fTNear,fTFar,fDelT,fQNear,fQFar,d
0,0,0,93,58,-40
3619298,3619306,8,3469,1031,-40
5208983,5208988,5,2608,1220,-40
6371745,6371760,15,1257,373,-40
7336241,7336248,7,3039,1228,-40
8047382,8047393,11,2244,1146,-40
9075361,9075367,6,2357,1344,-40
17142887,17142894,7,2279,1164,-40
18130371,18130377,6,1943,913,-40
18501689,18501695,6,1048,326,-40
21465225,21465209,-16,1953,1087,-40
23623915,23623913,-2,804,1067,-40
25386353,25386358,5,2674,1192,-40
27262768,27262775,7,3532,1512,-40
27523160,27523166,6,3005,1023,-40
28802130,28802137,7,2802,1171,-40
30906499,30906508,9,3489,1112,-40
30984450,30984456,6,2591,1074,-40
31350826,31350834,8,980,652,-40
35113730,35113735,5,2753,1150,-40
36247211,36247218,7,2566,916,-40
37825819,37825827,8,4087,1127,-40
38181509,38181514,5,3271,2223,-40
45482798,45482803,5,3562,1212,-40
50344870,50344875,5,2627,1056,-40
50845942,50845922,-20,3859,873,-40
59748796,59748780,-16,2777,1015,-40
61150534,61150538,4,1472,1093,-40
61657306,61657298,-8,610,161,-40
64093943,64093947,4,1494,993,-40
64817684,64817688,4,2159,1341,-40
66341986,66341994,8,2621,1211,-40
66539266,66539264,-2,1092,1267,-40
66883421,66883400,-21,2381,787,-40
69624702,69624708,6,2447,1306,-40
72446847,72446854,7,2855,1354,-40
72767381,72767387,6,2734,962,-40
72832365,72832354,-11,570,238,-40
75680633,75680637,4,3216,1200,-40
81985316,81985322,6,2986,1044,-40
91650569,91650573,4,2563,1382,-40
91817624,91817631,7,1368,831,-40
92625651,92625658,7,2208,1174,-40
92763021,92763027,6,3631,1758,-40
98092931,98092934,3,1974,1187,-40
99786278,99786285,7,2551,1200,-40
99812902,99812896,-6,505,4,-40
100620469,100620448,-21,1213,267,-40
105053764,105053769,5,3004,1126,-40
105162447,105162453,6,2503,1178,-40
105591895,105591902,7,2386,1235,-40
110755986,110755989,3,1648,1223,-40
111970002,111970008,6,2933,952,-40
117465494,117465500,6,3726,1570,-40
123082510,123082517,7,2204,819,-40
123469435,123469418,-17,1675,898,-40
126057753,126057759,6,3062,1341,-40
127438958,127438965,7,3462,1585,-40
128665150,128665157,7,3668,1846,-40
132177941,132177947,6,2534,1487,-40
133455625,133455621,-4,1558,4516,-40
134150646,134150653,7,45873,18814,-40
134788874,134788882,8,3087,1242,-40
136279718,136279719,1,1816,1867,-40
141094359,141094367,8,1993,753,-40
141508786,141508772,-14,2694,975,-40
141591125,141591130,5,2440,1237,-40
142818962,142818969,7,2604,1097,-40
150307699,150307705,6,1842,997,-40
151378665,151378671,6,2376,1140,-40
155921860,155921856,-4,3521,7685,-40
158108882,158108862,-20,1159,1836,-40
159065537,159065543,6,4131,1679,-40
159823122,159823126,4,2654,911,-40
160242477,160242482,5,2310,1144,-40
161254274,161254279,5,1362,1034,-40
162900766,162900771,5,1771,1134,-40
165203311,165203317,6,1616,657,-40
173719966,173719966,0,873,1277,-40
174890965,174890973,8,3384,1052,-40
178401214,178401222,8,2807,1269,-40
180552239,180552245,6,2566,1107,-40
183497345,183497350,5,2509,1178,-40
184518157,184518151,-6,1171,3082,-40
186472782,186472787,5,4432,2456,-40
192374826,192374834,8,2131,1902,-40
197290920,197290926,6,2307,917,-40
197621882,197621889,7,2622,1207,-40
198277125,198277131,6,2647,1507,-40
200188810,200188806,-4,2084,5325,-40
202701361,202701369,8,2018,1375,-40
203788795,203788802,7,1850,1086,-40
204607919,204607927,8,4325,1387,-40
211803976,211803980,4,2376,1339,-40
213987100,213987106,6,2242,1156,-40
216154648,216154655,7,2433,1345,-40
216288429,216288450,21,1391,286,-40
219590779,219590786,7,3275,1532,-40
222734016,222734026,10,1892,44821,-40
235198125,235198131,6,1974,1427,-40
235256859,235256862,3,2389,1417,-40
238754854,238754859,5,2173,960,-40
243442782,243442781,-1,771,1702,-40
245207573,245207579,6,3619,1316,-40
249032969,249032975,6,2459,1302,-40
251660086,251660093,7,3013,1152,-40
258992267,258992281,14,590,3749,-40
260641873,260641878,5,3122,1542,-40
261890472,261890473,1,11087,11153,-40
265384822,265384830,8,2864,1566,-40
280372556,280372562,6,2921,1169,-40
282183315,282183320,5,1863,1408,-40
290585037,290585042,5,2827,1078,-40
293621402,293621410,8,2930,931,-40
297083715,297083721,6,2260,1168,-40
297244430,297244448,18,2783,1165,-40
298204246,298204254,8,1836,1113,-40
299614601,299614609,8,2865,1068,-40
302573577,302573583,6,2785,1593,-40
306079171,306079178,7,4103,1426,-40
307442959,307442963,4,788,977,-40
312685825,312685832,7,2848,1225,-40
315025759,315025766,7,2923,1484,-40
317056924,317056930,6,3636,1428,-40
320039242,320039249,7,3878,1553,-40
331811154,331811160,6,3131,1275,-40
339160521,339160526,5,2377,1602,-40
342504991,342504998,7,2781,1367,-40
347367717,347367722,5,2335,1613,-40
348977246,348977234,-12,1886,676,-40
351727830,351727834,4,2049,1377,-40
356811622,356811628,6,2658,1462,-40
364762974,364762980,6,2440,1293,-40
366251253,366251258,5,1992,1058,-40
368971370,368971377,7,2191,1145,-40
376271298,376271301,3,2170,1916,-40
378256597,378256602,5,3235,1228,-40
382169514,382169522,8,3907,1633,-40
384047821,384047827,6,3228,1299,-40
386906785,386906782,-3,1102,2807,-40
392720971,392720978,7,4047,1326,-40
394937256,394937264,8,1714,1402,-40
397209261,397209266,5,3312,1453,-40
398181060,398181068,8,2506,1263,-40
400271475,400271479,4,2500,1755,-40
403113976,403113982,6,3042,1733,-40
403386249,403386255,6,3507,1771,-40
407824390,407824397,7,4089,1949,-40
411667552,411667558,6,2963,1083,-40
416065611,416065618,7,3444,1616,-40
417250022,417250028,6,3241,1319,-40
417299294,417299299,5,2108,1643,-40
418714926,418714934,8,2779,1127,-40
419795005,419795011,6,2886,1116,-40
427883574,427883578,4,3660,1740,-40
431725260,431725267,7,3522,1772,-40
431835896,431835901,5,3058,1509,-40
433110190,433110197,7,5176,1745,-40
439744746,439744743,-3,767,1585,-40
440548970,440548976,6,2786,1134,-40
442533194,442533200,6,2352,1544,-40
442596706,442596712,6,4704,2410,-40
448989417,448989422,5,2918,1090,-40
454379948,454379954,6,3176,1163,-40
455865406,455865384,-22,907,358,-40
458671077,458671086,9,2547,1282,-40
465237673,465237679,6,1831,920,-40
465448387,465448372,-15,4248,1742,-40
466675681,466675686,5,2445,1468,-40
466997334,466997339,5,3423,1344,-40
467553052,467553059,7,2512,838,-40
470685026,470685008,-18,1165,199,-40
473308715,473308723,8,2027,1217,-40
473983998,473984008,10,15709,28376,-40
474989001,474989006,5,2718,1147,-40
475235945,475235955,10,3743,1274,-40
479343974,479343966,-8,2061,10682,-40
487340758,487340765,7,2187,1600,-40
487979415,487979424,9,493,187,-40
489301378,489301385,7,2135,991,-40
489975376,489975382,6,2667,1224,-40
490285403,490285386,-17,2915,1404,-40
490714526,490714533,7,3622,1173,-40
497654351,497654359,8,4550,1707,-40
497754776,497754781,5,2581,1946,-40
499531420,499531426,6,3014,1026,-40
502980510,502980517,7,2782,1826,-40
503984122,503984124,2,4193,3591,-40
505456285,505456293,8,2418,1260,-40
506080529,506080534,5,2054,1421,-40
509399542,509399549,7,2493,1232,-40
509727029,509727030,1,42250,25535,-40
525419470,525419476,6,3703,1628,-40
529521758,529521765,7,2553,1466,-40
529801416,529801416,0,2095,1352,-40
536139029,536139031,2,1701,1948,-40
536549446,536549445,-1,1638,2178,-40
536871683,536871692,9,948,410,-40
540002363,540002359,-4,1074,2058,-40
540653621,540653626,5,1836,971,-40
540925103,540925090,-13,619,63,-40
550086821,550086838,17,1016,272,-40
552850733,552850738,5,3097,1018,-40
563146851,563146858,7,4334,2160,-40
570579686,570579693,7,1967,1109,-40
573144669,573144676,7,4427,1315,-40
574019678,574019683,5,3541,1338,-40
575274497,575274504,7,1806,860,-40
576963482,576963478,-4,984,1170,-40
577065813,577065794,-19,835,472,-40
578229520,578229516,-4,32337,14105,-40
579108439,579108446,7,3412,1640,-40
583274415,583274423,8,3139,1178,-40
584155450,584155443,-7,1250,7818,-40
587587338,587587345,7,1808,919,-40
594288919,594288926,7,3426,1253,-40
602638149,602638156,7,1987,936,-40
603117984,603117987,3,1606,1228,-40
604168159,604168167,8,3385,1284,-40
604196416,604196411,-5,1149,242,-40
606738921,606738925,4,2302,1498,-40
607664561,607664566,5,2573,1634,-40
609576688,609576694,6,2659,1169,-40
611669934,611669941,7,2651,1464,-40
613205966,613205960,-6,30654,13194,-40
616504694,616504690,-4,545,2265,-40
617047693,617047699,6,3369,1263,-40
623720489,623720471,-18,367,1130,-40
626153339,626153333,-6,1667,10288,-40
629792279,629792282,3,1659,1157,-40
630853986,630853986,0,2019,2503,-40
632633425,632633432,7,1753,764,-40
634438396,634438402,6,2401,1203,-40
640190183,640190191,8,2613,1080,-40
640291220,640291204,-16,2825,1584,-40
644114676,644114683,7,4701,1253,-40
648018034,648018041,7,2819,1484,-40
648580393,648580399,6,3531,1443,-40
652023114,652023118,4,2410,1242,-40
654935314,654935322,8,4323,1627,-40
654983187,654983193,6,1817,884,-40
655277879,655277891,12,1295,147,-40
657914177,657914183,6,3774,1679,-40
666528609,666528615,6,3404,1687,-40
666597794,666597798,4,2437,1208,-40
667672406,667672413,7,2505,1179,-40
674414460,674414468,8,2240,1273,-40
674520412,674520424,12,2556,1419,-40
682202031,682202030,-1,28234,17984,-40
685538447,685538454,7,2722,969,-40
685859469,685859450,-19,2838,1066,-40
686011902,686011909,7,3489,1397,-40
686153792,686153787,-5,688,3584,-40
690292669,690292675,6,2194,935,-40
691152233,691152235,2,1728,1116,-40
695396316,695396322,6,4262,1480,-40
698065987,698065997,10,2679,1195,-40
711585304,711585292,-12,1004,325,-40
711859890,711859886,-4,1089,2572,-40
712599838,712599847,9,2975,1281,-40
718214364,718214370,6,3202,1109,-40
718769499,718769506,7,2857,1086,-40
726320153,726320155,2,3814,3136,-40
726934161,726934167,6,2298,1152,-40
731816451,731816451,0,1240,1326,-40
736373451,736373448,-3,1333,2205,-40
742981770,742981775,5,2872,1389,-40
748634320,748634324,4,2726,939,-40
750431868,750431874,6,3061,1262,-40
751530802,751530802,0,1356,1801,-40
756089551,756089556,5,13528,27733,-40
756453534,756453536,2,1794,1334,-40
756502291,756502297,6,2977,1305,-40
761935028,761935016,-12,1038,1194,-40
768625832,768625838,6,2278,1032,-40
769051780,769051788,8,2298,1349,-40
769955938,769955938,0,591,255,-40
770476673,770476690,17,1083,17,-40
771209489,771209494,5,2344,1080,-40
777865242,777865247,5,2403,1066,-40
779736131,779736134,3,2293,1648,-40
784197190,784197194,4,3269,1140,-40
784664944,784664950,6,2782,1424,-40
784848664,784848670,6,3612,1185,-40
785162066,785162074,8,2933,1315,-40
790306128,790306133,5,3903,1418,-40
791009444,791009451,7,1291,368,-40
792213902,792213881,-21,1436,284,-40
794144564,794144573,9,1513,752,-40
795172952,795172958,6,2304,1045,-40
795304579,795304576,-3,1521,3844,-40
799840424,799840430,6,3103,1413,-40
801585322,801585327,5,2738,1118,-40
809803824,809803831,7,3248,1473,-40
812804669,812804673,4,2957,1222,-40
813472458,813472472,14,878,364,-40
817527618,817527622,4,1788,1082,-40
820850977,820850980,3,2527,1427,-40
821469778,821469786,8,3478,1179,-40
828456937,828456943,6,560,502,-40
834207255,834207245,-10,30149,17487,-40
834403582,834403584,2,2423,2045,-40
834679986,834679979,-7,932,3596,-40
835310013,835310016,3,1789,1557,-40
838799446,838799451,5,3995,1363,-40
845562445,845562449,4,2421,1849,-40
846652918,846652920,2,2036,1587,-40
850752538,850752546,8,3055,1643,-40
852859299,852859305,6,3689,1606,-40
853204657,853204662,5,2244,1092,-40
856612099,856612105,6,2303,1323,-40
858462574,858462580,6,9247,3273,-40
860382674,860382678,4,2446,1127,-40
861707382,861707386,4,2246,1544,-40
862761481,862761486,5,1895,909,-40
863448321,863448337,16,584,269,-40
868328313,868328310,-3,2016,4747,-40
872615555,872615561,6,3718,1449,-40
873509611,873509617,6,2929,1352,-40
878660022,878660021,-1,1846,3012,-40
882134778,882134785,7,44811,15840,-40
891191536,891191537,1,2652,3301,-40
891435973,891435978,5,2568,1510,-40
892907219,892907222,3,2198,2144,-40
895581307,895581313,6,3983,1454,-40
898394373,898394381,8,3361,1409,-40
900097009,900097015,6,2998,1233,-40
900165721,900165727,6,1847,1016,-40
901603869,901603862,-7,787,546,-40
904244978,904244985,7,2176,1386,-40
905689154,905689152,-2,25358,42977,-40
906504307,906504314,7,2119,954,-40
909098934,909098915,-19,1960,1034,-40
915626653,915626659,6,3570,1429,-40
916913997,916914003,6,3388,1639,-40
918573273,918573278,5,1629,759,-40
921525074,921525079,5,3177,1271,-40
925557692,925557692,0,1316,2211,-40
927448457,927448462,5,2716,1544,-40
928981989,928981995,6,2726,1166,-40
930011731,930011737,6,3866,1375,-40
935923129,935923135,6,3069,1314,-40
940260710,940260714,4,3023,1126,-40
943348045,943348049,4,3674,1674,-40
943976928,943976933,5,1759,1230,-40
950421400,950421407,7,2482,1277,-40
952708247,952708249,2,2256,2189,-40
952786288,952786294,6,2123,1123,-40
957286299,957286306,7,3507,1263,-40
957502472,957502478,6,2817,1287,-40
960171252,960171259,7,3921,1877,-40
961805549,961805554,5,3657,1883,-40
962340455,962340453,-2,2557,3873,-40
964283546,964283527,-19,2759,1727,-40
978981935,978981935,0,22863,19885,-40
983020433,983020438,5,2820,1328,-40
986793083,986793090,7,2900,1198,-40
994645746,994645751,5,3092,1115,-40
996753879,996753885,6,3331,1630,-40
996984491,996984498,7,3930,1092,-40
1000756297,1000756302,5,3257,1206,-40
1011024847,1011024854,7,4842,1418,-40
1013673449,1013673455,6,2359,920,-40
1013963222,1013963201,-21,798,313,-40
1016365572,1016365578,6,3617,2776,-40
1017202287,1017202295,8,4370,1310,-40
1017595549,1017595531,-18,1286,511,-40
1018972709,1018972715,6,2338,886,-40
1025759392,1025759396,4,4630,3099,-40
1026813174,1026813179,5,2279,920,-40
1027744937,1027744943,6,3677,1161,-40
1028084416,1028084422,6,3529,1207,-40
1030928271,1030928277,6,3275,1495,-40
1031749677,1031749682,5,2919,886,-40
1032031221,1032031226,5,2466,736,-40
1033171322,1033171329,7,2424,865,-40
1034090418,1034090423,5,3205,1822,-40
1040764181,1040764186,5,2761,1545,-40
1044888343,1044888340,-3,3017,51323,-40
1052406845,1052406850,5,2323,1195,-40
1058343895,1058343901,6,2254,1518,-40
1061918059,1061918061,2,2104,2000,-40
1062078209,1062078210,1,1926,1424,-40
1063100749,1063100754,5,4145,1352,-40
1063160945,1063160951,6,2230,1016,-40
1071067952,1071067959,7,2915,1093,-40
1074095946,1074095946,0,974,1206,-40
1074249107,1074249090,-17,784,231,-40
1074510766,1074510778,12,2356,1177,-40
1074573875,1074573882,7,3246,1467,-40
1076916098,1076916105,7,2849,1168,-40
1078150999,1078150998,-1,1248,3239,-40
1078292696,1078292702,6,4557,2101,-40
1082795585,1082795591,6,2076,853,-40
1085028998,1085029003,5,3233,1835,-40
1085965444,1085965451,7,3071,1260,-40
1086311653,1086311658,5,2611,1055,-40
1089328186,1089328194,8,3841,855,-40
1094325323,1094325330,7,2861,1095,-40
1095582543,1095582549,6,3297,1271,-40
1095996770,1095996777,7,2331,1381,-40
1096059554,1096059538,-16,1620,548,-40
1096210238,1096210247,9,3227,896,-40
1096424702,1096424684,-18,1561,702,-40
1097062121,1097062128,7,3777,1403,-40
1100889760,1100889766,6,3509,1564,-40
1103053710,1103053715,5,3560,1004,-40
1107470117,1107470105,-12,1279,265,-40
1107570946,1107570950,4,1713,810,-40
1107931598,1107931602,4,1678,1162,-40
1108102740,1108102747,7,531,103,-40
1115396638,1115396646,8,1915,805,-40
1115957897,1115957883,-14,1511,729,-40
1117694002,1117694009,7,3798,1078,-40
1118830378,1118830383,5,3278,1025,-40
1123149461,1123149466,5,2778,1112,-40
1124021227,1124021233,6,4417,1408,-40
1124861486,1124861493,7,3375,1140,-40
1124989806,1124989820,14,1139,235,-40
1125073051,1125073069,18,818,2275,-40
1130704792,1130704797,5,2257,1325,-40
1135755425,1135755434,9,1506,646,-40
1137279775,1137279782,7,2613,2224,-40
1138085218,1138085210,-8,915,770,-40
1142640720,1142640727,7,2641,1358,-40
1143827677,1143827683,6,2032,723,-40
1150827240,1150827246,6,4439,1321,-40
1151487925,1151487930,5,2770,1291,-40
1156717491,1156717497,6,3426,1690,-40
1163618783,1163618791,8,1984,1022,-40
1166644963,1166644964,1,1327,2407,-40
1168449061,1168449067,6,2057,1540,-40
1168835418,1168835426,8,2719,1451,-40
1170398033,1170398040,7,2959,1493,-40
1172094568,1172094573,5,2492,1197,-40
1173256642,1173256647,5,2279,1589,-40
1174730624,1174730630,6,1921,776,-40
1176211462,1176211455,-7,1831,9105,-40
1179120244,1179120251,7,3426,1211,-40
1180374178,1180374183,5,2812,1389,-40
1181539595,1181539603,8,2377,1619,-40
1181647305,1181647290,-15,714,342,-40
1183141600,1183141606,6,3168,1187,-40
1183228526,1183228508,-18,982,123,-40
1187032188,1187032194,6,2600,1347,-40
1195898662,1195898671,9,3588,1192,-40
1198053907,1198053889,-18,1178,444,-40
1202328253,1202328258,5,3045,1301,-40
1202440719,1202440715,-4,1052,3592,-40
1208214071,1208214066,-5,1994,5680,-40
1218252258,1218252262,4,3465,1443,-40
1218325966,1218325970,4,3379,1683,-40
1220147393,1220147399,6,3936,2026,-40
1223195762,1223195768,6,2158,1366,-40
1226937484,1226937488,4,4379,2386,-40
1229211361,1229211368,7,3237,1655,-40
1231356765,1231356771,6,2055,1192,-40
1233338046,1233338050,4,1777,1722,-40
1237911168,1237911174,6,3314,1686,-40
1240907965,1240907969,4,1704,1440,-40
1241339501,1241339507,6,3739,969,-40
1244470027,1244470033,6,2803,1252,-40
1244937946,1244937955,9,1677,1140,-40
1244976586,1244976570,-16,1885,1029,-40
1245246702,1245246709,7,4128,1084,-40
1246908256,1246908262,6,2952,1584,-40
1249855990,1249855997,7,2672,1298,-40
1256412138,1256412146,8,2707,1136,-40
1257637930,1257637927,-3,1188,2710,-40
1257783555,1257783562,7,3152,1538,-40
1261244243,1261244249,6,2937,965,-40
1263409725,1263409733,8,3462,1440,-40
1264944229,1264944234,5,1676,1419,-40
1273516595,1273516601,6,1990,710,-40
1275243346,1275243342,-4,1280,2817,-40
1283525737,1283525742,5,3471,1344,-40
1284969634,1284969616,-18,3182,1290,-40
1285215889,1285215894,5,1682,1331,-40
1288930383,1288930388,5,2141,966,-40
1289465438,1289465418,-20,2206,1014,-40
1290842270,1290842277,7,2837,1147,-40
1291658596,1291658604,8,1990,1181,-40
1300876470,1300876474,4,3133,2283,-40
1301535121,1301535129,8,1958,1110,-40
1301982753,1301982759,6,2122,959,-40
1302861312,1302861322,10,2085,940,-40
1302919769,1302919762,-7,1812,381,-40
1306476005,1306476011,6,2857,1170,-40
1307154102,1307154110,8,2742,1315,-40
1307490783,1307490778,-5,1649,4037,-40
1308338863,1308338871,8,2865,1241,-40
1317512421,1317512421,0,2467,3852,-40
1318162857,1318162864,7,3751,1713,-40
1320694305,1320694310,5,2768,1023,-40
1322731780,1322731786,6,3081,1369,-40
1325096610,1325096614,4,3514,2002,-40
1329254868,1329254862,-6,30559,13627,-40
1329601140,1329601146,6,2407,1305,-40
1329711439,1329711428,-11,4804,1750,-40
1329896289,1329896294,5,3494,1453,-40
1335622621,1335622627,6,1510,1187,-40
1342794518,1342794522,4,3771,1666,-40
1342889964,1342889970,6,2900,1630,-40
1347268493,1347268498,5,3370,1512,-40
1355529401,1355529406,5,3004,1274,-40
1357172822,1357172828,6,2540,1239,-40
1357591974,1357591981,7,3006,1540,-40
1360437378,1360437384,6,2502,1447,-40
1361540161,1361540166,5,2988,1482,-40
1370244564,1370244568,4,2013,1743,-40
1370407351,1370407363,12,494,194,-40
1374668188,1374668191,3,2202,1268,-40
1376996241,1376996247,6,2811,1052,-40
1377492115,1377492119,4,1796,1428,-40
1377964982,1377964988,6,2550,888,-40
1379272230,1379272237,7,2794,869,-40
1379338128,1379338115,-13,1638,467,-40
1386115004,1386115009,5,3383,1285,-40
1386847545,1386847550,5,3277,1488,-40
1388568490,1388568495,5,3314,1511,-40
1388892809,1388892815,6,3167,1591,-40
1390854758,1390854779,21,761,174,-40
1393072325,1393072330,5,3654,1498,-40
1393561902,1393561911,9,2817,1200,-40
1394912393,1394912401,8,4329,1685,-40
1397372198,1397372203,5,3447,1448,-40
1397927202,1397927208,6,2092,1430,-40
1400405298,1400405306,8,2164,858,-40
1402186113,1402186118,5,3797,1720,-40
1403832252,1403832259,7,2167,1407,-40
1404220968,1404220974,6,2917,1171,-40
1407160650,1407160657,7,2642,1336,-40
1411794062,1411794069,7,3817,1165,-40
1416931294,1416931299,5,2449,958,-40
1422958866,1422958873,7,2253,1456,-40
1423552518,1423552526,8,2255,1839,-40
1430895518,1430895524,6,2554,1327,-40
1431086997,1431087003,6,2912,1386,-40
1432592895,1432592902,7,3251,1493,-40
1436052701,1436052708,7,2223,1188,-40
1443990478,1443990486,8,2835,1437,-40
1447556379,1447556385,6,3338,1334,-40
1451085893,1451085899,6,3740,1220,-40
1451692662,1451692664,2,1465,1821,-40
1455668336,1455668341,5,9180,6418,-40
1457172375,1457172381,6,3453,1304,-40
1461281475,1461281481,6,2694,1324,-40
1470252412,1470252408,-4,1162,2756,-40
1470331406,1470331412,6,1931,1665,-40
1471241721,1471241728,7,2618,1349,-40
1480823980,1480823986,6,3042,1171,-40
1482738916,1482738923,7,4242,2056,-40
1484395320,1484395326,6,3504,1869,-40
1484670801,1484670806,5,3095,1518,-40
1485422500,1485422507,7,2694,1274,-40
1487371614,1487371620,6,3062,1191,-40
1488872879,1488872885,6,2851,1145,-40
1490791774,1490791755,-19,1226,816,-40
1491144237,1491144237,0,1300,2221,-40
1491268055,1491268060,5,2693,1230,-40
1494041633,1494041639,6,3909,1760,-40
1497397584,1497397590,6,4029,1379,-40
1504074681,1504074687,6,2590,925,-40
1504892591,1504892598,7,1451,1052,-40
1508732470,1508732475,5,2664,1484,-40
1509011507,1509011512,5,2248,1147,-40
1515107686,1515107690,4,3479,1461,-40
1515290746,1515290751,5,3520,1106,-40
1518882264,1518882270,6,3594,1133,-40
1520013946,1520013951,5,3280,1548,-40
1530153542,1530153546,4,1722,748,-40
1532295445,1532295451,6,2653,1002,-40
1533204203,1533204210,7,2710,1448,-40
1539035862,1539035869,7,3733,1339,-40
1543734807,1543734813,6,2651,1140,-40
1545457685,1545457693,8,2800,1071,-40
1547443206,1547443222,16,1208,2750,-40
1553836957,1553836955,-2,534,678,-40
1556310464,1556310470,6,4018,1592,-40
1559190750,1559190755,5,2615,1242,-40
1560367113,1560367121,8,3013,1838,-40
1561432670,1561432675,5,2783,1476,-40
1562947303,1562947310,7,2627,1125,-40
1565380234,1565380240,6,2932,1195,-40
1567566135,1567566141,6,2992,1235,-40
1568849534,1568849540,6,2726,1586,-40
1570062950,1570062956,6,1531,930,-40
1573435997,1573435982,-15,1707,561,-40
1574528743,1574528749,6,2457,1162,-40
1581431544,1581431538,-6,1522,4338,-40
1584108910,1584108905,-5,1162,3224,-40
1589258090,1589258090,0,4852,5836,-40
1592594586,1592594595,9,1943,850,-40
1593538818,1593538824,6,3090,1128,-40
1596758614,1596758622,8,3090,1386,-40
1597608806,1597608810,4,2017,940,-40
1598550456,1598550454,-2,18886,11466,-40
1598880974,1598880963,-11,1207,263,-40
1599898710,1599898705,-5,1153,2901,-40
1604493202,1604493210,8,2582,1037,-40
1608423370,1608423377,7,2476,1217,-40
1608759832,1608759833,1,1289,1804,-40
1610384475,1610384469,-6,1637,4850,-40
1612371601,1612371607,6,2805,1411,-40
1616399897,1616399902,5,3491,1486,-40
1617479462,1617479440,-22,1529,1545,-40
1618605539,1618605541,2,1968,2172,-40
1619133630,1619133635,5,2598,1273,-40
1620889684,1620889691,7,3158,1317,-40
1621328993,1621328998,5,2642,1061,-40
1624869603,1624869609,6,3168,942,-40
1625243951,1625243946,-5,1444,5505,-40
1625534369,1625534375,6,2113,1581,-40
1628992097,1628992102,5,2681,1259,-40
1631195086,1631195089,3,1153,999,-40
1631616297,1631616302,5,2830,1875,-40
1638291039,1638291046,7,3168,1347,-40
1639959385,1639959391,6,2773,927,-40
1644014466,1644014472,6,1922,1428,-40
1645881531,1645881526,-5,1230,3206,-40
1647731771,1647731777,6,2907,1740,-40
1647923318,1647923325,7,2336,1089,-40
1648552918,1648552915,-3,921,338,-40
1649532154,1649532161,7,3008,1411,-40
1653020963,1653020970,7,3441,1629,-40
1653894634,1653894634,0,1204,2412,-40
1655754282,1655754289,7,3122,1308,-40
1656057159,1656057145,-14,1387,322,-40
1658291585,1658291590,5,2020,926,-40
1658570311,1658570298,-13,2951,1230,-40
1661546770,1661546777,7,3043,1212,-40
1662373074,1662373074,0,1390,1733,-40
1662985981,1662985985,4,1628,1189,-40
1668431957,1668431964,7,3071,1258,-40
1670275395,1670275402,7,3886,1181,-40
1674457832,1674457839,7,2029,1254,-40
1679777599,1679777606,7,2794,887,-40
1682150047,1682150053,6,2253,1124,-40
1683125969,1683125974,5,2256,1267,-40
1683450562,1683450563,1,29442,24990,-40
1688244717,1688244722,5,2899,1835,-40
1688396687,1688396693,6,1926,1124,-40
1691347256,1691347263,7,2181,1289,-40
1691560293,1691560298,5,2344,1251,-40
1701411282,1701411286,4,3685,1670,-40
1703230527,1703230531,4,2778,1939,-40
1707453029,1707453036,7,3051,1402,-40
1708020529,1708020516,-13,2849,1156,-40
1711634363,1711634370,7,2839,1170,-40
1719051574,1719051582,8,2708,1640,-40
1720314790,1720314795,5,1592,1159,-40
1720833874,1720833880,6,3208,1494,-40
1724987021,1724987027,6,2401,966,-40
1726755939,1726755939,0,966,794,-40
1731756578,1731756585,7,3272,1198,-40
1734072275,1734072282,7,4090,1366,-40
1735245838,1735245842,4,2077,1024,-40
1739084623,1739084621,-2,1825,3612,-40
1743681331,1743681338,7,3499,1863,-40
1744259962,1744259964,2,2126,1057,-40
1744292887,1744292867,-20,3269,1599,-40
1745562873,1745562891,18,1912,1155,-40
1746035343,1746035332,-11,3802,1492,-40
1749741605,1749741603,-2,1549,3282,-40
1754863460,1754863466,6,3533,1454,-40
1755819555,1755819562,7,2780,1369,-40
1756966017,1756966022,5,2504,943,-40
1758524831,1758524839,8,2705,1370,-40
1759782529,1759782522,-7,557,2402,-40
1761055949,1761055962,13,18462,31910,-40
1761562763,1761562769,6,3284,1232,-40
1761747012,1761747018,6,2545,1247,-40
1771311098,1771311103,5,3001,925,-40
1771492961,1771492963,2,1974,884,-40
1772769803,1772769809,6,4067,886,-40
1773300698,1773300702,4,2452,1220,-40
1774686738,1774686743,5,2187,1162,-40
1781836928,1781836933,5,2262,1778,-40
1784332076,1784332082,6,2884,1507,-40
1788038226,1788038232,6,2446,1577,-40
1790505214,1790505217,3,1356,1118,-40
1791910635,1791910642,7,2574,1049,-40
1798015942,1798015949,7,4355,1286,-40
1798554112,1798554096,-16,2244,869,-40
1799415880,1799415887,7,5157,1641,-40
1802484878,1802484886,8,3385,1148,-40
1803291660,1803291642,-18,3211,902,-40
1805536252,1805536259,7,2557,934,-40
1808875294,1808875302,8,2700,1565,-40
1809172116,1809172122,6,2951,1547,-40
1810416817,1810416822,5,4950,2063,-40
1812411087,1812411081,-6,1939,7782,-40
1814736379,1814736387,8,2247,1136,-40
1816624986,1816624981,-5,1884,6278,-40
1822750296,1822750302,6,2540,1130,-40
1822918098,1822918083,-15,2762,1270,-40
1829140950,1829140957,7,2673,1352,-40
1832856306,1832856313,7,3121,1887,-40
1842897933,1842897939,6,2256,942,-40
1844173587,1844173595,8,2599,1023,-40
1847816085,1847816091,6,3977,1350,-40
1848378437,1848378441,4,2723,1988,-40
1850282179,1850282174,-5,1499,4250,-40
1852792124,1852792130,6,2993,1035,-40
1858230178,1858230175,-3,918,1682,-40
1871766327,1871766333,6,2090,950,-40
1873508906,1873508898,-8,2206,40912,-40
1880495058,1880495065,7,3215,1107,-40
1883576644,1883576649,5,3998,1396,-40
1884272692,1884272674,-18,923,220,-40
1884895841,1884895826,-15,1393,193,-40
1886684730,1886684733,3,2336,885,-40
1887083869,1887083874,5,2388,1138,-40
1887990656,1887990663,7,3149,957,-40
1889245094,1889245099,5,2887,1010,-40
1906725654,1906725661,7,3276,1837,-40
1908171445,1908171451,6,4853,1091,-40
1910529962,1910529967,5,2456,982,-40
1912840109,1912840114,5,1486,1100,-40
1914371222,1914371227,5,2116,1256,-40
1915139918,1915139918,0,2543,1524,-40
1916337744,1916337749,5,2640,1264,-40
1917634713,1917634719,6,2929,1019,-40
1919736030,1919736036,6,3116,1250,-40
1921752288,1921752294,6,2726,1613,-40
1927943982,1927943987,5,2199,961,-40
1931740011,1931740013,2,1277,1450,-40
1934396748,1934396748,0,1059,1502,-40
1937828571,1937828577,6,3529,1287,-40
1938081232,1938081237,5,2234,1401,-40
1942675232,1942675238,6,3392,1359,-40
1943750862,1943750866,4,1343,876,-40
1948042677,1948042683,6,2811,1345,-40
1949948758,1949948764,6,2732,1317,-40
1954128089,1954128094,5,2982,1088,-40
1954762093,1954762098,5,4641,1558,-40
1956055861,1956055865,4,2223,1430,-40
1962044563,1962044567,4,2547,1317,-40
1969944117,1969944124,7,4033,1312,-40
1973104210,1973104217,7,4065,1735,-40
1978228578,1978228585,7,2068,1153,-40
1979710886,1979710899,13,2950,1368,-40
1980381544,1980381531,-13,1832,1266,-40
1984219172,1984219180,8,864,284,-40
1987089102,1987089109,7,3023,1221,-40
1987154346,1987154363,17,1413,970,-40
1988886146,1988886154,8,3798,1173,-40
1991547459,1991547466,7,2587,1144,-40
1994196934,1994196942,8,2545,1408,-40
1999580337,1999580342,5,3061,1431,-40
2002915209,2002915215,6,1642,1057,-40
2009919246,2009919250,4,4538,2293,-40
2012931520,2012931527,7,3048,1310,-40
2016920338,2016920344,6,3083,1447,-40
2017854733,2017854737,4,2959,2094,-40
2024372574,2024372578,4,1745,542,-40
2026026090,2026026094,4,2008,1489,-40
2026401978,2026401981,3,1846,1963,-40
2026427447,2026427454,7,2958,1342,-40
2027891994,2027892001,7,3970,1405,-40
2029118026,2029118031,5,2640,981,-40
2030823583,2030823587,4,1280,601,-40
2031106489,2031106474,-15,2584,1506,-40
2033000734,2033000739,5,3239,1078,-40
2034691485,2034691491,6,3203,1606,-40
2043320098,2043320102,4,1619,940,-40
2046291622,2046291625,3,1525,1402,-40
2047832416,2047832422,6,2296,1340,-40
2051333222,2051333230,8,2396,874,-40
2052057141,2052057146,5,3553,1251,-40
2052309603,2052309609,6,2453,1358,-40
2052691606,2052691613,7,3601,1742,-40
2056806512,2056806517,5,2531,1610,-40
2057071650,2057071654,4,2380,1289,-40
2057243973,2057243995,22,916,194,-40
2060131512,2060131518,6,2356,947,-40
2063094777,2063094782,5,3513,1330,-40
2065281130,2065281138,8,4421,1497,-40
2070189174,2070189168,-6,952,3591,-40
2073708270,2073708277,7,2031,1334,-40
2074834777,2074834779,2,2571,2357,-40
2077478828,2077478834,6,3199,1961,-40
2079146085,2079146090,5,1630,706,-40
2083962797,2083962803,6,2483,1470,-40
2088063169,2088063174,5,1552,941,-40
2093042249,2093042245,-4,126,684,-40
2094485305,2094485311,6,3487,1622,-40
2096024581,2096024587,6,4023,1970,-40
2099382493,2099382498,5,3279,1137,-40
2108535639,2108535623,-16,288,2709,-40
2108933813,2108933819,6,2347,1516,-40
2109311802,2109311807,5,2959,1293,-40
2109808260,2109808278,18,945,1411,-40
2123606443,2123606450,7,2583,1261,-40
2126200789,2126200781,-8,1373,2442,-40
2128306797,2128306803,6,3229,1100,-40
2133797041,2133797046,5,2510,1361,-40
2136513777,2136513783,6,1863,854,-40
2139835611,2139835617,6,2722,1424,-40
2150931721,2150931726,5,2336,887,-40
2152371573,2152371578,5,2298,937,-40
2153395534,2153395540,6,3065,1139,-40
2153642655,2153642664,9,2364,1166,-40
2155767273,2155767278,5,3386,1133,-40
2163122601,2163122605,4,2208,983,-40
2164379546,2164379551,5,2252,1349,-40
2165787686,2165787698,12,2704,1211,-40
2166275047,2166275065,18,3842,1386,-40
2173960246,2173960254,8,3759,1009,-40
2174716091,2174716106,15,1273,317,-40
2175295268,2175295273,5,4679,2707,-40
2176054158,2176054165,7,2364,1409,-40
2176801014,2176801022,8,2814,1020,-40
2177157958,2177157969,11,1180,302,-40
2181334519,2181334522,3,2140,807,-40
2184073619,2184073627,8,2196,946,-40
2184487240,2184487238,-2,2236,4550,-40
2187622750,2187622757,7,3809,1454,-40
2192245601,2192245606,5,1825,1219,-40
2201377208,2201377213,5,2764,1286,-40
2203965195,2203965200,5,2934,1137,-40
2208914770,2208914776,6,2853,1505,-40
2209339205,2209339210,5,3538,1865,-40
2210174154,2210174173,19,858,409,-40
2215174184,2215174190,6,3222,926,-40
2221842874,2221842871,-3,894,2432,-40
2224919529,2224919509,-20,2815,1322,-40
2226033389,2226033394,5,3089,1464,-40
2232607644,2232607650,6,1742,993,-40
2241110766,2241110772,6,3792,1488,-40
2241348912,2241348923,11,3446,1473,-40
2242272218,2242272225,7,611,199,-40
2245221419,2245221424,5,2832,1155,-40
2245799580,2245799561,-19,2826,1264,-40
2247823525,2247823530,5,2704,751,-40
2252675201,2252675207,6,1412,936,-40
2255268418,2255268427,9,2313,1042,-40
2255453803,2255453801,-2,1147,2796,-40
2258405420,2258405424,4,1713,1097,-40
2259219875,2259219882,7,2176,999,-40
2265198277,2265198283,6,3241,1679,-40
2265381703,2265381710,7,3059,1309,-40
2270038167,2270038162,-5,1205,3860,-40
2270528797,2270528799,2,2090,1000,-40
2271320071,2271320076,5,2971,1004,-40
2275850474,2275850479,5,1821,1150,-40
2276437337,2276437343,6,3999,1808,-40
2279638167,2279638173,6,2873,1701,-40
2288606231,2288606238,7,3628,1701,-40
2294775565,2294775570,5,3472,1260,-40
2296375416,2296375422,6,2960,1061,-40
2296470402,2296470387,-15,2672,1058,-40
2296601403,2296601410,7,1907,975,-40
2299409305,2299409310,5,1577,679,-40
2300432135,2300432139,4,1814,1340,-40
2301238842,2301238849,7,3167,1714,-40
2303014457,2303014463,6,2264,1465,-40
2308532959,2308532965,6,2166,1155,-40
2312415325,2312415308,-17,3172,1382,-40
2320338815,2320338821,6,2554,1393,-40
2320364974,2320364954,-20,1501,1044,-40
2321914282,2321914279,-3,1733,3425,-40
2323865226,2323865235,9,3174,1258,-40
2324483262,2324483256,-6,1348,50,-40
2324525874,2324525859,-15,1984,1104,-40
2324997422,2324997400,-22,1347,446,-40
2327117553,2327117558,5,4316,1335,-40
2330113184,2330113190,6,2336,863,-40
2333162353,2333162340,-13,1197,648,-40
2333527193,2333527201,8,3333,1732,-40
2337279442,2337279447,5,2016,1321,-40
2344674886,2344674892,6,3631,1871,-40
2348824466,2348824471,5,1771,857,-40
2349760585,2349760589,4,2218,1958,-40
2351423641,2351423646,5,2798,1036,-40
2352580822,2352580829,7,2639,1468,-40
2354058119,2354058125,6,3722,1568,-40
2354289857,2354289844,-13,1089,506,-40
2356064581,2356064574,-7,28224,13377,-40
2356216237,2356216244,7,1895,1217,-40
2357817250,2357817257,7,2669,1212,-40
2360169468,2360169454,-14,3150,1350,-40
2361484274,2361484281,7,2976,814,-40
2363085262,2363085278,16,11490,51987,-40
2365464033,2365464037,4,1257,1206,-40
2366307166,2366307173,7,3386,1602,-40
2368040751,2368040754,3,2431,1234,-40
2368361519,2368361526,7,4109,1396,-40
2370497324,2370497317,-7,896,3706,-40
2374656139,2374656145,6,3659,1238,-40
2375221415,2375221420,5,2493,1737,-40
2392178217,2392178223,6,1046,665,-40
2396066846,2396066853,7,3491,2009,-40
2398076703,2398076710,7,2379,1306,-40
2400238372,2400238378,6,2027,1041,-40
2400746422,2400746427,5,2656,826,-40
2401601407,2401601414,7,1688,659,-40
2404282226,2404282232,6,2881,1445,-40
2408201597,2408201603,6,3084,1415,-40
2413946050,2413946055,5,2089,1435,-40
2414883342,2414883348,6,2674,1459,-40
2417318475,2417318481,6,3458,1058,-40
2419853674,2419853678,4,2503,1632,-40
2424196986,2424196991,5,4217,2638,-40
2429950295,2429950303,8,2866,1242,-40
2432307088,2432307095,7,3064,1553,-40
2437830339,2437830344,5,2300,1187,-40
2442239665,2442239670,5,2404,1292,-40
2442794670,2442794675,5,1477,941,-40
2445730329,2445730336,7,2211,1472,-40
2447321412,2447321417,5,2403,938,-40
2447458878,2447458882,4,2454,1356,-40
2449349153,2449349163,10,2569,1012,-40
2450647782,2450647789,7,3529,1306,-40
2450681762,2450681746,-16,2637,904,-40
2451214769,2451214771,2,6818,5144,-40
2452787345,2452787350,5,3019,1691,-40
2453585546,2453585552,6,2404,1005,-40
2454136957,2454136963,6,2551,1235,-40
2456749929,2456749934,5,2866,1087,-40
2458628390,2458628377,-13,85,761,-40
2459910589,2459910597,8,2333,753,-40
2460707161,2460707167,6,3711,1443,-40
2461934029,2461934035,6,2738,1331,-40
2463816202,2463816209,7,1985,924,-40
2464012466,2464012469,3,3177,3247,-40
2465283245,2465283250,5,2766,1380,-40
2466534886,2466534892,6,3668,1701,-40
2467534696,2467534701,5,2626,1421,-40
2468809897,2468809902,5,2883,1259,-40
2470023571,2470023554,-17,402,182,-40
2472593117,2472593124,7,3193,1777,-40
2473022457,2473022464,7,4837,2570,-40
2474924790,2474924790,0,1676,2500,-40
2475326018,2475326023,5,4148,1555,-40
2475697379,2475697386,7,3385,1486,-40
2475964790,2475964768,-22,2235,717,-40
2481543010,2481543031,21,3071,1281,-40
2481914298,2481914284,-14,1196,349,-40
2485069745,2485069750,5,3842,1797,-40
2487138299,2487138307,8,3783,1354,-40
2488443185,2488443190,5,1912,1135,-40
2494889909,2494889914,5,1849,961,-40
2496279300,2496279306,6,2123,1506,-40
2502854362,2502854366,4,2254,1045,-40
2506670076,2506670072,-4,1558,3724,-40
2507915131,2507915126,-5,1011,4650,-40
2509909965,2509909966,1,4328,53841,-40
2511395453,2511395459,6,1389,782,-40
2513409908,2513409914,6,2844,1438,-40
2515245134,2515245142,8,3882,1535,-40
2518732665,2518732666,1,1741,2337,-40
2520122530,2520122537,7,2337,737,-40
2520328793,2520328799,6,3468,1490,-40
2521970774,2521970779,5,2217,1144,-40
2526162713,2526162722,9,6578,646,-40
2534984804,2534984810,6,3872,1525,-40
2536765614,2536765621,7,3350,1559,-40
2538406173,2538406178,5,2235,1076,-40
2539837500,2539837512,12,2548,1236,-40
2546234587,2546234594,7,3553,1129,-40
2547556861,2547556869,8,2606,1003,-40
2548394854,2548394861,7,3142,1414,-40
2550185354,2550185336,-18,1836,398,-40
2552018164,2552018171,7,3527,1728,-40
2554176170,2554176177,7,3424,1283,-40
2554448183,2554448171,-12,700,263,-40
2555339781,2555339776,-5,903,1965,-40
2569091098,2569091103,5,2672,1907,-40
2573643955,2573643961,6,3683,1053,-40
2583102654,2583102663,9,2340,1063,-40
2584369457,2584369458,1,1266,2170,-40
2584693530,2584693546,16,969,4891,-40
2589324093,2589324100,7,3354,1427,-40
2590738738,2590738745,7,2084,1025,-40
2590951622,2590951604,-18,2152,855,-40
2592440518,2592440525,7,2707,1488,-40
2595367944,2595367949,5,2298,1717,-40
2595544750,2595544756,6,3755,1838,-40
2598670570,2598670575,5,1986,951,-40
2608905907,2608905914,7,3488,1230,-40
2612267661,2612267663,2,1348,1135,-40
2615238234,2615238234,0,1680,2328,-40
2617654463,2617654467,4,2610,995,-40
2623712964,2623712968,4,2574,1582,-40
2626874598,2626874604,6,1824,979,-40
2629086514,2629086521,7,2732,1175,-40
2630277122,2630277128,6,2622,1160,-40
2631536690,2631536697,7,3711,1301,-40
2632745775,2632745793,18,1084,310,-40
2636575473,2636575473,0,4169,6911,-40
2641530998,2641531003,5,3070,1003,-40
2646728133,2646728139,6,2129,1333,-40
2648468632,2648468639,7,2346,1073,-40
2648629904,2648629889,-15,3147,1174,-40
2658709671,2658709677,6,3380,1691,-40
2658830929,2658830944,15,726,229,-40
2660566566,2660566570,4,2132,1397,-40
2661242113,2661242118,5,1567,1170,-40
2663436802,2663436808,6,4617,1440,-40
2664311838,2664311846,8,2585,1466,-40
2664469566,2664469573,7,2959,1729,-40
2665633112,2665633118,6,2443,1003,-40
2671509896,2671509903,7,2273,930,-40
2676530856,2676530862,6,2887,1135,-40
2676808334,2676808320,-14,2407,1174,-40
2681250000,2681250000,0,19370,58600,-40
2685029099,2685029106,7,3389,1629,-40
2685211061,2685211052,-9,1165,355,-40
2688290656,2688290662,6,1963,974,-40
2691975818,2691975824,6,3782,1751,-40
2692799954,2692799958,4,2660,1342,-40
2694113094,2694113101,7,3402,1107,-40
2695291032,2695291039,7,2642,1111,-40
2699353282,2699353289,7,2666,1315,-40
2700894917,2700894922,5,3839,1413,-40
2702562681,2702562686,5,2673,1430,-40
2703379104,2703379111,7,3257,1385,-40
2708689861,2708689868,7,2635,1214,-40
2709668668,2709668674,6,2427,1507,-40
2711573136,2711573144,8,2377,989,-40
2713459044,2713459050,6,3258,2049,-40
2715348067,2715348062,-5,1493,2889,-40
2716852419,2716852426,7,3265,1235,-40
2719749731,2719749737,6,3354,1120,-40
2720017464,2720017470,6,4205,1358,-40
2720092815,2720092822,7,1465,828,-40
2722216117,2722216123,6,1925,566,-40
2722341296,2722341281,-15,2895,1487,-40
2722835194,2722835199,5,2470,1205,-40
2723375124,2723375131,7,1976,1219,-40
2723870621,2723870611,-10,848,151,-40
2725116154,2725116154,0,717,140,-40
2730964646,2730964650,4,2408,1239,-40
2731061110,2731061115,5,1570,1145,-40
2731306660,2731306666,6,2851,1345,-40
2731508213,2731508192,-21,2324,1516,-40
2731651858,2731651865,7,3425,1420,-40
2732424802,2732424808,6,3459,1377,-40
2733845942,2733845949,7,2633,1328,-40
2746504379,2746504386,7,3006,1513,-40
2747229629,2747229635,6,3786,1715,-40
2750961209,2750961214,5,3445,1607,-40
2751645381,2751645386,5,2030,1154,-40
2751869679,2751869686,7,3021,1193,-40
2759772790,2759772796,6,3268,1819,-40
2761995102,2761995109,7,1697,911,-40
2762581105,2762581120,15,15954,51553,-40
2764747683,2764747691,8,5701,1403,-40
2765097095,2765097099,4,2805,1059,-40
2770190667,2770190673,6,4165,1212,-40
2770965912,2770965900,-12,2755,1475,-40
2772873800,2772873808,8,4131,1721,-40
2773564139,2773564123,-16,902,354,-40
2774803068,2774803074,6,1797,1184,-40
2779052994,2779052993,-1,1145,2216,-40
2783069923,2783069918,-5,2053,6652,-40
2784662764,2784662769,5,2778,1376,-40
2785178856,2785178862,6,2695,1367,-40
2785526255,2785526256,1,915,154,-40
2787076368,2787076374,6,3767,1196,-40
2792511922,2792511930,8,1423,1141,-40
2797734765,2797734769,4,3716,1563,-40
2798906329,2798906337,8,3916,2053,-40
2799881933,2799881938,5,2705,1403,-40
2803038798,2803038803,5,2259,1005,-40
2804409341,2804409341,0,1069,1514,-40
2805199163,2805199171,8,2660,1090,-40
2806602498,2806602506,8,3400,1032,-40
2817179318,2817179325,7,2834,1117,-40
2820143277,2820143283,6,2769,1466,-40
2822739959,2822739966,7,3207,937,-40
2824834702,2824834707,5,3512,1825,-40
2828286589,2828286596,7,2556,1399,-40
2828592200,2828592188,-12,347,278,-40
2833757203,2833757210,7,2771,1472,-40
2834147477,2834147483,6,2928,1355,-40
2838288339,2838288343,4,2395,1667,-40
2838692910,2838692915,5,2664,1044,-40
2839629905,2839629910,5,3003,1300,-40
2839724174,2839724153,-21,1301,556,-40
2840596715,2840596721,6,3079,1713,-40
2842949313,2842949319,6,2104,1268,-40
2843333687,2843333694,7,3455,1639,-40
2846058501,2846058502,1,1954,1439,-40
2847856046,2847856027,-19,2199,552,-40
2850280574,2850280581,7,4264,1345,-40
2850433033,2850433050,17,1695,1226,-40
2851144293,2851144301,8,3089,1110,-40
2851361561,2851361569,8,3597,1799,-40
2856006131,2856006134,3,1627,1188,-40
2856145127,2856145134,7,3333,1203,-40
2859258632,2859258643,11,3500,1138,-40
2863497899,2863497893,-6,4509,16588,-40
2863624115,2863624121,6,2284,804,-40
2865121933,2865121939,6,2191,869,-40
2865536931,2865536929,-2,740,1842,-40
2871351888,2871351882,-6,1066,5393,-40
2873409203,2873409209,6,3564,1692,-40
2880123615,2880123621,6,3836,1438,-40
2882379741,2882379745,4,2485,1522,-40
2896052122,2896052128,6,2743,1079,-40
2898561116,2898561131,15,248,1990,-40
2900963575,2900963573,-2,832,2260,-40
2905162958,2905162963,5,3379,973,-40
2909291591,2909291597,6,3760,1341,-40
2909458633,2909458646,13,18675,31311,-40
2910442012,2910442019,7,1306,1116,-40
2910650819,2910650810,-9,707,2771,-40
2913285736,2913285743,7,1222,742,-40
2920029919,2920029926,7,2162,973,-40
2920355579,2920355585,6,2614,1343,-40
2924079318,2924079326,8,3984,1274,-40
2924283080,2924283087,7,9361,1144,-40
2925208954,2925208958,4,25744,20912,-40
2927166738,2927166745,7,2818,1468,-40
2927275665,2927275682,17,1456,680,-40
2935389853,2935389859,6,3408,1417,-40
2935656057,2935656040,-17,912,128,-40
2935985369,2935985374,5,3270,1835,-40
2937891974,2937891980,6,1865,1171,-40
2939099934,2939099938,4,3607,1609,-40
2943408207,2943408214,7,3390,1352,-40
2945535954,2945535961,7,4236,1636,-40
2945791414,2945791394,-20,2229,868,-40
2948421348,2948421355,7,2863,1341,-40
2948755934,2948755939,5,2692,1208,-40
2950985851,2950985858,7,2279,768,-40
2951071855,2951071860,5,4234,1576,-40
2951889689,2951889694,5,3793,1453,-40
2955826334,2955826339,5,2646,1538,-40
2958636451,2958636442,-9,1772,28065,-40
2962726081,2962726086,5,3604,1619,-40
2966867416,2966867422,6,3007,1590,-40
2967625604,2967625611,7,4289,1192,-40
2968042866,2968042871,5,2783,1319,-40
2968425575,2968425594,19,2214,1026,-40
2969238221,2969238226,5,2316,1960,-40
2969550649,2969550654,5,1904,1602,-40
2971244944,2971244950,6,4782,1133,-40
2976696782,2976696789,7,3490,1430,-40
2978404851,2978404857,6,2332,1055,-40
2980232506,2980232513,7,2038,1155,-40
2985431818,2985431822,4,1574,1025,-40
2989243665,2989243669,4,1954,1060,-40
2989627794,2989627784,-10,1421,588,-40
2998093777,2998093778,1,1616,1875,-40
3002558010,3002558015,5,3105,1084,-40
3003933265,3003933269,4,1896,1310,-40
3004871613,3004871594,-19,826,366,-40
3007061738,3007061742,4,2282,1420,-40
3008561502,3008561508,6,2948,1675,-40
3015826127,3015826134,7,2493,1524,-40
3015934980,3015934970,-10,838,264,-40
3022193995,3022194002,7,2363,976,-40
3022355928,3022355935,7,2809,1364,-40
3026393738,3026393745,7,2970,1178,-40
3027618517,3027618522,5,2857,1652,-40
3030349522,3030349518,-4,1779,1448,-40
3030817537,3030817543,6,2667,828,-40
3032863570,3032863577,7,3195,1136,-40
3034658384,3034658391,7,2683,1314,-40
3035054378,3035054363,-15,1679,1053,-40
3035874247,3035874254,7,3063,1319,-40
3036171260,3036171267,7,3009,1639,-40
3039987661,3039987666,5,3409,1161,-40
3040479030,3040479019,-11,1250,633,-40
3050949742,3050949749,7,3133,1229,-40
3053054423,3053054430,7,2334,864,-40
3055274750,3055274750,0,491,1038,-40
3057647762,3057647767,5,1999,1803,-40
3058275869,3058275875,6,3607,1604,-40
3058990014,3058990019,5,3048,1446,-40
3060012704,3060012710,6,4212,1483,-40
3063791549,3063791555,6,4005,1628,-40
3066549336,3066549342,6,2607,1987,-40
3072891919,3072891923,4,3227,1049,-40
3073826580,3073826600,20,757,338,-40
3091972095,3091972100,5,2958,1207,-40
3100969566,3100969571,5,1455,1385,-40
3111092130,3111092135,5,2488,1232,-40
3112660326,3112660332,6,3430,1755,-40
3115045053,3115045059,6,3149,1736,-40
3116112835,3116112841,6,3073,1454,-40
3118920950,3118920942,-8,914,5414,-40
3122057626,3122057631,5,2088,1335,-40
3128555867,3128555871,4,1902,1391,-40
3128833183,3128833187,4,1074,309,-40
3131840754,3131840763,9,3986,1350,-40
3132577508,3132577514,6,3295,1154,-40
3137429686,3137429689,3,1715,1661,-40
3137518539,3137518546,7,2895,1395,-40
3141317658,3141317664,6,986,766,-40
3151752689,3151752694,5,3082,1643,-40
3156120801,3156120808,7,2954,1293,-40
3164919231,3164919238,7,3042,1532,-40
3170535701,3170535706,5,2469,1260,-40
3173418661,3173418669,8,4064,1339,-40
3174983035,3174983040,5,2254,1035,-40
3175057130,3175057129,-1,947,257,-40
3180620166,3180620171,5,3177,1601,-40
3184719211,3184719210,-1,980,817,-40
3186887235,3186887239,4,2321,1333,-40
3188076987,3188076994,7,2737,1253,-40
3189662458,3189662463,5,2720,1209,-40
3192647549,3192647554,5,2775,1074,-40
3194648782,3194648787,5,997,1389,-40
3194797034,3194797027,-7,25451,13403,-40
3198640160,3198640166,6,3049,1231,-40
3216789494,3216789500,6,3410,1556,-40
3219101105,3219101111,6,3525,1636,-40
3221394089,3221394094,5,2035,1038,-40
3221588725,3221588705,-20,2508,985,-40
3224461799,3224461806,7,3458,1439,-40
3226640903,3226640911,8,2212,1203,-40
3227011565,3227011585,20,1048,240,-40
3229520520,3229520527,7,2175,1005,-40
3229860764,3229860769,5,2479,1386,-40
3231005502,3231005509,7,2472,1273,-40
3231143978,3231143960,-18,1592,502,-40
3237162369,3237162374,5,2462,1225,-40
3239090400,3239090407,7,2552,1475,-40
3239995006,3239995011,5,2265,983,-40
3240226117,3240226107,-10,3190,1285,-40
3242594616,3242594622,6,2739,1566,-40
3251057476,3251057482,6,3392,1315,-40
3254852706,3254852710,4,1651,1303,-40
3255174094,3255174099,5,2223,1223,-40
3256343437,3256343442,5,2704,1062,-40
3258890937,3258890943,6,2232,939,-40
3261636816,3261636822,6,2064,1111,-40
3268413199,3268413206,7,3448,1607,-40
3269267788,3269267768,-20,2666,1360,-40
3271161789,3271161795,6,2823,1013,-40
3272189320,3272189307,-13,2310,1104,-40
3274884162,3274884166,4,3192,1063,-40
3277898989,3277898995,6,2141,1355,-40
3280784454,3280784459,5,1428,643,-40
3282686441,3282686436,-5,1229,106,-40
3293508090,3293508081,-9,2348,9029,-40
3293562527,3293562534,7,3411,1325,-40
3297053077,3297053082,5,4323,2293,-40
3299119478,3299119483,5,2186,1220,-40
3303070997,3303071004,7,3210,1257,-40
3309123949,3309123957,8,2194,740,-40
3309839375,3309839379,4,2294,1009,-40
3315298688,3315298695,7,2483,1111,-40
3315923693,3315923700,7,3079,1443,-40
3316886877,3316886882,5,2483,1150,-40
3321197782,3321197791,9,3538,1326,-40
3321582150,3321582157,7,3742,1221,-40
3331222313,3331222319,6,3061,1078,-40
3331572553,3331572559,6,2005,867,-40
3331873105,3331873112,7,3441,1908,-40
3333906766,3333906763,-3,1251,1676,-40
3337664083,3337664089,6,2968,1625,-40
3345082774,3345082781,7,2623,1420,-40
3347063306,3347063313,7,4888,1617,-40
3353233911,3353233919,8,1636,637,-40
3353319011,3353318995,-16,913,476,-40
3355125394,3355125399,5,3869,1247,-40
3356501504,3356501510,6,2164,1085,-40
3362722465,3362722471,6,2876,910,-40
3364322090,3364322097,7,3052,1119,-40
3365343393,3365343397,4,2318,1103,-40
3368352524,3368352527,3,1532,788,-40
3369465378,3369465385,7,4110,1771,-40
3369800588,3369800594,6,1888,945,-40
3375259322,3375259326,4,2361,1319,-40
3376190150,3376190157,7,2425,1655,-40
3380605412,3380605418,6,2840,1251,-40
3382548413,3382548418,5,3248,1280,-40
3385700329,3385700346,17,688,258,-40
3386390899,3386390903,4,3045,1545,-40
3388154173,3388154179,6,2665,1297,-40
3388943694,3388943708,14,964,154,-40
3392611115,3392611122,7,3375,1346,-40
3393313538,3393313530,-8,1373,78,-40
3395934987,3395934994,7,3817,1283,-40
3396796458,3396796463,5,1951,1132,-40
3397670054,3397670058,4,2107,2061,-40
3401344888,3401344894,6,2352,1466,-40
3403776110,3403776117,7,1654,959,-40
3404768586,3404768594,8,3454,1377,-40
3406038893,3406038898,5,1575,1344,-40
3406737958,3406737946,-12,1179,351,-40
3407271363,3407271369,6,1393,1158,-40
3409188394,3409188400,6,3471,1077,-40
3413787000,3413787006,6,2774,1432,-40
3418515987,3418515995,8,3889,1419,-40
3419448436,3419448442,6,3249,1263,-40
3419594911,3419594918,7,2675,876,-40
3422408192,3422408211,19,300,1147,-40
3424384579,3424384585,6,2638,1453,-40
3426954035,3426954041,6,2766,1534,-40
3429356706,3429356712,6,2309,1102,-40
3430020324,3430020335,11,14650,28189,-40
3431400157,3431400163,6,2940,1315,-40
3436092413,3436092422,9,1593,861,-40
3438081947,3438081955,8,2117,1037,-40
3443792220,3443792227,7,3057,1628,-40
3445402230,3445402235,5,3138,1329,-40
3451602284,3451602287,3,1208,1041,-40
3452070337,3452070338,1,223,2418,-40
3465286463,3465286469,6,3767,1400,-40
3467747534,3467747527,-7,1505,7883,-40
3473305774,3473305757,-17,1592,392,-40
3475654038,3475654044,6,3591,1391,-40
3475815231,3475815251,20,1172,275,-40
3478191681,3478191686,5,2406,1197,-40
3481478082,3481478088,6,3211,1794,-40
3484088734,3484088741,7,2392,1152,-40
3493890731,3493890723,-8,866,202,-40
3501250002,3501249995,-7,1894,9285,-40
3502232812,3502232812,0,1363,2101,-40
3507497803,3507497810,7,3440,1342,-40
3520369542,3520369548,6,3060,1676,-40
3524589408,3524589414,6,2730,1048,-40
3526291135,3526291137,2,7338,25662,-40
3528617121,3528617129,8,3181,1271,-40
3532649291,3532649296,5,997,1447,-40
3536591540,3536591546,6,3098,1510,-40
3537311325,3537311331,6,2153,982,-40
3540518924,3540518930,6,2231,1091,-40
3542018228,3542018235,7,2469,1162,-40
3542497250,3542497254,4,2701,1002,-40
3544572316,3544572323,7,2433,1622,-40
3548522017,3548522025,8,3482,1418,-40
3549625457,3549625465,8,5734,1092,-40
3554303435,3554303441,6,2765,1423,-40
3555409317,3555409323,6,3342,1608,-40
3556549934,3556549942,8,3079,1223,-40
3560983471,3560983477,6,2073,838,-40
3561543286,3561543293,7,3304,1212,-40
3566832787,3566832794,7,2156,1175,-40
3567728487,3567728493,6,3603,1383,-40
3571811239,3571811246,7,2902,1084,-40
3574857369,3574857376,7,1989,857,-40
3577358285,3577358291,6,3519,1431,-40
3579895051,3579895031,-20,755,319,-40
3582218154,3582218159,5,1726,1475,-40
3586224178,3586224184,6,2183,893,-40
3587050966,3587050972,6,3091,1500,-40
3592023806,3592023814,8,3132,954,-40
3593075331,3593075335,4,2543,1314,-40
3593823256,3593823262,6,2220,1277,-40
3600503855,3600503862,7,2700,1260,-40
3604940126,3604940135,9,3129,1418,-40
3605397518,3605397497,-21,2272,914,-40
3607255565,3607255570,5,3841,1356,-40
3617665133,3617665138,5,2070,1760,-40
3620215983,3620215989,6,1448,1019,-40
3631086877,3631086886,9,18110,30994,-40
3631956813,3631956819,6,3730,952,-40
3632537389,3632537395,6,3308,1573,-40
3635314953,3635314959,6,2931,1671,-40
3636294150,3636294132,-18,2907,1350,-40
3636401906,3636401914,8,2918,1457,-40
3642891374,3642891383,9,2624,1067,-40
3643618685,3643618691,6,6543,2355,-40
3644420640,3644420646,6,2321,1388,-40
3649662238,3649662246,8,2839,1030,-40
3649722999,3649722987,-12,2666,801,-40
3653234954,3653234959,5,1883,871,-40
3654777817,3654777817,0,1484,1461,-40
3659853625,3659853633,8,3288,1467,-40
3660386033,3660386039,6,3728,1173,-40
3662489966,3662489974,8,2469,1353,-40
3664125095,3664125102,7,2428,1024,-40
3664681014,3664681017,3,2527,1864,-40
3664832286,3664832286,0,885,897,-40
3679563988,3679563994,6,2892,1249,-40
3681967419,3681967425,6,1972,869,-40
3682603758,3682603760,2,1882,2218,-40
3683934310,3683934294,-16,2772,1216,-40
3684824477,3684824484,7,4252,1582,-40
3685441954,3685441961,7,2951,1490,-40
3685764538,3685764542,4,2196,1224,-40
3686594100,3686594106,6,2281,1194,-40
3686739925,3686739930,5,2676,1313,-40
3686879477,3686879489,12,3418,1099,-40
3687045622,3687045628,6,2061,1159,-40
3688557574,3688557579,5,2113,1047,-40
3691669221,3691669226,5,2599,1318,-40
3692539873,3692539878,5,3130,1605,-40
3693691139,3693691147,8,2880,1471,-40
3695091073,3695091080,7,2501,1309,-40
3698125565,3698125571,6,3752,1361,-40
3702827337,3702827342,5,1318,1139,-40
3704634825,3704634829,4,3258,1413,-40
3714257370,3714257378,8,3188,1546,-40
3719413979,3719413986,7,3338,947,-40
3723547190,3723547174,-16,1748,573,-40
3725130146,3725130156,10,1982,580,-40
3728352258,3728352265,7,4169,1604,-40
3730813697,3730813703,6,2067,1130,-40
3731762569,3731762585,16,1244,328,-40
3734458269,3734458271,2,2900,1790,-40
3734857609,3734857604,-5,2366,5969,-40
3735066397,3735066399,2,1698,1445,-40
3736757094,3736757100,6,2796,1614,-40
3737007313,3737007320,7,2935,839,-40
3739001492,3739001497,5,2101,1497,-40
3742951971,3742951978,7,2435,1503,-40
3743028780,3743028801,21,3932,1297,-40
3744944927,3744944925,-2,743,2509,-40
3749021806,3749021813,7,3147,1167,-40
3752390548,3752390555,7,3156,1323,-40
3755943321,3755943328,7,14733,22250,-40
3757336579,3757336589,10,2236,967,-40
3757884819,3757884817,-2,1398,1914,-40
3764448122,3764448129,7,3486,1233,-40
3773773861,3773773866,5,3059,1304,-40
3774039291,3774039293,2,1497,1409,-40
3775351122,3775351127,5,2304,1074,-40
3786959159,3786959166,7,971,736,-40
3791340117,3791340122,5,2340,1178,-40
3793876455,3793876462,7,3070,1523,-40
3794284227,3794284230,3,2298,1281,-40
3794797870,3794797850,-20,1410,1536,-40
3796694773,3796694779,6,2620,1459,-40
3803018918,3803018923,5,1703,458,-40
3803068931,3803068913,-18,2858,1256,-40
3803613555,3803613559,4,2155,1439,-40
3810534936,3810534941,5,3440,1473,-40
3811428826,3811428832,6,3363,1229,-40
3814274138,3814274144,6,2760,1030,-40
3817214665,3817214671,6,2643,1153,-40
3818354749,3818354755,6,2000,830,-40
3820210470,3820210464,-6,2759,45171,-40
3823434406,3823434412,6,3541,1415,-40
3830100709,3830100696,-13,1107,600,-40
3831506774,3831506782,8,2803,1149,-40
3832138769,3832138776,7,1421,971,-40
3841396534,3841396540,6,3532,1301,-40
3849945191,3849945197,6,3174,1069,-40
3851041033,3851041033,0,2101,1495,-40
3858318618,3858318618,0,1516,1683,-40
3860431057,3860431060,3,1490,1135,-40
3861128854,3861128859,5,2184,844,-40
3863121494,3863121502,8,10057,28490,-40
3863972877,3863972883,6,3861,1100,-40
3864275449,3864275454,5,2150,1220,-40
3864320337,3864320354,17,804,376,-40
3866962234,3866962239,5,2454,1933,-40
3867432375,3867432381,6,2748,1492,-40
3867725721,3867725730,9,753,154,-40
3874756965,3874756970,5,2326,1118,-40
3875217985,3875217989,4,2633,1250,-40
3877797510,3877797515,5,2734,1091,-40
3894127241,3894127246,5,3271,1744,-40
3895088385,3895088392,7,2990,1213,-40
3898906970,3898906975,5,1499,1049,-40
3899442126,3899442131,5,3149,1604,-40
3900187126,3900187135,9,2382,1126,-40
3901849830,3901849808,-22,1214,2119,-40
3905531614,3905531619,5,2542,1140,-40
3905796983,3905796990,7,3689,1553,-40
3908494604,3908494610,6,2868,1186,-40
3912322238,3912322242,4,2111,842,-40
3913099882,3913099866,-16,979,347,-40
3920366300,3920366306,6,2530,1099,-40
3921672711,3921672707,-4,1035,3674,-40
3937773766,3937773773,7,3935,1397,-40
3953319230,3953319237,7,2873,1393,-40
3955151404,3955151409,5,2758,1029,-40
3955524392,3955524398,6,2356,1475,-40
3959642327,3959642333,6,2971,1464,-40
3960441847,3960441853,6,2383,1747,-40
3969187873,3969187879,6,1722,1071,-40
3969280453,3969280459,6,3095,1327,-40
3972003098,3972003094,-4,1302,2473,-40
3974679326,3974679344,18,830,180,-40
3976920770,3976920776,6,1954,1091,-40
3977925125,3977925107,-18,1310,574,-40
3979664733,3979664739,6,2381,1382,-40
3984192190,3984192197,7,3126,1256,-40
3986572868,3986572875,7,2635,1308,-40
3988807403,3988807409,6,2098,877,-40
4003057412,4003057400,-12,3038,1190,-40
4010327489,4010327495,6,2788,1093,-40
4012160981,4012160986,5,3603,1672,-40
4012656390,4012656380,-10,3440,1531,-40
4018107712,4018107719,7,3985,1376,-40
4018473517,4018473496,-21,2186,728,-40
4018580049,4018580047,-2,1410,1889,-40
4019066843,4019066843,0,3463,4225,-40
4019306066,4019306080,14,40291,16371,-40
4019606294,4019606300,6,2602,1452,-40
4019683307,4019683302,-5,15563,55604,-40
4020316275,4020316281,6,2577,1011,-40
4020736645,4020736651,6,1456,865,-40
4024514037,4024514042,5,1483,1057,-40
4025670983,4025670989,6,3227,1445,-40
4028361294,4028361299,5,1381,876,-40
4028529990,4028529995,5,910,253,-40
4030704374,4030704381,7,3641,1594,-40
4031363910,4031363917,7,3200,1368,-40
4034170919,4034170926,7,2767,1404,-40
4034890184,4034890191,7,4146,1231,-40
4037087030,4037087038,8,2276,983,-40
4040808835,4040808841,6,2915,1348,-40
4041937287,4041937298,11,430,118,-40
4044193358,4044193363,5,3747,1506,-40
4045670252,4045670257,5,3276,1094,-40
4046467913,4046467897,-16,2692,1386,-40
4047410213,4047410219,6,2438,1004,-40
4049050826,4049050831,5,2902,1505,-40
4053474433,4053474438,5,2759,1448,-40
4059540726,4059540731,5,2129,1665,-40
4061879666,4061879670,4,1896,1090,-40
4062584756,4062584762,6,2259,1024,-40
4065234957,4065234961,4,1984,1238,-40
4068725002,4068725011,9,4415,1261,-40
4075838170,4075838151,-19,503,174,-40
4077512661,4077512666,5,4241,2057,-40
4078745850,4078745857,7,3282,1218,-40
4079469810,4079469817,7,2974,1032,-40
4081564068,4081564070,2,907,1105,-40
4090143263,4090143270,7,2848,1165,-40
4092779361,4092779366,5,2262,585,-40
4093431089,4093431090,1,1411,1472,-40
4094198385,4094198391,6,3961,1088,-40
4098294070,4098294059,-11,1357,436,-40
4103725778,4103725784,6,3296,1441,-40
4104751329,4104751335,6,3175,1367,-40
4105420324,4105420330,6,3024,1757,-40
4106704968,4106704971,3,2117,1419,-40
4107628740,4107628746,6,2565,1355,-40
4116510035,4116510042,7,5511,2225,-40
4120276103,4120276081,-22,2937,1138,-40
4120838011,4120838017,6,2562,1730,-40
4121631361,4121631366,5,2658,1452,-40
4124286770,4124286777,7,3185,1213,-40
4132947733,4132947739,6,1918,1050,-40
4133823810,4133823817,7,3435,1095,-40
4137648887,4137648894,7,3385,1119,-40
4138940059,4138940066,7,3512,1485,-40
4139233605,4139233611,6,3399,1686,-40
4140548215,4140548222,7,1714,1074,-40
4143971413,4143971419,6,2428,943,-40
4152201392,4152201394,2,1477,1270,-40
4156283488,4156283495,7,3119,1614,-40
4156665326,4156665331,5,4178,1782,-40
4165004118,4165004125,7,2872,1085,-40
4169402519,4169402519,0,1497,1065,-40
4173703094,4173703098,4,926,1405,-40
4174361033,4174361041,8,3580,1488,-40
4174755356,4174755336,-20,2339,574,-40
4180096463,4180096470,7,2787,1481,-40
4180147538,4180147538,0,1310,1768,-40
4180233758,4180233763,5,2111,1280,-40
4187480865,4187480870,5,2568,1498,-40
4187893253,4187893258,5,1390,766,-40
4190150769,4190150776,7,1829,1317,-40
4200025497,4200025502,5,1576,861,-40
4201662150,4201662157,7,3480,1685,-40
4202146173,4202146180,7,2692,1100,-40
4202533702,4202533709,7,2152,1151,-40
4202896210,4202896217,7,2713,1171,-40
4206512825,4206512830,5,1958,989,-40
4208656844,4208656850,6,2605,1558,-40
4208985062,4208985067,5,3127,1279,-40
4220009822,4220009823,1,1654,2368,-40
4224435996,4224436002,6,3007,1281,-40
4230870614,4230870614,0,985,1686,-40
4234215979,4234215984,5,3647,1450,-40
4237558745,4237558750,5,1901,1025,-40
4238821549,4238821554,5,2581,1532,-40
4239414831,4239414808,-23,2101,627,-40
4245298254,4245298250,-4,886,1433,-40
4247184929,4247184937,8,3844,1575,-40
4247290774,4247290756,-18,2542,1209,-40
4247959568,4247959578,10,981,287,-40
4251991290,4251991294,4,3119,1263,-40
4255386761,4255386767,6,2243,1267,-40
4256263207,4256263213,6,3665,1410,-40
4256601275,4256601281,6,1808,1127,-40
4256654175,4256654152,-23,3555,1446,-40
4257886273,4257886279,6,3342,1106,-40
4267409731,4267409738,7,3119,1241,-40
4270260090,4270260087,-3,743,1144,-40
4271591867,4271591874,7,3509,1156,-40
4272515441,4272515437,-4,1178,3030,-40
4275168570,4275168577,7,3031,1168,-40
4275347951,4275347932,-19,1166,450,-40
4275813373,4275813379,6,3451,1415,-40
4277416149,4277416155,6,2219,981,-40
4281765880,4281765887,7,2423,778,-40
4282684886,4282684893,7,3426,1457,-40
4284825922,4284825930,8,4258,1616,-40
4285805110,4285805116,6,2618,1093,-40
4286539643,4286539650,7,2784,1217,-40
4288357030,4288357051,21,1597,647,-40
4288443429,4288443427,-2,957,310,-40
4290813989,4290813997,8,4436,1223,-40
4295159929,4295159935,6,3941,1310,-40
4295624853,4295624858,5,3123,1530,-40
4297285449,4297285456,7,3427,1173,-40
4300275996,4300276001,5,3590,2011,-40
4310219657,4310219662,5,2498,1483,-40
4312025394,4312025403,9,2473,610,-40
4319168850,4319168855,5,1748,1330,-40
4325891190,4325891197,7,2658,1439,-40
4326551289,4326551295,6,3492,1576,-40
4327517800,4327517806,6,3226,1101,-40
4330072249,4330072254,5,2100,1222,-40
4330497034,4330497039,5,2660,1200,-40
4340062790,4340062795,5,2376,1353,-40
4348732674,4348732679,5,2307,1322,-40
4353717904,4353717911,7,1424,654,-40
4356950669,4356950675,6,3133,1125,-40
4359812407,4359812411,4,1598,1583,-40
4359856559,4359856567,8,3326,946,-40
4364034796,4364034801,5,1678,1523,-40
4367321201,4367321207,6,1860,802,-40
4370278153,4370278160,7,2636,1262,-40
4375957709,4375957714,5,3086,1300,-40
4380072634,4380072639,5,4840,3100,-40
4381301397,4381301403,6,2679,1230,-40
4381873700,4381873682,-18,1332,568,-40
4382348095,4382348102,7,3178,1522,-40
4384733873,4384733879,6,2967,1204,-40
4386022686,4386022689,3,1885,1169,-40
4393688062,4393688066,4,2934,1096,-40
4395926637,4395926618,-19,1159,566,-40
4396684672,4396684679,7,3696,1392,-40
4399405452,4399405458,6,2779,1559,-40
4402878358,4402878364,6,2542,1275,-40
4407390782,4407390790,8,3827,1663,-40
4422712114,4422712120,6,3038,1535,-40
4424713659,4424713664,5,1610,1314,-40
4426704197,4426704203,6,3017,911,-40
4427590447,4427590455,8,3046,985,-40
4427621502,4427621481,-21,3742,1209,-40
4429869732,4429869738,6,3033,1723,-40
4430763159,4430763158,-1,665,1119,-40
4432279738,4432279740,2,9426,8304,-40
4434499903,4434499907,4,2761,1842,-40
4436823041,4436823049,8,3803,1613,-40
4440822618,4440822608,-10,768,412,-40
4441445156,4441445159,3,3339,1968,-40
4444924766,4444924773,7,3182,1617,-40
4446900434,4446900442,8,1031,733,-40
4447856127,4447856134,7,4635,1244,-40
4448266591,4448266603,12,815,147,-40
4448693522,4448693516,-6,884,3718,-40
4454022610,4454022615,5,3256,1398,-40
4454690861,4454690843,-18,3263,1290,-40
4459515802,4459515810,8,3913,1494,-40
4460181423,4460181404,-19,801,365,-40
4461361618,4461361627,9,1536,961,-40
4464492892,4464492898,6,2240,949,-40
4475104584,4475104591,7,2215,1051,-40
4475203357,4475203363,6,1262,771,-40
4477497445,4477497453,8,4476,2114,-40
4484809471,4484809487,16,917,2683,-40
4486694754,4486694758,4,2212,1543,-40
4488570870,4488570868,-2,9413,13922,-40
4491736012,4491736006,-6,37207,11008,-40
4494069798,4494069794,-4,2555,41966,-40
4495719918,4495719923,5,1773,1266,-40
4500424141,4500424146,5,3005,2273,-40
4502636793,4502636789,-4,1371,3927,-40
4504073090,4504073096,6,3654,1245,-40
4511624986,4511624982,-4,2306,4881,-40
4515650762,4515650769,7,3860,1288,-40
4518222757,4518222758,1,809,944,-40
4523588556,4523588562,6,2159,1413,-40
4525952939,4525952945,6,2669,1356,-40
4529726071,4529726078,7,3289,1038,-40
4529866418,4529866402,-16,1235,389,-40
4533400698,4533400697,-1,3094,4137,-40
4535961007,4535961015,8,2939,1254,-40
4536039219,4536039225,6,1198,251,-40
4537398376,4537398379,3,2263,1249,-40
4542080959,4542080966,7,4434,1644,-40
4542616224,4542616227,3,2244,1617,-40
4543601690,4543601697,7,3162,1606,-40
4544167444,4544167449,5,3970,1515,-40
4549300574,4549300577,3,3078,2831,-40
4549732333,4549732341,8,2802,1582,-40
4552218578,4552218582,4,2217,1015,-40
4556300594,4556300602,8,3499,1499,-40
4556483796,4556483802,6,3099,1825,-40
4556924075,4556924081,6,2273,1391,-40
4566290573,4566290581,8,2678,1127,-40
4567211686,4567211690,4,3263,1035,-40
4569157013,4569157019,6,2612,1292,-40
4570766890,4570766895,5,835,762,-40
4571391741,4571391730,-11,873,266,-40
4573208881,4573208887,6,2961,1167,-40
4573304849,4573304859,10,2723,1268,-40
4574555851,4574555857,6,3862,1593,-40
4574895149,4574895155,6,2983,1271,-40
4577712454,4577712436,-18,2825,1123,-40
4577809709,4577809714,5,2895,1003,-40
4578341326,4578341334,8,1147,422,-40
4578852734,4578852739,5,2059,1078,-40
4579623099,4579623114,15,3559,2041,-40
4586878169,4586878174,5,3386,1386,-40
4594452086,4594452090,4,3410,1287,-40
4595050086,4595050093,7,3021,1271,-40
4595502422,4595502430,8,3082,1588,-40
4596344237,4596344242,5,2387,1390,-40
4599029847,4599029854,7,2774,1720,-40
4603370226,4603370231,5,2562,1092,-40
4603800114,4603800121,7,3353,1610,-40
4607105319,4607105326,7,3372,1635,-40
4608616654,4608616659,5,2933,1450,-40
4608724774,4608724779,5,2233,1752,-40
4609394002,4609394008,6,3271,1435,-40
4610181618,4610181627,9,2590,1176,-40
4610827550,4610827538,-12,1670,797,-40
4611218597,4611218603,6,2342,1237,-40
4611644770,4611644778,8,4065,1646,-40
4613000672,4613000680,8,35008,10202,-40
4613298793,4613298798,5,1400,1085,-40
4615508501,4615508507,6,2933,1293,-40
4618897555,4618897559,4,2441,1145,-40
4619228703,4619228684,-19,2016,745,-40
4619588005,4619588011,6,2759,931,-40
4622061606,4622061611,5,2853,890,-40
4622900714,4622900719,5,2410,1042,-40
4626881994,4626881994,0,1329,1954,-40
4627987075,4627987080,5,3085,1004,-40
4635839634,4635839641,7,3149,1785,-40
4637875265,4637875270,5,1616,955,-40
4639450529,4639450533,4,2178,1117,-40
4640073700,4640073706,6,3441,1394,-40
4640597223,4640597219,-4,608,83,-40
4640737397,4640737402,5,1204,1260,-40
4641730341,4641730348,7,2066,1025,-40
4643466182,4643466190,8,3076,1140,-40
4645176850,4645176855,5,3256,1495,-40
4645414740,4645414747,7,2731,1320,-40
4646520655,4646520664,9,1092,1116,-40
4647540689,4647540690,1,1431,1509,-40
4659921662,4659921668,6,2638,1748,-40
4660055555,4660055562,7,3849,1469,-40
4665080986,4665080994,8,2867,1876,-40
4668742679,4668742686,7,2597,956,-40
4671336570,4671336574,4,1738,1427,-40
4672393741,4672393747,6,3192,1319,-40
4675555064,4675555070,6,2815,1322,-40
4676550655,4676550651,-4,1056,2861,-40
4678457368,4678457374,6,4068,1543,-40
4680544006,4680544011,5,3176,1614,-40
4680722588,4680722594,6,1721,738,-40
4681140634,4681140649,15,2246,986,-40
4682265957,4682265936,-21,1876,1020,-40
4682649029,4682649037,8,3756,1440,-40
4683268083,4683268086,3,1363,933,-40
4684413049,4684413054,5,1913,1247,-40
4685705214,4685705221,7,2939,1102,-40
4685912420,4685912425,5,2929,2439,-40
4686361882,4686361890,8,3686,1489,-40
4686490575,4686490554,-21,2175,600,-40
4687560979,4687560973,-6,31113,4988,-40
4688348488,4688348495,7,2216,1212,-40
4689419749,4689419766,17,14733,42758,-40
4689800159,4689800162,3,1527,1173,-40
4690753226,4690753234,8,3070,1079,-40
4690918661,4690918667,6,1008,160,-40
4696262667,4696262666,-1,1681,2184,-40
4698679071,4698679067,-4,1482,3546,-40
4700128890,4700128898,8,3603,1133,-40
4700283323,4700283329,6,13106,22976,-40
4704728752,4704728756,4,2406,1466,-40
4707016548,4707016554,6,2188,1300,-40
4707562637,4707562644,7,3347,1279,-40
4708664767,4708664774,7,3890,1518,-40
4710525794,4710525801,7,4406,1297,-40
4711942666,4711942666,0,1554,2208,-40
4716140847,4716140853,6,3120,1243,-40
4716363706,4716363688,-18,1415,418,-40
4717525122,4717525126,4,43603,2675,-40
4717631155,4717631162,7,3063,1070,-40
4717948749,4717948755,6,2873,1480,-40
4721723804,4721723810,6,2416,1206,-40
4722554650,4722554664,14,1294,270,-40
4723349720,4723349727,7,3609,1474,-40
4728222301,4728222306,5,3431,1544,-40
4729665882,4729665889,7,3362,1323,-40
4733373305,4733373309,4,1993,1162,-40
4733559273,4733559281,8,1273,85,-40
4734426625,4734426635,10,1706,715,-40
4745462380,4745462386,6,3552,1846,-40
4746701834,4746701841,7,2016,1363,-40
4751963353,4751963358,5,3523,1797,-40
4758779267,4758779273,6,3736,1515,-40
4759635529,4759635537,8,3127,1915,-40
4760980374,4760980379,5,3821,1430,-40
4762337182,4762337188,6,3610,1537,-40
4764847693,4764847697,4,3654,1277,-40
4776127205,4776127211,6,3404,1676,-40
4780153517,4780153511,-6,875,1520,-40
4780902250,4780902267,17,3010,1715,-40
4785203770,4785203777,7,3031,1313,-40
4787170055,4787170062,7,4215,1848,-40
4788438647,4788438625,-22,2869,1238,-40
4790841730,4790841737,7,3317,1792,-40
4794081632,4794081634,2,1645,1951,-40
4796092030,4796092035,5,2371,785,-40
4796231973,4796231977,4,2583,868,-40
4803953239,4803953242,3,2758,1228,-40
4805369647,4805369654,7,5577,27931,-40
4805952625,4805952630,5,3789,1455,-40
4807532872,4807532878,6,2451,1233,-40
4808273199,4808273205,6,3445,1351,-40
4808487464,4808487451,-13,1112,474,-40
4808598418,4808598433,15,1941,8966,-40
4809862712,4809862726,14,372,5059,-40
4811498989,4811498994,5,3318,1241,-40
4811744461,4811744466,5,3229,1306,-40
4812245851,4812245858,7,2439,659,-40
4814405694,4814405699,5,1982,1372,-40
4814776158,4814776140,-18,1240,362,-40
4815969178,4815969185,7,2758,1372,-40
4816760191,4816760198,7,2936,1240,-40
4817451458,4817451463,5,3347,1062,-40
4819349842,4819349850,8,2484,958,-40
4819616483,4819616490,7,2475,1225,-40
4821169141,4821169147,6,3053,1191,-40
4821483038,4821483043,5,2870,1405,-40
4822447966,4822447970,4,2911,1677,-40
4826599558,4826599564,6,2477,1353,-40
4829725513,4829725518,5,1088,1079,-40
4833537655,4833537661,6,3047,1085,-40
4834568985,4834568988,3,37629,35650,-40
4834898345,4834898350,5,3992,1402,-40
4837843606,4837843614,8,3210,1348,-40
4838062466,4838062470,4,1513,921,-40
4838335448,4838335454,6,2828,1110,-40
4840773142,4840773147,5,3317,2075,-40
4842859226,4842859232,6,3526,1321,-40
4848317905,4848317911,6,2248,1336,-40
4852349330,4852349336,6,2295,969,-40
4853045079,4853045085,6,1622,1269,-40
4853216334,4853216324,-10,493,472,-40
4856922494,4856922499,5,2391,1041,-40
4860395594,4860395599,5,2086,886,-40
4860792553,4860792559,6,2302,1151,-40
4861159071,4861159077,6,2588,1406,-40
4865010766,4865010773,7,3037,1186,-40
4870154339,4870154344,5,1969,1333,-40
4872115493,4872115499,6,2975,1384,-40
4872364139,4872364145,6,2673,1133,-40
4877046840,4877046845,5,2310,2024,-40
4877582458,4877582467,9,2363,916,-40
4881153118,4881153115,-3,1784,4217,-40
4891832965,4891832971,6,3427,2532,-40
4894696587,4894696581,-6,859,2902,-40
4897543069,4897543070,1,2095,2153,-40
4899759321,4899759328,7,2819,1562,-40
4901493890,4901493898,8,4038,1142,-40
4904575433,4904575438,5,2552,1147,-40
4904720961,4904720947,-14,1844,798,-40
4905220446,4905220453,7,1936,947,-40
4906099724,4906099730,6,2606,1289,-40
4908359517,4908359523,6,3169,1553,-40
4908540446,4908540451,5,3670,1417,-40
4908916570,4908916552,-18,2073,1081,-40
4912373225,4912373231,6,2815,1263,-40
4913889786,4913889794,8,2012,1156,-40
4914324119,4914324126,7,3343,1719,-40
4915697843,4915697843,0,756,1439,-40
4916430526,4916430531,5,2545,1115,-40
4918227298,4918227291,-7,1555,7731,-40
4920101104,4920101110,6,3496,1471,-40
4924472923,4924472931,8,3075,1697,-40
4927123955,4927123962,7,2067,654,-40
4927733266,4927733252,-14,1148,27598,-40
4928158365,4928158373,8,3407,1529,-40
4928706307,4928706314,7,1090,313,-40
4928851262,4928851268,6,2837,1092,-40
4931280337,4931280343,6,2860,1329,-40
4932378039,4932378025,-14,1065,334,-40
4934350000,4934350007,7,4115,1670,-40
4937917759,4937917764,5,2648,1688,-40
4940499937,4940499942,5,2097,832,-40
4945228094,4945228101,7,3001,1576,-40
4947057611,4947057617,6,3644,1744,-40
4949819112,4949819114,2,1482,1394,-40
4954868270,4954868277,7,2869,1142,-40
4955520248,4955520234,-14,2859,1009,-40
4957615580,4957615586,6,2804,1239,-40
4959850492,4959850490,-2,855,2543,-40
4962642402,4962642407,5,2778,1052,-40
4963826506,4963826492,-14,1370,710,-40
4965659461,4965659466,5,2881,1276,-40
4969663863,4969663869,6,4593,1363,-40
4969743333,4969743338,5,2739,1340,-40
4969997877,4969997883,6,3852,1607,-40
4970336352,4970336358,6,2221,1086,-40
4971313018,4971313024,6,3988,1183,-40
4975101205,4975101211,6,1953,1154,-40
4975382389,4975382371,-18,2160,1086,-40
4975421272,4975421278,6,3690,1602,-40
4975666233,4975666243,10,1002,217,-40
4977204697,4977204702,5,1849,1507,-40
4977392496,4977392476,-20,1302,2011,-40
4978150126,4978150131,5,3192,1545,-40
4978344386,4978344390,4,1665,1203,-40
4978724999,4978725005,6,3364,1374,-40
4979547141,4979547146,5,2908,1042,-40
4983293574,4983293578,4,1527,787,-40
4983379721,4983379715,-6,1226,285,-40
4984174725,4984174731,6,3936,1345,-40
4989007961,4989007966,5,2407,712,-40
4989702779,4989702786,7,1409,696,-40
4990198565,4990198571,6,2716,1279,-40
4991507609,4991507615,6,4188,1353,-40
4994319918,4994319923,5,2469,980,-40
5000172769,5000172774,5,2012,1059,-40
5000301055,5000301057,2,1214,1320,-40
5001071969,5001071971,2,1496,1617,-40
5009771868,5009771874,6,3005,1766,-40
5013524546,5013524542,-4,941,2579,-40
5016501109,5016501114,5,3145,1516,-40
5017202861,5017202869,8,2825,858,-40
5020620026,5020620033,7,2185,907,-40
5023089450,5023089450,0,3368,3697,-40
5026085166,5026085173,7,2916,1236,-40
5027504607,5027504615,8,2124,1297,-40
5029276585,5029276593,8,3243,1234,-40
5031870474,5031870479,5,2974,1736,-40
5036583666,5036583671,5,2359,1107,-40
5040334842,5040334850,8,2024,1053,-40
5041352324,5041352329,5,2310,832,-40
5041841581,5041841587,6,3422,1682,-40
5043809374,5043809379,5,2263,1049,-40
5043895237,5043895227,-10,537,518,-40
5048395846,5048395851,5,2161,1272,-40
5050132743,5050132750,7,3766,1558,-40
5052189728,5052189734,6,3983,1832,-40
5055068993,5055068998,5,2758,1345,-40
5055105638,5055105646,8,2906,1358,-40
5057934276,5057934282,6,2486,1945,-40
5058285967,5058285974,7,3727,1791,-40
5058645855,5058645862,7,5005,1392,-40
5058921987,5058921979,-8,1094,310,-40
5059108871,5059108878,7,3165,1962,-40
5060651724,5060651730,6,3057,1422,-40
5061183162,5061183167,5,3596,2623,-40
5069653941,5069653946,5,3154,1261,-40
5069751181,5069751170,-11,581,30,-40
5070849774,5070849755,-19,3853,1808,-40
5074511545,5074511551,6,2058,999,-40
5075889471,5075889478,7,3099,1038,-40
5076740963,5076740970,7,2701,1010,-40
5084484570,5084484576,6,2993,1391,-40
5086088736,5086088733,-3,1545,4908,-40
5086997025,5086997032,7,2729,1361,-40
5089270738,5089270743,5,3046,1400,-40
5089356665,5089356672,7,3342,1308,-40
5089978929,5089978926,-3,1259,1994,-40
5090311880,5090311886,6,2964,1232,-40
5090364541,5090364561,20,3885,1131,-40
5090795943,5090795961,18,2550,872,-40
5093751839,5093751842,3,750,1276,-40
5097268994,5097269000,6,2895,1105,-40
5100591473,5100591467,-6,1574,6338,-40
5102764930,5102764937,7,2969,1051,-40
5103473263,5103473252,-11,544,99,-40
5104103201,5104103205,4,2120,1080,-40
5106129221,5106129230,9,12114,22310,-40
5118047023,5118047030,7,3047,1367,-40
5119141525,5119141529,4,2892,950,-40
5123085104,5123085110,6,2787,1808,-40
5124015449,5124015456,7,3709,2003,-40
5125525783,5125525789,6,3314,1486,-40
5125654230,5125654212,-18,2774,1002,-40
5128438826,5128438831,5,3651,975,-40
5128614458,5128614463,5,1704,1286,-40
5130665142,5130665147,5,928,661,-40
5130854502,5130854484,-18,1130,535,-40
5138301400,5138301405,5,3101,1911,-40
5139984297,5139984302,5,1252,740,-40
5142577205,5142577212,7,3068,1540,-40
5145511705,5145511705,0,110,1383,-40
5149276679,5149276686,7,2095,1125,-40
5154287096,5154287101,5,2086,1480,-40
5155308736,5155308743,7,3273,1384,-40
5156048976,5156048982,6,2367,990,-40
5158772883,5158772890,7,2038,1102,-40
5161198198,5161198203,5,2675,964,-40
5161282593,5161282599,6,2620,1052,-40
5161976350,5161976355,5,3218,1454,-40
5162919612,5162919618,6,2533,1221,-40
5166525576,5166525583,7,2495,1248,-40
5167147538,5167147542,4,10954,19881,-40
5171681078,5171681085,7,3476,1205,-40
5172466614,5172466624,10,553,118,-40
5173863922,5173863930,8,2541,1187,-40
5175517469,5175517473,4,2424,1348,-40
5176419055,5176419035,-20,37580,19163,-40
5185758778,5185758785,7,2380,1169,-40
5186759826,5186759831,5,2500,987,-40
5186937503,5186937500,-3,945,118,-40
5191670654,5191670658,4,1702,1043,-40
5193489191,5193489198,7,2868,1249,-40
5196889886,5196889892,6,3662,1630,-40
5198198522,5198198526,4,1291,1457,-40
5200274131,5200274137,6,5154,2446,-40
5201775872,5201775879,7,2547,1352,-40
5203369061,5203369067,6,3378,1591,-40
5203562150,5203562146,-4,734,264,-40
5209412553,5209412558,5,2383,1499,-40
5214820417,5214820423,6,1963,1273,-40
5216176630,5216176637,7,3037,1392,-40
5217556694,5217556698,4,2016,1119,-40
5223528752,5223528758,6,2598,1163,-40
5230249905,5230249911,6,2945,1566,-40
5231866410,5231866417,7,2343,854,-40
5234501413,5234501419,6,2684,1546,-40
5237014083,5237014087,4,2634,1735,-40
5238218505,5238218513,8,2290,1248,-40
5240793000,5240793006,6,2297,1136,-40
5246425411,5246425417,6,3137,1387,-40
5251330226,5251330230,4,2408,1534,-40
5259485009,5259485015,6,2568,1380,-40
5260749252,5260749259,7,2543,1348,-40
5261398706,5261398720,14,3139,1125,-40
5267826878,5267826885,7,3186,1635,-40
5270647725,5270647731,6,3125,1470,-40
5271117203,5271117211,8,3765,1251,-40
5272217009,5272217006,-3,1444,3434,-40
5277030821,5277030827,6,3371,1698,-40
5279805943,5279805949,6,2981,1527,-40
5284873214,5284873220,6,2391,955,-40
5293975797,5293975801,4,2286,1266,-40
5296348807,5296348813,6,2972,1601,-40
5296524163,5296524170,7,3054,949,-40
5299059867,5299059874,7,2970,1380,-40
5300160771,5300160777,6,2607,1674,-40
5300863956,5300863963,7,2960,1294,-40
5301319488,5301319496,8,3258,955,-40
5302449287,5302449282,-5,1368,4974,-40
5302730502,5302730509,7,3256,1699,-40
5304113737,5304113743,6,2684,1656,-40
5309609230,5309609238,8,2492,1254,-40
5310465400,5310465405,5,2594,950,-40
5311472578,5311472576,-2,1609,2089,-40
5321568117,5321568125,8,1206,820,-40
5325436511,5325436514,3,1599,32590,-40
5327864460,5327864466,6,3350,1107,-40
5328205866,5328205866,0,1029,241,-40
5330836919,5330836925,6,2773,1295,-40
5332964343,5332964350,7,3623,1719,-40
5335219517,5335219522,5,2968,1599,-40
5351636561,5351636569,8,3842,1683,-40
5359676735,5359676741,6,3485,1399,-40
5359993840,5359993848,8,2059,973,-40
5361305871,5361305879,8,3177,1360,-40
5365724426,5365724430,4,2013,2157,-40
5371378862,5371378867,5,2697,1155,-40
5379676334,5379676342,8,1336,890,-40
5381688366,5381688370,4,2675,1976,-40
5382772621,5382772627,6,3208,1104,-40
5384587551,5384587550,-1,1129,1068,-40
5388499762,5388499770,8,2880,985,-40
5389062190,5389062180,-10,182,877,-40
5390067989,5390067986,-3,4082,12000,-40
5392024621,5392024627,6,2336,1126,-40
5392572343,5392572350,7,3196,948,-40
5393900305,5393900311,6,3234,1553,-40
5394887546,5394887550,4,2866,1517,-40
5395515034,5395515039,5,1860,474,-40
5396406109,5396406131,22,2548,916,-40
5398165030,5398165037,7,3369,1276,-40
5400633545,5400633551,6,2564,1184,-40
5401391337,5401391343,6,3805,1176,-40
5406675283,5406675291,8,3209,1288,-40
5407352518,5407352496,-22,1163,311,-40
5409419333,5409419339,6,2331,1579,-40
5415231314,5415231311,-3,1939,4679,-40
5416112046,5416112053,7,2035,1097,-40
5418075640,5418075647,7,4053,1304,-40
5418229670,5418229649,-21,1760,661,-40
5418893270,5418893277,7,2667,1125,-40
5418932325,5418932331,6,2843,1291,-40
5426285869,5426285877,8,3358,1445,-40
5426739076,5426739082,6,2441,1343,-40
5428878394,5428878399,5,19694,24272,-40
5431375750,5431375755,5,2857,1405,-40
5431909138,5431909147,9,3114,1082,-40
5443178185,5443178191,6,2753,1313,-40
5443769787,5443769793,6,2621,1764,-40
5444597321,5444597316,-5,1087,182,-40
5445723561,5445723567,6,2318,1337,-40
5447127855,5447127859,4,3278,1512,-40
5448077268,5448077277,9,362,1815,-40
5449549152,5449549158,6,2905,1425,-40
5458697774,5458697782,8,4073,1294,-40
5460864097,5460864103,6,3399,1309,-40
5465590486,5465590493,7,2700,1137,-40
5470529912,5470529918,6,2226,1054,-40
5471259170,5471259177,7,2591,1240,-40
5471289511,5471289492,-19,1063,556,-40
5476379528,5476379535,7,3696,1508,-40
5479045472,5479045477,5,3083,1848,-40
5480147093,5480147101,8,2499,1344,-40
5481056007,5481056014,7,915,302,-40
5481632221,5481632226,5,2268,1276,-40
5483835546,5483835552,6,2550,1530,-40
5484769993,5484770001,8,3218,1493,-40
5485289215,5485289221,6,3377,953,-40
5485513689,5485513687,-2,30483,79798,-40
5487573900,5487573905,5,2419,1298,-40
5489111866,5489111871,5,1373,570,-40
5491944430,5491944437,7,3319,1771,-40
5494010085,5494010070,-15,1183,5087,-40
5498635966,5498635972,6,3295,1570,-40
5501697410,5501697416,6,2641,1346,-40
5502069445,5502069443,-2,1695,411,-40
5503706243,5503706250,7,5564,2218,-40
5505508471,5505508479,8,2577,1345,-40
5505815074,5505815075,1,1111,1046,-40
5516257227,5516257232,5,2235,1498,-40
5525002322,5525002329,7,3920,1664,-40
5529040225,5529040230,5,4209,1499,-40
5531461493,5531461499,6,2649,1090,-40
5536269629,5536269635,6,2265,1005,-40
5540028115,5540028122,7,3661,1501,-40
5545595425,5545595431,6,2316,1024,-40
5545981961,5545981947,-14,786,206,-40
5548635710,5548635710,0,2160,3328,-40
5551859341,5551859346,5,1722,1292,-40
5553268785,5553268794,9,3720,1344,-40
5558694709,5558694715,6,2208,1058,-40
5560359586,5560359593,7,2554,1170,-40
5565828549,5565828555,6,4262,1037,-40
5567577731,5567577744,13,810,386,-40
5569700199,5569700204,5,2035,1158,-40
5570244002,5570244018,16,1914,751,-40
5572952082,5572952095,13,788,310,-40
5577547360,5577547365,5,2652,1231,-40
5580706168,5580706168,0,1493,1846,-40
5583665853,5583665859,6,2651,1080,-40
5584132450,5584132455,5,3056,1526,-40
5584608283,5584608280,-3,1275,2911,-40
5587162854,5587162833,-21,1024,2129,-40
5588332973,5588332981,8,2719,963,-40
5592658631,5592658630,-1,1065,2176,-40
5592898351,5592898352,1,24267,26500,-40
5593024914,5593024912,-2,1016,1640,-40
5594012278,5594012283,5,2024,1389,-40
5598821595,5598821602,7,3833,1603,-40
5603539366,5603539373,7,4271,1446,-40
5608259585,5608259590,5,3084,1116,-40
5608967471,5608967477,6,2728,1086,-40
5614596789,5614596793,4,1977,1593,-40
5617724007,5617724010,3,1222,1700,-40
5618406542,5618406550,8,2941,909,-40
5620298688,5620298672,-16,1071,438,-40
5621933837,5621933843,6,1645,1397,-40
5627048226,5627048230,4,1323,898,-40
5630812167,5630812175,8,1233,684,-40
5635468558,5635468536,-22,3456,1688,-40
5639868166,5639868163,-3,1172,2636,-40
5647621985,5647621990,5,3096,1440,-40
5647744165,5647744170,5,4050,1907,-40
5648062463,5648062482,19,676,204,-40
5657570799,5657570802,3,996,674,-40
5657831870,5657831851,-19,6401,894,-40
5658870705,5658870710,5,2315,1626,-40
5659220191,5659220199,8,3082,1346,-40
5661697701,5661697708,7,4462,1238,-40
5663834127,5663834135,8,1301,782,-40
5663995474,5663995481,7,2511,1122,-40
5664140337,5664140321,-16,1839,544,-40
5666556177,5666556183,6,3707,1407,-40
5670270114,5670270121,7,1998,1286,-40
5672257178,5672257185,7,2574,1192,-40
5678882920,5678882927,7,3485,1733,-40
5689215841,5689215848,7,3212,1776,-40
5694767183,5694767189,6,2040,885,-40
5695728600,5695728606,6,2525,912,-40
5695987348,5695987356,8,3430,1489,-40
5707725073,5707725082,9,3842,1255,-40
5708467132,5708467139,7,3097,1375,-40
5712061513,5712061496,-17,890,368,-40
5712423408,5712423431,23,612,2246,-40
5717777334,5717777330,-4,2050,5050,-40
5725392117,5725392126,9,2942,1189,-40
5727466987,5727466993,6,2953,1349,-40
5728590705,5728590710,5,3568,1473,-40
5734628901,5734628906,5,3397,1614,-40
5737391630,5737391638,8,3500,1064,-40
5739296236,5739296243,7,3435,1484,-40
5740910095,5740910090,-5,909,3025,-40
5758002065,5758002070,5,2727,761,-40
5760712287,5760712292,5,2542,907,-40
5763417427,5763417434,7,3834,1563,-40
5767382311,5767382317,6,1781,1189,-40
5767954606,5767954611,5,2132,1099,-40
5774495433,5774495439,6,2351,960,-40
5776297301,5776297307,6,2737,1295,-40
5777318195,5777318202,7,2248,1044,-40
5780010622,5780010626,4,3517,1145,-40
5781763574,5781763578,4,1461,1431,-40
5783801922,5783801926,4,3232,1260,-40
5785942576,5785942577,1,22532,21522,-40
5788111179,5788111186,7,2535,866,-40
5793692377,5793692384,7,2790,1443,-40
5797143408,5797143414,6,2598,1005,-40
5797271179,5797271161,-18,4443,1684,-40
5798280438,5798280443,5,2102,1012,-40
5801046026,5801046031,5,3033,1492,-40
5801222080,5801222088,8,11665,28786,-40
5806017607,5806017604,-3,998,2061,-40
5814069819,5814069826,7,3391,1019,-40
5815716706,5815716712,6,2724,1189,-40
5816753322,5816753329,7,2057,1152,-40
5817243206,5817243193,-13,1607,563,-40
5819258215,5819258219,4,1835,1273,-40
5823143890,5823143895,5,1715,1282,-40
5824647814,5824647819,5,2938,1721,-40
5824739222,5824739229,7,3303,1210,-40
5827887555,5827887562,7,4347,1756,-40
5827998341,5827998348,7,3825,1847,-40
5828610846,5828610854,8,3142,1153,-40
5828824621,5828824630,9,2475,642,-40
5829035966,5829035944,-22,962,340,-40
5831477437,5831477444,7,4344,1693,-40
5832942968,5832942985,17,554,2034,-40
5833310654,5833310660,6,3063,1317,-40
5837709575,5837709582,7,2789,1059,-40
5837944583,5837944561,-22,1023,228,-40
5838679875,5838679883,8,2072,1168,-40
5841185162,5841185168,6,3034,1665,-40
5848225702,5848225708,6,2372,1423,-40
5850477981,5850477988,7,2877,1466,-40
5850845542,5850845547,5,3090,1532,-40
5854715091,5854715095,4,1608,1389,-40
5854825147,5854825129,-18,682,206,-40
5855522313,5855522319,6,2710,1313,-40
5856046412,5856046418,6,2527,1095,-40
5859809450,5859809458,8,1873,907,-40
5865164078,5865164085,7,2944,1053,-40
5866221179,5866221159,-20,768,240,-40
5869922908,5869922914,6,2723,1269,-40
5872360062,5872360068,6,2755,1178,-40
5874981235,5874981239,4,2371,1352,-40
5876001007,5876001018,11,1056,135,-40
5877391445,5877391458,13,747,367,-40
5878661841,5878661824,-17,2187,749,-40
5879653451,5879653458,7,3975,1985,-40
5886530407,5886530414,7,3457,2270,-40
5890378319,5890378325,6,3170,1316,-40
5892540173,5892540180,7,2416,1151,-40
5893090137,5893090142,5,1986,983,-40
5893146757,5893146769,12,14737,49438,-40
5896178302,5896178310,8,4041,1424,-40
5896501082,5896501089,7,3755,1459,-40
5905094586,5905094593,7,3278,1155,-40
5905332030,5905332038,8,2852,1006,-40
5906244266,5906244272,6,3259,1231,-40
5906290341,5906290347,6,2137,826,-40
5907875657,5907875661,4,1716,1074,-40
5908498793,5908498798,5,2828,1346,-40
5909087505,5909087490,-15,970,183,-40
5910012115,5910012121,6,3918,1380,-40
5911222309,5911222315,6,2113,1013,-40
5911642695,5911642676,-19,2895,939,-40
5911950791,5911950797,6,2863,1277,-40
5912627365,5912627371,6,2407,1336,-40
5922388043,5922388049,6,2341,1086,-40
5926652172,5926652178,6,2853,1117,-40
5929682241,5929682243,2,2349,2420,-40
5930783853,5930783858,5,2680,1564,-40
5933017482,5933017481,-1,1318,2092,-40
5940661095,5940661103,8,2602,1362,-40
5941488254,5941488258,4,1824,695,-40
5943494894,5943494901,7,1694,1011,-40
5944526768,5944526770,2,3222,2549,-40
5944837376,5944837383,7,3264,893,-40
5947172742,5947172747,5,1967,886,-40
5951741373,5951741378,5,3671,2108,-40
5952755717,5952755722,5,3501,1386,-40
5957202354,5957202362,8,1936,1271,-40
5959590209,5959590214,5,2450,1569,-40
5959995111,5959995119,8,3298,1469,-40
5962658672,5962658678,6,2087,1423,-40
5966344206,5966344211,5,1779,757,-40
5968655887,5968655893,6,3219,1522,-40
5974261210,5974261217,7,2304,1014,-40
5975295325,5975295332,7,3591,1323,-40
5979226592,5979226597,5,3205,1214,-40
5980698073,5980698079,6,2094,989,-40
5980941706,5980941711,5,3163,1047,-40
5981803636,5981803616,-20,2829,1471,-40
5983083570,5983083576,6,3016,1483,-40
5984767337,5984767342,5,3390,1296,-40
5990183897,5990183901,4,1819,1007,-40
5999865479,5999865487,8,2454,1160,-40
6001197899,6001197906,7,2747,1480,-40
6005320558,6005320564,6,1617,1256,-40
6007718529,6007718535,6,2550,1391,-40
6008026384,6008026390,6,3021,1642,-40
6027011406,6027011402,-4,1434,3572,-40
6027164555,6027164561,6,3059,946,-40
6030827294,6030827298,4,1712,1433,-40
6033955637,6033955642,5,2518,1563,-40
6037596459,6037596455,-4,965,2159,-40
6039400320,6039400326,6,2599,1434,-40
6039607171,6039607178,7,2140,1277,-40
6040099532,6040099538,6,2609,1168,-40
6048642174,6048642174,0,1034,1277,-40
6050724560,6050724565,5,2693,922,-40
6053964989,6053964995,6,4412,1779,-40
6055156874,6055156881,7,2380,917,-40
6062880338,6062880341,3,2407,730,-40
6066990006,6066990014,8,3564,1324,-40
6069210973,6069210978,5,2156,779,-40
6071128642,6071128650,8,3152,969,-40
6071445967,6071445953,-14,1437,497,-40
6073034198,6073034204,6,2931,1119,-40
6081124353,6081124358,5,11716,31795,-40
6082088858,6082088865,7,5533,1840,-40
6084946366,6084946372,6,3567,1523,-40
6085432444,6085432450,6,4619,1253,-40
6088127860,6088127867,7,3225,1551,-40
6089987554,6089987561,7,3989,1399,-40
6095230131,6095230131,0,1152,2648,-40
6099932419,6099932423,4,1366,870,-40
6103494321,6103494326,5,3755,1151,-40
6103602410,6103602392,-18,892,288,-40
6108521712,6108521717,5,3027,1328,-40
6109867714,6109867719,5,2960,1129,-40
6113212610,6113212617,7,3828,2256,-40
6114691408,6114691413,5,2689,1525,-40
6115157189,6115157191,2,2532,3202,-40
6115534922,6115534927,5,2844,1008,-40
6118173775,6118173782,7,2826,1313,-40
6120052893,6120052907,14,543,19,-40
6121206214,6121206221,7,2265,1405,-40
6121405941,6121405924,-17,3795,999,-40
6122539686,6122539690,4,3134,1219,-40
6125298955,6125298961,6,3180,1851,-40
6126831605,6126831613,8,3458,1127,-40
6127779398,6127779402,4,1670,746,-40
6128159488,6128159494,6,3413,1005,-40
6130696430,6130696445,15,2560,1055,-40
6141990566,6141990572,6,2789,1270,-40
6142350761,6142350767,6,3126,1179,-40
6144971746,6144971746,0,1154,1719,-40
6145370298,6145370306,8,2984,1318,-40
6146609638,6146609637,-1,2601,3308,-40
6146758591,6146758583,-8,1443,27800,-40
6147149408,6147149414,6,3304,1212,-40
6147331690,6147331695,5,1725,1051,-40
6148506214,6148506214,0,39128,37916,-40
6155442218,6155442224,6,3186,1636,-40
6159948938,6159948951,13,14038,37140,-40
6160893844,6160893850,6,2445,1397,-40
6161194896,6161194904,8,3177,1291,-40
6161528250,6161528258,8,2910,1218,-40
6161618014,6161617993,-21,2769,1507,-40
6161695180,6161695169,-11,1480,572,-40
6162441695,6162441701,6,2175,1476,-40
6165970676,6165970683,7,3103,1225,-40
6166360894,6166360899,5,2033,1038,-40
6173555257,6173555262,5,3126,1034,-40
6179016215,6179016222,7,2751,1168,-40
6181225531,6181225537,6,5021,1598,-40
6183606190,6183606194,4,3214,1265,-40
6184642782,6184642788,6,2558,1510,-40
6184783130,6184783115,-15,1032,371,-40
6189506393,6189506399,6,1939,1008,-40
6192103848,6192103855,7,2182,870,-40
6192872536,6192872542,6,2352,1334,-40
6192922796,6192922817,21,2388,890,-40
6195968389,6195968394,5,1091,105,-40
6201406084,6201406081,-3,21301,13859,-40
6202420458,6202420463,5,2075,742,-40
6202655438,6202655441,3,2044,1605,-40
6205861815,6205861817,2,1932,1464,-40
6207435638,6207435643,5,2256,1790,-40
6211814361,6211814361,0,1907,2230,-40
6213245643,6213245646,3,2365,1869,-40
6214826450,6214826457,7,3919,1457,-40
6218020074,6218020079,5,2810,1864,-40
6224218791,6224218798,7,3249,2026,-40
6231649758,6231649766,8,1995,1434,-40
6231952353,6231952358,5,2848,1079,-40
6233909885,6233909890,5,1850,1036,-40
6234662088,6234662094,6,2209,906,-40
6234830963,6234830979,16,1213,354,-40
6236335549,6236335555,6,1907,1145,-40
6236725985,6236725987,2,1759,1490,-40
6239662424,6239662429,5,3817,1596,-40
6240659693,6240659699,6,3098,1242,-40
6240839501,6240839482,-19,1409,758,-40
6241668805,6241668812,7,2111,1188,-40
6242735751,6242735759,8,2215,1329,-40
6244745956,6244745962,6,2389,1556,-40
6246375550,6246375554,4,2628,1927,-40
6248805286,6248805290,4,2174,1379,-40
6259518978,6259518982,4,2041,1083,-40
6259843549,6259843555,6,2220,1103,-40
6265477958,6265477963,5,2752,1394,-40
6267931830,6267931838,8,2833,1220,-40
6268440510,6268440509,-1,1972,3096,-40
6275883722,6275883727,5,2961,1485,-40
6279287379,6279287387,8,2586,1074,-40
6283624516,6283624522,6,2547,993,-40
6285680873,6285680880,7,3326,1492,-40
6300241694,6300241700,6,2046,983,-40
6302281327,6302281333,6,1372,1125,-40
6304898205,6304898202,-3,1924,3561,-40
6309616693,6309616699,6,2649,1434,-40
6313438547,6313438554,7,2777,1105,-40
6320493947,6320493942,-5,1374,3421,-40
6322375014,6322375023,9,4330,1789,-40
6323244006,6323244014,8,2624,1231,-40
6326520589,6326520595,6,2088,1269,-40
6334131062,6334131069,7,5008,1625,-40
6338086382,6338086390,8,2798,796,-40
6347602575,6347602581,6,2868,1305,-40
6348318007,6348317995,-12,928,234,-40
6348740327,6348740333,6,2726,1230,-40
6349917823,6349917829,6,2835,1156,-40
6351702913,6351702918,5,2942,1421,-40
6353045119,6353045125,6,2483,1442,-40
6355797683,6355797684,1,3616,3008,-40
6359100458,6359100459,1,1326,1143,-40
6368033560,6368033559,-1,1776,2568,-40
6372701600,6372701581,-19,2546,1362,-40
6377638931,6377638928,-3,769,1805,-40
6380236832,6380236837,5,3259,1337,-40
6381897398,6381897406,8,2266,1187,-40
6382407169,6382407175,6,2992,1359,-40
6384403141,6384403146,5,2507,1442,-40
6389209315,6389209321,6,2059,1318,-40
6391936346,6391936350,4,1345,1630,-40
6392111550,6392111556,6,2109,1163,-40
6392935910,6392935917,7,2144,1031,-40
6395334496,6395334493,-3,1776,4460,-40
6395623493,6395623489,-4,2107,5762,-40
6395893146,6395893153,7,3230,1234,-40
6395939126,6395939115,-11,898,420,-40
6396292942,6396292946,4,2349,1763,-40
6398174367,6398174375,8,2957,1380,-40
6398235731,6398235737,6,2198,890,-40
6402299422,6402299427,5,3560,1300,-40
6404369098,6404369099,1,1153,1607,-40
6405566081,6405566087,6,3160,1514,-40
6406172828,6406172833,5,2663,1162,-40
6410570794,6410570798,4,2865,1619,-40
6411241499,6411241503,4,1772,1095,-40
6415068883,6415068885,2,1928,1281,-40
6426425177,6426425182,5,3243,1238,-40
6426549738,6426549745,7,2649,1385,-40
6431575907,6431575910,3,1858,2002,-40
6434369147,6434369153,6,2700,1153,-40
6437193362,6437193369,7,3056,1040,-40
6437435641,6437435650,9,1134,183,-40
6440735647,6440735653,6,2408,1083,-40
6442211066,6442211069,3,2479,1566,-40
6443882305,6443882313,8,2812,1241,-40
6451745612,6451745618,6,3378,1240,-40
6452084427,6452084425,-2,1790,246,-40
6452357813,6452357821,8,2232,1497,-40
6454532993,6454532999,6,2493,1666,-40
6457006532,6457006538,6,3031,1226,-40
6461747235,6461747238,3,1636,1328,-40
6462009222,6462009240,18,338,45,-40
6467624701,6467624707,6,2172,1142,-40
6474887010,6474887018,8,2977,1274,-40
6476313838,6476313845,7,2534,1270,-40
6476691494,6476691483,-11,955,437,-40
6478608425,6478608430,5,2345,1776,-40
6478724786,6478724790,4,3508,1618,-40
6479303823,6479303829,6,1774,1901,-40
6482870471,6482870478,7,3208,1117,-40
6488429473,6488429479,6,2537,1185,-40
6489167088,6489167093,5,4273,2243,-40
6489531075,6489531081,6,2701,1369,-40
6490134121,6490134125,4,2673,1136,-40
6491162803,6491162802,-1,2454,4027,-40
6491990486,6491990494,8,4253,1458,-40
6497644530,6497644537,7,2742,1257,-40
6501264126,6501264130,4,2536,1130,-40
6501364566,6501364569,3,2105,1459,-40
6510455687,6510455681,-6,1423,6663,-40
6511675925,6511675932,7,2771,1281,-40
6511900455,6511900461,6,2649,1432,-40
6516216652,6516216658,6,2690,1362,-40
6517353065,6517353072,7,2763,1124,-40
6517992318,6517992323,5,3072,1554,-40
6518567325,6518567330,5,1735,689,-40
6520345674,6520345681,7,2002,740,-40
6520435722,6520435708,-14,2730,897,-40
6524396753,6524396759,6,1604,545,-40
6525283013,6525283001,-12,985,450,-40
6528933398,6528933405,7,2273,985,-40
6529367221,6529367225,4,1628,1311,-40
6530704359,6530704367,8,4657,1391,-40
6531121930,6531121935,5,3518,1568,-40
6537140400,6537140406,6,4551,1997,-40
6538756434,6538756441,7,1367,1252,-40
6540150471,6540150476,5,2800,1099,-40
6542999557,6542999563,6,1115,620,-40
6543748911,6543748918,7,2828,1546,-40
6544478289,6544478299,10,2977,1196,-40
6545602509,6545602513,4,4857,2781,-40
6547407219,6547407223,4,2829,1117,-40
6548573313,6548573319,6,3646,1286,-40
6549798707,6549798712,5,2824,1253,-40
6551045341,6551045346,5,3710,1318,-40
6551783138,6551783143,5,1940,958,-40
6552655685,6552655704,19,1125,266,-40
6560322538,6560322543,5,2090,1334,-40
6560550345,6560550350,5,2867,1645,-40
6562932137,6562932143,6,3051,842,-40
6563438865,6563438848,-17,2865,1213,-40
6564610184,6564610193,9,2877,1298,-40
6566739355,6566739362,7,2936,1239,-40
6567270390,6567270386,-4,1601,6084,-40
6567736986,6567736992,6,2206,1288,-40
6570675827,6570675834,7,3059,1505,-40
6571662731,6571662737,6,2507,784,-40
6571982015,6571982011,-4,836,285,-40
6575403725,6575403731,6,2496,926,-40
6575467940,6575467946,6,1963,1331,-40
6577675178,6577675171,-7,1546,34927,-40
6583025272,6583025279,7,2318,1674,-40
6586133618,6586133623,5,2505,1424,-40
6598357327,6598357334,7,2464,897,-40
6599891770,6599891775,5,1936,1666,-40
6600201942,6600201947,5,2623,1157,-40
6601629018,6601629025,7,2985,1387,-40
6603664426,6603664430,4,1733,758,-40
6609974957,6609974971,14,3486,1373,-40
6616151070,6616151078,8,2538,1101,-40
6617355013,6617355019,6,2651,1259,-40
6617619013,6617619019,6,2430,1392,-40
6618792796,6618792803,7,3321,1291,-40
6620471984,6620471991,7,2959,1550,-40
6621946542,6621946548,6,2593,989,-40
6622424307,6622424304,-3,1174,2972,-40
6630828153,6630828155,2,57596,44824,-40
6632718751,6632718748,-3,1296,2701,-40
6634425931,6634425938,7,2805,1626,-40
6635326785,6635326768,-17,1439,257,-40
6635913045,6635913050,5,2114,1188,-40
6637348633,6637348638,5,1935,1062,-40
6641325989,6641325995,6,2269,1328,-40
6643603445,6643603451,6,2741,1073,-40
6648362505,6648362515,10,2724,1131,-40
6648726009,6648726015,6,2202,1265,-40
6650388925,6650388932,7,3055,1448,-40
6650781676,6650781682,6,2457,1208,-40
6652764146,6652764153,7,2825,981,-40
6662148245,6662148251,6,2978,1275,-40
6664402961,6664402967,6,1808,866,-40
6666287354,6666287359,5,3137,1060,-40
6670845976,6670845983,7,2126,1374,-40
6674128101,6674128108,7,4100,1437,-40
6676299666,6676299671,5,2040,1186,-40
6676769943,6676769951,8,868,461,-40
6677058540,6677058546,6,1704,895,-40
6678074858,6678074875,17,2690,1267,-40
6680065181,6680065190,9,3565,1438,-40
6680679562,6680679560,-2,23076,41216,-40
6680706889,6680706894,5,2032,1074,-40
6682268777,6682268783,6,2218,1199,-40
6683592795,6683592801,6,2847,1273,-40
6686567333,6686567337,4,2634,1022,-40
6697356753,6697356761,8,4144,1480,-40
6702518948,6702518954,6,2360,1073,-40
6702788753,6702788738,-15,2113,1038,-40
6703850194,6703850198,4,2162,1699,-40
6706263595,6706263601,6,2870,1194,-40
6709816203,6709816207,4,2679,2015,-40
6709915518,6709915525,7,2901,1189,-40
6710062325,6710062330,5,2183,1091,-40
6710176606,6710176624,18,645,123,-40
6713687962,6713687963,1,3037,3982,-40
6714990929,6714990924,-5,1854,4865,-40
6718673985,6718673991,6,2075,1023,-40
6719035574,6719035593,19,869,113,-40
6721927108,6721927110,2,1372,1417,-40
6724038813,6724038819,6,1606,874,-40
6732043719,6732043717,-2,1564,2074,-40
6736282543,6736282550,7,3200,1020,-40
6736683382,6736683369,-13,1313,453,-40
6739619350,6739619357,7,15334,21783,-40
6741537514,6741537522,8,3220,1331,-40
6741820398,6741820409,11,1140,94,-40
6749468761,6749468766,5,1634,637,-40
6751542790,6751542795,5,2566,1552,-40
6752491307,6752491302,-5,871,3496,-40
6758927283,6758927290,7,3746,1408,-40
6762428191,6762428198,7,2194,1292,-40
6766628389,6766628386,-3,2278,2376,-40
6766925737,6766925743,6,3043,1301,-40
6772331063,6772331070,7,3317,1569,-40
6772394834,6772394840,6,3052,1062,-40
6780806936,6780806942,6,3315,1655,-40
6785425737,6785425743,6,3098,1296,-40
6787046307,6787046302,-5,1081,3907,-40
6787187358,6787187363,5,2885,1257,-40
6789220394,6789220400,6,2229,1767,-40
6791722648,6791722653,5,1947,1166,-40
6792346902,6792346908,6,2882,1949,-40
6797276342,6797276351,9,3072,1141,-40
6799339371,6799339378,7,3194,1150,-40
6803155363,6803155358,-5,906,3827,-40
6807609297,6807609303,6,2774,1317,-40
6812891817,6812891823,6,1542,793,-40
6814296065,6814296072,7,2931,1176,-40
6815161545,6815161550,5,2303,761,-40
6823185288,6823185294,6,2390,1091,-40
6825250907,6825250907,0,1284,1525,-40
6825421656,6825421661,5,2925,1368,-40
6827107086,6827107093,7,2975,1160,-40
6829874861,6829874865,4,3850,1113,-40
6833081829,6833081834,5,2124,1052,-40
6837066451,6837066458,7,3608,1396,-40
6838042063,6838042063,0,677,1412,-40
6849523506,6849523513,7,2105,1246,-40
6849796958,6849796962,4,3032,1588,-40
6852799797,6852799803,6,3975,1342,-40
6854219585,6854219590,5,2394,877,-40
6858128970,6858128978,8,2894,1048,-40
6862696550,6862696531,-19,3279,1127,-40
6863761941,6863761947,6,2329,970,-40
6866157701,6866157708,7,2303,1695,-40
6866670482,6866670466,-16,2204,842,-40
6868326309,6868326317,8,4514,933,-40
6872275484,6872275490,6,2136,770,-40
6873594471,6873594477,6,3017,982,-40
6875280851,6875280858,7,2896,1500,-40
6875416604,6875416627,23,2352,1085,-40
6876902531,6876902537,6,2645,844,-40
6884844499,6884844503,4,2913,1399,-40
6887467171,6887467177,6,2353,1266,-40
6888627322,6888627329,7,3643,1059,-40
6888913722,6888913726,4,1843,1200,-40
6893937511,6893937517,6,2120,582,-40
6893980894,6893980900,6,4115,1552,-40
6894381749,6894381756,7,2838,1206,-40
6894891265,6894891260,-5,1113,3953,-40
6895742957,6895742963,6,2866,1672,-40
6900771911,6900771918,7,1907,842,-40
6907354530,6907354533,3,4465,24519,-40
6908974148,6908974142,-6,1654,7247,-40
6909111299,6909111304,5,2260,1059,-40
6909918379,6909918362,-17,742,896,-40
6921757238,6921757243,5,2739,900,-40
6921790035,6921790042,7,3013,1653,-40
6923458944,6923458949,5,2872,1165,-40
6925396602,6925396607,5,1869,1846,-40
6927462129,6927462135,6,3245,1688,-40
6931854491,6931854498,7,2019,816,-40
6939127535,6939127542,7,2921,1267,-40
6943593608,6943593613,5,2886,1401,-40
6944638400,6944638403,3,4503,3305,-40
6947193378,6947193379,1,1111,1256,-40
6948039441,6948039448,7,2899,1383,-40
6949376780,6949376786,6,2466,960,-40
6952911656,6952911662,6,1716,976,-40
6955383734,6955383740,6,2789,1533,-40
6957420089,6957420094,5,3076,1555,-40
6957708373,6957708369,-4,23069,16959,-40
6961026034,6961026039,5,2289,1322,-40
6963375743,6963375750,7,3490,1068,-40
6967264651,6967264658,7,3059,1278,-40
6972988751,6972988758,7,2601,1324,-40
6974889950,6974889956,6,4669,1955,-40
6975979831,6975979833,2,1057,1402,-40
6984901617,6984901622,5,3340,1500,-40
6985563069,6985563075,6,4221,1741,-40
6994295109,6994295114,5,2743,650,-40
6994574981,6994574987,6,2339,1338,-40
6995140497,6995140493,-4,1299,3031,-40
6996553800,6996553806,6,3676,1639,-40
6997539596,6997539602,6,3229,1424,-40
7001194411,7001194418,7,5099,1119,-40
7001774150,7001774154,4,2592,1448,-40
7005373625,7005373631,6,3141,1547,-40
7006572878,7006572882,4,2204,1485,-40
7012127094,7012127099,5,3189,1439,-40
7013215875,7013215881,6,2775,1312,-40
7014790324,7014790330,6,3172,1470,-40
7017011029,7017011037,8,2405,1404,-40
7020824835,7020824841,6,3384,1625,-40
7022050074,7022050076,2,2425,40186,-40
7022775630,7022775637,7,3120,1503,-40
7031267775,7031267782,7,1227,1060,-40
7032370702,7032370706,4,1931,1274,-40
7037366261,7037366266,5,3439,1551,-40
7039477840,7039477846,6,1013,886,-40
7052974233,7052974227,-6,961,3152,-40
7054732783,7054732789,6,2358,1531,-40
7055496233,7055496240,7,3673,1232,-40
7057809389,7057809395,6,2564,1151,-40
7063260301,7063260306,5,2231,1283,-40
7069238681,7069238688,7,3021,1936,-40
7069524927,7069524938,11,2403,761,-40
7069866775,7069866781,6,3838,1453,-40
7073287633,7073287641,8,3566,1820,-40
7075500499,7075500507,8,3217,1668,-40
7075542261,7075542241,-20,1880,1077,-40
7075917026,7075917031,5,3782,1740,-40
7077969478,7077969480,2,2198,1716,-40
7084132073,7084132079,6,2454,1154,-40
7086521513,7086521519,6,2657,1614,-40
7087237946,7087237950,4,1873,1086,-40
7087529762,7087529772,10,2995,898,-40
7087831746,7087831755,9,2420,947,-40
7087870659,7087870665,6,3215,1253,-40
7094482401,7094482408,7,2599,937,-40
7095329009,7095329014,5,3179,1270,-40
7105872413,7105872418,5,3638,1450,-40
7109894434,7109894441,7,2688,1336,-40
7110412779,7110412768,-11,1142,254,-40
7110447895,7110447903,8,2672,968,-40
7119481367,7119481373,6,2753,1989,-40
7124169512,7124169519,7,2625,1005,-40
7130133423,7130133429,6,2285,1016,-40
7131483706,7131483712,6,2112,753,-40
7131613510,7131613514,4,1515,1407,-40
7134119093,7134119100,7,3238,1249,-40
7134551473,7134551470,-3,1795,4332,-40
7137347232,7137347238,6,11621,35606,-40
7139684105,7139684110,5,2611,1613,-40
7139990386,7139990393,7,2317,1485,-40
7143179433,7143179441,8,3408,993,-40
7143364998,7143364998,0,914,1070,-40
7145898348,7145898353,5,2434,1172,-40
7146303034,7146303016,-18,2553,1152,-40
7146613898,7146613904,6,3100,1247,-40
7148980446,7148980444,-2,3834,15368,-40
7149444844,7149444850,6,2707,1269,-40
7149493287,7149493282,-5,946,1993,-40
7149623955,7149623957,2,1873,1344,-40
7149778551,7149778537,-14,839,338,-40
7157185377,7157185383,6,3435,1822,-40
7157312153,7157312159,6,3606,1212,-40
7158540571,7158540575,4,2803,1947,-40
7160367166,7160367174,8,3028,1127,-40
7162001646,7162001649,3,1613,709,-40
7167816623,7167816624,1,1190,1619,-40
7168044906,7168044914,8,1410,1055,-40
7170738469,7170738474,5,3183,1513,-40
7173414161,7173414167,6,2233,1215,-40
7174197095,7174197103,8,2804,976,-40
7174911678,7174911686,8,1905,824,-40
7175643454,7175643460,6,3210,1838,-40
7178044221,7178044227,6,2953,1001,-40
7181518139,7181518134,-5,860,4389,-40
7185471778,7185471785,7,3137,961,-40
7186685390,7186685395,5,1623,640,-40
7192179326,7192179332,6,3230,1375,-40
7192563490,7192563495,5,3231,1431,-40
7196833894,7196833902,8,2559,823,-40
7197366477,7197366483,6,2825,1795,-40
7203791300,7203791307,7,2568,1873,-40
7208068483,7208068490,7,2604,1487,-40
7208310295,7208310294,-1,1073,1847,-40
7209506872,7209506877,5,2638,1151,-40
7214120928,7214120934,6,3135,1073,-40
7215805282,7215805302,20,1281,2079,-40
7223944953,7223944958,5,1762,1581,-40
7226292064,7226292071,7,3630,1663,-40
7226492623,7226492630,7,2573,1363,-40
7227403150,7227403157,7,3177,1499,-40
7228371861,7228371867,6,3051,1683,-40
7233997654,7233997660,6,2128,1109,-40
7234254166,7234254146,-20,2236,919,-40
7236104561,7236104567,6,3930,1985,-40
7241858762,7241858766,4,12847,9218,-40
7242509027,7242509034,7,2919,1408,-40
7243960843,7243960849,6,2460,1444,-40
7246103695,7246103701,6,2719,971,-40
7247002882,7247002887,5,2695,1183,-40
7249797934,7249797935,1,1159,946,-40
7249895685,7249895691,6,2487,1148,-40
7252097868,7252097883,15,15789,48144,-40
7252221130,7252221135,5,2730,1175,-40
7258659277,7258659282,5,2493,1302,-40
7259824964,7259824971,7,2530,835,-40
7262647029,7262647035,6,19792,22439,-40
7265256945,7265256951,6,2841,1310,-40
7266337896,7266337902,6,2753,1243,-40
7269803550,7269803555,5,2335,1465,-40
7270557679,7270557683,4,2614,1683,-40
7274963186,7274963190,4,3649,1541,-40
7275969071,7275969077,6,2788,957,-40
7276556344,7276556348,4,2251,1399,-40
7276685261,7276685250,-11,1353,554,-40
7279407315,7279407321,6,3302,1331,-40
7281908674,7281908681,7,3170,1276,-40
7289617058,7289617065,7,3104,1442,-40
7291421303,7291421310,7,3744,1896,-40
7292376306,7292376314,8,2344,834,-40
7294922064,7294922070,6,2791,1122,-40
7297127381,7297127390,9,2578,1471,-40
7300355242,7300355249,7,3197,1157,-40
7300576298,7300576304,6,1923,1051,-40
7301618266,7301618274,8,2877,1156,-40
7301648198,7301648202,4,2044,1389,-40
7307241708,7307241714,6,3033,1025,-40
7315031135,7315031141,6,3310,1414,-40
7317184611,7317184619,8,3117,1177,-40
7318744346,7318744351,5,3389,1173,-40
7320244077,7320244084,7,2450,1748,-40
7320598731,7320598737,6,2956,1130,-40
7322952406,7322952414,8,3175,1333,-40
7328702268,7328702268,0,1132,2422,-40
7333885861,7333885862,1,2250,1879,-40
7335764524,7335764530,6,2125,1012,-40
7337073727,7337073708,-19,2277,879,-40
7340173791,7340173797,6,2715,1132,-40
7342493125,7342493130,5,2048,929,-40
7346615677,7346615683,6,3041,898,-40
7349124637,7349124643,6,1882,707,-40
7351258585,7351258590,5,2403,944,-40
7356041590,7356041595,5,1982,933,-40
7357819400,7357819406,6,2214,1165,-40
7358229461,7358229467,6,2177,1159,-40
7358724734,7358724752,18,2922,1174,-40
7369116590,7369116593,3,1520,1525,-40
7371072665,7371072670,5,2287,1604,-40
7372583001,7372583008,7,2073,773,-40
7372772620,7372772635,15,858,86,-40
7387479293,7387479298,5,2685,1297,-40
7387729420,7387729426,6,3031,1508,-40
7393646960,7393646957,-3,2039,3388,-40
7394516281,7394516288,7,3023,1276,-40
7396853402,7396853409,7,3334,1853,-40
7400485605,7400485609,4,2759,1273,-40
7406586038,7406586046,8,3779,1238,-40
7407887069,7407887070,1,3609,3477,-40
7418156542,7418156550,8,1726,858,-40
7418599666,7418599673,7,2679,1232,-40
7419539655,7419539659,4,2137,1263,-40
7420149812,7420149817,5,3624,1874,-40
7424891688,7424891695,7,3083,1576,-40
7432081315,7432081322,7,2186,917,-40
7433015693,7433015699,6,3445,1554,-40
7433213474,7433213480,6,1007,561,-40
7437957674,7437957670,-4,1323,2949,-40
7442417897,7442417902,5,4174,1676,-40
7445897584,7445897585,1,1913,2922,-40
7446595493,7446595501,8,2497,974,-40
7448157666,7448157674,8,2846,955,-40
7451558325,7451558329,4,2724,1018,-40
7454301147,7454301154,7,2287,1351,-40
7457355446,7457355454,8,3388,1336,-40
7461710137,7461710143,6,1712,861,-40
7461792640,7461792626,-14,1156,423,-40
7466102554,7466102561,7,2697,1178,-40
7477002349,7477002354,5,2681,1681,-40
7477546872,7477546878,6,3802,1450,-40
7481004203,7481004207,4,2867,1523,-40
7482533015,7482533022,7,3150,1198,-40
7490873531,7490873538,7,3168,1467,-40
7491487525,7491487530,5,3747,1633,-40
7491666157,7491666163,6,3642,1183,-40
7495724289,7495724296,7,3773,1703,-40
7500097650,7500097656,6,2335,1236,-40
7501738423,7501738431,8,2365,909,-40
7503434309,7503434313,4,1424,976,-40
7504398664,7504398670,6,2449,1359,-40
7504997480,7504997485,5,2881,1298,-40
7505301889,7505301895,6,1654,1140,-40
7513059887,7513059891,4,2923,1127,-40
7519238752,7519238759,7,4235,856,-40
7523317457,7523317463,6,3143,1071,-40
7525611494,7525611503,9,3345,1541,-40
7527655720,7527655726,6,3512,1304,-40
7529694045,7529694051,6,3683,1877,-40
7534109670,7534109677,7,2902,997,-40
7536143343,7536143337,-6,2278,6884,-40
7537277138,7537277147,9,3638,1130,-40
7538755031,7538755038,7,1754,687,-40
7539607317,7539607323,6,2926,1094,-40
7540301573,7540301570,-3,1143,440,-40
7543908351,7543908359,8,2341,850,-40
7545010222,7545010227,5,2133,1447,-40
7548554679,7548554684,5,2070,1144,-40
7553270339,7553270346,7,2586,1280,-40
7553783624,7553783633,9,3316,2385,-40
7554667666,7554667667,1,1338,1104,-40
7555548499,7555548481,-18,1731,475,-40
7555674570,7555674563,-7,1900,10585,-40
7559814620,7559814620,0,25338,33100,-40
7560133624,7560133630,6,1385,811,-40
7560463957,7560463937,-20,2948,889,-40
7562047673,7562047680,7,1733,1131,-40
7562419109,7562419130,21,1245,1122,-40
7562775007,7562775000,-7,2081,44326,-40
7565514789,7565514796,7,2101,1063,-40
7566324739,7566324721,-18,785,248,-40
7566841030,7566841037,7,3615,1734,-40
7576631053,7576631059,6,2771,949,-40
7580697467,7580697475,8,2853,1061,-40
7580738891,7580738873,-18,863,237,-40
7581724319,7581724313,-6,973,4636,-40
7581937330,7581937329,-1,882,1715,-40
7582125402,7582125410,8,3797,849,-40
7593277224,7593277230,6,2808,1152,-40
7603756168,7603756175,7,3314,995,-40
7609765932,7609765939,7,1922,1365,-40
7611956923,7611956931,8,2582,1186,-40
7615032878,7615032884,6,4202,1725,-40
7616369647,7616369653,6,2987,929,-40
7628144407,7628144413,6,2320,637,-40
7630141857,7630141863,6,2687,1029,-40
7632935793,7632935799,6,3223,1507,-40
7633181736,7633181742,6,2681,1120,-40
7635411895,7635411904,9,2677,1282,-40
7637816553,7637816559,6,3754,1340,-40
7639874118,7639874125,7,3655,1910,-40
7644834597,7644834603,6,2739,1416,-40
7653938413,7653938419,6,3346,1522,-40
7655144349,7655144354,5,2789,1598,-40
7659545915,7659545911,-4,1533,2551,-40
7666474716,7666474723,7,3136,1391,-40
7668252828,7668252834,6,2575,1340,-40
7673787482,7673787487,5,2787,1339,-40
7674234751,7674234757,6,3963,1553,-40
7674335199,7674335206,7,3274,1180,-40
7674865423,7674865435,12,989,151,-40
7676114882,7676114886,4,2245,1422,-40
7678029027,7678029034,7,2106,736,-40
7680985614,7680985622,8,2762,1290,-40
7681176172,7681176179,7,1778,1129,-40
7687616034,7687616042,8,1052,467,-40
7688248987,7688248971,-16,1906,848,-40
7689045873,7689045877,4,3011,936,-40
7701897061,7701897067,6,1887,1368,-40
7707276500,7707276506,6,3029,1170,-40
7713013069,7713013073,4,3383,1686,-40
7713552365,7713552370,5,3482,1463,-40
7715032940,7715032945,5,2644,1255,-40
7715573353,7715573353,0,1366,203,-40
7715969601,7715969616,15,2876,1205,-40
7724468687,7724468688,1,1649,2083,-40
7724523600,7724523607,7,2986,1209,-40
7725985178,7725985186,8,2731,1358,-40
7728179735,7728179741,6,4399,2401,-40
7729124771,7729124777,6,2465,1088,-40
7731792273,7731792277,4,1770,1349,-40
7733736365,7733736370,5,2798,881,-40
7733766487,7733766495,8,3674,1260,-40
7736347274,7736347281,7,2612,1519,-40
7737861061,7737861069,8,2263,1240,-40
7742874978,7742874984,6,3584,1707,-40
7746226985,7746226991,6,2655,1096,-40
7746365149,7746365154,5,2988,1546,-40
7747152291,7747152281,-10,1134,129,-40
7748605645,7748605652,7,2629,1022,-40
7752223355,7752223362,7,3558,1104,-40
7753498218,7753498225,7,2883,1403,-40
7753997702,7753997707,5,2356,1047,-40
7760236462,7760236462,0,1270,2168,-40
7760578587,7760578594,7,2509,1025,-40
7760672283,7760672264,-19,2818,1389,-40
7763563316,7763563323,7,2510,1101,-40
7770327124,7770327132,8,5793,1219,-40
7776522995,7776522997,2,2584,2213,-40
7781611941,7781611946,5,2353,1350,-40
7788801213,7788801218,5,2647,906,-40
7789791609,7789791615,6,2190,779,-40
7791616661,7791616666,5,3409,1517,-40
7791662602,7791662604,2,2130,1753,-40
7793767307,7793767313,6,2638,1173,-40
7797763118,7797763126,8,3484,1574,-40
7800381715,7800381721,6,2090,1324,-40
7800564345,7800564351,6,3126,1530,-40
7804980810,7804980815,5,2280,1607,-40
7805397079,7805397091,12,2868,1388,-40
7805932602,7805932609,7,3929,1838,-40
7806657389,7806657368,-21,1965,1005,-40
7806822879,7806822886,7,2894,1319,-40
7811141821,7811141823,2,743,170,-40
7814157163,7814157168,5,2595,1787,-40
7815889938,7815889943,5,1913,827,-40
7816170167,7816170174,7,2217,1273,-40
7817503711,7817503718,7,3963,1553,-40
7818179660,7818179667,7,2103,1050,-40
7818226679,7818226682,3,1864,2174,-40
7820622463,7820622456,-7,2006,10190,-40
7831935898,7831935906,8,3966,1351,-40
7835881381,7835881382,1,3633,3229,-40
7836525111,7836525117,6,2042,1020,-40
7837413356,7837413378,22,682,169,-40
7838965711,7838965718,7,5132,1407,-40
7842282949,7842282954,5,2797,1461,-40
7843080845,7843080832,-13,755,552,-40
7843902757,7843902764,7,2793,1629,-40
7849651987,7849651993,6,2245,934,-40
7849990933,7849990938,5,4561,2040,-40
7852257330,7852257324,-6,881,3916,-40
7856614386,7856614392,6,2602,1071,-40
7856763518,7856763506,-12,1084,172,-40
7857386175,7857386182,7,3809,2135,-40
7858953644,7858953634,-10,1547,1743,-40
7860024974,7860024979,5,3899,2328,-40
7860110862,7860110861,-1,1814,1904,-40
7862480142,7862480147,5,3638,1249,-40
7865647304,7865647309,5,2230,789,-40
7866521785,7866521794,9,2910,1346,-40
7866752270,7866752266,-4,1436,242,-40
7870609256,7870609262,6,1561,1127,-40
7875136821,7875136827,6,2044,1136,-40
7877568438,7877568443,5,3323,1254,-40
7877856620,7877856626,6,1961,995,-40
7877923210,7877923226,16,2731,1294,-40
7879501278,7879501282,4,2390,1418,-40
7881176390,7881176396,6,1966,1089,-40
7881602113,7881602119,6,2129,747,-40
7882804768,7882804776,8,3519,1496,-40
7883058146,7883058146,0,751,59,-40
7883775131,7883775136,5,1789,1871,-40
7884074495,7884074501,6,3669,1943,-40
7890374724,7890374730,6,3629,1568,-40
7898645714,7898645721,7,3092,1663,-40
7902165510,7902165518,8,4044,1604,-40
7902518629,7902518634,5,2328,1031,-40
7903442762,7903442766,4,2022,1039,-40
7906834429,7906834434,5,3121,1307,-40
7908734562,7908734569,7,1818,828,-40
7908957162,7908957170,8,3314,1398,-40
7911507118,7911507125,7,3371,1362,-40
7916840005,7916840013,8,2330,1420,-40
7919326985,7919326991,6,2829,1194,-40
7919507098,7919507104,6,3048,1161,-40
7925543751,7925543755,4,2309,1036,-40
7927381757,7927381765,8,3596,1594,-40
7930566695,7930566702,7,2712,1209,-40
7944403499,7944403505,6,3324,1458,-40
7946935939,7946935933,-6,906,5817,-40
7947109162,7947109168,6,3249,1033,-40
7949021429,7949021436,7,3466,1281,-40
7949104030,7949104019,-11,1282,638,-40
7951744685,7951744682,-3,829,2649,-40
7953203877,7953203876,-1,22848,27711,-40
7956021679,7956021685,6,2874,1647,-40
7957375884,7957375892,8,2743,1269,-40
7961686739,7961686746,7,1892,967,-40
7967880093,7967880099,6,2556,1154,-40
7969634151,7969634158,7,1865,793,-40
7971694668,7971694674,6,2518,826,-40
7978607363,7978607369,6,2654,1188,-40
7983033371,7983033378,7,2332,1549,-40
7986806191,7986806197,6,2904,1512,-40
7987541953,7987541951,-2,986,2325,-40
7988311870,7988311877,7,2719,1433,-40
7991558249,7991558255,6,2688,1803,-40
7996854115,7996854118,3,2343,35753,-40
7997277362,7997277367,5,2937,1000,-40
7997392045,7997392050,5,4912,1102,-40
7997929493,7997929499,6,2878,1527,-40
7998265417,7998265422,5,3386,1643,-40
8000636694,8000636699,5,1368,886,-40
8002258882,8002258886,4,1487,1207,-40
8008500562,8008500544,-18,5586,1000,-40
8016804306,8016804314,8,3834,1070,-40
8017774355,8017774362,7,3070,1509,-40
8019874225,8019874231,6,2165,1379,-40
8020300465,8020300470,5,2521,1169,-40
8025920137,8025920143,6,3075,1157,-40
8027542570,8027542578,8,2674,1435,-40
8027973615,8027973592,-23,888,234,-40
8029916141,8029916133,-8,1346,7124,-40
8030953895,8030953894,-1,1307,1854,-40
8032446947,8032446953,6,2698,1657,-40
8034432369,8034432374,5,2433,1505,-40
8035722211,8035722218,7,2747,930,-40
8035790057,8035790065,8,4638,1541,-40
8036120882,8036120888,6,4042,1944,-40
8036248423,8036248401,-22,1764,680,-40
8039863129,8039863134,5,2696,904,-40
8045064697,8045064705,8,3209,1458,-40
8047854895,8047854902,7,2749,932,-40
8048896542,8048896547,5,3580,1337,-40
8051573973,8051573979,6,3115,916,-40
8052088657,8052088665,8,2958,1443,-40
8054570642,8054570645,3,1580,1053,-40
8058041383,8058041391,8,2255,776,-40
8058368890,8058368897,7,1707,650,-40
8058421770,8058421777,7,3377,1245,-40
8058747834,8058747841,7,2846,906,-40
8062040065,8062040073,8,4262,2055,-40
8063594524,8063594521,-3,1069,2046,-40
8063659106,8063659122,16,518,2426,-40
8068822754,8068822763,9,1865,1075,-40
8070422370,8070422374,4,3230,1662,-40
8077260258,8077260269,11,3154,1156,-40
8078007813,8078007796,-17,963,39,-40
8079250938,8079250940,2,14506,11708,-40
8082982914,8082982919,5,3029,1159,-40
8083857221,8083857226,5,2542,1097,-40
8085267697,8085267703,6,2180,1006,-40
8085640277,8085640298,21,2322,845,-40
8088053020,8088053026,6,3695,1194,-40
8097232498,8097232497,-1,1346,3124,-40
8099167779,8099167787,8,4204,1472,-40
8107612730,8107612735,5,3019,1269,-40
8108711982,8108711986,4,1509,766,-40
8109841460,8109841477,17,959,3273,-40
8110885161,8110885167,6,2863,1287,-40
8115434454,8115434457,3,1207,1402,-40
8115460892,8115460896,4,2000,2381,-40
8117507530,8117507524,-6,1317,3227,-40
8119020804,8119020810,6,3422,1417,-40
8120218079,8120218081,2,1761,1892,-40
8120260557,8120260562,5,2091,910,-40
8120639766,8120639784,18,3113,1981,-40
8124878708,8124878705,-3,1114,2856,-40
8126314501,8126314508,7,3002,1367,-40
8128767675,8128767682,7,2348,1030,-40
8131960749,8131960757,8,2060,1032,-40
8132567698,8132567690,-8,656,177,-40
8140462547,8140462553,6,2823,1222,-40
8143082755,8143082746,-9,24667,13877,-40
8143378059,8143378066,7,3589,1607,-40
8145864707,8145864714,7,2928,1271,-40
8145997259,8145997263,4,2576,1548,-40
8148125230,8148125237,7,3179,1487,-40
8152113919,8152113922,3,2295,1477,-40
8156175158,8156175164,6,2990,1826,-40
8156273521,8156273526,5,2971,982,-40
8161811279,8161811286,7,3518,1258,-40
8165677674,8165677682,8,3523,1479,-40
8165881570,8165881578,8,3542,1486,-40
8168378602,8168378610,8,3245,1447,-40
8172241502,8172241508,6,2285,924,-40
8173740549,8173740555,6,3086,1504,-40
8174464305,8174464311,6,3144,1484,-40
8178474817,8178474822,5,3078,1667,-40
8178851461,8178851467,6,2701,1170,-40
8183511909,8183511910,1,19308,11203,-40
8184482838,8184482846,8,4624,1543,-40
8185231644,8185231642,-2,1229,1871,-40
8185731840,8185731846,6,2865,1820,-40
8186211524,8186211530,6,2675,1564,-40
8187394524,8187394530,6,3991,1274,-40
8191368454,8191368461,7,2552,1616,-40
8197562470,8197562489,19,5683,1194,-40
8203178837,8203178844,7,3803,1265,-40
8205840821,8205840828,7,2863,1343,-40
8207250602,8207250608,6,2280,1185,-40
8211103683,8211103675,-8,24461,12836,-40
8217206372,8217206378,6,2029,1088,-40
8219278384,8219278391,7,3089,1049,-40
8220052667,8220052672,5,3067,1173,-40
8220783281,8220783288,7,3631,1261,-40
8230166298,8230166303,5,3253,1199,-40
8231808050,8231808056,6,3327,1345,-40
8237921367,8237921374,7,4881,1118,-40
8238351362,8238351366,4,2147,1165,-40
8244782055,8244782062,7,2766,1066,-40
8245749032,8245749038,6,2455,1378,-40
8247656913,8247656915,2,2194,1649,-40
8260612110,8260612117,7,2706,1285,-40
8262861821,8262861827,6,2947,1301,-40
8262906673,8262906669,-4,1242,3031,-40
8264054292,8264054298,6,3972,1718,-40
8266549148,8266549154,6,2767,1696,-40
8269186367,8269186375,8,3330,1158,-40
8272242165,8272242170,5,2441,1300,-40
8272500070,8272500050,-20,1518,369,-40
8274396452,8274396458,6,3970,1578,-40
8274876755,8274876762,7,2204,1094,-40
8276361097,8276361091,-6,3345,8510,-40
8277204386,8277204391,5,3416,1447,-40
8277322420,8277322426,6,3551,1372,-40
8278713018,8278713017,-1,1144,1655,-40
8280164465,8280164470,5,3165,965,-40
8280966415,8280966422,7,2444,922,-40
8282840795,8282840801,6,1879,953,-40
8283427155,8283427162,7,3506,1094,-40
8283879743,8283879729,-14,3718,1963,-40
8286137129,8286137137,8,1580,1035,-40
8289781092,8289781098,6,3784,1659,-40
8290190617,8290190623,6,3034,1482,-40
8291069294,8291069301,7,3265,1415,-40
8294739843,8294739848,5,2539,1375,-40
8295109538,8295109545,7,3861,1454,-40
8295306440,8295306447,7,2886,1524,-40
8299744201,8299744206,5,1990,1044,-40
8302095994,8302095991,-3,1003,3760,-40
8309910933,8309910928,-5,3702,7123,-40
8316740579,8316740587,8,2537,1310,-40
8318024167,8318024171,4,1860,1042,-40
8320358995,8320359002,7,2686,1090,-40
8321779144,8321779150,6,3812,1535,-40
8326469114,8326469114,0,2364,1892,-40
8327377814,8327377822,8,3439,1206,-40
8329098362,8329098367,5,3563,1427,-40
8329174050,8329174055,5,3871,1327,-40
8329768369,8329768373,4,2334,1340,-40
8331748129,8331748135,6,2726,1548,-40
8333331014,8333331021,7,2984,1524,-40
8335451933,8335451939,6,2486,1180,-40
8339218107,8339218113,6,2808,1091,-40
8339723157,8339723144,-13,875,232,-40
8342115562,8342115558,-4,1133,3057,-40
8342621844,8342621844,0,2837,3979,-40
8347237282,8347237287,5,2723,1459,-40
8352001748,8352001754,6,2790,1191,-40
8353294213,8353294212,-1,6321,15513,-40
8354549657,8354549663,6,2373,916,-40
8359042783,8359042790,7,2839,1344,-40
8359367933,8359367938,5,2726,1308,-40
8360818393,8360818376,-17,2556,1013,-40
8362430869,8362430874,5,2577,1140,-40
8365177042,8365177048,6,2137,1013,-40
8365331459,8365331441,-18,1737,868,-40
8366555638,8366555644,6,2227,1267,-40
8366870411,8366870404,-7,671,274,-40
8367514712,8367514717,5,2044,859,-40
8369944296,8369944302,6,3338,1413,-40
8370223326,8370223333,7,2958,1250,-40
8373794641,8373794647,6,3203,1175,-40
8374919938,8374919943,5,2558,1472,-40
8376935622,8376935629,7,3392,1327,-40
8383151575,8383151579,4,3996,1879,-40
8386461878,8386461883,5,2218,1254,-40
8393654252,8393654259,7,2994,1386,-40
8393735405,8393735400,-5,18084,14138,-40
8393781236,8393781243,7,3113,1037,-40
8396875926,8396875930,4,1717,1283,-40
8409018695,8409018701,6,3037,1454,-40
8409231809,8409231816,7,3007,1317,-40
8409484805,8409484810,5,1409,668,-40
8413908706,8413908712,6,2657,1370,-40
8414331684,8414331664,-20,1237,600,-40
8415540205,8415540212,7,4108,1218,-40
8420322855,8420322861,6,2552,1319,-40
8420574637,8420574644,7,3003,1423,-40
8420825238,8420825235,-3,1136,1932,-40
8423636145,8423636151,6,3537,1604,-40
8426476813,8426476819,6,2233,1522,-40
8428503641,8428503643,2,1673,2078,-40
8429395734,8429395731,-3,1695,3019,-40
8430240481,8430240482,1,1539,1516,-40
8436900679,8436900683,4,2846,1047,-40
8437367383,8437367360,-23,676,193,-40
8440374853,8440374859,6,3271,1240,-40
8441649114,8441649121,7,2571,1392,-40
8449767089,8449767098,9,3014,1341,-40
8458310518,8458310523,5,2164,1649,-40
8459653619,8459653629,10,1418,704,-40
8460188234,8460188238,4,2488,1060,-40
8464186296,8464186304,8,4090,1590,-40
8465798750,8465798753,3,1968,1227,-40
8465885940,8465885946,6,2327,1414,-40
8467407870,8467407862,-8,2163,32876,-40
8468610707,8468610713,6,6900,35482,-40
8472608295,8472608303,8,2437,1320,-40
8472779397,8472779395,-2,1390,175,-40
8475647600,8475647606,6,3159,1136,-40
8476005117,8476005128,11,3190,1294,-40
8478644986,8478644991,5,2574,991,-40
8478784566,8478784544,-22,2710,868,-40
8481421346,8481421354,8,2741,1078,-40
8482006893,8482006880,-13,1072,253,-40
8482546394,8482546398,4,2304,1118,-40
8489714904,8489714900,-4,1738,4598,-40
8493532528,8493532534,6,3983,1377,-40
8498635703,8498635707,4,1543,1007,-40
8500945245,8500945250,5,3159,1304,-40
8504445122,8504445127,5,3018,1141,-40
8504546498,8504546503,5,2680,1299,-40
8504939858,8504939865,7,2512,1387,-40
8506136473,8506136478,5,2844,1134,-40
8510229593,8510229598,5,2655,1430,-40
8513812710,8513812714,4,2142,1344,-40
8515386876,8515386883,7,3216,1051,-40
8519250128,8519250134,6,4198,1493,-40
8520010826,8520010810,-16,1323,523,-40
8524667617,8524667615,-2,1420,2319,-40
8525329998,8525330003,5,2627,1048,-40
8525397871,8525397877,6,1906,613,-40
8525585466,8525585463,-3,1020,1489,-40
8527926853,8527926858,5,2810,1496,-40
8528408027,8528408031,4,2105,1855,-40
8532178900,8532178905,5,3846,1842,-40
8534575337,8534575334,-3,935,3340,-40
8537571612,8537571618,6,2347,1404,-40
8539776127,8539776128,1,8452,8882,-40
8543663494,8543663501,7,3115,954,-40
8544694174,8544694169,-5,1150,4537,-40
8545623910,8545623907,-3,1659,1963,-40
8547839254,8547839260,6,2885,1288,-40
8548704221,8548704225,4,2573,1026,-40
8549874133,8549874139,6,3162,1548,-40
8552219771,8552219777,6,3883,1466,-40
8553864414,8553864414,0,2183,1877,-40
8556133972,8556133977,5,3094,1331,-40
8562627796,8562627802,6,2265,1078,-40
8564778965,8564778972,7,2529,1134,-40
8571139817,8571139823,6,1908,1298,-40
8573342461,8573342471,10,2937,1085,-40
8576562947,8576562953,6,3264,1184,-40
8577064653,8577064648,-5,1276,2401,-40
8582771885,8582771890,5,2462,1213,-40
8584760671,8584760675,4,2552,1329,-40
8585452970,8585452974,4,2719,1780,-40
8586755262,8586755270,8,2275,1134,-40
8589858800,8589858806,6,3469,1530,-40
8590381814,8590381819,5,2450,729,-40
8594404198,8594404206,8,4509,1395,-40
8596132493,8596132498,5,2941,1229,-40
8596517238,8596517242,4,1654,1491,-40
8596707222,8596707229,7,3492,1668,-40
8600078192,8600078198,6,2442,1208,-40
8600450641,8600450648,7,1036,102,-40
8603740298,8603740303,5,2622,1221,-40
8605803849,8605803856,7,2972,804,-40
8606257109,8606257115,6,2275,991,-40
8607004262,8607004266,4,1796,1363,-40
8607222566,8607222546,-20,585,199,-40
8607676041,8607676045,4,2679,1144,-40
8608869338,8608869344,6,2997,1689,-40
8609087731,8609087737,6,2185,1457,-40
8613699435,8613699437,2,1845,1260,-40
8615101155,8615101162,7,3713,916,-40
8623803337,8623803343,6,2732,1384,-40
8624997706,8624997714,8,4505,1528,-40
8626108705,8626108710,5,2740,1366,-40
8627227184,8627227190,6,3214,1373,-40
8627533981,8627533985,4,3058,1574,-40
8631090354,8631090350,-4,24319,9573,-40
8633808881,8633808887,6,3279,1098,-40
8636647945,8636647950,5,2275,862,-40
8638059593,8638059603,10,2981,1194,-40
8639481284,8639481291,7,2410,1380,-40
8642282450,8642282456,6,2280,1335,-40
8643589273,8643589277,4,2959,1591,-40
8644531965,8644531970,5,2612,1022,-40
8646793152,8646793158,6,2778,820,-40
8655718265,8655718270,5,2260,1108,-40
8657864081,8657864086,5,2611,1366,-40
8658952779,8658952785,6,1813,1205,-40
8659280358,8659280363,5,2754,859,-40
8661012229,8661012235,6,3301,1105,-40
8661816204,8661816208,4,3316,1305,-40
8662803579,8662803585,6,3462,1484,-40
8662992344,8662992345,1,1935,1583,-40
8663112526,8663112531,5,2745,1069,-40
8664919394,8664919401,7,2523,1734,-40
8670414489,8670414495,6,2883,1712,-40
8672302600,8672302606,6,3205,1343,-40
8673113312,8673113318,6,2121,1115,-40
8674212166,8674212173,7,2221,1285,-40
8680002418,8680002423,5,3369,1000,-40
8680518888,8680518873,-15,2182,1094,-40
8685990501,8685990507,6,2308,1298,-40
8687814566,8687814573,7,2271,1508,-40
8689020926,8689020933,7,2741,1490,-40
8698493304,8698493310,6,3760,2048,-40
8702519594,8702519602,8,2545,1248,-40
8706931593,8706931597,4,1225,835,-40
8713623570,8713623575,5,2436,1481,-40
8714535039,8714535036,-3,2366,4864,-40
8714790000,8714790006,6,3412,1724,-40
8715046894,8715046901,7,2706,1072,-40
8717175698,8717175698,0,1813,2226,-40
8718083420,8718083427,7,2653,1679,-40
8718843687,8718843674,-13,745,328,-40
8720552552,8720552560,8,2713,1366,-40
8722850957,8722850962,5,6985,2909,-40
8723440461,8723440467,6,1990,983,-40
8725958874,8725958881,7,2300,1827,-40
8727657317,8727657321,4,1707,1616,-40
8731323558,8731323563,5,1463,1075,-40
8735884473,8735884478,5,2530,1204,-40
8741128651,8741128648,-3,526,1265,-40
8744421942,8744421948,6,2406,1368,-40
8745769952,8745769957,5,2500,998,-40
8745966291,8745966290,-1,23619,18116,-40
8749518215,8749518222,7,2833,931,-40
8751599062,8751599067,5,3028,1089,-40
8752366210,8752366205,-5,2162,2620,-40
8753596043,8753596049,6,3676,1975,-40
8756539389,8756539396,7,3219,1551,-40
8757220113,8757220118,5,3755,1846,-40
8760054068,8760054073,5,2040,1415,-40
8761189893,8761189899,6,2183,974,-40
8762543949,8762543954,5,2176,1262,-40
8764407684,8764407690,6,2651,1107,-40
8764590079,8764590085,6,3921,1657,-40
8772779926,8772779932,6,2480,1114,-40
8773707714,8773707720,6,3168,943,-40
8774481298,8774481303,5,2733,1192,-40
8789984506,8789984511,5,3371,1700,-40
8790806449,8790806454,5,2194,1210,-40
8791723966,8791723973,7,2002,1119,-40
8792080711,8792080715,4,2983,990,-40
8792868921,8792868927,6,2475,1203,-40
8793786381,8793786389,8,4274,1730,-40
8805784329,8805784337,8,4527,1442,-40
8807614996,8807615003,7,2104,826,-40
8810688846,8810688850,4,2000,907,-40
8811471601,8811471606,5,2793,910,-40
8813602078,8813602082,4,1530,1709,-40
8813963646,8813963650,4,3006,1692,-40
8817503138,8817503143,5,2476,1154,-40
8820224125,8820224131,6,3791,1676,-40
8821802549,8821802554,5,2064,1105,-40
8822335081,8822335088,7,3195,1365,-40
8824052187,8824052195,8,2670,1074,-40
8829354514,8829354519,5,2216,800,-40
8840223547,8840223554,7,3880,1148,-40
8840685593,8840685578,-15,1171,448,-40
8840995417,8840995421,4,2449,1561,-40
8845602741,8845602748,7,2207,988,-40
8848504915,8848504919,4,1930,923,-40
8851011814,8851011815,1,1789,1913,-40
8855205568,8855205575,7,6593,1412,-40
8855738057,8855738066,9,2541,1319,-40
8856598856,8856598863,7,1829,1070,-40
8862524358,8862524363,5,3003,1134,-40
8863113135,8863113142,7,3111,1400,-40
8864942918,8864942927,9,3312,1120,-40
8865305904,8865305921,17,3410,1475,-40
8865891663,8865891670,7,2963,1658,-40
8867256329,8867256336,7,3486,1050,-40
8873701394,8873701402,8,3565,1443,-40
8877119485,8877119486,1,1654,1578,-40
8880571669,8880571676,7,2943,1238,-40
8884465768,8884465775,7,1760,1109,-40
8886425294,8886425301,7,2825,951,-40
8886822433,8886822424,-9,666,44,-40
8889820614,8889820622,8,4081,1811,-40
8901199466,8901199471,5,1616,948,-40
8903215181,8903215187,6,2911,1188,-40
8903783506,8903783516,10,14537,59859,-40
8906371349,8906371345,-4,1755,6028,-40
8909228450,8909228454,4,2152,1517,-40
8911078407,8911078415,8,2936,875,-40
8911290187,8911290194,7,2022,1069,-40
8916532044,8916532050,6,2978,1042,-40
8916723949,8916723953,4,2682,1882,-40
8923495185,8923495166,-19,1390,1768,-40
8923857649,8923857655,6,3594,1567,-40
8926913678,8926913682,4,1678,1361,-40
8927141881,8927141886,5,1378,703,-40
8928479902,8928479909,7,2837,1399,-40
8930383602,8930383610,8,2224,1092,-40
8930465439,8930465443,4,2745,1719,-40
8930787194,8930787201,7,3706,1335,-40
8931500742,8931500748,6,3910,1762,-40
8932075217,8932075221,4,2869,1505,-40
8933411602,8933411609,7,1956,834,-40
8934070697,8934070704,7,2716,1421,-40
8938232726,8938232732,6,3662,1190,-40
8939979253,8939979258,5,2304,1253,-40
8943099554,8943099561,7,3265,1059,-40
8943738803,8943738810,7,3961,1694,-40
8945832816,8945832821,5,2698,1153,-40
8951001532,8951001538,6,4652,1334,-40
8955801051,8955801058,7,1870,1123,-40
8959581524,8959581530,6,2460,1351,-40
8961818825,8961818833,8,2223,1042,-40
8965654442,8965654446,4,3237,1542,-40
8969376394,8969376400,6,2844,1290,-40
8970410822,8970410829,7,2666,985,-40
8972968191,8972968197,6,2179,1045,-40
8975382320,8975382326,6,2184,1047,-40
8977032184,8977032191,7,4109,1345,-40
8977708881,8977708887,6,2318,1142,-40
8978610250,8978610255,5,2750,1254,-40
8978902834,8978902841,7,3340,1204,-40
8979141782,8979141764,-18,1460,355,-40
8979459792,8979459793,1,986,1253,-40
8983513558,8983513564,6,1269,990,-40
8995010329,8995010335,6,2477,1283,-40
8995807234,8995807239,5,3052,1602,-40
8998388526,8998388516,-10,59933,30885,-40
8998757204,8998757201,-3,7670,17839,-40
8999255063,8999255069,6,3607,1842,-40
9003566354,9003566354,0,2433,3757,-40
9006033040,9006033022,-18,1474,958,-40
9009539457,9009539462,5,2435,1361,-40
9009574807,9009574808,1,1021,358,-40
9010438282,9010438290,8,4234,1703,-40
9013723005,9013723004,-1,1331,2300,-40
9015156465,9015156473,8,4102,1733,-40
9020425318,9020425323,5,2065,1666,-40
9020673277,9020673282,5,3380,1710,-40
9020932104,9020932123,19,662,236,-40
9021239596,9021239602,6,1632,989,-40
9021291674,9021291657,-17,2115,627,-40
9022618439,9022618445,6,3733,1785,-40
9028374517,9028374523,6,2700,1395,-40
9030733303,9030733309,6,6631,927,-40
9031910319,9031910325,6,2628,1319,-40
9034684434,9034684438,4,1738,1521,-40
9036117706,9036117709,3,2487,1385,-40
9036226794,9036226797,3,1257,1541,-40
9038698538,9038698546,8,2789,1442,-40
9039001510,9039001518,8,3191,1219,-40
9039575794,9039575808,14,2858,1289,-40
9045255107,9045255115,8,11101,20364,-40
9050536973,9050536978,5,2336,1402,-40
9051899441,9051899447,6,1353,580,-40
9052319814,9052319821,7,1568,598,-40
9052789551,9052789557,6,2846,904,-40
9054234958,9054234962,4,800,710,-40
9055783609,9055783616,7,3120,1378,-40
9056009213,9056009193,-20,922,340,-40
9062221713,9062221721,8,2623,1386,-40
9063489361,9063489378,17,769,272,-40
9064153794,9064153801,7,3465,1616,-40
9074221541,9074221546,5,2062,1150,-40
9074288402,9074288410,8,2387,1219,-40
9076227501,9076227505,4,5186,3090,-40
9077864683,9077864683,0,3046,4166,-40
9078770537,9078770543,6,2764,1214,-40
9085667985,9085667991,6,3173,1773,-40
9086887330,9086887337,7,3607,1474,-40
9087825441,9087825447,6,2761,1636,-40
9088049096,9088049093,-3,908,2242,-40
9088408155,9088408159,4,44229,32951,-40
9094344706,9094344711,5,2623,1371,-40
9098223582,9098223589,7,3264,1026,-40
9106153023,9106153030,7,3174,1441,-40
9108113505,9108113510,5,1382,1071,-40
9109816105,9109816112,7,3130,1457,-40
9114534403,9114534394,-9,1252,6384,-40
9116956674,9116956681,7,2336,861,-40
9117785602,9117785610,8,2713,998,-40
9123835594,9123835602,8,2866,920,-40
9124267010,9124267015,5,2923,1159,-40
9126267623,9126267630,7,3111,1008,-40
9126505244,9126505244,0,1404,2173,-40
9127379537,9127379541,4,2273,1263,-40
9127582854,9127582860,6,3781,1577,-40
9128901162,9128901170,8,2800,1677,-40
9129276383,9129276389,6,3814,1139,-40
9129933606,9129933614,8,2848,811,-40
9130611793,9130611778,-15,2392,845,-40
9132667210,9132667210,0,1182,2032,-40
9133066443,9133066449,6,3870,1387,-40
9136804369,9136804374,5,3523,1192,-40
9141277735,9141277740,5,2500,1681,-40
9141435660,9141435682,22,2719,1207,-40
9143627266,9143627271,5,2923,1314,-40
9145884825,9145884830,5,1763,883,-40
9152091903,9152091909,6,2574,1483,-40
9153291663,9153291669,6,1998,1206,-40
9155275645,9155275648,3,2190,1139,-40
9155671242,9155671251,9,2854,1177,-40
9157567903,9157567906,3,1977,1264,-40
9157731375,9157731377,2,1682,1870,-40
9158251150,9158251157,7,3673,1371,-40
9161010427,9161010433,6,3793,1422,-40
9163623647,9163623653,6,2415,1380,-40
9168709093,9168709101,8,3080,1153,-40
9171293826,9171293833,7,4442,1883,-40
9171653809,9171653808,-1,868,179,-40
9174095030,9174095036,6,1717,1083,-40
9176217542,9176217549,7,2819,1285,-40
9179564226,9179564231,5,2226,1309,-40
9180819246,9180819253,7,2663,1626,-40
9184933987,9184933993,6,3100,1313,-40
9187587033,9187587040,7,1237,890,-40
9189067667,9189067673,6,2105,914,-40
9189438179,9189438162,-17,692,95,-40
9189543093,9189543088,-5,1302,2853,-40
9194782640,9194782646,6,2946,1206,-40
9198729863,9198729869,6,3803,1469,-40
9199959845,9199959849,4,1619,915,-40
9200371089,9200371089,0,879,212,-40
9200822374,9200822363,-11,1377,504,-40
9201592217,9201592223,6,2348,1148,-40
9201621731,9201621715,-16,2573,802,-40
9216657172,9216657179,7,3089,1285,-40
9218610105,9218610111,6,1278,877,-40
9222141425,9222141430,5,2913,1261,-40
9222837683,9222837690,7,2539,1182,-40
9227750877,9227750885,8,2543,1157,-40
9228342644,9228342651,7,3024,1018,-40
9228642090,9228642095,5,2610,1004,-40
9230047323,9230047330,7,2421,1142,-40
9232859457,9232859462,5,3214,1631,-40
9234638570,9234638577,7,2512,1032,-40
9235036838,9235036858,20,829,332,-40
9236272821,9236272826,5,2478,1373,-40
9240100699,9240100706,7,3356,1240,-40
9242023410,9242023394,-16,1145,541,-40
9246573717,9246573724,7,2656,1718,-40
9250037566,9250037575,9,2696,978,-40
9256278554,9256278559,5,3186,1488,-40
9256775110,9256775115,5,3006,1216,-40
9265579773,9265579774,1,8052,7581,-40
9265997246,9265997246,0,1425,1163,-40
9268200645,9268200653,8,3102,854,-40
9268664705,9268664692,-13,1511,438,-40
9269799327,9269799333,6,1990,959,-40
9270721373,9270721374,1,1618,1471,-40
9270811534,9270811539,5,2611,951,-40
9273487770,9273487765,-5,931,3019,-40
9278976274,9278976279,5,1742,1113,-40
9279399213,9279399220,7,5914,1475,-40
9281774321,9281774323,2,2034,1599,-40
9283003057,9283003064,7,4009,1508,-40
9284154070,9284154077,7,3937,1553,-40
9287751942,9287751947,5,3187,1147,-40
9289402207,9289402214,7,3395,1627,-40
9290219166,9290219171,5,2842,1143,-40
9293908902,9293908907,5,2406,1442,-40
9298204186,9298204171,-15,1283,353,-40
9302958933,9302958938,5,2056,1485,-40
9303253439,9303253442,3,1698,1049,-40
9308500183,9308500191,8,3681,881,-40
9309225170,9309225153,-17,1003,110,-40
9315868729,9315868735,6,2644,1134,-40
9316697583,9316697589,6,2656,1361,-40
9317972468,9317972474,6,3481,1765,-40
9318784413,9318784417,4,3008,1256,-40
9324820017,9324820023,6,2889,942,-40
9326066088,9326066093,5,3088,2016,-40
9327183551,9327183554,3,1496,29935,-40
9327283937,9327283942,5,2140,1195,-40
9328677325,9328677326,1,1458,868,-40
9329707820,9329707826,6,2359,1085,-40
9329808453,9329808458,5,3698,1766,-40
9330178230,9330178237,7,3202,1380,-40
9330706182,9330706190,8,3726,1692,-40
9331830629,9331830636,7,3009,1574,-40
9331889595,9331889603,8,604,321,-40
9336414498,9336414506,8,3089,1109,-40
9338359050,9338359058,8,2288,785,-40
9339288658,9339288667,9,4531,1345,-40
9339640158,9339640147,-11,950,334,-40
9340819064,9340819071,7,2886,1140,-40
9342337632,9342337618,-14,2918,818,-40
9343870862,9343870869,7,3172,1402,-40
9349067641,9349067646,5,2436,1173,-40
9349449100,9349449107,7,2252,1349,-40
9350169918,9350169896,-22,994,475,-40
9352042748,9352042754,6,3126,1467,-40
9355482142,9355482146,4,1354,674,-40
9357296458,9357296444,-14,956,247,-40
9358737935,9358737943,8,1980,1089,-40
9364998978,9364998985,7,3381,1300,-40
9366381798,9366381794,-4,1334,2959,-40
9369457111,9369457119,8,3271,1586,-40
9369537902,9369537920,18,1038,356,-40
9370061668,9370061675,7,2745,937,-40
9381510578,9381510583,5,2347,1402,-40
9385047843,9385047850,7,2068,1288,-40
9386120659,9386120665,6,3020,1456,-40
9389722694,9389722702,8,2991,1278,-40
9390762830,9390762834,4,2331,1611,-40
9391417886,9391417887,1,1309,1244,-40
9395257897,9395257901,4,1053,1546,-40
9397523973,9397523975,2,1883,2126,-40
9398738124,9398738130,6,4051,1452,-40
9406055022,9406055027,5,2123,1786,-40
9406866228,9406866234,6,2259,1186,-40
9412425242,9412425249,7,3911,1587,-40
9413338232,9413338235,3,3151,3131,-40
9413541863,9413541866,3,9005,8232,-40
9415005027,9415005034,7,3114,1379,-40
9416074130,9416074135,5,3354,1061,-40
9418258229,9418258235,6,3164,1639,-40
9420084356,9420084362,6,3371,1569,-40
9428102344,9428102351,7,2828,1766,-40
9429794100,9429794094,-6,30484,15061,-40
9430180097,9430180099,2,1439,936,-40
9431390405,9431390410,5,2776,1382,-40
9431452462,9431452467,5,1469,760,-40
9433277078,9433277083,5,2430,920,-40
9436113297,9436113302,5,2952,1773,-40
9437174799,9437174807,8,2324,1358,-40
9437558121,9437558108,-13,3083,990,-40
9445921249,9445921253,4,2079,1141,-40
9447751662,9447751669,7,3569,1540,-40
9451117545,9451117551,6,3413,1362,-40
9452491111,9452491117,6,1843,1040,-40
9453887138,9453887146,8,2773,1185,-40
9455190761,9455190766,5,2567,1376,-40
9457218879,9457218885,6,3311,1689,-40
9458570170,9458570172,2,2495,2439,-40
9459591866,9459591871,5,2420,1263,-40
9460345110,9460345106,-4,630,353,-40
9461657150,9461657157,7,3577,1444,-40
9462032695,9462032680,-15,1318,395,-40
9466443838,9466443844,6,2447,1377,-40
9466646128,9466646134,6,3244,1227,-40
9472711608,9472711613,5,2688,1085,-40
9473207585,9473207591,6,3473,1492,-40
9477050044,9477050050,6,4106,1621,-40
9480933942,9480933949,7,3631,1082,-40
9483273027,9483273033,6,2881,1499,-40
9486139258,9486139264,6,2154,1591,-40
9492140542,9492140549,7,2923,1308,-40
9493328022,9493328027,5,2671,1033,-40
9498196585,9498196578,-7,1582,7836,-40
9501587738,9501587742,4,3227,1485,-40
9502609397,9502609402,5,3227,1474,-40
9503823922,9503823929,7,2181,1015,-40
9505234431,9505234439,8,2969,1506,-40
9507519009,9507519005,-4,22838,45546,-40
9511641053,9511641058,5,2762,1115,-40
9515398415,9515398422,7,3355,1351,-40
9519156911,9519156906,-5,19938,16784,-40
9524834461,9524834481,20,2536,1007,-40
9525715473,9525715479,6,3156,1261,-40
9528036786,9528036795,9,4132,1513,-40
9530839086,9530839091,5,2876,1938,-40
9536738616,9536738622,6,3386,1367,-40
9537490433,9537490438,5,3695,1124,-40
9540577879,9540577886,7,3150,1529,-40
9542331765,9542331748,-17,2852,1121,-40
9546681033,9546681041,8,3360,1443,-40
9554396207,9554396211,4,2418,1154,-40
9558737695,9558737700,5,4125,1669,-40
9564184181,9564184187,6,2616,975,-40
9564441809,9564441825,16,2020,1194,-40
9570826338,9570826347,9,1607,920,-40
9579015619,9579015626,7,1297,957,-40
9580142943,9580142947,4,2111,1535,-40
9581770097,9581770103,6,2205,742,-40
9585382117,9585382125,8,2991,1291,-40
9585781369,9585781365,-4,7160,16969,-40
9592876954,9592876958,4,2136,1302,-40
9594825245,9594825250,5,2785,1383,-40
9596416821,9596416827,6,2680,1389,-40
9602621477,9602621482,5,3151,1929,-40
9603961785,9603961793,8,2426,1166,-40
9605416688,9605416695,7,2499,1073,-40
9606250084,9606250081,-3,2474,6907,-40
9608538112,9608538117,5,1667,1621,-40
9612162063,9612162070,7,2746,1143,-40
9613895377,9613895382,5,2808,1220,-40
9613996258,9613996264,6,2260,1283,-40
9616814167,9616814173,6,3294,1792,-40
9617332409,9617332415,6,4558,1441,-40
9618719398,9618719378,-20,3141,1106,-40
9623523577,9623523583,6,2753,1446,-40
9625246658,9625246665,7,3160,1214,-40
9629952170,9629952151,-19,855,418,-40
9632445074,9632445082,8,3442,1042,-40
9633302155,9633302162,7,20773,47973,-40
9634554040,9634554046,6,2833,1168,-40
9634750511,9634750516,5,584,753,-40
9636132842,9636132847,5,2088,1137,-40
9641912656,9641912662,6,3138,903,-40
9641993878,9641993896,18,2599,1298,-40
9643033341,9643033347,6,3567,1305,-40
9644195409,9644195415,6,3059,969,-40
9645385949,9645385955,6,1789,903,-40
9646159598,9646159594,-4,23895,58439,-40
9647029210,9647029208,-2,1493,2809,-40
9648676929,9648676935,6,4075,1358,-40
9649367965,9649367970,5,3255,1732,-40
9649848662,9649848669,7,3157,1963,-40
9651266194,9651266201,7,2757,1847,-40
9651697120,9651697125,5,2916,1737,-40
9652554525,9652554531,6,2933,1446,-40
9654052414,9654052394,-20,2266,989,-40
9654282550,9654282555,5,2934,1231,-40
9654992184,9654992190,6,3776,1350,-40
9655604753,9655604759,6,2323,1468,-40
9658091453,9658091459,6,3122,1224,-40
9672136157,9672136163,6,3730,1429,-40
9679585350,9679585357,7,2397,1376,-40
9683209390,9683209389,-1,1529,1895,-40
9684287206,9684287200,-6,29554,15840,-40
9685765891,9685765896,5,2654,1246,-40
9694227354,9694227361,7,2973,1691,-40
9695639886,9695639891,5,3435,2333,-40
9700998774,9700998781,7,2826,1201,-40
9702161488,9702161479,-9,1389,321,-40
9706117887,9706117892,5,3198,1538,-40
9706318749,9706318755,6,2891,1101,-40
9708888870,9708888856,-14,1301,26774,-40
9709852931,9709852937,6,2055,1236,-40
9715571199,9715571206,7,3469,1101,-40
9717649958,9717649963,5,3062,1262,-40
9718837145,9718837150,5,1735,1348,-40
9724704609,9724704613,4,1839,1161,-40
9731206238,9731206244,6,2472,1389,-40
9736285013,9736285018,5,1469,1185,-40
9736350531,9736350513,-18,1058,691,-40
9741121490,9741121496,6,2395,1142,-40
9741458430,9741458437,7,2620,965,-40
9742468865,9742468870,5,1904,1488,-40
9743005679,9743005686,7,3912,1496,-40
9745318680,9745318687,7,3619,1392,-40
9745598386,9745598398,12,2889,1271,-40
9745709102,9745709109,7,2817,1183,-40
9746981514,9746981522,8,2199,1189,-40
9747206777,9747206761,-16,1250,258,-40
9750439374,9750439380,6,3192,1455,-40
9752034593,9752034600,7,2691,966,-40
9754778308,9754778313,5,2719,1755,-40
9760876182,9760876190,8,2664,1409,-40
9766445184,9766445191,7,2621,1497,-40
9769214892,9769214886,-6,1645,8429,-40
9771705809,9771705815,6,2830,1225,-40
9776270062,9776270069,7,3015,1785,-40
9779483081,9779483086,5,3557,1405,-40
9787799372,9787799377,5,3189,1276,-40
9789969099,9789969106,7,1600,775,-40
9791839476,9791839477,1,1049,1984,-40
9795335596,9795335602,6,3697,1425,-40
9803567805,9803567813,8,3716,1554,-40
9809465966,9809465974,8,4632,1774,-40
9810949514,9810949518,4,2579,1531,-40
9813389047,9813389049,2,250,1795,-40
9813948014,9813948023,9,2927,1146,-40
9816754585,9816754590,5,2138,1214,-40
9816788915,9816788928,13,2806,1537,-40
9819181486,9819181493,7,4309,1753,-40
9820138621,9820138626,5,3663,1343,-40
9821228910,9821228915,5,2300,926,-40
9823975877,9823975882,5,2093,833,-40
9826732576,9826732581,5,39272,46233,-40
9828689910,9828689916,6,3197,959,-40
9831703480,9831703482,2,1677,1992,-40
9832807781,9832807787,6,2769,1121,-40
9833226612,9833226618,6,2883,1271,-40
9835358550,9835358555,5,2946,1164,-40
9840715115,9840715122,7,2402,963,-40
9843497683,9843497690,7,3138,1812,-40
9844751057,9844751063,6,3235,1442,-40
9845370154,9845370158,4,1730,866,-40
9847996305,9847996311,6,2532,1338,-40
9852539889,9852539895,6,2748,864,-40
9855516818,9855516826,8,2727,1245,-40
9855988563,9855988558,-5,988,4420,-40
9859637281,9859637287,6,2925,1413,-40
9860986153,9860986158,5,4347,1390,-40
9861143007,9861143003,-4,1263,2179,-40
9862098462,9862098468,6,2804,1346,-40
9862358375,9862358362,-13,895,284,-40
9863505347,9863505352,5,1647,1871,-40
9863929886,9863929885,-1,1178,1747,-40
9864539347,9864539351,4,2869,1326,-40
9869808952,9869808960,8,2110,1734,-40
9873471636,9873471642,6,3130,1831,-40
9874350629,9874350635,6,4075,1701,-40
9879720541,9879720546,5,1995,1167,-40
9880463574,9880463562,-12,883,395,-40
9881344450,9881344457,7,2081,870,-40
9884323881,9884323886,5,1659,1570,-40
9889686190,9889686197,7,3290,949,-40
9894902304,9894902310,6,3107,1392,-40
9898518454,9898518460,6,3435,1019,-40
9901160238,9901160246,8,2543,1068,-40
9901514240,9901514246,6,2796,1324,-40
9901854194,9901854201,7,3943,1496,-40
9904297791,9904297797,6,2504,1042,-40
9904966776,9904966783,7,2481,1281,-40
9905711073,9905711088,15,2650,1080,-40
9908285423,9908285430,7,2370,1010,-40
9910196606,9910196586,-20,3433,1142,-40
9919884416,9919884423,7,1542,997,-40
9920050679,9920050668,-11,545,244,-40
9923062813,9923062818,5,1846,976,-40
9924335761,9924335767,6,2958,1216,-40
9925903454,9925903462,8,2137,1095,-40
9926284598,9926284603,5,3973,1962,-40
9930852547,9930852554,7,3209,1422,-40
9931361586,9931361593,7,2549,1500,-40
9935775943,9935775949,6,3128,1166,-40
9939781244,9939781250,6,1748,828,-40
9947650421,9947650426,5,2559,1218,-40
9948876207,9948876212,5,2873,1730,-40
9949352841,9949352846,5,2460,1248,-40
9952979948,9952979948,0,34754,15753,-40
9955649773,9955649779,6,1762,832,-40
9956408293,9956408299,6,3072,1245,-40
9957160059,9957160065,6,2676,1429,-40
9958546527,9958546530,3,2148,1471,-40
9960495957,9960495964,7,4495,1470,-40
9961423259,9961423264,5,2489,1507,-40
9970856443,9970856451,8,2877,1057,-40
9971555874,9971555879,5,2181,876,-40
9971948375,9971948382,7,2994,1240,-40
9977522502,9977522510,8,2051,714,-40
9977735770,9977735771,1,1155,1206,-40
9978756926,9978756948,22,2362,1294,-40
9979062426,9979062431,5,2373,1611,-40
9981927906,9981927910,4,2715,2018,-40
9984016749,9984016753,4,2373,1126,-40
9986984227,9986984225,-2,2083,4971,-40
9988349979,9988349985,6,2320,1472,-40
9989809978,9989809986,8,5176,1578,-40
9989867197,9989867206,9,3067,1047,-40
9990149664,9990149670,6,3007,1277,-40
9992960437,9992960443,6,2919,1495,-40
9993485446,9993485450,4,2467,1028,-40
10002755618,10002755620,2,8293,6231,-40
10004606350,10004606357,7,2051,817,-40
10010268177,10010268183,6,2326,1215,-40
10015339772,10015339780,8,3219,1291,-40
10021931899,10021931905,6,2885,1393,-40
10023674569,10023674577,8,3485,1155,-40
10028209634,10028209641,7,3297,1733,-40
10028507234,10028507216,-18,1309,636,-40
10031237987,10031237981,-6,27932,9120,-40
10031630509,10031630514,5,3532,1637,-40
10041079305,10041079311,6,1927,841,-40
10041235875,10041235885,10,2694,1077,-40
10043539617,10043539622,5,2216,968,-40
10045492962,10045492968,6,1240,499,-40
10046932074,10046932079,5,1709,896,-40
10049565554,10049565561,7,2651,1127,-40
10056119213,10056119216,3,2040,2598,-40
10060789142,10060789147,5,2278,1195,-40
10061174555,10061174562,7,2984,1320,-40
10061984311,10061984318,7,5137,1501,-40
10063809407,10063809415,8,3520,1361,-40
10064310726,10064310747,21,1050,212,-40
10069491466,10069491466,0,1974,3255,-40
10078894322,10078894327,5,2998,812,-40
10079123445,10079123449,4,2388,1265,-40
10081525450,10081525457,7,4410,1694,-40
10082230691,10082230696,5,3063,1437,-40
10083045345,10083045350,5,2976,1264,-40
10088415095,10088415102,7,4514,1478,-40
10088533826,10088533830,4,2480,964,-40
10094660775,10094660782,7,2555,980,-40
10095003898,10095003907,9,845,253,-40
10095379421,10095379427,6,3288,1402,-40
10095745354,10095745358,4,2036,1189,-40
10096416586,10096416592,6,2338,752,-40
10096816058,10096816074,16,1981,1164,-40
10097555163,10097555162,-1,1239,2303,-40
10098470855,10098470862,7,2822,1447,-40
10099740405,10099740413,8,3619,1465,-40
10103841726,10103841730,4,1997,900,-40
10104341401,10104341407,6,2513,1101,-40
10105185015,10105185015,0,824,17326,-40
10106830710,10106830717,7,1888,1115,-40
10107942114,10107942119,5,2814,1116,-40
10110030480,10110030485,5,2587,1270,-40
10112354970,10112354975,5,2468,1192,-40
10114987695,10114987701,6,2949,1446,-40
10115585501,10115585508,7,3192,1312,-40
10117993102,10117993107,5,2711,1506,-40
10118107554,10118107561,7,3311,1611,-40
10120769100,10120769105,5,1589,976,-40
10122661630,10122661635,5,2705,1442,-40
10125889881,10125889881,0,1132,2198,-40
10127016719,10127016726,7,2042,1474,-40
10128558677,10128558684,7,1483,1746,-40
10129379238,10129379246,8,2419,1179,-40
10130552492,10130552498,6,2411,1178,-40
10131519363,10131519369,6,3342,1527,-40
10132656706,10132656711,5,2513,982,-40
10133174402,10133174406,4,2441,1451,-40
10134784281,10134784287,6,1936,878,-40
10135995369,10135995374,5,2868,1170,-40
10140480845,10140480851,6,3315,1655,-40
10146079313,10146079319,6,3287,1070,-40
10146533166,10146533173,7,2496,1430,-40
10149195297,10149195294,-3,671,1693,-40
10149447304,10149447311,7,3280,1293,-40
10149481561,10149481569,8,3060,1408,-40
10150120784,10150120787,3,36164,16524,-40
10150771654,10150771662,8,2342,1441,-40
10151092440,10151092434,-6,23808,14767,-40
10160254856,10160254861,5,1555,837,-40
10161348070,10161348075,5,2868,1156,-40
10165582209,10165582215,6,3057,1370,-40
10172225196,10172225202,6,3813,1751,-40
10175359721,10175359727,6,2649,1143,-40
10176297422,10176297430,8,2564,1381,-40
10187379077,10187379084,7,3928,1427,-40
10187920279,10187920260,-19,2682,1321,-40
10189882208,10189882214,6,3235,1091,-40
10191008142,10191008136,-6,1206,3968,-40
10191533812,10191533829,17,2124,4641,-40
10192123355,10192123361,6,2669,1637,-40
10195128490,10195128495,5,3169,1178,-40
10197191888,10197191891,3,2168,2029,-40
10199892655,10199892662,7,3154,1415,-40
10204841362,10204841369,7,2132,1020,-40
10205246272,10205246282,10,2393,1099,-40
10214339881,10214339887,6,2251,1260,-40
10222583505,10222583510,5,3876,1671,-40
10222795353,10222795359,6,3315,1459,-40
10224286239,10224286241,2,1359,1457,-40
10224907918,10224907925,7,3010,1414,-40
10226892584,10226892579,-5,1114,1987,-40
10230770578,10230770583,5,5785,2954,-40
10232839393,10232839394,1,1657,1895,-40
10237453705,10237453711,6,2079,1185,-40
10240356390,10240356397,7,2754,1305,-40
10244466478,10244466485,7,2169,973,-40
10246308211,10246308215,4,2314,1269,-40
10246574865,10246574871,6,3074,1624,-40
10247029440,10247029446,6,2625,1294,-40
10249900817,10249900821,4,1760,937,-40
10256152969,10256152969,0,1122,1472,-40
10256265212,10256265219,7,5372,1610,-40
10256302243,10256302251,8,1273,870,-40
10256709025,10256709032,7,7069,1444,-40
10261511492,10261511498,6,2082,1394,-40
10262412846,10262412852,6,2425,1042,-40
10271269749,10271269755,6,3029,1516,-40
10272919614,10272919618,4,2675,1016,-40
10275649471,10275649477,6,2868,1209,-40
10278599431,10278599439,8,2190,1238,-40
10279119227,10279119232,5,2525,1343,-40
10287046580,10287046586,6,2556,1192,-40
10287590802,10287590788,-14,2963,1300,-40
10289543525,10289543527,2,1267,1382,-40
10290123217,10290123221,4,2768,880,-40
10291695902,10291695909,7,3690,1135,-40
10293090381,10293090366,-15,1924,357,-40
10296241287,10296241294,7,3634,1245,-40
10298261291,10298261298,7,3716,1270,-40
10299525292,10299525299,7,3385,909,-40
10303285606,10303285611,5,3643,1182,-40
10305496089,10305496095,6,3602,1807,-40
10307530706,10307530714,8,3762,1196,-40
10309483192,10309483198,6,3859,1555,-40
10311087557,10311087560,3,1736,1697,-40
10318024739,10318024747,8,2713,656,-40
10319114455,10319114461,6,2615,1683,-40
10320278530,10320278537,7,2903,1252,-40
10324044410,10324044416,6,2982,1166,-40
10327822559,10327822565,6,3521,1735,-40
10327909065,10327909071,6,577,698,-40
10330351334,10330351340,6,2602,1371,-40
10330487549,10330487554,5,2117,1259,-40
10331242229,10331242235,6,4373,3337,-40
10331754868,10331754874,6,2860,1155,-40
10331813898,10331813897,-1,957,1301,-40
10334425709,10334425714,5,3571,1184,-40
10339260526,10339260533,7,1685,1437,-40
10341194611,10341194609,-2,767,900,-40
10343909577,10343909583,6,2454,1236,-40
10344193507,10344193513,6,1972,1538,-40
10345461989,10345461995,6,2640,1518,-40
10346012409,10346012415,6,3606,1337,-40
10352300844,10352300852,8,6322,1217,-40
10354526735,10354526741,6,2170,649,-40
10354973718,10354973724,6,3080,1212,-40
10355538099,10355538106,7,3680,910,-40
10355974278,10355974257,-21,995,428,-40
10358353955,10358353935,-20,44538,29967,-40
10359937197,10359937204,7,2439,1149,-40
10360653358,10360653340,-18,2044,778,-40
10362213857,10362213863,6,3539,825,-40
10362872479,10362872486,7,2326,1244,-40
10365304209,10365304214,5,2975,996,-40
10366466681,10366466689,8,2281,1435,-40
10366825365,10366825371,6,2572,1098,-40
10367304521,10367304523,2,807,161,-40
10369216073,10369216078,5,2465,941,-40
10370762701,10370762706,5,2988,1219,-40
10373571616,10373571622,6,2681,1205,-40
10374379770,10374379777,7,3169,1474,-40
10380732291,10380732298,7,2714,1315,-40
10381793906,10381793888,-18,2230,602,-40
10382826263,10382826260,-3,34056,14486,-40
10384871270,10384871275,5,4042,1519,-40
10385492016,10385492022,6,1790,931,-40
10386783844,10386783850,6,3195,1134,-40
10387258969,10387258979,10,4316,1156,-40
10388283864,10388283870,6,2863,1846,-40
10391031979,10391031985,6,3405,1404,-40
10391102961,10391102953,-8,880,261,-40
10404302911,10404302917,6,2479,1327,-40
10407836247,10407836254,7,4329,1869,-40
10408420516,10408420522,6,2738,1192,-40
10418432122,10418432128,6,2088,1192,-40
10421185805,10421185811,6,2436,1118,-40
10426603493,10426603497,4,2812,1554,-40
10426760327,10426760334,7,3591,1237,-40
10427368462,10427368470,8,1682,888,-40
10427724642,10427724648,6,2978,1327,-40
10436150126,10436150133,7,2609,1259,-40
10440439853,10440439858,5,2133,1228,-40
10440611109,10440611110,1,2102,1453,-40
10440887171,10440887178,7,2926,1574,-40
10444566683,10444566689,6,3787,1670,-40
10445080151,10445080150,-1,36987,25309,-40
10453368952,10453368958,6,2713,1211,-40
10453598613,10453598608,-5,1417,127,-40
10454980405,10454980411,6,3632,1586,-40
10457519690,10457519694,4,2730,943,-40
10458029004,10458029011,7,2949,1446,-40
10458580657,10458580663,6,2563,1304,-40
10463041931,10463041939,8,3324,942,-40
10463459710,10463459707,-3,767,202,-40
10480112668,10480112675,7,2935,1098,-40
10482915314,10482915320,6,4857,1452,-40
10483140094,10483140099,5,1524,32831,-40
10484802134,10484802128,-6,2441,4128,-40
10485917296,10485917294,-2,1352,2474,-40
10486676763,10486676767,4,1639,723,-40
10487137637,10487137646,9,2558,1228,-40
10487609613,10487609603,-10,2357,358,-40
10489004638,10489004645,7,2789,1513,-40
10491392018,10491392025,7,2768,1092,-40
10491497494,10491497507,13,3327,1469,-40
10492188240,10492188246,6,3335,1306,-40
10493184670,10493184669,-1,1225,1642,-40
10493768135,10493768142,7,3021,1199,-40
10493803587,10493803586,-1,1005,387,-40
10495667108,10495667116,8,2399,1396,-40
10495961269,10495961282,13,2927,1148,-40
10496685138,10496685144,6,3390,1583,-40
10496796674,10496796681,7,2906,822,-40
10497207961,10497207969,8,3023,1203,-40
10498169139,10498169145,6,3259,1551,-40
10505796681,10505796687,6,2436,902,-40
10506424688,10506424694,6,1954,808,-40
10508536206,10508536185,-21,1212,629,-40
10509706489,10509706495,6,2427,836,-40
10511309835,10511309843,8,2961,1296,-40
10512902513,10512902518,5,2075,852,-40
10516111654,10516111651,-3,796,1803,-40
10517070319,10517070325,6,2523,944,-40
10519112672,10519112679,7,4766,894,-40
10519169765,10519169770,5,1179,280,-40
10519341479,10519341468,-11,2663,954,-40
10520587975,10520587982,7,2117,1044,-40
10521031986,10521032003,17,1745,822,-40
10522452973,10522452980,7,3033,1160,-40
10526166353,10526166358,5,2872,1042,-40
10526270590,10526270606,16,251,1460,-40
10528040450,10528040455,5,2410,1000,-40
10537152357,10537152365,8,2263,882,-40
10539103186,10539103193,7,3176,1536,-40
10540736594,10540736589,-5,1003,2022,-40
10542080246,10542080254,8,3761,1624,-40
10544802015,10544802019,4,3574,1473,-40
10546939718,10546939725,7,3077,1477,-40
10547629222,10547629229,7,3531,1119,-40
10549338489,10549338495,6,4075,1455,-40
10549907506,10549907499,-7,1584,9233,-40
10550984797,10550984806,9,2595,1307,-40
10551189570,10551189575,5,1446,815,-40
10554068946,10554068954,8,1832,1068,-40
10554118700,10554118706,6,3849,1137,-40
10556550821,10556550827,6,2750,1192,-40
10559750155,10559750161,6,3433,1356,-40
10560685426,10560685432,6,2806,1619,-40
10566446691,10566446698,7,3991,1608,-40
10574206050,10574206055,5,3240,1453,-40
10576073306,10576073284,-22,677,279,-40
10577189941,10577189943,2,1351,1072,-40
10578439910,10578439917,7,2581,1353,-40
10579582129,10579582137,8,3420,1095,-40
10580546303,10580546308,5,3609,1846,-40
10582468903,10582468910,7,2831,1327,-40
10583090030,10583090048,18,2240,1160,-40
10583307503,10583307513,10,537,223,-40
10583547876,10583547893,17,56246,2705,-40
10586220696,10586220702,6,2783,1127,-40
10586881761,10586881770,9,2703,1365,-40
10593183975,10593183981,6,2237,1273,-40
10594709105,10594709111,6,2965,1282,-40
10597199025,10597199031,6,2243,1325,-40
10599123648,10599123654,6,2556,911,-40
10601180338,10601180345,7,3203,1230,-40
10601571982,10601571983,1,1551,1566,-40
10604159024,10604159034,10,2646,871,-40
10605588302,10605588307,5,3572,1096,-40
10608457754,10608457761,7,3823,1339,-40
10614124088,10614124093,5,2602,1336,-40
10620105543,10620105545,2,1993,1887,-40
10623669950,10623669955,5,2664,1088,-40
10624645689,10624645694,5,2215,1527,-40
10630096966,10630096971,5,1969,1072,-40
10630166752,10630166736,-16,3144,1295,-40
10631116322,10631116330,8,3486,1439,-40
10631909817,10631909816,-1,1048,1787,-40
10635217408,10635217414,6,1520,1516,-40
10638220318,10638220317,-1,1090,1596,-40
10642034465,10642034472,7,2778,1185,-40
10643460937,10643460938,1,1700,1765,-40
10651974790,10651974796,6,1735,1146,-40
10652012231,10652012211,-20,2700,958,-40
10654441857,10654441862,5,2656,1407,-40
10658017626,10658017631,5,3011,1512,-40
10658045840,10658045846,6,2902,1157,-40
10661540806,10661540812,6,2735,1246,-40
10665390254,10665390259,5,2203,1064,-40
10666039537,10666039542,5,2891,1424,-40
10669624349,10669624354,5,3365,1226,-40
10670678066,10670678074,8,3584,1104,-40
10675527530,10675527536,6,3145,1611,-40
10683389746,10683389751,5,1606,1321,-40
10687161590,10687161584,-6,1433,8219,-40
10688719830,10688719837,7,2079,1146,-40
10695677817,10695677823,6,2665,1104,-40
10699403071,10699403065,-6,167,924,-40
10701849661,10701849667,6,3347,1101,-40
10702966147,10702966153,6,1674,1058,-40
10709716810,10709716818,8,2818,1545,-40
10710320432,10710320442,10,3538,1132,-40
10710997011,10710997015,4,2555,1150,-40
10714338352,10714338357,5,1533,1013,-40
10720095440,10720095446,6,3272,917,-40
10721254463,10721254473,10,2712,1452,-40
10729852905,10729852911,6,3280,1025,-40
10731935088,10731935096,8,1824,1213,-40
10733109604,10733109602,-2,1157,1434,-40
10738438674,10738438678,4,2356,1335,-40
10739950189,10739950196,7,2858,1128,-40
10742628068,10742628076,8,2843,1175,-40
10747477964,10747477970,6,2507,1861,-40
10747903035,10747903039,4,3870,1284,-40
10750053498,10750053502,4,4464,3008,-40
10755387323,10755387329,6,2464,1376,-40
10758083380,10758083382,2,2079,1041,-40
10761740646,10761740652,6,2360,1388,-40
10762267902,10762267906,4,2563,1296,-40
10763734072,10763734082,10,15909,13112,-40
10767374868,10767374867,-1,1700,2649,-40
10770882970,10770882970,0,1230,1756,-40
10778816524,10778816530,6,2290,1441,-40
10779358374,10779358378,4,2696,1405,-40
10779443830,10779443835,5,2591,754,-40
10783189909,10783189914,5,2554,1306,-40
10784675439,10784675444,5,1721,1509,-40
10790984789,10790984796,7,3633,1285,-40
10791652744,10791652750,6,3448,1379,-40
10799953189,10799953194,5,2392,1464,-40
10801469789,10801469794,5,1939,941,-40
10802701241,10802701247,6,3095,1487,-40
10803810561,10803810565,4,2812,1731,-40
10804278885,10804278890,5,2180,1111,-40
10804596595,10804596577,-18,934,322,-40
10805798513,10805798515,2,1949,1149,-40
10806316282,10806316291,9,2990,946,-40
10813499299,10813499305,6,2263,1077,-40
10813892951,10813892930,-21,2443,808,-40
10818147337,10818147348,11,115,2044,-40
10820168466,10820168473,7,2376,1307,-40
10821339065,10821339071,6,3654,1110,-40
10822052609,10822052613,4,1744,1201,-40
10827395158,10827395164,6,2450,1365,-40
10832056535,10832056539,4,2890,1328,-40
10832328923,10832328929,6,3580,1331,-40
10844564156,10844564163,7,2873,1506,-40
10844816668,10844816674,6,2769,1071,-40
10844968921,10844968925,4,3156,1288,-40
10851294211,10851294217,6,3710,1456,-40
10852025345,10852025331,-14,1987,685,-40
10852254414,10852254429,15,10683,54628,-40
10852355615,10852355622,7,3602,983,-40
10854122741,10854122748,7,2974,1259,-40
10866400854,10866400859,5,2525,972,-40
10867035348,10867035352,4,2440,1113,-40
10871831865,10871831850,-15,209,856,-40
10873859878,10873859886,8,2420,1481,-40
10876282994,10876283001,7,3039,1121,-40
10879459721,10879459728,7,2284,1342,-40
10881328811,10881328809,-2,2105,4923,-40
10881800574,10881800579,5,2923,1322,-40
10883444873,10883444878,5,2709,962,-40
10884398351,10884398357,6,1901,644,-40
10884676999,10884677017,18,2859,734,-40
10896209058,10896209050,-8,952,160,-40
10902392950,10902392958,8,1656,932,-40
10902695419,10902695425,6,2461,1322,-40
10902806833,10902806839,6,3218,1689,-40
10902987407,10902987414,7,3606,1555,-40
10908243402,10908243399,-3,1082,2786,-40
10911852197,10911852204,7,2630,1328,-40
10912297754,10912297763,9,3185,1006,-40
10923220606,10923220609,3,1788,1328,-40
10924622299,10924622307,8,3218,1402,-40
10929167766,10929167744,-22,756,298,-40
10930217885,10930217891,6,2058,1244,-40
10930819682,10930819664,-18,664,53,-40
10933085653,10933085651,-2,43197,22674,-40
10938688874,10938688879,5,2839,1126,-40
10940933414,10940933419,5,2422,1238,-40
10941466680,10941466686,6,3495,977,-40
10941976817,10941976818,1,26080,30207,-40
10943219878,10943219879,1,2262,2270,-40
10947564204,10947564210,6,2799,1457,-40
10949604961,10949604969,8,2293,679,-40
10951080494,10951080500,6,2429,1087,-40
10951474457,10951474462,5,2526,1742,-40
10957317942,10957317949,7,2327,1261,-40
10959193555,10959193561,6,1727,821,-40
10961749918,10961749925,7,2701,1078,-40
10962493722,10962493727,5,2541,1321,-40
10964420471,10964420478,7,3043,1213,-40
10968865837,10968865842,5,3167,1560,-40
10971846341,10971846346,5,2465,1613,-40
10976432586,10976432591,5,2381,1183,-40
10976593509,10976593513,4,2358,1223,-40
10978889775,10978889783,8,2029,1070,-40
10980025225,10980025232,7,3630,2153,-40
10980231817,10980231823,6,2666,1302,-40
10984672108,10984672115,7,2675,1175,-40
10989480749,10989480754,5,2296,1157,-40
10990809274,10990809282,8,2524,875,-40
10992078377,10992078378,1,1209,148,-40
10992368006,10992367984,-22,2698,1103,-40
11003032225,11003032230,5,2425,1415,-40
11008302734,11008302742,8,4241,1998,-40
11008701107,11008701115,8,2316,1132,-40
11008788854,11008788835,-19,2467,1298,-40
11009906273,11009906279,6,2889,1091,-40
11011141069,11011141075,6,3603,1562,-40
11011862116,11011862121,5,2643,745,-40
11014579310,11014579317,7,3280,1124,-40
11015358109,11015358115,6,1428,666,-40
11015491733,11015491738,5,3244,1426,-40
11019586526,11019586531,5,2328,1604,-40
11021144416,11021144423,7,3412,1504,-40
11021855478,11021855485,7,3043,1191,-40
11025771524,11025771529,5,3195,1352,-40
11025843782,11025843790,8,2810,1264,-40
11026292386,11026292392,6,6246,2319,-40
11027830646,11027830650,4,2448,1574,-40
11030413734,11030413740,6,2012,885,-40
11034106305,11034106311,6,2486,1217,-40
11034943366,11034943373,7,1890,1128,-40
11038118917,11038118921,4,2578,906,-40
11041632062,11041632070,8,3237,1131,-40
11041746658,11041746666,8,2994,1278,-40
11043069491,11043069486,-5,1272,4251,-40
11043550766,11043550771,5,1137,1003,-40
11043890376,11043890368,-8,919,256,-40
11054823322,11054823321,-1,1648,2146,-40
11054941796,11054941801,5,3703,1520,-40
11055719044,11055719053,9,2586,1189,-40
11056217513,11056217520,7,2963,1405,-40
11056869105,11056869110,5,3451,1678,-40
11058195630,11058195634,4,2061,1431,-40
11058685836,11058685842,6,3228,1419,-40
11059571847,11059571825,-22,1304,1270,-40
11062861140,11062861147,7,2475,1140,-40
11065850317,11065850321,4,2344,1224,-40
11076153991,11076153996,5,2247,1247,-40
11082419526,11082419533,7,1737,1151,-40
11083777823,11083777825,2,1824,2489,-40
11085909194,11085909201,7,2231,1099,-40
11086799711,11086799718,7,2519,1164,-40
11087177546,11087177551,5,4097,1228,-40
11087822089,11087822088,-1,1523,1566,-40
11088154313,11088154320,7,2931,1571,-40
11089171706,11089171714,8,1812,1034,-40
11091340607,11091340614,7,2877,1298,-40
11093393495,11093393502,7,2802,1319,-40
11094192464,11094192460,-4,1049,2759,-40
11096171555,11096171564,9,2365,977,-40
11096598657,11096598641,-16,987,310,-40
11098074410,11098074404,-6,1059,492,-40
11109302748,11109302753,5,2634,1205,-40
11109435749,11109435753,4,2039,1285,-40
11111350525,11111350531,6,3659,1505,-40
11116627164,11116627162,-2,1236,2030,-40
11117850111,11117850117,6,1328,910,-40
11118017481,11118017464,-17,2033,860,-40
11118491567,11118491572,5,3795,1832,-40
11118849358,11118849366,8,3339,1318,-40
11121068513,11121068518,5,2457,1353,-40
11121129025,11121129031,6,2793,1364,-40
11122108366,11122108374,8,2450,864,-40
11126654419,11126654425,6,3194,1359,-40
11127770033,11127770016,-17,1251,312,-40
11130742878,11130742883,5,2995,1280,-40
11131253983,11131253989,6,3371,1621,-40
11133185971,11133185978,7,3305,963,-40
11135319510,11135319516,6,1139,937,-40
11137730775,11137730778,3,1609,940,-40
11138571757,11138571762,5,2882,1306,-40
11140259761,11140259768,7,3463,1347,-40
11144733561,11144733569,8,2846,1061,-40
11152027949,11152027954,5,2461,1174,-40
11152361981,11152361960,-21,1808,429,-40
11155020361,11155020365,4,2817,1421,-40
11166401086,11166401091,5,2247,1519,-40
11168207196,11168207203,7,2652,1017,-40
11169916741,11169916747,6,3785,1236,-40
11170067885,11170067875,-10,2361,1098,-40
11172270611,11172270614,3,1551,1168,-40
11179521017,11179521023,6,3513,1422,-40
11182464550,11182464558,8,2717,1312,-40
11185148810,11185148817,7,2117,905,-40
11190949538,11190949545,7,2708,1264,-40
11192139813,11192139819,6,2922,1187,-40
11196212170,11196212175,5,2556,1055,-40
11201238230,11201238235,5,2437,1298,-40
11203798829,11203798834,5,2971,1226,-40
11204112597,11204112602,5,2122,1048,-40
11205864709,11205864716,7,2288,1599,-40
11207133882,11207133887,5,2207,953,-40
11209923514,11209923519,5,1954,1227,-40
11212042918,11212042900,-18,2837,1530,-40
11213175528,11213175534,6,1774,1281,-40
11213990493,11213990501,8,3575,1749,-40
11214833645,11214833653,8,3451,1330,-40
11216709047,11216709054,7,3798,1238,-40
11222363268,11222363274,6,4380,1583,-40
11225355341,11225355346,5,1976,971,-40
11225564130,11225564120,-10,1614,429,-40
11226710093,11226710094,1,2306,1348,-40
11229858970,11229858970,0,1141,1749,-40
11230106442,11230106438,-4,1160,3954,-40
11231059554,11231059551,-3,958,162,-40
11231458701,11231458707,6,4092,1202,-40
11239239982,11239239977,-5,875,634,-40
11241666052,11241666057,5,5115,2429,-40
11242000367,11242000360,-7,783,206,-40
11243740314,11243740318,4,1768,974,-40
11244103654,11244103660,6,2699,1369,-40
11244251381,11244251386,5,3310,1021,-40
11244873763,11244873771,8,3285,1610,-40
11245299150,11245299154,4,2561,835,-40
11250149425,11250149435,10,2871,1081,-40
11250381731,11250381738,7,4218,1486,-40
11255740201,11255740209,8,3851,1392,-40
11256166250,11256166234,-16,941,356,-40
11257340534,11257340541,7,3857,1161,-40
11257966106,11257966096,-10,1547,533,-40
11259374325,11259374319,-6,1142,3275,-40
11266592908,11266592913,5,2209,1323,-40
11267079394,11267079397,3,2308,1538,-40
11267909135,11267909138,3,2133,2955,-40
11270222098,11270222103,5,2735,1139,-40
11270468921,11270468925,4,1797,770,-40
11275285665,11275285671,6,1292,1057,-40
11280940414,11280940429,15,780,2230,-40
11283368922,11283368915,-7,1721,40467,-40
11284152146,11284152151,5,2712,1026,-40
11287161313,11287161318,5,3183,1226,-40
11287833113,11287833097,-16,418,235,-40
11288885585,11288885590,5,2217,1279,-40
11291014101,11291014109,8,2873,1102,-40
11292943053,11292943058,5,1916,1186,-40
11294769874,11294769882,8,2231,1249,-40
11295046619,11295046625,6,3915,1595,-40
11302261920,11302261915,-5,1697,1262,-40
11304453861,11304453867,6,3471,1513,-40
11304718925,11304718944,19,981,363,-40
11306740909,11306740912,3,2272,1508,-40
11307686813,11307686825,12,2859,1301,-40
11308379403,11308379408,5,1616,1204,-40
11309297919,11309297912,-7,726,241,-40
11313937605,11313937611,6,2461,1211,-40
11325518400,11325518406,6,2603,1401,-40
11326361863,11326361881,18,3698,1151,-40
11329579003,11329579009,6,2289,1383,-40
11329817418,11329817426,8,1529,865,-40
11332319330,11332319332,2,2510,3355,-40
11336316750,11336316755,5,3110,1749,-40
11341683393,11341683395,2,640,755,-40
11345061706,11345061712,6,2806,1029,-40
11345229636,11345229643,7,2483,1333,-40
11348295130,11348295146,16,3576,1337,-40
11349039686,11349039693,7,3529,1479,-40
11358418086,11358418094,8,3492,1305,-40
11359271563,11359271571,8,2915,1095,-40
11359769076,11359769083,7,2538,979,-40
11361691729,11361691736,7,2829,1516,-40
11363644249,11363644253,4,3420,1676,-40
11364683550,11364683555,5,3086,1366,-40
11365938631,11365938637,6,2576,1580,-40
11374735616,11374735623,7,2674,1160,-40
11377764108,11377764114,6,2745,1120,-40
11377825549,11377825529,-20,2127,959,-40
11378158362,11378158370,8,3440,1290,-40
11379814016,11379814022,6,3007,1471,-40
11381458849,11381458848,-1,1132,2226,-40
11384698576,11384698582,6,3202,1239,-40
11390102016,11390102021,5,2158,1566,-40
11392052526,11392052531,5,3400,1351,-40
11393314786,11393314791,5,2629,1255,-40
11394026660,11394026665,5,2140,1203,-40
11397031385,11397031390,5,2860,1452,-40
11403456816,11403456822,6,3118,1222,-40
11407523073,11407523079,6,3573,1453,-40
11409259137,11409259143,6,2515,1089,-40
11417408403,11417408409,6,2177,1394,-40
11418675621,11418675617,-4,1269,3256,-40
11418981261,11418981266,5,2206,925,-40
11419477433,11419477417,-16,994,467,-40
11421186617,11421186620,3,2929,1789,-40
11422325223,11422325226,3,1513,1435,-40
11427093798,11427093790,-8,1729,7561,-40
11427361801,11427361807,6,2891,1217,-40
11428367320,11428367325,5,1757,1217,-40
11429903569,11429903576,7,2680,1136,-40
11433210707,11433210714,7,2127,706,-40
11434907489,11434907494,5,2386,1047,-40
11435859931,11435859937,6,3069,1211,-40
11437223761,11437223745,-16,1415,562,-40
11437649430,11437649435,5,2280,1358,-40
11439883666,11439883672,6,1612,822,-40
11440976768,11440976774,6,2042,1049,-40
11442312071,11442312078,7,2441,983,-40
11443959820,11443959826,6,3928,1418,-40
11445097975,11445097980,5,3011,1517,-40
11445869490,11445869495,5,2550,1150,-40
11446420054,11446420075,21,2033,926,-40
11446606754,11446606771,17,2603,1264,-40
11447674392,11447674408,16,2058,1078,-40
11448533635,11448533634,-1,556,182,-40
11448943564,11448943577,13,1812,1226,-40
11452901022,11452901027,5,3791,1442,-40
11457635993,11457635999,6,2857,688,-40
11459286334,11459286338,4,2415,1437,-40
11467700102,11467700110,8,2697,893,-40
11472849967,11472849975,8,3155,1234,-40
11473496521,11473496504,-17,958,161,-40
11478279929,11478279926,-3,775,2546,-40
11487162247,11487162251,4,3004,1266,-40
11495921182,11495921187,5,2836,1053,-40
11496080901,11496080907,6,872,56,-40
11496809178,11496809182,4,3377,1197,-40
11498381600,11498381606,6,3003,1545,-40
11504767439,11504767446,7,3019,1277,-40
11509960262,11509960270,8,3478,1095,-40
11510007609,11510007619,10,2036,910,-40
11514781481,11514781487,6,2992,1803,-40
11521186305,11521186311,6,3981,1965,-40
11521694706,11521694710,4,2407,1361,-40
11524313954,11524313959,5,1670,882,-40
11526913726,11526913733,7,3480,1547,-40
11528684035,11528684042,7,2651,836,-40
11530953097,11530953097,0,12058,15159,-40
11532849410,11532849402,-8,1861,9292,-40
11535232630,11535232637,7,2823,945,-40
11535353977,11535353982,5,2619,2129,-40
11537069932,11537069938,6,3295,1694,-40
11537525698,11537525703,5,2150,1422,-40
11539811302,11539811288,-14,1602,1066,-40
11540055335,11540055342,7,3950,1139,-40
11545768054,11545768060,6,2852,1366,-40
11546700364,11546700370,6,3303,1344,-40
11548919287,11548919293,6,2754,773,-40
11551957673,11551957679,6,2888,1707,-40
11555453721,11555453727,6,2301,1143,-40
11558354442,11558354447,5,2616,1860,-40
11563279604,11563279610,6,2842,1408,-40
11565491658,11565491666,8,2510,843,-40
11566973244,11566973248,4,1742,1252,-40
11570814838,11570814821,-17,1108,389,-40
11573133997,11573134003,6,2846,1213,-40
11573187458,11573187465,7,3971,1723,-40
11574971775,11574971780,5,2853,1281,-40
11577736471,11577736479,8,2232,1088,-40
11580499130,11580499135,5,1775,794,-40
11580545974,11580545954,-20,3384,983,-40
11581054440,11581054446,6,3239,1401,-40
11581312962,11581312946,-16,2423,1301,-40
11584723737,11584723743,6,2201,965,-40
11584978317,11584978322,5,2014,967,-40
11585019736,11585019720,-16,2736,851,-40
11585743237,11585743242,5,1859,1042,-40
11586216904,11586216911,7,2806,1202,-40
11591353978,11591353986,8,2825,1160,-40
11591953626,11591953632,6,2691,1114,-40
11592220922,11592220929,7,3380,1454,-40
11592593637,11592593642,5,3405,1985,-40
11592973132,11592973138,6,4760,985,-40
11593161075,11593161083,8,2507,1280,-40
11593872021,11593872027,6,2666,1598,-40
11595910543,11595910540,-3,879,1535,-40
11600001526,11600001533,7,2251,1339,-40
11601770785,11601770791,6,3200,1462,-40
11605385471,11605385478,7,3072,1668,-40
11606217860,11606217858,-2,752,1829,-40
11606593558,11606593562,4,2832,1219,-40
11607460760,11607460765,5,6992,31448,-40
11613133325,11613133330,5,3096,1154,-40
11613436406,11613436414,8,2497,1322,-40
11615145005,11615145011,6,3015,1524,-40
11618461532,11618461538,6,2950,1790,-40
11622438362,11622438370,8,2321,1057,-40
11623634942,11623634949,7,3061,1491,-40
11625722510,11625722517,7,2794,1489,-40
11625832496,11625832501,5,1397,1397,-40
11626378948,11626378954,6,2700,1008,-40
11627951588,11627951590,2,30586,23720,-40
11630095449,11630095454,5,2974,867,-40
11631471637,11631471642,5,2478,1075,-40
11631728973,11631728981,8,1903,1067,-40
11631934694,11631934694,0,1621,1778,-40
11632138897,11632138903,6,3814,1661,-40
11637461845,11637461850,5,2696,1127,-40
11639791721,11639791725,4,3147,1162,-40
11643497874,11643497880,6,3018,990,-40
11645891329,11645891332,3,2907,1630,-40
11648817450,11648817456,6,1933,988,-40
11653251796,11653251803,7,3585,1264,-40
11657997629,11657997635,6,2992,1366,-40
11658656361,11658656368,7,3146,1314,-40
11660076152,11660076158,6,2844,1078,-40
11661171452,11661171457,5,2767,1345,-40
11663554053,11663554059,6,2917,1113,-40
11666650407,11666650414,7,2786,1034,-40
11666837835,11666837828,-7,1032,323,-40
11669044428,11669044434,6,2491,1094,-40
11672220336,11672220344,8,3486,1465,-40
11675568155,11675568162,7,3009,1268,-40
11676181006,11676181013,7,3149,926,-40
11678169059,11678169066,7,1563,996,-40
11680748730,11680748726,-4,1104,3161,-40
11683756666,11683756666,0,1731,1932,-40
11683850679,11683850685,6,2897,1424,-40
11684557202,11684557207,5,2747,1348,-40
11686168485,11686168493,8,3440,1034,-40
11686224251,11686224250,-1,1065,1361,-40
11690106584,11690106590,6,2732,1143,-40
11690746565,11690746548,-17,2164,720,-40
11691164468,11691164473,5,3755,1187,-40
11692768286,11692768294,8,2628,1005,-40
11694333443,11694333450,7,2517,1148,-40
11696455215,11696455218,3,3121,1028,-40
11696642748,11696642730,-18,971,393,-40
11698498834,11698498838,4,2437,1231,-40
11701655061,11701655067,6,3439,1257,-40
11702416533,11702416539,6,2972,1263,-40
11719400110,11719400117,7,3335,1593,-40
11721006796,11721006802,6,4020,1428,-40
11729726950,11729726958,8,2687,1152,-40
11732590915,11732590917,2,1422,1080,-40
11733256550,11733256551,1,1343,1263,-40
11734348912,11734348919,7,2447,1332,-40
11737143219,11737143225,6,2377,1189,-40
11738771250,11738771250,0,1875,1801,-40
11745398026,11745398031,5,2945,1387,-40
11751750638,11751750646,8,2806,1280,-40
11753652143,11753652150,7,3492,1092,-40
11753814670,11753814648,-22,2742,1310,-40
11754797594,11754797601,7,2123,910,-40
11760474038,11760474018,-20,1298,399,-40
11761117586,11761117593,7,2854,896,-40
11761939074,11761939081,7,3606,1228,-40
11763778345,11763778350,5,2867,1324,-40
11764321026,11764321030,4,2694,832,-40
11766817875,11766817871,-4,2971,5543,-40
11767670566,11767670573,7,2569,1306,-40
11770000787,11770000794,7,4065,1485,-40
11774526164,11774526170,6,2441,1219,-40
11774991173,11774991179,6,2357,977,-40
11775395840,11775395847,7,3237,972,-40
11775711479,11775711464,-15,1072,326,-40
11789270022,11789270027,5,775,597,-40
11793213952,11793213957,5,2626,1215,-40
11797110213,11797110198,-15,2066,781,-40
11798333242,11798333248,6,2685,1543,-40
11802206709,11802206701,-8,703,85,-40
11803600991,11803601005,14,13801,43359,-40
11806626595,11806626601,6,1913,1419,-40
11807478962,11807478970,8,3319,1115,-40
11808789259,11808789240,-19,2723,1148,-40
11811043122,11811043127,5,2704,1344,-40
11811975845,11811975836,-9,1019,179,-40
11816663537,11816663543,6,2702,1115,-40
11821083618,11821083625,7,2731,1555,-40
11825858889,11825858894,5,3141,1354,-40
11826038509,11826038530,21,3238,1411,-40
11827548206,11827548213,7,3611,1300,-40
11829609033,11829609042,9,1666,1041,-40
11830044106,11830044091,-15,1352,2733,-40
11830114740,11830114717,-23,44,452,-40
11831260378,11831260383,5,2304,1011,-40
11834909289,11834909294,5,2568,1240,-40
11841779502,11841779507,5,3521,1735,-40
11842186777,11842186783,6,3229,1380,-40
11842246911,11842246898,-13,3667,1117,-40
11843992902,11843992907,5,2484,1430,-40
11858415131,11858415108,-23,1039,588,-40
11867506514,11867506519,5,4701,2128,-40
11868457185,11868457189,4,2521,1231,-40
11873307170,11873307173,3,2083,1979,-40
11875901081,11875901087,6,3079,1375,-40
11877624095,11877624099,4,1547,1175,-40
11886469359,11886469348,-11,881,502,-40
11892751398,11892751403,5,3368,1329,-40
11913116544,11913116551,7,1740,914,-40
11913448935,11913448929,-6,1445,10166,-40
11913512938,11913512945,7,2252,1811,-40
11914962597,11914962602,5,2976,801,-40
11915777018,11915777023,5,3194,1318,-40
11919539338,11919539359,21,1151,315,-40
11919809255,11919809261,6,2479,1023,-40
11921342218,11921342218,0,993,598,-40
11921532442,11921532450,8,2618,1077,-40
11926906085,11926906091,6,2126,1122,-40
11928020506,11928020513,7,3447,956,-40
11929013636,11929013642,6,2236,801,-40
11930129774,11930129782,8,5210,1371,-40
11931973413,11931973398,-15,79,1271,-40
11933474664,11933474670,6,2213,1154,-40
11934679982,11934679987,5,3512,1869,-40
11935748278,11935748277,-1,1383,2023,-40
11936499773,11936499780,7,4474,1551,-40
11938706146,11938706151,5,1341,853,-40
11939631066,11939631071,5,3018,1106,-40
11940229442,11940229448,6,2332,1173,-40
11945714579,11945714586,7,4525,1312,-40
11945879847,11945879824,-23,567,169,-40
11947943970,11947943977,7,3036,1214,-40
11951013089,11951013094,5,2950,1285,-40
11952573592,11952573595,3,1328,1264,-40
11958426284,11958426291,7,2598,998,-40
11963651562,11963651566,4,1633,1351,-40
11967669578,11967669585,7,3209,1179,-40
11974011214,11974011221,7,2908,1176,-40
11974333953,11974333958,5,1778,1057,-40
11974406058,11974406073,15,1073,113,-40
11975424662,11975424669,7,2529,1668,-40
11975764806,11975764815,9,1686,981,-40
11975929330,11975929336,6,3040,1459,-40
11980670001,11980670006,5,2691,709,-40
11981542922,11981542925,3,1438,786,-40
11984445717,11984445721,4,2096,1118,-40
11984711295,11984711282,-13,1782,637,-40
11988374998,11988375006,8,3438,1479,-40
11989915272,11989915277,5,9039,24324,-40
11990282137,11990282142,5,3057,1540,-40
11996642519,11996642514,-5,1118,3412,-40
12009421289,12009421296,7,2507,1513,-40
12009957349,12009957355,6,2970,1312,-40
12013220550,12013220554,4,2352,1175,-40
12017194670,12017194675,5,2088,863,-40
12017516942,12017516922,-20,2532,641,-40
12018625464,12018625470,6,2911,1443,-40
12019027565,12019027571,6,2500,1012,-40
12021413014,12021413018,4,2107,811,-40
12022929402,12022929404,2,2006,1452,-40
12024160509,12024160514,5,3081,1303,-40
12026293973,12026293978,5,3381,1457,-40
12029181338,12029181342,4,4343,1294,-40
12029519418,12029519425,7,2674,1059,-40
12031073689,12031073694,5,3588,1145,-40
12032535137,12032535143,6,3748,1921,-40
12036479486,12036479490,4,2188,1640,-40
12037406049,12037406054,5,3357,1663,-40
12042704201,12042704206,5,2912,991,-40
12042952934,12042952912,-22,3385,1804,-40
12043520107,12043520114,7,3274,885,-40
12048939184,12048939186,2,1500,1734,-40
12050018000,12050018009,9,4357,1256,-40
12050416428,12050416434,6,3107,1323,-40
12052346745,12052346747,2,3463,3335,-40
12054688470,12054688475,5,3501,1712,-40
12055324293,12055324299,6,2761,1408,-40
12058063763,12058063761,-2,2644,4894,-40
12065335539,12065335545,6,2761,1316,-40
12067121223,12067121217,-6,922,203,-40
12072812139,12072812146,7,3153,1049,-40
12075886549,12075886549,0,1076,1302,-40
12084511712,12084511705,-7,2313,10339,-40
12085519802,12085519785,-17,717,456,-40
12087035104,12087035108,4,20570,20721,-40
12093257860,12093257854,-6,25793,2892,-40
12098011187,12098011194,7,3409,1365,-40
12101279033,12101279038,5,3207,1672,-40
12101924272,12101924278,6,2035,1221,-40
12103761266,12103761274,8,4749,1419,-40
12104848881,12104848887,6,2537,940,-40
12111239010,12111239013,3,2353,1229,-40
12113493359,12113493365,6,4080,2068,-40
12120341777,12120341783,6,1955,1232,-40
12125579354,12125579360,6,2906,1667,-40
12125958497,12125958502,5,2625,1135,-40
12128530277,12128530283,6,2132,1270,-40
12131170386,12131170387,1,21804,16765,-40
12134561654,12134561659,5,3824,1668,-40
12135628495,12135628482,-13,1229,455,-40
12136132894,12136132902,8,2857,731,-40
12136880860,12136880867,7,2397,1149,-40
12137161990,12137161995,5,1807,787,-40
12139304550,12139304558,8,1810,834,-40
12140974537,12140974543,6,2038,1261,-40
12141717281,12141717290,9,1725,1189,-40
12144928761,12144928768,7,3258,1025,-40
12146110397,12146110405,8,2520,1006,-40
12148560350,12148560356,6,6914,2460,-40
12148624382,12148624380,-2,1510,2363,-40
12150933298,12150933304,6,3167,1530,-40
12151187502,12151187507,5,2493,1157,-40
12153761918,12153761925,7,1628,657,-40
12154528910,12154528891,-19,1130,973,-40
12158286014,12158286021,7,1913,1268,-40
12163273929,12163273935,6,2329,1306,-40
12173113300,12173113306,6,3469,1598,-40
12175414654,12175414660,6,2374,1372,-40
12175538622,12175538617,-5,1334,400,-40
12184564625,12184564630,5,3470,1347,-40
12185934149,12185934155,6,3130,1150,-40
12187878050,12187878057,7,3228,1787,-40
12188545455,12188545452,-3,2327,5129,-40
12188754711,12188754714,3,1513,1584,-40
12188794054,12188794062,8,2753,978,-40
12189533153,12189533137,-16,3569,1487,-40
12190478770,12190478772,2,1873,1730,-40
12193460331,12193460335,4,2591,1483,-40
12197702998,12197703003,5,2728,1006,-40
12208732814,12208732821,7,3308,1403,-40
12208826457,12208826440,-17,3209,1178,-40
12210007719,12210007725,6,2958,1610,-40
12211245068,12211245075,7,3044,1019,-40
12212299969,12212299975,6,4047,1430,-40
12218727781,12218727786,5,2645,1345,-40
12219154934,12219154916,-18,2668,877,-40
12220957789,12220957794,5,3521,1563,-40
12221011638,12221011646,8,4598,1641,-40
12224473553,12224473561,8,5661,2393,-40
12228352303,12228352309,6,2389,977,-40
12232784517,12232784523,6,3360,1287,-40
12241174668,12241174674,6,2817,1163,-40
12241738193,12241738199,6,4212,1619,-40
12241809098,12241809104,6,3125,1534,-40
12250584271,12250584278,7,5588,1225,-40
12253076643,12253076649,6,2467,1395,-40
12253301682,12253301675,-7,1175,3917,-40
12254253306,12254253314,8,3878,1510,-40
12255217633,12255217639,6,3169,1568,-40
12261712680,12261712687,7,2872,1112,-40
12262351091,12262351107,16,504,73,-40
12263377763,12263377766,3,1773,2087,-40
12268799810,12268799817,7,1975,1319,-40
12274297299,12274297306,7,2895,1224,-40
12275403435,12275403442,7,2100,1194,-40
12275561211,12275561208,-3,971,339,-40
12276415741,12276415746,5,1940,1119,-40
12280006573,12280006580,7,2236,1464,-40
12280402048,12280402032,-16,795,1973,-40
12280603777,12280603782,5,2642,1731,-40
12281788590,12281788595,5,3254,1465,-40
12282983051,12282983059,8,4317,1473,-40
12284757029,12284757011,-18,2064,916,-40
12286537506,12286537511,5,2139,1621,-40
12286784989,12286784972,-17,3471,1146,-40
12289045204,12289045210,6,3645,1436,-40
12291809982,12291809987,5,2954,1054,-40
12292728463,12292728442,-21,2733,674,-40
12297176107,12297176115,8,3094,1343,-40
12297598157,12297598154,-3,804,119,-40
12301398031,12301398026,-5,1348,2703,-40
12302546609,12302546615,6,2476,842,-40
12307880162,12307880170,8,923,553,-40
12311017006,12311017011,5,1791,1127,-40
12311594233,12311594237,4,2502,1432,-40
12311927820,12311927818,-2,1568,1559,-40
12316446482,12316446487,5,2876,1155,-40
12319303958,12319303962,4,3783,2903,-40
12320150312,12320150317,5,2541,1305,-40
12321411770,12321411776,6,2499,1203,-40
12321499026,12321499034,8,2893,1683,-40
12321766310,12321766320,10,3014,1457,-40
12323724879,12323724886,7,1047,545,-40
12324778739,12324778746,7,3153,1397,-40
12328744199,12328744205,6,2853,1599,-40
12329507045,12329507038,-7,1092,4468,-40
12329986005,12329986010,5,2273,1147,-40
12330790898,12330790904,6,4212,1811,-40
12338354750,12338354749,-1,1672,1813,-40
12339867337,12339867342,5,2180,1054,-40
12340119667,12340119649,-18,931,179,-40
12340597732,12340597738,6,2775,965,-40
12341343755,12341343753,-2,43568,20701,-40
12341728045,12341728050,5,2565,1095,-40
12344462594,12344462601,7,2910,738,-40
12346949269,12346949277,8,2977,1541,-40
12353904584,12353904591,7,2838,1290,-40
12356669165,12356669170,5,2332,1725,-40
12358831093,12358831099,6,3437,1769,-40
12359926218,12359926224,6,2947,1679,-40
12361190590,12361190596,6,3098,1379,-40
12361574171,12361574177,6,3195,1196,-40
12365363449,12365363456,7,3290,1682,-40
12366107293,12366107299,6,7553,2930,-40
12367068333,12367068339,6,1256,1031,-40
12373190549,12373190549,0,794,2046,-40
12373726958,12373726963,5,3336,1239,-40
12373944230,12373944237,7,3421,1680,-40
12377524194,12377524199,5,2390,1415,-40
12381787244,12381787252,8,3848,1371,-40
12381933154,12381933160,6,2796,1451,-40
12383262575,12383262594,19,2907,1228,-40
12383347496,12383347483,-13,3099,1266,-40
12391023569,12391023576,7,2362,732,-40
12391373111,12391373089,-22,861,480,-40
12393168176,12393168182,6,2236,1066,-40
12396902240,12396902245,5,2338,1430,-40
12397009779,12397009785,6,2051,1091,-40
12397921257,12397921257,0,1290,1705,-40
12398362885,12398362890,5,2289,1476,-40
12401264485,12401264491,6,3520,1520,-40
12410031372,12410031377,5,1316,693,-40
12412088523,12412088529,6,3684,1785,-40
12414070566,12414070571,5,2337,1187,-40
12420496412,12420496419,7,3267,1303,-40
12424322930,12424322935,5,2645,1213,-40
12426896037,12426896041,4,1523,1569,-40
12431632757,12431632765,8,2428,1347,-40
12431910773,12431910753,-20,2253,906,-40
12433765473,12433765480,7,3049,1344,-40
12433971765,12433971760,-5,1144,331,-40
12436052989,12436052984,-5,1521,192,-40
12437901611,12437901618,7,1624,1096,-40
12438300202,12438300207,5,2943,1286,-40
12439260691,12439260697,6,2354,1079,-40
12449908086,12449908091,5,2500,1092,-40
12450184111,12450184118,7,3752,1578,-40
12451196282,12451196287,5,2995,1420,-40
12452317509,12452317511,2,1883,2634,-40
12452895989,12452895995,6,3248,1133,-40
12455891734,12455891738,4,2027,1393,-40
12460690488,12460690494,6,2418,864,-40
12467549563,12467549558,-5,1281,2971,-40
12467969070,12467969065,-5,1833,6599,-40
12470864729,12470864735,6,2847,1283,-40
12472596479,12472596483,4,1998,944,-40
12473316966,12473316973,7,2828,1356,-40
12474666746,12474666754,8,1238,898,-40
12475442906,12475442891,-15,3018,835,-40
12476095027,12476095034,7,4234,2066,-40
12478006196,12478006201,5,2895,1360,-40
12478713398,12478713403,5,2259,855,-40
12478760245,12478760250,5,2829,1200,-40
12482014061,12482014066,5,3875,1529,-40
12483175896,12483175902,6,3114,862,-40
12483673660,12483673680,20,1104,197,-40
12487691653,12487691660,7,3547,1651,-40
12490217338,12490217342,4,1366,547,-40
12492220537,12492220518,-19,774,323,-40
12493830710,12493830713,3,1612,1308,-40
12494325486,12494325473,-13,887,286,-40
12496186686,12496186693,7,2768,1223,-40
12498810907,12498810893,-14,2539,642,-40
12505718185,12505718190,5,3251,1187,-40
12508582948,12508582953,5,2792,957,-40
12510560064,12510560071,7,2164,1302,-40
12511400618,12511400622,4,2479,801,-40
12517803374,12517803381,7,2775,1256,-40
12518037111,12518037118,7,2919,1536,-40
12521149945,12521149950,5,2750,1134,-40
12521357030,12521357043,13,3457,1087,-40
12528314091,12528314098,7,2825,1046,-40
12531724293,12531724298,5,3106,1347,-40
12532468047,12532468033,-14,1052,472,-40
12535611259,12535611261,2,3649,1507,-40
12537134767,12537134772,5,2627,1064,-40
12537301002,12537301017,15,932,273,-40
12537945508,12537945510,2,1870,1470,-40
12538094424,12538094431,7,2704,1282,-40
12542278168,12542278174,6,3662,1657,-40
12543807350,12543807357,7,1935,1022,-40
12552698598,12552698604,6,2557,1190,-40
12555792104,12555792111,7,2288,1118,-40
12561334746,12561334751,5,2558,995,-40
12561798562,12561798547,-15,1075,360,-40
12573258289,12573258295,6,2517,1274,-40
12576103137,12576103142,5,1481,843,-40
12578424087,12578424095,8,18572,12541,-40
12583648563,12583648565,2,2304,2079,-40
12586095709,12586095715,6,2646,1168,-40
12587771529,12587771527,-2,1719,2659,-40
12588855356,12588855362,6,2871,1258,-40
12594826831,12594826837,6,2857,1302,-40
12597561626,12597561630,4,1517,30625,-40
12598661251,12598661260,9,1717,1112,-40
12604198144,12604198150,6,3013,1621,-40
12604743482,12604743491,9,4034,1206,-40
12605246945,12605246951,6,3690,1099,-40
12605952635,12605952618,-17,895,298,-40
12609312918,12609312925,7,1508,759,-40
12610717949,12610717955,6,2885,1321,-40
12611586394,12611586399,5,2149,796,-40
12612817434,12612817442,8,2529,1185,-40
12617863946,12617863952,6,3403,1406,-40
12620223268,12620223274,6,3004,1304,-40
12620957574,12620957579,5,3146,1399,-40
12622986019,12622986027,8,1738,947,-40
12624262661,12624262658,-3,2601,5940,-40
12624450502,12624450507,5,2962,1005,-40
12627271091,12627271098,7,3060,1352,-40
12629995344,12629995350,6,1910,877,-40
12634370233,12634370242,9,4042,1642,-40
12639734798,12639734797,-1,1271,2439,-40
12642364641,12642364645,4,1587,693,-40
12644312665,12644312668,3,3119,1582,-40
12644424236,12644424242,6,1887,894,-40
12646550409,12646550415,6,2840,1126,-40
12647944063,12647944070,7,3960,1403,-40
12648410033,12648410039,6,2687,1240,-40
12648867025,12648867022,-3,546,1676,-40
12655385480,12655385487,7,3420,1379,-40
12655696946,12655696948,2,1943,2451,-40
12655945297,12655945304,7,4785,964,-40
12657347417,12657347424,7,5264,1839,-40
12658971216,12658971223,7,3004,1740,-40
12660242398,12660242405,7,3157,1177,-40
12671363102,12671363110,8,3171,1203,-40
12671494369,12671494374,5,2340,1329,-40
12673524912,12673524918,6,2199,1169,-40
12677346191,12677346191,0,1649,2297,-40
12678996054,12678996058,4,2431,1230,-40
12679593882,12679593878,-4,1159,2398,-40
12681250744,12681250749,5,2694,1222,-40
12681922874,12681922882,8,2303,977,-40
12682950836,12682950834,-2,184,1522,-40
12686458949,12686458954,5,1896,769,-40
12688119433,12688119438,5,2503,1045,-40
12689656249,12689656254,5,3665,936,-40
12691390917,12691390923,6,2206,1389,-40
12693852380,12693852387,7,2597,1334,-40
12694200833,12694200839,6,2928,868,-40
12700681490,12700681498,8,3204,1297,-40
12703582723,12703582729,6,3654,1511,-40
12705698643,12705698650,7,3118,1144,-40
12706673425,12706673430,5,2773,1371,-40
12708057325,12708057310,-15,3640,1161,-40
12709205647,12709205654,7,2383,1037,-40
12710501403,12710501410,7,1902,916,-40
12712487949,12712487928,-21,2787,1037,-40
12712849557,12712849559,2,1187,1644,-40
12713894898,12713894905,7,3510,1235,-40
12714358451,12714358458,7,2555,1008,-40
12716382199,12716382205,6,2985,1225,-40
12719321816,12719321822,6,4258,1355,-40
12719933938,12719933946,8,4492,1356,-40
12724484607,12724484611,4,2239,1240,-40
12726411445,12726411432,-13,919,243,-40
12730018278,12730018286,8,2876,1382,-40
12736453102,12736453109,7,3074,1135,-40
12739745158,12739745163,5,1315,750,-40
12741294258,12741294263,5,2559,1163,-40
12746928973,12746928979,6,2738,1236,-40
12749322286,12749322290,4,2260,1070,-40
12749560201,12749560200,-1,1501,323,-40
12756053774,12756053781,7,2934,1113,-40
12756706529,12756706537,8,2630,1138,-40
12757086919,12757086916,-3,1000,2180,-40
12757198729,12757198735,6,2029,1147,-40
12759709198,12759709206,8,4021,1761,-40
12760393315,12760393322,7,2999,1027,-40
12761724677,12761724685,8,4087,1387,-40
12763616414,12763616421,7,3007,1329,-40
12763721467,12763721465,-2,565,167,-40
12765088888,12765088905,17,1255,268,-40
12767246889,12767246891,2,1146,1301,-40
12769857672,12769857674,2,1336,1451,-40
12774905269,12774905275,6,2677,935,-40
12775138467,12775138474,7,1514,826,-40
12781735563,12781735561,-2,1011,1228,-40
12788430662,12788430659,-3,2867,4480,-40
12789190146,12789190153,7,4074,1330,-40
12789374469,12789374473,4,2006,1514,-40
12795275029,12795275037,8,2646,1072,-40
12795820498,12795820507,9,2146,990,-40
12797725472,12797725478,6,2585,1372,-40
12798456447,12798456449,2,1721,1890,-40
12805886710,12805886714,4,1026,1045,-40
12807632211,12807632215,4,2461,865,-40
12808766178,12808766185,7,3141,1730,-40
12809407373,12809407378,5,2920,1683,-40
12814766050,12814766056,6,2654,1206,-40
12815325717,12815325723,6,1945,805,-40
12819484918,12819484925,7,1989,1288,-40
12823647644,12823647652,8,3058,1360,-40
12825158849,12825158855,6,2201,783,-40
12832826514,12832826518,4,989,1207,-40
12833403570,12833403567,-3,1043,1751,-40
12833971169,12833971174,5,4278,1454,-40
12838100870,12838100878,8,2884,1195,-40
12841946269,12841946275,6,3111,1391,-40
12843184274,12843184281,7,2732,1329,-40
12845129051,12845129058,7,3282,1629,-40
12848637397,12848637403,6,1770,924,-40
12852445980,12852445985,5,1234,1126,-40
12853134270,12853134267,-3,1362,2392,-40
12864086978,12864086977,-1,1846,3128,-40
12864525495,12864525502,7,4181,1866,-40
12865030916,12865030922,6,3018,1029,-40
12865743711,12865743719,8,1939,1592,-40
12866375422,12866375427,5,2186,893,-40
12866598013,12866598022,9,2902,1218,-40
12868613839,12868613846,7,4032,1155,-40
12872693087,12872693094,7,2429,978,-40
12874932205,12874932210,5,3186,1304,-40
12878964353,12878964358,5,4339,1332,-40
12879497289,12879497274,-15,2254,809,-40
12879718130,12879718135,5,3156,1157,-40
12880485842,12880485849,7,3364,1307,-40
12881087730,12881087737,7,3525,1647,-40
12881429525,12881429523,-2,988,177,-40
12885685326,12885685333,7,2151,1044,-40
12892944110,12892944116,6,2900,1037,-40
12898251431,12898251436,5,4396,2375,-40
12898453959,12898453967,8,2128,1234,-40
12901504851,12901504853,2,999,965,-40
12904721685,12904721690,5,2014,1164,-40
12904828870,12904828851,-19,1514,344,-40
12904891269,12904891275,6,2382,1017,-40
12907632814,12907632822,8,2523,1190,-40
12907801791,12907801802,11,2298,1160,-40
12909144285,12909144289,4,2117,1005,-40
12915315887,12915315893,6,3801,1410,-40
12918600530,12918600530,0,1316,1303,-40
12919431148,12919431154,6,2392,1381,-40
12921716134,12921716123,-11,1649,881,-40
12924230526,12924230530,4,11043,6612,-40
12925179273,12925179277,4,1771,1517,-40
12927782200,12927782205,5,1997,1191,-40
12927816989,12927816994,5,3190,1163,-40
12928911891,12928911910,19,175,1180,-40
12929358250,12929358255,5,2498,1363,-40
12937074658,12937074664,6,2499,1564,-40
12938128926,12938128916,-10,1087,432,-40
12947506621,12947506629,8,3417,1320,-40
12949177630,12949177635,5,1668,1251,-40
12950931686,12950931691,5,2688,1003,-40
12955932962,12955932969,7,2570,1466,-40
12962805378,12962805359,-19,1188,350,-40
12974438554,12974438561,7,2693,1039,-40
12976627994,12976627999,5,2934,1085,-40
12977647245,12977647250,5,2774,1307,-40
12978110976,12978110983,7,1346,762,-40
12979652629,12979652636,7,2064,1315,-40
12982906924,12982906930,6,3243,1117,-40
12984583953,12984583958,5,3591,1770,-40
12986068870,12986068869,-1,704,1024,-40
12986691294,12986691305,11,2998,995,-40
12986926562,12986926577,15,749,284,-40
12988055196,12988055202,6,3315,1037,-40
12988245514,12988245497,-17,774,126,-40
12990245425,12990245430,5,2949,1059,-40
12995021283,12995021291,8,1149,368,-40
12997384523,12997384523,0,609,207,-40
13001280631,13001280638,7,3635,1277,-40
13002774470,13002774476,6,1794,1073,-40
13009241950,13009241956,6,3006,1094,-40
13010306629,13010306634,5,3760,1487,-40
13011443537,13011443541,4,3680,1107,-40
13012799500,13012799505,5,3211,1520,-40
13013145455,13013145462,7,3484,1040,-40
13019548732,13019548739,7,2778,972,-40
13020316665,13020316672,7,2969,996,-40
13021238037,13021238056,19,4187,1613,-40
13024466158,13024466165,7,3090,1315,-40
13027008427,13027008434,7,4871,1316,-40
13032075169,13032075174,5,3262,1569,-40
13040300110,13040300116,6,2005,1391,-40
13043066561,13043066567,6,1650,1049,-40
13047870838,13047870834,-4,59572,26088,-40
13049912513,13049912518,5,2675,1304,-40
13061376818,13061376825,7,3252,1100,-40
13064108879,13064108878,-1,970,1173,-40
13065125108,13065125114,6,2149,1211,-40
13065808306,13065808324,18,2112,966,-40
13067527998,13067528005,7,3245,1494,-40
13068047432,13068047438,6,2684,1269,-40
13073012142,13073012146,4,3393,3691,-40
13075222261,13075222257,-4,1504,2199,-40
13077223698,13077223705,7,2615,1396,-40
13080781714,13080781720,6,2785,1130,-40
13081316564,13081316571,7,1538,589,-40
13084852968,13084852969,1,15255,19203,-40
13085666090,13085666097,7,3182,1272,-40
13088814434,13088814441,7,2943,1458,-40
13090368551,13090368554,3,1686,1309,-40
13090468171,13090468178,7,2744,1069,-40
13095499627,13095499632,5,2057,1595,-40
13097973810,13097973814,4,2076,1320,-40
13098625273,13098625291,18,2487,1008,-40
13102870856,13102870862,6,2697,1135,-40
13104096261,13104096267,6,2961,1495,-40
13107786788,13107786794,6,2240,1330,-40
13107953594,13107953601,7,3113,1291,-40
13113169992,13113169998,6,2079,1363,-40
13115206271,13115206275,4,2721,1548,-40
13116234649,13116234655,6,3935,1267,-40
13125026936,13125026933,-3,1169,2698,-40
13126751638,13126751645,7,4160,1573,-40
13127786317,13127786314,-3,975,2066,-40
13127903183,13127903164,-19,3534,1430,-40
13129576626,13129576631,5,2033,1428,-40
13130490590,13130490598,8,2052,1028,-40
13133370994,13133371001,7,2621,1006,-40
13133586570,13133586576,6,2164,933,-40
13137501228,13137501234,6,2657,1522,-40
13140423730,13140423735,5,2558,1333,-40
13141041730,13141041739,9,2719,1106,-40
13142891676,13142891678,2,1454,1361,-40
13143720673,13143720680,7,4095,1657,-40
13144312093,13144312101,8,2937,1199,-40
13145708162,13145708159,-3,1134,2047,-40
13151237969,13151237970,1,1283,263,-40
13155654871,13155654877,6,2911,1091,-40
13157253233,13157253237,4,2194,905,-40
13159169279,13159169286,7,1754,1130,-40
13160923329,13160923334,5,2148,1179,-40
13163012214,13163012220,6,3050,1300,-40
13165634966,13165634972,6,2193,1537,-40
13168069817,13168069823,6,2262,958,-40
13171287192,13171287199,7,3083,1226,-40
13172959209,13172959216,7,2721,1379,-40
13173509878,13173509882,4,2886,1286,-40
13174499318,13174499325,7,2949,1471,-40
13177397963,13177397942,-21,3357,963,-40
13183689450,13183689456,6,3511,1487,-40
13185179506,13185179513,7,3791,1754,-40
13186442713,13186442719,6,3135,1111,-40
13187137615,13187137612,-3,1217,3540,-40
13189146440,13189146447,7,3349,1057,-40
13190857817,13190857822,5,3139,1342,-40
13194774209,13194774216,7,3545,1561,-40
13201035966,13201035972,6,2281,928,-40
13202878908,13202878913,5,3389,1787,-40
13208039489,13208039495,6,2327,1141,-40
13217350958,13217350965,7,4201,1168,-40
13218338070,13218338059,-11,3660,1046,-40
13219071419,13219071427,8,2274,1056,-40
13220959607,13220959614,7,2471,1088,-40
13227584098,13227584106,8,3564,1336,-40
13229518738,13229518745,7,2150,1316,-40
13231940191,13231940198,7,2876,1081,-40
13235365703,13235365696,-7,1955,8628,-40
13239728931,13239728938,7,3092,947,-40
13243350684,13243350689,5,2142,1526,-40
13251777205,13251777211,6,1995,1282,-40
13251862802,13251862809,7,2333,1300,-40
13252383939,13252383947,8,3350,1057,-40
13253952805,13253952812,7,2684,1011,-40
13255744384,13255744390,6,2056,1040,-40
13259113929,13259113935,6,1876,1028,-40
13264327233,13264327242,9,2056,943,-40
13266997472,13266997478,6,2048,1256,-40
13267940468,13267940474,6,2795,1300,-40
13269517872,13269517876,4,2753,1229,-40
13273550911,13273550916,5,2880,1719,-40
13274119725,13274119729,4,1671,1021,-40
13276992587,13276992593,6,3592,1625,-40
13277562622,13277562629,7,1799,1087,-40
13278116481,13278116486,5,3604,1245,-40
13285814205,13285814210,5,1571,734,-40
13286188374,13286188354,-20,947,451,-40
13288994547,13288994551,4,2483,1499,-40
13290171747,13290171754,7,2842,1173,-40
13292483994,13292484001,7,2858,1735,-40
13293071330,13293071325,-5,794,2955,-40
13295176289,13295176294,5,2814,1377,-40
13297074718,13297074723,5,2323,1322,-40
13297721281,13297721287,6,2456,1123,-40
13297953151,13297953157,6,11544,24467,-40
13298641020,13298641025,5,1307,978,-40
13299602050,13299602056,6,2529,900,-40
13302270791,13302270799,8,2655,1161,-40
13303022257,13303022263,6,1425,898,-40
13306200261,13306200265,4,3162,1661,-40
13311163477,13311163482,5,1604,1049,-40
13314917605,13314917611,6,3418,1078,-40
13315242534,13315242539,5,1465,815,-40
13316249294,13316249298,4,2543,1916,-40
13318317001,13318317006,5,2778,1398,-40
13326348230,13326348237,7,1376,1230,-40
13328318240,13328318246,6,2038,1275,-40
13330174454,13330174459,5,2653,1409,-40
13333422870,13333422879,9,3750,1097,-40
13334879525,13334879529,4,1861,1219,-40
13336953065,13336953071,6,3300,1727,-40
13337408430,13337408438,8,2569,898,-40
13338508666,13338508672,6,3647,1012,-40
13338709161,13338709148,-13,2118,1025,-40
13340790825,13340790832,7,3644,1885,-40
13344701901,13344701907,6,1517,836,-40
13344747181,13344747176,-5,1091,3954,-40
13346368949,13346368954,5,3863,1258,-40
13347164046,13347164050,4,2329,1149,-40
13359489968,13359489966,-2,1127,2544,-40
13359999820,13359999806,-14,2166,40153,-40
13374080915,13374080913,-2,157,677,-40
13374732881,13374732875,-6,945,303,-40
13381586700,13381586706,6,3388,1513,-40
13382241692,13382241698,6,3789,1596,-40
13386708258,13386708263,5,3391,1680,-40
13388160730,13388160734,4,2728,1247,-40
13397246270,13397246274,4,2438,1670,-40
13401696742,13401696745,3,906,185,-40
13403620750,13403620757,7,3150,1426,-40
13406342310,13406342317,7,2395,1298,-40
13407948362,13407948367,5,2101,1244,-40
13411132755,13411132762,7,3011,1465,-40
13411258246,13411258250,4,1932,1310,-40
13420224116,13420224122,6,2818,1382,-40
13420423959,13420423968,9,2620,849,-40
13421622396,13421622402,6,2904,1125,-40
13422283910,13422283918,8,3746,1595,-40
13425640384,13425640389,5,3402,1577,-40
13425678475,13425678482,7,1403,1003,-40
13429952643,13429952649,6,2185,1004,-40
13430308733,13430308738,5,3380,1129,-40
13431723524,13431723530,6,1689,939,-40
13432377169,13432377175,6,2517,1240,-40
13434399122,13434399129,7,1873,1197,-40
13439639181,13439639170,-11,985,521,-40
13439869418,13439869426,8,4449,1715,-40
13441297913,13441297918,5,2261,1636,-40
13441960101,13441960105,4,3690,1391,-40
13447301794,13447301801,7,3346,1736,-40
13448234177,13448234184,7,2768,1452,-40
13449070085,13449070090,5,2602,1333,-40
13450140494,13450140500,6,2130,1745,-40
13451841873,13451841878,5,3875,1356,-40
13457675309,13457675314,5,2832,1101,-40
13463933857,13463933851,-6,1006,3425,-40
13464138326,13464138333,7,3249,1524,-40
13467821701,13467821706,5,2376,1043,-40
13471325604,13471325609,5,3213,1568,-40
13471930109,13471930115,6,3039,1208,-40
13474756440,13474756446,6,2709,1587,-40
13475861242,13475861244,2,1609,1617,-40
13479021118,13479021126,8,3319,1485,-40
13489939029,13489939035,6,2556,1366,-40
13490085257,13490085265,8,2632,1388,-40
13490209801,13490209806,5,1761,991,-40
13492049229,13492049235,6,3964,1397,-40
13494574854,13494574858,4,2441,1753,-40
13495764345,13495764353,8,5414,1913,-40
13498106129,13498106134,5,1830,1097,-40
13498999759,13498999770,11,1943,1038,-40
13499038797,13499038819,22,852,256,-40
13505426524,13505426524,0,21431,35497,-40
13509968910,13509968908,-2,1083,1820,-40
13511290613,13511290611,-2,1169,1927,-40
13515104137,13515104143,6,2390,1183,-40
13515644565,13515644571,6,3130,1317,-40
13515949362,13515949368,6,3337,1499,-40
13519201974,13519201979,5,1685,1396,-40
13523833279,13523833286,7,2646,1360,-40
13526263146,13526263152,6,3149,1401,-40
13528852854,13528852862,8,5167,1164,-40
13530101021,13530101027,6,2751,868,-40
13533042308,13533042309,1,2070,1306,-40
13538290994,13538290979,-15,2843,1330,-40
13543541357,13543541363,6,3296,1085,-40
13545520296,13545520302,6,2877,1367,-40
13547547317,13547547322,5,3234,1286,-40
13553089901,13553089896,-5,2824,9046,-40
13558275471,13558275478,7,3074,1236,-40
13562153151,13562153158,7,3420,1508,-40
13564046913,13564046918,5,1728,680,-40
13564544733,13564544738,5,2110,594,-40
13564824478,13564824456,-22,766,312,-40
13567860206,13567860211,5,1937,751,-40
13570102518,13570102526,8,3589,1315,-40
13570524356,13570524362,6,2564,1435,-40
13576188413,13576188420,7,3440,988,-40
13576467469,13576467466,-3,1136,378,-40
13577745127,13577745122,-5,643,3354,-40
13579013857,13579013863,6,2670,1340,-40
13581818060,13581818063,3,2183,1372,-40
13582364801,13582364802,1,36727,41481,-40
13587414069,13587414076,7,2854,1099,-40
13595670580,13595670585,5,1844,500,-40
13596238205,13596238211,6,2782,1358,-40
13602111621,13602111627,6,4635,1227,-40
13603548777,13603548783,6,2470,1162,-40
13605918313,13605918318,5,2703,1092,-40
13609229659,13609229665,6,2906,1059,-40
13612556659,13612556665,6,4407,1523,-40
13616609390,13616609395,5,2390,792,-40
13617000192,13617000197,5,2077,1474,-40
13617432770,13617432777,7,1780,546,-40
13619462581,13619462587,6,2456,949,-40
13620784213,13620784219,6,3129,1462,-40
13621396598,13621396577,-21,1490,458,-40
13621925566,13621925571,5,3800,1659,-40
13622569293,13622569275,-18,5453,2363,-40
13624660342,13624660349,7,2325,1183,-40
13626159349,13626159354,5,2353,1137,-40
13626891054,13626891056,2,2355,2635,-40
13627478208,13627478214,6,2826,1271,-40
13630354939,13630354944,5,2760,1346,-40
13630803874,13630803867,-7,1127,417,-40
13631593658,13631593664,6,2381,916,-40
13634433264,13634433270,6,2101,892,-40
13634988422,13634988410,-12,2258,839,-40
13637239707,13637239714,7,3179,1675,-40
13638251311,13638251316,5,2333,985,-40
13641727276,13641727280,4,1855,1196,-40
13641854086,13641854072,-14,1016,348,-40
13641916638,13641916643,5,3190,1853,-40
13657103954,13657103960,6,2666,1286,-40
13657698755,13657698761,6,1617,1003,-40
13658008578,13658008583,5,1804,1306,-40
13663122957,13663122962,5,2238,1579,-40
13670405975,13670405954,-21,768,470,-40
13676336354,13676336362,8,4636,1184,-40
13676694842,13676694849,7,1434,954,-40
13679154441,13679154447,6,3246,1507,-40
13681350240,13681350246,6,3530,1286,-40
13681456206,13681456213,7,2850,1144,-40
13681892074,13681892080,6,2246,2061,-40
13683953163,13683953168,5,2275,1711,-40
13693076478,13693076483,5,1708,725,-40
13693303469,13693303474,5,2635,1348,-40
13695449644,13695449650,6,2736,1449,-40
13699399962,13699399967,5,2305,737,-40
13699660887,13699660866,-21,819,144,-40
13700640600,13700640607,7,2283,859,-40
13701982471,13701982489,18,4013,935,-40
13709292445,13709292450,5,2422,1307,-40
13709762019,13709762026,7,2921,1203,-40
13710265605,13710265612,7,3043,979,-40
13710527487,13710527474,-13,3180,888,-40
13711000949,13711000954,5,2816,1213,-40
13711424019,13711424004,-15,3400,1099,-40
13711938454,13711938460,6,2320,861,-40
13713619225,13713619230,5,1715,720,-40
13715743225,13715743231,6,2615,1695,-40
13720115724,13720115725,1,8461,10554,-40
13722500489,13722500496,7,2089,1038,-40
13723246161,13723246154,-7,424,107,-40
13727074022,13727074027,5,1863,910,-40
13727854074,13727854081,7,4445,1190,-40
13728655314,13728655319,5,1795,1180,-40
13729636357,13729636363,6,2104,988,-40
13731133568,13731133574,6,1924,1063,-40
13736756924,13736756900,-24,19,3775,-40
13737211624,13737211618,-6,21477,18125,-40
13737421425,13737421430,5,1782,1120,-40
13741580675,13741580682,7,2736,1572,-40
13742657890,13742657898,8,3855,1347,-40
13748497706,13748497711,5,1958,1114,-40
13750432857,13750432864,7,2678,1089,-40
13760124173,13760124178,5,3589,1382,-40
13760232746,13760232751,5,3423,1143,-40
13760949815,13760949792,-23,690,272,-40
13761505614,13761505621,7,3840,1189,-40
13768036282,13768036291,9,1622,666,-40
13769688333,13769688338,5,2758,1542,-40
13772272397,13772272399,2,1292,1386,-40
13773608574,13773608579,5,2711,1440,-40
13783504582,13783504594,12,501,1555,-40
13786311913,13786311921,8,1974,1130,-40
13786827481,13786827465,-16,2761,1102,-40
13787239898,13787239905,7,3417,859,-40
13787949353,13787949358,5,4128,1852,-40
13789184766,13789184772,6,3033,876,-40
13789465120,13789465126,6,2574,1030,-40
13790990387,13790990393,6,2565,1518,-40
13793769025,13793769029,4,1789,1203,-40
13794157802,13794157803,1,1139,1820,-40
13799351394,13799351401,7,2038,838,-40
13799464959,13799464944,-15,2554,1067,-40
13800814567,13800814547,-20,3063,1136,-40
13803834774,13803834779,5,1826,1188,-40
13804705205,13804705210,5,2804,949,-40
13804813147,13804813149,2,2313,1262,-40
13804903854,13804903861,7,3348,1120,-40
13807401717,13807401722,5,3248,1998,-40
13809911900,13809911905,5,3381,1730,-40
13814168678,13814168684,6,5526,1022,-40
13817052190,13817052194,4,2928,1169,-40
13818463178,13818463172,-6,2043,39831,-40
13820397725,13820397731,6,3068,1143,-40
13824632866,13824632873,7,3158,1717,-40
13831409122,13831409126,4,1064,1081,-40
13832289592,13832289598,6,3485,1319,-40
13834362387,13834362393,6,1753,698,-40
13835563713,13835563708,-5,1901,7008,-40
13852446216,13852446222,6,2584,893,-40
13852727232,13852727238,6,8908,29797,-40
13856108244,13856108250,6,2538,991,-40
13858461619,13858461625,6,2821,1503,-40
13859717247,13859717233,-14,2477,414,-40
13866206849,13866206854,5,3758,1503,-40
13870764306,13870764299,-7,618,3260,-40
13876982163,13876982170,7,80192,38367,-40
13879414959,13879414965,6,2446,1099,-40
13879564437,13879564456,19,2171,629,-40
13883717542,13883717546,4,2766,1547,-40
13884035777,13884035784,7,2487,1028,-40
13885222829,13885222834,5,3050,1183,-40
13887213444,13887213449,5,2542,1315,-40
13892896458,13892896466,8,3610,1439,-40
13894745123,13894745128,5,2727,1556,-40
13897597348,13897597355,7,1702,1076,-40
13910631871,13910631881,10,3283,1076,-40
13911393236,13911393243,7,2980,1268,-40
13913962125,13913962132,7,2134,1301,-40
13924697353,13924697362,9,1498,670,-40
13925154973,13925154979,6,2510,1457,-40
13925350849,13925350844,-5,1154,3537,-40
13926974800,13926974805,5,2813,1264,-40
13932652918,13932652926,8,3009,1245,-40
13933285303,13933285304,1,2669,2875,-40
13936485504,13936485490,-14,50128,15036,-40
13940366747,13940366755,8,3191,1007,-40
13940473380,13940473386,6,2974,981,-40
13941461108,13941461114,6,2608,1406,-40
13945958785,13945958791,6,2490,1054,-40
13947765498,13947765506,8,2577,768,-40
13953467186,13953467192,6,1539,1098,-40
13956712311,13956712315,4,1005,943,-40
13957348185,13957348192,7,2682,1455,-40
13961237627,13961237634,7,2453,1034,-40
13961513232,13961513235,3,2142,1244,-40
13968260921,13968260920,-1,1242,1485,-40
13968455650,13968455636,-14,999,185,-40
13968818617,13968818601,-16,3270,1025,-40
13971890814,13971890819,5,2939,885,-40
13972008840,13972008824,-16,3264,1446,-40
13974423659,13974423663,4,2617,898,-40
13983708978,13983708986,8,1740,1055,-40
13984426511,13984426513,2,37499,40241,-40
13986822484,13986822490,6,2467,1179,-40
13989475105,13989475101,-4,1035,3169,-40
13993963937,13993963942,5,3647,1242,-40
13994666012,13994666019,7,2661,1283,-40
13995883532,13995883538,6,2249,1208,-40
13996808165,13996808172,7,4610,1534,-40
13998316814,13998316820,6,1661,1310,-40
13998500798,13998500797,-1,1030,2185,-40
14000403202,14000403207,5,2748,1408,-40
14003245276,14003245280,4,2659,1497,-40
14007085425,14007085429,4,1689,1446,-40
14012429044,14012429050,6,3158,1115,-40
14015401717,14015401721,4,2224,1418,-40
14019877858,14019877862,4,2146,684,-40
14020188840,14020188847,7,3411,954,-40
14022498673,14022498679,6,2176,1060,-40
14023407258,14023407266,8,2903,1202,-40
14034086775,14034086779,4,2206,1457,-40
14038621477,14038621482,5,1955,1220,-40
14040554701,14040554706,5,2542,1621,-40
14042948699,14042948706,7,2212,1066,-40
14044833798,14044833806,8,2462,1432,-40
14047050873,14047050879,6,2028,1435,-40
14050369081,14050369086,5,2860,1276,-40
14051025843,14051025852,9,2898,1528,-40
14052681560,14052681567,7,3476,1402,-40
14052924090,14052924097,7,3110,1522,-40
14054301195,14054301202,7,2283,1161,-40
14056365976,14056365981,5,3284,1193,-40
14057544462,14057544468,6,3256,1225,-40
14059409003,14059409009,6,3476,1272,-40
14065228833,14065228838,5,2611,1656,-40
14074030663,14074030670,7,2890,1000,-40
14074509072,14074509078,6,2839,1385,-40
14076360301,14076360306,5,2435,1398,-40
14077956415,14077956421,6,4713,2875,-40
14078464138,14078464143,5,3742,1483,-40
14082170303,14082170310,7,3741,1446,-40
14086261789,14086261794,5,3200,1135,-40
14087474306,14087474311,5,3264,1382,-40
14099320031,14099320037,6,2737,1566,-40
14108302123,14108302140,17,167,1076,-40
14111114763,14111114769,6,3710,1932,-40
14120112103,14120112109,6,2799,1104,-40
14120713806,14120713808,2,1948,1541,-40
14127605913,14127605918,5,3138,1144,-40
14129126926,14129126931,5,2776,1158,-40
14129528462,14129528469,7,3504,1763,-40
14129829765,14129829770,5,2514,1244,-40
14130409652,14130409633,-19,3504,1403,-40
14131683335,14131683341,6,3558,1157,-40
14132829062,14132829068,6,2352,993,-40
14134052914,14134052910,-4,788,2084,-40
14135933804,14135933810,6,1695,1063,-40
14143939894,14143939900,6,2462,836,-40
14146079523,14146079530,7,2143,1014,-40
14147570997,14147570995,-2,830,1571,-40
14152292894,14152292892,-2,1230,1829,-40
14156289927,14156289934,7,2026,969,-40
14156577616,14156577622,6,1906,832,-40
14163091621,14163091626,5,2311,843,-40
14174109438,14174109442,4,2211,985,-40
14174585929,14174585934,5,2156,979,-40
14176930430,14176930435,5,3277,1402,-40
14178470864,14178470871,7,2971,1516,-40
14178581370,14178581378,8,1434,524,-40
14179227738,14179227723,-15,509,400,-40
14181251601,14181251606,5,3528,1805,-40
14183686574,14183686579,5,6425,2869,-40
14184059565,14184059570,5,2438,1517,-40
14185216874,14185216869,-5,930,2864,-40
14190119976,14190119973,-3,1901,2696,-40
14191883516,14191883522,6,2185,934,-40
14192321673,14192321680,7,4053,1430,-40
14194544959,14194544966,7,3577,2046,-40
14195475309,14195475315,6,2594,1462,-40
14195539808,14195539814,6,1937,1281,-40
14196096173,14196096181,8,2211,1174,-40
14196259474,14196259480,6,2995,1342,-40
14198127339,14198127345,6,3065,1159,-40
14198440142,14198440136,-6,1073,466,-40
14201112081,14201112087,6,2406,1299,-40
14201248560,14201248568,8,3017,1475,-40
14202270847,14202270854,7,2827,1187,-40
14207141942,14207141950,8,4202,1909,-40
14212860746,14212860752,6,3807,1443,-40
14213627854,14213627859,5,2863,1749,-40
14215105671,14215105678,7,2974,1264,-40
14215303709,14215303714,5,2939,1198,-40
14215749013,14215749019,6,2121,1402,-40
14222148646,14222148665,19,238,1263,-40
14228006133,14228006140,7,2700,1224,-40
14229863136,14229863145,9,7205,2226,-40
14233539625,14233539629,4,2464,1328,-40
14235489634,14235489641,7,2514,1213,-40
14238017002,14238017006,4,2678,2709,-40
14239752848,14239752854,6,2837,1252,-40
14240849390,14240849397,7,3141,1031,-40
14243903028,14243903032,4,2300,1461,-40
14245191384,14245191388,4,2166,1066,-40
14246400178,14246400185,7,1533,1210,-40
14248924062,14248924065,3,2364,1356,-40
14250931872,14250931877,5,2755,1063,-40
14252995281,14252995287,6,3019,1022,-40
14253543477,14253543483,6,3213,1777,-40
14256518002,14256518009,7,1807,1231,-40
14256823278,14256823284,6,2630,1313,-40
14264825963,14264825962,-1,3132,48579,-40
14267171989,14267171996,7,5055,1707,-40
14268159743,14268159751,8,3216,1312,-40
14270075938,14270075944,6,3846,1636,-40
14271884690,14271884697,7,2971,1291,-40
14272711630,14272711619,-11,841,319,-40
14273926725,14273926733,8,6839,1214,-40
14274903631,14274903638,7,1992,1070,-40
14279759374,14279759378,4,2597,1681,-40
14281139606,14281139611,5,2831,808,-40
14282936987,14282936994,7,2564,1550,-40
14282965498,14282965503,5,1943,791,-40
14286394535,14286394542,7,2405,1172,-40
14287287179,14287287185,6,2802,1205,-40
14295070082,14295070082,0,1880,1632,-40
14297411090,14297411085,-5,915,1623,-40
14299450901,14299450905,4,1684,1167,-40
14302561465,14302561472,7,2701,1298,-40
14302825911,14302825930,19,578,196,-40
14309532480,14309532487,7,3767,1386,-40
14313528952,14313528959,7,2063,871,-40
14321827215,14321827218,3,1721,2174,-40
14323203069,14323203074,5,2556,1293,-40
14323596655,14323596662,7,3411,1191,-40
14323806857,14323806872,15,1299,236,-40
14324413572,14324413569,-3,1456,138,-40
14325479000,14325479002,2,1678,1346,-40
14327195838,14327195847,9,2010,780,-40
14331364392,14331364392,0,35961,19550,-40
14335130641,14335130647,6,3198,1262,-40
14337874173,14337874177,4,5223,3728,-40
14341741784,14341741791,7,2464,1227,-40
14344744877,14344744883,6,1916,1136,-40
14345215117,14345215122,5,2178,1199,-40
14347212625,14347212629,4,2252,1537,-40
14349733691,14349733689,-2,927,2262,-40
14351155951,14351155958,7,1663,999,-40
14351890397,14351890378,-19,1984,1345,-40
14352849150,14352849158,8,1946,920,-40
14354307056,14354307062,6,3379,1755,-40
14356071850,14356071854,4,2721,1518,-40
14358158042,14358158046,4,2627,1053,-40
14359625356,14359625363,7,2796,1322,-40
14363721549,14363721555,6,2584,1268,-40
14366543314,14366543321,7,2323,1319,-40
14367456643,14367456622,-21,1760,586,-40
14367878327,14367878329,2,1227,670,-40
14379880482,14379880482,0,1681,3243,-40
14382649886,14382649892,6,3773,1795,-40
14386013280,14386013286,6,3956,2111,-40
14398341930,14398341937,7,4360,1785,-40
14400962778,14400962786,8,2125,1271,-40
14401296295,14401296301,6,2850,1328,-40
14404154928,14404154934,6,2665,1215,-40
14404616685,14404616665,-20,3555,1225,-40
14406438794,14406438798,4,2724,1023,-40
14409690291,14409690298,7,2952,1398,-40
14410439766,14410439745,-21,1873,1149,-40
14410920985,14410920991,6,2881,1296,-40
14416421601,14416421606,5,2739,960,-40
14416579455,14416579462,7,2533,800,-40
14418309452,14418309455,3,2152,1020,-40
14420526823,14420526829,6,2027,864,-40
14420738118,14420738120,2,1564,1377,-40
14422461930,14422461937,7,2813,1226,-40
14424823202,14424823209,7,3011,1458,-40
14426665115,14426665123,8,1584,1008,-40
14427939886,14427939891,5,2918,1036,-40
14432454813,14432454817,4,2189,1667,-40
14433775974,14433775979,5,2842,1026,-40
14434110085,14434110091,6,2687,1054,-40
14436875285,14436875293,8,3361,1919,-40
14441202698,14441202707,9,2744,1480,-40
14441466831,14441466835,4,8596,6077,-40
14444230755,14444230761,6,2384,1144,-40
14446317377,14446317383,6,2132,843,-40
14447535510,14447535517,7,3694,1655,-40
14449369487,14449369489,2,1239,1710,-40
14452239009,14452239017,8,2736,1059,-40
14456404650,14456404657,7,3169,1177,-40
14462755129,14462755137,8,2668,1005,-40
14468406034,14468406039,5,2125,1001,-40
14472636018,14472636023,5,1399,1009,-40
14472713948,14472713953,5,2117,1161,-40
14472971768,14472971775,7,2847,1046,-40
14475481630,14475481638,8,3537,1415,-40
14477981458,14477981466,8,3037,1263,-40
14478505619,14478505624,5,2432,1303,-40
14478559068,14478559074,6,3977,1156,-40
14479189130,14479189128,-2,1585,2114,-40
14481600901,14481600906,5,2048,1269,-40
14486590841,14486590845,4,2083,987,-40
14487176057,14487176063,6,2219,1157,-40
14490318005,14490318011,6,3064,1282,-40
14494270911,14494270918,7,3133,1025,-40
14497299816,14497299823,7,3399,988,-40
14500462971,14500462974,3,1172,944,-40
14500622112,14500622119,7,2067,1098,-40
14505798197,14505798203,6,3209,1679,-40
14510108392,14510108392,0,1120,2364,-40
14511609977,14511609982,5,3307,1453,-40
14513876439,14513876446,7,2541,1348,-40
14514603358,14514603363,5,2634,1156,-40
14515338005,14515338002,-3,2223,3556,-40
14521919082,14521919090,8,3692,1661,-40
14526425779,14526425786,7,3270,1229,-40
14528744977,14528744984,7,3746,1053,-40
14529059842,14529059850,8,3071,1350,-40
14532690781,14532690785,4,2225,1354,-40
14533806097,14533806103,6,2140,1145,-40
14534424259,14534424264,5,2220,1076,-40
14534672381,14534672402,21,3197,1131,-40
14534801754,14534801738,-16,936,196,-40
14535235044,14535235049,5,2131,898,-40
14536692846,14536692851,5,1630,1240,-40
14538334605,14538334610,5,2320,1109,-40
14542159889,14542159896,7,2542,1210,-40
14542256928,14542256935,7,2092,908,-40
14543198590,14543198597,7,1820,1299,-40
14543312966,14543312952,-14,934,436,-40
14544977209,14544977215,6,2078,929,-40
14546955123,14546955129,6,2187,1264,-40
14550357486,14550357494,8,2697,1356,-40
14556677285,14556677290,5,1986,951,-40
14557749379,14557749386,7,3711,1186,-40
14560873969,14560873974,5,2169,1174,-40
14564192476,14564192481,5,2943,1314,-40
14564246090,14564246076,-14,1458,680,-40
14565466881,14565466886,5,2472,1401,-40
14569229409,14569229416,7,1823,822,-40
14569428274,14569428259,-15,3272,1819,-40
14572537304,14572537301,-3,2742,6594,-40
14575567263,14575567270,7,3621,1116,-40
14581792420,14581792419,-1,95,761,-40
14587060686,14587060693,7,2833,1514,-40
14590175634,14590175640,6,1894,1221,-40
14590725298,14590725303,5,2326,1023,-40
14591392019,14591392025,6,2015,1439,-40
14591565260,14591565265,5,2422,1411,-40
14592918200,14592918205,5,1978,1141,-40
14595012328,14595012334,6,3143,1569,-40
14601162047,14601162053,6,2626,1010,-40
14602615509,14602615514,5,1391,411,-40
14602829709,14602829714,5,1217,281,-40
14603919694,14603919699,5,2091,1017,-40
14606187982,14606187978,-4,195,108,-40
14607908698,14607908698,0,1631,2752,-40
14609450341,14609450338,-3,1408,2140,-40
14617156318,14617156325,7,3104,1449,-40
14619703893,14619703899,6,3637,1644,-40
14622196593,14622196597,4,2467,1092,-40
14623832428,14623832435,7,3355,1292,-40
14630813194,14630813203,9,1587,818,-40
14639617084,14639617087,3,1940,1498,-40
14640207289,14640207291,2,1545,967,-40
14641785190,14641785192,2,1453,1827,-40
14648015750,14648015755,5,2245,1184,-40
14649196589,14649196593,4,2075,1021,-40
14660743782,14660743790,8,3010,1464,-40
14664783440,14664783445,5,3018,1348,-40
14667605185,14667605192,7,2569,1398,-40
14668830149,14668830131,-18,1687,1347,-40
14669371190,14669371197,7,2622,1191,-40
14669425503,14669425505,2,1139,253,-40
14684808918,14684808924,6,3223,1727,-40
14688280438,14688280445,7,2805,1355,-40
14689210821,14689210814,-7,1444,5823,-40
14692912670,14692912678,8,2408,914,-40
14693904489,14693904495,6,3220,1611,-40
14694741965,14694741971,6,11681,21823,-40
14695279830,14695279825,-5,1608,4269,-40
14696261065,14696261069,4,2363,953,-40
14698348550,14698348556,6,3343,1337,-40
14699972254,14699972261,7,3232,1625,-40
14700055703,14700055705,2,793,162,-40
14700951507,14700951502,-5,1472,1096,-40
14702926945,14702926949,4,3109,1524,-40
14706466163,14706466170,7,3993,869,-40
14710940358,14710940365,7,2017,1079,-40
14714108509,14714108515,6,2131,1063,-40
14714756603,14714756588,-15,2365,607,-40
14717782370,14717782375,5,3782,1948,-40
14717948811,14717948819,8,3203,1681,-40
14719070531,14719070520,-11,39666,17723,-40
14724189467,14724189472,5,2369,1114,-40
14725979283,14725979290,7,3579,1579,-40
14726341605,14726341611,6,3356,852,-40
14726494478,14726494464,-14,1609,642,-40
14728881001,14728881007,6,2551,1385,-40
14729907650,14729907657,7,3436,1082,-40
14734269911,14734269913,2,12694,14035,-40
14736729235,14736729241,6,2634,1240,-40
14742879626,14742879636,10,3205,2213,-40
14753170765,14753170771,6,2989,1518,-40
14762377273,14762377279,6,2188,1170,-40
14762974694,14762974701,7,2282,1471,-40
14764066242,14764066249,7,4013,1663,-40
14766809490,14766809496,6,1099,271,-40
14767041675,14767041681,6,1260,890,-40
14768241227,14768241234,7,3001,1354,-40
14768522267,14768522273,6,2254,1308,-40
14770029768,14770029762,-6,1262,4611,-40
14770610393,14770610394,1,2293,1309,-40
14772273644,14772273658,14,735,1793,-40
14772961144,14772961149,5,2919,1633,-40
14779655660,14779655666,6,2458,1848,-40
14782749239,14782749246,7,2866,1733,-40
14784097935,14784097941,6,3926,1262,-40
14786924930,14786924937,7,1502,1213,-40
14793786637,14793786639,2,1451,1328,-40
14806509762,14806509768,6,3137,1280,-40
14821459052,14821459058,6,2657,885,-40
14825670626,14825670631,5,2442,1662,-40
14827688461,14827688470,9,1363,683,-40
14830372541,14830372547,6,2146,905,-40
14830524798,14830524777,-21,1835,314,-40
14832126404,14832126410,6,7657,1174,-40
14832504725,14832504725,0,3169,4356,-40
14833176022,14833176026,4,4426,3167,-40
14838254206,14838254202,-4,1399,3462,-40
14839519555,14839519561,6,2220,1168,-40
14844790314,14844790321,7,4795,1267,-40
14855392078,14855392085,7,3564,1649,-40
14856148293,14856148298,5,2462,1103,-40
14856299298,14856299282,-16,1083,471,-40
14860681308,14860681313,5,2182,1292,-40
14863998384,14863998390,6,2855,1431,-40
14864300432,14864300439,7,2512,1436,-40
14870138410,14870138402,-8,536,2415,-40
14871444586,14871444592,6,3464,2673,-40
14871968672,14871968678,6,3662,1061,-40
14873588323,14873588327,4,1925,1612,-40
14879113021,14879113027,6,3004,1128,-40
14885816384,14885816389,5,2972,1426,-40
14887390142,14887390149,7,2402,897,-40
14891358377,14891358382,5,3539,1417,-40
14892315858,14892315863,5,2727,1375,-40
14892745063,14892745069,6,2087,1053,-40
14892955966,14892955956,-10,1922,1016,-40
14893370469,14893370476,7,2446,1248,-40
14893678438,14893678420,-18,2951,1331,-40
14894687326,14894687317,-9,1173,3382,-40
14899205108,14899205114,6,2677,1362,-40
14903197769,14903197775,6,3312,1205,-40
14904605701,14904605709,8,2859,1264,-40
14911867924,14911867933,9,2921,811,-40
14917538718,14917538726,8,3110,1476,-40
14921797710,14921797715,5,3308,1457,-40
14921916367,14921916347,-20,1942,1343,-40
14923236472,14923236479,7,2854,1476,-40
14924411285,14924411270,-15,1590,656,-40
14937044629,14937044636,7,2379,1322,-40
14937425184,14937425182,-2,2405,5002,-40
14938310834,14938310839,5,2588,1413,-40
14938484134,14938484140,6,2615,1211,-40
14939118246,14939118252,6,2300,1031,-40
14943712569,14943712576,7,1782,932,-40
14944417049,14944417054,5,1772,1263,-40
14947907954,14947907961,7,42126,58836,-40
14951290013,14951290014,1,26046,22187,-40
14951386055,14951386058,3,1893,1698,-40
14953637045,14953637050,5,1554,1202,-40
14956868958,14956868963,5,3075,1028,-40
14957743262,14957743265,3,13,4396,-40
14959777982,14959777991,9,3326,1621,-40
14963184033,14963184040,7,2388,1259,-40
14965370913,14965370907,-6,684,2401,-40
14966883241,14966883246,5,2576,1076,-40
14973672466,14973672472,6,3002,1240,-40
14975914327,14975914335,8,4045,1408,-40
14976845413,14976845419,6,3289,1285,-40
14977521877,14977521860,-17,1122,649,-40
14986065101,14986065107,6,3044,1576,-40
14987985425,14987985431,6,2861,1288,-40
14990428917,14990428922,5,4268,1136,-40
14993075060,14993075065,5,2569,1083,-40
14993612410,14993612414,4,2806,1129,-40
14993701464,14993701473,9,1002,234,-40
14996043082,14996043089,7,3174,1512,-40
14997253048,14997253055,7,2645,1562,-40
14999872460,14999872466,6,2321,1252,-40
15001892586,15001892593,7,2486,1339,-40
15003678843,15003678850,7,2408,1017,-40
15004980506,15004980512,6,1954,1207,-40
15005200837,15005200841,4,6748,27410,-40
15005486307,15005486311,4,1152,977,-40
15017964138,15017964147,9,2377,1154,-40
15018555355,15018555336,-19,1115,426,-40
15020273988,15020273996,8,3673,1141,-40
15021071267,15021071251,-16,2750,1466,-40
15021747939,15021747946,7,2229,1139,-40
15025967909,15025967915,6,2351,1087,-40
15026193557,15026193555,-2,1557,2259,-40
15031731997,15031732004,7,4546,1317,-40
15039268900,15039268911,11,128,1190,-40
15039424559,15039424563,4,1678,1240,-40
15040386937,15040386943,6,3369,1460,-40
15041088252,15041088258,6,3399,1467,-40
15041170109,15041170123,14,2087,1378,-40
15042790601,15042790607,6,3547,1367,-40
15042897149,15042897155,6,3302,1286,-40
15050028141,15050028146,5,2092,1522,-40
15051867918,15051867904,-14,1819,679,-40
15052838627,15052838633,6,3007,2249,-40
15058253078,15058253085,7,3829,1629,-40
15060336608,15060336590,-18,240,926,-40
15061047742,15061047747,5,2127,948,-40
15063879323,15063879331,8,2785,1313,-40
15066383120,15066383126,6,2877,1736,-40
15070793139,15070793154,15,26783,14162,-40
15073370170,15073370178,8,2636,1080,-40
15073734878,15073734859,-19,1235,391,-40
15074776980,15074776972,-8,2003,35252,-40
15075448716,15075448718,2,1120,1019,-40
15075824087,15075824074,-13,1028,405,-40
15083922754,15083922761,7,2313,1123,-40
15083963973,15083963970,-3,659,67,-40
15088283713,15088283719,6,3599,863,-40
15089895331,15089895335,4,2095,1433,-40
15090969639,15090969646,7,3301,1379,-40
15091631405,15091631393,-12,1187,409,-40
15091801987,15091801993,6,2121,1325,-40
15091931201,15091931187,-14,1809,1076,-40
15099639999,15099640003,4,1687,534,-40
15100031863,15100031870,7,3131,1375,-40
15101949581,15101949587,6,1560,830,-40
15105764404,15105764409,5,1977,1545,-40
15106388998,15106389008,10,597,145,-40
15107955930,15107955937,7,2601,1235,-40
15109954617,15109954621,4,3583,1214,-40
15110348070,15110348071,1,1682,2053,-40
15110422542,15110422541,-1,14131,49364,-40
15116104609,15116104616,7,2204,1031,-40
15120731679,15120731688,9,1974,1156,-40
15120813965,15120813985,20,5300,584,-40
15121569202,15121569207,5,2616,1318,-40
15123046410,15123046417,7,2268,1230,-40
15126920014,15126920021,7,2378,886,-40
15128735274,15128735281,7,2917,1419,-40
15136761418,15136761424,6,2892,1249,-40
15137830284,15137830289,5,2289,1407,-40
15139626829,15139626835,6,2245,1242,-40
15140155912,15140155917,5,2761,1157,-40
15140724129,15140724134,5,4009,1167,-40
15142176006,15142176014,8,3482,1205,-40
15144716494,15144716497,3,2840,1327,-40
15148610367,15148610374,7,4060,1592,-40
15151940238,15151940242,4,2322,1327,-40
15152803165,15152803171,6,3024,1395,-40
15154107930,15154107937,7,2167,1702,-40
15157471748,15157471754,6,2828,1534,-40
15160253210,15160253205,-5,1112,3998,-40
15161263427,15161263433,6,1637,1002,-40
15162486608,15162486614,6,2905,1112,-40
15163202022,15163202030,8,3056,1508,-40
15163628185,15163628191,6,4070,1394,-40
15166164893,15166164898,5,2534,1488,-40
15167525186,15167525191,5,3149,1306,-40
15167828477,15167828485,8,3010,1435,-40
15170186671,15170186676,5,1758,1113,-40
15170289704,15170289710,6,3694,1485,-40
15171929358,15171929346,-12,309,1483,-40
15175380548,15175380553,5,2268,1433,-40
15179145253,15179145259,6,3211,1310,-40
15184749695,15184749696,1,1908,1516,-40
15193862572,15193862571,-1,1106,1782,-40
15196861409,15196861415,6,1573,1088,-40
15198049698,15198049703,5,2750,981,-40
15198866864,15198866869,5,3050,1104,-40
15198985897,15198985884,-13,2371,906,-40
15199229416,15199229421,5,2605,1429,-40
15201275788,15201275795,7,1514,704,-40
15215937800,15215937806,6,2566,1202,-40
15218014642,15218014650,8,2238,1204,-40
15220066494,15220066494,0,2803,3664,-40
15229535911,15229535910,-1,5413,8314,-40
15231927753,15231927758,5,3139,1643,-40
15233907853,15233907859,6,2155,1182,-40
15236700820,15236700827,7,2429,1410,-40
15238077065,15238077072,7,2939,1482,-40
15240531649,15240531654,5,1822,1220,-40
15242496409,15242496414,5,3225,1401,-40
15245317923,15245317930,7,2328,1580,-40
15247750889,15247750894,5,2801,1496,-40
15248443021,15248443027,6,1598,710,-40
15250879229,15250879233,4,3178,1364,-40
15251837355,15251837362,7,2475,620,-40
15265691910,15265691916,6,1744,1098,-40
15267531990,15267531996,6,3455,1633,-40
15268673662,15268673671,9,2440,989,-40
15273124957,15273124962,5,1963,1364,-40
15274781341,15274781348,7,3123,1140,-40
15279249077,15279249085,8,1448,664,-40
15282177302,15282177307,5,1372,1041,-40
15284145910,15284145917,7,2538,625,-40
15287475366,15287475372,6,2306,1297,-40
15292559112,15292559116,4,2048,1308,-40
15297457017,15297457021,4,2018,1526,-40
15298158305,15298158305,0,1896,2418,-40
15298591285,15298591290,5,1963,1147,-40
15299300559,15299300565,6,2791,1281,-40
15302198914,15302198920,6,2653,1093,-40
15302517960,15302517966,6,3275,1420,-40
15304723334,15304723340,6,3158,992,-40
15307966326,15307966331,5,3561,1389,-40
15308765775,15308765782,7,1067,623,-40
15311376571,15311376569,-2,1357,1853,-40
15313152623,15313152628,5,2135,1155,-40
15313353138,15313353142,4,1665,1045,-40
15316955913,15316955919,6,1004,580,-40
15326393761,15326393766,5,2161,816,-40
15326822275,15326822283,8,3449,1033,-40
15327040673,15327040682,9,1855,1109,-40
15328687821,15328687818,-3,2897,5460,-40
15328996388,15328996397,9,4169,1376,-40
15336036328,15336036333,5,3201,1962,-40
15336614133,15336614138,5,3031,1046,-40
15336769842,15336769845,3,2061,1694,-40
15337065637,15337065643,6,2660,1091,-40
15338009522,15338009527,5,1403,1146,-40
15339446895,15339446901,6,2965,1528,-40
15340234476,15340234481,5,3469,1021,-40
15341841185,15341841191,6,3529,1385,-40
15343055307,15343055313,6,3388,1361,-40
15343421022,15343421003,-19,3130,1347,-40
15344483297,15344483283,-14,1538,1056,-40
15344738557,15344738536,-21,2636,921,-40
15346702294,15346702299,5,4122,1478,-40
15347194471,15347194479,8,3055,1299,-40
15351841479,15351841475,-4,749,2345,-40
15353759978,15353759984,6,2664,1343,-40
15354217036,15354217016,-20,2159,1063,-40
15354868529,15354868534,5,35502,28035,-40
15358446111,15358446117,6,3567,1816,-40
15361223971,15361223976,5,2984,1196,-40
15363467425,15363467433,8,3885,1544,-40
15364230466,15364230471,5,2391,980,-40
15369900978,15369900985,7,3458,1413,-40
15371281815,15371281820,5,3117,1443,-40
15371549315,15371549322,7,2764,1127,-40
15372117322,15372117327,5,2604,1122,-40
15378706185,15378706193,8,2926,1390,-40
15380660130,15380660135,5,3090,1467,-40
15380841240,15380841245,5,3204,1540,-40
15382032101,15382032107,6,3206,1650,-40
15382167607,15382167587,-20,1406,485,-40
15388275192,15388275196,4,2914,2089,-40
15391570432,15391570438,6,3134,1327,-40
15396124187,15396124193,6,2701,1808,-40
15396620657,15396620664,7,3201,1214,-40
15400371486,15400371483,-3,1194,1952,-40
15403590138,15403590143,5,2964,2122,-40
15404222327,15404222333,6,2355,1229,-40
15404590660,15404590658,-2,1353,3352,-40
15409308161,15409308166,5,2405,973,-40
15412976798,15412976806,8,1798,1142,-40
15413395570,15413395578,8,3352,1457,-40
15418225183,15418225190,7,2761,1331,-40
15419470946,15419470953,7,2616,1440,-40
15420358321,15420358306,-15,1382,595,-40
15421591145,15421591154,9,2550,959,-40
15427837870,15427837875,5,3596,1097,-40
15430238769,15430238774,5,2555,1601,-40
15430290385,15430290390,5,2637,1533,-40
15433551410,15433551418,8,3258,1085,-40
15437017346,15437017353,7,955,714,-40
15437649722,15437649727,5,2535,1150,-40
15440997954,15440997958,4,6016,5070,-40
15441898029,15441898035,6,2891,1068,-40
15442853719,15442853718,-1,1377,2213,-40
15451202521,15451202527,6,2561,1136,-40
15453966026,15453966033,7,3620,1548,-40
15455108377,15455108383,6,2298,1320,-40
15461015011,15461015017,6,2784,1298,-40
15467181861,15467181867,6,1690,993,-40
15471493537,15471493544,7,3087,1140,-40
15475398011,15475398018,7,3996,1454,-40
15476252258,15476252265,7,2985,1454,-40
15476615718,15476615724,6,3231,1620,-40
15477912157,15477912165,8,3265,959,-40
15486890014,15486890019,5,2438,1569,-40
15489323628,15489323634,6,2964,1294,-40
15493012861,15493012867,6,2746,946,-40
15493998911,15493998916,5,1507,976,-40
15495954797,15495954803,6,3949,1170,-40
15496284486,15496284492,6,3570,1590,-40
15506456643,15506456649,6,2835,1190,-40
15508425934,15508425922,-12,1133,367,-40
15511647439,15511647424,-15,1684,34107,-40
15512304071,15512304078,7,2490,1366,-40
15513148046,15513148035,-11,1215,442,-40
15515223178,15515223182,4,2947,1112,-40
15516748831,15516748832,1,843,269,-40
15519331174,15519331178,4,2471,1496,-40
15519377406,15519377401,-5,1094,2647,-40
15520047306,15520047314,8,2491,1387,-40
15523515825,15523515831,6,1707,934,-40
15523710686,15523710690,4,1814,1546,-40
15525888176,15525888182,6,3962,1548,-40
15526313230,15526313242,12,1978,1010,-40
15526537490,15526537493,3,1277,1091,-40
15527648183,15527648190,7,2571,1044,-40
15528444641,15528444626,-15,1929,1014,-40
15528708694,15528708699,5,2725,1582,-40
15528734302,15528734310,8,2354,888,-40
15532508442,15532508446,4,3009,1223,-40
15535917482,15535917487,5,2537,1404,-40
15536904471,15536904477,6,2188,832,-40
15538800371,15538800378,7,2486,1046,-40
15538914371,15538914353,-18,2180,686,-40
15544385875,15544385882,7,2905,1361,-40
15545091849,15545091855,6,3396,1031,-40
15547290985,15547290992,7,3397,1614,-40
15549403250,15549403248,-2,919,1642,-40
15551102490,15551102496,6,2855,1198,-40
15551589678,15551589684,6,3167,1675,-40
15552307287,15552307294,7,2141,1419,-40
15554285020,15554285025,5,2286,1216,-40
15554630542,15554630554,12,677,71,-40
15555402917,15555402896,-21,2249,679,-40
15555811084,15555811090,6,2142,919,-40
15559149827,15559149833,6,2816,1122,-40
15559297237,15559297218,-19,2917,549,-40
15565893898,15565893905,7,3099,1291,-40
15566119050,15566119050,0,630,244,-40
15566486541,15566486546,5,2301,1786,-40
15570693653,15570693658,5,2409,1553,-40
15572568054,15572568059,5,1810,1277,-40
15575530621,15575530620,-1,1689,1395,-40
15575629521,15575629527,6,2162,867,-40
15576826417,15576826421,4,1615,1366,-40
15579608062,15579608070,8,1841,978,-40
15583140076,15583140083,7,2259,1247,-40
15584420783,15584420789,6,1953,1176,-40
15587197577,15587197581,4,1825,1257,-40
15592771902,15592771907,5,2543,1065,-40
15592967053,15592967057,4,2008,934,-40
15593052969,15593052952,-17,1050,340,-40
15594107303,15594107298,-5,1665,4080,-40
15595935625,15595935630,5,1815,917,-40
15596561104,15596561088,-16,1595,300,-40
15597927536,15597927539,3,3339,2765,-40
15598652866,15598652869,3,1891,1439,-40
15598824889,15598824873,-16,1677,612,-40
15601516622,15601516629,7,2101,906,-40
15603652405,15603652413,8,3655,1369,-40
15605286094,15605286102,8,3564,1372,-40
15609115902,15609115907,5,1987,634,-40
15610450556,15610450562,6,2555,783,-40
15613521229,15613521241,12,3194,1781,-40
15613590109,15613590100,-9,675,467,-40
15617670312,15617670318,6,2264,1459,-40
15621211962,15621211970,8,3256,1129,-40
15621976262,15621976266,4,2201,1299,-40
15622856045,15622856039,-6,1438,3515,-40
15624844755,15624844749,-6,1429,7028,-40
15625984281,15625984288,7,2175,1257,-40
15631765310,15631765317,7,3277,888,-40
15631967193,15631967199,6,2016,1000,-40
15633159029,15633159034,5,1937,1377,-40
15633410108,15633410113,5,2121,1263,-40
15633542533,15633542539,6,3537,1650,-40
15636721714,15636721723,9,4311,1672,-40
15637522348,15637522354,6,2363,1209,-40
15646462865,15646462871,6,2914,1043,-40
15648797517,15648797523,6,1913,1006,-40
15655533622,15655533626,4,2769,1070,-40
15656090756,15656090762,6,3441,1735,-40
15657910107,15657910114,7,3404,1375,-40
15660247035,15660247041,6,2899,1240,-40
15660719696,15660719693,-3,2969,5439,-40
15669371378,15669371386,8,3881,1672,-40
15674771293,15674771299,6,2697,929,-40
15678415918,15678415926,8,2916,1037,-40
15678650348,15678650349,1,1855,2222,-40
15683845574,15683845581,7,2892,1150,-40
15684916879,15684916868,-11,769,208,-40
15685819582,15685819580,-2,1375,1503,-40
15687648577,15687648581,4,1882,1088,-40
15703245687,15703245690,3,1550,679,-40
15705026788,15705026795,7,3183,1309,-40
15705482483,15705482487,4,2544,1780,-40
15708890594,15708890615,21,576,1882,-40
15710887035,15710887040,5,2410,1421,-40
15713721806,15713721812,6,4432,1388,-40
15717463553,15717463557,4,2115,1013,-40
15723077894,15723077901,7,6764,948,-40
15724445443,15724445449,6,4369,1934,-40
15727433498,15727433503,5,2655,1290,-40
15728201297,15728201304,7,3239,1294,-40
15728562962,15728562968,6,4592,1750,-40
15731591505,15731591511,6,3416,1570,-40
15732824222,15732824231,9,2832,1380,-40
15733978212,15733978221,9,1951,990,-40
15736010479,15736010486,7,1946,1135,-40
15737923167,15737923174,7,2132,990,-40
15739384958,15739384964,6,1690,1038,-40
15740773077,15740773082,5,3200,1423,-40
15742122786,15742122793,7,2951,1135,-40
15752622662,15752622669,7,2801,1301,-40
15753686753,15753686758,5,2131,1064,-40
15768577193,15768577181,-12,1824,405,-40
15771817177,15771817183,6,2453,845,-40
15777762766,15777762773,7,2863,1213,-40
15781765925,15781765931,6,1741,1261,-40
15781868239,15781868241,2,897,1981,-40
15782762233,15782762241,8,2465,894,-40
15787178674,15787178681,7,3202,1361,-40
15787579183,15787579171,-12,747,406,-40
15790906428,15790906428,0,1930,2188,-40
15791530080,15791530083,3,1479,1044,-40
15793156896,15793156880,-16,3083,1198,-40
15797852095,15797852102,7,3324,1839,-40
15799002373,15799002379,6,3811,1333,-40
15800227577,15800227581,4,2607,1143,-40
15801951526,15801951533,7,3005,1117,-40
15803148758,15803148766,8,3083,1472,-40
15806420924,15806420929,5,2356,1219,-40
15811628516,15811628522,6,3495,1160,-40
15813624587,15813624593,6,3012,1463,-40
15824879988,15824879993,5,3466,1688,-40
15826079315,15826079321,6,2673,1084,-40
15826812548,15826812547,-1,1583,2039,-40
15828488444,15828488450,6,2721,1237,-40
15829667602,15829667609,7,2439,1388,-40
15833657885,15833657891,6,2944,1134,-40
15834220536,15834220524,-12,2795,1157,-40
15839521725,15839521732,7,2544,1631,-40
15843444516,15843444522,6,2438,869,-40
15844331572,15844331577,5,2211,1158,-40
15847082411,15847082414,3,1840,2457,-40
15847357477,15847357484,7,2082,1478,-40
15847657142,15847657123,-19,2410,1038,-40
15848702502,15848702509,7,1604,1300,-40
15852824618,15852824625,7,3045,1422,-40
15857042994,15857042997,3,1488,1390,-40
15865709478,15865709485,7,1367,733,-40
15869381127,15869381135,8,3202,1424,-40
15870395425,15870395432,7,2853,1529,-40
15870515815,15870515794,-21,731,221,-40
15871465773,15871465780,7,4729,833,-40
15871968391,15871968372,-19,735,505,-40
15873776775,15873776782,7,2733,1339,-40
15877217179,15877217185,6,3934,1599,-40
15878722397,15878722404,7,3523,1359,-40
15879522847,15879522824,-23,718,321,-40
15880367112,15880367119,7,3293,1073,-40
15880468189,15880468195,6,2476,1643,-40
15882045802,15882045808,6,2670,1513,-40
15882731874,15882731870,-4,773,1604,-40
15887169220,15887169226,6,3115,1660,-40
15887421175,15887421182,7,2675,1530,-40
15887790756,15887790762,6,2048,1086,-40
15890705790,15890705796,6,2640,1015,-40
15892319676,15892319681,5,3400,1709,-40
15892553412,15892553418,6,3683,1502,-40
15893307450,15893307457,7,2960,1369,-40
15894325821,15894325828,7,3826,1739,-40
15896220963,15896220970,7,2752,1113,-40
15898675405,15898675410,5,3125,1681,-40
15903924895,15903924898,3,645,838,-40
15907286833,15907286838,5,2524,1180,-40
15907845378,15907845383,5,3604,1455,-40
15910234137,15910234129,-8,526,4522,-40
15911299062,15911299067,5,2759,1779,-40
15914850186,15914850191,5,2234,613,-40
15915167329,15915167332,3,2000,1945,-40
15923555016,15923555019,3,1333,1655,-40
15926173316,15926173322,6,3967,1813,-40
15927221935,15927221942,7,2346,1146,-40
15928692492,15928692491,-1,1549,1752,-40
15932681901,15932681906,5,1378,491,-40
15935781327,15935781332,5,2570,1045,-40
15939209087,15939209095,8,3165,1124,-40
15941377066,15941377063,-3,1996,42065,-40
15941627487,15941627494,7,2750,873,-40
15946853082,15946853089,7,2202,1354,-40
15961980513,15961980519,6,2140,1054,-40
15962292239,15962292249,10,2089,934,-40
15969652775,15969652779,4,1988,1128,-40
15971447146,15971447156,10,2190,1439,-40
15977525985,15977525990,5,3297,1633,-40
15980455701,15980455707,6,3351,1092,-40
15983087811,15983087818,7,2404,1186,-40
15983743850,15983743847,-3,603,1271,-40
15988465831,15988465835,4,1377,1108,-40
15991843786,15991843802,16,1077,141,-40
15999544333,15999544338,5,2312,839,-40
16002234933,16002234940,7,2304,1260,-40
16002528069,16002528049,-20,2464,1264,-40
16003966690,16003966697,7,3055,1249,-40
16013369624,16013369631,7,2135,1208,-40
16013534236,16013534243,7,3097,1206,-40
16013597972,16013597977,5,3191,1227,-40
16016403856,16016403863,7,4187,1296,-40
16016444294,16016444299,5,2206,1229,-40
16017531723,16017531730,7,3311,1109,-40
16020611668,16020611665,-3,1528,3200,-40
16020946180,16020946186,6,2426,1075,-40
16024289790,16024289780,-10,36463,8646,-40
16025121736,16025121743,7,2908,1170,-40
16034405230,16034405237,7,2813,1784,-40
16036791793,16036791800,7,3010,1474,-40
16038398178,16038398183,5,2379,1286,-40
16044646927,16044646922,-5,2224,6986,-40
16047010102,16047010109,7,3140,1273,-40
16047675954,16047675961,7,2437,879,-40
16049018862,16049018884,22,744,206,-40
16050779401,16050779409,8,3438,1217,-40
16053259405,16053259410,5,2148,1137,-40
16054427781,16054427802,21,2669,1570,-40
16054910325,16054910323,-2,1198,259,-40
16061084661,16061084666,5,3711,1213,-40
16061374047,16061374048,1,961,311,-40
16069891130,16069891138,8,2025,1074,-40
16075455834,16075455842,8,3076,1323,-40
16077591984,16077591989,5,2516,1017,-40
16080776292,16080776298,6,3104,1732,-40
16082230698,16082230703,5,2272,1046,-40
16084533937,16084533942,5,2087,1153,-40
16086095668,16086095670,2,1494,933,-40
16089043749,16089043755,6,2907,1112,-40
16091121028,16091121035,7,3068,1131,-40
16093874009,16093874011,2,2428,2358,-40
16097302397,16097302403,6,3114,1371,-40
16099510251,16099510255,4,9156,25381,-40
16100062215,16100062222,7,3016,1618,-40
16107868366,16107868362,-4,1472,3901,-40
16113648726,16113648732,6,2756,1799,-40
16115092171,16115092177,6,3236,1403,-40
16116733206,16116733214,8,3019,835,-40
16117515557,16117515564,7,2651,1207,-40
16118390892,16118390898,6,2235,1786,-40
16119214422,16119214429,7,3595,1144,-40
16123501742,16123501747,5,3852,1381,-40
16125579355,16125579351,-4,865,2188,-40
16126797093,16126797099,6,2669,1169,-40
16127419935,16127419921,-14,1277,516,-40
16132844688,16132844694,6,2722,1305,-40
16133791874,16133791882,8,2448,909,-40
16138797833,16138797844,11,13347,51722,-40
16141432409,16141432414,5,2545,1258,-40
16149068959,16149068965,6,3479,1857,-40
16159088300,16159088306,6,2283,921,-40
16162292221,16162292228,7,4003,1380,-40
16162358756,16162358779,23,2322,1120,-40
16163493773,16163493761,-12,1401,614,-40
16165677813,16165677820,7,1865,1651,-40
16167429445,16167429447,2,3852,2079,-40
16175127108,16175127115,7,3317,1451,-40
16178493112,16178493118,6,2347,935,-40
16182201149,16182201155,6,2104,1148,-40
16184745669,16184745674,5,3154,1113,-40
16192435593,16192435599,6,3222,1102,-40
16195144804,16195144811,7,2534,1101,-40
16196777545,16196777547,2,1432,999,-40
16198961878,16198961885,7,4390,1434,-40
16201178117,16201178123,6,2726,1477,-40
16204859762,16204859769,7,1714,1024,-40
16222419614,16222419621,7,2926,1252,-40
16225356749,16225356756,7,2899,1381,-40
16232618647,16232618654,7,2020,1015,-40
16238645394,16238645402,8,3351,1221,-40
16238679670,16238679651,-19,2901,1188,-40
16243453021,16243453028,7,3368,1218,-40
16247500449,16247500458,9,3518,1287,-40
16248441199,16248441202,3,1760,1276,-40
16249476225,16249476230,5,2606,1165,-40
16251966942,16251966949,7,3632,1294,-40
16255606961,16255606966,5,1945,1162,-40
16262804170,16262804174,4,1235,857,-40
16264928009,16264928015,6,2401,1308,-40
16265422265,16265422274,9,2125,1193,-40
16265815389,16265815395,6,2427,1021,-40
16268591280,16268591285,5,2961,1365,-40
16276358594,16276358589,-5,1110,4418,-40
16278391014,16278391017,3,1676,1567,-40
16280498560,16280498566,6,2769,811,-40
16280769971,16280769977,6,644,160,-40
16282986745,16282986750,5,2527,1083,-40
16285412221,16285412222,1,2537,3790,-40
16286892945,16286892951,6,3027,1188,-40
16289584841,16289584845,4,2991,1500,-40
16289630264,16289630271,7,3786,1509,-40
16296668671,16296668675,4,2301,1845,-40
16298403824,16298403830,6,2790,1110,-40
16298767043,16298767051,8,2788,943,-40
16310534461,16310534467,6,1991,917,-40
16312688423,16312688430,7,2178,917,-40
16314711068,16314711075,7,2079,1257,-40
16323397301,16323397308,7,3322,1308,-40
16323904871,16323904878,7,2341,1374,-40
16325324032,16325324038,6,2387,1308,-40
16325839151,16325839158,7,3440,824,-40
16326662041,16326662046,5,3620,1427,-40
16329212130,16329212136,6,3647,1291,-40
16334463266,16334463271,5,2387,1288,-40
16334944922,16334944908,-14,2238,1189,-40
16338100410,16338100415,5,2290,1169,-40
16338211957,16338211936,-21,1108,837,-40
16348759164,16348759171,7,2387,1299,-40
16351465467,16351465474,7,2019,634,-40
16352901231,16352901225,-6,1656,7803,-40
16354205677,16354205683,6,3179,751,-40
16354397199,16354397179,-20,1564,859,-40
16358375858,16358375862,4,1154,1415,-40
16359072078,16359072083,5,1788,795,-40
16360184749,16360184745,-4,1282,2431,-40
16364154548,16364154551,3,23958,25394,-40
16364181474,16364181478,4,3068,845,-40
16365209422,16365209429,7,1884,1410,-40
16369627340,16369627346,6,3450,1469,-40
16371652882,16371652890,8,2996,1262,-40
16372432753,16372432759,6,2835,1226,-40
16376542721,16376542713,-8,986,2989,-40
16380550754,16380550734,-20,2125,800,-40
16383387170,16383387159,-11,774,314,-40
16384605720,16384605726,6,1976,839,-40
16386705294,16386705301,7,3105,1344,-40
16386817043,16386817050,7,3348,1383,-40
16387456285,16387456293,8,4291,1634,-40
16389467123,16389467130,7,2013,1114,-40
16389749743,16389749728,-15,2188,1530,-40
16394827586,16394827592,6,2351,1168,-40
16397107152,16397107159,7,1813,551,-40
16398327672,16398327678,6,3951,1698,-40
16402299809,16402299816,7,1958,652,-40
16409224807,16409224811,4,1670,982,-40
16413358830,16413358835,5,2515,931,-40
16415090535,16415090542,7,2830,1352,-40
16415376177,16415376162,-15,1070,396,-40
16415883020,16415883024,4,869,934,-40
16417927059,16417927065,6,2367,1266,-40
16418233906,16418233915,9,2623,1010,-40
16425590490,16425590502,12,141,3783,-40
16429086971,16429086975,4,3411,1741,-40
16432816711,16432816718,7,2612,1186,-40
16433461830,16433461835,5,3205,937,-40
16434118130,16434118112,-18,2488,755,-40
16434468311,16434468319,8,1962,1737,-40
16434858765,16434858769,4,479,251,-40
16439537457,16439537462,5,2523,1441,-40
16440489347,16440489346,-1,1908,2519,-40
16440677213,16440677218,5,2245,1182,-40
16445423605,16445423612,7,3106,1353,-40
16449124107,16449124091,-16,1097,1335,-40
16451971203,16451971202,-1,569,1127,-40
16452359104,16452359089,-15,2041,1478,-40
16455940690,16455940693,3,1496,846,-40
16457136949,16457136955,6,4029,1581,-40
16466648001,16466648007,6,2935,1567,-40
16467681952,16467681956,4,2150,1189,-40
16470535067,16470535061,-6,1330,4364,-40
16472390795,16472390802,7,1311,1428,-40
16480440177,16480440182,5,2862,985,-40
16482933686,16482933693,7,3342,1987,-40
16489293473,16489293480,7,1913,892,-40
16489491419,16489491426,7,2302,1397,-40
16493772938,16493772942,4,2643,1492,-40
16499249610,16499249615,5,2193,808,-40
16499320405,16499320386,-19,1238,550,-40
16500059604,16500059610,6,1815,1036,-40
16501770314,16501770322,8,2317,1411,-40
16502696881,16502696887,6,2592,1524,-40
16503152072,16503152078,6,2806,1170,-40
16506125296,16506125302,6,3130,1097,-40
16509122731,16509122737,6,2503,1169,-40
16517193329,16517193335,6,2562,1248,-40
16518355685,16518355691,6,2480,1268,-40
16527420765,16527420771,6,1920,1290,-40
16528436096,16528436088,-8,794,494,-40
16530076177,16530076171,-6,1869,938,-40
16530804973,16530804963,-10,1251,697,-40
16534513004,16534513010,6,2668,1280,-40
16539861556,16539861557,1,2030,2399,-40
16539965038,16539965034,-4,2026,6256,-40
16540877413,16540877419,6,1784,924,-40
16543614750,16543614740,-10,1026,292,-40
16544323693,16544323698,5,2186,1304,-40
16549858742,16549858749,7,3596,1585,-40
16554629030,16554629038,8,2888,1048,-40
16560611615,16560611621,6,2566,1371,-40
16560820424,16560820441,17,1389,1484,-40
16562456643,16562456649,6,2577,1481,-40
16563989550,16563989555,5,669,417,-40
16568245093,16568245090,-3,1035,1976,-40
16569321930,16569321951,21,2396,905,-40
16579713867,16579713875,8,3718,1305,-40
16584546461,16584546468,7,3195,1251,-40
16586196003,16586196007,4,1655,1287,-40
16588161045,16588161051,6,2863,1184,-40
16589393405,16589393413,8,3896,1694,-40
16593281190,16593281197,7,2288,1324,-40
16596619781,16596619787,6,2195,1124,-40
16598497749,16598497756,7,2915,957,-40
16599510313,16599510320,7,3119,1311,-40
16600061147,16600061145,-2,765,130,-40
16601612993,16601612999,6,2004,1525,-40
16604068269,16604068275,6,4954,1127,-40
16606143877,16606143882,5,2258,1271,-40
16607139153,16607139146,-7,902,4416,-40
16609190153,16609190159,6,2442,1013,-40
16616634510,16616634517,7,3664,1229,-40
16621666355,16621666345,-10,742,237,-40
16622421321,16622421327,6,2080,820,-40
16623917149,16623917170,21,1172,1531,-40
16632867676,16632867683,7,3043,1000,-40
16637078094,16637078103,9,4049,1220,-40
16638353237,16638353242,5,2221,1012,-40
16645512417,16645512421,4,2743,1785,-40
16646886778,16646886778,0,2385,2520,-40
16650385780,16650385785,5,2333,994,-40
16651068650,16651068655,5,3209,1104,-40
16652438738,16652438746,8,3945,1191,-40
16658059105,16658059110,5,1796,865,-40
16663929532,16663929538,6,3164,1377,-40
16668823809,16668823814,5,2979,1134,-40
16671230175,16671230181,6,2857,1828,-40
16673130222,16673130230,8,2481,1403,-40
16677318631,16677318637,6,3151,1118,-40
16679149850,16679149857,7,1703,807,-40
16684139339,16684139347,8,4193,1589,-40
16684258567,16684258573,6,3027,1007,-40
16685126148,16685126153,5,2836,1317,-40
16685421586,16685421569,-17,2597,977,-40
16685548216,16685548224,8,2889,877,-40
16686426845,16686426851,6,2054,1391,-40
16689969697,16689969703,6,1916,711,-40
16693739694,16693739694,0,1461,2125,-40
16693853942,16693853947,5,1609,1481,-40
16695374893,16695374899,6,3780,1233,-40
16696354712,16696354696,-16,1130,457,-40
16701286211,16701286217,6,2115,1076,-40
16701487622,16701487627,5,2279,1349,-40
16706950652,16706950646,-6,1313,5206,-40
16708077422,16708077430,8,3013,1277,-40
16708508345,16708508340,-5,2131,8095,-40
16711571684,16711571683,-1,7660,10136,-40
16711967601,16711967610,9,3563,1393,-40
16715017235,16715017241,6,3212,1281,-40
16716894199,16716894206,7,3669,811,-40
16717335021,16717335021,0,1355,1981,-40
16720807546,16720807552,6,2476,1465,-40
16721082303,16721082309,6,2719,1477,-40
16722439658,16722439664,6,3235,2084,-40
16724514410,16724514415,5,2055,1185,-40
16731154884,16731154878,-6,2276,43556,-40
16731945442,16731945449,7,3038,1309,-40
16732005808,16732005814,6,2475,1463,-40
16733277461,16733277467,6,2419,1080,-40
16736276347,16736276355,8,2657,1275,-40
16740211901,16740211906,5,1963,1365,-40
16741326837,16741326842,5,3090,1524,-40
16741752310,16741752289,-21,1787,983,-40
16743572035,16743572042,7,1929,1151,-40
16743796083,16743796083,0,609,285,-40
16744505630,16744505637,7,2396,1233,-40
16744584634,16744584618,-16,1394,924,-40
16746540677,16746540682,5,4428,1367,-40
16747071148,16747071153,5,1706,1150,-40
16763735222,16763735230,8,3238,1019,-40
16764422868,16764422848,-20,2256,973,-40
16766281821,16766281828,7,3123,1622,-40
16768983267,16768983270,3,1325,1283,-40
16769658517,16769658523,6,5457,1429,-40
16770814885,16770814866,-19,735,583,-40
16772825770,16772825769,-1,1479,1362,-40
16772862752,16772862758,6,271,1141,-40
16774978765,16774978771,6,1969,1129,-40
16775797917,16775797923,6,3271,1114,-40
16778183720,16778183725,5,3377,1752,-40
16782972751,16782972758,7,2932,1431,-40
16785535064,16785535067,3,3028,2812,-40
16787810921,16787810929,8,2353,1008,-40
16788171902,16788171902,0,1057,1420,-40
16793032644,16793032648,4,2260,922,-40
16801264200,16801264205,5,3275,1598,-40
16801372085,16801372091,6,2049,872,-40
16807677845,16807677851,6,2718,1246,-40
16808169695,16808169692,-3,1014,2160,-40
16817013823,16817013825,2,1132,1471,-40
16821072751,16821072758,7,2774,1369,-40
16822983930,16822983933,3,3191,3527,-40
16830956354,16830956360,6,2577,1321,-40
16831524758,16831524766,8,1398,1036,-40
16831814291,16831814274,-17,957,677,-40
16832777530,16832777537,7,3477,1377,-40
16834358948,16834358954,6,3217,1492,-40
16834486274,16834486280,6,3082,1287,-40
16835595488,16835595491,3,1582,1249,-40
16837555127,16837555134,7,2569,1400,-40
16839314309,16839314315,6,2808,1210,-40
16840886254,16840886250,-4,816,3321,-40
16845787505,16845787510,5,1279,787,-40
16859603290,16859603292,2,1003,1109,-40
16860593131,16860593137,6,3332,1860,-40
16862365299,16862365298,-1,2440,4082,-40
16862664261,16862664267,6,2252,1290,-40
16863798821,16863798826,5,2839,1080,-40
16864322783,16864322789,6,3776,1108,-40
16864552600,16864552584,-16,2659,1394,-40
16865603097,16865603102,5,2540,1118,-40
16868752581,16868752587,6,2964,1054,-40
16869924330,16869924335,5,2502,1500,-40
16870018345,16870018351,6,3247,1192,-40
16872720799,16872720805,6,2141,773,-40
16872920873,16872920878,5,3140,1326,-40
16875105755,16875105761,6,3068,1251,-40
16877444982,16877444970,-12,4134,1376,-40
16880105309,16880105314,5,2443,1263,-40
16883337961,16883337966,5,2340,1343,-40
16883670842,16883670847,5,3176,1259,-40
16883823886,16883823894,8,3105,1256,-40
16884642142,16884642123,-19,1360,584,-40
16885487574,16885487580,6,2660,969,-40
16885835658,16885835652,-6,812,192,-40
16886812541,16886812549,8,3059,1449,-40
16887431896,16887431900,4,2239,1398,-40
16894078349,16894078356,7,2680,1024,-40
16906815385,16906815387,2,3723,3631,-40
16907987358,16907987358,0,1538,2050,-40
16912975551,16912975558,7,2940,1588,-40
16914148638,16914148646,8,2772,1026,-40
16915311337,16915311324,-13,823,220,-40
16920727700,16920727706,6,4359,1561,-40
16921103975,16921103955,-20,1063,253,-40
16921201498,16921201503,5,3798,1416,-40
16921720969,16921720974,5,3480,1248,-40
16925351005,16925351010,5,2839,1372,-40
16925704822,16925704827,5,3371,1452,-40
16927033342,16927033346,4,2649,987,-40
16927704660,16927704683,23,150,748,-40
16930419670,16930419677,7,2492,1024,-40
16934309618,16934309626,8,2670,1366,-40
16935575306,16935575314,8,4211,2235,-40
16939179160,16939179164,4,1596,1328,-40
16941832386,16941832392,6,2657,1368,-40
16944704474,16944704471,-3,509,1518,-40
16946429738,16946429733,-5,1123,3334,-40
16946859845,16946859852,7,2158,1894,-40
16947490198,16947490203,5,2165,1069,-40
16949212330,16949212335,5,2046,1327,-40
16955455915,16955455922,7,3704,1408,-40
16958825034,16958825036,2,1941,1964,-40
16961350178,16961350184,6,3604,1605,-40
16965814571,16965814578,7,4371,1624,-40
16968968470,16968968470,0,2739,4142,-40
16974280842,16974280837,-5,1150,5651,-40
16978789850,16978789857,7,3077,1756,-40
16979537126,16979537131,5,2587,1705,-40
16980304382,16980304387,5,4136,1660,-40
16980417553,16980417554,1,2110,2906,-40
16981515486,16981515494,8,3045,1346,-40
16986301081,16986301089,8,2834,892,-40
16986730625,16986730631,6,3582,1745,-40
16991274519,16991274528,9,3733,1840,-40
17003747366,17003747371,5,2274,1285,-40
17006443361,17006443362,1,3351,3260,-40
17010829787,17010829794,7,2147,1202,-40
17015958158,17015958156,-2,1957,2749,-40
17020535379,17020535383,4,2184,1643,-40
17024443273,17024443279,6,2625,1145,-40
17024694721,17024694727,6,1745,1041,-40
17026096938,17026096945,7,1523,849,-40
17028368844,17028368850,6,2361,876,-40
17029087559,17029087565,6,2740,1265,-40
17032301619,17032301624,5,1224,684,-40
17036548960,17036548967,7,1215,460,-40
17037208606,17037208613,7,3104,1364,-40
17039721254,17039721260,6,2771,1465,-40
17040626564,17040626569,5,2845,1025,-40
17042128613,17042128619,6,1687,1032,-40
17043379923,17043379905,-18,2904,912,-40
17045159841,17045159846,5,2734,809,-40
17045630758,17045630754,-4,1133,3077,-40
17045922461,17045922467,6,2142,1432,-40
17050289641,17050289646,5,2506,794,-40
17050432159,17050432165,6,3081,1318,-40
17052134270,17052134278,8,3568,1447,-40
17056961391,17056961399,8,2826,1049,-40
17057416293,17057416315,22,1176,265,-40
17065436325,17065436331,6,2977,1325,-40
17067570874,17067570871,-3,2434,3351,-40
17070185774,17070185779,5,3833,1696,-40
17070713645,17070713651,6,1926,1402,-40
17071441387,17071441394,7,3362,1050,-40
17071950722,17071950727,5,2565,1175,-40
17075784161,17075784166,5,2200,1061,-40
17080674241,17080674247,6,1683,1295,-40
17082053861,17082053868,7,3556,1511,-40
17088519733,17088519737,4,1511,1017,-40
17095318110,17095318117,7,3000,1413,-40
17098860162,17098860167,5,2383,1098,-40
17102607218,17102607226,8,3109,1386,-40
17107598922,17107598927,5,1768,1294,-40
17110696062,17110696069,7,3744,1419,-40
17110910174,17110910181,7,2882,1134,-40
17113646542,17113646547,5,2134,867,-40
17118621993,17118622000,7,3528,1441,-40
17119218462,17119218458,-4,20070,13264,-40
17120963802,17120963812,10,3008,1127,-40
17122943437,17122943443,6,2678,1266,-40
17125552789,17125552795,6,2680,1544,-40
17126324366,17126324372,6,18915,52946,-40
17129424990,17129424997,7,2886,891,-40
17131542184,17131542190,6,1725,676,-40
17141535435,17141535442,7,3180,1186,-40
17142224621,17142224627,6,3024,1651,-40
17143514210,17143514215,5,2949,1249,-40
17143670147,17143670164,17,14344,50239,-40
17146137277,17146137278,1,1376,23224,-40
17149874727,17149874726,-1,20087,27385,-40
17149907774,17149907778,4,2220,1414,-40
17151666198,17151666200,2,1254,2097,-40
17154771506,17154771513,7,3515,1682,-40
17156696116,17156696120,4,3280,1204,-40
17156848533,17156848547,14,3224,1291,-40
17159893138,17159893142,4,4164,2129,-40
17159956215,17159956213,-2,24271,17327,-40
17164354957,17164354962,5,2349,1310,-40
17171172380,17171172388,8,1931,1069,-40
17171323768,17171323753,-15,1806,560,-40
17172283516,17172283523,7,2597,1207,-40
17173157037,17173157043,6,2750,1401,-40
17173475225,17173475212,-13,2727,1019,-40
17176136133,17176136139,6,3053,904,-40
17176650258,17176650241,-17,3137,1229,-40
17178787537,17178787543,6,2588,810,-40
17180794430,17180794436,6,2949,1201,-40
17181338389,17181338395,6,2392,1228,-40
17182563298,17182563304,6,14919,24635,-40
17183402635,17183402640,5,2158,1076,-40
17190297639,17190297643,4,2826,1503,-40
17194989760,17194989766,6,3008,1635,-40
17196353574,17196353581,7,2987,1180,-40
17196588802,17196588810,8,2849,1342,-40
17199314889,17199314894,5,2134,695,-40
17201947413,17201947419,6,2913,1286,-40
17202858409,17202858403,-6,1201,5723,-40
17205398272,17205398277,5,2997,1181,-40
17205739426,17205739433,7,3538,1281,-40
17207319732,17207319735,3,1998,1592,-40
17222320386,17222320394,8,3639,1098,-40
17224619466,17224619474,8,1948,861,-40
17226812367,17226812370,3,2237,1017,-40
17227576970,17227576982,12,15747,34496,-40
17228842027,17228842034,7,2956,1375,-40
17235625727,17235625735,8,2067,995,-40
17237121717,17237121722,5,3553,1553,-40
17237767650,17237767657,7,3169,1307,-40
17243312984,17243312990,6,2934,1337,-40
17245484131,17245484138,7,4109,1747,-40
17250255374,17250255382,8,2913,1451,-40
17256973522,17256973528,6,2489,1197,-40
17262845353,17262845358,5,2478,1260,-40
17267511669,17267511675,6,2568,1066,-40
17271235481,17271235489,8,3325,1089,-40
17273651518,17273651524,6,3036,1353,-40
17279140254,17279140260,6,1611,631,-40
17283366584,17283366590,6,4525,2158,-40
17284968219,17284968225,6,2875,1103,-40
17285725774,17285725778,4,1776,883,-40
17286436458,17286436443,-15,2795,1045,-40
17289708769,17289708774,5,2924,1187,-40
17293300222,17293300229,7,2917,1505,-40
17298921247,17298921253,6,2459,1263,-40
17304895374,17304895381,7,3174,1566,-40
17307931513,17307931509,-4,1160,2421,-40
17309505363,17309505370,7,2672,1582,-40
17314921390,17314921395,5,2092,1109,-40
17319368243,17319368250,7,3488,1738,-40
17326299072,17326299078,6,2254,1265,-40
17333013790,17333013798,8,3092,1137,-40
17342834653,17342834659,6,2716,1199,-40
17342959354,17342959338,-16,1289,242,-40
17343756718,17343756722,4,3129,1380,-40
17344097686,17344097692,6,2860,1065,-40
17346390641,17346390642,1,3048,2454,-40
17347990281,17347990286,5,1888,1161,-40
17352185246,17352185247,1,2952,3399,-40
17353158057,17353158062,5,3804,1311,-40
17356487143,17356487150,7,4138,1291,-40
17356960701,17356960709,8,2739,1131,-40
17360558311,17360558317,6,3543,1515,-40
17371735621,17371735627,6,2211,1114,-40
17372538917,17372538923,6,3697,1551,-40
17375274149,17375274155,6,3148,1378,-40
17386670313,17386670321,8,15385,15282,-40
17390689166,17390689173,7,2866,1140,-40
17391807320,17391807324,4,1702,1754,-40
17392159433,17392159440,7,3669,1590,-40
17400614686,17400614690,4,3423,1722,-40
17402985710,17402985711,1,1476,1625,-40
17403505157,17403505163,6,3058,1293,-40
17406706774,17406706779,5,3219,1185,-40
17407185523,17407185530,7,3603,1414,-40
17407232974,17407232981,7,2990,1007,-40
17407738176,17407738170,-6,1496,4286,-40
17411605015,17411605021,6,2488,1092,-40
17413730411,17413730417,6,2442,1159,-40
17415168937,17415168945,8,3089,1358,-40
17416274055,17416274061,6,3356,1409,-40
17417662298,17417662306,8,2919,1654,-40
17421831270,17421831270,0,891,1860,-40
17422245782,17422245789,7,2818,1458,-40
17423531031,17423531038,7,3666,1304,-40
17425705057,17425705062,5,1977,1275,-40
17428655797,17428655803,6,3155,1202,-40
17431237302,17431237309,7,2554,1329,-40
17434358886,17434358891,5,2778,1168,-40
17434972656,17434972643,-13,2963,1564,-40
17435276798,17435276811,13,2956,1126,-40
17435521293,17435521299,6,1521,985,-40
17436939222,17436939226,4,3682,1427,-40
17439650806,17439650811,5,3189,920,-40
17441186840,17441186844,4,1970,1285,-40
17441892581,17441892587,6,2298,976,-40
17445186306,17445186313,7,2585,1066,-40
17454874570,17454874575,5,2016,973,-40
17456886274,17456886272,-2,1049,2949,-40
17461187404,17461187409,5,3299,1688,-40
17461641254,17461641258,4,1842,1390,-40
17462268331,17462268339,8,2730,1388,-40
17466335886,17466335891,5,2737,1259,-40
17473914182,17473914189,7,2844,1481,-40
17473948202,17473948209,7,2157,1285,-40
17477686775,17477686770,-5,1365,3161,-40
17481518505,17481518511,6,3371,965,-40
17483613424,17483613430,6,1902,853,-40
17486840030,17486840035,5,2383,1652,-40
17500064645,17500064651,6,2857,1138,-40
17502465293,17502465299,6,2637,1298,-40
17505040195,17505040202,7,1957,891,-40
17508317207,17508317211,4,1689,944,-40
17509423483,17509423490,7,2549,917,-40
17514147029,17514147034,5,2404,1486,-40
17521876801,17521876810,9,2727,1550,-40
17524539045,17524539044,-1,824,1390,-40
17525616177,17525616184,7,4050,2086,-40
17526391331,17526391344,13,1368,183,-40
17527913356,17527913363,7,2987,1425,-40
17532054338,17532054337,-1,1988,4020,-40
17532179193,17532179175,-18,28709,29963,-40
17532390481,17532390494,13,15988,53298,-40
17533078129,17533078135,6,1813,1061,-40
17534171818,17534171834,16,592,2487,-40
17536630036,17536630050,14,281,1822,-40
17538894114,17538894121,7,3059,1638,-40
17542890450,17542890455,5,1702,1232,-40
17543444552,17543444558,6,3204,1828,-40
17544228274,17544228282,8,2690,1196,-40
17546024879,17546024882,3,2224,2176,-40
17550002553,17550002561,8,2416,44171,-40
17551804382,17551804390,8,2728,1079,-40
17551967762,17551967754,-8,926,167,-40
17552224924,17552224919,-5,1554,4447,-40
17557883456,17557883461,5,3146,1166,-40
17558021441,17558021448,7,2697,1001,-40
17558281176,17558281183,7,2479,1001,-40
17566473547,17566473542,-5,2001,5260,-40
17570318818,17570318827,9,3444,1708,-40
17574459910,17574459913,3,14124,10166,-40
17578001446,17578001455,9,18954,48845,-40
17580757632,17580757637,5,3757,1669,-40
17587027076,17587027083,7,3191,1255,-40
17587664526,17587664525,-1,1031,1841,-40
17590563581,17590563586,5,2559,1512,-40
17592213635,17592213641,6,2507,1315,-40
17592331349,17592331353,4,1918,1025,-40
17594942618,17594942615,-3,790,1473,-40
17600465933,17600465939,6,2796,1614,-40
17603221854,17603221859,5,2122,849,-40
17607241365,17607241372,7,3194,1243,-40
17607919274,17607919280,6,1710,916,-40
17609080802,17609080808,6,3097,1464,-40
17612909201,17612909204,3,1449,1106,-40
17613682181,17613682177,-4,2719,10993,-40
17614534009,17614534014,5,4039,1616,-40
17619614701,17619614687,-14,2478,1380,-40
17630164856,17630164862,6,2822,983,-40
17630663469,17630663474,5,2451,1150,-40
17633544448,17633544454,6,1270,777,-40
17638537501,17638537506,5,2604,1200,-40
17638622356,17638622362,6,2756,938,-40
17639771205,17639771210,5,2278,901,-40
17641913642,17641913649,7,3810,1278,-40
17642144661,17642144666,5,3003,1321,-40
17644093700,17644093708,8,2541,826,-40
17646106937,17646106938,1,1105,1448,-40
17648233726,17648233733,7,2967,1559,-40
17648878538,17648878537,-1,1316,1425,-40
17659215035,17659215042,7,1615,791,-40
17659704171,17659704184,13,2903,829,-40
17660203094,17660203072,-22,2534,973,-40
17668430205,17668430211,6,2549,1170,-40
17669027754,17669027761,7,4362,2182,-40
17680171670,17680171665,-5,4171,13403,-40
17682045487,17682045495,8,51539,24629,-40
17683505010,17683505018,8,2132,1002,-40
17684077027,17684077009,-18,1677,559,-40
17686260978,17686260985,7,3095,1140,-40
17687049150,17687049155,5,1390,742,-40
17687479529,17687479534,5,2681,1569,-40
17688593680,17688593681,1,29737,31429,-40
17689655619,17689655626,7,3787,1305,-40
17689880762,17689880766,4,3194,1614,-40
17690970594,17690970603,9,2804,907,-40
17691514676,17691514656,-20,2835,902,-40
17692192049,17692192054,5,2573,815,-40
17692508757,17692508777,20,3420,1567,-40
17694930597,17694930606,9,2887,1178,-40
17695313533,17695313539,6,3347,1290,-40
17701530003,17701530003,0,1393,1875,-40
17703352857,17703352861,4,1550,824,-40
17706271946,17706271952,6,3290,1169,-40
17707850953,17707850936,-17,3271,1479,-40
17709925425,17709925422,-3,994,2658,-40
17711330925,17711330931,6,3005,1280,-40
17713854369,17713854375,6,2632,1235,-40
17716998390,17716998395,5,3314,1510,-40
17719433668,17719433691,23,2824,987,-40
17725094237,17725094243,6,3139,2074,-40
17731743914,17731743914,0,1820,1540,-40
17732299097,17732299103,6,2691,1310,-40
17734096373,17734096379,6,1955,576,-40
17736055774,17736055780,6,3265,1779,-40
17740470033,17740470039,6,3200,1735,-40
17743032422,17743032426,4,2099,587,-40
17743117671,17743117651,-20,866,380,-40
17746631314,17746631319,5,2502,971,-40
17748602486,17748602490,4,1698,691,-40
17749148289,17749148276,-13,893,280,-40
17750002111,17750002118,7,2072,795,-40
17752085614,17752085619,5,2344,1150,-40
17754373815,17754373822,7,3795,1633,-40
17761960264,17761960270,6,2335,1018,-40
17765066789,17765066794,5,3193,1524,-40
17765154846,17765154850,4,2189,1388,-40
17771832399,17771832405,6,3144,1183,-40
17776913683,17776913687,4,1331,1329,-40
17779764647,17779764653,6,2814,982,-40
17780808558,17780808562,4,1229,810,-40
17782340756,17782340759,3,3161,919,-40
17783039814,17783039821,7,2372,1353,-40
17784770958,17784770963,5,2312,1612,-40
17785147086,17785147065,-21,2368,1418,-40
17788468644,17788468650,6,3103,1367,-40
17790400446,17790400454,8,2085,974,-40
17791486177,17791486183,6,2926,1383,-40
17795641840,17795641846,6,2760,1291,-40
17798339389,17798339394,5,2721,900,-40
17799983657,17799983663,6,2749,1259,-40
17801819798,17801819805,7,1544,748,-40
17803963597,17803963604,7,2586,1260,-40
17805553310,17805553317,7,3444,1552,-40
17810102106,17810102111,5,2500,683,-40
17810251026,17810251032,6,3601,1425,-40
17810782869,17810782850,-19,725,184,-40
17811871869,17811871876,7,1596,881,-40
17814490482,17814490502,20,622,2312,-40
17815874044,17815874050,6,3711,1211,-40
17817127039,17817127046,7,4518,996,-40
17817548385,17817548383,-2,5559,8916,-40
17819251713,17819251719,6,1665,873,-40
17820123962,17820123947,-15,1833,912,-40
17826214556,17826214562,6,3474,1324,-40
17826387925,17826387930,5,4007,1336,-40
17827081834,17827081814,-20,1147,3301,-40
17827924101,17827924105,4,2207,1361,-40
17828321757,17828321761,4,2357,1725,-40
17828835738,17828835720,-18,2431,848,-40
17829162335,17829162339,4,2717,1591,-40
17829448124,17829448129,5,4745,2026,-40
17830078823,17830078829,6,4071,1573,-40
17833874172,17833874165,-7,1964,10496,-40
17835293504,17835293510,6,2468,948,-40
17845509292,17845509298,6,2679,1663,-40
17848179692,17848179701,9,3184,1192,-40
17849106114,17849106100,-14,2563,1260,-40
17850517326,17850517331,5,3085,1184,-40
17852565905,17852565913,8,3910,1716,-40
17853565314,17853565322,8,2482,1542,-40
17855541705,17855541710,5,2205,1089,-40
17855716998,17855716976,-22,1045,269,-40
17859305108,17859305113,5,2625,1223,-40
17859632061,17859632067,6,3065,1481,-40
17859937874,17859937881,7,2769,1295,-40
17866067846,17866067851,5,2930,1438,-40
17866194753,17866194760,7,4518,1465,-40
17867437994,17867437998,4,2173,1158,-40
17868766028,17868766033,5,1737,1171,-40
17871149081,17871149102,21,129,2214,-40
17872843592,17872843598,6,4481,1786,-40
17876345177,17876345183,6,2992,1151,-40
17879136623,17879136630,7,4323,1367,-40
17881483047,17881483054,7,3005,1538,-40
17883975154,17883975160,6,2686,1393,-40
17884134119,17884134115,-4,791,258,-40
17886683906,17886683913,7,3170,1261,-40
17889560902,17889560909,7,3189,1276,-40
17891054086,17891054091,5,2660,1262,-40
17892868622,17892868627,5,3111,1445,-40
17893556629,17893556639,10,3035,835,-40
17894230449,17894230435,-14,2510,842,-40
17895965350,17895965353,3,2929,1028,-40
17896693718,17896693722,4,1512,529,-40
17897536742,17897536722,-20,2346,1318,-40
17897625238,17897625228,-10,823,238,-40
17898883304,17898883309,5,2537,1541,-40
17903040705,17903040713,8,3760,1290,-40
17904078686,17904078690,4,2032,737,-40
17905641678,17905641688,10,1176,992,-40
17905805544,17905805551,7,3881,1705,-40
17905972477,17905972485,8,2130,1280,-40
17907896396,17907896402,6,3524,1482,-40
17910134900,17910134908,8,3294,1232,-40
17910918155,17910918159,4,1928,1508,-40
17911802361,17911802367,6,2908,1138,-40
17915099963,17915099969,6,2166,1348,-40
17915926705,17915926711,6,1270,948,-40
17916188070,17916188076,6,2911,1285,-40
17917748734,17917748723,-11,1490,478,-40
17920072486,17920072491,5,2087,1231,-40
17920725050,17920725057,7,3352,1545,-40
17920963610,17920963618,8,3428,1324,-40
17926075210,17926075217,7,3579,1412,-40
17927824165,17927824169,4,2658,1323,-40
17928237393,17928237379,-14,1564,898,-40
17929377658,17929377662,4,2489,1384,-40
17940208807,17940208805,-2,1114,2598,-40
17945362265,17945362273,8,3191,1718,-40
17946699045,17946699051,6,2174,1415,-40
17947134258,17947134263,5,2273,904,-40
17948266570,17948266575,5,1452,820,-40
17949073975,17949073980,5,3321,1328,-40
17953436913,17953436919,6,3411,1916,-40
17958736597,17958736603,6,2882,1270,-40
17959124108,17959124114,6,2019,940,-40
17959611875,17959611881,6,3498,1023,-40
17961267771,17961267779,8,3945,1496,-40
17961534833,17961534838,5,2852,1396,-40
17962667605,17962667609,4,2960,1179,-40
17962708575,17962708581,6,2471,1470,-40
17963949123,17963949128,5,2872,1747,-40
17967776127,17967776132,5,2034,1028,-40
17968920306,17968920295,-11,1070,24896,-40
17970929141,17970929145,4,2993,1300,-40
17976573005,17976573005,0,2166,2898,-40
17978012329,17978012335,6,2461,1457,-40
17978203045,17978203025,-20,779,446,-40
17982777721,17982777726,5,2142,1119,-40
17983465976,17983465983,7,3312,1245,-40
17984151901,17984151906,5,2399,1249,-40
17987640537,17987640544,7,3221,1546,-40
17987882715,17987882721,6,2526,1126,-40
17988488783,17988488794,11,3060,1421,-40
17988683923,17988683936,13,764,112,-40
17989491555,17989491561,6,2202,943,-40
17995082510,17995082516,6,2034,1618,-40
17996591171,17996591177,6,1885,833,-40
17998338255,17998338261,6,1934,929,-40
17999018358,17999018346,-12,2486,995,-40
17999519921,17999519927,6,3742,1123,-40
18000086846,18000086852,6,2383,1244,-40
18000844279,18000844286,7,3975,1540,-40
18003715813,18003715819,6,3050,1508,-40
18004908761,18004908757,-4,18767,16243,-40
18008009129,18008009136,7,3102,929,-40
18008711238,18008711246,8,2586,897,-40
18010561330,18010561335,5,2530,1027,-40
18011845102,18011845106,4,2178,1322,-40
18012142097,18012142107,10,3785,1256,-40
18012712336,18012712322,-14,1144,366,-40
18014684102,18014684109,7,3317,1535,-40
18015091609,18015091616,7,3660,1316,-40
18018417167,18018417173,6,2690,890,-40
18022664898,18022664902,4,2554,1576,-40
18024495384,18024495391,7,2848,1705,-40
18027245745,18027245751,6,3092,1259,-40
18027293134,18027293139,5,2283,1401,-40
18031342228,18031342235,7,3612,874,-40
18031938341,18031938347,6,2595,1521,-40
18032509019,18032509025,6,3686,1392,-40
18035977128,18035977135,7,3404,1563,-40
18046106727,18046106734,7,4265,1477,-40
18046871034,18046871038,4,1689,636,-40
18047069734,18047069728,-6,1005,306,-40
18048415802,18048415807,5,1273,831,-40
18049095066,18049095074,8,5837,1111,-40
18050302889,18050302890,1,38465,19260,-40
18050852094,18050852101,7,1285,861,-40
18051139179,18051139163,-16,1653,668,-40
18052148483,18052148483,0,779,1056,-40
18059273098,18059273104,6,2782,1135,-40
18060480699,18060480705,6,3464,1631,-40
18060588762,18060588769,7,3385,1286,-40
18063741786,18063741790,4,1910,1105,-40
18067389506,18067389506,0,1462,1906,-40
18068230745,18068230751,6,2987,1510,-40
18079015187,18079015195,8,4229,1408,-40
18079471903,18079471906,3,1320,1943,-40
18081963689,18081963695,6,2659,1127,-40
18082248359,18082248366,7,3534,1309,-40
18083507885,18083507891,6,1480,636,-40
18084599840,18084599846,6,2369,1256,-40
18089657785,18089657791,6,1764,640,-40
18092037835,18092037840,5,2493,906,-40
18092124463,18092124471,8,3278,1442,-40
18094592026,18094592032,6,2713,1207,-40
18098861664,18098861670,6,2484,1646,-40
18100781028,18100781034,6,3932,1165,-40
18101280890,18101280895,5,2855,960,-40
18104588208,18104588214,6,2489,1277,-40
18105213549,18105213530,-19,1556,1324,-40
18108838981,18108838986,5,3018,1967,-40
18113276710,18113276718,8,3419,1250,-40
18114331872,18114331877,5,3511,1255,-40
18115725834,18115725842,8,2620,1335,-40
18117004394,18117004399,5,1173,681,-40
18122731514,18122731518,4,3091,1344,-40
18126778977,18126778980,3,1942,1710,-40
18127178190,18127178198,8,3268,841,-40
18132470222,18132470228,6,2717,1384,-40
18135201850,18135201854,4,3113,1632,-40
18139385626,18139385632,6,1816,1281,-40
18140498610,18140498616,6,2245,950,-40
18142760049,18142760052,3,1771,1113,-40
18143610659,18143610666,7,4969,1459,-40
18145185766,18145185771,5,2640,1241,-40
18149761184,18149761187,3,2767,1134,-40
18150748744,18150748744,0,1835,1641,-40
18151766312,18151766296,-16,3140,16857,-40
18154233005,18154233010,5,2815,1248,-40
18159209814,18159209792,-22,1133,251,-40
18159916597,18159916603,6,2769,1519,-40
18162524343,18162524351,8,2234,1168,-40
18163954181,18163954190,9,4166,1286,-40
18164712886,18164712893,7,2611,952,-40
18168744690,18168744694,4,2270,1191,-40
18172318774,18172318780,6,2812,1085,-40
18172358346,18172358354,8,1717,777,-40
18172592562,18172592559,-3,1256,2481,-40
18173646381,18173646388,7,2742,1234,-40
18175644702,18175644709,7,2680,899,-40
18177839465,18177839472,7,3781,1217,-40
18179454623,18179454629,6,3094,1668,-40
18180522185,18180522168,-17,2994,913,-40
18181064708,18181064717,9,3172,1195,-40
18182127651,18182127657,6,3225,1492,-40
18184705273,18184705279,6,4155,1509,-40
18185676359,18185676358,-1,951,998,-40
18188009781,18188009788,7,2467,1170,-40
18188561191,18188561197,6,3620,1474,-40
18188761917,18188761923,6,2020,1164,-40
18194626371,18194626378,7,3343,1305,-40
18195245730,18195245735,5,3452,1202,-40
18200574751,18200574758,7,2252,1217,-40
18204448188,18204448186,-2,1049,2316,-40
18214352224,18214352231,7,3528,1591,-40
18215110753,18215110759,6,3467,1590,-40
18215413160,18215413167,7,1603,719,-40
18215992871,18215992880,9,1282,321,-40
18217482807,18217482814,7,3854,1514,-40
18223675280,18223675282,2,1448,1440,-40
18234304169,18234304174,5,2971,1451,-40
18235211385,18235211391,6,4211,1688,-40
18238830828,18238830835,7,3450,1480,-40
18247608091,18247608099,8,2738,1304,-40
18251981155,18251981160,5,2959,1280,-40
18253478582,18253478590,8,3211,1241,-40
18254389817,18254389822,5,1855,1204,-40
18255423738,18255423743,5,1861,1119,-40
18257614177,18257614164,-13,1094,370,-40
18259663551,18259663551,0,2242,2809,-40
18261091301,18261091308,7,2703,1129,-40
18268787291,18268787297,6,3509,1486,-40
18271636906,18271636914,8,3886,1062,-40
18274599587,18274599593,6,2502,897,-40
18274739005,18274739010,5,3246,1395,-40
18276939305,18276939306,1,1427,1074,-40
18277388866,18277388871,5,1991,900,-40
18278896108,18278896108,0,1775,2189,-40
18280810156,18280810154,-2,1849,2419,-40
18281238517,18281238520,3,44444,22770,-40
18282730521,18282730529,8,2766,943,-40
18285586608,18285586614,6,3498,1388,-40
18287689346,18287689346,0,1253,1550,-40
18287786463,18287786471,8,3295,1047,-40
18290034303,18290034304,1,3778,4005,-40
18291984817,18291984805,-12,773,2118,-40
18297905859,18297905866,7,2515,1099,-40
18299089588,18299089590,2,1521,1307,-40
18300800794,18300800802,8,2485,1469,-40
18302646749,18302646754,5,2552,1487,-40
18303578655,18303578661,6,2320,1356,-40
18308247850,18308247856,6,3055,1061,-40
18309197865,18309197871,6,3133,1336,-40
18313169106,18313169114,8,3022,1117,-40
18314570462,18314570467,5,721,1010,-40
18316163195,18316163189,-6,957,4050,-40
18317748013,18317748017,4,2297,1460,-40
18317813382,18317813388,6,2840,1461,-40
18318713975,18318713979,4,2812,1340,-40
18323779159,18323779165,6,2348,1156,-40
18326664650,18326664655,5,1919,1341,-40
18331975075,18331975074,-1,1898,2860,-40
18334003756,18334003758,2,2509,1483,-40
18337616098,18337616083,-15,2474,812,-40
18339683502,18339683505,3,1335,963,-40
18342610669,18342610664,-5,905,3918,-40
18343047819,18343047821,2,37869,86476,-40
18350185263,18350185267,4,2013,1213,-40
18351934334,18351934339,5,1937,904,-40
18352762902,18352762902,0,2297,4116,-40
18360593814,18360593820,6,2727,959,-40
18362779995,18362779999,4,2065,1143,-40
18362806734,18362806752,18,678,49,-40
18364629039,18364629037,-2,1112,1205,-40
18367056166,18367056170,4,3177,1249,-40
18372977034,18372977042,8,4112,1572,-40
18375827767,18375827766,-1,1479,1835,-40
18376964025,18376964032,7,3208,1413,-40
18389704059,18389704066,7,3243,1226,-40
18389970550,18389970536,-14,1740,564,-40
18395857942,18395857949,7,4094,1514,-40
18397330207,18397330210,3,1606,962,-40
18397850672,18397850670,-2,1349,2508,-40
18398753930,18398753939,9,3812,1649,-40
18400190053,18400190059,6,3370,893,-40
18400240281,18400240289,8,2561,900,-40
18402367737,18402367742,5,2194,1011,-40
18403663110,18403663115,5,3172,1463,-40
18403781121,18403781117,-4,1986,4886,-40
18403926791,18403926783,-8,890,3337,-40
18405921407,18405921415,8,3921,1708,-40
18408093561,18408093566,5,2317,1100,-40
18408924274,18408924273,-1,11231,45239,-40
18409077234,18409077241,7,2291,1109,-40
18422057040,18422057046,6,2441,1586,-40
18428696294,18428696299,5,2501,1345,-40
18429669145,18429669151,6,2644,974,-40
18430001858,18430001862,4,1451,761,-40
18431734021,18431734026,5,2464,1312,-40
18431957741,18431957746,5,3414,1775,-40
18433835258,18433835266,8,2552,800,-40
18436039854,18436039860,6,2275,1720,-40
18436447814,18436447834,20,2218,1372,-40
18437281914,18437281921,7,2499,1077,-40
18443005975,18443005982,7,3587,1179,-40
18444701360,18444701366,6,3567,1620,-40
18450338781,18450338788,7,1944,1011,-40
18453554686,18453554693,7,3125,1609,-40
18453877413,18453877419,6,3172,1080,-40
18455828517,18455828522,5,2662,1406,-40
18460666630,18460666636,6,4632,1719,-40
18461211842,18461211849,7,2597,1377,-40
18461360970,18461360974,4,2403,850,-40
18463862825,18463862830,5,1940,650,-40
18464626144,18464626152,8,2718,795,-40
18466830173,18466830179,6,2092,1351,-40
18475236384,18475236390,6,2793,998,-40
18475775311,18475775316,5,2420,986,-40
18476892918,18476892922,4,1800,1222,-40
18481277471,18481277475,4,2406,1089,-40
18481942539,18481942546,7,3152,1324,-40
18488297761,18488297762,1,2114,1798,-40
18490342646,18490342653,7,3444,1380,-40
18491234678,18491234656,-22,2884,1404,-40
18496458731,18496458738,7,2859,1277,-40
18498947554,18498947561,7,1288,777,-40
18502601934,18502601942,8,2552,1374,-40
18503827210,18503827202,-8,1505,9549,-40
18504091456,18504091475,19,2825,1131,-40
18510927989,18510927994,5,3067,1325,-40
18515409591,18515409597,6,2805,1397,-40
18516136485,18516136491,6,3428,1707,-40
18517908457,18517908461,4,3500,1442,-40
18520891945,18520891950,5,2669,1084,-40
18521078007,18521078014,7,2605,1277,-40
18521323753,18521323759,6,3227,1263,-40
18522296149,18522296154,5,2343,1071,-40
18523319059,18523319063,4,2640,1470,-40
18524644627,18524644621,-6,1212,3530,-40
18528693559,18528693566,7,3123,974,-40
18532111825,18532111831,6,2655,1080,-40
18540598512,18540598518,6,2371,1338,-40
18541550298,18541550303,5,2538,1207,-40
18543649580,18543649585,5,3269,1145,-40
18544465627,18544465612,-15,3069,1157,-40
18545446455,18545446459,4,2031,1166,-40
18548610201,18548610204,3,5453,3506,-40
18550105709,18550105714,5,3923,1329,-40
18558979402,18558979410,8,3062,1133,-40
18559090415,18559090422,7,3297,1323,-40
18565974641,18565974647,6,3608,1097,-40
18568441274,18568441280,6,2137,1516,-40
18570990049,18570990055,6,2073,838,-40
18574336287,18574336285,-2,1206,2125,-40
18576211937,18576211934,-3,1367,2206,-40
18577316222,18577316230,8,2317,1129,-40
18578604840,18578604846,6,3190,1098,-40
18580526723,18580526730,7,2420,1260,-40
18587006797,18587006804,7,1842,671,-40
18588245316,18588245322,6,1841,935,-40
18590596317,18590596321,4,1834,1040,-40
18607973982,18607973988,6,2089,785,-40
18608036476,18608036460,-16,913,361,-40
18612209387,18612209394,7,2393,1289,-40
18620165141,18620165149,8,3438,1512,-40
18625500018,18625500016,-2,1149,2482,-40
18626059747,18626059754,7,2866,1622,-40
18632820679,18632820687,8,2652,1033,-40
18637008308,18637008314,6,2721,903,-40
18638051856,18638051856,0,664,441,-40
18639296840,18639296846,6,2037,1307,-40
18639766905,18639766911,6,1331,758,-40
18640283191,18640283169,-22,794,63,-40
18642060022,18642060027,5,2115,1132,-40
18645396849,18645396853,4,2349,1401,-40
18653271749,18653271754,5,1344,962,-40
18653866202,18653866209,7,1983,1035,-40
18654147962,18654147969,7,2464,1262,-40
18657828384,18657828393,9,2702,1350,-40
18658138994,18658138978,-16,1356,138,-40
18663889686,18663889692,6,2519,1440,-40
18666388664,18666388671,7,3495,1600,-40
18670615567,18670615567,0,1678,1668,-40
18672207746,18672207752,6,4746,1897,-40
18673058564,18673058570,6,3997,1616,-40
18675601514,18675601521,7,3429,1316,-40
18678548290,18678548295,5,3293,1220,-40
18678660125,18678660105,-20,2576,1029,-40
18679429958,18679429966,8,2695,768,-40
18680504194,18680504198,4,1992,1256,-40
18681818986,18681818992,6,3124,1028,-40
18687698894,18687698899,5,2147,866,-40
18700022857,18700022862,5,2744,1067,-40
18703237283,18703237290,7,2767,1059,-40
18703640706,18703640714,8,2608,739,-40
18704542603,18704542610,7,2390,1294,-40
18711253571,18711253567,-4,1009,3237,-40
18714143942,18714143951,9,3486,1326,-40
18716447574,18716447570,-4,991,2789,-40
18717901479,18717901483,4,3295,1338,-40
18718725789,18718725796,7,2802,861,-40
18728255992,18728255998,6,1324,866,-40
18730023614,18730023621,7,2810,1682,-40
18743844924,18743844930,6,2401,844,-40
18744119224,18744119221,-3,34946,15602,-40
18748055252,18748055260,8,1712,1059,-40
18752457974,18752457983,9,961,483,-40
18754155473,18754155475,2,1266,627,-40
18757160878,18757160885,7,4206,1612,-40
18763399487,18763399491,4,2025,1333,-40
18771385233,18771385238,5,2654,1202,-40
18771969370,18771969375,5,3205,1799,-40
18772345477,18772345483,6,2173,1019,-40
18774234123,18774234130,7,2435,1048,-40
18776851091,18776851085,-6,1667,51233,-40
18779248680,18779248686,6,2273,1485,-40
18782172665,18782172671,6,3298,1354,-40
18787198602,18787198607,5,2948,1134,-40
18792563870,18792563878,8,3317,1380,-40
18794332355,18794332362,7,3291,1376,-40
18799747170,18799747176,6,2957,1223,-40
18801333149,18801333145,-4,1451,3612,-40
18802155328,18802155335,7,1838,1264,-40
18804787774,18804787769,-5,1114,2888,-40
18812978227,18812978234,7,2267,977,-40
18818361182,18818361186,4,1592,794,-40
18820312316,18820312322,6,2464,1190,-40
18820793986,18820793991,5,2888,1319,-40
18822585091,18822585099,8,2041,906,-40
18823563935,18823563942,7,3633,1338,-40
18824722331,18824722338,7,2232,1580,-40
18825213522,18825213505,-17,1234,435,-40
18826323946,18826323952,6,2592,1243,-40
18826907747,18826907753,6,4488,1807,-40
18832585704,18832585710,6,1329,945,-40
18834415114,18834415122,8,2458,1053,-40
18841599030,18841599034,4,2698,1193,-40
18841690738,18841690743,5,1284,813,-40
18845916871,18845916878,7,2413,1198,-40
18853089477,18853089482,5,2762,1442,-40
18855383231,18855383239,8,3067,984,-40
18857784508,18857784515,7,3628,1812,-40
18863312861,18863312866,5,1442,866,-40
18863419558,18863419545,-13,908,423,-40
18866991600,18866991605,5,2917,1334,-40
18870566673,18870566681,8,2646,1461,-40
18870687018,18870687025,7,2340,1136,-40
18878033146,18878033153,7,3331,1160,-40
18881558135,18881558139,4,1525,1455,-40
18885973358,18885973366,8,3492,1416,-40
18886241565,18886241571,6,2141,887,-40
18886703326,18886703304,-22,1509,1224,-40
18890884676,18890884681,5,2932,1583,-40
18894063120,18894063126,6,1850,649,-40
18898032835,18898032843,8,2615,1277,-40
18899470337,18899470343,6,2826,1148,-40
18901788039,18901788045,6,3463,1848,-40
18901926574,18901926579,5,2036,971,-40
18902874994,18902874999,5,2264,945,-40
18905995898,18905995902,4,1457,852,-40
18912611347,18912611351,4,1618,1201,-40
18920528724,18920528728,4,2197,1274,-40
18922001772,18922001776,4,2461,1525,-40
18924947958,18924947952,-6,1011,2823,-40
18927789080,18927789086,6,4270,1217,-40
18927998046,18927998051,5,2638,2364,-40
18930398622,18930398629,7,3895,1797,-40
18932175941,18932175949,8,2519,1168,-40
18933595524,18933595531,7,1417,708,-40
18934432187,18934432195,8,3643,1210,-40
18938052111,18938052118,7,2568,866,-40
18938806842,18938806846,4,3009,1101,-40
18942118846,18942118842,-4,1235,3005,-40
18944909611,18944909618,7,1393,712,-40
18955034325,18955034331,6,2522,1131,-40
18958999182,18958999190,8,2453,1225,-40
18959184626,18959184632,6,2650,994,-40
18960199186,18960199193,7,3141,1402,-40
18964695320,18964695325,5,4145,1602,-40
18965026298,18965026302,4,1897,840,-40
18973616285,18973616291,6,3662,1486,-40
18975074329,18975074335,6,3516,1249,-40
18980745622,18980745628,6,2760,1262,-40
18982272456,18982272461,5,1715,1086,-40
18983405666,18983405671,5,2643,1661,-40
18988007639,18988007646,7,3283,1060,-40
18988469142,18988469139,-3,2367,5000,-40
18992270885,18992270893,8,4292,1364,-40
18993737630,18993737629,-1,865,796,-40
18996040654,18996040659,5,1729,1055,-40
18998967563,18998967570,7,1951,964,-40
19006901447,19006901452,5,2162,1029,-40
19007296583,19007296561,-22,1382,752,-40
19007915102,19007915098,-4,962,2742,-40
19008972056,19008972058,2,23647,35016,-40
19009092812,19009092818,6,2986,893,-40
19012291343,19012291350,7,3293,1381,-40
19012584771,19012584777,6,2398,1487,-40
19014613182,19014613189,7,3039,1425,-40
19022572247,19022572254,7,2575,1486,-40
19026749368,19026749370,2,2239,1666,-40
19028056596,19028056603,7,1864,840,-40
19030338511,19030338517,6,2786,1264,-40
19032823858,19032823865,7,3845,1911,-40
19033960309,19033960315,6,3354,856,-40
19037356643,19037356651,8,2868,1074,-40
19038633457,19038633463,6,1790,851,-40
19041850587,19041850594,7,2673,1018,-40
19041896213,19041896218,5,2545,1411,-40
19045863774,19045863780,6,3197,1636,-40
19056365215,19056365222,7,2235,825,-40
19058345761,19058345766,5,1110,820,-40
19058785879,19058785898,19,1298,193,-40
19058892661,19058892672,11,2242,1468,-40
19059093595,19059093577,-18,1383,654,-40
19059828565,19059828570,5,18957,16424,-40
19060066659,19060066666,7,2736,1219,-40
19070978365,19070978369,4,2538,1067,-40
19075546455,19075546461,6,4143,1533,-40
19077272286,19077272293,7,1439,1027,-40
19083301123,19083301131,8,3665,1535,-40
19083381702,19083381702,0,1807,2367,-40
19087720581,19087720586,5,2515,1542,-40
19095997006,19095997006,0,5181,6536,-40
19098023710,19098023718,8,2396,1446,-40
19105181377,19105181383,6,2975,1085,-40
19109906033,19109906038,5,1931,1181,-40
19115548679,19115548686,7,3023,1616,-40
19115828818,19115828827,9,1691,530,-40
19116505034,19116505039,5,1644,897,-40
19117592453,19117592454,1,3553,3408,-40
19118975269,19118975274,5,2487,1010,-40
19123633061,19123633067,6,2881,1420,-40
19126307881,19126307888,7,3365,1170,-40
19129064545,19129064552,7,3303,1232,-40
19133510899,19133510907,8,3009,1525,-40
19134018161,19134018162,1,1957,1264,-40
19135855129,19135855131,2,2765,2124,-40
19142051914,19142051921,7,2397,1032,-40
19144273941,19144273947,6,2457,1153,-40
19145982341,19145982348,7,2098,1134,-40
19146167407,19146167415,8,2454,1192,-40
19146485494,19146485501,7,2517,1485,-40
19150144365,19150144370,5,3740,1207,-40
19152467421,19152467426,5,2474,1176,-40
19158423822,19158423829,7,2133,1507,-40
19160406667,19160406673,6,3457,1542,-40
19163767945,19163767944,-1,1319,1766,-40
19164686566,19164686571,5,2365,1372,-40
19167845097,19167845112,15,1209,159,-40
19168774114,19168774120,6,2357,1241,-40
19173278382,19173278387,5,1278,847,-40
19176445744,19176445749,5,4637,3185,-40
19178263619,19178263621,2,3760,3790,-40
19187980674,19187980680,6,2906,1692,-40
19188583873,19188583878,5,4534,1877,-40
19190219546,19190219554,8,4366,1079,-40
19191389461,19191389467,6,3254,1277,-40
19193005725,19193005731,6,1158,26480,-40
19196842851,19196842859,8,3314,1006,-40
19201184249,19201184254,5,2641,1129,-40
19202928625,19202928631,6,2614,1014,-40
19203181399,19203181406,7,2236,1093,-40
19204107859,19204107866,7,2575,1709,-40
19204482541,19204482545,4,2128,1190,-40
19205098345,19205098363,18,922,252,-40
19207060746,19207060747,1,1906,2087,-40
19211709794,19211709789,-5,16383,16742,-40
19212535965,19212535961,-4,1461,5662,-40
19214390209,19214390215,6,2475,1217,-40
19216393565,19216393569,4,2287,1599,-40
19220045243,19220045249,6,2700,1159,-40
19222665400,19222665405,5,3103,1536,-40
19224207369,19224207374,5,2726,1593,-40
19229025296,19229025302,6,2147,1319,-40
19242214305,19242214312,7,2520,1181,-40
19244241253,19244241246,-7,940,3572,-40
19247077206,19247077214,8,2102,805,-40
19247394070,19247394082,12,3144,1380,-40
19251677018,19251677022,4,3573,1391,-40
19253791055,19253791051,-4,1390,4456,-40
19255549169,19255549174,5,2511,807,-40
19261933316,19261933322,6,3400,1706,-40
19262548125,19262548131,6,2462,1255,-40
19264477892,19264477899,7,2624,1383,-40
19266308566,19266308571,5,2418,1119,-40
19268279569,19268279574,5,3306,1317,-40
19268734746,19268734729,-17,3259,1052,-40
19270756568,19270756573,5,2655,1123,-40
19271898674,19271898660,-14,1612,775,-40
19273462034,19273462038,4,2606,1384,-40
19274330506,19274330514,8,4180,1726,-40
19275673048,19275673054,6,2551,1597,-40
19276812162,19276812169,7,3435,1990,-40
19277815265,19277815270,5,3378,1584,-40
19279930770,19279930778,8,1967,1001,-40
19287374538,19287374529,-9,1411,9278,-40
19288005248,19288005253,5,2650,1451,-40
19291228181,19291228188,7,2948,1373,-40
19295118389,19295118394,5,2416,1342,-40
19296202153,19296202161,8,2480,920,-40
19300299906,19300299912,6,1655,988,-40
19300365249,19300365264,15,943,170,-40
19301087886,19301087882,-4,767,226,-40
19301811173,19301811178,5,2131,975,-40
19302975623,19302975629,6,2493,1321,-40
19308822690,19308822697,7,345,127,-40
19310290378,19310290383,5,2814,1686,-40
19311153490,19311153472,-18,840,292,-40
19313167805,19313167811,6,2108,776,-40
19317275318,19317275302,-16,3281,1385,-40
19318236625,19318236631,6,2036,788,-40
19322690212,19322690217,5,3368,1698,-40
19323480082,19323480089,7,2804,1378,-40
19324051186,19324051191,5,632,341,-40
19328563135,19328563142,7,2735,1278,-40
19333641788,19333641794,6,2840,1083,-40
19334140125,19334140104,-21,3123,1104,-40
19341513388,19341513395,7,1598,1180,-40
19344646669,19344646674,5,1911,1019,-40
19344864847,19344864856,9,2002,800,-40
19347030244,19347030246,2,16954,17038,-40
19351834334,19351834326,-8,1748,11284,-40
19354680462,19354680466,4,2011,2274,-40
19355434983,19355434987,4,3699,1607,-40
19356739046,19356739050,4,2799,1951,-40
19357321742,19357321749,7,2723,1428,-40
19357604766,19357604773,7,3885,1423,-40
19359057846,19359057850,4,3416,1562,-40
19360057718,19360057725,7,3552,1440,-40
19366691778,19366691785,7,2155,1450,-40
19368412494,19368412502,8,2994,1441,-40
19373113230,19373113239,9,3231,1783,-40
19377342210,19377342216,6,3226,2172,-40
19379095914,19379095921,7,3234,1665,-40
19383442050,19383442057,7,2830,1061,-40
19388545624,19388545630,6,2313,1294,-40
19391725578,19391725579,1,2343,2364,-40
19392446651,19392446658,7,3629,1762,-40
19392764061,19392764066,5,2151,969,-40
19393965230,19393965235,5,3520,1096,-40
19397506230,19397506238,8,3146,1896,-40
19399178380,19399178386,6,2850,1135,-40
19401122084,19401122088,4,2767,1002,-40
19402655232,19402655239,7,2757,1286,-40
19403885009,19403885014,5,876,611,-40
19410372810,19410372815,5,2004,1264,-40
19412802778,19412802783,5,2422,971,-40
19415830378,19415830385,7,2519,1330,-40
19416733178,19416733182,4,1240,804,-40
19417552277,19417552283,6,2433,1363,-40
19420139986,19420139991,5,1234,510,-40
19421776196,19421776202,6,2345,1278,-40
19429376238,19429376245,7,3695,1700,-40
19438616141,19438616141,0,1193,1778,-40
19440531531,19440531537,6,1798,1454,-40
19440766534,19440766523,-11,2169,833,-40
19443126995,19443127001,6,3904,1449,-40
19447786306,19447786311,5,2257,1301,-40
19448715450,19448715448,-2,1157,2125,-40
19456115257,19456115263,6,2622,1395,-40
19464236627,19464236635,8,3420,1402,-40
19471172509,19471172514,5,3029,1311,-40
19471285918,19471285923,5,3338,1017,-40
19473875127,19473875134,7,2983,1189,-40
19473950534,19473950541,7,3202,1370,-40
19477611303,19477611301,-2,1497,2967,-40
19479906413,19479906418,5,2604,1549,-40
19486447058,19486447054,-4,946,2606,-40
19488903674,19488903680,6,2446,1081,-40
19490319332,19490319321,-11,796,200,-40
19491002793,19491002779,-14,2635,1427,-40
19491464941,19491464948,7,6070,2310,-40
19493529645,19493529650,5,2793,925,-40
19493829193,19493829199,6,2990,1366,-40
19505493766,19505493767,1,3219,3612,-40
19510882211,19510882210,-1,102,1968,-40
19516099029,19516099034,5,2724,1415,-40
19517797565,19517797571,6,3288,1680,-40
19520167734,19520167739,5,2738,1147,-40
19521310165,19521310170,5,2729,1367,-40
19522237726,19522237731,5,3236,1505,-40
19526720096,19526720102,6,6879,2722,-40
19527427394,19527427400,6,3102,1237,-40
19528880257,19528880263,6,2808,1158,-40
19530848450,19530848457,7,2633,1654,-40
19533152042,19533152050,8,3189,1292,-40
19533674510,19533674504,-6,865,3,-40
19534800662,19534800668,6,3253,1731,-40
19538688107,19538688103,-4,1381,3211,-40
19539325146,19539325152,6,3425,1295,-40
19539752326,19539752331,5,3143,1361,-40
19542164969,19542164974,5,2567,991,-40
19544512392,19544512399,7,3222,1382,-40
19544605885,19544605874,-11,872,380,-40
19546649021,19546649027,6,2805,1142,-40
19547005703,19547005710,7,2501,1062,-40
19551243123,19551243125,2,813,1057,-40
19552950490,19552950496,6,2770,954,-40
19560447789,19560447796,7,5054,1480,-40
19560556986,19560556992,6,2317,1075,-40
19568203570,19568203577,7,3978,1248,-40
19575724263,19575724269,6,1774,855,-40
19575949156,19575949168,12,627,173,-40
19579521857,19579521863,6,2970,1391,-40
19581884349,19581884355,6,3492,1215,-40
19583920481,19583920488,7,1818,1062,-40
19585454913,19585454921,8,17800,51582,-40
19588972282,19588972288,6,2569,950,-40
19589891996,19589892002,6,3118,1424,-40
19591447962,19591447967,5,3628,1471,-40
19594014441,19594014445,4,2618,1667,-40
19596184535,19596184537,2,1264,1536,-40
19600860362,19600860367,5,2422,973,-40
19603474937,19603474943,6,1706,1261,-40
19612749249,19612749254,5,2166,926,-40
19616475746,19616475753,7,3379,1507,-40
19625726914,19625726927,13,12699,37517,-40
19637332992,19637332991,-1,1615,1724,-40
19638406737,19638406721,-16,45640,14195,-40
19638627438,19638627441,3,2683,1692,-40
19644593675,19644593679,4,1965,885,-40
19645638005,19645638011,6,2620,1183,-40
19648368084,19648368090,6,2473,1147,-40
19653766050,19653766065,15,761,303,-40
19654547511,19654547514,3,1499,1054,-40
19656941974,19656941980,6,3111,1618,-40
19658485020,19658485026,6,2152,1063,-40
19658999709,19658999704,-5,1433,5246,-40
19660687066,19660687071,5,2786,1183,-40
19660864565,19660864572,7,3489,1323,-40
19666403979,19666403985,6,2194,1469,-40
19666638552,19666638557,5,2274,1608,-40
19677341318,19677341320,2,1590,1621,-40
19678691331,19678691337,6,2863,1408,-40
19687249062,19687249065,3,3748,1879,-40
19688135882,19688135888,6,3016,1256,-40
19698850448,19698850442,-6,2073,5029,-40
19703439486,19703439491,5,2799,1182,-40
19705246060,19705246065,5,2829,1645,-40
19710105473,19710105482,9,2491,1422,-40
19710181217,19710181222,5,2890,1723,-40
19713118449,19713118455,6,2242,1203,-40
19713577034,19713577018,-16,1911,843,-40
19714714670,19714714676,6,2647,1547,-40
19715922183,19715922190,7,3202,1467,-40
19717081202,19717081209,7,2778,929,-40
19727706460,19727706465,5,3720,1724,-40
19727785094,19727785090,-4,1420,3211,-40
19740371089,19740371095,6,3191,1079,-40
19745768476,19745768470,-6,666,3338,-40
19749444657,19749444663,6,3525,1088,-40
19757600868,19757600872,4,1852,995,-40
19768551754,19768551760,6,3085,1646,-40
19768924403,19768924408,5,2146,797,-40
19771738269,19771738275,6,2679,1657,-40
19772386770,19772386767,-3,1369,2286,-40
19773443898,19773443889,-9,1236,220,-40
19774070469,19774070475,6,2780,1217,-40
19779564222,19779564239,17,1393,198,-40
19780783852,19780783858,6,3187,1128,-40
19789475113,19789475119,6,3304,1557,-40
19793743099,19793743117,18,3528,1288,-40
19796254951,19796254958,7,3133,1031,-40
19796549234,19796549218,-16,896,352,-40
19797621407,19797621401,-6,1278,5176,-40
19798426215,19798426223,8,2966,1241,-40
19799016864,19799016880,16,2590,1396,-40
19799140284,19799140268,-16,2675,1094,-40
19800226286,19800226293,7,2213,873,-40
19803802817,19803802824,7,2306,1264,-40
19804361087,19804361093,6,2683,1474,-40
19805381021,19805381022,1,1577,1543,-40
19805689949,19805689954,5,3728,1474,-40
19806883437,19806883444,7,2974,1566,-40
19809255685,19809255693,8,3338,1371,-40
19812816671,19812816662,-9,25809,13259,-40
19813548946,19813548950,4,1838,1620,-40
19819803177,19819803183,6,1773,1096,-40
19821233816,19821233821,5,2065,1384,-40
19823134057,19823134062,5,2247,1224,-40
19825611860,19825611867,7,3661,1835,-40
19825952134,19825952141,7,3422,1443,-40
19826611471,19826611475,4,2070,911,-40
19828112279,19828112282,3,2878,2808,-40
19829096350,19829096358,8,3533,1376,-40
19829473909,19829473914,5,4912,1519,-40
19841415185,19841415193,8,2798,977,-40
19841668057,19841668053,-4,1189,2343,-40
19846360924,19846360931,7,3152,988,-40
19848515034,19848515050,16,625,275,-40
19849729234,19849729240,6,3049,1671,-40
19851197865,19851197871,6,3029,1320,-40
19857748337,19857748345,8,2635,1134,-40
19859752827,19859752834,7,2759,1370,-40
19864142286,19864142291,5,2329,1242,-40
19865670632,19865670637,5,2040,1105,-40
19866838102,19866838108,6,2920,1586,-40
19866971525,19866971531,6,3195,1101,-40
19869387826,19869387819,-7,1858,6260,-40
19872748796,19872748802,6,2914,1144,-40
19872829062,19872829081,19,1025,309,-40
19874667558,19874667565,7,3010,1823,-40
19875846573,19875846558,-15,1164,509,-40
19881075444,19881075449,5,2593,1277,-40
19881382055,19881382061,6,2838,1438,-40
19887239974,19887239981,7,4330,2912,-40
19888623213,19888623218,5,3420,1488,-40
19889390151,19889390140,-11,1414,272,-40
19894519802,19894519809,7,4782,2484,-40
19904322389,19904322396,7,1602,673,-40
19908902690,19908902694,4,2597,1084,-40
19909354029,19909354034,5,1544,904,-40
19911228745,19911228752,7,2439,1192,-40
19921649198,19921649203,5,2573,1405,-40
19921865537,19921865545,8,3393,1623,-40
19926941776,19926941782,6,2609,1244,-40
19930616698,19930616703,5,2404,979,-40
19933497915,19933497922,7,2379,997,-40
19935830090,19935830095,5,2173,1170,-40
19941541672,19941541678,6,2795,1169,-40
19951060345,19951060354,9,4251,1551,-40
19952224673,19952224678,5,3056,1416,-40
19954490275,19954490281,6,3118,1231,-40
19954752003,19954752010,7,4051,1840,-40
19961647259,19961647266,7,3101,1359,-40
19962180019,19962180026,7,3288,1084,-40
19968595839,19968595845,6,3038,1506,-40
19975248953,19975248958,5,2663,1202,-40
19978890734,19978890739,5,2941,999,-40
19981373445,19981373453,8,3404,1178,-40
19981718103,19981718113,10,2851,1450,-40
19982512094,19982512101,7,2989,1096,-40
19984337733,19984337737,4,3284,1344,-40
19984452809,19984452815,6,11169,1306,-40
19984968345,19984968351,6,1654,1054,-40
19989191814,19989191796,-18,911,450,-40
19991768504,19991768510,6,3112,1087,-40
19996582438,19996582445,7,3307,1617,-40
19997121212,19997121219,7,2187,1828,-40
19998880190,19998880198,8,3074,1422,-40
20001837442,20001837449,7,2771,1483,-40
20001889908,20001889890,-18,2545,618,-40
20003717678,20003717677,-1,689,1417,-40
20006867542,20006867539,-3,46130,16685,-40
20008662671,20008662678,7,49246,17935,-40
20014973608,20014973614,6,2956,1456,-40
20017588797,20017588804,7,3135,1042,-40
20020397403,20020397410,7,3508,1269,-40
20029403490,20029403496,6,3957,1249,-40
20030613642,20030613648,6,2653,1220,-40
20031803099,20031803106,7,2264,1200,-40
20037323633,20037323638,5,2643,1339,-40
20040016819,20040016826,7,1963,1112,-40
20041648298,20041648303,5,2164,1339,-40
20046871945,20046871950,5,1768,1145,-40
20047016423,20047016400,-23,1262,719,-40
20049095541,20049095541,0,3005,1646,-40
20049331851,20049331851,0,24439,18387,-40
20049870124,20049870131,7,2396,1372,-40
20053549066,20053549071,5,3375,1325,-40
20056986371,20056986376,5,2242,935,-40
20059205374,20059205379,5,2634,1275,-40
20062645236,20062645242,6,1673,846,-40
20065733088,20065733093,5,3676,1527,-40
20068052009,20068052005,-4,3954,9141,-40
20072652723,20072652703,-20,1157,546,-40
20076073826,20076073832,6,2813,1231,-40
20078064622,20078064627,5,2386,1204,-40
20079075217,20079075222,5,2879,1066,-40
20079221615,20079221622,7,3207,1119,-40
20084081786,20084081794,8,3364,1200,-40
20088946284,20088946291,7,2526,1168,-40
20090812010,20090812015,5,3118,1650,-40
20091681854,20091681861,7,1960,1118,-40
20098230494,20098230500,6,2067,911,-40
20104128715,20104128722,7,3517,1267,-40
20106247575,20106247581,6,2662,1103,-40
20107415322,20107415329,7,2241,1490,-40
20107787903,20107787909,6,2337,1421,-40
20108457022,20108457001,-21,1270,542,-40
20115085429,20115085434,5,3205,1384,-40
20115777739,20115777745,6,949,657,-40
20117228091,20117228107,16,2777,1209,-40
20125485365,20125485371,6,2767,953,-40
20130573687,20130573695,8,3199,1303,-40
20130905673,20130905679,6,2677,1095,-40
20130974494,20130974481,-13,987,573,-40
20133334449,20133334453,4,2087,1667,-40
20140385282,20140385262,-20,1867,970,-40
20141708928,20141708933,5,2511,1438,-40
20142194887,20142194881,-6,1039,5071,-40
20142754177,20142754182,5,2302,1461,-40
20143310551,20143310557,6,3239,1607,-40
20143568630,20143568627,-3,1018,349,-40
20146089840,20146089846,6,1875,943,-40
20146508633,20146508619,-14,2831,987,-40
20148385770,20148385764,-6,1108,368,-40
20149298992,20149298993,1,1258,1110,-40
20149833682,20149833687,5,2847,1043,-40
20154794544,20154794551,7,3569,1110,-40
20168411029,20168411034,5,3598,1652,-40
20172567286,20172567286,0,272,1018,-40
20175647890,20175647897,7,2462,1549,-40
20175951682,20175951673,-9,37413,14361,-40
20177311264,20177311271,7,2227,1228,-40
20178707758,20178707764,6,1921,2941,-40
20179031442,20179031450,8,3409,1519,-40
20179215444,20179215459,15,2242,1329,-40
20179593734,20179593720,-14,1277,540,-40
20180101187,20180101193,6,1775,1268,-40
20189682450,20189682450,0,1758,3089,-40
20191501906,20191501915,9,3427,1413,-40
20191956134,20191956141,7,5473,1949,-40
20196087381,20196087384,3,1597,2039,-40
20210902385,20210902391,6,2141,1012,-40
20214984109,20214984115,6,2760,1079,-40
20215950133,20215950139,6,2837,949,-40
20223743442,20223743449,7,2829,1175,-40
20233896958,20233896965,7,2037,1095,-40
20236442795,20236442803,8,1781,964,-40
20239607609,20239607615,6,2514,1218,-40
20242204573,20242204578,5,3122,1144,-40
20245891764,20245891769,5,1329,1092,-40
20246181518,20246181524,6,944,319,-40
20246766782,20246766789,7,2460,1129,-40
20249716227,20249716226,-1,1037,1857,-40
20250049082,20250049082,0,2059,2276,-40
20252246430,20252246435,5,1645,1269,-40
20256459201,20256459209,8,4310,1143,-40
20256820214,20256820196,-18,2491,1034,-40
20259387484,20259387487,3,1558,1053,-40
20262243033,20262243039,6,2958,1049,-40
20264415258,20264415266,8,2941,1284,-40
20267300644,20267300641,-3,1116,3580,-40
20267791226,20267791233,7,3158,1400,-40
20268255582,20268255564,-18,2519,1205,-40
20270488242,20270488247,5,3421,1251,-40
20274346081,20274346077,-4,1388,3028,-40
20275081154,20275081161,7,2608,1076,-40
20276594603,20276594611,8,2622,1274,-40
20279484113,20279484118,5,4079,1750,-40
20279678270,20279678277,7,3091,1368,-40
20281058486,20281058493,7,3252,1287,-40
20284070253,20284070259,6,3316,1279,-40
20284356975,20284356981,6,3808,1704,-40
20286947121,20286947127,6,3144,1534,-40
20299311331,20299311338,7,2329,965,-40
20299839282,20299839289,7,2842,1726,-40
20301100563,20301100570,7,2537,1371,-40
20304109234,20304109238,4,2307,1016,-40
20304949654,20304949642,-12,2468,787,-40
20309436786,20309436795,9,1774,813,-40
20314313859,20314313866,7,3242,1953,-40
20314401577,20314401583,6,1884,958,-40
20315208142,20315208151,9,3083,1106,-40
20320395152,20320395150,-2,1456,2975,-40
20322034446,20322034450,4,1775,991,-40
20323417822,20323417830,8,2847,1594,-40
20330422159,20330422167,8,3258,1355,-40
20330992298,20330992305,7,3442,1197,-40
20337505220,20337505227,7,2148,1202,-40
20339211475,20339211481,6,2969,1582,-40
20340073306,20340073311,5,2378,1007,-40
20340828967,20340828974,7,2163,1080,-40
20341183085,20341183092,7,3693,1446,-40
20341987803,20341987806,3,1679,1712,-40
20342578877,20342578883,6,2529,1038,-40
20342727881,20342727897,16,1113,196,-40
20345246605,20345246610,5,2678,1077,-40
20348111630,20348111636,6,2889,1137,-40
20350132590,20350132597,7,2517,1187,-40
20351291498,20351291507,9,3423,1335,-40
20353985374,20353985378,4,2115,1149,-40
20354127022,20354127004,-18,785,386,-40
20354865151,20354865158,7,2381,1046,-40
20359141878,20359141881,3,1168,1219,-40
20359169715,20359169698,-17,2130,1271,-40
20359475395,20359475401,6,3741,1731,-40
20361198714,20361198721,7,3427,1285,-40
20365642770,20365642777,7,2584,1074,-40
20376076126,20376076129,3,1253,1668,-40
20377382637,20377382641,4,1868,1111,-40
20378425718,20378425722,4,2163,1200,-40
20378569297,20378569315,18,1777,579,-40
20382469333,20382469339,6,3329,1151,-40
20384497230,20384497234,4,2703,1230,-40
20385831899,20385831906,7,2045,41165,-40
20388796589,20388796595,6,2895,1218,-40
20390403309,20390403308,-1,1435,3920,-40
20390549448,20390549451,3,2385,2676,-40
20392469234,20392469241,7,2651,1343,-40
20393330763,20393330770,7,3055,1167,-40
20393648702,20393648709,7,4138,1348,-40
20394684354,20394684361,7,5252,1874,-40
20397328214,20397328222,8,2798,1152,-40
20399080246,20399080253,7,2858,1132,-40
20400597855,20400597842,-13,891,496,-40
20401651973,20401651979,6,3392,1996,-40
20401788962,20401788969,7,2516,1256,-40
20403508598,20403508606,8,3356,1586,-40
20405921682,20405921686,4,1612,870,-40
20405964262,20405964281,19,2649,1258,-40
20409988233,20409988238,5,2833,998,-40
20412990415,20412990415,0,899,1386,-40
20415106101,20415106106,5,2817,1483,-40
20415886303,20415886298,-5,859,5272,-40
20417044558,20417044563,5,2714,1412,-40
20417746743,20417746743,0,1983,2205,-40
20422897939,20422897947,8,2327,964,-40
20425386603,20425386611,8,3154,1503,-40
20425846034,20425846039,5,2913,1281,-40
20426076918,20426076923,5,2685,1202,-40
20430201022,20430201009,-13,1122,274,-40
20442759739,20442759746,7,3578,1677,-40
20442924470,20442924475,5,2006,1193,-40
20443241206,20443241211,5,3118,1072,-40
20443610528,20443610533,5,2960,2093,-40
20446091561,20446091567,6,3119,1153,-40
20450186149,20450186155,6,4118,1566,-40
20451682369,20451682365,-4,49630,20955,-40
20451946650,20451946657,7,3407,1699,-40
20453003157,20453003163,6,2491,1055,-40
20453434131,20453434137,6,3025,1435,-40
20454722673,20454722678,5,2580,1059,-40
20456818481,20456818485,4,2002,1169,-40
20457766123,20457766129,6,3846,1443,-40
20460659859,20460659861,2,1869,1685,-40
20461809413,20461809418,5,3894,1549,-40
20466833194,20466833199,5,1823,1137,-40
20467633987,20467633990,3,1128,1617,-40
20469472883,20469472888,5,3926,1717,-40
20473120456,20473120461,5,2029,1002,-40
20474565985,20474565990,5,3413,1381,-40
20481744882,20481744887,5,3746,1296,-40
20483230865,20483230866,1,2169,1667,-40
20490885530,20490885536,6,2923,1412,-40
20492276417,20492276423,6,1831,604,-40
20494286407,20494286414,7,3720,1378,-40
20497337114,20497337119,5,3394,1065,-40
20499696859,20499696865,6,2581,1186,-40
20500940878,20500940882,4,2603,1532,-40
20502522265,20502522271,6,2767,1371,-40
20503339141,20503339146,5,3515,1896,-40
20503766735,20503766741,6,1925,1121,-40
20508807928,20508807935,7,3129,1229,-40
20508934645,20508934625,-20,1643,706,-40
20511819278,20511819282,4,2378,1699,-40
20513353432,20513353438,6,2403,917,-40
20515628176,20515628183,7,2286,823,-40
20516709706,20516709714,8,1662,1552,-40
20516778360,20516778378,18,1449,374,-40
20526626599,20526626602,3,2909,1078,-40
20526847811,20526847826,15,540,1862,-40
20528533644,20528533650,6,2451,1282,-40
20529243908,20529243915,7,12799,28057,-40
20529301974,20529301970,-4,1215,3031,-40
20530843561,20530843545,-16,855,239,-40
20531794599,20531794599,0,1165,2037,-40
20535026099,20535026106,7,4028,1239,-40
20536665050,20536665051,1,2234,2182,-40
20540666709,20540666716,7,3016,1572,-40
20543565549,20543565554,5,1250,806,-40
20545362963,20545362971,8,3276,1448,-40
20545959906,20545959910,4,3312,2169,-40
20547065902,20547065908,6,2689,1232,-40
20547915453,20547915459,6,3182,898,-40
20548961640,20548961646,6,2656,1578,-40
20553309515,20553309522,7,3635,1393,-40
20557156350,20557156357,7,3189,1217,-40
20559915986,20559915991,5,2259,837,-40
20560306078,20560306058,-20,1742,1463,-40
20561007460,20561007466,6,4739,1697,-40
20563968470,20563968476,6,2379,1109,-40
20565392971,20565392977,6,3054,1540,-40
20565442783,20565442790,7,3121,1090,-40
20567036337,20567036339,2,1429,2079,-40
20568391805,20568391810,5,3110,2126,-40
20570138498,20570138505,7,3362,1360,-40
20570636562,20570636566,4,1787,1143,-40
20570758289,20570758294,5,2568,1184,-40
20571424376,20571424361,-15,1846,1051,-40
20572860475,20572860479,4,2642,1401,-40
20579845412,20579845418,6,3639,1607,-40
20580419074,20580419073,-1,4673,8301,-40
20583560465,20583560473,8,3263,1535,-40
20584201450,20584201456,6,4106,1662,-40
20585545290,20585545294,4,1699,1543,-40
20588077208,20588077214,6,3221,1435,-40
20590506655,20590506663,8,2426,1024,-40
20599898043,20599898047,4,2106,1636,-40
20602345254,20602345260,6,2867,1232,-40
20602807838,20602807843,5,2194,1086,-40
20616120028,20616120033,5,3008,872,-40
20617693256,20617693262,6,2715,1260,-40
20619078810,20619078804,-6,1378,85,-40
20622454876,20622454883,7,2781,815,-40
20624627165,20624627172,7,2328,1632,-40
20625081593,20625081599,6,1894,1240,-40
20626751506,20626751513,7,2367,1443,-40
20626787458,20626787444,-14,3651,1305,-40
20626845741,20626845740,-1,1041,1580,-40
20627169995,20627170003,8,3297,1099,-40
20632298533,20632298538,5,2671,1288,-40
20636280614,20636280608,-6,840,2596,-40
20636865643,20636865650,7,2558,1402,-40
20647230058,20647230063,5,2494,1194,-40
20647974972,20647974979,7,2120,1298,-40
20648708098,20648708098,0,1522,1875,-40
20653500353,20653500359,6,3869,1645,-40
20655667350,20655667356,6,3002,1169,-40
20658615735,20658615729,-6,2301,6184,-40
20661118153,20661118159,6,3293,1171,-40
20663701650,20663701658,8,3145,1457,-40
20666802953,20666802959,6,3148,1413,-40
20673438510,20673438517,7,3330,1743,-40
20674150358,20674150365,7,3620,1598,-40
20679605764,20679605787,23,138,5279,-40
20679945763,20679945769,6,4040,1455,-40
20684068650,20684068655,5,1892,1569,-40
20685533264,20685533272,8,3092,927,-40
20687768378,20687768383,5,2296,2006,-40
20688067061,20688067066,5,2208,1240,-40
20689128362,20689128369,7,2840,1020,-40
20692948658,20692948665,7,2579,1585,-40
20693888502,20693888506,4,1470,1475,-40
20700700451,20700700445,-6,1618,3646,-40
20705658436,20705658443,7,3109,1417,-40
20711769057,20711769064,7,3140,1227,-40
20713780341,20713780349,8,3803,1405,-40
20715334643,20715334633,-10,37500,15872,-40
20715532071,20715532078,7,2133,859,-40
20716367386,20716367393,7,3166,1851,-40
20716466282,20716466287,5,2536,1497,-40
20716812543,20716812551,8,2972,1519,-40
20717749990,20717749995,5,3894,1226,-40
20726824208,20726824215,7,1684,1021,-40
20727124482,20727124489,7,3873,1344,-40
20730777942,20730777942,0,2728,2867,-40
20731573906,20731573913,7,2974,1156,-40
20732336603,20732336598,-5,128,1347,-40
20736574541,20736574547,6,3403,1076,-40
20750139855,20750139861,6,3195,1350,-40
20750280458,20750280474,16,953,236,-40
20752921019,20752921026,7,2282,1421,-40
20754549422,20754549421,-1,1451,2288,-40
20755672470,20755672476,6,2408,1073,-40
20756352262,20756352272,10,2787,1286,-40
20756568221,20756568229,8,11244,42767,-40
20757609213,20757609218,5,1748,1032,-40
20764423884,20764423890,6,3040,1463,-40
20768318569,20768318575,6,2862,1292,-40
20768399144,20768399124,-20,2003,889,-40
20769977050,20769977058,8,3477,1576,-40
20771297869,20771297877,8,2274,1108,-40
20775740472,20775740478,6,2397,1154,-40
20775773172,20775773174,2,1442,1413,-40
20779663578,20779663584,6,2767,1253,-40
20791537321,20791537323,2,1225,712,-40
20796782191,20796782195,4,2666,1001,-40
20796952683,20796952666,-17,913,477,-40
20797570769,20797570775,6,3005,1407,-40
20803142486,20803142492,6,2245,1628,-40
20803439121,20803439126,5,2078,1381,-40
20803628554,20803628553,-1,1425,2098,-40
20806886337,20806886343,6,3268,1297,-40
20811070661,20811070651,-10,1601,24217,-40
20818499732,20818499738,6,3461,1363,-40
20820327107,20820327090,-17,3946,1423,-40
20820374014,20820374020,6,3417,1164,-40
20822623446,20822623451,5,2950,1502,-40
20825515446,20825515424,-22,965,607,-40
20826421822,20826421827,5,2452,894,-40
20827523085,20827523090,5,2296,1345,-40
20828053153,20828053158,5,2552,1666,-40
20832413513,20832413519,6,3798,1676,-40
20833149504,20833149509,5,2368,889,-40
20833694979,20833694985,6,2910,1075,-40
20839489158,20839489148,-10,2992,1203,-40
20840056065,20840056071,6,2576,891,-40
20841041747,20841041752,5,2457,2029,-40
20844855006,20844855011,5,2977,1436,-40
20845688934,20845688938,4,2219,1322,-40
20847332107,20847332114,7,3558,1407,-40
20849422013,20849422020,7,2210,1470,-40
20850786297,20850786279,-18,1187,295,-40
20851399558,20851399564,6,3053,1033,-40
20853158309,20853158315,6,3066,1275,-40
20861200393,20861200399,6,4230,1349,-40
20862061821,20862061826,5,2533,947,-40
20872453879,20872453878,-1,997,2062,-40
20876841267,20876841276,9,3029,890,-40
20884596102,20884596103,1,1317,1813,-40
20885988258,20885988265,7,1344,1136,-40
20888003240,20888003246,6,3505,978,-40
20891425963,20891425968,5,2288,1452,-40
20892798975,20892798987,12,935,251,-40
20893952993,20893952999,6,2117,1022,-40
20895217617,20895217623,6,3166,1234,-40
20896422205,20896422212,7,7949,2797,-40
20898661734,20898661741,7,3148,1169,-40
20899876531,20899876537,6,2745,1000,-40
20901896145,20901896151,6,1921,1054,-40
20902395831,20902395838,7,3094,1424,-40
20903899441,20903899446,5,2361,1100,-40
20904496424,20904496430,6,2314,1183,-40
20908380241,20908380245,4,2763,1754,-40
20908416157,20908416163,6,3623,1314,-40
20910639078,20910639083,5,3942,1796,-40
20914886500,20914886506,6,2860,962,-40
20916125141,20916125123,-18,2305,1234,-40
20916980564,20916980558,-6,2017,6851,-40
20917351406,20917351413,7,2784,1405,-40
20918376338,20918376345,7,3459,1588,-40
20919334991,20919334998,7,2664,1257,-40
20921915826,20921915833,7,4057,1218,-40
20924069197,20924069202,5,3268,1151,-40
20924294349,20924294346,-3,574,1584,-40
20930011494,20930011502,8,2664,1531,-40
20931572734,20931572741,7,3357,1234,-40
20935066729,20935066735,6,2676,1411,-40
20939264999,20939265005,6,2708,1395,-40
20943448946,20943448952,6,2403,960,-40
20946282142,20946282150,8,3198,973,-40
20946896159,20946896137,-22,2375,632,-40
20948847395,20948847401,6,2184,1260,-40
20952031529,20952031535,6,5011,1251,-40
20952824454,20952824459,5,1592,828,-40
20953674243,20953674226,-17,780,202,-40
20955259947,20955259947,0,1158,1,-40
20958160197,20958160205,8,3812,1581,-40
20958371971,20958371953,-18,3446,1301,-40
20960135145,20960135149,4,2896,1105,-40
20960363350,20960363361,11,1061,60,-40
20960990379,20960990360,-19,1400,511,-40
20962562090,20962562095,5,2142,1268,-40
20962894493,20962894499,6,3402,1129,-40
20963885695,20963885698,3,1528,1556,-40
20965971201,20965971203,2,1933,763,-40
20967490334,20967490335,1,1013,1499,-40
20968078715,20968078721,6,2786,875,-40
20970179433,20970179438,5,2337,1287,-40
20976876849,20976876855,6,2445,1009,-40
20982046430,20982046440,10,15461,33087,-40
20983904699,20983904707,8,2933,1634,-40
20984216676,20984216682,6,3482,1578,-40
20986314913,20986314906,-7,37958,13663,-40
20986782904,20986782910,6,2411,907,-40
20987690214,20987690222,8,2615,1420,-40
20992464090,20992464094,4,2632,1206,-40
20999279623,20999279641,18,464,2023,-40
21000375723,21000375730,7,2392,1123,-40
21000727510,21000727515,5,2735,1443,-40
21001012899,21001012906,7,3047,1149,-40
21004535313,21004535320,7,3214,1511,-40
21004848821,21004848826,5,2641,1549,-40
21005645926,21005645930,4,1771,1103,-40
21008882868,21008882875,7,1716,981,-40
21010468703,21010468706,3,1938,967,-40
21010907406,21010907412,6,1950,867,-40
21014707785,21014707779,-6,801,4840,-40
21017672205,21017672210,5,3249,1196,-40
21019595293,21019595299,6,1584,939,-40
21020899577,21020899583,6,3800,1187,-40
21022379426,21022379432,6,2012,1008,-40
21024606300,21024606306,6,2651,1146,-40
21025172995,21025173002,7,3081,1207,-40
21026388186,21026388191,5,1834,915,-40
21027178436,21027178442,6,3054,837,-40
21028263833,21028263840,7,3413,1598,-40
21029847957,21029847962,5,2466,1079,-40
21032863197,21032863202,5,33188,19411,-40
21033157516,21033157522,6,2836,702,-40
21037775649,21037775654,5,2362,1194,-40
21046325776,21046325779,3,2408,1906,-40
21048193723,21048193726,3,1855,1313,-40
21049349487,21049349491,4,1519,1030,-40
21051021275,21051021282,7,2730,1070,-40
21053204479,21053204485,6,2561,1001,-40
21053743045,21053743049,4,1643,1317,-40
21053978549,21053978556,7,2473,1185,-40
21056796508,21056796515,7,2764,1016,-40
21057168575,21057168586,11,3905,1211,-40
21063129101,21063129107,6,2476,1063,-40
21067199794,21067199801,7,3020,863,-40
21068451833,21068451836,3,2914,1756,-40
21068993124,21068993129,5,2204,796,-40
21070581649,21070581654,5,1784,718,-40
21075221089,21075221098,9,1689,758,-40
21076228737,21076228738,1,1037,478,-40
21077098752,21077098758,6,3312,1575,-40
21078798281,21078798287,6,1812,1044,-40
21083747793,21083747799,6,2195,1037,-40
21084898219,21084898223,4,2945,1466,-40
21087152367,21087152374,7,1761,817,-40
21089826299,21089826305,6,3308,1346,-40
21092324206,21092324213,7,2900,1390,-40
21093166837,21093166841,4,1105,933,-40
21098632690,21098632694,4,1764,1423,-40
21099565000,21099565005,5,3386,1216,-40
21099891103,21099891090,-13,1066,334,-40
21100466178,21100466185,7,3204,1124,-40
21105495341,21105495331,-10,27768,15638,-40
21106818913,21106818919,6,4149,1451,-40
21110142637,21110142644,7,5094,1394,-40
21110548648,21110548655,7,2727,1379,-40
21115131050,21115131058,8,2110,1025,-40
21115931019,21115931003,-16,3447,1594,-40
21116654070,21116654078,8,2629,1441,-40
21117816225,21117816225,0,996,1777,-40
21118332128,21118332134,6,2267,1114,-40
21118435873,21118435883,10,1871,1362,-40
21120481197,21120481196,-1,2391,3313,-40
21126778455,21126778461,6,2538,1533,-40
21127034312,21127034319,7,1939,875,-40
21130682881,21130682882,1,3018,3832,-40
21136373170,21136373177,7,2532,1492,-40
21144056689,21144056694,5,2292,1443,-40
21145294762,21145294766,4,3989,2409,-40
21145738301,21145738307,6,2027,1272,-40
21152261997,21152262003,6,3695,1411,-40
21153965237,21153965242,5,4253,1300,-40
21154525781,21154525761,-20,2293,740,-40
21157030866,21157030887,21,2990,1677,-40
21160991966,21160991973,7,2514,1232,-40
21161426472,21161426477,5,2663,1565,-40
21161609200,21161609205,5,2972,1702,-40
21163289757,21163289752,-5,1001,2185,-40
21163412005,21163411986,-19,2206,828,-40
21166672100,21166672106,6,3292,1579,-40
21167509292,21167509302,10,231,899,-40
21169363663,21169363654,-9,28433,19714,-40
21169636768,21169636772,4,2715,1259,-40
21172815842,21172815848,6,2468,1132,-40
21175845461,21175845467,6,3039,1175,-40
21178866599,21178866602,3,2786,1315,-40
21187424206,21187424213,7,2418,1978,-40
21187927503,21187927509,6,2186,1212,-40
21189447075,21189447083,8,3134,1474,-40
21189778951,21189778958,7,2369,1262,-40
21191089987,21191089986,-1,2213,2354,-40
21192384914,21192384918,4,2055,1348,-40
21196315922,21196315929,7,2773,950,-40
21198309127,21198309132,5,2738,1514,-40
21200136182,21200136190,8,2909,1182,-40
21200944305,21200944290,-15,1162,275,-40
21205770515,21205770519,4,2137,1558,-40
21206711003,21206711009,6,3499,1272,-40
21211556768,21211556760,-8,1902,38103,-40
21212382683,21212382679,-4,77,3566,-40
21219045915,21219045922,7,2706,793,-40
21225815903,21225815910,7,4894,1952,-40
21225855233,21225855239,6,2561,1515,-40
21226543770,21226543777,7,2740,1141,-40
21228405704,21228405709,5,3378,1441,-40
21229168071,21229168076,5,3684,1843,-40
21231418082,21231418088,6,2624,1112,-40
21240133432,21240133429,-3,1605,2262,-40
21245416172,21245416178,6,3294,1309,-40
21247413168,21247413177,9,2040,988,-40
21247661746,21247661748,2,1537,1672,-40
21248073859,21248073865,6,2757,1145,-40
21252495494,21252495491,-3,1528,2565,-40
21253774566,21253774574,8,2535,1437,-40
21256363899,21256363906,7,3675,2012,-40
21256783841,21256783847,6,2562,1512,-40
21256948781,21256948789,8,2258,962,-40
21260220362,21260220366,4,1982,1442,-40
21260642174,21260642162,-12,787,122,-40
21261741078,21261741087,9,2706,1116,-40
21261951485,21261951490,5,3207,1781,-40
21265322966,21265322961,-5,1605,3811,-40
21267131476,21267131481,5,3524,1988,-40
21268362171,21268362179,8,2584,1296,-40
21271946842,21271946849,7,2767,1008,-40
21273451163,21273451148,-15,716,193,-40
21280101084,21280101091,7,2919,1163,-40
21280130697,21280130682,-15,996,264,-40
21284996879,21284996885,6,3864,1544,-40
21287145006,21287145013,7,2682,988,-40
21287512873,21287512878,5,1993,1174,-40
21287580326,21287580330,4,1329,619,-40
21293563748,21293563754,6,1645,1067,-40
21293621022,21293621043,21,420,258,-40
21296680194,21296680199,5,1714,1107,-40
21300619837,21300619845,8,2636,1465,-40
21300709331,21300709337,6,872,173,-40
21302772467,21302772474,7,2813,1121,-40
21303094210,21303094195,-15,2780,1023,-40
21306016446,21306016453,7,2634,1501,-40
21306643463,21306643452,-11,2958,1496,-40
21308508509,21308508513,4,3376,1063,-40
21308620858,21308620866,8,3728,1455,-40
21311887552,21311887559,7,2032,796,-40
21311926562,21311926570,8,3933,1222,-40
21313385226,21313385232,6,1578,1319,-40
21318550094,21318550100,6,2695,1542,-40
21320081439,21320081417,-22,995,257,-40
21323232246,21323232253,7,2431,774,-40
21323269025,21323269042,17,4182,1293,-40
21327120536,21327120542,6,3732,1671,-40
21329725563,21329725570,7,3572,1469,-40
21331985838,21331985845,7,2343,1246,-40
21332022507,21332022488,-19,2049,1129,-40
21332573943,21332573949,6,2652,989,-40
21332935148,21332935169,21,3904,1802,-40
21335744296,21335744302,6,2162,1036,-40
21339392405,21339392410,5,2491,1184,-40
21342995032,21342995039,7,2777,1014,-40
21343087903,21343087890,-13,1985,1096,-40
21343551224,21343551232,8,3944,1161,-40
21346398495,21346398474,-21,1800,820,-40
21351692040,21351692046,6,1872,908,-40
21355117205,21355117210,5,1699,983,-40
21360491910,21360491889,-21,973,171,-40
21361697346,21361697353,7,3044,1480,-40
21362108420,21362108404,-16,2449,1008,-40
21365472825,21365472829,4,859,1259,-40
21368193505,21368193511,6,2126,871,-40
21373337494,21373337498,4,1765,1702,-40
21375006138,21375006145,7,3631,2038,-40
21376786166,21376786174,8,2287,1324,-40
21377617389,21377617397,8,4119,1716,-40
21377714977,21377714983,6,3918,1687,-40
21378499006,21378499010,4,1419,880,-40
21387597952,21387597958,6,4101,1317,-40
21388239780,21388239787,7,2387,1247,-40
21392499300,21392499307,7,2462,1137,-40
21393874382,21393874389,7,3119,1378,-40
21394109285,21394109290,5,2890,1184,-40
21401230278,21401230281,3,3353,3535,-40
21402326647,21402326653,6,11071,32140,-40
21403878522,21403878530,8,1909,731,-40
21404642044,21404642061,17,16719,24211,-40
21406579786,21406579792,6,2956,1350,-40
21408976559,21408976568,9,2288,949,-40
21417149323,21417149326,3,2515,1005,-40
21417181695,21417181701,6,2231,1015,-40
21419942144,21419942150,6,3345,1854,-40
21420105223,21420105216,-7,33144,13241,-40
21420851937,21420851943,6,2691,1209,-40
21421327686,21421327666,-20,2165,1219,-40
21422310798,21422310802,4,2418,1799,-40
21422923999,21422924006,7,2542,1103,-40
21429504372,21429504378,6,2055,863,-40
21431150102,21431150106,4,2321,1637,-40
21432362197,21432362178,-19,2108,1339,-40
21434467376,21434467382,6,3841,1837,-40
21436754472,21436754465,-7,1033,4776,-40
21438252179,21438252173,-6,1202,3012,-40
21442805193,21442805199,6,2363,672,-40
21445077186,21445077190,4,2174,1347,-40
21445944578,21445944585,7,2172,776,-40
21446090354,21446090339,-15,282,15,-40
21446896278,21446896285,7,2496,1074,-40
21449508290,21449508295,5,2678,1598,-40
21457023963,21457023970,7,2984,1160,-40
21461612815,21461612821,6,3145,1323,-40
21462005333,21462005341,8,1413,795,-40
21468338672,21468338677,5,3570,1755,-40
21469700612,21469700619,7,2714,1298,-40
21473193711,21473193718,7,3579,1542,-40
21473787359,21473787363,4,2639,949,-40
21474577866,21474577870,4,2055,1434,-40
21477228002,21477228008,6,1860,970,-40
21481466308,21481466314,6,3887,1016,-40
21481962266,21481962273,7,3002,1354,-40
21483490806,21483490814,8,3126,1083,-40
21484089410,21484089414,4,2102,1168,-40
21494845166,21494845171,5,2380,1356,-40
21495672477,21495672486,9,2293,1456,-40
21499239986,21499239995,9,2118,634,-40
21499742119,21499742097,-22,1829,578,-40
21499825321,21499825327,6,3154,1104,-40
21501230242,21501230250,8,2932,1637,-40
21502857434,21502857440,6,3018,1160,-40
21504264362,21504264370,8,3721,1942,-40
21505478446,21505478453,7,2513,1190,-40
21506370226,21506370233,7,1981,918,-40
21510127096,21510127103,7,2608,1318,-40
21511001781,21511001787,6,3135,1794,-40
21512368653,21512368650,-3,1177,2832,-40
21516892074,21516892081,7,3238,1002,-40
21517123811,21517123800,-11,1287,150,-40
21517795322,21517795304,-18,675,345,-40
21521485664,21521485667,3,1878,1356,-40
21522182697,21522182703,6,2843,1346,-40
21526475706,21526475713,7,1897,959,-40
21527085886,21527085885,-1,2091,3869,-40
21527273242,21527273247,5,872,668,-40
21527990798,21527990805,7,3882,1638,-40
21528645280,21528645286,6,2056,876,-40
21530121966,21530121961,-5,584,2461,-40
21533907751,21533907755,4,2281,891,-40
21534220013,21534220018,5,3044,1539,-40
21535061239,21535061245,6,3203,1268,-40
21536992317,21536992324,7,1929,1171,-40
21538065738,21538065744,6,4450,1156,-40
21538731193,21538731196,3,2326,1033,-40
21541606233,21541606239,6,6397,2191,-40
21542144429,21542144434,5,1248,970,-40
21542549885,21542549867,-18,2527,1143,-40
21547901106,21547901114,8,2602,1466,-40
21548119241,21548119246,5,2564,1340,-40
21549231652,21549231659,7,2135,934,-40
21549610639,21549610645,6,2977,949,-40
21550222631,21550222635,4,2373,1264,-40
21551905040,21551905030,-10,1155,1058,-40
21554833507,21554833494,-13,2557,1558,-40
21555916494,21555916499,5,2420,987,-40
21558779633,21558779640,7,2887,1101,-40
21559121035,21559121040,5,1887,1155,-40
21564476590,21564476595,5,2130,748,-40
21572674372,21572674378,6,3306,1270,-40
21573198119,21573198125,6,3230,1308,-40
21576440215,21576440211,-4,1016,2043,-40
21583279837,21583279843,6,2825,1004,-40
21583775867,21583775849,-18,1245,247,-40
21587103253,21587103258,5,1676,820,-40
21592805994,21592805982,-12,10071,38255,-40
21593085294,21593085300,6,2190,1477,-40
21597028470,21597028477,7,3809,1724,-40
21603713697,21603713694,-3,1467,2256,-40
21607024528,21607024525,-3,882,2279,-40
21610760734,21610760741,7,2889,1585,-40
21615304818,21615304820,2,2115,2056,-40
21615772124,21615772131,7,3372,1662,-40
21617828655,21617828642,-13,2705,1038,-40
21619972650,21619972657,7,3442,1784,-40
21622064040,21622064047,7,6899,1290,-40
21625952213,21625952219,6,4116,1828,-40
21630493110,21630493115,5,2354,971,-40
21630759950,21630759949,-1,1083,1829,-40
21630986678,21630986671,-7,1322,31010,-40
21631565083,21631565083,0,1473,2068,-40
21634753931,21634753936,5,3578,1567,-40
21636662664,21636662658,-6,2043,5410,-40
21638906696,21638906702,6,3547,1177,-40
21639301634,21639301618,-16,930,326,-40
21641183795,21641183801,6,2636,1147,-40
21646006532,21646006534,2,1762,1837,-40
21646731450,21646731458,8,3756,1594,-40
21653658924,21653658930,6,2081,945,-40
21655572346,21655572330,-16,2164,780,-40
21663360543,21663360549,6,2232,598,-40
21666061915,21666061922,7,4966,1436,-40
21667477327,21667477333,6,3694,1784,-40
21667850379,21667850386,7,2518,1213,-40
21671121076,21671121082,6,1806,1120,-40
21674020652,21674020658,6,2654,1088,-40
21676831041,21676831046,5,2441,833,-40
21677870803,21677870809,6,3312,1482,-40
21679238053,21679238058,5,1943,1295,-40
21679693935,21679693941,6,2672,1465,-40
21680948675,21680948681,6,2288,1399,-40
21682266810,21682266815,5,2458,1317,-40
21685061797,21685061802,5,3695,1384,-40
21687091820,21687091826,6,2516,942,-40
21687810998,21687810984,-14,948,142,-40
21688177484,21688177489,5,2620,1136,-40
21692012403,21692012409,6,3700,1344,-40
21693883646,21693883648,2,2137,2705,-40
21694194795,21694194801,6,2265,1253,-40
21695358333,21695358340,7,3757,1483,-40
21699039429,21699039435,6,2192,1593,-40
21699642773,21699642780,7,3397,1241,-40
21701613818,21701613825,7,2893,1423,-40
21706036582,21706036588,6,3448,1718,-40
21706083342,21706083346,4,3403,1792,-40
21707737689,21707737695,6,3652,1542,-40
21708117742,21708117728,-14,4723,1243,-40
21711677381,21711677386,5,2637,1242,-40
21713728201,21713728207,6,2702,1311,-40
21717185034,21717185038,4,2906,1451,-40
21717425989,21717425994,5,3394,1857,-40
21720758207,21720758213,6,2502,1288,-40
21724173338,21724173340,2,1860,1641,-40
21730944816,21730944821,5,2760,1080,-40
21731179148,21731179132,-16,2240,889,-40
21732263990,21732263995,5,1888,970,-40
21733481591,21733481597,6,3532,1486,-40
21734483307,21734483312,5,4437,1192,-40
21734596530,21734596537,7,2358,975,-40
21742541652,21742541658,6,3401,1411,-40
21747970682,21747970687,5,3931,1424,-40
21750534970,21750534990,20,787,315,-40
21751971729,21751971736,7,3383,1283,-40
21753429466,21753429471,5,2719,1609,-40
21759968553,21759968559,6,2285,1136,-40
21761492018,21761492002,-16,3479,895,-40
21779822170,21779822176,6,1755,679,-40
21780308264,21780308251,-13,2146,818,-40
21784406781,21784406764,-17,3162,1257,-40
21787783813,21787783820,7,3179,1765,-40
21792844973,21792844975,2,1557,907,-40
21799013460,21799013465,5,2034,707,-40
21799305626,21799305633,7,2431,1270,-40
21803583535,21803583541,6,3074,1698,-40
21816881382,21816881388,6,4069,1597,-40
21820174575,21820174582,7,3636,1348,-40
21826643929,21826643931,2,2198,1913,-40
21831762014,21831762019,5,1772,948,-40
21832906046,21832906054,8,2025,627,-40
21833405566,21833405571,5,2036,853,-40
21833954199,21833954205,6,3815,1769,-40
21834451493,21834451499,6,2943,1305,-40
21834496654,21834496640,-14,1081,397,-40
21836397569,21836397574,5,3914,1582,-40
21837501422,21837501402,-20,2585,1125,-40
21838207219,21838207223,4,2536,960,-40
21838973569,21838973575,6,2931,1120,-40
21845321322,21845321329,7,4184,1525,-40
21847059787,21847059785,-2,1038,1465,-40
21847179070,21847179075,5,2474,1669,-40
21847642929,21847642936,7,2120,888,-40
21857725081,21857725087,6,3051,1784,-40
21863501534,21863501543,9,13305,33029,-40
21863787133,21863787139,6,2443,1442,-40
21865787871,21865787853,-18,848,389,-40
21873580042,21873580049,7,3466,1511,-40
21873810049,21873810058,9,2932,870,-40
21873996942,21873996948,6,4267,1868,-40
21875675169,21875675174,5,1721,1091,-40
21876766810,21876766814,4,2343,1196,-40
21878167298,21878167302,4,2957,1338,-40
21882619927,21882619934,7,2437,1155,-40
21885647822,21885647829,7,3301,1844,-40
21889583726,21889583728,2,1523,1108,-40
21890810089,21890810095,6,3324,1561,-40
21893063930,21893063935,5,3784,1851,-40
21894820425,21894820432,7,3331,1122,-40
21897900082,21897900087,5,2963,1201,-40
21898068821,21898068825,4,45636,27095,-40
21898458913,21898458918,5,2163,1106,-40
21899008762,21899008769,7,3394,1162,-40
21902824261,21902824267,6,3764,1374,-40
21904266619,21904266625,6,2537,1647,-40
21905424890,21905424895,5,1239,672,-40
21911317508,21911317515,7,3375,1030,-40
21912618408,21912618415,7,2168,1285,-40
21917607854,21917607862,8,1934,556,-40
21921286294,21921286301,7,3443,1287,-40
21922359190,21922359178,-12,2973,1753,-40
21925091990,21925091998,8,2979,1326,-40
21927380409,21927380415,6,1679,1131,-40
21927556490,21927556497,7,3309,958,-40
21934280492,21934280498,6,3338,1202,-40
21934419396,21934419403,7,4026,1365,-40
21934611737,21934611743,6,3133,1131,-40
21937318368,21937318375,7,2425,817,-40
21942775187,21942775193,6,3758,1730,-40
21947146883,21947146889,6,3752,1693,-40
21947364642,21947364641,-1,733,178,-40
21950091374,21950091380,6,2556,1135,-40
21957963351,21957963358,7,3382,1394,-40
21961637849,21961637847,-2,1560,1947,-40
21966559375,21966559381,6,3058,1064,-40
21966809098,21966809099,1,1074,331,-40
21968718010,21968718018,8,3503,1435,-40
21971185717,21971185721,4,2867,1140,-40
21975069258,21975069263,5,2350,916,-40
21981090513,21981090519,6,1465,1082,-40
21982570952,21982570954,2,34242,18374,-40
21984241426,21984241430,4,2049,1093,-40
21988418438,21988418442,4,1487,1213,-40
21992457050,21992457057,7,3553,1111,-40
21994328313,21994328320,7,2839,1504,-40
21996435358,21996435367,9,3364,1712,-40
21998406436,21998406440,4,1572,1694,-40
21999316558,21999316565,7,2708,1578,-40
21999628252,21999628258,6,2037,884,-40
22002275471,22002275478,7,2861,909,-40
22003025495,22003025500,5,1906,1771,-40
22003213028,22003213032,4,1353,959,-40
22008532270,22008532275,5,2725,1717,-40
22011278495,22011278499,4,2311,969,-40
22013571071,22013571077,6,2844,1436,-40
22017695168,22017695173,5,2764,1429,-40
22027056505,22027056513,8,2836,1621,-40
22027851288,22027851295,7,2211,1242,-40
22027886711,22027886690,-21,896,462,-40
22030234283,22030234290,7,2084,1168,-40
22031053271,22031053277,6,3802,1297,-40
22031778862,22031778869,7,2923,1271,-40
22036457099,22036457106,7,3138,1036,-40
22037026554,22037026559,5,1027,1202,-40
22043213768,22043213765,-3,965,1767,-40
22043645216,22043645220,4,731,280,-40
22044148511,22044148500,-11,1971,1021,-40
22049212227,22049212234,7,2208,841,-40
22051730905,22051730910,5,2818,1165,-40
22053558998,22053559005,7,3150,1075,-40
22060209651,22060209658,7,4902,1989,-40
22063708058,22063708064,6,2831,1282,-40
22064424314,22064424297,-17,1129,153,-40
22069115267,22069115273,6,1667,1266,-40
22070316129,22070316134,5,3282,1268,-40
22070346557,22070346539,-18,1759,439,-40
22070445342,22070445348,6,3137,1244,-40
22071851828,22071851834,6,3007,1088,-40
22077341822,22077341826,4,2264,1615,-40
22077452706,22077452713,7,2375,1379,-40
22080644780,22080644786,6,2528,1116,-40
22080832729,22080832727,-2,875,1445,-40
22081707193,22081707200,7,2276,986,-40
22082776989,22082776994,5,2932,1313,-40
22083480006,22083480010,4,3352,1586,-40
22084472489,22084472496,7,2351,1145,-40
22085362205,22085362211,6,2772,1189,-40
22085578387,22085578393,6,2271,960,-40
22085642275,22085642259,-16,4120,1252,-40
22086327426,22086327421,-5,785,1865,-40
22086484353,22086484338,-15,1298,326,-40
22092489515,22092489521,6,3022,1268,-40
22097344147,22097344154,7,2414,737,-40
22098747080,22098747086,6,3360,1917,-40
22099744849,22099744857,8,3231,1094,-40
22103456895,22103456899,4,1614,993,-40
22104226553,22104226559,6,2412,1167,-40
22108875773,22108875779,6,2643,1506,-40
22112731450,22112731455,5,2600,1132,-40
22113068750,22113068745,-5,531,2090,-40
22118429370,22118429371,1,2068,1604,-40
22119063806,22119063813,7,2740,1315,-40
22119937338,22119937341,3,1317,1885,-40
22123852487,22123852493,6,2155,1147,-40
22125374329,22125374324,-5,2701,8037,-40
22130413063,22130413070,7,2513,1438,-40
22130502730,22130502735,5,2059,972,-40
22131114315,22131114318,3,1403,1433,-40
22132792347,22132792355,8,4586,2162,-40
22133878599,22133878606,7,2865,1010,-40
22134803530,22134803537,7,3468,1888,-40
22134926060,22134926066,6,2626,1147,-40
22135773742,22135773734,-8,969,4800,-40
22137906656,22137906662,6,3476,1334,-40
22138294687,22138294667,-20,1165,306,-40
22140299427,22140299433,6,3068,1209,-40
22144918418,22144918424,6,2856,1313,-40
22146921719,22146921725,6,3085,1158,-40
22148242086,22148242093,7,3858,1188,-40
22153105130,22153105137,7,1844,972,-40
22154194782,22154194784,2,19293,33021,-40
22159567021,22159567010,-11,1104,230,-40
22166002726,22166002733,7,2143,969,-40
22168089370,22168089376,6,2636,1302,-40
22169266150,22169266156,6,3574,1753,-40
22171311558,22171311554,-4,1095,292,-40
22173067420,22173067426,6,2481,1250,-40
22176320225,22176320229,4,2659,1155,-40
22179740743,22179740747,4,2666,1222,-40
22182264841,22182264829,-12,21441,16160,-40
22182709545,22182709550,5,2611,993,-40
22186008985,22186008991,6,2576,1274,-40
22186387974,22186387979,5,3087,994,-40
22194027984,22194027985,1,1515,1159,-40
22194187465,22194187473,8,1669,1004,-40
22198664774,22198664781,7,2509,1178,-40
22201586275,22201586283,8,2547,840,-40
22201693791,22201693780,-11,746,260,-40
22201856769,22201856774,5,1907,1095,-40
22213077955,22213077962,7,2708,1339,-40
22213703946,22213703946,0,1164,849,-40
22214476296,22214476294,-2,18794,7313,-40
22217080406,22217080411,5,2263,1311,-40
22217185707,22217185714,7,4245,2112,-40
22218800757,22218800751,-6,1500,6149,-40
22220429914,22220429920,6,1281,653,-40
22221576022,22221576028,6,3078,1422,-40
22223568029,22223568034,5,2063,1554,-40
22226501614,22226501623,9,2938,1198,-40
22228326879,22228326871,-8,6255,14395,-40
22237031608,22237031601,-7,1533,5470,-40
22237900777,22237900782,5,1394,818,-40
22239687933,22239687938,5,1747,1385,-40
22241244075,22241244079,4,1777,1350,-40
22248890362,22248890369,7,2241,1131,-40
22250311671,22250311681,10,2994,1448,-40
22251673458,22251673466,8,2726,1130,-40
22251921366,22251921363,-3,863,216,-40
22252250963,22252250969,6,3776,1664,-40
22253186682,22253186687,5,3248,1974,-40
22255733898,22255733906,8,2774,976,-40
22257359675,22257359689,14,2347,980,-40
22259704778,22259704785,7,2946,1114,-40
22260669226,22260669231,5,3919,1168,-40
22260955222,22260955230,8,3098,1286,-40
22262051770,22262051775,5,3823,1372,-40
22262375774,22262375779,5,2791,1248,-40
22266068329,22266068334,5,2332,857,-40
22267139402,22267139406,4,1900,1354,-40
22269734871,22269734877,6,3223,1036,-40
22275387997,22275388003,6,2600,1117,-40
22280649653,22280649674,21,425,629,-40
22281802725,22281802731,6,2688,2055,-40
22284341762,22284341767,5,2067,1151,-40
22287999759,22287999767,8,2881,958,-40
22288191886,22288191892,6,2931,1304,-40
22289409357,22289409364,7,2734,957,-40
22289659000,22289658985,-15,3857,1471,-40
22289745287,22289745283,-4,335,128,-40
22292384004,22292384010,6,2158,867,-40
22292527447,22292527452,5,2406,1090,-40
22294004174,22294004182,8,1556,887,-40
22294070366,22294070344,-22,3127,1156,-40
22294906802,22294906811,9,5077,1241,-40
22294999990,22295000001,11,1930,689,-40
22297337922,22297337918,-4,705,2644,-40
22305896464,22305896469,5,1549,1009,-40
22306674867,22306674858,-9,2765,708,-40
22311203210,22311203217,7,2867,1638,-40
22322377001,22322377006,5,3012,1001,-40
22324003446,22324003454,8,6131,1408,-40
22328261510,22328261517,7,2925,1350,-40
22328315069,22328315074,5,3551,1673,-40
22328735588,22328735594,6,2688,1392,-40
22329117377,22329117382,5,2093,1119,-40
22330142031,22330142010,-21,884,1498,-40
22337147879,22337147889,10,2448,1200,-40
22338515581,22338515574,-7,33570,14017,-40
22339776578,22339776586,8,2535,918,-40
22342182744,22342182751,7,2862,1360,-40
22344665969,22344665965,-4,1666,2829,-40
22344819722,22344819729,7,3295,1751,-40
22352786494,22352786499,5,2234,977,-40
22355997601,22355997608,7,3387,1606,-40
22357147859,22357147865,6,2748,1255,-40
22357886774,22357886782,8,2729,954,-40
22360808575,22360808580,5,3051,1515,-40
22361845829,22361845834,5,2470,1190,-40
22362116350,22362116336,-14,924,159,-40
22362735463,22362735474,11,842,340,-40
22367254120,22367254126,6,3101,1364,-40
22367714018,22367714023,5,3064,1281,-40
22369205150,22369205154,4,2133,1295,-40
22370495225,22370495231,6,2104,747,-40
22372199419,22372199425,6,2981,1438,-40
22372494177,22372494168,-9,1183,154,-40
22373447088,22373447094,6,2920,1284,-40
22384313858,22384313866,8,2696,1236,-40
22384625862,22384625868,6,3804,1691,-40
22386482922,22386482929,7,2616,1284,-40
22387120218,22387120213,-5,1754,3601,-40
22391248305,22391248313,8,3162,913,-40
22397772254,22397772240,-14,2943,1022,-40
22397846957,22397846960,3,835,290,-40
22403541126,22403541132,6,2859,1339,-40
22404449323,22404449327,4,1153,845,-40
22405703246,22405703228,-18,592,139,-40
22410792108,22410792110,2,1811,39967,-40
22414427977,22414427970,-7,1051,7516,-40
22415878654,22415878659,5,2423,1008,-40
22416538217,22416538225,8,2839,1324,-40
22418615615,22418615622,7,2517,1126,-40
22421384654,22421384658,4,3580,1263,-40
22421622730,22421622738,8,3729,996,-40
22426957089,22426957095,6,3181,1493,-40
22428943214,22428943220,6,2908,1333,-40
22429647845,22429647849,4,2699,1370,-40
22433229293,22433229299,6,2473,1033,-40
22438364109,22438364107,-2,2550,3767,-40
22439834048,22439834055,7,2924,1268,-40
22440710829,22440710840,11,1797,738,-40
22442663742,22442663748,6,2624,1125,-40
22443224583,22443224601,18,884,135,-40
22447726509,22447726515,6,4017,1512,-40
22454672110,22454672117,7,2603,1119,-40
22454706983,22454706984,1,1774,2039,-40
22455168414,22455168421,7,3989,1707,-40
22461471297,22461471303,6,3195,1468,-40
22462891941,22462891947,6,2298,1145,-40
22464936837,22464936843,6,3132,1074,-40
22468288658,22468288666,8,5881,1742,-40
22469487298,22469487294,-4,2231,4023,-40
22470432025,22470432031,6,1533,826,-40
22472861426,22472861432,6,2466,1268,-40
22474350235,22474350242,7,3316,1727,-40
22476284563,22476284569,6,2627,1185,-40
22477283695,22477283702,7,3346,1270,-40
22478462064,22478462070,6,2263,696,-40
22478680033,22478680039,6,2464,1345,-40
22479024431,22479024437,6,3391,1302,-40
22479809510,22479809516,6,2736,1619,-40
22482427938,22482427937,-1,1190,1918,-40
22487236827,22487236834,7,3031,1373,-40
22492830074,22492830081,7,12078,34509,-40
22499297066,22499297073,7,2196,1175,-40
22501480057,22501480063,6,3327,1193,-40
22503386930,22503386934,4,2758,1342,-40
22503906424,22503906430,6,2489,1014,-40
22505986493,22505986499,6,3240,1174,-40
22507012732,22507012740,8,2571,1019,-40
22508150064,22508150069,5,2685,1503,-40
22509385789,22509385795,6,2776,1273,-40
22509765648,22509765650,2,1798,1705,-40
22513248942,22513248946,4,2521,1359,-40
22521122393,22521122410,17,14762,43111,-40
22521318292,22521318274,-18,2441,1426,-40
22522578706,22522578713,7,2695,1104,-40
22522865621,22522865628,7,3381,1094,-40
22528208258,22528208263,5,1911,995,-40
22528544349,22528544350,1,1163,1007,-40
22531326530,22531326525,-5,964,3163,-40
22533445909,22533445914,5,3312,820,-40
22533726344,22533726349,5,1960,950,-40
22536500235,22536500224,-11,2195,941,-40
22537106395,22537106385,-10,239,1522,-40
22537605610,22537605617,7,4068,1167,-40
22544129306,22544129313,7,2276,1161,-40
22546558302,22546558303,1,1051,1837,-40
22555017299,22555017305,6,3319,959,-40
22555604695,22555604707,12,831,278,-40
22560356529,22560356534,5,2578,1295,-40
22561575102,22561575109,7,2863,1172,-40
22567366898,22567366905,7,2433,981,-40
22567891974,22567891956,-18,2248,1078,-40
22571383250,22571383258,8,3309,1451,-40
22571921126,22571921131,5,4007,1157,-40
22574304701,22574304719,18,2317,1208,-40
22577970277,22577970283,6,2154,1572,-40
22578161887,22578161873,-14,1701,762,-40
22578291377,22578291360,-17,2954,1257,-40
22583807226,22583807232,6,2688,1048,-40
22589847298,22589847306,8,3463,1418,-40
22592630988,22592630995,7,1763,893,-40
22595663581,22595663583,2,1175,730,-40
22596440870,22596440877,7,3491,1692,-40
22596791737,22596791742,5,1433,570,-40
22599106852,22599106857,5,1913,1538,-40
22599701629,22599701635,6,3238,1248,-40
22600827897,22600827902,5,3132,1637,-40
22601051044,22601051051,7,2935,1225,-40
22601634204,22601634210,6,4357,1405,-40
22602508118,22602508123,5,3111,1134,-40
22603818850,22603818854,4,2071,1454,-40
22605581797,22605581803,6,2892,1204,-40
22606096386,22606096391,5,1937,1313,-40
22606522669,22606522675,6,2764,1268,-40
22608414866,22608414871,5,3018,1231,-40
22612734723,22612734710,-13,3634,1311,-40
22617523177,22617523183,6,1853,814,-40
22618518587,22618518594,7,3106,1858,-40
22621523257,22621523266,9,2361,1368,-40
22622093799,22622093805,6,1695,1114,-40
22623899501,22623899507,6,1883,750,-40
22625419781,22625419789,8,3470,1467,-40
22628227238,22628227245,7,2670,1313,-40
22632507747,22632507744,-3,19468,45812,-40
22635850018,22635850024,6,2245,1392,-40
22636026451,22636026458,7,3185,1101,-40
22637231321,22637231328,7,2117,840,-40
22642691057,22642691062,5,3033,1680,-40
22643176686,22643176698,12,1992,1219,-40
22643357808,22643357827,19,725,184,-40
22644375914,22644375923,9,4361,1466,-40
22645806190,22645806198,8,3143,1604,-40
22650070479,22650070487,8,3485,1214,-40
22652014385,22652014391,6,3828,1437,-40
22653297005,22653297011,6,7118,2142,-40
22654772689,22654772695,6,3301,1375,-40
22657417018,22657417012,-6,250,982,-40
22658470154,22658470159,5,2905,1350,-40
22664866714,22664866721,7,2727,1566,-40
22669396714,22669396721,7,2424,1255,-40
22670455446,22670455451,5,2450,1208,-40
22671006550,22671006555,5,4198,1140,-40
22672421806,22672421804,-2,1533,2753,-40
22675224372,22675224379,7,2600,1179,-40
22676910125,22676910132,7,3159,1226,-40
22678529276,22678529282,6,3243,1248,-40
22684112274,22684112258,-16,2497,1839,-40
22686083086,22686083082,-4,925,1212,-40
22687136198,22687136202,4,2263,1693,-40
22691398233,22691398239,6,3250,1064,-40
22691987656,22691987663,7,2520,1223,-40
22693407953,22693407958,5,3555,1403,-40
22693650310,22693650316,6,1537,754,-40
22699287150,22699287159,9,976,699,-40
22702444355,22702444361,6,2867,1502,-40
22706454155,22706454157,2,2245,3017,-40
22708817578,22708817585,7,2869,1482,-40
22712760589,22712760597,8,2853,1043,-40
22713376142,22713376147,5,2945,1172,-40
22714632786,22714632793,7,2901,1328,-40
22715087782,22715087787,5,2959,982,-40
22717147231,22717147235,4,44306,28984,-40
22720267098,22720267105,7,2801,1195,-40
22721262707,22721262698,-9,534,291,-40
22726762807,22726762814,7,2484,1501,-40
22729149408,22729149414,6,2981,1081,-40
22731425507,22731425514,7,2863,808,-40
22731887577,22731887589,12,15222,39897,-40
22732534887,22732534893,6,3062,848,-40
22740036264,22740036269,5,2528,1212,-40
22740471305,22740471313,8,1076,346,-40
22742055080,22742055086,6,2161,1298,-40
22748427234,22748427242,8,3385,1423,-40
22757956516,22757956517,1,1150,1497,-40
22761272171,22761272152,-19,772,465,-40
22765711089,22765711095,6,3091,1279,-40
22765897257,22765897263,6,2854,1051,-40
22769703931,22769703939,8,2869,1073,-40
22772244282,22772244290,8,3331,970,-40
22773939074,22773939080,6,2285,1294,-40
22777561274,22777561287,13,387,1272,-40
22785613805,22785613808,3,1376,1135,-40
22788212908,22788212914,6,3459,648,-40
22793500231,22793500237,6,3544,1172,-40
22793619975,22793619971,-4,518,278,-40
22793970252,22793970258,6,2691,1278,-40
22797989477,22797989482,5,2691,1273,-40
22803464083,22803464091,8,1592,842,-40
22812585820,22812585826,6,1810,1277,-40
22813115675,22813115681,6,2876,1233,-40
22817581506,22817581513,7,2649,1037,-40
22818570844,22818570851,7,1465,913,-40
22819428239,22819428245,6,3022,1177,-40
22821512247,22821512255,8,2702,50851,-40
22833973705,22833973711,6,2684,1300,-40
22836091765,22836091771,6,3264,1523,-40
22841028710,22841028717,7,3082,1193,-40
22841343957,22841343962,5,2692,1313,-40
22846475829,22846475835,6,4699,1697,-40
22847157185,22847157190,5,3143,1343,-40
22848271404,22848271411,7,3597,1366,-40
22853531522,22853531530,8,3313,1489,-40
22856740820,22856740825,5,3363,1826,-40
22857013784,22857013790,6,3128,1325,-40
22858584853,22858584860,7,3657,1330,-40
22862588254,22862588262,8,2300,1084,-40
22862777761,22862777767,6,3592,1795,-40
22865669890,22865669897,7,4197,1618,-40
22870338073,22870338079,6,2323,1227,-40
22875588857,22875588862,5,3518,1314,-40
22876022207,22876022214,7,2546,1351,-40
22876475370,22876475353,-17,1300,466,-40
22878095328,22878095333,5,3031,989,-40
22878980862,22878980866,4,2230,1322,-40
22879241298,22879241303,5,3792,1411,-40
22879784895,22879784901,6,3260,1192,-40
22880356713,22880356717,4,2401,833,-40
22885098278,22885098283,5,1855,1093,-40
22885357568,22885357555,-13,926,423,-40
22885392358,22885392361,3,5132,2912,-40
22885999982,22885999986,4,1679,968,-40
22888430285,22888430289,4,1991,1546,-40
22889997625,22889997632,7,2188,896,-40
22893073986,22893073990,4,2825,1173,-40
22894063056,22894063062,6,2828,1179,-40
22896691886,22896691891,5,3197,995,-40
22896904190,22896904195,5,3125,1276,-40
22898689590,22898689598,8,2907,1228,-40
22906117141,22906117146,5,3823,1061,-40
22908662521,22908662526,5,3073,1533,-40
22911564774,22911564779,5,2409,1178,-40
22912366966,22912366971,5,938,390,-40
22913208542,22913208546,4,1526,790,-40
22914081129,22914081113,-16,3041,1138,-40
22918077822,22918077830,8,2974,1320,-40
22918478831,22918478840,9,830,220,-40
22920334806,22920334813,7,3605,1098,-40
22921291005,22921291011,6,3563,923,-40
22928743633,22928743638,5,2504,996,-40
22931583114,22931583121,7,2067,1372,-40
22932883164,22932883169,5,2985,996,-40
22933545180,22933545163,-17,2448,813,-40
22934915780,22934915787,7,2721,1336,-40
22941137882,22941137890,8,3356,1347,-40
22941202967,22941202974,7,3175,1788,-40
22942822539,22942822546,7,2645,1384,-40
22947089501,22947089493,-8,5325,16740,-40
22948402789,22948402796,7,3497,1448,-40
22949001997,22949002003,6,2706,845,-40
22953321153,22953321157,4,2461,1391,-40
22959435549,22959435554,5,1494,1196,-40
22960615860,22960615866,6,2882,1464,-40
22961371954,22961371960,6,3468,1178,-40
22969731096,22969731106,10,1823,499,-40
22970381175,22970381181,6,3271,1556,-40
22977054939,22977054944,5,3565,1813,-40
22977710234,22977710242,8,2795,1107,-40
22979189409,22979189416,7,22,1440,-40
22983547193,22983547198,5,2787,1389,-40
22990731655,22990731662,7,1923,871,-40
22999804660,22999804666,6,3374,1398,-40
23002831020,23002831027,7,4002,1347,-40
23003130983,23003130990,7,1734,938,-40
23004943279,23004943286,7,3627,1261,-40
23009104835,23009104842,7,2706,1047,-40
23011606054,23011606057,3,1877,1196,-40
23012895769,23012895773,4,1167,615,-40
23015521797,23015521804,7,2607,984,-40
23017584234,23017584232,-2,2755,4163,-40
23018135519,23018135526,7,3581,1559,-40
23023655017,23023655023,6,2978,1592,-40
23024805563,23024805568,5,3380,1396,-40
23035186371,23035186377,6,1982,969,-40
23042900774,23042900781,7,2572,1087,-40
23047219081,23047219086,5,3397,1464,-40
23047769213,23047769218,5,2847,1210,-40
23048493607,23048493614,7,2619,1241,-40
23053897508,23053897514,6,3492,1018,-40
23058508690,23058508694,4,16551,12708,-40
23064417509,23064417511,2,1651,1663,-40
23064783634,23064783642,8,12141,36964,-40
23068692290,23068692291,1,1817,2277,-40
23071401898,23071401906,8,2141,882,-40
23073532590,23073532607,17,14960,52923,-40
23073586278,23073586284,6,1518,667,-40
23074352335,23074352341,6,2608,1299,-40
23081683196,23081683203,7,2944,1401,-40
23082521746,23082521740,-6,1264,3692,-40
23082876847,23082876855,8,3404,1658,-40
23088631661,23088631664,3,3607,3275,-40
23090239297,23090239303,6,2838,1038,-40
23091218528,23091218531,3,7113,22725,-40
23091497734,23091497740,6,2872,1333,-40
23092654041,23092654047,6,2046,1093,-40
23093596108,23093596115,7,2964,1411,-40
23093860285,23093860294,9,2845,1144,-40
23094180388,23094180393,5,1887,993,-40
23096212246,23096212254,8,3445,1067,-40
23097984395,23097984399,4,2294,1278,-40
23100773301,23100773306,5,1936,961,-40
23101681734,23101681740,6,2769,1242,-40
23105608235,23105608239,4,1981,1930,-40
23107301339,23107301346,7,2709,941,-40
23117386067,23117386075,8,2623,1235,-40
23119092629,23119092636,7,4126,1686,-40
23125609933,23125609939,6,2782,1318,-40
23130180415,23130180422,7,3547,1335,-40
23131289714,23131289720,6,3456,1398,-40
23134668962,23134668968,6,2199,1514,-40
23144205629,23144205634,5,1832,1333,-40
23144361880,23144361896,16,2813,1250,-40
23148742969,23148742975,6,2601,1343,-40
23152746534,23152746540,6,2114,1084,-40
23153381849,23153381858,9,4971,1610,-40
23156869050,23156869058,8,3773,1176,-40
23159583415,23159583422,7,2459,1171,-40
23172013638,23172013645,7,2902,1301,-40
23174986973,23174986979,6,2754,1114,-40
23180077451,23180077457,6,2933,1099,-40
23183559468,23183559475,7,2344,1084,-40
23186904740,23186904746,6,2561,942,-40
23187176326,23187176304,-22,1594,358,-40
23193724385,23193724391,6,3337,906,-40
23193889702,23193889721,19,3024,1047,-40
23194440674,23194440689,15,871,167,-40
23195604066,23195604075,9,2803,936,-40
23198107911,23198107919,8,2002,1110,-40
23200720108,23200720108,0,1119,1791,-40
23205589101,23205589106,5,3252,1443,-40
23207531497,23207531503,6,2757,1250,-40
23207670133,23207670139,6,2859,1039,-40
23214170409,23214170416,7,4392,1384,-40
23214895874,23214895876,2,1571,1510,-40
23217279517,23217279519,2,1815,1920,-40
23217375402,23217375400,-2,1295,1680,-40
23222868598,23222868605,7,3576,1312,-40
23224267209,23224267214,5,3626,1451,-40
23229640774,23229640777,3,1918,2403,-40
23232971397,23232971403,6,3836,1154,-40
23233314774,23233314779,5,2774,1057,-40
23235186089,23235186094,5,2254,1390,-40
23237173836,23237173841,5,2930,1158,-40
23238152671,23238152678,7,2692,1178,-40
23242184332,23242184338,6,2681,1183,-40
23242865113,23242865117,4,7400,20447,-40
23242984218,23242984222,4,2552,905,-40
23244973787,23244973792,5,3160,1245,-40
23245358969,23245358975,6,2934,1031,-40
23246859286,23246859292,6,2579,1148,-40
23247586475,23247586482,7,2402,1301,-40
23250919712,23250919719,7,3404,1104,-40
23253334422,23253334428,6,3365,2033,-40
23255002377,23255002382,5,2741,1229,-40
23258192230,23258192238,8,1890,934,-40
23259070527,23259070534,7,1431,858,-40
23261584157,23261584155,-2,1510,3358,-40
23266182999,23266183006,7,2911,1022,-40
23268792483,23268792489,6,2361,1307,-40
23269700931,23269700936,5,1985,1694,-40
23272027591,23272027598,7,1920,832,-40
23272812381,23272812387,6,1992,673,-40
23272963340,23272963320,-20,816,171,-40
23273116154,23273116161,7,2571,1048,-40
23274296198,23274296204,6,2535,1279,-40
23274335553,23274335538,-15,3218,813,-40
23274822838,23274822824,-14,852,474,-40
23278284745,23278284750,5,2154,1509,-40
23279869860,23279869866,6,3597,1483,-40
23283887064,23283887070,6,2868,1334,-40
23285106600,23285106603,3,1882,2174,-40
23286130685,23286130690,5,3008,1503,-40
23286196345,23286196349,4,2691,1656,-40
23287881871,23287881879,8,4155,1400,-40
23287967760,23287967765,5,2339,948,-40
23288379310,23288379318,8,2997,1239,-40
23289645685,23289645690,5,2678,1857,-40
23291332910,23291332916,6,2463,1372,-40
23291626270,23291626269,-1,843,1246,-40
23291989673,23291989675,2,2036,1095,-40
23294122065,23294122070,5,2121,1052,-40
23299319081,23299319086,5,3875,1799,-40
23299495994,23299496001,7,3128,772,-40
23302284422,23302284427,5,3308,1031,-40
23304268046,23304268053,7,3091,2044,-40
23306245144,23306245152,8,2381,1178,-40
23308106518,23308106526,8,3836,1296,-40
23309331082,23309331087,5,3241,1192,-40
23314323904,23314323910,6,3009,888,-40
23315923558,23315923565,7,2035,1224,-40
23320524880,23320524886,6,2636,1466,-40
23320912517,23320912523,6,1847,1005,-40
23322601175,23322601181,6,2580,1262,-40
23325979224,23325979230,6,1684,1067,-40
23326940192,23326940196,4,633,745,-40
23329522378,23329522383,5,2384,1472,-40
23342322170,23342322175,5,2797,1220,-40
23347381832,23347381838,6,2746,1458,-40
23350274490,23350274492,2,1143,1375,-40
23355275663,23355275670,7,2518,1046,-40
23356941586,23356941590,4,1518,1311,-40
23362789909,23362789913,4,2510,1387,-40
23368731629,23368731635,6,2553,1141,-40
23369920789,23369920795,6,3626,1650,-40
23371395300,23371395306,6,3508,1085,-40
23371840081,23371840098,17,599,231,-40
23374255610,23374255615,5,1706,672,-40
23375347117,23375347123,6,995,467,-40
23376997158,23376997163,5,1978,777,-40
23380004294,23380004302,8,2514,1349,-40
23386368866,23386368874,8,2610,1087,-40
23387245372,23387245378,6,3103,1158,-40
23389633867,23389633873,6,3154,1408,-40
23391802406,23391802411,5,2133,791,-40
23394305745,23394305753,8,2310,1285,-40
23398252117,23398252123,6,2402,848,-40
23401423731,23401423738,7,2645,1832,-40
23404574473,23404574466,-7,1371,4451,-40
23405306611,23405306618,7,1599,1083,-40
23405548534,23405548512,-22,2980,1090,-40
23405701044,23405701050,6,2681,1097,-40
23410845267,23410845262,-5,1225,1993,-40
23416310090,23416310096,6,2134,572,-40
23419242681,23419242686,5,2611,1158,-40
23420400155,23420400162,7,2861,999,-40
23420582963,23420582970,7,757,333,-40
23421915505,23421915511,6,2919,1275,-40
23423438370,23423438375,5,1822,1032,-40
23424023805,23424023810,5,2703,1505,-40
23426210358,23426210366,8,1891,1173,-40
23426794707,23426794691,-16,1513,814,-40
23432010257,23432010262,5,2983,893,-40
23435407873,23435407878,5,3380,1496,-40
23437037918,23437037922,4,3044,1450,-40
23439819742,23439819741,-1,1486,2372,-40
23439942459,23439942467,8,2583,1142,-40
23441230193,23441230200,7,3674,1236,-40
23442549525,23442549531,6,3681,1652,-40
23447551973,23447551978,5,2725,1178,-40
23449759179,23449759185,6,2452,1253,-40
23451307686,23451307690,4,2853,1641,-40
23451395138,23451395143,5,1663,879,-40
23453421411,23453421410,-1,1579,1874,-40
23456221862,23456221867,5,2324,1237,-40
23463412123,23463412129,6,2016,1071,-40
23466606638,23466606643,5,2929,1342,-40
23466660872,23466660860,-12,1608,234,-40
23466950453,23466950455,2,1563,1202,-40
23471262321,23471262325,4,3186,1484,-40
23476017622,23476017626,4,2400,1540,-40
23483556184,23483556190,6,2287,1034,-40
23483756835,23483756842,7,3192,1258,-40
23485023439,23485023447,8,2739,1178,-40
23486989594,23486989601,7,2833,1575,-40
23489160160,23489160166,6,2619,1337,-40
23494649591,23494649598,7,2606,1169,-40
23497574933,23497574939,6,2598,1446,-40
23497861468,23497861474,6,3385,1390,-40
23497950383,23497950385,2,2222,1547,-40
23498536115,23498536123,8,4945,1664,-40
23499028427,23499028423,-4,1727,2965,-40
23500197372,23500197377,5,2766,1291,-40
23502513005,23502513009,4,1783,1071,-40
23504087755,23504087759,4,3473,1657,-40
23505152658,23505152658,0,2176,2080,-40
23507314853,23507314858,5,2745,1163,-40
23510468857,23510468864,7,1669,1232,-40
23516329653,23516329661,8,2775,986,-40
23517335577,23517335571,-6,1036,188,-40
23518326572,23518326579,7,3539,1554,-40
23521850769,23521850765,-4,1022,2648,-40
23526796592,23526796598,6,2219,1028,-40
23527327206,23527327210,4,2891,1306,-40
23527704309,23527704314,5,5159,2439,-40
23529437877,23529437883,6,1846,876,-40
23530147787,23530147794,7,3024,1043,-40
23530267783,23530267771,-12,1275,534,-40
23534287100,23534287112,12,2765,1397,-40
23534347088,23534347093,5,2707,1129,-40
23541678717,23541678723,6,3110,1184,-40
23543332138,23543332142,4,3754,2351,-40
23548891466,23548891471,5,2263,1353,-40
23554280416,23554280422,6,2472,1249,-40
23554364978,23554364982,4,3589,1224,-40
23554730919,23554730906,-13,1796,708,-40
23556818353,23556818359,6,2766,928,-40
23557434455,23557434461,6,2925,1070,-40
23558083903,23558083908,5,4241,2202,-40
23572547139,23572547146,7,2776,1282,-40
23578168202,23578168209,7,3627,1879,-40
23581189222,23581189228,6,1374,765,-40
23581797631,23581797635,4,1041,613,-40
23585464994,23585465005,11,276,906,-40
23588828842,23588828847,5,2481,1213,-40
23589649093,23589649089,-4,1543,3630,-40
23596931386,23596931391,5,1888,836,-40
23599335487,23599335494,7,2650,1566,-40
23601950993,23601951000,7,1723,1056,-40
23606785021,23606785023,2,2089,1550,-40
23607535259,23607535265,6,2095,1111,-40
23608042478,23608042459,-19,1074,229,-40
23608157558,23608157564,6,2875,1512,-40
23609740833,23609740826,-7,1304,5235,-40
23613875278,23613875286,8,2212,841,-40
23614008614,23614008608,-6,1158,4890,-40
23614124077,23614124082,5,1400,839,-40
23614473798,23614473803,5,1325,608,-40
23615115672,23615115678,6,2143,1271,-40
23617341343,23617341350,7,3120,1586,-40
23618470548,23618470554,6,3330,1468,-40
23619243771,23619243778,7,2564,1430,-40
23622265895,23622265898,3,1880,1863,-40
23623389779,23623389783,4,2155,1593,-40
23626486353,23626486358,5,1569,1048,-40
23627792315,23627792321,6,1812,761,-40
23628764046,23628764052,6,3530,1896,-40
23630400154,23630400159,5,1953,1040,-40
23633430578,23633430584,6,2803,1153,-40
23634665814,23634665818,4,2770,792,-40
23639107958,23639107966,8,2653,1489,-40
23639703389,23639703397,8,2075,1290,-40
23640105822,23640105829,7,3595,1708,-40
23641964467,23641964474,7,2027,922,-40
23643349767,23643349772,5,2774,1215,-40
23649230919,23649230927,8,2791,795,-40
23649319795,23649319801,6,3206,1238,-40
23650931526,23650931533,7,3652,2066,-40
23651905601,23651905607,6,3259,1138,-40
23653970734,23653970740,6,2663,1064,-40
23654545125,23654545130,5,2211,767,-40
23655205700,23655205706,6,1834,1419,-40
23656442718,23656442723,5,2107,1211,-40
23659876445,23659876450,5,3479,1572,-40
23665397926,23665397931,5,2050,1480,-40
23667588518,23667588525,7,4374,1450,-40
23670214882,23670214889,7,3627,1666,-40
23676572766,23676572774,8,3006,1092,-40
23676962661,23676962666,5,1896,1102,-40
23679289200,23679289206,6,2342,1238,-40
23679771984,23679771982,-2,1072,2100,-40
23685672113,23685672121,8,1478,667,-40
23688279219,23688279220,1,1776,1967,-40
23688702228,23688702234,6,3043,1306,-40
23689158351,23689158358,7,3402,1670,-40
23689619098,23689619101,3,2176,2007,-40
23690717486,23690717480,-6,2090,6349,-40
23692859727,23692859731,4,1386,1219,-40
23695921426,23695921433,7,1699,925,-40
23697632820,23697632826,6,2732,1238,-40
23698137164,23698137170,6,2671,1114,-40
23702245054,23702245061,7,2534,1258,-40
23704898183,23704898178,-5,2116,9990,-40
23705062488,23705062495,7,1423,1302,-40
23708148730,23708148736,6,3434,1646,-40
23709048116,23709048121,5,2451,914,-40
23709948012,23709948018,6,3250,1188,-40
23711879378,23711879385,7,2605,1019,-40
23712577030,23712577037,7,2543,1585,-40
23713570050,23713570056,6,3023,1092,-40
23715247902,23715247907,5,4027,1298,-40
23715339470,23715339464,-6,1044,2711,-40
23715641475,23715641482,7,3850,1672,-40
23716612921,23716612927,6,2852,1390,-40
23718260506,23718260511,5,3757,1441,-40
23720684366,23720684374,8,2531,1293,-40
23722158986,23722158991,5,2461,1181,-40
23727525398,23727525406,8,3189,1588,-40
23734824282,23734824289,7,1659,1140,-40
23735302951,23735302957,6,2254,1000,-40
23742999685,23742999691,6,2976,1215,-40
23743834360,23743834366,6,4332,1319,-40
23748562821,23748562828,7,3220,1275,-40
23750122835,23750122839,4,2513,1201,-40
23752242377,23752242382,5,2806,1306,-40
23759630830,23759630835,5,3443,1362,-40
23762024699,23762024706,7,2592,950,-40
23764561762,23764561769,7,1943,890,-40
23764646627,23764646626,-1,1723,3448,-40
23765072378,23765072382,4,2619,1439,-40
23767908214,23767908215,1,2173,2779,-40
23773600134,23773600138,4,2319,1520,-40
23776500821,23776500826,5,2908,797,-40
23777376402,23777376418,16,774,151,-40
23787594121,23787594127,6,3132,1160,-40
23788343230,23788343237,7,2351,1119,-40
23789310848,23789310840,-8,1661,3871,-40
23794089690,23794089696,6,2637,1746,-40
23794729547,23794729553,6,4249,1423,-40
23805221031,23805221035,4,1511,1032,-40
23810619539,23810619546,7,2747,1569,-40
23814232720,23814232726,6,2566,1192,-40
23814715124,23814715131,7,2279,1204,-40
23817200606,23817200613,7,3259,1973,-40
23819587134,23819587139,5,2640,1044,-40
23821287356,23821287353,-3,1420,2681,-40
23823006055,23823006058,3,1465,1095,-40
23824215169,23824215175,6,2651,843,-40
23830384363,23830384369,6,3094,1361,-40
23833989795,23833989797,2,1208,1328,-40
23835268679,23835268685,6,2847,1189,-40
23836121305,23836121310,5,2846,1130,-40
23838596533,23838596538,5,3977,1694,-40
23842788931,23842788939,8,2506,1273,-40
23845592193,23845592198,5,2392,1122,-40
23846228970,23846228977,7,2571,657,-40
23847091968,23847091975,7,1486,1489,-40
23847221262,23847221270,8,2019,1062,-40
23849417082,23849417089,7,2961,1015,-40
23849585182,23849585163,-19,1188,767,-40
23851680338,23851680345,7,2836,1318,-40
23852036413,23852036435,22,3694,1839,-40
23852457423,23852457427,4,2518,1425,-40
23852492286,23852492294,8,4379,825,-40
23858502917,23858502922,5,4403,1851,-40
23861401596,23861401601,5,4343,1523,-40
23862746056,23862746062,6,3120,1151,-40
23863212641,23863212656,15,845,2875,-40
23867401870,23867401877,7,5451,2361,-40
23869240501,23869240506,5,2732,1221,-40
23870196182,23870196178,-4,2181,5099,-40
23872146718,23872146725,7,2165,1243,-40
23877308101,23877308106,5,3496,1106,-40
23877638937,23877638933,-4,1157,4941,-40
23879474686,23879474686,0,1355,1729,-40
23880554662,23880554669,7,6536,2810,-40
23881244433,23881244439,6,2404,978,-40
23884596283,23884596290,7,1652,641,-40
23891614064,23891614069,5,3220,1311,-40
23896142465,23896142461,-4,109,2117,-40
23900932171,23900932177,6,2337,1116,-40
23902320487,23902320494,7,2175,1085,-40
23905274246,23905274248,2,1803,2070,-40
23906073002,23906073008,6,2629,1485,-40
23911257818,23911257825,7,1434,1178,-40
23914373358,23914373364,6,3287,1274,-40
23914404916,23914404922,6,2974,1290,-40
23914640035,23914640042,7,3988,1591,-40
23920611810,23920611817,7,2580,1239,-40
23924989813,23924989818,5,1939,834,-40
23935023087,23935023093,6,3907,1156,-40
23939552446,23939552449,3,1390,1215,-40
23944787842,23944787849,7,3023,918,-40
23948432262,23948432267,5,2623,1130,-40
23955834863,23955834857,-6,886,3864,-40
23956761153,23956761149,-4,25497,45384,-40
23956871419,23956871425,6,3018,1494,-40
23957898595,23957898603,8,979,1015,-40
23958348262,23958348259,-3,956,1377,-40
23960272064,23960272072,8,3267,1544,-40
23960710965,23960710970,5,3118,1088,-40
23961006497,23961006480,-17,1103,317,-40
23961548307,23961548313,6,3286,1666,-40
23964147056,23964147062,6,3405,1031,-40
23966585603,23966585610,7,4128,1829,-40
23971940697,23971940702,5,1851,837,-40
23973628727,23973628731,4,1019,618,-40
23975511830,23975511838,8,2542,1234,-40
23978772341,23978772346,5,2896,1206,-40
23980210932,23980210938,6,1885,1012,-40
23984361805,23984361812,7,3529,1435,-40
23986615629,23986615635,6,2610,1190,-40
23987045034,23987045042,8,2017,1223,-40
23992099409,23992099417,8,3071,1427,-40
23993474535,23993474542,7,2903,1374,-40
23999152808,23999152814,6,2516,895,-40
23999557399,23999557405,6,2617,923,-40
24000063402,24000063406,4,1977,1004,-40
24001212413,24001212417,4,1870,2207,-40
24003443741,24003443746,5,2594,1099,-40
24006379522,24006379529,7,2837,1012,-40
24008108570,24008108579,9,3049,46964,-40
24019019434,24019019440,6,2614,1191,-40
24019106459,24019106442,-17,963,289,-40
24021756446,24021756445,-1,13394,18697,-40
24026097592,24026097589,-3,1024,1279,-40
24026894760,24026894766,6,2668,1208,-40
24028258447,24028258449,2,2163,2047,-40
24028856760,24028856766,6,2871,1182,-40
24030495966,24030495971,5,3131,1696,-40
24031311954,24031311958,4,2844,1088,-40
24032894526,24032894522,-4,2323,6148,-40
24034474042,24034474038,-4,237,1001,-40
24037052662,24037052668,6,2426,924,-40
24040870784,24040870791,7,4415,1372,-40
24041442561,24041442567,6,2958,1233,-40
24044013245,24044013249,4,2467,1209,-40
24050732377,24050732383,6,2728,992,-40
24051049906,24051049912,6,3662,1257,-40
24053675818,24053675825,7,1614,692,-40
24054833136,24054833141,5,1904,1396,-40
24056739698,24056739704,6,2707,925,-40
24058777414,24058777424,10,3927,1038,-40
24074068450,24074068459,9,2305,607,-40
24085642913,24085642918,5,3336,1542,-40
24088851880,24088851887,7,3047,1865,-40
24089503855,24089503859,4,2884,1193,-40
24090101143,24090101151,8,6204,1444,-40
24090451949,24090451944,-5,1138,2281,-40
24090577533,24090577523,-10,38292,16048,-40
24091074994,24091075001,7,3484,1384,-40
24091780581,24091780589,8,2736,1216,-40
24093837327,24093837326,-1,1192,1978,-40
24097455538,24097455538,0,2897,2082,-40
24101797090,24101797097,7,2404,804,-40
24104139353,24104139356,3,1933,1933,-40
24107233661,24107233667,6,3165,1460,-40
24107966590,24107966599,9,4071,1440,-40
24109508056,24109508061,5,3207,1154,-40
24113202609,24113202615,6,1598,1331,-40
24120316478,24120316485,7,3338,1518,-40
24121442442,24121442447,5,3355,1073,-40
24123868879,24123868886,7,2035,1265,-40
24127798534,24127798538,4,2779,1607,-40
24127925767,24127925774,7,2736,1110,-40
24128794105,24128794112,7,2484,1137,-40
24131213796,24131213789,-7,1293,5804,-40
24132605804,24132605810,6,2711,913,-40
24136245909,24136245915,6,1745,1151,-40
24137380522,24137380514,-8,745,57,-40
24138867338,24138867337,-1,2624,4028,-40
24141618178,24141618185,7,2929,1176,-40
24144618249,24144618254,5,1685,994,-40
24145315742,24145315749,7,3046,1456,-40
24145682885,24145682876,-9,3166,770,-40
24146397453,24146397460,7,3234,1302,-40
24146553403,24146553388,-15,2602,760,-40
24150174874,24150174881,7,2432,944,-40
24151518062,24151518065,3,2111,1550,-40
24155439946,24155439952,6,2343,1245,-40
24155748413,24155748418,5,2742,1145,-40
24157248016,24157248022,6,2130,1366,-40
24158506106,24158506112,6,2754,1313,-40
24162456744,24162456750,6,2023,1168,-40
24165195598,24165195601,3,1783,1240,-40
24165777438,24165777438,0,798,1364,-40
24166492097,24166492093,-4,23477,53563,-40
24166594646,24166594651,5,2949,1867,-40
24168551108,24168551114,6,3250,1387,-40
24173357662,24173357663,1,1755,1822,-40
24173979314,24173979319,5,3152,1215,-40
24176918695,24176918702,7,2623,1341,-40
24180290549,24180290556,7,2723,973,-40
24181035061,24181035068,7,2478,1293,-40
24182690884,24182690889,5,2525,1050,-40
24190884673,24190884681,8,2650,1428,-40
24191153935,24191153941,6,2962,1622,-40
24194105757,24194105763,6,2788,1011,-40
24194384623,24194384631,8,2812,1258,-40
24197565641,24197565649,8,1929,976,-40
24198228595,24198228602,7,3752,1400,-40
24201465773,24201465779,6,2149,1693,-40
24202809537,24202809542,5,3061,1735,-40
24204660366,24204660375,9,2605,1374,-40
24207315631,24207315639,8,2479,1019,-40
24210657042,24210657043,1,858,1119,-40
24215146510,24215146517,7,2071,1217,-40
24216336048,24216336055,7,1805,736,-40
24216905950,24216905955,5,2601,1237,-40
24220971666,24220971673,7,4345,1029,-40
24231120348,24231120355,7,2675,868,-40
24239147751,24239147759,8,4088,1366,-40
24241798715,24241798719,4,2608,1373,-40
24243031690,24243031698,8,3418,1647,-40
24245821637,24245821643,6,3140,1190,-40
24247060136,24247060141,5,2504,1283,-40
24247644036,24247644042,6,2618,1362,-40
24248270491,24248270497,6,3075,1512,-40
24249375750,24249375768,18,2342,984,-40
24251924898,24251924905,7,2814,1162,-40
24253589038,24253589045,7,3159,1387,-40
24254835721,24254835727,6,2778,1129,-40
24263748394,24263748384,-10,920,227,-40
24264782037,24264782041,4,2688,1287,-40
24266029282,24266029289,7,3152,1003,-40
24266972391,24266972370,-21,1844,778,-40
24267377679,24267377684,5,2791,1446,-40
24268606097,24268606103,6,1876,1040,-40
24269934105,24269934110,5,1493,469,-40
24271114110,24271114117,7,1136,552,-40
24271384293,24271384283,-10,584,296,-40
24275402973,24275402979,6,1785,1275,-40
24276624286,24276624286,0,945,1385,-40
24277324525,24277324531,6,2624,1245,-40
24282365523,24282365526,3,756,426,-40
24283042985,24283042986,1,1714,1620,-40
24283139284,24283139290,6,2013,1088,-40
24284876429,24284876422,-7,974,3190,-40
24285019352,24285019360,8,1479,430,-40
24286010316,24286010322,6,3343,1403,-40
24289468422,24289468429,7,2862,1233,-40
24293141274,24293141279,5,2022,1463,-40
24294655604,24294655610,6,3319,1094,-40
24294972591,24294972598,7,2725,1617,-40
24295236361,24295236369,8,2605,1105,-40
24297524900,24297524906,6,3566,1374,-40
24298902426,24298902433,7,2593,1170,-40
24303238193,24303238198,5,1602,724,-40
24307282665,24307282671,6,1432,819,-40
24307735844,24307735851,7,3545,995,-40
24308415308,24308415314,6,1513,704,-40
24308493282,24308493290,8,1720,867,-40
24308984095,24308984102,7,1670,1124,-40
24309791981,24309791986,5,2633,1065,-40
24312641754,24312641762,8,3661,1019,-40
24314663357,24314663363,6,4118,1315,-40
24315134450,24315134458,8,2045,1494,-40
24315376640,24315376645,5,2455,854,-40
24319472701,24319472707,6,3270,1498,-40
24324967393,24324967399,6,3644,1770,-40
24330674821,24330674827,6,3061,907,-40
24336405372,24336405378,6,2798,1263,-40
24337590690,24337590696,6,2073,1056,-40
24337711543,24337711540,-3,763,276,-40
24339985517,24339985523,6,1654,938,-40
24340413054,24340413032,-22,892,322,-40
24344071001,24344071008,7,2549,896,-40
24345988146,24345988153,7,3538,1620,-40
24347577711,24347577718,7,3673,1307,-40
24349963446,24349963451,5,2359,878,-40
24350617538,24350617545,7,2075,903,-40
24357487962,24357487969,7,2451,1048,-40
24357873644,24357873626,-18,1110,1336,-40
24358275377,24358275382,5,2828,862,-40
24360187378,24360187383,5,1181,1383,-40
24373530198,24373530205,7,2112,913,-40
24376300016,24376300020,4,2416,1409,-40
24388204266,24388204271,5,3572,1569,-40
24392513831,24392513828,-3,1887,3974,-40
24392846226,24392846222,-4,1522,3457,-40
24393313390,24393313391,1,1227,1181,-40
24398754605,24398754610,5,3206,917,-40
24402074482,24402074489,7,3390,1937,-40
24403166642,24403166647,5,2242,1067,-40
24406938097,24406938104,7,3247,1302,-40
24406965054,24406965062,8,2802,1242,-40
24407336828,24407336835,7,2712,1396,-40
24414828210,24414828214,4,1999,1342,-40
24415678967,24415678970,3,1678,1144,-40
24421475105,24421475112,7,2659,1571,-40
24427307861,24427307868,7,3287,1418,-40
24430201907,24430201914,7,3374,1772,-40
24430839550,24430839555,5,1765,1040,-40
24432496442,24432496449,7,1990,792,-40
24435355901,24435355907,6,2515,1201,-40
24435622237,24435622243,6,2677,1204,-40
24440630897,24440630904,7,3502,917,-40
24441428562,24441428567,5,1463,1305,-40
24441734654,24441734639,-15,1203,325,-40
24444366425,24444366431,6,2224,1313,-40
24446416762,24446416767,5,3235,1396,-40
24446816016,24446816022,6,2928,1212,-40
24447038149,24447038154,5,2344,1095,-40
24448798482,24448798490,8,3060,1375,-40
24450495458,24450495462,4,3510,1720,-40
24456309253,24456309259,6,2608,1059,-40
24457916869,24457916875,6,2911,1396,-40
24458545533,24458545539,6,2945,1216,-40
24464579757,24464579762,5,3021,1239,-40
24470079134,24470079134,0,1068,1856,-40
24475095243,24475095249,6,2798,1753,-40
24475263402,24475263407,5,3370,1919,-40
24486357376,24486357381,5,2144,1499,-40
24487951651,24487951658,7,3240,1076,-40
24489521744,24489521750,6,2565,1035,-40
24493595166,24493595170,4,2172,1399,-40
24504001601,24504001602,1,30093,18988,-40
24504126394,24504126400,6,1707,1222,-40
24507797191,24507797197,6,3282,1599,-40
24517958494,24517958497,3,1657,1499,-40
24519280514,24519280519,5,4298,1553,-40
24524567106,24524567112,6,2424,987,-40
24525074111,24525074117,6,3157,1259,-40
24529352627,24529352631,4,1976,958,-40
24529705360,24529705355,-5,733,76,-40
24535665869,24535665875,6,2630,1394,-40
24539301426,24539301433,7,2808,1393,-40
24542547801,24542547807,6,2409,1078,-40
24542725758,24542725767,9,2783,1039,-40
24548705518,24548705522,4,2726,1231,-40
24551582289,24551582295,6,3706,1358,-40
24552761186,24552761193,7,3431,1697,-40
24554330369,24554330376,7,1309,428,-40
24555681881,24555681886,5,2833,1120,-40
24557444789,24557444796,7,2318,1016,-40
24557502101,24557502080,-21,1264,600,-40
24557609405,24557609412,7,6127,2508,-40
24557758006,24557758010,4,3151,1091,-40
24558865648,24558865659,11,13992,24334,-40
24560212222,24560212229,7,2783,1016,-40
24560823002,24560823008,6,2656,1286,-40
24563405696,24563405701,5,2928,1634,-40
24564019673,24564019689,16,874,178,-40
24564809637,24564809643,6,4135,2013,-40
24573065930,24573065937,7,2978,1474,-40
24573521750,24573521769,19,947,235,-40
24579483290,24579483296,6,3605,1586,-40
24584127098,24584127105,7,3161,1127,-40
24585466497,24585466504,7,2100,1211,-40
24587014036,24587014051,15,3308,1524,-40
24590106417,24590106425,8,2806,1152,-40
24592272897,24592272903,6,2671,1036,-40
24593741734,24593741739,5,3502,1283,-40
24596566423,24596566431,8,3055,1408,-40
24596912254,24596912240,-14,938,405,-40
24598568128,24598568134,6,3650,1667,-40
24602282084,24602282090,6,3663,1335,-40
24603536675,24603536678,3,8334,19313,-40
24608050442,24608050450,8,2454,1214,-40
24617486953,24617486958,5,1945,1210,-40
24619345746,24619345745,-1,1536,507,-40
24621338243,24621338249,6,1650,1203,-40
24623368643,24623368645,2,2270,1569,-40
24623915185,24623915191,6,2022,1223,-40
24624812051,24624812058,7,3452,1133,-40
24629242850,24629242845,-5,1022,2365,-40
24636151936,24636151942,6,2441,1211,-40
24640752788,24640752795,7,3600,1327,-40
24640857644,24640857653,9,379,1436,-40
24642523902,24642523907,5,2258,885,-40
24642836523,24642836506,-17,1132,113,-40
24644143418,24644143423,5,2970,975,-40
24644392485,24644392490,5,3578,1786,-40
24647098495,24647098501,6,4327,1584,-40
24648023417,24648023421,4,3084,1223,-40
24648142882,24648142866,-16,1863,576,-40
24649915810,24649915818,8,1407,493,-40
24658759819,24658759818,-1,953,2004,-40
24662489154,24662489159,5,2391,1150,-40
24662747764,24662747767,3,2597,1014,-40
24664576704,24664576709,5,2404,1633,-40
24665477713,24665477718,5,2698,1244,-40
24666997659,24666997663,4,1844,1433,-40
24667262876,24667262877,1,2554,2014,-40
24670974318,24670974326,8,3795,1549,-40
24676048275,24676048281,6,2051,1069,-40
24676233855,24676233855,0,2329,2986,-40
24679084443,24679084451,8,3258,1008,-40
24682377070,24682377077,7,2666,1168,-40
24685679482,24685679487,5,2443,1243,-40
24689754955,24689754959,4,2728,2233,-40
24690634549,24690634554,5,2868,1412,-40
24693312117,24693312123,6,2723,1190,-40
24694361607,24694361608,1,3259,3617,-40
24700327005,24700327009,4,2870,1334,-40
24703663479,24703663485,6,2262,1233,-40
24704893161,24704893168,7,1545,906,-40
24706868172,24706868180,8,2421,1176,-40
24710655665,24710655671,6,3827,1419,-40
24715221742,24715221750,8,3340,935,-40
24715627234,24715627242,8,2832,1267,-40
24717621878,24717621882,4,1872,1250,-40
24718472450,24718472454,4,2868,1653,-40
24721830982,24721830990,8,2796,1484,-40
24727550922,24727550929,7,4055,1774,-40
24727639197,24727639201,4,3165,1728,-40
24727921546,24727921552,6,2111,1696,-40
24727974728,24727974715,-13,2199,824,-40
24730652472,24730652479,7,3886,1550,-40
24731763141,24731763146,5,2898,1460,-40
24732411279,24732411285,6,3344,1593,-40
24733651299,24733651302,3,2213,968,-40
24739928445,24739928450,5,1833,765,-40
24741237474,24741237479,5,1961,1181,-40
24747839682,24747839687,5,1754,951,-40
24748343954,24748343957,3,3296,1904,-40
24748437284,24748437290,6,2841,1509,-40
24748651196,24748651202,6,3192,1150,-40
24749114577,24749114583,6,1729,858,-40
24749985607,24749985614,7,2269,1024,-40
24756718270,24756718266,-4,1169,3115,-40
24760780701,24760780707,6,4088,2087,-40
24762186490,24762186488,-2,1982,3139,-40
24770525517,24770525518,1,3249,3001,-40
24783039320,24783039325,5,3006,1077,-40
24783498213,24783498218,5,3794,1289,-40
24784858893,24784858898,5,3150,1363,-40
24787262833,24787262837,4,2102,1328,-40
24796130848,24796130855,7,3613,1309,-40
24796929798,24796929785,-13,1486,304,-40
24797189309,24797189314,5,3201,1489,-40
24797725398,24797725406,8,3598,1451,-40
24802492399,24802492397,-2,888,1674,-40
24812522813,24812522803,-10,1760,30652,-40
24815052138,24815052142,4,2661,1139,-40
24815665653,24815665658,5,3145,1144,-40
24816051609,24816051615,6,2033,1245,-40
24816447470,24816447473,3,3011,2114,-40
24820243254,24820243260,6,3360,1339,-40
24820645342,24820645330,-12,1692,902,-40
24822377371,24822377375,4,1928,944,-40
24822592660,24822592666,6,2287,868,-40
24824033421,24824033423,2,3500,2931,-40
24828251245,24828251250,5,1600,779,-40
24830693534,24830693542,8,3490,1216,-40
24831387331,24831387338,7,3344,1204,-40
24832090706,24832090707,1,670,142,-40
24835571676,24835571683,7,3759,1076,-40
24837543358,24837543360,2,1743,1350,-40
24839530761,24839530766,5,3068,1297,-40
24839886780,24839886787,7,1824,720,-40
24840650860,24840650866,6,2703,1236,-40
24850120303,24850120298,-5,685,2375,-40
24857180665,24857180671,6,2379,1109,-40
24860836990,24860836994,4,2594,1318,-40
24861101906,24861101913,7,3647,1445,-40
24863445999,24863446005,6,3006,1183,-40
24867213162,24867213180,18,912,64,-40
24869131405,24869131411,6,3381,1463,-40
24870029001,24870029007,6,2637,991,-40
24870152115,24870152097,-18,3252,1161,-40
24877442641,24877442647,6,2038,1107,-40
24877535272,24877535260,-12,2677,1198,-40
24878625694,24878625700,6,3333,1690,-40
24881543552,24881543539,-13,2106,1056,-40
24881787866,24881787875,9,3414,1290,-40
24882329188,24882329193,5,2061,1201,-40
24883361857,24883361863,6,2405,1111,-40
24883761567,24883761573,6,2687,1068,-40
24884929629,24884929635,6,2861,1288,-40
24884984732,24884984729,-3,1738,3554,-40
24885329032,24885329038,6,3029,1364,-40
24886025586,24886025591,5,2283,1181,-40
24886720786,24886720790,4,1783,1222,-40
24887459325,24887459331,6,2652,1188,-40
24893393885,24893393891,6,2863,908,-40
24894949017,24894949023,6,2751,1585,-40
24896404149,24896404154,5,2849,1417,-40
24898620896,24898620904,8,3746,1074,-40
24902369365,24902369371,6,2293,1149,-40
24905155818,24905155824,6,3705,1459,-40
24906530538,24906530545,7,3436,1173,-40
24914428440,24914428445,5,2578,1297,-40
24915674011,24915674017,6,1456,912,-40
24916524602,24916524608,6,2440,1197,-40
24916706897,24916706889,-8,1070,221,-40
24919158942,24919158951,9,1992,1002,-40
24922932599,24922932607,8,2639,1337,-40
24924434155,24924434161,6,3167,1207,-40
24924628124,24924628105,-19,1601,635,-40
24929722643,24929722650,7,3568,1328,-40
24931722491,24931722498,7,3205,1200,-40
24932351640,24932351646,6,3109,1411,-40
24939557945,24939557950,5,3024,1006,-40
24947466182,24947466187,5,3097,1117,-40
24948211698,24948211702,4,1593,1326,-40
24949543058,24949543064,6,3076,1163,-40
24956326135,24956326140,5,2318,1191,-40
24957809710,24957809715,5,3618,1728,-40
24958915279,24958915286,7,1811,1178,-40
24959190478,24959190491,13,3308,1306,-40
24960642609,24960642613,4,4253,2284,-40
24960826636,24960826641,5,2970,1055,-40
24962056595,24962056603,8,13979,9463,-40
24962448507,24962448511,4,2325,1265,-40
24978383822,24978383828,6,3105,1428,-40
24978452190,24978452194,4,2844,986,-40
24979586925,24979586929,4,6941,28103,-40
24981151226,24981151234,8,2598,1164,-40
24985072894,24985072899,5,1934,661,-40
24989500315,24989500319,4,2818,2622,-40
24990192178,24990192180,2,2009,1407,-40
24990913038,24990913047,9,2924,1196,-40
24991565818,24991565826,8,1213,809,-40
24992966599,24992966606,7,3294,1370,-40
24993129530,24993129538,8,2288,860,-40
24993401848,24993401850,2,2382,1267,-40
24998501806,24998501812,6,3034,1247,-40
24999226659,24999226671,12,11967,22550,-40
25001649167,25001649175,8,2648,985,-40
25002143878,25002143884,6,4186,1484,-40
25004191291,25004191297,6,1820,1450,-40
25005499433,25005499439,6,3318,1233,-40
25010366348,25010366354,6,2711,1231,-40
25010591836,25010591840,4,2393,1924,-40
25012580669,25012580674,5,3689,1570,-40
25012914430,25012914439,9,2511,1162,-40
25015299481,25015299488,7,3510,1252,-40
25018387934,25018387939,5,2340,1088,-40
25019181483,25019181497,14,790,452,-40
25019771334,25019771323,-11,1111,481,-40
25025907898,25025907902,4,2959,1222,-40
25026440807,25026440812,5,2864,1340,-40
25026747924,25026747938,14,3150,1424,-40
25033780685,25033780690,5,2963,1310,-40
25038246070,25038246077,7,2779,1105,-40
25039742776,25039742785,9,1978,1006,-40
25041751221,25041751225,4,3540,1554,-40
25044596256,25044596261,5,3113,1702,-40
25044926494,25044926499,5,2818,1597,-40
25045708292,25045708297,5,1516,995,-40
25049033444,25049033450,6,3378,1158,-40
25049616679,25049616684,5,2627,1460,-40
25051651887,25051651896,9,15037,30160,-40
25053691387,25053691393,6,3566,1126,-40
25057710507,25057710514,7,2418,766,-40
25058770634,25058770638,4,2322,1117,-40
25067115638,25067115643,5,1310,951,-40
25068270464,25068270469,5,3235,1519,-40
25068628249,25068628235,-14,2347,1310,-40
25070467670,25070467676,6,3180,1227,-40
25071646490,25071646495,5,2464,1407,-40
25073686262,25073686266,4,2588,1586,-40
25077508170,25077508192,22,643,166,-40
25081449915,25081449919,4,4304,3030,-40
25087804105,25087804113,8,14623,12974,-40
25090554945,25090554946,1,1508,1624,-40
25091795487,25091795494,7,3866,1653,-40
25093053530,25093053536,6,3227,1158,-40
25093183086,25093183068,-18,2335,991,-40
25102780363,25102780363,0,1092,1144,-40
25107944250,25107944246,-4,593,2654,-40
25112183227,25112183234,7,3009,1291,-40
25113070003,25113070009,6,2993,1060,-40
25117904947,25117904949,2,1727,1833,-40
25119872750,25119872749,-1,2756,4379,-40
25125641126,25125641132,6,3647,1516,-40
25125685298,25125685313,15,3382,1215,-40
25127909435,25127909433,-2,1567,1898,-40
25129834069,25129834075,6,1856,1380,-40
25132431577,25132431583,6,2929,926,-40
25135721798,25135721802,4,1927,1204,-40
25138097658,25138097662,4,1831,1131,-40
25140732710,25140732714,4,1293,681,-40
25143764449,25143764455,6,4360,1631,-40
25143819591,25143819580,-11,485,321,-40
25144929018,25144929025,7,2689,1195,-40
25150453466,25150453474,8,2441,1036,-40
25151099082,25151099079,-3,1647,3200,-40
25155634820,25155634825,5,2594,906,-40
25156356538,25156356545,7,3294,1210,-40
25159121912,25159121917,5,7228,27186,-40
25162987220,25162987228,8,2123,893,-40
25167172154,25167172161,7,3757,1394,-40
25169893006,25169893012,6,2798,1507,-40
25171662898,25171662900,2,2456,283,-40
25173632170,25173632154,-16,3416,1627,-40
25175592271,25175592275,4,1452,1233,-40
25177137762,25177137766,4,831,823,-40
25178285718,25178285723,5,2412,1388,-40
25180509895,25180509902,7,2459,1531,-40
25180721241,25180721247,6,3622,1396,-40
25183312270,25183312276,6,2236,1010,-40
25185592030,25185592036,6,3418,1030,-40
25187811622,25187811627,5,4110,1828,-40
25194603658,25194603663,5,3759,1440,-40
25204683810,25204683813,3,2708,47278,-40
25204750240,25204750245,5,1927,1254,-40
25206090421,25206090427,6,3011,1013,-40
25210166166,25210166173,7,3617,1762,-40
25214529347,25214529353,6,2684,845,-40
25215047537,25215047543,6,2152,967,-40
25215105937,25215105943,6,1675,1072,-40
25218475913,25218475918,5,2124,1163,-40
25218508064,25218508051,-13,1502,360,-40
25223632892,25223632897,5,3649,1350,-40
25225556063,25225556071,8,2587,1141,-40
25226312294,25226312282,-12,3653,1427,-40
25230872342,25230872344,2,12993,14661,-40
25233065761,25233065769,8,2954,1636,-40
25237606378,25237606386,8,4023,1480,-40
25239013966,25239013971,5,2988,1078,-40
25239190354,25239190362,8,3454,1419,-40
25240116836,25240116843,7,4493,2230,-40
25244670168,25244670174,6,2917,1138,-40
25246343859,25246343866,7,4012,1409,-40
25249813513,25249813518,5,3176,1195,-40
25249987811,25249987818,7,2625,1129,-40
25251398927,25251398933,6,2928,1081,-40
25253023493,25253023499,6,2452,769,-40
25254647595,25254647602,7,1928,1132,-40
25254754322,25254754330,8,2524,1052,-40
25260792614,25260792620,6,3027,1195,-40
25262477506,25262477513,7,2775,1359,-40
25263936582,25263936588,6,2652,1710,-40
25265503750,25265503757,7,1691,773,-40
25270834258,25270834265,7,4670,1175,-40
25272309165,25272309166,1,1968,2363,-40
25273290106,25273290107,1,1184,1483,-40
25274601959,25274601966,7,3158,1221,-40
25276037447,25276037427,-20,1096,1085,-40
25276798498,25276798498,0,1423,1834,-40
25277678605,25277678626,21,3225,1171,-40
25277772405,25277772392,-13,1786,578,-40
25277897345,25277897350,5,3217,1153,-40
25278020380,25278020387,7,2595,1295,-40
25278226914,25278226922,8,3205,1069,-40
25281739515,25281739522,7,4470,1498,-40
25283763034,25283763041,7,3033,871,-40
25288231250,25288231254,4,2765,1317,-40
25296106242,25296106238,-4,891,3881,-40
25299108051,25299108058,7,3455,1546,-40
25299455232,25299455216,-16,2302,740,-40
25301391445,25301391450,5,1898,1584,-40
25302703010,25302703018,8,3057,1297,-40
25303078871,25303078865,-6,1118,3700,-40
25305718817,25305718823,6,2394,995,-40
25310000174,25310000179,5,2438,1247,-40
25312393959,25312393962,3,1499,1174,-40
25317841177,25317841183,6,2107,1008,-40
25318280430,25318280450,20,876,360,-40
25320842916,25320842900,-16,951,233,-40
25323469567,25323469574,7,3441,1632,-40
25324325694,25324325674,-20,2911,1123,-40
25325870154,25325870158,4,2585,1348,-40
25326245020,25326245022,2,2188,1713,-40
25326972126,25326972133,7,3389,1104,-40
25327313306,25327313290,-16,3355,1547,-40
25329751575,25329751583,8,1360,1326,-40
25331984896,25331984896,0,2016,1644,-40
25333670978,25333670983,5,3516,1356,-40
25338121174,25338121180,6,2056,1136,-40
25338291102,25338291102,0,1880,2420,-40
25340360386,25340360393,7,3801,2076,-40
25341958802,25341958808,6,3123,902,-40
25342087629,25342087633,4,2234,1957,-40
25342470386,25342470386,0,1780,1860,-40
25346149593,25346149599,6,1689,1378,-40
25349494109,25349494114,5,2767,1252,-40
25353522106,25353522113,7,2289,1485,-40
25354129444,25354129434,-10,1386,563,-40
25354731123,25354731118,-5,1249,4567,-40
25359448037,25359448043,6,3141,1110,-40
25360796723,25360796729,6,2738,1195,-40
25361022565,25361022545,-20,2268,724,-40
25361972177,25361972174,-3,1496,2740,-40
25363528504,25363528507,3,1781,1615,-40
25364778938,25364778945,7,3368,1725,-40
25365290117,25365290123,6,2876,1385,-40
25365332267,25365332265,-2,1871,3376,-40
25366595334,25366595339,5,2908,1308,-40
25366863202,25366863207,5,2812,1133,-40
25367514837,25367514843,6,3042,1559,-40
25368164410,25368164403,-7,1217,6407,-40
25368441867,25368441874,7,3638,1706,-40
25368595386,25368595400,14,820,41,-40
25368790199,25368790194,-5,27085,15531,-40
25380211433,25380211439,6,2531,1142,-40
25380627871,25380627859,-12,2491,1090,-40
25389427686,25389427694,8,1729,948,-40
25390291388,25390291394,6,2042,1396,-40
25392934807,25392934813,6,3730,1773,-40
25393393201,25393393207,6,2954,1378,-40
25395001358,25395001362,4,3170,1275,-40
25395686148,25395686155,7,3362,1778,-40
25395823707,25395823701,-6,1095,4076,-40
25397029292,25397029297,5,2840,1561,-40
25399508821,25399508829,8,3181,1513,-40
25402566890,25402566894,4,3253,1125,-40
25412167971,25412167975,4,2005,1085,-40
25415606570,25415606578,8,5832,1772,-40
25422902748,25422902754,6,1694,1439,-40
25426993749,25426993755,6,4055,1915,-40
25427043247,25427043254,7,2352,977,-40
25430821725,25430821732,7,3046,1740,-40
25431310783,25431310789,6,2691,799,-40
25440105752,25440105758,6,1686,1664,-40
25440963205,25440963211,6,2672,1415,-40
25444472459,25444472458,-1,1022,1580,-40
25447574539,25447574547,8,3094,1420,-40
25449190210,25449190216,6,3492,1599,-40
25453000010,25453000017,7,2791,1158,-40
25453292827,25453292833,6,2599,1555,-40
25453577772,25453577770,-2,965,1983,-40
25456845696,25456845702,6,2083,1058,-40
25458691297,25458691303,6,2882,955,-40
25459283757,25459283739,-18,1687,911,-40
25460194551,25460194528,-23,2705,1273,-40
25462873133,25462873138,5,1955,1096,-40
25466464933,25466464939,6,1296,876,-40
25468687601,25468687613,12,585,3739,-40
25471125253,25471125257,4,2352,1600,-40
25471880652,25471880657,5,2540,1450,-40
25472877286,25472877292,6,3163,926,-40
25473807245,25473807251,6,2540,1275,-40
25474875835,25474875830,-5,831,1682,-40
25475464093,25475464097,4,2619,1334,-40
25476998950,25476998956,6,2513,1748,-40
25479448288,25479448294,6,3795,1733,-40
25482624465,25482624472,7,2545,1292,-40
25482743074,25482743056,-18,1935,372,-40
25488312186,25488312191,5,2322,1633,-40
25489948411,25489948418,7,2381,999,-40
25494473578,25494473578,0,8791,12870,-40
25495155157,25495155164,7,2662,1314,-40
25499076026,25499076030,4,3273,1778,-40
25499104030,25499104034,4,1389,372,-40
25499356259,25499356267,8,3318,1278,-40
25505215694,25505215701,7,2989,1516,-40
25506811719,25506811726,7,4424,1505,-40
25508143460,25508143466,6,2858,1074,-40
25508946733,25508946739,6,3561,1825,-40
25510586565,25510586569,4,2234,1671,-40
25510966092,25510966089,-3,939,2650,-40
25511644810,25511644817,7,2799,1525,-40
25512261089,25512261094,5,3392,1282,-40
25512858973,25512858980,7,3339,1131,-40
25518275508,25518275515,7,2542,1202,-40
25520375253,25520375259,6,1835,1199,-40
25520879155,25520879136,-19,2150,1219,-40
25522322055,25522322069,14,26125,11059,-40
25526699120,25526699126,6,3066,1227,-40
25528055893,25528055898,5,3072,1212,-40
25528390790,25528390769,-21,1522,422,-40
25534114305,25534114310,5,2123,766,-40
25535958496,25535958501,5,2483,844,-40
25536604665,25536604670,5,3298,1116,-40
25537180469,25537180474,5,2543,1056,-40
25538292090,25538292098,8,3207,1051,-40
25538489949,25538489928,-21,3661,1317,-40
25543717885,25543717867,-18,844,214,-40
25547278614,25547278619,5,2823,1912,-40
25547549034,25547549043,9,2916,909,-40
25548546294,25548546301,7,2791,1933,-40
25549692334,25549692340,6,2744,1501,-40
25553816579,25553816574,-5,864,2002,-40
25555717258,25555717254,-4,2715,5395,-40
25556003352,25556003358,6,3271,1072,-40
25557379694,25557379702,8,6430,1076,-40
25557624094,25557624098,4,1671,1686,-40
25559181469,25559181473,4,3125,1400,-40
25561441602,25561441609,7,1936,1139,-40
25568225738,25568225745,7,3236,1679,-40
25570301722,25570301729,7,3879,1430,-40
25570570308,25570570315,7,3449,1354,-40
25574037021,25574037027,6,2676,1506,-40
25574457503,25574457508,5,3065,1518,-40
25574622223,25574622230,7,2655,1692,-40
25580014182,25580014187,5,2073,760,-40
25581543845,25581543852,7,2681,939,-40
25581904949,25581904928,-21,2396,858,-40
25581946398,25581946405,7,2726,1255,-40
25585600403,25585600409,6,2581,1095,-40
25586321522,25586321529,7,3391,1638,-40
25586425518,25586425523,5,3420,991,-40
25586834304,25586834308,4,3514,2132,-40
25587206934,25587206940,6,3604,1802,-40
25589250414,25589250422,8,4130,1477,-40
25589518533,25589518523,-10,958,422,-40
25592338128,25592338135,7,3239,1219,-40
25593409368,25593409374,6,3601,1331,-40
25594020266,25594020273,7,2144,1151,-40
25595131608,25595131614,6,3707,1583,-40
25598637330,25598637334,4,1159,835,-40
25601138584,25601138591,7,3635,1329,-40
25601722634,25601722642,8,2850,1177,-40
25602068386,25602068393,7,3330,1600,-40
25604197018,25604197023,5,2690,1035,-40
25604607406,25604607411,5,3103,1497,-40
25605063931,25605063925,-6,1449,4105,-40
25606130689,25606130695,6,2259,1635,-40
25606956592,25606956598,6,3846,1793,-40
25609206000,25609206006,6,2207,842,-40
25610519549,25610519555,6,2364,1233,-40
25618632057,25618632044,-13,3325,1183,-40
25618896521,25618896527,6,2518,1501,-40
25619994126,25619994132,6,3569,1567,-40
25620797268,25620797274,6,2130,1260,-40
25622527928,25622527933,5,2770,1288,-40
25624112974,25624112980,6,4913,1552,-40
25625024583,25625024579,-4,2427,42585,-40
25625057517,25625057522,5,2056,1130,-40
25629166046,25629166054,8,2554,1011,-40
25629377006,25629377013,7,3174,1098,-40
25629738309,25629738331,22,2545,1352,-40
25632978364,25632978370,6,2841,1731,-40
25634420452,25634420458,6,2530,1460,-40
25635823982,25635823989,7,1719,1063,-40
25636828034,25636828039,5,1934,1342,-40
25638076878,25638076883,5,2276,808,-40
25639800552,25639800556,4,2383,1238,-40
25641173048,25641173053,5,2088,1020,-40
25641663898,25641663903,5,3332,1688,-40
25642527985,25642527991,6,2276,1019,-40
25647614606,25647614614,8,3483,1558,-40
25650161941,25650161947,6,3509,1568,-40
25651703606,25651703612,6,4103,1472,-40
25652104618,25652104623,5,2849,1316,-40
25654663898,25654663902,4,1553,1059,-40
25655671929,25655671928,-1,2291,4337,-40
25657176795,25657176800,5,1926,1330,-40
25662637348,25662637354,6,2872,924,-40
25664338811,25664338817,6,2594,1674,-40
25664502299,25664502282,-17,944,178,-40
25668850222,25668850230,8,2864,919,-40
25676004226,25676004233,7,2495,949,-40
25685268644,25685268647,3,2184,1369,-40
25686086406,25686086410,4,2979,1546,-40
25686294182,25686294188,6,3632,1641,-40
25687014289,25687014294,5,2864,1216,-40
25687578008,25687578028,20,3781,1011,-40
25688707505,25688707510,5,3050,1290,-40
25689746974,25689746980,6,3276,1900,-40
25696005599,25696005605,6,2721,1310,-40
25697954361,25697954366,5,2085,1597,-40
25698402957,25698402964,7,1771,1197,-40
25705475562,25705475567,5,3556,1593,-40
25707871910,25707871918,8,3672,1679,-40
25708359084,25708359089,5,1505,1316,-40
25709934374,25709934374,0,12695,14683,-40
25711450222,25711450227,5,2544,926,-40
25719543792,25719543797,5,2917,1256,-40
25720269172,25720269179,7,2867,1611,-40
25724486400,25724486406,6,2932,1209,-40
25726175908,25726175905,-3,822,1676,-40
25729113570,25729113576,6,2595,1538,-40
25729279173,25729279153,-20,1008,273,-40
25730220589,25730220595,6,1893,1433,-40
25733212142,25733212146,4,1708,959,-40
25733757556,25733757545,-11,933,454,-40
25735829129,25735829123,-6,1004,3383,-40
25742808965,25742808971,6,2997,1629,-40
25742911916,25742911922,6,2987,1144,-40
25743085481,25743085466,-15,2337,716,-40
25746698667,25746698674,7,2983,1212,-40
25747263597,25747263611,14,2254,1081,-40
25747339183,25747339184,1,1015,1902,-40
25748187123,25748187129,6,2754,1083,-40
25751282007,25751282013,6,2892,1789,-40
25754730152,25754730157,5,2617,1114,-40
25761913318,25761913323,5,2283,931,-40
25764991161,25764991167,6,2933,963,-40
25768134334,25768134341,7,2755,1215,-40
25769216762,25769216769,7,2381,1402,-40
25770591466,25770591468,2,3126,3286,-40
25775418028,25775418033,5,2718,1259,-40
25787903615,25787903632,17,683,284,-40
25788862864,25788862870,6,2898,1161,-40
25789907533,25789907538,5,4455,1540,-40
25792744491,25792744497,6,2450,890,-40
25796898263,25796898270,7,1722,1440,-40
25797666861,25797666868,7,2642,1539,-40
25799819463,25799819469,6,2227,1245,-40
25801692341,25801692348,7,14299,32943,-40
25807094597,25807094601,4,4398,981,-40
25808771021,25808771014,-7,771,7582,-40
25809051706,25809051711,5,2675,989,-40
25809615002,25809615009,7,1783,661,-40
25810488084,25810488090,6,3756,1864,-40
25812550125,25812550132,7,3236,1532,-40
25816533302,25816533308,6,2250,1156,-40
25820310650,25820310659,9,3863,1727,-40
25821637430,25821637435,5,2989,1292,-40
25822154623,25822154629,6,3734,1144,-40
25823008969,25823008974,5,3382,1183,-40
25826665882,25826665887,5,2713,1471,-40
25826745900,25826745906,6,3594,1245,-40
25827065179,25827065186,7,2814,1304,-40
25828438070,25828438074,4,2658,957,-40
25831627267,25831627275,8,3638,1778,-40
25831686429,25831686434,5,2883,1039,-40
25835086862,25835086867,5,2814,993,-40
25836308720,25836308726,6,2937,1711,-40
25838798653,25838798661,8,4689,1275,-40
25838917978,25838917961,-17,2523,1010,-40
25842390965,25842390971,6,3095,1004,-40
25842636947,25842636954,7,2751,1075,-40
25845342646,25845342649,3,1760,1275,-40
25849368474,25849368482,8,2576,1583,-40
25849884552,25849884558,6,2524,1147,-40
25853334057,25853334064,7,2124,1088,-40
25855639892,25855639899,7,2477,1040,-40
25857634091,25857634097,6,2193,1053,-40
25859469091,25859469098,7,2935,1252,-40
25859682521,25859682527,6,2010,803,-40
25860107689,25860107696,7,2735,1509,-40
25862257521,25862257528,7,3038,1511,-40
25863847488,25863847494,6,2984,1243,-40
25865587773,25865587781,8,4176,1335,-40
25866328508,25866328488,-20,2327,983,-40
25867053067,25867053074,7,2245,1290,-40
25870061825,25870061835,10,3263,1639,-40
25870965411,25870965418,7,2153,1097,-40
25872752988,25872752995,7,1921,740,-40
25873889286,25873889292,6,2523,1232,-40
25873937994,25873937999,5,3224,1134,-40
25875150833,25875150838,5,3210,1112,-40
25878010132,25878010138,6,1861,1013,-40
25878671221,25878671227,6,2473,1025,-40
25879148545,25879148552,7,2230,1014,-40
25879875566,25879875572,6,4160,1378,-40
25880833437,25880833443,6,1840,857,-40
25882079221,25882079228,7,3600,1305,-40
25882838415,25882838422,7,2583,1109,-40
25883198909,25883198921,12,769,202,-40
25883796875,25883796881,6,2748,1374,-40
25885890482,25885890490,8,2387,843,-40
25886062094,25886062114,20,1555,748,-40
25890213959,25890213957,-2,1232,1113,-40
25890297920,25890297926,6,2830,1072,-40
25894005060,25894005066,6,2428,1257,-40
25897251724,25897251731,7,2954,1400,-40
25897893503,25897893509,6,2395,1115,-40
25898597482,25898597490,8,3025,884,-40
25898852572,25898852578,6,2010,1198,-40
25900511929,25900511934,5,1812,659,-40
25902267079,25902267085,6,2379,1700,-40
25903047735,25903047742,7,3271,1031,-40
25906614026,25906614032,6,2853,1047,-40
25907125081,25907125087,6,2839,953,-40
25910442512,25910442518,6,2852,1141,-40
25911509130,25911509138,8,3236,1192,-40
25913404774,25913404779,5,3604,1114,-40
25917432521,25917432528,7,3145,1371,-40
25921100570,25921100572,2,1937,1893,-40
25922618119,25922618125,6,2694,813,-40
25923964224,25923964208,-16,1042,195,-40
25926935033,25926935038,5,2237,689,-40
25927199885,25927199890,5,2088,1044,-40
25928353166,25928353173,7,2534,1461,-40
25930041870,25930041877,7,2445,1120,-40
25930233722,25930233707,-15,2434,1665,-40
25932550870,25932550874,4,1715,1180,-40
25939557397,25939557403,6,3063,1419,-40
25939673670,25939673677,7,1711,910,-40
25944991336,25944991334,-2,819,1287,-40
25946262570,25946262576,6,2621,1310,-40
25951076154,25951076159,5,2818,940,-40
25951546266,25951546269,3,1083,1307,-40
25952379380,25952379386,6,2893,1638,-40
25953075613,25953075620,7,2723,1261,-40
25953130906,25953130891,-15,2453,1311,-40
25954822102,25954822107,5,2996,1271,-40
25956163754,25956163758,4,1600,985,-40
25957124497,25957124503,6,2451,960,-40
25962042668,25962042675,7,7681,1228,-40
25962278533,25962278540,7,1878,903,-40
25976333482,25976333486,4,3715,1256,-40
25983238599,25983238606,7,2479,1437,-40
25983717698,25983717706,8,3367,1156,-40
25984554629,25984554611,-18,798,382,-40
25985499182,25985499183,1,1330,969,-40
25986538978,25986538983,5,2445,1016,-40
25988060646,25988060653,7,3005,1485,-40
25989306498,25989306503,5,2891,935,-40
25991599072,25991599079,7,4319,1542,-40
25992021454,25992021436,-18,1100,180,-40
25992334912,25992334919,7,1541,946,-40
25992576056,25992576063,7,3464,1575,-40
25995087139,25995087147,8,3314,1882,-40
26000014520,26000014512,-8,1207,502,-40
26002146566,26002146571,5,2183,1244,-40
26005745965,26005745970,5,2668,1014,-40
26006157925,26006157931,6,1011,439,-40
26007788939,26007788933,-6,1058,4033,-40
26008942455,26008942462,7,3085,1417,-40
26010909317,26010909320,3,1924,1554,-40
26011888333,26011888339,6,5211,1666,-40
26012330489,26012330492,3,257,5876,-40
26015347966,26015347975,9,2733,1124,-40
26021029581,26021029587,6,2130,1576,-40
26023055406,26023055414,8,2930,1099,-40
26023960694,26023960699,5,2419,938,-40
26024644590,26024644597,7,3805,1552,-40
26033224612,26033224619,7,3002,892,-40
26033807235,26033807243,8,3181,1133,-40
26036193746,26036193743,-3,1130,1154,-40
26045044084,26045044090,6,3882,1152,-40
26046820652,26046820658,6,2429,1321,-40
26048327508,26048327515,7,3224,1063,-40
26052456034,26052456039,5,2064,1111,-40
26057007721,26057007725,4,2634,1872,-40
26057648084,26057648090,6,2931,1121,-40
26059096095,26059096102,7,1804,1447,-40
26059944471,26059944477,6,3316,1570,-40
26062173666,26062173671,5,3666,1333,-40
26062294849,26062294852,3,2114,1308,-40
26065410235,26065410241,6,3035,1198,-40
26065826266,26065826283,17,3716,1685,-40
26066041105,26066041111,6,2862,1379,-40
26066201134,26066201113,-21,1908,515,-40
26074892754,26074892759,5,2398,1393,-40
26079880909,26079880915,6,2411,1266,-40
26080266441,26080266426,-15,670,373,-40
26081833863,26081833870,7,1718,798,-40
26084538702,26084538704,2,3140,1771,-40
26085814707,26085814706,-1,1249,1013,-40
26086734757,26086734766,9,4282,1682,-40
26096584361,26096584367,6,2878,1457,-40
26096872168,26096872174,6,2757,1120,-40
26099289262,26099289262,0,29030,34915,-40
26100979582,26100979590,8,3231,1241,-40
26101073990,26101073976,-14,1176,193,-40
26101290101,26101290106,5,2991,1117,-40
26102725693,26102725700,7,3614,1563,-40
26103080605,26103080588,-17,1276,874,-40
26105109249,26105109255,6,2583,1230,-40
26107079045,26107079051,6,2446,1085,-40
26110345106,26110345113,7,3369,1501,-40
26111387333,26111387339,6,3994,1737,-40
26113760974,26113760979,5,2531,1331,-40
26113943017,26113943024,7,3124,1160,-40
26114525702,26114525722,20,2651,1137,-40
26115902897,26115902900,3,2475,1169,-40
26125586483,26125586489,6,1238,991,-40
26127918101,26127918106,5,2845,959,-40
26129918191,26129918196,5,2904,1187,-40
26132221173,26132221178,5,3460,1630,-40
26135346930,26135346935,5,2176,1223,-40
26138731962,26138731968,6,2067,1508,-40
26143203959,26143203964,5,2225,1204,-40
26147580831,26147580836,5,2892,1119,-40
26153047317,26153047322,5,3710,1602,-40
26154118793,26154118798,5,2092,982,-40
26156420110,26156420117,7,1998,872,-40
26161055468,26161055475,7,2797,1034,-40
26161291530,26161291515,-15,1698,924,-40
26162167357,26162167362,5,3184,1616,-40
26162925878,26162925884,6,2613,1071,-40
26164676534,26164676539,5,3319,1124,-40
26164772658,26164772657,-1,1776,2651,-40
26168127166,26168127171,5,2098,991,-40
26168446887,26168446874,-13,3440,997,-40
26178322520,26178322527,7,2771,1278,-40
26186334261,26186334267,6,2546,1250,-40
26194748012,26194748018,6,3970,1319,-40
26198064777,26198064783,6,2742,1075,-40
26198789332,26198789314,-18,2177,1039,-40
26202336993,26202337001,8,2305,1164,-40
26211913343,26211913339,-4,599,1593,-40
26215064046,26215064058,12,19453,24269,-40
26215360643,26215360650,7,1492,1024,-40
26220830636,26220830642,6,3742,1386,-40
26221898691,26221898697,6,2509,1197,-40
26223243845,26223243849,4,2505,1565,-40
26227625173,26227625177,4,3653,1653,-40
26233594441,26233594443,2,1976,1191,-40
26235361815,26235361820,5,1396,1015,-40
26236573500,26236573506,6,3249,1342,-40
26239079383,26239079390,7,3130,1211,-40
26239811016,26239811022,6,2988,1316,-40
26242356860,26242356868,8,2804,1528,-40
26242401346,26242401351,5,2679,1532,-40
26244119430,26244119429,-1,1161,1571,-40
26246683873,26246683879,6,3342,1608,-40
26247544638,26247544646,8,3228,1352,-40
26250545219,26250545226,7,2605,1182,-40
26250818533,26250818513,-20,1627,734,-40
26251034105,26251034120,15,4048,1222,-40
26251543150,26251543154,4,3517,1370,-40
26253659083,26253659089,6,3107,1513,-40
26253977469,26253977448,-21,1527,32022,-40
26256367542,26256367542,0,2069,2420,-40
26257036747,26257036754,7,2641,1154,-40
26257924914,26257924922,8,3965,1462,-40
26263573489,26263573496,7,2855,1291,-40
26265031298,26265031307,9,4208,1212,-40
26265158864,26265158871,7,3634,1940,-40
26266280286,26266280290,4,2452,948,-40
26267224321,26267224326,5,2053,1294,-40
26272796542,26272796548,6,3376,1584,-40
26273086962,26273086971,9,741,1016,-40
26274638665,26274638671,6,3755,1758,-40
26275174789,26275174796,7,3067,904,-40
26280062869,26280062875,6,2973,1592,-40
26282983898,26282983905,7,3331,1154,-40
26288593345,26288593352,7,3909,1809,-40
26288970347,26288970346,-1,1518,2273,-40
26295317475,26295317481,6,1987,1078,-40
26297581466,26297581470,4,2192,1439,-40
26300576650,26300576658,8,2684,1017,-40
26301544263,26301544263,0,1334,1561,-40
26302461590,26302461595,5,1461,902,-40
26302984215,26302984219,4,1857,1360,-40
26305204493,26305204499,6,1987,1127,-40
26306850158,26306850162,4,1557,821,-40
26315600761,26315600766,5,2393,864,-40
26316912809,26316912814,5,3816,1964,-40
26322019707,26322019714,7,2184,990,-40
26322186792,26322186776,-16,747,505,-40
26323312785,26323312791,6,3776,1226,-40
26323705592,26323705595,3,2309,1511,-40
26329016157,26329016174,17,1547,843,-40
26333459935,26333459942,7,3082,1127,-40
26334937722,26334937739,17,2904,1197,-40
26338737690,26338737685,-5,1316,3410,-40
26338864517,26338864524,7,2450,1143,-40
26340582374,26340582383,9,4209,1478,-40
26341154702,26341154707,5,2824,880,-40
26341709404,26341709415,11,28796,58887,-40
26342076863,26342076870,7,2316,1143,-40
26343446399,26343446380,-19,2216,521,-40
26343903938,26343903944,6,1303,1465,-40
26345131778,26345131785,7,1933,639,-40
26346473838,26346473844,6,3175,1425,-40
26348225942,26348225949,7,3979,1917,-40
26349697945,26349697950,5,2795,1222,-40
26351096804,26351096811,7,3553,1568,-40
26352147435,26352147442,7,3807,1612,-40
26352257417,26352257423,6,2599,1408,-40
26352414089,26352414096,7,2886,1230,-40
26353206104,26353206108,4,2114,1135,-40
26353817395,26353817404,9,2112,790,-40
26355908439,26355908446,7,3247,1304,-40
26357995898,26357995888,-10,1127,256,-40
26358984263,26358984268,5,2099,1147,-40
26359790436,26359790442,6,2434,705,-40
26365108413,26365108418,5,2481,1308,-40
26366139217,26366139224,7,2663,1376,-40
26366892454,26366892459,5,1943,1205,-40
26368453182,26368453189,7,2438,1076,-40
26370713005,26370713010,5,3465,1168,-40
26375545975,26375545982,7,2358,1530,-40
26376342515,26376342521,6,2909,1044,-40
26378349249,26378349256,7,2497,1359,-40
26379407301,26379407306,5,1631,693,-40
26382464318,26382464322,4,3841,1947,-40
26386612027,26386612034,7,1959,1499,-40
26389782339,26389782346,7,1457,757,-40
26397294687,26397294693,6,3402,1456,-40
26399174831,26399174837,6,2924,1190,-40
26400493926,26400493922,-4,1592,2681,-40
26400970690,26400970691,1,1132,1543,-40
26403228500,26403228506,6,4057,1978,-40
26409322407,26409322410,3,1855,883,-40
26410168894,26410168898,4,2416,994,-40
26412522554,26412522561,7,2176,1089,-40
26414947185,26414947185,0,1186,1729,-40
26416865563,26416865553,-10,129,1431,-40
26420767879,26420767885,6,3091,1193,-40
26431415747,26431415754,7,4159,2224,-40
26431892582,26431892588,6,3577,1786,-40
26439574566,26439574572,6,3367,1622,-40
26440130953,26440130959,6,4203,1872,-40
26448289306,26448289312,6,2871,1007,-40
26448542694,26448542682,-12,1705,857,-40
26451860738,26451860742,4,3621,1407,-40
26454701706,26454701714,8,1672,852,-40
26454883210,26454883215,5,2672,1110,-40
26455729998,26455729998,0,1425,2180,-40
26455853796,26455853801,5,2557,1224,-40
26457058551,26457058558,7,2719,1553,-40
26462779669,26462779677,8,2965,1241,-40
26463814830,26463814829,-1,1501,2227,-40
26463964564,26463964568,4,346,1134,-40
26464422237,26464422256,19,892,977,-40
26472146761,26472146766,5,1794,732,-40
26472732424,26472732429,5,2640,1040,-40
26475594197,26475594195,-2,285,1243,-40
26477245757,26477245762,5,3861,1423,-40
26482045349,26482045354,5,2900,1664,-40
26487562289,26487562286,-3,1723,2115,-40
26490657657,26490657662,5,3028,1573,-40
26495459221,26495459226,5,2385,1560,-40
26507055004,26507055010,6,3307,1723,-40
26507877392,26507877399,7,2944,1144,-40
26510975814,26510975821,7,3124,1784,-40
26511831018,26511831021,3,3501,2725,-40
26512476210,26512476217,7,2438,1258,-40
26512881201,26512881208,7,3010,957,-40
26513255894,26513255873,-21,1756,679,-40
26515186648,26515186655,7,3932,1404,-40
26516424323,26516424327,4,2288,1448,-40
26518331614,26518331624,10,3421,1373,-40
26530493606,26530493615,9,3319,1164,-40
26530689263,26530689270,7,2004,988,-40
26530775325,26530775306,-19,2939,926,-40
26531825707,26531825709,2,1731,2076,-40
26532260679,26532260659,-20,1063,349,-40
26535639261,26535639268,7,3125,1162,-40
26536325946,26536325953,7,2945,1539,-40
26536558387,26536558393,6,1662,837,-40
26537290082,26537290090,8,1254,943,-40
26540179010,26540179017,7,4078,1669,-40
26540599051,26540599055,4,1923,883,-40
26547369349,26547369356,7,4470,1254,-40
26548237616,26548237621,5,2018,1093,-40
26548322187,26548322169,-18,4006,976,-40
26551991757,26551991758,1,1293,1283,-40
26553554650,26553554658,8,3917,1350,-40
26554625936,26554625943,7,2231,1249,-40
26557961625,26557961633,8,2607,1249,-40
26558595746,26558595753,7,4735,2806,-40
26559170482,26559170488,6,1218,846,-40
26559690366,26559690373,7,3006,963,-40
26561996175,26561996159,-16,1187,280,-40
26563375824,26563375831,7,2455,1185,-40
26567195662,26567195666,4,2982,1404,-40
26568613003,26568613002,-1,792,1944,-40
26569244838,26569244845,7,3987,1364,-40
26572061030,26572061036,6,3408,1472,-40
26579803254,26579803259,5,2427,883,-40
26582711242,26582711246,4,1813,996,-40
26583277698,26583277712,14,1975,1171,-40
26591029434,26591029438,4,2863,850,-40
26592824445,26592824450,5,1542,1142,-40
26599455218,26599455222,4,3234,1179,-40
26600769946,26600769948,2,1748,1763,-40
26601099549,26601099553,4,3637,1851,-40
26602003141,26602003145,4,3757,1805,-40
26608987096,26608987102,6,3482,909,-40
26616704026,26616704032,6,2717,1236,-40
26618364039,26618364046,7,2697,1387,-40
26619426523,26619426529,6,1576,1001,-40
26620806084,26620806090,6,3446,1492,-40
26620864246,26620864253,7,3223,1343,-40
26622467049,26622467058,9,3158,1221,-40
26622970666,26622970673,7,4449,1656,-40
26627019764,26627019768,4,1434,1188,-40
26628496603,26628496588,-15,1160,450,-40
26629731962,26629731969,7,3091,1435,-40
26631844117,26631844102,-15,1923,525,-40
26636046114,26636046122,8,5693,958,-40
26636305094,26636305101,7,3725,1438,-40
26640535173,26640535181,8,2777,1161,-40
26649801470,26649801477,7,2271,1266,-40
26652703385,26652703390,5,8471,30917,-40
26656808513,26656808518,5,1967,729,-40
26659505797,26659505803,6,2195,637,-40
26662433354,26662433360,6,3635,1364,-40
26662519153,26662519162,9,3436,1619,-40
26662947191,26662947202,11,2655,1264,-40
26663957046,26663957052,6,2781,1328,-40
26665107490,26665107505,15,13285,52483,-40
26670867861,26670867862,1,1313,1786,-40
26673514502,26673514509,7,2683,1060,-40
26679577154,26679577161,7,3161,1251,-40
26680106304,26680106310,6,3117,1682,-40
26683484085,26683484091,6,2979,1220,-40
26686123282,26686123288,6,2273,1270,-40
26689278317,26689278321,4,2335,1400,-40
26691727022,26691727030,8,3302,1448,-40
26692745878,26692745883,5,1374,446,-40
26693707297,26693707303,6,4070,1340,-40
26695141221,26695141227,6,2711,1331,-40
26696554364,26696554360,-4,1771,2891,-40
26697196764,26697196769,5,2976,1292,-40
26697631310,26697631307,-3,2877,4958,-40
26699393490,26699393495,5,3490,1439,-40
26702025594,26702025601,7,2573,839,-40
26703252697,26703252702,5,2854,1122,-40
26709035762,26709035769,7,2089,1134,-40
26711918826,26711918833,7,2778,1049,-40
26719076351,26719076356,5,3037,1918,-40
26719461401,26719461385,-16,2078,727,-40
26723610017,26723610023,6,2236,1379,-40
26723945273,26723945282,9,3336,1272,-40
26727072287,26727072293,6,2692,1164,-40
26727509521,26727509527,6,2359,1083,-40
26728431058,26728431063,5,3476,1485,-40
26728848552,26728848538,-14,2046,1577,-40
26730517607,26730517613,6,3700,1683,-40
26731152565,26731152564,-1,4563,7105,-40
26733164578,26733164586,8,4144,1358,-40
26733619317,26733619324,7,2693,1150,-40
26736395038,26736395044,6,3811,1221,-40
26737195654,26737195659,5,2118,991,-40
26740854897,26740854903,6,3043,1240,-40
26744654918,26744654923,5,2877,1021,-40
26744806701,26744806708,7,1550,930,-40
26746732873,26746732874,1,2387,2032,-40
26747743318,26747743323,5,2468,1293,-40
26747958400,26747958387,-13,2060,1035,-40
26751146154,26751146155,1,1387,1884,-40
26756292796,26756292792,-4,57186,28597,-40
26757126004,26757126010,6,2619,1649,-40
26758374217,26758374201,-16,938,183,-40
26758717592,26758717597,5,2502,1548,-40
26759214880,26759214885,5,2925,1365,-40
26761094808,26761094814,6,1578,1107,-40
26763459405,26763459412,7,2598,1176,-40
26763837701,26763837722,21,989,198,-40
26764679236,26764679234,-2,1089,245,-40
26773915013,26773915019,6,2648,840,-40
26775397615,26775397621,6,1964,877,-40
26778976554,26778976560,6,2211,1273,-40
26781993741,26781993746,5,2951,1508,-40
26783655001,26783655007,6,2679,1396,-40
26783705810,26783705811,1,1090,314,-40
26784470082,26784470086,4,2190,1113,-40
26791858649,26791858654,5,2982,1467,-40
26792604438,26792604438,0,2633,4260,-40
26796455948,26796455955,7,3734,1086,-40
26801028618,26801028617,-1,18404,11324,-40
26804574218,26804574225,7,3762,1281,-40
26814023434,26814023439,5,2975,1033,-40
26816384814,26816384823,9,3000,1114,-40
26819136721,26819136727,6,3681,1358,-40
26819717098,26819717105,7,2543,1299,-40
26824006733,26824006738,5,3824,1183,-40
26824356118,26824356120,2,2036,1704,-40
26829917911,26829917916,5,2951,1020,-40
26830307833,26830307841,8,3423,1366,-40
26831206372,26831206378,6,2907,1480,-40
26835275678,26835275683,5,2055,1087,-40
26835822534,26835822523,-11,1734,611,-40
26837088414,26837088394,-20,1315,499,-40
26839572136,26839572140,4,2994,1185,-40
26839867598,26839867604,6,1507,853,-40
26841580714,26841580719,5,2966,1156,-40
26842511391,26842511403,12,4502,61912,-40
26843027775,26843027781,6,3342,1232,-40
26844243490,26844243475,-15,1935,892,-40
26854056050,26854056058,8,3112,1190,-40
26855200781,26855200787,6,2507,1073,-40
26856739810,26856739817,7,2234,1268,-40
26861208589,26861208595,6,2982,1478,-40
26863120791,26863120798,7,3837,1124,-40
26863727694,26863727684,-10,848,393,-40
26868836749,26868836754,5,2004,1079,-40
26871861393,26871861381,-12,1023,322,-40
26874138037,26874138043,6,1843,942,-40
26876659958,26876659963,5,2907,1335,-40
26880219093,26880219099,6,1729,675,-40
26880664609,26880664608,-1,1203,1998,-40
26881737534,26881737539,5,3709,1426,-40
26885661222,26885661227,5,2937,1231,-40
26885781942,26885781921,-21,2813,817,-40
26889407764,26889407770,6,3135,1095,-40
26889901914,26889901907,-7,1001,164,-40
26893801517,26893801518,1,1692,978,-40
26894870270,26894870275,5,3612,1610,-40
26897723493,26897723499,6,1944,830,-40
26901858078,26901858085,7,3346,1381,-40
26902540440,26902540427,-13,2014,1090,-40
26904325196,26904325203,7,3143,1625,-40
26907454197,26907454203,6,1592,897,-40
26909449459,26909449453,-6,942,5410,-40
26911940133,26911940139,6,3039,1135,-40
26917958523,26917958527,4,1454,1628,-40
26923505791,26923505803,12,3132,885,-40
26926063468,26926063474,6,2593,1330,-40
26926099150,26926099157,7,2177,872,-40
26929971278,26929971285,7,11007,26552,-40
26940314954,26940314960,6,3062,1527,-40
26940788578,26940788586,8,1303,1023,-40
26940831727,26940831712,-15,931,497,-40
26946628033,26946628039,6,3327,1314,-40
26949146837,26949146844,7,2802,1300,-40
26949440118,26949440097,-21,3058,1549,-40
26949671841,26949671847,6,3473,1590,-40
26950893462,26950893467,5,2314,1383,-40
26953153276,26953153282,6,1932,1039,-40
26953428641,26953428635,-6,514,282,-40
26957669657,26957669661,4,13721,731,-40
26965753674,26965753681,7,3119,1463,-40
26971727234,26971727242,8,2420,963,-40
26973025619,26973025626,7,3240,1637,-40
26975849849,26975849855,6,4193,1454,-40
26976199692,26976199698,6,2667,1049,-40
26976468405,26976468410,5,2551,1019,-40
26977135796,26977135778,-18,1399,820,-40
26977874485,26977874490,5,2010,1009,-40
26979058579,26979058585,6,3581,2036,-40
26983924358,26983924364,6,1861,1568,-40
26984258925,26984258945,20,2985,1358,-40
26985975860,26985975866,6,3392,1867,-40
26989927790,26989927797,7,2368,860,-40
26990257062,26990257068,6,2784,1246,-40
26990663825,26990663842,17,738,236,-40
26990744093,26990744074,-19,949,181,-40
26992382218,26992382225,7,2905,1368,-40
26997948048,26997948054,6,1252,1019,-40
26999875033,26999875038,5,2604,1292,-40
27001266557,27001266564,7,3086,1171,-40
27003973813,27003973819,6,2953,1141,-40
27005448202,27005448208,6,2949,1110,-40
27006552797,27006552797,0,626,1480,-40
27010227021,27010227028,7,2510,1386,-40
27011147377,27011147385,8,2887,1391,-40
27012032466,27012032470,4,1593,747,-40
27014898317,27014898323,6,3229,1010,-40
27016048764,27016048769,5,2545,981,-40
27018540406,27018540409,3,2094,1294,-40
27018784100,27018784084,-16,1387,785,-40
27023178619,27023178626,7,4256,1526,-40
27023748130,27023748124,-6,1716,7718,-40
27025043986,27025043994,8,2072,901,-40
27025707395,27025707378,-17,2768,1456,-40
27035684406,27035684410,4,1477,645,-40
27036936726,27036936731,5,3445,1625,-40
27037547746,27037547753,7,2993,1235,-40
27040028407,27040028423,16,1131,385,-40
27043083608,27043083594,-14,1658,3115,-40
27049300930,27049300924,-6,1231,3266,-40
27052826483,27052826490,7,1438,1059,-40
27054025133,27054025139,6,2875,1686,-40
27054747389,27054747371,-18,1677,966,-40
27058185093,27058185098,5,2167,972,-40
27063039976,27063039983,7,2467,1219,-40
27064458285,27064458279,-6,1193,3072,-40
27066118287,27066118295,8,3240,1188,-40
27066259118,27066259099,-19,2958,1206,-40
27066991969,27066991970,1,1071,1857,-40
27067663540,27067663544,4,24881,36197,-40
27070723058,27070723066,8,2978,1506,-40
27074590632,27074590638,6,2261,1593,-40
27080181137,27080181144,7,3608,1276,-40
27081678426,27081678434,8,2131,1194,-40
27082926715,27082926719,4,3017,978,-40
27083670181,27083670184,3,1081,1228,-40
27084910499,27084910482,-17,1388,930,-40
27091047228,27091047233,5,3927,1576,-40
27094527009,27094527010,1,1499,713,-40
27095451687,27095451689,2,1658,1429,-40
27095788433,27095788442,9,3507,1068,-40
27098575122,27098575128,6,3353,1040,-40
27099463702,27099463682,-20,1772,599,-40
27099756716,27099756723,7,1524,884,-40
27102350661,27102350668,7,3226,1161,-40
27108460469,27108460474,5,3268,1218,-40
27111094459,27111094459,0,961,1318,-40
27111535155,27111535168,13,1149,331,-40
27112297764,27112297747,-17,2667,1091,-40
27115940106,27115940112,6,2796,1610,-40
27118505828,27118505834,6,3213,888,-40
27120353038,27120353037,-1,1879,2650,-40
27121473189,27121473197,8,2859,1239,-40
27122587726,27122587733,7,3301,1301,-40
27123327654,27123327662,8,3232,1305,-40
27123416953,27123416960,7,810,220,-40
27127670732,27127670738,6,3853,1330,-40
27132165386,27132165391,5,2311,952,-40
27133505301,27133505307,6,2807,1193,-40
27140360605,27140360612,7,3756,1416,-40
27142973489,27142973495,6,3278,1429,-40
27144813949,27144813956,7,3421,1513,-40
27148234566,27148234573,7,2912,1939,-40
27148999705,27148999711,6,2958,907,-40
27152021273,27152021274,1,1034,1455,-40
27158123688,27158123694,6,2897,1050,-40
27159014844,27159014851,7,2805,1318,-40
27159794130,27159794135,5,1749,1117,-40
27161156557,27161156562,5,1848,1108,-40
27166526266,27166526272,6,3215,1166,-40
27166584664,27166584670,6,2787,1019,-40
27168075142,27168075147,5,1812,1100,-40
27168320652,27168320642,-10,1134,272,-40
27168786043,27168786050,7,1834,816,-40
27170818971,27170818977,6,3157,1093,-40
27171754482,27171754485,3,785,723,-40
27174226336,27174226342,6,1739,1427,-40
27176503991,27176503998,7,2827,1393,-40
27177011709,27177011714,5,3997,1633,-40
27184537208,27184537213,5,2411,1418,-40
27189064612,27189064613,1,1251,992,-40
27192415855,27192415862,7,3130,1282,-40
27193234481,27193234489,8,3422,1172,-40
27193839162,27193839170,8,738,191,-40
27198317034,27198317040,6,2969,1473,-40
27201192153,27201192159,6,1828,1242,-40
27206229377,27206229384,7,3191,1075,-40
27206518113,27206518118,5,3290,1553,-40
27207365559,27207365561,2,1372,781,-40
27208951975,27208951982,7,3265,1450,-40
27209073326,27209073330,4,2678,1511,-40
27210953049,27210953054,5,1856,1038,-40
27215542313,27215542318,5,1443,884,-40
27216248302,27216248308,6,2410,931,-40
27218003322,27218003326,4,2446,1957,-40
27219813706,27219813705,-1,818,1850,-40
27220974236,27220974233,-3,1277,3727,-40
27221851470,27221851479,9,2094,864,-40
27223283314,27223283321,7,3285,1573,-40
27224528789,27224528796,7,4713,1409,-40
27225032449,27225032432,-17,1350,201,-40
27227248202,27227248210,8,3568,1937,-40
27228220631,27228220625,-6,1393,4210,-40
27228558326,27228558333,7,2522,1493,-40
27230657103,27230657101,-2,769,1429,-40
27237769960,27237769967,7,3205,1554,-40
27240215372,27240215378,6,2855,1332,-40
27240857701,27240857707,6,3256,1225,-40
27244381474,27244381478,4,2808,1178,-40
27245087369,27245087375,6,2184,982,-40
27249203686,27249203693,7,3825,1543,-40
27249246203,27249246210,7,2591,1227,-40
27250674341,27250674346,5,3474,1167,-40
27252110844,27252110849,5,3823,1161,-40
27252426458,27252426473,15,693,1412,-40
27252729577,27252729582,5,3307,1288,-40
27253618174,27253618178,4,2377,1033,-40
27255540911,27255540916,5,2312,1283,-40
27255566794,27255566810,16,3031,808,-40
27255826173,27255826179,6,2595,1412,-40
27256991121,27256991127,6,3539,1600,-40
27259706212,27259706219,7,3664,1158,-40
27261185509,27261185514,5,3297,1138,-40
27261248342,27261248321,-21,3037,923,-40
27262684290,27262684297,7,3394,1255,-40
27266400318,27266400323,5,2639,1428,-40
27267245517,27267245525,8,2911,1299,-40
27267398051,27267398056,5,1890,1543,-40
27267762083,27267762065,-18,3158,1341,-40
27269928470,27269928477,7,3405,1287,-40
27271046437,27271046443,6,2612,1018,-40
27275193127,27275193133,6,3134,1126,-40
27278299062,27278299067,5,2503,1229,-40
27283727789,27283727794,5,2717,1510,-40
27285904066,27285904065,-1,3275,14475,-40
27287430246,27287430253,7,5181,1403,-40
27289401986,27289401991,5,3336,1798,-40
27289664569,27289664574,5,2829,923,-40
27290441760,27290441765,5,2303,1073,-40
27291491597,27291491602,5,3980,988,-40
27296442428,27296442434,6,2993,1175,-40
27297443662,27297443665,3,1549,1526,-40
27298182496,27298182502,6,4117,1602,-40
27300071878,27300071875,-3,2695,4144,-40
27301764670,27301764670,0,2415,3688,-40
27303845490,27303845497,7,2762,1606,-40
27307280319,27307280325,6,2729,1728,-40
27310937730,27310937736,6,2090,1021,-40
27311097654,27311097659,5,2694,808,-40
27311679729,27311679735,6,2662,1699,-40
27311726702,27311726706,4,2953,1182,-40
27317309738,27317309745,7,3115,1802,-40
27317692346,27317692332,-14,2213,1308,-40
27318948157,27318948163,6,2168,1336,-40
27319769907,27319769915,8,2838,899,-40
27320026559,27320026563,4,1986,1324,-40
27320491494,27320491502,8,2730,1372,-40
27322588175,27322588178,3,1723,1508,-40
27323459356,27323459361,5,2453,1375,-40
27323488591,27323488568,-23,1053,71,-40
27323527006,27323527013,7,5474,1376,-40
27327694487,27327694494,7,2602,936,-40
27327824952,27327824948,-4,1727,4651,-40
27330724101,27330724105,4,2960,1088,-40
27332780124,27332780131,7,2917,781,-40
27337945619,27337945627,8,2768,859,-40
27338618550,27338618557,7,1560,927,-40
27338942381,27338942384,3,1289,358,-40
27342387406,27342387413,7,3425,1151,-40
27343471074,27343471071,-3,946,1446,-40
27343560508,27343560515,7,2710,1041,-40
27345176774,27345176779,5,2232,1091,-40
27345819893,27345819897,4,1501,786,-40
27349543410,27349543418,8,4315,1368,-40
27351489970,27351489976,6,1517,1254,-40
27352149080,27352149074,-6,1612,6415,-40
27356493162,27356493170,8,3236,1255,-40
27358239124,27358239131,7,31,665,-40
27361779809,27361779815,6,2425,849,-40
27361882399,27361882409,10,4047,1224,-40
27363534218,27363534224,6,1878,1299,-40
27365180546,27365180553,7,3256,1465,-40
27368715399,27368715405,6,1784,1006,-40
27371703193,27371703198,5,3506,1193,-40
27371843261,27371843267,6,3319,1262,-40
27373425897,27373425905,8,2704,1145,-40
27375249490,27375249497,7,3123,1808,-40
27375908136,27375908142,6,2501,1600,-40
27377173456,27377173463,7,2360,1081,-40
27380700785,27380700790,5,1534,1287,-40
27383820331,27383820338,7,3187,1347,-40
27385169275,27385169257,-18,1549,1013,-40
27385577995,27385578000,5,2601,1188,-40
27387389385,27387389391,6,3467,1111,-40
27388031976,27388031984,8,3303,1501,-40
27388860698,27388860704,6,3260,1564,-40
27389220927,27389220934,7,2743,1056,-40
27393808446,27393808452,6,2788,1535,-40
27394313883,27394313888,5,824,1048,-40
27396903410,27396903415,5,3311,1093,-40
27397640975,27397640983,8,1720,882,-40
27397954498,27397954503,5,3210,1685,-40
27402389781,27402389787,6,3308,1400,-40
27407674966,27407674972,6,2679,1143,-40
27416423670,27416423678,8,2356,1486,-40
27419939055,27419939061,6,2372,1543,-40
27419996375,27419996392,17,1240,235,-40
27420947223,27420947230,7,3450,1224,-40
27422492768,27422492774,6,2804,1083,-40
27434257543,27434257539,-4,798,1900,-40
27438814270,27438814280,10,4883,1602,-40
27440341925,27440341932,7,2979,1438,-40
27440417628,27440417650,22,3137,1945,-40
27440527003,27440527016,13,2198,1298,-40
27441164054,27441164059,5,2313,892,-40
27441501077,27441501082,5,3127,1193,-40
27442244822,27442244827,5,2954,1092,-40
27443358045,27443358051,6,2896,1239,-40
27444464646,27444464653,7,2459,1589,-40
27446068205,27446068212,7,3439,1559,-40
27451218223,27451218231,8,2591,1131,-40
27452695960,27452695965,5,2661,1389,-40
27456896603,27456896609,6,2354,1496,-40
27457121674,27457121679,5,3338,1466,-40
27459351726,27459351733,7,2739,1236,-40
27459400940,27459400947,7,2404,1233,-40
27461378777,27461378783,6,1925,840,-40
27461756675,27461756659,-16,605,427,-40
27463354830,27463354837,7,3166,1371,-40
27463491259,27463491264,5,1179,842,-40
27463728979,27463728985,6,3270,1170,-40
27464882011,27464882016,5,1022,617,-40
27465638930,27465638935,5,2128,1241,-40
27467388268,27467388249,-19,2349,731,-40
27467864434,27467864439,5,2157,889,-40
27470638401,27470638408,7,3212,1471,-40
27471022961,27471022967,6,2864,786,-40
27472754453,27472754458,5,3926,1543,-40
27474172533,27474172540,7,3139,1751,-40
27475633866,27475633872,6,2545,1481,-40
27476590994,27476591001,7,2781,1157,-40
27478404270,27478404275,5,3367,1232,-40
27478499282,27478499288,6,2619,1192,-40
27479928965,27479928971,6,2737,1157,-40
27485415763,27485415770,7,2665,1024,-40
27488176346,27488176353,7,3089,1422,-40
27499229584,27499229591,7,1968,1081,-40
27501921302,27501921308,6,2903,1452,-40
27504478678,27504478682,4,791,1100,-40
27504558688,27504558674,-14,1499,927,-40
27509162949,27509162954,5,3264,1603,-40
27511341345,27511341350,5,3960,1339,-40
27511935284,27511935273,-11,1151,101,-40
27512287029,27512287035,6,2899,1417,-40
27517388184,27517388189,5,2184,1288,-40
27517474102,27517474083,-19,1152,259,-40
27519937879,27519937885,6,4574,1895,-40
27522835746,27522835752,6,2789,1333,-40
27522861567,27522861554,-13,895,258,-40
27523421239,27523421246,7,3877,1060,-40
27525645192,27525645197,5,2925,1190,-40
27537634342,27537634349,7,4349,1843,-40
27538021219,27538021227,8,4782,933,-40
27542097626,27542097631,5,2129,1086,-40
27544271127,27544271125,-2,1090,1441,-40
27545797099,27545797108,9,2432,1202,-40
27548198482,27548198464,-18,228,989,-40
27554201904,27554201909,5,1745,936,-40
27556799978,27556799985,7,2426,1442,-40
27557459190,27557459192,2,3207,2719,-40
27562260181,27562260188,7,3604,1410,-40
27569311288,27569311295,7,1644,1402,-40
27572045085,27572045084,-1,2863,5324,-40
27575298544,27575298550,6,3007,1559,-40
27575575565,27575575569,4,1391,1179,-40
27577220211,27577220219,8,2697,1355,-40
27578438918,27578438924,6,14496,22001,-40
27600241937,27600241943,6,2718,1515,-40
27601015401,27601015406,5,2816,1356,-40
27603170463,27603170469,6,2414,1102,-40
27603325155,27603325162,7,2600,1103,-40
27606564042,27606564047,5,2977,936,-40
27607469984,27607469971,-13,1091,478,-40
27607831435,27607831440,5,2387,1222,-40
27608299515,27608299522,7,3582,1549,-40
27615234325,27615234329,4,1972,907,-40
27615497978,27615497983,5,2405,1056,-40
27621277235,27621277242,7,2848,1256,-40
27622118601,27622118607,6,3008,1391,-40
27624421057,27624421062,5,4550,2644,-40
27625569644,27625569649,5,1410,1425,-40
27628385895,27628385902,7,3379,1434,-40
27632257193,27632257199,6,2895,941,-40
27635487297,27635487303,6,1742,1221,-40
27636951341,27636951347,6,2845,1134,-40
27638483421,27638483424,3,1664,958,-40
27638575281,27638575285,4,2005,788,-40
27640701777,27640701783,6,2300,994,-40
27641132642,27641132648,6,3214,1432,-40
27641888987,27641888994,7,2683,1375,-40
27642153999,27642153977,-22,1046,419,-40
27643898064,27643898070,6,2691,1475,-40
27644799303,27644799306,3,962,20035,-40
27647214897,27647214899,2,1677,1372,-40
27650980267,27650980274,7,3514,1368,-40
27651265270,27651265277,7,2266,876,-40
27651516733,27651516737,4,3157,1124,-40
27653409177,27653409181,4,2022,1409,-40
27654099989,27654099972,-17,1982,597,-40
27660040436,27660040442,6,2276,854,-40
27664064477,27664064485,8,3801,1113,-40
27664640725,27664640732,7,2705,1761,-40
27666568833,27666568838,5,3193,1141,-40
27667658810,27667658818,8,1213,611,-40
27670368607,27670368613,6,3520,1121,-40
27670817519,27670817525,6,3923,2484,-40
27681601289,27681601285,-4,856,3083,-40
27681885378,27681885386,8,3228,890,-40
27686650490,27686650496,6,3032,1554,-40
27687050373,27687050378,5,2937,882,-40
27699434602,27699434610,8,3458,1388,-40
27701731950,27701731962,12,1413,236,-40
27704025717,27704025723,6,2848,1343,-40
27704377508,27704377491,-17,2975,1283,-40
27706824259,27706824262,3,2885,1251,-40
27706946363,27706946370,7,3257,918,-40
27710411738,27710411745,7,1867,864,-40
27711164956,27711164939,-17,2940,1604,-40
27711304003,27711303988,-15,1171,655,-40
27713675817,27713675821,4,1139,737,-40
27720132380,27720132388,8,3430,1859,-40
27728253657,27728253663,6,1359,961,-40
27734201250,27734201258,8,2633,1272,-40
27734451797,27734451803,6,2587,1218,-40
27735375216,27735375222,6,2804,1278,-40
27738954477,27738954484,7,2066,1095,-40
27740155102,27740155106,4,2759,1232,-40
27742037049,27742037055,6,2541,1415,-40
27742168294,27742168301,7,2429,1118,-40
27742435042,27742435047,5,3707,2164,-40
27742954578,27742954575,-3,1252,3669,-40
27744918745,27744918751,6,3986,1654,-40
27746532293,27746532299,6,2845,1328,-40
27747268065,27747268071,6,2797,1315,-40
27753504635,27753504642,7,2925,882,-40
27754257000,27754257006,6,3006,1638,-40
27756617972,27756617976,4,2385,1088,-40
27758148382,27758148387,5,2470,1390,-40
27759032033,27759032039,6,2772,939,-40
27760578929,27760578930,1,16668,16344,-40
27765581250,27765581254,4,2080,1247,-40
27768375962,27768375972,10,3197,964,-40
27772385770,27772385777,7,3697,1588,-40
27772929954,27772929958,4,2212,1040,-40
27779854641,27779854648,7,2289,1473,-40
27783355966,27783355973,7,2291,1129,-40
27784105707,27784105706,-1,1235,1385,-40
27784989106,27784989111,5,2267,1258,-40
27789540462,27789540469,7,3897,2190,-40
27790842072,27790842078,6,3905,1380,-40
27790898030,27790898016,-14,3131,896,-40
27793470488,27793470495,7,3208,1265,-40
27794083620,27794083623,3,2977,1770,-40
27797490358,27797490364,6,2649,1121,-40
27800347601,27800347602,1,1925,2355,-40
27809908291,27809908289,-2,2223,3200,-40
27813417813,27813417819,6,2502,1284,-40
27813603082,27813603087,5,2128,1051,-40
27816516330,27816516337,7,2711,1319,-40
27817280394,27817280376,-18,904,220,-40
27818529594,27818529598,4,1132,871,-40
27819670215,27819670222,7,2454,1332,-40
27825315262,27825315258,-4,1358,2325,-40
27825500013,27825500019,6,2932,1551,-40
27825772410,27825772394,-16,2789,1282,-40
27838049698,27838049703,5,2904,1414,-40
27840520201,27840520208,7,3991,1395,-40
27841379953,27841379959,6,2042,947,-40
27842618776,27842618780,4,1764,1110,-40
27854156342,27854156346,4,2192,1516,-40
27855152855,27855152862,7,12223,4511,-40
27855221948,27855221955,7,2133,906,-40
27855456642,27855456650,8,1110,1173,-40
27861967233,27861967239,6,2504,1450,-40
27866397725,27866397733,8,3509,1582,-40
27866642511,27866642518,7,2764,964,-40
27867203869,27867203875,6,2631,1377,-40
27867352945,27867352941,-4,2357,6074,-40
27867558579,27867558581,2,1923,2180,-40
27868029279,27868029285,6,2496,1187,-40
27869015984,27869015986,2,1056,722,-40
27871401007,27871401009,2,1174,1751,-40
27874126174,27874126177,3,1227,1484,-40
27879349169,27879349176,7,3079,1337,-40
27880525159,27880525155,-4,884,224,-40
27880823397,27880823377,-20,931,440,-40
27883522478,27883522486,8,3684,895,-40
27886790924,27886790930,6,2436,737,-40
27895601203,27895601210,7,2100,911,-40
27897256122,27897256121,-1,974,1251,-40
27900448417,27900448422,5,2628,1163,-40
27903365826,27903365829,3,2403,1654,-40
27909285064,27909285071,7,1793,771,-40
27910184255,27910184261,6,3108,1470,-40
27911528566,27911528568,2,1128,366,-40
27911914294,27911914295,1,1639,1595,-40
27915749685,27915749692,7,2816,1451,-40
27915823949,27915823969,20,1269,633,-40
27916927235,27916927241,6,802,1242,-40
27919824542,27919824548,6,2038,1119,-40
27922828169,27922828174,5,1525,973,-40
27929145563,27929145569,6,1977,763,-40
27929469755,27929469736,-19,2707,1088,-40
27930824167,27930824173,6,2327,1434,-40
27935697521,27935697527,6,1526,1379,-40
27937715252,27937715259,7,3190,1533,-40
27938052166,27938052144,-22,3435,1749,-40
27944015129,27944015122,-7,1764,8609,-40
27950539181,27950539186,5,2696,958,-40
27954246714,27954246719,5,4107,2559,-40
27959916522,27959916528,6,2864,1161,-40
27961862801,27961862806,5,2356,1071,-40
27962535644,27962535650,6,3694,1423,-40
27963195745,27963195751,6,2006,1042,-40
27964966091,27964966097,6,2530,977,-40
27966993693,27966993698,5,2373,1310,-40
27967311812,27967311806,-6,1106,2800,-40
27975951370,27975951375,5,3280,990,-40
27976563301,27976563306,5,2877,1072,-40
27979855673,27979855680,7,4053,1757,-40
27983645355,27983645337,-18,1678,1408,-40
27986310433,27986310437,4,1777,1631,-40
27986449967,27986449946,-21,1863,828,-40
27991776254,27991776261,7,2787,1323,-40
27991943720,27991943706,-14,3007,860,-40
27992293433,27992293437,4,2453,1761,-40
27995317738,27995317746,8,2364,1622,-40
28001624958,28001624965,7,1871,1034,-40
28002355578,28002355584,6,2315,1333,-40
28008901613,28008901614,1,1892,1748,-40
28015065610,28015065615,5,2936,1838,-40
28017547317,28017547325,8,2348,1205,-40
28017946733,28017946739,6,3773,1876,-40
28019473413,28019473419,6,3547,1523,-40
28023473814,28023473823,9,3005,1485,-40
28029220362,28029220369,7,2572,950,-40
28030769909,28030769915,6,2944,948,-40
28038885293,28038885299,6,1989,1067,-40
28040365270,28040365276,6,2034,901,-40
28046680862,28046680868,6,4394,1321,-40
28048804877,28048804881,4,1324,1001,-40
28049397148,28049397146,-2,1236,2799,-40
28052172810,28052172815,5,1789,743,-40
28052533538,28052533545,7,3412,1377,-40
28053205578,28053205574,-4,1147,2185,-40
28056224866,28056224873,7,2287,1042,-40
28056592974,28056592979,5,2519,1276,-40
28057052428,28057052410,-18,3441,1410,-40
28060714900,28060714907,7,3380,1523,-40
28062036759,28062036767,8,4144,1306,-40
28063556745,28063556750,5,3453,1641,-40
28064574055,28064574061,6,4218,1746,-40
28064653969,28064653978,9,2621,1544,-40
28066476062,28066476069,7,3038,1415,-40
28066677314,28066677323,9,2412,768,-40
28067556737,28067556743,6,1802,898,-40
28069927158,28069927159,1,3375,2979,-40
28070870891,28070870898,7,2109,1461,-40
28075067212,28075067218,6,2279,1339,-40
28078145701,28078145703,2,1258,1182,-40
28086198479,28086198486,7,2088,934,-40
28086770742,28086770764,22,472,249,-40
28088973489,28088973490,1,2508,2093,-40
28092332183,28092332190,7,2850,1061,-40
28092391894,28092391875,-19,2948,1165,-40
28092584964,28092584969,5,2926,1595,-40
28092756703,28092756709,6,3084,1802,-40
28093981010,28093981015,5,3526,1526,-40
28095948997,28095948999,2,22951,31984,-40
28097190769,28097190775,6,3106,1203,-40
28097299335,28097299322,-13,2112,881,-40
28097650426,28097650431,5,3031,1105,-40
28097932139,28097932145,6,2609,1614,-40
28098129913,28098129918,5,3507,1520,-40
28101396594,28101396602,8,2341,1139,-40
28102657707,28102657714,7,2858,1792,-40
28105964094,28105964098,4,2204,1266,-40
28109348190,28109348195,5,2796,1768,-40
28110656127,28110656133,6,2181,1385,-40
28111308478,28111308484,6,3902,2738,-40
28112518111,28112518118,7,2362,1164,-40
28122520443,28122520450,7,2659,1272,-40
28126454825,28126454831,6,2699,1388,-40
28126993307,28126993306,-1,20916,8366,-40
28130636130,28130636137,7,1306,662,-40
28131031905,28131031911,6,3460,1249,-40
28132475126,28132475134,8,4079,1591,-40
28134361692,28134361698,6,3156,983,-40
28144360661,28144360661,0,1618,1881,-40
28144665517,28144665521,4,2499,1275,-40
28148152806,28148152810,4,2013,1401,-40
28152793502,28152793507,5,2516,1180,-40
28156728057,28156728062,5,2231,860,-40
28163517774,28163517778,4,1812,1093,-40
28166402901,28166402906,5,2683,1089,-40
28166778386,28166778385,-1,935,147,-40
28169710814,28169710819,5,3819,1222,-40
28171753853,28171753861,8,2371,1188,-40
28176118341,28176118349,8,2878,1335,-40
28177020905,28177020902,-3,1665,2863,-40
28178211229,28178211222,-7,3450,10617,-40
28181645930,28181645936,6,1956,1254,-40
28186098463,28186098469,6,2350,1380,-40
28188018952,28188018958,6,2412,980,-40
28190522152,28190522158,6,2383,1135,-40
28191392466,28191392473,7,2571,1358,-40
28199414453,28199414464,11,11613,43494,-40
28200273187,28200273193,6,2781,1405,-40
28203082394,28203082401,7,3157,1505,-40
28204274302,28204274307,5,2474,926,-40
28204620370,28204620373,3,1999,2042,-40
28205264782,28205264794,12,3352,1403,-40
28205366665,28205366673,8,3295,1153,-40
28205926186,28205926183,-3,1462,2857,-40
28212916469,28212916476,7,2897,907,-40
28213324765,28213324770,5,2311,1097,-40
28214191623,28214191617,-6,1873,6636,-40
28215768454,28215768459,5,1973,1231,-40
28215880437,28215880430,-7,1948,10079,-40
28215982001,28215982006,5,1914,847,-40
28224982358,28224982363,5,3132,1324,-40
28225311476,28225311483,7,2569,1445,-40
28226274342,28226274345,3,1490,1077,-40
28232959764,28232959770,6,3160,1544,-40
28235029418,28235029405,-13,1073,4900,-40
28236159844,28236159847,3,2037,1231,-40
28236300091,28236300073,-18,2106,998,-40
28236469367,28236469374,7,2570,1018,-40
28238109305,28238109310,5,2773,1209,-40
28241967164,28241967170,6,3180,1504,-40
28242233278,28242233257,-21,968,241,-40
28243082361,28243082366,5,3872,1021,-40
28244312693,28244312699,6,2031,1604,-40
28249615850,28249615857,7,3072,1619,-40
28252170113,28252170117,4,1252,996,-40
28253455021,28253455028,7,2596,1093,-40
28253989662,28253989667,5,3465,1278,-40
28255785285,28255785291,6,2476,798,-40
28256769613,28256769602,-11,1091,464,-40
28262186456,28262186462,6,2971,1139,-40
28262345374,28262345361,-13,1304,463,-40
28271079224,28271079228,4,2858,1330,-40
28272405882,28272405874,-8,645,159,-40
28273027299,28273027293,-6,833,10171,-40
28276050550,28276050557,7,2978,1313,-40
28279385544,28279385550,6,2446,1228,-40
28281270706,28281270712,6,3041,1227,-40
28281806195,28281806202,7,2274,1400,-40
28283295473,28283295478,5,2730,1309,-40
28284259097,28284259102,5,3708,1642,-40
28284318422,28284318423,1,1190,1768,-40
28284907258,28284907264,6,2854,1597,-40
28289503493,28289503499,6,2985,1029,-40
28289632838,28289632834,-4,1286,275,-40
28290626525,28290626505,-20,2478,946,-40
28292194972,28292194979,7,1999,1226,-40
28294158706,28294158712,6,4010,1910,-40
28294519609,28294519614,5,3936,1350,-40
28295556993,28295556998,5,111,5284,-40
28297762576,28297762582,6,2311,1362,-40
28298222916,28298222921,5,2077,951,-40
28298542498,28298542503,5,1879,1383,-40
28298655483,28298655491,8,1941,1075,-40
28300970790,28300970795,5,2826,1313,-40
28302643490,28302643496,6,3378,1515,-40
28308871547,28308871556,9,5154,1312,-40
28310987774,28310987772,-2,582,1376,-40
28317944928,28317944915,-13,1144,944,-40
28321327545,28321327548,3,15525,5053,-40
28325061830,28325061840,10,3647,1393,-40
28326257957,28326257964,7,2020,1303,-40
28333492353,28333492359,6,4610,1426,-40
28335241730,28335241738,8,3065,1031,-40
28338190793,28338190799,6,1650,1158,-40
28338639450,28338639459,9,2790,1421,-40
28339962082,28339962090,8,3778,961,-40
28340360621,28340360609,-12,940,304,-40
28341212690,28341212695,5,2316,1366,-40
28344355694,28344355701,7,3060,1162,-40
28345371305,28345371311,6,2819,1386,-40
28345608214,28345608220,6,2912,1591,-40
28347046875,28347046882,7,2853,1515,-40
28348184064,28348184071,7,4333,1182,-40
28351918255,28351918261,6,2283,1038,-40
28352268929,28352268934,5,3488,1191,-40
28352719877,28352719884,7,2276,952,-40
28354385197,28354385204,7,2857,1939,-40
28357198990,28357198997,7,3012,1395,-40
28358955538,28358955547,9,2404,1033,-40
28361236733,28361236738,5,2552,1149,-40
28365578272,28365578274,2,1784,1763,-40
28365728999,28365729003,4,1812,1204,-40
28367000332,28367000332,0,1123,145,-40
28374180365,28374180366,1,2205,2363,-40
28374378386,28374378393,7,2849,1584,-40
28375736549,28375736530,-19,1745,741,-40
28379151157,28379151163,6,1559,951,-40
28382618308,28382618314,6,3373,1316,-40
28386373750,28386373758,8,3865,1302,-40
28388323742,28388323750,8,4019,1181,-40
28388765775,28388765753,-22,1989,759,-40
28391586062,28391586069,7,4331,1259,-40
28393209757,28393209762,5,2314,1362,-40
28396835260,28396835267,7,1508,889,-40
28400182249,28400182254,5,2336,1019,-40
28400727763,28400727746,-17,1192,243,-40
28401036866,28401036872,6,3376,997,-40
28401231454,28401231444,-10,1064,343,-40
28402545390,28402545397,7,3280,1038,-40
28405411167,28405411169,2,1983,1220,-40
28405460612,28405460617,5,2382,854,-40
28405965933,28405965938,5,2413,766,-40
28412026921,28412026927,6,2846,1241,-40
28412954693,28412954700,7,3206,1551,-40
28414225337,28414225341,4,2670,1045,-40
28415015243,28415015251,8,2818,1499,-40
28417563948,28417563958,10,13022,41544,-40
28417898418,28417898423,5,2672,1368,-40
28418934558,28418934567,9,2946,1335,-40
28420357439,28420357445,6,3375,1148,-40
28421583170,28421583160,-10,1117,456,-40
28423394873,28423394874,1,1197,1037,-40
28428652761,28428652766,5,1494,1140,-40
28428755522,28428755508,-14,1024,1107,-40
28432787160,28432787167,7,2102,891,-40
28433598622,28433598629,7,2959,1406,-40
28434435022,28434435029,7,2008,1024,-40
28435370016,28435370020,4,1575,858,-40
28440098742,28440098749,7,2937,1623,-40
28441472643,28441472649,6,2065,1107,-40
28444108373,28444108379,6,2965,1310,-40
28447709558,28447709560,2,1993,1746,-40
28447936426,28447936435,9,3106,1399,-40
28449271098,28449271102,4,1732,1007,-40
28449408166,28449408163,-3,1285,156,-40
28449770198,28449770176,-22,519,200,-40
28452010951,28452010959,8,3198,1067,-40
28453606947,28453606946,-1,1052,1295,-40
28454637540,28454637545,5,3045,1250,-40
28457124096,28457124106,10,15294,25643,-40
28462277348,28462277349,1,4050,20527,-40
28467073209,28467073215,6,2493,1035,-40
28468845355,28468845361,6,2276,1648,-40
28477188806,28477188810,4,3002,1305,-40
28478021130,28478021137,7,2826,1495,-40
28482600657,28482600662,5,3259,1157,-40
28483195662,28483195666,4,2805,1153,-40
28485602387,28485602394,7,2341,1306,-40
28487221724,28487221729,5,1725,816,-40
28490804763,28490804770,7,5304,2567,-40
28495091429,28495091434,5,3201,1302,-40
28495640842,28495640849,7,2690,1326,-40
28496020477,28496020460,-17,3101,1365,-40
28497619655,28497619664,9,1108,283,-40
28500471703,28500471709,6,3237,1302,-40
28500875746,28500875751,5,3349,1096,-40
28524495498,28524495506,8,2984,1608,-40
28524977616,28524977621,5,2626,927,-40
28525738342,28525738345,3,1467,2,-40
28530193464,28530193471,7,4036,1067,-40
28531062838,28531062818,-20,2226,1118,-40
28535169943,28535169937,-6,2431,38758,-40
28536826442,28536826447,5,2838,1067,-40
28537365486,28537365494,8,2782,573,-40
28538186571,28538186554,-17,1086,641,-40
28539069493,28539069499,6,1613,881,-40
28545372219,28545372223,4,2139,1355,-40
28547312773,28547312779,6,3594,1376,-40
28550248074,28550248082,8,1758,779,-40
28555401358,28555401366,8,2898,1647,-40
28557409774,28557409782,8,3253,1770,-40
28559759679,28559759686,7,2422,1289,-40
28564383294,28564383301,7,3368,2003,-40
28564573450,28564573457,7,2675,1303,-40
28565844781,28565844787,6,2192,1227,-40
28567321729,28567321721,-8,891,232,-40
28567598421,28567598429,8,3025,1503,-40
28569148019,28569148026,7,3555,1290,-40
28570136194,28570136197,3,1600,1125,-40
28570589951,28570589957,6,3651,1360,-40
28570819626,28570819633,7,1803,341,-40
28577031591,28577031598,7,3038,1014,-40
28578550526,28578550530,4,2646,1415,-40
28578584003,28578584010,7,3515,1311,-40
28580816902,28580816908,6,3730,1072,-40
28581876498,28581876504,6,3242,1514,-40
28582049569,28582049569,0,1720,439,-40
28582262634,28582262642,8,2058,1514,-40
28582547101,28582547115,14,2386,1025,-40
28586012289,28586012297,8,2744,1133,-40
28586060914,28586060900,-14,4113,1716,-40
28587162858,28587162862,4,2162,1158,-40
28588312993,28588312999,6,2807,1252,-40
28588496625,28588496631,6,3500,1692,-40
28591253714,28591253720,6,3991,1871,-40
28591650006,28591650012,6,2563,977,-40
28592101596,28592101601,5,2290,1060,-40
28594036830,28594036835,5,2645,1078,-40
28594973689,28594973684,-5,1096,2337,-40
28597152213,28597152213,0,28771,34739,-40
28600173925,28600173931,6,3020,1537,-40
28603838192,28603838198,6,2289,1856,-40
28603989566,28603989567,1,1803,2170,-40
28606796840,28606796837,-3,956,1229,-40
28609531031,28609531036,5,2737,1970,-40
28617187029,28617187034,5,3511,906,-40
28617759797,28617759802,5,1976,1318,-40
28618389259,28618389264,5,2885,1297,-40
28618798390,28618798396,6,3609,1234,-40
28619196313,28619196319,6,2489,1066,-40
28620476959,28620476979,20,1176,192,-40
28621211263,28621211283,20,3439,1039,-40
28622516084,28622516090,6,2665,1027,-40
28629439614,28629439620,6,2458,1077,-40
28631508505,28631508512,7,2963,1013,-40
28632743154,28632743157,3,1230,1234,-40
28635917217,28635917222,5,3702,1804,-40
28636282098,28636282106,8,2295,1592,-40
28640153505,28640153511,6,2552,1494,-40
28641843134,28641843142,8,2511,865,-40
28644756274,28644756279,5,2005,1133,-40
28645947397,28645947404,7,3976,1624,-40
28647051428,28647051434,6,2171,890,-40
28650232957,28650232963,6,2830,1313,-40
28652480240,28652480246,6,2911,1848,-40
28657625831,28657625837,6,3835,1607,-40
28658493569,28658493574,5,1981,1237,-40
28658902007,28658902015,8,3081,1204,-40
28664790180,28664790186,6,2827,1058,-40
28666482458,28666482462,4,2671,1196,-40
28667865345,28667865350,5,1018,1181,-40
28668754529,28668754534,5,4236,1393,-40
28672630164,28672630169,5,3791,1792,-40
28678510089,28678510095,6,3778,1593,-40
28680377876,28680377883,7,2896,952,-40
28684087386,28684087393,7,2765,1342,-40
28684538401,28684538409,8,3927,1541,-40
28687747663,28687747660,-3,1275,1576,-40
28689647510,28689647518,8,2822,1088,-40
28691459601,28691459602,1,2023,1825,-40
28692010322,28692010329,7,2162,942,-40
28697954184,28697954190,6,3335,1201,-40
28705929755,28705929762,7,3363,1219,-40
28706240916,28706240923,7,3656,962,-40
28707621559,28707621567,8,3101,1990,-40
28716065709,28716065716,7,3915,1446,-40
28718038526,28718038504,-22,1104,358,-40
28718885694,28718885701,7,3164,1349,-40
28719587509,28719587515,6,1691,860,-40
28721167046,28721167053,7,3931,1512,-40
28724967553,28724967559,6,2820,1242,-40
28732153876,28732153881,5,2257,1077,-40
28734195729,28734195735,6,2360,1196,-40
28734347306,28734347289,-17,804,352,-40
28734731293,28734731299,6,2503,1550,-40
28735127329,28735127335,6,3325,1780,-40
28741037473,28741037474,1,1599,1413,-40
28744239552,28744239560,8,3122,1384,-40
28745945256,28745945262,6,2124,1072,-40
28749371723,28749371729,6,3223,1100,-40
28753148657,28753148638,-19,2938,1089,-40
28756200915,28756200922,7,2440,1208,-40
28756959271,28756959251,-20,1925,897,-40
28761572887,28761572893,6,2756,1230,-40
28768472319,28768472322,3,2151,1274,-40
28769351267,28769351266,-1,1729,3514,-40
28771878405,28771878404,-1,22289,8371,-40
28772247529,28772247547,18,602,355,-40
28772577472,28772577494,22,207,1356,-40
28773724526,28773724532,6,2349,805,-40
28781814519,28781814526,7,3126,1428,-40
28782282497,28782282505,8,2420,1272,-40
28782869515,28782869521,6,2447,1205,-40
28786515137,28786515143,6,3208,1647,-40
28786793758,28786793766,8,3454,1421,-40
28790282053,28790282048,-5,1237,3347,-40
28797788778,28797788779,1,1322,1574,-40
28798967125,28798967123,-2,1357,2117,-40
28801513171,28801513177,6,2374,948,-40
28802041610,28802041602,-8,2642,11425,-40
28808631767,28808631774,7,2885,1174,-40
28809322153,28809322159,6,2844,1176,-40
28809674223,28809674228,5,1997,1247,-40
28810061883,28810061890,7,2865,1574,-40
28812808221,28812808226,5,3872,1412,-40
28813891029,28813891035,6,2523,1142,-40
28814410681,28814410686,5,3616,1192,-40
28815434222,28815434226,4,1656,1846,-40
28816780809,28816780813,4,1905,1062,-40
28817024064,28817024049,-15,1249,305,-40
28817898761,28817898768,7,2445,1584,-40
28818877319,28818877326,7,3163,1345,-40
28819130790,28819130797,7,3447,1215,-40
28820808126,28820808130,4,2234,1206,-40
28821726931,28821726937,6,3282,1183,-40
28824920850,28824920855,5,2027,922,-40
28825230806,28825230812,6,2945,1412,-40
28826431526,28826431506,-20,1816,1113,-40
28828512627,28828512637,10,4007,1620,-40
28828855178,28828855183,5,2483,1219,-40
28834363434,28834363415,-19,1572,449,-40
28837101846,28837101852,6,5948,2799,-40
28840630749,28840630755,6,2082,1411,-40
28844395263,28844395278,15,1217,2017,-40
28850400740,28850400746,6,3079,1268,-40
28850863640,28850863647,7,2719,1122,-40
28857570509,28857570516,7,2947,1656,-40
28859173434,28859173435,1,1214,221,-40
28859858317,28859858324,7,2918,989,-40
28861501385,28861501393,8,2233,1402,-40
28861558594,28861558599,5,2858,976,-40
28862690389,28862690395,6,3294,1437,-40
28863088493,28863088499,6,2609,1254,-40
28864146062,28864146069,7,3187,1481,-40
28865039307,28865039314,7,2239,912,-40
28868308204,28868308209,5,2151,1555,-40
28868348338,28868348342,4,2780,1198,-40
28869464891,28869464897,6,2462,1126,-40
28869979310,28869979290,-20,1470,350,-40
28870029696,28870029703,7,2960,1341,-40
28870078074,28870078078,4,2912,1669,-40
28870164688,28870164692,4,896,163,-40
28871974924,28871974931,7,3502,1436,-40
28875468047,28875468054,7,2852,1256,-40
28875847571,28875847578,7,3985,1250,-40
28880147292,28880147298,6,3319,1371,-40
28881186289,28881186295,6,2792,1164,-40
28881384428,28881384435,7,4414,1677,-40
28881582446,28881582453,7,3538,1380,-40
28882270711,28882270715,4,998,974,-40
28894865935,28894865942,7,3245,1226,-40
28895206031,28895206042,11,821,198,-40
28895606458,28895606463,5,3239,1281,-40
28896245940,28896245945,5,2766,1340,-40
28896906514,28896906499,-15,3022,1265,-40
28901790075,28901790078,3,3900,2866,-40
28907413059,28907413065,6,2475,1198,-40
28917188131,28917188138,7,3245,1248,-40
28917406450,28917406459,9,1984,1036,-40
28928693609,28928693615,6,2724,1010,-40
28929912298,28929912306,8,2552,1282,-40
28932026818,28932026822,4,2231,1045,-40
28933788973,28933788966,-7,1098,4224,-40
28935137867,28935137862,-5,5766,2228,-40
28941845291,28941845297,6,1935,1084,-40
28942567135,28942567142,7,4519,1585,-40
28943742162,28943742166,4,3033,1397,-40
28944256621,28944256630,9,2873,1450,-40
28955411028,28955411033,5,2601,1330,-40
28955712037,28955712019,-18,1871,436,-40
28956330257,28956330263,6,2352,1032,-40
28958355321,28958355329,8,2587,727,-40
28959839014,28959839021,7,1656,827,-40
28964872397,28964872399,2,1406,1379,-40
28965608856,28965608863,7,3820,1168,-40
28968277277,28968277282,5,2221,1316,-40
28969678678,28969678666,-12,1214,395,-40
28974370356,28974370362,6,2801,990,-40
28975234814,28975234819,5,2518,1236,-40
28976689653,28976689657,4,1922,1237,-40
28976914461,28976914458,-3,1213,2576,-40
28978652288,28978652294,6,2479,1191,-40
28980923602,28980923608,6,3816,1581,-40
28987519906,28987519913,7,3953,1294,-40
28995764191,28995764197,6,2851,1500,-40
29000615602,29000615608,6,2858,1196,-40
29000948638,29000948658,20,1900,1325,-40
29001485261,29001485267,6,2129,1152,-40
29003373197,29003373205,8,2269,983,-40
29004111182,29004111187,5,3924,1488,-40
29004441137,29004441146,9,2491,1149,-40
29004490177,29004490179,2,2755,1809,-40
29006245435,29006245442,7,3270,1284,-40
29009448633,29009448638,5,1416,1612,-40
29020381634,29020381641,7,2254,1027,-40
29021784830,29021784836,6,2466,984,-40
29027128518,29027128522,4,3009,1390,-40
29031859786,29031859791,5,2060,900,-40
29035520634,29035520640,6,2974,1921,-40
29036549017,29036549023,6,3155,1342,-40
29044402419,29044402426,7,2820,1237,-40
29046395527,29046395531,4,1900,1185,-40
29051392490,29051392492,2,1637,1241,-40
29052676655,29052676662,7,6164,3390,-40
29057399638,29057399633,-5,1811,4837,-40
29058440225,29058440230,5,3041,1307,-40
29065135289,29065135288,-1,1385,2354,-40
29068192522,29068192530,8,2623,1147,-40
29069304029,29069304033,4,3093,1489,-40
29070667297,29070667302,5,2419,1674,-40
29073624781,29073624786,5,3591,1387,-40
29073685547,29073685530,-17,3128,1098,-40
29074199857,29074199863,6,1200,308,-40
29074887125,29074887130,5,2999,1663,-40
29076426390,29076426396,6,3264,1481,-40
29080978839,29080978845,6,2259,1268,-40
29082331403,29082331409,6,1765,1022,-40
29086717563,29086717557,-6,2162,5375,-40
29090642933,29090642939,6,4049,1636,-40
29092797734,29092797720,-14,751,221,-40
29094596085,29094596091,6,3769,1302,-40
29096786297,29096786303,6,3026,1506,-40
29097653787,29097653783,-4,720,2798,-40
29100258799,29100258805,6,13251,7895,-40
29103160798,29103160805,7,2586,1174,-40
29104230006,29104230013,7,3535,1519,-40
29104524433,29104524420,-13,860,404,-40
29113412862,29113412866,4,3229,1213,-40
29114150286,29114150282,-4,1301,2090,-40
29122072031,29122072022,-9,1297,31409,-40
29129890480,29129890486,6,75,1811,-40
29137932390,29137932397,7,2360,1236,-40
29140327806,29140327810,4,3219,1210,-40
29140786795,29140786802,7,3546,1637,-40
29143926511,29143926490,-21,1699,1498,-40
29147189693,29147189695,2,1853,2297,-40
29147965829,29147965834,5,2328,1227,-40
29149224137,29149224143,6,3641,1620,-40
29149620938,29149620944,6,2653,1340,-40
29150472626,29150472634,8,4268,1357,-40
29151264817,29151264829,12,4181,1283,-40
29151682546,29151682551,5,1694,798,-40
29152371277,29152371280,3,1180,723,-40
29153385857,29153385862,5,2011,1063,-40
29153556573,29153556579,6,1946,1057,-40
29156404714,29156404722,8,2465,1573,-40
29158572850,29158572854,4,2513,1085,-40
29163330299,29163330307,8,3519,1250,-40
29164045170,29164045175,5,2769,1582,-40
29165665106,29165665113,7,3267,1450,-40
29165766766,29165766755,-11,3028,909,-40
29166340244,29166340250,6,2745,1654,-40
29166462010,29166462014,4,2128,1052,-40
29173293365,29173293373,8,2908,1582,-40
29173439691,29173439698,7,3063,898,-40
29174196728,29174196734,6,3140,1294,-40
29174656262,29174656269,7,4363,1469,-40
29174740069,29174740048,-21,845,514,-40
29177288843,29177288850,7,2614,941,-40
29178289757,29178289761,4,3671,1442,-40
29180052803,29180052809,6,2361,1165,-40
29180687602,29180687609,7,3370,1833,-40
29181185968,29181185966,-2,1017,2232,-40
29184734339,29184734343,4,1370,1101,-40
29185506134,29185506154,20,1458,618,-40
29188853648,29188853652,4,1970,1530,-40
29191861303,29191861309,6,2554,1653,-40
29193076492,29193076498,6,4158,1221,-40
29194069349,29194069356,7,3908,1873,-40
29194736114,29194736121,7,4363,1467,-40
29196440721,29196440727,6,2754,744,-40
29197821778,29197821785,7,7976,4153,-40
29204459742,29204459749,7,1844,1023,-40
29210437343,29210437347,4,1167,690,-40
29211362623,29211362629,6,2557,1511,-40
29213281524,29213281530,6,3579,1498,-40
29223314429,29223314437,8,3547,1388,-40
29230891669,29230891672,3,3877,3983,-40
29233224614,29233224619,5,30320,24177,-40
29236010859,29236010866,7,2906,1091,-40
29236670802,29236670807,5,1266,759,-40
29237585890,29237585897,7,2272,954,-40
29239437377,29239437384,7,2245,1403,-40
29239995253,29239995258,5,2859,1618,-40
29243415984,29243415989,5,2832,1206,-40
29244992036,29244992042,6,2656,1440,-40
29246020407,29246020406,-1,1496,1823,-40
29252599606,29252599612,6,2793,1499,-40
29252961651,29252961655,4,2641,1052,-40
29255605707,29255605716,9,3049,1409,-40
29266145881,29266145887,6,2423,1109,-40
29269594173,29269594178,5,2060,904,-40
29270502903,29270502889,-14,3137,1118,-40
29270532466,29270532472,6,3508,1898,-40
29270724485,29270724488,3,1560,1627,-40
29271520340,29271520348,8,2701,1241,-40
29272821477,29272821485,8,4114,1727,-40
29273692142,29273692147,5,2967,1045,-40
29273889085,29273889091,6,1415,846,-40
29274015086,29274015078,-8,1042,4269,-40
29276582870,29276582870,0,1620,1580,-40
29278765314,29278765321,7,2500,1251,-40
29280970367,29280970374,7,2367,993,-40
29283614094,29283614101,7,3488,1206,-40
29286747189,29286747198,9,3225,1149,-40
29287948216,29287948223,7,2974,1547,-40
29288157774,29288157781,7,3398,1088,-40
29288197659,29288197642,-17,2711,1139,-40
29288692407,29288692414,7,3513,1324,-40
29288860156,29288860162,6,2423,1139,-40
29291457285,29291457283,-2,1520,3542,-40
29292761938,29292761945,7,3726,1487,-40
29294554946,29294554945,-1,1734,2540,-40
29296138603,29296138611,8,2615,1239,-40
29296286009,29296285994,-15,637,335,-40
29298328191,29298328198,7,1155,363,-40
29307031800,29307031806,6,2177,1494,-40
29309500022,29309500026,4,1894,1901,-40
29310375930,29310375937,7,3200,1292,-40
29314497826,29314497832,6,3166,1261,-40
29314997253,29314997261,8,1908,1140,-40
29319680397,29319680403,6,3975,1600,-40
29321001617,29321001623,6,1202,546,-40
29324898304,29324898310,6,2797,954,-40
29326751069,29326751073,4,2799,1561,-40
29326964330,29326964313,-17,1943,872,-40
29328340830,29328340834,4,2110,1049,-40
29330449795,29330449780,-15,1242,1357,-40
29331451211,29331451218,7,3034,1137,-40
29332157581,29332157561,-20,867,491,-40
29333131353,29333131359,6,2681,931,-40
29335166601,29335166618,17,2573,1160,-40
29339067116,29339067117,1,1426,1346,-40
29339896630,29339896637,7,2633,936,-40
29340459858,29340459842,-16,2606,902,-40
29341109789,29341109794,5,2225,1004,-40
29341151777,29341151784,7,1937,1060,-40
29341218860,29341218866,6,2023,1217,-40
29342428654,29342428638,-16,101,812,-40
29344093538,29344093545,7,2513,1085,-40
29346334833,29346334841,8,2959,1206,-40
29347078725,29347078731,6,2332,1206,-40
29347144261,29347144267,6,2930,1197,-40
29347508879,29347508885,6,2554,1316,-40
29352243577,29352243581,4,2739,1453,-40
29352867863,29352867869,6,3498,861,-40
29359161775,29359161781,6,4021,1862,-40
29363085789,29363085795,6,3471,1072,-40
29368145077,29368145082,5,2926,1352,-40
29368504987,29368504982,-5,1514,6113,-40
29371027693,29371027698,5,2753,1016,-40
29376268821,29376268827,6,3997,1554,-40
29379955693,29379955699,6,1831,830,-40
29380123906,29380123905,-1,1656,1808,-40
29380719674,29380719655,-19,1023,818,-40
29382807969,29382807971,2,1372,1297,-40
29385838330,29385838337,7,1346,966,-40
29386515523,29386515527,4,2403,1200,-40
29389740241,29389740246,5,3089,1167,-40
29390705122,29390705127,5,3007,1476,-40
29396265249,29396265255,6,2158,1059,-40
29397145924,29397145931,7,3858,1065,-40
29399450125,29399450132,7,3178,1310,-40
29400115858,29400115863,5,2533,1210,-40
29401335932,29401335938,6,2408,846,-40
29403901247,29403901253,6,2754,1050,-40
29404960966,29404960974,8,2310,1433,-40
29406233901,29406233906,5,2391,1464,-40
29406868387,29406868393,6,2504,1561,-40
29409847569,29409847575,6,1776,1346,-40
29412076969,29412076965,-4,1395,1657,-40
29413126651,29413126657,6,3303,988,-40
29414753010,29414753012,2,3803,3403,-40
29415179014,29415179022,8,1944,1087,-40
29418271793,29418271799,6,1455,1084,-40
29421936630,29421936637,7,2474,1035,-40
29430204133,29430204141,8,12517,24298,-40
29430256642,29430256643,1,1094,1376,-40
29431395278,29431395287,9,3195,1358,-40
29436124203,29436124209,6,3656,1763,-40
29436239127,29436239128,1,1908,2141,-40
29437137803,29437137811,8,3259,1174,-40
29437280099,29437280106,7,1945,1059,-40
29439451382,29439451388,6,1190,709,-40
29440518966,29440518974,8,2763,1184,-40
29441806782,29441806791,9,2274,1218,-40
29441976894,29441976873,-21,2293,779,-40
29442103393,29442103398,5,3377,1648,-40
29448800818,29448800825,7,3385,1090,-40
29451480509,29451480516,7,2590,1186,-40
29453374569,29453374575,6,1923,953,-40
29460833928,29460833934,6,3132,972,-40
29464792504,29464792510,6,1586,1005,-40
29465782871,29465782879,8,3970,1205,-40
29474925399,29474925398,-1,1212,1520,-40
29480785009,29480785016,7,2324,1357,-40
29485682791,29485682797,6,3275,1273,-40
29488587709,29488587716,7,2204,1288,-40
29490651597,29490651602,5,2163,1405,-40
29490729103,29490729099,-4,968,197,-40
29495814983,29495814991,8,3003,1646,-40
29496328821,29496328803,-18,1098,515,-40
29497153014,29497153019,5,3404,1391,-40
29497680686,29497680682,-4,1211,2144,-40
29499828021,29499828026,5,2502,1474,-40
29499858716,29499858723,7,3134,975,-40
29505723574,29505723582,8,3007,1044,-40
29506374972,29506374979,7,3401,1096,-40
29507043646,29507043651,5,2599,1418,-40
29509777014,29509777022,8,3071,1645,-40
29510769369,29510769375,6,2855,1681,-40
29513557120,29513557125,5,4422,1798,-40
29514964795,29514964801,6,3180,1404,-40
29515091850,29515091833,-17,3368,1291,-40
29515662390,29515662398,8,2065,1075,-40
29519364493,29519364498,5,3358,1317,-40
29524154250,29524154257,7,2459,1298,-40
29524404679,29524404686,7,3110,1151,-40
29525265442,29525265449,7,2969,1218,-40
29527782975,29527782976,1,1401,439,-40
29527837366,29527837385,19,3222,1404,-40
29528799911,29528799917,6,2344,1309,-40
29531431986,29531431993,7,4233,1711,-40
29532024297,29532024303,6,2307,787,-40
29532550611,29532550595,-16,1018,291,-40
29533303515,29533303522,7,2876,731,-40
29533456174,29533456185,11,1051,270,-40
29534695909,29534695917,8,3401,1126,-40
29534797702,29534797696,-6,1119,230,-40
29540044214,29540044221,7,2553,998,-40
29543672346,29543672352,6,2486,1389,-40
29544451396,29544451399,3,1852,1360,-40
29546975395,29546975401,6,2913,1480,-40
29547033185,29547033179,-6,2502,9621,-40
29547134288,29547134295,7,1694,1370,-40
29547194174,29547194177,3,1717,1904,-40
29547879813,29547879819,6,2785,1158,-40
29549959998,29549960005,7,2889,1285,-40
29553292651,29553292657,6,1484,897,-40
29557113417,29557113423,6,3059,1135,-40
29560985454,29560985460,6,3428,919,-40
29561432859,29561432842,-17,1511,429,-40
29562678985,29562678990,5,2842,1039,-40
29569280863,29569280865,2,1089,2690,-40
29572811594,29572811600,6,3292,1248,-40
29576390685,29576390689,4,2071,1200,-40
29577886512,29577886507,-5,649,1332,-40
29580312888,29580312882,-6,2017,7377,-40
29580944286,29580944289,3,2133,2110,-40
29582872135,29582872141,6,2791,1128,-40
29584545262,29584545265,3,1403,1038,-40
29588142908,29588142914,6,2321,1323,-40
29591149501,29591149510,9,3444,1210,-40
29592798094,29592798101,7,2421,1448,-40
29594868635,29594868641,6,3391,1549,-40
29595684585,29595684568,-17,784,246,-40
29595810939,29595810947,8,2238,980,-40
29596796233,29596796238,5,3252,1156,-40
29598846497,29598846504,7,2934,1117,-40
29598975183,29598975168,-15,991,501,-40
29599189301,29599189309,8,3013,1437,-40
29599644805,29599644812,7,3374,1212,-40
29601252892,29601252898,6,3254,1048,-40
29601654265,29601654248,-17,1466,410,-40
29610055920,29610055927,7,1951,781,-40
29610827621,29610827628,7,4187,1455,-40
29611431257,29611431262,5,1548,760,-40
29611594226,29611594243,17,2454,1019,-40
29620135670,29620135676,6,3532,1256,-40
29621565190,29621565197,7,3264,1303,-40
29622282082,29622282089,7,1950,1362,-40
29622929746,29622929730,-16,2785,1524,-40
29623015646,29623015643,-3,917,353,-40
29630247898,29630247905,7,1984,1021,-40
29630656946,29630656951,5,3630,1435,-40
29632736379,29632736386,7,3884,1463,-40
29636451444,29636451449,5,1906,1316,-40
29636935559,29636935565,6,1888,1368,-40
29638966141,29638966147,6,1470,791,-40
29643785689,29643785694,5,2278,996,-40
29644497918,29644497922,4,2656,1132,-40
29647632431,29647632436,5,1820,1190,-40
29653947443,29653947449,6,3037,2050,-40
29654983552,29654983554,2,5618,56260,-40
29656419254,29656419259,5,1417,954,-40
29659304941,29659304946,5,3100,1375,-40
29659828942,29659828949,7,3678,1337,-40
29662979476,29662979482,6,3651,1822,-40
29666078195,29666078201,6,1918,964,-40
29666207167,29666207155,-12,820,115,-40
29666806083,29666806090,7,4378,1291,-40
29670752810,29670752815,5,2328,1264,-40
29671967613,29671967618,5,1409,828,-40
29674386554,29674386536,-18,1080,422,-40
29676522865,29676522866,1,2260,1488,-40
29678782053,29678782061,8,2874,1180,-40
29680361507,29680361513,6,2256,1018,-40
29684419271,29684419274,3,2143,863,-40
29688168226,29688168233,7,2567,1354,-40
29688870742,29688870747,5,3437,1317,-40
29690567138,29690567122,-16,666,110,-40
29691998428,29691998445,17,14929,31702,-40
29699821074,29699821081,7,1877,801,-40
29701746565,29701746569,4,2217,941,-40
29702955570,29702955578,8,3241,1310,-40
29703940456,29703940463,7,2951,1043,-40
29706178020,29706178022,2,1823,1299,-40
29711085514,29711085529,15,615,3968,-40
29712250794,29712250800,6,2754,1343,-40
29712555006,29712555011,5,2563,1131,-40
29714584294,29714584300,6,3761,2007,-40
29715891001,29715891007,6,3014,1441,-40
29719087521,29719087526,5,1814,1134,-40
29719595814,29719595818,4,2542,1063,-40
29720777888,29720777894,6,3137,1126,-40
29724321685,29724321693,8,2208,1151,-40
29725866602,29725866602,0,1520,2158,-40
29726872381,29726872385,4,2172,1227,-40
29729014866,29729014866,0,1315,703,-40
29729604642,29729604649,7,2915,1338,-40
29729665721,29729665726,5,2449,1180,-40
29731374953,29731374959,6,2892,896,-40
29732520713,29732520719,6,3700,1068,-40
29733907810,29733907818,8,1849,882,-40
29736225894,29736225901,7,2637,1311,-40
29737956240,29737956245,5,2873,1504,-40
29740016567,29740016573,6,2532,960,-40
29745486272,29745486279,7,2598,1172,-40
29746090163,29746090169,6,3170,1493,-40
29746133175,29746133152,-23,1194,480,-40
29748373891,29748373899,8,2755,1412,-40
29750908411,29750908417,6,3442,1234,-40
29751982917,29751982922,5,2596,1613,-40
29753730408,29753730413,5,3215,2009,-40
29755246178,29755246181,3,2166,1350,-40
29760665826,29760665832,6,3673,1127,-40
29761299541,29761299552,11,795,254,-40
29764121235,29764121243,8,2752,1263,-40
29767587267,29767587273,6,2711,1126,-40
29767852119,29767852118,-1,133,1150,-40
29769265245,29769265251,6,2132,947,-40
29769521278,29769521258,-20,834,420,-40
29771307557,29771307564,7,1390,776,-40
29779094546,29779094553,7,2931,1202,-40
29780554334,29780554354,20,2120,1154,-40
29780915138,29780915146,8,3968,1105,-40
29786568861,29786568865,4,3381,1558,-40
29787760089,29787760095,6,4160,1493,-40
29789274448,29789274454,6,2532,1198,-40
29789305129,29789305135,6,4239,1418,-40
29789777657,29789777663,6,2237,997,-40
29790044110,29790044117,7,2726,1294,-40
29790091486,29790091464,-22,1425,552,-40
29791639162,29791639170,8,2120,985,-40
29794381024,29794381030,6,3055,944,-40
29798524211,29798524214,3,1229,1075,-40
29803514340,29803514346,6,2173,1023,-40
29804656405,29804656410,5,2654,1296,-40
29806329866,29806329873,7,2755,969,-40
29807897121,29807897129,8,2997,2323,-40
29816702931,29816702937,6,2932,1691,-40
29824292601,29824292606,5,2286,778,-40
29825346914,29825346921,7,2444,1277,-40
29825943649,29825943655,6,3125,1046,-40
29827938416,29827938423,7,4141,1541,-40
29836590155,29836590161,6,2185,1412,-40
29836794454,29836794472,18,905,220,-40
29837372861,29837372866,5,2469,1303,-40
29840211058,29840211065,7,2484,955,-40
29846488113,29846488118,5,2377,1337,-40
29850581740,29850581746,6,2263,1157,-40
29853571334,29853571332,-2,1842,1921,-40
29856627054,29856627051,-3,811,1738,-40
29856990181,29856990186,5,2900,1184,-40
29860286444,29860286448,4,1999,1237,-40
29862345774,29862345779,5,1456,1539,-40
29862563595,29862563598,3,1712,1019,-40
29862896738,29862896742,4,2133,1524,-40
29867438893,29867438899,6,2369,862,-40
29867520177,29867520184,7,1003,221,-40
29870631199,29870631205,6,2465,1055,-40
29872354249,29872354255,6,1953,1093,-40
29873710091,29873710098,7,3194,1625,-40
29877204041,29877204046,5,3156,1468,-40
29883099063,29883099068,5,3000,1364,-40
29886753621,29886753626,5,2824,1453,-40
29886893943,29886893953,10,914,214,-40
29891920678,29891920683,5,2915,1745,-40
29893417723,29893417730,7,2914,1625,-40
29894385978,29894385974,-4,1772,5544,-40
29894885067,29894885071,4,1755,1160,-40
29896227539,29896227547,8,3943,1019,-40
29897613606,29897613611,5,1636,898,-40
29899831925,29899831932,7,4543,1822,-40
29907165939,29907165944,5,2209,1033,-40
29910748290,29910748297,7,4502,1370,-40
29911579505,29911579513,8,3323,1525,-40
29917297294,29917297299,5,1693,1289,-40
29922667373,29922667379,6,2342,1386,-40
29924143252,29924143258,6,2720,1929,-40
29930527254,29930527261,7,3125,1269,-40
29935930425,29935930433,8,3651,1343,-40
29938124194,29938124202,8,2989,965,-40
29939227243,29939227250,7,3564,1561,-40
29939639322,29939639307,-15,2676,1240,-40
29941240546,29941240553,7,2761,1223,-40
29942635322,29942635329,7,2637,1118,-40
29947306549,29947306555,6,2222,982,-40
29947408305,29947408291,-14,2470,1373,-40
29948296572,29948296573,1,2397,837,-40
29953137418,29953137397,-21,2015,1129,-40
29956158074,29956158078,4,3125,1246,-40
29956411269,29956411274,5,1906,1172,-40
29957857440,29957857447,7,3153,1318,-40
29959225223,29959225228,5,2097,1239,-40
29959572143,29959572150,7,2035,1078,-40
29965416911,29965416917,6,2718,1385,-40
29965458933,29965458937,4,1222,171,-40
29965709950,29965709957,7,2600,1448,-40
29967209106,29967209113,7,2071,1758,-40
29971499406,29971499413,7,2466,1212,-40
29971773635,29971773638,3,2364,1112,-40
29974821881,29974821886,5,2485,1276,-40
29975702382,29975702388,6,3721,1668,-40
29976654132,29976654139,7,2685,1368,-40
29982499991,29982499998,7,3898,1581,-40
29983869385,29983869390,5,1431,1257,-40
29984599774,29984599781,7,2624,815,-40
29984644334,29984644344,10,3046,1087,-40
29986463604,29986463609,5,2997,1725,-40
29987920111,29987920117,6,2552,1299,-40
29988826530,29988826534,4,3105,1411,-40
29988969374,29988969356,-18,3504,1239,-40
29992062708,29992062714,6,2841,1566,-40
29996887225,29996887231,6,2260,1083,-40
30002711519,30002711525,6,3296,1830,-40
30004506618,30004506624,6,2057,1367,-40
30005199002,30005199003,1,2095,2432,-40
30008311339,30008311346,7,3411,1531,-40
30009639132,30009639139,7,3172,1238,-40
30010315005,30010315013,8,3737,1213,-40
30018337871,30018337879,8,1449,1057,-40
30018364190,30018364200,10,886,291,-40
30019482130,30019482136,6,2023,1306,-40
30020195690,30020195694,4,2407,1353,-40
30022677549,30022677546,-3,2345,3098,-40
30024652166,30024652174,8,2947,1216,-40
30025327244,30025327250,6,3505,1515,-40
30026286268,30026286275,7,3206,1859,-40
30026708915,30026708921,6,2629,1481,-40
30035930997,30035931002,5,2004,1482,-40
30038359600,30038359607,7,2902,1434,-40
30041314717,30041314724,7,4014,2025,-40
30044181010,30044181015,5,3152,893,-40
30045936569,30045936575,6,2559,1176,-40
30047135271,30047135252,-19,977,829,-40
30047532398,30047532404,6,2727,1463,-40
30054612399,30054612406,7,2428,1245,-40
30055841787,30055841794,7,2107,975,-40
30055942727,30055942713,-14,632,242,-40
30058632922,30058632929,7,2947,1329,-40
30058958028,30058958008,-20,2226,875,-40
30063035819,30063035824,5,2766,1226,-40
30064865269,30064865274,5,2841,1265,-40
30065540839,30065540846,7,3469,894,-40
30066181324,30066181330,6,3190,1186,-40
30067045093,30067045101,8,3448,932,-40
30069698457,30069698437,-20,1311,580,-40
30070671806,30070671813,7,2873,1410,-40
30071321670,30071321658,-12,718,291,-40
30075933267,30075933274,7,1119,566,-40
30077134518,30077134527,9,2184,549,-40
30077566057,30077566063,6,2905,1423,-40
30077834273,30077834278,5,2690,1002,-40
30080553167,30080553166,-1,1584,1974,-40
30085549533,30085549538,5,1907,1199,-40
30087290109,30087290110,1,1534,2083,-40
30087939727,30087939734,7,4705,1491,-40
30092724294,30092724294,0,5167,8216,-40
30097447940,30097447947,7,2570,967,-40
30100379338,30100379346,8,2318,1269,-40
30100548862,30100548870,8,2223,1191,-40
30102235735,30102235738,3,1591,1180,-40
30103402202,30103402207,5,2551,1167,-40
30107641405,30107641401,-4,1850,5868,-40
30108107619,30108107623,4,2401,1360,-40
30111861226,30111861233,7,3307,1068,-40
30115002085,30115002091,6,3241,1336,-40
30119658945,30119658950,5,2573,1613,-40
30119800422,30119800428,6,3117,996,-40
30121499119,30121499127,8,1323,574,-40
30123360631,30123360628,-3,34282,2133,-40
30125774533,30125774539,6,2648,898,-40
30125821736,30125821742,6,3506,1581,-40
30129042284,30129042291,7,2817,1163,-40
30131538833,30131538839,6,3044,1441,-40
30132067195,30132067201,6,3511,1611,-40
30132409553,30132409561,8,3265,1422,-40
30137899803,30137899806,3,2072,1053,-40
30138591171,30138591174,3,2265,2379,-40
30142028566,30142028552,-14,1223,279,-40
30144377045,30144377051,6,2298,924,-40
30145343873,30145343878,5,2964,1269,-40
30153939800,30153939805,5,3327,1600,-40
30154068910,30154068915,5,2695,991,-40
30157951193,30157951200,7,2062,1152,-40
30158760230,30158760230,0,2844,4029,-40
30169890828,30169890835,7,3073,1066,-40
30170525227,30170525234,7,3458,1161,-40
30174283498,30174283503,5,2927,1059,-40
30174689753,30174689758,5,3071,697,-40
30186491795,30186491802,7,2482,1232,-40
30188218768,30188218777,9,23149,50251,-40
30190324073,30190324081,8,3832,1592,-40
30190758735,30190758744,9,888,292,-40
30191482714,30191482717,3,2944,2267,-40
30194034449,30194034454,5,2620,984,-40
30196035393,30196035395,2,35674,31330,-40
30196251397,30196251404,7,2980,1427,-40
30196342349,30196342354,5,2973,1017,-40
30196376842,30196376851,9,14279,26235,-40
30198030274,30198030277,3,4001,3614,-40
30199374434,30199374440,6,1715,1009,-40
30199481695,30199481699,4,694,551,-40
30200246772,30200246779,7,3247,1160,-40
30201759810,30201759810,0,1117,2278,-40
30203815661,30203815667,6,2334,1231,-40
30204273537,30204273542,5,2476,1333,-40
30204367417,30204367400,-17,3609,1968,-40
30204485706,30204485714,8,3161,1494,-40
30204977762,30204977768,6,1583,1145,-40
30210169694,30210169702,8,3564,1605,-40
30211533759,30211533766,7,2553,1193,-40
30213491278,30213491285,7,3095,1270,-40
30218979538,30218979543,5,2740,1512,-40
30219113801,30219113807,6,2245,1119,-40
30219491071,30219491056,-15,3108,1382,-40
30224832759,30224832762,3,39145,9541,-40
30227377925,30227377930,5,3047,1186,-40
30228342981,30228342995,14,2244,1055,-40
30231169025,30231169030,5,4157,1408,-40
30231560073,30231560064,-9,52137,17196,-40
30235670674,30235670681,7,3011,1099,-40
30235791483,30235791489,6,2564,1042,-40
30237183106,30237183101,-5,1885,6146,-40
30239497042,30239497047,5,2822,956,-40
30241391837,30241391844,7,2777,1198,-40
30246682546,30246682551,5,1921,827,-40
30248650418,30248650423,5,1889,1089,-40
30250368315,30250368321,6,2761,1428,-40
30251041653,30251041659,6,2136,1048,-40
30253157250,30253157255,5,3840,1894,-40
30256881035,30256881041,6,2299,856,-40
30260119104,30260119111,7,3209,1010,-40
30261724291,30261724298,7,2142,1019,-40
30262151854,30262151861,7,3824,1430,-40
30263275401,30263275405,4,2894,1487,-40
30264271605,30264271611,6,2575,1443,-40
30264638173,30264638171,-2,1268,2043,-40
30264834306,30264834314,8,2583,872,-40
30265290301,30265290309,8,3922,764,-40
30266190586,30266190578,-8,951,5149,-40
30270336546,30270336550,4,3044,1389,-40
30277145745,30277145749,4,9451,18571,-40
30277833986,30277833994,8,2690,1156,-40
30279805966,30279805971,5,2986,1102,-40
30281237543,30281237550,7,2090,985,-40
30281600794,30281600800,6,4292,1757,-40
30282886057,30282886062,5,2404,1406,-40
30283347350,30283347350,0,951,1132,-40
30284621891,30284621871,-20,1059,640,-40
30292904768,30292904773,5,2390,1136,-40
30292993754,30292993739,-15,1663,483,-40
30293829150,30293829158,8,1786,1548,-40
30294535713,30294535719,6,4042,2209,-40
30295831454,30295831463,9,1691,845,-40
30299193288,30299193294,6,1500,836,-40
30302048277,30302048282,5,3689,1337,-40
30303929570,30303929576,6,3544,1412,-40
30305451888,30305451893,5,3944,1488,-40
30305644588,30305644585,-3,22121,15071,-40
30306641434,30306641441,7,3657,1158,-40
30307069278,30307069282,4,2254,631,-40
30307334953,30307334940,-13,2305,1264,-40
30308928392,30308928390,-2,1075,1550,-40
30309473049,30309473054,5,3499,1403,-40
30311876646,30311876652,6,3300,1649,-40
30314756895,30314756901,6,2825,1410,-40
30316083682,30316083690,8,3842,1434,-40
30317050781,30317050785,4,1311,764,-40
30317887958,30317887978,20,3134,1186,-40
30319148990,30319148994,4,2333,1256,-40
30323246386,30323246384,-2,1304,2403,-40
30325396757,30325396764,7,2552,1322,-40
30325738166,30325738164,-2,28318,22948,-40
30327781312,30327781319,7,3985,1385,-40
30328629638,30328629646,8,4901,1362,-40
30329337149,30329337154,5,3229,1473,-40
30329704962,30329704970,8,2316,1066,-40
30331532267,30331532286,19,6026,15672,-40
30335158353,30335158361,8,2924,1318,-40
30335960691,30335960698,7,4345,1273,-40
30341513933,30341513941,8,3075,975,-40
30343992729,30343992735,6,3119,961,-40
30344173730,30344173715,-15,989,340,-40
30344768854,30344768859,5,2274,1004,-40
30349195954,30349195959,5,1709,1017,-40
30353473235,30353473241,6,3773,1357,-40
30355105569,30355105575,6,2286,1276,-40
30355479117,30355479123,6,3568,1688,-40
30357159763,30357159770,7,2519,1143,-40
30357693465,30357693471,6,5747,2787,-40
30357970691,30357970682,-9,1393,896,-40
30358487432,30358487433,1,1518,1880,-40
30360165969,30360165975,6,3082,1126,-40
30360255870,30360255850,-20,940,375,-40
30363491398,30363491403,5,2440,1376,-40
30365448585,30365448592,7,2438,1562,-40
30365605885,30365605865,-20,1402,301,-40
30366205760,30366205765,5,3069,1060,-40
30367582152,30367582150,-2,1286,1849,-40
30368571090,30368571095,5,2590,1357,-40
30373687298,30373687306,8,4006,1424,-40
30373979832,30373979840,8,1599,723,-40
30374999918,30374999922,4,1878,1334,-40
30375928974,30375928982,8,2531,1405,-40
30379377533,30379377538,5,3125,1044,-40
30379447990,30379447976,-14,1872,551,-40
30380532438,30380532446,8,3606,1289,-40
30381491069,30381491072,3,710,203,-40
30382514453,30382514434,-19,2273,659,-40
30390475593,30390475599,6,2913,1213,-40
30391383982,30391383988,6,3979,1662,-40
30399660589,30399660595,6,2627,1325,-40
30400541360,30400541341,-19,2794,1481,-40
30404063089,30404063095,6,3583,1713,-40
30408701515,30408701521,6,3632,1142,-40
30411435645,30411435651,6,2030,1156,-40
30411495858,30411495864,6,3019,1710,-40
30411717318,30411717324,6,3426,1619,-40
30413251625,30413251633,8,2026,1106,-40
30414150555,30414150562,7,1949,1262,-40
30415186215,30415186211,-4,833,2526,-40
30416963064,30416963068,4,1745,1054,-40
30424379017,30424379021,4,3393,1869,-40
30424684722,30424684728,6,3164,1655,-40
30426687324,30426687330,6,2359,809,-40
30429903426,30429903431,5,1594,1204,-40
30430585390,30430585384,-6,1164,2120,-40
30431717968,30431717972,4,2420,1799,-40
30434121849,30434121853,4,2174,1054,-40
30434369282,30434369267,-15,3298,1184,-40
30437815326,30437815332,6,2357,1093,-40
30438775553,30438775559,6,2303,1197,-40
30442176194,30442176200,6,3788,2108,-40
30442274590,30442274577,-13,1078,341,-40
30443791977,30443791982,5,2944,1529,-40
30443856165,30443856171,6,3479,1446,-40
30446820266,30446820271,5,3211,1444,-40
30449822274,30449822287,13,49175,19203,-40
30453007748,30453007755,7,1930,767,-40
30454869263,30454869270,7,2748,1023,-40
30456137991,30456137999,8,3657,1005,-40
30457110209,30457110214,5,1199,773,-40
30457293052,30457293059,7,5662,3153,-40
30458291875,30458291883,8,2393,1041,-40
30463265065,30463265071,6,2895,1192,-40
30464550011,30464550017,6,2359,1118,-40
30464595318,30464595314,-4,1799,6048,-40
30466373491,30466373504,13,2923,1072,-40
30466897754,30466897736,-18,3391,1577,-40
30467844383,30467844390,7,2366,1079,-40
30471405298,30471405302,4,2173,1124,-40
30471767962,30471767969,7,4434,1255,-40
30478069823,30478069828,5,2143,991,-40
30479848630,30479848637,7,3790,1414,-40
30488838014,30488838018,4,1655,805,-40
30489798527,30489798534,7,4619,1427,-40
30491888580,30491888586,6,2927,1403,-40
30493893193,30493893198,5,3080,1619,-40
30496661037,30496661041,4,1399,542,-40
30500430509,30500430508,-1,823,2042,-40
30508118545,30508118550,5,2462,1289,-40
30508660930,30508660936,6,2292,891,-40
30509146870,30509146876,6,2621,1476,-40
30509819533,30509819521,-12,1697,973,-40
30511218954,30511218958,4,2681,1648,-40
30515725323,30515725330,7,3830,1266,-40
30517824993,30517824997,4,3097,1108,-40
30525314331,30525314325,-6,833,4822,-40
30527548713,30527548718,5,2740,1185,-40
30528047273,30528047278,5,2622,1494,-40
30529873994,30529873999,5,2918,1032,-40
30532949886,30532949894,8,3189,1202,-40
30535276930,30535276936,6,1692,1362,-40
30540119681,30540119687,6,3609,1303,-40
30542310884,30542310892,8,3376,1261,-40
30545182182,30545182188,6,2817,1324,-40
30545322134,30545322141,7,4261,1697,-40
30546635533,30546635541,8,1498,1349,-40
30546803796,30546803803,7,2422,1345,-40
30550539577,30550539583,6,3612,1370,-40
30556484023,30556484021,-2,964,1867,-40
30561139321,30561139326,5,2567,1043,-40
30563590358,30563590365,7,3057,1099,-40
30564587658,30564587665,7,2650,1252,-40
30566638137,30566638138,1,2370,1290,-40
30570835666,30570835672,6,3386,1736,-40
30571754502,30571754510,8,2862,1064,-40
30574121399,30574121405,6,2768,1421,-40
30577546177,30577546185,8,2908,1036,-40
30578263416,30578263422,6,3097,1269,-40
30579919616,30579919623,7,3747,1823,-40
30582196289,30582196294,5,2405,1057,-40
30582772722,30582772729,7,2558,1314,-40
30586213456,30586213458,2,1508,1219,-40
30586493239,30586493226,-13,2632,1277,-40
30588164727,30588164714,-13,3038,812,-40
30592597646,30592597654,8,1789,872,-40
30593364774,30593364779,5,3074,1329,-40
30602480262,30602480259,-3,607,1837,-40
30604315426,30604315415,-11,3904,1395,-40
30605578231,30605578237,6,852,630,-40
30606158019,30606158014,-5,1997,5852,-40
30609697741,30609697746,5,2548,1322,-40
30614428710,30614428706,-4,731,1707,-40
30617173710,30617173705,-5,1384,4521,-40
30625878981,30625878987,6,2586,950,-40
30637430681,30637430687,6,2184,1342,-40
30639009371,30639009350,-21,1601,781,-40
30641766845,30641766852,7,1830,609,-40
30644647366,30644647371,5,2602,1288,-40
30650750273,30650750281,8,2007,1004,-40
30651931798,30651931805,7,3227,1406,-40
30659641900,30659641894,-6,799,2513,-40
30662954728,30662954734,6,2731,1632,-40
30663913150,30663913154,4,1743,1783,-40
30668668899,30668668905,6,1386,1148,-40
30669382834,30669382841,7,3288,1044,-40
30671909073,30671909074,1,4050,2472,-40
30679187177,30679187182,5,3430,1577,-40
30683620770,30683620774,4,1803,658,-40
30684900138,30684900149,11,1929,862,-40
30689385958,30689385966,8,2852,1438,-40
30689979828,30689979833,5,2612,1448,-40
30694535843,30694535850,7,2250,1310,-40
30696469357,30696469362,5,3238,1681,-40
30696596506,30696596514,8,2820,1205,-40
30697002849,30697002856,7,2848,1236,-40
30697178765,30697178770,5,1577,1218,-40
30698346326,30698346330,4,1815,930,-40
30701993510,30701993518,8,3030,1200,-40
30704469479,30704469486,7,3064,1141,-40
30706555788,30706555794,6,2075,1227,-40
30708854947,30708854953,6,3119,1505,-40
30711368867,30711368873,6,2811,1266,-40
30712452414,30712452421,7,2441,1357,-40
30713777097,30713777104,7,2922,1700,-40
30719604349,30719604354,5,2622,1055,-40
30719935394,30719935400,6,2765,1627,-40
30720144817,30720144804,-13,1455,826,-40
30720536125,30720536129,4,1427,1236,-40
30724747438,30724747445,7,3232,1259,-40
30730715738,30730715744,6,2283,871,-40
30731116924,30731116929,5,2383,1383,-40
30732231474,30732231478,4,1585,995,-40
30733911725,30733911730,5,3582,1819,-40
30736400518,30736400526,8,2833,1108,-40
30737218247,30737218253,6,2298,649,-40
30741903955,30741903933,-22,3647,1758,-40
30743506333,30743506329,-4,1451,2647,-40
30750042979,30750042985,6,2870,1486,-40
30750271518,30750271521,3,1682,2313,-40
30757286095,30757286093,-2,1159,1179,-40
30759489211,30759489218,7,2621,1104,-40
30763408384,30763408392,8,2902,980,-40
30763569654,30763569662,8,1698,1088,-40
30766279217,30766279222,5,3425,1757,-40
30767306223,30767306228,5,3372,1643,-40
30769647802,30769647801,-1,2742,5731,-40
30771344723,30771344729,6,1892,1364,-40
30771942721,30771942726,5,2362,923,-40
30772111368,30772111375,7,2903,1299,-40
30773067133,30773067138,5,3776,1878,-40
30774106605,30774106611,6,2118,1019,-40
30778187722,30778187727,5,3028,1311,-40
30780559458,30780559465,7,2166,882,-40
30782331645,30782331650,5,2717,1507,-40
30788818346,30788818351,5,1614,770,-40
30789819742,30789819749,7,2284,1049,-40
30794073794,30794073801,7,6918,2471,-40
30798384573,30798384581,8,3480,1025,-40
30798616701,30798616680,-21,797,350,-40
30798913330,30798913337,7,3147,1314,-40
30799151843,30799151849,6,3849,1763,-40
30801970982,30801970999,17,3322,1231,-40
30802921798,30802921803,5,3002,1397,-40
30803714637,30803714644,7,3235,1557,-40
30807033409,30807033416,7,5843,1669,-40
30812417658,30812417664,6,2503,1348,-40
30815503599,30815503605,6,2034,1005,-40
30816474862,30816474866,4,1850,1365,-40
30820827706,30820827711,5,2751,1095,-40
30821667441,30821667447,6,2065,838,-40
30821813573,30821813578,5,418,329,-40
30822194316,30822194323,7,2364,1033,-40
30827641403,30827641409,6,3258,1518,-40
30829015356,30829015342,-14,1,1076,-40
30829584789,30829584796,7,1990,1405,-40
30829709848,30829709854,6,2794,869,-40
30832251361,30832251350,-11,1410,25869,-40
30844750244,30844750250,6,1787,1325,-40
30846322646,30846322653,7,3307,1476,-40
30847365498,30847365503,5,1825,1129,-40
30848362481,30848362489,8,3070,1262,-40
30860146286,30860146292,6,2817,1302,-40
30862103233,30862103239,6,2939,1589,-40
30864719166,30864719171,5,3297,1081,-40
30871934217,30871934222,5,1574,926,-40
30877356936,30877356942,6,1319,913,-40
30879506834,30879506840,6,3402,1346,-40
30886046130,30886046136,6,2403,1583,-40
30887992367,30887992375,8,4068,1314,-40
30888779589,30888779596,7,4582,1614,-40
30889121175,30889121186,11,3827,1038,-40
30889156025,30889156011,-14,1706,601,-40
30890035044,30890035049,5,3622,1331,-40
30890155631,30890155651,20,2188,1073,-40
30894327065,30894327070,5,1611,803,-40
30894974073,30894974070,-3,1541,2318,-40
30898288571,30898288578,7,2309,1100,-40
30898804551,30898804557,6,3252,1718,-40
30899359595,30899359603,8,2378,1215,-40
30900822858,30900822863,5,2988,1592,-40
30910289366,30910289375,9,3612,880,-40
30910772441,30910772442,1,1166,1433,-40
30910837665,30910837672,7,2408,1299,-40
30911012500,30911012512,12,1323,614,-40
30911454030,30911454033,3,1227,814,-40
30917191353,30917191359,6,3699,1247,-40
30917764705,30917764690,-15,1811,682,-40
30918070873,30918070879,6,1858,1354,-40
30922251787,30922251776,-11,2717,862,-40
30923419388,30923419393,5,3570,1881,-40
30923875851,30923875847,-4,21139,9013,-40
30926499644,30926499651,7,2474,1251,-40
30936199476,30936199479,3,2207,1559,-40
30937672973,30937672979,6,2887,1133,-40
30937835682,30937835687,5,3175,1266,-40
30937965801,30937965806,5,3206,1124,-40
30940562461,30940562466,5,3437,1097,-40
30940675241,30940675240,-1,1256,240,-40
30941336214,30941336223,9,2677,1190,-40
30941885134,30941885141,7,2934,1167,-40
30942212201,30942212206,5,2563,1318,-40
30944091451,30944091458,7,2459,1145,-40
30946226269,30946226264,-5,1383,5141,-40
30952413826,30952413831,5,1945,1223,-40
30957125946,30957125941,-5,1341,4017,-40
30958594418,30958594426,8,3876,1373,-40
30961524492,30961524487,-5,1485,4783,-40
30973914879,30973914886,7,3368,1057,-40
30977749706,30977749712,6,3129,1561,-40
30978615250,30978615257,7,2933,1254,-40
30979345399,30979345403,4,1667,1116,-40
30980047517,30980047524,7,2910,1587,-40
30984313544,30984313547,3,1984,931,-40
30986722757,30986722764,7,3048,1106,-40
30987185190,30987185195,5,3573,1162,-40
30989688782,30989688789,7,3367,1675,-40
30993329091,30993329096,5,2415,1549,-40
30996259150,30996259154,4,2292,1122,-40
31007436715,31007436722,7,3230,1001,-40
31008090527,31008090506,-21,1176,350,-40
31009178009,31009178016,7,3798,1718,-40
31018920853,31018920858,5,3033,1419,-40
31019113424,31019113411,-13,4867,1074,-40
31020885283,31020885291,8,2405,981,-40
31021216361,31021216370,9,2620,1225,-40
31021499321,31021499306,-15,931,78,-40
31026447557,31026447561,4,2354,1004,-40
31027792442,31027792438,-4,948,1464,-40
31030443014,31030443020,6,1892,1199,-40
31034373031,31034373037,6,2401,1311,-40
31037711413,31037711410,-3,1416,2404,-40
31043668373,31043668377,4,2159,987,-40
31046179506,31046179513,7,2737,1359,-40
31046250173,31046250179,6,2695,1468,-40
31046500556,31046500563,7,3684,1295,-40
31060444771,31060444777,6,3110,1720,-40
31064294329,31064294337,8,3382,1880,-40
31065154045,31065154052,7,3842,1827,-40
31071160772,31071160777,5,2443,826,-40
31071933511,31071933507,-4,1126,378,-40
31072414648,31072414654,6,3109,1454,-40
31075217782,31075217788,6,2618,1333,-40
31077119351,31077119358,7,3206,1349,-40
31079672754,31079672760,6,5874,2778,-40
31083474589,31083474594,5,2663,1146,-40
31084306797,31084306803,6,2864,1687,-40
31084536260,31084536267,7,3126,964,-40
31085517044,31085517049,5,3063,1460,-40
31085649421,31085649421,0,31446,33785,-40
31087132834,31087132841,7,3879,1456,-40
31087641117,31087641123,6,2584,1501,-40
31088258658,31088258654,-4,19939,52756,-40
31088396393,31088396400,7,2396,764,-40
31088592271,31088592257,-14,2664,949,-40
31089379139,31089379147,8,2535,995,-40
31092651429,31092651435,6,2810,1510,-40
31093146351,31093146358,7,3078,1505,-40
31096648053,31096648058,5,1796,1132,-40
31097431606,31097431611,5,2746,929,-40
31097888897,31097888903,6,2532,1227,-40
31102023240,31102023247,7,3145,1432,-40
31104040033,31104040039,6,3117,960,-40
31104682894,31104682873,-21,3432,1160,-40
31105453264,31105453270,6,3805,1494,-40
31106370346,31106370353,7,3020,1359,-40
31107776379,31107776377,-2,1915,4928,-40
31108517481,31108517486,5,3957,1736,-40
31109378914,31109378919,5,3545,1917,-40
31111337242,31111337248,6,2317,1127,-40
31115437402,31115437410,8,4468,1527,-40
31117669749,31117669750,1,37301,40729,-40
31118819326,31118819321,-5,1531,3686,-40
31126977071,31126977065,-6,1453,5580,-40
31129056612,31129056618,6,2778,1000,-40
31130648734,31130648739,5,1827,991,-40
31131646778,31131646785,7,2647,1269,-40
31137154598,31137154605,7,3127,2083,-40
31142106403,31142106409,6,1622,1033,-40
31154923596,31154923614,18,161,1998,-40
31161882246,31161882253,7,2573,1174,-40
31162630738,31162630745,7,2354,823,-40
31171679823,31171679826,3,1975,1411,-40
31173264187,31173264194,7,3106,1341,-40
31174802132,31174802139,7,3356,1593,-40
31178342114,31178342121,7,3511,1546,-40
31179423571,31179423578,7,2908,825,-40
31180662791,31180662789,-2,2052,1102,-40
31181834738,31181834742,4,2827,1256,-40
31182081737,31182081721,-16,1116,438,-40
31186305970,31186305976,6,2936,1170,-40
31190435326,31190435333,7,2496,1072,-40
31190780015,31190779996,-19,1445,1265,-40
31190966898,31190966878,-20,151,1691,-40
31192061963,31192061965,2,1651,1052,-40
31195252550,31195252555,5,2863,1271,-40
31197166851,31197166848,-3,1171,2138,-40
31200094317,31200094296,-21,2529,1738,-40
31205213842,31205213843,1,1970,2111,-40
31207528212,31207528217,5,2320,1333,-40
31219118682,31219118687,5,2731,980,-40
31219716207,31219716213,6,2464,1010,-40
31229550723,31229550718,-5,1146,4667,-40
31232369976,31232369981,5,3981,1636,-40
31233668673,31233668679,6,3256,1069,-40
31233921143,31233921138,-5,942,3011,-40
31234861882,31234861889,7,1616,838,-40
31235065855,31235065866,11,2648,1027,-40
31241753553,31241753559,6,3264,1434,-40
31242181094,31242181102,8,2890,918,-40
31242823140,31242823146,6,2208,905,-40
31243581173,31243581169,-4,1371,3463,-40
31246113232,31246113238,6,3242,892,-40
31246385849,31246385855,6,2579,1281,-40
31246623243,31246623247,4,1388,821,-40
31247128305,31247128310,5,2810,1578,-40
31256241131,31256241139,8,2440,1230,-40
31256955272,31256955257,-15,1926,926,-40
31257655175,31257655181,6,3271,1854,-40
31258847869,31258847875,6,3716,1676,-40
31263439162,31263439170,8,3091,1294,-40
31268441927,31268441933,6,2717,1261,-40
31275291969,31275291972,3,1623,819,-40
31275373006,31275373017,11,2436,1060,-40
31277941953,31277941958,5,2375,1138,-40
31278100661,31278100667,6,3052,1183,-40
31281910293,31281910299,6,2610,1111,-40
31282942894,31282942901,7,1856,1186,-40
31283097449,31283097435,-14,2709,1432,-40
31289117094,31289117101,7,3252,1366,-40
31292334937,31292334942,5,3048,1267,-40
31297586559,31297586565,6,2638,1410,-40
31297840656,31297840662,6,3011,1188,-40
31298085333,31298085338,5,1379,1018,-40
31298823185,31298823169,-16,772,463,-40
31312890197,31312890204,7,3132,981,-40
31313565522,31313565536,14,1819,989,-40
31314234391,31314234396,5,2534,1262,-40
31315274477,31315274483,6,3243,1382,-40
31317458526,31317458535,9,2629,749,-40
31317909812,31317909803,-9,1635,384,-40
31318070240,31318070248,8,3712,1596,-40
31319854810,31319854818,8,3584,1371,-40
31322341313,31322341319,6,3367,1667,-40
31322935658,31322935653,-5,2511,6477,-40
31323935319,31323935325,6,1232,1091,-40
31324341710,31324341715,5,3038,1133,-40
31325503622,31325503630,8,4278,1243,-40
31326081734,31326081712,-22,828,220,-40
31329107689,31329107693,4,2036,1067,-40
31330625028,31330625034,6,2782,1030,-40
31330701018,31330701026,8,1402,875,-40
31338379629,31338379634,5,2336,1247,-40
31339860794,31339860800,6,2771,1638,-40
31346439333,31346439339,6,2484,1597,-40
31351585109,31351585102,-7,28036,6821,-40
31355214369,31355214374,5,3642,1374,-40
31359334688,31359334691,3,1949,1409,-40
31359545292,31359545298,6,3329,1209,-40
31363663601,31363663606,5,3216,1115,-40
31365967458,31365967453,-5,3049,8607,-40
31366053949,31366053929,-20,859,345,-40
31367145189,31367145195,6,3270,1102,-40
31370274493,31370274500,7,3078,1519,-40
31371764262,31371764268,6,2657,1454,-40
31376243450,31376243457,7,3732,1699,-40
31376680787,31376680795,8,5134,1413,-40
31377889062,31377889067,5,1904,1409,-40
31380728171,31380728178,7,2963,1457,-40
31380759465,31380759471,6,2536,1092,-40
31381924961,31381924967,6,4529,1405,-40
31383600612,31383600618,6,3626,1370,-40
31384294128,31384294135,7,1749,1027,-40
31386502949,31386502955,6,2702,1149,-40
31390231271,31390231274,3,1116,1325,-40
31391590547,31391590554,7,3189,1506,-40
31396912182,31396912189,7,2600,1341,-40
31400093677,31400093683,6,2598,1671,-40
31404358535,31404358541,6,2602,1015,-40
31405781057,31405781041,-16,2313,1169,-40
31408320733,31408320740,7,1689,467,-40
31411093929,31411093934,5,2502,929,-40
31413368682,31413368687,5,2242,1358,-40
31413786999,31413786996,-3,2650,3045,-40
31418636199,31418636201,2,1983,1713,-40
31419202585,31419202591,6,3071,1353,-40
31423144228,31423144234,6,3770,1435,-40
31423562886,31423562865,-21,794,209,-40
31427106638,31427106645,7,3197,1393,-40
31431930912,31431930920,8,20104,45695,-40
31432083194,31432083199,5,3778,3070,-40
31434613642,31434613649,7,3675,1671,-40
31436222882,31436222889,7,3002,1428,-40
31437220525,31437220530,5,1586,971,-40
31440995079,31440995086,7,2893,758,-40
31442770881,31442770888,7,3039,1135,-40
31444741786,31444741768,-18,2039,766,-40
31448282025,31448282034,9,2290,1140,-40
31450913893,31450913897,4,2072,2300,-40
31452771158,31452771159,1,1826,1637,-40
31454613941,31454613947,6,1094,435,-40
31456419242,31456419247,5,2863,1533,-40
31466613211,31466613218,7,4595,1689,-40
31467231511,31467231519,8,2241,1085,-40
31468142244,31468142234,-10,23395,17486,-40
31468173583,31468173589,6,3550,1705,-40
31468324443,31468324451,8,2531,1305,-40
31469807190,31469807195,5,3298,1593,-40
31471323987,31471324005,18,2082,842,-40
31473576061,31473576068,7,2723,1184,-40
31473737874,31473737881,7,2916,923,-40
31474661393,31474661394,1,2047,3207,-40
31476227767,31476227774,7,2888,1249,-40
31480061086,31480061092,6,3502,1345,-40
31480940061,31480940069,8,2710,1392,-40
31485217186,31485217193,7,3086,1201,-40
31486179538,31486179522,-16,1019,453,-40
31486403195,31486403202,7,3457,1697,-40
31492812697,31492812701,4,2688,1224,-40
31496740259,31496740259,0,968,1298,-40
31497070637,31497070643,6,1500,594,-40
31504769823,31504769830,7,4162,1323,-40
31505802845,31505802843,-2,947,1510,-40
31506716163,31506716169,6,5510,1746,-40
31507079051,31507079058,7,3271,1172,-40
31507560255,31507560240,-15,1003,273,-40
31511856317,31511856322,5,2095,1004,-40
31519273412,31519273407,-5,2897,8708,-40
31519992269,31519992274,5,3020,1133,-40
31520191401,31520191406,5,1841,739,-40
31522908558,31522908557,-1,1885,2213,-40
31526587966,31526587971,5,3259,1405,-40
31531067113,31531067119,6,1905,1182,-40
31533056358,31533056363,5,3223,1210,-40
31533457051,31533457054,3,1322,1091,-40
31534821234,31534821242,8,2639,998,-40
31536790885,31536790890,5,2722,1089,-40
31540342325,31540342331,6,3812,1557,-40
31543393633,31543393640,7,3901,1544,-40
31546051151,31546051158,7,2949,1212,-40
31546415208,31546415208,0,24859,93306,-40
31555073407,31555073402,-5,2183,7124,-40
31555609821,31555609828,7,1385,430,-40
31555824811,31555824792,-19,818,583,-40
31556780324,31556780330,6,5501,1826,-40
31559947058,31559947065,7,2924,1465,-40
31564212667,31564212668,1,3002,2538,-40
31566426823,31566426830,7,3241,1395,-40
31571051414,31571051421,7,2501,1245,-40
31572071838,31572071846,8,3484,1540,-40
31572629644,31572629626,-18,1283,369,-40
31575609116,31575609122,6,4393,2088,-40
31578403497,31578403502,5,2606,1507,-40
31579116477,31579116466,-11,1025,396,-40
31585877966,31585877974,8,3409,1710,-40
31587132827,31587132835,8,2759,1143,-40
31587953641,31587953643,2,1886,1709,-40
31588801501,31588801507,6,3244,1259,-40
31589835980,31589835987,7,3687,1729,-40
31590646938,31590646943,5,3447,1917,-40
31591484774,31591484781,7,2659,1196,-40
31595739368,31595739374,6,2310,1357,-40
31595876982,31595876962,-20,1096,430,-40
31596058343,31596058345,2,1331,1278,-40
31602346434,31602346439,5,2601,1365,-40
31607677414,31607677418,4,2071,1083,-40
31608240962,31608240969,7,3138,1426,-40
31608562754,31608562758,4,3326,1443,-40
31610334076,31610334079,3,2683,1882,-40
31614001175,31614001173,-2,1226,1763,-40
31618120934,31618120938,4,1595,1406,-40
31619605238,31619605246,8,3148,1241,-40
31622569172,31622569177,5,2698,1528,-40
31624649058,31624649066,8,4534,1109,-40
31626234621,31626234627,6,1582,1088,-40
31626945393,31626945400,7,1984,944,-40
31628851495,31628851502,7,1772,905,-40
31629201813,31629201825,12,3320,1288,-40
31634055341,31634055336,-5,1922,7312,-40
31634997014,31634997013,-1,917,1633,-40
31636524489,31636524494,5,2675,1269,-40
31642913919,31642913926,7,2115,1203,-40
31647464963,31647464969,6,6656,3055,-40
31647656409,31647656415,6,3509,1581,-40
31648080078,31648080078,0,1208,1791,-40
31648880845,31648880851,6,2631,979,-40
31648906527,31648906505,-22,1322,305,-40
31651480606,31651480611,5,2363,1151,-40
31654694150,31654694155,5,2750,1501,-40
31656323150,31656323146,-4,1173,4128,-40
31664619793,31664619798,5,3201,1320,-40
31667576369,31667576373,4,1850,1149,-40
31667823184,31667823184,0,1840,2574,-40
31670289797,31670289803,6,2432,1766,-40
31673449162,31673449143,-19,1996,1042,-40
31678444633,31678444617,-16,1289,105,-40
31680743358,31680743367,9,3425,1181,-40
31682032778,31682032785,7,2670,1574,-40
31683319356,31683319363,7,2494,1538,-40
31686723660,31686723665,5,3187,1679,-40
31687850351,31687850358,7,3329,1255,-40
31690631921,31690631927,6,1576,721,-40
31692623924,31692623930,6,2576,966,-40
31695283270,31695283271,1,1320,1215,-40
31695418706,31695418711,5,2844,1038,-40
31696544954,31696544960,6,1921,1007,-40
31700193528,31700193534,6,2779,1370,-40
31707039613,31707039617,4,1805,1101,-40
31707123308,31707123315,7,2129,1378,-40
31713771029,31713771037,8,2847,1424,-40
31714281732,31714281737,5,2950,1131,-40
31716869154,31716869161,7,2919,1234,-40
31717535825,31717535829,4,21177,23720,-40
31721979607,31721979614,7,2378,1072,-40
31724183605,31724183611,6,3490,1077,-40
31726711131,31726711137,6,2295,1579,-40
31731191410,31731191417,7,4012,1581,-40
31737017390,31737017395,5,4075,1196,-40
31737793221,31737793226,5,2725,1386,-40
31741010413,31741010418,5,2236,1382,-40
31746737027,31746737033,6,3279,1280,-40
31752300535,31752300543,8,3127,1194,-40
31755872005,31755872006,1,56024,42047,-40
31757488450,31757488454,4,2588,946,-40
31758383530,31758383527,-3,1539,3814,-40
31763566363,31763566370,7,1845,951,-40
31764679837,31764679817,-20,3963,1242,-40
31768209515,31768209522,7,2440,1038,-40
31768479967,31768479978,11,3073,1266,-40
31776575858,31776575866,8,4204,1743,-40
31777867426,31777867433,7,2751,1254,-40
31778685443,31778685450,7,3430,1496,-40
31785613513,31785613518,5,2649,923,-40
31786720854,31786720860,6,2627,1601,-40
31789652237,31789652243,6,2434,1315,-40
31789723838,31789723844,6,2005,811,-40
31791956701,31791956706,5,1920,757,-40
31793674975,31793674980,5,3013,1195,-40
31794080394,31794080411,17,1213,243,-40
31797611661,31797611667,6,2056,630,-40
31812896906,31812896914,8,2258,1629,-40
31821656861,31821656865,4,2866,1362,-40
31825158526,31825158534,8,2015,926,-40
31827074327,31827074334,7,5357,1999,-40
31828188023,31828188031,8,1728,1012,-40
31831451854,31831451862,8,3136,1449,-40
31833930206,31833930211,5,2829,1708,-40
31835126746,31835126752,6,2380,1130,-40
31837862330,31837862335,5,2430,1060,-40
31838363492,31838363476,-16,1463,221,-40
31846108089,31846108094,5,2462,948,-40
31846408410,31846408401,-9,1258,95,-40
31847590114,31847590099,-15,1853,907,-40
31852404002,31852404006,4,2187,1413,-40
31855671689,31855671694,5,2790,1195,-40
31858375984,31858375990,6,2453,1407,-40
31859325253,31859325252,-1,2078,2804,-40
31863135278,31863135286,8,3627,1429,-40
31863357872,31863357865,-7,39824,12050,-40
31863569330,31863569335,5,2556,1372,-40
31867709993,31867709998,5,2559,1128,-40
31868332907,31868332914,7,4454,1734,-40
31868778357,31868778350,-7,1819,7687,-40
31871402853,31871402859,6,3221,1414,-40
31878718195,31878718203,8,4001,1408,-40
31878901958,31878901970,12,1483,720,-40
31880352495,31880352503,8,2671,1242,-40
31881746129,31881746126,-3,18207,12802,-40
31882194148,31882194155,7,4218,1429,-40
31884959056,31884959062,6,3634,1576,-40
31889058679,31889058685,6,2652,1346,-40
31892082959,31892082964,5,2252,1383,-40
31892704795,31892704803,8,3327,1356,-40
31893923991,31893923997,6,1892,1533,-40
31894720759,31894720763,4,2318,1178,-40
31895236802,31895236785,-17,5091,941,-40
31895742905,31895742889,-16,2918,1357,-40
31898400533,31898400530,-3,1382,3476,-40
31898523227,31898523226,-1,1171,1131,-40
31898891018,31898891004,-14,1176,473,-40
31899338042,31899338049,7,3153,1811,-40
31907857292,31907857290,-2,995,2086,-40
31908637746,31908637754,8,2754,850,-40
31909775322,31909775329,7,2848,1684,-40
31910903472,31910903456,-16,1556,1171,-40
31914679444,31914679451,7,4472,1418,-40
31920388647,31920388655,8,3854,1566,-40
31922556430,31922556436,6,1725,1472,-40
31925059338,31925059356,18,580,1333,-40
31927526313,31927526318,5,3115,1030,-40
31929418361,31929418369,8,3789,1494,-40
31930695197,31930695203,6,2673,973,-40
31933704920,31933704922,2,1402,1931,-40
31934050097,31934050103,6,2654,1093,-40
31943208519,31943208522,3,1339,943,-40
31944661819,31944661818,-1,2196,3743,-40
31945879071,31945879078,7,4301,1822,-40
31949045086,31949045091,5,1585,1091,-40
31949899252,31949899272,20,2208,1093,-40
31950413547,31950413555,8,2468,1174,-40
31951350310,31951350318,8,2763,1640,-40
31954003399,31954003403,4,1289,862,-40
31961135822,31961135827,5,2420,1441,-40
31962465453,31962465459,6,2733,1475,-40
31964244265,31964244271,6,2684,1254,-40
31965200362,31965200369,7,2984,1342,-40
31965320923,31965320928,5,3292,1306,-40
31966045046,31966045053,7,2589,1164,-40
31968810658,31968810663,5,3143,1498,-40
31970979133,31970979134,1,1883,1907,-40
31972314953,31972314957,4,2125,1006,-40
31976801218,31976801223,5,3882,1550,-40
31977091302,31977091307,5,2254,1627,-40
31977143822,31977143841,19,921,258,-40
31978358710,31978358717,7,1924,743,-40
31982844604,31982844610,6,4339,1979,-40
31987589825,31987589824,-1,2149,2330,-40
31994774690,31994774697,7,2318,1372,-40
31996412738,31996412722,-16,1126,228,-40
31999537031,31999537038,7,2483,1293,-40
32000546581,32000546586,5,3312,1497,-40
32002856495,32002856501,6,2826,1315,-40
32002887730,32002887735,5,2983,1344,-40
32004516754,32004516761,7,2806,1362,-40
32005109667,32005109682,15,908,270,-40
32008096326,32008096310,-16,3572,1591,-40
32009743030,32009743035,5,2890,1319,-40
32010634281,32010634278,-3,1196,2922,-40
32012337620,32012337614,-6,839,2146,-40
32013887129,32013887137,8,3015,1387,-40
32014485388,32014485394,6,2959,1202,-40
32016587174,32016587182,8,3669,1662,-40
32017720911,32017720918,7,1834,801,-40
32018712939,32018712946,7,2684,1432,-40
32020505727,32020505734,7,3410,1256,-40
32021384778,32021384784,6,3615,1610,-40
32023009054,32023009034,-20,1342,704,-40
32024701521,32024701527,6,2518,1545,-40
32027847619,32027847627,8,3612,1062,-40
32030791681,32030791686,5,2784,748,-40
32031310901,32031310907,6,2546,1323,-40
32037724312,32037724318,6,4600,1231,-40
32046257240,32046257247,7,2891,1362,-40
32047685294,32047685299,5,2380,1010,-40
32048726024,32048726030,6,2700,1241,-40
32050280446,32050280451,5,1704,984,-40
32055460609,32055460614,5,2436,1160,-40
32058698541,32058698546,5,2740,1064,-40
32060797347,32060797352,5,2945,2156,-40
32064216842,32064216847,5,3249,1580,-40
32066324862,32066324868,6,2659,1606,-40
32066396802,32066396810,8,6305,2382,-40
32066929535,32066929542,7,901,387,-40
32073015130,32073015130,0,1167,2267,-40
32073169503,32073169507,4,2469,883,-40
32074323335,32074323339,4,2705,1648,-40
32080509964,32080509971,7,3009,1232,-40
32086844198,32086844203,5,787,799,-40
32091358834,32091358839,5,3170,1250,-40
32091528969,32091528979,10,3149,1254,-40
32095625738,32095625744,6,2849,1088,-40
32101207361,32101207367,6,2249,1023,-40
32101892393,32101892390,-3,1024,2770,-40
32106906304,32106906310,6,5527,2212,-40
32109054439,32109054446,7,2125,1340,-40
32111702067,32111702073,6,3054,1596,-40
32112964042,32112964048,6,2540,1053,-40
32115028757,32115028762,5,2388,1020,-40
32115122388,32115122394,6,2894,1282,-40
32122916081,32122916087,6,3072,1104,-40
32123003931,32123003938,7,3329,1408,-40
32124726742,32124726748,6,2710,1730,-40
32124800105,32124800112,7,1416,646,-40
32124859582,32124859563,-19,1121,706,-40
32127225569,32127225574,5,1960,965,-40
32128087069,32128087049,-20,2525,861,-40
32128301174,32128301171,-3,823,125,-40
32129752644,32129752650,6,3139,1380,-40
32129981406,32129981414,8,2940,1614,-40
32132083160,32132083167,7,2718,1229,-40
32134987478,32134987487,9,2963,909,-40
32141737609,32141737617,8,2305,800,-40
32142877657,32142877644,-13,2756,1393,-40
32145631977,32145631983,6,2593,1399,-40
32146663308,32146663314,6,2832,1270,-40
32152982152,32152982158,6,3966,1758,-40
32153130433,32153130440,7,2601,1868,-40
32154106363,32154106369,6,2351,875,-40
32155219204,32155219209,5,2668,1284,-40
32157603605,32157603610,5,2858,978,-40
32158054371,32158054353,-18,2561,988,-40
32158816764,32158816752,-12,935,783,-40
32159892267,32159892273,6,3484,1179,-40
32159939827,32159939833,6,2479,1146,-40
32160371594,32160371602,8,1321,860,-40
32161177633,32161177617,-16,1539,372,-40
32161997226,32161997233,7,2776,1284,-40
32162197292,32162197287,-5,1031,1900,-40
32164204406,32164204411,5,2601,946,-40
32164365995,32164366002,7,2321,1004,-40
32167616938,32167616943,5,3177,1561,-40
32167852485,32167852491,6,2002,731,-40
32169292578,32169292586,8,2820,1432,-40
32169330934,32169330912,-22,1837,500,-40
32170579521,32170579531,10,2392,1472,-40
32175702658,32175702665,7,1538,822,-40
32176639882,32176639874,-8,1735,9552,-40
32176672798,32176672805,7,2690,1298,-40
32180162805,32180162812,7,3030,1588,-40
32181771909,32181771914,5,2145,937,-40
32185121239,32185121246,7,2964,1244,-40
32185809517,32185809524,7,2661,799,-40
32193690905,32193690911,6,1965,862,-40
32200370579,32200370588,9,2663,1292,-40
32204040373,32204040354,-19,962,383,-40
32204937357,32204937362,5,2044,1236,-40
32205752898,32205752904,6,5323,2337,-40
32215958234,32215958238,4,3890,2480,-40
32216217525,32216217532,7,2646,1187,-40
32218603102,32218603106,4,2978,1935,-40
32219483582,32219483588,6,3491,2010,-40
32222682530,32222682537,7,2283,1038,-40
32223179846,32223179841,-5,711,163,-40
32223702719,32223702729,10,834,833,-40
32231005299,32231005298,-1,1520,2431,-40
32235603377,32235603384,7,2652,1110,-40
32238191258,32238191263,5,2025,1236,-40
32239093957,32239093963,6,4741,1035,-40
32239306243,32239306249,6,2582,816,-40
32243232882,32243232887,5,2326,1138,-40
32245640454,32245640456,2,14042,50613,-40
32248378570,32248378577,7,2803,1403,-40
32248574665,32248574671,6,2420,949,-40
32250900044,32250900050,6,4556,1677,-40
32261373506,32261373514,8,1916,794,-40
32265567974,32265567981,7,3025,1580,-40
32267171247,32267171251,4,2637,1243,-40
32267342427,32267342443,16,462,272,-40
32268449511,32268449517,6,17008,56596,-40
32272240272,32272240277,5,2758,1365,-40
32272733147,32272733155,8,2455,972,-40
32272844456,32272844441,-15,1093,226,-40
32275767258,32275767254,-4,1229,2678,-40
32276137261,32276137268,7,3264,1203,-40
32277543395,32277543399,4,1605,1495,-40
32285480517,32285480522,5,2729,1013,-40
32289468327,32289468333,6,1983,1105,-40
32294567962,32294567969,7,2660,1271,-40
32295908030,32295908038,8,2755,989,-40
32296587713,32296587713,0,8129,13017,-40
32298047982,32298047990,8,3688,1224,-40
32298542770,32298542775,5,3351,1293,-40
32298926569,32298926575,6,3181,1433,-40
32299841421,32299841426,5,1809,1104,-40
32303386978,32303386985,7,3842,1414,-40
32308417562,32308417566,4,2797,1044,-40
32309585190,32309585196,6,2677,1366,-40
32309627425,32309627409,-16,622,294,-40
32310606647,32310606651,4,4214,2055,-40
32315729830,32315729836,6,2360,1453,-40
32316732154,32316732161,7,2916,1130,-40
32318746413,32318746421,8,4802,1404,-40
32320212365,32320212373,8,2855,1219,-40
32324919906,32324919914,8,3036,1150,-40
32325662714,32325662727,13,12249,50137,-40
32327374298,32327374286,-12,680,544,-40
32330335782,32330335789,7,5121,2624,-40
32335079041,32335079046,5,2797,1529,-40
32335664200,32335664206,6,3128,1423,-40
32335909079,32335909087,8,2770,1042,-40
32337131046,32337131053,7,2107,1135,-40
32338592704,32338592711,7,2767,1532,-40
32339018877,32339018882,5,2363,1181,-40
32340362065,32340362071,6,3053,913,-40
32346675388,32346675394,6,2725,1182,-40
32349387566,32349387562,-4,959,2119,-40
32352621456,32352621462,6,2571,1309,-40
32352724453,32352724443,-10,911,129,-40
32354896714,32354896723,9,2769,2599,-40
32356202349,32356202357,8,3835,1289,-40
32359920577,32359920583,6,1928,683,-40
32360783359,32360783366,7,2084,1047,-40
32361110519,32361110526,7,2945,1408,-40
32361138924,32361138931,7,1811,1114,-40
32366938558,32366938566,8,2088,1000,-40
32368117070,32368117078,8,3048,1603,-40
32372880122,32372880127,5,2889,969,-40
32374595712,32374595715,3,1746,1810,-40
32375609315,32375609321,6,2343,1017,-40
32376276294,32376276307,13,1099,181,-40
32376504426,32376504435,9,2151,1239,-40
32380815678,32380815684,6,2453,1034,-40
32382279988,32382279995,7,2936,1281,-40
32382621749,32382621730,-19,2818,1223,-40
32383477211,32383477217,6,2241,1076,-40
32383624042,32383624026,-16,3587,1235,-40
32383945061,32383945067,6,2333,1176,-40
32390539644,32390539651,7,2557,1489,-40
32390614218,32390614223,5,2889,958,-40
32390956246,32390956242,-4,1316,90,-40
32393757358,32393757363,5,2490,1178,-40
32396491958,32396491957,-1,951,1475,-40
32397338793,32397338798,5,2861,1175,-40
32398030597,32398030602,5,2745,1431,-40
32398496506,32398496512,6,4221,1888,-40
32398803417,32398803402,-15,2541,929,-40
32399052576,32399052561,-15,1258,638,-40
32401794168,32401794174,6,4207,1431,-40
32402233909,32402233915,6,2714,1060,-40
32404743937,32404743942,5,4042,2529,-40
32405279690,32405279696,6,2461,1291,-40
32408714078,32408714084,6,3396,1470,-40
32410378617,32410378600,-17,800,141,-40
32415252350,32415252354,4,2094,1526,-40
32418270230,32418270235,5,1762,1407,-40
32419913117,32419913123,6,2960,1238,-40
32423096283,32423096289,6,2868,1184,-40
32431636250,32431636257,7,2825,1454,-40
32438917723,32438917730,7,2283,1517,-40
32440601277,32440601283,6,2510,1095,-40
32444195814,32444195822,8,3506,1310,-40
32445717946,32445717952,6,2479,1133,-40
32445912440,32445912428,-12,1482,754,-40
32448475316,32448475333,17,16364,17992,-40
32450528602,32450528610,8,2830,1108,-40
32453092074,32453092079,5,2552,1168,-40
32461017758,32461017765,7,3474,1380,-40
32461086346,32461086350,4,2370,1252,-40
32463328021,32463328027,6,2328,1429,-40
32465120983,32465120990,7,2310,1708,-40
32465173005,32465173011,6,1674,586,-40
32465409761,32465409767,6,2614,1444,-40
32469412862,32469412867,5,3216,1371,-40
32475296245,32475296250,5,2913,1377,-40
32475686644,32475686650,6,2885,1120,-40
32480699356,32480699363,7,2450,1415,-40
32483764398,32483764403,5,2867,1406,-40
32488207558,32488207565,7,2771,1390,-40
32489574601,32489574606,5,2399,1075,-40
32491086689,32491086694,5,3727,1901,-40
32493935205,32493935210,5,2871,1189,-40
32494741473,32494741479,6,2706,1351,-40
32494920565,32494920571,6,3225,1530,-40
32495755103,32495755105,2,1229,911,-40
32495932297,32495932302,5,2772,858,-40
32496695125,32496695131,6,2592,1362,-40
32501768157,32501768163,6,2913,1386,-40
32502330226,32502330208,-18,2875,1362,-40
32502842544,32502842544,0,6399,8190,-40
32507663889,32507663896,7,2977,1171,-40
32509835884,32509835890,6,2277,1239,-40
32510375272,32510375278,6,3277,1634,-40
32511713776,32511713779,3,1929,1496,-40
32511760300,32511760306,6,1976,846,-40
32517400494,32517400499,5,2160,1185,-40
32518331450,32518331455,5,2129,962,-40
32520750241,32520750246,5,3401,1656,-40
32520964741,32520964747,6,1989,1187,-40
32522300220,32522300226,6,2493,1229,-40
32522457083,32522457066,-17,1309,294,-40
32524164283,32524164289,6,2883,1229,-40
32536440411,32536440417,6,2077,1136,-40
32538751010,32538751012,2,1966,1539,-40
32540756211,32540756218,7,3355,1405,-40
32542803811,32542803815,4,1909,1686,-40
32547319890,32547319895,5,2955,981,-40
32549985671,32549985676,5,1902,1450,-40
32555338293,32555338301,8,2632,1543,-40
32558969673,32558969680,7,2783,1608,-40
32560039399,32560039405,6,2011,1076,-40
32562534538,32562534544,6,1728,905,-40
32566754761,32566754757,-4,1444,3216,-40
32566798947,32566798947,0,1432,1786,-40
32568432546,32568432546,0,2353,3470,-40
32569631589,32569631594,5,2653,1548,-40
32570046214,32570046196,-18,3002,1128,-40
32570408246,32570408250,4,2446,1508,-40
32570865376,32570865382,6,2787,910,-40
32571779417,32571779423,6,3199,1579,-40
32572448352,32572448358,6,2987,1293,-40
32572665762,32572665767,5,2279,1344,-40
32573130489,32573130493,4,2700,1579,-40
32573884713,32573884718,5,2458,977,-40
32576545609,32576545612,3,1898,1561,-40
32579756410,32579756419,9,2501,914,-40
32580583037,32580583042,5,3112,1207,-40
32586803526,32586803532,6,2368,967,-40
32594536070,32594536077,7,1573,1122,-40
32606298826,32606298833,7,3010,1340,-40
32607763122,32607763125,3,1117,624,-40
32608686510,32608686515,5,9033,5172,-40
32611041570,32611041577,7,2296,982,-40
32611360357,32611360361,4,1971,1139,-40
32611678683,32611678692,9,13561,30613,-40
32614077211,32614077217,6,2358,1460,-40
32618670486,32618670494,8,2929,1243,-40
32624488730,32624488729,-1,731,1812,-40
32624942426,32624942430,4,3200,1689,-40
32626561898,32626561893,-5,1443,8078,-40
32630006490,32630006498,8,2648,1261,-40
32630292142,32630292148,6,3038,924,-40
32632296007,32632296014,7,3335,1436,-40
32637952442,32637952442,0,799,1642,-40
32640051855,32640051861,6,2620,1154,-40
32643258261,32643258257,-4,1574,4946,-40
32645332296,32645332293,-3,9,1621,-40
32652613205,32652613211,6,3664,1912,-40
32654369215,32654369217,2,1425,1423,-40
32657619559,32657619566,7,2540,1540,-40
32660646621,32660646629,8,3955,1399,-40
32662200241,32662200247,6,2536,1063,-40
32663363086,32663363094,8,3232,1384,-40
32665460322,32665460327,5,3239,1649,-40
32668373990,32668373995,5,2433,1484,-40
32668713107,32668713090,-17,756,389,-40
32669403734,32669403740,6,2615,1221,-40
32673105517,32673105523,6,3388,1164,-40
32673511930,32673511937,7,4305,1818,-40
32678744764,32678744771,7,1749,756,-40
32679426074,32679426058,-16,3054,1763,-40
32683962281,32683962289,8,3027,1114,-40
32684004201,32684004218,17,2821,1347,-40
32684227695,32684227701,6,2579,1285,-40
32684415993,32684415978,-15,1399,477,-40
32689202849,32689202853,4,4779,4098,-40
32690335170,32690335179,9,2215,847,-40
32693015827,32693015833,6,2591,1088,-40
32694286925,32694286947,22,3011,1053,-40
32695996674,32695996682,8,2274,1042,-40
32698567603,32698567615,12,46,1166,-40
32700213032,32700213037,5,1965,1348,-40
32701121423,32701121429,6,2178,1096,-40
32703217594,32703217602,8,3707,1226,-40
32705548224,32705548222,-2,23509,41817,-40
32706515519,32706515526,7,2120,1150,-40
32709896872,32709896879,7,7261,1615,-40
32712976578,32712976585,7,3495,2092,-40
32713379322,32713379329,7,1684,630,-40
32714150054,32714150058,4,2253,1062,-40
32715368445,32715368451,6,3054,1266,-40
32715573005,32715573012,7,3667,1640,-40
32717547166,32717547175,9,3629,1484,-40
32720473115,32720473121,6,2768,1081,-40
32721928801,32721928806,5,3206,1564,-40
32722161757,32722161768,11,2137,1246,-40
32725146808,32725146816,8,16071,31643,-40
32729897675,32729897668,-7,24794,14420,-40
32730669627,32730669630,3,3825,3038,-40
32731825873,32731825878,5,2637,1067,-40
32734985849,32734985856,7,3284,1233,-40
32736265834,32736265841,7,2757,973,-40
32738804600,32738804606,6,1907,1190,-40
32738953829,32738953810,-19,2578,1166,-40
32741967951,32741967956,5,2363,1427,-40
32744692186,32744692192,6,3308,994,-40
32750577461,32750577469,8,1367,950,-40
32751922309,32751922315,6,3055,1257,-40
32752684153,32752684158,5,2481,1090,-40
32755985446,32755985453,7,3182,1442,-40
32756138131,32756138137,6,3032,1500,-40
32758873345,32758873345,0,672,1633,-40
32760371182,32760371187,5,3257,1489,-40
32761504117,32761504122,5,1750,917,-40
32761814798,32761814805,7,6928,2806,-40
32762356919,32762356927,8,3318,1272,-40
32769431941,32769431943,2,4179,2326,-40
32773718073,32773718080,7,3194,975,-40
32775024777,32775024783,6,2488,1233,-40
32784881734,32784881741,7,2580,1098,-40
32785069609,32785069621,12,12803,42664,-40
32787855248,32787855255,7,9030,1327,-40
32792082253,32792082259,6,1956,822,-40
32792750386,32792750393,7,3403,1317,-40
32796865921,32796865927,6,3285,1674,-40
32799251777,32799251783,6,3788,1246,-40
32800031575,32800031582,7,2966,1435,-40
32800288133,32800288116,-17,910,404,-40
32805943870,32805943876,6,1862,928,-40
32807416767,32807416765,-2,23025,83497,-40
32812642727,32812642734,7,2996,1203,-40
32815228085,32815228089,4,1929,1078,-40
32816459989,32816459997,8,1793,1033,-40
32817504932,32817504933,1,768,178,-40
32817827774,32817827780,6,2494,1529,-40
32818112102,32818112106,4,962,338,-40
32820023151,32820023156,5,2853,903,-40
32821715337,32821715321,-16,3068,1720,-40
32830564459,32830564464,5,2545,1426,-40
32847842926,32847842931,5,2059,1105,-40
32853967914,32853967922,8,4011,1852,-40
32859236616,32859236599,-17,1043,555,-40
32863777495,32863777505,10,2376,879,-40
32864494392,32864494398,6,2524,1449,-40
32869562862,32869562867,5,2110,1493,-40
32871846938,32871846944,6,1970,789,-40
32872618645,32872618652,7,3317,1187,-40
32873294370,32873294376,6,2952,1189,-40
32874861477,32874861483,6,2408,1335,-40
32875987310,32875987317,7,2991,1666,-40
32876566685,32876566692,7,3253,977,-40
32876974202,32876974210,8,2718,1088,-40
32877840981,32877840969,-12,976,138,-40
32878506677,32878506683,6,3035,1281,-40
32878595762,32878595769,7,2876,1184,-40
32878844701,32878844720,19,870,199,-40
32886283156,32886283162,6,2620,1074,-40
32886513098,32886513105,7,1076,138,-40
32894346919,32894346921,2,1996,1039,-40
32896077163,32896077170,7,3868,1396,-40
32896446444,32896446450,6,3298,1816,-40
32898053686,32898053694,8,2858,1339,-40
32898135084,32898135105,21,624,2876,-40
32898770609,32898770615,6,3463,1408,-40
32904936241,32904936246,5,666,429,-40
32907495577,32907495583,6,2905,1497,-40
32910807053,32910807072,19,1715,785,-40
32912095690,32912095684,-6,1176,205,-40
32913745472,32913745465,-7,36211,16120,-40
32914762127,32914762133,6,2821,1316,-40
32916938109,32916938116,7,2441,1371,-40
32917175807,32917175813,6,3139,1188,-40
32919133217,32919133221,4,2392,1396,-40
32919361063,32919361052,-11,1959,794,-40
32920449885,32920449891,6,2211,1550,-40
32921245130,32921245135,5,1970,832,-40
32921903202,32921903185,-17,2320,1072,-40
32925180085,32925180093,8,3484,1328,-40
32927359918,32927359925,7,3146,1305,-40
32929443019,32929443025,6,1460,977,-40
32934139613,32934139613,0,1180,1637,-40
32938458761,32938458766,5,1677,1257,-40
32941377362,32941377368,6,2949,1187,-40
32941480361,32941480367,6,3169,1210,-40
32946183278,32946183285,7,3073,1286,-40
32946602132,32946602139,7,2777,1364,-40
32947243221,32947243227,6,3617,1349,-40
32952426372,32952426377,5,2714,1322,-40
32952684596,32952684602,6,1922,923,-40
32956135824,32956135829,5,3355,1636,-40
32958626332,32958626338,6,3668,1607,-40
32962010561,32962010562,1,39405,16203,-40
32962632958,32962632962,4,2708,1182,-40
32967211682,32967211690,8,3677,1493,-40
32970398419,32970398425,6,2068,1411,-40
32970937050,32970937058,8,3500,1265,-40
32972114893,32972114898,5,1989,1272,-40
32974519314,32974519310,-4,1992,6321,-40
32975135137,32975135140,3,8859,6262,-40
32977999125,32977999133,8,2319,1229,-40
32982128063,32982128070,7,3383,1137,-40
32993645479,32993645486,7,2830,1389,-40
32994022000,32994022005,5,2649,1002,-40
32995247738,32995247743,5,3664,1207,-40
32996133248,32996133254,6,1596,1312,-40
33001277142,33001277141,-1,1302,2141,-40
33006460833,33006460820,-13,2622,1210,-40
33008231766,33008231771,5,1904,941,-40
33020692317,33020692322,5,3290,1161,-40
33023144225,33023144232,7,3885,998,-40
33026600124,33026600130,6,3303,1199,-40
33026732214,33026732220,6,2079,1101,-40
33029002168,33029002151,-17,1245,602,-40
33030600213,33030600218,5,2733,1278,-40
33032017413,33032017422,9,2803,1171,-40
33035050046,33035050045,-1,1427,1962,-40
33040278534,33040278540,6,3240,1592,-40
33041397138,33041397143,5,2580,1190,-40
33043772033,33043772039,6,2194,1098,-40
33047471078,33047471083,5,3007,1036,-40
33048256663,33048256667,4,3242,1471,-40
33050841224,33050841231,7,2630,949,-40
33051518569,33051518576,7,2323,1284,-40
33058013774,33058013781,7,3210,1584,-40
33058063110,33058063114,4,3385,1090,-40
33061580959,33061580960,1,1622,1480,-40
33061860410,33061860395,-15,1387,748,-40
33064345681,33064345678,-3,1496,4423,-40
33066155690,33066155698,8,3392,1739,-40
33066209022,33066209002,-20,2399,1056,-40
33067019034,33067019040,6,2574,1341,-40
33068280649,33068280646,-3,1043,1408,-40
33069289567,33069289575,8,2477,1011,-40
33078765510,33078765516,6,3223,1197,-40
33081349651,33081349658,7,3483,1691,-40
33083804300,33083804307,7,2099,900,-40
33084558143,33084558149,6,2665,1445,-40
33086211414,33086211420,6,3041,1436,-40
33087799373,33087799381,8,3693,1344,-40
33089440253,33089440258,5,3090,1437,-40
33106536196,33106536202,6,2017,1161,-40
33106843086,33106843094,8,2683,1640,-40
33108689466,33108689470,4,2632,936,-40
33109123679,33109123699,20,3277,1272,-40
33112696713,33112696719,6,2788,1353,-40
33118049097,33118049103,6,2156,903,-40
33118231039,33118231046,7,4284,1520,-40
33120776977,33120776983,6,2101,917,-40
33121728765,33121728770,5,2600,1398,-40
33122359757,33122359759,2,1408,937,-40
33125013938,33125013945,7,2598,1100,-40
33126200125,33126200130,5,2498,740,-40
33126795508,33126795513,5,2180,1670,-40
33127460084,33127460089,5,2521,1730,-40
33128945202,33128945209,7,3582,1305,-40
33129761914,33129761922,8,2984,1482,-40
33131104313,33131104319,6,2711,1218,-40
33135298565,33135298571,6,2025,790,-40
33135754038,33135754044,6,2909,1346,-40
33136886837,33136886819,-18,1024,375,-40
33139179259,33139179265,6,2904,1288,-40
33142517033,33142517039,6,2177,876,-40
33146195271,33146195278,7,2252,975,-40
33147364566,33147364570,4,3047,1575,-40
33147389734,33147389742,8,4424,1616,-40
33150421657,33150421658,1,1090,1538,-40
33154601501,33154601504,3,1755,1503,-40
33155154438,33155154446,8,3315,1066,-40
33155406024,33155406032,8,3221,1004,-40
33156084319,33156084329,10,12536,35737,-40
33161871217,33161871234,17,188,1637,-40
33162039798,33162039805,7,1677,1299,-40
33164274495,33164274502,7,2173,718,-40
33165846967,33165846974,7,1144,1192,-40
33168210985,33168210990,5,1896,1661,-40
33169379810,33169379817,7,2827,1108,-40
33170781714,33170781720,6,3109,1335,-40
33171213003,33171213010,7,3238,1145,-40
33175709478,33175709484,6,3322,1516,-40
33177270131,33177270138,7,4159,1719,-40
33180641839,33180641838,-1,1177,1715,-40
33181222614,33181222620,6,3833,1645,-40
33181289725,33181289744,19,1843,649,-40
33181791913,33181791917,4,3014,1372,-40
33184723932,33184723937,5,58428,32623,-40
33185851491,33185851498,7,3381,1397,-40
33187805462,33187805468,6,3884,1710,-40
33188598793,33188598797,4,2478,1075,-40
33188722145,33188722130,-15,1053,163,-40
33194287378,33194287384,6,2656,777,-40
33195644647,33195644654,7,3349,1498,-40
33197744378,33197744379,1,1250,1782,-40
33202262724,33202262732,8,2557,1108,-40
33205563929,33205563934,5,1547,842,-40
33210622050,33210622057,7,3396,1688,-40
33210783653,33210783661,8,3716,1559,-40
33211080685,33211080707,22,3746,1678,-40
33211664139,33211664121,-18,2102,1398,-40
33211820874,33211820881,7,2076,1172,-40
33213213725,33213213730,5,2676,1151,-40
33213469629,33213469634,5,2725,1622,-40
33214384354,33214384362,8,4621,789,-40
33215032074,33215032080,6,2221,1224,-40
33218277357,33218277362,5,2728,1194,-40
33218418873,33218418891,18,3171,1612,-40
33222546145,33222546151,6,3381,1226,-40
33226659251,33226659258,7,4396,1247,-40
33226794654,33226794640,-14,903,284,-40
33227394541,33227394548,7,2763,1060,-40
33228967826,33228967832,6,3016,1815,-40
33229914870,33229914875,5,2860,1546,-40
33233112374,33233112373,-1,1498,2215,-40
33233192140,33233192146,6,2276,1307,-40
33237554642,33237554646,4,3361,1228,-40
33240015466,33240015471,5,1101,761,-40
33240133403,33240133409,6,2185,1024,-40
33242766956,33242766954,-2,1243,2412,-40
33247361233,33247361236,3,1456,1026,-40
33247709037,33247709043,6,2060,1332,-40
33248425101,33248425106,5,2439,909,-40
33248546254,33248546234,-20,2507,1396,-40
33250219382,33250219387,5,2582,1293,-40
33252689306,33252689311,5,2042,1425,-40
33253115390,33253115395,5,2516,1631,-40
33254711362,33254711370,8,2508,1208,-40
33255042941,33255042947,6,2574,927,-40
33255371742,33255371723,-19,2041,745,-40
33255810972,33255810977,5,1960,1000,-40
33256129106,33256129110,4,3754,1382,-40
33257484469,33257484475,6,3038,1644,-40
33260320999,33260321006,7,2513,1085,-40
33261037592,33261037599,7,3941,1341,-40
33270496454,33270496459,5,2430,1007,-40
33272530269,33272530274,5,2298,1103,-40
33272836425,33272836430,5,2623,1097,-40
33275497194,33275497198,4,1390,1301,-40
33277593044,33277593048,4,2532,1354,-40
33278280749,33278280756,7,2586,1625,-40
33280007276,33280007283,7,2212,1090,-40
33280398848,33280398839,-9,1575,25111,-40
33282953168,33282953172,4,1894,797,-40
33283517951,33283517956,5,2476,1185,-40
33283758533,33283758555,22,1142,344,-40
33285416166,33285416172,6,3192,1555,-40
33286308493,33286308498,5,2966,1802,-40
33290931061,33290931069,8,3882,1576,-40
33291989134,33291989140,6,3163,1142,-40
33295924566,33295924572,6,2231,818,-40
33297838049,33297838055,6,5017,1057,-40
33297935455,33297935463,8,2590,1073,-40
33299816591,33299816598,7,3474,1325,-40
33299888674,33299888681,7,2925,1134,-40
33300059309,33300059315,6,2691,1481,-40
33300292426,33300292434,8,3919,1609,-40
33301203167,33301203173,6,2281,1194,-40
33304439366,33304439372,6,3919,1278,-40
33307951588,33307951594,6,2942,1417,-40
33315586682,33315586687,5,2150,969,-40
33316960690,33316960697,7,2726,1291,-40
33317437198,33317437205,7,2205,1274,-40
33319359198,33319359203,5,3448,1234,-40
33320474868,33320474875,7,2638,1300,-40
33321189382,33321189386,4,2241,1208,-40
33322236015,33322236021,6,1592,1032,-40
33324659854,33324659860,6,789,553,-40
33326159928,33326159935,7,1820,900,-40
33326843106,33326843110,4,2080,811,-40
33328707630,33328707635,5,2395,971,-40
33331055151,33331055158,7,3952,1664,-40
33336834290,33336834298,8,2524,818,-40
33339728565,33339728570,5,1573,1013,-40
33340207121,33340207107,-14,1810,651,-40
33345908690,33345908695,5,3302,1642,-40
33352303604,33352303611,7,3742,1372,-40
33352340152,33352340163,11,3059,1522,-40
33358886782,33358886789,7,2457,1368,-40
33359030428,33359030433,5,2928,1634,-40
33361753259,33361753268,9,3140,1004,-40
33366315676,33366315690,14,254,2272,-40
33375359841,33375359847,6,3251,1616,-40
33386032351,33386032356,5,2233,1394,-40
33389173058,33389173066,8,2851,1276,-40
33394869067,33394869073,6,3393,1375,-40
33397674657,33397674637,-20,3565,1187,-40
33397830760,33397830776,16,4574,1417,-40
33400437279,33400437287,8,2515,1398,-40
33403910559,33403910564,5,2634,1178,-40
33405034141,33405034146,5,2357,1007,-40
33410060366,33410060351,-15,3494,974,-40
33410843219,33410843218,-1,1728,2702,-40
33413232598,33413232604,6,2874,1096,-40
33413795733,33413795712,-21,2854,1141,-40
33413907931,33413907934,3,3256,2634,-40
33415639108,33415639113,5,2501,986,-40
33417102966,33417102974,8,2863,1219,-40
33418360032,33418360038,6,3030,1012,-40
33418456486,33418456492,6,2379,1570,-40
33419419347,33419419354,7,3673,1622,-40
33420605465,33420605471,6,2859,1068,-40
33424142793,33424142800,7,2595,1235,-40
33424414842,33424414849,7,3131,1293,-40
33424464123,33424464127,4,2707,1377,-40
33425662506,33425662509,3,1541,1193,-40
33426626774,33426626780,6,4082,1604,-40
33426736735,33426736742,7,3052,1188,-40
33429791012,33429791018,6,2327,1277,-40
33432088106,33432088114,8,3023,1374,-40
33434274555,33434274562,7,2422,1015,-40
33438014038,33438014044,6,3137,1428,-40
33440661565,33440661571,6,3308,1170,-40
33449454993,33449454998,5,3539,1043,-40
33450286902,33450286909,7,2360,904,-40
33451697479,33451697479,0,2670,3384,-40
33465196845,33465196850,5,3083,1427,-40
33467084093,33467084099,6,2701,1317,-40
33473311401,33473311406,5,4494,1174,-40
33473630398,33473630384,-14,2277,1027,-40
33476913879,33476913873,-6,747,1918,-40
33478091075,33478091080,5,2548,1169,-40
33478330307,33478330314,7,3045,1343,-40
33481802282,33481802283,1,5557,5098,-40
33483283118,33483283123,5,878,1094,-40
33485312217,33485312221,4,3238,1188,-40
33487667565,33487667571,6,3150,1238,-40
33488566219,33488566215,-4,22524,45392,-40
33488692765,33488692772,7,3065,1742,-40
33491300348,33491300353,5,3092,1038,-40
33491413482,33491413465,-17,3575,1422,-40
33493464446,33493464452,6,3859,1195,-40
33495391280,33495391286,6,2269,1384,-40
33495763438,33495763441,3,2646,1890,-40
33496246194,33496246200,6,13381,23985,-40
33496571973,33496571975,2,1698,1357,-40
33497120028,33497120010,-18,1320,574,-40
33499978699,33499978719,20,16389,44265,-40
33502068862,33502068866,4,1906,1014,-40
33507720597,33507720603,6,2320,1492,-40
33509187459,33509187458,-1,855,237,-40
33513526927,33513526933,6,2906,1214,-40
33516500145,33516500154,9,3003,1081,-40
33517816116,33517816122,6,3541,1343,-40
33521636919,33521636925,6,2507,2074,-40
33522905433,33522905434,1,1411,1445,-40
33524005959,33524005965,6,2323,1169,-40
33525791477,33525791482,5,2811,1576,-40
33527470416,33527470405,-11,904,4926,-40
33529500297,33529500302,5,4114,2322,-40
33529852165,33529852169,4,2802,1195,-40
33531259894,33531259901,7,3937,1551,-40
33531402914,33531402915,1,555,86,-40
33537231589,33537231595,6,2505,1233,-40
33538956437,33538956443,6,2865,1077,-40
33542078882,33542078887,5,1973,875,-40
33543603510,33543603517,7,3076,1340,-40
33549062721,33549062722,1,883,1439,-40
33549283991,33549283997,6,2451,1147,-40
33549942714,33549942721,7,4080,1813,-40
33555676879,33555676886,7,2896,1605,-40
33556451271,33556451276,5,2929,1001,-40
33556965090,33556965091,1,677,161,-40
33564025334,33564025339,5,1673,545,-40
33564056783,33564056802,19,2877,1261,-40
33565114123,33565114123,0,854,164,-40
33567055091,33567055073,-18,1295,254,-40
33570120390,33570120397,7,2652,1243,-40
33575017348,33575017355,7,2081,1275,-40
33575382202,33575382206,4,2101,1060,-40
33577253341,33577253343,2,1099,1227,-40
33581456806,33581456811,5,2688,1482,-40
33583558110,33583558108,-2,942,156,-40
33589148920,33589148927,7,2875,1511,-40
33595981253,33595981258,5,3488,1641,-40
33597355249,33597355254,5,2496,1510,-40
33600941802,33600941807,5,2874,1274,-40
33605629978,33605629983,5,2707,981,-40
33606576953,33606576957,4,3101,1629,-40
33609788686,33609788694,8,3099,1098,-40
33613389623,33613389624,1,1225,1153,-40
33614320307,33614320309,2,1261,891,-40
33621106153,33621106159,6,3030,1030,-40
33622610402,33622610407,5,3685,1105,-40
33624460583,33624460587,4,3344,1679,-40
33628034174,33628034179,5,3089,1575,-40
33630740984,33630740990,6,3334,957,-40
33631477494,33631477501,7,2574,1082,-40
33639091622,33639091629,7,3062,1874,-40
33642515446,33642515450,4,2598,1415,-40
33643643517,33643643524,7,3011,1061,-40
33643749911,33643749919,8,3517,1549,-40
33647335739,33647335745,6,2620,1381,-40
33648917879,33648917882,3,2862,2452,-40
33649290639,33649290645,6,3907,1595,-40
33649564785,33649564792,7,3342,1348,-40
33649617396,33649617379,-17,3327,944,-40
33653876997,33653877003,6,3510,1373,-40
33654721112,33654721109,-3,24428,14788,-40
33655324024,33655324031,7,3280,1476,-40
33662513277,33662513282,5,2445,1317,-40
33664677902,33664677908,6,3380,1272,-40
33674513393,33674513398,5,2953,994,-40
33675696678,33675696685,7,1873,730,-40
33680426939,33680426937,-2,1845,1688,-40
33681193407,33681193406,-1,2285,4107,-40
33685128342,33685128346,4,4122,3305,-40
33685968669,33685968666,-3,726,2180,-40
33687995121,33687995125,4,2587,1316,-40
33690921432,33690921437,5,1841,866,-40
33691092211,33691092192,-19,3434,1333,-40
33691585246,33691585251,5,3155,1051,-40
33693049728,33693049735,7,3146,976,-40
33695340387,33695340395,8,2876,1167,-40
33700326819,33700326818,-1,1682,2225,-40
33700673517,33700673531,14,1456,517,-40
33704277375,33704277382,7,2404,1630,-40
33707171147,33707171154,7,2748,992,-40
33708589103,33708589091,-12,1183,466,-40
33711769887,33711769893,6,2706,1187,-40
33712762592,33712762598,6,2927,1916,-40
33716203822,33716203818,-4,354,986,-40
33719276267,33719276273,6,1893,930,-40
33720084776,33720084782,6,4213,1620,-40
33725327999,33725328007,8,3122,943,-40
33726080992,33726080999,7,2648,1533,-40
33727512430,33727512436,6,2732,1370,-40
33733305429,33733305423,-6,911,2518,-40
33738353557,33738353562,5,3158,1394,-40
33740273686,33740273691,5,2762,1376,-40
33741228056,33741228063,7,2860,1372,-40
33745064470,33745064477,7,1700,719,-40
33747326946,33747326951,5,2017,1119,-40
33754132938,33754132919,-19,3100,1224,-40
33754591386,33754591392,6,2170,1285,-40
33755383409,33755383415,6,3010,1355,-40
33756194706,33756194714,8,3782,1627,-40
33757012722,33757012704,-18,1410,933,-40
33763383598,33763383606,8,2800,1032,-40
33763933626,33763933635,9,3342,1302,-40
33770783947,33770783953,6,3219,1136,-40
33776668568,33776668573,5,2350,1155,-40
33776967458,33776967455,-3,1222,2913,-40
33786365454,33786365460,6,2810,1073,-40
33786445690,33786445698,8,3416,1407,-40
33787679110,33787679115,5,3165,1716,-40
33788626939,33788626945,6,2938,1274,-40
33788747610,33788747617,7,2845,1537,-40
33790097362,33790097356,-6,1124,3024,-40
33791376208,33791376205,-3,1172,3755,-40
33794104553,33794104561,8,3530,1421,-40
33794356165,33794356153,-12,1342,348,-40
33794449667,33794449672,5,2243,1339,-40
33797277285,33797277290,5,3496,1478,-40
33807204761,33807204759,-2,1706,2828,-40
33807907714,33807907718,4,1561,1087,-40
33810137741,33810137722,-19,1990,441,-40
33810242963,33810242969,6,1978,974,-40
33810473340,33810473346,6,3864,870,-40
33818230278,33818230283,5,2681,1463,-40
33821366688,33821366695,7,8093,18729,-40
33823631765,33823631769,4,2349,1507,-40
33824704858,33824704866,8,2066,1392,-40
33825844208,33825844214,6,3061,1139,-40
33827546684,33827546691,7,4045,1345,-40
33828296814,33828296821,7,2943,1320,-40
33828412816,33828412811,-5,543,364,-40
33833287534,33833287542,8,3737,1617,-40
33837700042,33837700047,5,2631,1728,-40
33841532546,33841532529,-17,1308,494,-40
33841772246,33841772252,6,3472,1225,-40
33842205461,33842205467,6,3141,1155,-40
33848394377,33848394382,5,3421,1596,-40
33848796673,33848796677,4,1784,1052,-40
33856166059,33856166057,-2,2289,4878,-40
33856434541,33856434547,6,3087,1479,-40
33856803177,33856803184,7,2083,816,-40
33857524730,33857524736,6,3009,1120,-40
33860191807,33860191814,7,2286,1274,-40
33862668070,33862668078,8,2896,1135,-40
33863281326,33863281331,5,2089,896,-40
33864990201,33864990206,5,3199,1560,-40
33865342602,33865342608,6,2619,1234,-40
33868192519,33868192524,5,2384,1862,-40
33875002965,33875002973,8,2397,1243,-40
33876727066,33876727073,7,3119,1340,-40
33877460434,33877460441,7,1329,711,-40
33878146213,33878146218,5,2442,986,-40
33879628190,33879628198,8,3292,1290,-40
33880271504,33880271499,-5,2014,6393,-40
33881177298,33881177291,-7,1977,6725,-40
33881727294,33881727301,7,2850,1011,-40
33884075229,33884075235,6,3218,1357,-40
33885303541,33885303549,8,3323,1674,-40
33887457937,33887457942,5,1438,886,-40
33890830197,33890830202,5,1719,885,-40
33894942582,33894942588,6,3507,1187,-40
33897630876,33897630883,7,3812,1889,-40
33899981409,33899981412,3,2280,1523,-40
33900058873,33900058859,-14,856,236,-40
33902307015,33902307022,7,4227,1564,-40
33902945775,33902945782,7,2465,912,-40
33904443373,33904443379,6,1950,1383,-40
33905118614,33905118616,2,471,21,-40
33905895351,33905895359,8,1878,1313,-40
33907612122,33907612129,7,1264,987,-40
33908602262,33908602269,7,3124,1777,-40
33910832598,33910832577,-21,2188,1373,-40
33919032326,33919032331,5,2377,1298,-40
33919256298,33919256303,5,2681,1014,-40
33925827569,33925827574,5,2807,1081,-40
33927030278,33927030286,8,2371,1370,-40
33929774725,33929774731,6,3396,1062,-40
33932160749,33932160754,5,2353,1300,-40
33933557921,33933557926,5,2706,899,-40
33933982143,33933982150,7,3070,1770,-40
33934209898,33934209883,-15,1331,684,-40
33934723233,33934723239,6,2897,1222,-40
33940708107,33940708114,7,2672,1101,-40
33949770491,33949770497,6,3353,1174,-40
33949836112,33949836118,6,2606,1480,-40
33950433554,33950433560,6,1854,1245,-40
33952792603,33952792607,4,2457,1212,-40
33958285811,33958285818,7,2329,1267,-40
33961101654,33961101660,6,3803,1345,-40
33970570172,33970570194,22,335,4200,-40
33971730817,33971730821,4,2865,898,-40
33972116726,33972116715,-11,842,95,-40
33973247310,33973247315,5,3193,1551,-40
33977198678,33977198686,8,2449,990,-40
33979773471,33979773478,7,1783,961,-40
33980302881,33980302887,6,4000,1215,-40
33981807536,33981807543,7,2800,994,-40
33982479530,33982479515,-15,817,193,-40
33985926946,33985926950,4,2461,1149,-40
33986000382,33986000360,-22,2359,1206,-40
33988047597,33988047594,-3,1414,2064,-40
33988355687,33988355693,6,3581,1752,-40
33992368684,33992368689,5,1857,1411,-40
33995245823,33995245831,8,2089,1002,-40
33995409045,33995409050,5,2406,1435,-40
33996088265,33996088271,6,3342,1234,-40
34004386263,34004386261,-2,919,1309,-40
34005772387,34005772394,7,2444,907,-40
34006773232,34006773238,6,3230,1152,-40
34006901371,34006901377,6,1411,504,-40
34009157790,34009157794,4,1111,791,-40
34011177266,34011177272,6,2885,1600,-40
34021690235,34021690237,2,44288,3063,-40
34023957178,34023957186,8,3264,1558,-40
34024781582,34024781564,-18,2540,1033,-40
34026932760,34026932766,6,2732,2102,-40
34027269291,34027269298,7,2412,728,-40
34041673069,34041673075,6,2853,1151,-40
34044686888,34044686895,7,1745,961,-40
34046251932,34046251937,5,2781,1139,-40
34046981901,34046981905,4,2367,1386,-40
34047502363,34047502369,6,1951,958,-40
34048051474,34048051478,4,2985,1919,-40
34054113349,34054113355,6,3045,1038,-40
34055143615,34055143623,8,2926,1159,-40
34056446997,34056447002,5,1693,1000,-40
34058955753,34058955758,5,1767,918,-40
34061290165,34061290171,6,2133,800,-40
34061696582,34061696587,5,4042,1482,-40
34063085260,34063085267,7,3736,1592,-40
34067014729,34067014709,-20,819,2343,-40
34071382341,34071382346,5,3059,1542,-40
34073914663,34073914670,7,3364,1686,-40
34077630937,34077630942,5,3274,1402,-40
34078543749,34078543755,6,2218,996,-40
34080543935,34080543941,6,3106,1191,-40
34087742835,34087742838,3,1461,1098,-40
34098055034,34098055041,7,2219,957,-40
34100374218,34100374203,-15,2932,838,-40
34102155339,34102155318,-21,3359,1190,-40
34103809217,34103809224,7,2727,1413,-40
34104676622,34104676629,7,2329,1085,-40
34107178299,34107178305,6,3573,963,-40
34107750235,34107750233,-2,1131,1616,-40
34111773472,34111773477,5,2471,973,-40
34115589701,34115589707,6,3008,1203,-40
34115866784,34115866790,6,3814,910,-40
34118241524,34118241531,7,5564,1092,-40
34119114283,34119114291,8,2302,1193,-40
34120443965,34120443970,5,2831,1272,-40
34122762986,34122762994,8,2407,745,-40
34127085997,34127086007,10,994,39,-40
34127628521,34127628527,6,3572,1334,-40
34128399431,34128399435,4,2177,1146,-40
34130250413,34130250418,5,2071,1217,-40
34131248561,34131248568,7,4008,1429,-40
34131426037,34131426049,12,2532,1190,-40
34133326776,34133326781,5,2469,1339,-40
34147221377,34147221383,6,3716,1411,-40
34147434017,34147434023,6,4261,1466,-40
34152529116,34152529120,4,2323,1270,-40
34154022537,34154022521,-16,1533,1954,-40
34157532451,34157532444,-7,1205,8743,-40
34160204151,34160204147,-4,1546,4384,-40
34161330634,34161330640,6,2492,1364,-40
34162614746,34162614745,-1,1408,1468,-40
34167381043,34167381050,7,3569,1418,-40
34169368138,34169368143,5,2729,1395,-40
34170777526,34170777531,5,2541,1421,-40
34175182692,34175182697,5,3202,921,-40
34175830183,34175830189,6,2913,1409,-40
34177546258,34177546259,1,3675,4107,-40
34183490032,34183490038,6,2347,1407,-40
34183956143,34183956150,7,2802,1129,-40
34186351519,34186351525,6,1759,996,-40
34186415015,34186415003,-12,2693,882,-40
34191248543,34191248550,7,7380,3038,-40
34192015190,34192015185,-5,4446,10628,-40
34192080881,34192080876,-5,1024,334,-40
34194357503,34194357513,10,2639,1011,-40
34195825693,34195825698,5,2270,1464,-40
34196692206,34196692211,5,2489,1492,-40
34197250477,34197250482,5,3157,1279,-40
34197364474,34197364457,-17,641,200,-40
34201083737,34201083743,6,3502,1359,-40
34202065780,34202065786,6,2684,1281,-40
34202956096,34202956103,7,1442,1006,-40
34203869866,34203869871,5,2728,1308,-40
34204509123,34204509107,-16,1959,567,-40
34206061503,34206061509,6,3582,1293,-40
34213323443,34213323449,6,2280,932,-40
34215602889,34215602896,7,2241,1154,-40
34220751937,34220751949,12,77,1073,-40
34220826074,34220826057,-17,3597,1175,-40
34223521476,34223521473,-3,8642,17404,-40
34223886461,34223886456,-5,25205,14087,-40
34225141894,34225141890,-4,1095,3175,-40
34227392530,34227392535,5,2336,1268,-40
34228878411,34228878415,4,2814,837,-40
34230576798,34230576804,6,3414,1979,-40
34230650996,34230651002,6,2943,845,-40
34236518777,34236518783,6,3426,1597,-40
34239287129,34239287135,6,2514,1083,-40
34242943598,34242943603,5,1731,976,-40
34244469486,34244469493,7,2843,1503,-40
34250842787,34250842785,-2,1674,3672,-40
34256754916,34256754913,-3,709,1952,-40
34257363969,34257363975,6,2366,1128,-40
34258174364,34258174370,6,2540,1052,-40
34259235963,34259235970,7,3196,1933,-40
34259948921,34259948926,5,1643,940,-40
34261718815,34261718821,6,2637,1083,-40
34263311017,34263311018,1,1452,2990,-40
34263853586,34263853586,0,1149,1829,-40
34269696933,34269696936,3,2470,1579,-40
34276570813,34276570810,-3,1046,2750,-40
34277432119,34277432123,4,1585,519,-40
34286704313,34286704318,5,3144,997,-40
34290373133,34290373140,7,2373,1070,-40
34291623868,34291623874,6,2284,1244,-40
34294957032,34294957040,8,3352,1372,-40
34298360941,34298360947,6,2329,1375,-40
34298727535,34298727543,8,3380,1497,-40
34300396571,34300396573,2,982,158,-40
34302141393,34302141398,5,1939,1223,-40
34303640091,34303640090,-1,2080,2457,-40
34312743196,34312743202,6,2984,1347,-40
34312819114,34312819113,-1,805,1485,-40
34313698202,34313698206,4,1665,1282,-40
34320930044,34320930050,6,2849,1675,-40
34327430031,34327430037,6,3024,1380,-40
34328635843,34328635847,4,2218,1476,-40
34334926777,34334926781,4,1861,1558,-40
34336311921,34336311927,6,3251,1274,-40
34337701192,34337701197,5,1553,879,-40
34338625361,34338625366,5,2385,1596,-40
34341834248,34341834254,6,2664,1268,-40
34344957249,34344957245,-4,809,2217,-40
34346225845,34346225850,5,2422,1066,-40
34347337334,34347337330,-4,1465,2976,-40
34347527249,34347527254,5,2515,1642,-40
34347692554,34347692563,9,4837,1880,-40
34348442868,34348442873,5,2504,1317,-40
34349503333,34349503328,-5,1783,6631,-40
34349777614,34349777621,7,4250,1685,-40
34350043787,34350043794,7,2648,1351,-40
34350760324,34350760325,1,1975,1279,-40
34354759629,34354759634,5,3100,1986,-40
34354952469,34354952475,6,2149,1342,-40
34357572819,34357572799,-20,24368,28853,-40
34358079216,34358079217,1,1397,1322,-40
34365769193,34365769174,-19,1847,995,-40
34366901716,34366901722,6,3688,1520,-40
34371353537,34371353543,6,2412,1236,-40
34371547634,34371547637,3,1261,1155,-40
34373776898,34373776904,6,3499,1218,-40
34375862269,34375862275,6,2232,701,-40
34377364809,34377364815,6,3318,1491,-40
34380256158,34380256163,5,2639,820,-40
34380471394,34380471400,6,3708,1985,-40
34380693761,34380693767,6,3012,1354,-40
34385274814,34385274821,7,2084,1180,-40
34386355557,34386355563,6,3955,966,-40
34386455199,34386455201,2,768,1126,-40
34387559130,34387559138,8,3843,1435,-40
34387735338,34387735338,0,2875,4053,-40
34389632937,34389632943,6,2478,865,-40
34389977329,34389977314,-15,1417,394,-40
34390286778,34390286784,6,3032,1289,-40
34393346738,34393346742,4,2563,1563,-40
34398679743,34398679749,6,2631,1049,-40
34401780114,34401780118,4,1610,977,-40
34403396972,34403396979,7,4122,2308,-40
34408009102,34408009110,8,2335,738,-40
34413858637,34413858636,-1,2645,3887,-40
34414253542,34414253551,9,3489,930,-40
34421785231,34421785234,3,1699,1577,-40
34426572099,34426572106,7,2604,906,-40
34426970338,34426970342,4,2811,671,-40
34428250158,34428250162,4,1265,1002,-40
34429202588,34429202595,7,2546,965,-40
34431059047,34431059052,5,1445,749,-40
34447029712,34447029718,6,2985,1207,-40
34448123382,34448123387,5,2057,1493,-40
34449864609,34449864616,7,3560,1205,-40
34450385992,34450385998,6,1880,742,-40
34451258253,34451258259,6,2347,1170,-40
34452617575,34452617581,6,1993,1300,-40
34460233395,34460233402,7,4473,1514,-40
34462736874,34462736880,6,3762,1583,-40
34468087497,34468087507,10,2357,1140,-40
34470219174,34470219179,5,1808,971,-40
34470445199,34470445185,-14,1207,687,-40
34470748142,34470748149,7,3818,1673,-40
34478013985,34478013970,-15,2001,1322,-40
34481563422,34481563427,5,1724,1320,-40
34485955646,34485955651,5,2642,1067,-40
34490159605,34490159610,5,1712,1396,-40
34491406249,34491406252,3,26975,111852,-40
34491743665,34491743670,5,2457,889,-40
34498479143,34498479139,-4,1612,3932,-40
34499391834,34499391836,2,6228,25053,-40
34509033802,34509033807,5,2805,1022,-40
34511167822,34511167827,5,2199,1347,-40
34516236913,34516236918,5,2484,731,-40
34519819478,34519819484,6,2664,1007,-40
34521192725,34521192730,5,2225,1311,-40
34528444791,34528444797,6,3298,1203,-40
34529297430,34529297437,7,2870,1006,-40
34531684288,34531684294,6,2652,984,-40
34534162103,34534162109,6,2342,1615,-40
34534253316,34534253322,6,3681,2142,-40
34535404419,34535404424,5,1800,1009,-40
34535712186,34535712178,-8,654,210,-40
34536792534,34536792539,5,2092,1406,-40
34537900398,34537900404,6,2424,1473,-40
34545194618,34545194625,7,3639,1220,-40
34545438299,34545438307,8,1836,1047,-40
34554060073,34554060080,7,2644,1412,-40
34554359476,34554359482,6,3019,1220,-40
34555576636,34555576641,5,2309,1055,-40
34557395424,34557395430,6,2525,1336,-40
34563307088,34563307094,6,3767,1460,-40
34563958153,34563958159,6,2334,1134,-40
34564831083,34564831082,-1,1279,2341,-40
34567979146,34567979150,4,2182,972,-40
34568290169,34568290175,6,2639,991,-40
34569224248,34569224257,9,2001,848,-40
34571297286,34571297293,7,2142,1331,-40
34572842143,34572842141,-2,2416,3575,-40
34573735345,34573735350,5,2700,1171,-40
34573874896,34573874904,8,2774,1280,-40
34578773649,34578773658,9,3747,1569,-40
34578879751,34578879763,12,2870,1152,-40
34580464057,34580464062,5,1797,934,-40
34581080789,34581080795,6,3369,1629,-40
34582316456,34582316463,7,3455,1194,-40
34585551494,34585551499,5,2868,1361,-40
34585786990,34585786995,5,3231,1083,-40
34592809134,34592809140,6,2044,1225,-40
34592909616,34592909626,10,2009,704,-40
34598787113,34598787119,6,2858,1161,-40
34600613365,34600613372,7,2811,1631,-40
34602843625,34602843631,6,2444,1265,-40
34604286618,34604286625,7,2789,1050,-40
34610751403,34610751407,4,2705,1346,-40
34612056181,34612056186,5,2769,1138,-40
34617602581,34617602586,5,19104,28277,-40
34623231177,34623231183,6,2535,1029,-40
34624492987,34624492994,7,2812,1309,-40
34625404761,34625404766,5,2839,1156,-40
34628951614,34628951621,7,3924,2033,-40
34629364353,34629364361,8,3824,1401,-40
34631750418,34631750400,-18,1689,1007,-40
34642401916,34642401923,7,2996,940,-40
34644051009,34644051014,5,3299,1526,-40
34644243768,34644243772,4,1617,979,-40
34648191854,34648191859,5,2332,1034,-40
34659966861,34659966868,7,2416,1020,-40
34662389545,34662389550,5,3146,1069,-40
34663047673,34663047678,5,2640,1239,-40
34666138126,34666138131,5,2935,1255,-40
34667956092,34667956098,6,3576,1688,-40
34669836665,34669836673,8,3428,1504,-40
34673048197,34673048202,5,2160,1436,-40
34675777565,34675777570,5,3131,1294,-40
34676521175,34676521182,7,3464,1395,-40
34679067682,34679067688,6,4013,1535,-40
34683420932,34683420938,6,3887,1492,-40
34685921598,34685921604,6,2611,1313,-40
34687973613,34687973619,6,3579,1118,-40
34689154942,34689154921,-21,4690,1761,-40
34690342835,34690342841,6,2692,1473,-40
34692374400,34692374405,5,2924,1733,-40
34695043985,34695043991,6,2572,913,-40
34696209671,34696209690,19,1135,464,-40
34698815370,34698815377,7,2610,1450,-40
34699083240,34699083241,1,726,234,-40
34702964893,34702964886,-7,1500,5118,-40
34704210294,34704210300,6,2488,1228,-40
34704612966,34704612944,-22,2237,629,-40
34706904197,34706904202,5,2993,1373,-40
34710163333,34710163338,5,3732,1801,-40
34710690153,34710690155,2,1451,1130,-40
34711141890,34711141897,7,3063,1170,-40
34713011786,34713011792,6,3074,2299,-40
34714204798,34714204804,6,2400,1017,-40
34717590392,34717590389,-3,22763,10247,-40
34719562381,34719562386,5,2051,1290,-40
34721992293,34721992299,6,2664,1070,-40
34722173350,34722173332,-18,2110,887,-40
34722807867,34722807874,7,3079,1445,-40
34725552650,34725552658,8,2242,1210,-40
34726453793,34726453790,-3,1249,2971,-40
34734290755,34734290762,7,1724,815,-40
34735562767,34735562773,6,1830,1327,-40
34738172058,34738172062,4,3832,2308,-40
34738428417,34738428419,2,2560,1475,-40
34745471575,34745471583,8,3671,1282,-40
34746520278,34746520256,-22,2533,1344,-40
34751679174,34751679182,8,3499,1184,-40
34751826806,34751826804,-2,1091,2347,-40
34751973357,34751973363,6,1637,881,-40
34752157507,34752157513,6,2833,965,-40
34753646077,34753646083,6,2784,1622,-40
34762659879,34762659885,6,3185,1142,-40
34762839301,34762839284,-17,3221,1382,-40
34769310969,34769310968,-1,1285,2559,-40
34769790709,34769790712,3,2172,942,-40
34770413508,34770413492,-16,2837,1609,-40
34771804050,34771804038,-12,906,799,-40
34772138598,34772138606,8,3015,1232,-40
34778244661,34778244667,6,2793,1492,-40
34778468921,34778468929,8,3048,1285,-40
34784155546,34784155549,3,2579,1466,-40
34786139231,34786139238,7,3503,1484,-40
34787912206,34787912210,4,2876,1105,-40
34790845072,34790845078,6,2717,1077,-40
34793249023,34793249034,11,251,944,-40
34794554042,34794554042,0,1053,1495,-40
34795237946,34795237951,5,2121,669,-40
34796908092,34796908099,7,3148,1038,-40
34798187893,34798187899,6,1730,1021,-40
34799877446,34799877452,6,2886,1411,-40
34802252923,34802252929,6,1730,725,-40
34804655886,34804655894,8,2864,1333,-40
34805131780,34805131787,7,2537,1114,-40
34809329894,34809329899,5,2355,1204,-40
34815422861,34815422865,4,2784,1230,-40
34821525921,34821525927,6,2625,1213,-40
34824726919,34824726926,7,2659,1459,-40
34827507904,34827507914,10,25,916,-40
34829080949,34829080954,5,2530,1139,-40
34843995150,34843995158,8,4276,1739,-40
34844555753,34844555759,6,3033,950,-40
34847894461,34847894465,4,3302,1355,-40
34850366472,34850366477,5,3085,1320,-40
34851027103,34851027108,5,2466,1338,-40
34853141235,34853141232,-3,36200,19277,-40
34856234578,34856234586,8,6383,2906,-40
34856366276,34856366282,6,2570,995,-40
34859524159,34859524165,6,3777,1644,-40
34859612249,34859612250,1,1554,2075,-40
34860994442,34860994448,6,3644,1140,-40
34864390984,34864390990,6,2396,718,-40
34866216995,34866217001,6,3629,1001,-40
34867142258,34867142265,7,2374,896,-40
34869205141,34869205149,8,5413,2071,-40
34874197267,34874197269,2,1349,1430,-40
34875464594,34875464600,6,2068,1172,-40
34882639989,34882639998,9,2613,1054,-40
34884080915,34884080921,6,3043,1213,-40
34888613638,34888613643,5,2163,996,-40
34893283636,34893283642,6,3731,1620,-40
34896787672,34896787678,6,3549,1272,-40
34899131816,34899131821,5,3391,1477,-40
34899830424,34899830430,6,1373,664,-40
34902669410,34902669418,8,4384,1304,-40
34907970912,34907970919,7,2355,1024,-40
34909026132,34909026139,7,1982,980,-40
34909443287,34909443280,-7,838,101,-40
34910423313,34910423319,6,1028,710,-40
34912932724,34912932730,6,3813,1704,-40
34922538969,34922538975,6,3766,1515,-40
34923427546,34923427553,7,3089,1333,-40
34924895653,34924895658,5,1860,938,-40
34924989986,34924990000,14,1017,285,-40
34926556574,34926556552,-22,3383,1586,-40
34927281142,34927281149,7,2193,1041,-40
34929771334,34929771339,5,2547,1236,-40
34931548357,34931548363,6,2309,1315,-40
34932714653,34932714660,7,1918,1082,-40
34933182877,34933182881,4,4511,3199,-40
34937927490,34937927495,5,2356,1356,-40
34938051067,34938051074,7,2927,915,-40
34941452122,34941452129,7,2787,1198,-40
34944541938,34944541945,7,2361,970,-40
34947352745,34947352752,7,3448,1471,-40
34950277258,34950277266,8,1905,1057,-40
34950673985,34950673992,7,2836,1020,-40
34953079567,34953079575,8,2461,1259,-40
34958403058,34958403062,4,2120,1059,-40
34958582182,34958582170,-12,1279,372,-40
34960334396,34960334378,-18,2097,1048,-40
34962740515,34962740521,6,2334,1282,-40
34964041085,34964041091,6,2960,1230,-40
34968154693,34968154699,6,3293,1661,-40
34971116225,34971116230,5,2478,1467,-40
34975989413,34975989418,5,1838,1364,-40
34980405334,34980405330,-4,4182,15705,-40
34981789447,34981789453,6,2161,1441,-40
34984850466,34984850469,3,1882,1700,-40
34986871266,34986871271,5,2793,1043,-40
34988400966,34988400971,5,3338,1431,-40
34990026840,34990026841,1,1809,1946,-40
34992026922,34992026926,4,2113,1262,-40
34992144333,34992144338,5,1993,711,-40
34995361365,34995361369,4,2519,1282,-40
34996510318,34996510324,6,3230,1578,-40
34997236227,34997236233,6,1109,1422,-40
34997644562,34997644570,8,4087,1278,-40
35002842984,35002842990,6,2204,1385,-40
35006060982,35006060986,4,1317,1015,-40
35006828121,35006828126,5,2066,830,-40
35006945569,35006945554,-15,1969,527,-40
35007731437,35007731442,5,3425,1304,-40
35012004467,35012004473,6,2908,1009,-40
35014005631,35014005620,-11,1955,986,-40
35023037231,35023037239,8,2066,1122,-40
35025087205,35025087211,6,1558,925,-40
35025398174,35025398176,2,10301,10709,-40
35035027883,35035027890,7,3780,1132,-40
35037083026,35037083031,5,2473,1264,-40
35038670499,35038670500,1,1289,1310,-40
35041782294,35041782300,6,3067,1529,-40
35043043641,35043043646,5,2163,991,-40
35043155862,35043155843,-19,1253,488,-40
35047364484,35047364489,5,2305,1419,-40
35048481389,35048481372,-17,2210,806,-40
35048961614,35048961620,6,3817,1582,-40
35049784385,35049784391,6,2092,1168,-40
35051564234,35051564243,9,3041,1339,-40
35054002592,35054002598,6,2489,1088,-40
35054073799,35054073805,6,2250,1179,-40
35060283246,35060283250,4,1268,974,-40
35062474787,35062474794,7,2603,1451,-40
35064209929,35064209913,-16,320,1247,-40
35064838183,35064838190,7,2506,1465,-40
35064890594,35064890580,-14,2386,1149,-40
35067202999,35067203006,7,3599,1317,-40
35081978933,35081978931,-2,20537,12960,-40
35082254806,35082254811,5,3712,1182,-40
35087646402,35087646408,6,3572,1116,-40
35087817621,35087817601,-20,2203,1303,-40
35094490998,35094491003,5,2813,926,-40
35095731277,35095731285,8,2266,1122,-40
35096181566,35096181548,-18,3270,1195,-40
35097714397,35097714404,7,3175,1299,-40
35099607941,35099607947,6,2584,1483,-40
35103010733,35103010739,6,2735,1345,-40
35107557625,35107557631,6,3326,1162,-40
35108174614,35108174619,5,3273,1062,-40
35109940525,35109940528,3,2007,1855,-40
35110676192,35110676198,6,3583,1240,-40
35114817849,35114817854,5,3111,976,-40
35115891435,35115891442,7,3271,1203,-40
35119012418,35119012425,7,1979,1130,-40
35121936137,35121936142,5,1562,975,-40
35122057244,35122057251,7,3970,1382,-40
35122532531,35122532536,5,1844,1379,-40
35125548781,35125548787,6,3497,1692,-40
35125799349,35125799354,5,3333,1268,-40
35131429541,35131429547,6,3191,1610,-40
35131906592,35131906599,7,2611,1255,-40
35133888765,35133888770,5,2482,1525,-40
35135572745,35135572751,6,1468,761,-40
35136027945,35136027955,10,2435,1152,-40
35136401686,35136401692,6,3401,1528,-40
35141022675,35141022682,7,2288,1470,-40
35147890439,35147890424,-15,33984,15045,-40
35149061449,35149061454,5,4071,1336,-40
35149530528,35149530531,3,2973,1425,-40
35152247914,35152247925,11,1020,324,-40
35160973614,35160973619,5,2323,1421,-40
35162141625,35162141630,5,2153,1374,-40
35163208739,35163208747,8,818,664,-40
35164152150,35164152157,7,2292,1108,-40
35165854454,35165854459,5,2450,1341,-40
35168148978,35168148974,-4,862,1049,-40
35171317509,35171317513,4,1105,721,-40
35171455941,35171455945,4,3075,1653,-40
35171662442,35171662448,6,3884,1413,-40
35171699213,35171699215,2,1855,1877,-40
35173569133,35173569139,6,2492,1421,-40
35175239114,35175239118,4,2135,1132,-40
35176711533,35176711539,6,2638,893,-40
35177439677,35177439684,7,3748,1629,-40
35180117132,35180117135,3,2030,1970,-40
35181177744,35181177751,7,2991,1117,-40
35184615611,35184615618,7,3333,1509,-40
35186819290,35186819297,7,2984,1222,-40
35188911798,35188911803,5,2713,898,-40
35197362070,35197362077,7,2846,1428,-40
35200618948,35200618954,6,2379,1159,-40
35201262458,35201262464,6,2648,1422,-40
35203484590,35203484597,7,1411,819,-40
35208329913,35208329918,5,2922,958,-40
35223397849,35223397855,6,1867,1203,-40
35223562978,35223562994,16,416,171,-40
35224170897,35224170903,6,3874,1070,-40
35225629220,35225629226,6,2368,1062,-40
35225950722,35225950705,-17,1182,457,-40
35226680965,35226680971,6,2954,1252,-40
35228265401,35228265408,7,2940,1125,-40
35234254774,35234254769,-5,3042,51596,-40
35240046069,35240046076,7,2798,1281,-40
35240482657,35240482657,0,1099,311,-40
35240804825,35240804810,-15,1483,322,-40
35244660693,35244660699,6,2748,1366,-40
35253746730,35253746738,8,2381,1548,-40
35254636122,35254636120,-2,1485,1942,-40
35254961686,35254961693,7,2940,1451,-40
35256142517,35256142522,5,3572,1596,-40
35256385600,35256385607,7,4238,1348,-40
35256807232,35256807238,6,2437,1287,-40
35257620151,35257620158,7,3651,1508,-40
35266985462,35266985467,5,2552,1087,-40
35268438367,35268438374,7,2432,941,-40
35272472182,35272472189,7,5011,1757,-40
35274003693,35274003699,6,2407,922,-40
35274662063,35274662070,7,2215,1044,-40
35275464837,35275464843,6,2974,699,-40
35277681606,35277681587,-19,3298,1557,-40
35281791933,35281791938,5,2247,939,-40
35282873820,35282873824,4,3448,2590,-40
35283958517,35283958521,4,3271,1389,-40
35287969045,35287969039,-6,2341,8181,-40
35292937029,35292937036,7,2453,1123,-40
35294793556,35294793563,7,2469,796,-40
35297302302,35297302307,5,2156,1311,-40
35300165099,35300165097,-2,2371,4604,-40
35300830558,35300830564,6,2494,1172,-40
35302069130,35302069135,5,4091,1709,-40
35303689065,35303689069,4,2641,1095,-40
35305141878,35305141885,7,2959,1166,-40
35307567582,35307567587,5,1605,1236,-40
35308922017,35308922022,5,3257,1127,-40
35316384346,35316384353,7,3834,1539,-40
35318365553,35318365558,5,4766,2574,-40
35322304341,35322304345,4,1852,1474,-40
35322660449,35322660452,3,3302,2920,-40
35325528281,35325528288,7,3026,1447,-40
35327734353,35327734359,6,2091,1080,-40
35330472571,35330472577,6,2708,839,-40
35333242245,35333242250,5,2052,804,-40
35333876770,35333876767,-3,1305,3817,-40
35336728470,35336728478,8,2700,1102,-40
35337396302,35337396324,22,1908,1059,-40
35339776366,35339776378,12,11327,52237,-40
35341460518,35341460525,7,2073,873,-40
35342354211,35342354218,7,2963,1029,-40
35344868021,35344868001,-20,1922,659,-40
35346328214,35346328222,8,3018,1590,-40
35346833007,35346833013,6,2185,1221,-40
35347560397,35347560380,-17,938,340,-40
35348990615,35348990619,4,3138,1414,-40
35350202970,35350202975,5,3056,1371,-40
35351079775,35351079774,-1,1122,1450,-40
35352217953,35352217960,7,1821,862,-40
35352508262,35352508242,-20,2593,1482,-40
35356104132,35356104138,6,3279,1407,-40
35358165066,35358165072,6,2720,1082,-40
35361835203,35361835211,8,3139,1268,-40
35363033316,35363033322,6,2873,1074,-40
35364242226,35364242230,4,2885,972,-40
35366136241,35366136242,1,1618,1813,-40
35366761293,35366761298,5,3941,1791,-40
35367007520,35367007525,5,2709,1333,-40
35373102769,35373102768,-1,1841,2304,-40
35374606346,35374606353,7,2632,1735,-40
35375213136,35375213138,2,1496,1277,-40
35375854883,35375854872,-11,1480,367,-40
35376513828,35376513834,6,2569,1247,-40
35378718689,35378718696,7,4634,1542,-40
35382362818,35382362825,7,3442,1416,-40
35385274418,35385274425,7,2916,1260,-40
35388233877,35388233882,5,2711,1305,-40
35389864906,35389864910,4,1554,1176,-40
35390282903,35390282915,12,3072,1172,-40
35390374687,35390374667,-20,2308,818,-40
35391451877,35391451877,0,1339,1733,-40
35398688161,35398688167,6,3316,1586,-40
35401151165,35401151166,1,1092,894,-40
35404096253,35404096258,5,3025,1397,-40
35405785281,35405785280,-1,2110,1284,-40
35411923507,35411923513,6,3437,1221,-40
35414480997,35414481003,6,2946,1445,-40
35416212666,35416212675,9,3672,1311,-40
35419181362,35419181369,7,2829,1343,-40
35419731939,35419731944,5,2117,1456,-40
35422760930,35422760938,8,2645,1212,-40
35425216150,35425216157,7,3378,1498,-40
35425418294,35425418299,5,3682,3193,-40
35425859041,35425859045,4,2081,893,-40
35427226134,35427226143,9,2852,1386,-40
35430468450,35430468458,8,1447,850,-40
35431841682,35431841689,7,1951,833,-40
35434207222,35434207220,-2,2603,5601,-40
35445500185,35445500187,2,1823,1084,-40
35446838510,35446838518,8,2674,1026,-40
35447413718,35447413725,7,4002,1690,-40
35447801276,35447801282,6,2565,1115,-40
35451251919,35451251925,6,3019,1150,-40
35451679132,35451679138,6,2702,1353,-40
35453288843,35453288845,2,1394,1150,-40
35454654157,35454654153,-4,1290,5177,-40
35456439842,35456439849,7,2197,1232,-40
35459112990,35459112991,1,1735,2341,-40
35466961693,35466961698,5,2104,918,-40
35468417322,35468417331,9,3195,1198,-40
35468864546,35468864551,5,2316,1062,-40
35470966037,35470966042,5,2633,1034,-40
35472143365,35472143369,4,2543,1423,-40
35473068318,35473068322,4,2576,1341,-40
35474884435,35474884421,-14,2550,1084,-40
35479122247,35479122257,10,1100,780,-40
35479874733,35479874739,6,2495,1358,-40
35480668542,35480668541,-1,1668,2503,-40
35482175847,35482175853,6,2676,1317,-40
35484908238,35484908238,0,996,1844,-40
35486940443,35486940445,2,1610,1952,-40
35488848807,35488848805,-2,2458,4148,-40
35492063845,35492063851,6,2892,1554,-40
35494519094,35494519102,8,3035,1125,-40
35500242360,35500242366,6,3084,1639,-40
35501526472,35501526478,6,3434,925,-40
35502480520,35502480526,6,3126,940,-40
35503872785,35503872792,7,1512,1208,-40
35506517810,35506517813,3,1348,1380,-40
35508929849,35508929855,6,2764,1314,-40
35512706970,35512706963,-7,1577,5946,-40
35519015933,35519015940,7,2929,1440,-40
35520544561,35520544567,6,3264,1279,-40
35521534240,35521534246,6,3013,1374,-40
35526889432,35526889438,6,3390,1317,-40
35532381629,35532381636,7,3336,2329,-40
35533176469,35533176463,-6,2247,7077,-40
35534704853,35534704857,4,2184,1496,-40
35536980662,35536980668,6,2301,1663,-40
35545245721,35545245726,5,3241,1315,-40
35550777290,35550777298,8,3139,1610,-40
35553856234,35553856238,4,3560,1064,-40
35557292250,35557292257,7,2256,1278,-40
35557521428,35557521433,5,2813,867,-40
35561065862,35561065870,8,2303,1297,-40
35562491643,35562491649,6,4261,1372,-40
35564156434,35564156441,7,3708,1774,-40
35564370163,35564370171,8,2572,1159,-40
35564941611,35564941619,8,2976,853,-40
35567034710,35567034714,4,1229,950,-40
35569609741,35569609747,6,4013,1739,-40
35572130206,35572130210,4,2287,1068,-40
35572263545,35572263532,-13,968,476,-40
35573856274,35573856282,8,2431,1394,-40
35579084586,35579084591,5,6355,2557,-40
35583765137,35583765143,6,3749,1570,-40
35586085256,35586085262,6,2662,1361,-40
35588172215,35588172222,7,1848,998,-40
35590832059,35590832043,-16,739,265,-40
35591028914,35591028918,4,3421,1499,-40
35591352093,35591352099,6,3127,1422,-40
35591388058,35591388064,6,2710,1315,-40
35595156133,35595156141,8,2846,927,-40
35595189250,35595189234,-16,2175,580,-40
35598244118,35598244125,7,3881,1581,-40
35602816781,35602816790,9,3526,1086,-40
35602995889,35602995894,5,3097,1376,-40
35605750749,35605750754,5,2829,1421,-40
35606282421,35606282426,5,5194,20265,-40
35610857993,35610858000,7,2820,1105,-40
35619614349,35619614353,4,3867,1735,-40
35619984577,35619984585,8,2775,1044,-40
35621903869,35621903874,5,2729,945,-40
35626381982,35626381990,8,3166,927,-40
35627541349,35627541354,5,2851,1498,-40
35629371030,35629371035,5,1661,895,-40
35631527321,35631527329,8,12675,25197,-40
35633615162,35633615167,5,3053,1345,-40
35636957506,35636957505,-1,1461,2327,-40
35639448502,35639448506,4,4159,1873,-40
35639520457,35639520463,6,2389,963,-40
35642370554,35642370554,0,2760,3665,-40
35647504377,35647504379,2,1927,1548,-40
35649525129,35649525137,8,2741,1303,-40
35649572122,35649572130,8,3533,1485,-40
35650622806,35650622815,9,3448,724,-40
35651153302,35651153307,5,2529,1200,-40
35653325196,35653325202,6,2304,1303,-40
35653428972,35653428979,7,3195,1807,-40
35655074066,35655074075,9,2589,662,-40
35655548429,35655548433,4,1018,242,-40
35663693947,35663693954,7,3128,1456,-40
35664823180,35664823185,5,2411,1094,-40
35676543509,35676543514,5,2629,1044,-40
35688977326,35688977331,5,1716,1009,-40
35691384485,35691384490,5,2651,1160,-40
35695292491,35695292484,-7,917,222,-40
35697111221,35697111227,6,3810,1305,-40
35698867710,35698867717,7,2551,1279,-40
35699216082,35699216090,8,5704,1226,-40
35703109414,35703109421,7,3241,1176,-40
35703145439,35703145442,3,737,96,-40
35704012217,35704012219,2,2380,2457,-40
35707323141,35707323149,8,2608,1184,-40
35707782054,35707782048,-6,584,35,-40
35708456336,35708456342,6,1909,1174,-40
35710693729,35710693729,0,1994,3047,-40
35712622205,35712622211,6,1866,822,-40
35715281311,35715281317,6,2153,1092,-40
35715759750,35715759754,4,1089,315,-40
35719305432,35719305439,7,4119,1829,-40
35720587718,35720587723,5,2205,1011,-40
35720897357,35720897362,5,2280,838,-40
35727757085,35727757089,4,22098,15561,-40
35729440725,35729440731,6,3022,1053,-40
35732355800,35732355805,5,2855,1256,-40
35734591898,35734591903,5,2809,1291,-40
35734944259,35734944256,-3,1017,2665,-40
35735583342,35735583349,7,2419,1145,-40
35745508434,35745508441,7,8483,2525,-40
35747002495,35747002500,5,2187,1451,-40
35747470600,35747470605,5,2714,1098,-40
35750863090,35750863096,6,3907,1322,-40
35755615972,35755615977,5,2273,1607,-40
35758489247,35758489253,6,3048,1531,-40
35760162343,35760162346,3,1425,1552,-40
35760476645,35760476628,-17,2256,1222,-40
35763459221,35763459225,4,2763,1981,-40
35763955104,35763955107,3,1438,1285,-40
35764589751,35764589758,7,3031,1171,-40
35765213348,35765213354,6,2664,1243,-40
35765925175,35765925181,6,3422,1103,-40
35767912758,35767912738,-20,869,245,-40
35768735005,35768734995,-10,958,307,-40
35769871070,35769871075,5,3160,1081,-40
35770697802,35770697809,7,3034,1000,-40
35772712777,35772712783,6,2550,1021,-40
35777846923,35777846930,7,1388,833,-40
35782311962,35782311958,-4,1394,3083,-40
35785965016,35785965022,6,2623,1654,-40
35788000554,35788000561,7,3011,1300,-40
35793022253,35793022252,-1,1704,2688,-40
35793307335,35793307342,7,2451,982,-40
35793474023,35793474030,7,2667,1182,-40
35795313841,35795313847,6,3043,1614,-40
35797602914,35797602921,7,4067,1344,-40
35800781206,35800781213,7,3594,1453,-40
35805174013,35805174021,8,2063,1093,-40
35806268248,35806268249,1,1319,1789,-40
35807235194,35807235200,6,2851,1458,-40
35808081762,35808081754,-8,865,2337,-40
35809414218,35809414225,7,2902,1882,-40
35811567001,35811567004,3,1543,2062,-40
35817063466,35817063472,6,2688,1336,-40
35819654950,35819654956,6,3999,1515,-40
35820979586,35820979594,8,3830,1581,-40
35821509146,35821509155,9,907,125,-40
35821686297,35821686302,5,2401,1580,-40
35821743268,35821743250,-18,1097,504,-40
35822151619,35822151626,7,3319,1143,-40
35826081624,35826081630,6,3087,1417,-40
35826229652,35826229658,6,2468,1082,-40
35826825450,35826825457,7,2467,1619,-40
35832556890,35832556895,5,3396,1330,-40
35834004711,35834004718,7,2354,950,-40
35837296585,35837296593,8,5677,1218,-40
35842279392,35842279373,-19,2917,1284,-40
35842534719,35842534720,1,1793,1996,-40
35843554789,35843554796,7,2331,985,-40
35844105119,35844105126,7,2886,1060,-40
35845154952,35845154958,6,3534,1684,-40
35853060698,35853060707,9,9242,1526,-40
35853693581,35853693563,-18,2297,1306,-40
35854664640,35854664647,7,2632,1061,-40
35857165734,35857165739,5,2594,1378,-40
35868451853,35868451860,7,2867,1637,-40
35870917125,35870917131,6,3944,1340,-40
35873105425,35873105431,6,3314,1003,-40
35881101390,35881101398,8,2148,1287,-40
35885263394,35885263397,3,2975,1325,-40
35885404494,35885404490,-4,709,278,-40
35886605424,35886605417,-7,805,2519,-40
35887184231,35887184236,5,1780,1560,-40
35887965324,35887965329,5,2770,1300,-40
35888216744,35888216749,5,1633,964,-40
35889504226,35889504231,5,2199,777,-40
35889785014,35889785022,8,4161,1664,-40
35890230858,35890230863,5,2516,1447,-40
35890270797,35890270802,5,2375,966,-40
35890859866,35890859873,7,3929,1154,-40
35895358569,35895358573,4,2581,1185,-40
35896605318,35896605322,4,2170,1247,-40
35896883808,35896883813,5,2002,1454,-40
35900466596,35900466602,6,2555,1489,-40
35902561605,35902561609,4,196,531,-40
35904315274,35904315282,8,4446,1709,-40
35905615408,35905615416,8,2651,989,-40
35906870409,35906870415,6,2418,1160,-40
35906907794,35906907779,-15,868,298,-40
35908127101,35908127115,14,2489,1326,-40
35910101674,35910101681,7,2363,1173,-40
35911735742,35911735747,5,3548,1072,-40
35913085853,35913085861,8,2892,1547,-40
35915254801,35915254806,5,2291,1435,-40
35915669853,35915669833,-20,3273,1003,-40
35916615506,35916615513,7,2943,1444,-40
35917342562,35917342559,-3,1064,3416,-40
35925798461,35925798461,0,1468,1353,-40
35927485843,35927485839,-4,2294,5024,-40
35928373375,35928373383,8,2252,1197,-40
35929193462,35929193483,21,2046,924,-40
35935075132,35935075138,6,3099,946,-40
35936341295,35936341302,7,3697,1885,-40
35937679582,35937679588,6,3757,1203,-40
35944020326,35944020334,8,1719,1437,-40
35946450357,35946450363,6,1360,647,-40
35947058899,35947058880,-19,992,377,-40
35947360572,35947360579,7,3170,1392,-40
35950758866,35950758872,6,2170,785,-40
35956397026,35956397032,6,3299,1557,-40
35956619289,35956619295,6,3510,1231,-40
35957093074,35957093080,6,4095,1553,-40
35961438449,35961438455,6,3426,2068,-40
35962154158,35962154165,7,2892,1203,-40
35962705083,35962705083,0,1089,432,-40
35963482365,35963482373,8,4603,1870,-40
35964690427,35964690412,-15,868,504,-40
35969335691,35969335692,1,1589,1843,-40
35969904965,35969904972,7,2617,1018,-40
35970202848,35970202835,-13,2348,1280,-40
35970970997,35970971004,7,3933,1616,-40
35972981226,35972981232,6,4260,1973,-40
35975104966,35975104973,7,3135,1124,-40
35977486838,35977486848,10,2568,1203,-40
35977524460,35977524467,7,2583,1214,-40
35979703098,35979703102,4,3632,2910,-40
35980677681,35980677687,6,2835,1244,-40
35981079720,35981079716,-4,1427,2911,-40
35982350060,35982350065,5,2145,1471,-40
35982708117,35982708114,-3,31489,71563,-40
35987037433,35987037440,7,3886,1502,-40
35988258507,35988258514,7,2658,1246,-40
35988536413,35988536418,5,2011,1359,-40
35991729311,35991729315,4,2453,1257,-40
35992678309,35992678314,5,2494,1304,-40
35993021878,35993021883,5,2826,940,-40
35993179734,35993179736,2,1518,1672,-40
35993421918,35993421922,4,3060,1213,-40
35994461920,35994461919,-1,1189,1914,-40
35997881602,35997881610,8,2194,944,-40
35998500770,35998500757,-13,832,153,-40
36005557342,36005557347,5,2489,1105,-40
36009629431,36009629438,7,3329,1188,-40
36016905872,36016905878,6,2465,825,-40
36020625796,36020625803,7,1587,1176,-40
36021382635,36021382641,6,2809,1008,-40
36023995924,36023995930,6,1702,1037,-40
36026091696,36026091693,-3,42502,21236,-40
36030324687,36030324693,6,3796,1568,-40
36033305881,36033305886,5,2323,885,-40
36035688091,36035688097,6,2790,1663,-40
36044319158,36044319163,5,1758,1285,-40
36046085469,36046085469,0,14268,17560,-40
36052331953,36052331959,6,2338,1530,-40
36052606720,36052606726,6,3084,1550,-40
36058402365,36058402370,5,1927,1526,-40
36059812281,36059812284,3,2278,1552,-40
36062016306,36062016310,4,2367,1355,-40
36062464265,36062464270,5,3149,1759,-40
36063058676,36063058682,6,2449,956,-40
36072166474,36072166480,6,2722,1355,-40
36074837134,36074837139,5,3271,1620,-40
36075880298,36075880303,5,2424,1207,-40
36077191703,36077191710,7,2358,993,-40
36085694788,36085694794,6,4334,1626,-40
36086151078,36086151056,-22,2642,1022,-40
36086984478,36086984485,7,3014,1207,-40
36088078477,36088078481,4,2670,1120,-40
36088238248,36088238255,7,2659,1015,-40
36088295551,36088295554,3,2528,1465,-40
36090107226,36090107235,9,35493,87158,-40
36100082235,36100082241,6,2282,1221,-40
36100687003,36100687010,7,2914,1398,-40
36101456713,36101456718,5,2414,1208,-40
36103184467,36103184474,7,3366,1079,-40
36103936895,36103936897,2,2868,3374,-40
36104425919,36104425926,7,3028,1081,-40
36104693986,36104693991,5,2750,1262,-40
36108569485,36108569490,5,1920,942,-40
36109200930,36109200935,5,2645,1187,-40
36109806127,36109806134,7,2171,887,-40
36111762649,36111762654,5,2428,1166,-40
36113024979,36113024986,7,3442,1377,-40
36120567950,36120567955,5,2468,1382,-40
36123651068,36123651073,5,21991,26067,-40
36124313313,36124313318,5,2558,1288,-40
36124482440,36124482441,1,2500,3149,-40
36126184165,36126184172,7,6615,1309,-40
36128297761,36128297767,6,2622,1330,-40
36133374375,36133374390,15,16984,18212,-40
36136017005,36136017011,6,3687,1445,-40
36138053803,36138053811,8,20385,51919,-40
36138938146,36138938152,6,2508,1339,-40
36142322864,36142322856,-8,876,3686,-40
36146025308,36146025315,7,2667,1473,-40
36150541646,36150541653,7,2946,1573,-40
36155926963,36155926968,5,1868,1590,-40
36156575055,36156575062,7,1972,958,-40
36156612191,36156612188,-3,2212,5797,-40
36157645378,36157645357,-21,1869,1537,-40
36159292146,36159292152,6,2677,1244,-40
36164998361,36164998357,-4,879,1555,-40
36167393926,36167393937,11,12769,40100,-40
36173292418,36173292422,4,1769,860,-40
36175156231,36175156237,6,2459,1520,-40
36175504182,36175504164,-18,623,348,-40
36175704817,36175704821,4,1938,1269,-40
36177598211,36177598205,-6,925,4032,-40
36178507419,36178507425,6,1401,1556,-40
36178696063,36178696043,-20,607,47,-40
36183458694,36183458698,4,2728,1275,-40
36186949247,36186949255,8,4202,1456,-40
36187488422,36187488429,7,4203,1162,-40
36190613393,36190613398,5,2575,1063,-40
36191988291,36191988298,7,2445,1413,-40
36193993265,36193993271,6,1726,1107,-40
36197578049,36197578054,5,3561,1049,-40
36198615562,36198615570,8,2578,1187,-40
36203160286,36203160283,-3,2919,6816,-40
36205665278,36205665286,8,3060,944,-40
36208338045,36208338045,0,1287,1404,-40
36209424963,36209424977,14,2587,905,-40
36211562978,36211562985,7,2932,1369,-40
36212306610,36212306625,15,1811,1048,-40
36212702464,36212702471,7,3463,1274,-40
36212802708,36212802714,6,2641,1563,-40
36216415793,36216415798,5,3156,1233,-40
36216690926,36216690904,-22,2231,407,-40
36217543014,36217543018,4,2696,1440,-40
36217847362,36217847370,8,2930,954,-40
36219790833,36219790839,6,2693,905,-40
36220009132,36220009112,-20,1924,1010,-40
36223381186,36223381190,4,2072,911,-40
36224885961,36224885966,5,2448,1516,-40
36225518133,36225518133,0,1082,1023,-40
36229482374,36229482379,5,2727,1569,-40
36229729929,36229729934,5,3133,1396,-40
36230165095,36230165101,6,2892,1156,-40
36230392765,36230392771,6,3686,1405,-40
36231332962,36231332969,7,2521,1400,-40
36237425748,36237425754,6,3258,1534,-40
36238263994,36238264003,9,4153,1813,-40
36244720637,36244720640,3,3561,2034,-40
36244788618,36244788634,16,1352,434,-40
36246334789,36246334797,8,2462,1110,-40
36254006159,36254006165,6,1750,1089,-40
36254452924,36254452929,5,1913,980,-40
36256500293,36256500298,5,2729,1307,-40
36267221361,36267221366,5,2959,1064,-40
36268143580,36268143587,7,3436,1293,-40
36269665994,36269666000,6,1722,1561,-40
36270173442,36270173448,6,2551,1674,-40
36271415570,36271415574,4,2661,1317,-40
36271750206,36271750214,8,3921,1133,-40
36280488169,36280488177,8,2629,1496,-40
36286207330,36286207338,8,4704,1162,-40
36287233915,36287233922,7,3043,1274,-40
36290756257,36290756263,6,4458,1957,-40
36296544356,36296544362,6,2987,1226,-40
36297618942,36297618950,8,4130,1424,-40
36300981058,36300981066,8,2229,1095,-40
36301057379,36301057363,-16,1127,722,-40
36303505235,36303505242,7,2962,1246,-40
36303613640,36303613645,5,2987,1402,-40
36306360777,36306360782,5,2199,1291,-40
36309901807,36309901809,2,2849,2044,-40
36315202142,36315202141,-1,26996,15760,-40
36318732808,36318732810,2,1414,1458,-40
36319171689,36319171695,6,2833,1572,-40
36319489685,36319489666,-19,2551,798,-40
36323570344,36323570346,2,2674,1655,-40
36327439756,36327439763,7,2801,1131,-40
36330185088,36330185094,6,2764,1011,-40
36334635781,36334635787,6,3349,1041,-40
36337639973,36337639970,-3,24229,14236,-40
36340228594,36340228597,3,1308,1047,-40
36340400603,36340400609,6,3334,1371,-40
36343088666,36343088671,5,2874,1877,-40
36345104917,36345104916,-1,25437,16106,-40
36347217576,36347217582,6,2297,1013,-40
36351322148,36351322155,7,1554,695,-40
36352732261,36352732267,6,2704,1291,-40
36356791834,36356791842,8,2470,1020,-40
36358825385,36358825391,6,2650,1258,-40
36361006225,36361006230,5,2011,809,-40
36361203707,36361203723,16,1560,1426,-40
36362320756,36362320754,-2,2308,4958,-40
36362631848,36362631855,7,2289,1165,-40
36368021427,36368021434,7,2780,1249,-40
36371049189,36371049194,5,2616,1242,-40
36371140462,36371140467,5,1969,1026,-40
36372676175,36372676154,-21,1600,551,-40
36375460492,36375460497,5,1934,1163,-40
36375500912,36375500916,4,2364,1769,-40
36378489139,36378489144,5,2125,1258,-40
36379661377,36379661382,5,2545,938,-40
36383357154,36383357159,5,3126,1330,-40
36385264008,36385264014,6,4680,1317,-40
36387788008,36387788015,7,467,1004,-40
36388112085,36388112093,8,2711,1229,-40
36389961538,36389961542,4,3241,2048,-40
36396285667,36396285674,7,2537,1308,-40
36397704701,36397704723,22,1181,281,-40
36401388595,36401388605,10,355,1574,-40
36401505765,36401505771,6,2780,1181,-40
36404426698,36404426702,4,2433,1206,-40
36405514854,36405514861,7,3685,1396,-40
36405732450,36405732456,6,2902,1052,-40
36410464150,36410464156,6,1612,1130,-40
36415098654,36415098661,7,2883,1306,-40
36415428026,36415428033,7,2522,1346,-40
36417605132,36417605137,5,2128,1025,-40
36418358958,36418358966,8,2838,973,-40
36424860169,36424860174,5,3296,1965,-40
36427920672,36427920678,6,3311,1261,-40
36435436455,36435436461,6,3158,1752,-40
36437530442,36437530449,7,3601,1704,-40
36437688721,36437688728,7,3619,1251,-40
36441368061,36441368067,6,2273,1506,-40
36441859495,36441859502,7,3152,1349,-40
36441905806,36441905811,5,2388,1215,-40
36442315267,36442315273,6,5308,1644,-40
36443586068,36443586075,7,3312,1309,-40
36443638914,36443638900,-14,2985,1215,-40
36445578517,36445578523,6,1797,1081,-40
36447458990,36447458996,6,2940,934,-40
36447775160,36447775147,-13,1749,664,-40
36448160404,36448160410,6,3323,1339,-40
36448190437,36448190442,5,3166,1160,-40
36450240517,36450240521,4,2082,1179,-40
36452550034,36452550039,5,2300,1216,-40
36455040396,36455040402,6,2424,1752,-40
36464709518,36464709525,7,2373,1220,-40
36466663115,36466663111,-4,1720,2474,-40
36468153112,36468153107,-5,711,1132,-40
36469470218,36469470223,5,2889,1219,-40
36473593562,36473593569,7,2521,1026,-40
36475366698,36475366704,6,3017,1361,-40
36477560998,36477561004,6,2940,1404,-40
36478279801,36478279809,8,4641,1757,-40
36480064746,36480064751,5,1976,940,-40
36480760729,36480760730,1,1590,1597,-40
36487799590,36487799596,6,3678,1534,-40
36488953937,36488953942,5,3258,1340,-40
36489305350,36489305354,4,2730,1641,-40
36491120045,36491120050,5,1783,1196,-40
36492756366,36492756374,8,2607,1192,-40
36497490570,36497490571,1,1354,1530,-40
36497939510,36497939491,-19,1366,572,-40
36498776458,36498776457,-1,1456,2081,-40
36499544123,36499544129,6,2397,1853,-40
36500043447,36500043451,4,898,214,-40
36504552744,36504552751,7,1743,760,-40
36506296271,36506296278,7,3342,1065,-40
36511029337,36511029341,4,2016,1350,-40
36514049016,36514049023,7,2549,1377,-40
36515637805,36515637811,6,2260,1246,-40
36519337485,36519337492,7,3368,1611,-40
36519708061,36519708067,6,4283,1990,-40
36522098763,36522098770,7,2097,1040,-40
36523947035,36523947042,7,3772,1632,-40
36527633562,36527633569,7,3207,1204,-40
36527812963,36527812971,8,2492,688,-40
36530391074,36530391082,8,3079,1158,-40
36530971813,36530971821,8,2320,1515,-40
36534895947,36534895953,6,2928,1373,-40
36537951492,36537951497,5,3930,1137,-40
36543513785,36543513792,7,3098,1284,-40
36544121958,36544121966,8,1673,716,-40
36549274570,36549274576,6,3197,1235,-40
36549328978,36549328987,9,1272,523,-40
36550372778,36550372783,5,2293,955,-40
36559272566,36559272562,-4,1031,2003,-40
36561205063,36561205071,8,3853,1252,-40
36562245185,36562245200,15,1365,31,-40
36562914882,36562914889,7,2753,1445,-40
36563952610,36563952618,8,2728,1432,-40
36565365473,36565365478,5,2428,1491,-40
36568318574,36568318553,-21,1143,710,-40
36570741585,36570741587,2,1788,1282,-40
36571579778,36571579763,-15,811,187,-40
36572668833,36572668839,6,3092,1309,-40
36574753088,36574753094,6,1962,1310,-40
36579243909,36579243914,5,2749,1115,-40
36579395826,36579395810,-16,1874,865,-40
36579759477,36579759482,5,3437,1086,-40
36583203875,36583203881,6,1681,1063,-40
36584226978,36584226978,0,1261,1571,-40
36585027582,36585027586,4,2205,1141,-40
36587396362,36587396368,6,3011,1412,-40
36589929654,36589929654,0,3391,4051,-40
36594891710,36594891717,7,3922,1787,-40
36595990526,36595990507,-19,2158,1232,-40
36605548504,36605548509,5,2182,1177,-40
36605634801,36605634784,-17,1282,620,-40
36608664663,36608664652,-11,969,3032,-40
36611810743,36611810751,8,1537,654,-40
36616021847,36616021852,5,3184,1922,-40
36619944332,36619944338,6,2950,1132,-40
36620855622,36620855627,5,3880,1900,-40
36623277291,36623277299,8,3958,1526,-40
36626555810,36626555815,5,2388,1318,-40
36627381256,36627381241,-15,1362,239,-40
36627723435,36627723437,2,2210,2928,-40
36627850714,36627850718,4,2508,1074,-40
36629982181,36629982186,5,1850,1276,-40
36633266497,36633266503,6,2801,1379,-40
36633684714,36633684698,-16,3242,1598,-40
36635516082,36635516088,6,3547,1654,-40
36637199822,36637199828,6,3392,1408,-40
36637498021,36637498023,2,1359,1110,-40
36637832634,36637832642,8,3515,1079,-40
36638114283,36638114290,7,3032,977,-40
36638184956,36638184969,13,3025,1297,-40
36638468574,36638468582,8,2059,1010,-40
36639390882,36639390889,7,2772,838,-40
36643228959,36643228950,-9,815,2515,-40
36646638673,36646638678,5,2298,1284,-40
36650846069,36650846074,5,3200,1256,-40
36652465664,36652465669,5,2050,1138,-40
36653078046,36653078051,5,2732,1297,-40
36663738973,36663738978,5,4055,1257,-40
36672621457,36672621463,6,3431,771,-40
36678636567,36678636574,7,2715,1411,-40
36682780213,36682780218,5,2498,908,-40
36684285882,36684285891,9,2865,1221,-40
36684804862,36684804869,7,2004,1079,-40
36687583893,36687583898,5,3408,1697,-40
36687771563,36687771570,7,2801,1021,-40
36689700061,36689700066,5,4157,1705,-40
36690136163,36690136170,7,3341,1917,-40
36690240789,36690240794,5,2060,1365,-40
36694291174,36694291179,5,1766,1023,-40
36697793834,36697793841,7,2844,1382,-40
36700113750,36700113758,8,4056,1042,-40
36703725547,36703725556,9,2572,1024,-40
36704941224,36704941226,2,2567,1124,-40
36709700838,36709700843,5,2161,1454,-40
36712510441,36712510449,8,3119,1454,-40
36717935182,36717935189,7,4192,1273,-40
36719183104,36719183110,6,2181,1552,-40
36719947338,36719947345,7,2568,1140,-40
36724142345,36724142349,4,2022,1130,-40
36725215458,36725215465,7,1340,787,-40
36727304048,36727304060,12,2039,767,-40
36738236826,36738236831,5,2801,1266,-40
36747611926,36747611934,8,2514,1037,-40
36749344301,36749344300,-1,2229,2963,-40
36749392615,36749392622,7,2276,1167,-40
36750332133,36750332138,5,2003,906,-40
36751062679,36751062684,5,4130,1131,-40
36752953807,36752953814,7,3921,1566,-40
36753119674,36753119672,-2,1211,258,-40
36754715788,36754715794,6,3035,1213,-40
36755482287,36755482294,7,3378,1015,-40
36759092937,36759092944,7,2367,1006,-40
36760158509,36760158521,12,2447,1216,-40
36760558134,36760558138,4,2443,1197,-40
36764713593,36764713597,4,2314,2035,-40
36765772225,36765772231,6,2363,1166,-40
36766584983,36766584979,-4,1209,1951,-40
36771258601,36771258607,6,2809,1464,-40
36772207678,36772207682,4,2026,1141,-40
36772899099,36772899105,6,3508,1758,-40
36775849340,36775849347,7,2972,1323,-40
36781391309,36781391313,4,1965,1233,-40
36782415673,36782415681,8,3353,1405,-40
36786091937,36786091944,7,3441,1551,-40
36788831596,36788831603,7,2661,1490,-40
36789597935,36789597943,8,4322,2043,-40
36789990654,36789990661,7,3804,1702,-40
36792734225,36792734231,6,2315,1975,-40
36792965477,36792965478,1,2217,3004,-40
36797270742,36797270749,7,3069,1104,-40
36809067091,36809067095,4,1701,28797,-40
36810089754,36810089760,6,2017,1079,-40
36811483888,36811483894,6,2696,1148,-40
36824887090,36824887098,8,2694,815,-40
36826068775,36826068782,7,2388,1807,-40
36835655041,36835655041,0,32862,20898,-40
36836565049,36836565056,7,2437,1299,-40
36838071362,36838071370,8,3233,975,-40
36838297168,36838297186,18,2312,944,-40
36841043242,36841043245,3,1125,1622,-40
36843232059,36843232067,8,1558,979,-40
36843917255,36843917241,-14,851,344,-40
36845164697,36845164702,5,1408,603,-40
36846522498,36846522497,-1,863,2529,-40
36850309651,36850309655,4,2354,1381,-40
36850343173,36850343180,7,3505,1390,-40
36851145134,36851145141,7,4183,1909,-40
36851442646,36851442653,7,2746,1388,-40
36856083440,36856083448,8,15231,25902,-40
36857440108,36857440114,6,2138,1111,-40
36858805740,36858805745,5,3072,1410,-40
36859910494,36859910499,5,2140,1217,-40
36867791193,36867791200,7,3058,1245,-40
36868518894,36868518901,7,2299,977,-40
36868897752,36868897758,6,2435,1146,-40
36870009553,36870009562,9,3345,1472,-40
36870087634,36870087639,5,1419,925,-40
36875263873,36875263877,4,22256,18518,-40
36876090230,36876090238,8,1970,827,-40
36876183038,36876183031,-7,1330,7608,-40
36878045502,36878045510,8,3216,1751,-40
36880621115,36880621092,-23,3008,1065,-40
36884848531,36884848535,4,2925,1354,-40
36891883606,36891883612,6,3040,1008,-40
36898765977,36898765982,5,3235,1358,-40
36899789325,36899789329,4,2508,1504,-40
36900544235,36900544241,6,2475,1315,-40
36902567476,36902567482,6,2858,1727,-40
36905445377,36905445384,7,3981,1727,-40
36906336106,36906336086,-20,653,388,-40
36907897867,36907897874,7,3832,1241,-40
36908199542,36908199532,-10,1115,389,-40
36912321657,36912321662,5,2941,1490,-40
36912629275,36912629282,7,1194,1208,-40
36918496770,36918496775,5,1879,462,-40
36919317896,36919317890,-6,2949,9542,-40
36922686679,36922686685,6,3895,1713,-40
36929888569,36929888575,6,2156,1158,-40
36931521502,36931521509,7,1989,1107,-40
36933257769,36933257787,18,3063,1278,-40
36938148152,36938148134,-18,1896,985,-40
36938587880,36938587886,6,2029,858,-40
36938708454,36938708435,-19,2287,1143,-40
36939637260,36939637266,6,2770,1199,-40
36941072686,36941072690,4,2651,1094,-40
36949419729,36949419735,6,3272,1464,-40
36950186129,36950186133,4,2737,1573,-40
36950403913,36950403919,6,3403,1498,-40
36950905799,36950905801,2,2546,2360,-40
36965038047,36965038055,8,2652,1581,-40
36966517579,36966517585,6,2974,1349,-40
36969247300,36969247307,7,2328,917,-40
36970838568,36970838576,8,1864,678,-40
36971029841,36971029836,-5,385,4,-40
36971437705,36971437711,6,1547,1313,-40
36973077642,36973077648,6,3869,1378,-40
36973912362,36973912359,-3,1727,4147,-40
36980520987,36980520994,7,1969,1030,-40
36988036829,36988036836,7,4904,2048,-40
36995552988,36995552986,-2,2042,3052,-40
37001237587,37001237593,6,2698,1372,-40
37004746030,37004746037,7,2184,1168,-40
37005007463,37005007467,4,1102,312,-40
37005408294,37005408288,-6,997,443,-40
37010478590,37010478586,-4,1415,2457,-40
37011406343,37011406350,7,3188,1812,-40
37012987613,37012987620,7,2740,1418,-40
37013592886,37013592890,4,2462,1083,-40
37015197561,37015197567,6,2787,1381,-40
37015779058,37015779063,5,913,343,-40
37017903650,37017903655,5,2105,1162,-40
37018561731,37018561737,6,2399,1226,-40
37018675538,37018675545,7,3215,1587,-40
37019758549,37019758554,5,1684,859,-40
37019969792,37019969780,-12,3559,1106,-40
37025497089,37025497096,7,3110,1707,-40
37031939822,37031939829,7,2541,1101,-40
37032895599,37032895605,6,2615,837,-40
37033079089,37033079095,6,3328,1401,-40
37033104430,37033104412,-18,2654,947,-40
37033647780,37033647788,8,2015,1219,-40
37035067833,37035067842,9,4755,1317,-40
37036537358,37036537336,-22,3710,1750,-40
37038785091,37038785093,2,1435,946,-40
37040822155,37040822137,-18,1636,779,-40
37041378305,37041378310,5,2284,1201,-40
37041946149,37041946154,5,1812,1025,-40
37042218679,37042218685,6,3276,1080,-40
37043048921,37043048929,8,2431,1132,-40
37051345381,37051345385,4,1760,1083,-40
37052026053,37052026059,6,2640,1352,-40
37052370007,37052370014,7,3029,1567,-40
37055872927,37055872934,7,2804,1313,-40
37062331598,37062331605,7,1411,566,-40
37072151181,37072151174,-7,2222,8512,-40
37073634050,37073634054,4,3688,856,-40
37074736188,37074736194,6,3356,1047,-40
37084089846,37084089851,5,2733,1431,-40
37085003058,37085003061,3,1208,685,-40
37087013063,37087013068,5,1714,996,-40
37087941122,37087941127,5,2356,1183,-40
37091091827,37091091828,1,1530,1189,-40
37094992573,37094992578,5,3350,1117,-40
37095110511,37095110491,-20,1383,579,-40
37098069736,37098069742,6,2839,1097,-40
37099260102,37099260102,0,1583,1763,-40
37100847632,37100847638,6,2713,1070,-40
37101382567,37101382573,6,3650,1275,-40
37103132298,37103132299,1,1485,1347,-40
37105070316,37105070322,6,3625,1871,-40
37105636467,37105636474,7,3261,1374,-40
37106293141,37106293146,5,2951,1293,-40
37107524434,37107524441,7,3188,1236,-40
37108854789,37108854794,5,2750,1150,-40
37118667053,37118667059,6,3376,1267,-40
37120324158,37120324159,1,1863,2115,-40
37121655120,37121655114,-6,1472,6305,-40
37124482721,37124482729,8,2722,1203,-40
37129897906,37129897912,6,2264,1269,-40
37130260569,37130260577,8,2492,1051,-40
37132571206,37132571206,0,1736,2064,-40
37135458214,37135458209,-5,30120,14153,-40
37138643508,37138643512,4,2833,1386,-40
37142372242,37142372249,7,6635,3397,-40
37148147029,37148147037,8,4424,1523,-40
37148823585,37148823590,5,3579,1628,-40
37149115284,37149115290,6,3259,1364,-40
37158417953,37158417952,-1,1862,2745,-40
37160398595,37160398600,5,2314,1246,-40
37164961275,37164961278,3,7539,5134,-40
37165436704,37165436714,10,10502,37510,-40
37166138397,37166138402,5,2417,1550,-40
37167867213,37167867218,5,1882,750,-40
37175930014,37175930022,8,2144,1326,-40
37179438707,37179438713,6,1614,765,-40
37179717547,37179717554,7,3225,1191,-40
37184845221,37184845228,7,3339,1562,-40
37186540940,37186540946,6,3099,1386,-40
37190135841,37190135848,7,2644,1246,-40
37192582820,37192582826,6,2978,1436,-40
37192822952,37192822946,-6,747,84,-40
37194749157,37194749162,5,2722,1377,-40
37196339227,37196339233,6,3641,1084,-40
37205417411,37205417419,8,3542,1381,-40
37206998193,37206998198,5,3299,1566,-40
37208078894,37208078901,7,2618,1152,-40
37208275065,37208275051,-14,868,332,-40
37209219274,37209219281,7,2889,973,-40
37209469229,37209469243,14,1303,318,-40
37210254486,37210254499,13,1102,1,-40
37215976592,37215976597,5,2265,1465,-40
37218384868,37218384879,11,28532,40103,-40
37222938253,37222938259,6,2471,955,-40
37223429807,37223429802,-5,1076,377,-40
37225516466,37225516473,7,2435,1414,-40
37225555285,37225555285,0,1608,1920,-40
37232365313,37232365319,6,2359,1287,-40
37236123538,37236123544,6,4219,1723,-40
37236287923,37236287929,6,3550,1570,-40
37237965597,37237965604,7,3958,1438,-40
37240729512,37240729519,7,4629,1672,-40
37242058278,37242058285,7,2468,1000,-40
37242800976,37242800962,-14,2435,630,-40
37243177416,37243177423,7,2438,1262,-40
37248080131,37248080137,6,2761,1148,-40
37251184013,37251184021,8,2600,1051,-40
37251924390,37251924398,8,3245,1253,-40
37253249718,37253249722,4,1709,1052,-40
37254354891,37254354898,7,2969,1551,-40
37254824766,37254824746,-20,1130,337,-40
37255847216,37255847222,6,2818,1246,-40
37258042349,37258042358,9,1169,614,-40
37262535138,37262535145,7,2366,1249,-40
37263366501,37263366507,6,3001,1052,-40
37266109150,37266109156,6,3179,1412,-40
37266434758,37266434765,7,3262,1397,-40
37267752093,37267752099,6,2375,1379,-40
37272611017,37272611022,5,2309,1786,-40
37273395945,37273395950,5,2291,1417,-40
37275326208,37275326215,7,4016,1557,-40
37276713857,37276713863,6,3198,1063,-40
37277649116,37277649112,-4,591,34,-40
37278109667,37278109651,-16,2999,974,-40
37278711482,37278711487,5,4711,3152,-40
37279450380,37279450386,6,3837,1582,-40
37283069663,37283069659,-4,562,1279,-40
37291136030,37291136037,7,1627,853,-40
37294772307,37294772314,7,2329,939,-40
37296161847,37296161841,-6,2045,6776,-40
37296608507,37296608514,7,2274,1102,-40
37302406648,37302406655,7,2499,1282,-40
37302616677,37302616683,6,2693,1296,-40
37302757031,37302757038,7,2117,1161,-40
37310925313,37310925319,6,2465,1163,-40
37311723277,37311723284,7,3065,1494,-40
37318146198,37318146203,5,3352,1268,-40
37320541541,37320541522,-19,2638,1181,-40
37321909205,37321909210,5,2713,1153,-40
37323468221,37323468228,7,2032,973,-40
37325670775,37325670783,8,3165,1066,-40
37325815826,37325815808,-18,2493,1020,-40
37328716905,37328716912,7,2941,1178,-40
37332192724,37332192731,7,2034,1138,-40
37332404691,37332404675,-16,2804,986,-40
37333202625,37333202630,5,2197,1155,-40
37336108081,37336108087,6,3032,1274,-40
37336133757,37336133762,5,2721,1373,-40
37337659095,37337659103,8,4914,1443,-40
37338568161,37338568147,-14,2451,943,-40
37339508958,37339508962,4,2714,1358,-40
37341718918,37341718925,7,3682,1240,-40
37349821378,37349821383,5,2480,1059,-40
37350791891,37350791898,7,3193,859,-40
37356177482,37356177486,4,1781,1100,-40
37357803298,37357803305,7,4249,1360,-40
37359442691,37359442697,6,2716,881,-40
37360339153,37360339158,5,1773,965,-40
37361596246,37361596225,-21,4478,1498,-40
37365484781,37365484789,8,2942,1283,-40
37376834303,37376834310,7,3225,1326,-40
37378379941,37378379948,7,2640,1096,-40
37387144817,37387144822,5,2416,1297,-40
37389490986,37389490986,0,2394,3525,-40
37393762792,37393762800,8,2683,811,-40
37394991852,37394991858,6,2634,1284,-40
37396312257,37396312262,5,1763,900,-40
37398500455,37398500462,7,3188,1536,-40
37399652282,37399652288,6,1820,1072,-40
37400127625,37400127610,-15,2150,876,-40
37401492339,37401492344,5,2246,1333,-40
37401549538,37401549543,5,1944,1048,-40
37406319159,37406319167,8,2925,1357,-40
37406964022,37406964019,-3,838,237,-40
37407765932,37407765939,7,3452,1593,-40
37407804021,37407804026,5,947,142,-40
37410494692,37410494697,5,2360,1229,-40
37410881339,37410881340,1,903,213,-40
37411810121,37411810114,-7,1935,11308,-40
37411843606,37411843610,4,2113,1503,-40
37412135308,37412135314,6,2292,1518,-40
37413732411,37413732393,-18,881,856,-40
37415659526,37415659532,6,1037,434,-40
37419854573,37419854579,6,2880,1395,-40
37420361268,37420361274,6,2704,1607,-40
37420404778,37420404784,6,803,243,-40
37422928098,37422928106,8,3137,1289,-40
37425057350,37425057358,8,3151,1570,-40
37426954246,37426954255,9,1025,809,-40
37428511123,37428511128,5,2171,1271,-40
37429392238,37429392244,6,4428,1771,-40
37430785314,37430785321,7,3711,964,-40
37432740941,37432740947,6,4526,1986,-40
37434307731,37434307736,5,2039,1288,-40
37437984925,37437984930,5,2935,1609,-40
37439511898,37439511906,8,2003,595,-40
37441091809,37441091813,4,1336,1127,-40
37442755285,37442755290,5,2004,1058,-40
37446112249,37446112255,6,2038,1455,-40
37446216179,37446216184,5,2229,812,-40
37446984278,37446984284,6,4352,1279,-40
37448101003,37448101009,6,2986,999,-40
37448143629,37448143608,-21,1941,857,-40
37452512523,37452512529,6,1660,1281,-40
37455711439,37455711444,5,2517,852,-40
37457184946,37457184952,6,3325,2065,-40
37457225026,37457225011,-15,1953,1166,-40
37457737191,37457737210,19,1015,364,-40
37458500470,37458500469,-1,1571,3456,-40
37459038446,37459038453,7,3018,1297,-40
37459442473,37459442490,17,2430,1228,-40
37462856831,37462856839,8,2812,1273,-40
37470088446,37470088440,-6,28917,12225,-40
37470790013,37470790006,-7,40459,11055,-40
37473998410,37473998418,8,3998,783,-40
37475107154,37475107149,-5,714,4758,-40
37477928597,37477928603,6,2632,1291,-40
37478048559,37478048568,9,2886,1092,-40
37487626861,37487626867,6,3151,915,-40
37487882337,37487882342,5,2543,1297,-40
37491656834,37491656842,8,3149,1058,-40
37492877351,37492877358,7,2208,1182,-40
37494052550,37494052556,6,5055,2667,-40
37498915535,37498915541,6,3092,1519,-40
37501056010,37501056018,8,2121,547,-40
37505057314,37505057313,-1,1605,2301,-40
37507653365,37507653371,6,2376,1375,-40
37512934659,37512934666,7,4847,1691,-40
37513660673,37513660680,7,3489,1275,-40
37518589330,37518589335,5,2695,1129,-40
37521084242,37521084249,7,3552,1145,-40
37523979842,37523979850,8,14419,22661,-40
37526528458,37526528466,8,2395,1377,-40
37527469565,37527469571,6,3186,1597,-40
37527501647,37527501655,8,2532,1177,-40
37531262961,37531262968,7,3219,1609,-40
37532923615,37532923609,-6,1993,6480,-40
37533058341,37533058341,0,3112,4548,-40
37533442001,37533442009,8,4240,1781,-40
37534091668,37534091675,7,2526,1040,-40
37537713084,37537713090,6,3177,1639,-40
37542510085,37542510091,6,2227,1023,-40
37543918662,37543918667,5,2176,1247,-40
37544382359,37544382370,11,368,317,-40
37545247589,37545247594,5,3529,1011,-40
37548798047,37548798051,4,2297,1501,-40
37549715922,37549715923,1,1078,1085,-40
37551958364,37551958371,7,3531,1504,-40
37554307413,37554307421,8,2538,1262,-40
37555662335,37555662339,4,2653,1710,-40
37557885619,37557885625,6,2341,1062,-40
37558064080,37558064085,5,2574,1077,-40
37559349694,37559349699,5,2526,1190,-40
37561630255,37561630263,8,2673,886,-40
37562151665,37562151671,6,3030,1260,-40
37564999393,37564999398,5,2228,1317,-40
37577136677,37577136683,6,3407,1177,-40
37577624943,37577624962,19,798,86,-40
37578527146,37578527150,4,3464,1436,-40
37579256854,37579256861,7,1800,1154,-40
37582235226,37582235233,7,3049,1509,-40
37586919978,37586919984,6,3439,2037,-40
37591717738,37591717742,4,4123,1537,-40
37592439358,37592439365,7,3140,1549,-40
37592525710,37592525688,-22,2167,1113,-40
37593575189,37593575194,5,2092,860,-40
37595602726,37595602731,5,3682,1618,-40
37596968635,37596968641,6,3409,1662,-40
37597617507,37597617514,7,3530,1352,-40
37600503798,37600503779,-19,715,216,-40
37601070314,37601070319,5,2696,1050,-40
37601907010,37601907014,4,1939,1423,-40
37604350109,37604350114,5,2559,918,-40
37614223349,37614223354,5,3038,1241,-40
37614364465,37614364470,5,3992,1521,-40
37617230955,37617230961,6,2211,636,-40
37618102382,37618102387,5,2800,1495,-40
37620394342,37620394346,4,1918,1152,-40
37623055697,37623055703,6,3860,1515,-40
37624464579,37624464585,6,2446,1545,-40
37625369419,37625369426,7,3972,1545,-40
37630882082,37630882088,6,2853,1284,-40
37631039015,37631039021,6,3364,1788,-40
37631927071,37631927088,17,1108,186,-40
37636000013,37636000018,5,2099,894,-40
37636744718,37636744723,5,3803,1537,-40
37636843701,37636843706,5,3275,2284,-40
37637043028,37637043034,6,2932,1186,-40
37640194514,37640194519,5,2202,1157,-40
37650354542,37650354527,-15,1751,240,-40
37651019414,37651019418,4,2893,1356,-40
37657140097,37657140103,6,3476,1508,-40
37657174972,37657174979,7,2357,1281,-40
37659089474,37659089479,5,2201,717,-40
37659771049,37659771055,6,2499,1526,-40
37663113736,37663113731,-5,2096,5446,-40
37664048094,37664048088,-6,2607,37262,-40
37675307554,37675307575,21,1258,3716,-40
37675543658,37675543662,4,2545,1341,-40
37677996786,37677996791,5,3351,879,-40
37678940333,37678940340,7,1978,1138,-40
37679061515,37679061520,5,2358,1016,-40
37680144339,37680144345,6,2772,1694,-40
37682713407,37682713413,6,2290,1493,-40
37684913337,37684913353,16,16581,18033,-40
37685566037,37685566044,7,2370,1278,-40
37692339378,37692339385,7,3228,1278,-40
37695636839,37695636845,6,2456,801,-40
37697085879,37697085885,6,2285,1118,-40
37697659058,37697659058,0,1204,2221,-40
37698063819,37698063826,7,2344,1174,-40
37699158703,37699158682,-21,3551,1435,-40
37699858215,37699858222,7,2370,1093,-40
37703061697,37703061702,5,2957,1138,-40
37703504103,37703504088,-15,1253,501,-40
37707334038,37707334043,5,1858,1027,-40
37708158098,37708158084,-14,2783,740,-40
37708296574,37708296581,7,3310,1738,-40
37714369509,37714369514,5,3282,1482,-40
37715119174,37715119179,5,1690,975,-40
37717803595,37717803601,6,3716,1924,-40
37717923893,37717923899,6,2640,983,-40
37719876765,37719876773,8,3245,1305,-40
37720551628,37720551634,6,2869,1074,-40
37721494869,37721494875,6,2742,1113,-40
37721523561,37721523566,5,2465,915,-40
37724353465,37724353473,8,3653,1704,-40
37725690472,37725690474,2,1336,828,-40
37731432568,37731432574,6,3017,1106,-40
37732230555,37732230562,7,2283,925,-40
37735838502,37735838507,5,2186,881,-40
37736659470,37736659474,4,987,122,-40
37738148501,37738148508,7,2909,1209,-40
37738356368,37738356374,6,2041,881,-40
37739166522,37739166527,5,2164,941,-40
37739432573,37739432579,6,2473,1306,-40
37740194201,37740194198,-3,2066,5617,-40
37750434991,37750434998,7,2153,855,-40
37751541644,37751541651,7,2766,1382,-40
37755803384,37755803391,7,2887,1080,-40
37757394150,37757394156,6,3398,1231,-40
37757842759,37757842760,1,1295,1453,-40
37758772724,37758772731,7,2274,1267,-40
37760436902,37760436907,5,2039,1406,-40
37762007693,37762007688,-5,1602,5935,-40
37767146589,37767146595,6,4071,1504,-40
37768075143,37768075149,6,2186,1178,-40
37769112054,37769112059,5,2630,1122,-40
37769179505,37769179513,8,2399,1073,-40
37773078971,37773078977,6,3240,1697,-40
37774836487,37774836497,10,2661,1164,-40
37775276416,37775276413,-3,2971,4852,-40
37775479127,37775479133,6,2918,1752,-40
37782291965,37782291973,8,2043,1292,-40
37784991152,37784991160,8,3166,1536,-40
37785429057,37785429062,5,2492,962,-40
37785544075,37785544081,6,2420,1356,-40
37786798863,37786798869,6,3937,2213,-40
37788575234,37788575232,-2,192,3910,-40
37790107560,37790107565,5,1936,1295,-40
37791758987,37791758994,7,2931,1091,-40
37792536249,37792536257,8,2554,1247,-40
37793770218,37793770225,7,2086,1074,-40
37795364486,37795364494,8,4243,1347,-40
37804599448,37804599454,6,3855,1100,-40
37805801934,37805801940,6,2544,1295,-40
37806751650,37806751663,13,9371,41952,-40
37807659675,37807659694,19,677,2395,-40
37814041449,37814041459,10,13012,36750,-40
37815588942,37815588950,8,2041,974,-40
37818603185,37818603190,5,2647,1494,-40
37819142710,37819142715,5,1735,887,-40
37820869881,37820869886,5,2861,934,-40
37822562125,37822562144,19,3772,1085,-40
37834687376,37834687383,7,2808,1318,-40
37840860785,37840860790,5,3596,1594,-40
37843178105,37843178094,-11,885,365,-40
37844558297,37844558300,3,1574,1734,-40
37844687237,37844687242,5,2232,888,-40
37848725369,37848725374,5,3307,1557,-40
37849461261,37849461267,6,2464,1154,-40
37853602819,37853602825,6,2852,1310,-40
37854171114,37854171121,7,3498,1313,-40
37854278231,37854278238,7,2220,986,-40
37855878657,37855878662,5,2661,1151,-40
37858698830,37858698835,5,3346,1144,-40
37859465223,37859465229,6,2541,1208,-40
37866794306,37866794311,5,1541,949,-40
37867506477,37867506485,8,4029,1767,-40
37867814024,37867814030,6,2688,1130,-40
37868227254,37868227235,-19,1615,666,-40
37870398017,37870398021,4,1908,1406,-40
37870709442,37870709442,0,1664,1619,-40
37872734294,37872734299,5,1859,805,-40
37875111878,37875111884,6,3327,1279,-40
37875493402,37875493409,7,3501,973,-40
37876610850,37876610857,7,3547,647,-40
37877708950,37877708951,1,1426,1949,-40
37879006881,37879006887,6,1416,598,-40
37879466274,37879466281,7,2489,1692,-40
37879626849,37879626856,7,3294,1650,-40
37879775419,37879775425,6,1707,1106,-40
37879832744,37879832762,18,795,405,-40
37880330670,37880330666,-4,1725,4745,-40
37881238161,37881238167,6,1259,691,-40
37881711382,37881711395,13,3153,1081,-40
37885280279,37885280286,7,2866,961,-40
37886135301,37886135306,5,2381,1595,-40
37887175618,37887175621,3,2095,1012,-40
37890878254,37890878262,8,3587,1032,-40
37891406390,37891406378,-12,1131,417,-40
37897263550,37897263556,6,3580,1309,-40
37898362302,37898362297,-5,626,259,-40
37899542330,37899542338,8,2689,1365,-40
37901021689,37901021694,5,2909,999,-40
37901613983,37901613988,5,2139,1443,-40
37902344238,37902344242,4,2920,1620,-40
37903425475,37903425481,6,1715,823,-40
37906016481,37906016489,8,3661,1173,-40
37909666907,37909666915,8,2913,1199,-40
37910182490,37910182504,14,2052,977,-40
37913379398,37913379401,3,1283,723,-40
37913406737,37913406743,6,3453,1825,-40
37915474246,37915474250,4,1591,963,-40
37915888502,37915888508,6,2074,1447,-40
37918624034,37918624039,5,2866,1312,-40
37921802151,37921802157,6,2336,1093,-40
37928292596,37928292600,4,1910,1018,-40
37931069946,37931069952,6,3935,1559,-40
37935295877,37935295877,0,1765,1678,-40
37935597037,37935597039,2,1411,1170,-40
37935788826,37935788833,7,3297,1538,-40
37945126443,37945126450,7,2534,1220,-40
37945644741,37945644732,-9,1812,454,-40
37954248916,37954248914,-2,1186,1918,-40
37954682128,37954682134,6,2679,1187,-40
37957211970,37957211960,-10,40781,14143,-40
37957644857,37957644862,5,3214,1159,-40
37963832917,37963832923,6,2981,1100,-40
37965746742,37965746750,8,2969,868,-40
37966950891,37966950895,4,2062,1053,-40
37972965102,37972965101,-1,1612,1806,-40
37978229920,37978229921,1,17303,3500,-40
37982661206,37982661212,6,2202,1091,-40
37985562822,37985562830,8,2843,1501,-40
37986313312,37986313317,5,2663,1662,-40
37989027298,37989027304,6,2038,1153,-40
37990788425,37990788431,6,2031,1163,-40
37991003748,37991003731,-17,2198,866,-40
37995168864,37995168850,-14,1450,925,-40
37998136928,37998136923,-5,22269,10877,-40
37999076334,37999076338,4,2542,1104,-40
38004513458,38004513463,5,3060,1499,-40
38005057007,38005057015,8,3020,1339,-40
38008962813,38008962814,1,1602,2600,-40
38009150614,38009150622,8,4224,1290,-40
38013817747,38013817754,7,3107,1479,-40
38015083451,38015083457,6,2802,1104,-40
38018370483,38018370467,-16,618,538,-40
38018512690,38018512697,7,4284,1022,-40
38023205194,38023205199,5,1550,1293,-40
38024122517,38024122496,-21,2091,801,-40
38030907283,38030907290,7,2144,634,-40
38031039025,38031039031,6,2901,1099,-40
38032187131,38032187134,3,2021,911,-40
38035449781,38035449788,7,3296,934,-40
38041043490,38041043495,5,1968,1353,-40
38041487817,38041487821,4,2141,1108,-40
38042036198,38042036208,10,3160,1556,-40
38044610066,38044610072,6,2503,1307,-40
38046172062,38046172067,5,3110,1381,-40
38047424722,38047424727,5,2106,852,-40
38051979845,38051979851,6,8027,34040,-40
38052960816,38052960810,-6,2047,6667,-40
38060315210,38060315217,7,4339,1399,-40
38062370074,38062370081,7,2939,1176,-40
38063324117,38063324121,4,1231,966,-40
38063471189,38063471195,6,3809,1518,-40
38065060305,38065060312,7,2705,1036,-40
38065296394,38065296391,-3,1474,3305,-40
38065505957,38065505962,5,2098,1362,-40
38065843255,38065843234,-21,2378,603,-40
38066803707,38066803711,4,2663,1255,-40
38071181742,38071181750,8,2807,1173,-40
38076133117,38076133122,5,1772,1013,-40
38077897297,38077897303,6,2949,1167,-40
38078306471,38078306475,4,1210,680,-40
38081610511,38081610490,-21,1584,1232,-40
38087836789,38087836796,7,4182,1751,-40
38090864454,38090864455,1,2438,2538,-40
38090986733,38090986739,6,3272,1412,-40
38094812865,38094812870,5,2714,1480,-40
38097154086,38097154093,7,1965,1270,-40
38097596090,38097596097,7,2995,1226,-40
38099639028,38099639034,6,5084,2849,-40
38100046405,38100046406,1,1418,2456,-40
38103028073,38103028078,5,2744,1595,-40
38104324711,38104324709,-2,846,1286,-40
38106533024,38106533031,7,3395,1056,-40
38106603142,38106603148,6,2281,1121,-40
38107407617,38107407600,-17,1855,841,-40
38109741333,38109741330,-3,22689,16136,-40
38112837055,38112837047,-8,736,2115,-40
38114750690,38114750696,6,2549,1060,-40
38115148039,38115148016,-23,1205,74,-40
38119422970,38119422976,6,2741,1196,-40
38124160282,38124160287,5,3065,1607,-40
38128073669,38128073675,6,2050,1028,-40
38134939812,38134939817,5,3481,1684,-40
38136887413,38136887418,5,2707,1206,-40
38142093261,38142093266,5,2732,1323,-40
38144201647,38144201653,6,2603,1562,-40
38145363232,38145363239,7,2765,1713,-40
38147036703,38147036707,4,1326,1270,-40
38147282126,38147282105,-21,1305,316,-40
38148009256,38148009263,7,4608,1290,-40
38149238121,38149238126,5,1290,795,-40
38152180805,38152180809,4,25987,26604,-40
38156167849,38156167856,7,2355,1150,-40
38157753476,38157753476,0,1374,1195,-40
38159596745,38159596753,8,5616,918,-40
38160585524,38160585531,7,2835,986,-40
38166276015,38166275999,-16,1244,185,-40
38166472549,38166472555,6,3030,1651,-40
38168381685,38168381691,6,2485,1515,-40
38170989835,38170989839,4,2059,1260,-40
38173609005,38173609011,6,2671,1240,-40
38175153726,38175153733,7,2491,1161,-40
38176365975,38176365983,8,3901,1436,-40
38177830780,38177830787,7,2161,1257,-40
38177953030,38177953035,5,2074,1018,-40
38179830714,38179830722,8,1167,356,-40
38179966215,38179966215,0,3572,3375,-40
38180749941,38180749949,8,3990,1451,-40
38180839282,38180839289,7,2759,1192,-40
38181915221,38181915225,4,1999,1364,-40
38182374762,38182374753,-9,1242,355,-40
38183194842,38183194847,5,1792,960,-40
38184802290,38184802296,6,3286,1471,-40
38184845540,38184845520,-20,2712,1365,-40
38185994544,38185994549,5,2533,1153,-40
38199330558,38199330563,5,1835,923,-40
38201154262,38201154269,7,2525,1377,-40
38201550142,38201550146,4,2588,1713,-40
38203644845,38203644850,5,3319,1448,-40
38204666820,38204666826,6,4199,1685,-40
38207185474,38207185479,5,1714,922,-40
38207234773,38207234793,20,2155,1209,-40
38207287973,38207287954,-19,1577,709,-40
38209799449,38209799455,6,3135,1375,-40
38210592499,38210592484,-15,1161,599,-40
38213892370,38213892377,7,2586,1226,-40
38214077733,38214077739,6,2615,1065,-40
38214180926,38214180919,-7,750,3363,-40
38216961381,38216961388,7,2800,1181,-40
38218403688,38218403694,6,3877,1907,-40
38219862996,38219863003,7,2611,1564,-40
38223035993,38223035993,0,1090,1503,-40
38226344653,38226344659,6,3082,1237,-40
38226567274,38226567260,-14,2758,1134,-40
38231537731,38231537738,7,4045,1602,-40
38237188422,38237188427,5,3768,1985,-40
38239786863,38239786869,6,3984,1353,-40
38241028098,38241028103,5,2515,998,-40
38241108293,38241108298,5,2339,1112,-40
38244223201,38244223206,5,2448,1056,-40
38247036882,38247036887,5,3301,1014,-40
38248147973,38248147979,6,2169,1098,-40
38248175670,38248175678,8,2661,1238,-40
38255914442,38255914447,5,2858,1003,-40
38258160774,38258160781,7,2532,1632,-40
38258196100,38258196080,-20,1489,649,-40
38260815071,38260815079,8,2687,1162,-40
38262501329,38262501335,6,2477,1184,-40
38263600455,38263600453,-2,1628,2872,-40
38264233711,38264233715,4,2350,922,-40
38264981438,38264981446,8,3882,1485,-40
38266905010,38266905014,4,2504,1792,-40
38268932753,38268932760,7,3418,1635,-40
38270738802,38270738796,-6,1132,3238,-40
38273811043,38273811050,7,3939,1146,-40
38278509837,38278509842,5,2223,1297,-40
38279909678,38279909689,11,1722,1356,-40
38283860032,38283860039,7,2197,1284,-40
38283900975,38283900956,-19,3477,1313,-40
38286056816,38286056822,6,3341,1157,-40
38292252856,38292252857,1,7867,8924,-40
38295431259,38295431267,8,2590,1275,-40
38296108060,38296108043,-17,2098,406,-40
38300392717,38300392723,6,3189,1367,-40
38301649664,38301649670,6,2523,1005,-40
38302603505,38302603510,5,2922,1081,-40
38304568015,38304568013,-2,2501,5379,-40
38305726463,38305726467,4,2394,988,-40
38307545562,38307545543,-19,1170,395,-40
38308169973,38308169968,-5,1204,211,-40
38309186068,38309186075,7,3068,1332,-40
38313488454,38313488458,4,2487,1237,-40
38313736944,38313736928,-16,1723,886,-40
38319035181,38319035187,6,2236,1078,-40
38320417846,38320417851,5,2623,1365,-40
38322168447,38322168466,19,84,536,-40
38323084918,38323084925,7,4078,1891,-40
38327020738,38327020739,1,1909,1724,-40
38327161043,38327161050,7,2184,1067,-40
38331429988,38331429995,7,3991,1854,-40
38332126909,38332126913,4,4135,2535,-40
38332619137,38332619142,5,3217,1078,-40
38333198027,38333198030,3,1463,1315,-40
38333706627,38333706634,7,2752,1154,-40
38334939161,38334939167,6,2966,857,-40
38336381451,38336381457,6,2671,1384,-40
38336988930,38336988935,5,2391,748,-40
38339902579,38339902586,7,2828,1153,-40
38341622691,38341622694,3,1545,1643,-40
38344287536,38344287541,5,2395,1311,-40
38351791084,38351791090,6,3682,1117,-40
38354545282,38354545289,7,2379,1099,-40
38355779930,38355779937,7,2937,1085,-40
38355819166,38355819179,13,1579,899,-40
38359381117,38359381122,5,3315,1833,-40
38359784117,38359784122,5,3109,1143,-40
38362654389,38362654394,5,3819,1960,-40
38370789801,38370789804,3,3017,2804,-40
38372728668,38372728671,3,1249,1668,-40
38373161823,38373161826,3,1400,1590,-40
38378570396,38378570401,5,3347,1630,-40
38382470670,38382470676,6,3986,1980,-40
38383196609,38383196613,4,8801,28846,-40
38383523417,38383523417,0,3041,2577,-40
38383715433,38383715441,8,2193,1036,-40
38387822429,38387822430,1,3005,2310,-40
38388465794,38388465802,8,2287,1349,-40
38389749509,38389749489,-20,1422,185,-40
38391544709,38391544731,22,3171,1215,-40
38392107680,38392107686,6,3277,1233,-40
38392482289,38392482290,1,13241,13730,-40
38393561763,38393561770,7,3369,1085,-40
38394772996,38394773001,5,3194,1574,-40
38399798522,38399798522,0,1453,1614,-40
38402870304,38402870310,6,2758,1456,-40
38402896934,38402896924,-10,1107,373,-40
38405737503,38405737508,5,13680,27662,-40
38416088990,38416088997,7,2710,1420,-40
38416237785,38416237790,5,2743,1147,-40
38420062081,38420062088,7,4341,1467,-40
38423115962,38423115968,6,2582,42773,-40
38427451475,38427451482,7,3150,1331,-40
38427698190,38427698179,-11,2213,1027,-40
38428517777,38428517779,2,2538,2184,-40
38429412542,38429412547,5,2116,1031,-40
38429663284,38429663273,-11,657,431,-40
38434053270,38434053277,7,2680,1246,-40
38434409417,38434409423,6,2641,1303,-40
38436479020,38436479027,7,2897,1324,-40
38437363579,38437363585,6,3231,1194,-40
38440337665,38440337671,6,2168,744,-40
38442061165,38442061171,6,2387,1347,-40
38444704229,38444704238,9,2320,822,-40
38450904482,38450904485,3,3783,3719,-40
38451154198,38451154203,5,1379,692,-40
38454095186,38454095193,7,3852,2085,-40
38454887226,38454887232,6,3558,1697,-40
38455265937,38455265943,6,3364,1437,-40
38456107020,38456107027,7,3212,1385,-40
38457445323,38457445330,7,2883,1325,-40
38457536313,38457536312,-1,1294,227,-40
38457772634,38457772642,8,901,184,-40
38458835894,38458835900,6,2864,1113,-40
38461239177,38461239183,6,2338,1443,-40
38463108962,38463108970,8,2418,847,-40
38468047220,38468047228,8,1956,1177,-40
38468081335,38468081342,7,3686,1390,-40
38470470137,38470470144,7,3972,1332,-40
38475302872,38475302878,6,3325,951,-40
38477048990,38477048995,5,2759,1386,-40
38482050192,38482050198,6,2670,1363,-40
38483122335,38483122341,6,3901,1331,-40
38484212962,38484212961,-1,649,1861,-40
38486762554,38486762538,-16,1379,909,-40
38487677334,38487677339,5,2985,1351,-40
38488961635,38488961642,7,2418,1111,-40
38490520669,38490520668,-1,1225,3025,-40
38498497407,38498497414,7,2360,1054,-40
38505369080,38505369086,6,2301,1157,-40
38512736597,38512736594,-3,1374,2899,-40
38516571070,38516571048,-22,1677,758,-40
38519841086,38519841093,7,2660,1420,-40
38520010298,38520010303,5,2953,1162,-40
38520751081,38520751086,5,3166,1074,-40
38522348316,38522348323,7,1533,764,-40
38523164995,38523164989,-6,1098,3736,-40
38523791432,38523791437,5,2178,855,-40
38523833773,38523833793,20,2771,933,-40
38524981427,38524981436,9,3500,1368,-40
38525543818,38525543823,5,2554,1017,-40
38525774597,38525774576,-21,1745,1180,-40
38527520315,38527520319,4,1052,795,-40
38529184651,38529184658,7,2330,1434,-40
38529469645,38529469652,7,2183,1150,-40
38539234787,38539234795,8,2525,1213,-40
38542246300,38542246305,5,3209,2120,-40
38544277947,38544277954,7,2700,1444,-40
38548068731,38548068737,6,2882,1397,-40
38549489784,38549489780,-4,155,6427,-40
38555262920,38555262925,5,2747,1260,-40
38558611469,38558611465,-4,2793,6356,-40
38559033857,38559033862,5,4222,1261,-40
38561011729,38561011741,12,3158,1370,-40
38564245174,38564245181,7,2669,1445,-40
38565669569,38565669575,6,2782,994,-40
38575018182,38575018190,8,3126,1155,-40
38576201157,38576201163,6,2655,1082,-40
38576737359,38576737366,7,1589,989,-40
38585971170,38585971177,7,2519,1406,-40
38586394170,38586394174,4,2419,1133,-40
38587970731,38587970737,6,3007,1074,-40
38589401112,38589401118,6,3005,1434,-40
38589690883,38589690898,15,1180,371,-40
38591092495,38591092502,7,2794,1053,-40
38604482558,38604482565,7,2909,1422,-40
38605527243,38605527256,13,2484,1212,-40
38609632562,38609632568,6,2224,1161,-40
38609678238,38609678243,5,3374,1269,-40
38610999973,38610999979,6,3162,1264,-40
38612865981,38612865987,6,2702,1070,-40
38616203373,38616203381,8,2867,1284,-40
38618389680,38618389687,7,2259,1094,-40
38621790522,38621790526,4,2461,1236,-40
38622821537,38622821545,8,2963,1670,-40
38628092027,38628092034,7,3406,1878,-40
38628755595,38628755601,6,1758,881,-40
38630215103,38630215110,7,2658,945,-40
38630315279,38630315257,-22,1432,630,-40
38630342055,38630342062,7,3252,1438,-40
38630948535,38630948542,7,2868,1468,-40
38631074981,38631074993,12,2859,1296,-40
38635443909,38635443916,7,4758,2148,-40
38637586534,38637586539,5,1640,849,-40
38653447985,38653447991,6,2477,1553,-40
38660216562,38660216571,9,2800,1340,-40
38660742159,38660742146,-13,544,63,-40
38662370074,38662370082,8,2519,1335,-40
38662856971,38662856978,7,2283,826,-40
38663170333,38663170344,11,1972,1050,-40
38664522034,38664522037,3,1939,1145,-40
38665821851,38665821858,7,4086,1456,-40
38666496229,38666496235,6,2200,773,-40
38672131890,38672131894,4,3477,1381,-40
38677404731,38677404737,6,2917,1163,-40
38681997994,38681998000,6,2626,1136,-40
38684209459,38684209466,7,2507,1175,-40
38685340705,38685340711,6,2719,1270,-40
38686567542,38686567549,7,3339,1664,-40
38687659884,38687659891,7,2076,438,-40
38687839441,38687839448,7,3378,1624,-40
38688135063,38688135069,6,3616,1687,-40
38700970448,38700970456,8,2358,885,-40
38703848309,38703848313,4,1995,1477,-40
38713572821,38713572825,4,1388,1201,-40
38715231610,38715231618,8,1654,706,-40
38720630762,38720630759,-3,977,1860,-40
38732153505,38732153511,6,2562,973,-40
38737082405,38737082413,8,2270,1223,-40
38739306139,38739306145,6,2127,862,-40
38740253611,38740253596,-15,3562,1538,-40
38744998150,38744998157,7,3271,1174,-40
38745813422,38745813412,-10,1127,660,-40
38748659937,38748659944,7,4450,1270,-40
38748699636,38748699617,-19,682,388,-40
38748967621,38748967627,6,3032,1264,-40
38762861699,38762861707,8,3825,1860,-40
38766423674,38766423681,7,3992,1198,-40
38772502590,38772502590,0,987,2090,-40
38772992732,38772992739,7,2657,1017,-40
38778116533,38778116540,7,1915,1212,-40
38780777446,38780777451,5,1367,864,-40
38780877953,38780877938,-15,2141,1093,-40
38783351523,38783351530,7,2739,1029,-40
38784693367,38784693348,-19,1008,381,-40
38785231454,38785231460,6,2006,1283,-40
38785385323,38785385323,0,19615,26733,-40
38785852922,38785852931,9,3639,1480,-40
38786961141,38786961146,5,1431,818,-40
38788794965,38788794971,6,2229,1400,-40
38793578362,38793578369,7,2238,810,-40
38801446034,38801446031,-3,1640,3348,-40
38802950960,38802950966,6,2424,1199,-40
38808758063,38808758068,5,2506,1201,-40
38810373569,38810373571,2,2309,2116,-40
38810773931,38810773938,7,3118,1539,-40
38812145812,38812145818,6,3816,1510,-40
38812612407,38812612414,7,3275,1440,-40
38812769634,38812769640,6,3809,1429,-40
38817704899,38817704903,4,974,813,-40
38819416029,38819416035,6,1308,1338,-40
38820503691,38820503698,7,3370,1457,-40
38826579889,38826579886,-3,911,1509,-40
38827062278,38827062285,7,1600,900,-40
38830090016,38830090019,3,1490,21964,-40
38831513859,38831513867,8,2310,792,-40
38838049997,38838050003,6,1941,777,-40
38838109991,38838109995,4,2036,907,-40
38846145472,38846145478,6,3485,1321,-40
38846634749,38846634761,12,2531,1321,-40
38847869869,38847869875,6,4049,1858,-40
38851782677,38851782684,7,2095,973,-40
38854472961,38854472967,6,3330,1536,-40
38854666073,38854666080,7,3400,1378,-40
38856840472,38856840477,5,1867,993,-40
38857102596,38857102578,-18,2422,1001,-40
38859543046,38859543053,7,2650,815,-40
38862143430,38862143437,7,3084,1959,-40
38862810350,38862810357,7,3602,1188,-40
38868081605,38868081610,5,12765,4714,-40
38873518742,38873518750,8,1884,863,-40
38883205166,38883205172,6,2006,1259,-40
38885742238,38885742244,6,2831,1038,-40
38898468207,38898468214,7,3057,1156,-40
38899155977,38899155982,5,3091,1374,-40
38900793599,38900793606,7,1370,974,-40
38903176105,38903176099,-6,1252,4807,-40
38903809728,38903809734,6,2201,1221,-40
38905311650,38905311656,6,3111,1051,-40
38908292883,38908292890,7,3725,1339,-40
38909957899,38909957906,7,4195,1260,-40
38910399410,38910399416,6,2936,1321,-40
38910428451,38910428434,-17,3431,969,-40
38910956918,38910956918,0,2265,3930,-40
38911064190,38911064197,7,4050,1255,-40
38911460088,38911460074,-14,1371,892,-40
38912502678,38912502679,1,4833,5892,-40
38915118257,38915118262,5,1812,1459,-40
38915656409,38915656415,6,3301,1184,-40
38917515978,38917515985,7,3230,1099,-40
38918854396,38918854402,6,2756,937,-40
38924954682,38924954688,6,2625,1850,-40
38927072780,38927072786,6,2671,1104,-40
38929253519,38929253526,7,3715,1187,-40
38931911871,38931911875,4,2512,908,-40
38932082656,38932082662,6,2030,1064,-40
38940927434,38940927439,5,1728,1118,-40
38949394496,38949394504,8,2150,1048,-40
38950821550,38950821556,6,1736,1098,-40
38951220066,38951220075,9,3230,1696,-40
38952121493,38952121499,6,2962,1120,-40
38957935032,38957935041,9,2823,1171,-40
38960011978,38960011981,3,2031,1613,-40
38964766020,38964766026,6,2737,1155,-40
38968312773,38968312779,6,3947,2712,-40
38972000839,38972000839,0,931,1211,-40
38974593905,38974593910,5,2360,1103,-40
38977237259,38977237266,7,3642,1263,-40
38978762853,38978762860,7,2318,1256,-40
38979051697,38979051703,6,3057,1422,-40
38980349005,38980349011,6,3204,958,-40
38980799354,38980799371,17,2689,989,-40
38984770673,38984770678,5,3091,1621,-40
38988750470,38988750477,7,4782,1694,-40
38989396654,38989396672,18,526,422,-40
38992180982,38992180986,4,2190,1484,-40
38992387586,38992387593,7,3021,1939,-40
38992631659,38992631667,8,2693,1350,-40
38993209022,38993209035,13,1603,993,-40
38994289114,38994289119,5,3170,1019,-40
39001041567,39001041574,7,3363,1504,-40
39004089805,39004089802,-3,976,2392,-40
39004572849,39004572855,6,2561,1759,-40
39006920386,39006920391,5,2330,1243,-40
39008513989,39008513994,5,2713,1302,-40
39013291160,39013291176,16,390,1810,-40
39017498686,39017498689,3,2314,1652,-40
39023712547,39023712544,-3,1353,3705,-40
39023860871,39023860877,6,3157,1446,-40
39024107734,39024107712,-22,846,234,-40
39029942297,39029942302,5,1218,955,-40
39036656755,39036656759,4,1493,1094,-40
39042526646,39042526650,4,2950,1285,-40
39044392526,39044392534,8,2117,1239,-40
39045078308,39045078303,-5,1734,6097,-40
39047740591,39047740599,8,2692,960,-40
39047810857,39047810841,-16,2139,796,-40
39050408946,39050408955,9,6063,1195,-40
39054141199,39054141205,6,1821,1077,-40
39054481765,39054481785,20,1402,138,-40
39054747545,39054747552,7,2513,1012,-40
39057411317,39057411325,8,3233,1019,-40
39057576092,39057576098,6,2227,1261,-40
39059016813,39059016820,7,1609,807,-40
39064934633,39064934640,7,2861,983,-40
39070120387,39070120376,-11,27998,15508,-40
39071770803,39071770809,6,3600,1876,-40
39073999338,39073999346,8,2869,1368,-40
39080018274,39080018272,-2,890,1330,-40
39080247155,39080247162,7,3292,1629,-40
39084699344,39084699352,8,4170,1924,-40
39084877953,39084877957,4,2344,1135,-40
39086073811,39086073815,4,2142,1812,-40
39092067994,39092067999,5,2133,1028,-40
39092775757,39092775763,6,1719,798,-40
39093566401,39093566404,3,1750,1214,-40
39097463762,39097463766,4,2817,1333,-40
39098141160,39098141167,7,2319,1204,-40
39099608615,39099608622,7,2581,1258,-40
39101810357,39101810362,5,2622,1342,-40
39102030143,39102030137,-6,914,2827,-40
39112197884,39112197889,5,2327,1316,-40
39112675438,39112675417,-21,1854,959,-40
39116886126,39116886133,7,2940,1218,-40
39117264998,39117265005,7,2838,1254,-40
39119411268,39119411274,6,2891,1220,-40
39120316022,39120316002,-20,986,237,-40
39125044463,39125044470,7,4137,1824,-40
39125500909,39125500913,4,2103,1533,-40
39126262832,39126262839,7,3550,1730,-40
39126960454,39126960461,7,1529,1026,-40
39129165022,39129165030,8,2725,1523,-40
39130573283,39130573290,7,2213,1592,-40
39137293949,39137293955,6,2989,1041,-40
39137441212,39137441192,-20,1592,521,-40
39137601713,39137601715,2,34118,20597,-40
39141421480,39141421487,7,3094,1520,-40
39142389762,39142389766,4,2666,1459,-40
39144874538,39144874542,4,2160,1347,-40
39147480132,39147480144,12,12386,48019,-40
39149457089,39149457094,5,2049,1429,-40
39151871954,39151871949,-5,900,2127,-40
39156815066,39156815073,7,4138,1579,-40
39157085750,39157085746,-4,1047,3158,-40
39159475787,39159475783,-4,1401,3044,-40
39159733170,39159733175,5,2981,1225,-40
39162779002,39162779007,5,2569,1003,-40
39164018615,39164018622,7,2796,1133,-40
39165090993,39165090999,6,2801,1320,-40
39168389486,39168389492,6,3684,1180,-40
39171827088,39171827092,4,2522,1904,-40
39173326270,39173326276,6,3718,1290,-40
39176576587,39176576593,6,1630,927,-40
39178761519,39178761527,8,3409,1438,-40
39178834431,39178834411,-20,2782,803,-40
39180164048,39180164055,7,3317,1729,-40
39182313849,39182313855,6,2591,1253,-40
39184331308,39184331314,6,2825,1342,-40
39187100707,39187100713,6,2335,654,-40
39189306919,39189306926,7,3218,1353,-40
39189706043,39189706035,-8,1771,38841,-40
39190008233,39190008239,6,2378,1173,-40
39199835223,39199835222,-1,1024,1889,-40
39204043074,39204043081,7,2475,1061,-40
39207077406,39207077388,-18,1306,528,-40
39207754890,39207754898,8,2752,1120,-40
39215697475,39215697481,6,2503,1111,-40
39215960398,39215960394,-4,1969,5611,-40
39219130920,39219130928,8,2442,1438,-40
39219812120,39219812126,6,2392,1653,-40
39225165162,39225165168,6,3682,1754,-40
39226718298,39226718306,8,3095,1204,-40
39227123324,39227123331,7,1544,1233,-40
39231875050,39231875051,1,37767,21571,-40
39232161897,39232161905,8,10072,29878,-40
39236240434,39236240437,3,1539,1013,-40
39236289002,39236288987,-15,3379,1212,-40
39246619997,39246620003,6,2897,1068,-40
39248763398,39248763382,-16,2283,552,-40
39250265140,39250265147,7,1799,1151,-40
39250770934,39250770942,8,2572,1455,-40
39251059867,39251059874,7,1221,382,-40
39251590546,39251590553,7,1859,942,-40
39254560854,39254560834,-20,1060,30,-40
39263280950,39263280957,7,2717,1045,-40
39266686022,39266686028,6,2676,1207,-40
39273183657,39273183662,5,2931,2160,-40
39274008913,39274008919,6,3241,1623,-40
39275978349,39275978355,6,1894,860,-40
39276447018,39276447024,6,2662,1525,-40
39277157541,39277157548,7,2785,1117,-40
39277997892,39277997895,3,3690,782,-40
39282955260,39282955266,6,3843,1236,-40
39290282313,39290282318,5,1814,1090,-40
39292237382,39292237386,4,2343,1349,-40
39297529766,39297529771,5,2662,1160,-40
39297842725,39297842733,8,3477,1208,-40
39298086181,39298086161,-20,2854,811,-40
39299321457,39299321463,6,2935,1455,-40
39307733892,39307733898,6,2845,1160,-40
39312711809,39312711814,5,2102,1065,-40
39313958375,39313958380,5,2339,1286,-40
39314227893,39314227898,5,3057,1404,-40
39314619094,39314619074,-20,2316,850,-40
39314890216,39314890221,5,3620,1222,-40
39318011259,39318011263,4,2171,1165,-40
39319859374,39319859370,-4,2106,6923,-40
39321577613,39321577620,7,3067,1087,-40
39322613303,39322613308,5,1832,1343,-40
39326664546,39326664552,6,3088,1812,-40
39334348430,39334348438,8,3227,1166,-40
39334773985,39334773991,6,2084,1203,-40
39336086034,39336086038,4,6130,27742,-40
39337275499,39337275505,6,2415,1473,-40
39341610268,39341610274,6,2220,1408,-40
39347302182,39347302190,8,2917,1483,-40
39350496743,39350496749,6,2118,1028,-40
39350807631,39350807616,-15,1391,700,-40
39352475694,39352475701,7,2579,1337,-40
39352532269,39352532265,-4,1672,209,-40
39357602877,39357602886,9,3016,1038,-40
39360271430,39360271435,5,2590,1043,-40
39362202801,39362202804,3,2096,1166,-40
39362560458,39362560473,15,3057,1741,-40
39362692550,39362692546,-4,633,36,-40
39375412976,39375412982,6,3507,1202,-40
39381760933,39381760938,5,2429,1101,-40
39383052259,39383052266,7,4055,1847,-40
39384876498,39384876502,4,1935,1244,-40
39385203881,39385203887,6,5740,1016,-40
39385433142,39385433142,0,1832,2110,-40
39385710262,39385710268,6,2160,1541,-40
39390196205,39390196210,5,1352,709,-40
39398907525,39398907531,6,3015,1264,-40
39399532541,39399532549,8,3925,1207,-40
39401938625,39401938629,4,2660,963,-40
39403121186,39403121195,9,2523,1130,-40
39406085998,39406086005,7,2997,1289,-40
39410467046,39410467051,5,2919,1116,-40
39411031429,39411031409,-20,658,408,-40
39412458409,39412458412,3,2161,1701,-40
39415283747,39415283753,6,3224,1324,-40
39424113616,39424113622,6,2812,1426,-40
39429582728,39429582734,6,3342,1089,-40
39430218455,39430218461,6,1664,835,-40
39432930722,39432930727,5,1874,1104,-40
39433185082,39433185098,16,1350,369,-40
39433860270,39433860278,8,3895,1413,-40
39435823310,39435823309,-1,878,307,-40
39438768316,39438768321,5,3920,1331,-40
39445713478,39445713485,7,2416,981,-40
39445772566,39445772547,-19,1569,1044,-40
39448307492,39448307498,6,2386,1359,-40
39456086853,39456086858,5,3343,1243,-40
39457341987,39457341993,6,2322,1407,-40
39459187530,39459187535,5,3317,1702,-40
39461594762,39461594767,5,1712,1061,-40
39463978346,39463978351,5,3324,1424,-40
39467145660,39467145666,6,2269,1384,-40
39478142372,39478142377,5,4346,2028,-40
39489968054,39489968062,8,2600,1010,-40
39499822901,39499822906,5,3214,1884,-40
39499857439,39499857444,5,504,19,-40
39502544013,39502544018,5,2389,1154,-40
39503651531,39503651537,6,2852,897,-40
39504146173,39504146181,8,4068,1122,-40
39507774036,39507774038,2,2010,1288,-40
39508053997,39508053989,-8,1208,3456,-40
39508595532,39508595538,6,2411,1624,-40
39513105435,39513105443,8,1485,762,-40
39513699380,39513699385,5,2358,1290,-40
39526654863,39526654869,6,2537,1255,-40
39535682726,39535682732,6,4284,1419,-40
39539360796,39539360819,23,2077,1942,-40
39540337743,39540337751,8,1906,1286,-40
39540843982,39540843977,-5,1078,317,-40
39542404643,39542404624,-19,642,241,-40
39547793042,39547793045,3,1726,1294,-40
39554606546,39554606553,7,2458,1232,-40
39554911154,39554911158,4,2741,1260,-40
39556245946,39556245954,8,2899,1283,-40
39561040254,39561040260,6,2657,1310,-40
39562687399,39562687407,8,972,923,-40
39563294588,39563294594,6,1864,613,-40
39563981734,39563981742,8,2898,1612,-40
39565265905,39565265910,5,3175,1248,-40
39567655420,39567655427,7,3822,1736,-40
39568878073,39568878067,-6,651,195,-40
39570879638,39570879645,7,2664,1155,-40
39576458492,39576458498,6,2483,1522,-40
39577624426,39577624434,8,3839,1042,-40
39578133495,39578133497,2,1029,222,-40
39579032813,39579032818,5,2330,1418,-40
39579897109,39579897115,6,2747,1204,-40
39579995458,39579995440,-18,2226,1356,-40
39580053325,39580053326,1,3455,4485,-40
39583232904,39583232910,6,2716,909,-40
39588342673,39588342679,6,2378,1481,-40
39589948528,39589948535,7,3112,1163,-40
39590978386,39590978392,6,4346,1598,-40
39597705652,39597705659,7,2023,994,-40
39598456295,39598456304,9,2475,1272,-40
39598616893,39598616888,-5,1048,303,-40
39604168248,39604168254,6,3809,1281,-40
39605533250,39605533255,5,2832,1308,-40
39608274302,39608274310,8,2127,923,-40
39608507014,39608507034,20,807,281,-40
39608916465,39608916471,6,2138,1125,-40
39610290066,39610290074,8,3685,1535,-40
39623477003,39623477007,4,1174,972,-40
39624586013,39624586019,6,1316,942,-40
39627564014,39627564019,5,2336,872,-40
39636123327,39636123332,5,3078,1769,-40
39636301674,39636301683,9,3425,1240,-40
39639799347,39639799353,6,3179,1556,-40
39641042055,39641042061,6,2799,1378,-40
39642091268,39642091264,-4,1062,2787,-40
39646970154,39646970161,7,2920,1244,-40
39648415529,39648415535,6,4320,1604,-40
39651104951,39651104957,6,2525,1085,-40
39654397854,39654397860,6,2619,1618,-40
39654926534,39654926541,7,2282,1282,-40
39655314757,39655314757,0,1601,1155,-40
39655728585,39655728587,2,828,401,-40
39656382790,39656382789,-1,1453,4608,-40
39663183611,39663183617,6,2361,864,-40
39663337734,39663337720,-14,1371,636,-40
39663425401,39663425406,5,4320,1541,-40
39666958745,39666958753,8,9416,1369,-40
39670204306,39670204312,6,3913,1554,-40
39670562426,39670562433,7,2438,1048,-40
39671046634,39671046632,-2,872,271,-40
39671374780,39671374787,7,2599,802,-40
39675876758,39675876763,5,3550,1503,-40
39675997983,39675997977,-6,1119,4117,-40
39676178916,39676178930,14,588,1568,-40
39678188691,39678188697,6,2708,1713,-40
39678849449,39678849456,7,12473,4693,-40
39679117451,39679117459,8,3165,1381,-40
39679835000,39679834984,-16,2651,1094,-40
39682896506,39682896510,4,1358,885,-40
39684725190,39684725190,0,506,1053,-40
39686342525,39686342530,5,1300,1012,-40
39691877350,39691877355,5,2156,951,-40
39693427603,39693427609,6,1967,1123,-40
39695511902,39695511894,-8,2062,182,-40
39696391306,39696391313,7,3908,1344,-40
39697408116,39697408122,6,2734,1037,-40
39698567562,39698567566,4,2429,1097,-40
39700198690,39700198697,7,2819,1247,-40
39701011626,39701011633,7,2403,1785,-40
39701225654,39701225641,-13,1076,36,-40
39702883442,39702883449,7,3057,1324,-40
39703192449,39703192456,7,3134,1734,-40
39704243861,39704243869,8,2378,1244,-40
39704974391,39704974399,8,1664,879,-40
39710591795,39710591801,6,2055,1168,-40
39713697238,39713697236,-2,1058,2155,-40
39715693009,39715693017,8,1977,1232,-40
39722040444,39722040449,5,2240,936,-40
39724506769,39724506775,6,3361,971,-40
39725606044,39725606049,5,2137,1310,-40
39725884724,39725884731,7,2643,1172,-40
39727590194,39727590200,6,3066,1652,-40
39727977119,39727977123,4,1997,1212,-40
39730245139,39730245145,6,2451,1244,-40
39738023299,39738023303,4,2818,1816,-40
39738282353,39738282359,6,3659,1358,-40
39742880408,39742880397,-11,735,243,-40
39746612653,39746612659,6,2708,1660,-40
39747301084,39747301090,6,2769,1372,-40
39747982778,39747982782,4,2580,1044,-40
39748855645,39748855651,6,2246,1011,-40
39749359991,39749359994,3,944,1234,-40
39750092611,39750092616,5,1393,950,-40
39750944173,39750944178,5,2268,1118,-40
39751635511,39751635496,-15,474,398,-40
39752711381,39752711387,6,2540,1019,-40
39759672179,39759672185,6,2914,1150,-40
39759723885,39759723891,6,1851,750,-40
39761423036,39761423020,-16,2964,1466,-40
39762947733,39762947739,6,2152,1373,-40
39764455675,39764455681,6,2529,1018,-40
39766170836,39766170842,6,6890,3254,-40
39766901847,39766901854,7,3747,1655,-40
39767831277,39767831273,-4,1456,4189,-40
39773223230,39773223234,4,1728,1003,-40
39775056269,39775056276,7,1811,941,-40
39781624190,39781624197,7,2354,1399,-40
39784760429,39784760434,5,2456,865,-40
39786199968,39786199975,7,3685,1807,-40
39787995945,39787995951,6,2645,1252,-40
39788731373,39788731378,5,2865,1139,-40
39789130669,39789130676,7,1883,1452,-40
39789467957,39789467964,7,3059,2070,-40
39792433975,39792433981,6,2359,1237,-40
39799753192,39799753199,7,3157,1218,-40
39800709084,39800709090,6,93,1908,-40
39808540062,39808540068,6,2124,1312,-40
39808807173,39808807163,-10,1096,424,-40
39809960108,39809960113,5,2735,1471,-40
39818768875,39818768883,8,3104,1396,-40
39828777064,39828777071,7,3219,1114,-40
39832107687,39832107694,7,3748,1038,-40
39832204581,39832204586,5,3083,1528,-40
39832706913,39832706918,5,3095,1314,-40
39836223403,39836223407,4,3340,1707,-40
39836298953,39836298961,8,2207,1349,-40
39837404261,39837404258,-3,1424,2480,-40
39839835139,39839835148,9,1179,253,-40
39843285348,39843285369,21,2432,1100,-40
39843790625,39843790642,17,870,271,-40
39847794509,39847794514,5,2208,1613,-40
39849729961,39849729966,5,3291,1201,-40
39856011293,39856011300,7,4468,1563,-40
39856693557,39856693561,4,2391,718,-40
39858397322,39858397326,4,2394,748,-40
39861708273,39861708278,5,3258,1446,-40
39862743991,39862743998,7,2831,1647,-40
39866089396,39866089402,6,3126,1356,-40
39869138507,39869138513,6,2247,1330,-40
39870085174,39870085180,6,3025,1584,-40
39871131707,39871131713,6,2541,951,-40
39874161389,39874161394,5,2418,1053,-40
39875212949,39875212955,6,3482,1688,-40
39875284234,39875284238,4,2583,1319,-40
39877460878,39877460879,1,1896,1929,-40
39877601235,39877601240,5,2286,1082,-40
39877745941,39877745946,5,2347,1509,-40
39880664738,39880664720,-18,2891,1254,-40
39888215089,39888215094,5,1993,808,-40
39888717691,39888717675,-16,1300,525,-40
39897104029,39897104036,7,2384,1017,-40
39897735512,39897735498,-14,1164,531,-40
39901941495,39901941501,6,3082,1773,-40
39902480600,39902480606,6,3279,1263,-40
39903156485,39903156465,-20,1789,603,-40
39919544108,39919544114,6,3091,1340,-40
39919932661,39919932668,7,3839,1993,-40
39926218126,39926218132,6,2543,1526,-40
39930953157,39930953163,6,3028,1149,-40
39936592068,39936592075,7,3064,1555,-40
39939385979,39939385984,5,3461,1688,-40
39939461921,39939461925,4,3283,1563,-40
39939620011,39939620018,7,3895,1495,-40
39940923486,39940923493,7,2893,1192,-40
39941961154,39941961151,-3,2287,3687,-40
39943646054,39943646058,4,2060,1117,-40
39943785863,39943785856,-7,1132,200,-40
39944572548,39944572554,6,2643,1333,-40
39945194953,39945194958,5,3543,1145,-40
39946654442,39946654442,0,1447,1980,-40
39947844167,39947844149,-18,3395,1117,-40
39949968731,39949968732,1,1215,1378,-40
39952095589,39952095596,7,2789,1140,-40
39952164158,39952164161,3,1713,1133,-40
39953037151,39953037154,3,4355,57186,-40
39953457514,39953457520,6,2978,1532,-40
39953914276,39953914281,5,2578,1277,-40
39958188729,39958188734,5,3225,1135,-40
39958897702,39958897712,10,1368,264,-40
39966083017,39966083023,6,2966,1624,-40
39971063244,39971063250,6,2117,1143,-40
39978507637,39978507642,5,2465,1493,-40
39985116351,39985116355,4,1553,1368,-40
39988740694,39988740702,8,2721,987,-40
39988811220,39988811216,-4,26382,7021,-40
39991284505,39991284511,6,2776,1453,-40
40004349175,40004349183,8,2450,1350,-40
40004575760,40004575766,6,2611,1082,-40
40006874673,40006874679,6,2697,1164,-40
40008429593,40008429598,5,2007,805,-40
40010029597,40010029602,5,3231,1262,-40
40013952198,40013952202,4,2936,1348,-40
40015025188,40015025196,8,1386,681,-40
40017354272,40017354278,6,2315,1244,-40
40017741634,40017741641,7,3415,1959,-40
40018034948,40018034954,6,2469,1259,-40
40018249053,40018249058,5,3080,1450,-40
40021384442,40021384449,7,3093,1517,-40
40029931321,40029931326,5,3621,1837,-40
40030928602,40030928607,5,2349,1195,-40
40031337453,40031337447,-6,1384,3360,-40
40036154238,40036154245,7,2737,1730,-40
40038938830,40038938837,7,2054,844,-40
40040003362,40040003367,5,3844,1354,-40
40044006193,40044006198,5,1616,1468,-40
40044888102,40044888104,2,1192,1247,-40
40045575934,40045575940,6,2955,1549,-40
40048118519,40048118527,8,2719,1445,-40
40050790146,40050790153,7,3454,1815,-40
40050903442,40050903449,7,3019,1317,-40
40055991739,40055991746,7,3257,1375,-40
40058802231,40058802239,8,1805,1107,-40
40060543131,40060543123,-8,696,145,-40
40060771738,40060771747,9,924,466,-40
40063643113,40063643121,8,4100,1495,-40
40066306734,40066306735,1,1825,1669,-40
40066905014,40066905019,5,2856,1265,-40
40066962346,40066962348,2,3240,3449,-40
40076941762,40076941770,8,3676,1454,-40
40077887150,40077887158,8,3672,1430,-40
40081110702,40081110706,4,2821,1308,-40
40086062114,40086062120,6,2801,1140,-40
40086626478,40086626480,2,2149,1878,-40
40086742444,40086742424,-20,1832,809,-40
40091879042,40091879050,8,2686,1744,-40
40092077889,40092077897,8,2074,634,-40
40092609961,40092609967,6,1823,801,-40
40093681448,40093681454,6,2492,1212,-40
40096389757,40096389763,6,1964,1137,-40
40097212067,40097212073,6,2518,1347,-40
40098701160,40098701166,6,3095,1255,-40
40098849621,40098849601,-20,987,274,-40
40102528343,40102528350,7,2306,1436,-40
40104746667,40104746673,6,2131,1668,-40
40107164789,40107164795,6,2717,1159,-40
40108098063,40108098069,6,2194,1197,-40
40109209045,40109209051,6,2821,1400,-40
40111282558,40111282562,4,1267,1153,-40
40112893650,40112893656,6,2340,1334,-40
40113237951,40113237936,-15,1884,713,-40
40114434504,40114434510,6,3451,1056,-40
40114920108,40114920114,6,3148,1498,-40
40114990330,40114990313,-17,986,539,-40
40119824201,40119824207,6,2340,1239,-40
40122111815,40122111796,-19,700,308,-40
40123770042,40123770047,5,2856,1301,-40
40132266357,40132266363,6,2744,1239,-40
40137549073,40137549078,5,2923,1952,-40
40139339595,40139339590,-5,1159,4642,-40
40145864469,40145864474,5,1986,1308,-40
40147286925,40147286930,5,2914,1076,-40
40152935448,40152935455,7,3004,1457,-40
40156066996,40156067002,6,3190,1189,-40
40168724505,40168724510,5,2233,1105,-40
40168766981,40168766963,-18,2546,1435,-40
40170722714,40170722719,5,1672,931,-40
40177772720,40177772727,7,4488,931,-40
40181885861,40181885868,7,3614,1349,-40
40183292398,40183292398,0,1685,1643,-40
40183548901,40183548902,1,1379,1652,-40
40184221750,40184221756,6,3360,1141,-40
40184739343,40184739347,4,3008,1589,-40
40185236863,40185236864,1,3305,3541,-40
40185815420,40185815426,6,2258,1113,-40
40191629294,40191629302,8,1541,1107,-40
40191677217,40191677219,2,8447,8413,-40
40193945514,40193945520,6,2181,1463,-40
40194297903,40194297910,7,3334,1560,-40
40197580776,40197580782,6,2986,1352,-40
40213782267,40213782275,8,2293,715,-40
40214955155,40214955154,-1,870,2365,-40
40220488979,40220488976,-3,1302,2777,-40
40230536728,40230536734,6,2508,1542,-40
40230595038,40230595024,-14,1957,535,-40
40230977341,40230977338,-3,1487,2309,-40
40231315735,40231315741,6,3066,1369,-40
40233986269,40233986275,6,2427,1283,-40
40234471701,40234471706,5,2161,1201,-40
40235830845,40235830850,5,2369,1088,-40
40238959806,40238959801,-5,1022,4756,-40
40242654194,40242654202,8,3495,1309,-40
40243045991,40243045997,6,3114,1527,-40
40243822950,40243822938,-12,678,1087,-40
40247306240,40247306243,3,2015,1168,-40
40250418275,40250418279,4,23336,34220,-40
40251795869,40251795874,5,2474,1232,-40
40252514735,40252514747,12,2932,1168,-40
40253118316,40253118322,6,2372,1405,-40
40254705522,40254705530,8,4275,1269,-40
40256094881,40256094886,5,3165,1610,-40
40258299796,40258299800,4,2117,1208,-40
40260671594,40260671598,4,2677,2687,-40
40262160889,40262160893,4,2362,1076,-40
40264416812,40264416819,7,4635,1183,-40
40264605778,40264605785,7,3058,1584,-40
40269075858,40269075865,7,2645,955,-40
40271240670,40271240674,4,2186,1002,-40
40271518985,40271518984,-1,1082,2039,-40
40271753210,40271753205,-5,1469,3628,-40
40274461978,40274461982,4,2838,1050,-40
40279207602,40279207607,5,2164,1176,-40
40280037705,40280037692,-13,1145,406,-40
40280765710,40280765718,8,3149,1403,-40
40284852062,40284852067,5,3983,1802,-40
40296169740,40296169747,7,3561,1290,-40
40300883497,40300883503,6,4282,1599,-40
40301080058,40301080065,7,2189,1086,-40
40301380500,40301380506,6,3597,1508,-40
40301896169,40301896175,6,2539,1537,-40
40302585239,40302585246,7,3362,1367,-40
40307452424,40307452430,6,3484,1488,-40
40308104870,40308104877,7,4415,1592,-40
40308525754,40308525760,6,2556,1246,-40
40310438249,40310438255,6,3075,1718,-40
40312191477,40312191474,-3,1258,1683,-40
40315540453,40315540459,6,2458,791,-40
40316344066,40316344051,-15,1867,1048,-40
40317079037,40317079044,7,2794,1684,-40
40317192793,40317192799,6,3040,1056,-40
40318325148,40318325154,6,2723,937,-40
40319541493,40319541497,4,2690,1424,-40
40322292550,40322292557,7,2626,1019,-40
40324330346,40324330351,5,2796,1380,-40
40324822410,40324822415,5,3008,1206,-40
40326350304,40326350309,5,2422,1333,-40
40330121862,40330121870,8,2993,1350,-40
40332845358,40332845362,4,2264,2145,-40
40333083240,40333083247,7,2675,936,-40
40335549392,40335549399,7,2520,1749,-40
40337841193,40337841199,6,3121,1580,-40
40338552845,40338552850,5,2306,1021,-40
40340189259,40340189265,6,2209,1047,-40
40342728901,40342728905,4,2616,1456,-40
40342981635,40342981638,3,1438,1304,-40
40343874785,40343874790,5,4435,1716,-40
40344255341,40344255340,-1,27351,27721,-40
40344406284,40344406290,6,3346,1410,-40
40346673489,40346673495,6,3395,1514,-40
40351020958,40351020962,4,2462,1303,-40
40351212346,40351212364,18,2883,1206,-40
40352391773,40352391778,5,2649,1301,-40
40352509732,40352509745,13,11453,44248,-40
40354856811,40354856818,7,3079,1254,-40
40360131071,40360131074,3,1229,1797,-40
40362244381,40362244388,7,2205,1443,-40
40362569224,40362569223,-1,2614,3495,-40
40362818014,40362818020,6,3697,1953,-40
40364395246,40364395226,-20,1714,628,-40
40367764559,40367764565,6,2877,1359,-40
40367946426,40367946410,-16,2756,1059,-40
40380926674,40380926677,3,1546,1620,-40
40382814930,40382814933,3,18621,42965,-40
40385140461,40385140466,5,2251,1089,-40
40387201474,40387201480,6,3361,1495,-40
40388382016,40388382022,6,1729,942,-40
40392602887,40392602891,4,1962,1425,-40
40396383135,40396383142,7,2749,1337,-40
40401654232,40401654238,6,3713,1664,-40
40401718373,40401718367,-6,30825,12278,-40
40403777777,40403777782,5,2121,1130,-40
40406363549,40406363554,5,2437,939,-40
40413379488,40413379493,5,2510,1054,-40
40422142277,40422142282,5,2622,1230,-40
40430933331,40430933338,7,3391,1243,-40
40431139682,40431139682,0,1176,1041,-40
40437581095,40437581102,7,2649,1277,-40
40439104200,40439104200,0,1828,1914,-40
40442252566,40442252573,7,2926,1525,-40
40448417053,40448417060,7,2966,1353,-40
40448515707,40448515720,13,576,65,-40
40449984281,40449984262,-19,2339,877,-40
40450641705,40450641713,8,2865,1505,-40
40452323401,40452323407,6,3453,1355,-40
40456358417,40456358422,5,1263,1366,-40
40458981563,40458981569,6,2183,1145,-40
40459766813,40459766818,5,3255,1763,-40
40462590194,40462590200,6,2542,1538,-40
40463103266,40463103272,6,2996,1520,-40
40463849727,40463849734,7,3029,1150,-40
40464706599,40464706604,5,1093,219,-40
40464761000,40464761009,9,3310,1620,-40
40465846566,40465846562,-4,1483,3948,-40
40466082061,40466082061,0,1990,1904,-40
40472080331,40472080337,6,2588,1002,-40
40473422292,40473422298,6,3205,1643,-40
40476396828,40476396834,6,2998,1374,-40
40477215594,40477215598,4,2273,1238,-40
40477546103,40477546107,4,2183,1406,-40
40484134351,40484134358,7,3137,1367,-40
40486014249,40486014254,5,2674,575,-40
40488608078,40488608083,5,1816,813,-40
40488989810,40488989801,-9,1092,188,-40
40490062259,40490062266,7,2333,1085,-40
40493363602,40493363607,5,3411,1222,-40
40495235239,40495235245,6,4322,1370,-40
40496460610,40496460615,5,2872,974,-40
40498922770,40498922776,6,3262,1908,-40
40501568420,40501568427,7,3598,1229,-40
40502489722,40502489730,8,2770,1291,-40
40502583068,40502583075,7,2491,942,-40
40503667163,40503667168,5,2929,1192,-40
40508422425,40508422431,6,2796,1204,-40
40508984732,40508984738,6,3728,2225,-40
40509012041,40509012046,5,2351,1268,-40
40509916431,40509916437,6,2491,1213,-40
40511126180,40511126185,5,3946,1441,-40
40517074190,40517074198,8,4217,1752,-40
40519525814,40519525821,7,2066,1598,-40
40525585650,40525585657,7,3022,1323,-40
40528046262,40528046267,5,1803,1083,-40
40529048935,40529048940,5,1894,598,-40
40529416375,40529416353,-22,800,306,-40
40529724321,40529724326,5,3031,1426,-40
40530417340,40530417324,-16,2343,1089,-40
40532637993,40532638000,7,2992,1365,-40
40532930403,40532930394,-9,1062,206,-40
40538380189,40538380195,6,2495,966,-40
40541185385,40541185391,6,2782,1208,-40
40543102726,40543102720,-6,1414,5471,-40
40546809745,40546809750,5,3345,1706,-40
40552056217,40552056223,6,3737,1111,-40
40552725697,40552725703,6,3459,1503,-40
40555461709,40555461714,5,3308,1464,-40
40559827991,40559827997,6,2667,1370,-40
40583610881,40583610888,7,2083,1354,-40
40587697846,40587697853,7,2492,1341,-40
40587724469,40587724466,-3,780,425,-40
40588677409,40588677414,5,1067,653,-40
40592109626,40592109633,7,1896,905,-40
40592360763,40592360748,-15,1139,686,-40
40593011856,40593011853,-3,783,1964,-40
40598078097,40598078104,7,2872,1392,-40
40603082841,40603082849,8,3579,1088,-40
40605062425,40605062432,7,2416,1411,-40
40606629342,40606629350,8,3094,1754,-40
40614757762,40614757769,7,2604,1009,-40
40616135314,40616135319,5,1424,1390,-40
40617284465,40617284480,15,886,331,-40
40619087135,40619087139,4,2243,818,-40
40620465661,40620465666,5,3120,1362,-40
40621521323,40621521329,6,4097,2371,-40
40624109062,40624109058,-4,306,1439,-40
40624998770,40624998774,4,2039,1424,-40
40630012909,40630012916,7,2671,1186,-40
40630445234,40630445228,-6,1227,254,-40
40634606816,40634606818,2,18941,10433,-40
40636683191,40636683197,6,2296,938,-40
40638416008,40638416013,5,2948,1580,-40
40639527250,40639527232,-18,1765,717,-40
40640563909,40640563915,6,3512,1462,-40
40643946678,40643946681,3,2132,1088,-40
40648535899,40648535905,6,4139,1695,-40
40654431966,40654431974,8,1222,1323,-40
40654873548,40654873554,6,2940,1070,-40
40655069378,40655069386,8,1408,855,-40
40655547793,40655547778,-15,2659,1515,-40
40658718842,40658718841,-1,1110,1590,-40
40660786205,40660786210,5,2759,1556,-40
40661749806,40661749809,3,3127,3022,-40
40662205414,40662205419,5,2961,975,-40
40663114121,40663114126,5,3081,989,-40
40663743733,40663743739,6,2940,1187,-40
40668955619,40668955610,-9,778,120,-40
40670314856,40670314862,6,3850,1256,-40
40670887926,40670887906,-20,624,296,-40
40675530935,40675530938,3,2262,1883,-40
40676766021,40676766026,5,1085,609,-40
40677393959,40677393966,7,1711,970,-40
40678290148,40678290157,9,1534,976,-40
40684024375,40684024381,6,2463,1431,-40
40684832702,40684832720,18,2196,1248,-40
40685809314,40685809319,5,3195,1203,-40
40688341802,40688341807,5,1419,811,-40
40698303205,40698303212,7,2076,1159,-40
40701830382,40701830390,8,1180,568,-40
40704598294,40704598302,8,2604,1424,-40
40707375751,40707375757,6,3579,736,-40
40707884761,40707884769,8,1107,320,-40
40709256555,40709256561,6,2232,1179,-40
40709505621,40709505611,-10,983,406,-40
40711302301,40711302307,6,2274,1336,-40
40711467143,40711467151,8,4524,1275,-40
40712688273,40712688279,6,2597,1346,-40
40719415749,40719415754,5,3071,1508,-40
40719680438,40719680446,8,3119,1311,-40
40728276763,40728276770,7,2090,1053,-40
40729489109,40729489115,6,3344,1490,-40
40730664347,40730664352,5,2996,1502,-40
40731410368,40731410373,5,1431,949,-40
40732650371,40732650377,6,1036,202,-40
40733259915,40733259930,15,1112,254,-40
40735454305,40735454311,6,2190,1407,-40
40740484592,40740484600,8,2047,1319,-40
40743334958,40743334963,5,2912,1067,-40
40746606289,40746606295,6,3568,2046,-40
40748687761,40748687767,6,2948,1435,-40
40758937521,40758937518,-3,2078,2347,-40
40760648034,40760648042,8,3026,962,-40
40761119119,40761119139,20,474,210,-40
40765174258,40765174265,7,3016,1218,-40
40766140611,40766140625,14,2682,341,-40
40767238525,40767238533,8,4107,1630,-40
40767764705,40767764711,6,3420,1227,-40
40768921334,40768921328,-6,1202,4415,-40
40769258549,40769258554,5,2069,1007,-40
40772758485,40772758490,5,2227,1152,-40
40774930478,40774930485,7,3475,1196,-40
40777983441,40777983450,9,4066,1020,-40
40778332062,40778332052,-10,782,570,-40
40787936818,40787936825,7,3063,1318,-40
40788777138,40788777143,5,3098,1628,-40
40789035605,40789035611,6,2007,1096,-40
40791686069,40791686076,7,2507,1467,-40
40791753460,40791753451,-9,1366,25416,-40
40793298553,40793298561,8,3189,1308,-40
40793657541,40793657529,-12,1237,452,-40
40794807169,40794807174,5,2509,929,-40
40804932959,40804932941,-18,3008,1374,-40
40805074809,40805074814,5,1817,1130,-40
40807268820,40807268820,0,43201,33438,-40
40807711891,40807711897,6,3196,1722,-40
40813131220,40813131226,6,2887,1072,-40
40816836410,40816836404,-6,732,3336,-40
40825620134,40825620139,5,1917,1194,-40
40828946717,40828946722,5,1285,755,-40
40835033929,40835033932,3,1577,1632,-40
40837443158,40837443159,1,1728,3000,-40
40843169731,40843169738,7,3874,1584,-40
40850058321,40850058312,-9,1702,4208,-40
40854059966,40854059974,8,4302,1635,-40
40854246703,40854246713,10,2618,1285,-40
40854863852,40854863859,7,2541,985,-40
40855314286,40855314265,-21,3165,1602,-40
40864997153,40864997159,6,1751,1008,-40
40865725165,40865725146,-19,949,301,-40
40868362422,40868362426,4,1971,678,-40
40874014541,40874014547,6,2144,989,-40
40876948131,40876948136,5,3201,1727,-40
40881080044,40881080051,7,3214,942,-40
40881183246,40881183238,-8,27228,17184,-40
40881614689,40881614695,6,1167,489,-40
40893800150,40893800154,4,2624,1489,-40
40893957871,40893957870,-1,1259,1887,-40
40897819514,40897819520,6,2555,1240,-40
40898549307,40898549290,-17,2380,1031,-40
40899544994,40899544989,-5,1480,4124,-40
40900292782,40900292789,7,2494,1483,-40
40900489137,40900489142,5,3383,1210,-40
40902525115,40902525122,7,3504,1169,-40
40903082477,40903082485,8,2850,1408,-40
40903835642,40903835626,-16,812,286,-40
40907177973,40907177978,5,2394,1274,-40
40913792954,40913792961,7,2589,1515,-40
40916466298,40916466307,9,2348,1148,-40
40918032105,40918032113,8,2716,1011,-40
40924071106,40924071113,7,3052,1490,-40
40924434369,40924434353,-16,2122,877,-40
40926097146,40926097154,8,1937,1163,-40
40929171869,40929171872,3,1941,426,-40
40931770837,40931770842,5,2171,1271,-40
40932796501,40932796506,5,2879,1517,-40
40934675442,40934675447,5,2716,1355,-40
40935086862,40935086869,7,2532,1363,-40
40937595318,40937595322,4,1556,1216,-40
40938407802,40938407808,6,2389,1163,-40
40945753322,40945753328,6,2637,1386,-40
40952809857,40952809862,5,2319,1255,-40
40956113641,40956113646,5,2967,1506,-40
40956413101,40956413089,-12,927,43,-40
40957256062,40957256052,-10,3766,1268,-40
40957331469,40957331489,20,1238,57,-40
40958884596,40958884596,0,1137,1445,-40
40966493309,40966493315,6,2663,1119,-40
40967497538,40967497545,7,2808,1341,-40
40970125089,40970125095,6,3382,1543,-40
40971811769,40971811777,8,8956,40740,-40
40973231831,40973231837,6,2110,1305,-40
40973351813,40973351820,7,3952,1398,-40
40974624181,40974624187,6,2882,901,-40
40975418622,40975418609,-13,613,50,-40
40980501442,40980501449,7,1339,887,-40
40987857757,40987857763,6,2707,635,-40
40989062106,40989062113,7,2278,1156,-40
40989246525,40989246504,-21,3181,1715,-40
40989497869,40989497876,7,2774,1758,-40
40990358840,40990358846,6,2039,980,-40
40992499424,40992499430,6,2472,1244,-40
40993473794,40993473800,6,1541,680,-40
40995951498,40995951503,5,2353,1094,-40
40996534545,40996534530,-15,3607,1949,-40
41001331981,41001331985,4,14143,23494,-40
41005587014,41005587018,4,2650,1370,-40
41006151677,41006151685,8,2873,1543,-40
41012782403,41012782411,8,3394,1150,-40
41016640501,41016640506,5,3030,1325,-40
41021060857,41021060862,5,2990,1382,-40
41022995654,41022995659,5,2577,1642,-40
41027863556,41027863562,6,4736,1660,-40
41033626438,41033626442,4,2151,1631,-40
41033988293,41033988298,5,3803,1606,-40
41034183144,41034183151,7,3632,1309,-40
41036665342,41036665349,7,3362,1656,-40
41036892337,41036892339,2,1772,1589,-40
41040495950,41040495956,6,3034,1670,-40
41041673803,41041673809,6,2289,1034,-40
41042130763,41042130747,-16,3162,1059,-40
41042971249,41042971255,6,2275,1304,-40
41053197286,41053197295,9,2144,1042,-40
41054637250,41054637255,5,2926,1181,-40
41058901149,41058901143,-6,1720,4253,-40
41065103050,41065103056,6,3575,1340,-40
41066005990,41066005994,4,3493,1457,-40
41067342337,41067342345,8,3337,1435,-40
41068397752,41068397758,6,3397,1136,-40
41072596917,41072596925,8,2360,1393,-40
41075720630,41075720637,7,2452,1168,-40
41079612108,41079612103,-5,1860,5478,-40
41080396906,41080396923,17,1045,27,-40
41082195413,41082195417,4,2322,1511,-40
41088639131,41088639137,6,3081,1504,-40
41090207115,41090207121,6,3071,1185,-40
41094123166,41094123171,5,2948,1158,-40
41095181239,41095181238,-1,1561,2282,-40
41096277000,41096277007,7,3087,1174,-40
41101851578,41101851569,-9,31527,15697,-40
41104037439,41104037447,8,3392,1644,-40
41107082915,41107082921,6,2638,1388,-40
41108559132,41108559138,6,3356,1074,-40
41108820314,41108820329,15,2843,982,-40
41110898441,41110898446,5,2482,969,-40
41111403015,41111403021,6,3296,1748,-40
41111490093,41111490112,19,1821,1311,-40
41114748135,41114748129,-6,728,2991,-40
41115442348,41115442354,6,2246,1012,-40
41115541086,41115541068,-18,1737,639,-40
41118024813,41118024819,6,3179,1288,-40
41118722163,41118722169,6,2453,1025,-40
41121595674,41121595679,5,2646,1407,-40
41121986001,41121986008,7,3490,1576,-40
41122738580,41122738583,3,1799,1060,-40
41126059050,41126059055,5,3333,1284,-40
41126722654,41126722662,8,3176,1382,-40
41129942256,41129942261,5,3714,1463,-40
41132464566,41132464575,9,3574,865,-40
41133582106,41133582114,8,2420,1119,-40
41134170436,41134170442,6,3159,928,-40
41135188158,41135188163,5,1624,586,-40
41136747505,41136747514,9,2993,1267,-40
41137003822,41137003809,-13,745,345,-40
41137625149,41137625156,7,2441,1355,-40
41140455085,41140455092,7,2811,1399,-40
41140789397,41140789387,-10,1075,453,-40
41140845253,41140845261,8,2599,1461,-40
41142084946,41142084947,1,3175,4178,-40
41144007623,41144007629,6,2745,1537,-40
41146588490,41146588495,5,2631,1335,-40
41150097328,41150097334,6,2127,1033,-40
41155318205,41155318211,6,2968,1399,-40
41156838785,41156838783,-2,1095,2610,-40
41159534654,41159534661,7,2656,1240,-40
41161862887,41161862894,7,2468,1241,-40
41163896117,41163896126,9,12750,31328,-40
41168417606,41168417589,-17,2543,937,-40
41169128223,41169128222,-1,887,1805,-40
41171839505,41171839512,7,3111,1605,-40
41172235859,41172235865,6,1821,786,-40
41173152759,41173152739,-20,2543,1434,-40
41176698608,41176698614,6,3851,1469,-40
41176728645,41176728653,8,2493,331,-40
41178027835,41178027839,4,1595,1610,-40
41180857174,41180857182,8,3491,1463,-40
41183173648,41183173654,6,1458,730,-40
41185713627,41185713633,6,3432,1521,-40
41186123327,41186123312,-15,753,508,-40
41187822068,41187822075,7,2304,1005,-40
41189777422,41189777426,4,2150,1058,-40
41190085589,41190085595,6,3424,1703,-40
41190988896,41190988902,6,3212,1179,-40
41191855670,41191855674,4,2662,1259,-40
41196027611,41196027617,6,3304,1751,-40
41197119033,41197119042,9,3085,938,-40
41198367433,41198367439,6,2931,1307,-40
41200394523,41200394531,8,1125,648,-40
41201996765,41201996772,7,2999,1322,-40
41202546166,41202546170,4,1462,1585,-40
41204820570,41204820577,7,2895,1475,-40
41208838253,41208838259,6,2104,1117,-40
41220108441,41220108440,-1,1836,1663,-40
41220214095,41220214102,7,1850,1023,-40
41221565489,41221565493,4,1278,1093,-40
41221889698,41221889706,8,1591,932,-40
41226593680,41226593685,5,3733,2095,-40
41232344053,41232344058,5,3713,1741,-40
41235818441,41235818448,7,5288,1273,-40
41237841794,41237841802,8,2807,1546,-40
41238518104,41238518110,6,3725,1409,-40
41240296897,41240296902,5,2491,1554,-40
41240742779,41240742786,7,3547,1469,-40
41241463265,41241463270,5,2199,886,-40
41243964255,41243964257,2,4390,4268,-40
41246600330,41246600335,5,3334,1571,-40
41247936510,41247936516,6,3530,1226,-40
41254635481,41254635485,4,2285,1045,-40
41255396788,41255396794,6,2329,1048,-40
41257664146,41257664151,5,1417,1582,-40
41258432460,41258432466,6,4163,1542,-40
41258722717,41258722697,-20,1357,453,-40
41260091883,41260091890,7,4123,1932,-40
41260119375,41260119383,8,3733,1506,-40
41261290296,41261290304,8,13914,43816,-40
41261712382,41261712382,0,823,1217,-40
41263441754,41263441762,8,8071,1009,-40
41265626062,41265626067,5,2503,1246,-40
41267183114,41267183118,4,2994,1738,-40
41270309841,41270309846,5,2835,1964,-40
41276162855,41276162862,7,2696,1005,-40
41276575240,41276575249,9,12880,34050,-40
41276895574,41276895581,7,2829,1787,-40
41280593659,41280593667,8,3745,1462,-40
41280959520,41280959522,2,43595,22483,-40
41285193414,41285193422,8,2736,1388,-40
41287692355,41287692355,0,1227,1082,-40
41295470113,41295470118,5,2119,1113,-40
41299258783,41299258781,-2,1334,2182,-40
41302679657,41302679663,6,2023,1072,-40
41308135258,41308135263,5,3457,1362,-40
41313355005,41313355008,3,2442,1228,-40
41315104579,41315104584,5,1778,801,-40
41319410605,41319410610,5,2876,1402,-40
41321295770,41321295774,4,1715,1222,-40
41323520433,41323520438,5,2242,1919,-40
41325280595,41325280601,6,2340,1692,-40
41326070059,41326070065,6,2005,1303,-40
41326143229,41326143235,6,3278,1412,-40
41326184154,41326184154,0,1474,1825,-40
41329420596,41329420599,3,2210,976,-40
41330416452,41330416458,6,2308,1276,-40
41331934641,41331934647,6,1884,971,-40
41334327154,41334327159,5,3173,1151,-40
41337768471,41337768478,7,3224,1382,-40
41338524569,41338524575,6,3015,1496,-40
41340018681,41340018686,5,1701,1029,-40
41340814770,41340814777,7,3079,1021,-40
41347590667,41347590674,7,2820,1212,-40
41352575205,41352575211,6,3339,996,-40
41353905616,41353905622,6,4661,1826,-40
41356752557,41356752538,-19,2435,748,-40
41358312585,41358312593,8,4687,1343,-40
41364530919,41364530927,8,4148,1734,-40
41366404293,41366404299,6,3086,1282,-40
41371246585,41371246591,6,2833,1507,-40
41373900665,41373900670,5,2905,1544,-40
41376976620,41376976618,-2,1380,2025,-40
41379261060,41379261067,7,2757,1177,-40
41379772526,41379772534,8,3539,1523,-40
41380409141,41380409147,6,2256,1071,-40
41380887269,41380887249,-20,1177,247,-40
41384773300,41384773307,7,3127,1425,-40
41385733958,41385733961,3,1928,1140,-40
41390756160,41390756154,-6,2078,10251,-40
41391383480,41391383486,6,2453,1339,-40
41393982383,41393982372,-11,1409,447,-40
41395496357,41395496362,5,2349,947,-40
41400312329,41400312334,5,2892,1759,-40
41408902948,41408902955,7,3605,1470,-40
41412290553,41412290551,-2,1612,2130,-40
41419026532,41419026539,7,3897,1146,-40
41420033109,41420033114,5,3574,1715,-40
41420439726,41420439732,6,3166,1048,-40
41423472770,41423472777,7,4245,1755,-40
41426887519,41426887525,6,3024,1373,-40
41429985384,41429985390,6,2680,1258,-40
41430835756,41430835759,3,1551,1679,-40
41430890644,41430890650,6,2556,1406,-40
41435250596,41435250601,5,2433,1515,-40
41436613074,41436613081,7,2093,817,-40
41436707966,41436707956,-10,902,162,-40
41437306904,41437306910,6,3162,1376,-40
41437804020,41437804026,6,3362,999,-40
41438146215,41438146223,8,3098,1401,-40
41438736538,41438736545,7,3839,1742,-40
41439067197,41439067204,7,2453,833,-40
41442551109,41442551116,7,2379,1360,-40
41443720397,41443720401,4,2661,1180,-40
41444961818,41444961822,4,5170,21088,-40
41447175994,41447176000,6,1957,1104,-40
41449313942,41449313950,8,1308,465,-40
41452064043,41452064050,7,3180,1367,-40
41454903248,41454903255,7,2615,1384,-40
41457056286,41457056291,5,3128,1715,-40
41458440097,41458440101,4,34659,111880,-40
41459325209,41459325214,5,3377,1295,-40
41462465077,41462465085,8,2912,1348,-40
41470851376,41470851382,6,4054,1507,-40
41471477514,41471477521,7,2178,1381,-40
41473510593,41473510601,8,2911,1049,-40
41474047486,41474047494,8,3131,1558,-40
41480312313,41480312319,6,1805,778,-40
41489042268,41489042266,-2,895,1888,-40
41490993870,41490993859,-11,12568,39788,-40
41491459471,41491459464,-7,1591,36773,-40
41491945263,41491945270,7,2449,1524,-40
41497925714,41497925720,6,4099,1652,-40
41499457267,41499457274,7,3906,1491,-40
41503434769,41503434774,5,2697,1615,-40
41506423229,41506423235,6,3578,1149,-40
41507033210,41507033214,4,2973,1410,-40
41509853183,41509853190,7,2694,1730,-40
41509897941,41509897949,8,4359,1378,-40
41513799004,41513799010,6,2232,1264,-40
41514018716,41514018719,3,1900,1687,-40
41517783425,41517783430,5,2805,1477,-40
41521341068,41521341074,6,1414,809,-40
41524800601,41524800605,4,1866,846,-40
41527768817,41527768823,6,2337,964,-40
41528814255,41528814262,7,3465,1332,-40
41529624794,41529624799,5,2209,1138,-40
41531294063,41531294070,7,3308,1526,-40
41535417303,41535417303,0,2135,2763,-40
41537027054,41537027059,5,1412,816,-40
41540710366,41540710372,6,2282,1373,-40
41541368154,41541368152,-2,976,2647,-40
41543665505,41543665511,6,2088,808,-40
41544557802,41544557802,0,881,165,-40
41546668918,41546668926,8,664,275,-40
41548804860,41548804863,3,1430,1154,-40
41549681078,41549681085,7,3602,1109,-40
41549972575,41549972561,-14,1284,705,-40
41552973294,41552973294,0,1136,1806,-40
41557700027,41557700033,6,1900,770,-40
41559830623,41559830634,11,608,154,-40
41561901839,41561901834,-5,943,1129,-40
41562301574,41562301554,-20,1779,511,-40
41566745312,41566745317,5,3848,1373,-40
41567385954,41567385958,4,1217,863,-40
41570201626,41570201631,5,2980,1226,-40
41570983419,41570983425,6,2744,1577,-40
41572188110,41572188114,4,1805,1128,-40
41572564019,41572564016,-3,1134,1509,-40
41573715934,41573715938,4,2519,1145,-40
41574096730,41574096735,5,2442,1046,-40
41576491690,41576491696,6,1197,789,-40
41578054313,41578054318,5,2098,1218,-40
41580139274,41580139268,-6,1756,7548,-40
41580650223,41580650230,7,3268,1201,-40
41582793862,41582793867,5,1931,1168,-40
41586650558,41586650563,5,2733,1672,-40
41586892946,41586892950,4,2320,1608,-40
41597708142,41597708145,3,3825,3659,-40
41601687329,41601687310,-19,896,2295,-40
41603205897,41603205907,10,18150,24897,-40
41607666313,41607666319,6,2309,1073,-40
41608746748,41608746755,7,2449,901,-40
41612339656,41612339662,6,3838,1473,-40
41616145103,41616145111,8,3802,1370,-40
41617977070,41617977076,6,2346,960,-40
41619339557,41619339561,4,2742,1412,-40
41619881611,41619881618,7,3606,1099,-40
41621973351,41621973356,5,1373,1023,-40
41623572782,41623572787,5,2060,1574,-40
41627538570,41627538576,6,3058,1372,-40
41630571770,41630571774,4,3272,1436,-40
41632835070,41632835075,5,2290,1892,-40
41632877410,41632877410,0,699,1346,-40
41633653586,41633653569,-17,911,383,-40
41634369743,41634369749,6,3981,1372,-40
41635598430,41635598437,7,3174,1069,-40
41640177332,41640177339,7,3320,1489,-40
41650127183,41650127189,6,2649,927,-40
41654617317,41654617324,7,4299,1445,-40
41655338038,41655338018,-20,4916,1124,-40
41655640478,41655640458,-20,3094,1576,-40
41656727955,41656727961,6,2372,1229,-40
41659507284,41659507294,10,63,6828,-40
41662049389,41662049395,6,2505,1104,-40
41662282717,41662282700,-17,1975,912,-40
41665598575,41665598581,6,3003,1357,-40
41666335224,41666335212,-12,1389,372,-40
41669865581,41669865587,6,2217,1156,-40
41670106610,41670106617,7,3292,1264,-40
41670145541,41670145523,-18,671,85,-40
41672435646,41672435653,7,3004,1340,-40
41674639129,41674639137,8,4155,1543,-40
41677452819,41677452829,10,2284,1335,-40
41677505746,41677505753,7,3359,1062,-40
41677590772,41677590786,14,1797,339,-40
41678509877,41678509884,7,2577,1181,-40
41681655481,41681655489,8,2896,1298,-40
41685961445,41685961450,5,2285,664,-40
41686934494,41686934500,6,4039,1335,-40
41696637998,41696638006,8,4030,1607,-40
41698780777,41698780785,8,2723,1119,-40
41699344039,41699344030,-9,921,3531,-40
41705743946,41705743950,4,1965,1443,-40
41710750138,41710750134,-4,1192,1893,-40
41716133090,41716133095,5,2531,1103,-40
41718266356,41718266362,6,3427,1198,-40
41720328385,41720328387,2,1120,1015,-40
41721248574,41721248574,0,1513,1867,-40
41723774228,41723774232,4,2052,1537,-40
41724795321,41724795327,6,2682,1116,-40
41727637760,41727637766,6,3017,907,-40
41728906859,41728906859,0,638,511,-40
41732085785,41732085791,6,3651,1282,-40
41736534517,41736534524,7,2343,1061,-40
41741387401,41741387405,4,2291,1206,-40
41741798726,41741798737,11,1387,235,-40
41747482217,41747482222,5,4728,1946,-40
41747973641,41747973647,6,2118,1025,-40
41748374795,41748374803,8,1678,1339,-40
41749103976,41749103983,7,2893,1055,-40
41755125426,41755125430,4,912,1208,-40
41757456542,41757456547,5,2968,1358,-40
41757714569,41757714576,7,14212,5535,-40
41759987667,41759987674,7,3619,1459,-40
41761586882,41761586890,8,2608,1826,-40
41763079962,41763079967,5,2709,1771,-40
41763397814,41763397821,7,2451,1065,-40
41763728262,41763728266,4,1712,954,-40
41773871352,41773871359,7,2337,1125,-40
41777697302,41777697307,5,2885,1589,-40
41781025949,41781025951,2,1770,1383,-40
41782150621,41782150627,6,3438,1176,-40
41783108889,41783108876,-13,2580,1335,-40
41784828380,41784828387,7,3652,1469,-40
41788973215,41788973208,-7,1157,94,-40
41789368321,41789368327,6,2510,1502,-40
41792679475,41792679479,4,1831,823,-40
41794082487,41794082494,7,4024,1519,-40
41801134970,41801134976,6,2810,1344,-40
41803156575,41803156585,10,3454,1171,-40
41804717790,41804717797,7,2851,1648,-40
41804770726,41804770712,-14,3946,18636,-40
41808547748,41808547753,5,2865,1028,-40
41817248410,41817248418,8,2434,1085,-40
41817807808,41817807815,7,3943,900,-40
41820585540,41820585546,6,4000,1460,-40
41822584431,41822584438,7,2987,1164,-40
41822802494,41822802500,6,3033,1224,-40
41824041710,41824041691,-19,1249,486,-40
41827344429,41827344436,7,3834,1921,-40
41827413125,41827413144,19,1038,290,-40
41828299094,41828299100,6,2726,1656,-40
41828470832,41828470819,-13,2140,760,-40
41831908352,41831908358,6,3333,1174,-40
41832730429,41832730430,1,1557,2417,-40
41833141425,41833141426,1,1471,1648,-40
41837086734,41837086731,-3,1147,2993,-40
41838778243,41838778238,-5,1625,3019,-40
41840073838,41840073847,9,11768,26685,-40
41840600494,41840600499,5,3706,1117,-40
41840835406,41840835413,7,3863,1657,-40
41842504267,41842504272,5,3890,1362,-40
41848690262,41848690267,5,2331,1310,-40
41852401096,41852401102,6,3120,1303,-40
41856476947,41856476954,7,9061,1581,-40
41858532254,41858532260,6,3608,2032,-40
41858617817,41858617823,6,2621,1150,-40
41865278443,41865278449,6,3676,1319,-40
41867680355,41867680359,4,1422,1079,-40
41870300477,41870300483,6,2462,1452,-40
41873406882,41873406886,4,3292,945,-40
41876836528,41876836534,6,3797,1409,-40
41877177135,41877177142,7,2019,1118,-40
41878036544,41878036543,-1,1581,2230,-40
41878364814,41878364820,6,2799,1938,-40
41879611132,41879611137,5,2903,1350,-40
41879976793,41879976779,-14,681,583,-40
41882307742,41882307741,-1,2441,1257,-40
41884496762,41884496769,7,3891,1200,-40
41888192595,41888192603,8,3406,1587,-40
41895096752,41895096758,6,1925,879,-40
41895334754,41895334762,8,2197,1248,-40
41896752209,41896752206,-3,1830,3332,-40
41899026357,41899026362,5,2421,1224,-40
41899851373,41899851378,5,2148,1188,-40
41900353778,41900353783,5,2142,1174,-40
41907673681,41907673687,6,2014,1027,-40
41908455425,41908455430,5,3290,1094,-40
41908885890,41908885898,8,2698,1348,-40
41912501605,41912501612,7,3836,889,-40
41914180634,41914180641,7,2286,1182,-40
41914234272,41914234278,6,3102,1120,-40
41914673509,41914673499,-10,1088,475,-40
41920778721,41920778726,5,2594,1130,-40
41923916574,41923916581,7,8011,2533,-40
41925820229,41925820234,5,2780,1519,-40
41927105447,41927105455,8,3159,1423,-40
41929722692,41929722697,5,2482,1334,-40
41931077055,41931077060,5,3380,1853,-40
41931274852,41931274857,5,2435,1098,-40
41931338094,41931338101,7,3359,1553,-40
41938605041,41938605042,1,1878,1436,-40
41939282617,41939282622,5,2331,1288,-40
41941863442,41941863446,4,2753,1167,-40
41949503940,41949503946,6,3576,1749,-40
41965331111,41965331118,7,1891,973,-40
41965726186,41965726179,-7,890,357,-40
41965916110,41965916100,-10,1111,609,-40
41966063192,41966063178,-14,1151,630,-40
41967059538,41967059546,8,3275,1224,-40
41971379408,41971379406,-2,1063,1817,-40
41971511446,41971511465,19,1515,1204,-40
41971872995,41971873003,8,2501,1379,-40
41974591269,41974591275,6,2596,1152,-40
41979172177,41979172182,5,2864,1501,-40
41981242951,41981242950,-1,962,1045,-40
41981429467,41981429451,-16,2795,823,-40
41983392928,41983392934,6,2736,1331,-40
41986637686,41986637693,7,2785,1409,-40
41987001139,41987001122,-17,618,426,-40
41998927452,41998927458,6,2845,1610,-40
41999878861,41999878867,6,2134,935,-40
42002106483,42002106482,-1,1148,1851,-40
42002471427,42002471434,7,2866,1352,-40
42002839105,42002839091,-14,3218,1304,-40
42003707323,42003707329,6,3003,1533,-40
42008739782,42008739790,8,2349,1013,-40
42015336445,42015336428,-17,2626,1152,-40
42019857432,42019857438,6,3603,1195,-40
42022115349,42022115354,5,3043,1188,-40
42024207365,42024207370,5,3009,1222,-40
42024662392,42024662398,6,2167,1417,-40
42042986369,42042986375,6,3645,2167,-40
42051350707,42051350714,7,2289,1318,-40
42051827150,42051827157,7,3108,1862,-40
42053896905,42053896910,5,3167,1220,-40
42061805251,42061805258,7,2673,1405,-40
42063327538,42063327545,7,4180,1607,-40
42065895001,42065895009,8,15793,34467,-40
42067880985,42067880990,5,3942,1521,-40
42070553807,42070553813,6,2923,2187,-40
42070722923,42070722930,7,3808,1256,-40
42070962799,42070962812,13,1738,365,-40
42072735982,42072735990,8,2784,1382,-40
42072849790,42072849795,5,952,437,-40
42072886653,42072886634,-19,2622,1041,-40
42072961013,42072961019,6,2725,1281,-40
42073116625,42073116611,-14,2193,628,-40
42073699274,42073699276,2,694,155,-40
42076522687,42076522694,7,2547,1658,-40
42076595709,42076595722,13,2270,949,-40
42077515675,42077515681,6,2393,1271,-40
42079632857,42079632862,5,3977,1787,-40
42080322830,42080322837,7,2486,1112,-40
42085302178,42085302185,7,3148,1164,-40
42085387112,42085387117,5,2802,1192,-40
42086790777,42086790782,5,3063,1059,-40
42087517886,42087517894,8,3086,968,-40
42089949604,42089949611,7,3163,1236,-40
42090153493,42090153499,6,1652,975,-40
42090402245,42090402253,8,2881,1210,-40
42093455282,42093455287,5,2411,1304,-40
42093567101,42093567106,5,2785,1363,-40
42095609157,42095609164,7,2922,1139,-40
42098743209,42098743214,5,2815,1054,-40
42100363015,42100363021,6,2724,1287,-40
42100790355,42100790363,8,3370,1456,-40
42107155825,42107155830,5,1865,642,-40
42107328143,42107328123,-20,3376,1302,-40
42108858178,42108858186,8,3234,1195,-40
42110474272,42110474265,-7,1595,9418,-40
42115857163,42115857170,7,2101,966,-40
42117285681,42117285687,6,2865,1334,-40
42121710194,42121710199,5,2340,1152,-40
42123473717,42123473724,7,3619,1490,-40
42133167230,42133167229,-1,1520,3410,-40
42133334881,42133334886,5,2822,1653,-40
42136891311,42136891310,-1,1328,1969,-40
42138275325,42138275331,6,2442,1403,-40
42142638439,42142638448,9,1518,907,-40
42145253616,42145253635,19,2708,1203,-40
42145949386,42145949394,8,3438,1304,-40
42152116686,42152116693,7,1858,948,-40
42154470185,42154470190,5,3734,1774,-40
42154720030,42154720037,7,2410,1091,-40
42156048972,42156048978,6,2149,1051,-40
42164410585,42164410590,5,2354,1444,-40
42166661170,42166661177,7,1475,1276,-40
42167225261,42167225267,6,4820,1002,-40
42168545770,42168545777,7,2371,1084,-40
42170610257,42170610265,8,3407,1351,-40
42170820047,42170820054,7,1812,908,-40
42171703942,42171703928,-14,1448,390,-40
42172173169,42172173175,6,2318,1576,-40
42176774335,42176774338,3,1496,1403,-40
42177625695,42177625701,6,3491,1015,-40
42177650882,42177650887,5,2729,1480,-40
42185782388,42185782394,6,2521,1129,-40
42186978867,42186978874,7,2790,802,-40
42192106143,42192106151,8,2266,1142,-40
42192518171,42192518152,-19,2707,991,-40
42195416320,42195416327,7,1665,1046,-40
42198119807,42198119813,6,2346,1203,-40
42198395477,42198395484,7,2701,1684,-40
42198883218,42198883223,5,2674,1461,-40
42199980810,42199980817,7,3113,1059,-40
42217972729,42217972735,6,2125,956,-40
42231169959,42231169966,7,2076,1358,-40
42233592139,42233592133,-6,2185,7658,-40
42233836725,42233836732,7,2615,1259,-40
42236018552,42236018557,5,2273,1147,-40
42241694505,42241694511,6,2714,1128,-40
42244433374,42244433379,5,2897,1508,-40
42252885190,42252885195,5,2302,1500,-40
42254174965,42254174971,6,4332,1169,-40
42254941656,42254941664,8,2750,1185,-40
42255600122,42255600105,-17,2398,925,-40
42258744471,42258744478,7,2543,1418,-40
42259682655,42259682662,7,3540,1702,-40
42260900478,42260900485,7,3095,1612,-40
42262875685,42262875682,-3,49881,15698,-40
42264151963,42264151969,6,2532,1359,-40
42265909154,42265909161,7,2600,1153,-40
42269975365,42269975370,5,2830,1090,-40
42275747479,42275747485,6,1732,39630,-40
42276006234,42276006238,4,1585,1559,-40
42277791757,42277791763,6,2606,1035,-40
42279941696,42279941691,-5,1798,5001,-40
42282118632,42282118652,20,1090,236,-40
42284284040,42284284046,6,1221,591,-40
42285838942,42285838934,-8,2421,10329,-40
42286652240,42286652228,-12,843,271,-40
42295647431,42295647438,7,3781,1761,-40
42296032082,42296032083,1,1618,1564,-40
42297839657,42297839662,5,2904,1095,-40
42302119866,42302119868,2,1835,1608,-40
42307866253,42307866262,9,3319,1374,-40
42308450432,42308450428,-4,1338,2626,-40
42312176442,42312176445,3,1013,1017,-40
42320243013,42320243019,6,4382,1599,-40
42325799410,42325799417,7,2732,1541,-40
42327717705,42327717710,5,2445,959,-40
42329633016,42329633022,6,2157,1069,-40
42332421531,42332421538,7,3571,1198,-40
42334392045,42334392046,1,1979,2913,-40
42334440550,42334440557,7,4062,1582,-40
42335953290,42335953297,7,2784,1260,-40
42339883633,42339883638,5,2913,1024,-40
42340776541,42340776546,5,1835,1417,-40
42340907388,42340907393,5,3197,1477,-40
42346062701,42346062708,7,3835,1619,-40
42346680080,42346680085,5,3068,1352,-40
42349297164,42349297171,7,3018,1379,-40
42359948711,42359948714,3,1291,1291,-40
42361357671,42361357678,7,3867,1920,-40
42363948687,42363948694,7,3524,1335,-40
42368135597,42368135602,5,3382,1560,-40
42370058894,42370058898,4,2279,1550,-40
42372739618,42372739626,8,3809,1709,-40
42377073725,42377073731,6,2583,1168,-40
42384867217,42384867223,6,3360,1658,-40
42386745821,42386745826,5,1997,1135,-40
42391171562,42391171566,4,2925,1445,-40
42392139521,42392139525,4,2185,1053,-40
42392692362,42392692369,7,2738,1432,-40
42392901702,42392901709,7,2129,1230,-40
42394925723,42394925731,8,3265,1612,-40
42398446882,42398446890,8,8999,1036,-40
42402329702,42402329705,3,976,813,-40
42405126662,42405126669,7,3288,1103,-40
42408609334,42408609340,6,3620,1820,-40
42411932862,42411932869,7,3305,1075,-40
42412191096,42412191083,-13,2311,897,-40
42413787938,42413787945,7,2620,1112,-40
42414119357,42414119361,4,1687,1174,-40
42414472534,42414472541,7,3918,1292,-40
42417773082,42417773082,0,1365,1275,-40
42418432554,42418432535,-19,632,516,-40
42420678474,42420678481,7,2391,1134,-40
42426815994,42426815994,0,1423,2219,-40
42430173058,42430173067,9,3351,918,-40
42431460453,42431460457,4,20606,20331,-40
42436640237,42436640242,5,1736,1194,-40
42438068687,42438068683,-4,1831,4531,-40
42438142530,42438142535,5,1779,921,-40
42439137177,42439137181,4,2238,1281,-40
42445028340,42445028347,7,3834,1448,-40
42447345410,42447345418,8,1901,1025,-40
42457547813,42457547818,5,2044,1018,-40
42464527656,42464527650,-6,1985,6529,-40
42466102311,42466102317,6,2758,1370,-40
42467325311,42467325307,-4,1383,2694,-40
42469160778,42469160783,5,2553,927,-40
42469653325,42469653332,7,3056,1528,-40
42469690373,42469690379,6,2285,919,-40
42471918437,42471918442,5,2281,1678,-40
42473186033,42473186038,5,2008,831,-40
42473663146,42473663153,7,3525,1640,-40
42475173114,42475173119,5,1879,921,-40
42477167324,42477167330,6,2725,1032,-40
42483742378,42483742387,9,2795,624,-40
42484352362,42484352344,-18,2530,809,-40
42485729143,42485729150,7,2689,1205,-40
42485977851,42485977857,6,2341,1125,-40
42486830603,42486830609,6,3221,1253,-40
42487747486,42487747490,4,2497,2135,-40
42499220429,42499220433,4,3077,1991,-40
42500076699,42500076703,4,3664,1219,-40
42500803673,42500803678,5,2922,1518,-40
42501879870,42501879868,-2,2539,5105,-40
42502105052,42502105059,7,1702,1034,-40
42503216506,42503216510,4,1725,1097,-40
42505871992,42505872000,8,2780,1240,-40
42513149751,42513149757,6,2967,1833,-40
42518646542,42518646546,4,2042,1190,-40
42518968030,42518968035,5,2731,1292,-40
42520398594,42520398601,7,3044,965,-40
42520658425,42520658434,9,2841,1430,-40
42524767993,42524768000,7,3202,1209,-40
42525059582,42525059587,5,2338,1444,-40
42527062755,42527062759,4,2525,894,-40
42528210493,42528210498,5,2760,1354,-40
42531863132,42531863137,5,2210,1257,-40
42535899714,42535899720,6,3167,1481,-40
42536666658,42536666662,4,2823,1155,-40
42538759358,42538759363,5,1233,784,-40
42543538338,42543538343,5,1704,674,-40
42546015891,42546015897,6,3739,1157,-40
42548018754,42548018759,5,1953,915,-40
42551389506,42551389513,7,3071,1247,-40
42554576545,42554576549,4,1527,1399,-40
42554668750,42554668728,-22,3711,1229,-40
42556484203,42556484209,6,2615,1060,-40
42559565141,42559565147,6,2832,1307,-40
42562828688,42562828695,7,3501,1127,-40
42563386273,42563386280,7,3035,1659,-40
42570948585,42570948591,6,2652,1182,-40
42575450181,42575450186,5,3660,1413,-40
42576227546,42576227554,8,4834,1994,-40
42576636642,42576636650,8,3461,1683,-40
42578376819,42578376826,7,3293,1511,-40
42580888402,42580888409,7,2151,1096,-40
42582656437,42582656443,6,2885,1159,-40
42585520326,42585520338,12,11625,46771,-40
42586378339,42586378346,7,2201,881,-40
42586510657,42586510662,5,2942,1447,-40
42591561665,42591561670,5,1622,655,-40
42596470770,42596470777,7,3611,1657,-40
42598709170,42598709153,-17,3011,1232,-40
42603144482,42603144487,5,2805,914,-40
42603708136,42603708139,3,2524,1664,-40
42606655722,42606655728,6,2668,1091,-40
42626328157,42626328162,5,2684,1485,-40
42626609120,42626609122,2,4406,4564,-40
42632094071,42632094070,-1,2546,4113,-40
42633787941,42633787946,5,3764,1743,-40
42633843011,42633843017,6,2748,1274,-40
42641368839,42641368838,-1,2485,4802,-40
42644547154,42644547143,-11,1531,592,-40
42648454677,42648454683,6,2485,1347,-40
42650003407,42650003413,6,2235,1501,-40
42651599547,42651599554,7,1941,925,-40
42655369994,42655370002,8,3994,1937,-40
42657621750,42657621756,6,3238,1072,-40
42660582081,42660582074,-7,1434,8891,-40
42661669309,42661669314,5,1832,901,-40
42662044169,42662044171,2,1723,1119,-40
42664952654,42664952659,5,1587,1048,-40
42665849371,42665849370,-1,625,107,-40
42667757907,42667757915,8,3483,1706,-40
42669738433,42669738439,6,2819,997,-40
42671820498,42671820505,7,2282,765,-40
42677691238,42677691244,6,3522,1674,-40
42678073209,42678073218,9,2228,1672,-40
42683242567,42683242574,7,3102,1208,-40
42683769551,42683769557,6,3200,1322,-40
42684907549,42684907560,11,2783,1123,-40
42685053427,42685053410,-17,1979,604,-40
42696044211,42696044219,8,3288,1113,-40
42696176000,42696176005,5,2810,1836,-40
42699822641,42699822647,6,1592,1150,-40
42703523418,42703523423,5,1700,1014,-40
42704820823,42704820826,3,1839,1556,-40
42708833117,42708833122,5,2865,1467,-40
42709960519,42709960519,0,1162,1825,-40
42719280166,42719280171,5,2764,1537,-40
42720581297,42720581302,5,4106,1707,-40
42722279764,42722279771,7,4578,2094,-40
42722575157,42722575163,6,3976,1287,-40
42724091240,42724091246,6,2962,1518,-40
42731083653,42731083650,-3,26058,12241,-40
42731740883,42731740889,6,3035,1917,-40
42731852861,42731852866,5,2328,925,-40
42733580917,42733580922,5,3641,1001,-40
42734059565,42734059572,7,3638,1154,-40
42734979869,42734979877,8,2709,1343,-40
42735504877,42735504884,7,2126,880,-40
42736813498,42736813502,4,2518,1509,-40
42739337877,42739337882,5,3067,836,-40
42739435978,42739435987,9,3486,1177,-40
42740271534,42740271542,8,5073,877,-40
42746632627,42746632634,7,2661,1827,-40
42746805401,42746805408,7,1990,1248,-40
42748192140,42748192146,6,3055,1089,-40
42749325131,42749325137,6,4020,1154,-40
42749577782,42749577789,7,2919,1488,-40
42749771445,42749771443,-2,880,258,-40
42760910243,42760910238,-5,1298,4593,-40
42761231486,42761231492,6,1969,1173,-40
42762678954,42762678962,8,3512,1699,-40
42764473716,42764473713,-3,1216,2663,-40
42765569178,42765569184,6,2175,950,-40
42769883839,42769883848,9,2482,995,-40
42770462774,42770462781,7,2811,1031,-40
42770810951,42770810958,7,3074,1467,-40
42774492045,42774492050,5,3442,1246,-40
42777546674,42777546681,7,4115,933,-40
42778224481,42778224466,-15,872,195,-40
42786184733,42786184739,6,2048,1064,-40
42788327268,42788327276,8,2844,1760,-40
42791031474,42791031474,0,1266,1634,-40
42791097960,42791097965,5,2870,1299,-40
42791700359,42791700336,-23,2496,1164,-40
42794274866,42794274871,5,1947,1261,-40
42798365581,42798365589,8,3108,1458,-40
42798756350,42798756355,5,2510,1291,-40
42800423437,42800423442,5,3330,1214,-40
42800680618,42800680625,7,3415,1357,-40
42802751026,42802751032,6,2112,1009,-40
42803066740,42803066745,5,2116,1400,-40
42804869014,42804869021,7,3219,1429,-40
42806339657,42806339662,5,3109,1088,-40
42807594146,42807594150,4,2193,1595,-40
42812517290,42812517298,8,2632,1757,-40
42816601631,42816601637,6,2756,1371,-40
42819220977,42819220982,5,2740,1224,-40
42821561226,42821561235,9,2345,1260,-40
42824109390,42824109395,5,2734,1205,-40
42824548099,42824548105,6,2529,1440,-40
42834197921,42834197927,6,2125,1009,-40
42841383191,42841383198,7,1824,838,-40
42844042722,42844042728,6,2225,1286,-40
42844319447,42844319426,-21,4273,1323,-40
42844498831,42844498837,6,1595,845,-40
42847511806,42847511813,7,2505,903,-40
42847540701,42847540681,-20,1450,490,-40
42849054094,42849054097,3,1444,1314,-40
42852973622,42852973627,5,2341,1303,-40
42855630791,42855630795,4,1450,746,-40
42858372624,42858372627,3,1873,1252,-40
42863189439,42863189446,7,2667,1269,-40
42863794758,42863794765,7,9105,33337,-40
42865751890,42865751896,6,2280,857,-40
42867689818,42867689823,5,2345,992,-40
42868304037,42868304042,5,3616,1110,-40
42868530247,42868530253,6,3243,1400,-40
42870045835,42870045842,7,3330,1557,-40
42873009910,42873009915,5,2344,935,-40
42873082138,42873082143,5,1817,878,-40
42873396222,42873396227,5,2978,1352,-40
42874656557,42874656563,6,3728,1435,-40
42875051926,42875051933,7,2709,796,-40
42876948555,42876948561,6,3120,1225,-40
42880288505,42880288509,4,1327,1030,-40
42884174641,42884174646,5,2454,1116,-40
42884450174,42884450185,11,2267,170,-40
42884695978,42884695984,6,2476,1673,-40
42887709001,42887709007,6,2196,1028,-40
42890886229,42890886235,6,2548,1208,-40
42892095892,42892095905,13,1655,895,-40
42898286011,42898286018,7,3204,1562,-40
42898883993,42898883999,6,16762,12100,-40
42901580469,42901580473,4,1578,1027,-40
42902543709,42902543714,5,2681,842,-40
42907917725,42907917733,8,2720,937,-40
42909774742,42909774749,7,2224,1324,-40
42920849882,42920849889,7,2941,1142,-40
42923866641,42923866646,5,3161,1506,-40
42924531008,42924531014,6,1855,992,-40
42924791827,42924791834,7,3595,1401,-40
42926956206,42926956213,7,2884,1268,-40
42930461489,42930461496,7,2812,1313,-40
42934931523,42934931529,6,2434,1327,-40
42934983586,42934983587,1,2270,2838,-40
42936788277,42936788281,4,1466,1409,-40
42944304414,42944304421,7,3471,1436,-40
42948720833,42948720839,6,3395,1389,-40
42950523688,42950523693,5,2748,1637,-40
42955314386,42955314385,-1,3217,6696,-40
42957882002,42957882008,6,3814,1633,-40
42960369421,42960369425,4,2980,1006,-40
42964364866,42964364874,8,3557,1294,-40
42965388496,42965388502,6,2340,1576,-40
42966111969,42966111991,22,499,1433,-40
42969251180,42969251187,7,2712,1231,-40
42971404364,42971404370,6,3528,1386,-40
42971901344,42971901350,6,2685,1286,-40
42974109608,42974109615,7,2277,928,-40
42975174384,42975174370,-14,744,299,-40
42977475689,42977475694,5,3270,1060,-40
42979835466,42979835474,8,3855,1843,-40
42980246114,42980246115,1,1234,1749,-40
42989365829,42989365836,7,2686,1195,-40
42989718167,42989718174,7,3436,1788,-40
42993689166,42993689167,1,1411,1825,-40
42993734097,42993734102,5,924,821,-40
42994458417,42994458424,7,3218,1127,-40
42995414156,42995414163,7,2873,1268,-40
42997700906,42997700913,7,2183,1238,-40
43001351642,43001351647,5,1829,992,-40
43003100606,43003100611,5,2922,1458,-40
43003225558,43003225562,4,1575,34655,-40
43003708345,43003708353,8,2412,862,-40
43005459722,43005459729,7,2493,1513,-40
43006392965,43006392971,6,4016,1091,-40
43010235181,43010235179,-2,1534,1590,-40
43016913509,43016913514,5,3907,1485,-40
43017092924,43017092912,-12,1105,269,-40
43021010016,43021010022,6,3991,1476,-40
43022989623,43022989629,6,2475,1232,-40
43024133799,43024133803,4,1172,858,-40
43025612104,43025612110,6,2041,1267,-40
43027805480,43027805477,-3,1185,2247,-40
43032793573,43032793582,9,2735,1123,-40
43036868537,43036868542,5,3146,868,-40
43037615679,43037615683,4,2340,893,-40
43045283660,43045283665,5,2300,876,-40
43045543001,43045543006,5,1329,897,-40
43050700696,43050700689,-7,1647,11451,-40
43052606945,43052606945,0,1259,2417,-40
43054561333,43054561338,5,3414,1287,-40
43055600877,43055600881,4,2973,2215,-40
43060741148,43060741152,4,1844,1761,-40
43060923374,43060923384,10,2286,1446,-40
43061884723,43061884706,-17,693,387,-40
43068431875,43068431872,-3,1155,2892,-40
43071328849,43071328855,6,3272,1389,-40
43071825418,43071825426,8,4107,1613,-40
43078721427,43078721430,3,1307,1172,-40
43080244709,43080244717,8,2176,1094,-40
43084171549,43084171556,7,1529,1070,-40
43084809503,43084809497,-6,1003,341,-40
43084981285,43084981266,-19,1484,666,-40
43087764970,43087764969,-1,1175,790,-40
43088856937,43088856942,5,1932,811,-40
43088946498,43088946483,-15,3394,1174,-40
43098260631,43098260638,7,1931,1046,-40
43100408710,43100408716,6,3210,1396,-40
43101179581,43101179589,8,3206,1456,-40
43105848444,43105848447,3,1480,843,-40
43106718597,43106718599,2,1025,974,-40
43107008530,43107008535,5,2475,866,-40
43107135758,43107135762,4,3021,1609,-40
43109226394,43109226399,5,3828,1222,-40
43112214342,43112214356,14,11465,51370,-40
43112291895,43112291901,6,2619,1211,-40
43113835374,43113835379,5,2602,1221,-40
43115646790,43115646797,7,2354,1539,-40
43117750910,43117750895,-15,2472,1103,-40
43124530649,43124530654,5,2708,1477,-40
43124653305,43124653312,7,3513,1255,-40
43132829987,43132829994,7,2598,1333,-40
43132957870,43132957888,18,872,140,-40
43133896556,43133896578,22,1675,623,-40
43135648835,43135648842,7,3731,1439,-40
43135810518,43135810525,7,2943,1419,-40
43136725722,43136725728,6,3311,1636,-40
43137280928,43137280924,-4,2417,5930,-40
43137480951,43137480957,6,4071,1787,-40
43137879745,43137879753,8,1325,709,-40
43138700890,43138700898,8,3066,1052,-40
43141422746,43141422751,5,2292,1286,-40
43141786617,43141786612,-5,42832,7569,-40
43146399920,43146399926,6,2792,1313,-40
43147937009,43147937015,6,3876,1670,-40
43148321585,43148321591,6,2633,1096,-40
43148716268,43148716274,6,2504,1138,-40
43150904002,43150904007,5,2848,1617,-40
43153081376,43153081383,7,1944,1213,-40
43156019829,43156019834,5,5087,1626,-40
43157054753,43157054758,5,2007,700,-40
43157537106,43157537106,0,1045,1095,-40
43161183118,43161183126,8,2161,955,-40
43162148525,43162148532,7,2145,823,-40
43166152562,43166152569,7,3300,1208,-40
43167236681,43167236686,5,3083,1104,-40
43168513904,43168513910,6,2949,1092,-40
43168764649,43168764649,0,1045,1986,-40
43169018556,43169018562,6,2544,1110,-40
43173241966,43173241970,4,1011,511,-40
43174529393,43174529397,4,2367,1076,-40
43178024806,43178024811,5,1957,1082,-40
43182801369,43182801375,6,2585,964,-40
43182865730,43182865712,-18,2292,1146,-40
43182941560,43182941561,1,1598,1382,-40
43184126919,43184126926,7,3621,1193,-40
43184546090,43184546097,7,3179,1531,-40
43184691232,43184691226,-6,1382,207,-40
43185582694,43185582701,7,4859,1600,-40
43187300083,43187300083,0,27395,20106,-40
43188970854,43188970863,9,3049,1354,-40
43189924738,43189924744,6,3293,1181,-40
43192932710,43192932717,7,2604,1053,-40
43198729969,43198729974,5,3393,1191,-40
43199683950,43199683958,8,2974,1705,-40
43202837669,43202837675,6,2961,1369,-40
43205923609,43205923617,8,2579,978,-40
43206673375,43206673382,7,1912,1330,-40
43207712825,43207712831,6,3108,2105,-40
43210180382,43210180378,-4,1645,7333,-40
43214861460,43214861467,7,2715,1316,-40
43221941315,43221941323,8,4115,1235,-40
43224796566,43224796574,8,3247,1553,-40
43225729850,43225729855,5,2248,1457,-40
43227447339,43227447338,-1,2097,4995,-40
43232433522,43232433529,7,2793,1062,-40
43232840655,43232840660,5,2333,1028,-40
43234581845,43234581850,5,3184,1672,-40
43234812717,43234812723,6,3225,1250,-40
43236799769,43236799779,10,1216,98,-40
43237736026,43237736043,17,1194,257,-40
43238814506,43238814527,21,855,1257,-40
43240962891,43240962897,6,3502,1626,-40
43244342405,43244342408,3,2125,1047,-40
43244384150,43244384154,4,3663,1852,-40
43249762175,43249762183,8,2723,942,-40
43251307369,43251307374,5,2536,1317,-40
43251656931,43251656938,7,3493,1407,-40
43252084350,43252084351,1,1239,1231,-40
43257241956,43257241961,5,2566,1446,-40
43257275126,43257275131,5,1966,906,-40
43257389676,43257389672,-4,1849,5153,-40
43259418165,43259418171,6,2859,1011,-40
43260404526,43260404522,-4,642,2513,-40
43262294866,43262294871,5,1270,605,-40
43265595397,43265595402,5,2919,1504,-40
43265897403,43265897407,4,2236,871,-40
43265977602,43265977586,-16,2127,623,-40
43267456425,43267456432,7,3170,1452,-40
43269122898,43269122906,8,2147,947,-40
43269739875,43269739873,-2,1009,2178,-40
43270623879,43270623881,2,1425,1430,-40
43274240754,43274240759,5,2454,985,-40
43274947730,43274947739,9,2340,1487,-40
43277826585,43277826574,-11,549,969,-40
43280381102,43280381108,6,2770,1245,-40
43286487997,43286488003,6,4625,1623,-40
43286544798,43286544805,7,2299,1043,-40
43287068860,43287068864,4,3029,1425,-40
43287851571,43287851576,5,3109,1587,-40
43290264970,43290264976,6,2789,1523,-40
43302633587,43302633594,7,1764,523,-40
43303497360,43303497379,19,633,1999,-40
43304946618,43304946623,5,2442,1001,-40
43309769030,43309769032,2,2485,2461,-40
43312325125,43312325130,5,3899,1922,-40
43318226250,43318226257,7,3609,1440,-40
43321481116,43321481123,7,3287,1716,-40
43324647930,43324647930,0,2474,2319,-40
43324844591,43324844589,-2,5288,8793,-40
43327323359,43327323353,-6,704,2487,-40
43329467806,43329467809,3,2213,1317,-40
43329898134,43329898153,19,636,36,-40
43332122636,43332122642,6,2862,1355,-40
43335883649,43335883655,6,3344,1192,-40
43336092529,43336092538,9,2265,1040,-40
43340565953,43340565952,-1,2218,4646,-40
43341879385,43341879391,6,2216,1195,-40
43347917506,43347917490,-16,3659,1508,-40
43350469713,43350469718,5,894,1091,-40
43352015239,43352015245,6,1351,1103,-40
43353049668,43353049666,-2,1118,1603,-40
43357175348,43357175353,5,2482,932,-40
43360438224,43360438221,-3,2114,4923,-40
43363152753,43363152749,-4,1920,5488,-40
43369872049,43369872054,5,2354,1155,-40
43370426587,43370426569,-18,1391,941,-40
43373274066,43373274070,4,1462,1229,-40
43373507304,43373507310,6,3462,1744,-40
43375643509,43375643515,6,2344,1048,-40
43377029291,43377029299,8,14228,22101,-40
43383987694,43383987702,8,3000,1542,-40
43384586107,43384586090,-17,1721,1280,-40
43391273033,43391273041,8,2922,1127,-40
43392380238,43392380243,5,3103,1417,-40
43394591198,43394591205,7,2163,1178,-40
43402028228,43402028234,6,6043,3083,-40
43408292370,43408292374,4,1727,727,-40
43410131591,43410131572,-19,3311,1084,-40
43411763018,43411763024,6,2311,986,-40
43414602889,43414602894,5,2308,1202,-40
43416706425,43416706432,7,2935,1437,-40
43417725121,43417725123,2,1777,1995,-40
43418263829,43418263835,6,3881,980,-40
43418459567,43418459556,-11,3802,1295,-40
43420675825,43420675829,4,2833,1499,-40
43421525025,43421525030,5,2982,1057,-40
43423810145,43423810153,8,2890,1363,-40
43427044286,43427044296,10,2151,957,-40
43427468629,43427468635,6,2630,1150,-40
43432604106,43432604111,5,3015,1515,-40
43433055195,43433055202,7,2934,1597,-40
43434703119,43434703125,6,2876,1029,-40
43440861910,43440861915,5,2349,1344,-40
43441469616,43441469621,5,1384,1458,-40
43442699849,43442699857,8,2528,760,-40
43445435665,43445435669,4,2199,1276,-40
43451791168,43451791174,6,2963,1619,-40
43451836586,43451836581,-5,1516,5454,-40
43456965895,43456965890,-5,1138,4525,-40
43459502849,43459502853,4,1936,1566,-40
43461936793,43461936799,6,2858,1484,-40
43462403455,43462403465,10,1564,1114,-40
43466464331,43466464338,7,3769,867,-40
43472567694,43472567694,0,1786,2381,-40
43477413942,43477413947,5,2848,1195,-40
43483096586,43483096592,6,4652,1737,-40
43484539161,43484539167,6,3509,1207,-40
43484930047,43484930053,6,3137,1137,-40
43486267035,43486267041,6,2785,1868,-40
43490583962,43490583967,5,2343,1029,-40
43490796515,43490796531,16,3349,1278,-40
43491318479,43491318459,-20,761,174,-40
43493939444,43493939451,7,3554,1279,-40
43497842717,43497842723,6,3637,1378,-40
43503025473,43503025477,4,1394,943,-40
43503609719,43503609705,-14,1788,772,-40
43505765280,43505765284,4,3117,1666,-40
43508616422,43508616428,6,3716,1330,-40
43510368237,43510368242,5,2803,1419,-40
43510905287,43510905284,-3,2201,3938,-40
43513444146,43513444152,6,2859,1425,-40
43514023233,43514023236,3,1925,1798,-40
43516346557,43516346565,8,1432,820,-40
43518957486,43518957485,-1,1206,2694,-40
43520860497,43520860502,5,3086,1574,-40
43522095761,43522095768,7,2758,1194,-40
43522163970,43522163954,-16,1988,1510,-40
43525611590,43525611595,5,2640,1336,-40
43526309569,43526309575,6,2745,966,-40
43529271230,43529271234,4,1476,1075,-40
43532526258,43532526266,8,3414,1064,-40
43532974984,43532974990,6,46815,20171,-40
43536555074,43536555081,7,3314,1709,-40
43538647060,43538647067,7,3261,1310,-40
43544570764,43544570769,5,3133,1507,-40
43544705436,43544705442,6,5085,1103,-40
43548294518,43548294536,18,797,213,-40
43550228329,43550228335,6,3284,1391,-40
43554103767,43554103773,6,1734,1080,-40
43556816086,43556816091,5,3116,1261,-40
43558646151,43558646158,7,3737,1219,-40
43559460194,43559460199,5,2064,1018,-40
43562045944,43562045952,8,3523,1088,-40
43562371897,43562371905,8,3502,1301,-40
43564262123,43564262128,5,3586,1370,-40
43571838807,43571838815,8,2326,863,-40
43573863279,43573863278,-1,1237,1924,-40
43577137053,43577137058,5,1910,1058,-40
43583886386,43583886387,1,1760,1502,-40
43585059290,43585059297,7,1216,835,-40
43586111121,43586111127,6,2134,1331,-40
43586983167,43586983171,4,1882,909,-40
43587465490,43587465497,7,1689,1019,-40
43593873074,43593873079,5,3010,924,-40
43594990049,43594990054,5,2538,1013,-40
43598773341,43598773346,5,1612,957,-40
43599463070,43599463076,6,2231,1119,-40
43602702980,43602702977,-3,803,2261,-40
43602790337,43602790341,4,2013,1255,-40
43602986889,43602986906,17,15069,19569,-40
43603510259,43603510265,6,3182,905,-40
43605310590,43605310598,8,3239,1518,-40
43609574132,43609574138,6,4261,1585,-40
43612782581,43612782583,2,1254,1061,-40
43614266506,43614266513,7,3094,1377,-40
43614397817,43614397822,5,2716,1209,-40
43615214673,43615214678,5,2976,1579,-40
43615761225,43615761231,6,2899,1332,-40
43623029146,43623029141,-5,2134,8134,-40
43626302998,43626303005,7,1988,1050,-40
43627293247,43627293226,-21,1304,239,-40
43628715464,43628715461,-3,1699,3415,-40
43630121937,43630121943,6,2306,886,-40
43631130318,43631130324,6,3606,1753,-40
43633629872,43633629877,5,2125,1151,-40
43635018150,43635018157,7,2834,1028,-40
43636375832,43636375838,6,2563,854,-40
43640142356,43640142365,9,3263,1649,-40
43640626911,43640626898,-13,2889,636,-40
43642669893,43642669886,-7,1706,5754,-40
43646386224,43646386229,5,1501,1137,-40
43655043969,43655043974,5,4315,1437,-40
43655321272,43655321277,5,2546,1607,-40
43656104093,43656104103,10,2011,1462,-40
43662164863,43662164870,7,3561,1376,-40
43662522674,43662522680,6,2147,1305,-40
43664085136,43664085143,7,4031,1621,-40
43667085717,43667085723,6,2919,1371,-40
43672387281,43672387281,0,1439,1227,-40
43673304007,43673304014,7,2162,812,-40
43679054412,43679054418,6,3968,1264,-40
43679927041,43679927048,7,3758,1661,-40
43683977368,43683977374,6,2862,1892,-40
43684111502,43684111508,6,3722,1416,-40
43688311320,43688311300,-20,3157,1406,-40
43694266281,43694266287,6,2239,1144,-40
43694420125,43694420130,5,3627,1073,-40
43695483405,43695483410,5,2875,1355,-40
43695621647,43695621626,-21,3354,1096,-40
43698502841,43698502846,5,2719,933,-40
43699697752,43699697758,6,1764,644,-40
43700484373,43700484379,6,3017,1255,-40
43702695694,43702695694,0,1564,2138,-40
43703511279,43703511285,6,3133,1273,-40
43705835410,43705835414,4,2894,1660,-40
43707568470,43707568475,5,4411,1388,-40
43711755122,43711755128,6,2928,1260,-40
43712163105,43712163113,8,1982,928,-40
43714110625,43714110631,6,2783,1645,-40
43719522450,43719522454,4,1286,1144,-40
43720959736,43720959730,-6,1607,6635,-40
43723867607,43723867615,8,2000,1056,-40
43724911987,43724911994,7,2879,1250,-40
43726093865,43726093870,5,2484,1340,-40
43728213314,43728213322,8,3116,1479,-40
43738144732,43738144738,6,2805,1457,-40
43738335396,43738335403,7,2490,739,-40
43739729376,43739729382,6,3045,1277,-40
43746083169,43746083174,5,2319,871,-40
43747776622,43747776633,11,3120,1638,-40
43751603954,43751603960,6,2687,1337,-40
43754124635,43754124640,5,1444,505,-40
43761034698,43761034680,-18,904,354,-40
43765887257,43765887262,5,2921,1734,-40
43768597848,43768597855,7,2305,1377,-40
43769314335,43769314329,-6,1927,7864,-40
43770392385,43770392391,6,4624,1474,-40
43773395338,43773395343,5,1632,1061,-40
43776068297,43776068302,5,2092,1357,-40
43777914112,43777914107,-5,1546,4782,-40
43780045581,43780045589,8,3040,1500,-40
43782102768,43782102757,-11,145,1277,-40
43782678289,43782678298,9,3078,818,-40
43782783043,43782783058,15,657,229,-40
43787117142,43787117151,9,5267,1131,-40
43791205779,43791205785,6,2337,1116,-40
43792839502,43792839513,11,339,1584,-40
43793476739,43793476732,-7,2111,7469,-40
43797919255,43797919262,7,3849,1270,-40
43799745602,43799745607,5,3216,1099,-40
43801265544,43801265551,7,3296,1311,-40
43802036711,43802036718,7,1910,687,-40
43804556581,43804556588,7,2994,1294,-40
43805040028,43805040029,1,1764,1888,-40
43807530590,43807530594,4,2036,1637,-40
43809919845,43809919851,6,2384,1081,-40
43810773574,43810773553,-21,2563,951,-40
43815779374,43815779381,7,3129,1394,-40
43819509869,43819509876,7,3325,1303,-40
43823751921,43823751926,5,2702,1173,-40
43842718320,43842718327,7,2851,1236,-40
43847335845,43847335851,6,2431,1225,-40
43854655434,43854655434,0,890,2149,-40
43864391110,43864391118,8,2473,1097,-40
43871163811,43871163818,7,2877,1743,-40
43871189178,43871189184,6,2364,1209,-40
43873740970,43873740976,6,2681,880,-40
43873966806,43873966796,-10,2376,698,-40
43879536511,43879536519,8,2772,1490,-40
43881271053,43881271058,5,2971,1179,-40
43882402589,43882402594,5,2249,970,-40
43882905660,43882905662,2,1557,1266,-40
43883910261,43883910261,0,2593,3766,-40
43890053242,43890053247,5,2369,753,-40
43890265781,43890265788,7,3388,1269,-40
43891520877,43891520881,4,4490,3404,-40
43893150856,43893150861,5,2701,1491,-40
43894055737,43894055732,-5,1142,3732,-40
43898096366,43898096371,5,2723,1617,-40
43899490557,43899490562,5,3720,1051,-40
43900067273,43900067256,-17,1391,858,-40
43902133479,43902133479,0,38405,21081,-40
43902609129,43902609134,5,2288,1220,-40
43906949278,43906949285,7,2532,1024,-40
43908323361,43908323369,8,3715,838,-40
43915105463,43915105481,18,187,897,-40
43919182682,43919182690,8,2623,1487,-40
43919714398,43919714393,-5,1150,3885,-40
43922371997,43922372004,7,2792,1367,-40
43922760549,43922760554,5,1751,1342,-40
43923810570,43923810577,7,2389,990,-40
43923957544,43923957530,-14,1780,832,-40
43925923188,43925923193,5,1837,1162,-40
43929961371,43929961378,7,3323,1460,-40
43933646327,43933646322,-5,18913,15632,-40
43935089369,43935089375,6,2812,1099,-40
43939161659,43939161667,8,2762,1258,-40
43946581554,43946581562,8,3106,1214,-40
43947050211,43947050218,7,3350,1152,-40
43947324469,43947324476,7,2712,1775,-40
43948618917,43948618923,6,5065,1620,-40
43949814473,43949814479,6,2146,1593,-40
43956281227,43956281235,8,1892,712,-40
43957741153,43957741158,5,2923,1129,-40
43959120334,43959120340,6,3620,1699,-40
43963473700,43963473706,6,2133,850,-40
43967311336,43967311342,6,2449,1295,-40
43970659738,43970659741,3,2268,1908,-40
43971572114,43971572121,7,13060,27872,-40
43975535154,43975535160,6,2295,1240,-40
43978469413,43978469422,9,2260,952,-40
43979160162,43979160161,-1,1042,1996,-40
43982419553,43982419558,5,1864,968,-40
43982708687,43982708683,-4,755,440,-40
43982841770,43982841775,5,3178,934,-40
43988069178,43988069186,8,4116,1646,-40
43989582412,43989582417,5,2794,922,-40
43991484417,43991484404,-13,804,346,-40
44002323237,44002323238,1,1948,1893,-40
44002635878,44002635884,6,2598,897,-40
44002667693,44002667697,4,4104,2973,-40
44002874612,44002874617,5,1347,722,-40
44005637386,44005637393,7,3211,1101,-40
44006178039,44006178043,4,2269,1452,-40
44008403826,44008403826,0,33837,38049,-40
44009830821,44009830827,6,3135,972,-40
44011244402,44011244409,7,3252,1456,-40
44012740397,44012740402,5,2674,962,-40
44012917257,44012917256,-1,973,277,-40
44013001290,44013001298,8,6010,848,-40
44013617727,44013617727,0,1692,1911,-40
44015533501,44015533508,7,4430,1507,-40
44019515265,44019515270,5,3262,1994,-40
44026193689,44026193694,5,2683,1595,-40
44029120630,44029120636,6,2029,1334,-40
44031540186,44031540192,6,2879,1091,-40
44033082345,44033082351,6,2555,1281,-40
44034922262,44034922256,-6,881,1868,-40
44037926805,44037926811,6,2196,1053,-40
44038400498,44038400490,-8,762,134,-40
44042705324,44042705330,6,4014,1250,-40
44050080018,44050080023,5,3034,1209,-40
44051027687,44051027694,7,2205,1112,-40
44051568481,44051568500,19,3707,1164,-40
44053075099,44053075106,7,1912,724,-40
44057597849,44057597854,5,3057,1284,-40
44060465903,44060465911,8,3831,973,-40
44060624093,44060624099,6,2920,1303,-40
44062014794,44062014779,-15,2046,1008,-40
44064362584,44064362590,6,1475,537,-40
44066469590,44066469597,7,3225,989,-40
44067035703,44067035684,-19,1080,332,-40
44068685037,44068685042,5,3002,1290,-40
44068932219,44068932235,16,10316,51027,-40
44071881895,44071881901,6,2222,1307,-40
44072325396,44072325402,6,12676,4246,-40
44073766073,44073766078,5,2714,1420,-40
44074034381,44074034372,-9,2151,551,-40
44075618350,44075618355,5,2573,1349,-40
44076923797,44076923804,7,4496,1889,-40
44078195388,44078195402,14,503,1456,-40
44081673723,44081673730,7,1910,1126,-40
44082593954,44082593954,0,978,1391,-40
44082929990,44082929977,-13,1108,393,-40
44083792701,44083792707,6,3473,1282,-40
44086204965,44086204970,5,1847,838,-40
44090879678,44090879679,1,1029,1647,-40
44090905563,44090905557,-6,1414,5751,-40
44092199393,44092199398,5,3108,1311,-40
44093577792,44093577796,4,2405,1316,-40
44098409374,44098409380,6,2568,1163,-40
44098891295,44098891272,-23,2130,1153,-40
44105965401,44105965405,4,2784,1439,-40
44107449402,44107449407,5,2436,1435,-40
44107583221,44107583201,-20,1865,901,-40
44109095990,44109095995,5,974,964,-40
44109806587,44109806594,7,2003,842,-40
44111459911,44111459919,8,2336,1120,-40
44112066034,44112066033,-1,1098,317,-40
44114512371,44114512377,6,2697,1107,-40
44114761682,44114761664,-18,1370,543,-40
44123092201,44123092206,5,1690,1474,-40
44124918901,44124918905,4,39507,30176,-40
44126392752,44126392758,6,3665,1694,-40
44127697902,44127697909,7,3332,1334,-40
44131929927,44131929934,7,3104,1237,-40
44132655778,44132655764,-14,2706,980,-40
44133487363,44133487368,5,2187,1054,-40
44134276298,44134276306,8,2813,1338,-40
44134498204,44134498184,-20,2665,1262,-40
44139607834,44139607837,3,2362,1042,-40
44145282275,44145282274,-1,1584,1869,-40
44153878878,44153878885,7,1920,943,-40
44156048255,44156048261,6,2030,1188,-40
44156348758,44156348762,4,2270,1066,-40
44157800573,44157800581,8,2556,1326,-40
44160387525,44160387521,-4,8319,18410,-40
44161012321,44161012337,16,2558,1192,-40
44161661830,44161661834,4,2079,1767,-40
44164597059,44164597066,7,3013,1133,-40
44165130674,44165130681,7,3044,1287,-40
44169326542,44169326547,5,1788,670,-40
44179103171,44179103176,5,2799,1055,-40
44188385718,44188385726,8,2828,948,-40
44188913110,44188913123,13,2995,1115,-40
44188960646,44188960666,20,3730,1312,-40
44189196519,44189196523,4,1947,1151,-40
44193284199,44193284203,4,2120,928,-40
44196853789,44196853797,8,2203,1248,-40
44197530266,44197530271,5,1513,674,-40
44203766945,44203766951,6,1979,40674,-40
44210195274,44210195277,3,2584,1509,-40
44212554219,44212554215,-4,1138,2324,-40
44219757132,44219757139,7,2987,1215,-40
44220852133,44220852140,7,2926,1755,-40
44220948613,44220948593,-20,1054,384,-40
44227063692,44227063685,-7,1806,7775,-40
44230294168,44230294173,5,2923,1294,-40
44234775799,44234775808,9,3433,933,-40
44235848012,44235848019,7,3342,968,-40
44236928177,44236928187,10,784,179,-40
44240290163,44240290171,8,2453,1305,-40
44240701275,44240701268,-7,714,160,-40
44249680954,44249680960,6,3033,1322,-40
44250517425,44250517435,10,927,236,-40
44252218614,44252218619,5,3361,1171,-40
44252984363,44252984370,7,2936,1765,-40
44256877909,44256877915,6,2099,1664,-40
44257601219,44257601225,6,2697,1457,-40
44262701743,44262701747,4,2712,1623,-40
44263796376,44263796381,5,1738,1113,-40
44263986006,44263986012,6,2933,1790,-40
44271277846,44271277851,5,2260,834,-40
44280496105,44280496111,6,2244,1074,-40
44282029166,44282029172,6,3162,1294,-40
44282492314,44282492299,-15,3016,1245,-40
44283526222,44283526230,8,3404,1259,-40
44284551068,44284551074,6,1952,731,-40
44284636374,44284636395,21,1085,621,-40
44289762979,44289762986,7,5117,1849,-40
44290648159,44290648166,7,3482,1332,-40
44315346449,44315346455,6,2237,1105,-40
44317660121,44317660127,6,3709,1481,-40
44324857589,44324857595,6,2667,1249,-40
44325137390,44325137396,6,4310,1664,-40
44327175497,44327175503,6,4093,1351,-40
44330611353,44330611355,2,1556,968,-40
44332955949,44332955954,5,2586,1297,-40
44333655420,44333655425,5,2946,1479,-40
44334499647,44334499626,-21,1053,495,-40
44336898018,44336898026,8,4087,1465,-40
44337656606,44337656592,-14,2178,934,-40
44345742690,44345742697,7,2780,1104,-40
44350803918,44350803916,-2,1182,1656,-40
44351428475,44351428483,8,2400,998,-40
44351673897,44351673882,-15,2953,1239,-40
44352552373,44352552381,8,2386,909,-40
44352639825,44352639808,-17,1438,781,-40
44355846322,44355846328,6,2092,1244,-40
44355936369,44355936353,-16,1727,754,-40
44357608089,44357608094,5,3069,1792,-40
44360368443,44360368451,8,3733,1571,-40
44360744522,44360744528,6,4030,1778,-40
44364579426,44364579431,5,2524,1119,-40
44365083315,44365083322,7,2127,1183,-40
44367329229,44367329235,6,3620,1545,-40
44368849955,44368849964,9,4402,1625,-40
44370234821,44370234827,6,2166,893,-40
44372974623,44372974628,5,2138,1390,-40
44376126802,44376126807,5,2385,885,-40
44377755641,44377755645,4,3695,2623,-40
44385976201,44385976206,5,3948,1606,-40
44387181977,44387181985,8,982,784,-40
44390295742,44390295738,-4,1116,3304,-40
44395438187,44395438194,7,2670,1527,-40
44396790024,44396790029,5,2584,1212,-40
44396871453,44396871459,6,2671,1016,-40
44400646365,44400646372,7,1928,973,-40
44404993866,44404993874,8,2226,1283,-40
44410453348,44410453355,7,3375,1267,-40
44415242635,44415242641,6,2561,1409,-40
44418283929,44418283934,5,2691,1612,-40
44423978706,44423978713,7,3368,1529,-40
44427981465,44427981471,6,3770,1636,-40
44428335578,44428335583,5,2574,1044,-40
44431341474,44431341481,7,2896,1029,-40
44431646574,44431646579,5,2052,1632,-40
44434672270,44434672279,9,2559,1213,-40
44435034891,44435034898,7,2652,1267,-40
44436624173,44436624179,6,3476,1535,-40
44436940625,44436940630,5,1370,1147,-40
44441826934,44441826939,5,2375,970,-40
44443178982,44443178986,4,2123,1748,-40
44443699095,44443699098,3,2596,1676,-40
44444224129,44444224133,4,2159,1580,-40
44447406824,44447406805,-19,2927,1286,-40
44447994446,44447994454,8,3477,1458,-40
44453241534,44453241538,4,2120,1475,-40
44455023419,44455023425,6,1924,1012,-40
44456067021,44456067026,5,2801,1028,-40
44456937575,44456937581,6,2555,1359,-40
44457786696,44457786702,6,2618,984,-40
44458887061,44458887067,6,2559,1539,-40
44462228996,44462229001,5,2285,1083,-40
44465645037,44465645043,6,2836,1532,-40
44467929568,44467929576,8,3282,1783,-40
44470695050,44470695057,7,3235,1015,-40
44478705897,44478705917,20,205,13653,-40
44488233728,44488233733,5,2918,1360,-40
44491565634,44491565653,19,2854,1694,-40
44491916887,44491916895,8,1895,947,-40
44495246270,44495246277,7,2592,1276,-40
44496365708,44496365706,-2,930,1530,-40
44502719717,44502719725,8,17232,22258,-40
44506594254,44506594261,7,5023,2032,-40
44507701093,44507701096,3,1504,1337,-40
44515894530,44515894534,4,3333,1710,-40
44517963837,44517963843,6,2319,1022,-40
44518085706,44518085690,-16,3443,1211,-40
44519614180,44519614186,6,2726,1386,-40
44520333575,44520333580,5,1719,907,-40
44520743625,44520743618,-7,1204,4955,-40
44527636840,44527636843,3,1294,1571,-40
44528965793,44528965794,1,1394,1183,-40
44530553818,44530553824,6,4782,1335,-40
44531090630,44531090635,5,3398,1297,-40
44534216075,44534216079,4,2016,1318,-40
44538978766,44538978773,7,6220,2510,-40
44539444629,44539444634,5,3123,1313,-40
44541477280,44541477286,6,2297,1146,-40
44546137900,44546137906,6,2499,1827,-40
44550176042,44550176049,7,3219,1119,-40
44550899391,44550899397,6,2282,1053,-40
44551477970,44551477975,5,3423,1057,-40
44557222164,44557222171,7,2722,1354,-40
44558511532,44558511538,6,3575,1074,-40
44558604798,44558604777,-21,2012,1002,-40
44560967721,44560967730,9,2186,816,-40
44562033057,44562033065,8,2283,1250,-40
44563123186,44563123169,-17,2836,1049,-40
44563575477,44563575464,-13,930,477,-40
44563809362,44563809365,3,3672,3101,-40
44568617674,44568617681,7,2849,1430,-40
44572804290,44572804299,9,3297,1353,-40
44572981576,44572981578,2,13284,13625,-40
44575889882,44575889889,7,3547,1494,-40
44577718007,44577718013,6,2653,1438,-40
44580607366,44580607373,7,2909,1375,-40
44582979719,44582979725,6,1749,981,-40
44587100843,44587100838,-5,1095,2007,-40
44589217593,44589217599,6,3526,1298,-40
44597543970,44597543976,6,2429,1566,-40
44599191793,44599191798,5,2046,864,-40
44599223798,44599223785,-13,1919,741,-40
44599787756,44599787771,15,2640,965,-40
44602723294,44602723302,8,1132,618,-40
44603303197,44603303203,6,2519,1293,-40
44604459606,44604459613,7,2948,1207,-40
44604770662,44604770671,9,4348,1308,-40
44606189069,44606189074,5,2987,1590,-40
44611264714,44611264716,2,1759,1697,-40
44611656674,44611656658,-16,1955,553,-40
44614010436,44614010443,7,1369,1526,-40
44618621242,44618621247,5,2257,1362,-40
44623273848,44623273854,6,2934,1125,-40
44629114962,44629114967,5,3132,1179,-40
44630667698,44630667702,4,1484,917,-40
44631333100,44631333118,18,1167,1101,-40
44636389675,44636389677,2,974,1362,-40
44636861564,44636861566,2,1750,755,-40
44637863000,44637863007,7,2305,1469,-40
44638738404,44638738409,5,1843,845,-40
44638841485,44638841490,5,2685,1169,-40
44640405101,44640405107,6,2094,956,-40
44642802178,44642802186,8,3574,1415,-40
44643386389,44643386372,-17,3349,1090,-40
44647474350,44647474355,5,2803,1104,-40
44650710881,44650710886,5,2775,1768,-40
44651969805,44651969802,-3,58976,91728,-40
44661880732,44661880739,7,2439,1148,-40
44663633553,44663633558,5,2144,942,-40
44664268118,44664268126,8,2930,1348,-40
44665523610,44665523617,7,884,383,-40
44667389742,44667389738,-4,2655,4198,-40
44667444289,44667444295,6,3926,1598,-40
44668288496,44668288502,6,2019,1094,-40
44670961674,44670961682,8,2881,908,-40
44677209688,44677209694,6,3923,1086,-40
44678630697,44678630684,-13,31524,14471,-40
44680483445,44680483451,6,2964,1195,-40
44686849762,44686849770,8,2768,1151,-40
44688052387,44688052394,7,3224,1107,-40
44688894925,44688894931,6,3050,1550,-40
44690153564,44690153570,6,1493,1038,-40
44691446663,44691446669,6,2069,958,-40
44696979445,44696979452,7,4492,1508,-40
44698737118,44698737125,7,2365,1232,-40
44699512305,44699512311,6,2734,1006,-40
44699996394,44699996409,15,2998,1405,-40
44701899202,44701899209,7,2769,979,-40
44706282513,44706282519,6,2392,937,-40
44712873601,44712873605,4,1631,1574,-40
44717314886,44717314892,6,3086,1482,-40
44717401594,44717401600,6,1032,260,-40
44720746411,44720746417,6,2576,1288,-40
44722951482,44722951489,7,2862,863,-40
44723474925,44723474904,-21,1323,592,-40
44729733468,44729733470,2,1197,1016,-40
44733277247,44733277255,8,2662,1314,-40
44733683075,44733683082,7,2678,1220,-40
44733867975,44733867955,-20,3028,1105,-40
44734337455,44734337432,-23,1636,656,-40
44735767868,44735767875,7,1926,652,-40
44739855666,44739855673,7,2879,1314,-40
44741592268,44741592275,7,1804,949,-40
44743622117,44743622111,-6,1446,3276,-40
44746569482,44746569492,10,2961,1894,-40
44755027642,44755027649,7,2582,870,-40
44755615282,44755615290,8,3330,1599,-40
44758336646,44758336652,6,2802,1419,-40
44758376582,44758376562,-20,2504,1262,-40
44761132677,44761132683,6,2640,1476,-40
44763535433,44763535440,7,2487,1077,-40
44767234347,44767234353,6,2088,946,-40
44769780858,44769780863,5,4039,1433,-40
44771000290,44771000288,-2,1642,2929,-40
44773198485,44773198493,8,2943,1451,-40
44773586109,44773586114,5,1002,299,-40
44774442786,44774442772,-14,928,631,-40
44775899291,44775899299,8,3655,1381,-40
44776690422,44776690427,5,2910,1190,-40
44778401182,44778401187,5,2518,1169,-40
44778643090,44778643098,8,1721,931,-40
44780445586,44780445591,5,3120,1417,-40
44781561963,44781561948,-15,551,315,-40
44786269262,44786269268,6,2545,1110,-40
44791970518,44791970513,-5,1443,4409,-40
44795604289,44795604298,9,3050,1178,-40
44804942854,44804942849,-5,593,914,-40
44809430181,44809430183,2,2071,1477,-40
44812390663,44812390669,6,3079,1417,-40
44816854654,44816854647,-7,1450,7700,-40
44817797885,44817797891,6,4132,1394,-40
44818245163,44818245170,7,2727,1234,-40
44819549893,44819549899,6,2465,882,-40
44825551249,44825551254,5,2743,1241,-40
44825627527,44825627545,18,3110,1018,-40
44826011001,44826010995,-6,891,407,-40
44828981818,44828981823,5,2238,956,-40
44829874376,44829874377,1,1546,1803,-40
44833274768,44833274770,2,199,1322,-40
44838691163,44838691166,3,1909,1786,-40
44843658282,44843658287,5,1936,713,-40
44844972112,44844972118,6,2339,1349,-40
44849023465,44849023469,4,2189,1535,-40
44853309298,44853309306,8,3724,1625,-40
44859179460,44859179467,7,3006,1326,-40
44859381571,44859381571,0,907,191,-40
44860851102,44860851106,4,1870,1043,-40
44862698545,44862698545,0,1136,474,-40
44865384506,44865384515,9,3426,1294,-40
44866970016,44866970022,6,1643,687,-40
44867338455,44867338441,-14,893,198,-40
44867598004,44867598011,7,2206,992,-40
44868425035,44868425039,4,1993,1398,-40
44869079124,44869079131,7,2110,1206,-40
44869229045,44869229049,4,3043,1964,-40
44871972724,44871972726,2,3165,2664,-40
44883278578,44883278583,5,2372,1017,-40
44883402974,44883402972,-2,899,264,-40
44886343766,44886343761,-5,29183,10637,-40
44887064468,44887064474,6,2091,1083,-40
44887195104,44887195110,6,2921,1314,-40
44888154702,44888154681,-21,2219,1119,-40
44892400270,44892400276,6,3129,1655,-40
44892714228,44892714235,7,2263,705,-40
44893275802,44893275808,6,2367,1050,-40
44895521716,44895521738,22,250,1859,-40
44896255653,44896255658,5,2347,1308,-40
44902348224,44902348231,7,3262,1316,-40
44907033224,44907033230,6,1697,1416,-40
44910388428,44910388434,6,2662,1412,-40
44910902458,44910902441,-17,1795,1050,-40
44911778074,44911778082,8,2792,1399,-40
44915852396,44915852398,2,1252,1756,-40
44921900849,44921900856,7,2199,723,-40
44924543740,44924543761,21,764,1633,-40
44927063212,44927063219,7,3042,1193,-40
44931401401,44931401405,4,2187,1341,-40
44932080750,44932080771,21,2896,1462,-40
44938807222,44938807228,6,3858,1882,-40
44942351678,44942351685,7,3454,1512,-40
44944064064,44944064081,17,593,1682,-40
44945194695,44945194702,7,2637,1014,-40
44945366054,44945366061,7,6637,3319,-40
44946617102,44946617098,-4,1379,1867,-40
44955610127,44955610134,7,3356,2035,-40
44959638797,44959638803,6,3042,1093,-40
44962088083,44962088088,5,2015,1514,-40
44962362155,44962362154,-1,1164,1066,-40
44963404758,44963404764,6,2512,1225,-40
44966335674,44966335679,5,2955,1440,-40
44970670961,44970670967,6,2545,1000,-40
44971035709,44971035691,-18,2378,1202,-40
44971934003,44971934007,4,2492,1109,-40
44972484595,44972484601,6,4009,1413,-40
44986818430,44986818435,5,2543,1396,-40
44987522800,44987522806,6,3719,1451,-40
44992177533,44992177530,-3,781,1461,-40
44997154247,44997154253,6,3992,1500,-40
44998823728,44998823724,-4,18974,18445,-40
44999912772,44999912749,-23,80,5235,-40
45001260415,45001260421,6,2264,1290,-40
45008688901,45008688906,5,2895,1094,-40
45013894017,45013894023,6,2693,1214,-40
45015613866,45015613874,8,1325,1251,-40
45022786270,45022786278,8,3142,1047,-40
45025690977,45025690982,5,2641,984,-40
45026271448,45026271446,-2,1720,2285,-40
45026626368,45026626373,5,3918,1674,-40
45027273731,45027273737,6,2951,1430,-40
45027614766,45027614773,7,1785,594,-40
45027663050,45027663033,-17,663,314,-40
45028198413,45028198402,-11,1052,274,-40
45032229089,45032229094,5,2008,1353,-40
45033043438,45033043444,6,3009,1601,-40
45035154125,45035154130,5,2675,1133,-40
45039440861,45039440866,5,3557,1940,-40
45041914588,45041914594,6,2193,971,-40
45046464282,45046464287,5,4159,1372,-40
45046880434,45046880418,-16,3410,1011,-40
45047149829,45047149835,6,3261,1556,-40
45048613035,45048613029,-6,23800,17300,-40
45053821680,45053821687,7,4474,1893,-40
45055379158,45055379166,8,2550,909,-40
45065707783,45065707791,8,2861,1189,-40
45067171154,45067171139,-15,1654,620,-40
45067728842,45067728849,7,2559,1006,-40
45069392850,45069392855,5,1937,902,-40
45069512149,45069512155,6,2666,1108,-40
45073066623,45073066631,8,1797,1037,-40
45073483579,45073483586,7,2218,1302,-40
45075764781,45075764789,8,3350,1124,-40
45078017044,45078017051,7,2770,1482,-40
45079311977,45079311982,5,2494,1417,-40
45080393010,45080393011,1,1104,1277,-40
45086197173,45086197180,7,3839,1604,-40
45091058622,45091058627,5,2765,1430,-40
45092895125,45092895133,8,2987,1127,-40
45093409028,45093409033,5,2703,1596,-40
45094143060,45094143066,6,1563,961,-40
45095441142,45095441149,7,3206,1360,-40
45096838636,45096838643,7,2688,1416,-40
45098071970,45098071977,7,4117,1195,-40
45098876624,45098876630,6,4122,1483,-40
45100775577,45100775582,5,2815,1146,-40
45100869809,45100869825,16,1293,245,-40
45104282208,45104282214,6,3513,1098,-40
45107651155,45107651162,7,3493,1325,-40
45108411704,45108411711,7,3501,1594,-40
45113290912,45113290916,4,2297,1487,-40
45115185177,45115185182,5,2084,1254,-40
45118137582,45118137590,8,1229,772,-40
45120009541,45120009546,5,2377,1109,-40
45123372689,45123372694,5,2489,975,-40
45128726472,45128726478,6,3241,1196,-40
45128762798,45128762805,7,4691,2575,-40
45133388052,45133388057,5,2358,1113,-40
45133491445,45133491427,-18,1131,367,-40
45134015212,45134015213,1,1137,2319,-40
45138735330,45138735334,4,2479,1015,-40
45139293323,45139293323,0,810,1976,-40
45144563080,45144563085,5,2169,1331,-40
45144607738,45144607747,9,3007,1513,-40
45145766786,45145766794,8,2184,1440,-40
45146930474,45146930474,0,11882,15497,-40
45148903265,45148903271,6,3608,1418,-40
45152428426,45152428433,7,3013,1305,-40
45152720117,45152720122,5,2008,985,-40
45153378232,45153378238,6,3660,1228,-40
45155635764,45155635770,6,4012,1833,-40
45155713069,45155713074,5,2406,1161,-40
45157263493,45157263499,6,4384,1919,-40
45158085082,45158085088,6,2977,1424,-40
45160233858,45160233864,6,3422,1654,-40
45161232630,45161232633,3,1643,1678,-40
45163883867,45163883874,7,3407,1379,-40
45168367505,45168367512,7,3741,1477,-40
45168744640,45168744627,-13,2041,1075,-40
45172423291,45172423299,8,3191,2014,-40
45172741729,45172741735,6,3642,1173,-40
45174600468,45174600451,-17,2106,710,-40
45176132645,45176132652,7,4007,2265,-40
45178891087,45178891090,3,2964,1335,-40
45181178670,45181178677,7,2283,1194,-40
45182055576,45182055562,-14,1490,305,-40
45187035730,45187035738,8,1367,532,-40
45191627653,45191627659,6,3155,1435,-40
45192803362,45192803370,8,2856,1389,-40
45204789004,45204789011,7,3140,1461,-40
45206112982,45206112986,4,3074,1232,-40
45206326138,45206326152,14,824,173,-40
45206975285,45206975290,5,4151,1732,-40
45207456106,45207456110,4,3206,1599,-40
45209254474,45209254456,-18,3461,1479,-40
45209290611,45209290596,-15,1060,430,-40
45211626329,45211626335,6,2343,1133,-40
45211741086,45211741094,8,3076,1737,-40
45211999501,45211999508,7,3027,1811,-40
45216831511,45216831507,-4,976,3263,-40
45219212981,45219212986,5,2295,1606,-40
45219692101,45219692082,-19,2035,1096,-40
45220560906,45220560910,4,1965,1303,-40
45222164206,45222164211,5,1773,863,-40
45227452521,45227452527,6,3099,1160,-40
45227839773,45227839778,5,4080,1449,-40
45227979144,45227979151,7,3832,1019,-40
45228804470,45228804476,6,2903,1432,-40
45231097848,45231097858,10,2600,1550,-40
45234816214,45234816218,4,3012,1900,-40
45235895160,45235895166,6,2796,1096,-40
45236231230,45236231232,2,1042,122,-40
45236372967,45236372952,-15,822,394,-40
45237212969,45237212974,5,2529,1331,-40
45237334132,45237334139,7,1971,905,-40
45237495487,45237495494,7,3783,1723,-40
45249016459,45249016466,7,2794,1015,-40
45257013142,45257013139,-3,1651,3786,-40
45263831659,45263831666,7,3105,1340,-40
45265194744,45265194750,6,3028,1184,-40
45269320884,45269320891,7,2342,1314,-40
45273306498,45273306505,7,1681,932,-40
45274506909,45274506910,1,1103,1406,-40
45275025158,45275025165,7,2762,970,-40
45283320291,45283320286,-5,1773,7887,-40
45284218721,45284218723,2,2116,1704,-40
45286866265,45286866269,4,3022,1446,-40
45293528587,45293528591,4,1510,1013,-40
45295709584,45295709590,6,3709,976,-40
45295871041,45295871049,8,3143,1248,-40
45297404270,45297404275,5,3215,1571,-40
45297977257,45297977258,1,3079,3845,-40
45298380913,45298380918,5,1916,1068,-40
45303138378,45303138381,3,1666,1004,-40
45303713655,45303713659,4,2581,809,-40
45305433540,45305433547,7,2542,1344,-40
45306539420,45306539426,6,2969,1424,-40
45311659932,45311659938,6,2544,1466,-40
45316171835,45316171842,7,2743,1118,-40
45318935864,45318935848,-16,43134,15567,-40
45319932082,45319932088,6,2494,998,-40
45324685461,45324685468,7,2549,1153,-40
45326986734,45326986740,6,3192,1214,-40
45332451019,45332451025,6,2514,1033,-40
45334725305,45334725310,5,2846,1225,-40
45336002394,45336002388,-6,1423,4320,-40
45339094164,45339094171,7,2828,1136,-40
45342051374,45342051382,8,3380,1622,-40
45343975365,45343975369,4,3619,1403,-40
45345513918,45345513925,7,2515,1555,-40
45346886406,45346886401,-5,1250,4000,-40
45350897295,45350897303,8,3510,1478,-40
45354549841,45354549850,9,3943,1568,-40
45356671206,45356671207,1,2085,3910,-40
45359181448,45359181454,6,2632,701,-40
45360443186,45360443189,3,1652,1243,-40
45361390769,45361390778,9,2844,1347,-40
45366376858,45366376864,6,3438,1570,-40
45366472710,45366472700,-10,1011,280,-40
45366595019,45366595032,13,4585,1385,-40
45368551549,45368551554,5,2398,1089,-40
45368581209,45368581195,-14,2186,1357,-40
45376185902,45376185910,8,3421,835,-40
45384116320,45384116327,7,1222,945,-40
45388023095,45388023102,7,3269,1459,-40
45388300158,45388300162,4,2928,1267,-40
45390551818,45390551824,6,4215,1522,-40
45391515763,45391515771,8,2664,1092,-40
45392993025,45392993031,6,2052,902,-40
45393092902,45393092891,-11,957,273,-40
45397029878,45397029883,5,3159,1273,-40
45399594142,45399594150,8,2875,1356,-40
45401739918,45401739923,5,3000,1493,-40
45403361166,45403361172,6,3551,1371,-40
45404004595,45404004601,6,2165,885,-40
45406480637,45406480631,-6,1436,6446,-40
45406937751,45406937747,-4,1455,3216,-40
45418314833,45418314840,7,3509,1487,-40
45421865474,45421865486,12,2249,1342,-40
45423038013,45423038016,3,1858,1068,-40
45425082898,45425082903,5,1617,746,-40
45425427769,45425427755,-14,2778,1136,-40
45427699720,45427699727,7,4837,1553,-40
45435256415,45435256422,7,4235,1877,-40
45438221840,45438221846,6,2642,1071,-40
45438287176,45438287195,19,2160,1321,-40
45438514641,45438514649,8,2438,1168,-40
45440028793,45440028798,5,3680,1921,-40
45443136342,45443136348,6,2099,1107,-40
45444149652,45444149658,6,2917,1035,-40
45444740106,45444740110,4,1868,1550,-40
45448798401,45448798406,5,2670,1260,-40
45455218097,45455218102,5,2703,963,-40
45457590599,45457590606,7,3561,1959,-40
45458433617,45458433625,8,2569,1350,-40
45459383610,45459383614,4,2199,1306,-40
45459958089,45459958095,6,2878,1200,-40
45460306558,45460306562,4,2323,1100,-40
45461046769,45461046773,4,2797,1208,-40
45461319570,45461319577,7,4396,1820,-40
45462035454,45462035461,7,2546,1007,-40
45462173802,45462173818,16,2333,994,-40
45463692073,45463692083,10,10153,36957,-40
45463758305,45463758298,-7,1854,8454,-40
45465474129,45465474133,4,1963,1168,-40
45469891454,45469891459,5,1737,930,-40
45469960737,45469960746,9,897,223,-40
45471133247,45471133255,8,2696,1276,-40
45471789733,45471789739,6,2043,890,-40
45472811890,45472811873,-17,1854,571,-40
45474717503,45474717509,6,2761,1464,-40
45475924774,45475924781,7,2042,1134,-40
45485859208,45485859214,6,2995,1461,-40
45486323946,45486323940,-6,2013,5921,-40
45492029356,45492029341,-15,1123,323,-40
45499168600,45499168589,-11,1805,1407,-40
45501890670,45501890677,7,2218,980,-40
45502242157,45502242166,9,3026,1295,-40
45503824207,45503824215,8,2021,1230,-40
45504379577,45504379583,6,2398,800,-40
45504451743,45504451749,6,2611,1517,-40
45505751502,45505751507,5,2765,1213,-40
45510107048,45510107053,5,3198,1956,-40
45511077877,45511077883,6,2784,1146,-40
45516911315,45516911322,7,2104,763,-40
45517275646,45517275653,7,2779,1207,-40
45518317483,45518317467,-16,1481,598,-40
45518519438,45518519447,9,2685,1520,-40
45520090978,45520090978,0,739,999,-40
45520554659,45520554665,6,3007,1307,-40
45521548126,45521548133,7,3197,1362,-40
45521581914,45521581900,-14,847,251,-40
45530175430,45530175437,7,3418,1030,-40
45532902116,45532902122,6,3233,1566,-40
45536982971,45536982978,7,2937,1246,-40
45539336081,45539336077,-4,28036,6172,-40
45542824293,45542824299,6,3619,1141,-40
45543398855,45543398833,-22,2864,1273,-40
45551257246,45551257253,7,3031,1305,-40
45551368079,45551368059,-20,2263,795,-40
45558245368,45558245374,6,3065,1204,-40
45561083794,45561083801,7,3324,1120,-40
45565078649,45565078654,5,2799,1097,-40
45566047321,45566047327,6,2605,1098,-40
45575673232,45575673237,5,1144,892,-40
45578923255,45578923262,7,2723,1628,-40
45583473225,45583473231,6,2519,1161,-40
45587000186,45587000191,5,2974,1575,-40
45588988430,45588988435,5,1304,835,-40
45589459021,45589459000,-21,7908,2608,-40
45589971090,45589971095,5,2620,1217,-40
45591772357,45591772363,6,3222,1515,-40
45592947826,45592947830,4,2562,1033,-40
45596979496,45596979502,6,1314,718,-40
45598838699,45598838706,7,2329,1136,-40
45600248978,45600248986,8,4262,1413,-40
45600753793,45600753798,5,2003,1555,-40
45603208310,45603208317,7,3287,1640,-40
45604041414,45604041421,7,1449,888,-40
45610562673,45610562681,8,1798,877,-40
45612568135,45612568141,6,2359,1675,-40
45615938925,45615938932,7,2893,1380,-40
45620233388,45620233394,6,3049,1624,-40
45622335262,45622335269,7,3026,1161,-40
45623487022,45623487025,3,46838,9691,-40
45630906926,45630906931,5,2934,1665,-40
45631309145,45631309151,6,3753,1269,-40
45631868997,45631868996,-1,1059,2349,-40
45632706778,45632706782,4,3835,1558,-40
45635957764,45635957770,6,3029,1717,-40
45636655438,45636655442,4,2311,1684,-40
45645920273,45645920278,5,3701,1518,-40
45651631937,45651631942,5,2686,1400,-40
45653479680,45653479686,6,2353,1499,-40
45653654638,45653654620,-18,1503,535,-40
45656648826,45656648831,5,2933,1328,-40
45659603314,45659603319,5,1656,987,-40
45662227291,45662227299,8,1458,1063,-40
45663747348,45663747354,6,3262,1129,-40
45665727285,45665727290,5,3033,1502,-40
45667253924,45667253907,-17,2040,1091,-40
45668617170,45668617160,-10,1051,2703,-40
45669330606,45669330605,-1,8898,47372,-40
45669417997,45669418003,6,2746,1104,-40
45673762693,45673762699,6,3756,1113,-40
45674049637,45674049643,6,3047,1140,-40
45676526618,45676526624,6,3653,1318,-40
45681394384,45681394391,7,2562,1082,-40
45685770370,45685770378,8,4047,1486,-40
45692259377,45692259379,2,1888,983,-40
45695156257,45695156263,6,3383,1137,-40
45695278482,45695278487,5,2426,1445,-40
45701713587,45701713587,0,1757,1895,-40
45706445154,45706445163,9,4153,1333,-40
45706522241,45706522226,-15,1278,442,-40
45707979294,45707979299,5,2271,1174,-40
45708235897,45708235883,-14,2847,867,-40
45708374892,45708374900,8,2638,1007,-40
45714362505,45714362510,5,2663,980,-40
45719347509,45719347515,6,2494,1327,-40
45722897355,45722897359,4,1792,1140,-40
45728136378,45728136385,7,2986,1554,-40
45729332470,45729332474,4,2199,1472,-40
45731470364,45731470370,6,2332,828,-40
45741181698,45741181702,4,2890,2045,-40
45742911486,45742911494,8,3757,1174,-40
45745584678,45745584682,4,2463,1347,-40
45747690641,45747690662,21,587,1262,-40
45748534773,45748534778,5,2787,1154,-40
45751470889,45751470895,6,2712,1364,-40
45752276335,45752276342,7,3744,1243,-40
45752895857,45752895862,5,2684,1583,-40
45758629186,45758629192,6,4025,1388,-40
45759067806,45759067806,0,861,1761,-40
45762795653,45762795661,8,2716,1723,-40
45765276914,45765276921,7,2987,1458,-40
45766208113,45766208118,5,2777,755,-40
45766253087,45766253067,-20,877,199,-40
45766745382,45766745369,-13,1489,874,-40
45766982853,45766982859,6,2725,753,-40
45768834322,45768834329,7,2673,1061,-40
45770025329,45770025331,2,1560,709,-40
45771622696,45771622697,1,1184,1287,-40
45772619154,45772619162,8,1964,1188,-40
45776188814,45776188823,9,2475,1071,-40
45781127429,45781127432,3,1628,1579,-40
45785312499,45785312507,8,4791,1339,-40
45790935483,45790935489,6,2827,1370,-40
45791646714,45791646728,14,1307,360,-40
45791789790,45791789796,6,15153,22059,-40
45799459474,45799459481,7,2496,1002,-40
45799826727,45799826734,7,6333,1499,-40
45801385583,45801385589,6,2948,1089,-40
45801760394,45801760402,8,3778,1348,-40
45803331466,45803331471,5,2271,1002,-40
45806947245,45806947252,7,3136,1456,-40
45807041451,45807041457,6,2969,1561,-40
45807645586,45807645591,5,3182,1177,-40
45809251472,45809251478,6,3470,1489,-40
45818659163,45818659160,-3,25904,26393,-40
45823277705,45823277710,5,2487,1104,-40
45826571211,45826571218,7,3715,1793,-40
45829707462,45829707469,7,2012,1768,-40
45830463651,45830463652,1,1488,1691,-40
45832530666,45832530673,7,3277,1231,-40
45833038161,45833038166,5,3439,1212,-40
45834333395,45834333393,-2,1801,1645,-40
45838286655,45838286660,5,3011,1467,-40
45838333069,45838333049,-20,2767,1525,-40
45842548846,45842548853,7,4034,1892,-40
45843128083,45843128088,5,3869,1490,-40
45847783659,45847783667,8,3220,1521,-40
45848824684,45848824690,6,3840,1775,-40
45850027950,45850027957,7,3290,1040,-40
45850969638,45850969645,7,3210,1096,-40
45851143682,45851143689,7,1762,786,-40
45851978099,45851978096,-3,972,135,-40
45854283261,45854283267,6,3031,1447,-40
45866692981,45866692986,5,3547,1600,-40
45867220115,45867220115,0,1149,1881,-40
45868892322,45868892326,4,2098,776,-40
45871234738,45871234746,8,4084,1286,-40
45872746544,45872746550,6,3758,1534,-40
45873012507,45873012491,-16,3651,1301,-40
45873521186,45873521165,-21,2564,1112,-40
45876073930,45876073935,5,2740,1166,-40
45878412013,45878412020,7,3498,1346,-40
45878705402,45878705420,18,924,418,-40
45880326163,45880326169,6,2619,1505,-40
45885416561,45885416566,5,716,621,-40
45888401651,45888401658,7,3380,1082,-40
45890677637,45890677643,6,3476,1389,-40
45892647230,45892647231,1,2264,2681,-40
45892733738,45892733745,7,2635,1466,-40
45893948018,45893948021,3,1964,1492,-40
45894357943,45894357963,20,2609,1054,-40
45894655939,45894655946,7,2816,1319,-40
45898703706,45898703711,5,3113,1777,-40
45899661173,45899661178,5,2587,1156,-40
45899884511,45899884516,5,1075,920,-40
45907402543,45907402550,7,2776,1412,-40
45913825402,45913825410,8,2919,1152,-40
45913976653,45913976649,-4,997,3352,-40
45915015678,45915015682,4,3647,1535,-40
45915163470,45915163452,-18,1097,571,-40
45917998166,45917998170,4,2484,1142,-40
45918237502,45918237505,3,1284,26429,-40
45920173369,45920173375,6,1933,1110,-40
45927883162,45927883166,4,1464,1066,-40
45928795813,45928795829,16,2776,10762,-40
45929663180,45929663187,7,3553,1453,-40
45930923438,45930923437,-1,1151,2326,-40
45932938018,45932938025,7,2533,1267,-40
45937331722,45937331708,-14,3033,1245,-40
45937630938,45937630944,6,3620,1219,-40
45938876790,45938876798,8,4455,1328,-40
45939821281,45939821266,-15,1108,390,-40
45939948249,45939948254,5,3100,1018,-40
45941729242,45941729246,4,2043,980,-40
45945009169,45945009174,5,2203,1016,-40
45945797863,45945797865,2,1852,1742,-40
45949954602,45949954609,7,4388,1310,-40
45951720450,45951720454,4,2212,895,-40
45954341736,45954341742,6,2853,1435,-40
45956582318,45956582317,-1,1294,1948,-40
45961834901,45961834907,6,3267,1048,-40
45962856730,45962856734,4,1811,1065,-40
45963642154,45963642159,5,1725,692,-40
45964660562,45964660546,-16,3410,1147,-40
45968888661,45968888667,6,2083,1425,-40
45974861417,45974861423,6,2919,1082,-40
45977986351,45977986358,7,3914,1757,-40
45978079436,45978079441,5,2491,1680,-40
45978366974,45978366974,0,837,1718,-40
45982959049,45982959055,6,1870,856,-40
45984976639,45984976645,6,2686,937,-40
45993029165,45993029167,2,1643,729,-40
45996485162,45996485168,6,2549,1142,-40
45996723458,45996723466,8,988,259,-40
45998100845,45998100851,6,1218,689,-40
46003442170,46003442175,5,2152,1185,-40
46005574697,46005574698,1,2872,3173,-40
46015776236,46015776243,7,2587,875,-40
46017801650,46017801654,4,3084,1282,-40
46018689256,46018689262,6,2474,925,-40
46020610521,46020610526,5,2609,823,-40
46023876533,46023876539,6,3819,1629,-40
46028222618,46028222626,8,2694,1386,-40
46030567681,46030567685,4,1631,1468,-40
46030719345,46030719351,6,2693,1188,-40
46031509103,46031509111,8,1881,1291,-40
46033424402,46033424409,7,3534,1646,-40
46034911042,46034911048,6,3320,1240,-40
46035083722,46035083727,5,2618,1161,-40
46036059718,46036059723,5,1737,989,-40
46038040121,46038040127,6,3167,1146,-40
46040709955,46040709961,6,2767,1459,-40
46045590457,46045590462,5,3578,1593,-40
46046389623,46046389630,7,3081,998,-40
46049834378,46049834383,5,2016,1087,-40
46051454130,46051454113,-17,2393,1150,-40
46066523640,46066523646,6,4081,1988,-40
46067283605,46067283614,9,2220,782,-40
46070654302,46070654308,6,1833,926,-40
46075010487,46075010496,9,2653,1120,-40
46076337690,46076337696,6,2034,1281,-40
46078214952,46078214955,3,2141,1290,-40
46079393495,46079393495,0,1740,3877,-40
46085664602,46085664607,5,2662,1441,-40
46089190818,46089190825,7,3923,1301,-40
46092165824,46092165831,7,3467,1956,-40
46092802989,46092802995,6,1824,1203,-40
46094639417,46094639424,7,3117,1347,-40
46097742834,46097742839,5,3297,1670,-40
46099872063,46099872058,-5,2133,6074,-40
46100759170,46100759174,4,2173,1165,-40
46101772209,46101772214,5,1945,950,-40
46106650428,46106650434,6,2348,1136,-40
46107146186,46107146193,7,3503,1797,-40
46110477917,46110477926,9,5259,1323,-40
46116686345,46116686351,6,3154,1571,-40
46116826658,46116826665,7,955,395,-40
46117122481,46117122486,5,2866,1312,-40
46118104202,46118104205,3,1811,1007,-40
46122737120,46122737123,3,1371,1487,-40
46128876892,46128876896,4,934,908,-40
46133980169,46133980176,7,2730,1259,-40
46137399849,46137399854,5,2268,1388,-40
46138791431,46138791439,8,1702,856,-40
46139451665,46139451670,5,3698,1353,-40
46140724242,46140724249,7,2041,1122,-40
46141029390,46141029399,9,994,1063,-40
46144183874,46144183880,6,3425,1243,-40
46145057408,46145057402,-6,1156,3814,-40
46145814990,46145814997,7,2243,1175,-40
46147065136,46147065141,5,3211,1351,-40
46149740641,46149740646,5,1981,779,-40
46152356833,46152356838,5,2428,1172,-40
46152519318,46152519327,9,3439,1573,-40
46152965398,46152965406,8,2783,964,-40
46154595628,46154595635,7,2449,957,-40
46157427621,46157427623,2,2472,1045,-40
46158091066,46158091049,-17,3161,816,-40
46164726175,46164726179,4,2307,1425,-40
46168662487,46168662495,8,3682,1183,-40
46170266112,46170266117,5,1591,1277,-40
46175259464,46175259466,2,3141,2637,-40
46177543159,46177543165,6,1849,1110,-40
46177827305,46177827310,5,3556,1394,-40
46178628574,46178628580,6,2332,1748,-40
46179183386,46179183388,2,2917,3318,-40
46179274338,46179274345,7,3172,1425,-40
46183628209,46183628214,5,2448,1855,-40
46185641319,46185641325,6,2193,1379,-40
46186841096,46186841103,7,2416,1089,-40
46192115693,46192115700,7,2239,1045,-40
46193170935,46193170942,7,2559,1404,-40
46199509679,46199509686,7,4580,2261,-40
46200359147,46200359155,8,4467,1645,-40
46200769058,46200769063,5,1513,1060,-40
46206926382,46206926389,7,3460,1222,-40
46208216372,46208216377,5,1529,762,-40
46210956909,46210956914,5,3016,1318,-40
46211488581,46211488587,6,3709,1706,-40
46212933534,46212933542,8,2621,1905,-40
46213372497,46213372503,6,1614,607,-40
46213753606,46213753612,6,2878,1384,-40
46214905742,46214905749,7,2312,1441,-40
46215521194,46215521202,8,2576,1321,-40
46217057697,46217057701,4,3085,1092,-40
46217394078,46217394083,5,2484,821,-40
46223217529,46223217534,5,2826,1381,-40
46224752650,46224752654,4,2577,1346,-40
46225892282,46225892282,0,3325,3000,-40
46228663797,46228663802,5,2489,1438,-40
46235711859,46235711853,-6,1580,6071,-40
46241934669,46241934676,7,3657,1427,-40
46244296807,46244296815,8,6513,28771,-40
46244995201,46244995207,6,2703,1375,-40
46245706409,46245706415,6,2419,1431,-40
46246626067,46246626066,-1,811,1513,-40
46251923585,46251923594,9,2723,1301,-40
46252051649,46252051634,-15,1025,734,-40
46253724071,46253724078,7,2139,1197,-40
46256063218,46256063224,6,3768,1580,-40
46263907126,46263907134,8,3459,1107,-40
46269203574,46269203580,6,4229,1876,-40
46270533868,46270533873,5,1359,666,-40
46272834663,46272834677,14,26258,55227,-40
46277458892,46277458895,3,3373,4003,-40
46277915068,46277915065,-3,1645,3794,-40
46278476497,46278476505,8,3860,1679,-40
46278804982,46278804993,11,2628,1056,-40
46282772716,46282772727,11,2392,1135,-40
46283373809,46283373814,5,2159,1425,-40
46303087391,46303087390,-1,1442,2544,-40
46313825678,46313825682,4,2354,1306,-40
46315247201,46315247207,6,3015,1069,-40
46315855080,46315855085,5,1885,906,-40
46316041198,46316041203,5,2616,1261,-40
46316215588,46316215588,0,2638,3105,-40
46318867112,46318867117,5,2090,866,-40
46319242511,46319242498,-13,898,279,-40
46324588271,46324588276,5,3493,2129,-40
46324683261,46324683240,-21,1810,995,-40
46326282495,46326282502,7,2083,1090,-40
46329893389,46329893395,6,1820,1369,-40
46331666486,46331666491,5,3287,1781,-40
46335516216,46335516209,-7,1605,9585,-40
46336892313,46336892318,5,3094,1295,-40
46337013554,46337013536,-18,3633,1311,-40
46337132409,46337132414,5,2434,1044,-40
46345975585,46345975591,6,2966,1236,-40
46347154392,46347154399,7,3856,1273,-40
46349896571,46349896575,4,2974,1427,-40
46350140189,46350140196,7,1159,966,-40
46350928800,46350928806,6,2388,1015,-40
46353185178,46353185182,4,1486,1112,-40
46359535799,46359535805,6,3470,1753,-40
46365980530,46365980534,4,2214,1417,-40
46366448082,46366448089,7,917,501,-40
46379937010,46379937017,7,2940,1360,-40
46381700910,46381700916,6,2343,1283,-40
46381785497,46381785514,17,1771,778,-40
46383442906,46383442911,5,2780,1022,-40
46385008893,46385008897,4,2089,841,-40
46386165285,46386165291,6,2580,1086,-40
46386317984,46386318001,17,2882,1297,-40
46391932165,46391932171,6,1913,1075,-40
46396715733,46396715739,6,2476,1510,-40
46396961066,46396961073,7,3027,1580,-40
46397527936,46397527931,-5,883,184,-40
46401381738,46401381743,5,2932,1555,-40
46402105933,46402105937,4,2523,1410,-40
46402472438,46402472443,5,3140,1207,-40
46406288311,46406288319,8,1910,1265,-40
46408143935,46408143942,7,2464,890,-40
46409208365,46409208370,5,2189,1145,-40
46409394614,46409394632,18,549,126,-40
46409678899,46409678906,7,3419,1137,-40
46410680030,46410680035,5,2919,1438,-40
46412056097,46412056104,7,2233,1056,-40
46416138107,46416138118,11,1907,1123,-40
46416745286,46416745291,5,2677,1447,-40
46418343991,46418343998,7,2453,1207,-40
46419841929,46419841935,6,2839,863,-40
46427521318,46427521323,5,2227,1511,-40
46438604990,46438604998,8,1737,966,-40
46439946487,46439946494,7,3108,1189,-40
46446725658,46446725662,4,1971,1319,-40
46447675236,46447675220,-16,4271,1527,-40
46448485543,46448485551,8,3813,1472,-40
46448673137,46448673142,5,2563,1272,-40
46452801454,46452801461,7,2892,1350,-40
46456566030,46456566037,7,3240,1590,-40
46462611070,46462611078,8,13026,20888,-40
46470304193,46470304199,6,2240,843,-40
46471028122,46471028125,3,2652,1973,-40
46473243738,46473243744,6,2349,1271,-40
46475313322,46475313330,8,3293,1108,-40
46475530222,46475530229,7,4121,1365,-40
46478596065,46478596070,5,2463,822,-40
46479685753,46479685759,6,4043,1798,-40
46486130913,46486130917,4,1513,1505,-40
46489344767,46489344773,6,1886,908,-40
46491707553,46491707559,6,3376,1021,-40
46494198350,46494198358,8,2660,885,-40
46494595969,46494595975,6,2063,1037,-40
46494689613,46494689595,-18,2869,1074,-40
46499819548,46499819553,5,2038,1234,-40
46506367899,46506367907,8,2082,1162,-40
46507503397,46507503404,7,2560,1571,-40
46510515629,46510515635,6,2185,1152,-40
46514882310,46514882316,6,2477,1631,-40
46516187906,46516187909,3,1448,1620,-40
46516847185,46516847191,6,3068,1066,-40
46519875229,46519875234,5,2638,1299,-40
46520204281,46520204287,6,2075,949,-40
46523950405,46523950406,1,756,819,-40
46529178842,46529178849,7,1419,841,-40
46532523618,46532523624,6,2174,906,-40
46532788573,46532788563,-10,688,156,-40
46534227914,46534227920,6,2957,1596,-40
46534885971,46534885978,7,2294,1162,-40
46538180723,46538180730,7,2145,1397,-40
46539184297,46539184302,5,3809,1869,-40
46543746169,46543746174,5,3337,1038,-40
46546064668,46546064675,7,3747,1681,-40
46550126875,46550126881,6,2670,1169,-40
46551962149,46551962154,5,3099,1691,-40
46553112196,46553112203,7,3310,1335,-40
46555414000,46555414007,7,2825,1129,-40
46559481837,46559481842,5,2152,1104,-40
46561104805,46561104807,2,1855,2046,-40
46563684772,46563684769,-3,1061,3048,-40
46568349055,46568349061,6,2994,1080,-40
46568376422,46568376440,18,987,215,-40
46568423617,46568423601,-16,509,314,-40
46575192553,46575192558,5,3106,1372,-40
46576690178,46576690182,4,2071,1570,-40
46583773694,46583773700,6,2040,1095,-40
46594583181,46594583187,6,1821,1096,-40
46597809019,46597809022,3,2856,1717,-40
46598136798,46598136788,-10,681,268,-40
46599741326,46599741331,5,2517,1329,-40
46601167187,46601167185,-2,1741,3648,-40
46604447479,46604447485,6,2968,1393,-40
46605679497,46605679501,4,2718,2018,-40
46606625283,46606625287,4,2391,1531,-40
46607457610,46607457606,-4,944,2394,-40
46608672805,46608672809,4,2130,1035,-40
46612096583,46612096590,7,2082,1144,-40
46612166050,46612166066,16,1422,166,-40
46612636555,46612636563,8,575,85,-40
46613546442,46613546449,7,1502,720,-40
46616714026,46616714031,5,3126,1273,-40
46621718206,46621718214,8,2972,1271,-40
46621940182,46621940188,6,2395,947,-40
46621981826,46621981835,9,2120,1143,-40
46623695673,46623695679,6,2686,1721,-40
46627760621,46627760630,9,2876,1216,-40
46628178424,46628178441,17,2265,972,-40
46632818730,46632818729,-1,1189,1587,-40
46639618042,46639618048,6,3644,1383,-40
46643511973,46643511979,6,2718,1363,-40
46645614189,46645614194,5,1244,823,-40
46651277571,46651277579,8,2021,780,-40
46651832473,46651832479,6,2167,1283,-40
46652057779,46652057786,7,2717,1515,-40
46652959003,46652959009,6,2107,1388,-40
46653058015,46653058023,8,3225,1345,-40
46656697685,46656697690,5,2586,1097,-40
46658929669,46658929665,-4,1979,6641,-40
46658980086,46658980094,8,2847,1500,-40
46659303969,46659303974,5,3361,1713,-40
46660149183,46660149186,3,2003,37749,-40
46665326569,46665326575,6,1159,652,-40
46672269219,46672269225,6,915,634,-40
46674657513,46674657519,6,2604,1113,-40
46677446586,46677446590,4,3583,1556,-40
46679040758,46679040765,7,3031,1220,-40
46681522042,46681522047,5,2398,1396,-40
46681655085,46681655093,8,2910,1324,-40
46686519069,46686519075,6,1533,1273,-40
46693276084,46693276069,-15,831,867,-40
46698243018,46698243026,8,5931,1011,-40
46702339978,46702339985,7,3303,1560,-40
46704012297,46704012302,5,2742,1100,-40
46705742561,46705742569,8,8040,1416,-40
46706224866,46706224851,-15,3451,762,-40
46709095366,46709095371,5,2871,1482,-40
46711730252,46711730258,6,2765,1766,-40
46714295328,46714295334,6,2535,1105,-40
46716763987,46716763986,-1,991,1220,-40
46720676146,46720676154,8,5815,916,-40
46721436350,46721436355,5,2163,1339,-40
46723197550,46723197557,7,2722,1104,-40
46723758587,46723758602,15,2748,1055,-40
46729809465,46729809472,7,3163,1138,-40
46730691197,46730691211,14,1271,219,-40
46732472420,46732472427,7,3177,1626,-40
46737311265,46737311270,5,2242,942,-40
46747180821,46747180827,6,3213,2050,-40
46747229635,46747229643,8,2313,1149,-40
46748005631,46748005637,6,3031,1357,-40
46749427727,46749427732,5,10732,31726,-40
46750218401,46750218406,5,3090,1237,-40
46754135574,46754135574,0,1086,2443,-40
46756866532,46756866538,6,2965,1001,-40
46757912815,46757912819,4,2461,871,-40
46765218708,46765218713,5,2873,1253,-40
46770126341,46770126345,4,2830,1323,-40
46770365331,46770365315,-16,3928,1607,-40
46770796009,46770796015,6,1418,639,-40
46775996514,46775996519,5,2393,1284,-40
46777119500,46777119504,4,2863,1139,-40
46778022983,46778022990,7,3332,1622,-40
46778392983,46778392976,-7,1008,13017,-40
46779589371,46779589376,5,3581,1513,-40
46779931425,46779931431,6,2540,1394,-40
46781354022,46781354024,2,33629,39604,-40
46782798489,46782798488,-1,1192,1796,-40
46790814306,46790814311,5,2992,1187,-40
46792318866,46792318871,5,3362,1290,-40
46792370026,46792370036,10,1584,798,-40
46795315618,46795315622,4,2494,1844,-40
46797342632,46797342638,6,2109,1400,-40
46802733422,46802733427,5,2037,1220,-40
46806257339,46806257334,-5,278,96,-40
46806499459,46806499464,5,1512,486,-40
46814314722,46814314729,7,2140,981,-40
46815225470,46815225477,7,3519,1069,-40
46815405794,46815405786,-8,1792,384,-40
46815908117,46815908121,4,2356,1313,-40
46816829390,46816829396,6,2309,1162,-40
46818330448,46818330455,7,2666,1502,-40
46834108702,46834108709,7,3224,1003,-40
46835821184,46835821190,6,2659,1206,-40
46837388943,46837388949,6,2860,1465,-40
46837922561,46837922565,4,1667,1310,-40
46838283784,46838283787,3,1905,945,-40
46839835589,46839835593,4,2066,1069,-40
46840903002,46840903008,6,2852,1226,-40
46847509413,46847509419,6,3145,1281,-40
46848720895,46848720901,6,2084,1154,-40
46849359966,46849359965,-1,2936,3889,-40
46851075341,46851075349,8,3651,1318,-40
46851824573,46851824578,5,2289,732,-40
46852809722,46852809722,0,716,962,-40
46854469433,46854469439,6,3287,1485,-40
46854875021,46854875026,5,3078,642,-40
46855624081,46855624086,5,3259,1494,-40
46857770015,46857770019,4,2864,1115,-40
46858211762,46858211768,6,3240,1675,-40
46860532472,46860532459,-13,1828,957,-40
46862917327,46862917330,3,2402,1764,-40
46863372658,46863372665,7,2769,1583,-40
46863533801,46863533807,6,2388,1206,-40
46863838515,46863838528,13,670,266,-40
46864445013,46864445035,22,1347,189,-40
46872668747,46872668752,5,2457,1249,-40
46876157536,46876157541,5,3628,1319,-40
46877463797,46877463803,6,2512,1422,-40
46877510637,46877510644,7,2340,1331,-40
46878303885,46878303865,-20,3563,1546,-40
46884776337,46884776342,5,2915,1357,-40
46886322355,46886322362,7,3223,1804,-40
46886889846,46886889852,6,3312,1170,-40
46891965796,46891965800,4,2978,2477,-40
46892370597,46892370603,6,2120,1129,-40
46892946837,46892946818,-19,1101,373,-40
46894222496,46894222505,9,3798,1702,-40
46894483143,46894483152,9,2958,1323,-40
46897348292,46897348298,6,2700,1284,-40
46902788106,46902788115,9,3255,1327,-40
46905263365,46905263371,6,2178,1244,-40
46905713349,46905713354,5,3098,1219,-40
46912019638,46912019646,8,2647,910,-40
46912159161,46912159168,7,1703,1147,-40
46912231347,46912231340,-7,1624,521,-40
46914969858,46914969864,6,2676,1331,-40
46917569389,46917569393,4,2217,1053,-40
46919470556,46919470564,8,3152,1512,-40
46920280595,46920280595,0,1046,1155,-40
46925082734,46925082738,4,2717,1053,-40
46927609927,46927609931,4,2849,1238,-40
46927909101,46927909105,4,2135,805,-40
46928399512,46928399499,-13,3034,1186,-40
46930226298,46930226307,9,3685,1353,-40
46934449617,46934449622,5,2246,1386,-40
46936155274,46936155277,3,1075,1394,-40
46937371658,46937371642,-16,3055,1119,-40
46939803291,46939803297,6,2874,1249,-40
46940463458,46940463465,7,3462,1213,-40
46946498923,46946498931,8,2977,1342,-40
46948681084,46948681090,6,3469,1454,-40
46949083570,46949083575,5,3222,1529,-40
46949882355,46949882346,-9,1343,665,-40
46952253560,46952253566,6,2402,1158,-40
46956669532,46956669538,6,3322,1813,-40
46956943141,46956943148,7,6075,2783,-40
46956978570,46956978563,-7,895,6975,-40
46967375190,46967375196,6,2016,1449,-40
46971894749,46971894756,7,3486,1281,-40
46975541713,46975541715,2,1610,1663,-40
46977955625,46977955631,6,1840,1207,-40
46978177430,46978177408,-22,2404,754,-40
46980982809,46980982815,6,3056,1607,-40
46981093958,46981093966,8,5120,1420,-40
46983603214,46983603222,8,3144,1086,-40
46983941130,46983941116,-14,1604,736,-40
46986887528,46986887538,10,19031,45067,-40
46987752500,46987752508,8,2062,1472,-40
46991992334,46991992339,5,4729,1406,-40
46992814409,46992814417,8,3356,1642,-40
46993052640,46993052647,7,3324,1129,-40
46994200483,46994200490,7,2937,1198,-40
46994795739,46994795734,-5,1030,2842,-40
46995410700,46995410690,-10,984,254,-40
47001238698,47001238705,7,2541,1321,-40
47004796470,47004796475,5,2023,999,-40
47006598127,47006598127,0,767,816,-40
47007058560,47007058566,6,2264,775,-40
47009283774,47009283780,6,2925,1275,-40
47009507687,47009507676,-11,2724,1110,-40
47012288277,47012288281,4,2645,1380,-40
47013263266,47013263272,6,3348,1506,-40
47013828134,47013828114,-20,2368,933,-40
47017553653,47017553659,6,3236,1280,-40
47019991873,47019991878,5,2099,880,-40
47020056158,47020056162,4,7383,23574,-40
47021124659,47021124641,-18,3827,1524,-40
47025953770,47025953777,7,2425,781,-40
47027362830,47027362835,5,1935,1220,-40
47030719372,47030719365,-7,1663,41483,-40
47031841297,47031841302,5,2663,1330,-40
47032379489,47032379494,5,2020,1066,-40
47033616525,47033616529,4,2795,1297,-40
47038572040,47038572046,6,3071,1282,-40
47038994584,47038994590,6,3540,1517,-40
47039644566,47039644573,7,4044,1819,-40
47039698980,47039698985,5,2105,1490,-40
47040522052,47040522058,6,2687,1026,-40
47042005158,47042005138,-20,3331,1440,-40
47042048550,47042048558,8,3119,1407,-40
47045918189,47045918195,6,4040,1670,-40
47048087106,47048087109,3,2300,1735,-40
47050343040,47050343046,6,2710,1361,-40
47053068946,47053068954,8,2939,1168,-40
47057525618,47057525626,8,2542,998,-40
47063568805,47063568813,8,2561,1124,-40
47068814879,47068814886,7,2684,1542,-40
47070285785,47070285793,8,3288,1136,-40
47070559311,47070559318,7,3227,1598,-40
47078795462,47078795466,4,4135,3310,-40
47078990002,47078990006,4,3207,1506,-40
47081034546,47081034548,2,1395,1986,-40
47087293587,47087293590,3,2127,679,-40
47088274772,47088274778,6,3031,1159,-40
47091921501,47091921507,6,2650,1429,-40
47096219746,47096219753,7,1550,1110,-40
47096719160,47096719164,4,1661,1293,-40
47097209079,47097209085,6,3550,1366,-40
47100123759,47100123766,7,2671,1772,-40
47102489632,47102489637,5,2654,1536,-40
47103040965,47103040986,21,3588,1154,-40
47103830989,47103830995,6,3517,2409,-40
47105847681,47105847682,1,1944,2497,-40
47109908575,47109908581,6,885,951,-40
47112285106,47112285113,7,3530,1450,-40
47112870568,47112870568,0,17281,1520,-40
47113309236,47113309243,7,3169,1115,-40
47122242917,47122242923,6,3310,1940,-40
47123348614,47123348619,5,2896,822,-40
47123777333,47123777336,3,2177,1815,-40
47127734886,47127734891,5,3032,1720,-40
47128523231,47128523238,7,1681,932,-40
47128719694,47128719675,-19,2896,1265,-40
47128857251,47128857234,-17,1313,529,-40
47133808140,47133808146,6,4281,1680,-40
47135997142,47135997148,6,2952,1742,-40
47136269097,47136269103,6,3026,1548,-40
47138525292,47138525298,6,3322,1290,-40
47141837157,47141837165,8,3091,1371,-40
47143226261,47143226269,8,2500,981,-40
47144332731,47144332738,7,2318,883,-40
47145543110,47145543129,19,1859,1160,-40
47147028339,47147028347,8,3158,971,-40
47148426245,47148426250,5,3042,1071,-40
47154036282,47154036287,5,3246,1868,-40
47155257407,47155257414,7,1608,924,-40
47156345445,47156345451,6,3994,1650,-40
47161439530,47161439537,7,2866,1839,-40
47165275366,47165275370,4,1951,1650,-40
47166339151,47166339149,-2,1197,1069,-40
47178930293,47178930290,-3,780,1451,-40
47179882965,47179882971,6,5386,2091,-40
47181896474,47181896479,5,1777,919,-40
47187001754,47187001759,5,2609,1312,-40
47187388607,47187388615,8,3185,1095,-40
47190011054,47190011061,7,2928,1337,-40
47190306012,47190306019,7,3561,1015,-40
47194857782,47194857788,6,3520,1265,-40
47197353446,47197353453,7,2762,1637,-40
47208199898,47208199905,7,3711,1511,-40
47208869241,47208869242,1,899,346,-40
47209800451,47209800454,3,1399,661,-40
47210432060,47210432066,6,2803,1153,-40
47210725054,47210725048,-6,1411,4024,-40
47211755164,47211755169,5,2561,921,-40
47212852846,47212852857,11,2262,1220,-40
47215886117,47215886123,6,2783,1053,-40
47219125195,47219125194,-1,32404,19274,-40
47223369606,47223369602,-4,1055,3538,-40
47225031327,47225031334,7,2814,1181,-40
47227059350,47227059358,8,3048,1249,-40
47228416927,47228416933,6,3334,1648,-40
47233027339,47233027345,6,5395,2787,-40
47234409972,47234409979,7,3097,1182,-40
47238474871,47238474865,-6,1330,4735,-40
47239548386,47239548391,5,2926,1491,-40
47240477906,47240477911,5,2668,1433,-40
47242321578,47242321585,7,3742,1376,-40
47243051507,47243051514,7,2665,1196,-40
47243363509,47243363517,8,1957,1466,-40
47245208061,47245208067,6,2692,1038,-40
47247343399,47247343406,7,3138,1233,-40
47247645200,47247645218,18,595,4190,-40
47248677582,47248677589,7,3023,1480,-40
47253547413,47253547409,-4,1241,3085,-40
47254529402,47254529409,7,2186,997,-40
47256062498,47256062504,6,2792,990,-40
47257676313,47257676320,7,489,566,-40
47264406492,47264406498,6,2589,1364,-40
47268215073,47268215078,5,3036,1457,-40
47268363150,47268363131,-19,3022,1225,-40
47268918974,47268918979,5,3072,1488,-40
47273199190,47273199195,5,2330,1354,-40
47275456846,47275456851,5,2765,1324,-40
47277629810,47277629805,-5,2096,7171,-40
47278864534,47278864541,7,3344,1219,-40
47279058712,47279058718,6,3605,1432,-40
47281043526,47281043529,3,2282,2024,-40
47282450765,47282450771,6,2679,1455,-40
47282787714,47282787720,6,2631,1708,-40
47290949563,47290949569,6,2928,1152,-40
47297061827,47297061834,7,2118,808,-40
47297625805,47297625810,5,3555,1448,-40
47298521480,47298521481,1,1594,1597,-40
47299935561,47299935567,6,3290,1523,-40
47302585522,47302585530,8,3381,1038,-40
47305324859,47305324866,7,6107,1596,-40
47309443669,47309443674,5,3428,1628,-40
47315522924,47315522929,5,1850,1190,-40
47318087789,47318087788,-1,2064,4125,-40
47318823747,47318823738,-9,168,842,-40
47319233903,47319233911,8,3168,1179,-40
47319358211,47319358215,4,2723,1522,-40
47320156669,47320156667,-2,881,577,-40
47326641334,47326641339,5,2281,1271,-40
47333888026,47333888035,9,2566,1121,-40
47337136037,47337136042,5,3674,1253,-40
47339364505,47339364511,6,3150,1369,-40
47340402878,47340402884,6,3003,1286,-40
47340470630,47340470633,3,1033,127,-40
47341462101,47341462108,7,4822,1610,-40
47344095893,47344095899,6,3436,1304,-40
47346196589,47346196594,5,2655,1086,-40
47347435493,47347435498,5,2817,1203,-40
47348157595,47348157601,6,4507,1334,-40
47348578144,47348578150,6,3031,1063,-40
47349024950,47349024958,8,2521,953,-40
47350867232,47350867237,5,2375,1143,-40
47356266695,47356266701,6,4054,1659,-40
47357752838,47357752842,4,1727,924,-40
47357886297,47357886305,8,1562,522,-40
47359923860,47359923866,6,1896,1251,-40
47363637857,47363637863,6,2588,1666,-40
47365128418,47365128425,7,1888,796,-40
47365313734,47365313728,-6,1234,215,-40
47367572737,47367572752,15,1845,1161,-40
47371183276,47371183282,6,1589,686,-40
47380596505,47380596513,8,1176,751,-40
47381252462,47381252467,5,2042,1120,-40
47381773181,47381773192,11,1958,1067,-40
47385858919,47385858922,3,2165,1263,-40
47393351613,47393351619,6,2140,902,-40
47393954992,47393954994,2,2616,2413,-40
47393983701,47393983706,5,2036,830,-40
47394897251,47394897259,8,1846,1311,-40
47398499091,47398499099,8,3150,1278,-40
47401170028,47401170035,7,2316,1310,-40
47404481751,47404481771,20,1417,33405,-40
47407594500,47407594507,7,3807,1505,-40
47409091246,47409091246,0,1237,2017,-40
47411874554,47411874562,8,3454,1177,-40
47412467838,47412467845,7,2914,1291,-40
47413306388,47413306395,7,2556,1416,-40
47415272125,47415272131,6,3549,1712,-40
47417070287,47417070294,7,2258,884,-40
47418641151,47418641158,7,3158,1230,-40
47420362781,47420362788,7,1684,779,-40
47426246689,47426246694,5,2203,921,-40
47431131189,47431131195,6,3287,1405,-40
47434913843,47434913838,-5,1015,3515,-40
47435909074,47435909079,5,3644,1515,-40
47440316435,47440316441,6,4087,1897,-40
47441149236,47441149243,7,2634,1318,-40
47441228562,47441228566,4,1604,1150,-40
47443913847,47443913854,7,2944,1173,-40
47444511811,47444511818,7,2254,883,-40
47448530090,47448530097,7,2822,1213,-40
47448885952,47448885959,7,2593,1403,-40
47451370555,47451370561,6,1459,757,-40
47459130134,47459130141,7,2793,1744,-40
47464887010,47464887018,8,2209,1157,-40
47471903863,47471903869,6,3046,1712,-40
47477298112,47477298119,7,2718,1136,-40
47477914998,47477915002,4,1386,1361,-40
47479267867,47479267850,-17,4275,1033,-40
47482093717,47482093723,6,1648,893,-40
47482201474,47482201456,-18,648,398,-40
47485600900,47485600907,7,2507,1040,-40
47486760819,47486760826,7,3155,1399,-40
47487368720,47487368727,7,2707,1795,-40
47489270657,47489270666,9,2492,1388,-40
47489685526,47489685508,-18,1155,290,-40
47491950196,47491950203,7,3142,1090,-40
47494844254,47494844260,6,3840,1611,-40
47498376174,47498376179,5,1776,888,-40
47501348026,47501348034,8,2075,1276,-40
47501650121,47501650126,5,1652,693,-40
47510741631,47510741637,6,1595,1338,-40
47513109158,47513109160,2,1195,1149,-40
47517126373,47517126373,0,2911,4241,-40
47526830182,47526830189,7,2698,1506,-40
47534057285,47534057286,1,3317,3707,-40
47534876343,47534876350,7,1382,373,-40
47535271158,47535271166,8,2718,1165,-40
47535917129,47535917120,-9,455,166,-40
47540165450,47540165457,7,3149,992,-40
47542566603,47542566610,7,2629,1539,-40
47546734038,47546734038,0,1057,1249,-40
47546907941,47546907947,6,1912,1000,-40
47549564122,47549564125,3,2747,2252,-40
47549891905,47549891913,8,3911,1364,-40
47551011678,47551011671,-7,1995,6812,-40
47551425260,47551425267,7,3072,2093,-40
47551805414,47551805420,6,3608,1671,-40
47559101655,47559101661,6,2055,932,-40
47564618541,47564618540,-1,1525,1847,-40
47566755312,47566755319,7,2314,1477,-40
47567128380,47567128392,12,1719,1420,-40
47569767642,47569767649,7,4350,1745,-40
47573246818,47573246804,-14,2832,1139,-40
47577446096,47577446104,8,3069,1400,-40
47578392746,47578392753,7,2735,1286,-40
47583745426,47583745429,3,1870,2129,-40
47584594138,47584594131,-7,1646,5898,-40
47588203482,47588203489,7,2472,1486,-40
47590232517,47590232523,6,3326,1399,-40
47597482595,47597482590,-5,690,2482,-40
47604194103,47604194102,-1,1186,1276,-40
47605254785,47605254790,5,2085,1037,-40
47607874961,47607874963,2,3162,2339,-40
47608110319,47608110325,6,2058,1262,-40
47608425115,47608425130,15,1244,496,-40
47609218322,47609218316,-6,892,3451,-40
47610815846,47610815854,8,3266,1706,-40
47613705471,47613705477,6,2545,959,-40
47616286853,47616286858,5,2719,1451,-40
47625685364,47625685368,4,1954,1564,-40
47629428362,47629428370,8,2370,1319,-40
47632240600,47632240606,6,1829,1149,-40
47635364789,47635364794,5,2417,1271,-40
47637536598,47637536605,7,4176,1174,-40
47640837699,47640837703,4,2207,1423,-40
47645109000,47645109007,7,2686,1190,-40
47645653843,47645653826,-17,1981,676,-40
47649252520,47649252525,5,2062,996,-40
47653021839,47653021845,6,1941,947,-40
47656520432,47656520438,6,4457,1418,-40
47657474716,47657474712,-4,28979,12979,-40
47662916297,47662916302,5,1666,812,-40
47664652225,47664652230,5,2441,1611,-40
47667066934,47667066939,5,2654,1278,-40
47667443833,47667443838,5,3114,962,-40
47669336633,47669336638,5,2653,945,-40
47670261433,47670261436,3,2174,2353,-40
47672428851,47672428857,6,3386,1584,-40
47679973666,47679973662,-4,2518,6293,-40
47681197921,47681197926,5,3034,1375,-40
47681625468,47681625474,6,1504,696,-40
47692410314,47692410318,4,1773,1183,-40
47693111033,47693111040,7,4064,1495,-40
47695267235,47695267240,5,2418,1353,-40
47699055242,47699055247,5,2769,882,-40
47700108305,47700108289,-16,1111,681,-40
47701037646,47701037653,7,2887,1654,-40
47702031842,47702031850,8,2714,1344,-40
47703384859,47703384858,-1,1470,1121,-40
47711264101,47711264106,5,2133,1018,-40
47712597110,47712597115,5,2396,1065,-40
47714617915,47714617921,6,2133,703,-40
47715023487,47715023496,9,2583,1238,-40
47716254961,47716254967,6,2243,1091,-40
47718022428,47718022433,5,2768,1171,-40
47726686242,47726686250,8,2877,1240,-40
47727811927,47727811934,7,1759,978,-40
47728366226,47728366233,7,3243,1663,-40
47729734456,47729734463,7,2238,890,-40
47730153925,47730153908,-17,3130,1350,-40
47732367176,47732367178,2,1546,1398,-40
47734728014,47734728019,5,2981,2081,-40
47734755107,47734755114,7,2840,1295,-40
47736106902,47736106909,7,4268,1768,-40
47738311409,47738311413,4,1478,1322,-40
47742106706,47742106713,7,1852,1012,-40
47747029990,47747029994,4,2993,1431,-40
47747351647,47747351653,6,3577,1168,-40
47749324982,47749324987,5,1822,1121,-40
47750332290,47750332296,6,2206,914,-40
47751717787,47751717793,6,3036,1506,-40
47759074357,47759074365,8,4444,1547,-40
47765925798,47765925795,-3,1516,2524,-40
47768812215,47768812222,7,2193,1057,-40
47769363850,47769363858,8,2389,917,-40
47771503122,47771503128,6,3439,1632,-40
47772502461,47772502467,6,2922,1527,-40
47774459584,47774459590,6,3499,1522,-40
47774558915,47774558920,5,2496,1294,-40
47780590694,47780590698,4,2588,1236,-40
47783675718,47783675725,7,2677,1472,-40
47788555966,47788555973,7,5042,879,-40
47798329664,47798329670,6,2782,1392,-40
47807898589,47807898594,5,2512,1317,-40
47819851970,47819851975,5,3672,1534,-40
47820483989,47820483998,9,1894,841,-40
47820955033,47820955037,4,3493,1468,-40
47827163291,47827163298,7,3314,1063,-40
47827277670,47827277676,6,3007,1428,-40
47834346400,47834346406,6,2285,1328,-40
47834891195,47834891202,7,3029,1586,-40
47837350378,47837350385,7,3913,1247,-40
47837413675,47837413674,-1,1368,135,-40
47840437089,47840437086,-3,1254,2463,-40
47846092822,47846092829,7,1488,1018,-40
47847364678,47847364683,5,1967,1104,-40
47853028335,47853028343,8,2519,989,-40
47853935039,47853935042,3,1684,913,-40
47858610285,47858610291,6,2730,1207,-40
47859793806,47859793811,5,3278,1585,-40
47861468312,47861468319,7,2357,1178,-40
47863889810,47863889806,-4,4342,9620,-40
47864546768,47864546761,-7,1817,4691,-40
47876674602,47876674607,5,2024,1101,-40
47876967836,47876967842,6,2768,1506,-40
47878408701,47878408706,5,1987,1164,-40
47883907106,47883907109,3,2168,1155,-40
47884398087,47884398094,7,2394,1281,-40
47884503114,47884503124,10,2327,47863,-40
47884556551,47884556554,3,1675,1227,-40
47885597238,47885597241,3,2288,1630,-40
47886133626,47886133633,7,3177,1709,-40
47888685149,47888685155,6,2378,1413,-40
47892684964,47892684971,7,3602,1784,-40
47895763967,47895763973,6,3337,1516,-40
47899653529,47899653535,6,4250,1376,-40
47900872575,47900872582,7,2283,1340,-40
47904947402,47904947408,6,2403,1445,-40
47906099031,47906099038,7,3020,1318,-40
47912668398,47912668403,5,4025,1499,-40
47913748356,47913748363,7,3536,1458,-40
47915064166,47915064171,5,2359,1072,-40
47922632583,47922632590,7,2849,1101,-40
47923798525,47923798531,6,3041,1594,-40
47924334682,47924334664,-18,2223,1088,-40
47929217445,47929217450,5,2061,1424,-40
47933940230,47933940237,7,4324,1832,-40
47941559454,47941559459,5,2613,1491,-40
47941661845,47941661849,4,2746,1141,-40
47942712861,47942712866,5,3142,1252,-40
47944729850,47944729857,7,4689,1182,-40
47946158786,47946158793,7,2010,1006,-40
47949703550,47949703558,8,2977,1211,-40
47951450735,47951450743,8,4095,1166,-40
47951518222,47951518203,-19,501,87,-40
47952039623,47952039641,18,692,176,-40
47955046757,47955046765,8,3614,1348,-40
47955396062,47955396083,21,2273,784,-40
47955798137,47955798143,6,1844,1005,-40
47956839558,47956839571,13,4737,1669,-40
47961207575,47961207583,8,3810,2109,-40
47962047294,47962047300,6,2804,1391,-40
47964485063,47964485070,7,3536,1431,-40
47965238593,47965238598,5,3256,1772,-40
47966839765,47966839770,5,1898,809,-40
47969499846,47969499851,5,3036,1185,-40
47976253813,47976253828,15,3609,1634,-40
47978768979,47978768978,-1,1536,2037,-40
47979744855,47979744840,-15,1850,545,-40
47979813846,47979813851,5,3068,1422,-40
47980042207,47980042214,7,2897,1199,-40
47984573077,47984573082,5,2736,1260,-40
47986826147,47986826153,6,2216,942,-40
47987261229,47987261235,6,2508,1124,-40
47992775955,47992775961,6,4055,1366,-40
47997420337,47997420342,5,2432,1170,-40
48003606109,48003606115,6,3332,1527,-40
48005924469,48005924474,5,2249,1905,-40
48007132202,48007132204,2,3665,3131,-40
48008602198,48008602204,6,3094,1906,-40
48014639090,48014639097,7,2197,1222,-40
48016948706,48016948718,12,16409,23945,-40
48020209042,48020209050,8,2032,1023,-40
48020973049,48020973053,4,3102,1373,-40
48021295509,48021295490,-19,1571,1024,-40
48025686160,48025686167,7,2225,1163,-40
48029264598,48029264605,7,2180,1048,-40
48044515125,48044515132,7,3519,1305,-40
48046252999,48046252996,-3,1424,2087,-40
48049043782,48049043789,7,1637,973,-40
48049766990,48049766997,7,4051,1402,-40
48050235231,48050235212,-19,2549,1344,-40
48050441972,48050441987,15,798,15,-40
48051651049,48051651054,5,2818,1187,-40
48056837644,48056837651,7,1922,1186,-40
48060895582,48060895590,8,2598,1226,-40
48067467688,48067467693,5,2835,1655,-40
48069189829,48069189834,5,3344,1313,-40
48072398602,48072398608,6,2348,1395,-40
48075800891,48075800897,6,2755,1788,-40
48080503715,48080503722,7,3144,1028,-40
48085620459,48085620466,7,2462,1255,-40
48085729420,48085729403,-17,2055,720,-40
48087294629,48087294634,5,1727,988,-40
48089033806,48089033813,7,3656,1890,-40
48095825509,48095825515,6,2630,1290,-40
48096672330,48096672335,5,2597,1158,-40
48099518096,48099518090,-6,1005,4593,-40
48099576266,48099576273,7,2799,1073,-40
48099907897,48099907882,-15,2932,1286,-40
48101752639,48101752645,6,2950,1043,-40
48103534843,48103534858,15,3655,1244,-40
48104633135,48104633120,-15,1765,660,-40
48110553550,48110553558,8,1985,839,-40
48110842709,48110842714,5,4146,2291,-40
48113720017,48113720022,5,2398,1471,-40
48115845782,48115845789,7,3722,1504,-40
48115962539,48115962546,7,822,149,-40
48116559542,48116559549,7,2778,1458,-40
48118989585,48118989591,6,3235,1311,-40
48119439987,48119439993,6,2298,1412,-40
48124376276,48124376283,7,1713,1015,-40
48128399019,48128399026,7,2640,1179,-40
48132750706,48132750713,7,3918,1659,-40
48135332801,48135332808,7,4164,1640,-40
48138223951,48138223958,7,2813,1202,-40
48140963113,48140963119,6,2497,1405,-40
48148886208,48148886215,7,2785,906,-40
48154476206,48154476212,6,2760,1446,-40
48156787938,48156787945,7,3650,965,-40
48157959346,48157959354,8,3496,1561,-40
48158988764,48158988769,5,2149,1449,-40
48162681198,48162681202,4,3032,1051,-40
48174125908,48174125914,6,2846,1352,-40
48176304706,48176304710,4,1295,703,-40
48178974731,48178974737,6,2197,1070,-40
48180423501,48180423505,4,1835,947,-40
48181006245,48181006250,5,2283,1403,-40
48184744740,48184744746,6,2168,1667,-40
48194883834,48194883841,7,2520,1096,-40
48195095022,48195095019,-3,619,90,-40
48200952578,48200952586,8,3595,1994,-40
48213654078,48213654085,7,3113,1402,-40
48220685413,48220685419,6,3105,1283,-40
48220962950,48220962929,-21,1035,123,-40
48221387590,48221387578,-12,1098,248,-40
48221817177,48221817161,-16,862,148,-40
48222995442,48222995449,7,3187,1582,-40
48223930596,48223930593,-3,116,4888,-40
48227037478,48227037483,5,2179,1207,-40
48227441921,48227441908,-13,3099,1247,-40
48239250106,48239250113,7,15078,36400,-40
48246289687,48246289694,7,3774,1410,-40
48249502089,48249502095,6,1943,1070,-40
48259010525,48259010530,5,1996,1333,-40
48267753271,48267753278,7,1655,1123,-40
48273538261,48273538267,6,2633,1385,-40
48273877776,48273877782,6,2490,993,-40
48274131246,48274131253,7,3644,1158,-40
48274351266,48274351273,7,2956,1702,-40
48277282302,48277282309,7,2255,1191,-40
48281992678,48281992685,7,2777,1481,-40
48283650771,48283650777,6,2821,1615,-40
48283962116,48283962123,7,1414,1025,-40
48287708523,48287708531,8,2316,975,-40
48291454746,48291454751,5,2589,1416,-40
48294512301,48294512307,6,1590,1049,-40
48304316114,48304316118,4,1246,995,-40
48307232612,48307232618,6,4697,957,-40
48316771729,48316771735,6,2022,1558,-40
48316839115,48316839096,-19,2872,913,-40
48318174750,48318174758,8,2515,1454,-40
48318969106,48318969113,7,3622,1655,-40
48321523437,48321523442,5,2461,873,-40
48323271737,48323271743,6,2475,924,-40
48325270921,48325270914,-7,958,3726,-40
48328218961,48328218970,9,2469,1518,-40
48328821997,48328822002,5,1041,661,-40
48335503792,48335503798,6,3361,1386,-40
48337374447,48337374441,-6,2074,10055,-40
48339886217,48339886222,5,2396,1250,-40
48347984011,48347984018,7,2415,1334,-40
48348629685,48348629689,4,3003,1610,-40
48349725631,48349725636,5,2108,953,-40
48351991749,48351991754,5,4010,1978,-40
48352194377,48352194387,10,991,316,-40
48352702143,48352702150,7,3354,1317,-40
48353314574,48353314555,-19,2623,1205,-40
48354186346,48354186351,5,2264,1117,-40
48358904810,48358904818,8,2544,1120,-40
48359016391,48359016397,6,1881,1170,-40
48361458010,48361458011,1,37955,23456,-40
48367123425,48367123431,6,3504,1391,-40
48368169694,48368169703,9,3874,1087,-40
48368491839,48368491851,12,3611,1289,-40
48372384162,48372384164,2,7144,20096,-40
48374226484,48374226490,6,2165,1143,-40
48376767670,48376767678,8,4102,1433,-40
48377678621,48377678627,6,2705,1188,-40
48377940281,48377940289,8,4561,1883,-40
48379170240,48379170246,6,3483,1095,-40
48385949718,48385949725,7,3061,1170,-40
48386361370,48386361375,5,2802,1334,-40
48386466433,48386466419,-14,580,232,-40
48391031267,48391031273,6,2079,1222,-40
48393465273,48393465277,4,2071,1248,-40
48393512074,48393512082,8,4428,982,-40
48395017820,48395017818,-2,2967,5354,-40
48399290182,48399290190,8,3283,2019,-40
48401130322,48401130332,10,151,2633,-40
48403060022,48403060029,7,3337,1296,-40
48405195528,48405195536,8,3738,1556,-40
48406877543,48406877527,-16,1277,713,-40
48412180126,48412180133,7,3583,1217,-40
48413271026,48413271033,7,3305,1313,-40
48417519249,48417519255,6,3542,1619,-40
48419155849,48419155854,5,2441,1151,-40
48419237827,48419237812,-15,441,224,-40
48421223585,48421223590,5,2411,934,-40
48423195186,48423195189,3,1775,1585,-40
48424651421,48424651426,5,3485,1164,-40
48424847681,48424847686,5,2981,1257,-40
48426329151,48426329158,7,3677,1645,-40
48432117410,48432117417,7,4112,1783,-40
48433766818,48433766824,6,2908,1944,-40
48434379280,48434379286,6,895,609,-40
48434945522,48434945523,1,1589,1631,-40
48435645834,48435645841,7,3650,962,-40
48435987114,48435987121,7,3537,1354,-40
48450053008,48450053014,6,2626,1283,-40
48457791866,48457791871,5,1536,718,-40
48458248337,48458248342,5,1710,1793,-40
48458429168,48458429174,6,3319,1227,-40
48463055436,48463055442,6,2098,593,-40
48463239323,48463239306,-17,1441,1050,-40
48464627119,48464627126,7,3175,1691,-40
48465322205,48465322187,-18,2390,1148,-40
48467964218,48467964225,7,2507,1358,-40
48468052806,48468052810,4,3402,1285,-40
48468949222,48468949229,7,3697,1299,-40
48471727637,48471727643,6,2556,1393,-40
48476658449,48476658454,5,2777,1149,-40
48478097879,48478097887,8,3080,1439,-40
48484052630,48484052633,3,2356,1401,-40
48489386609,48489386614,5,2565,1196,-40
48497558259,48497558266,7,3166,984,-40
48502076829,48502076835,6,2263,785,-40
48502607370,48502607355,-15,1688,657,-40
48504295641,48504295645,4,3276,1386,-40
48504705860,48504705866,6,2755,1644,-40
48509721230,48509721234,4,1462,858,-40
48509991515,48509991500,-15,2413,1212,-40
48510233889,48510233898,9,2276,1050,-40
48516111026,48516111023,-3,2738,4009,-40
48516998518,48516998522,4,2598,1085,-40
48521750354,48521750357,3,1923,1451,-40
48523129644,48523129650,6,2205,1088,-40
48528206409,48528206413,4,2572,1336,-40
48534545242,48534545249,7,1896,1115,-40
48542043803,48542043809,6,2771,1318,-40
48543141678,48543141683,5,2963,870,-40
48546579061,48546579067,6,2871,879,-40
48555315146,48555315125,-21,635,302,-40
48561827824,48561827829,5,3395,1173,-40
48563928918,48563928926,8,2638,1086,-40
48564150069,48564150081,12,2324,1196,-40
48565754705,48565754712,7,1918,1367,-40
48566054468,48566054448,-20,1165,269,-40
48567202838,48567202846,8,2076,1020,-40
48568634639,48568634643,4,2443,1725,-40
48575450726,48575450733,7,2587,1488,-40
48581467435,48581467430,-5,993,2024,-40
48587135110,48587135116,6,2302,1350,-40
48587633602,48587633608,6,2878,1281,-40
48591680857,48591680862,5,2700,1940,-40
48593046530,48593046536,6,2767,1237,-40
48593084365,48593084386,21,2844,1297,-40
48598445266,48598445273,7,3026,1117,-40
48610030678,48610030682,4,2615,1760,-40
48613461093,48613461097,4,2386,2099,-40
48615340430,48615340437,7,3971,1289,-40
48617737916,48617737923,7,2417,1247,-40
48619936702,48619936705,3,2982,2792,-40
48620538543,48620538550,7,3180,896,-40
48623431706,48623431714,8,2594,1160,-40
48632136766,48632136774,8,2169,1101,-40
48633195043,48633195050,7,5296,1530,-40
48633806139,48633806145,6,2260,45538,-40
48636007494,48636007498,4,2240,1284,-40
48636880568,48636880575,7,2719,1595,-40
48636957522,48636957528,6,2811,1787,-40
48645256752,48645256759,7,3116,1478,-40
48645915317,48645915322,5,2430,1359,-40
48646108895,48646108898,3,1511,1403,-40
48651230717,48651230722,5,3536,1679,-40
48652007538,48652007545,7,3780,1400,-40
48654098862,48654098882,20,1400,298,-40
48656245399,48656245403,4,1921,1574,-40
48656596066,48656596072,6,2286,1780,-40
48657552079,48657552066,-13,393,407,-40
48666871730,48666871735,5,2331,1089,-40
48667673761,48667673767,6,3871,1739,-40
48669826237,48669826217,-20,1023,3386,-40
48669993359,48669993365,6,2558,1645,-40
48671515721,48671515726,5,2141,1252,-40
48673626678,48673626685,7,2474,1121,-40
48673869934,48673869941,7,3125,1854,-40
48677329927,48677329931,4,3211,1886,-40
48679258468,48679258475,7,3608,1366,-40
48679512645,48679512651,6,1662,739,-40
48687118646,48687118655,9,3410,1547,-40
48689982702,48689982709,7,2958,1432,-40
48692051971,48692051978,7,2561,1340,-40
48692097199,48692097218,19,1266,121,-40
48693382009,48693382014,5,3048,1090,-40
48698852234,48698852241,7,2036,896,-40
48702636152,48702636154,2,1531,1774,-40
48703853750,48703853750,0,2683,4345,-40
48707383018,48707383026,8,2645,903,-40
48707584706,48707584713,7,3442,1550,-40
48711175349,48711175355,6,2616,1097,-40
48711696973,48711696992,19,3601,1003,-40
48713512683,48713512690,7,3414,1440,-40
48716656155,48716656162,7,3341,1289,-40
48716773139,48716773134,-5,22151,10970,-40
48716914922,48716914906,-16,874,374,-40
48720276058,48720276062,4,2281,1299,-40
48721861261,48721861266,5,2458,1142,-40
48724202780,48724202785,5,2733,1233,-40
48728034845,48728034850,5,2407,1093,-40
48728546018,48728546003,-15,3191,1639,-40
48731058044,48731058050,6,4160,1455,-40
48731255688,48731255695,7,3598,1191,-40
48732409478,48732409486,8,2315,1346,-40
48733180399,48733180384,-15,3058,1397,-40
48733314497,48733314483,-14,3174,1376,-40
48739615777,48739615783,6,2446,979,-40
48739838971,48739838952,-19,1575,984,-40
48740766915,48740766922,7,3466,1533,-40
48741108384,48741108371,-13,3730,1576,-40
48742344754,48742344745,-9,949,245,-40
48742474158,48742474137,-21,2768,1077,-40
48743102503,48743102502,-1,1036,1598,-40
48754339223,48754339222,-1,3626,3270,-40
48761146900,48761146907,7,3081,1109,-40
48763564396,48763564403,7,2779,1592,-40
48767384702,48767384707,5,2067,1274,-40
48769083384,48769083381,-3,1259,3221,-40
48769129529,48769129534,5,2653,1393,-40
48776459462,48776459471,9,3620,1183,-40
48779841985,48779841981,-4,1729,6963,-40
48783831861,48783831866,5,2885,1187,-40
48784320870,48784320874,4,2497,1081,-40
48785370895,48785370902,7,3504,1397,-40
48789698841,48789698841,0,2087,1758,-40
48791044702,48791044709,7,2459,1356,-40
48791235929,48791235914,-15,1402,243,-40
48793259725,48793259731,6,3979,1359,-40
48797919586,48797919594,8,2574,935,-40
48799463366,48799463373,7,3410,1743,-40
48799685174,48799685178,4,2437,1844,-40
48800042534,48800042540,6,2947,1414,-40
48802745728,48802745734,6,1524,789,-40
48808999406,48808999412,6,3268,1354,-40
48820143092,48820143105,13,11988,41675,-40
48822898411,48822898421,10,3711,1522,-40
48827753047,48827753053,6,3698,1493,-40
48830906049,48830906055,6,2308,1102,-40
48833771970,48833771978,8,2696,1577,-40
48834872591,48834872595,4,2131,1079,-40
48834939494,48834939502,8,2965,1566,-40
48838128943,48838128947,4,2667,1097,-40
48838800987,48838800987,0,1004,1153,-40
48839617161,48839617166,5,3041,1309,-40
48842174594,48842174599,5,2292,1279,-40
48842447460,48842447464,4,3619,2019,-40
48842801961,48842801967,6,1963,1446,-40
48846994572,48846994578,6,2901,1223,-40
48847299340,48847299355,15,753,189,-40
48847606886,48847606891,5,2294,1034,-40
48852661822,48852661830,8,2758,1083,-40
48861162281,48861162286,5,2362,1163,-40
48861311085,48861311107,22,942,310,-40
48861741154,48861741162,8,2276,954,-40
48862179166,48862179172,6,2437,1237,-40
48862269663,48862269669,6,3064,1538,-40
48862638173,48862638178,5,2708,1496,-40
48866224389,48866224394,5,2140,1341,-40
48866324620,48866324641,21,835,294,-40
48873103577,48873103582,5,2425,1164,-40
48875712854,48875712855,1,3066,3153,-40
48875758674,48875758670,-4,1101,1943,-40
48876770378,48876770385,7,77125,25288,-40
48878749491,48878749498,7,2130,973,-40
48879259193,48879259190,-3,910,2693,-40
48880234213,48880234218,5,2447,1057,-40
48882130876,48882130877,1,3056,3787,-40
48884516419,48884516425,6,2173,965,-40
48886552225,48886552231,6,2340,1216,-40
48888031010,48888031003,-7,2339,10378,-40
48889630934,48889630941,7,3358,1618,-40
48891288562,48891288547,-15,1773,807,-40
48895727491,48895727497,6,2548,1120,-40
48896641785,48896641792,7,2299,1323,-40
48898585040,48898585045,5,3787,1911,-40
48900212553,48900212560,7,3442,899,-40
48900821377,48900821381,4,12014,9463,-40
48901395715,48901395718,3,1948,1001,-40
48901554529,48901554535,6,3004,1077,-40
48905248704,48905248709,5,1939,1696,-40
48907149153,48907149149,-4,723,3524,-40
48913077144,48913077150,6,2468,1242,-40
48915191789,48915191795,6,3111,1287,-40
48915520938,48915520955,17,2406,1293,-40
48915798646,48915798657,11,1024,335,-40
48922518605,48922518612,7,2049,933,-40
48923639398,48923639401,3,1414,1158,-40
48924399771,48924399776,5,2375,956,-40
48925442052,48925442060,8,4862,1845,-40
48926467825,48926467831,6,2398,1042,-40
48927321301,48927321283,-18,905,248,-40
48928140594,48928140602,8,12916,22538,-40
48936920031,48936920038,7,1429,739,-40
48937438903,48937438890,-13,1979,853,-40
48937550177,48937550185,8,3470,1289,-40
48937901543,48937901549,6,1491,839,-40
48938056987,48938056994,7,3285,1459,-40
48942217186,48942217187,1,3543,3000,-40
48947539289,48947539282,-7,720,2472,-40
48953167834,48953167839,5,1905,1470,-40
48958029749,48958029756,7,3813,1441,-40
48964454825,48964454830,5,2790,1209,-40
48973379715,48973379722,7,4158,1554,-40
48981062628,48981062611,-17,2776,1516,-40
48991039523,48991039520,-3,278,111,-40
48991595342,48991595347,5,3188,1523,-40
48998387192,48998387198,6,3222,1778,-40
48998607865,48998607873,8,3166,1366,-40
49000781113,49000781119,6,1293,620,-40
49009507203,49009507210,7,2241,1241,-40
49010348581,49010348576,-5,778,164,-40
49015478362,49015478367,5,2543,1291,-40
49017205502,49017205508,6,4123,1318,-40
49019526205,49019526210,5,3189,1237,-40
49021564748,49021564754,6,2169,1169,-40
49021861518,49021861518,0,1234,1548,-40
49022861405,49022861411,6,3724,1350,-40
49023168506,49023168514,8,3340,1174,-40
49031615678,49031615684,6,1674,944,-40
49032601211,49032601193,-18,1701,1412,-40
49033614641,49033614647,6,3760,1549,-40
49037715674,49037715683,9,2784,1431,-40
49040930131,49040930124,-7,1271,6475,-40
49041301660,49041301666,6,2429,1385,-40
49042640511,49042640518,7,5302,1333,-40
49046873822,49046873827,5,1356,980,-40
49049647157,49049647162,5,3976,1294,-40
49050629293,49050629312,19,1083,312,-40
49054816763,49054816766,3,890,1168,-40
49062622393,49062622400,7,4655,1650,-40
49069808318,49069808318,0,1426,1781,-40
49071449499,49071449507,8,2812,1044,-40
49074766378,49074766375,-3,2168,4312,-40
49075215825,49075215830,5,3642,1144,-40
49077575598,49077575602,4,2606,1041,-40
49077663763,49077663753,-10,35772,14456,-40
49078468281,49078468290,9,2267,790,-40
49079820928,49079820932,4,2626,1583,-40
49080082475,49080082474,-1,1567,3507,-40
49081312683,49081312690,7,3009,951,-40
49081950060,49081950057,-3,1622,3790,-40
49083318801,49083318807,6,3152,1330,-40
49084607685,49084607691,6,2404,1139,-40
49092433918,49092433922,4,1856,802,-40
49093843087,49093843095,8,1859,512,-40
49094326777,49094326782,5,1612,749,-40
49098935685,49098935693,8,2315,1028,-40
49099921769,49099921777,8,1840,985,-40
49101834850,49101834855,5,2501,839,-40
49108205593,49108205598,5,2979,1435,-40
49110213718,49110213724,6,2157,1257,-40
49112157034,49112157034,0,984,68,-40
49112306892,49112306891,-1,1074,145,-40
49113679443,49113679446,3,27745,48711,-40
49115338814,49115338819,5,1838,1088,-40
49120406947,49120406957,10,3060,1410,-40
49121857012,49121857013,1,2562,3442,-40
49122868047,49122868053,6,1601,706,-40
49124513553,49124513556,3,12905,17428,-40
49125321438,49125321446,8,3188,962,-40
49125434163,49125434169,6,2972,1353,-40
49126831610,49126831592,-18,2409,866,-40
49128703100,49128703106,6,3159,1138,-40
49129010150,49129010149,-1,2928,5127,-40
49129185653,49129185658,5,2609,1471,-40
49132180497,49132180503,6,2225,842,-40
49133948627,49133948633,6,3016,853,-40
49137142383,49137142390,7,3606,1882,-40
49139245182,49139245188,6,3115,1105,-40
49140133986,49140133991,5,3584,1315,-40
49140481094,49140481100,6,2756,1235,-40
49142797353,49142797370,17,1033,5334,-40
49143915738,49143915744,6,2016,1280,-40
49144092527,49144092505,-22,9120,40685,-40
49144215209,49144215215,6,2381,981,-40
49147366333,49147366338,5,2606,1346,-40
49148062652,49148062657,5,1925,913,-40
49148350590,49148350595,5,1226,515,-40
49150475363,49150475357,-6,548,1869,-40
49155678302,49155678303,1,2837,2512,-40
49155912702,49155912707,5,4283,2092,-40
49157000669,49157000686,17,507,2428,-40
49164496129,49164496134,5,2546,1172,-40
49164705111,49164705098,-13,2691,1220,-40
49164853341,49164853352,11,1850,697,-40
49167463721,49167463727,6,2079,1445,-40
49167576325,49167576330,5,2904,1130,-40
49169731759,49169731769,10,12250,32567,-40
49170609492,49170609497,5,2086,1073,-40
49171674818,49171674822,4,2301,980,-40
49171832126,49171832137,11,1080,189,-40
49173613499,49173613502,3,1291,1884,-40
49177081746,49177081755,9,3492,1441,-40
49181608602,49181608610,8,2846,1750,-40
49190218506,49190218511,5,1807,1133,-40
49193112189,49193112194,5,3233,1284,-40
49195649538,49195649542,4,2229,1866,-40
49196740609,49196740615,6,2224,1167,-40
49197603463,49197603471,8,2918,1960,-40
49198153363,49198153366,3,2264,1233,-40
49200764109,49200764114,5,2882,743,-40
49202627625,49202627631,6,2948,1142,-40
49207313905,49207313911,6,3357,1142,-40
49207844989,49207845000,11,2559,1232,-40
49220986022,49220986018,-4,1110,3365,-40
49223132142,49223132149,7,2925,1712,-40
49227280603,49227280610,7,3444,1306,-40
49227460307,49227460300,-7,1152,382,-40
49228210722,49228210730,8,2971,1275,-40
49228792915,49228792899,-16,1475,211,-40
49234764842,49234764846,4,1626,875,-40
49234972290,49234972275,-15,1527,325,-40
49243492972,49243492979,7,2603,1680,-40
49249810065,49249810070,5,2900,902,-40
49250003474,49250003481,7,2896,1255,-40
49255203966,49255203972,6,2833,1162,-40
49255778985,49255778993,8,2918,1023,-40
49258508774,49258508779,5,2159,1073,-40
49262648628,49262648634,6,4351,1900,-40
49265878345,49265878354,9,2067,1105,-40
49274206391,49274206399,8,3804,1535,-40
49279694829,49279694835,6,2549,1195,-40
49280878930,49280878945,15,12693,53849,-40
49282346337,49282346343,6,3552,1341,-40
49289140406,49289140411,5,3021,1051,-40
49290577510,49290577516,6,2005,1635,-40
49292983317,49292983323,6,3232,1410,-40
49293449301,49293449281,-20,3089,910,-40
49296487119,49296487125,6,2722,1770,-40
49296652627,49296652634,7,3195,1344,-40
49296861025,49296861031,6,3575,1359,-40
49299291735,49299291742,7,2080,946,-40
49304323506,49304323510,4,1726,1281,-40
49312347047,49312347050,3,5500,2570,-40
49315291094,49315291103,9,3715,1267,-40
49316168963,49316168946,-17,2302,1285,-40
49319605036,49319605042,6,3475,1411,-40
49322242339,49322242343,4,2700,1550,-40
49323769413,49323769421,8,3878,1407,-40
49327688977,49327688978,1,1306,1833,-40
49328471987,49328471991,4,3115,1344,-40
49329234721,49329234714,-7,1700,1375,-40
49329838871,49329838854,-17,1169,422,-40
49333178841,49333178847,6,3604,1363,-40
49335334502,49335334511,9,2359,1194,-40
49336961126,49336961133,7,4442,1538,-40
49340135622,49340135628,6,3211,1562,-40
49340524242,49340524246,4,2415,1055,-40
49347924554,49347924561,7,3447,1507,-40
49350964400,49350964405,5,1956,1041,-40
49351975485,49351975482,-3,2878,43826,-40
49354384312,49354384318,6,2253,1259,-40
49357324145,49357324151,6,3917,1380,-40
49365050525,49365050530,5,2799,1525,-40
49367710072,49367710079,7,3892,1408,-40
49368574178,49368574186,8,3146,1384,-40
49383532529,49383532535,6,3111,1194,-40
49385455415,49385455421,6,2299,1287,-40
49386128589,49386128594,5,1561,1302,-40
49387353177,49387353179,2,1662,1418,-40
49392255230,49392255235,5,3265,1373,-40
49393255577,49393255582,5,1895,905,-40
49393641134,49393641139,5,3436,1977,-40
49398108977,49398108982,5,2518,1400,-40
49399275522,49399275531,9,2130,809,-40
49400604249,49400604249,0,1838,2742,-40
49402872269,49402872277,8,3333,1540,-40
49403769801,49403769806,5,2340,1069,-40
49405146412,49405146418,6,2145,1023,-40
49406098183,49406098189,6,2643,1132,-40
49406891149,49406891155,6,2079,873,-40
49410301506,49410301511,5,2828,1600,-40
49416924881,49416924885,4,1882,1140,-40
49417986085,49417986068,-17,2956,1232,-40
49418135571,49418135579,8,3150,1236,-40
49418748517,49418748522,5,2749,1392,-40
49420542698,49420542703,5,2217,1214,-40
49422983238,49422983238,0,25734,21147,-40
49432508975,49432508982,7,3090,1508,-40
49434542861,49434542867,6,2885,1140,-40
49436182679,49436182685,6,2873,1509,-40
49439200681,49439200686,5,3114,1176,-40
49448346750,49448346755,5,3716,1598,-40
49449495910,49449495915,5,2982,1040,-40
49451546580,49451546599,19,520,1263,-40
49453118958,49453118964,6,3558,1608,-40
49454888893,49454888898,5,3393,1368,-40
49455650323,49455650327,4,2350,1557,-40
49455738958,49455738962,4,2484,988,-40
49458471654,49458471661,7,2029,917,-40
49461568578,49461568583,5,2451,1137,-40
49462348913,49462348918,5,4331,1634,-40
49464143056,49464143061,5,2454,955,-40
49468009995,49468010003,8,3471,1705,-40
49470210873,49470210879,6,1970,1256,-40
49476061605,49476061611,6,2946,1168,-40
49478111017,49478111011,-6,1150,3735,-40
49479556336,49479556343,7,3995,1655,-40
49482885819,49482885826,7,2921,767,-40
49482979491,49482979499,8,790,921,-40
49486201861,49486201865,4,1850,869,-40
49491198292,49491198298,6,1921,1463,-40
49491856184,49491856190,6,4613,1509,-40
49492274562,49492274569,7,1899,1048,-40
49495612005,49495612010,5,3450,1323,-40
49495669353,49495669361,8,2440,1342,-40
49496906293,49496906298,5,1726,1325,-40
49499072163,49499072164,1,1885,3597,-40
49500021145,49500021151,6,2300,1706,-40
49501087301,49501087306,5,2497,1209,-40
49503828075,49503828083,8,2674,1165,-40
49504109760,49504109768,8,2374,1245,-40
49506460363,49506460370,7,2635,1160,-40
49516164197,49516164202,5,2291,1185,-40
49516201668,49516201666,-2,1206,301,-40
49518161940,49518161947,7,2831,1656,-40
49518250450,49518250459,9,3151,1063,-40
49521396074,49521396080,6,2978,1115,-40
49521835638,49521835646,8,3118,1633,-40
49527784073,49527784080,7,3515,1221,-40
49533706895,49533706897,2,2178,1362,-40
49535878154,49535878161,7,2699,1284,-40
49536897626,49536897611,-15,1477,203,-40
49539396365,49539396356,-9,888,3845,-40
49539769516,49539769522,6,2061,1104,-40
49541322018,49541322022,4,2205,984,-40
49542104828,49542104834,6,4008,902,-40
49542353550,49542353553,3,1424,1504,-40
49548217078,49548217084,6,2105,856,-40
49548373906,49548373920,14,3257,1626,-40
49549718753,49549718759,6,2870,1047,-40
49551717643,49551717650,7,2781,1146,-40
49552959180,49552959187,7,2730,1326,-40
49553243960,49553243965,5,1124,548,-40
49556934069,49556934076,7,2704,1343,-40
49558477990,49558477971,-19,2752,907,-40
49558962443,49558962449,6,2962,1273,-40
49559894286,49559894291,5,2598,1272,-40
49564879073,49564879080,7,2706,1254,-40
49570035206,49570035214,8,4526,1612,-40
49571482592,49571482598,6,6929,21539,-40
49571920844,49571920830,-14,10498,42768,-40
49572830827,49572830831,4,2634,1275,-40
49577885441,49577885450,9,2151,839,-40
49579142703,49579142692,-11,1024,366,-40
49579268562,49579268569,7,3369,1654,-40
49587404216,49587404223,7,3240,1203,-40
49587794805,49587794812,7,2563,1301,-40
49588207546,49588207551,5,3308,1800,-40
49592910085,49592910091,6,4255,1369,-40
49593855657,49593855660,3,4150,3147,-40
49600638274,49600638279,5,3745,2068,-40
49606030341,49606030345,4,3392,1458,-40
49609385549,49609385554,5,2376,1247,-40
49610937457,49610937462,5,3294,1375,-40
49613811601,49613811597,-4,25338,12706,-40
49619827737,49619827742,5,2718,1174,-40
49621532396,49621532401,5,2909,1192,-40
49624977078,49624977086,8,2633,1393,-40
49632947394,49632947398,4,2690,1470,-40
49634485866,49634485872,6,2516,1184,-40
49634936966,49634936954,-12,915,191,-40
49636242338,49636242344,6,2178,1358,-40
49639060170,49639060175,5,2782,1441,-40
49639183872,49639183889,17,1206,309,-40
49640959674,49640959681,7,2325,1216,-40
49645304793,49645304799,6,1839,1020,-40
49648513578,49648513586,8,2101,1481,-40
49648732012,49648732011,-1,1034,158,-40
49649214347,49649214353,6,2957,1152,-40
49649735455,49649735461,6,2814,1452,-40
49650921692,49650921705,13,2346,1210,-40
49650994128,49650994116,-12,2213,907,-40
49652058727,49652058726,-1,95,896,-40
49652517664,49652517673,9,1222,348,-40
49653960057,49653960064,7,2692,896,-40
49655703051,49655703053,2,2531,2132,-40
49656345049,49656345051,2,1419,1740,-40
49657639109,49657639115,6,3992,1871,-40
49663615574,49663615581,7,2314,1417,-40
49668051005,49668051010,5,2673,1696,-40
49668424876,49668424859,-17,965,426,-40
49670042920,49670042927,7,2816,1651,-40
49670543187,49670543182,-5,1194,4364,-40
49671075964,49671075970,6,1832,1244,-40
49675483939,49675483947,8,2966,910,-40
49679710974,49679710981,7,2691,814,-40
49686051774,49686051779,5,2640,1059,-40
49687465998,49687466002,4,2583,2164,-40
49696447235,49696447234,-1,862,1195,-40
49697954309,49697954314,5,2985,1948,-40
49708849695,49708849702,7,2048,1122,-40
49710038711,49710038729,18,800,198,-40
49710825509,49710825514,5,2699,1375,-40
49714932910,49714932905,-5,849,1672,-40
49716344252,49716344258,6,2873,1599,-40
49719028841,49719028845,4,2428,1346,-40
49721303133,49721303139,6,1967,1101,-40
49722561810,49722561814,4,1928,1603,-40
49728141042,49728141051,9,2595,1451,-40
49737744883,49737744878,-5,1318,4563,-40
49740750236,49740750243,7,1986,857,-40
49741221498,49741221481,-17,965,371,-40
49742286069,49742286075,6,4464,1470,-40
49743544647,49743544632,-15,3139,874,-40
49745946960,49745946965,5,2913,1494,-40
49747237588,49747237593,5,2612,1197,-40
49749318572,49749318577,5,2907,1290,-40
49749548044,49749548049,5,1821,1366,-40
49749773481,49749773467,-14,1019,1906,-40
49751144293,49751144301,8,2424,1059,-40
49758050776,49758050782,6,3513,1227,-40
49759036749,49759036753,4,2486,1111,-40
49760126662,49760126670,8,2662,1612,-40
49762907105,49762907107,2,2611,2443,-40
49763276714,49763276718,4,3695,1493,-40
49763637241,49763637245,4,2509,1239,-40
49765716195,49765716201,6,3616,1799,-40
49767480602,49767480612,10,758,184,-40
49767656568,49767656554,-14,3046,931,-40
49771524225,49771524229,4,1807,1949,-40
49772348626,49772348634,8,1874,839,-40
49773753694,49773753701,7,3082,1285,-40
49773896878,49773896859,-19,702,251,-40
49775060633,49775060638,5,1369,794,-40
49775188858,49775188867,9,3099,1223,-40
49778825315,49778825319,4,2081,1059,-40
49780023669,49780023662,-7,1539,4602,-40
49788069864,49788069865,1,1702,2005,-40
49788822506,49788822502,-4,1131,3957,-40
49790468447,49790468453,6,19799,33772,-40
49792546982,49792546987,5,3647,1380,-40
49793209373,49793209363,-10,1098,397,-40
49793785770,49793785777,7,3747,1386,-40
49795811612,49795811618,6,2518,1149,-40
49799797672,49799797676,4,1855,1341,-40
49804205691,49804205698,7,3431,1197,-40
49804755483,49804755478,-5,1123,2951,-40
49807875399,49807875407,8,2266,1331,-40
49810138743,49810138749,6,4506,1793,-40
49813704376,49813704381,5,2398,1312,-40
49816313435,49816313437,2,1484,2212,-40
49816806630,49816806636,6,3311,1316,-40
49817450362,49817450368,6,2959,1657,-40
49819037448,49819037453,5,3958,2143,-40
49820154855,49820154861,6,2301,1576,-40
49822162702,49822162709,7,2665,1311,-40
49822868718,49822868725,7,2203,1389,-40
49829564915,49829564921,6,4027,1431,-40
49829665186,49829665169,-17,885,365,-40
49832902134,49832902141,7,2961,1080,-40
49834802690,49834802701,11,11718,45917,-40
49835683651,49835683657,6,3653,1380,-40
49842839761,49842839769,8,2454,1076,-40
49844368912,49844368918,6,2153,927,-40
49844858868,49844858873,5,2524,1271,-40
49847030177,49847030183,6,2825,1251,-40
49851235798,49851235802,4,2269,1218,-40
49854205581,49854205587,6,2176,1159,-40
49855804261,49855804267,6,2971,1322,-40
49867521993,49867521999,6,2787,1284,-40
49870132702,49870132707,5,2118,1056,-40
49871962327,49871962335,8,4421,1561,-40
49880028790,49880028796,6,2169,908,-40
49882875023,49882875029,6,2900,1193,-40
49891172335,49891172342,7,3486,1525,-40
49892416497,49892416494,-3,1599,2982,-40
49896607488,49896607492,4,1552,1332,-40
49899617911,49899617918,7,2536,1210,-40
49902438174,49902438182,8,3306,1118,-40
49903669593,49903669598,5,2330,1142,-40
49905365282,49905365288,6,3914,1683,-40
49906514734,49906514722,-12,1453,467,-40
49917770821,49917770827,6,2166,1754,-40
49919354202,49919354209,7,3552,1493,-40
49922406430,49922406437,7,3316,1588,-40
49927118235,49927118243,8,3525,1091,-40
49929957641,49929957646,5,1960,856,-40
49936182105,49936182110,5,1575,939,-40
49939314310,49939314315,5,3255,1230,-40
49940347508,49940347513,5,3349,1069,-40
49941582614,49941582619,5,2511,1174,-40
49943213298,49943213303,5,2052,951,-40
49944062237,49944062245,8,3474,1614,-40
49945522098,49945522087,-11,1243,170,-40
49947192618,49947192624,6,3618,1587,-40
49949367166,49949367161,-5,1398,2612,-40
49955325365,49955325371,6,3307,1233,-40
49956514151,49956514162,11,2173,1166,-40
49959836062,49959836066,4,2482,1331,-40
49962680657,49962680660,3,1679,1554,-40
49962970749,49962970754,5,4927,2748,-40
49964258884,49964258889,5,2769,1191,-40
49971657340,49971657347,7,2519,1084,-40
49972270457,49972270462,5,3929,1436,-40
49973990574,49973990564,-10,727,168,-40
49982554131,49982554138,7,2891,1199,-40
49983351735,49983351741,6,3238,1858,-40
49983546409,49983546413,4,1937,1399,-40
49984021754,49984021760,6,3669,1805,-40
49984877041,49984877048,7,3136,1324,-40
49990011431,49990011437,6,3198,1711,-40
49990790340,49990790347,7,2928,1190,-40
49993011348,49993011355,7,2670,799,-40
49995481731,49995481744,13,321,71,-40
49996176021,49996176020,-1,2074,1928,-40
49997156634,49997156643,9,1915,1417,-40
50000743155,50000743162,7,2956,1148,-40
50003050379,50003050384,5,3297,1061,-40
50004249587,50004249593,6,2579,1426,-40
50007658309,50007658318,9,14064,36033,-40
50010684998,50010685006,8,1927,880,-40
50011945660,50011945666,6,2309,1184,-40
50013886140,50013886148,8,2733,967,-40
50018247191,50018247195,4,2741,964,-40
50021608593,50021608575,-18,1289,387,-40
50022669838,50022669845,7,3290,1178,-40
50023027544,50023027561,17,2304,1571,-40
50028566651,50028566658,7,3332,1230,-40
50030209846,50030209853,7,1870,1079,-40
50030823676,50030823683,7,2845,1273,-40
50032356428,50032356433,5,3179,1722,-40
50033194089,50033194095,6,3236,1406,-40
50034594984,50034594991,7,2413,969,-40
50036667366,50036667373,7,2679,1344,-40
50036818035,50036818020,-15,806,284,-40
50039122242,50039122249,7,1931,1368,-40
50041601071,50041601077,6,2628,1923,-40
50042706900,50042706901,1,1176,1526,-40
50043448078,50043448067,-11,963,336,-40
50044184428,50044184435,7,2786,1490,-40
50046397435,50046397443,8,2349,1242,-40
50051763498,50051763505,7,13950,5382,-40
50058128661,50058128666,5,3138,1102,-40
50062297554,50062297561,7,3207,1371,-40
50063971598,50063971604,6,2393,1262,-40
50067438671,50067438672,1,2553,2776,-40
50071753675,50071753690,15,26495,13055,-40
50076588945,50076588951,6,4072,1665,-40
50081307459,50081307466,7,2801,1383,-40
50086164848,50086164854,6,4367,1553,-40
50089801475,50089801481,6,3645,1619,-40
50090724659,50090724651,-8,1498,33591,-40
50094751390,50094751397,7,4053,1790,-40
50095480001,50095480001,0,1757,2949,-40
50099483466,50099483473,7,3083,1294,-40
50102513118,50102513139,21,2176,1396,-40
50105551726,50105551732,6,2898,1327,-40
50105828934,50105828954,20,1959,748,-40
50107528350,50107528357,7,1255,803,-40
50112760042,50112760047,5,2392,1123,-40
50115015462,50115015463,1,1465,1106,-40
50117902281,50117902287,6,2371,1296,-40
50118172810,50118172818,8,2480,1502,-40
50118483769,50118483784,15,2186,690,-40
50122869814,50122869819,5,2693,1505,-40
50124938675,50124938669,-6,1464,5698,-40
50143885796,50143885805,9,2617,1375,-40
50148089041,50148089048,7,4701,1396,-40
50160739217,50160739223,6,2517,1558,-40
50161876310,50161876316,6,3190,1565,-40
50162243969,50162243976,7,2139,1313,-40
50172023171,50172023173,2,3589,1334,-40
50176076839,50176076846,7,4396,2136,-40
50176221996,50176222000,4,1866,1309,-40
50178523192,50178523198,6,4263,1589,-40
50179778438,50179778446,8,3483,1416,-40
50180273754,50180273761,7,2820,1264,-40
50180890556,50180890539,-17,2593,1166,-40
50182996961,50182996966,5,2579,1255,-40
50186995600,50186995606,6,1363,681,-40
50190286435,50190286442,7,2597,1393,-40
50191493069,50191493074,5,3084,1961,-40
50194537355,50194537360,5,2884,1531,-40
50195499233,50195499238,5,2434,1167,-40
50200568520,50200568513,-7,2643,9629,-40
50201225087,50201225094,7,4132,1238,-40
50202667418,50202667423,5,2306,1130,-40
50208462657,50208462663,6,3532,1352,-40
50212142814,50212142819,5,3040,1253,-40
50219867931,50219867937,6,3920,1602,-40
50220694414,50220694422,8,2496,1253,-40
50223477850,50223477848,-2,856,3359,-40
50224352558,50224352563,5,1879,909,-40
50230336395,50230336399,4,3201,1255,-40
50231012423,50231012400,-23,1829,694,-40
50232382054,50232382058,4,2456,1957,-40
50232718811,50232718818,7,2738,1351,-40
50235238954,50235238962,8,2482,1384,-40
50237465404,50237465410,6,3060,1242,-40
50239843926,50239843920,-6,1316,6484,-40
50239946631,50239946637,6,2391,1003,-40
50240421602,50240421608,6,1554,815,-40
50241298543,50241298549,6,3571,1585,-40
50243995027,50243995034,7,2492,1319,-40
50250529168,50250529175,7,2697,1697,-40
50251109470,50251109477,7,3973,1438,-40
50255401238,50255401243,5,1708,1176,-40
50257414752,50257414758,6,2321,966,-40
50257900898,50257900899,1,2159,1427,-40
50262947769,50262947774,5,3098,2017,-40
50264270840,50264270846,6,1621,717,-40
50265007054,50265007062,8,3263,1303,-40
50265824230,50265824237,7,3994,1345,-40
50266163847,50266163856,9,837,198,-40
50277957023,50277957029,6,14720,21440,-40
50288507489,50288507493,4,2056,1369,-40
50288781310,50288781318,8,3609,1168,-40
50291691117,50291691122,5,2605,958,-40
50292069358,50292069339,-19,3428,1996,-40
50292861310,50292861315,5,2623,1259,-40
50296746743,50296746748,5,3828,1526,-40
50305089778,50305089787,9,3450,1136,-40
50305334791,50305334801,10,2911,1084,-40
50308630066,50308630073,7,3062,978,-40
50308741327,50308741316,-11,973,416,-40
50311954929,50311954934,5,4150,1601,-40
50312464010,50312464014,4,2669,1543,-40
50321400358,50321400363,5,2016,1164,-40
50322559470,50322559477,7,2189,1092,-40
50323945734,50323945739,5,2170,1290,-40
50324120221,50324120226,5,2571,1082,-40
50325863650,50325863653,3,1045,1365,-40
50330338151,50330338157,6,3467,1616,-40
50337364649,50337364654,5,1702,990,-40
50337576842,50337576849,7,2329,1086,-40
50338835022,50338835026,4,2375,1511,-40
50343203003,50343203011,8,3621,1329,-40
50343912974,50343912952,-22,1209,330,-40
50348950754,50348950748,-6,2351,6946,-40
50351126694,50351126698,4,3665,1573,-40
50351847475,50351847477,2,2888,2701,-40
50355382422,50355382430,8,2748,1041,-40
50356017030,50356017034,4,2562,1198,-40
50359223726,50359223713,-13,1074,14437,-40
50363028822,50363028828,6,3565,1628,-40
50364453789,50364453798,9,2678,1544,-40
50366457945,50366457953,8,6651,2904,-40
50368391794,50368391799,5,3231,1572,-40
50368625879,50368625868,-11,3716,1106,-40
50368761914,50368761932,18,872,222,-40
50369955382,50369955380,-2,3018,4466,-40
50370263285,50370263274,-11,1053,460,-40
50375788597,50375788602,5,2078,1018,-40
50376560750,50376560756,6,3517,1536,-40
50377098384,50377098389,5,3714,1806,-40
50377399574,50377399581,7,3987,1496,-40
50377817011,50377817017,6,1642,808,-40
50380211039,50380211046,7,3997,1797,-40
50380510737,50380510743,6,2635,1446,-40
50382455605,50382455611,6,2089,1571,-40
50383511652,50383511660,8,3108,1123,-40
50385019926,50385019932,6,3116,1298,-40
50397712822,50397712830,8,2507,1293,-40
50410728632,50410728639,7,2310,1552,-40
50412086649,50412086654,5,3859,2016,-40
50414201810,50414201818,8,2032,1375,-40
50414751173,50414751178,5,1814,763,-40
50415504265,50415504270,5,3099,1368,-40
50416692112,50416692118,6,3803,1804,-40
50416897391,50416897398,7,4463,2187,-40
50420152082,50420152089,7,2754,1307,-40
50421999385,50421999391,6,1242,1081,-40
50431045897,50431045902,5,2595,1014,-40
50432567578,50432567585,7,2369,1056,-40
50432735918,50432735897,-21,1689,882,-40
50438715791,50438715797,6,3122,1248,-40
50438868681,50438868697,16,1036,858,-40
50439720177,50439720183,6,3253,1625,-40
50440411906,50440411903,-3,2152,4151,-40
50440854678,50440854682,4,2687,930,-40
50441187541,50441187547,6,2224,1128,-40
50442613097,50442613101,4,1525,1696,-40
50443858948,50443858954,6,2940,1251,-40
50444143628,50444143634,6,2252,1464,-40
50446003044,50446003050,6,2955,1028,-40
50449204035,50449204041,6,3532,1217,-40
50452572362,50452572370,8,3592,1440,-40
50453570026,50453570028,2,1913,1197,-40
50463812695,50463812702,7,2924,1228,-40
50469890406,50469890413,7,2351,1559,-40
50473347735,50473347743,8,3233,1341,-40
50478736062,50478736067,5,2498,1404,-40
50480634790,50480634796,6,2736,1212,-40
50481854711,50481854719,8,2219,904,-40
50482273297,50482273303,6,3111,1141,-40
50482428070,50482428064,-6,1896,5826,-40
50482944054,50482944061,7,2971,1510,-40
50484290546,50484290553,7,3573,999,-40
50487920327,50487920332,5,2516,1719,-40
50488341553,50488341551,-2,2671,45448,-40
50489538125,50489538131,6,3060,1098,-40
50491781367,50491781373,6,3636,1137,-40
50496602496,50496602500,4,3223,1889,-40
50498337189,50498337195,6,3598,1851,-40
50499713182,50499713189,7,2791,1671,-40
50500805838,50500805844,6,2402,1537,-40
50500904736,50500904744,8,1548,1352,-40
50503505060,50503505066,6,1929,816,-40
50504856637,50504856643,6,2890,1567,-40
50511208129,50511208127,-2,1053,1412,-40
50512813381,50512813386,5,3248,1510,-40
50513836257,50513836241,-16,1173,359,-40
50517322806,50517322811,5,2445,829,-40
50517934670,50517934674,4,1595,939,-40
50521200043,50521200049,6,2917,1846,-40
50522638477,50522638483,6,2793,1315,-40
50523350462,50523350441,-21,2257,1128,-40
50523598478,50523598499,21,894,221,-40
50523704326,50523704315,-11,781,186,-40
50526125134,50526125141,7,3329,1348,-40
50529273065,50529273074,9,11741,21213,-40
50533965970,50533965973,3,4608,3381,-40
50534204102,50534204109,7,2360,840,-40
50537794417,50537794425,8,5141,1781,-40
50541761193,50541761198,5,3048,1348,-40
50542952033,50542952040,7,2348,1125,-40
50546840407,50546840412,5,3587,1918,-40
50547005911,50547005917,6,4380,1537,-40
50547051365,50547051359,-6,741,2061,-40
50548654482,50548654479,-3,1198,1464,-40
50549041291,50549041297,6,1777,1231,-40
50550984561,50550984567,6,3422,1041,-40
50552016679,50552016686,7,2594,1256,-40
50554415341,50554415345,4,3093,1160,-40
50559271310,50559271315,5,2338,858,-40
50562030877,50562030883,6,2111,1330,-40
50568937152,50568937159,7,4011,1550,-40
50570021250,50570021254,4,4067,3037,-40
50572198914,50572198900,-14,2551,1364,-40
50580259465,50580259471,6,2433,1001,-40
50580348481,50580348487,6,1803,890,-40
50580608839,50580608856,17,891,221,-40
50582238818,50582238825,7,3145,1170,-40
50582338983,50582338979,-4,871,280,-40
50586403202,50586403197,-5,1080,2794,-40
50590987448,50590987455,7,2852,1155,-40
50596051454,50596051453,-1,1159,2716,-40
50599630604,50599630611,7,2659,1127,-40
50604344830,50604344835,5,2494,1346,-40
50607084716,50607084719,3,1809,1239,-40
50611909521,50611909526,5,3214,1533,-40
50612481733,50612481739,6,2542,1579,-40
50615028636,50615028638,2,22267,14596,-40
50616732550,50616732555,5,2063,379,-40
50622286246,50622286251,5,2481,1143,-40
50629608269,50629608275,6,3234,1452,-40
50630468352,50630468358,6,2363,1304,-40
50632356805,50632356813,8,2627,1525,-40
50633131558,50633131564,6,2747,1096,-40
50633904867,50633904873,6,2787,1305,-40
50637312929,50637312934,5,2230,1093,-40
50637513486,50637513499,13,1195,2131,-40
50638551474,50638551478,4,1773,892,-40
50638787743,50638787755,12,4648,1162,-40
50643269571,50643269577,6,1118,1023,-40
50647777953,50647777961,8,3691,1525,-40
50648151203,50648151186,-17,860,165,-40
50651723462,50651723468,6,2851,991,-40
50652244381,50652244387,6,3436,1089,-40
50653151797,50653151804,7,2513,1059,-40
50655977074,50655977082,8,6379,1989,-40
50657189249,50657189255,6,2457,1204,-40
50659239982,50659239986,4,1586,690,-40
50668313805,50668313810,5,3343,1523,-40
50669830900,50669830906,6,2965,1201,-40
50675915365,50675915372,7,4006,1651,-40
50680248563,50680248570,7,3906,1299,-40
50681696625,50681696626,1,1394,1894,-40
50685140478,50685140482,4,1866,1449,-40
50685494430,50685494409,-21,2978,1548,-40
50687940402,50687940410,8,3824,1230,-40
50688177197,50688177202,5,3819,1678,-40
50694850353,50694850358,5,3878,1735,-40
50698986414,50698986418,4,3727,1436,-40
50699215210,50699215208,-2,1176,2141,-40
50701990015,50701990021,6,2515,1292,-40
50703153450,50703153458,8,2928,1252,-40
50705144501,50705144509,8,4601,1636,-40
50705191003,50705191005,2,2895,2791,-40
50705754926,50705754933,7,2592,1011,-40
50706032648,50706032634,-14,3355,1206,-40
50707492050,50707492057,7,3698,1546,-40
50708647841,50708647827,-14,1759,1144,-40
50709791693,50709791694,1,2031,1778,-40
50711964717,50711964721,4,2399,883,-40
50713021483,50713021466,-17,492,38,-40
50714826051,50714826055,4,749,285,-40
50716963122,50716963106,-16,864,229,-40
50722011499,50722011501,2,2049,2300,-40
50723682294,50723682301,7,3036,1326,-40
50724469652,50724469658,6,2873,1071,-40
50724549360,50724549362,2,613,1,-40
50725376249,50725376235,-14,1473,536,-40
50727896003,50727895980,-23,1264,2172,-40
50729125839,50729125845,6,2838,1192,-40
50734168026,50734168033,7,3903,1555,-40
50734576783,50734576779,-4,1660,6829,-40
50736781525,50736781531,6,3390,1131,-40
50741108606,50741108613,7,3554,1364,-40
50744073294,50744073301,7,2986,1263,-40
50744386766,50744386772,6,1824,1787,-40
50748608650,50748608655,5,2869,1435,-40
50749874710,50749874717,7,2204,1232,-40
50750245286,50750245297,11,3379,1278,-40
50759419385,50759419391,6,2404,1307,-40
50763037786,50763037790,4,2123,1114,-40
50764239278,50764239286,8,4076,1296,-40
50767950263,50767950269,6,1843,834,-40
50770436615,50770436613,-2,941,1557,-40
50771069106,50771069109,3,2653,2559,-40
50777168976,50777168982,6,3478,1653,-40
50779175241,50779175249,8,3012,1529,-40
50780258733,50780258740,7,3072,1115,-40
50780657850,50780657836,-14,1726,932,-40
50781457607,50781457614,7,2968,1115,-40
50781624018,50781624003,-15,2590,958,-40
50784754029,50784754035,6,2927,1149,-40
50786376570,50786376577,7,3638,1578,-40
50786613115,50786613123,8,3010,1165,-40
50787852205,50787852210,5,3656,1474,-40
50789356967,50789356972,5,893,149,-40
50789585162,50789585169,7,3440,1615,-40
50790423846,50790423854,8,2626,1170,-40
50794443779,50794443785,6,2643,1418,-40
50794924322,50794924330,8,2583,1307,-40
50808760243,50808760250,7,2061,1038,-40
50812495631,50812495622,-9,1521,951,-40
50812955203,50812955210,7,3359,1399,-40
50815618322,50815618330,8,2892,1462,-40
50815976502,50815976480,-22,2626,1217,-40
50816042203,50816042184,-19,2666,1598,-40
50817694299,50817694297,-2,2827,3595,-40
50818220304,50818220310,6,1919,1281,-40
50818865227,50818865209,-18,2110,651,-40
50820170354,50820170356,2,1017,1783,-40
50821439282,50821439289,7,3525,1307,-40
50824611734,50824611734,0,2021,1866,-40
50825241653,50825241658,5,2322,1059,-40
50829292536,50829292542,6,2430,1097,-40
50830075349,50830075354,5,2635,1609,-40
50832800826,50832800833,7,2308,1556,-40
50836680410,50836680410,0,1106,1600,-40
50839487943,50839487950,7,2954,1328,-40
50840381415,50840381396,-19,3319,1721,-40
50841815963,50841815969,6,2144,1337,-40
50841853617,50841853625,8,2940,1142,-40
50841897059,50841897042,-17,654,235,-40
50848519202,50848519210,8,2300,857,-40
50857772766,50857772773,7,3485,1151,-40
50858197549,50858197555,6,1602,954,-40
50861243966,50861243974,8,2811,1465,-40
50862524211,50862524217,6,4241,1426,-40
50864076165,50864076171,6,3270,1106,-40
50865635109,50865635115,6,3769,1097,-40
50865976393,50865976400,7,5050,1583,-40
50873759309,50873759318,9,2607,959,-40
50877747147,50877747153,6,2195,1120,-40
50879474630,50879474635,5,4097,1817,-40
50882266701,50882266707,6,1845,799,-40
50882728869,50882728874,5,2447,724,-40
50882835566,50882835574,8,2932,1514,-40
50888541841,50888541847,6,2770,1461,-40
50889617369,50889617371,2,1584,1828,-40
50890989423,50890989401,-22,1814,819,-40
50892386994,50892387001,7,3247,1598,-40
50897793706,50897793700,-6,1206,4058,-40
50899360686,50899360692,6,2277,1658,-40
50899816284,50899816291,7,3450,1283,-40
50900424587,50900424571,-16,748,5,-40
50902424576,50902424582,6,2527,1194,-40
50902788144,50902788155,11,3272,1220,-40
50905066013,50905066018,5,3225,1793,-40
50910235429,50910235435,6,2733,1008,-40
50913489041,50913489045,4,1919,1415,-40
50919036007,50919036013,6,2188,991,-40
50922520727,50922520733,6,3641,1679,-40
50922562395,50922562389,-6,1014,2963,-40
50923605868,50923605874,6,2260,1276,-40
50929914489,50929914495,6,2148,763,-40
50931598107,50931598113,6,2147,1179,-40
50931837149,50931837155,6,2198,1274,-40
50932205406,50932205413,7,2126,1090,-40
50935347970,50935347978,8,3040,945,-40
50935930321,50935930327,6,2773,1188,-40
50938209390,50938209393,3,2093,1538,-40
50941466329,50941466326,-3,27310,71735,-40
50941705647,50941705651,4,2782,1324,-40
50942038005,50942038009,4,2543,1093,-40
50942201099,50942201105,6,2759,1273,-40
50943272443,50943272452,9,2799,1716,-40
50945456318,50945456323,5,2139,1060,-40
50946938623,50946938621,-2,1179,1765,-40
50949155108,50949155114,6,3542,1829,-40
50949380664,50949380673,9,3149,809,-40
50949642936,50949642939,3,1721,1092,-40
50950510644,50950510656,12,4757,1596,-40
50950594906,50950594921,15,2549,1680,-40
50954067738,50954067743,5,2130,1130,-40
50960656973,50960656979,6,2725,1189,-40
50965205506,50965205514,8,2387,984,-40
50970961003,50970960997,-6,867,4207,-40
50971498865,50971498871,6,1312,789,-40
50972058538,50972058521,-17,2317,910,-40
50974136238,50974136245,7,2798,725,-40
50976265650,50976265654,4,2533,1382,-40
50981255448,50981255454,6,2938,1238,-40
50986341449,50986341451,2,3677,18240,-40
50988816704,50988816718,14,246,864,-40
50992604510,50992604517,7,1735,1469,-40
50994413138,50994413142,4,3532,1437,-40
50994457414,50994457420,6,2477,1094,-40
50995856472,50995856458,-14,2533,1113,-40
50997290726,50997290718,-8,1265,3473,-40
51005052237,51005052242,5,1733,1111,-40
51009808011,51009808017,6,2565,1268,-40
51010465838,51010465845,7,3089,1228,-40
51015405093,51015405096,3,2201,1609,-40
51017384817,51017384821,4,4409,2976,-40
51023748158,51023748159,1,35619,23589,-40
51025403730,51025403737,7,2401,986,-40
51027061078,51027061082,4,2655,908,-40
51031892870,51031892878,8,2487,1083,-40
51033152705,51033152700,-5,1824,6005,-40
51033376086,51033376090,4,2057,1216,-40
51035647726,51035647734,8,3382,1691,-40
51040067976,51040067982,6,1650,1199,-40
51040354198,51040354179,-19,2940,957,-40
51040610941,51040610923,-18,1781,1453,-40
51042195553,51042195558,5,2077,852,-40
51042868297,51042868302,5,3436,1378,-40
51043419314,51043419318,4,1986,910,-40
51045452594,51045452601,7,4467,1412,-40
51047962374,51047962377,3,2895,1385,-40
51048145825,51048145812,-13,1722,863,-40
51060463818,51060463826,8,2573,1057,-40
51063521813,51063521821,8,2247,961,-40
51064415571,51064415578,7,3805,1549,-40
51067395567,51067395574,7,2264,1486,-40
51080862017,51080862014,-3,456,1047,-40
51083616118,51083616120,2,1406,1356,-40
51087967001,51087967007,6,2100,1012,-40
51089581913,51089581918,5,2820,1484,-40
51089972332,51089972338,6,1773,471,-40
51090152366,51090152371,5,2772,937,-40
51090846173,51090846185,12,2382,727,-40
51091857080,51091857089,9,1695,745,-40
51091914477,51091914484,7,3667,1627,-40
51104476894,51104476899,5,2552,1184,-40
51105729575,51105729581,6,3911,1583,-40
51106434277,51106434283,6,2678,1102,-40
51108007566,51108007569,3,2078,1243,-40
51108381726,51108381707,-19,1133,575,-40
51109703700,51109703706,6,2088,1274,-40
51110098590,51110098589,-1,20651,16210,-40
51114053887,51114053883,-4,5052,11097,-40
51114376544,51114376550,6,2260,1172,-40
51117015542,51117015542,0,2072,1598,-40
51118099323,51118099326,3,4120,3230,-40
51118848766,51118848773,7,3762,1530,-40
51119052426,51119052410,-16,2941,1008,-40
51123499077,51123499083,6,3448,1225,-40
51125552681,51125552687,6,2709,1768,-40
51125993013,51125993018,5,3021,1136,-40
51127912206,51127912212,6,2719,1358,-40
51130889222,51130889228,6,3490,1684,-40
51133100414,51133100422,8,3225,1237,-40
51133212136,51133212141,5,2825,1283,-40
51136859436,51136859442,6,2158,1142,-40
51137201487,51137201464,-23,2755,844,-40
51142048887,51142048893,6,2971,1327,-40
51145667319,51145667325,6,2856,2028,-40
51146917633,51146917638,5,2785,1199,-40
51146985905,51146985915,10,2040,793,-40
51149136765,51149136770,5,1137,681,-40
51165526952,51165526958,6,3366,1080,-40
51166188149,51166188155,6,2752,1447,-40
51167453906,51167453914,8,3321,1218,-40
51167994932,51167994938,6,3208,1005,-40
51173072143,51173072125,-18,1164,318,-40
51181042387,51181042396,9,2432,1271,-40
51183834147,51183834154,7,2858,1155,-40
51184051506,51184051522,16,759,89,-40
51186515204,51186515198,-6,1332,1619,-40
51187868438,51187868444,6,3904,1757,-40
51189752453,51189752459,6,3422,1025,-40
51190071453,51190071460,7,1819,1221,-40
51190856438,51190856443,5,2912,1367,-40
51201112790,51201112798,8,3898,976,-40
51201516878,51201516881,3,865,347,-40
51208062465,51208062472,7,1540,1429,-40
51210506106,51210506111,5,1721,992,-40
51210957682,51210957665,-17,1367,256,-40
51213885922,51213885927,5,3005,1423,-40
51216091349,51216091356,7,3747,1810,-40
51216699307,51216699313,6,2369,770,-40
51218386753,51218386761,8,3634,1503,-40
51220167575,51220167580,5,3635,1281,-40
51222018604,51222018609,5,1758,683,-40
51222628496,51222628502,6,2153,1008,-40
51222836045,51222836027,-18,1106,846,-40
51231314282,51231314278,-4,950,2580,-40
51231552565,51231552571,6,2741,995,-40
51235658865,51235658870,5,2417,1353,-40
51237068613,51237068618,5,3102,1382,-40
51238141562,51238141569,7,3701,1337,-40
51239237514,51239237519,5,2462,1389,-40
51240172010,51240172017,7,3020,1161,-40
51240657274,51240657279,5,2574,1059,-40
51243830718,51243830710,-8,1681,28361,-40
51244196434,51244196442,8,2810,1351,-40
51245184456,51245184463,7,2794,1071,-40
51246235175,51246235180,5,3531,1115,-40
51248477641,51248477647,6,4241,1412,-40
51248610773,51248610778,5,3380,1749,-40
51249098218,51249098226,8,2400,1280,-40
51250178482,51250178467,-15,2014,805,-40
51251203555,51251203562,7,3636,1206,-40
51254974203,51254974210,7,3844,1531,-40
51255541673,51255541681,8,1597,944,-40
51257557074,51257557079,5,2217,1082,-40
51258884158,51258884157,-1,1313,1894,-40
51264565217,51264565221,4,2528,1710,-40
51267380514,51267380518,4,1882,1711,-40
51267625654,51267625659,5,2013,1530,-40
51268047606,51268047612,6,2477,1298,-40
51270408410,51270408415,5,3052,1019,-40
51270476389,51270476400,11,1108,358,-40
51283087897,51283087901,4,3110,1767,-40
51291806558,51291806563,5,3031,1691,-40
51293102370,51293102379,9,2397,1008,-40
51296601274,51296601279,5,2662,1039,-40
51296816035,51296816051,16,1978,773,-40
51311804106,51311804108,2,1657,1956,-40
51314227078,51314227085,7,3974,1411,-40
51317096525,51317096530,5,2558,915,-40
51318323310,51318323305,-5,982,2103,-40
51323891009,51323891014,5,2964,1326,-40
51325721581,51325721562,-19,1519,426,-40
51334748866,51334748873,7,2702,1348,-40
51338123684,51338123690,6,4861,979,-40
51338620692,51338620698,6,3478,1516,-40
51340248490,51340248497,7,3499,1533,-40
51340293394,51340293401,7,2702,1374,-40
51341368811,51341368818,7,3011,1534,-40
51343039046,51343039051,5,2558,916,-40
51347927949,51347927953,4,1660,1179,-40
51348381629,51348381635,6,2556,1615,-40
51348717956,51348717963,7,3669,1072,-40
51350054025,51350054004,-21,3231,1412,-40
51357216915,51357216922,7,2755,1110,-40
51359378560,51359378567,7,2491,1490,-40
51361494813,51361494818,5,3080,1421,-40
51361722402,51361722409,7,2382,780,-40
51364560248,51364560254,6,2308,1287,-40
51365998749,51365998754,5,2720,1292,-40
51377584979,51377584983,4,3650,1134,-40
51382477180,51382477177,-3,1630,4473,-40
51383072570,51383072577,7,2663,1108,-40
51388057005,51388057014,9,2823,1307,-40
51394917867,51394917873,6,2473,1367,-40
51396451917,51396451923,6,2267,1146,-40
51397926043,51397926047,4,2239,967,-40
51400434423,51400434428,5,3064,1404,-40
51401344591,51401344577,-14,1777,903,-40
51404696998,51404697003,5,2242,874,-40
51407151625,51407151630,5,2496,1089,-40
51407802314,51407802319,5,3320,1323,-40
51407921292,51407921298,6,3295,1288,-40
51411834689,51411834694,5,2337,1076,-40
51420046017,51420046022,5,2726,1253,-40
51420272313,51420272318,5,2509,1249,-40
51423157734,51423157721,-13,1463,378,-40
51432025888,51432025895,7,3718,1459,-40
51436847980,51436847986,6,3055,1551,-40
51442872133,51442872139,6,1891,1108,-40
51443402851,51443402858,7,3280,1884,-40
51444801207,51444801213,6,3840,1535,-40
51449243525,51449243532,7,2350,850,-40
51451135057,51451135063,6,2826,1256,-40
51455640832,51455640838,6,3138,1218,-40
51459411726,51459411734,8,2434,1207,-40
51460792123,51460792128,5,2774,1263,-40
51463879745,51463879751,6,2258,809,-40
51467489809,51467489814,5,2999,1179,-40
51468353986,51468353991,5,3433,1315,-40
51468477269,51468477275,6,4364,1721,-40
51473716815,51473716823,8,912,628,-40
51475727257,51475727263,6,2125,1002,-40
51479533188,51479533172,-16,2279,1425,-40
51486710700,51486710703,3,25987,37999,-40
51488850074,51488850081,7,2614,948,-40
51491158913,51491158919,6,1430,812,-40
51491313753,51491313737,-16,861,53,-40
51495341938,51495341946,8,3082,1497,-40
51495506998,51495507003,5,2516,908,-40
51495834754,51495834761,7,3643,1311,-40
51496249893,51496249898,5,1898,883,-40
51497531659,51497531658,-1,30420,20547,-40
51502527425,51502527430,5,2408,894,-40
51509200266,51509200271,5,2689,1594,-40
51510387154,51510387161,7,2979,1206,-40
51519622389,51519622394,5,3208,1806,-40
51519947251,51519947245,-6,1460,4661,-40
51522126886,51522126891,5,2656,1234,-40
51524925222,51524925230,8,2807,842,-40
51526369761,51526369766,5,2643,1267,-40
51533460076,51533460082,6,2860,1348,-40
51534550610,51534550613,3,1385,1501,-40
51535583183,51535583191,8,2970,1771,-40
51535891911,51535891899,-12,1465,477,-40
51537228571,51537228577,6,2197,1052,-40
51541205481,51541205487,6,2259,1250,-40
51542019034,51542019042,8,2659,1494,-40
51544186209,51544186215,6,2225,1399,-40
51550526769,51550526776,7,3942,1166,-40
51551766767,51551766773,6,3058,1270,-40
51554023883,51554023884,1,1491,2145,-40
51555420869,51555420874,5,1955,1056,-40
51561503457,51561503465,8,2913,1785,-40
51561690510,51561690498,-12,974,362,-40
51563612365,51563612370,5,2645,1500,-40
51563851230,51563851234,4,2223,1584,-40
51564254420,51564254427,7,2892,1151,-40
51564303118,51564303122,4,2319,1217,-40
51567188064,51567188069,5,3805,1513,-40
51567555498,51567555482,-16,3261,1688,-40
51572917315,51572917318,3,1903,937,-40
51576458648,51576458648,0,2024,3277,-40
51579928978,51579928985,7,2474,617,-40
51580153047,51580153024,-23,1294,542,-40
51587362729,51587362733,4,3242,1678,-40
51587469385,51587469391,6,3344,1166,-40
51587557306,51587557310,4,2694,1373,-40
51591651114,51591651122,8,2332,1160,-40
51595380288,51595380272,-16,2061,1112,-40
51595795398,51595795403,5,1810,1361,-40
51599888693,51599888699,6,2627,1369,-40
51602602675,51602602655,-20,489,293,-40
51604004017,51604004022,5,2794,1187,-40
51604970128,51604970133,5,3689,1400,-40
51607896033,51607896038,5,2845,1148,-40
51608869934,51608869941,7,2356,1050,-40
51609543677,51609543682,5,2197,673,-40
51611566734,51611566740,6,2978,948,-40
51612693182,51612693189,7,2690,841,-40
51613130347,51613130353,6,2034,765,-40
51620405873,51620405878,5,3343,1354,-40
51622893256,51622893255,-1,5745,10065,-40
51623825503,51623825509,6,3214,1418,-40
51624555410,51624555415,5,2411,1252,-40
51625047489,51625047491,2,2279,2034,-40
51625547094,51625547101,7,3224,1172,-40
51628250714,51628250719,5,1440,1561,-40
51629548950,51629548956,6,2771,1296,-40
51630613399,51630613406,7,3422,1110,-40
51642040223,51642040229,6,3783,1546,-40
51642192461,51642192467,6,3024,1208,-40
51644336155,51644336151,-4,1502,4969,-40
51649413381,51649413383,2,3831,3520,-40
51650811700,51650811705,5,11287,6081,-40
51651713333,51651713339,6,1920,1317,-40
51655337433,51655337437,4,2707,1313,-40
51655438485,51655438491,6,2723,1210,-40
51660603815,51660603817,2,2146,2522,-40
51660965685,51660965686,1,2488,2766,-40
51662225975,51662225976,1,1296,2429,-40
51664756097,51664756102,5,1997,963,-40
51670593844,51670593851,7,3379,1070,-40
51675388944,51675388953,9,2762,1271,-40
51676430580,51676430577,-3,2432,3825,-40
51682367329,51682367334,5,2057,1567,-40
51683189229,51683189233,4,3540,1587,-40
51688242581,51688242589,8,2820,1192,-40
51689105934,51689105938,4,1818,1504,-40
51689780593,51689780600,7,2459,1067,-40
51700944533,51700944540,7,2136,1314,-40
51701069478,51701069459,-19,1807,728,-40
51702867365,51702867371,6,3086,1439,-40
51705363419,51705363421,2,1293,1763,-40
51706815415,51706815418,3,1792,1215,-40
51708382359,51708382357,-2,781,2167,-40
51708597772,51708597779,7,1686,1129,-40
51708666290,51708666298,8,561,246,-40
51708696779,51708696770,-9,2053,33482,-40
51712015850,51712015857,7,6494,1923,-40
51712946233,51712946238,5,3546,1595,-40
51720095501,51720095505,4,2305,1437,-40
51724951954,51724951959,5,3344,1674,-40
51726214978,51726214960,-18,2175,1422,-40
51726434681,51726434687,6,3248,1125,-40
51726757574,51726757553,-21,2809,1335,-40
51738580961,51738580966,5,3043,1221,-40
51742538586,51742538591,5,10075,4861,-40
51751338031,51751338037,6,3112,1300,-40
51752459134,51752459141,7,2929,1167,-40
51752868738,51752868744,6,1899,1053,-40
51755609021,51755609027,6,3130,1318,-40
51755949910,51755949917,7,2502,821,-40
51757312490,51757312486,-4,1416,944,-40
51758280433,51758280442,9,2327,683,-40
51758339831,51758339842,11,663,145,-40
51760196366,51760196374,8,3346,1259,-40
51763731446,51763731453,7,3008,1070,-40
51764533434,51764533441,7,2509,1391,-40
51769743638,51769743645,7,3410,1385,-40
51774769647,51774769653,6,2783,1342,-40
51777742663,51777742670,7,3895,1622,-40
51778673286,51778673290,4,2988,1195,-40
51780428057,51780428062,5,2200,1229,-40
51782044654,51782044662,8,3634,1234,-40
51788141177,51788141184,7,2903,1309,-40
51790025272,51790025278,6,2866,758,-40
51791489467,51791489475,8,2686,1298,-40
51796741753,51796741736,-17,2127,1542,-40
51799122782,51799122791,9,2825,981,-40
51800916777,51800916783,6,2653,1190,-40
51802545502,51802545510,8,2691,920,-40
51807060429,51807060435,6,2649,1158,-40
51814409134,51814409143,9,2673,1274,-40
51815540433,51815540438,5,1945,1113,-40
51822004401,51822004406,5,2639,1059,-40
51823316478,51823316482,4,1472,1206,-40
51824062388,51824062393,5,2478,1357,-40
51824821693,51824821699,6,3676,1093,-40
51825502557,51825502561,4,2470,1077,-40
51826831584,51826831589,5,2761,1251,-40
51829477139,51829477145,6,1979,1043,-40
51833287902,51833287906,4,2450,1500,-40
51834329396,51834329386,-10,985,598,-40
51837919488,51837919494,6,3030,1305,-40
51837961170,51837961178,8,2256,1112,-40
51840439510,51840439515,5,2120,1507,-40
51842666668,51842666674,6,2074,943,-40
51842692391,51842692376,-15,780,134,-40
51843702434,51843702441,7,3336,1418,-40
51845315957,51845315962,5,3011,1593,-40
51845419634,51845419618,-16,1391,297,-40
51852875297,51852875303,6,3651,1159,-40
51853077171,51853077179,8,3956,1469,-40
51853678692,51853678699,7,3170,1280,-40
51856197607,51856197610,3,1436,1488,-40
51857125779,51857125786,7,2537,1308,-40
51859325347,51859325354,7,2444,916,-40
51861420149,51861420155,6,3132,1157,-40
51861597153,51861597157,4,2860,1464,-40
51862115629,51862115634,5,2207,1369,-40
51862371554,51862371562,8,2620,1263,-40
51867071284,51867071289,5,2041,1042,-40
51867870462,51867870466,4,2560,920,-40
51872712003,51872712005,2,1563,1688,-40
51872971390,51872971370,-20,582,253,-40
51877622390,51877622398,8,3102,1230,-40
51878222966,51878222970,4,1961,997,-40
51878590886,51878590864,-22,1104,470,-40
51878710618,51878710626,8,1983,1254,-40
51879706821,51879706825,4,2639,1516,-40
51883711523,51883711529,6,2971,1479,-40
51885254916,51885254923,7,1793,465,-40
51886777651,51886777643,-8,779,342,-40
51889062758,51889062766,8,4103,1615,-40
51889358078,51889358082,4,1887,787,-40
51890401405,51890401411,6,3243,1626,-40
51890746119,51890746118,-1,1071,2780,-40
51891545582,51891545587,5,2141,1396,-40
51892824197,51892824202,5,3121,1216,-40
51896978220,51896978226,6,3116,1707,-40
51898035526,51898035534,8,3103,1068,-40
51902587444,51902587451,7,2709,1342,-40
51904126865,51904126874,9,3411,1944,-40
51906993601,51906993607,6,2495,1378,-40
51911722125,51911722130,5,2927,1111,-40
51913773259,51913773272,13,999,143,-40
51918670714,51918670715,1,1854,1331,-40
51920163654,51920163654,0,1140,2008,-40
51930902737,51930902742,5,1944,1109,-40
51930930806,51930930794,-12,2243,1093,-40
51931559578,51931559582,4,2862,1535,-40
51939048324,51939048330,6,2868,1207,-40
51948845773,51948845780,7,3074,1544,-40
51954739612,51954739632,20,3252,1363,-40
51957868482,51957868489,7,2624,908,-40
51962470278,51962470283,5,1551,949,-40
51966195990,51966195998,8,3873,1795,-40
51969400407,51969400411,4,1466,968,-40
51969534441,51969534447,6,1948,862,-40
51969831413,51969831393,-20,1120,240,-40
51970883236,51970883243,7,3151,1405,-40
51978344958,51978344965,7,3704,1171,-40
51981951460,51981951466,6,3332,1376,-40
51984169125,51984169130,5,1457,1116,-40
51986603294,51986603304,10,2860,1286,-40
51995561249,51995561254,5,3265,1434,-40
51999869234,51999869241,7,3321,1438,-40
52001349557,52001349538,-19,3106,1286,-40
52001905415,52001905422,7,2653,1162,-40
52002270370,52002270376,6,2964,1494,-40
52003661784,52003661789,5,2736,1148,-40
52005123338,52005123343,5,2418,942,-40
52005706989,52005706994,5,2821,1481,-40
52007386761,52007386767,6,2848,1370,-40
52009684758,52009684765,7,3018,1392,-40
52011478478,52011478485,7,4014,1844,-40
52012241359,52012241368,9,2609,1274,-40
52016459387,52016459394,7,3820,1846,-40
52024207420,52024207426,6,2259,1448,-40
52025606863,52025606869,6,2432,1372,-40
52025649571,52025649577,6,2926,1547,-40
52026928576,52026928579,3,46731,30011,-40
52027040509,52027040515,6,2593,795,-40
52028771894,52028771901,7,2312,904,-40
52032472566,52032472573,7,2202,1100,-40
52040528220,52040528215,-5,1743,4123,-40
52042502067,52042502074,7,2647,1002,-40
52042855494,52042855472,-22,2080,1000,-40
52048513985,52048513993,8,3601,1558,-40
52048852965,52048852946,-19,678,386,-40
52052082331,52052082325,-6,1614,6548,-40
52056068730,52056068735,5,1749,783,-40
52056261650,52056261665,15,1004,235,-40
52059335141,52059335145,4,2671,1310,-40
52059628577,52059628583,6,2147,989,-40
52067974793,52067974799,6,2407,831,-40
52075965810,52075965818,8,2993,744,-40
52079688994,52079689001,7,3039,1313,-40
52084430968,52084430974,6,2310,1436,-40
52085465117,52085465124,7,2890,1137,-40
52085891134,52085891146,12,745,193,-40
52088182073,52088182079,6,2889,1270,-40
52097941244,52097941238,-6,1385,5887,-40
52098957717,52098957723,6,3541,1166,-40
52102397355,52102397362,7,3562,1422,-40
52112011789,52112011795,6,2579,973,-40
52115745649,52115745654,5,2406,1360,-40
52115900058,52115900059,1,1811,2151,-40
52116221806,52116221807,1,1516,1459,-40
52118308639,52118308645,6,3983,1735,-40
52120087258,52120087259,1,1154,1018,-40
52121364237,52121364243,6,3046,824,-40
52127570410,52127570407,-3,1103,1564,-40
52131142529,52131142539,10,2876,1225,-40
52135447420,52135447426,6,1971,1237,-40
52135600922,52135600906,-16,751,415,-40
52135844304,52135844309,5,2149,1261,-40
52136076238,52136076216,-22,1896,538,-40
52137609764,52137609769,5,2557,1651,-40
52138326533,52138326538,5,2288,1170,-40
52139050517,52139050526,9,14861,24317,-40
52141299632,52141299647,15,518,1860,-40
52141447790,52141447798,8,3858,1058,-40
52142862113,52142862109,-4,1458,2442,-40
52146640765,52146640772,7,3384,1373,-40
52156505122,52156505128,6,3628,1273,-40
52158178002,52158178010,8,3385,1141,-40
52158323567,52158323572,5,826,320,-40
52158541558,52158541537,-21,1424,850,-40
52164479810,52164479805,-5,1558,4487,-40
52167626082,52167626086,4,3168,1432,-40
52174775275,52174775282,7,2283,1476,-40
52175677147,52175677130,-17,1246,700,-40
52179417126,52179417134,8,3339,1321,-40
52180305579,52180305587,8,3291,1844,-40
52180721943,52180721950,7,3097,1341,-40
52182547064,52182547070,6,3081,1125,-40
52182990439,52182990419,-20,906,542,-40
52183927385,52183927391,6,3089,1186,-40
52186027350,52186027358,8,2371,939,-40
52186093338,52186093346,8,2999,1380,-40
52186194376,52186194362,-14,2374,648,-40
52187589324,52187589329,5,4207,1420,-40
52187972366,52187972374,8,2300,1292,-40
52190755620,52190755627,7,2782,1373,-40
52200425187,52200425192,5,2857,1570,-40
52206913099,52206913105,6,2140,1190,-40
52208478727,52208478733,6,1826,1105,-40
52209019158,52209019139,-19,695,445,-40
52215405951,52215405956,5,4431,2677,-40
52218229225,52218229231,6,2329,1209,-40
52223807462,52223807469,7,2434,1173,-40
52224431509,52224431514,5,1873,1126,-40
52226500582,52226500591,9,2540,1150,-40
52227585362,52227585370,8,1949,1099,-40
52230926158,52230926165,7,3986,1420,-40
52231020741,52231020749,8,2631,970,-40
52234403442,52234403450,8,3030,1203,-40
52241598242,52241598250,8,3986,1162,-40
52245728757,52245728764,7,2693,1353,-40
52247404090,52247404094,4,1700,1258,-40
52249500274,52249500279,5,3081,1266,-40
52253983066,52253983062,-4,23425,16163,-40
52254305280,52254305283,3,1361,1483,-40
52256653448,52256653455,7,2419,1048,-40
52257066766,52257066752,-14,970,313,-40
52257637230,52257637237,7,2811,1069,-40
52258519506,52258519511,5,2485,1433,-40
52259672373,52259672379,6,3906,1244,-40
52260267986,52260267990,4,1681,1209,-40
52260301290,52260301272,-18,2370,1122,-40
52262593921,52262593927,6,3571,1542,-40
52262659457,52262659463,6,2972,1217,-40
52278114826,52278114832,6,3381,1445,-40
52278665410,52278665418,8,2654,1273,-40
52282816283,52282816290,7,2726,1147,-40
52283055702,52283055705,3,1504,1317,-40
52285831394,52285831399,5,2839,886,-40
52295551343,52295551351,8,4082,1749,-40
52304143689,52304143695,6,4104,1319,-40
52305007591,52305007599,8,3092,1045,-40
52312607591,52312607597,6,1545,1089,-40
52313017456,52313017454,-2,858,1857,-40
52313841174,52313841178,4,2835,1199,-40
52320396532,52320396539,7,3613,1146,-40
52322300407,52322300413,6,2057,978,-40
52323003363,52323003345,-18,920,486,-40
52323671996,52323672003,7,3183,1317,-40
52326287762,52326287769,7,2647,965,-40
52332104001,52332104008,7,2478,1297,-40
52332269763,52332269778,15,2294,1183,-40
52340746583,52340746582,-1,1062,1323,-40
52351795081,52351795086,5,3155,1539,-40
52352185600,52352185587,-13,1167,468,-40
52353303537,52353303544,7,3710,1462,-40
52353331765,52353331769,4,2780,1216,-40
52353951123,52353951127,4,2462,1247,-40
52358512409,52358512415,6,4314,1598,-40
52359365026,52359365033,7,3100,1197,-40
52363556682,52363556689,7,3686,1702,-40
52365405648,52365405653,5,1931,946,-40
52367275301,52367275307,6,2375,1048,-40
52367618198,52367618205,7,2047,1073,-40
52369337735,52369337738,3,2025,775,-40
52373480772,52373480772,0,1656,1846,-40
52374332663,52374332668,5,2179,1899,-40
52374389642,52374389637,-5,837,3226,-40
52376300872,52376300877,5,3616,1363,-40
52379681527,52379681533,6,2289,1161,-40
52381608197,52381608202,5,1611,891,-40
52381758038,52381758047,9,3226,1363,-40
52382644061,52382644066,5,2624,1337,-40
52383403710,52383403688,-22,2592,789,-40
52385518663,52385518670,7,2120,948,-40
52385974041,52385974047,6,2381,1221,-40
52387993142,52387993146,4,2205,1257,-40
52396248629,52396248637,8,1640,902,-40
52396931847,52396931854,7,3850,1564,-40
52400389983,52400389983,0,994,1966,-40
52404706941,52404706948,7,1834,1245,-40
52408784810,52408784816,6,1718,1298,-40
52411041141,52411041146,5,2476,1898,-40
52412388666,52412388672,6,2206,1213,-40
52412703281,52412703286,5,1782,702,-40
52415368620,52415368626,6,2689,1214,-40
52423304413,52423304418,5,2903,1412,-40
52424305250,52424305248,-2,1599,2861,-40
52429704752,52429704758,6,2281,1109,-40
52436354746,52436354751,5,2268,1293,-40
52441681453,52441681458,5,3160,1449,-40
52442581958,52442581966,8,2435,963,-40
52445133926,52445133931,5,2386,782,-40
52447933986,52447933995,9,3122,1138,-40
52450427402,52450427407,5,1190,930,-40
52450940226,52450940210,-16,1522,865,-40
52455013659,52455013662,3,2244,1859,-40
52457948589,52457948594,5,2835,1244,-40
52461461227,52461461235,8,3287,1050,-40
52471876519,52471876525,6,3490,1163,-40
52473214170,52473214160,-10,1169,623,-40
52473794962,52473794946,-16,980,200,-40
52475581434,52475581435,1,11610,12792,-40
52476473509,52476473516,7,4050,1554,-40
52477529615,52477529610,-5,1093,1875,-40
52481374557,52481374562,5,1690,1301,-40
52482273610,52482273615,5,2870,2112,-40
52484644929,52484644923,-6,1318,2963,-40
52485559474,52485559481,7,2887,829,-40
52485952886,52485952866,-20,2699,1238,-40
52487331004,52487331011,7,1973,908,-40
52487451909,52487451897,-12,884,430,-40
52496058828,52496058835,7,2922,1284,-40
52496612429,52496612434,5,2469,1109,-40
52497855682,52497855690,8,3523,1288,-40
52498053903,52498053910,7,3600,1580,-40
52501155682,52501155689,7,3020,1231,-40
52505886498,52505886510,12,1957,1128,-40
52514168913,52514168919,6,2617,1254,-40
52514689899,52514689882,-17,850,203,-40
52515938142,52515938147,5,1981,1024,-40
52517665728,52517665734,6,2659,1387,-40
52519101436,52519101442,6,2918,1417,-40
52522113235,52522113230,-5,1270,2655,-40
52527099193,52527099198,5,2225,1004,-40
52530043710,52530043716,6,2825,1290,-40
52534616333,52534616341,8,2841,1331,-40
52537756775,52537756783,8,3879,1328,-40
52537974935,52537974941,6,1239,659,-40
52538757049,52538757054,5,3496,1482,-40
52539162957,52539162963,6,3025,1307,-40
52539804863,52539804840,-23,751,314,-40
52544042822,52544042829,7,2144,1505,-40
52545032051,52545032059,8,3166,1468,-40
52546408623,52546408620,-3,2503,4462,-40
52548875399,52548875407,8,2725,781,-40
52549282337,52549282320,-17,1746,476,-40
52550892925,52550892931,6,4287,1086,-40
52552065993,52552065986,-7,1227,5113,-40
52555180102,52555180107,5,3053,1407,-40
52556939254,52556939261,7,2800,1011,-40
52557827718,52557827723,5,2407,1898,-40
52564064138,52564064142,4,1439,26518,-40
52565264507,52565264513,6,1613,1203,-40
52566235139,52566235140,1,3608,3306,-40
52567062298,52567062305,7,2736,1185,-40
52569161915,52569161921,6,2667,1238,-40
52569412327,52569412333,6,3281,1084,-40
52569923566,52569923552,-14,1304,674,-40
52571694124,52571694131,7,2375,1371,-40
52576450665,52576450669,4,2580,2226,-40
52576828105,52576828110,5,2765,842,-40
52577444245,52577444257,12,1850,237,-40
52577702644,52577702667,23,3371,1143,-40
52581869470,52581869477,7,2182,958,-40
52582862253,52582862236,-17,2002,643,-40
52584537566,52584537573,7,3152,1179,-40
52586012216,52586012222,6,2326,1047,-40
52587367766,52587367771,5,2319,1407,-40
52592759707,52592759704,-3,1660,2796,-40
52593323065,52593323071,6,2338,1309,-40
52593682382,52593682390,8,3003,1321,-40
52600277157,52600277162,5,2050,1576,-40
52602510888,52602510895,7,3978,994,-40
52602553574,52602553584,10,2662,1191,-40
52603512013,52603512019,6,2620,1451,-40
52605296594,52605296598,4,2111,1305,-40
52609996124,52609996130,6,4125,1550,-40
52612564018,52612564024,6,2430,1279,-40
52614683157,52614683162,5,3091,1573,-40
52615700406,52615700412,6,2948,1469,-40
52618668509,52618668514,5,2731,1174,-40
52621246928,52621246934,6,2554,1307,-40
52621763771,52621763768,-3,1286,89,-40
52624589740,52624589745,5,3070,1264,-40
52625406784,52625406790,6,2608,1374,-40
52625556445,52625556425,-20,2727,1625,-40
52626144700,52626144707,7,2982,1438,-40
52637739148,52637739154,6,3222,1457,-40
52639290173,52639290178,5,3077,1152,-40
52644642869,52644642875,6,3841,1770,-40
52652142123,52652142129,6,3377,1747,-40
52655330879,52655330883,4,1156,945,-40
52655627024,52655627031,7,3888,1662,-40
52656713865,52656713871,6,3007,1132,-40
52657085187,52657085172,-15,1104,154,-40
52657947321,52657947326,5,3472,1090,-40
52659422552,52659422558,6,1964,1434,-40
52660910087,52660910091,4,1550,538,-40
52661617165,52661617169,4,6359,27377,-40
52662079306,52662079313,7,2626,1167,-40
52662327072,52662327065,-7,1092,313,-40
52665981373,52665981378,5,3080,1711,-40
52667594652,52667594658,6,1947,1550,-40
52668143701,52668143706,5,2175,1184,-40
52672317709,52672317714,5,1623,772,-40
52672447227,52672447242,15,2065,1934,-40
52675122079,52675122084,5,2843,1472,-40
52676240938,52676240946,8,3000,1140,-40
52682584137,52682584143,6,2833,1213,-40
52684561737,52684561743,6,2305,1276,-40
52686845539,52686845546,7,3269,1429,-40
52689354267,52689354274,7,3390,1090,-40
52690361129,52690361134,5,2999,1295,-40
52692232220,52692232227,7,2475,877,-40
52694570899,52694570906,7,3850,1840,-40
52701315302,52701315311,9,1467,837,-40
52702383127,52702383133,6,2769,1359,-40
52710452190,52710452197,7,1897,988,-40
52710619615,52710619593,-22,3329,1367,-40
52710873575,52710873569,-6,24288,16071,-40
52715980102,52715980106,4,10417,7088,-40
52720592941,52720592949,8,3578,1432,-40
52724883154,52724883158,4,2640,1369,-40
52725922414,52725922421,7,3251,1114,-40
52732148127,52732148132,5,1917,1320,-40
52736346930,52736346932,2,2478,1793,-40
52738577450,52738577458,8,3063,1141,-40
52748010493,52748010499,6,3576,1022,-40
52748570160,52748570172,12,396,787,-40
52749977144,52749977131,-13,283,598,-40
52751140050,52751140065,15,2512,1016,-40
52753725609,52753725615,6,2884,1008,-40
52761781578,52761781583,5,2592,1078,-40
52762050516,52762050523,7,2618,1281,-40
52762881572,52762881578,6,2176,993,-40
52766318827,52766318833,6,3376,1988,-40
52767950924,52767950931,7,2366,943,-40
52770641589,52770641596,7,2977,1406,-40
52772729932,52772729938,6,1735,854,-40
52773724024,52773724026,2,1672,1617,-40
52777806415,52777806422,7,4103,1466,-40
52780086043,52780086050,7,2556,1354,-40
52780968978,52780968974,-4,1619,4248,-40
52785478189,52785478196,7,2786,1303,-40
52787825187,52787825192,5,2688,996,-40
52792476478,52792476485,7,3542,2022,-40
52795760191,52795760198,7,2839,1095,-40
52802301818,52802301825,7,2997,848,-40
52807834566,52807834562,-4,1585,6585,-40
52808828597,52808828602,5,2553,1463,-40
52809538950,52809538956,6,3244,1469,-40
52819252851,52819252857,6,1977,1321,-40
52825743300,52825743306,6,2970,1196,-40
52826348051,52826348034,-17,1403,722,-40
52829591166,52829591164,-2,738,2027,-40
52831483962,52831483968,6,3416,1402,-40
52834451788,52834451790,2,1669,1201,-40
52835926506,52835926513,7,2515,1182,-40
52840142050,52840142054,4,2731,1155,-40
52846420429,52846420435,6,2251,1111,-40
52846599642,52846599648,6,2718,1104,-40
52850126742,52850126750,8,2322,1158,-40
52852211265,52852211265,0,686,411,-40
52854456141,52854456149,8,2244,940,-40
52857264738,52857264743,5,2704,1301,-40
52863930797,52863930803,6,2304,956,-40
52864245043,52864245050,7,3315,1178,-40
52864542830,52864542819,-11,1917,895,-40
52873206702,52873206708,6,2758,1494,-40
52877414450,52877414447,-3,839,3092,-40
52879771979,52879771985,6,3513,1866,-40
52886674855,52886674861,6,2901,1204,-40
52886965010,52886964992,-18,3538,1087,-40
52891145725,52891145731,6,2110,967,-40
52895792162,52895792169,7,3412,1107,-40
52897751887,52897751894,7,2783,1187,-40
52901039543,52901039546,3,2040,2064,-40
52901877865,52901877870,5,1720,1213,-40
52903643732,52903643741,9,2555,1223,-40
52904221654,52904221636,-18,1177,775,-40
52914621809,52914621814,5,2891,1371,-40
52915052691,52915052682,-9,492,264,-40
52917063042,52917063051,9,2815,945,-40
52921723097,52921723103,6,2937,1167,-40
52921794417,52921794403,-14,797,276,-40
52926643049,52926643055,6,2803,973,-40
52931226263,52931226270,7,2268,1103,-40
52932107758,52932107762,4,2755,1267,-40
52935774373,52935774376,3,33874,28999,-40
52939145557,52939145558,1,1139,1852,-40
52943288853,52943288859,6,2618,1357,-40
52943352734,52943352721,-13,1702,437,-40
52943926774,52943926780,6,2009,1480,-40
52944884318,52944884322,4,3269,1250,-40
52945230160,52945230165,5,2560,1402,-40
52947044894,52947044873,-21,1336,483,-40
52950190691,52950190696,5,2293,1309,-40
52951731213,52951731218,5,3383,1366,-40
52957974087,52957974082,-5,2192,6216,-40
52964424561,52964424569,8,2437,1345,-40
52966670658,52966670665,7,2788,1479,-40
52966774190,52966774180,-10,932,422,-40
52967637361,52967637367,6,3270,1604,-40
52968613359,52968613366,7,5278,1904,-40
52970067486,52970067492,6,4608,1499,-40
52971561242,52971561248,6,2922,1414,-40
52973505685,52973505690,5,2173,1434,-40
52983795788,52983795793,5,2800,1377,-40
52984155601,52984155607,6,2990,968,-40
52985383145,52985383151,6,2784,1107,-40
52987329592,52987329598,6,4007,1854,-40
52989868777,52989868779,2,1946,1556,-40
52990683569,52990683573,4,1160,1116,-40
52990859543,52990859551,8,2865,933,-40
52991110146,52991110131,-15,855,165,-40
52992320598,52992320605,7,1544,776,-40
52995962479,52995962487,8,3245,1098,-40
52998592972,52998592979,7,2062,800,-40
52998895846,52998895834,-12,3629,1372,-40
53001351033,53001351039,6,2300,1261,-40
53003247361,53003247369,8,1968,491,-40
53003337117,53003337123,6,2727,1032,-40
53004092969,53004092953,-16,1611,855,-40
53006698138,53006698142,4,1810,744,-40
53008086277,53008086283,6,7153,1319,-40
53009982872,53009982878,6,1731,1347,-40
53010483903,53010483920,17,600,125,-40
53012219958,53012219963,5,9750,4848,-40
53012390042,53012390047,5,882,864,-40
53015222931,53015222946,15,1933,1107,-40
53026898838,53026898846,8,1985,998,-40
53027263975,53027263956,-19,1017,367,-40
53028893329,53028893335,6,3786,1511,-40
53030173452,53030173458,6,2985,1679,-40
53030607301,53030607307,6,3999,1443,-40
53039454213,53039454220,7,2651,1517,-40
53040330898,53040330891,-7,1923,1131,-40
53042119144,53042119150,6,2399,971,-40
53049092394,53049092399,5,2309,1246,-40
53051402587,53051402593,6,2795,1363,-40
53051735771,53051735777,6,2383,1743,-40
53054315733,53054315738,5,2451,1277,-40
53059578341,53059578351,10,2556,1407,-40
53060311124,53060311130,6,3401,1392,-40
53061720905,53061720913,8,876,236,-40
53065182851,53065182858,7,1645,554,-40
53065908392,53065908413,21,1253,1251,-40
53068867071,53068867078,7,3913,1458,-40
53069564998,53069565006,8,3333,1036,-40
53069656754,53069656754,0,825,146,-40
53070138809,53070138793,-16,1229,335,-40
53071053562,53071053567,5,2373,1248,-40
53074819903,53074819910,7,3379,838,-40
53077871357,53077871363,6,2341,1207,-40
53079800398,53079800403,5,2597,1008,-40
53081015513,53081015513,0,2974,3702,-40
53083153231,53083153237,6,1171,637,-40
53083687226,53083687232,6,2374,1487,-40
53085259283,53085259290,7,4451,1919,-40
53089303257,53089303251,-6,1263,4559,-40
53090356792,53090356789,-3,999,1751,-40
53090970177,53090970183,6,3576,980,-40
53091811413,53091811418,5,2768,1138,-40
53094283020,53094283026,6,2324,1013,-40
53094377896,53094377902,6,2835,1053,-40
53100765836,53100765841,5,2521,1002,-40
53101278993,53101278999,6,2644,824,-40
53104931325,53104931334,9,3128,1197,-40
53108282683,53108282691,8,2114,946,-40
53111505601,53111505607,6,3461,1598,-40
53111726276,53111726282,6,3291,1121,-40
53113653121,53113653127,6,3380,1609,-40
53114682992,53114683002,10,43178,13431,-40
53115156931,53115156938,7,4483,1851,-40
53123716807,53123716814,7,2067,1144,-40
53124669723,53124669730,7,2296,1441,-40
53128456610,53128456618,8,3180,898,-40
53128836876,53128836896,20,2342,1226,-40
53129320425,53129320432,7,3149,1161,-40
53129632008,53129632024,16,1057,83,-40
53130012477,53130012482,5,3433,1692,-40
53130647889,53130647875,-14,1817,805,-40
53137504028,53137504037,9,2842,1220,-40
53138057857,53138057862,5,2593,1391,-40
53139108955,53139108961,6,2261,1266,-40
53139534582,53139534601,19,784,137,-40
53141803428,53141803434,6,3041,1919,-40
53143480582,53143480585,3,1829,878,-40
53147602518,53147602522,4,1872,1212,-40
53153617865,53153617873,8,1918,1268,-40
53156378063,53156378069,6,3523,1303,-40
53158734765,53158734771,6,3267,1550,-40
53159547093,53159547099,6,2857,1707,-40
53162038845,53162038850,5,3739,1605,-40
53168440888,53168440894,6,2377,1290,-40
53171572917,53171572917,0,1781,1834,-40
53172886738,53172886742,4,2004,1400,-40
53175276142,53175276146,4,2498,1306,-40
53178905702,53178905708,6,2608,1464,-40
53180305006,53180305013,7,3285,1550,-40
53181049182,53181049188,6,2415,1200,-40
53185755125,53185755131,6,2125,898,-40
53190246174,53190246182,8,2945,1389,-40
53190633082,53190633090,8,2799,1141,-40
53196590005,53196590010,5,3519,1524,-40
53200284330,53200284335,5,3412,1546,-40
53200483654,53200483660,6,3141,1199,-40
53210591166,53210591174,8,3601,1845,-40
53210890586,53210890591,5,2562,1253,-40
53213190962,53213190970,8,3067,1547,-40
53214485818,53214485823,5,3582,1381,-40
53216368801,53216368803,2,1937,681,-40
53220984167,53220984175,8,3431,1113,-40
53226146317,53226146323,6,2936,1338,-40
53228509716,53228509723,7,2498,1192,-40
53230457855,53230457861,6,2921,1834,-40
53231271598,53231271606,8,2312,633,-40
53235918175,53235918182,7,2463,1197,-40
53237253125,53237253131,6,2087,1379,-40
53239645263,53239645270,7,3120,911,-40
53243642393,53243642400,7,1317,333,-40
53244913561,53244913566,5,2048,1271,-40
53254642198,53254642202,4,3192,1098,-40
53257254507,53257254514,7,3560,1371,-40
53262339090,53262339096,6,2468,792,-40
53264089781,53264089788,7,1872,585,-40
53264144930,53264144916,-14,2668,704,-40
53264554355,53264554362,7,3074,1583,-40
53265019660,53265019665,5,2546,1314,-40
53265624385,53265624381,-4,1401,2387,-40
53268424454,53268424459,5,1662,1361,-40
53269627034,53269627042,8,2256,1254,-40
53271337797,53271337803,6,2411,1334,-40
53280939369,53280939374,5,3156,1193,-40
53281724945,53281724950,5,2879,1125,-40
53284465237,53284465243,6,3705,1514,-40
53285720188,53285720196,8,2766,1475,-40
53285802780,53285802779,-1,1190,337,-40
53289077165,53289077171,6,3348,1012,-40
53291965922,53291965926,4,4061,1641,-40
53292057961,53292057966,5,2833,1423,-40
53294201173,53294201181,8,3561,1457,-40
53294920038,53294920042,4,1853,1109,-40
53295301530,53295301521,-9,523,196,-40
53296144490,53296144506,16,2138,995,-40
53303477990,53303477997,7,2489,1228,-40
53312221747,53312221755,8,2245,888,-40
53312567566,53312567572,6,2918,1628,-40
53312697121,53312697126,5,4000,1724,-40
53313002670,53313002679,9,1524,709,-40
53313986120,53313986108,-12,2254,750,-40
53316498878,53316498883,5,2742,1137,-40
53321722550,53321722556,6,3318,1479,-40
53321970385,53321970391,6,3351,1265,-40
53322121742,53322121746,4,2645,1354,-40
53322153379,53322153385,6,2539,1020,-40
53325547958,53325547966,8,2776,1823,-40
53325579351,53325579328,-23,3040,1172,-40
53327600937,53327600942,5,3252,1691,-40
53329051018,53329051025,7,2786,1196,-40
53334881320,53334881326,6,2614,1636,-40
53335500454,53335500458,4,2248,1183,-40
53338077634,53338077638,4,2106,868,-40
53338447181,53338447164,-17,1163,143,-40
53339031138,53339031143,5,2127,984,-40
53340426298,53340426296,-2,2441,4719,-40
53341959209,53341959215,6,3841,1478,-40
53343199266,53343199272,6,3554,1662,-40
53345334880,53345334885,5,3144,1757,-40
53347824989,53347824995,6,1932,1202,-40
53348608233,53348608239,6,3315,1601,-40
53351157853,53351157859,6,1795,951,-40
53351953176,53351953183,7,3458,1054,-40
53352607146,53352607152,6,2880,1383,-40
53356063706,53356063710,4,3573,1862,-40
53356725747,53356725754,7,3156,1409,-40
53359692514,53359692522,8,2979,1160,-40
53361186006,53361186013,7,3992,1332,-40
53363034875,53363034882,7,3287,1057,-40
53364338126,53364338134,8,2293,1393,-40
53368290894,53368290901,7,2560,627,-40
53370847452,53370847458,6,4229,1333,-40
53371189319,53371189338,19,908,208,-40
53373508961,53373508967,6,2205,1001,-40
53378141488,53378141496,8,2639,1375,-40
53378982166,53378982144,-22,1965,490,-40
53382219981,53382219987,6,2272,1252,-40
53387858078,53387858064,-14,901,144,-40
53391498374,53391498370,-4,853,1590,-40
53393229854,53393229861,7,2279,998,-40
53396619805,53396619787,-18,573,180,-40
53399629466,53399629473,7,2204,1331,-40
53399908895,53399908903,8,1893,607,-40
53404856950,53404856956,6,2390,1180,-40
53407681321,53407681326,5,3773,1623,-40
53408822096,53408822102,6,3706,915,-40
53410092156,53410092163,7,2224,1240,-40
53418007400,53418007407,7,4322,1476,-40
53420805193,53420805199,6,2605,1098,-40
53421271110,53421271116,6,1224,381,-40
53423045455,53423045459,4,3329,1221,-40
53424268122,53424268104,-18,1098,350,-40
53426039541,53426039546,5,2715,1488,-40
53427734665,53427734671,6,2644,1202,-40
53428864730,53428864737,7,2287,1338,-40
53431614062,53431614069,7,2732,1852,-40
53432090593,53432090595,2,1187,860,-40
53434514494,53434514497,3,2680,1441,-40
53436387030,53436387035,5,1377,613,-40
53437627815,53437627823,8,1804,1397,-40
53437676977,53437676985,8,2759,1057,-40
53440267590,53440267595,5,1195,1004,-40
53440450051,53440450058,7,2655,1237,-40
53440565757,53440565762,5,2104,1271,-40
53446913235,53446913240,5,3411,1551,-40
53447376438,53447376446,8,3197,1088,-40
53447446367,53447446354,-13,795,337,-40
53448547326,53448547315,-11,1234,221,-40
53450199954,53450199957,3,2270,1949,-40
53450607651,53450607655,4,2338,1022,-40
53451508243,53451508250,7,1109,379,-40
53451749318,53451749330,12,988,312,-40
53452734677,53452734684,7,4457,1711,-40
53455744857,53455744863,6,2449,1079,-40
53456065241,53456065249,8,3424,1161,-40
53459099497,53459099479,-18,2297,562,-40
53460328360,53460328366,6,2821,1111,-40
53461067330,53461067336,6,3202,1402,-40
53465051154,53465051160,6,3449,1653,-40
53465797530,53465797538,8,3171,1846,-40
53466832373,53466832380,7,1534,803,-40
53468309826,53468309827,1,42476,16657,-40
53469221194,53469221195,1,2701,2720,-40
53471334950,53471334956,6,2874,1429,-40
53474648397,53474648394,-3,1127,1602,-40
53477394495,53477394493,-2,1039,1549,-40
53479072432,53479072438,6,1894,1691,-40
53481703928,53481703934,6,1879,949,-40
53485771018,53485771025,7,2955,1115,-40
53493277997,53493277994,-3,880,1384,-40
53493926441,53493926449,8,3615,1673,-40
53494629921,53494629927,6,1945,1275,-40
53501396814,53501396820,6,6492,2843,-40
53503799149,53503799153,4,2323,949,-40
53505589749,53505589755,6,5360,3165,-40
53509489323,53509489317,-6,3271,12760,-40
53510323105,53510323110,5,2193,819,-40
53512709461,53512709467,6,3491,1189,-40
53518400195,53518400202,7,3197,1312,-40
53518443410,53518443427,17,3473,1261,-40
53520799821,53520799826,5,3028,1092,-40
53522187379,53522187385,6,3103,1397,-40
53527782438,53527782443,5,2319,576,-40
53528372451,53528372458,7,2920,1471,-40
53529581601,53529581604,3,2410,1464,-40
53529643914,53529643919,5,2001,880,-40
53534215186,53534215193,7,2419,1147,-40
53534439665,53534439674,9,3001,700,-40
53549322926,53549322932,6,2153,1168,-40
53551857151,53551857157,6,1947,1241,-40
53553021222,53553021230,8,2669,1433,-40
53556285176,53556285174,-2,1284,2830,-40
53558507461,53558507459,-2,1480,2299,-40
53559077689,53559077696,7,4643,1499,-40
53560890158,53560890163,5,2446,1145,-40
53564591518,53564591514,-4,1080,2372,-40
53571280166,53571280173,7,3330,990,-40
53574780188,53574780194,6,8347,1138,-40
53574967917,53574967900,-17,871,465,-40
53575176548,53575176555,7,2912,1071,-40
53576259121,53576259119,-2,1411,1791,-40
53577473988,53577473993,5,2719,1218,-40
53577736171,53577736178,7,3511,1129,-40
53581263301,53581263307,6,2708,1318,-40
53586197731,53586197739,8,2337,1094,-40
53586975437,53586975456,19,2130,1445,-40
53589552869,53589552875,6,2825,1560,-40
53596616522,53596616512,-10,1618,677,-40
53600497467,53600497473,6,2497,959,-40
53601304981,53601304987,6,2214,826,-40
53603640529,53603640549,20,403,1550,-40
53613589429,53613589434,5,3200,1724,-40
53614294233,53614294240,7,2405,1158,-40
53614687865,53614687870,5,2886,1558,-40
53617989740,53617989746,6,2852,1368,-40
53618861090,53618861098,8,3670,881,-40
53619419592,53619419598,6,2009,1303,-40
53625851320,53625851326,6,3571,1428,-40
53631711933,53631711939,6,3490,1363,-40
53633494281,53633494288,7,2141,1074,-40
53637696035,53637696039,4,1275,535,-40
53643072245,53643072249,4,2416,1347,-40
53645088490,53645088494,4,2406,1320,-40
53645772326,53645772326,0,1877,1760,-40
53645880047,53645880055,8,2253,1250,-40
53649776031,53649776035,4,2205,1494,-40
53654518770,53654518775,5,3279,1355,-40
53655738225,53655738233,8,2421,1037,-40
53659294457,53659294462,5,1723,1197,-40
53662264461,53662264457,-4,1975,4244,-40
53662840681,53662840687,6,2680,1136,-40
53665108551,53665108556,5,2667,1003,-40
53676126134,53676126139,5,2034,1620,-40
53676781535,53676781541,6,2225,1427,-40
53677456330,53677456329,-1,2284,3330,-40
53677845647,53677845654,7,2775,1425,-40
53679556929,53679556935,6,3076,1497,-40
53681255706,53681255713,7,2520,1493,-40
53682821229,53682821223,-6,1648,4621,-40
53686637870,53686637877,7,3536,1347,-40
53688194009,53688194015,6,3104,1416,-40
53689038970,53689038977,7,3686,1626,-40
53689150610,53689150613,3,872,835,-40
53690940694,53690940701,7,1612,929,-40
53691009280,53691009264,-16,2404,804,-40
53693498683,53693498689,6,3070,771,-40
53694608085,53694608088,3,951,137,-40
53698665970,53698665973,3,1619,987,-40
53700665412,53700665418,6,4291,1501,-40
53704960795,53704960803,8,3628,999,-40
53712033830,53712033835,5,2174,1635,-40
53726557234,53726557241,7,2928,1285,-40
53727205331,53727205314,-17,909,249,-40
53731381813,53731381819,6,2795,1481,-40
53733843106,53733843114,8,2861,1034,-40
53741584910,53741584911,1,1576,1481,-40
53748278637,53748278643,6,3419,980,-40
53749007374,53749007352,-22,1165,273,-40
53749237711,53749237720,9,3204,1382,-40
53749409838,53749409845,7,2891,1192,-40
53753076345,53753076350,5,2550,1034,-40
53756211757,53756211765,8,2225,967,-40
53756563193,53756563199,6,2661,1132,-40
53758739277,53758739270,-7,2219,5715,-40
53762733574,53762733582,8,3332,1438,-40
53763477815,53763477794,-21,630,436,-40
53765794223,53765794230,7,2872,1185,-40
53768703527,53768703524,-3,1777,3791,-40
53770155629,53770155635,6,2241,915,-40
53770587410,53770587417,7,1160,386,-40
53772946758,53772946737,-21,1250,762,-40
53775062808,53775062815,7,3237,1218,-40
53777513398,53777513405,7,2195,1174,-40
53779877761,53779877765,4,2060,1651,-40
53780694622,53780694604,-18,1126,381,-40
53781188204,53781188200,-4,958,2441,-40
53782311629,53782311635,6,1372,1076,-40
53783420269,53783420277,8,1514,883,-40
53784350517,53784350522,5,2747,1263,-40
53787960860,53787960856,-4,1653,2964,-40
53793443840,53793443847,7,3041,1088,-40
53793980978,53793980985,7,760,482,-40
53796019832,53796019837,5,2889,1048,-40
53797456618,53797456618,0,1376,2256,-40
53798557566,53798557571,5,3238,1302,-40
53801135237,53801135242,5,3692,1864,-40
53804936678,53804936684,6,3591,1247,-40
53805576093,53805576098,5,2523,950,-40
53807785610,53807785614,4,3119,1603,-40
53808433513,53808433519,6,2011,1203,-40
53808830729,53808830735,6,2132,1437,-40
53810760311,53810760294,-17,3064,1103,-40
53811259893,53811259901,8,3621,1240,-40
53811721511,53811721517,6,3213,1509,-40
53817521114,53817521120,6,3257,1468,-40
53817558225,53817558231,6,2581,1240,-40
53825247616,53825247622,6,2591,1332,-40
53825478553,53825478569,16,852,328,-40
53826245748,53826245754,6,4147,1262,-40
53826789294,53826789282,-12,1217,319,-40
53827182431,53827182424,-7,26958,13104,-40
53830138166,53830138167,1,1128,2276,-40
53831405114,53831405112,-2,2367,4182,-40
53832049629,53832049636,7,3404,1898,-40
53833518368,53833518374,6,3716,1495,-40
53836123862,53836123865,3,2351,1150,-40
53838011741,53838011747,6,2547,1034,-40
53839322681,53839322687,6,2494,1237,-40
53840020983,53840020991,8,3148,1107,-40
53840252390,53840252372,-18,664,525,-40
53845326905,53845326911,6,2185,1280,-40
53848394282,53848394290,8,2851,1559,-40
53850406076,53850406083,7,2677,1152,-40
53851348777,53851348782,5,2219,1259,-40
53851441146,53851441155,9,1115,538,-40
53862985545,53862985550,5,2705,1374,-40
53864036042,53864036050,8,2330,1324,-40
53867768061,53867768066,5,2537,1692,-40
53869989413,53869989419,6,2421,1073,-40
53871907330,53871907329,-1,1018,274,-40
53874758750,53874758756,6,3101,1451,-40
53878815155,53878815157,2,1490,2472,-40
53888485420,53888485425,5,2248,1433,-40
53891307815,53891307821,6,2520,1189,-40
53892964776,53892964777,1,1099,1398,-40
53897588834,53897588842,8,2718,1130,-40
53897865413,53897865395,-18,1422,722,-40
53899570653,53899570658,5,2480,1369,-40
53902111864,53902111870,6,3776,1503,-40
53905809867,53905809873,6,2332,1059,-40
53913839388,53913839393,5,3981,1501,-40
53914203959,53914203977,18,3626,1458,-40
53914485749,53914485763,14,2304,1029,-40
53923232112,53923232118,6,3281,1344,-40
53930652761,53930652766,5,2298,1230,-40
53935474463,53935474466,3,1844,1214,-40
53936745214,53936745220,6,2431,926,-40
53937178454,53937178443,-11,1509,370,-40
53939586251,53939586251,0,20220,20426,-40
53942507030,53942507038,8,3525,1947,-40
53943009520,53943009527,7,2852,1502,-40
53944466625,53944466631,6,1810,1328,-40
53950307078,53950307077,-1,1337,2060,-40
53952795492,53952795498,6,3836,2077,-40
53952834890,53952834897,7,5583,1261,-40
53954167409,53954167415,6,3693,1404,-40
53957977034,53957977042,8,2767,1008,-40
53968952229,53968952234,5,3380,1413,-40
53978838847,53978838854,7,3170,1286,-40
53982886599,53982886605,6,3459,1721,-40
53982922110,53982922117,7,4062,1290,-40
53992840118,53992840123,5,2255,981,-40
53994549174,53994549180,6,1737,1223,-40
53995231352,53995231358,6,3292,1266,-40
53997894949,53997894955,6,3033,1491,-40
54001795442,54001795449,7,3611,1586,-40
54005094170,54005094175,5,2368,1246,-40
54009855389,54009855395,6,3097,1310,-40
54013288573,54013288578,5,2875,1649,-40
54014594961,54014594966,5,2760,1050,-40
54027227361,54027227367,6,1519,1213,-40
54030388473,54030388479,6,3254,1345,-40
54030824270,54030824289,19,2770,1433,-40
54037910434,54037910420,-14,2754,1149,-40
54039500011,54039500016,5,1456,37371,-40
54040935575,54040935582,7,3141,1593,-40
54044153346,54044153352,6,2024,1253,-40
54044601618,54044601604,-14,958,448,-40
54045182691,54045182693,2,5996,3864,-40
54045479131,54045479138,7,3322,1541,-40
54045700305,54045700309,4,3778,1365,-40
54049635505,54049635513,8,2074,1212,-40
54051787114,54051787121,7,4467,1055,-40
54056965604,54056965611,7,2532,1107,-40
54057182145,54057182163,18,2145,673,-40
54062093001,54062093015,14,104998,40499,-40
54062420122,54062420127,5,3689,1642,-40
54064980567,54064980574,7,2339,1393,-40
54069709969,54069709973,4,1391,813,-40
54075773518,54075773525,7,3041,1507,-40
54076654969,54076654977,8,4019,1674,-40
54081676572,54081676579,7,3507,1433,-40
54081719657,54081719666,9,3837,1513,-40
54083587719,54083587726,7,3418,1200,-40
54084176922,54084176924,2,23938,35557,-40
54084239531,54084239538,7,2537,927,-40
54086050555,54086050547,-8,1919,9192,-40
54088569025,54088569031,6,3512,1014,-40
54089869507,54089869514,7,2871,1110,-40
54090104694,54090104691,-3,1340,2554,-40
54094884795,54094884802,7,3115,1093,-40
54096483895,54096483901,6,2638,1318,-40
54096523494,54096523473,-21,2662,986,-40
54098901059,54098901063,4,4582,2762,-40
54099397449,54099397454,5,2758,1036,-40
54102582121,54102582125,4,2602,1440,-40
54106151513,54106151518,5,2835,1740,-40
54109688030,54109688036,6,3527,1757,-40
54111588022,54111588019,-3,1142,2199,-40
54114473406,54114473411,5,1968,819,-40
54118224783,54118224790,7,3469,1046,-40
54119277960,54119277962,2,1927,1944,-40
54121703029,54121703027,-2,1260,2316,-40
54123936278,54123936284,6,2411,1355,-40
54127614856,54127614862,6,3902,1486,-40
54128786071,54128786075,4,1264,1242,-40
54130077573,54130077577,4,3097,1549,-40
54130271178,54130271186,8,2389,1448,-40
54133517605,54133517598,-7,1399,8368,-40
54143514457,54143514464,7,4256,1414,-40
54143684792,54143684799,7,3244,1497,-40
54152400300,54152400306,6,3020,1893,-40
54154056084,54154056091,7,2485,1103,-40
54154266110,54154266113,3,901,108,-40
54154899181,54154899178,-3,6990,15587,-40
54161070983,54161070989,6,2701,1367,-40
54166906570,54166906577,7,2198,1204,-40
54172220198,54172220204,6,3433,1491,-40
54173673890,54173673899,9,3119,1288,-40
54175883277,54175883283,6,3406,1524,-40
54181350667,54181350671,4,1860,1131,-40
54182097301,54182097307,6,1701,1245,-40
54184475818,54184475823,5,3381,1205,-40
54184731995,54184732002,7,2751,1639,-40
54187103165,54187103171,6,2284,1119,-40
54188312037,54188312043,6,2071,555,-40
54190001310,54190001297,-13,2078,747,-40
54191470961,54191470967,6,3888,1382,-40
54191973487,54191973494,7,3267,1422,-40
54196540167,54196540174,7,2414,1141,-40
54197006278,54197006283,5,2379,1129,-40
54201814762,54201814769,7,2452,1103,-40
54212337570,54212337576,6,3061,1461,-40
54214077644,54214077650,6,2471,1326,-40
54214957749,54214957755,6,2574,888,-40
54224631197,54224631201,4,1736,790,-40
54227373549,54227373554,5,2599,1069,-40
54228046677,54228046682,5,3401,1013,-40
54228330284,54228330290,6,2800,1287,-40
54228530849,54228530857,8,2394,1092,-40
54228761063,54228761057,-6,1137,2052,-40
54230316681,54230316687,6,2223,1283,-40
54232410751,54232410756,5,2279,1562,-40
54238710233,54238710243,10,14362,20656,-40
54240076022,54240076027,5,1693,874,-40
54241324282,54241324291,9,2131,1143,-40
54243600994,54243601000,6,2351,1454,-40
54248359110,54248359107,-3,622,1957,-40
54250278837,54250278858,21,2185,1104,-40
54250529747,54250529752,5,2069,1317,-40
54258491949,54258491954,5,2764,849,-40
54258949079,54258949087,8,3258,1326,-40
54259604131,54259604113,-18,843,40,-40
54260150499,54260150506,7,1361,786,-40
54262483161,54262483162,1,1365,2498,-40
54265823971,54265823976,5,2453,1262,-40
54266536019,54266536026,7,2494,857,-40
54272147167,54272147174,7,3706,1906,-40
54272310743,54272310751,8,3757,1155,-40
54273683287,54273683293,6,3544,1761,-40
54278424945,54278424951,6,4161,1375,-40
54282526823,54282526829,6,2953,1579,-40
54283582734,54283582738,4,1890,1693,-40
54289499714,54289499722,8,4670,1294,-40
54292522948,54292522954,6,3467,877,-40
54300462115,54300462120,5,1351,634,-40
54305088916,54305088916,0,1041,1390,-40
54307280838,54307280842,4,1889,1340,-40
54312306645,54312306651,6,1843,893,-40
54314276426,54314276439,13,10518,45423,-40
54314570981,54314570987,6,3878,1527,-40
54316147526,54316147532,6,2649,992,-40
54318145469,54318145474,5,3373,1182,-40
54319160929,54319160929,0,36351,19921,-40
54321034637,54321034642,5,3700,1267,-40
54323258318,54323258322,4,2184,1444,-40
54324168547,54324168553,6,3050,1376,-40
54326025188,54326025189,1,2159,2103,-40
54330458606,54330458613,7,4415,1499,-40
54335334230,54335334235,5,2794,1184,-40
54335381347,54335381346,-1,495,224,-40
54337780029,54337780035,6,2987,1588,-40
54345587866,54345587871,5,2630,1175,-40
54346965942,54346965949,7,3012,1605,-40
54347335934,54347335941,7,3773,1071,-40
54349669176,54349669181,5,3701,1425,-40
54349968398,54349968405,7,3072,1254,-40
54350893022,54350893026,4,2905,1209,-40
54351225529,54351225534,5,1911,759,-40
54355104146,54355104154,8,3352,1030,-40
54355500181,54355500186,5,3197,1476,-40
54357831797,54357831803,6,1952,1081,-40
54358048845,54358048836,-9,3396,516,-40
54359758777,54359758784,7,3830,1433,-40
54362814938,54362814945,7,2347,1379,-40
54366740682,54366740689,7,8664,2956,-40
54368344152,54368344157,5,2431,1574,-40
54370789591,54370789597,6,3232,1166,-40
54371355678,54371355685,7,3392,1470,-40
54372235573,54372235577,4,2353,1712,-40
54374181502,54374181505,3,2022,1434,-40
54378022157,54378022163,6,1802,1111,-40
54378931081,54378931066,-15,723,503,-40
54384699228,54384699234,6,2630,1393,-40
54387644380,54387644385,5,1338,639,-40
54389137419,54389137427,8,1782,851,-40
54389965744,54389965751,7,3220,1026,-40
54395986894,54395986884,-10,1481,25782,-40
54397972458,54397972465,7,3096,1298,-40
54399386004,54399386011,7,1831,821,-40
54400732503,54400732509,6,1719,521,-40
54402388041,54402388047,6,2698,1416,-40
54403888112,54403888118,6,1518,1262,-40
54404096488,54404096505,17,3524,842,-40
54404217028,54404217008,-20,1774,776,-40
54405378876,54405378882,6,2885,1177,-40
54406217945,54406217953,8,1476,1229,-40
54406894482,54406894488,6,1006,399,-40
54407636253,54407636259,6,2506,1315,-40
54411992614,54411992615,1,3492,2395,-40
54414841102,54414841110,8,4975,1399,-40
54415669102,54415669108,6,2379,1156,-40
54416108291,54416108297,6,3641,1706,-40
54416294742,54416294747,5,1829,1527,-40
54433472390,54433472396,6,2325,762,-40
54435200261,54435200268,7,2830,1225,-40
54436712443,54436712438,-5,1189,3993,-40
54438371634,54438371638,4,1566,1385,-40
54438527881,54438527887,6,2180,903,-40
54442292822,54442292834,12,14264,33567,-40
54444603369,54444603376,7,4453,1553,-40
54452080556,54452080561,5,1930,1155,-40
54453032249,54453032234,-15,2146,824,-40
54456616898,54456616905,7,3126,1327,-40
54456788875,54456788883,8,2235,998,-40
54458912349,54458912343,-6,572,2985,-40
54459192883,54459192871,-12,1701,915,-40
54460097133,54460097139,6,2849,1278,-40
54460881279,54460881286,7,3105,1320,-40
54461239819,54461239826,7,3297,1720,-40
54461734494,54461734491,-3,23132,46079,-40
54462787930,54462787936,6,3649,1405,-40
54465218685,54465218692,7,2218,1033,-40
54474618524,54474618522,-2,2846,4892,-40
54476598317,54476598323,6,3384,1647,-40
54477027163,54477027176,13,2784,1141,-40
54481835926,54481835933,7,3218,1253,-40
54486509694,54486509700,6,3308,2117,-40
54487654578,54487654585,7,3544,1145,-40
54488870901,54488870919,18,3249,1417,-40
54494770497,54494770503,6,2841,1263,-40
54495108893,54495108898,5,1748,1010,-40
54495815062,54495815067,5,2349,1297,-40
54499160904,54499160910,6,3229,1488,-40
54502878634,54502878639,5,3087,1019,-40
54505716683,54505716690,7,1667,1075,-40
54511006462,54511006463,1,1959,1964,-40
54512333258,54512333265,7,2106,1108,-40
54512905005,54512905011,6,2355,1533,-40
54513519318,54513519324,6,4451,1389,-40
54514609230,54514609233,3,2036,1268,-40
54514876252,54514876232,-20,1620,1106,-40
54519049971,54519049976,5,1209,809,-40
54519940849,54519940854,5,3355,1443,-40
54521994214,54521994222,8,3670,1224,-40
54524670352,54524670349,-3,1247,2703,-40
54526287166,54526287174,8,3597,989,-40
54530273095,54530273093,-2,1642,2450,-40
54532624234,54532624238,4,1988,756,-40
54533901144,54533901150,6,1554,1106,-40
54534110114,54534110119,5,2305,1169,-40
54538374168,54538374173,5,4094,1757,-40
54538443821,54538443827,6,2643,819,-40
54539875834,54539875841,7,3502,1542,-40
54542635007,54542635011,4,2043,2094,-40
54543259366,54543259364,-2,2355,3074,-40
54544137405,54544137411,6,2146,861,-40
54546150573,54546150578,5,2466,1093,-40
54558475507,54558475511,4,2401,1026,-40
54558907713,54558907718,5,2424,1636,-40
54560796672,54560796679,7,1976,728,-40
54561000998,54561001003,5,1189,963,-40
54561670841,54561670845,4,3283,1673,-40
54574903625,54574903630,5,3297,1229,-40
54578639893,54578639895,2,1464,1483,-40
54582939449,54582939457,8,3541,1191,-40
54591075474,54591075479,5,3308,1386,-40
54597446108,54597446113,5,3021,1629,-40
54604257691,54604257711,20,641,1070,-40
54604749318,54604749300,-18,2786,1258,-40
54606018449,54606018457,8,3282,1141,-40
54614166487,54614166493,6,1793,783,-40
54618343254,54618343253,-1,977,3341,-40
54622014385,54622014392,7,3039,1306,-40
54622357280,54622357287,7,2272,1069,-40
54624211422,54624211426,4,2091,1331,-40
54625253894,54625253891,-3,1809,3893,-40
54626649573,54626649579,6,3220,1394,-40
54626891494,54626891474,-20,4163,1580,-40
54629366802,54629366810,8,2843,1432,-40
54631450290,54631450306,16,16644,27744,-40
54633463726,54633463732,6,3805,1551,-40
54636884123,54636884116,-7,1344,3403,-40
54642084489,54642084494,5,3811,1641,-40
54645088179,54645088187,8,3623,1301,-40
54649170177,54649170184,7,2870,1319,-40
54653029483,54653029480,-3,23255,21345,-40
54656227761,54656227766,5,1890,956,-40
54656339382,54656339389,7,2287,1150,-40
54658742606,54658742611,5,1271,985,-40
54660322575,54660322581,6,2595,1306,-40
54661006546,54661006554,8,1561,687,-40
54663832219,54663832227,8,4446,1938,-40
54666639384,54666639391,7,2918,1079,-40
54670197254,54670197237,-17,1776,1180,-40
54671914585,54671914594,9,2936,1352,-40
54673242949,54673242955,6,2491,948,-40
54674031870,54674031877,7,1527,586,-40
54674622809,54674622814,5,2755,964,-40
54676285025,54676285032,7,2715,1110,-40
54676469878,54676469857,-21,1152,445,-40
54683239848,54683239855,7,2732,1375,-40
54684969421,54684969429,8,3631,1673,-40
54685471030,54685471037,7,2972,1483,-40
54689424724,54689424729,5,1971,1229,-40
54691905883,54691905893,10,806,362,-40
54701524014,54701524029,15,16964,52857,-40
54702888938,54702888921,-17,2847,1721,-40
54706898635,54706898641,6,3209,1540,-40
54707337686,54707337693,7,2404,969,-40
54707937660,54707937665,5,3502,1438,-40
54714695525,54714695531,6,3606,1080,-40
54725271284,54725271289,5,2432,797,-40
54734335942,54734335947,5,2814,1613,-40
54742911101,54742911109,8,2881,1115,-40
54745988854,54745988861,7,3009,1407,-40
54748598274,54748598279,5,3519,1501,-40
54750981105,54750981110,5,1583,1057,-40
54755754146,54755754151,5,3326,1397,-40
54757444022,54757444022,0,2404,1103,-40
54758810176,54758810183,7,1572,1016,-40
54760649742,54760649747,5,3049,1310,-40
54767623522,54767623527,5,2068,1313,-40
54769551090,54769551098,8,3154,1585,-40
54769854708,54769854713,5,1592,1413,-40
54772189405,54772189387,-18,1461,533,-40
54772742061,54772742068,7,3063,986,-40
54772857910,54772857914,4,1742,752,-40
54773621358,54773621365,7,2789,1408,-40
54775988155,54775988160,5,2643,1524,-40
54777505123,54777505130,7,892,244,-40
54778747949,54778747970,21,2663,1040,-40
54781263127,54781263125,-2,667,2284,-40
54783624753,54783624758,5,3713,1088,-40
54785826311,54785826318,7,2527,985,-40
54786435087,54786435088,1,2177,2007,-40
54786699661,54786699668,7,3936,1630,-40
54790061371,54790061369,-2,1110,1438,-40
54792599593,54792599599,6,3530,1738,-40
54798593145,54798593150,5,2718,939,-40
54801125970,54801125977,7,5029,2586,-40
54801896117,54801896122,5,2154,1349,-40
54802591297,54802591305,8,4669,1173,-40
54812263814,54812263819,5,2225,973,-40
54813775569,54813775575,6,3321,1096,-40
54815402183,54815402188,5,3269,940,-40
54817095101,54817095107,6,1148,414,-40
54817591937,54817591946,9,3808,1291,-40
54817933443,54817933451,8,4141,1552,-40
54818546087,54818546091,4,2016,868,-40
54831301177,54831301185,8,2260,942,-40
54831672916,54831672921,5,2146,1546,-40
54835636542,54835636549,7,2018,1297,-40
54836570328,54836570333,5,3310,1648,-40
54837306778,54837306785,7,3006,1346,-40
54839750190,54839750195,5,2630,936,-40
54843034794,54843034802,8,3049,1280,-40
54845159682,54845159690,8,2773,1048,-40
54845978109,54845978114,5,2753,1108,-40
54847974272,54847974278,6,3017,1360,-40
54854114244,54854114250,6,2017,1164,-40
54855379178,54855379187,9,4308,1655,-40
54858444311,54858444317,6,3256,1426,-40
54859965785,54859965791,6,1971,649,-40
54860955692,54860955697,5,2774,1361,-40
54866720510,54866720515,5,2885,901,-40
54866802506,54866802522,16,1128,1197,-40
54868181142,54868181147,5,2879,1069,-40
54874528721,54874528726,5,2306,1280,-40
54881761754,54881761756,2,30620,17625,-40
54887636046,54887636053,7,2739,1178,-40
54891589981,54891589986,5,1764,951,-40
54894716357,54894716362,5,1776,668,-40
54894869776,54894869792,16,3010,1013,-40
54896783568,54896783574,6,2306,1415,-40
54899548450,54899548453,3,1704,1769,-40
54900136997,54900136989,-8,1907,9709,-40
54902688986,54902688988,2,1613,2293,-40
54903559363,54903559370,7,2652,1391,-40
54908290314,54908290319,5,2853,1058,-40
54911171769,54911171773,4,2514,1072,-40
54911568539,54911568546,7,3442,1672,-40
54918245125,54918245131,6,2825,1041,-40
54918518290,54918518276,-14,1836,774,-40
54924291074,54924291079,5,2890,1342,-40
54924923076,54924923081,5,3109,1325,-40
54929760367,54929760373,6,3237,1255,-40
54936597713,54936597718,5,3169,1276,-40
54937486829,54937486835,6,3454,1106,-40
54937766722,54937766731,9,18307,954,-40
54941611111,54941611118,7,2931,895,-40
54950932146,54950932151,5,2800,1157,-40
54952055148,54952055128,-20,4557,1481,-40
54952143254,54952143259,5,2991,1335,-40
54957454873,54957454878,5,2217,1536,-40
54957906670,54957906676,6,3952,1161,-40
54960005409,54960005415,6,2533,1722,-40
54964182474,54964182480,6,3659,1246,-40
54968143830,54968143835,5,3118,1138,-40
54975673945,54975673951,6,4352,2001,-40
54978447084,54978447091,7,2628,1146,-40
54979166101,54979166109,8,2755,1473,-40
54982813198,54982813204,6,3926,1040,-40
54984891851,54984891857,6,3839,1639,-40
54986877319,54986877325,6,3485,1566,-40
54993076957,54993076965,8,5991,831,-40
54994387174,54994387178,4,2652,1191,-40
54997071752,54997071759,7,2773,1793,-40
54997826774,54997826781,7,3125,1678,-40
55000159660,55000159671,11,2694,1218,-40
55000501745,55000501739,-6,775,344,-40
55000978252,55000978249,-3,4131,9343,-40
55001298067,55001298051,-16,659,249,-40
55003928001,55003928007,6,3215,1265,-40
55004573110,55004573113,3,970,1148,-40
55007342447,55007342455,8,2974,1208,-40
55009719109,55009719113,4,3868,1445,-40
55010260494,55010260502,8,3218,1530,-40
55013774030,55013774036,6,3417,1808,-40
55018717891,55018717898,7,3694,1449,-40
55019075393,55019075398,5,5575,2010,-40
55019276850,55019276856,6,3072,1260,-40
55021645206,55021645214,8,2312,745,-40
55023965986,55023965991,5,2862,1652,-40
55029423166,55029423171,5,1880,1325,-40
55029460362,55029460348,-14,1650,476,-40
55030505354,55030505348,-6,1228,4806,-40
55033628399,55033628404,5,3010,1742,-40
55037095900,55037095908,8,3335,1718,-40
55039939354,55039939362,8,2247,1317,-40
55040244081,55040244088,7,3556,1809,-40
55041336929,55041336933,4,2778,1474,-40
55049492751,55049492758,7,3033,1393,-40
55057426290,55057426294,4,10452,17794,-40
55059493160,55059493166,6,4242,1585,-40
55065348243,55065348238,-5,753,1890,-40
55072467038,55072467045,7,3799,1498,-40
55072583589,55072583595,6,2824,1061,-40
55078760602,55078760608,6,2824,1253,-40
55078851634,55078851644,10,926,75,-40
55079324033,55079324039,6,2734,938,-40
55081430264,55081430269,5,3332,1421,-40
55082550726,55082550731,5,1794,978,-40
55086101766,55086101760,-6,2144,7676,-40
55086795857,55086795861,4,1660,997,-40
55096807220,55096807225,5,1913,1253,-40
55097635325,55097635331,6,3262,1378,-40
55099682680,55099682686,6,2683,658,-40
55100890018,55100890024,6,1798,891,-40
55103771585,55103771591,6,3051,1330,-40
55104401329,55104401336,7,2799,1129,-40
55107468229,55107468235,6,3294,1203,-40
55115336581,55115336586,5,2014,1044,-40
55115999812,55115999818,6,1922,897,-40
55121518599,55121518606,7,1531,1382,-40
55122024783,55122024790,7,2363,1051,-40
55126291304,55126291311,7,3877,1189,-40
55127720201,55127720197,-4,1292,2880,-40
55128616353,55128616361,8,2079,1131,-40
55128848089,55128848080,-9,1008,326,-40
55132036861,55132036866,5,3703,1586,-40
55133354865,55133354870,5,2015,1262,-40
55144166012,55144166018,6,2107,977,-40
55146071661,55146071663,2,1843,1668,-40
55146732433,55146732441,8,3102,793,-40
55151147098,55151147103,5,2424,827,-40
55153790225,55153790230,5,2220,678,-40
55157273834,55157273831,-3,1439,5218,-40
55165350589,55165350590,1,4149,53242,-40
55165528105,55165528112,7,4092,1085,-40
55169199534,55169199517,-17,1156,439,-40
55169975042,55169975047,5,1380,836,-40
55170874126,55170874135,9,3699,1069,-40
55173125247,55173125240,-7,50593,15651,-40
55178687085,55178687090,5,2323,990,-40
55180072510,55180072517,7,1699,1114,-40
55180123548,55180123563,15,1511,1272,-40
55194932430,55194932435,5,2125,1065,-40
55199374186,55199374194,8,2072,1018,-40
55212184862,55212184870,8,2071,774,-40
55212310879,55212310891,12,2940,1172,-40
55213407202,55213407186,-16,2065,1112,-40
55219645742,55219645748,6,3993,1745,-40
55221904293,55221904298,5,2534,1148,-40
55225084967,55225084974,7,2888,1744,-40
55226135321,55226135327,6,3894,1801,-40
55229586964,55229586970,6,2910,1394,-40
55232582943,55232582947,4,2801,1306,-40
55234615694,55234615700,6,3046,1121,-40
55236819358,55236819363,5,3238,1279,-40
55237415957,55237415964,7,2839,1195,-40
55237558226,55237558208,-18,1311,257,-40
55239138589,55239138585,-4,508,2907,-40
55239267640,55239267647,7,2074,1268,-40
55239538579,55239538585,6,3103,1833,-40
55242213918,55242213916,-2,1040,1836,-40
55242499541,55242499547,6,3019,1285,-40
55243751271,55243751277,6,3317,1722,-40
55246659977,55246659983,6,2487,1217,-40
55247685015,55247685012,-3,1441,2691,-40
55249217751,55249217758,7,1228,913,-40
55254360765,55254360772,7,3095,1250,-40
55257031333,55257031338,5,3772,1322,-40
55259210799,55259210795,-4,409,102,-40
55261323261,55261323266,5,3104,1789,-40
55262492658,55262492664,6,2572,1180,-40
55263039527,55263039506,-21,4239,1510,-40
55266176238,55266176244,6,2072,1015,-40
55266381230,55266381224,-6,2584,7918,-40
55266599559,55266599563,4,2213,1260,-40
55268840054,55268840062,8,3745,1179,-40
55269712834,55269712839,5,2595,1354,-40
55270050164,55270050170,6,2504,1287,-40
55277210128,55277210135,7,2949,1138,-40
55278742470,55278742476,6,2770,1165,-40
55278948870,55278948850,-20,1964,892,-40
55279727034,55279727039,5,2645,1070,-40
55284988215,55284988222,7,2615,1221,-40
55300848968,55300848967,-1,1664,1407,-40
55302498201,55302498208,7,4085,1796,-40
55302701608,55302701614,6,3415,1306,-40
55302783481,55302783486,5,3798,1863,-40
55302938071,55302938077,6,2403,1215,-40
55304167990,55304167998,8,3966,1268,-40
55309399938,55309399943,5,2615,1256,-40
55310331178,55310331182,4,2211,887,-40
55313220251,55313220258,7,2645,1197,-40
55313678809,55313678817,8,3236,1497,-40
55313724794,55313724779,-15,1126,119,-40
55314303340,55314303348,8,1313,754,-40
55315863825,55315863830,5,1963,841,-40
55317270439,55317270443,4,2674,1633,-40
55317610855,55317610862,7,3291,1348,-40
55317669913,55317669920,7,1434,784,-40
55323436434,55323436442,8,3483,1905,-40
55326858222,55326858229,7,3927,1025,-40
55329744076,55329744083,7,2249,1938,-40
55330083741,55330083749,8,4688,1669,-40
55330753809,55330753818,9,2291,938,-40
55331673955,55331673962,7,2413,866,-40
55331720034,55331720018,-16,2888,1752,-40
55333895099,55333895098,-1,1133,2083,-40
55336214204,55336214210,6,3388,1298,-40
55338073490,55338073474,-16,2447,1120,-40
55339705294,55339705300,6,3340,1693,-40
55341154713,55341154730,17,2598,1067,-40
55341213570,55341213553,-17,3410,1534,-40
55341633805,55341633814,9,2980,983,-40
55347932406,55347932412,6,2698,1234,-40
55352067108,55352067114,6,3270,1496,-40
55357287414,55357287421,7,3400,1079,-40
55363725838,55363725843,5,1264,411,-40
55367146644,55367146664,20,13554,50742,-40
55371632263,55371632270,7,3155,1312,-40
55373195307,55373195313,6,3112,1679,-40
55412299594,55412299601,7,2784,1286,-40
55413877274,55413877269,-5,1181,3042,-40
55425342662,55425342670,8,2576,1139,-40
55430771330,55430771337,7,2905,928,-40
55430979029,55430979009,-20,1023,482,-40
55432662994,55432662999,5,2184,905,-40
55435208902,55435208907,5,2497,1002,-40
55439589279,55439589285,6,3263,1088,-40
55441631389,55441631390,1,2170,1535,-40
55442445102,55442445110,8,2646,1394,-40
55443172842,55443172858,16,3087,1466,-40
55443630139,55443630147,8,1691,552,-40
55443734004,55443734011,7,2182,1126,-40
55451373306,55451373313,7,2468,908,-40
55456276052,55456276057,5,1958,1626,-40
55461962753,55461962755,2,2684,1803,-40
55471028244,55471028251,7,3452,1043,-40
55471291357,55471291362,5,2837,1255,-40
55471942886,55471942894,8,3168,1626,-40
55472645326,55472645334,8,2374,838,-40
55475883870,55475883873,3,1659,820,-40
55478616446,55478616450,4,2750,1122,-40
55479232126,55479232133,7,2112,749,-40
55483480201,55483480205,4,2156,1157,-40
55485599382,55485599391,9,3554,1170,-40
55486170786,55486170802,16,3368,1778,-40
55487988553,55487988558,5,2991,1035,-40
55488438456,55488438467,11,2392,1199,-40
55495284114,55495284120,6,2681,1163,-40
55496279802,55496279805,3,858,161,-40
55498677354,55498677358,4,1897,1123,-40
55499148321,55499148304,-17,1280,362,-40
55501905576,55501905594,18,362,1466,-40
55503700935,55503700916,-19,3503,1637,-40
55503920415,55503920408,-7,786,144,-40
55507338413,55507338420,7,2827,1460,-40
55508751467,55508751475,8,3769,1258,-40
55511214978,55511214982,4,2009,934,-40
55511303959,55511303946,-13,1536,631,-40
55514134613,55514134621,8,2986,1264,-40
55517584081,55517584088,7,13629,7012,-40
55519469265,55519469270,5,2277,1145,-40
55519699413,55519699419,6,3190,1144,-40
55521187749,55521187760,11,12963,36244,-40
55523516084,55523516090,6,2787,989,-40
55524461631,55524461637,6,3023,1608,-40
55525390312,55525390313,1,1340,2110,-40
55526125366,55526125375,9,3878,1379,-40
55526967106,55526967112,6,1430,1074,-40
55530460050,55530460057,7,2791,1323,-40
55531128211,55531128214,3,2328,1082,-40
55531647850,55531647833,-17,3417,634,-40
55532158688,55532158696,8,3580,1495,-40
55537562550,55537562555,5,2018,1131,-40
55539183332,55539183337,5,3290,2067,-40
55540239548,55540239553,5,2736,1155,-40
55540661842,55540661848,6,1920,686,-40
55543557058,55543557063,5,2295,1393,-40
55544744555,55544744564,9,3658,1667,-40
55546375223,55546375230,7,2901,1145,-40
55548158913,55548158917,4,2030,1021,-40
55549209111,55549209118,7,2965,1159,-40
55551763987,55551763994,7,2922,1221,-40
55552872840,55552872846,6,3786,1165,-40
55558379854,55558379859,5,2727,1350,-40
55559276731,55559276738,7,2844,1058,-40
55559947186,55559947193,7,3887,873,-40
55564894531,55564894539,8,2486,1300,-40
55566113177,55566113178,1,32175,32298,-40
55572868909,55572868905,-4,1049,3424,-40
55575770923,55575770930,7,2477,1118,-40
55576142479,55576142485,6,2969,1194,-40
55585560060,55585560066,6,3076,1313,-40
55585639022,55585639002,-20,1194,479,-40
55588737093,55588737098,5,3933,1646,-40
55590572538,55590572545,7,2760,998,-40
55590773410,55590773415,5,2665,1580,-40
55591511795,55591511801,6,1831,1312,-40
55591996770,55591996766,-4,1217,3957,-40
55592600075,55592600082,7,4163,1204,-40
55595168453,55595168459,6,2579,1402,-40
55599852695,55599852701,6,1760,903,-40
55608371110,55608371117,7,2582,1412,-40
55613595087,55613595093,6,2040,1336,-40
55614589559,55614589567,8,3523,1399,-40
55615635730,55615635744,14,549,100,-40
55618567525,55618567529,4,3342,1381,-40
55619858553,55619858558,5,3186,987,-40
55620929790,55620929796,6,1247,733,-40
55623593042,55623593049,7,3264,1363,-40
55624128669,55624128674,5,2313,993,-40
55624403258,55624403256,-2,1097,279,-40
55632435810,55632435815,5,2235,864,-40
55633904680,55633904684,4,3322,1511,-40
55634568710,55634568717,7,2774,1364,-40
55640948722,55640948727,5,1925,1134,-40
55642492662,55642492666,4,4065,2976,-40
55646622905,55646622911,6,2714,1766,-40
55651300928,55651300934,6,2268,1169,-40
55653605362,55653605366,4,2537,1387,-40
55654006187,55654006193,6,2758,1618,-40
55656428963,55656428958,-5,1012,2948,-40
55660231336,55660231342,6,3368,1502,-40
55660934122,55660934129,7,3122,1569,-40
55666099798,55666099804,6,2496,1396,-40
55666218538,55666218545,7,2879,1256,-40
55666588957,55666588951,-6,1331,5223,-40
55666713093,55666713100,7,2864,1367,-40
55669337105,55669337110,5,3921,1280,-40
55670134082,55670134085,3,1533,1262,-40
55670775011,55670775018,7,2842,1039,-40
55670804197,55670804180,-17,3031,1152,-40
55673574684,55673574690,6,2833,1959,-40
55674814622,55674814628,6,2341,744,-40
55676311589,55676311576,-13,1250,354,-40
55679163007,55679162997,-10,60773,26466,-40
55679826745,55679826751,6,2168,1200,-40
55689049790,55689049797,7,2680,1316,-40
55689608361,55689608367,6,2394,1075,-40
55689831004,55689831011,7,6807,2775,-40
55692223214,55692223221,7,3202,1466,-40
55692959730,55692959726,-4,1529,4057,-40
55695005242,55695005248,6,1338,1660,-40
55696613538,55696613545,7,4654,1446,-40
55699684587,55699684593,6,2225,1403,-40
55699862125,55699862131,6,1937,781,-40
55703911814,55703911820,6,2195,1292,-40
55705690152,55705690158,6,2944,1361,-40
55706007798,55706007792,-6,1323,206,-40
55706896309,55706896316,7,3892,1626,-40
55715220929,55715220935,6,1805,912,-40
55717288277,55717288284,7,1521,862,-40
55717364669,55717364674,5,1999,1177,-40
55718820883,55718820890,7,3512,1348,-40
55727345313,55727345318,5,2307,841,-40
55728705424,55728705430,6,2146,1285,-40
55730663745,55730663750,5,3889,1465,-40
55732274571,55732274579,8,3069,1478,-40
55736135258,55736135258,0,25511,32433,-40
55741583039,55741583040,1,1790,1851,-40
55742236917,55742236923,6,2402,1108,-40
55744147720,55744147718,-2,1483,2101,-40
55745646891,55745646898,7,2043,747,-40
55746563798,55746563805,7,2300,1103,-40
55748185101,55748185120,19,3266,1329,-40
55749849798,55749849805,7,4862,2003,-40
55752485766,55752485772,6,3296,1686,-40
55753923974,55753923979,5,1633,1172,-40
55754335657,55754335662,5,2827,1303,-40
55756767405,55756767411,6,2613,1392,-40
55758914258,55758914264,6,2541,1375,-40
55759958575,55759958583,8,3123,1297,-40
55760095197,55760095202,5,3015,1378,-40
55763529303,55763529308,5,2172,820,-40
55763603776,55763603782,6,3583,1886,-40
55765140526,55765140534,8,3841,937,-40
55766219189,55766219196,7,3965,1431,-40
55768726941,55768726946,5,3233,1066,-40
55770949452,55770949459,7,3400,1525,-40
55776266905,55776266911,6,2200,1380,-40
55781153024,55781153031,7,4255,1365,-40
55783403281,55783403287,6,2142,1514,-40
55793238129,55793238136,7,2296,1229,-40
55797576103,55797576110,7,1905,1057,-40
55799873896,55799873902,6,2085,1234,-40
55800228689,55800228698,9,4668,1553,-40
55802548518,55802548525,7,2462,1210,-40
55802860113,55802860117,4,1839,1756,-40
55804207556,55804207563,7,4359,1406,-40
55804307393,55804307380,-13,1907,805,-40
55806133202,55806133209,7,2269,1145,-40
55809366897,55809366902,5,3474,1038,-40
55815567045,55815567051,6,2597,1185,-40
55817471258,55817471263,5,2246,1339,-40
55820275234,55820275229,-5,1082,2753,-40
55820660446,55820660451,5,4305,3658,-40
55821695062,55821695071,9,2076,849,-40
55822768826,55822768830,4,1651,1535,-40
55824338321,55824338304,-17,1857,1274,-40
55827647492,55827647500,8,2975,1098,-40
55830219178,55830219186,8,2665,1205,-40
55830317054,55830317032,-22,1583,724,-40
55835000861,55835000866,5,3067,1188,-40
55835838661,55835838667,6,3129,1747,-40
55839812028,55839812034,6,1618,1087,-40
55840601638,55840601643,5,2062,1141,-40
55842718514,55842718521,7,2139,901,-40
55845632696,55845632693,-3,833,2079,-40
55854344574,55854344579,5,2746,850,-40
55859908966,55859908959,-7,1540,29182,-40
55863510817,55863510825,8,1740,886,-40
55867543020,55867543017,-3,1113,1449,-40
55871368211,55871368217,6,3187,1514,-40
55873201184,55873201191,7,3065,1302,-40
55875083116,55875083121,5,2514,1126,-40
55876201394,55876201401,7,2310,1314,-40
55878741789,55878741795,6,2550,1136,-40
55884481953,55884481958,5,3253,1192,-40
55885212706,55885212707,1,1271,1497,-40
55887356820,55887356827,7,2776,1108,-40
55891912172,55891912178,6,2830,1223,-40
55904691212,55904691218,6,3193,769,-40
55905614709,55905614715,6,4503,1180,-40
55906310058,55906310062,4,2317,1272,-40
55909097590,55909097597,7,2540,1232,-40
55911854826,55911854833,7,2521,1045,-40
55912219444,55912219447,3,1418,1412,-40
55915012787,55915012782,-5,2333,6930,-40
55915725432,55915725438,6,4611,1438,-40
55917440015,55917440020,5,2714,1142,-40
55919155025,55919155032,7,3304,1662,-40
55920529773,55920529778,5,2796,1571,-40
55921265169,55921265166,-3,1426,3614,-40
55921433502,55921433511,9,2777,968,-40
55922426302,55922426299,-3,1267,2588,-40
55924961809,55924961816,7,1906,974,-40
55926138375,55926138373,-2,19183,19877,-40
55928552989,55928552994,5,2540,1143,-40
55929065642,55929065649,7,15192,23420,-40
55932627581,55932627586,5,3163,1780,-40
55934719306,55934719313,7,3152,1571,-40
55936183251,55936183256,5,1865,1417,-40
55936653302,55936653299,-3,927,412,-40
55937041577,55937041582,5,2946,1827,-40
55937593221,55937593227,6,3256,1578,-40
55938480566,55938480567,1,1328,1524,-40
55939135313,55939135318,5,3556,1405,-40
55941039986,55941039990,4,2143,1808,-40
55946174505,55946174511,6,3336,1339,-40
55947303996,55947304016,20,2706,1395,-40
55947771819,55947771800,-19,830,51,-40
55949810188,55949810193,5,1861,1188,-40
55954027632,55954027630,-2,925,1206,-40
55954921550,55954921557,7,3814,1496,-40
55955902553,55955902558,5,2866,1352,-40
55956247619,55956247626,7,2978,1503,-40
55956831761,55956831767,6,1684,945,-40
55962705042,55962705042,0,1726,1582,-40
55964903130,55964903134,4,2977,1322,-40
55967638830,55967638837,7,2475,1340,-40
55968180217,55968180223,6,3223,1210,-40
55968469297,55968469302,5,2249,1419,-40
55968542056,55968542044,-12,1861,1136,-40
55976894609,55976894617,8,3575,1357,-40
55978962654,55978962650,-4,1093,3240,-40
55979791293,55979791299,6,1729,909,-40
55980311785,55980311783,-2,2340,4675,-40
55980718399,55980718405,6,3563,1485,-40
55982255597,55982255601,4,2332,1605,-40
55986631989,55986631996,7,2998,1413,-40
55988204683,55988204687,4,1835,1206,-40
55991989068,55991989074,6,2424,951,-40
55992203122,55992203130,8,2139,1009,-40
55997476993,55997476999,6,2915,1941,-40
55998382147,55998382144,-3,25283,24573,-40
56000123300,56000123300,0,1916,2332,-40
56002728938,56002728942,4,2322,1069,-40
56003557170,56003557155,-15,1724,751,-40
56005112715,56005112723,8,1899,899,-40
56005471454,56005471462,8,2357,1343,-40
56006347622,56006347630,8,3383,1429,-40
56008593358,56008593363,5,2554,1120,-40
56010316139,56010316146,7,2664,1074,-40
56013096690,56013096697,7,2878,1129,-40
56016421140,56016421147,7,4104,1462,-40
56024074495,56024074498,3,2440,1957,-40
56025149883,56025149889,6,2084,1615,-40
56026149762,56026149769,7,3397,1673,-40
56028215576,56028215583,7,3055,1680,-40
56028497906,56028497913,7,3009,1644,-40
56029694016,56029694000,-16,2215,974,-40
56031172194,56031172197,3,2195,1910,-40
56033218594,56033218597,3,2180,1254,-40
56040588406,56040588411,5,2642,1476,-40
56043562157,56043562161,4,2581,1348,-40
56044193514,56044193513,-1,856,1725,-40
56045103604,56045103611,7,3308,1286,-40
56050416723,56050416729,6,2508,1395,-40
56053052221,56053052229,8,2570,1585,-40
56053097106,56053097113,7,2365,1310,-40
56055253794,56055253798,4,2634,1314,-40
56061264578,56061264582,4,2963,1437,-40
56063468595,56063468602,7,2357,1132,-40
56066269365,56066269371,6,3767,1383,-40
56074163129,56074163134,5,2387,1338,-40
56075545826,56075545831,5,2648,1320,-40
56077221649,56077221655,6,3567,1333,-40
56078670637,56078670643,6,3632,1551,-40
56084769479,56084769483,4,2872,1506,-40
56085035373,56085035380,7,4356,1596,-40
56090723094,56090723103,9,2407,1492,-40
56102704471,56102704479,8,19511,58141,-40
56103231887,56103231893,6,3069,1211,-40
56103369233,56103369240,7,2759,1351,-40
56106695397,56106695398,1,1671,2277,-40
56106925795,56106925801,6,2516,996,-40
56107119089,56107119073,-16,2678,1158,-40
56107851140,56107851161,21,3148,946,-40
56109285382,56109285389,7,2896,1277,-40
56110050229,56110050235,6,3258,1473,-40
56112290273,56112290282,9,2669,1236,-40
56115417340,56115417346,6,3189,1661,-40
56117896239,56117896241,2,27037,34206,-40
56119099429,56119099422,-7,1249,3187,-40
56121568605,56121568611,6,2782,1001,-40
56124712646,56124712651,5,2301,868,-40
56127621589,56127621587,-2,1451,3104,-40
56133304983,56133304987,4,1446,1158,-40
56136836364,56136836371,7,4002,1067,-40
56138244520,56138244526,6,3032,882,-40
56138854289,56138854295,6,2933,1543,-40
56143177497,56143177502,5,2181,1065,-40
56146329697,56146329706,9,4221,1273,-40
56147705155,56147705161,6,3652,1693,-40
56158178674,56158178680,6,2988,1174,-40
56160104526,56160104529,3,1999,1070,-40
56161010853,56161010858,5,2578,1609,-40
56161773034,56161773041,7,2626,1301,-40
56162924800,56162924806,6,3549,1738,-40
56167059903,56167059909,6,2052,1473,-40
56170616443,56170616448,5,1946,1166,-40
56172660915,56172660927,12,3049,1395,-40
56174626891,56174626879,-12,2124,1431,-40
56175526544,56175526545,1,1636,1802,-40
56177066106,56177066111,5,2525,977,-40
56177160097,56177160094,-3,1374,2625,-40
56181882592,56181882597,5,2718,757,-40
56183110838,56183110843,5,3686,1222,-40
56183812870,56183812876,6,2372,1493,-40
56186840953,56186840961,8,3322,1552,-40
56188052919,56188052919,0,1555,1483,-40
56191664822,56191664829,7,2599,1041,-40
56195629395,56195629399,4,1772,1298,-40
56215340320,56215340328,8,3514,1652,-40
56217440066,56217440069,3,1734,1265,-40
56218225365,56218225370,5,1349,407,-40
56219768033,56219768039,6,2914,966,-40
56219979825,56219979811,-14,2450,1046,-40
56223008640,56223008647,7,2177,657,-40
56225433280,56225433281,1,1973,803,-40
56230529300,56230529306,6,2083,1596,-40
56231181779,56231181794,15,2848,1354,-40
56231343402,56231343385,-17,3492,1181,-40
56231382506,56231382511,5,2603,1540,-40
56232001062,56232001071,9,2480,905,-40
56232528888,56232528900,12,866,200,-40
56234137167,56234137173,6,3288,1261,-40
56237834765,56237834771,6,3406,1379,-40
56240388383,56240388390,7,3499,1619,-40
56241503717,56241503699,-18,1009,348,-40
56244453253,56244453252,-1,35830,20840,-40
56245094458,56245094465,7,2520,1382,-40
56247670486,56247670485,-1,789,2629,-40
56254622778,56254622783,5,3391,1330,-40
56256391062,56256391066,4,2571,1118,-40
56258859584,56258859590,6,2900,1407,-40
56258930251,56258930266,15,3444,1229,-40
56266217054,56266217061,7,4105,1665,-40
56268678715,56268678726,11,3408,1182,-40
56272299769,56272299768,-1,2487,2465,-40
56272970099,56272970106,7,2037,1287,-40
56277585689,56277585691,2,1762,1156,-40
56279263691,56279263691,0,6739,9282,-40
56296076412,56296076418,6,1968,1010,-40
56302694766,56302694770,4,8421,31666,-40
56306451374,56306451381,7,1740,986,-40
56309561659,56309561666,7,2720,1131,-40
56312387317,56312387323,6,1800,1315,-40
56312891556,56312891538,-18,1993,889,-40
56314366225,56314366230,5,2360,870,-40
56315150835,56315150843,8,2794,1289,-40
56317138286,56317138290,4,1992,1451,-40
56317648191,56317648197,6,2188,1205,-40
56323330972,56323330966,-6,805,3792,-40
56325790239,56325790248,9,1386,1186,-40
56344533318,56344533327,9,2742,1157,-40
56345208579,56345208562,-17,1673,661,-40
56345365775,56345365781,6,3473,1577,-40
56348306745,56348306750,5,2757,1409,-40
56358331834,56358331841,7,2778,1532,-40
56358782879,56358782886,7,3025,1129,-40
56368227255,56368227262,7,2577,1043,-40
56368950863,56368950868,5,1348,843,-40
56372547414,56372547418,4,2556,1309,-40
56379035931,56379035937,6,2505,1627,-40
56384636656,56384636662,6,2766,1374,-40
56387233291,56387233290,-1,1366,963,-40
56389424103,56389424103,0,591,1670,-40
56393233231,56393233233,2,1727,1297,-40
56395843898,56395843902,4,3434,1536,-40
56396242479,56396242466,-13,976,555,-40
56400316775,56400316761,-14,1758,1004,-40
56400797057,56400797063,6,4411,1850,-40
56403888774,56403888779,5,2188,1848,-40
56405992355,56405992362,7,3688,1302,-40
56408335751,56408335757,6,2490,1081,-40
56413096350,56413096357,7,4040,1384,-40
56418312168,56418312173,5,2285,1042,-40
56418882099,56418882106,7,2261,1127,-40
56422348330,56422348337,7,2226,1038,-40
56429250476,56429250482,6,2683,1087,-40
56432966119,56432966126,7,2584,1038,-40
56435652054,56435652059,5,1637,668,-40
56437354573,56437354577,4,1462,1313,-40
56437440333,56437440339,6,3141,1420,-40
56438922544,56438922551,7,2353,925,-40
56441210013,56441210019,6,2784,1498,-40
56447942787,56447942794,7,4213,1493,-40
56449037969,56449037970,1,1776,1511,-40
56449541450,56449541457,7,2770,1434,-40
56451079639,56451079647,8,5777,1510,-40
56451402209,56451402215,6,2446,1546,-40
56456858318,56456858323,5,2014,697,-40
56456989685,56456989675,-10,814,211,-40
56460661576,56460661582,6,3189,1135,-40
56462292538,56462292544,6,3355,1616,-40
56465947601,56465947607,6,2495,1363,-40
56466412978,56466412980,2,3963,3472,-40
56467858410,56467858415,5,2288,1232,-40
56471585268,56471585271,3,2385,1585,-40
56473786749,56473786754,5,2820,1423,-40
56475388916,56475388922,6,2849,1484,-40
56477638415,56477638421,6,3415,1635,-40
56478800490,56478800474,-16,847,541,-40
56480730857,56480730858,1,1274,1879,-40
56510212667,56510212673,6,2419,734,-40
56516284645,56516284639,-6,1442,5943,-40
56519206128,56519206134,6,2882,1253,-40
56525827657,56525827662,5,3091,1445,-40
56526063721,56526063727,6,3826,1409,-40
56531255571,56531255576,5,3417,1487,-40
56532146021,56532146000,-21,1810,895,-40
56532605640,56532605647,7,1771,923,-40
56534463750,56534463754,4,2811,993,-40
56534683862,56534683867,5,2854,945,-40
56535781946,56535781953,7,2134,1359,-40
56536290122,56536290106,-16,2100,1103,-40
56537364006,56537364011,5,2707,1195,-40
56538917090,56538917085,-5,1568,4682,-40
56539233194,56539233202,8,3500,1612,-40
56540040510,56540040517,7,2000,730,-40
56541484796,56541484802,6,2554,1090,-40
56551220209,56551220210,1,2795,2599,-40
56553623089,56553623096,7,3464,1549,-40
56554665777,56554665780,3,1546,1325,-40
56556714993,56556714998,5,1927,1207,-40
56558056081,56558056087,6,2506,1158,-40
56564874790,56564874795,5,2607,1106,-40
56565448899,56565448906,7,3798,1551,-40
56575035482,56575035489,7,4007,1025,-40
56575676227,56575676217,-10,1311,351,-40
56580516601,56580516606,5,2932,1229,-40
56585425053,56585425058,5,3278,1598,-40
56586183832,56586183837,5,2056,1024,-40
56596944549,56596944554,5,3536,971,-40
56596972697,56596972704,7,2389,1365,-40
56603921249,56603921255,6,1393,1168,-40
56603987094,56603987082,-12,911,377,-40
56604137995,56604138001,6,1917,1231,-40
56605015009,56605015014,5,3054,1468,-40
56607889894,56607889901,7,3537,1320,-40
56608345229,56608345250,21,2528,1364,-40
56608776171,56608776178,7,3620,1599,-40
56609124458,56609124465,7,2850,1030,-40
56610686665,56610686669,4,2315,1490,-40
56611860650,56611860648,-2,898,2386,-40
56613992066,56613992070,4,2089,1083,-40
56615534606,56615534611,5,2715,1454,-40
56615997168,56615997174,6,3737,1232,-40
56625378730,56625378736,6,4015,2061,-40
56632466637,56632466645,8,4278,818,-40
56637655030,56637655038,8,2964,1367,-40
56638636545,56638636550,5,2880,1171,-40
56641693606,56641693611,5,3318,945,-40
56642867416,56642867421,5,3061,1523,-40
56644065621,56644065627,6,2544,1095,-40
56650420041,56650420047,6,2579,1189,-40
56651726742,56651726722,-20,2625,1503,-40
56652017210,56652017208,-2,877,140,-40
56654016724,56654016730,6,2301,966,-40
56660567712,56660567718,6,2933,1430,-40
56665489930,56665489930,0,938,109,-40
56669118401,56669118403,2,30259,20603,-40
56669387633,56669387639,6,2661,1397,-40
56673610682,56673610689,7,3807,1778,-40
56674173206,56674173211,5,2743,1380,-40
56675351414,56675351393,-21,3401,1030,-40
56677535414,56677535416,2,738,138,-40
56683024668,56683024665,-3,1988,2854,-40
56683731734,56683731738,4,2275,1316,-40
56683829197,56683829207,10,10541,27580,-40
56685404017,56685404023,6,3984,1481,-40
56687656853,56687656850,-3,1070,3449,-40
56690744938,56690744945,7,2614,1277,-40
56696495233,56696495239,6,2774,1141,-40
56697451607,56697451613,6,3240,1346,-40
56699180263,56699180270,7,3108,1084,-40
56699508005,56699508010,5,2011,1041,-40
56699628109,56699628117,8,3790,1728,-40
56703603103,56703603110,7,7879,1299,-40
56703843678,56703843657,-21,1279,457,-40
56707776179,56707776186,7,2059,1349,-40
56710259430,56710259437,7,2956,1276,-40
56711050163,56711050166,3,2800,1977,-40
56717815313,56717815318,5,1831,1287,-40
56721969189,56721969199,10,1663,821,-40
56722572071,56722572050,-21,967,230,-40
56727592898,56727592906,8,2416,1129,-40
56727790806,56727790811,5,2649,1964,-40
56728878642,56728878649,7,2872,1070,-40
56729862737,56729862721,-16,752,216,-40
56730752388,56730752390,2,2840,3200,-40
56736949181,56736949187,6,3924,1570,-40
56747498905,56747498910,5,3822,1519,-40
56749679989,56749679989,0,747,194,-40
56751736918,56751736926,8,2110,998,-40
56752060857,56752060862,5,3080,1149,-40
56755087489,56755087497,8,2047,1004,-40
56758806921,56758806927,6,1975,1193,-40
56759013257,56759013263,6,2796,1183,-40
56759334134,56759334139,5,2475,1043,-40
56766639352,56766639355,3,1771,623,-40
56769232894,56769232900,6,2586,1206,-40
56772055316,56772055322,6,2425,981,-40
56773141468,56773141474,6,2296,942,-40
56773593186,56773593185,-1,1301,1584,-40
56778736634,56778736640,6,3509,1543,-40
56780318334,56780318342,8,3143,1264,-40
56780441109,56780441117,8,2562,1245,-40
56783854245,56783854252,7,2827,1202,-40
56785350062,56785350066,4,2989,1296,-40
56788570208,56788570211,3,1008,98,-40
56794268383,56794268378,-5,1115,3115,-40
56796470958,56796470963,5,3177,1227,-40
56802969537,56802969543,6,3709,1139,-40
56803785821,56803785804,-17,2910,863,-40
56804572285,56804572290,5,3543,1490,-40
56804889210,56804889206,-4,2664,5955,-40
56806990709,56806990715,6,2951,1467,-40
56809393198,56809393193,-5,2211,7022,-40
56816065555,56816065562,7,3151,1313,-40
56818021618,56818021624,6,2635,1850,-40
56823681847,56823681854,7,3546,1313,-40
56826340721,56826340728,7,3407,1630,-40
56832864749,56832864752,3,1386,1045,-40
56836395889,56836395897,8,2442,1022,-40
56838209314,56838209320,6,2895,958,-40
56842408812,56842408817,5,4039,1981,-40
56843409397,56843409402,5,4201,1976,-40
56846832341,56846832346,5,2415,1432,-40
56847570550,56847570558,8,1529,694,-40
56847664937,56847664945,8,3385,1192,-40
56848320056,56848320075,19,2309,1112,-40
56850267170,56850267175,5,2201,1397,-40
56850837333,56850837338,5,3165,1469,-40
56866872268,56866872274,6,3412,1533,-40
56870869822,56870869827,5,2809,1114,-40
56873455882,56873455887,5,2844,1200,-40
56873546747,56873546753,6,2610,1611,-40
56873595710,56873595691,-19,743,229,-40
56876925686,56876925691,5,1943,1082,-40
56881064288,56881064294,6,2880,1266,-40
56885835986,56885835986,0,1331,2353,-40
56889462536,56889462543,7,2927,1083,-40
56890362314,56890362318,4,3462,2186,-40
56895261182,56895261187,5,2379,1380,-40
56895655962,56895655970,8,3036,930,-40
56898350653,56898350662,9,1463,935,-40
56900151367,56900151374,7,2171,1127,-40
56901283813,56901283819,6,2754,886,-40
56904919490,56904919494,4,834,528,-40
56908884172,56908884178,6,2814,1129,-40
56910629694,56910629698,4,2656,841,-40
56910898072,56910898078,6,1966,669,-40
56914017209,56914017213,4,1368,1496,-40
56919504070,56919504048,-22,1241,714,-40
56923109103,56923109109,6,3447,1330,-40
56924749002,56924749009,7,1959,1317,-40
56925359387,56925359395,8,3024,1363,-40
56926015180,56926015186,6,1619,1299,-40
56926843399,56926843405,6,2829,1376,-40
56930138057,56930138062,5,2624,1292,-40
56934472754,56934472750,-4,624,352,-40
56935712796,56935712802,6,2975,983,-40
56936400461,56936400466,5,2427,1497,-40
56936945224,56936945229,5,2726,1171,-40
56937390691,56937390694,3,2371,2001,-40
56937539113,56937539121,8,2317,1331,-40
56941818330,56941818337,7,3123,1783,-40
56942965058,56942965063,5,2466,1704,-40
56944829645,56944829651,6,1846,947,-40
56946146786,56946146793,7,2958,962,-40
56949116861,56949116865,4,3411,1291,-40
56951186113,56951186118,5,2604,1638,-40
56954034013,56954034019,6,1946,1249,-40
56955975837,56955975845,8,2558,929,-40
56956287442,56956287434,-8,824,8,-40
56957821870,56957821878,8,2406,1313,-40
56957918109,56957918089,-20,1015,317,-40
56961638851,56961638832,-19,2425,728,-40
56963115357,56963115363,6,3361,1776,-40
56965082392,56965082398,6,2390,1477,-40
56968972257,56968972264,7,2846,1468,-40
56971072676,56971072683,7,2991,1440,-40
56972443951,56972443947,-4,521,1400,-40
56973544851,56973544828,-23,2019,680,-40
56973708549,56973708555,6,2794,1572,-40
56979412489,56979412494,5,2078,646,-40
56980474526,56980474514,-12,1398,161,-40
56980553997,56980554002,5,2455,957,-40
56980765135,56980765138,3,1876,1230,-40
56982589418,56982589419,1,747,1317,-40
56982867253,56982867258,5,2920,1536,-40
56983059831,56983059837,6,3376,1423,-40
56984196774,56984196779,5,2528,1508,-40
56987036617,56987036621,4,2970,1517,-40
56987889971,56987889988,17,2293,1326,-40
56988615232,56988615241,9,794,255,-40
56989999599,56989999603,4,2203,1163,-40
56993849579,56993849578,-1,1325,1894,-40
56995424150,56995424154,4,2582,1235,-40
56996123965,56996123972,7,2623,1160,-40
56997074418,56997074425,7,2636,1309,-40
57007790543,57007790551,8,3316,1439,-40
57011724330,57011724337,7,2924,1119,-40
57012810194,57012810201,7,2829,1724,-40
57013544023,57013544029,6,3603,1464,-40
57013593244,57013593250,6,3586,1344,-40
57016572035,57016572042,7,3276,1510,-40
57016984147,57016984154,7,5523,999,-40
57018810110,57018810117,7,2718,1712,-40
57020877381,57020877389,8,3360,1290,-40
57023427777,57023427783,6,2579,1079,-40
57023614233,57023614223,-10,28535,15946,-40
57025048641,57025048646,5,3176,1284,-40
57045759433,57045759439,6,2581,1547,-40
57047853461,57047853466,5,2510,1640,-40
57051995402,57051995407,5,1879,763,-40
57052617643,57052617650,7,3763,1350,-40
57054409445,57054409451,6,2276,1273,-40
57055672538,57055672543,5,1439,917,-40
57057233243,57057233248,5,1385,1332,-40
57064720733,57064720743,10,2099,913,-40
57066252923,57066252929,6,2892,1035,-40
57066613537,57066613543,6,3080,1393,-40
57066910809,57066910818,9,2753,973,-40
57067763040,57067763035,-5,593,76,-40
57072301419,57072301425,6,1698,1072,-40
57078310914,57078310919,5,1705,1006,-40
57079528897,57079528909,12,10748,41619,-40
57080227790,57080227810,20,998,346,-40
57085920822,57085920829,7,4828,1773,-40
57099961588,57099961594,6,3039,1866,-40
57100364961,57100364966,5,2091,1214,-40
57100673433,57100673426,-7,130,2021,-40
57113849640,57113849645,5,2982,919,-40
57113874784,57113874770,-14,1840,492,-40
57113962642,57113962647,5,1399,1272,-40
57115577433,57115577431,-2,1806,2198,-40
57115768242,57115768237,-5,1451,8709,-40
57117694994,57117695002,8,3008,1405,-40
57117751715,57117751722,7,3670,752,-40
57121988407,57121988413,6,3459,1424,-40
57122041383,57122041377,-6,1862,297,-40
57123739913,57123739911,-2,913,1879,-40
57129911105,57129911111,6,2137,1303,-40
57135291994,57135291987,-7,1341,30701,-40
57140523969,57140523963,-6,1345,4312,-40
57142206147,57142206154,7,2287,1473,-40
57144010159,57144010165,6,2586,1228,-40
57145609822,57145609829,7,3331,810,-40
57151164074,57151164085,11,2438,1254,-40
57151979829,57151979835,6,3109,1147,-40
57152194948,57152194954,6,9741,25428,-40
57152789669,57152789674,5,4762,1543,-40
57154300033,57154300039,6,3730,1307,-40
57155500913,57155500921,8,4552,1468,-40
57155552364,57155552370,6,2796,1665,-40
57158920511,57158920517,6,3873,2108,-40
57164994886,57164994892,6,3088,1369,-40
57166225129,57166225125,-4,727,2832,-40
57168461389,57168461395,6,3419,1561,-40
57175905162,57175905167,5,2830,1399,-40
57176501118,57176501106,-12,759,275,-40
57177020253,57177020260,7,3178,1689,-40
57185643161,57185643166,5,2739,1318,-40
57186672802,57186672808,6,3410,1130,-40
57189989719,57189989725,6,2347,881,-40
57191918810,57191918813,3,2080,945,-40
57193057601,57193057606,5,3434,1957,-40
57195797250,57195797254,4,620,68,-40
57195911246,57195911226,-20,2038,1042,-40
57199026974,57199026982,8,4134,1311,-40
57199171667,57199171674,7,785,158,-40
57204830730,57204830729,-1,2444,3525,-40
57205284233,57205284229,-4,1255,2751,-40
57205979993,57205979999,6,2513,1125,-40
57211995321,57211995327,6,3084,1472,-40
57213351729,57213351734,5,2668,1340,-40
57215044529,57215044536,7,2604,1275,-40
57226204326,57226204331,5,3388,1511,-40
57226980241,57226980248,7,3687,1668,-40
57231274522,57231274530,8,3165,1344,-40
57231796826,57231796840,14,2078,1232,-40
57236407331,57236407339,8,1186,600,-40
57244077207,57244077209,2,1133,1098,-40
57244422170,57244422176,6,1771,1158,-40
57247832654,57247832659,5,2753,1053,-40
57247904831,57247904826,-5,1093,474,-40
57248736688,57248736694,6,4122,1620,-40
57251306877,57251306882,5,2527,1560,-40
57253123662,57253123669,7,3021,1652,-40
57256228242,57256228249,7,3501,1893,-40
57257519142,57257519150,8,2765,1705,-40
57266793490,57266793497,7,2532,1117,-40
57268291630,57268291635,5,2685,1287,-40
57268850562,57268850570,8,2571,1222,-40
57275559907,57275559913,6,2655,1105,-40
57276302954,57276302960,6,2948,1390,-40
57277053149,57277053152,3,1851,1359,-40
57280370834,57280370841,7,3453,998,-40
57280457426,57280457408,-18,861,299,-40
57280583736,57280583742,6,4087,1544,-40
57289581377,57289581381,4,1469,1725,-40
57291660023,57291660030,7,2827,1144,-40
57292250993,57292250999,6,1947,816,-40
57293372865,57293372870,5,2717,1077,-40
57293576844,57293576848,4,1680,1441,-40
57299062614,57299062614,0,2453,3333,-40
57303427165,57303427171,6,2564,1555,-40
57307701633,57307701638,5,2654,1307,-40
57312880329,57312880334,5,3539,1584,-40
57314726434,57314726441,7,2642,969,-40
57322708500,57322708503,3,4313,3283,-40
57328586354,57328586359,5,1976,1388,-40
57338432745,57338432751,6,3510,881,-40
57338503638,57338503618,-20,750,327,-40
57339800245,57339800251,6,1229,682,-40
57340683972,57340683979,7,2455,946,-40
57340875318,57340875329,11,3168,907,-40
57342432721,57342432728,7,1940,792,-40
57343443141,57343443146,5,2782,1429,-40
57347660774,57347660780,6,2862,1319,-40
57349833641,57349833645,4,2695,1464,-40
57352056414,57352056415,1,1165,2213,-40
57352263694,57352263702,8,1551,663,-40
57353291186,57353291181,-5,1329,4037,-40
57356215694,57356215699,5,3897,1607,-40
57357848129,57357848137,8,2187,1324,-40
57359874886,57359874892,6,2512,1003,-40
57360505916,57360505924,8,1912,1176,-40
57363251248,57363251255,7,2133,1226,-40
57364092716,57364092722,6,3585,1351,-40
57364621593,57364621601,8,561,93,-40
57365551335,57365551342,7,2702,1746,-40
57365866973,57365866978,5,2491,1337,-40
57367044653,57367044658,5,2178,2086,-40
57367291862,57367291856,-6,27972,14903,-40
57371039529,57371039534,5,3544,1022,-40
57372882810,57372882802,-8,1637,6291,-40
57376449348,57376449354,6,2304,1190,-40
57376506016,57376506023,7,1967,919,-40
57376867451,57376867435,-16,904,273,-40
57388692712,57388692718,6,2657,1415,-40
57388900069,57388900074,5,2636,1194,-40
57389863259,57389863266,7,2255,1191,-40
57390383497,57390383513,16,1030,234,-40
57391372066,57391372052,-14,2259,1095,-40
57396675222,57396675229,7,3667,1375,-40
57397121606,57397121601,-5,1328,647,-40
57397568694,57397568699,5,710,170,-40
57399956686,57399956693,7,3800,1721,-40
57400985666,57400985674,8,2998,1200,-40
57403226342,57403226349,7,3018,1388,-40
57405633583,57405633586,3,1566,1007,-40
57406099379,57406099385,6,2463,1226,-40
57407640281,57407640278,-3,1565,3614,-40
57407839400,57407839407,7,2346,814,-40
57408696036,57408696043,7,3301,1359,-40
57410785345,57410785352,7,1770,952,-40
57412161233,57412161238,5,2503,931,-40
57412989135,57412989142,7,1644,898,-40
57418469461,57418469466,5,2999,1357,-40
57423001552,57423001557,5,2921,1518,-40
57423941685,57423941691,6,4039,1144,-40
57425758631,57425758638,7,3002,1070,-40
57430653485,57430653491,6,2846,1254,-40
57433496739,57433496721,-18,2769,828,-40
57439887727,57439887734,7,2582,1413,-40
57440613501,57440613506,5,3317,1317,-40
57440904921,57440904939,18,2921,1272,-40
57441813777,57441813782,5,55857,20881,-40
57443715281,57443715287,6,3679,1701,-40
57445306034,57445306039,5,3406,1360,-40
57447671039,57447671024,-15,1072,270,-40
57447711146,57447711154,8,3819,1227,-40
57449830461,57449830466,5,3185,1171,-40
57451272455,57451272459,4,843,261,-40
57452493297,57452493303,6,1723,1056,-40
57453647599,57453647602,3,952,1682,-40
57466503957,57466503961,4,2525,1113,-40
57470194786,57470194791,5,3498,1655,-40
57473173861,57473173866,5,2422,1322,-40
57473290167,57473290146,-21,2043,1514,-40
57476014376,57476014384,8,3157,867,-40
57480895435,57480895414,-21,1130,331,-40
57484650766,57484650771,5,3555,1395,-40
57486701965,57486701971,6,1937,1030,-40
57487343858,57487343863,5,1407,1087,-40
57491110821,57491110827,6,2391,1227,-40
57491415543,57491415549,6,1862,1275,-40
57491605077,57491605083,6,3864,1170,-40
57495103182,57495103189,7,3432,1076,-40
57495438854,57495438875,21,833,141,-40
57498278630,57498278625,-5,31006,21928,-40
57499980262,57499980259,-3,1035,2041,-40
57502249375,57502249381,6,2517,1195,-40
57504406664,57504406670,6,3732,1497,-40
57505405001,57505405007,6,3022,1984,-40
57508566601,57508566607,6,2194,1612,-40
57513422603,57513422610,7,3910,1467,-40
57513698116,57513698119,3,2312,1724,-40
57514837549,57514837556,7,1972,1120,-40
57515590798,57515590796,-2,1326,3388,-40
57518733486,57518733495,9,3876,1406,-40
57522478889,57522478895,6,3231,1503,-40
57525406018,57525406022,4,2473,800,-40
57529575576,57529575582,6,3205,1002,-40
57530322913,57530322914,1,1480,915,-40
57534312007,57534312008,1,1356,1252,-40
57539764695,57539764702,7,3198,1043,-40
57543147418,57543147425,7,2324,1202,-40
57543500700,57543500717,17,210,840,-40
57545630742,57545630747,5,2837,1051,-40
57545768581,57545768587,6,1383,337,-40
57546569938,57546569922,-16,2085,820,-40
57547319081,57547319087,6,4696,1878,-40
57550395535,57550395540,5,4775,2495,-40
57553239573,57553239577,4,2240,43499,-40
57560915639,57560915645,6,2181,1276,-40
57564671119,57564671124,5,2976,1907,-40
57577016393,57577016399,6,1997,1087,-40
57580663820,57580663825,5,2107,1406,-40
57585750973,57585750979,6,2491,900,-40
57591977850,57591977854,4,2367,1499,-40
57592542011,57592542019,8,3638,1281,-40
57594265550,57594265557,7,4341,1864,-40
57596613024,57596613032,8,3098,1503,-40
57600335946,57600335941,-5,833,2611,-40
57603304258,57603304265,7,1915,946,-40
57604215303,57604215310,7,2021,1074,-40
57607664738,57607664746,8,3161,1192,-40
57609229567,57609229575,8,1754,960,-40
57617918473,57617918460,-13,1231,381,-40
57618444038,57618444045,7,3316,1518,-40
57618495827,57618495812,-15,2213,906,-40
57619634455,57619634459,4,2927,1216,-40
57620170866,57620170870,4,1886,1142,-40
57620349606,57620349593,-13,623,145,-40
57621263535,57621263543,8,3258,1141,-40
57621366050,57621366042,-8,628,263,-40
57628855219,57628855218,-1,1554,2051,-40
57629851553,57629851560,7,2688,1311,-40
57632701663,57632701668,5,8842,32794,-40
57633605893,57633605897,4,2534,1496,-40
57633654670,57633654691,21,3608,1559,-40
57633962276,57633962296,20,2364,931,-40
57635821624,57635821629,5,2977,1854,-40
57640413319,57640413324,5,1852,997,-40
57641888651,57641888658,7,2981,1407,-40
57642443543,57642443548,5,2070,1184,-40
57658035408,57658035413,5,2555,1374,-40
57660080986,57660080991,5,3046,1679,-40
57664649519,57664649525,6,3255,1270,-40
57666126797,57666126802,5,2136,1401,-40
57666244088,57666244094,6,5831,2161,-40
57666331850,57666331855,5,3192,1053,-40
57669320199,57669320206,7,2205,856,-40
57669909322,57669909330,8,1692,781,-40
57670719086,57670719066,-20,2857,488,-40
57677899313,57677899319,6,1878,1231,-40
57678034284,57678034267,-17,842,451,-40
57681272458,57681272467,9,3765,1666,-40
57681320924,57681320930,6,2194,702,-40
57682870200,57682870205,5,2091,1282,-40
57687378982,57687378989,7,2752,1285,-40
57687781526,57687781539,13,2280,1429,-40
57690094931,57690094938,7,2629,848,-40
57690214649,57690214651,2,1730,1248,-40
57695596665,57695596671,6,2302,1230,-40
57696959517,57696959526,9,3490,1286,-40
57697420450,57697420457,7,2897,1701,-40
57697915915,57697915922,7,3070,1185,-40
57698241271,57698241278,7,2902,1490,-40
57698545725,57698545731,6,3990,1195,-40
57699525611,57699525617,6,1896,900,-40
57700563089,57700563096,7,2162,798,-40
57703582761,57703582766,5,3125,1339,-40
57705291301,57705291295,-6,32814,14118,-40
57705384668,57705384672,4,2310,1468,-40
57705964344,57705964350,6,3254,1322,-40
57706016014,57706016019,5,3131,1208,-40
57706216698,57706216683,-15,846,368,-40
57711257692,57711257699,7,1848,859,-40
57717214329,57717214336,7,3235,1357,-40
57722830808,57722830814,6,3244,1344,-40
57723265945,57723265951,6,3213,1182,-40
57725048260,57725048267,7,3171,1235,-40
57739544595,57739544601,6,1738,1074,-40
57739675151,57739675139,-12,689,102,-40
57749077293,57749077300,7,3410,1504,-40
57749265646,57749265625,-21,844,166,-40
57749596675,57749596694,19,1,2097,-40
57751056835,57751056842,7,3721,1491,-40
57752956433,57752956440,7,2651,1738,-40
57755767663,57755767669,6,2853,1382,-40
57756610657,57756610663,6,2421,751,-40
57758574129,57758574135,6,1592,1097,-40
57760868006,57760868013,7,2265,750,-40
57762771770,57762771749,-21,1026,589,-40
57764267770,57764267777,7,2073,722,-40
57765113464,57765113471,7,2369,1360,-40
57772521715,57772521722,7,3609,1499,-40
57773268902,57773268907,5,2600,982,-40
57781550881,57781550882,1,1741,2862,-40
57795071534,57795071538,4,3465,1501,-40
57800551309,57800551315,6,2747,1332,-40
57804043016,57804043023,7,3401,1151,-40
57811312754,57811312756,2,14104,15016,-40
57812240513,57812240507,-6,1114,2680,-40
57813184258,57813184265,7,2084,857,-40
57818595178,57818595186,8,4812,1404,-40
57819634186,57819634192,6,2995,1255,-40
57820335765,57820335770,5,2498,824,-40
57821499663,57821499665,2,1874,1501,-40
57826307489,57826307490,1,1815,2256,-40
57826463545,57826463550,5,2624,1408,-40
57830076836,57830076842,6,2664,1233,-40
57830264926,57830264933,7,2591,1138,-40
57837263364,57837263370,6,3189,1228,-40
57839434649,57839434653,4,2562,1236,-40
57841047180,57841047186,6,2360,1388,-40
57844313954,57844313958,4,3177,2767,-40
57845326578,57845326585,7,7003,2035,-40
57850125655,57850125661,6,2235,771,-40
57850296540,57850296545,5,1991,1218,-40
57851970986,57851970993,7,3313,1486,-40
57853758872,57853758878,6,3066,1187,-40
57854188033,57854188020,-13,1302,493,-40
57854796472,57854796477,5,2561,1791,-40
57854841704,57854841714,10,1072,72,-40
57855576543,57855576523,-20,945,153,-40
57856311778,57856311782,4,2401,1386,-40
57858508181,57858508169,-12,987,312,-40
57859818189,57859818196,7,4021,1808,-40
57860555087,57860555093,6,2905,1488,-40
57861585888,57861585895,7,3808,1218,-40
57861809246,57861809253,7,2301,665,-40
57866974328,57866974333,5,1801,1273,-40
57867980634,57867980624,-10,813,28,-40
57873414529,57873414535,6,1869,1167,-40
57877874282,57877874287,5,2830,1498,-40
57881181043,57881181038,-5,3202,10374,-40
57885449255,57885449258,3,1750,1270,-40
57892085192,57892085198,6,3311,1350,-40
57903086210,57903086208,-2,1135,3228,-40
57906015200,57906015207,7,3588,911,-40
57908414605,57908414611,6,2815,1238,-40
57917540158,57917540164,6,3154,1542,-40
57919095878,57919095864,-14,1406,507,-40
57922402614,57922402623,9,2393,1205,-40
57923413312,57923413314,2,1950,1905,-40
57923897529,57923897533,4,3225,1702,-40
57925609248,57925609249,1,1662,1892,-40
57929224753,57929224759,6,4036,1461,-40
57932457566,57932457574,8,4087,1182,-40
57932704526,57932704506,-20,1354,278,-40
57935954125,57935954129,4,2520,1087,-40
57937432208,57937432214,6,1992,1283,-40
57937659253,57937659242,-11,2144,1102,-40
57938280533,57938280515,-18,795,222,-40
57940818706,57940818713,7,3569,1495,-40
57945679361,57945679367,6,3219,1221,-40
57949147915,57949147921,6,3483,1827,-40
57950520638,57950520643,5,2293,807,-40
57951062707,57951062713,6,1339,866,-40
57951435971,57951435984,13,2294,1315,-40
57951516085,57951516089,4,2719,1126,-40
57953684242,57953684245,3,1961,1348,-40
57957172207,57957172214,7,2628,917,-40
57962204748,57962204754,6,3833,1609,-40
57966954725,57966954731,6,2683,1148,-40
57968371973,57968371979,6,4231,1238,-40
57970226751,57970226753,2,1275,1836,-40
57974393160,57974393168,8,2756,1012,-40
57974866686,57974866685,-1,796,524,-40
57977136043,57977136045,2,2967,2061,-40
57977708460,57977708466,6,2558,1211,-40
57981919304,57981919300,-4,1932,4763,-40
57987873223,57987873227,4,2286,619,-40
57988064571,57988064578,7,4300,1391,-40
57991694773,57991694779,6,1834,1113,-40
57998679420,57998679419,-1,1424,2536,-40
57999970990,57999970995,5,3235,2067,-40
58000706584,58000706591,7,3874,1412,-40
58005126006,58005126013,7,2339,1235,-40
58007866980,58007866987,7,2492,1511,-40
58008206124,58008206130,6,2123,1000,-40
58011274006,58011274011,5,2919,1468,-40
58011379520,58011379526,6,3139,1412,-40
58012956329,58012956333,4,3284,1577,-40
58013210291,58013210276,-15,2407,886,-40
58020837351,58020837358,7,2468,1124,-40
58021602125,58021602131,6,2589,1147,-40
58021770835,58021770827,-8,834,176,-40
58025153377,58025153383,6,2814,1676,-40
58026091971,58026091979,8,3008,1432,-40
58032841250,58032841255,5,1353,1624,-40
58034029781,58034029786,5,2857,1129,-40
58034845811,58034845819,8,3495,1337,-40
58036129293,58036129299,6,2282,1241,-40
58040306186,58040306190,4,2039,1246,-40
58046753349,58046753356,7,2698,1316,-40
58046950981,58046950987,6,3605,1178,-40
58047053480,58047053485,5,3266,1380,-40
58047211722,58047211730,8,4810,1601,-40
58047934806,58047934813,7,2037,1080,-40
58051830973,58051830982,9,2585,1127,-40
58054240043,58054240049,6,3080,1463,-40
58055887321,58055887325,4,2463,1147,-40
58057081393,58057081397,4,2168,1576,-40
58057361086,58057361091,5,2491,1355,-40
58065786251,58065786259,8,2431,1077,-40
58067154024,58067154029,5,1454,1214,-40
58071947614,58071947621,7,1475,1236,-40
58079685682,58079685687,5,2530,1571,-40
58082080795,58082080800,5,2405,1126,-40
58084870777,58084870782,5,2522,1661,-40
58086013145,58086013151,6,2656,1412,-40
58089332413,58089332418,5,2377,1200,-40
58089587727,58089587705,-22,1534,444,-40
58094520309,58094520302,-7,1811,7114,-40
58098626517,58098626514,-3,1204,2113,-40
58099810379,58099810380,1,1977,1643,-40
58100194653,58100194658,5,3909,1422,-40
58101666754,58101666753,-1,2282,2868,-40
58101861818,58101861825,7,3196,1344,-40
58105911046,58105911053,7,3927,1810,-40
58118764236,58118764243,7,2271,1163,-40
58120168936,58120168941,5,2263,1277,-40
58120497582,58120497585,3,1824,1094,-40
58120778287,58120778266,-21,2360,988,-40
58120855703,58120855697,-6,2429,7176,-40
58132311130,58132311137,7,1441,1113,-40
58133348190,58133348209,19,962,260,-40
58141503550,58141503557,7,3621,1466,-40
58144514181,58144514186,5,3462,1288,-40
58145132763,58145132769,6,3634,1414,-40
58150387959,58150387965,6,3306,1057,-40
58150482190,58150482208,18,489,204,-40
58151397709,58151397690,-19,1031,371,-40
58153588198,58153588207,9,2941,1105,-40
58154290029,58154290033,4,2357,1510,-40
58157038726,58157038741,15,14593,54907,-40
58157414666,58157414671,5,2566,931,-40
58157668880,58157668887,7,2797,1076,-40
58168645837,58168645838,1,2050,2069,-40
58175830391,58175830396,5,2621,1456,-40
58177068258,58177068243,-15,3288,1137,-40
58179751544,58179751525,-19,3419,1365,-40
58183405604,58183405610,6,2387,1209,-40
58185568700,58185568705,5,3610,1480,-40
58189279951,58189279959,8,3035,1407,-40
58191568985,58191568990,5,3468,1504,-40
58196452674,58196452680,6,3177,1738,-40
58201041874,58201041877,3,1910,1803,-40
58202500146,58202500153,7,2497,1323,-40
58206010777,58206010782,5,2404,1096,-40
58208770865,58208770873,8,2495,1114,-40
58209649105,58209649110,5,2439,1460,-40
58216287986,58216287993,7,2755,1335,-40
58217031967,58217031964,-3,1177,2807,-40
58226812677,58226812681,4,3369,1165,-40
58227118861,58227118868,7,2526,1728,-40
58227874430,58227874411,-19,1153,179,-40
58229149681,58229149687,6,2716,1468,-40
58232350939,58232350945,6,3116,1274,-40
58237574554,58237574561,7,3443,1214,-40
58238769298,58238769303,5,2924,1199,-40
58244547265,58244547271,6,2551,1222,-40
58244733130,58244733135,5,2080,1210,-40
58251581482,58251581481,-1,1878,3145,-40
58251967415,58251967422,7,2754,1220,-40
58254069090,58254069098,8,1096,697,-40
58254896218,58254896223,5,1952,1173,-40
58256282707,58256282712,5,3058,1137,-40
58258802273,58258802279,6,2887,1409,-40
58264190654,58264190656,2,1194,1560,-40
58265091538,58265091546,8,2969,1562,-40
58270492307,58270492298,-9,35796,13651,-40
58270588093,58270588101,8,3018,1640,-40
58272363594,58272363600,6,2923,1319,-40
58273647013,58273647019,6,3836,1651,-40
58274712963,58274712969,6,2887,1768,-40
58274813486,58274813493,7,7314,1983,-40
58284889878,58284889885,7,2576,957,-40
58286430852,58286430858,6,1535,392,-40
58286770403,58286770385,-18,2238,571,-40
58288102133,58288102137,4,1754,817,-40
58290294177,58290294183,6,2572,1129,-40
58291882434,58291882440,6,3963,1739,-40
58291961723,58291961728,5,1152,774,-40
58295832031,58295832037,6,4431,1714,-40
58301163466,58301163474,8,3562,1181,-40
58302058711,58302058718,7,1754,1156,-40
58305055030,58305055035,5,1803,1577,-40
58308316264,58308316265,1,1197,1536,-40
58313808197,58313808203,6,2757,1521,-40
58319803663,58319803669,6,2743,1628,-40
58321024818,58321024811,-7,664,177,-40
58324036226,58324036232,6,3042,1409,-40
58325104690,58325104697,7,2196,1406,-40
58335030878,58335030863,-15,1921,623,-40
58335225293,58335225301,8,3224,1471,-40
58335258875,58335258879,4,2240,990,-40
58335350566,58335350563,-3,1811,3500,-40
58340809005,58340809011,6,3079,1228,-40
58342746333,58342746334,1,2958,3287,-40
58344280874,58344280881,7,3932,1529,-40
58344687329,58344687333,4,1876,1197,-40
58345764477,58345764482,5,2285,1229,-40
58347456904,58347456910,6,1916,1102,-40
58347734246,58347734227,-19,895,375,-40
58351328773,58351328778,5,2124,1199,-40
58355392074,58355392078,4,1455,868,-40
58359037633,58359037647,14,2954,1030,-40
58359218480,58359218486,6,3640,1600,-40
58360775193,58360775195,2,2381,2204,-40
58361058015,58361058022,7,3364,1154,-40
58362386438,58362386442,4,2484,1272,-40
58366500496,58366500504,8,3211,1079,-40
58370347818,58370347824,6,2450,1549,-40
58370842894,58370842873,-21,2960,1636,-40
58375584244,58375584249,5,2273,1847,-40
58379794073,58379794079,6,2664,1687,-40
58384757169,58384757173,4,2752,1257,-40
58389156158,58389156163,5,1539,1116,-40
58390502670,58390502674,4,2453,1221,-40
58391250948,58391250955,7,2541,1431,-40
58392964561,58392964564,3,1421,1576,-40
58393482689,58393482695,6,2559,1288,-40
58393818838,58393818842,4,2276,1436,-40
58398462905,58398462912,7,3359,1852,-40
58407327481,58407327486,5,2783,1264,-40
58408389766,58408389770,4,1807,1447,-40
58410713506,58410713510,4,2069,1169,-40
58411821557,58411821564,7,3311,1034,-40
58416441261,58416441266,5,2197,1505,-40
58417877761,58417877767,6,2642,1100,-40
58418768337,58418768342,5,2696,1754,-40
58424674818,58424674817,-1,3343,3972,-40
58425042300,58425042302,2,2242,2164,-40
58428321829,58428321808,-21,2267,925,-40
58429602804,58429602810,6,2047,1263,-40
58432678446,58432678453,7,2975,1618,-40
58434457415,58434457409,-6,1405,11125,-40
58436549529,58436549535,6,3113,1801,-40
58436680094,58436680098,4,2687,1060,-40
58441288125,58441288128,3,17067,13923,-40
58442482609,58442482606,-3,1544,2899,-40
58442593957,58442593963,6,2977,1069,-40
58445777152,58445777137,-15,1365,618,-40
58446459502,58446459509,7,2596,967,-40
58451867263,58451867260,-3,1120,2569,-40
58452423803,58452423806,3,2146,1508,-40
58452879946,58452879953,7,822,950,-40
58454773237,58454773238,1,28488,19327,-40
58456969070,58456969071,1,1271,1329,-40
58464398930,58464398936,6,1517,1151,-40
58464813207,58464813210,3,2364,1961,-40
58466153151,58466153158,7,2402,1027,-40
58468328100,58468328106,6,3076,1065,-40
58472967481,58472967487,6,2954,1203,-40
58473813346,58473813363,17,685,160,-40
58474822140,58474822146,6,3549,1523,-40
58480378898,58480378906,8,2169,1467,-40
58483054657,58483054662,5,1893,1336,-40
58496268653,58496268658,5,2520,1738,-40
58496443584,58496443592,8,350,104,-40
58500407745,58500407751,6,2357,1737,-40
58500718910,58500718917,7,5225,1692,-40
58506086582,58506086587,5,2309,1172,-40
58508081549,58508081555,6,1620,859,-40
58509637052,58509637057,5,3249,948,-40
58510621882,58510621896,14,3698,1411,-40
58510679037,58510679043,6,2722,1155,-40
58512241219,58512241217,-2,1067,1957,-40
58513028866,58513028872,6,2448,1016,-40
58514783078,58514783086,8,613,1124,-40
58515278382,58515278388,6,1646,893,-40
58518061825,58518061831,6,2651,1114,-40
58524319461,58524319467,6,2555,1496,-40
58525655675,58525655682,7,2350,1097,-40
58526417890,58526417897,7,2438,1025,-40
58528962594,58528962610,16,2681,1202,-40
58529009173,58529009187,14,11717,45586,-40
58530695924,58530695930,6,2672,1043,-40
58530801322,58530801329,7,3633,1346,-40
58533580377,58533580384,7,1409,1015,-40
58535599460,58535599462,2,2295,1355,-40
58544400437,58544400442,5,3736,1379,-40
58546650304,58546650311,7,3364,1233,-40
58547536578,58547536578,0,1571,1540,-40
58549639959,58549639954,-5,1757,3530,-40
58550768793,58550768799,6,4525,1444,-40
58552394727,58552394734,7,4719,1834,-40
58554000314,58554000320,6,4131,2056,-40
58554035577,58554035582,5,2605,1440,-40
58557123349,58557123357,8,2841,1123,-40
58557546507,58557546513,6,3392,1402,-40
58558165304,58558165310,6,2080,1312,-40
58560205285,58560205292,7,5136,1032,-40
58562583166,58562583169,3,1153,737,-40
58564068611,58564068615,4,2621,1711,-40
58567654037,58567654044,7,3226,1162,-40
58567860853,58567860861,8,4709,1399,-40
58568043728,58568043714,-14,1761,948,-40
58569647762,58569647768,6,3293,1256,-40
58569735022,58569735026,4,3150,2542,-40
58577979518,58577979519,1,2074,1906,-40
58579724221,58579724229,8,4387,1465,-40
58579874194,58579874203,9,1345,458,-40
58582582958,58582582964,6,3401,1692,-40
58584950241,58584950246,5,2783,1034,-40
58586667696,58586667701,5,2519,1731,-40
58586893219,58586893225,6,2349,1087,-40
58587243645,58587243650,5,1976,1048,-40
58590473586,58590473594,8,2603,1211,-40
58591843316,58591843309,-7,2105,7298,-40
58591967478,58591967485,7,3324,1411,-40
58595418562,58595418568,6,2812,1340,-40
58597084126,58597084133,7,3938,1326,-40
58597578622,58597578603,-19,1168,558,-40
58598328269,58598328275,6,3286,1228,-40
58599343038,58599343034,-4,845,1627,-40
58608006593,58608006592,-1,1866,2560,-40
58615891336,58615891342,6,3288,1308,-40
58616836208,58616836214,6,2336,1389,-40
58619005704,58619005701,-3,1769,2843,-40
58622107694,58622107701,7,2921,1764,-40
58626428129,58626428135,6,2117,775,-40
58627282445,58627282450,5,2305,894,-40
58627605574,58627605571,-3,3290,46467,-40
58628421058,58628421063,5,2319,1040,-40
58629784382,58629784376,-6,744,182,-40
58633556577,58633556583,6,1930,769,-40
58634065227,58634065211,-16,1432,532,-40
58634335615,58634335623,8,2545,1154,-40
58637478828,58637478833,5,2361,1477,-40
58640988421,58640988420,-1,1189,2620,-40
58642040848,58642040854,6,3104,1636,-40
58642351871,58642351867,-4,758,265,-40
58646740195,58646740201,6,2669,1128,-40
58647485356,58647485362,6,2777,1159,-40
58647552838,58647552826,-12,592,195,-40
58647882215,58647882221,6,3670,1623,-40
58651922364,58651922369,5,1583,1000,-40
58659430203,58659430208,5,2946,1436,-40
58663619276,58663619282,6,2291,994,-40
58671118080,58671118083,3,1856,1672,-40
58672569790,58672569795,5,3323,987,-40
58674238909,58674238914,5,2910,1594,-40
58674808959,58674808965,6,2928,1531,-40
58681631399,58681631406,7,2725,1131,-40
58681774553,58681774561,8,889,51,-40
58693970169,58693970174,5,2862,1614,-40
58694381417,58694381424,7,4096,2043,-40
58702562051,58702562055,4,1855,1071,-40
58704641069,58704641075,6,2402,1264,-40
58707492473,58707492481,8,2677,1745,-40
58708198285,58708198291,6,3056,1203,-40
58710143822,58710143829,7,3038,1490,-40
58710331616,58710331622,6,4399,1414,-40
58710523268,58710523273,5,3377,1024,-40
58712874647,58712874654,7,2742,885,-40
58715471935,58715471931,-4,3498,8736,-40
58716965690,58716965695,5,2862,1066,-40
58717634586,58717634593,7,2665,783,-40
58719320293,58719320283,-10,728,232,-40
58720515681,58720515680,-1,836,317,-40
58721082463,58721082470,7,1765,865,-40
58724105595,58724105600,5,2901,1417,-40
58726246503,58726246511,8,4366,1428,-40
58726828631,58726828634,3,1651,1304,-40
58730728519,58730728525,6,3478,1630,-40
58731163197,58731163201,4,2204,975,-40
58732231239,58732231246,7,3624,1309,-40
58733012787,58733012793,6,2328,1486,-40
58742276172,58742276172,0,30586,17376,-40
58745182237,58745182242,5,3565,1146,-40
58747006334,58747006338,4,2676,1566,-40
58748036963,58748036967,4,2044,1449,-40
58750303687,58750303695,8,3532,1211,-40
58755521603,58755521609,6,2692,1727,-40
58760208085,58760208091,6,2247,699,-40
58761670503,58761670509,6,5245,1506,-40
58762674014,58762674027,13,16152,35589,-40
58764047646,58764047653,7,2783,858,-40
58775424576,58775424570,-6,1378,4623,-40
58781735506,58781735511,5,2508,1031,-40
58788261066,58788261074,8,3237,1317,-40
58789013255,58789013261,6,2563,921,-40
58790703225,58790703232,7,2233,1398,-40
58791327669,58791327675,6,1871,1047,-40
58796617821,58796617827,6,2684,1259,-40
58796749960,58796749964,4,2485,1390,-40
58798208439,58798208442,3,2641,1223,-40
58805131898,58805131903,5,3346,1729,-40
58807481471,58807481469,-2,1015,2434,-40
58817655247,58817655252,5,2378,1039,-40
58819823390,58819823398,8,3000,1414,-40
58820891803,58820891809,6,2509,1032,-40
58823741226,58823741226,0,2770,3422,-40
58824724527,58824724523,-4,1631,3086,-40
58831625178,58831625185,7,2771,1487,-40
58831917639,58831917627,-12,729,5,-40
58835717384,58835717390,6,1766,1251,-40
58836208110,58836208115,5,1879,1095,-40
58842059614,58842059614,0,1152,977,-40
58845022622,58845022629,7,3477,1582,-40
58858285446,58858285454,8,2667,982,-40
58860624334,58860624335,1,1942,2226,-40
58862035209,58862035217,8,4206,1077,-40
58862367544,58862367551,7,4150,1390,-40
58862725894,58862725891,-3,1055,250,-40
58865541769,58865541775,6,1860,906,-40
58871091758,58871091766,8,3412,1066,-40
58871248145,58871248150,5,2583,1110,-40
58872448427,58872448412,-15,2294,780,-40
58873488438,58873488446,8,3253,1632,-40
58873789022,58873789030,8,4589,1364,-40
58874245934,58874245914,-20,1468,580,-40
58876543163,58876543169,6,3015,1815,-40
58877178968,58877178950,-18,850,3124,-40
58880040590,58880040587,-3,1150,2295,-40
58891126271,58891126266,-5,1949,6113,-40
58896165820,58896165822,2,1263,1398,-40
58899581090,58899581095,5,2092,520,-40
58907116265,58907116271,6,2622,1232,-40
58916759939,58916759948,9,2676,1116,-40
58919637776,58919637783,7,2614,1558,-40
58926062073,58926062074,1,1374,805,-40
58927895037,58927895042,5,2540,1021,-40
58928316887,58928316893,6,4564,1755,-40
58929189589,58929189594,5,1969,1377,-40
58929480563,58929480546,-17,672,540,-40
58938550838,58938550845,7,2976,1407,-40
58949508311,58949508318,7,2511,1304,-40
58951536132,58951536138,6,3489,1785,-40
58956838494,58956838502,8,4294,1368,-40
58958386522,58958386528,6,2575,924,-40
58959627078,58959627086,8,1412,713,-40
58961699797,58961699804,7,2918,1631,-40
58964177006,58964177012,6,2270,1277,-40
58967075486,58967075493,7,1980,1214,-40
58969048695,58969048702,7,3503,1624,-40
58970806856,58970806862,6,2966,1328,-40
58976109712,58976109717,5,2615,1646,-40
58979149121,58979149129,8,4331,1100,-40
58980512409,58980512417,8,1534,665,-40
58986165162,58986165167,5,2659,1423,-40
58987596465,58987596471,6,941,434,-40
58991803830,58991803836,6,2600,760,-40
58994598588,58994598594,6,3381,1470,-40
58996410133,58996410139,6,3947,1903,-40
58996736133,58996736138,5,1881,822,-40
59006294693,59006294696,3,844,73,-40
59006925182,59006925187,5,3509,1329,-40
59007667582,59007667588,6,2819,2210,-40
59011593122,59011593129,7,1884,1115,-40
59014851403,59014851403,0,863,1104,-40
59015015194,59015015199,5,2923,1336,-40
59017256058,59017256040,-18,2683,1064,-40
59017659919,59017659925,6,3254,1551,-40
59020183239,59020183245,6,3233,1257,-40
59020230007,59020230019,12,3802,1645,-40
59020700820,59020700825,5,2517,1252,-40
59021319297,59021319284,-13,774,194,-40
59022883683,59022883688,5,2769,1358,-40
59026632982,59026632990,8,3292,1030,-40
59026796551,59026796557,6,2445,1131,-40
59028767437,59028767442,5,3933,2109,-40
59028959446,59028959449,3,2013,1746,-40
59028990033,59028990038,5,2153,1112,-40
59032849891,59032849895,4,2426,1486,-40
59034743306,59034743310,4,2877,1311,-40
59037384414,59037384421,7,2626,1078,-40
59037725411,59037725417,6,2731,1517,-40
59040941396,59040941402,6,2069,1226,-40
59041718878,59041718895,17,73,834,-40
59042708475,59042708482,7,2807,1018,-40
59046531355,59046531361,6,2421,1239,-40
59047816673,59047816689,16,2818,1279,-40
59049287206,59049287214,8,2131,1064,-40
59049529529,59049529535,6,2356,1071,-40
59062161550,59062161554,4,1328,994,-40
59065525701,59065525709,8,2948,1358,-40
59070320574,59070320581,7,2379,1274,-40
59072194393,59072194399,6,3794,1597,-40
59073592481,59073592485,4,2554,1236,-40
59073937496,59073937484,-12,1168,554,-40
59074342202,59074342198,-4,1337,3486,-40
59074525401,59074525396,-5,969,2348,-40
59080554190,59080554197,7,3473,1362,-40
59083781249,59083781245,-4,4900,11758,-40
59085162947,59085162953,6,3273,1248,-40
59088487746,59088487751,5,2925,912,-40
59088659389,59088659368,-21,1369,446,-40
59091793008,59091793014,6,2016,1157,-40
59091999737,59091999720,-17,1114,647,-40
59092835277,59092835283,6,3322,1171,-40
59102582791,59102582797,6,3008,1320,-40
59107293153,59107293158,5,2540,1519,-40
59108603993,59108603999,6,15132,6018,-40
59109775648,59109775654,6,2500,1059,-40
59115214716,59115214722,6,4216,1248,-40
59118831121,59118831127,6,3097,1429,-40
59120315102,59120315107,5,2822,1334,-40
59124572789,59124572797,8,2783,1067,-40
59128085758,59128085763,5,2944,1214,-40
59128362617,59128362602,-15,1073,415,-40
59128651744,59128651750,6,1739,1292,-40
59129153352,59129153357,5,1655,698,-40
59129311150,59129311156,6,2574,910,-40
59130734265,59130734270,5,3467,1528,-40
59132196598,59132196603,5,3357,1736,-40
59133633943,59133633949,6,2766,1704,-40
59134520765,59134520774,9,2657,1524,-40
59134565310,59134565289,-21,1077,496,-40
59135377440,59135377447,7,2852,1441,-40
59138776873,59138776878,5,2930,1047,-40
59139154608,59139154614,6,2460,1047,-40
59140020309,59140020303,-6,569,4032,-40
59141698574,59141698581,7,2767,1255,-40
59146557030,59146557035,5,3098,1103,-40
59146903921,59146903926,5,2358,1455,-40
59150761258,59150761263,5,2185,1140,-40
59155488429,59155488434,5,2728,742,-40
59157251771,59157251779,8,3329,1216,-40
59157378780,59157378764,-16,2129,1003,-40
59158207270,59158207277,7,3568,1457,-40
59158811693,59158811698,5,2548,1113,-40
59159548594,59159548600,6,3019,1347,-40
59160675393,59160675397,4,2477,1424,-40
59164109236,59164109216,-20,935,2,-40
59165557596,59165557602,6,2359,1333,-40
59168951337,59168951342,5,2399,1249,-40
59169539392,59169539397,5,2470,1117,-40
59173232365,59173232370,5,3434,1770,-40
59173592422,59173592427,5,3039,1285,-40
59174135267,59174135280,13,2623,1201,-40
59186107509,59186107514,5,3563,1369,-40
59187329100,59187329091,-9,865,316,-40
59188643561,59188643566,5,1872,1141,-40
59189640594,59189640596,2,1864,1429,-40
59194098914,59194098921,7,3054,1076,-40
59194533977,59194533982,5,3122,1194,-40
59194854797,59194854803,6,2990,1255,-40
59199481130,59199481135,5,2538,918,-40
59201377263,59201377270,7,8831,1330,-40
59203494239,59203494245,6,3947,1401,-40
59206223031,59206223038,7,1732,1355,-40
59210179803,59210179810,7,2106,1372,-40
59213477993,59213478001,8,2451,1603,-40
59215102582,59215102587,5,2168,952,-40
59217396644,59217396650,6,3704,1416,-40
59219090666,59219090673,7,3343,1319,-40
59220212654,59220212662,8,3279,1131,-40
59221521770,59221521775,5,2302,1055,-40
59223446093,59223446097,4,3217,1735,-40
59223488758,59223488763,5,1948,887,-40
59225635902,59225635908,6,2852,1229,-40
59227185455,59227185461,6,2361,1972,-40
59229664589,59229664596,7,3250,1314,-40
59230653815,59230653816,1,860,1187,-40
59237170286,59237170294,8,2845,1625,-40
59243349717,59243349723,6,1760,967,-40
59246353210,59246353215,5,2611,1201,-40
59248928247,59248928250,3,1056,880,-40
59254780133,59254780127,-6,813,2868,-40
59260028073,59260028078,5,1580,1544,-40
59262763972,59262763978,6,2175,1298,-40
59264281961,59264281969,8,3504,1679,-40
59265218440,59265218447,7,8688,2603,-40
59265805695,59265805700,5,2939,1096,-40
59270383485,59270383491,6,2633,1106,-40
59272157594,59272157598,4,2124,954,-40
59273319838,59273319843,5,3122,1580,-40
59273364267,59273364274,7,3010,1199,-40
59278811955,59278811960,5,2594,990,-40
59279098513,59279098498,-15,1978,1021,-40
59281982285,59281982291,6,3385,925,-40
59286466776,59286466783,7,4547,1741,-40
59288423888,59288423894,6,2823,1220,-40
59290115692,59290115697,5,2532,1206,-40
59292589233,59292589239,6,2482,1383,-40
59294177562,59294177568,6,2108,1217,-40
59294887404,59294887417,13,1092,130,-40
59297240918,59297240925,7,3097,1466,-40
59298339998,59298339998,0,1336,2268,-40
59304465659,59304465653,-6,860,2485,-40
59308366769,59308366778,9,2625,1194,-40
59308411893,59308411876,-17,3531,1405,-40
59309759284,59309759276,-8,294,1118,-40
59312761013,59312761018,5,2851,1255,-40
59313778473,59313778479,6,3304,1711,-40
59316548006,59316548012,6,2646,1130,-40
59318012306,59318012311,5,3076,965,-40
59324861010,59324861014,4,2391,900,-40
59325949691,59325949698,7,3723,1871,-40
59327013724,59327013731,7,2609,1112,-40
59333681856,59333681862,6,2708,1206,-40
59333721216,59333721215,-1,2383,4542,-40
59333962923,59333962931,8,2947,1272,-40
59336671823,59336671830,7,7553,3275,-40
59336778053,59336778058,5,2693,1634,-40
59338114388,59338114389,1,1004,1705,-40
59343535514,59343535520,6,1959,1060,-40
59343566250,59343566265,15,2051,1574,-40
59344005414,59344005395,-19,1206,281,-40
59344250739,59344250741,2,3724,3019,-40
59351873575,59351873582,7,2458,1292,-40
59352665670,59352665650,-20,1538,801,-40
59352761669,59352761677,8,2554,586,-40
59353826925,59353826931,6,2329,1310,-40
59357595153,59357595159,6,2881,1186,-40
59358590862,59358590870,8,2768,1143,-40
59360302310,59360302317,7,1659,865,-40
59361578265,59361578270,5,1974,1032,-40
59369570545,59369570551,6,2327,1440,-40
59369982983,59369982990,7,2426,1223,-40
59371596055,59371596041,-14,24,1483,-40
59374982938,59374982946,8,2710,916,-40
59375924293,59375924306,13,817,2235,-40
59382488422,59382488427,5,2836,1463,-40
59385136018,59385136023,5,2097,1231,-40
59394499982,59394499988,6,3402,1369,-40
59395037465,59395037464,-1,528,252,-40
59398417749,59398417731,-18,2657,845,-40
59406385566,59406385561,-5,1662,8176,-40
59406449758,59406449763,5,2324,1047,-40
59406511434,59406511419,-15,3179,1295,-40
59411188276,59411188281,5,3106,1410,-40
59412068805,59412068811,6,2522,1440,-40
59412392996,59412393002,6,4259,2362,-40
59413174000,59413174002,2,2508,1971,-40
59413734639,59413734646,7,3011,1107,-40
59416530714,59416530722,8,1270,724,-40
59418208930,59418208935,5,2511,1772,-40
59419962158,59419962163,5,2623,1357,-40
59423852144,59423852147,3,2096,1235,-40
59427966213,59427966218,5,1997,1307,-40
59429574549,59429574554,5,2184,1309,-40
59432067254,59432067262,8,3910,1765,-40
59434730539,59434730546,7,2631,1182,-40
59436402643,59436402649,6,1473,936,-40
59437273382,59437273395,13,6597,866,-40
59441274956,59441274962,6,2556,1185,-40
59443259319,59443259327,8,3431,1722,-40
59451862164,59451862167,3,1296,1571,-40
59452433125,59452433130,5,1726,1249,-40
59454670070,59454670078,8,4363,1365,-40
59454980415,59454980421,6,3597,1427,-40
59455966377,59455966364,-13,962,185,-40
59457584982,59457584960,-22,2745,1185,-40
59457716861,59457716867,6,3815,1668,-40
59459303950,59459303957,7,3390,1323,-40
59466376657,59466376665,8,2869,1012,-40
59467794337,59467794343,6,2751,908,-40
59474111637,59474111643,6,1684,1178,-40
59474647029,59474647034,5,1785,1138,-40
59475339811,59475339818,7,2120,1072,-40
59475963774,59475963781,7,2769,1350,-40
59478642471,59478642477,6,2752,1246,-40
59478925621,59478925603,-18,1187,592,-40
59485675618,59485675625,7,2303,1053,-40
59486955312,59486955319,7,3252,1580,-40
59490908564,59490908570,6,3657,1747,-40
59491382697,59491382702,5,3830,1919,-40
59491485081,59491485087,6,3237,1896,-40
59493597279,59493597283,4,2315,1306,-40
59493639460,59493639468,8,3781,1068,-40
59493931396,59493931402,6,3293,1509,-40
59495875831,59495875834,3,2073,1641,-40
59499650050,59499650056,6,2631,1579,-40
59509394131,59509394135,4,2345,1095,-40
59509627098,59509627096,-2,1132,132,-40
59513567175,59513567181,6,3338,1514,-40
59513720713,59513720708,-5,879,309,-40
59518402425,59518402431,6,2482,1312,-40
59519609961,59519609967,6,3687,1536,-40
59522852952,59522852957,5,4105,1589,-40
59525709014,59525709023,9,2701,968,-40
59528427621,59528427626,5,2771,815,-40
59535717869,59535717875,6,2475,1184,-40
59535882100,59535882106,6,1033,426,-40
59538195847,59538195854,7,3001,1279,-40
59539016233,59539016240,7,2932,1206,-40
59539522657,59539522664,7,3482,1340,-40
59551047233,59551047239,6,3297,1279,-40
59551261149,59551261156,7,3333,1550,-40
59554196147,59554196154,7,2973,1320,-40
59554438063,59554438049,-14,1941,865,-40
59554548938,59554548943,5,4080,1074,-40
59555672615,59555672623,8,2285,1033,-40
59558818624,59558818630,6,2700,1268,-40
59560053026,59560053033,7,2838,1118,-40
59562977089,59562977096,7,2600,1247,-40
59564807009,59564807015,6,2795,1187,-40
59566847608,59566847615,7,2441,990,-40
59567294419,59567294427,8,8417,926,-40
59568004930,59568004916,-14,2329,981,-40
59569685755,59569685761,6,3676,1564,-40
59574247794,59574247798,4,1424,1201,-40
59579893045,59579893051,6,3679,1371,-40
59581199797,59581199804,7,3714,1246,-40
59582614139,59582614145,6,2248,1053,-40
59582791631,59582791637,6,2086,1283,-40
59586499349,59586499357,8,1762,942,-40
59590990814,59590990821,7,3421,1294,-40
59595310805,59595310810,5,2545,1205,-40
59595555477,59595555490,13,2971,1567,-40
59597477969,59597477977,8,2003,711,-40
59600000229,59600000234,5,2693,1446,-40
59600608546,59600608553,7,2172,1158,-40
59601565201,59601565206,5,3020,1973,-40
59601820866,59601820874,8,3424,1312,-40
59605759632,59605759639,7,3390,1232,-40
59608109378,59608109384,6,2657,1165,-40
59610520203,59610520182,-21,1017,488,-40
59613144829,59613144835,6,2881,1114,-40
59614685989,59614685994,5,2125,949,-40
59618494349,59618494333,-16,4005,1084,-40
59620282761,59620282766,5,2379,1315,-40
59621062925,59621062929,4,3127,1313,-40
59623702514,59623702522,8,3551,1407,-40
59625001178,59625001185,7,998,354,-40
59625446338,59625446343,5,3290,1400,-40
59626882429,59626882433,4,2731,1385,-40
59628302289,59628302294,5,1027,657,-40
59628798215,59628798221,6,2672,1278,-40
59630728214,59630728220,6,2170,1283,-40
59632651506,59632651513,7,2701,944,-40
59633384010,59633384016,6,3615,1943,-40
59634060034,59634060034,0,2922,3041,-40
59635926470,59635926475,5,1533,627,-40
59640700315,59640700316,1,1461,1421,-40
59642105454,59642105461,7,2800,1253,-40
59647245437,59647245442,5,2911,1330,-40
59648359899,59648359882,-17,2814,1204,-40
59648958349,59648958354,5,2973,993,-40
59650127274,59650127281,7,2890,938,-40
59650595429,59650595434,5,2946,1193,-40
59654210782,59654210790,8,2589,1441,-40
59659654873,59659654878,5,3199,1664,-40
59667365675,59667365682,7,2966,1947,-40
59670036652,59670036658,6,2658,1089,-40
59671353489,59671353498,9,1892,768,-40
59672241095,59672241098,3,2305,1702,-40
59675912746,59675912753,7,4214,1301,-40
59676758503,59676758506,3,1073,1885,-40
59679535618,59679535624,6,2711,1197,-40
59680749137,59680749143,6,2252,1093,-40
59682950194,59682950198,4,2203,1272,-40
59685181895,59685181902,7,3809,1194,-40
59685418397,59685418419,22,3145,1139,-40
59685591497,59685591480,-17,3763,1437,-40
59685793285,59685793307,22,2803,1314,-40
59692127328,59692127334,6,2243,921,-40
59693979978,59693979980,2,1448,1781,-40
59698570238,59698570243,5,3667,1243,-40
59699219703,59699219710,7,3100,1212,-40
59702409514,59702409521,7,3236,1168,-40
59704589938,59704589942,4,2603,1083,-40
59705243957,59705243947,-10,896,178,-40
59710002405,59710002411,6,1936,1145,-40
59710225882,59710225890,8,2960,1395,-40
59711274409,59711274414,5,1915,1206,-40
59713768635,59713768641,6,3901,1451,-40
59715817744,59715817750,6,3287,1317,-40
59718361302,59718361307,5,3733,993,-40
59723399887,59723399894,7,4100,1536,-40
59723495640,59723495624,-16,2274,772,-40
59724462002,59724462008,6,5056,2848,-40
59727889009,59727889014,5,2137,918,-40
59728223900,59728223883,-17,1015,412,-40
59729295663,59729295670,7,3139,1341,-40
59730744918,59730744938,20,991,265,-40
59731344767,59731344774,7,2676,1565,-40
59737817543,59737817550,7,3162,1686,-40
59739757638,59739757639,1,1467,1878,-40
59744747055,59744747061,6,3091,1537,-40
59750709427,59750709422,-5,1822,5949,-40
59758052969,59758052974,5,3658,1517,-40
59758213253,59758213258,5,1933,1051,-40
59758662223,59758662230,7,3356,1554,-40
59760042201,59760042207,6,2018,1550,-40
59762858298,59762858304,6,2856,1245,-40
59768290676,59768290678,2,1856,2286,-40
59768382757,59768382761,4,2139,1269,-40
59769787936,59769787920,-16,32793,16436,-40
59770122132,59770122138,6,2990,1189,-40
59770410830,59770410837,7,3029,1268,-40
59772070518,59772070525,7,3254,1316,-40
59775916825,59775916831,6,3439,1202,-40
59777273777,59777273783,6,1621,903,-40
59782727462,59782727455,-7,2238,8281,-40
59783278480,59783278486,6,2092,712,-40
59783727997,59783727999,2,1822,1862,-40
59786308819,59786308823,4,2031,1128,-40
59788631440,59788631450,10,19565,36266,-40
59791593245,59791593251,6,1712,1214,-40
59791772768,59791772753,-15,1221,1393,-40
59792659593,59792659597,4,1928,1130,-40
59792777473,59792777459,-14,3628,1674,-40
59798192219,59798192226,7,2787,1246,-40
59801650983,59801650990,7,3206,1475,-40
59802364250,59802364255,5,4101,1605,-40
59806271613,59806271619,6,2534,1593,-40
59809599190,59809599196,6,2210,1014,-40
59813682314,59813682319,5,1877,1078,-40
59825114594,59825114600,6,1986,1178,-40
59826455705,59826455711,6,3366,1576,-40
59828340494,59828340500,6,2705,1071,-40
59828638942,59828638950,8,2464,1475,-40
59829400155,59829400160,5,3037,1491,-40
59830346950,59830346957,7,3075,1292,-40
59833491369,59833491375,6,2874,1257,-40
59837230810,59837230817,7,1660,906,-40
59841592460,59841592468,8,2408,763,-40
59842382529,59842382536,7,8218,2782,-40
59844718203,59844718207,4,2682,1387,-40
59847511953,59847511962,9,4127,1460,-40
59849377918,59849377925,7,3034,1646,-40
59853209731,59853209733,2,1739,1495,-40
59856955962,59856955968,6,2344,1554,-40
59858861805,59858861797,-8,97,499,-40
59861443636,59861443644,8,4031,978,-40
59865406634,59865406639,5,3184,1344,-40
59867122798,59867122805,7,2745,1609,-40
59867842699,59867842684,-15,855,249,-40
59869452712,59869452723,11,16308,30682,-40
59869566057,59869566060,3,1747,1966,-40
59869883376,59869883373,-3,33555,14030,-40
59875891446,59875891452,6,1279,876,-40
59877431970,59877431977,7,3192,1676,-40
59878441318,59878441300,-18,3333,1196,-40
59880196454,59880196460,6,4126,1562,-40
59881503058,59881503064,6,2769,1548,-40
59884661880,59884661886,6,2030,1266,-40
59886681349,59886681354,5,1919,850,-40
59887731056,59887731062,6,2645,1002,-40
59888004635,59888004637,2,2606,1537,-40
59888682374,59888682374,0,1238,1783,-40
59891665692,59891665700,8,2828,935,-40
59891811052,59891811055,3,1210,1427,-40
59894420903,59894420908,5,3038,1593,-40
59896948729,59896948734,5,3822,1531,-40
59898082346,59898082351,5,1320,715,-40
59905839312,59905839308,-4,1292,4177,-40
59913706330,59913706338,8,2631,1270,-40
59914435251,59914435240,-11,1142,258,-40
59914575885,59914575892,7,4139,1581,-40
59915729625,59915729630,5,4067,3228,-40
59918501650,59918501649,-1,5515,9127,-40
59925648391,59925648398,7,2670,1312,-40
59927610162,59927610158,-4,1855,6321,-40
59936089615,59936089616,1,1196,1193,-40
59938679081,59938679086,5,2619,1467,-40
59939555674,59939555680,6,3021,1211,-40
59939598876,59939598882,6,2771,1202,-40
59942721518,59942721497,-21,3461,1421,-40
59943888063,59943888070,7,3489,1123,-40
59947698637,59947698645,8,3281,1189,-40
59950036664,59950036670,6,4134,1615,-40
59951005109,59951005115,6,2768,1209,-40
59951527828,59951527831,3,2596,1908,-40
59956201843,59956201850,7,4794,1672,-40
59958103734,59958103741,7,2978,956,-40
59960631610,59960631618,8,2866,1435,-40
59967905211,59967905218,7,2755,1384,-40
59968017181,59968017187,6,3289,1381,-40
59968866662,59968866667,5,2462,944,-40
59971173219,59971173226,7,3245,1586,-40
59971463748,59971463755,7,3154,1089,-40
59971528735,59971528720,-15,617,297,-40
59973980505,59973980509,4,1788,1108,-40
59975009082,59975009087,5,2342,750,-40
59975615414,59975615420,6,3006,1118,-40
59976848413,59976848419,6,2224,935,-40
59980031489,59980031493,4,1879,1232,-40
59986059502,59986059507,5,2551,1129,-40
59987670979,59987670987,8,1809,814,-40
59989441520,59989441525,5,2547,1243,-40
59989890382,59989890387,5,2388,1142,-40
59993503954,59993503952,-2,1429,2719,-40
59995328199,59995328207,8,3080,1024,-40
59995912931,59995912913,-18,843,115,-40
59996322962,59996322948,-14,3107,1071,-40
59996736345,59996736350,5,2234,1295,-40
59999117576,59999117582,6,2285,1685,-40
60002427981,60002427988,7,2768,1310,-40
60003592143,60003592149,6,2214,1473,-40
60008553931,60008553924,-7,2805,48149,-40
60014646670,60014646677,7,3898,1409,-40
60020798897,60020798902,5,2140,1210,-40
60022285522,60022285527,5,2970,1235,-40
60028891360,60028891366,6,2542,1076,-40
60030921310,60030921317,7,3057,1251,-40
60031160805,60031160811,6,3445,1287,-40
60034264773,60034264779,6,3118,1428,-40
60037577630,60037577634,4,2688,1446,-40
60038259001,60038259007,6,2643,1394,-40
60038357713,60038357718,5,1901,1236,-40
60038938918,60038938922,4,1051,275,-40
60040137046,60040137025,-21,1335,361,-40
60043621445,60043621453,8,2785,973,-40
60043919435,60043919434,-1,736,1293,-40
60044971227,60044971235,8,3565,978,-40
60046998215,60046998222,7,3364,1248,-40
60048229247,60048229253,6,3301,1800,-40
60052404471,60052404475,4,2201,1571,-40
60053958785,60053958791,6,1820,1200,-40
60054322245,60054322251,6,3687,1397,-40
60054847729,60054847735,6,3074,885,-40
60056125197,60056125203,6,2969,1648,-40
60058792705,60058792710,5,2762,1337,-40
60063081782,60063081787,5,2940,1119,-40
60063329913,60063329921,8,1317,190,-40
60067291102,60067291106,4,2546,1737,-40
60067954269,60067954276,7,2914,1492,-40
60073002694,60073002698,4,2271,1116,-40
60073726741,60073726738,-3,1386,1968,-40
60075088864,60075088870,6,2626,1515,-40
60077773493,60077773499,6,3273,1487,-40
60079456663,60079456670,7,2164,1283,-40
60079658783,60079658782,-1,1275,1671,-40
60079735879,60079735887,8,1917,1133,-40
60083779061,60083779068,7,2872,1297,-40
60084014142,60084014145,3,5890,1313,-40
60089418268,60089418275,7,3238,1089,-40
60089544758,60089544778,20,2678,1458,-40
60094842941,60094842949,8,2780,897,-40
60095806109,60095806115,6,3181,1355,-40
60096130223,60096130218,-5,720,1218,-40
60098146372,60098146378,6,2050,1187,-40
60102817446,60102817451,5,2716,1694,-40
60104862797,60104862817,20,1810,6424,-40
60107782308,60107782314,6,3234,1261,-40
60107890112,60107890097,-15,1969,960,-40
60108545772,60108545776,4,1806,1300,-40
60111415538,60111415543,5,2362,1540,-40
60112983254,60112983259,5,2761,1101,-40
60116547239,60116547244,5,19300,47662,-40
60117049867,60117049874,7,1445,747,-40
60119426206,60119426213,7,3494,1361,-40
60121667741,60121667747,6,3614,1867,-40
60133888882,60133888860,-22,1084,504,-40
60135138269,60135138273,4,3949,1889,-40
60141997219,60141997225,6,3453,1568,-40
60142182788,60142182794,6,2452,1462,-40
60143690638,60143690643,5,2613,1090,-40
60143806189,60143806195,6,3938,1156,-40
60149432655,60149432659,4,2078,1285,-40
60154494335,60154494341,6,2967,1434,-40
60154549610,60154549615,5,2673,1057,-40
60161028502,60161028507,5,1238,617,-40
60163399987,60163399993,6,1563,1424,-40
60166679133,60166679139,6,3282,1203,-40
60168486945,60168486950,5,3225,1384,-40
60171018750,60171018755,5,2850,1393,-40
60174093341,60174093346,5,2588,1401,-40
60176613742,60176613747,5,2383,1342,-40
60179793909,60179793917,8,3468,1171,-40
60182258062,60182258066,4,2606,1056,-40
60183086605,60183086616,11,3988,1604,-40
60184559493,60184559498,5,1782,741,-40
60191133034,60191133039,5,2553,1210,-40
60199586330,60199586325,-5,1486,4052,-40
60205407426,60205407433,7,2673,1354,-40
60207262937,60207262941,4,2347,1140,-40
60208680199,60208680206,7,3262,1283,-40
60214910975,60214910983,8,2657,1150,-40
60216562296,60216562302,6,3776,1237,-40
60217170485,60217170493,8,3010,1821,-40
60219347376,60219347382,6,1708,745,-40
60222149873,60222149880,7,2505,1406,-40
60222738349,60222738354,5,5084,2232,-40
60231026741,60231026747,6,2978,1161,-40
60232474731,60232474737,6,3518,1420,-40
60233686108,60233686113,5,2597,1107,-40
60233777893,60233777899,6,3176,1158,-40
60234886141,60234886146,5,3511,1480,-40
60235044039,60235044042,3,2212,1816,-40
60235386511,60235386517,6,2672,952,-40
60236781229,60236781234,5,1829,929,-40
60240346426,60240346433,7,3347,1577,-40
60241217397,60241217403,6,2068,546,-40
60241959069,60241959076,7,2416,1128,-40
60251195064,60251195087,23,2336,1146,-40
60253931619,60253931622,3,2020,1030,-40
60254390374,60254390379,5,2474,832,-40
60257241243,60257241250,7,2549,1195,-40
60258459652,60258459657,5,3701,1737,-40
60271541754,60271541747,-7,1148,4149,-40
60272518353,60272518361,8,3538,1853,-40
60274840606,60274840613,7,3570,1531,-40
60280900867,60280900868,1,1752,2129,-40
60289415089,60289415095,6,1150,1179,-40
60289763494,60289763500,6,2470,1326,-40
60290015874,60290015870,-4,1197,3156,-40
60290672145,60290672151,6,2820,939,-40
60297229978,60297229985,7,3602,1705,-40
60298383276,60298383284,8,1349,825,-40
60303228230,60303228228,-2,1247,2558,-40
60313896474,60313896480,6,2175,1292,-40
60325706549,60325706555,6,4572,1794,-40
60325935135,60325935142,7,2535,1302,-40
60326232628,60326232633,5,1198,917,-40
60330741539,60330741546,7,3784,1215,-40
60330927779,60330927763,-16,2552,1019,-40
60341495722,60341495727,5,2400,1512,-40
60344248269,60344248274,5,2101,1105,-40
60344558335,60344558342,7,3621,1494,-40
60344854154,60344854157,3,1922,1509,-40
60345153009,60345153014,5,2992,1187,-40
60345235982,60345235991,9,3050,1403,-40
60351500726,60351500732,6,3182,1229,-40
60351706165,60351706145,-20,1794,726,-40
60353856689,60353856695,6,2746,1271,-40
60369518239,60369518245,6,2206,1208,-40
60369682690,60369682697,7,3026,1574,-40
60371597790,60371597798,8,3401,1009,-40
60372987002,60372987007,5,1898,771,-40
60373540814,60373540817,3,2015,1555,-40
60379476204,60379476210,6,3224,1332,-40
60381393330,60381393335,5,2327,1090,-40
60383776735,60383776741,6,4396,1595,-40
60385600626,60385600629,3,1467,779,-40
60385664405,60385664394,-11,1191,324,-40
60388358825,60388358831,6,2985,916,-40
60394027090,60394027095,5,1169,1011,-40
60395060949,60395060955,6,2549,1325,-40
60395532393,60395532400,7,3990,1985,-40
60397727334,60397727340,6,3912,1441,-40
60399238341,60399238347,6,4219,1624,-40
60413342037,60413342043,6,2713,1404,-40
60413856991,60413856997,6,2704,1480,-40
60414407262,60414407243,-19,536,189,-40
60419792527,60419792533,6,2650,1405,-40
60422132693,60422132698,5,2229,1400,-40
60423590566,60423590566,0,972,1293,-40
60428152521,60428152504,-17,2200,1106,-40
60430576061,60430576067,6,2648,1048,-40
60433829434,60433829442,8,2941,1177,-40
60443493556,60443493562,6,3293,1586,-40
60445247579,60445247583,4,1256,1093,-40
60445425506,60445425512,6,3591,1386,-40
60447376191,60447376212,21,820,203,-40
60448269554,60448269561,7,2178,1069,-40
60449189573,60449189578,5,2386,1101,-40
60449252595,60449252580,-15,1228,426,-40
60452816687,60452816695,8,3803,1301,-40
60453221935,60453221940,5,2804,1430,-40
60454987858,60454987854,-4,943,2187,-40
60455649153,60455649158,5,3007,1093,-40
60457783940,60457783947,7,3174,1239,-40
60458462641,60458462646,5,2773,1506,-40
60459321885,60459321886,1,1823,1621,-40
60460918771,60460918777,6,3736,1216,-40
60461025821,60461025825,4,2135,1607,-40
60462575161,60462575166,5,2592,1002,-40
60467313174,60467313181,7,2442,1145,-40
60467962319,60467962326,7,10488,31647,-40
60473140661,60473140667,6,1458,1041,-40
60474889008,60474889015,7,2667,1158,-40
60476073885,60476073889,4,1997,2074,-40
60485284061,60485284066,5,3073,1476,-40
60486339906,60486339918,12,11143,43189,-40
60493242222,60493242228,6,2016,1016,-40
60494964926,60494964930,4,2019,964,-40
60496421758,60496421766,8,2992,1342,-40
60502551162,60502551167,5,1133,625,-40
60505341905,60505341911,6,2293,1167,-40
60505906884,60505906892,8,2210,1369,-40
60506004120,60506004126,6,2362,1434,-40
60506158228,60506158233,5,2510,1094,-40
60510884802,60510884807,5,2265,1315,-40
60512074806,60512074814,8,2141,1598,-40
60512832897,60512832899,2,1636,295,-40
60513132364,60513132347,-17,1464,425,-40
60514411455,60514411463,8,2745,1410,-40
60516228542,60516228547,5,3948,1557,-40
60517238430,60517238437,7,3526,1074,-40
60518879414,60518879421,7,3306,1062,-40
60518964978,60518964979,1,838,227,-40
60520193815,60520193815,0,764,1392,-40
60521103150,60521103156,6,2832,1052,-40
60522554690,60522554696,6,2297,945,-40
60530637331,60530637325,-6,1630,9892,-40
60531795498,60531795504,6,2283,1367,-40
60539510378,60539510384,6,2814,1573,-40
60541744703,60541744707,4,1635,703,-40
60543735450,60543735458,8,3176,1120,-40
60547206245,60547206250,5,2540,995,-40
60549614397,60549614393,-4,1083,3200,-40
60551448053,60551448060,7,2620,1626,-40
60551537711,60551537714,3,1966,1885,-40
60558834685,60558834691,6,3373,1445,-40
60562477737,60562477745,8,3135,1343,-40
60562681445,60562681434,-11,1106,264,-40
60565870375,60565870382,7,2722,1496,-40
60566939175,60566939182,7,2313,1050,-40
60567520095,60567520101,6,3192,1549,-40
60570792647,60570792654,7,1774,825,-40
60571170969,60571170975,6,3285,1112,-40
60572612752,60572612759,7,2008,995,-40
60573596603,60573596601,-2,1483,3041,-40
60578402486,60578402491,5,1974,927,-40
60579816118,60579816126,8,3195,1027,-40
60580040421,60580040404,-17,1402,1231,-40
60580764488,60580764493,5,2466,1184,-40
60584307814,60584307820,6,4566,2429,-40
60586618576,60586618582,6,2615,1478,-40
60590882712,60590882712,0,1203,1822,-40
60596630595,60596630602,7,2427,925,-40
60608218168,60608218174,6,3745,1593,-40
60613612029,60613612030,1,6423,7913,-40
60616668738,60616668746,8,2209,1289,-40
60619723087,60619723095,8,3095,1260,-40
60620732663,60620732666,3,2881,1381,-40
60621550005,60621550010,5,2420,954,-40
60622876953,60622876959,6,2461,1386,-40
60628175481,60628175481,0,1836,1330,-40
60628354861,60628354865,4,1794,1085,-40
60632319986,60632319990,4,3086,1621,-40
60635559469,60635559476,7,3298,1550,-40
60637057226,60637057236,10,1308,668,-40
60638018053,60638018072,19,2949,1120,-40
60647071578,60647071582,4,1541,1490,-40
60652876142,60652876148,6,2882,1508,-40
60659836901,60659836908,7,2332,979,-40
60663004542,60663004550,8,3532,1054,-40
60666118128,60666118135,7,3029,1196,-40
60670175660,60670175667,7,1975,875,-40
60673549788,60673549795,7,2253,846,-40
60674238911,60674238917,6,2603,1303,-40
60685594037,60685594020,-17,977,508,-40
60687378083,60687378090,7,2779,1541,-40
60688832205,60688832212,7,2987,1100,-40
60692770870,60692770874,4,1474,795,-40
60693120234,60693120241,7,1736,700,-40
60694258066,60694258061,-5,1916,7686,-40
60697156060,60697156066,6,3136,1192,-40
60702285810,60702285815,5,1922,957,-40
60702753594,60702753601,7,1896,1206,-40
60704655330,60704655338,8,4054,1296,-40
60707271151,60707271158,7,2321,1073,-40
60708445171,60708445178,7,2968,1151,-40
60708836094,60708836099,5,2133,1480,-40
60709323952,60709323958,6,2126,1304,-40
60711475173,60711475183,10,2606,937,-40
60715444144,60715444150,6,2616,956,-40
60718862185,60718862192,7,1297,1012,-40
60720107229,60720107235,6,2383,1562,-40
60725342747,60725342764,17,1158,178,-40
60729178566,60729178571,5,1465,1120,-40
60732335503,60732335506,3,2035,1631,-40
60732520606,60732520616,10,2722,831,-40
60732655758,60732655771,13,3137,47337,-40
60733571739,60733571745,6,3559,1860,-40
60738129097,60738129102,5,3132,1141,-40
60738656142,60738656146,4,2514,1416,-40
60740202183,60740202182,-1,1065,2437,-40
60743269453,60743269459,6,3537,1436,-40
60745583049,60745583054,5,3760,1242,-40
60745720410,60745720400,-10,1514,386,-40
60747688526,60747688531,5,1781,1056,-40
60748251295,60748251302,7,2690,1119,-40
60748429243,60748429251,8,3360,1501,-40
60749888083,60749888091,8,2387,1371,-40
60750657102,60750657097,-5,1115,3842,-40
60755230662,60755230666,4,1178,1010,-40
60756789105,60756789110,5,2941,1187,-40
60757778930,60757778938,8,1815,957,-40
60759170722,60759170726,4,2623,1372,-40
60764442698,60764442702,4,3525,1204,-40
60764479177,60764479182,5,2825,1231,-40
60766192699,60766192705,6,2947,1368,-40
60769940280,60769940285,5,2719,1443,-40
60773139802,60773139798,-4,1288,4113,-40
60777311389,60777311395,6,2473,1353,-40
60779078072,60779078075,3,3287,1166,-40
60779147845,60779147851,6,2899,1051,-40
60780620538,60780620542,4,18621,20775,-40
60786009431,60786009437,6,2147,1272,-40
60788762302,60788762309,7,2861,1528,-40
60791130477,60791130457,-20,1812,590,-40
60792212425,60792212430,5,2965,1414,-40
60793746217,60793746225,8,2857,1221,-40
60796376363,60796376369,6,4551,1729,-40
60803006939,60803006940,1,584,115,-40
60810884542,60810884548,6,3076,1400,-40
60812457360,60812457341,-19,189,1036,-40
60814332807,60814332797,-10,42550,14038,-40
60818785194,60818785202,8,3313,1516,-40
60824640808,60824640810,2,1943,1431,-40
60830863351,60830863357,6,2899,1448,-40
60832706937,60832706943,6,3535,1546,-40
60833401772,60833401778,6,1818,1419,-40
60835414641,60835414646,5,2011,994,-40
60837087826,60837087832,6,2545,1059,-40
60837678970,60837678978,8,1110,300,-40
60839975501,60839975506,5,2130,1111,-40
60841276088,60841276090,2,2317,1048,-40
60844376727,60844376734,7,2300,1483,-40
60845356339,60845356344,5,1947,980,-40
60845665386,60845665393,7,815,308,-40
60847518625,60847518628,3,1436,1454,-40
60851963719,60851963713,-6,1215,3468,-40
60860482609,60860482614,5,2646,1044,-40
60860749676,60860749658,-18,2748,1241,-40
60862089205,60862089210,5,2113,858,-40
60863581070,60863581075,5,2420,1277,-40
60873965136,60873965158,22,2037,1243,-40
60875006509,60875006501,-8,43573,15957,-40
60875745326,60875745333,7,2145,852,-40
60876843779,60876843786,7,2160,1660,-40
60877903436,60877903443,7,3330,1396,-40
60879324957,60879324963,6,2716,872,-40
60884005152,60884005159,7,1291,782,-40
60884798563,60884798564,1,1314,1941,-40
60885278794,60885278799,5,3121,1183,-40
60887499358,60887499362,4,1021,400,-40
60888706834,60888706842,8,2609,1192,-40
60891653915,60891653922,7,3447,1027,-40
60893019316,60893019322,6,2845,1500,-40
60896212017,60896212023,6,3769,1372,-40
60898520579,60898520584,5,2786,1359,-40
60900862016,60900862025,9,6152,1404,-40
60904151541,60904151550,9,3982,1371,-40
60904790667,60904790671,4,2243,1351,-40
60905456557,60905456563,6,1744,1124,-40
60911361877,60911361864,-13,161,6056,-40
60912200609,60912200612,3,16718,11325,-40
60916553440,60916553446,6,1990,937,-40
60923519965,60923519970,5,1874,775,-40
60923821245,60923821228,-17,1192,459,-40
60923924817,60923924823,6,2742,1454,-40
60924005790,60924005770,-20,3191,1984,-40
60928951954,60928951958,4,2652,910,-40
60932516715,60932516714,-1,1016,1328,-40
60933721037,60933721035,-2,1195,329,-40
60945018744,60945018750,6,3226,1662,-40
60945105234,60945105216,-18,2725,794,-40
60945989287,60945989293,6,3919,1555,-40
60947522387,60947522384,-3,758,1858,-40
60948728366,60948728370,4,2894,1692,-40
60949010442,60949010448,6,2010,925,-40
60950638698,60950638701,3,2291,1725,-40
60951837724,60951837731,7,2244,970,-40
60953716772,60953716777,5,1754,1550,-40
60956191618,60956191623,5,2904,1731,-40
60956351179,60956351186,7,3199,1199,-40
60957706125,60957706131,6,2895,1116,-40
60958970692,60958970697,5,3538,1628,-40
60960326658,60960326665,7,2272,1284,-40
60961642433,60961642443,10,16311,21286,-40
60968862362,60968862361,-1,570,1422,-40
60973849835,60973849841,6,2737,1129,-40
60974697113,60974697119,6,2653,1390,-40
60976035675,60976035679,4,1619,945,-40
60976735203,60976735186,-17,1051,1782,-40
60980862829,60980862834,5,3314,1093,-40
60981255175,60981255178,3,7981,16412,-40
60982282132,60982282138,6,3126,1340,-40
60982441924,60982441931,7,1672,1017,-40
60983538326,60983538333,7,2872,1375,-40
60989384366,60989384373,7,4989,1779,-40
60992087761,60992087766,5,3985,1831,-40
61005657532,61005657538,6,2956,1739,-40
61009444261,61009444269,8,2430,816,-40
61016730845,61016730852,7,2928,965,-40
61019505812,61019505817,5,2613,1400,-40
61026377952,61026377958,6,1970,1283,-40
61035086301,61035086306,5,2066,1145,-40
61038536576,61038536573,-3,1711,2278,-40
61038593289,61038593295,6,2482,1031,-40
61041838703,61041838710,7,2279,1138,-40
61041997898,61041997906,8,2976,1030,-40
61044495871,61044495873,2,1877,1271,-40
61049715542,61049715548,6,2112,1063,-40
61049985081,61049985083,2,1503,1654,-40
61051530833,61051530839,6,2789,1300,-40
61057071069,61057071075,6,2466,1519,-40
61060627945,61060627952,7,4538,1773,-40
61060945914,61060945929,15,907,161,-40
61062176569,61062176575,6,1516,713,-40
61064248737,61064248742,5,2337,1438,-40
61066709605,61066709611,6,2368,1171,-40
61066840155,61066840161,6,3032,1217,-40
61067692415,61067692422,7,1435,757,-40
61069402122,61069402105,-17,1967,1023,-40
61080853979,61080853985,6,2828,1104,-40
61081710630,61081710639,9,2781,973,-40
61086088261,61086088266,5,2817,1084,-40
61088082253,61088082259,6,4105,1502,-40
61090702049,61090702055,6,2899,1250,-40
61091135217,61091135209,-8,1199,4323,-40
61094326953,61094326960,7,3514,1259,-40
61094732122,61094732126,4,907,978,-40
61097247366,61097247371,5,3069,1358,-40
61100648597,61100648601,4,2432,939,-40
61103035565,61103035571,6,3702,1414,-40
61104557495,61104557501,6,3023,1218,-40
61109106847,61109106851,4,997,950,-40
61114714205,61114714212,7,2976,1359,-40
61122377707,61122377714,7,3838,1289,-40
61122645782,61122645770,-12,966,392,-40
61122798655,61122798632,-23,622,95,-40
61127028543,61127028549,6,2425,821,-40
61128733981,61128733962,-19,2448,1219,-40
61133074653,61133074658,5,2152,1241,-40
61140007202,61140007207,5,2665,833,-40
61142560058,61142560064,6,2953,1310,-40
61144723973,61144723980,7,2763,851,-40
61149611075,61149611081,6,2999,1433,-40
61149780707,61149780691,-16,1925,1154,-40
61162824326,61162824334,8,2348,1227,-40
61164776759,61164776766,7,3113,1022,-40
61165221658,61165221655,-3,2086,4023,-40
61169875998,61169876003,5,2881,1404,-40
61170898881,61170898861,-20,1540,749,-40
61171197216,61171197221,5,1865,1246,-40
61173014342,61173014346,4,930,564,-40
61174586616,61174586615,-1,940,1655,-40
61175374204,61175374213,9,2987,1422,-40
61176629922,61176629927,5,3108,1384,-40
61178644827,61178644832,5,3953,1960,-40
61178938248,61178938254,6,1625,579,-40
61185675974,61185675978,4,3755,1361,-40
61185751676,61185751687,11,4543,1496,-40
61186392784,61186392792,8,2348,1381,-40
61187744153,61187744158,5,3360,1588,-40
61194683238,61194683243,5,1528,983,-40
61196706326,61196706334,8,3581,1526,-40
61197197431,61197197443,12,3031,1303,-40
61199915284,61199915282,-2,1009,1429,-40
61202888794,61202888803,9,2490,916,-40
61208469031,61208469038,7,2497,1346,-40
61213939777,61213939779,2,1503,1018,-40
61218580816,61218580821,5,1525,1116,-40
61221547006,61221547010,4,1845,1444,-40
61221660302,61221660307,5,2039,1545,-40
61224212403,61224212407,4,2225,1191,-40
61229327280,61229327287,7,2185,837,-40
61230083998,61230083976,-22,3701,1478,-40
61230684042,61230684050,8,3877,1231,-40
61235176437,61235176444,7,3513,1894,-40
61242780830,61242780832,2,3000,2310,-40
61243401839,61243401847,8,3651,1621,-40
61245387871,61245387877,6,2540,964,-40
61246636288,61246636281,-7,1412,5065,-40
61253917288,61253917273,-15,2286,726,-40
61264640046,61264640052,6,2320,1234,-40
61265059941,61265059931,-10,851,311,-40
61265662857,61265662863,6,3353,1619,-40
61267411632,61267411620,-12,2893,1517,-40
61273089909,61273089916,7,3092,1165,-40
61274037220,61274037226,6,2256,1110,-40
61279794030,61279794037,7,4295,1612,-40
61284546242,61284546249,7,2240,1140,-40
61285305291,61285305297,6,3417,1590,-40
61287002686,61287002694,8,2612,1565,-40
61287034077,61287034059,-18,550,332,-40
61288915502,61288915508,6,2400,1228,-40
61288948325,61288948331,6,3296,813,-40
61289471550,61289471557,7,2718,1226,-40
61292601815,61292601824,9,2138,952,-40
61295523383,61295523389,6,3388,1715,-40
61296066182,61296066186,4,2348,1281,-40
61297501462,61297501463,1,1728,1372,-40
61302539968,61302539974,6,2536,1523,-40
61303779475,61303779482,7,2851,1382,-40
61307199626,61307199631,5,2804,1812,-40
61309619707,61309619712,5,2589,1279,-40
61312252392,61312252397,5,1412,769,-40
61320089762,61320089767,5,2390,1327,-40
61320189133,61320189138,5,4193,1663,-40
61323618719,61323618726,7,2643,1341,-40
61327799044,61327799049,5,4227,1103,-40
61336591920,61336591926,6,4039,1612,-40
61337402877,61337402882,5,2263,1120,-40
61338858344,61338858350,6,3094,1382,-40
61341317270,61341317277,7,2531,1491,-40
61343843283,61343843290,7,2641,836,-40
61344444363,61344444371,8,772,127,-40
61345229627,61345229632,5,2113,1607,-40
61348477057,61348477063,6,3420,1615,-40
61350255143,61350255150,7,2028,1133,-40
61352209056,61352209064,8,3177,1324,-40
61354300764,61354300773,9,3082,1103,-40
61355043082,61355043066,-16,1577,872,-40
61358161649,61358161655,6,2447,1005,-40
61358931944,61358931931,-13,1579,433,-40
61363042477,61363042482,5,2117,985,-40
61365832766,61365832773,7,2309,1383,-40
61371429409,61371429415,6,1849,970,-40
61378281998,61378282006,8,3128,1011,-40
61379131433,61379131439,6,2874,1287,-40
61388156374,61388156378,4,887,460,-40
61390141154,61390141162,8,3008,879,-40
61391196558,61391196565,7,2349,1486,-40
61392060471,61392060449,-22,1680,1095,-40
61393263897,61393263902,5,2030,1881,-40
61395313458,61395313465,7,1474,744,-40
61395524802,61395524787,-15,1066,450,-40
61396183497,61396183503,6,1979,1058,-40
61397240099,61397240098,-1,2598,4398,-40
61397962340,61397962336,-4,1756,5458,-40
61398027689,61398027677,-12,1588,1253,-40
61400702679,61400702687,8,2497,1147,-40
61407709969,61407709984,15,3140,1183,-40
61408952365,61408952371,6,2342,1115,-40
61415073300,61415073305,5,3024,1258,-40
61417601941,61417601947,6,2853,1377,-40
61417953070,61417953075,5,2198,1371,-40
61418730477,61418730482,5,2336,957,-40
61420320149,61420320155,6,2537,1266,-40
61422209430,61422209435,5,3478,1253,-40
61423174714,61423174717,3,1036,1397,-40
61430750244,61430750234,-10,1068,28027,-40
61430931177,61430931183,6,3420,1421,-40
61431029983,61431029989,6,2006,1026,-40
61431485354,61431485340,-14,463,326,-40
61432656111,61432656117,6,3229,1309,-40
61433376949,61433376955,6,2703,1667,-40
61436681177,61436681184,7,1747,1036,-40
61436990624,61436990630,6,2339,969,-40
61438478653,61438478661,8,2974,1194,-40
61441148341,61441148347,6,2057,1397,-40
61443280033,61443280040,7,2895,1629,-40
61444708652,61444708647,-5,1684,3130,-40
61445204688,61445204695,7,2822,1046,-40
61447046665,61447046671,6,821,514,-40
61447594103,61447594083,-20,2204,1117,-40
61448703073,61448703079,6,2437,1146,-40
61450152032,61450152039,7,2635,967,-40
61453410682,61453410687,5,2015,881,-40
61456090125,61456090131,6,3478,1495,-40
61459467543,61459467550,7,2736,1259,-40
61462680010,61462680015,5,3865,1695,-40
61463599298,61463599284,-14,1426,898,-40
61469603053,61469603058,5,3144,1451,-40
61477821202,61477821205,3,2407,1915,-40
61479237062,61479237069,7,3944,991,-40
61479320003,61479319986,-17,1014,414,-40
61485295626,61485295633,7,4534,1516,-40
61486094694,61486094699,5,3044,1641,-40
61487151706,61487151712,6,3347,1308,-40
61491281517,61491281523,6,3285,1385,-40
61493917630,61493917638,8,2735,1230,-40
61496486293,61496486298,5,2920,1172,-40
61501698122,61501698121,-1,1033,1740,-40
61503403789,61503403793,4,2981,1213,-40
61503957463,61503957469,6,3076,1958,-40
61504709670,61504709677,7,3842,1617,-40
61514688046,61514688050,4,4041,1330,-40
61514970463,61514970460,-3,26925,31542,-40
61515766786,61515766792,6,3060,1685,-40
61516782603,61516782609,6,3534,1343,-40
61517200453,61517200457,4,4230,1977,-40
61518649387,61518649393,6,3123,1440,-40
61521295930,61521295934,4,1395,1502,-40
61525015738,61525015747,9,12112,21346,-40
61532558978,61532558978,0,39149,35128,-40
61532718790,61532718796,6,2519,1268,-40
61534415426,61534415418,-8,686,331,-40
61540684994,61540685001,7,1981,1167,-40
61542313796,61542313800,4,2419,1002,-40
61542626598,61542626602,4,2574,1026,-40
61543044818,61543044801,-17,953,302,-40
61543699897,61543699903,6,2512,853,-40
61546928310,61546928316,6,1941,1138,-40
61548111462,61548111468,6,3637,1623,-40
61548482922,61548482931,9,3060,921,-40
61551591550,61551591546,-4,742,1878,-40
61552224536,61552224542,6,3045,919,-40
61553599918,61553599925,7,1471,979,-40
61554546809,61554546792,-17,2638,1289,-40
61556371184,61556371188,4,2056,1252,-40
61561762501,61561762506,5,2700,1202,-40
61566910371,61566910378,7,3693,1400,-40
61571149742,61571149747,5,3098,1072,-40
61571324342,61571324347,5,2039,1013,-40
61571600722,61571600705,-17,1299,346,-40
61571849254,61571849263,9,2322,1230,-40
61572303759,61572303766,7,2955,1268,-40
61575533751,61575533757,6,2179,927,-40
61576746437,61576746450,13,1292,999,-40
61589755699,61589755706,7,3365,1024,-40
61590855257,61590855270,13,18745,34825,-40
61591478361,61591478367,6,1640,1049,-40
61602654248,61602654244,-4,55043,22446,-40
61603470714,61603470721,7,2806,1333,-40
61603824459,61603824457,-2,707,340,-40
61605091422,61605091429,7,1872,1265,-40
61608155757,61608155764,7,2398,1064,-40
61610490109,61610490114,5,2770,1459,-40
61610939810,61610939815,5,2533,1416,-40
61612355665,61612355662,-3,1201,2405,-40
61617860062,61617860068,6,2659,1409,-40
61618484248,61618484233,-15,1432,635,-40
61622654327,61622654335,8,2700,1418,-40
61623507642,61623507647,5,2227,1282,-40
61636285961,61636285967,6,2425,1140,-40
61644433379,61644433386,7,2599,1539,-40
61654149714,61654149721,7,3427,1768,-40
61655235707,61655235713,6,1864,833,-40
61656112254,61656112264,10,1931,1181,-40
61657916940,61657916947,7,2850,1346,-40
61658247278,61658247258,-20,3373,1017,-40
61659774108,61659774114,6,2750,1017,-40
61662785721,61662785726,5,3082,1424,-40
61664453788,61664453795,7,3051,992,-40
61664680215,61664680232,17,1991,959,-40
61665443006,61665443013,7,2671,1121,-40
61665614178,61665614172,-6,2275,5785,-40
61666539277,61666539283,6,3136,1171,-40
61666955983,61666955990,7,3342,1260,-40
61667347999,61667347980,-19,2735,1094,-40
61668219785,61668219791,6,2953,1171,-40
61668604754,61668604759,5,2194,1201,-40
61668993778,61668993768,-10,1149,359,-40
61669171691,61669171689,-2,713,236,-40
61674683164,61674683174,10,127,1823,-40
61675767540,61675767543,3,2363,2428,-40
61680423206,61680423210,4,3278,1673,-40
61682400067,61682400075,8,2905,920,-40
61684268335,61684268342,7,10835,7108,-40
61685830948,61685830943,-5,2359,6136,-40
61686133474,61686133482,8,2518,1164,-40
61691119317,61691119324,7,3467,1470,-40
61693503854,61693503862,8,2549,1056,-40
61695566862,61695566862,0,755,966,-40
61697764975,61697764978,3,1450,1590,-40
61700281314,61700281321,7,3280,1365,-40
61702914841,61702914837,-4,1574,1943,-40
61706051155,61706051158,3,2226,1527,-40
61706854666,61706854671,5,1753,1091,-40
61706994622,61706994611,-11,2109,833,-40
61709573301,61709573306,5,2941,1309,-40
61709756058,61709756066,8,690,356,-40
61710825548,61710825531,-17,3803,349,-40
61712909999,61712910006,7,3194,1109,-40
61714283438,61714283449,11,1186,359,-40
61719933111,61719933110,-1,814,1316,-40
61720484726,61720484734,8,2054,994,-40
61721832981,61721832986,5,2740,1405,-40
61722153499,61722153503,4,2217,574,-40
61731670785,61731670780,-5,1190,2450,-40
61734057831,61734057835,4,3945,2444,-40
61734190266,61734190271,5,3888,1496,-40
61735073982,61735073988,6,4173,1202,-40
61736128793,61736128799,6,2465,1298,-40
61736206692,61736206676,-16,2666,835,-40
61736874539,61736874545,6,2252,1043,-40
61738528848,61738528855,7,4007,1623,-40
61739974153,61739974159,6,2742,1461,-40
61740121936,61740121942,6,1296,492,-40
61744110038,61744110046,8,1691,872,-40
61744455896,61744455903,7,1989,786,-40
61745439547,61745439554,7,2653,1036,-40
61746198755,61746198758,3,1250,1561,-40
61750466325,61750466330,5,4887,3039,-40
61752371610,61752371613,3,2270,1662,-40
61752488953,61752488959,6,3779,1222,-40
61753631738,61753631739,1,1362,1235,-40
61754025525,61754025530,5,3410,1641,-40
61756808492,61756808494,2,1778,2610,-40
61758367233,61758367240,7,2372,1469,-40
61758737314,61758737298,-16,859,655,-40
61762280251,61762280257,6,3458,1509,-40
61763818313,61763818319,6,2815,1378,-40
61765331936,61765331932,-4,39991,68772,-40
61767683770,61767683771,1,1560,1779,-40
61772532738,61772532743,5,2630,1190,-40
61775108078,61775108084,6,2493,1257,-40
61779025386,61779025394,8,2512,1222,-40
61780735828,61780735833,5,2586,860,-40
61781350108,61781350112,4,1497,1204,-40
61783966984,61783966966,-18,2696,1577,-40
61787808139,61787808133,-6,569,3510,-40
61789039013,61789039008,-5,839,191,-40
61797411392,61797411397,5,2767,1595,-40
61799039626,61799039632,6,2680,1390,-40
61802241047,61802241054,7,3106,1313,-40
61802710385,61802710371,-14,1178,251,-40
61807075633,61807075639,6,2941,1077,-40
61810112530,61810112535,5,3355,1208,-40
61810337895,61810337902,7,4410,1780,-40
61812543905,61812543909,4,2665,837,-40
61812739861,61812739868,7,2861,1335,-40
61813965393,61813965400,7,3587,1268,-40
61816942538,61816942542,4,2276,1253,-40
61819934397,61819934402,5,235,299,-40
61828032309,61828032315,6,2009,1631,-40
61831547333,61831547336,3,2254,1421,-40
61835189239,61835189243,4,1414,802,-40
61835272779,61835272785,6,3606,1072,-40
61836876018,61836876025,7,1675,879,-40
61837271471,61837271474,3,1436,1197,-40
61842067137,61842067143,6,3633,1208,-40
61850083886,61850083892,6,2603,1189,-40
61851979169,61851979175,6,2684,1046,-40
61856375649,61856375653,4,3666,745,-40
61858713105,61858713111,6,2656,760,-40
61860559422,61860559427,5,1621,1492,-40
61861072336,61861072341,5,2702,1309,-40
61862343952,61862343966,14,16194,37143,-40
61862727790,61862727798,8,2004,1210,-40
61865884658,61865884663,5,1151,432,-40
61868276177,61868276181,4,2174,1534,-40
61875466338,61875466345,7,2387,1394,-40
61877167306,61877167313,7,1985,852,-40
61879539206,61879539211,5,2196,1356,-40
61883131511,61883131514,3,2267,679,-40
61883442210,61883442214,4,2770,1288,-40
61887496749,61887496755,6,2583,1289,-40
61887785226,61887785210,-16,1480,467,-40
61891350737,61891350743,6,2316,1426,-40
61893296081,61893296087,6,2520,1227,-40
61895486986,61895486992,6,2174,1075,-40
61895776955,61895776940,-15,2629,1277,-40
61897839129,61897839134,5,2676,1317,-40
61899232702,61899232706,4,2900,1603,-40
61900698326,61900698332,6,3051,1191,-40
61902005573,61902005579,6,3137,1737,-40
61903687305,61903687301,-4,2569,46688,-40
61906823370,61906823374,4,2757,970,-40
61907929583,61907929583,0,1404,2487,-40
61908193601,61908193606,5,2616,1556,-40
61909228288,61909228295,7,2898,1430,-40
61909992776,61909992781,5,3542,1251,-40
61910062980,61910062986,6,3014,1324,-40
61910646338,61910646345,7,2370,675,-40
61911733306,61911733312,6,2775,1604,-40
61911928166,61911928169,3,933,144,-40
61919213317,61919213325,8,3729,1059,-40
61924568598,61924568601,3,3001,2657,-40
61925237074,61925237082,8,2858,1110,-40
61927508086,61927508092,6,2847,1495,-40
61929033282,61929033288,6,2239,1085,-40
61934792474,61934792481,7,2973,1417,-40
61938256309,61938256311,2,11720,11917,-40
61938445938,61938445941,3,2439,1437,-40
61939565711,61939565717,6,3536,1535,-40
61939875205,61939875210,5,2582,1389,-40
61939951811,61939951795,-16,1234,191,-40
61942648686,61942648693,7,1850,1028,-40
61945227816,61945227823,7,1793,897,-40
61945295373,61945295379,6,2249,1175,-40
61945373635,61945373641,6,2573,1495,-40
61945672768,61945672756,-12,947,300,-40
61948552939,61948552945,6,2432,921,-40
61950394260,61950394266,6,15144,18221,-40
61950914916,61950914921,5,2747,1192,-40
61955764143,61955764147,4,4810,3224,-40
61957209018,61957209025,7,3257,1362,-40
61960173334,61960173339,5,2876,1148,-40
61960719679,61960719683,4,2314,1305,-40
61963215784,61963215789,5,1437,753,-40
61964363285,61964363291,6,4239,1762,-40
61967379174,61967379182,8,3466,1568,-40
61967544387,61967544385,-2,1043,1573,-40
61969952938,61969952938,0,753,1157,-40
61972735642,61972735647,5,2735,971,-40
61976492576,61976492581,5,2876,1176,-40
61979944109,61979944094,-15,2044,705,-40
61980685809,61980685814,5,2656,1082,-40
61984621827,61984621833,6,1932,728,-40
61989159424,61989159429,5,2181,1497,-40
61989652301,61989652307,6,3011,1244,-40
61990800517,61990800539,22,679,64,-40
61991662421,61991662401,-20,3885,1599,-40
61994113378,61994113387,9,3127,1379,-40
61998232527,61998232533,6,2240,1219,-40
61998282678,61998282685,7,2780,1539,-40
62003711207,62003711213,6,2560,1163,-40
62008220083,62008220091,8,2347,1135,-40
62009434083,62009434102,19,473,1216,-40
62009474245,62009474254,9,2470,824,-40
62010641697,62010641702,5,2350,1200,-40
62011348635,62011348629,-6,26359,11081,-40
62012773720,62012773727,7,2820,1006,-40
62013925410,62013925417,7,3059,1259,-40
62016047602,62016047610,8,4507,1908,-40
62022063898,62022063902,4,2261,990,-40
62026018677,62026018685,8,2747,1312,-40
62031951074,62031951082,8,3134,1232,-40
62033178607,62033178611,4,2139,1114,-40
62034033082,62034033087,5,3227,1481,-40
62034118426,62034118433,7,3375,1387,-40
62035697545,62035697551,6,5428,1408,-40
62036448751,62036448757,6,2480,927,-40
62037214652,62037214659,7,3736,1093,-40
62046239394,62046239403,9,2456,1078,-40
62048234726,62048234732,6,2847,1343,-40
62049265590,62049265596,6,3065,1705,-40
62050557360,62050557366,6,1498,849,-40
62050730003,62050730008,5,2658,1137,-40
62054142411,62054142417,6,2115,1387,-40
62055247126,62055247104,-22,1058,332,-40
62060781037,62060781043,6,3095,1124,-40
62061875851,62061875857,6,1963,1271,-40
62065379522,62065379529,7,2030,1115,-40
62065843281,62065843287,6,2662,1076,-40
62068543794,62068543814,20,692,1607,-40
62068790671,62068790674,3,1621,1249,-40
62070254813,62070254794,-19,813,521,-40
62071192665,62071192671,6,2987,1243,-40
62073131739,62073131737,-2,2093,4479,-40
62073677375,62073677382,7,3339,1775,-40
62074340745,62074340763,18,838,359,-40
62085510617,62085510622,5,2625,1272,-40
62086068977,62086068982,5,2835,1466,-40
62087176822,62087176827,5,3625,1522,-40
62090809773,62090809778,5,3191,1287,-40
62094386364,62094386377,13,99,1326,-40
62095416738,62095416741,3,1867,1561,-40
62096027806,62096027812,6,1970,1612,-40
62097514564,62097514569,5,30621,45994,-40
62097572499,62097572500,1,1170,1818,-40
62098019174,62098019181,7,3366,1430,-40
62098181547,62098181553,6,2976,1096,-40
62100766025,62100766030,5,2176,1216,-40
62102643457,62102643463,6,4253,1471,-40
62103606308,62103606313,5,3957,1398,-40
62106878272,62106878278,6,2686,1313,-40
62107430914,62107430922,8,2322,832,-40
62108828742,62108828749,7,2919,1223,-40
62114483167,62114483167,0,1149,1387,-40
62116674758,62116674761,3,1668,1240,-40
62122706112,62122706118,6,2868,1121,-40
62123150929,62123150936,7,3372,811,-40
62124341221,62124341226,5,3888,1479,-40
62124908540,62124908546,6,2450,842,-40
62128907186,62128907190,4,2267,1465,-40
62130909313,62130909320,7,3254,1708,-40
62134180228,62134180234,6,2934,1642,-40
62141180022,62141180027,5,1037,931,-40
62141385162,62141385155,-7,1837,256,-40
62145146990,62145146996,6,2350,1454,-40
62145627803,62145627786,-17,1089,569,-40
62146788082,62146788090,8,1306,618,-40
62150807895,62150807902,7,3641,1207,-40
62153647821,62153647826,5,3024,1243,-40
62154736558,62154736557,-1,1161,1835,-40
62156896733,62156896738,5,2956,1195,-40
62159535124,62159535130,6,1865,757,-40
62161638213,62161638220,7,13074,22447,-40
62163487876,62163487882,6,3110,1782,-40
62164220236,62164220236,0,8890,11801,-40
62170076017,62170076021,4,1785,1247,-40
62170786980,62170786987,7,2090,1082,-40
62171455355,62171455361,6,3428,1376,-40
62172387925,62172387931,6,2976,1256,-40
62176465974,62176465980,6,2265,1420,-40
62176605175,62176605152,-23,716,145,-40
62177124130,62177124136,6,2328,1162,-40
62182820431,62182820431,0,1333,1955,-40
62183562030,62183562036,6,3880,1781,-40
62183683049,62183683065,16,2625,847,-40
62184418518,62184418522,4,2184,1448,-40
62186428042,62186428048,6,2761,1226,-40
62188661347,62188661352,5,1328,1442,-40
62193768278,62193768282,4,1962,1229,-40
62194681473,62194681456,-17,2878,1255,-40
62196009426,62196009434,8,2986,1679,-40
62196502443,62196502450,7,3401,1253,-40
62199012702,62199012710,8,2801,1166,-40
62200977231,62200977237,6,2782,1586,-40
62201179757,62201179769,12,1237,456,-40
62202052862,62202052868,6,2472,1414,-40
62204373266,62204373272,6,2083,1054,-40
62204747618,62204747600,-18,1612,285,-40
62206206152,62206206158,6,2886,1173,-40
62210015657,62210015663,6,3411,1464,-40
62211158102,62211158107,5,2902,1524,-40
62211947451,62211947444,-7,568,246,-40
62213549817,62213549822,5,2954,1464,-40
62215415538,62215415546,8,6062,979,-40
62216039126,62216039138,12,2350,1313,-40
62216587242,62216587224,-18,2263,1330,-40
62217041422,62217041429,7,3561,1529,-40
62217353057,62217353063,6,2576,1162,-40
62219480472,62219480478,6,3741,1670,-40
62221667265,62221667260,-5,1104,5702,-40
62226243635,62226243640,5,3129,1397,-40
62234713570,62234713578,8,3015,1386,-40
62234876901,62234876906,5,3756,1386,-40
62239829294,62239829301,7,3007,1448,-40
62241294454,62241294461,7,2603,1405,-40
62241843229,62241843234,5,3361,1495,-40
62243612220,62243612225,5,3041,1566,-40
62245928612,62245928618,6,2056,1024,-40
62247570962,62247570966,4,2716,1260,-40
62248009621,62248009627,6,1981,1206,-40
62248394326,62248394333,7,2553,1184,-40
62248788566,62248788575,9,3477,1161,-40
62249017958,62249017939,-19,3024,1306,-40
62249548973,62249548979,6,3265,1413,-40
62250560111,62250560115,4,3025,1862,-40
62254224630,62254224636,6,3733,1493,-40
62255559450,62255559457,7,3679,1036,-40
62256161950,62256161930,-20,3887,1839,-40
62257763120,62257763126,6,3465,1277,-40
62258304442,62258304447,5,1448,631,-40
62259007097,62259007102,5,1239,865,-40
62259397634,62259397642,8,5623,1816,-40
62266326165,62266326170,5,2947,1318,-40
62267990164,62267990157,-7,1527,1225,-40
62271378993,62271378999,6,1974,1137,-40
62271582252,62271582258,6,1328,656,-40
62275207426,62275207434,8,2678,1202,-40
62275633283,62275633268,-15,532,295,-40
62278074195,62278074203,8,2742,1431,-40
62278691045,62278691051,6,1779,1064,-40
62280721257,62280721263,6,3526,1342,-40
62283196376,62283196383,7,2995,1545,-40
62284224251,62284224258,7,2885,1104,-40
62286659410,62286659410,0,1615,2038,-40
62287826454,62287826459,5,3245,1460,-40
62291226165,62291226169,4,3883,1335,-40
62293069510,62293069517,7,3678,1407,-40
62298203450,62298203458,8,2903,844,-40
62299116031,62299116038,7,2582,1464,-40
62299332717,62299332728,11,802,300,-40
62301154214,62301154222,8,2570,1318,-40
62303574864,62303574870,6,2214,784,-40
62306383353,62306383354,1,1422,1025,-40
62311293038,62311293045,7,2713,932,-40
62312961278,62312961257,-21,1872,1031,-40
62314518549,62314518555,6,3148,1255,-40
62316842114,62316842118,4,2320,1479,-40
62321237618,62321237626,8,2844,1355,-40
62322500411,62322500415,4,1501,1152,-40
62328213184,62328213189,5,2586,944,-40
62328858445,62328858438,-7,989,3308,-40
62341988017,62341988023,6,1973,1012,-40
62347846151,62347846154,3,2596,1045,-40
62348205110,62348205115,5,3485,1402,-40
62349734333,62349734330,-3,1240,2855,-40
62350044213,62350044212,-1,1125,1680,-40
62350793174,62350793179,5,2075,880,-40
62351228766,62351228771,5,3584,1858,-40
62356053684,62356053690,6,1737,1142,-40
62356285510,62356285506,-4,949,205,-40
62366364714,62366364721,7,2692,1464,-40
62369156756,62369156752,-4,7982,16310,-40
62373580531,62373580537,6,3498,1328,-40
62378779187,62378779189,2,2295,2377,-40
62379178006,62379178010,4,2218,1271,-40
62381782119,62381782126,7,1919,1511,-40
62383423586,62383423586,0,1036,1447,-40
62387874220,62387874226,6,2936,1307,-40
62388548142,62388548121,-21,606,431,-40
62389839995,62389840001,6,3101,1271,-40
62391527666,62391527674,8,1889,978,-40
62394416596,62394416600,4,2762,1138,-40
62395277078,62395277078,0,2050,3161,-40
62399809201,62399809208,7,2504,1821,-40
62401199437,62401199442,5,2080,1019,-40
62404153537,62404153542,5,2512,1454,-40
62405035915,62405035899,-16,3230,1200,-40
62405415005,62405415010,5,1869,911,-40
62406880961,62406880966,5,1506,1229,-40
62407413283,62407413282,-1,1052,1354,-40
62409848549,62409848554,5,3026,1390,-40
62410083990,62410083969,-21,900,122,-40
62417954796,62417954802,6,3297,1499,-40
62419634417,62419634422,5,2085,1133,-40
62424097101,62424097109,8,10838,25855,-40
62432713326,62432713333,7,1866,1129,-40
62432872638,62432872619,-19,888,308,-40
62433368478,62433368474,-4,1058,2789,-40
62439536070,62439536077,7,2404,1244,-40
62440004273,62440004278,5,2432,1392,-40
62442368406,62442368413,7,3514,1507,-40
62444417595,62444417599,4,2645,2114,-40
62444891335,62444891347,12,3026,981,-40
62445584114,62445584120,6,1837,754,-40
62446235226,62446235220,-6,1136,232,-40
62448553770,62448553777,7,2346,959,-40
62448714447,62448714457,10,834,310,-40
62449669616,62449669632,16,1038,1639,-40
62450628337,62450628344,7,2772,1429,-40
62454291889,62454291896,7,1820,1043,-40
62455320448,62455320451,3,1767,829,-40
62459038419,62459038427,8,3251,1398,-40
62463321125,62463321132,7,2392,1374,-40
62463443416,62463443422,6,2289,1395,-40
62464352764,62464352771,7,3179,1427,-40
62464531563,62464531561,-2,1254,3245,-40
62477287911,62477287917,6,3486,1684,-40
62482673989,62482673997,8,3981,1732,-40
62492508693,62492508699,6,3320,1477,-40
62495660790,62495660795,5,4381,1561,-40
62499915237,62499915242,5,3137,1525,-40
62501132097,62501132102,5,2359,1264,-40
62505911702,62505911709,7,4287,1628,-40
62508559069,62508559073,4,2658,1048,-40
62515342884,62515342886,2,1813,1229,-40
62515397647,62515397652,5,1874,1307,-40
62519211906,62519211910,4,2611,1123,-40
62520076330,62520076335,5,2085,1188,-40
62525006829,62525006835,6,3169,1470,-40
62525154422,62525154411,-11,1335,529,-40
62526263150,62526263153,3,1833,1317,-40
62530991846,62530991851,5,1714,1061,-40
62533266730,62533266737,7,10606,31640,-40
62535573778,62535573784,6,2360,1045,-40
62537982636,62537982644,8,2070,1046,-40
62538532378,62538532361,-17,1413,836,-40
62539566497,62539566502,5,2035,899,-40
62540170390,62540170397,7,3619,1615,-40
62552931904,62552931910,6,2925,1324,-40
62553849582,62553849588,6,2993,1317,-40
62556479220,62556479225,5,2758,1327,-40
62560275249,62560275256,7,4283,1007,-40
62560301364,62560301347,-17,3009,1800,-40
62560393674,62560393689,15,2087,894,-40
62563432349,62563432355,6,2816,1448,-40
62565209990,62565209995,5,2506,1725,-40
62568968634,62568968638,4,2559,1572,-40
62569787846,62569787854,8,2826,1132,-40
62574440723,62574440730,7,2073,1012,-40
62578699198,62578699203,5,1434,787,-40
62586004900,62586004906,6,2612,1411,-40
62587754725,62587754730,5,2161,1353,-40
62587845389,62587845395,6,2536,1254,-40
62590995496,62590995503,7,2364,885,-40
62593977274,62593977279,5,2568,1150,-40
62597409637,62597409641,4,2519,1599,-40
62600303416,62600303422,6,3086,1285,-40
62605045085,62605045093,8,2903,1000,-40
62605678531,62605678537,6,3449,1911,-40
62609655987,62609655993,6,2689,1254,-40
62609715722,62609715729,7,1128,167,-40
62612415043,62612415051,8,2180,1258,-40
62613132540,62613132547,7,2410,1262,-40
62615146485,62615146493,8,942,787,-40
62616073330,62616073327,-3,4757,10755,-40
62617741877,62617741884,7,2383,1481,-40
62621760200,62621760205,5,3032,1515,-40
62623054879,62623054881,2,17210,5764,-40
62626503302,62626503307,5,2052,1079,-40
62627415409,62627415417,8,3237,1436,-40
62629356421,62629356425,4,5904,4159,-40
62630200497,62630200490,-7,1466,6131,-40
62633429069,62633429074,5,2442,1302,-40
62637801993,62637801998,5,2790,905,-40
62645861971,62645861974,3,896,1959,-40
62656659530,62656659537,7,3701,1384,-40
62659741529,62659741535,6,3119,1569,-40
62663161834,62663161833,-1,1498,2462,-40
62664670965,62664670970,5,3313,1114,-40
62666637826,62666637805,-21,820,1324,-40
62667899165,62667899171,6,2494,1055,-40
62668536473,62668536491,18,2336,1388,-40
62668664423,62668664426,3,2138,1587,-40
62671912213,62671912219,6,3003,1113,-40
62672045166,62672045172,6,3082,1565,-40
62672654932,62672654938,6,3944,1427,-40
62673640406,62673640414,8,2850,950,-40
62678083754,62678083762,8,3557,1492,-40
62682877874,62682877882,8,3523,1434,-40
62691625854,62691625861,7,2600,987,-40
62693531502,62693531507,5,689,807,-40
62695997829,62695997834,5,4260,1339,-40
62704277370,62704277375,5,2640,1354,-40
62706351941,62706351946,5,2548,1706,-40
62710034069,62710034075,6,1657,799,-40
62717154225,62717154209,-16,2963,981,-40
62719444850,62719444856,6,2810,1196,-40
62722022239,62722022245,6,2293,1359,-40
62722319798,62722319803,5,2134,1192,-40
62726527510,62726527517,7,3590,1732,-40
62727260814,62727260818,4,3848,1759,-40
62728700502,62728700507,5,2317,1312,-40
62731103098,62731103103,5,2040,1154,-40
62732461364,62732461370,6,3093,1395,-40
62732711966,62732711972,6,2669,1581,-40
62734087458,62734087463,5,2082,1275,-40
62735705134,62735705139,5,3662,1348,-40
62738961229,62738961232,3,24289,109627,-40
62743423138,62743423145,7,3461,1425,-40
62745093348,62745093356,8,6266,1345,-40
62749253351,62749253356,5,2457,1182,-40
62757560897,62757560903,6,2478,1356,-40
62765380553,62765380562,9,3697,1428,-40
62773480165,62773480172,7,2016,1107,-40
62773899446,62773899426,-20,918,436,-40
62777803834,62777803839,5,3265,1116,-40
62778007734,62778007714,-20,3986,2052,-40
62779537507,62779537514,7,3589,1215,-40
62782376943,62782376938,-5,1228,2211,-40
62785407369,62785407374,5,4093,1376,-40
62787869500,62787869506,6,2095,1015,-40
62788068358,62788068363,5,2460,1366,-40
62793380704,62793380710,6,2614,1104,-40
62795303513,62795303520,7,3145,1284,-40
62795692791,62795692796,5,2654,1440,-40
62803285082,62803285078,-4,43178,14163,-40
62807948450,62807948457,7,2616,1047,-40
62826224013,62826224018,5,3153,1539,-40
62826644950,62826644955,5,1560,567,-40
62827371883,62827371891,8,2876,1046,-40
62829485508,62829485514,6,2444,574,-40
62829928693,62829928698,5,3718,1681,-40
62835546374,62835546382,8,3343,1162,-40
62838227339,62838227352,13,25305,14398,-40
62841477810,62841477815,5,2853,1601,-40
62845134989,62845134995,6,3224,1464,-40
62845212663,62845212670,7,3427,1384,-40
62846221158,62846221166,8,3249,1576,-40
62847094850,62847094850,0,807,1241,-40
62853695031,62853695036,5,3278,1395,-40
62859085728,62859085733,5,1762,916,-40
62860128862,62860128870,8,2428,773,-40
62864447093,62864447099,6,2611,1197,-40
62864586530,62864586512,-18,1883,1467,-40
62866411071,62866411076,5,3730,1713,-40
62868255724,62868255727,3,2501,1237,-40
62874270227,62874270223,-4,1256,3323,-40
62874907858,62874907863,5,2017,1658,-40
62875004933,62875004939,6,2919,1307,-40
62876634786,62876634792,6,1721,1159,-40
62877043356,62877043361,5,2851,1547,-40
62878678601,62878678607,6,2996,1395,-40
62880522363,62880522367,4,1351,1271,-40
62880573017,62880573024,7,2761,1328,-40
62884384231,62884384226,-5,1526,3475,-40
62888086664,62888086670,6,2585,1352,-40
62890161147,62890161154,7,4183,1278,-40
62890446986,62890446993,7,3658,1187,-40
62892951335,62892951341,6,5611,1614,-40
62894011419,62894011419,0,1042,1972,-40
62895828276,62895828283,7,2544,1414,-40
62896308611,62896308617,6,2182,1246,-40
62897595222,62897595229,7,3143,1755,-40
62900150681,62900150686,5,2475,1630,-40
62904881809,62904881808,-1,2234,3126,-40
62908075237,62908075243,6,2734,847,-40
62908724338,62908724323,-15,2316,832,-40
62909230435,62909230419,-16,2225,1372,-40
62909722362,62909722369,7,3192,1190,-40
62910426526,62910426533,7,2582,1209,-40
62917084478,62917084482,4,1124,895,-40
62918309522,62918309525,3,2549,1232,-40
62919329221,62919329226,5,2982,1775,-40
62922098590,62922098574,-16,2890,1331,-40
62934207575,62934207584,9,3778,1361,-40
62934298386,62934298394,8,1786,810,-40
62935373206,62935373212,6,3455,1582,-40
62936031574,62936031571,-3,1191,3223,-40
62937563906,62937563912,6,3450,1507,-40
62937957362,62937957344,-18,1195,563,-40
62939143974,62939143982,8,2495,971,-40
62941559965,62941559970,5,1822,1178,-40
62945176019,62945176026,7,2890,1144,-40
62947239787,62947239793,6,3581,1146,-40
62948780046,62948780050,4,2285,882,-40
62950286152,62950286158,6,4333,2288,-40
62950573689,62950573694,5,2614,1014,-40
62957834797,62957834801,4,3005,1852,-40
62959957726,62959957731,5,1607,1562,-40
62963178754,62963178748,-6,1980,7598,-40
62966606302,62966606307,5,1413,1047,-40
62969693744,62969693751,7,4459,1992,-40
62971059765,62971059771,6,2538,822,-40
62975405191,62975405198,7,3679,1415,-40
62975546298,62975546303,5,2980,1206,-40
62983085801,62983085806,5,2818,1483,-40
62983153427,62983153412,-15,1443,427,-40
62987811909,62987811902,-7,1068,4961,-40
62988545530,62988545537,7,3979,1261,-40
62993360693,62993360698,5,2832,1651,-40
62999647973,62999647979,6,3251,1152,-40
63000626763,63000626769,6,3684,1505,-40
63001089607,63001089613,6,3013,1198,-40
63002841440,63002841447,7,2518,1603,-40
63005432467,63005432474,7,1694,1115,-40
63006881893,63006881897,4,2752,1390,-40
63007086381,63007086389,8,3125,1372,-40
63007567138,63007567143,5,2592,1222,-40
63010274899,63010274899,0,921,1178,-40
63011209309,63011209315,6,2297,1260,-40
63016318522,63016318529,7,2878,1340,-40
63017123116,63017123121,5,2129,1557,-40
63018645642,63018645649,7,2450,851,-40
63020217953,63020217959,6,2773,884,-40
63021007802,63021007782,-20,2328,1038,-40
63022656417,63022656421,4,2169,1269,-40
63025392594,63025392601,7,3413,1365,-40
63030818942,63030818948,6,3030,1485,-40
63035289793,63035289798,5,1569,985,-40
63037953214,63037953220,6,3355,1430,-40
63039849310,63039849315,5,2760,1325,-40
63042274740,63042274746,6,2684,1018,-40
63042596826,63042596833,7,2986,1559,-40
63044139391,63044139395,4,2233,1525,-40
63048337606,63048337611,5,2708,967,-40
63053183915,63053183922,7,3050,1104,-40
63053690175,63053690155,-20,2012,731,-40
63056585145,63056585152,7,2947,1271,-40
63057224668,63057224682,14,1231,391,-40
63070338773,63070338774,1,57676,66126,-40
63070530718,63070530726,8,3232,983,-40
63070845419,63070845433,14,2078,1151,-40
63073308310,63073308307,-3,1319,2761,-40
63076040625,63076040630,5,1574,1096,-40
63078457653,63078457658,5,2462,1005,-40
63079932061,63079932067,6,3751,1658,-40
63082600650,63082600655,5,2139,1414,-40
63084034086,63084034093,7,2128,1208,-40
63085110527,63085110534,7,3924,1830,-40
63085343606,63085343606,0,1356,1390,-40
63087779731,63087779737,6,3346,1865,-40
63087959109,63087959111,2,2727,1049,-40
63092298147,63092298153,6,2838,1203,-40
63092667644,63092667645,1,927,1295,-40
63095706459,63095706466,7,3164,822,-40
63099468803,63099468810,7,2226,774,-40
63105651309,63105651314,5,1866,958,-40
63110847323,63110847330,7,2393,1048,-40
63111123463,63111123469,6,3299,1795,-40
63111769033,63111769038,5,2880,971,-40
63112526582,63112526586,4,21193,33891,-40
63113228082,63113228091,9,3196,1431,-40
63116967054,63116967061,7,3032,1644,-40
63117085329,63117085334,5,2734,1447,-40
63117442772,63117442778,6,3990,1314,-40
63117597519,63117597507,-12,1216,350,-40
63123091621,63123091626,5,2557,1087,-40
63124631010,63124631018,8,2553,1062,-40
63125580290,63125580291,1,995,110,-40
63127591752,63127591759,7,2844,1132,-40
63128300114,63128300118,4,2568,1146,-40
63130032678,63130032698,20,2514,1392,-40
63130501802,63130501794,-8,2558,43134,-40
63140142444,63140142446,2,866,1433,-40
63141325557,63141325563,6,3200,1325,-40
63142770773,63142770778,5,3118,1515,-40
63144930509,63144930514,5,1559,956,-40
63145902845,63145902851,6,2416,910,-40
63147922006,63147922012,6,3081,1444,-40
63148449293,63148449298,5,2374,1315,-40
63151015290,63151015296,6,3199,1297,-40
63155759217,63155759224,7,2872,1341,-40
63156408026,63156408031,5,2392,806,-40
63158840864,63158840871,7,2644,1265,-40
63161887288,63161887295,7,3044,1449,-40
63164714368,63164714375,7,2991,1429,-40
63167219942,63167219947,5,2541,1306,-40
63168333319,63168333325,6,2494,1262,-40
63170562019,63170562025,6,3616,1456,-40
63171400234,63171400239,5,2459,901,-40
63171728396,63171728403,7,3034,1051,-40
63172653967,63172653956,-11,879,290,-40
63174239341,63174239344,3,2421,1304,-40
63174968070,63174968076,6,3383,1629,-40
63176391650,63176391635,-15,867,486,-40
63180285746,63180285752,6,3709,1394,-40
63186214416,63186214423,7,3044,1260,-40
63186632685,63186632691,6,2219,1368,-40
63186864342,63186864350,8,1359,603,-40
63187195866,63187195874,8,2982,1311,-40
63187301852,63187301836,-16,979,474,-40
63190641830,63190641836,6,3622,1197,-40
63198275030,63198275037,7,3088,1697,-40
63199687871,63199687889,18,814,111,-40
63201264016,63201264023,7,2269,998,-40
63201324793,63201324798,5,1851,971,-40
63204630377,63204630381,4,2808,1347,-40
63208120929,63208120934,5,1855,1237,-40
63209861275,63209861282,7,3055,1334,-40
63210478459,63210478443,-16,1069,330,-40
63212896420,63212896415,-5,142,1022,-40
63213911471,63213911476,5,7253,5214,-40
63214079122,63214079127,5,3430,917,-40
63219680398,63219680402,4,2622,959,-40
63225084210,63225084216,6,3404,1502,-40
63225592002,63225591988,-14,3003,1403,-40
63230874066,63230874069,3,1485,1426,-40
63232380861,63232380867,6,3138,865,-40
63234126115,63234126123,8,3535,1373,-40
63235377181,63235377186,5,2809,1444,-40
63237571302,63237571308,6,3304,1137,-40
63240014850,63240014851,1,1770,845,-40
63240886765,63240886772,7,2894,956,-40
63248884517,63248884522,5,2580,900,-40
63249253446,63249253428,-18,1152,1014,-40
63251566809,63251566815,6,1826,878,-40
63251926554,63251926545,-9,2020,506,-40
63253760531,63253760538,7,2498,951,-40
63258301298,63258301303,5,2541,1323,-40
63259087553,63259087558,5,2069,1602,-40
63265109518,63265109523,5,2867,1486,-40
63265392506,63265392512,6,2666,1495,-40
63267057862,63267057867,5,2993,1395,-40
63269007890,63269007897,7,3221,1340,-40
63270478826,63270478829,3,954,793,-40
63274623685,63274623690,5,2507,1633,-40
63278102603,63278102609,6,2397,1183,-40
63280579677,63280579681,4,3210,1445,-40
63284904497,63284904491,-6,1478,773,-40
63287242706,63287242714,8,1792,992,-40
63288118009,63288118015,6,2585,1190,-40
63288273162,63288273169,7,1437,219,-40
63289055710,63289055726,16,167,3444,-40
63289379510,63289379518,8,5811,1282,-40
63292982833,63292982839,6,2103,992,-40
63298639341,63298639347,6,3101,1563,-40
63301224381,63301224386,5,2323,1017,-40
63303461702,63303461706,4,2009,1827,-40
63306728155,63306728176,21,3057,1141,-40
63308383318,63308383325,7,2344,1063,-40
63308731010,63308731017,7,2572,1155,-40
63313544493,63313544499,6,2346,1099,-40
63318411280,63318411287,7,1777,1067,-40
63322273519,63322273527,8,2221,1186,-40
63323845615,63323845622,7,3097,1702,-40
63333101354,63333101359,5,2819,1294,-40
63334212877,63334212882,5,2912,1681,-40
63337457482,63337457488,6,3181,1574,-40
63340378440,63340378447,7,2711,1306,-40
63340433686,63340433668,-18,975,364,-40
63342786154,63342786159,5,2666,1096,-40
63345661803,63345661798,-5,1241,4138,-40
63347349210,63347349217,7,3135,1261,-40
63347664621,63347664603,-18,1004,570,-40
63351240697,63351240703,6,3267,1055,-40
63352573554,63352573561,7,2563,1171,-40
63352946772,63352946771,-1,1677,1740,-40
63354161093,63354161099,6,2288,1261,-40
63354887802,63354887810,8,9787,2343,-40
63357908378,63357908384,6,3531,1641,-40
63364236248,63364236244,-4,1519,985,-40
63374825795,63374825798,3,2015,1065,-40
63376534565,63376534571,6,2551,1250,-40
63377242806,63377242811,5,2078,1531,-40
63379145431,63379145426,-5,1412,3505,-40
63380677414,63380677422,8,3191,1008,-40
63381341695,63381341713,18,883,573,-40
63385057602,63385057618,16,1285,262,-40
63387934207,63387934214,7,3723,1071,-40
63398242285,63398242291,6,3480,1138,-40
63399088313,63399088320,7,2974,1460,-40
63400930674,63400930679,5,2223,1589,-40
63412201158,63412201164,6,2576,1286,-40
63412760348,63412760340,-8,737,192,-40
63416787597,63416787603,6,1893,1043,-40
63417468161,63417468167,6,2258,1033,-40
63422371338,63422371342,4,1909,1072,-40
63424490164,63424490172,8,3047,1263,-40
63427265363,63427265377,14,789,178,-40
63428377842,63428377846,4,2259,1974,-40
63434343401,63434343406,5,2874,1123,-40
63435792830,63435792848,18,3063,1329,-40
63439769926,63439769926,0,1162,1254,-40
63440895279,63440895285,6,2759,1342,-40
63443166467,63443166475,8,4149,1918,-40
63454122274,63454122281,7,3239,1712,-40
63456430019,63456430025,6,3447,1220,-40
63456512054,63456512035,-19,2134,1146,-40
63458745110,63458745114,4,2856,966,-40
63460634249,63460634255,6,2236,1336,-40
63460887645,63460887651,6,3162,1346,-40
63462815622,63462815627,5,1857,901,-40
63468004372,63468004367,-5,52499,19385,-40
63468749070,63468749067,-3,2454,4772,-40
63471943573,63471943578,5,1391,972,-40
63474536862,63474536870,8,2376,1255,-40
63476990755,63476990760,5,2906,1530,-40
63478253254,63478253259,5,2818,1221,-40
63480475325,63480475332,7,3880,1624,-40
63483600341,63483600346,5,3570,1614,-40
63485422381,63485422390,9,3031,1038,-40
63486082253,63486082258,5,4169,1430,-40
63486226595,63486226589,-6,1368,5255,-40
63490690646,63490690651,5,2927,1136,-40
63495992485,63495992491,6,2369,1245,-40
63496552630,63496552637,7,3265,1455,-40
63501144820,63501144826,6,3094,1530,-40
63501433503,63501433510,7,3591,1351,-40
63509199213,63509199219,6,2305,1238,-40
63511478222,63511478229,7,3416,1430,-40
63511875230,63511875237,7,3504,1307,-40
63515449800,63515449806,6,2868,1477,-40
63520273099,63520273105,6,2505,1283,-40
63520983781,63520983787,6,3219,1456,-40
63523949108,63523949113,5,3101,1328,-40
63524251874,63524251879,5,2942,1335,-40
63527204790,63527204796,6,4250,1687,-40
63534121163,63534121170,7,2472,1140,-40
63536039990,63536039994,4,1687,1405,-40
63537221154,63537221154,0,889,429,-40
63540336197,63540336211,14,15042,45036,-40
63541118702,63541118706,4,2250,1081,-40
63547407710,63547407714,4,3045,1441,-40
63547477694,63547477673,-21,2435,1167,-40
63547708988,63547708997,9,2593,1101,-40
63558120369,63558120375,6,1927,1138,-40
63562958517,63562958522,5,3080,1537,-40
63563200893,63563200898,5,1882,936,-40
63563614166,63563614152,-14,1752,878,-40
63567754530,63567754534,4,2028,1491,-40
63568654983,63568654990,7,4072,1556,-40
63570220330,63570220338,8,2175,1291,-40
63571464469,63571464474,5,2055,1285,-40
63572171037,63572171042,5,3285,1119,-40
63573442090,63573442097,7,3315,1753,-40
63573658188,63573658194,6,2683,1342,-40
63573991018,63573991001,-17,2276,1285,-40
63574352667,63574352673,6,3129,1211,-40
63575445295,63575445274,-21,2645,836,-40
63577899953,63577899948,-5,4257,10455,-40
63579019818,63579019827,9,7361,1277,-40
63580260434,63580260435,1,1428,2029,-40
63583192109,63583192115,6,3381,1133,-40
63597394786,63597394795,9,2361,1292,-40
63599331317,63599331323,6,4628,2245,-40
63599450393,63599450399,6,3044,1607,-40
63600353426,63600353430,4,2495,788,-40
63608626324,63608626330,6,3160,1399,-40
63609586433,63609586440,7,3646,1819,-40
63611127490,63611127497,7,4005,1598,-40
63611425724,63611425730,6,2614,1171,-40
63612446637,63612446619,-18,1717,737,-40
63614235770,63614235777,7,4306,2151,-40
63622075094,63622075103,9,3938,1183,-40
63625358069,63625358075,6,2216,1082,-40
63627714709,63627714715,6,3543,986,-40
63627937824,63627937840,16,2673,1169,-40
63629947032,63629947037,5,2426,1374,-40
63631369982,63631369986,4,2478,1260,-40
63633157315,63633157315,0,1161,1554,-40
63640471670,63640471675,5,2147,984,-40
63642331780,63642331786,6,1355,860,-40
63643902072,63643902080,8,3287,1324,-40
63644034414,63644034414,0,1170,1499,-40
63648629465,63648629472,7,3198,1164,-40
63653540387,63653540394,7,3817,1560,-40
63653630359,63653630356,-3,1369,2358,-40
63656055369,63656055375,6,3138,1663,-40
63664653766,63664653771,5,2849,1203,-40
63664744098,63664744102,4,1772,978,-40
63666444532,63666444538,6,2209,1209,-40
63672657397,63672657405,8,1704,919,-40
63672925801,63672925806,5,1781,922,-40
63675071099,63675071108,9,3664,1250,-40
63678770882,63678770890,8,3139,1274,-40
63678832303,63678832307,4,1083,516,-40
63681011701,63681011707,6,2134,1299,-40
63682604668,63682604690,22,2075,1102,-40
63686138111,63686138117,6,2812,1253,-40
63688393810,63688393816,6,2348,1077,-40
63699494468,63699494474,6,2615,1388,-40
63705864462,63705864482,20,428,2551,-40
63706163021,63706163027,6,2307,1030,-40
63708728193,63708728197,4,1348,896,-40
63709808107,63709808113,6,3364,1225,-40
63710413018,63710413022,4,3506,1412,-40
63711004090,63711004094,4,2307,1114,-40
63711398834,63711398818,-16,2587,1360,-40
63712181218,63712181218,0,925,1088,-40
63713456865,63713456870,5,3377,1497,-40
63714730538,63714730547,9,3729,1373,-40
63719292067,63719292066,-1,1403,1635,-40
63722413855,63722413862,7,1269,1057,-40
63724965826,63724965834,8,2192,987,-40
63725936322,63725936322,0,801,860,-40
63730527552,63730527558,6,4237,1451,-40
63733524378,63733524385,7,3263,1550,-40
63740208482,63740208490,8,3745,1606,-40
63743826786,63743826786,0,1667,2370,-40
63744042722,63744042729,7,7706,3176,-40
63747560631,63747560625,-6,1162,5222,-40
63754386321,63754386327,6,3355,1100,-40
63755336767,63755336774,7,3367,1056,-40
63756776239,63756776243,4,1745,874,-40
63758008609,63758008616,7,4835,1512,-40
63763055652,63763055658,6,2984,1096,-40
63763144898,63763144913,15,2971,1087,-40
63765827574,63765827577,3,15160,55010,-40
63766546110,63766546114,4,2706,1611,-40
63769273142,63769273149,7,2819,1382,-40
63769591937,63769591943,6,2782,1281,-40
63774795293,63774795293,0,24224,17553,-40
63777343531,63777343538,7,2463,858,-40
63785360040,63785360047,7,3052,1705,-40
63787246531,63787246538,7,3023,1356,-40
63787331279,63787331283,4,635,286,-40
63790174236,63790174242,6,2188,1262,-40
63792475745,63792475748,3,1458,1321,-40
63797093449,63797093454,5,2824,958,-40
63797603478,63797603481,3,2093,1701,-40
63799524335,63799524342,7,2278,1162,-40
63806347935,63806347941,6,2053,801,-40
63806693097,63806693103,6,2001,1155,-40
63806812213,63806812219,6,2502,757,-40
63806912854,63806912858,4,31560,27775,-40
63810494461,63810494456,-5,1102,2034,-40
63816144473,63816144475,2,1842,1319,-40
63820432715,63820432726,11,3849,59362,-40
63822126317,63822126322,5,2960,955,-40
63824901392,63824901397,5,2557,1087,-40
63833614853,63833614859,6,2608,1097,-40
63837562666,63837562670,4,1843,1548,-40
63842516156,63842516163,7,2444,1054,-40
63843871341,63843871346,5,2240,1141,-40
63844170130,63844170139,9,1218,1012,-40
63844589841,63844589825,-16,2712,1065,-40
63846615394,63846615402,8,4013,1090,-40
63846948382,63846948384,2,1825,2334,-40
63847188237,63847188242,5,2944,901,-40
63849847265,63849847271,6,1884,877,-40
63850738062,63850738067,5,1280,764,-40
63850769703,63850769720,17,548,1490,-40
63852375741,63852375732,-9,1110,113,-40
63852518959,63852518944,-15,837,347,-40
63852961010,63852961017,7,2120,1186,-40
63853835691,63853835687,-4,1081,2343,-40
63856833246,63856833253,7,1737,702,-40
63856980374,63856980393,19,2338,1229,-40
63858068582,63858068588,6,2369,1460,-40
63861619629,63861619635,6,3774,1608,-40
63864469866,63864469874,8,3496,1563,-40
63864724795,63864724778,-17,1718,850,-40
63869291060,63869291061,1,5870,24965,-40
63869885338,63869885342,4,2516,1089,-40
63875279177,63875279183,6,3376,1557,-40
63877017758,63877017764,6,3230,1476,-40
63882282718,63882282726,8,2754,1047,-40
63886266971,63886266965,-6,1328,6162,-40
63890222954,63890222961,7,2657,1253,-40
63890918859,63890918841,-18,885,418,-40
63894304528,63894304534,6,1708,955,-40
63899313561,63899313567,6,2647,1531,-40
63901223642,63901223645,3,1841,1751,-40
63903104202,63903104210,8,1966,873,-40
63904361278,63904361283,5,1791,1265,-40
63904569786,63904569791,5,3385,1071,-40
63914452907,63914452913,6,1933,1355,-40
63915235910,63915235912,2,1135,324,-40
63916538453,63916538454,1,1640,1449,-40
63921392397,63921392403,6,2862,1060,-40
63921868387,63921868392,5,503,372,-40
63923710571,63923710579,8,3987,1513,-40
63925698922,63925698928,6,2859,1118,-40
63926504001,63926504008,7,2647,1416,-40
63934212351,63934212358,7,2462,1112,-40
63934519551,63934519529,-22,2233,686,-40
63935920960,63935920957,-3,1974,3772,-40
63938496996,63938496978,-18,964,161,-40
63939144641,63939144646,5,3956,1412,-40
63940549943,63940549950,7,2580,1365,-40
63944559421,63944559423,2,2199,1220,-40
63950627689,63950627696,7,2486,1043,-40
63951131956,63951131963,7,2414,1104,-40
63952481697,63952481703,6,2550,1070,-40
63954423577,63954423582,5,2269,1199,-40
63954804134,63954804138,4,3455,1695,-40
63956264688,63956264694,6,4421,1496,-40
63968704485,63968704492,7,2258,1210,-40
63969975082,63969975087,5,2414,1383,-40
63972508272,63972508277,5,1241,529,-40
63974928737,63974928743,6,3046,828,-40
63977857796,63977857801,5,3352,1397,-40
63983033802,63983033808,6,2847,1508,-40
63992324018,63992324010,-8,1443,8060,-40
63993009415,63993009402,-13,1060,258,-40
63997027776,63997027783,7,2982,1462,-40
63999290927,63999290934,7,2860,1277,-40
64000722942,64000722950,8,2890,1157,-40
64001581513,64001581496,-17,3824,1225,-40
64005704352,64005704356,4,2001,992,-40
64009494749,64009494733,-16,925,412,-40
64011663450,64011663456,6,2372,1489,-40
64015693797,64015693803,6,3651,1387,-40
64023689711,64023689710,-1,2602,4359,-40
64033353029,64033353034,5,1990,1229,-40
64038526882,64038526888,6,3555,1498,-40
64040218569,64040218575,6,2344,1517,-40
64041177597,64041177605,8,3431,1653,-40
64041768705,64041768711,6,3344,1668,-40
64043080979,64043080987,8,2803,1718,-40
64044369426,64044369431,5,2751,1174,-40
64049708391,64049708397,6,2925,1112,-40
64070291850,64070291835,-15,1761,938,-40
64072281851,64072281851,0,1044,1497,-40
64076475699,64076475705,6,2251,1009,-40
64076596318,64076596321,3,2369,1033,-40
64079645786,64079645789,3,3403,1276,-40
64081681561,64081681566,5,2975,1632,-40
64082094921,64082094927,6,4188,1043,-40
64088812962,64088812968,6,2736,1644,-40
64089113350,64089113357,7,2626,1402,-40
64091144134,64091144140,6,2054,1218,-40
64092703972,64092703977,5,1469,715,-40
64097839593,64097839598,5,2624,1246,-40
64105443241,64105443242,1,1705,1448,-40
64108120965,64108120972,7,2688,1163,-40
64116896941,64116896947,6,3254,1476,-40
64118057526,64118057512,-14,2115,746,-40
64118399610,64118399605,-5,1546,5721,-40
64118732278,64118732285,7,2501,1511,-40
64123661263,64123661271,8,3220,1160,-40
64125470353,64125470352,-1,750,375,-40
64131207350,64131207357,7,2093,1140,-40
64133283078,64133283084,6,2123,1068,-40
64136209794,64136209799,5,1232,732,-40
64136360219,64136360201,-18,1726,519,-40
64136841447,64136841451,4,2885,894,-40
64137264859,64137264866,7,4185,1231,-40
64139388454,64139388462,8,3181,1746,-40
64142638993,64142638999,6,2991,1573,-40
64148019264,64148019270,6,3354,1343,-40
64149941466,64149941471,5,2505,886,-40
64152880789,64152880792,3,2301,1835,-40
64153351122,64153351121,-1,1388,2306,-40
64153942814,64153942819,5,2318,1289,-40
64154371662,64154371670,8,2494,872,-40
64154712778,64154712786,8,3016,1393,-40
64160224507,64160224514,7,2687,1491,-40
64162080625,64162080629,4,3210,2266,-40
64163259129,64163259134,5,2643,1658,-40
64166005022,64166005027,5,1896,837,-40
64168753234,64168753238,4,3376,1135,-40
64169367537,64169367544,7,1993,711,-40
64171443319,64171443325,6,2225,1079,-40
64172857221,64172857226,5,2589,868,-40
64174203282,64174203286,4,2140,1426,-40
64175600716,64175600725,9,2767,976,-40
64185082712,64185082718,6,3437,1426,-40
64195573431,64195573438,7,3154,1501,-40
64198246329,64198246338,9,2530,1360,-40
64198328434,64198328441,7,2724,1147,-40
64198456644,64198456627,-17,2542,1506,-40
64200101657,64200101665,8,3801,1647,-40
64200207308,64200207302,-6,1335,5337,-40
64200873458,64200873466,8,3086,1331,-40
64204220017,64204220020,3,3143,2185,-40
64204414849,64204414856,7,1921,1396,-40
64205292742,64205292749,7,4411,1945,-40
64208167308,64208167315,7,2603,1124,-40
64208315910,64208315899,-11,820,149,-40
64210345266,64210345271,5,2501,1123,-40
64211916117,64211916113,-4,1510,4599,-40
64212540417,64212540422,5,2894,1362,-40
64213142309,64213142313,4,2875,2205,-40
64216246015,64216246021,6,3192,1321,-40
64216660977,64216660984,7,3004,1312,-40
64218234083,64218234089,6,3414,1361,-40
64219724339,64219724346,7,3098,1388,-40
64220225290,64220225294,4,2979,2034,-40
64220455578,64220455569,-9,852,204,-40
64223816859,64223816863,4,2490,1035,-40
64223850967,64223850975,8,3855,751,-40
64232401729,64232401734,5,2540,999,-40
64235036663,64235036668,5,2149,1545,-40
64235788616,64235788614,-2,1182,2379,-40
64239794250,64239794256,6,1893,1044,-40
64242618182,64242618189,7,4229,1268,-40
64243044659,64243044666,7,3060,1282,-40
64243503718,64243503727,9,10004,41057,-40
64244381505,64244381510,5,3052,1323,-40
64247980162,64247980169,7,3742,1340,-40
64248849248,64248849253,5,2487,913,-40
64249190479,64249190458,-21,3019,791,-40
64265143951,64265143950,-1,892,1031,-40
64266805829,64266805835,6,2215,888,-40
64268909618,64268909601,-17,3754,1588,-40
64270969816,64270969823,7,8379,1638,-40
64271392370,64271392375,5,1993,1088,-40
64272122608,64272122614,6,2770,1077,-40
64272550958,64272550939,-19,2015,719,-40
64273966298,64273966302,4,3486,1003,-40
64275636694,64275636679,-15,20933,28163,-40
64290312953,64290312958,5,3676,1614,-40
64290807133,64290807138,5,2048,1090,-40
64291075898,64291075912,14,2804,1578,-40
64293606882,64293606892,10,13756,32895,-40
64310885750,64310885755,5,2921,1212,-40
64317305897,64317305903,6,3531,984,-40
64317919388,64317919395,7,3083,1057,-40
64318063339,64318063324,-15,1438,226,-40
64318567446,64318567435,-11,1079,483,-40
64319373240,64319373246,6,2374,1070,-40
64319925362,64319925366,4,2692,1375,-40
64323100986,64323100993,7,2937,1666,-40
64330593212,64330593218,6,3919,1334,-40
64331162011,64331161996,-15,905,266,-40
64335917357,64335917363,6,3952,1208,-40
64337285614,64337285621,7,2514,1481,-40
64338000010,64338000017,7,3364,1219,-40
64339252374,64339252380,6,2963,1194,-40
64343080157,64343080164,7,2398,1513,-40
64345160174,64345160183,9,1873,1253,-40
64350238558,64350238565,7,3873,1505,-40
64352330194,64352330200,6,2910,1495,-40
64357434261,64357434254,-7,957,4555,-40
64358524709,64358524717,8,3552,1298,-40
64358574613,64358574618,5,1948,1088,-40
64361272185,64361272189,4,4072,1746,-40
64365643518,64365643513,-5,847,2149,-40
64372081477,64372081482,5,3273,1558,-40
64381390643,64381390651,8,2803,931,-40
64383402630,64383402637,7,2936,1678,-40
64387089846,64387089853,7,2825,1460,-40
64389723988,64389723989,1,1452,2443,-40
64390634542,64390634547,5,2128,819,-40
64390829788,64390829787,-1,942,166,-40
64391061414,64391061419,5,2966,1172,-40
64391791855,64391791861,6,2526,1132,-40
64392524486,64392524490,4,2242,1256,-40
64393345537,64393345544,7,2304,1664,-40
64398239882,64398239889,7,2661,1424,-40
64402142190,64402142193,3,3231,1154,-40
64402216790,64402216797,7,3460,1433,-40
64402643911,64402643920,9,3037,900,-40
64403067046,64403067054,8,3049,1128,-40
64404928647,64404928655,8,4014,1355,-40
64405809843,64405809843,0,1242,1357,-40
64418590275,64418590282,7,3375,1244,-40
64422579671,64422579678,7,3487,1385,-40
64422827953,64422827960,7,2306,1496,-40
64429937594,64429937601,7,5226,2011,-40
64431687072,64431687066,-6,1752,4102,-40
64431741446,64431741441,-5,1089,2841,-40
64432536839,64432536846,7,3461,1428,-40
64433651994,64433651998,4,2953,1303,-40
64439563852,64439563846,-6,1086,2182,-40
64441938942,64441938922,-20,4091,1368,-40
64443429511,64443429518,7,2428,1394,-40
64450108058,64450108066,8,2493,1290,-40
64455885082,64455885079,-3,3100,5232,-40
64456321214,64456321219,5,3180,1212,-40
64460533065,64460533072,7,2669,1384,-40
64460648598,64460648584,-14,844,172,-40
64470272219,64470272225,6,3816,1461,-40
64474106403,64474106408,5,3766,1244,-40
64481096413,64481096419,6,2790,1280,-40
64482282130,64482282129,-1,1213,2633,-40
64494385265,64494385267,2,1852,1036,-40
64496889128,64496889133,5,3088,1094,-40
64497182726,64497182731,5,3107,1033,-40
64501640533,64501640539,6,2632,1115,-40
64505483050,64505483055,5,3591,1311,-40
64520194391,64520194397,6,2987,1533,-40
64520703134,64520703121,-13,396,24,-40
64522935107,64522935113,6,3092,1624,-40
64529605697,64529605703,6,2961,1423,-40
64530397791,64530397798,7,2252,1128,-40
64532206654,64532206659,5,2160,1899,-40
64533019645,64533019647,2,2215,2429,-40
64535926725,64535926732,7,3689,2248,-40
64536839611,64536839619,8,2970,1274,-40
64538044714,64538044720,6,2896,1353,-40
64555412454,64555412463,9,3673,1116,-40
64563038129,64563038134,5,3160,1294,-40
64564481744,64564481750,6,2383,1253,-40
64564612074,64564612092,18,2681,1239,-40
64565041493,64565041472,-21,3288,1146,-40
64566285151,64566285158,7,2696,1582,-40
64566573105,64566573110,5,2797,1282,-40
64571992447,64571992447,0,997,2042,-40
64575753345,64575753342,-3,1708,2188,-40
64577006148,64577006156,8,2468,1045,-40
64579365721,64579365727,6,2642,1490,-40
64579517534,64579517539,5,2269,943,-40
64580214202,64580214184,-18,2876,1258,-40
64585684854,64585684861,7,2132,1325,-40
64589202942,64589202952,10,11463,48336,-40
64592301093,64592301100,7,2825,1280,-40
64596264858,64596264862,4,1810,1102,-40
64604340866,64604340870,4,1814,1053,-40
64608580977,64608580983,6,2484,1620,-40
64609831815,64609831821,6,2873,1297,-40
64610933505,64610933492,-13,2167,1113,-40
64611312107,64611312102,-5,912,1598,-40
64613732559,64613732565,6,3545,1478,-40
64618454525,64618454530,5,2795,1761,-40
64620131753,64620131748,-5,37444,6863,-40
64624530255,64624530250,-5,1537,2168,-40
64625308234,64625308240,6,2139,1176,-40
64633454580,64633454586,6,2979,1529,-40
64633552250,64633552257,7,3237,1306,-40
64633845050,64633845036,-14,2399,806,-40
64644262821,64644262827,6,2214,1154,-40
64645047965,64645047970,5,2574,1019,-40
64645376693,64645376698,5,1295,289,-40
64646147895,64646147902,7,3350,1181,-40
64646343495,64646343473,-22,8580,9265,-40
64647951711,64647951718,7,1982,1195,-40
64649452533,64649452538,5,1202,970,-40
64652489381,64652489389,8,2780,1262,-40
64654849032,64654849039,7,2816,879,-40
64657970257,64657970259,2,1396,1753,-40
64659357845,64659357851,6,4491,1283,-40
64660529261,64660529262,1,1447,1683,-40
64660624098,64660624094,-4,1150,2167,-40
64664470711,64664470717,6,2430,1360,-40
64665478157,64665478164,7,2968,988,-40
64666500626,64666500632,6,2731,1357,-40
64667560528,64667560545,17,298,2050,-40
64668054688,64668054693,5,2670,1250,-40
64668197174,64668197169,-5,227,987,-40
64671762762,64671762766,4,3078,1301,-40
64672117809,64672117814,5,4276,1869,-40
64672174867,64672174874,7,3651,1384,-40
64672310332,64672310352,20,2987,1123,-40
64672997163,64672997169,6,2189,1040,-40
64679470917,64679470923,6,3325,1143,-40
64682378425,64682378425,0,3413,3890,-40
64686223917,64686223924,7,2434,1471,-40
64686509225,64686509209,-16,2600,785,-40
64709589986,64709589993,7,2722,1179,-40
64711066150,64711066157,7,3119,1301,-40
64712032634,64712032640,6,2253,1435,-40
64718657089,64718657097,8,4236,1169,-40
64727131097,64727131104,7,2868,1204,-40
64727746213,64727746218,5,1610,867,-40
64733669263,64733669270,7,2744,1118,-40
64735128289,64735128295,6,2946,1330,-40
64742469934,64742469941,7,3486,1455,-40
64743211421,64743211427,6,2394,945,-40
64743603865,64743603849,-16,2916,1722,-40
64745931998,64745932004,6,3598,2037,-40
64751666866,64751666872,6,3465,1325,-40
64752957671,64752957664,-7,949,262,-40
64761659670,64761659678,8,1831,838,-40
64762397979,64762397987,8,2093,800,-40
64762489468,64762489449,-19,2793,1373,-40
64763201442,64763201427,-15,1181,167,-40
64766701574,64766701577,3,1368,1036,-40
64770559945,64770559950,5,3259,2416,-40
64775126340,64775126346,6,2269,1108,-40
64775927409,64775927415,6,2380,1013,-40
64777909781,64777909760,-21,1048,155,-40
64781886834,64781886841,7,3296,1841,-40
64793681146,64793681153,7,2947,1415,-40
64796584745,64796584752,7,3269,1158,-40
64798336990,64798336997,7,2817,1541,-40
64802552970,64802552974,4,1790,1962,-40
64809871453,64809871458,5,2316,865,-40
64810490687,64810490684,-3,1461,234,-40
64810806244,64810806250,6,2343,1453,-40
64812961269,64812961278,9,2980,1236,-40
64814657902,64814657909,7,2976,1334,-40
64824313414,64824313435,21,1206,372,-40
64828404734,64828404738,4,2427,1130,-40
64833167121,64833167127,6,2447,1183,-40
64836019276,64836019282,6,2653,1784,-40
64837578470,64837578475,5,2841,1394,-40
64861684812,64861684819,7,3255,1211,-40
64861932486,64861932476,-10,1404,795,-40
64862019977,64862019983,6,2481,876,-40
64862336385,64862336371,-14,2164,929,-40
64866689622,64866689627,5,2140,1446,-40
64873033153,64873033159,6,2182,1326,-40
64874207944,64874207950,6,2567,987,-40
64878615111,64878615109,-2,1332,2394,-40
64878650997,64878651003,6,2432,1339,-40
64882858942,64882858950,8,3668,1371,-40
64884128392,64884128398,6,3352,1085,-40
64884699877,64884699880,3,1715,1048,-40
64885142412,64885142416,4,2468,1070,-40
64885200759,64885200768,9,3481,1361,-40
64885823848,64885823854,6,2902,1089,-40
64886936967,64886936966,-1,1048,2039,-40
64887042865,64887042870,5,2528,876,-40
64891227547,64891227553,6,2851,1794,-40
64891433783,64891433790,7,2534,1658,-40
64910918710,64910918719,9,3531,1233,-40
64911470792,64911470798,6,2465,1170,-40
64914400215,64914400218,3,1286,1032,-40
64914485268,64914485248,-20,1963,787,-40
64915124984,64915124969,-15,147,1032,-40
64927881498,64927881505,7,2896,1030,-40
64935102424,64935102425,1,1704,1014,-40
64938346612,64938346619,7,2903,1612,-40
64939271150,64939271157,7,3764,1856,-40
64942274777,64942274783,6,3209,1315,-40
64945327305,64945327307,2,1578,25227,-40
64945950480,64945950487,7,2103,1119,-40
64948034960,64948034965,5,3638,1754,-40
64950647217,64950647196,-21,3025,1445,-40
64954214532,64954214539,7,2679,1336,-40
64955889702,64955889707,5,2735,1455,-40
64956335711,64956335717,6,3551,1426,-40
64957386743,64957386750,7,3244,1096,-40
64960871461,64960871466,5,2900,1911,-40
64969082603,64969082610,7,1906,1216,-40
64969139372,64969139379,7,3027,1205,-40
64971848430,64971848435,5,2673,1104,-40
64973661335,64973661341,6,1877,1289,-40
64975379285,64975379290,5,3569,1257,-40
64988485261,64988485267,6,2393,1169,-40
64989049475,64989049482,7,1785,657,-40
64989780998,64989781005,7,2901,1468,-40
64993368166,64993368171,5,2821,1293,-40
64994275942,64994275921,-21,947,275,-40
64994693417,64994693423,6,1903,1125,-40
64999248682,64999248689,7,1959,965,-40
65002126071,65002126079,8,3118,1686,-40
65003718845,65003718847,2,1934,1887,-40
65004994674,65004994681,7,4180,1523,-40
65007219254,65007219261,7,2013,1093,-40
65009234387,65009234392,5,3542,1625,-40
65010197278,65010197287,9,3379,1376,-40
65018351470,65018351474,4,2546,1431,-40
65021032610,65021032617,7,2770,994,-40
65026958311,65026958320,9,1764,851,-40
65032579129,65032579135,6,1903,1048,-40
65039031389,65039031395,6,2948,1174,-40
65043068633,65043068639,6,3171,863,-40
65044063874,65044063889,15,2182,918,-40
65047409359,65047409340,-19,1130,450,-40
65049151324,65049151332,8,3175,1301,-40
65051345879,65051345891,12,14613,33669,-40
65053868970,65053868969,-1,1266,1448,-40
65053915201,65053915207,6,2914,1247,-40
65055735174,65055735170,-4,1183,1923,-40
65059262202,65059262207,5,2105,1068,-40
65066038086,65066038089,3,4812,3461,-40
65070478383,65070478390,7,3492,1711,-40
65079118094,65079118099,5,3098,1208,-40
65083099142,65083099148,6,3384,1149,-40
65085952841,65085952846,5,1590,671,-40
65087732062,65087732070,8,3462,1041,-40
65088185288,65088185293,5,2354,1047,-40
65095217421,65095217405,-16,2867,877,-40
65097511802,65097511807,5,2414,1347,-40
65098473548,65098473555,7,2703,923,-40
65098696654,65098696633,-21,2703,1478,-40
65101981208,65101981214,6,3420,1487,-40
65102398877,65102398884,7,3961,1905,-40
65108940014,65108940019,5,1536,1013,-40
65111144050,65111144056,6,3158,1460,-40
65113250299,65113250302,3,1322,1326,-40
65115670979,65115670985,6,2840,1014,-40
65116673771,65116673777,6,489,94,-40
65117051485,65117051493,8,2087,1055,-40
65119384682,65119384688,6,3437,1516,-40
65120562254,65120562262,8,4543,971,-40
65121622139,65121622124,-15,1570,923,-40
65125339886,65125339891,5,3286,1475,-40
65133910369,65133910362,-7,1553,8851,-40
65134683324,65134683330,6,3614,1356,-40
65135256153,65135256138,-15,2260,809,-40
65137540995,65137541003,8,1493,807,-40
65141030542,65141030549,7,3546,1505,-40
65141622477,65141622483,6,2935,728,-40
65142680011,65142680018,7,2533,1527,-40
65152527557,65152527562,5,1979,748,-40
65162631015,65162631022,7,3253,1131,-40
65163041306,65163041311,5,2342,975,-40
65165379852,65165379861,9,2866,971,-40
65166440667,65166440667,0,2201,3296,-40
65167103979,65167103986,7,3333,1412,-40
65177997233,65177997239,6,3905,1245,-40
65179883439,65179883446,7,2587,1121,-40
65179938665,65179938671,6,4513,1276,-40
65181078665,65181078671,6,3418,1467,-40
65181466333,65181466338,5,3228,1341,-40
65182088799,65182088777,-22,727,469,-40
65184876637,65184876638,1,1187,1271,-40
65185012619,65185012626,7,3549,1906,-40
65189179305,65189179311,6,2506,1412,-40
65189508816,65189508802,-14,940,241,-40
65191903722,65191903727,5,1997,877,-40
65194735728,65194735750,22,980,2227,-40
65200820524,65200820530,6,2738,1578,-40
65207280003,65207280009,6,2968,1555,-40
65207534983,65207534961,-22,2137,798,-40
65219680014,65219680022,8,3019,1253,-40
65219899606,65219899613,7,2395,1275,-40
65219962151,65219962130,-21,878,379,-40
65220133273,65220133279,6,2732,1318,-40
65225733404,65225733405,1,816,717,-40
65234503876,65234503883,7,7640,1103,-40
65235170137,65235170120,-17,1732,727,-40
65235786244,65235786250,6,3186,1384,-40
65241713565,65241713572,7,2510,1392,-40
65242006894,65242006875,-19,1343,1570,-40
65242534522,65242534530,8,2970,1265,-40
65251884937,65251884943,6,2999,1381,-40
65260797447,65260797454,7,2975,1254,-40
65261011757,65261011763,6,3032,1519,-40
65263637095,65263637101,6,2983,1210,-40
65264095517,65264095524,7,2307,1638,-40
65270190897,65270190900,3,1890,1818,-40
65279784378,65279784385,7,2959,1152,-40
65281192869,65281192875,6,2374,1237,-40
65282579114,65282579118,4,2598,1105,-40
65284539767,65284539769,2,770,143,-40
65288596558,65288596565,7,2377,986,-40
65289273809,65289273815,6,2667,1305,-40
65289299237,65289299237,0,1745,1371,-40
65292651478,65292651484,6,2428,1185,-40
65293065294,65293065314,20,3319,1128,-40
65293124572,65293124579,7,3023,1417,-40
65297637316,65297637321,5,2808,1372,-40
65300819812,65300819817,5,2367,1110,-40
65304220909,65304220917,8,2543,1159,-40
65304623601,65304623607,6,3996,1102,-40
65304867393,65304867398,5,3456,1245,-40
65305916923,65305916928,5,2213,1428,-40
65308454793,65308454799,6,2543,1089,-40
65310234846,65310234845,-1,1181,1832,-40
65315875433,65315875442,9,1872,694,-40
65316118686,65316118692,6,1493,690,-40
65316587278,65316587292,14,790,233,-40
65324547859,65324547866,7,2839,890,-40
65326302075,65326302081,6,4054,1926,-40
65326386958,65326386964,6,3268,1562,-40
65326830486,65326830493,7,2200,1642,-40
65328386306,65328386294,-12,1267,2177,-40
65332188932,65332188936,4,2085,1147,-40
65332479486,65332479493,7,2289,1046,-40
65332686485,65332686489,4,3153,1452,-40
65332829923,65332829926,3,12622,11883,-40
65333152662,65333152650,-12,3515,1180,-40
65335928314,65335928319,5,2649,1205,-40
65337310905,65337310911,6,2706,1387,-40
65341527073,65341527082,9,5699,1859,-40
65345493365,65345493370,5,2350,1084,-40
65351758342,65351758332,-10,1203,338,-40
65351990193,65351990199,6,2175,1218,-40
65354140575,65354140583,8,3295,1306,-40
65358640138,65358640141,3,2818,1535,-40
65359815610,65359815618,8,4107,1562,-40
65366963224,65366963231,7,2010,1067,-40
65367087048,65367087054,6,2704,1502,-40
65369082788,65369082794,6,3064,1328,-40
65369409301,65369409306,5,2452,1242,-40
65376009044,65376009049,5,2934,1576,-40
65376707482,65376707473,-9,811,62,-40
65377855417,65377855423,6,2588,1286,-40
65382973569,65382973574,5,2332,1162,-40
65385342457,65385342462,5,2994,1184,-40
65386090306,65386090286,-20,2640,1290,-40
65392656985,65392657003,18,2815,1112,-40
65394639414,65394639420,6,2468,1467,-40
65396621946,65396621951,5,2602,1164,-40
65398182490,65398182494,4,2004,1612,-40
65400699307,65400699314,7,4175,1230,-40
65409351806,65409351803,-3,1084,2128,-40
65423147821,65423147824,3,2081,1592,-40
65424843445,65424843450,5,2741,1605,-40
65431653968,65431653973,5,2441,911,-40
65437382173,65437382178,5,2539,1026,-40
65438197115,65438197122,7,5559,952,-40
65451994109,65451994115,6,1423,846,-40
65455015338,65455015345,7,3017,1174,-40
65456842461,65456842467,6,2216,1056,-40
65457266611,65457266618,7,4321,1710,-40
65459676716,65459676723,7,2977,1286,-40
65460357290,65460357287,-3,818,140,-40
65463391402,65463391410,8,2338,1047,-40
65470324998,65470325004,6,3487,1638,-40
65472306894,65472306898,4,5125,2546,-40
65480314670,65480314677,7,2996,1916,-40
65487573326,65487573333,7,18982,48986,-40
65489604544,65489604549,5,3648,1857,-40
65496978225,65496978230,5,3671,1447,-40
65500163666,65500163674,8,1651,1060,-40
65501026194,65501026199,5,2320,1179,-40
65501451127,65501451121,-6,1375,4390,-40
65501905286,65501905285,-1,2060,1984,-40
65502097517,65502097524,7,3130,1608,-40
65504813577,65504813583,6,2647,1112,-40
65506828044,65506828067,23,2045,933,-40
65507488550,65507488556,6,3128,1539,-40
65509520334,65509520331,-3,439,963,-40
65512059561,65512059566,5,2077,1101,-40
65515845139,65515845146,7,3278,1403,-40
65518237848,65518237852,4,3456,2948,-40
65524090534,65524090543,9,2798,1411,-40
65525701522,65525701527,5,2129,968,-40
65531024541,65531024546,5,1544,602,-40
65539317799,65539317804,5,2026,893,-40
65539433795,65539433801,6,2833,737,-40
65539720015,65539720016,1,1117,1584,-40
65540011399,65540011403,4,1755,1299,-40
65541501254,65541501258,4,1985,1355,-40
65543665511,65543665517,6,2345,1465,-40
65545146735,65545146742,7,4310,1523,-40
65547256012,65547256019,7,2012,1349,-40
65548745413,65548745419,6,2343,1018,-40
65549963400,65549963406,6,2474,1468,-40
65552382205,65552382210,5,2823,1289,-40
65552645418,65552645428,10,3460,1037,-40
65553045719,65553045726,7,3534,1593,-40
65553132359,65553132338,-21,3519,1529,-40
65554556861,65554556866,5,2158,1319,-40
65554693702,65554693691,-11,1175,263,-40
65558923117,65558923125,8,2162,811,-40
65559475415,65559475422,7,4679,1362,-40
65561605813,65561605817,4,2482,1742,-40
65564688560,65564688566,6,1963,1363,-40
65565569140,65565569146,6,4154,1806,-40
65569752361,65569752367,6,2757,1092,-40
65573702271,65573702275,4,2252,667,-40
65576293354,65576293361,7,2412,1161,-40
65580039678,65580039673,-5,571,3462,-40
65585008115,65585008118,3,1893,1113,-40
65586281485,65586281482,-3,1220,116,-40
65587080704,65587080711,7,2243,1052,-40
65591549319,65591549325,6,2234,1168,-40
65592957318,65592957325,7,2520,1336,-40
65594269298,65594269304,6,3041,1131,-40
65595919339,65595919345,6,2837,1614,-40
65597771413,65597771417,4,2982,1660,-40
65598469161,65598469167,6,1700,881,-40
65599493873,65599493878,5,2627,1157,-40
65599710994,65599711001,7,2694,958,-40
65599831309,65599831316,7,4546,1227,-40
65603781965,65603781968,3,3634,1972,-40
65604886018,65604886025,7,4463,1503,-40
65607883830,65607883834,4,2169,946,-40
65607946253,65607946261,8,10138,2169,-40
65614287678,65614287686,8,4969,1709,-40
65615411243,65615411249,6,2365,1314,-40
65618686670,65618686674,4,6478,22762,-40
65624200289,65624200295,6,3660,1497,-40
65625008038,65625008045,7,2631,1297,-40
65625656662,65625656642,-20,2908,1074,-40
65628611799,65628611796,-3,846,204,-40
65630001013,65630001019,6,1718,1164,-40
65630771569,65630771575,6,2614,1020,-40
65632745361,65632745355,-6,1259,5041,-40
65635487842,65635487847,5,3375,1127,-40
65637159055,65637159062,7,2905,1195,-40
65639558162,65639558162,0,4987,16674,-40
65642485755,65642485763,8,3201,1787,-40
65646660293,65646660302,9,3916,1551,-40
65649615950,65649615957,7,2866,1319,-40
65655099819,65655099823,4,2513,731,-40
65665105654,65665105659,5,2688,1351,-40
65672510337,65672510347,10,3610,1658,-40
65674872974,65674872979,5,2388,935,-40
65675163125,65675163131,6,3141,1138,-40
65677719314,65677719311,-3,5179,10640,-40
65680689822,65680689829,7,4976,1656,-40
65689545605,65689545610,5,3344,1516,-40
65691331845,65691331833,-12,1221,21789,-40
65697915518,65697915519,1,2743,3575,-40
65700967713,65700967718,5,3644,1307,-40
65705482822,65705482818,-4,1153,2494,-40
65706878444,65706878450,6,3096,1312,-40
65707351873,65707351879,6,2708,949,-40
65707957303,65707957310,7,1568,1026,-40
65708082232,65708082231,-1,1912,2306,-40
65708908749,65708908757,8,4548,1611,-40
65710465629,65710465635,6,2401,1664,-40
65712281278,65712281283,5,3262,1306,-40
65723818780,65723818783,3,1589,1175,-40
65724762798,65724762793,-5,1000,3479,-40
65733603241,65733603247,6,3164,1506,-40
65734954715,65734954714,-1,1512,2395,-40
65736175758,65736175765,7,3056,1205,-40
65737481525,65737481530,5,2043,994,-40
65739863821,65739863829,8,2565,905,-40
65743692550,65743692555,5,2597,1080,-40
65747767986,65747767993,7,6361,2229,-40
65749798531,65749798538,7,3003,1493,-40
65752786173,65752786180,7,3178,1213,-40
65753050594,65753050601,7,2664,1550,-40
65753505517,65753505525,8,2817,1510,-40
65755136584,65755136592,8,2607,1330,-40
65758733349,65758733354,5,2199,946,-40
65759217910,65759217915,5,1715,1315,-40
65762415246,65762415251,5,2961,1191,-40
65762849641,65762849624,-17,1992,781,-40
65764387196,65764387202,6,3016,1379,-40
65766790242,65766790250,8,1510,812,-40
65770127299,65770127306,7,2618,1357,-40
65770199414,65770199425,11,2185,848,-40
65779837787,65779837782,-5,1053,3760,-40
65786666516,65786666521,5,2763,773,-40
65789629313,65789629319,6,2629,1421,-40
65795687181,65795687185,4,2529,1708,-40
65797005778,65797005783,5,3881,1313,-40
65798057294,65798057302,8,4418,1263,-40
65799685931,65799685939,8,2866,1471,-40
65801581393,65801581399,6,2837,1243,-40
65802695877,65802695883,6,5830,2555,-40
65806760583,65806760590,7,2605,1117,-40
65807897632,65807897639,7,2157,1208,-40
65808999994,65808999998,4,2328,2029,-40
65811200853,65811200858,5,2282,1167,-40
65811292224,65811292230,6,3639,1467,-40
65811437171,65811437177,6,2635,1249,-40
65814905255,65814905262,7,2963,1264,-40
65821553466,65821553465,-1,1626,2352,-40
65822414387,65822414393,6,2610,1077,-40
65822982079,65822982065,-14,2067,744,-40
65827413178,65827413183,5,3037,1268,-40
65830074316,65830074333,17,2822,1159,-40
65840521073,65840521079,6,2712,1179,-40
65845439263,65845439269,6,2664,912,-40
65846201666,65846201674,8,828,179,-40
65846333827,65846333840,13,1066,130,-40
65847775406,65847775412,6,3127,1429,-40
65848308549,65848308554,5,2803,1072,-40
65854483662,65854483662,0,2605,3490,-40
65860409522,65860409529,7,2473,1244,-40
65864112886,65864112893,7,2189,1762,-40
65865324001,65865324004,3,6185,4815,-40
65869603660,65869603668,8,3291,1339,-40
65870007782,65870007788,6,2619,1650,-40
65871502102,65871502107,5,3412,1330,-40
65873261053,65873261058,5,2185,1249,-40
65874553615,65874553624,9,523,134,-40
65875096950,65875096956,6,3431,1452,-40
65880447308,65880447315,7,25765,30005,-40
65885344689,65885344675,-14,1217,324,-40
65887952410,65887952418,8,2630,1289,-40
65888583343,65888583346,3,1255,1547,-40
65888707402,65888707407,5,2782,1346,-40
65890494796,65890494802,6,2435,1365,-40
65896849128,65896849133,5,2877,1197,-40
65898399518,65898399523,5,1795,1001,-40
65904120805,65904120811,6,2608,1438,-40
65906309889,65906309894,5,3516,1373,-40
65912865026,65912865019,-7,945,6060,-40
65915877422,65915877430,8,2818,1474,-40
65917114941,65917114946,5,2684,1630,-40
65921097437,65921097442,5,1997,1071,-40
65922635987,65922635995,8,4354,806,-40
65923127629,65923127635,6,1093,113,-40
65926880445,65926880450,5,2298,1103,-40
65927151249,65927151245,-4,1444,3273,-40
65930708959,65930708942,-17,798,468,-40
65932517046,65932517051,5,3730,1375,-40
65934661926,65934661930,4,1340,785,-40
65936958837,65936958852,15,1985,710,-40
65943120405,65943120412,7,2516,1420,-40
65943831263,65943831265,2,1193,286,-40
65945241240,65945241246,6,3541,1616,-40
65945662527,65945662512,-15,1140,328,-40
65946759353,65946759359,6,2121,1046,-40
65948657494,65948657501,7,2996,1743,-40
65949229121,65949229105,-16,2745,763,-40
65955671863,65955671844,-19,3064,808,-40
65957168156,65957168178,22,1124,1834,-40
65961333203,65961333210,7,3119,1475,-40
65961632225,65961632230,5,3907,1834,-40
65961728725,65961728730,5,3646,1606,-40
65967502333,65967502338,5,1540,795,-40
65967592955,65967592937,-18,871,435,-40
65967892193,65967892199,6,3852,1949,-40
65968523302,65968523308,6,3411,1747,-40
65968590840,65968590845,5,2469,1030,-40
65969264334,65969264339,5,1414,851,-40
65969791704,65969791692,-12,59744,93293,-40
65971826731,65971826737,6,2752,1399,-40
65973677145,65973677150,5,2881,1491,-40
65975125343,65975125349,6,2559,1406,-40
65976617065,65976617070,5,1248,757,-40
65977164522,65977164505,-17,1594,929,-40
65978288687,65978288694,7,3087,1066,-40
65979465802,65979465807,5,1201,1216,-40
65982500885,65982500891,6,1854,963,-40
65984374066,65984374070,4,3580,1484,-40
65985806117,65985806123,6,1354,753,-40
65989650479,65989650485,6,2637,1006,-40
65992235122,65992235127,5,2604,2068,-40
65994323087,65994323083,-4,1324,4157,-40
65997816346,65997816354,8,2797,1027,-40
65998502515,65998502523,8,3436,1025,-40
66000020003,66000020009,6,4095,1595,-40
66001743191,66001743195,4,865,258,-40
66002518830,66002518835,5,3374,1284,-40
66002585381,66002585390,9,3101,960,-40
66003147459,66003147458,-1,986,1503,-40
66007803127,66007803132,5,1419,1420,-40
66008656721,66008656727,6,2338,1422,-40
66018593870,66018593874,4,2694,1462,-40
66020927780,66020927786,6,2844,1425,-40
66025924353,66025924358,5,3321,960,-40
66027988362,66027988361,-1,25637,40615,-40
66028350078,66028350083,5,1689,1223,-40
66029048565,66029048558,-7,1736,7142,-40
66031522322,66031522327,5,2871,1200,-40
66031907561,66031907547,-14,1824,773,-40
66036490605,66036490610,5,3505,2090,-40
66037755706,66037755713,7,2990,1049,-40
66040183365,66040183370,5,3084,1337,-40
66040333365,66040333346,-19,2531,800,-40
66041565453,66041565457,4,2975,1453,-40
66042094802,66042094808,6,4084,1490,-40
66047520215,66047520202,-13,1086,544,-40
66048948229,66048948233,4,1630,1231,-40
66053178939,66053178945,6,2377,1632,-40
66055829668,66055829678,10,18954,25019,-40
66056562479,66056562485,6,3892,1442,-40
66058845962,66058845949,-13,1264,466,-40
66061363310,66061363315,5,2271,1252,-40
66066162349,66066162357,8,4509,1718,-40
66066576244,66066576243,-1,33906,9396,-40
66069934701,66069934706,5,2394,1722,-40
66070073329,66070073334,5,2555,1535,-40
66070138603,66070138608,5,2787,1405,-40
66074091818,66074091824,6,2119,1784,-40
66074996997,66074996985,-12,1616,322,-40
66075806421,66075806427,6,3511,1875,-40
66079023327,66079023334,7,2971,1322,-40
66080506247,66080506254,7,2003,904,-40
66081777428,66081777408,-20,1682,934,-40
66085762777,66085762783,6,2809,1020,-40
66086894597,66086894603,6,3246,1465,-40
66088957918,66088957926,8,3126,1684,-40
66097464746,66097464753,7,4531,1726,-40
66104488927,66104488934,7,2760,1273,-40
66105354677,66105354683,6,2831,1477,-40
66105728399,66105728405,6,2266,1172,-40
66106362427,66106362408,-19,3168,1231,-40
66109547738,66109547748,10,2995,1539,-40
66111073734,66111073739,5,2434,1411,-40
66111397150,66111397137,-13,531,193,-40
66114539022,66114539026,4,1887,638,-40
66116920119,66116920125,6,1938,1171,-40
66118076793,66118076799,6,2932,935,-40
66122631860,66122631866,6,2908,1221,-40
66124493710,66124493717,7,3141,1555,-40
66125803649,66125803654,5,1944,1269,-40
66130082565,66130082569,4,2989,2063,-40
66130536285,66130536282,-3,2496,5211,-40
66131028754,66131028758,4,2622,1621,-40
66135461922,66135461933,11,397,1722,-40
66137967795,66137967788,-7,37003,10456,-40
66147057466,66147057474,8,1585,796,-40
66151263689,66151263695,6,2279,1072,-40
66154771682,66154771689,7,2279,971,-40
66157169716,66157169713,-3,971,2074,-40
66163493250,66163493254,4,2029,1025,-40
66165133228,66165133236,8,2119,1007,-40
66166451573,66166451562,-11,2686,826,-40
66167922664,66167922665,1,14394,16899,-40
66170570629,66170570635,6,2487,1105,-40
66175944762,66175944767,5,3352,1539,-40
66178499221,66178499228,7,2605,1374,-40
66181278476,66181278482,6,2614,1217,-40
66181351097,66181351083,-14,3687,1098,-40
66183794390,66183794396,6,1984,948,-40
66186037234,66186037239,5,2177,1262,-40
66186073767,66186073787,20,2410,1349,-40
66189193642,66189193647,5,2334,1132,-40
66190224906,66190224913,7,3830,952,-40
66191724248,66191724255,7,4444,1165,-40
66192619627,66192619635,8,3471,827,-40
66193743805,66193743802,-3,1639,2727,-40
66200670211,66200670215,4,5164,2573,-40
66200782651,66200782657,6,1234,955,-40
66203385507,66203385513,6,2447,877,-40
66212288490,66212288497,7,2335,1346,-40
66215152487,66215152494,7,1766,1344,-40
66216933665,66216933671,6,2362,1098,-40
66221307955,66221307962,7,2415,1325,-40
66223269977,66223269983,6,2966,1505,-40
66224229862,66224229869,7,3101,1116,-40
66225228213,66225228220,7,3529,1236,-40
66226831396,66226831402,6,2445,1360,-40
66235189941,66235189948,7,2816,1501,-40
66238812450,66238812454,4,2958,1189,-40
66240756883,66240756887,4,3890,2325,-40
66244940721,66244940727,6,2784,1338,-40
66253522570,66253522577,7,3787,1076,-40
66254156556,66254156539,-17,3059,1415,-40
66254436457,66254436468,11,14180,39016,-40
66254992593,66254992601,8,3050,958,-40
66259129542,66259129555,13,11973,26790,-40
66261631850,66261631853,3,1907,1402,-40
66268402774,66268402780,6,2764,1703,-40
66275779554,66275779559,5,1525,993,-40
66276318330,66276318335,5,23671,16969,-40
66279580765,66279580771,6,3250,1952,-40
66279670633,66279670635,2,1809,1479,-40
66280442266,66280442273,7,3320,1195,-40
66284717958,66284717963,5,2298,1929,-40
66287209801,66287209805,4,2137,1622,-40
66287474508,66287474514,6,2542,1523,-40
66288650054,66288650058,4,2009,1418,-40
66289602530,66289602535,5,2092,1299,-40
66293218330,66293218330,0,964,1579,-40
66296375250,66296375255,5,2668,1089,-40
66297311962,66297311967,5,2236,1145,-40
66303091982,66303091983,1,892,1420,-40
66303359958,66303359937,-21,1412,596,-40
66304481797,66304481802,5,2992,1095,-40
66307819825,66307819830,5,3173,1594,-40
66308705773,66308705778,5,3167,1318,-40
66314985477,66314985484,7,2165,1267,-40
66317785418,66317785423,5,2307,813,-40
66318372345,66318372342,-3,914,1919,-40
66318705216,66318705224,8,4567,1350,-40
66318873222,66318873202,-20,2579,1186,-40
66319377281,66319377287,6,3459,1750,-40
66319824314,66319824322,8,3099,1286,-40
66320321498,66320321504,6,2918,1579,-40
66329759625,66329759632,7,5104,2380,-40
66330329202,66330329207,5,3559,1466,-40
66331743097,66331743103,6,4320,1536,-40
66334287046,66334287054,8,3383,1754,-40
66338409024,66338409031,7,1913,1135,-40
66338660201,66338660184,-17,2148,630,-40
66339113250,66339113256,6,2507,987,-40
66340353003,66340352999,-4,1118,2490,-40
66341920606,66341920622,16,1219,3296,-40
66343810311,66343810317,6,3092,1263,-40
66344643351,66344643357,6,2221,922,-40
66344914001,66344914007,6,2949,1274,-40
66348320499,66348320501,2,1816,1634,-40
66351560947,66351560955,8,2926,1367,-40
66352387146,66352387150,4,2383,1633,-40
66355283613,66355283618,5,2618,1357,-40
66356470104,66356470110,6,2002,1482,-40
66360431316,66360431322,6,2051,1173,-40
66360896693,66360896699,6,2972,903,-40
66366882112,66366882118,6,3165,1269,-40
66368868490,66368868496,6,2695,1643,-40
66369693870,66369693876,6,3061,1644,-40
66372216654,66372216660,6,4690,1564,-40
66373037452,66373037457,5,2636,1009,-40
66378726308,66378726304,-4,948,1916,-40
66380952776,66380952783,7,2370,1358,-40
66381814348,66381814354,6,3917,1546,-40
66383986795,66383986802,7,2034,1431,-40
66390363710,66390363716,6,3248,1538,-40
66391552334,66391552342,8,3965,1534,-40
66392962572,66392962579,7,3729,1768,-40
66396750094,66396750094,0,3189,4070,-40
66399349908,66399349914,6,3654,1552,-40
66401791805,66401791810,5,2535,1353,-40
66409317470,66409317479,9,1420,722,-40
66412415118,66412415126,8,3206,1005,-40
66412505346,66412505353,7,3295,1219,-40
66413650042,66413650047,5,2636,1138,-40
66414541266,66414541281,15,718,17,-40
66415529693,66415529699,6,1500,1137,-40
66416016986,66416016992,6,3674,1259,-40
66418086801,66418086807,6,2841,1130,-40
66418351467,66418351451,-16,2780,1178,-40
66418740270,66418740273,3,26350,32122,-40
66420739724,66420739730,6,3488,996,-40
66425599505,66425599510,5,3321,992,-40
66426599806,66426599813,7,2055,945,-40
66428357633,66428357639,6,3003,926,-40
66430121073,66430121078,5,2191,1203,-40
66435181779,66435181785,6,3839,1967,-40
66435804897,66435804886,-11,1229,28114,-40
66437084878,66437084884,6,2490,1525,-40
66439907766,66439907765,-1,1110,1669,-40
66440335518,66440335525,7,2713,1296,-40
66441317528,66441317534,6,3209,1336,-40
66449779486,66449779493,7,2508,1261,-40
66451926117,66451926125,8,1893,1312,-40
66452250420,66452250427,7,2883,1408,-40
66454387193,66454387206,13,26,1085,-40
66456719200,66456719199,-1,1334,1758,-40
66457457455,66457457459,4,2173,1062,-40
66459022021,66459022027,6,4531,1692,-40
66460446545,66460446552,7,2538,1088,-40
66460485450,66460485459,9,1357,341,-40
66463281178,66463281182,4,2075,1692,-40
66463461346,66463461354,8,2939,1304,-40
66463629002,66463628992,-10,436,123,-40
66467487273,66467487278,5,3379,1505,-40
66469285735,66469285735,0,3525,4100,-40
66470168055,66470168050,-5,1081,5117,-40
66473021047,66473021054,7,3256,1214,-40
66477577794,66477577800,6,3305,1322,-40
66478266084,66478266083,-1,941,1487,-40
66480190851,66480190857,6,3079,1522,-40
66483433417,66483433423,6,2651,1277,-40
66484934577,66484934583,6,2282,1516,-40
66485231277,66485231283,6,2127,833,-40
66496619288,66496619293,5,3379,1348,-40
66497684810,66497684818,8,3604,1576,-40
66502534739,66502534733,-6,979,4354,-40
66503845033,66503845038,5,3968,1748,-40
66505230513,66505230511,-2,1528,2575,-40
66507794595,66507794615,20,208,797,-40
66510235227,66510235233,6,2719,1248,-40
66510874002,66510873995,-7,706,215,-40
66512253025,66512253031,6,2429,1115,-40
66516495790,66516495792,2,39831,39992,-40
66517451638,66517451634,-4,1128,4475,-40
66519680074,66519680082,8,2767,1197,-40
66522238251,66522238258,7,1964,950,-40
66530232333,66530232343,10,3647,1066,-40
66530929422,66530929427,5,3227,1462,-40
66535400165,66535400170,5,1755,1237,-40
66536230107,66536230114,7,2983,1419,-40
66536654956,66536654939,-17,3666,1371,-40
66540014361,66540014367,6,2611,1264,-40
66542472124,66542472130,6,4117,1105,-40
66543150193,66543150202,9,1237,395,-40
66544125702,66544125682,-20,1177,292,-40
66547276474,66547276479,5,3279,1745,-40
66550229598,66550229603,5,2193,1126,-40
66554334861,66554334866,5,2786,1475,-40
66559736618,66559736623,5,2065,1600,-40
66562619488,66562619493,5,3058,1165,-40
66564299161,66564299167,6,3298,1338,-40
66568108098,66568108105,7,2856,1129,-40
66570963177,66570963174,-3,1293,2270,-40
66572716326,66572716334,8,3116,1560,-40
66581615789,66581615804,15,2336,1101,-40
66585684983,66585684990,7,3462,1272,-40
66587925597,66587925603,6,3111,1058,-40
66588332538,66588332545,7,4577,1397,-40
66590879497,66590879499,2,1498,1825,-40
66595352452,66595352458,6,3054,1594,-40
66596843002,66596842997,-5,1103,3914,-40
66597517238,66597517242,4,1812,1199,-40
66598072211,66598072194,-17,1412,353,-40
66601030722,66601030730,8,2662,1086,-40
66605199141,66605199146,5,3481,2377,-40
66605842938,66605842943,5,2492,1001,-40
66607600198,66607600205,7,2444,1328,-40
66610131910,66610131913,3,1893,1698,-40
66619433190,66619433197,7,3259,1367,-40
66629307743,66629307750,7,2580,911,-40
66630283841,66630283847,6,2272,966,-40
66630962505,66630962510,5,2071,1153,-40
66632683689,66632683695,6,2302,1050,-40
66635578454,66635578448,-6,36308,15971,-40
66640305291,66640305297,6,3662,1556,-40
66644054292,66644054297,5,2499,1015,-40
66646663251,66646663258,7,2179,1308,-40
66648274432,66648274437,5,2969,1073,-40
66658439500,66658439506,6,3578,1209,-40
66661306362,66661306356,-6,3736,14295,-40
66668508638,66668508644,6,2168,1107,-40
66674095765,66674095770,5,1369,1162,-40
66674905122,66674905130,8,2994,1643,-40
66675472054,66675472036,-18,1094,308,-40
66679452056,66679452046,-10,55,668,-40
66680726543,66680726544,1,1988,1995,-40
66680763151,66680763159,8,2352,961,-40
66681577491,66681577497,6,4021,1464,-40
66684163247,66684163254,7,2660,984,-40
66684200567,66684200569,2,1652,1548,-40
66684226676,66684226657,-19,2133,765,-40
66685802781,66685802788,7,3597,1331,-40
66694582328,66694582334,6,2595,1101,-40
66699362854,66699362861,7,2582,1388,-40
66704592746,66704592753,7,3221,1826,-40
66704778667,66704778675,8,2891,1021,-40
66706652899,66706652903,4,1971,1032,-40
66708352982,66708352989,7,2600,966,-40
66709782921,66709782927,6,2786,1112,-40
66711972403,66711972409,6,2124,1366,-40
66713539994,66713539998,4,1956,1154,-40
66714212554,66714212559,5,3159,1225,-40
66715160304,66715160289,-15,2215,1017,-40
66715787550,66715787555,5,2457,937,-40
66720918670,66720918684,14,16237,40780,-40
66721848518,66721848526,8,3192,1534,-40
66722051313,66722051298,-15,2101,845,-40
66722222190,66722222170,-20,2409,1711,-40
66723168459,66723168466,7,23747,45428,-40
66724751708,66724751715,7,2640,1347,-40
66725303336,66725303343,7,1968,1376,-40
66726470106,66726470113,7,4418,1101,-40
66729513021,66729513025,4,3111,1928,-40
66729629086,66729629094,8,1409,714,-40
66731016070,66731016078,8,2093,1166,-40
66735887081,66735887088,7,3069,1474,-40
66738942188,66738942181,-7,34740,17229,-40
66739242778,66739242786,8,2447,824,-40
66745566956,66745566961,5,2266,1130,-40
66748618997,66748619002,5,1752,1293,-40
66751455933,66751455938,5,3476,1714,-40
66757031168,66757031173,5,2230,1030,-40
66758791569,66758791575,6,2413,922,-40
66759943705,66759943713,8,4013,1665,-40
66762865902,66762865908,6,3013,1039,-40
66766302255,66766302260,5,1640,662,-40
66770374935,66770374937,2,2275,1737,-40
66770969918,66770969925,7,4636,1138,-40
66771263246,66771263226,-20,2391,1208,-40
66771780980,66771780987,7,3524,1184,-40
66773778254,66773778250,-4,1390,2966,-40
66775819619,66775819625,6,3714,1963,-40
66777435406,66777435414,8,2465,1053,-40
66778281927,66778281934,7,2504,1512,-40
66780077543,66780077545,2,1731,1782,-40
66782749644,66782749650,6,2429,1109,-40
66786212963,66786212970,7,1796,802,-40
66791394538,66791394543,5,2960,1043,-40
66793443893,66793443887,-6,1695,4328,-40
66799029451,66799029457,6,1598,1430,-40
66801101129,66801101134,5,1741,1167,-40
66812390803,66812390806,3,33555,49234,-40
66815472313,66815472320,7,2409,1174,-40
66816094957,66816094963,6,2187,922,-40
66819150439,66819150445,6,2191,1388,-40
66820060318,66820060308,-10,780,368,-40
66821370676,66821370683,7,6622,1988,-40
66829952650,66829952656,6,2708,1434,-40
66832098126,66832098133,7,2555,1448,-40
66832238425,66832238412,-13,1508,340,-40
66833545581,66833545587,6,3285,1433,-40
66833592218,66833592223,5,2416,1377,-40
66834529234,66834529246,12,474,1042,-40
66842783877,66842783884,7,2190,903,-40
66843755964,66843755969,5,1852,908,-40
66849822682,66849822679,-3,1108,2387,-40
66850198342,66850198348,6,3580,1719,-40
66850515821,66850515826,5,2538,1450,-40
66851035441,66851035449,8,2065,801,-40
66863225562,66863225569,7,2538,1347,-40
66865844385,66865844391,6,2350,1133,-40
66866529323,66866529321,-2,1155,283,-40
66867824790,66867824796,6,2295,1238,-40
66876947642,66876947650,8,4894,1765,-40
66878606105,66878606111,6,2524,1101,-40
66879088177,66879088183,6,3745,1088,-40
66880234077,66880234082,5,3474,1455,-40
66884670253,66884670261,8,3597,1380,-40
66893222098,66893222105,7,3461,1208,-40
66898788149,66898788154,5,2385,1188,-40
66901865998,66901866004,6,2236,1250,-40
66902527988,66902527994,6,2832,993,-40
66907059921,66907059927,6,3609,1888,-40
66907859626,66907859622,-4,2147,5089,-40
66908721208,66908721214,6,2760,1213,-40
66914346917,66914346922,5,2076,846,-40
66916323842,66916323821,-21,3490,1559,-40
66917363602,66917363608,6,2614,997,-40
66917531295,66917531273,-22,3117,889,-40
66919372946,66919372950,4,2261,1403,-40
66924977058,66924977065,7,3538,1596,-40
66926846293,66926846299,6,3621,1307,-40
66934369982,66934369990,8,3061,1250,-40
66935613552,66935613558,6,2206,1355,-40
66936212081,66936212086,5,4260,1438,-40
66936790337,66936790342,5,3048,1215,-40
66939684010,66939684018,8,4056,1513,-40
66941448779,66941448785,6,3571,1388,-40
66950237416,66950237422,6,2085,899,-40
66955359602,66955359606,4,2327,1410,-40
66956063694,66956063698,4,1124,1137,-40
66957608261,66957608266,5,1755,689,-40
66958875309,66958875316,7,2963,1374,-40
66959945242,66959945249,7,2358,774,-40
66967750656,66967750662,6,3212,1220,-40
66970057909,66970057915,6,3199,1293,-40
66975590385,66975590387,2,1203,816,-40
66976848833,66976848838,5,2644,1060,-40
66977999999,66978000005,6,2823,1448,-40
66984849270,66984849275,5,2261,1201,-40
66984906534,66984906512,-22,1160,444,-40
66987247717,66987247721,4,2542,1466,-40
66987542202,66987542209,7,2788,1727,-40
66994896467,66994896468,1,1748,2578,-40
66997072593,66997072598,5,2727,1443,-40
66999477623,66999477630,7,2804,1008,-40
67000149141,67000149122,-19,2774,979,-40
67006872338,67006872323,-15,1915,346,-40
67018474587,67018474594,7,4216,1030,-40
67019240116,67019240122,6,3400,1415,-40
67019476195,67019476201,6,2577,944,-40
67020826342,67020826350,8,3376,1179,-40
67020893020,67020893043,23,786,209,-40
67021701779,67021701786,7,3764,1457,-40
67025125404,67025125411,7,1651,815,-40
67026544999,67026545006,7,1637,1303,-40
67030386046,67030386049,3,10141,10377,-40
67040101768,67040101771,3,4262,20815,-40
67048853875,67048853881,6,2726,1215,-40
67050247827,67050247833,6,2448,1342,-40
67050416070,67050416050,-20,1959,878,-40
67050607360,67050607368,8,3834,1033,-40
67057734563,67057734563,0,1252,1756,-40
67063623449,67063623454,5,2553,1415,-40
67072167884,67072167890,6,2529,1401,-40
67073160740,67073160749,9,2336,1041,-40
67074328070,67074328075,5,1939,1004,-40
67080063930,67080063935,5,2892,1570,-40
67082884126,67082884133,7,2576,1171,-40
67083094629,67083094631,2,2712,2030,-40
67097082185,67097082190,5,2888,1471,-40
67099844189,67099844193,4,2415,1020,-40
67102932110,67102932115,5,2036,1012,-40
67105100729,67105100736,7,3174,1456,-40
67114751098,67114751103,5,4097,1662,-40
67115365717,67115365723,6,2865,1158,-40
67117317498,67117317507,9,3784,1267,-40
67117450905,67117450910,5,3424,1313,-40
67118621811,67118621804,-7,1456,7325,-40
67121346274,67121346272,-2,1033,1540,-40
67122429079,67122429085,6,3012,1126,-40
67127458575,67127458577,2,1319,971,-40
67128621977,67128621983,6,3240,880,-40
67129208446,67129208465,19,873,175,-40
67130307817,67130307823,6,2296,1005,-40
67134987026,67134987033,7,2853,999,-40
67136443145,67136443151,6,2392,1244,-40
67136937734,67136937739,5,2021,852,-40
67142558058,67142558061,3,1852,1516,-40
67143734250,67143734255,5,3528,1449,-40
67145058360,67145058365,5,3473,1643,-40
67145219138,67145219137,-1,715,218,-40
67145894521,67145894528,7,2771,1679,-40
67148075246,67148075251,5,1827,1085,-40
67149492219,67149492223,4,2324,994,-40
67150517257,67150517262,5,3415,1951,-40
67150720012,67150720018,6,3503,1481,-40
67152477291,67152477290,-1,1592,2097,-40
67154223792,67154223800,8,4411,1072,-40
67159216345,67159216352,7,3271,1806,-40
67160265126,67160265133,7,3696,1171,-40
67163685861,67163685866,5,1726,702,-40
67165240552,67165240556,4,1480,855,-40
67166138370,67166138371,1,2307,3343,-40
67166366723,67166366729,6,2583,838,-40
67167064658,67167064662,4,2083,1067,-40
67173196633,67173196641,8,3260,1098,-40
67175554469,67175554475,6,2575,1258,-40
67178156415,67178156422,7,2498,1146,-40
67184365014,67184365018,4,2509,1421,-40
67184420227,67184420235,8,3610,1257,-40
67189957607,67189957615,8,2762,1528,-40
67198637890,67198637894,4,1386,1183,-40
67200534499,67200534506,7,3236,996,-40
67200970246,67200970227,-19,4722,1500,-40
67205845392,67205845392,0,1381,1775,-40
67206838920,67206838925,5,3611,1402,-40
67207417463,67207417470,7,5397,2563,-40
67214998210,67214998217,7,2076,1055,-40
67215212654,67215212660,6,3422,1561,-40
67220072179,67220072186,7,2368,1261,-40
67221910630,67221910637,7,2860,1081,-40
67222674210,67222674214,4,2559,1096,-40
67223777723,67223777705,-18,1446,409,-40
67224879651,67224879646,-5,683,3620,-40
67233303014,67233303021,7,2993,1054,-40
67236434150,67236434158,8,3601,1234,-40
67237193647,67237193654,7,2136,1232,-40
67238124253,67238124259,6,2498,1174,-40
67240104919,67240104926,7,1466,625,-40
67240142565,67240142578,13,3521,1236,-40
67241588730,67241588738,8,1617,1237,-40
67243588762,67243588769,7,3582,1521,-40
67248488713,67248488718,5,2634,1006,-40
67248825486,67248825490,4,1899,1339,-40
67248959906,67248959914,8,702,332,-40
67250186214,67250186221,7,3220,1759,-40
67250350307,67250350311,4,2256,1584,-40
67255699859,67255699863,4,2590,966,-40
67257359362,67257359369,7,2723,1839,-40
67258989694,67258989690,-4,2550,5768,-40
67259176362,67259176366,4,3540,1147,-40
67259478029,67259478035,6,3727,1538,-40
67260661997,67260662003,6,2321,1067,-40
67261172477,67261172457,-20,685,287,-40
67264530652,67264530658,6,3014,1782,-40
67268557569,67268557577,8,1999,809,-40
67269045578,67269045586,8,1803,1025,-40
67269318506,67269318490,-16,922,252,-40
67271909153,67271909159,6,2804,946,-40
67277995270,67277995265,-5,1894,3272,-40
67278023214,67278023222,8,3957,1351,-40
67279465281,67279465287,6,3607,1381,-40
67286455702,67286455709,7,4748,1510,-40
67290827106,67290827111,5,2540,1242,-40
67309126796,67309126802,6,3238,1481,-40
67310501199,67310501204,5,2123,1544,-40
67310635898,67310635912,14,1046,310,-40
67314720403,67314720410,7,2476,1528,-40
67314801205,67314801211,6,2309,1423,-40
67318325167,67318325173,6,2861,1540,-40
67319167990,67319167994,4,2694,1104,-40
67320272977,67320272983,6,3448,1295,-40
67321071769,67321071776,7,5714,1433,-40
67322670790,67322670786,-4,1589,3536,-40
67325675301,67325675301,0,1302,1932,-40
67326217782,67326217790,8,3538,1531,-40
67326563446,67326563456,10,3021,932,-40
67327819175,67327819178,3,3044,1659,-40
67328881501,67328881510,9,2679,830,-40
67329527621,67329527626,5,1081,977,-40
67330171204,67330171210,6,1385,337,-40
67330600254,67330600259,5,2369,1136,-40
67331381983,67331381960,-23,2499,1056,-40
67334391174,67334391179,5,2520,1575,-40
67334459372,67334459378,6,2245,1120,-40
67337621581,67337621589,8,3825,1234,-40
67338407901,67338407907,6,3230,1373,-40
67338444839,67338444844,5,2715,782,-40
67344381586,67344381593,7,2214,1159,-40
67345230323,67345230306,-17,3513,1666,-40
67345813580,67345813570,-10,2292,921,-40
67350086718,67350086725,7,2457,774,-40
67350910163,67350910169,6,2827,1522,-40
67351102163,67351102148,-15,2309,887,-40
67352010526,67352010531,5,2772,1164,-40
67353323986,67353323994,8,1750,916,-40
67356555348,67356555352,4,2813,1327,-40
67356954767,67356954773,6,3672,1360,-40
67357709025,67357709029,4,3694,1264,-40
67359495393,67359495400,7,3434,995,-40
67361994190,67361994195,5,2599,1512,-40
67362587058,67362587066,8,3145,1558,-40
67362780490,67362780487,-3,3328,9663,-40
67364213528,67364213534,6,3418,996,-40
67365339508,67365339490,-18,3092,1578,-40
67369542925,67369542930,5,1879,909,-40
67370227597,67370227577,-20,1508,885,-40
67381593277,67381593280,3,1699,1361,-40
67383366721,67383366727,6,2127,1042,-40
67392475487,67392475493,6,2281,941,-40
67395256154,67395256159,5,2304,1102,-40
67395556337,67395556320,-17,3095,1004,-40
67399193854,67399193851,-3,1296,2310,-40
67399956577,67399956578,1,1070,1604,-40
67401573970,67401573966,-4,2381,5868,-40
67405542086,67405542091,5,3075,1536,-40
67407572364,67407572370,6,3617,1656,-40
67407831188,67407831208,20,1062,50,-40
67409690141,67409690147,6,3339,1166,-40
67412686833,67412686839,6,3676,1718,-40
67412980644,67412980650,6,2515,962,-40
67414207594,67414207601,7,3050,1581,-40
67422045830,67422045834,4,2309,954,-40
67424942541,67424942547,6,2892,1148,-40
67425892452,67425892457,5,2899,1487,-40
67426283712,67426283728,16,1824,1198,-40
67432181740,67432181747,7,2003,796,-40
67436244354,67436244361,7,2484,1240,-40
67438562565,67438562570,5,2347,1265,-40
67439962340,67439962355,15,155,1282,-40
67443633406,67443633411,5,2359,930,-40
67443844843,67443844849,6,2373,1116,-40
67445761093,67445761100,7,2793,1249,-40
67446044302,67446044307,5,3219,1426,-40
67450786790,67450786797,7,3172,1464,-40
67453697874,67453697879,5,4072,1464,-40
67461754458,67461754450,-8,27772,15404,-40
67462368732,67462368731,-1,1062,1846,-40
67463016723,67463016714,-9,5202,13815,-40
67464511785,67464511793,8,2290,1092,-40
67469323245,67469323259,14,3046,1247,-40
67473962810,67473962816,6,2074,998,-40
67481862980,67481862986,6,2852,999,-40
67482264831,67482264838,7,4467,1775,-40
67489419841,67489419846,5,3393,1880,-40
67493991087,67493991093,6,2391,1226,-40
67494717753,67494717739,-14,3479,1108,-40
67496566866,67496566872,6,3051,1847,-40
67500422947,67500422954,7,3382,983,-40
67502654875,67502654882,7,3850,1371,-40
67503703000,67503703016,16,112,5247,-40
67506712977,67506712982,5,2689,1373,-40
67509804433,67509804416,-17,43990,16891,-40
67510996459,67510996463,4,1551,894,-40
67511710789,67511710794,5,3312,1221,-40
67512987242,67512987249,7,2600,1529,-40
67520516412,67520516417,5,2208,870,-40
67522895105,67522895113,8,3146,1267,-40
67526974702,67526974710,8,2346,1267,-40
67527435641,67527435647,6,3070,1398,-40
67534745893,67534745898,5,3170,1601,-40
67535595489,67535595475,-14,3176,746,-40
67539389490,67539389498,8,3029,1578,-40
67542620997,67542621003,6,2536,1245,-40
67544514938,67544514923,-15,1255,27121,-40
67544861453,67544861459,6,2184,1061,-40
67545281750,67545281768,18,987,137,-40
67545809903,67545809906,3,1929,1309,-40
67547918634,67547918641,7,1881,1044,-40
67548657860,67548657867,7,2935,942,-40
67549818306,67549818302,-4,1244,3670,-40
67552689178,67552689184,6,3723,1277,-40
67554563385,67554563391,6,2238,1512,-40
67555127977,67555127986,9,3017,1284,-40
67556259242,67556259249,7,2996,1524,-40
67557886240,67557886249,9,3189,1155,-40
67558025750,67558025763,13,606,274,-40
67560439560,67560439566,6,2394,1127,-40
67561755370,67561755374,4,2010,1172,-40
67561789695,67561789713,18,1202,206,-40
67565779465,67565779473,8,2750,1153,-40
67568399677,67568399683,6,3309,1436,-40
67570465047,67570465050,3,2149,1396,-40
67572820120,67572820126,6,2755,1093,-40
67573438654,67573438661,7,3293,1455,-40
67574748370,67574748375,5,4084,2165,-40
67577625454,67577625461,7,4188,1897,-40
67580783127,67580783134,7,2510,803,-40
67581859504,67581859509,5,2155,968,-40
67584842307,67584842314,7,2832,1552,-40
67591217655,67591217658,3,1647,1223,-40
67594259466,67594259473,7,3766,1360,-40
67596924961,67596924966,5,3922,1610,-40
67597058886,67597058907,21,753,440,-40
67604468438,67604468445,7,1896,1118,-40
67606032631,67606032636,5,3118,1435,-40
67607225669,67607225648,-21,1484,396,-40
67608454262,67608454269,7,2755,866,-40
67611032068,67611032071,3,2787,2633,-40
67611584902,67611584909,7,3670,1662,-40
67611990569,67611990575,6,5905,1651,-40
67616140894,67616140890,-4,1234,4431,-40
67619054890,67619054897,7,3453,1148,-40
67621366524,67621366504,-20,2925,1000,-40
67623729870,67623729877,7,3820,1531,-40
67625327426,67625327433,7,4446,1866,-40
67629883165,67629883173,8,2946,1613,-40
67630244297,67630244306,9,4532,1460,-40
67631536315,67631536322,7,3603,1577,-40
67637040081,67637040082,1,1453,1329,-40
67639104196,67639104202,6,3902,1579,-40
67640761005,67640761011,6,2795,1324,-40
67645113652,67645113658,6,3007,1434,-40
67652923620,67652923619,-1,480,1176,-40
67654783117,67654783130,13,546,1217,-40
67655496825,67655496827,2,16321,6643,-40
67660311234,67660311239,5,2920,991,-40
67660547369,67660547364,-5,675,2977,-40
67665810356,67665810362,6,2697,1109,-40
67667617522,67667617530,8,2813,1174,-40
67686525978,67686525983,5,2688,1385,-40
67697385202,67697385209,7,2912,1111,-40
67699465279,67699465288,9,2380,1036,-40
67704869513,67704869500,-13,935,313,-40
67705389032,67705389038,6,2676,1185,-40
67708586733,67708586738,5,2553,1237,-40
67710803408,67710803409,1,1310,2039,-40
67713691898,67713691905,7,3209,1299,-40
67713912293,67713912299,6,2794,949,-40
67719695777,67719695785,8,2651,922,-40
67723482718,67723482723,5,2807,1287,-40
67727178058,67727178063,5,1638,788,-40
67729833969,67729833975,6,3088,1342,-40
67730476958,67730476964,6,2600,1197,-40
67730507047,67730507035,-12,2121,447,-40
67731358439,67731358446,7,3290,1669,-40
67736309254,67736309261,7,3092,1705,-40
67736570861,67736570870,9,1298,841,-40
67736841962,67736841946,-16,2592,1234,-40
67738991917,67738991922,5,2623,1024,-40
67740605032,67740605038,6,1570,1017,-40
67742606272,67742606282,10,16289,26603,-40
67744343488,67744343494,6,3411,982,-40
67749904463,67749904450,-13,850,345,-40
67750238014,67750238023,9,3072,1714,-40
67750303386,67750303370,-16,916,356,-40
67751490146,67751490163,17,3061,1015,-40
67753391784,67753391789,5,3159,2411,-40
67754992436,67754992441,5,2957,1186,-40
67755260607,67755260610,3,2097,1489,-40
67757575137,67757575142,5,1838,1073,-40
67760934311,67760934311,0,2688,2896,-40
67771808062,67771808066,4,2545,1810,-40
67772072789,67772072795,6,3744,1300,-40
67772503733,67772503715,-18,3050,1281,-40
67774120489,67774120495,6,2514,1320,-40
67775075359,67775075365,6,3525,1374,-40
67780697417,67780697423,6,2768,963,-40
67780919428,67780919440,12,1747,1168,-40
67781333999,67781333998,-1,2071,2875,-40
67791492835,67791492834,-1,7042,10841,-40
67791858582,67791858586,4,2055,1309,-40
67795256365,67795256372,7,2800,1559,-40
67795875323,67795875331,8,1862,750,-40
67797876182,67797876190,8,2981,1615,-40
67801503658,67801503663,5,3390,856,-40
67803916734,67803916741,7,3106,1097,-40
67804019522,67804019529,7,2098,917,-40
67806607291,67806607298,7,1640,913,-40
67811396646,67811396650,4,2999,1452,-40
67811618956,67811618962,6,2138,955,-40
67814452021,67814452041,20,3827,1968,-40
67817024373,67817024378,5,4064,1649,-40
67817864465,67817864471,6,2082,1374,-40
67823570734,67823570741,7,2792,1274,-40
67825714597,67825714603,6,2930,1164,-40
67826052806,67826052810,4,2709,1215,-40
67830473628,67830473634,6,1739,1360,-40
67833645530,67833645536,6,1072,932,-40
67833859731,67833859736,5,3132,1260,-40
67838870450,67838870455,5,1774,1682,-40
67843936890,67843936896,6,3255,1617,-40
67848867687,67848867691,4,3025,1645,-40
67851559394,67851559400,6,1942,1222,-40
67851584833,67851584816,-17,499,23,-40
67851598395,67851598395,0,5,20,-40
67858042812,67858042819,7,1555,950,-40
67858151050,67858151032,-18,1635,722,-40
67858318194,67858318199,5,2410,847,-40
67866257376,67866257370,-6,2319,6710,-40
67867398033,67867398039,6,2203,983,-40
67871711522,67871711530,8,3030,1337,-40
67873815218,67873815222,4,2561,1141,-40
67880437388,67880437394,6,2425,1113,-40
67881799122,67881799129,7,2151,1273,-40
67882307225,67882307231,6,2399,1216,-40
67891458163,67891458169,6,3132,1095,-40
67891688575,67891688581,6,2663,1139,-40
67891912771,67891912777,6,3352,1596,-40
67897835869,67897835874,5,2825,1089,-40
67901484447,67901484447,0,1442,2141,-40
67904563416,67904563406,-10,1446,2566,-40
67906894325,67906894331,6,3988,2224,-40
67911310148,67911310154,6,3000,1385,-40
67916168170,67916168175,5,1636,1004,-40
67917675728,67917675734,6,2666,1175,-40
67918639594,67918639600,6,2568,1209,-40
67920269356,67920269361,5,2814,1445,-40
67923698093,67923698098,5,1745,1178,-40
67924541225,67924541243,18,1935,1135,-40
67928271821,67928271827,6,2554,1317,-40
67928854836,67928854842,6,2876,1414,-40
67929666234,67929666241,7,2821,1678,-40
67935279954,67935279961,7,3432,1383,-40
67938078330,67938078339,9,2677,1181,-40
67939749749,67939749755,6,3469,1670,-40
67942056504,67942056509,5,3294,1640,-40
67945017968,67945017975,7,3708,1496,-40
67945919540,67945919547,7,2666,1303,-40
67947584275,67947584281,6,3155,1511,-40
67948367070,67948367076,6,2977,1276,-40
67951995970,67951995976,6,2535,1227,-40
67952968885,67952968866,-19,1475,573,-40
67953415991,67953415997,6,3124,1306,-40
67954522813,67954522818,5,2939,1216,-40
67954724482,67954724490,8,2744,1038,-40
67957307922,67957307924,2,2102,1563,-40
67959879538,67959879542,4,1748,1288,-40
67961642779,67961642786,7,2930,1401,-40
67963012428,67963012433,5,2520,1191,-40
67963208262,67963208250,-12,443,381,-40
67968414097,67968414103,6,2615,1288,-40
67968927089,67968927093,4,1440,1175,-40
67971182695,67971182702,7,1723,907,-40
67973692827,67973692834,7,3051,1595,-40
67974084585,67974084591,6,1917,1142,-40
67975215898,67975215904,6,1700,1217,-40
67976140594,67976140598,4,2461,1118,-40
67976783878,67976783868,-10,2421,1098,-40
67981297408,67981297414,6,2356,1162,-40
67981900556,67981900561,5,1437,1155,-40
67982140736,67982140734,-2,5163,9440,-40
67983341308,67983341314,6,3118,1099,-40
67987502341,67987502348,7,3368,1469,-40
67990382543,67990382542,-1,1326,2310,-40
68014561093,68014561097,4,2245,1087,-40
68020014770,68020014777,7,3731,1529,-40
68020112883,68020112864,-19,1623,538,-40
68024738349,68024738346,-3,1450,3001,-40
68025006167,68025006174,7,2563,1067,-40
68026778846,68026778851,5,2638,1455,-40
68028010855,68028010860,5,2682,1338,-40
68033813549,68033813556,7,2732,1358,-40
68043246785,68043246791,6,1924,1043,-40
68043418429,68043418434,5,2553,1534,-40
68044291304,68044291292,-12,812,306,-40
68045925487,68045925489,2,1837,1353,-40
68050856858,68050856866,8,1753,733,-40
68053586374,68053586390,16,12713,52017,-40
68054499705,68054499711,6,2552,1437,-40
68056772065,68056772071,6,1928,818,-40
68062265513,68062265519,6,2475,1557,-40
68063448549,68063448554,5,2660,1524,-40
68063918187,68063918193,6,3109,1305,-40
68066824513,68066824518,5,2446,1102,-40
68069831552,68069831558,6,2513,1281,-40
68075650873,68075650878,5,2070,898,-40
68076202457,68076202465,8,952,141,-40
68077179062,68077179056,-6,983,4781,-40
68078593733,68078593734,1,1838,1074,-40
68078905840,68078905846,6,58489,25706,-40
68081786192,68081786197,5,3214,1995,-40
68082433829,68082433823,-6,2084,8566,-40
68082526644,68082526650,6,3729,1176,-40
68083442218,68083442224,6,3514,1209,-40
68084853153,68084853158,5,2981,1526,-40
68084963532,68084963529,-3,1072,186,-40
68085508549,68085508556,7,3614,1472,-40
68092959631,68092959639,8,2291,1415,-40
68095846641,68095846647,6,3308,1569,-40
68098278433,68098278439,6,2947,1093,-40
68100706026,68100706032,6,3228,1378,-40
68102592630,68102592613,-17,755,162,-40
68109145607,68109145614,7,5325,1602,-40
68114785647,68114785654,7,3951,1385,-40
68115077514,68115077521,7,3700,1018,-40
68120440189,68120440194,5,2857,1253,-40
68122717901,68122717910,9,1951,732,-40
68124790259,68124790264,5,3579,1785,-40
68124912970,68124912973,3,2091,1923,-40
68127225164,68127225171,7,2976,1648,-40
68127377748,68127377754,6,2543,1240,-40
68129484674,68129484675,1,1167,1456,-40
68129827456,68129827462,6,3949,1242,-40
68138509987,68138509991,4,1445,991,-40
68139165030,68139165017,-13,5164,2219,-40
68140156284,68140156290,6,3307,1171,-40
68141063841,68141063845,4,2424,1461,-40
68142334455,68142334458,3,1091,953,-40
68145157403,68145157409,6,3174,1448,-40
68155914086,68155914078,-8,856,4129,-40
68157780602,68157780599,-3,874,2067,-40
68163772109,68163772115,6,2359,1501,-40
68164193639,68164193628,-11,2963,1046,-40
68164395642,68164395643,1,801,370,-40
68167173806,68167173814,8,2103,869,-40
68169300578,68169300576,-2,1145,2130,-40
68170607702,68170607705,3,1887,1153,-40
68170742638,68170742657,19,3417,1389,-40
68174690786,68174690788,2,1766,1920,-40
68175878645,68175878651,6,3463,1098,-40
68178402454,68178402460,6,1331,1080,-40
68187863799,68187863805,6,2502,1303,-40
68189592502,68189592507,5,3076,1341,-40
68190253634,68190253641,7,3200,1270,-40
68191618993,68191618998,5,3436,1168,-40
68191911933,68191911916,-17,1490,383,-40
68193449253,68193449235,-18,1658,884,-40
68201246462,68201246468,6,2367,1204,-40
68209008416,68209008422,6,3503,1326,-40
68209796310,68209796317,7,2997,1486,-40
68210123330,68210123314,-16,1111,183,-40
68210849199,68210849186,-13,818,273,-40
68211285899,68211285903,4,1260,865,-40
68216825866,68216825873,7,12663,20184,-40
68217765079,68217765086,7,2118,794,-40
68218833594,68218833597,3,2283,1821,-40
68219305469,68219305475,6,2570,1151,-40
68219403102,68219403082,-20,453,10,-40
68237751791,68237751768,-23,1881,908,-40
68239064658,68239064644,-14,1109,492,-40
68243557371,68243557380,9,3648,1157,-40
68244917920,68244917925,5,4289,2538,-40
68249559011,68249559018,7,3790,1313,-40
68249844669,68249844679,10,3136,1203,-40
68250764313,68250764319,6,2778,1242,-40
68251436593,68251436589,-4,1145,3464,-40
68254753923,68254753930,7,3072,1119,-40
68255947112,68255947121,9,1464,1003,-40
68257104594,68257104602,8,3307,1013,-40
68258778079,68258778083,4,2549,941,-40
68261059389,68261059395,6,3079,1481,-40
68265113761,68265113766,5,2657,1468,-40
68274124609,68274124617,8,1759,1384,-40
68274787639,68274787617,-22,1669,466,-40
68276910546,68276910551,5,2142,1103,-40
68277492700,68277492706,6,3448,1477,-40
68277795185,68277795190,5,2662,1646,-40
68284760560,68284760565,5,2255,1157,-40
68288021334,68288021339,5,3522,1637,-40
68289379918,68289379919,1,598,736,-40
68290321299,68290321305,6,4878,2488,-40
68291683314,68291683321,7,3906,1895,-40
68292788263,68292788262,-1,17966,24290,-40
68294533901,68294533906,5,2821,1300,-40
68296219458,68296219454,-4,500,1787,-40
68297816573,68297816578,5,2597,1160,-40
68298437876,68298437868,-8,1237,343,-40
68300643810,68300643815,5,3356,1678,-40
68303765464,68303765468,4,3524,1534,-40
68305886989,68305886994,5,2340,1320,-40
68307035593,68307035599,6,2812,1444,-40
68307206556,68307206562,6,2899,1750,-40
68307284945,68307284950,5,2626,1201,-40
68308726460,68308726459,-1,1657,3988,-40
68315408785,68315408794,9,5325,1085,-40
68318840530,68318840531,1,1618,1217,-40
68332768051,68332768058,7,3171,1448,-40
68352864568,68352864575,7,17511,31573,-40
68355607448,68355607454,6,2505,1342,-40
68358682694,68358682696,2,1465,31795,-40
68363635269,68363635283,14,14344,44498,-40
68363749097,68363749104,7,2179,1364,-40
68365032302,68365032306,4,2824,1256,-40
68365097150,68365097128,-22,2692,1033,-40
68371532384,68371532390,6,2875,1938,-40
68375708553,68375708546,-7,994,5128,-40
68377293794,68377293802,8,3283,1091,-40
68377422026,68377422034,8,2294,1125,-40
68379661165,68379661172,7,2935,1141,-40
68380201217,68380201223,6,2925,970,-40
68380373078,68380373085,7,2886,1263,-40
68381359174,68381359181,7,2729,1235,-40
68391095038,68391095045,7,3385,1520,-40
68391959226,68391959226,0,2687,3128,-40
68392531208,68392531214,6,3399,1686,-40
68392774928,68392774933,5,3038,1570,-40
68396212874,68396212873,-1,1534,1853,-40
68396497314,68396497321,7,2878,1505,-40
68399374305,68399374310,5,2435,1752,-40
68400963374,68400963377,3,1910,1186,-40
68402835438,68402835443,5,3422,1443,-40
68402889812,68402889818,6,2059,1106,-40
68406464489,68406464494,5,2892,944,-40
68407501607,68407501602,-5,28631,15074,-40
68410943758,68410943765,7,3934,1330,-40
68413649626,68413649633,7,2915,1618,-40
68413995523,68413995531,8,2302,1097,-40
68422113789,68422113794,5,5139,1392,-40
68423355484,68423355489,5,2630,1138,-40
68424486981,68424486987,6,4403,1578,-40
68432042805,68432042811,6,2842,1210,-40
68432905855,68432905861,6,3647,1229,-40
68437542473,68437542480,7,3193,1494,-40
68437849470,68437849475,5,4009,1345,-40
68439558113,68439558115,2,1231,677,-40
68443389646,68443389650,4,2233,1255,-40
68445708272,68445708278,6,3250,978,-40
68445800092,68445800075,-17,1539,583,-40
68454910544,68454910549,5,3221,1542,-40
68455351833,68455351840,7,2097,1204,-40
68467577945,68467577951,6,2842,1122,-40
68471226124,68471226130,6,2849,1082,-40
68475235789,68475235794,5,2359,1650,-40
68475987694,68475987691,-3,593,158,-40
68488599350,68488599358,8,2667,867,-40
68491814722,68491814727,5,2822,1360,-40
68492925878,68492925885,7,2653,1201,-40
68494892730,68494892735,5,2201,1498,-40
68495181166,68495181184,18,738,147,-40
68495357570,68495357564,-6,1225,433,-40
68496493426,68496493425,-1,1146,1510,-40
68497555896,68497555891,-5,1656,4239,-40
68506720394,68506720401,7,2592,1328,-40
68507948964,68507948957,-7,1241,3987,-40
68512744980,68512744999,19,491,3345,-40
68514378835,68514378841,6,3172,1305,-40
68516539511,68516539517,6,1701,1477,-40
68526377205,68526377211,6,3626,1248,-40
68527617248,68527617255,7,2671,1039,-40
68529073950,68529073955,5,3974,1318,-40
68529564357,68529564362,5,2439,1115,-40
68529759102,68529759109,7,2677,1516,-40
68530904677,68530904685,8,2355,1342,-40
68532563509,68532563514,5,2430,1034,-40
68534874758,68534874763,5,3100,1243,-40
68535175526,68535175533,7,2360,1494,-40
68546740953,68546740958,5,2528,1112,-40
68548108152,68548108157,5,3165,1508,-40
68552624673,68552624679,6,1948,1139,-40
68555949549,68555949556,7,2308,1012,-40
68556481426,68556481433,7,2899,1426,-40
68556657441,68556657447,6,2963,1111,-40
68558189021,68558189026,5,2270,1331,-40
68559176170,68559176169,-1,1252,1391,-40
68559433534,68559433520,-14,945,198,-40
68562650593,68562650596,3,1349,1441,-40
68567330595,68567330608,13,3883,1495,-40
68568267610,68568267593,-17,1483,565,-40
68568697478,68568697482,4,2615,1328,-40
68570284001,68570284007,6,3788,1774,-40
68572652839,68572652845,6,2344,997,-40
68579562130,68579562135,5,2124,1177,-40
68582058900,68582058905,5,1578,1571,-40
68583428620,68583428626,6,3654,1476,-40
68588466840,68588466848,8,3469,1041,-40
68589252290,68589252297,7,1267,191,-40
68590277741,68590277746,5,2595,1305,-40
68593881709,68593881715,6,2766,1405,-40
68597858520,68597858526,6,2283,841,-40
68600233413,68600233418,5,2920,1243,-40
68604839293,68604839298,5,3172,1403,-40
68608645016,68608645019,3,3188,1290,-40
68612011162,68612011170,8,4245,1977,-40
68615046250,68615046259,9,2321,1064,-40
68616638693,68616638698,5,2636,1467,-40
68618205642,68618205647,5,2422,980,-40
68620475882,68620475887,5,2892,1130,-40
68627661562,68627661569,7,2989,1579,-40
68631256734,68631256742,8,3150,1057,-40
68631811396,68631811403,7,3384,1730,-40
68633983266,68633983271,5,2516,1181,-40
68634036234,68634036235,1,1056,163,-40
68635551989,68635551994,5,2117,1330,-40
68635897794,68635897808,14,651,238,-40
68639987990,68639987995,5,1999,1732,-40
68640725612,68640725616,4,2133,1652,-40
68641817305,68641817310,5,1340,622,-40
68643787570,68643787575,5,1427,1405,-40
68646693054,68646693052,-2,21348,20243,-40
68646725650,68646725658,8,3050,927,-40
68647343135,68647343155,20,938,893,-40
68652412799,68652412805,6,2735,1553,-40
68652457233,68652457239,6,3102,1420,-40
68653237472,68653237477,5,3431,1336,-40
68653807911,68653807917,6,762,616,-40
68655880505,68655880512,7,2254,1090,-40
68661765001,68661764995,-6,1692,5811,-40
68663091918,68663091924,6,3303,1481,-40
68668055964,68668055967,3,3683,2849,-40
68668214155,68668214162,7,3004,1093,-40
68671059516,68671059523,7,2737,1518,-40
68671613198,68671613204,6,3106,989,-40
68674933154,68674933162,8,2751,1169,-40
68675877977,68675877981,4,2053,1257,-40
68676070881,68676070885,4,2711,1482,-40
68677175595,68677175578,-17,1168,287,-40
68680040903,68680040910,7,2789,934,-40
68680087313,68680087296,-17,3101,852,-40
68686714006,68686714008,2,3416,2441,-40
68690214529,68690214530,1,1452,1684,-40
68692400880,68692400880,0,1762,3046,-40
68692925029,68692925035,6,2062,635,-40
68705405972,68705405979,7,11800,1385,-40
68709787370,68709787375,5,2309,853,-40
68710368593,68710368577,-16,1679,627,-40
68711537846,68711537853,7,3129,1346,-40
68721004167,68721004173,6,3971,1317,-40
68721693030,68721693035,5,1765,903,-40
68723547170,68723547175,5,2261,954,-40
68724156142,68724156148,6,3786,1471,-40
68725383126,68725383131,5,2035,1135,-40
68727094531,68727094533,2,2016,1991,-40
68730992177,68730992183,6,1990,1092,-40
68733741009,68733741016,7,3148,1736,-40
68738197039,68738197046,7,2373,1268,-40
68741458058,68741458063,5,2561,1111,-40
68741522890,68741522889,-1,1276,2127,-40
68741944995,68741944995,0,1144,1653,-40
68742916472,68742916478,6,1494,1145,-40
68744007192,68744007180,-12,18636,15679,-40
68746589165,68746589170,5,2513,1166,-40
68747413510,68747413518,8,3022,1002,-40
68752022561,68752022570,9,3690,1287,-40
68755305994,68755305999,5,2842,1205,-40
68761131258,68761131263,5,2453,1099,-40
68763531523,68763531529,6,2276,882,-40
68768115602,68768115607,5,2142,1028,-40
68770255678,68770255684,6,3376,2034,-40
68778212352,68778212358,6,2544,764,-40
68781195914,68781195914,0,1045,1137,-40
68785951927,68785951934,7,3052,1276,-40
68786701166,68786701174,8,3270,1092,-40
68792576344,68792576349,5,3111,1042,-40
68794779433,68794779440,7,3188,2077,-40
68796960397,68796960404,7,4996,1655,-40
68797104734,68797104738,4,2391,772,-40
68800246501,68800246507,6,2312,1418,-40
68813524944,68813524950,6,3910,1151,-40
68813688657,68813688655,-2,4919,39529,-40
68818585912,68818585895,-17,2860,1432,-40
68818615578,68818615586,8,8916,1041,-40
68820156511,68820156528,17,878,371,-40
68824920298,68824920303,5,1365,1035,-40
68832001746,68832001755,9,1672,1103,-40
68834561608,68834561614,6,2505,1546,-40
68837684209,68837684214,5,1914,1067,-40
68839166843,68839166850,7,2394,1040,-40
68842852992,68842852997,5,1572,1382,-40
68852403898,68852403906,8,6839,1274,-40
68852445907,68852445908,1,1104,1526,-40
68852694816,68852694823,7,2540,1192,-40
68859646175,68859646179,4,1973,1265,-40
68860032734,68860032740,6,3164,1383,-40
68860199473,68860199467,-6,1896,451,-40
68861339587,68861339594,7,3873,1148,-40
68861876446,68861876438,-8,1585,531,-40
68864028647,68864028654,7,3353,1626,-40
68864691695,68864691704,9,2535,1020,-40
68868974043,68868974047,4,2416,1104,-40
68871922749,68871922755,6,2096,1072,-40
68872673533,68872673539,6,3293,1188,-40
68873254554,68873254555,1,1419,2234,-40
68874028020,68874028026,6,3944,1074,-40
68876772958,68876772966,8,2650,1077,-40
68879805686,68879805692,6,2250,1075,-40
68881903052,68881903049,-3,1170,3186,-40
68882237881,68882237888,7,2639,934,-40
68883175650,68883175656,6,3088,1583,-40
68893903901,68893903904,3,4233,3792,-40
68895811076,68895811081,5,3615,1639,-40
68895841333,68895841347,14,2999,1368,-40
68901220730,68901220735,5,2223,1027,-40
68901828670,68901828676,6,3109,1240,-40
68902910457,68902910462,5,2500,1017,-40
68902970232,68902970240,8,1542,229,-40
68909718575,68909718570,-5,4087,11458,-40
68911950855,68911950862,7,3565,1195,-40
68918241570,68918241576,6,3711,1637,-40
68925321346,68925321351,5,4041,1490,-40
68930918262,68930918267,5,2614,1275,-40
68932668757,68932668762,5,2509,936,-40
68935598478,68935598485,7,2536,1324,-40
68936224666,68936224669,3,1739,1870,-40
68936416514,68936416521,7,2516,944,-40
68936975459,68936975458,-1,605,168,-40
68938281705,68938281711,6,3086,1102,-40
68941008502,68941008498,-4,1101,3358,-40
68942162585,68942162590,5,2895,1448,-40
68942948373,68942948391,18,2985,44302,-40
68947772762,68947772767,5,2908,1301,-40
68948570331,68948570330,-1,643,943,-40
68950637464,68950637471,7,2845,1176,-40
68959459298,68959459305,7,2241,1262,-40
68960430529,68960430515,-14,2658,1195,-40
68964357170,68964357178,8,3810,1075,-40
68965133905,68965133888,-17,1082,246,-40
68966140850,68966140857,7,2804,1217,-40
68968226937,68968226943,6,3121,1218,-40
68968596243,68968596250,7,3652,1428,-40
68970682276,68970682283,7,2274,1105,-40
68971455704,68971455709,5,3333,1336,-40
68971559526,68971559504,-22,1736,712,-40
68972129872,68972129879,7,3401,1735,-40
68973837829,68973837835,6,1897,1365,-40
68976074164,68976074170,6,2936,1125,-40
68976470050,68976470058,8,3557,1406,-40
68981421999,68981422005,6,3531,1434,-40
68982426018,68982426025,7,2801,1264,-40
68986151365,68986151371,6,4481,1373,-40
68987625567,68987625573,6,2480,1380,-40
68988160674,68988160681,7,3534,1439,-40
68992149805,68992149812,7,3193,1354,-40
68995559698,68995559698,0,3438,3743,-40
69001452875,69001452881,6,2643,1854,-40
69006007118,69006007125,7,3801,1857,-40
69006916664,69006916669,5,2520,1044,-40
69007042011,69007042018,7,939,287,-40
69008997889,69008997893,4,2788,1209,-40
69009341331,69009341332,1,1790,2695,-40
69011523454,69011523460,6,3273,1696,-40
69016916378,69016916375,-3,1142,2811,-40
69018414949,69018414954,5,2071,949,-40
69019301223,69019301229,6,2167,1224,-40
69022192693,69022192699,6,3557,1594,-40
69022566248,69022566254,6,3076,1208,-40
69023394793,69023394798,5,2202,1248,-40
69027973042,69027973047,5,2094,1572,-40
69028056941,69028056946,5,3629,1200,-40
69029056121,69029056127,6,4089,1784,-40
69029616444,69029616450,6,3393,1436,-40
69031298127,69031298132,5,2709,1453,-40
69031578815,69031578811,-4,1015,283,-40
69031775222,69031775214,-8,1460,2974,-40
69038061918,69038061923,5,2136,793,-40
69038107258,69038107262,4,3174,1522,-40
69040909116,69040909115,-1,980,2236,-40
69041655809,69041655806,-3,1719,5537,-40
69042966962,69042966967,5,3879,1251,-40
69049364093,69049364099,6,2477,816,-40
69056269625,69056269630,5,1618,795,-40
69062452210,69062452217,7,2975,1557,-40
69064992458,69064992454,-4,948,3211,-40
69066123950,69066123956,6,3046,1149,-40
69069884659,69069884646,-13,1757,1102,-40
69070216719,69070216697,-22,1775,961,-40
69078500757,69078500767,10,15259,20439,-40
69079798136,69079798124,-12,963,197,-40
69083256329,69083256332,3,34959,24246,-40
69083823149,69083823154,5,2302,1180,-40
69084026706,69084026696,-10,906,262,-40
69085153661,69085153668,7,2354,1190,-40
69085733924,69085733932,8,2552,1411,-40
69086740833,69086740835,2,2430,2340,-40
69087223853,69087223859,6,3229,1514,-40
69087386522,69087386529,7,2317,1157,-40
69087515691,69087515673,-18,1337,536,-40
69090753031,69090753039,8,2908,1145,-40
69092185227,69092185233,6,3788,1308,-40
69100419980,69100419986,6,3616,1780,-40
69109813042,69109813050,8,4093,1079,-40
69112220786,69112220793,7,2131,994,-40
69115254455,69115254463,8,3358,1109,-40
69121427185,69121427190,5,2887,1778,-40
69122713657,69122713662,5,3188,794,-40
69124881278,69124881275,-3,1913,4745,-40
69125208770,69125208777,7,2854,1353,-40
69130473817,69130473823,6,4060,1605,-40
69130814459,69130814466,7,2194,1163,-40
69132132253,69132132259,6,2969,1357,-40
69132668410,69132668419,9,3605,1426,-40
69138837126,69138837133,7,3093,1262,-40
69138884403,69138884384,-19,1350,501,-40
69147956124,69147956128,4,2885,1804,-40
69150156714,69150156722,8,3357,1084,-40
69152190537,69152190542,5,2473,1214,-40
69153831866,69153831871,5,3337,1461,-40
69162817005,69162817010,5,3573,1503,-40
69162880802,69162880807,5,2402,1088,-40
69165725314,69165725300,-14,1642,485,-40
69170004853,69170004858,5,2733,1701,-40
69172885444,69172885451,7,2429,1381,-40
69176673883,69176673886,3,4165,18268,-40
69180709297,69180709302,5,2729,974,-40
69181446090,69181446073,-17,2714,1130,-40
69190969435,69190969441,6,1937,779,-40
69191141123,69191141116,-7,1650,339,-40
69191521418,69191521427,9,3235,1183,-40
69194430737,69194430742,5,2404,1317,-40
69195117710,69195117716,6,2776,1852,-40
69196543984,69196543983,-1,1986,3158,-40
69204074458,69204074465,7,3394,1665,-40
69205615855,69205615862,7,3350,1196,-40
69208264606,69208264610,4,2698,1200,-40
69208317451,69208317432,-19,915,581,-40
69217142919,69217142924,5,2629,1337,-40
69218501948,69218501954,6,4120,1530,-40
69222040727,69222040734,7,1312,1391,-40
69224348377,69224348383,6,2944,1355,-40
69224526049,69224526056,7,4024,1576,-40
69225420322,69225420330,8,3914,1549,-40
69225460301,69225460307,6,3649,2016,-40
69226751615,69226751611,-4,1157,2284,-40
69228122845,69228122851,6,2637,1069,-40
69232231961,69232231967,6,3824,1115,-40
69233082493,69233082498,5,3179,1475,-40
69234712972,69234712979,7,3246,1334,-40
69234770275,69234770282,7,3966,1695,-40
69237781523,69237781529,6,2484,1853,-40
69240627598,69240627601,3,2886,1324,-40
69243102748,69243102755,7,2508,1272,-40
69243310070,69243310088,18,3787,971,-40
69250316538,69250316542,4,2323,1366,-40
69250964198,69250964190,-8,1177,25428,-40
69253167322,69253167331,9,2714,1242,-40
69253310091,69253310094,3,1089,968,-40
69261633537,69261633543,6,2913,1423,-40
69262336638,69262336642,4,2545,1011,-40
69263315391,69263315398,7,2770,1416,-40
69266740750,69266740754,4,2627,1340,-40
69271163433,69271163439,6,2868,1589,-40
69272022826,69272022824,-2,1771,2704,-40
69280216174,69280216182,8,2986,1174,-40
69282041122,69282041127,5,1934,839,-40
69284037106,69284037115,9,4170,1260,-40
69285976230,69285976238,8,3183,994,-40
69286125194,69286125203,9,2690,1137,-40
69286255179,69286255163,-16,694,408,-40
69286513050,69286513035,-15,1227,437,-40
69287321827,69287321834,7,1187,1029,-40
69287482392,69287482392,0,1879,2655,-40
69291196895,69291196901,6,2933,973,-40
69292795178,69292795184,6,1893,1284,-40
69293043807,69293043815,8,2808,1378,-40
69301643728,69301643735,7,2906,979,-40
69302239166,69302239145,-21,3249,822,-40
69306453264,69306453271,7,4196,1326,-40
69306909338,69306909339,1,1175,1340,-40
69311935124,69311935131,7,2349,1222,-40
69312773382,69312773389,7,2180,1118,-40
69314582666,69314582685,19,2529,1077,-40
69315060293,69315060299,6,4133,1575,-40
69320840987,69320840993,6,2787,1426,-40
69328768765,69328768769,4,2123,1019,-40
69334651565,69334651571,6,3362,874,-40
69340048408,69340048414,6,1777,1065,-40
69342012234,69342012241,7,3209,1095,-40
69345986289,69345986286,-3,1507,3411,-40
69360759150,69360759153,3,1903,1415,-40
69363885702,69363885696,-6,15054,17410,-40
69364107302,69364107307,5,3055,1056,-40
69364210096,69364210102,6,2085,988,-40
69368303997,69368304004,7,20325,56531,-40
69371472697,69371472703,6,2581,1394,-40
69380395062,69380395069,7,3610,1665,-40
69381263993,69381263999,6,4142,944,-40
69381578954,69381578947,-7,566,84,-40
69382741514,69382741521,7,1927,1017,-40
69386174439,69386174421,-18,1228,425,-40
69387261422,69387261429,7,3024,1196,-40
69387892382,69387892388,6,2907,1158,-40
69390478155,69390478162,7,1972,658,-40
69392830208,69392830214,6,3412,879,-40
69393994046,69393994052,6,2761,1450,-40
69398906953,69398906961,8,2235,896,-40
69400897291,69400897295,4,3091,1195,-40
69401379041,69401379041,0,838,98,-40
69406954784,69406954790,6,2399,1453,-40
69408417594,69408417602,8,2732,1582,-40
69413829159,69413829149,-10,6426,15342,-40
69417186102,69417186109,7,2992,1309,-40
69420957668,69420957675,7,2793,1382,-40
69421094245,69421094258,13,3114,1330,-40
69422064610,69422064611,1,1074,1425,-40
69425649092,69425649099,7,3782,1697,-40
69425713070,69425713060,-10,1994,489,-40
69436995029,69436995037,8,2078,1273,-40
69437663690,69437663699,9,900,218,-40
69438879780,69438879778,-2,1833,2595,-40
69440183685,69440183681,-4,1764,1887,-40
69445914634,69445914638,4,715,417,-40
69447126261,69447126266,5,4101,1724,-40
69447522229,69447522241,12,1143,235,-40
69447683564,69447683548,-16,2119,1190,-40
69450052914,69450052913,-1,1278,3254,-40
69453124077,69453124077,0,1159,2179,-40
69458164135,69458164141,6,2670,1266,-40
69465577053,69465577058,5,3469,1178,-40
69466085922,69466085927,5,3605,1597,-40
69466498430,69466498438,8,2095,1024,-40
69471397712,69471397710,-2,1376,2852,-40
69471506449,69471506453,4,1465,1345,-40
69474189449,69474189456,7,2266,875,-40
69474343523,69474343512,-11,851,337,-40
69475823217,69475823223,6,3065,1276,-40
69476880896,69476880899,3,2927,1453,-40
69479826837,69479826842,5,2914,1746,-40
69484850943,69484850950,7,3131,1245,-40
69485510931,69485510937,6,16768,35406,-40
69486918962,69486918966,4,1719,824,-40
69492655698,69492655702,4,2350,1159,-40
69493912906,69493912914,8,2365,1388,-40
69494515652,69494515659,7,2445,923,-40
69496714209,69496714215,6,2701,1112,-40
69502134711,69502134718,7,2727,1436,-40
69504654019,69504654026,7,3185,1549,-40
69511294181,69511294186,5,1491,988,-40
69512627189,69512627194,5,2398,1134,-40
69512695329,69512695336,7,2270,1193,-40
69520164738,69520164743,5,4950,1981,-40
69527289644,69527289644,0,2955,3973,-40
69529111680,69529111686,6,2967,1300,-40
69529142718,69529142725,7,2359,1158,-40
69533459593,69533459606,13,16206,34967,-40
69545111203,69545111206,3,2491,1462,-40
69547796982,69547796990,8,2032,978,-40
69548422839,69548422846,7,2168,1217,-40
69549994386,69549994393,7,2675,1634,-40
69553451821,69553451826,5,3074,1359,-40
69556606327,69556606332,5,2985,1488,-40
69558081421,69558081426,5,3372,1138,-40
69558856016,69558856018,2,1136,1156,-40
69559510794,69559510801,7,3046,1854,-40
69561451023,69561451028,5,2244,1148,-40
69565082501,69565082501,0,1594,2291,-40
69566746331,69566746334,3,3486,2823,-40
69574424822,69574424835,13,24157,57843,-40
69576677603,69576677609,6,1314,660,-40
69577042516,69577042507,-9,1159,248,-40
69578262013,69578261992,-21,178,1510,-40
69584803073,69584803079,6,3391,1253,-40
69586295057,69586295063,6,2871,1598,-40
69589335690,69589335698,8,2796,1338,-40
69594547990,69594547988,-2,32024,1434,-40
69595100976,69595100982,6,2427,1382,-40
69595444258,69595444248,-10,1448,384,-40
69597010150,69597010146,-4,1328,2536,-40
69598176873,69598176878,5,3033,1471,-40
69603511326,69603511321,-5,968,2854,-40
69603943436,69603943442,6,2645,1202,-40
69611434680,69611434687,7,3702,908,-40
69612517194,69612517198,4,2518,1070,-40
69614409882,69614409890,8,2210,1083,-40
69618883154,69618883161,7,1690,1067,-40
69624965427,69624965434,7,3141,1023,-40
69625185398,69625185405,7,2926,950,-40
69626275881,69626275888,7,1523,822,-40
69626351450,69626351465,15,3666,1375,-40
69626464970,69626464976,6,1452,1082,-40
69628393699,69628393705,6,2834,1267,-40
69628435380,69628435392,12,3057,1478,-40
69630185207,69630185213,6,1910,981,-40
69630810663,69630810667,4,1952,1200,-40
69633676753,69633676771,18,1520,30462,-40
69634067415,69634067422,7,3056,1200,-40
69638795015,69638795022,7,2096,1341,-40
69639581742,69639581742,0,860,1402,-40
69639897185,69639897190,5,2217,1029,-40
69641954529,69641954537,8,3877,1757,-40
69643396522,69643396530,8,2656,1517,-40
69643902650,69643902658,8,2086,1087,-40
69644299834,69644299841,7,3448,1564,-40
69644365761,69644365769,8,857,236,-40
69646223459,69646223467,8,1937,1085,-40
69647553213,69647553219,6,3648,1769,-40
69653190462,69653190467,5,2861,1678,-40
69657390626,69657390621,-5,2050,6983,-40
69661206458,69661206466,8,5649,1039,-40
69665704733,69665704738,5,2945,1335,-40
69667832097,69667832098,1,1422,2006,-40
69669235304,69669235311,7,3143,1587,-40
69671856897,69671856903,6,3341,1047,-40
69673084663,69673084671,8,2301,782,-40
69673478879,69673478865,-14,4366,1297,-40
69673931693,69673931699,6,1463,1106,-40
69677337123,69677337128,5,2491,1173,-40
69677404120,69677404113,-7,1150,65,-40
69677706903,69677706906,3,2101,1551,-40
69678656546,69678656555,9,2673,968,-40
69679612977,69679612983,6,2497,835,-40
69680925134,69680925139,5,2056,1644,-40
69684275423,69684275425,2,1733,1572,-40
69684716731,69684716740,9,2329,1434,-40
69687506277,69687506284,7,1381,1842,-40
69689866669,69689866677,8,1770,793,-40
69692868010,69692868028,18,2928,1208,-40
69694403785,69694403765,-20,3566,1934,-40
69696181652,69696181638,-14,1797,411,-40
69696598689,69696598694,5,2685,1022,-40
69697636349,69697636355,6,2252,1112,-40
69698227154,69698227162,8,1025,181,-40
69702614913,69702614919,6,3002,876,-40
69704288235,69704288228,-7,1303,4242,-40
69706938217,69706938222,5,1805,1478,-40
69709956653,69709956655,2,1671,821,-40
69712140534,69712140553,19,969,1262,-40
69713775745,69713775752,7,3322,1176,-40
69714366173,69714366178,5,2498,1191,-40
69719586076,69719586083,7,3931,1402,-40
69721211490,69721211497,7,3329,842,-40
69722202325,69722202329,4,1823,1171,-40
69726423925,69726423930,5,2724,1226,-40
69726630849,69726630835,-14,1256,458,-40
69729777743,69729777739,-4,1094,1466,-40
69735564138,69735564143,5,1364,658,-40
69737361213,69737361219,6,4668,1156,-40
69737437978,69737437981,3,2918,1021,-40
69738052785,69738052783,-2,1219,2597,-40
69741910190,69741910197,7,2959,1275,-40
69743812074,69743812080,6,2505,1438,-40
69746584825,69746584831,6,1921,974,-40
69752733410,69752733416,6,2512,1430,-40
69753201031,69753201009,-22,1134,991,-40
69760165460,69760165466,6,1550,733,-40
69766340855,69766340860,5,2884,907,-40
69770148968,69770148974,6,2706,1504,-40
69770296638,69770296645,7,2170,1407,-40
69776000981,69776000990,9,2564,1292,-40
69789233933,69789233942,9,3012,1292,-40
69790952737,69790952743,6,1583,1244,-40
69791374744,69791374750,6,2931,1028,-40
69793261065,69793261071,6,3772,1518,-40
69804505417,69804505423,6,3043,1421,-40
69805777862,69805777867,5,2454,918,-40
69806953005,69806953010,5,1498,951,-40
69807502668,69807502674,6,2586,1121,-40
69807618778,69807618762,-16,2543,819,-40
69808152427,69808152435,8,3689,1496,-40
69808538870,69808538866,-4,1111,3102,-40
69812009359,69812009364,5,2731,2006,-40
69812436243,69812436249,6,3979,1405,-40
69814786241,69814786240,-1,2421,3863,-40
69817310063,69817310070,7,2751,1222,-40
69820071098,69820071082,-16,1918,879,-40
69821538271,69821538277,6,3341,1261,-40
69822069336,69822069343,7,1623,1008,-40
69822295653,69822295660,7,2765,1745,-40
69824871360,69824871365,5,2648,1402,-40
69831519049,69831519054,5,2439,1026,-40
69834792749,69834792755,6,2072,1273,-40
69837566733,69837566742,9,2771,1388,-40
69848439770,69848439775,5,2516,1500,-40
69848639798,69848639806,8,2860,1183,-40
69849836179,69849836186,7,4297,1561,-40
69850257593,69850257600,7,5586,1436,-40
69851974152,69851974157,5,3157,1330,-40
69852423439,69852423444,5,2026,964,-40
69859961820,69859961826,6,2629,1012,-40
69860590209,69860590216,7,2891,1755,-40
69862401678,69862401682,4,1591,1048,-40
69863403014,69863403011,-3,845,776,-40
69863523769,69863523753,-16,2669,1120,-40
69864891753,69864891759,6,2469,1384,-40
69866305488,69866305495,7,2440,1261,-40
69868976241,69868976246,5,2187,1391,-40
69873906582,69873906586,4,2763,863,-40
69878301525,69878301531,6,2616,1254,-40
69880940247,69880940255,8,2960,1237,-40
69882200855,69882200861,6,3125,1264,-40
69883633349,69883633354,5,2382,767,-40
69889462434,69889462441,7,2262,1470,-40
69893037991,69893037998,7,3190,1338,-40
69904207230,69904207234,4,2153,1541,-40
69904275149,69904275130,-19,2105,711,-40
69905696866,69905696872,6,2807,1071,-40
69905853040,69905853047,7,2838,1160,-40
69907848469,69907848474,5,2113,1676,-40
69914595673,69914595669,-4,1396,3514,-40
69915710103,69915710104,1,1737,1758,-40
69916206418,69916206418,0,660,1310,-40
69917636792,69917636799,7,2227,1130,-40
69919601924,69919601930,6,2061,895,-40
69922824431,69922824429,-2,1505,2815,-40
69923344370,69923344377,7,2426,1509,-40
69923541231,69923541228,-3,1095,2750,-40
69927975952,69927975958,6,2349,969,-40
69929019182,69929019186,4,2320,1212,-40
69930056362,69930056367,5,2045,1298,-40
69932166649,69932166655,6,4074,1441,-40
69940895417,69940895401,-16,2654,1547,-40
69941250579,69941250595,16,703,312,-40
69945467571,69945467578,7,3853,1612,-40
69946457069,69946457074,5,3090,1423,-40
69952177863,69952177869,6,1392,1083,-40
69954306086,69954306092,6,3069,1371,-40
69954448550,69954448555,5,2490,1281,-40
69954540754,69954540736,-18,2335,1221,-40
69956936795,69956936791,-4,1368,776,-40
69958315143,69958315150,7,3293,1742,-40
69958545735,69958545738,3,1853,1409,-40
69961098016,69961098021,5,2688,1502,-40
69963666463,69963666469,6,2500,1420,-40
69963903454,69963903460,6,2796,1180,-40
69963963346,69963963351,5,2442,1402,-40
69966262373,69966262378,5,1698,1156,-40
69966458878,69966458883,5,1769,1125,-40
69973826838,69973826843,5,3984,1640,-40
69983048287,69983048294,7,2663,1423,-40
69985444813,69985444819,6,2858,1440,-40
69990529153,69990529159,6,1897,1139,-40
69992011121,69992011127,6,1955,904,-40
69995965574,69995965581,7,3152,1712,-40
69995996021,69995996033,12,1405,271,-40
69996541662,69996541661,-1,1314,2087,-40
69997373798,69997373807,9,2425,1287,-40
70005237680,70005237696,16,828,1368,-40
70008117950,70008117954,4,3257,1108,-40
70009546513,70009546521,8,4084,1250,-40
70010244013,70010244034,21,3411,1143,-40
70010701347,70010701354,7,2910,1603,-40
70010960448,70010960454,6,3780,1701,-40
70011455473,70011455478,5,3537,1276,-40
70015095103,70015095103,0,882,1293,-40
70015776985,70015776990,5,2755,1422,-40
70020459742,70020459749,7,3831,1072,-40
70037383103,70037383112,9,2371,1408,-40
70038626903,70038626910,7,3820,1611,-40
70041016494,70041016498,4,3351,1040,-40
70042803878,70042803887,9,1899,866,-40
70043721101,70043721108,7,1770,781,-40
70058604033,70058604036,3,1619,821,-40
70058850829,70058850834,5,3112,1975,-40
70060469575,70060469582,7,2936,1393,-40
70064371627,70064371621,-6,1520,3509,-40
70064787937,70064787943,6,2196,1178,-40
70070796821,70070796826,5,2678,1207,-40
70071562809,70071562814,5,3478,1247,-40
70074673426,70074673431,5,4111,1526,-40
70076767898,70076767879,-19,3314,1625,-40
70078559981,70078559987,6,2908,1138,-40
70079306025,70079306032,7,2920,1665,-40
70079711819,70079711804,-15,2784,716,-40
70083465204,70083465207,3,1775,1626,-40
70085049454,70085049442,-12,1027,360,-40
70088106606,70088106612,6,3023,1003,-40
70089975241,70089975245,4,2032,1449,-40
70090780277,70090780283,6,2245,1129,-40
70091440077,70091440078,1,1105,1831,-40
70092515750,70092515755,5,3064,1256,-40
70093103669,70093103674,5,2552,1193,-40
70097387666,70097387673,7,4000,1609,-40
70100046696,70100046702,6,3816,1281,-40
70100333330,70100333338,8,2060,1661,-40
70100722662,70100722642,-20,4001,1153,-40
70105495373,70105495374,1,27653,28595,-40
70106695739,70106695746,7,3227,1449,-40
70107070026,70107070032,6,3431,1355,-40
70107422515,70107422520,5,3964,1552,-40
70107550109,70107550115,6,4987,875,-40
70109593546,70109593548,2,2148,1992,-40
70110045256,70110045262,6,1910,1184,-40
70110540178,70110540161,-17,1575,1503,-40
70110692470,70110692474,4,2333,1387,-40
70110860762,70110860767,5,3116,1606,-40
70113230166,70113230171,5,1533,870,-40
70113590406,70113590385,-21,2588,942,-40
70117019161,70117019169,8,1834,983,-40
70127508397,70127508405,8,3400,1302,-40
70128858594,70128858600,6,2426,1238,-40
70133277352,70133277359,7,2302,1255,-40
70134301032,70134301038,6,2024,836,-40
70135533818,70135533827,9,3132,1281,-40
70139026463,70139026474,11,4087,1355,-40
70140215962,70140215967,5,1955,1202,-40
70146177013,70146177020,7,1947,1089,-40
70147648963,70147648970,7,2152,1161,-40
70148962619,70148962627,8,1212,714,-40
70151505806,70151505810,4,4977,2219,-40
70154085708,70154085714,6,3583,1427,-40
70156432317,70156432303,-14,1686,648,-40
70156501323,70156501321,-2,1297,2120,-40
70168730336,70168730342,6,3452,1530,-40
70173708670,70173708677,7,2609,1133,-40
70181548502,70181548516,14,1928,1233,-40
70183016759,70183016766,7,3148,1051,-40
70188125739,70188125745,6,4115,1527,-40
70189876010,70189876019,9,3392,1298,-40
70196032505,70196032514,9,5739,1166,-40
70197407563,70197407545,-18,2686,1026,-40
70201425563,70201425570,7,2799,1234,-40
70204691194,70204691202,8,2312,1019,-40
70206323947,70206323953,6,2903,1730,-40
70210604969,70210604976,7,3660,1534,-40
70216069873,70216069879,6,2258,927,-40
70216590298,70216590313,15,850,127,-40
70216952393,70216952400,7,2859,900,-40
70218286519,70218286524,5,3156,1649,-40
70218797033,70218797041,8,2731,1080,-40
70224725115,70224725109,-6,835,4209,-40
70228318431,70228318439,8,3849,2070,-40
70230871902,70230871909,7,3331,1056,-40
70233117571,70233117576,5,2194,1578,-40
70236879963,70236879961,-2,1781,2191,-40
70237003350,70237003355,5,2894,1388,-40
70237312478,70237312483,5,2060,1230,-40
70241140210,70241140218,8,3230,2132,-40
70241635079,70241635086,7,3875,1475,-40
70242810395,70242810379,-16,2008,628,-40
70246029626,70246029631,5,2549,1388,-40
70247295602,70247295601,-1,1292,1649,-40
70251776338,70251776343,5,3010,1688,-40
70255102455,70255102447,-8,1399,2351,-40
70256428403,70256428406,3,1891,1537,-40
70261732633,70261732638,5,2859,1031,-40
70276437466,70276437472,6,2786,1204,-40
70277265817,70277265823,6,2215,1265,-40
70278648093,70278648098,5,2729,1444,-40
70282231053,70282231059,6,3334,1122,-40
70282994475,70282994483,8,2481,1110,-40
70283219806,70283219813,7,2061,932,-40
70283813985,70283813991,6,3258,1572,-40
70284758612,70284758618,6,5073,2349,-40
70285743511,70285743519,8,2242,1022,-40
70288284426,70288284414,-12,796,576,-40
70288945611,70288945617,6,2558,1104,-40
70288996122,70288996139,17,821,222,-40
70291045650,70291045657,7,2910,1385,-40
70291254690,70291254696,6,2797,1298,-40
70291473738,70291473742,4,2790,1268,-40
70293474655,70293474661,6,1615,1420,-40
70296464677,70296464683,6,2024,874,-40
70297046434,70297046438,4,2914,1402,-40
70298791227,70298791231,4,2302,1579,-40
70304195341,70304195346,5,2957,1103,-40
70305735342,70305735347,5,2651,1244,-40
70306410728,70306410736,8,14281,21494,-40
70306510465,70306510467,2,1031,1063,-40
70308144209,70308144216,7,1783,886,-40
70308529567,70308529570,3,1401,1361,-40
70309922194,70309922202,8,2510,1509,-40
70310922152,70310922136,-16,1286,334,-40
70312993014,70312993022,8,3694,1136,-40
70314846530,70314846537,7,2207,1416,-40
70318974467,70318974470,3,1172,1129,-40
70321218097,70321218103,6,3093,870,-40
70321849583,70321849564,-19,3661,1569,-40
70322372614,70322372622,8,3086,1245,-40
70322509893,70322509902,9,2284,1096,-40
70327086194,70327086201,7,3024,1141,-40
70330373191,70330373191,0,1611,2444,-40
70330629780,70330629787,7,4458,1599,-40
70331281559,70331281564,5,1696,752,-40
70333231198,70333231203,5,2268,1321,-40
70343798634,70343798642,8,1846,768,-40
70344352030,70344352039,9,3300,1431,-40
70346846483,70346846490,7,2963,1384,-40
70349057969,70349057975,6,2797,1409,-40
70360335394,70360335401,7,4656,1616,-40
70361773922,70361773900,-22,2631,1109,-40
70363026630,70363026634,4,2511,1647,-40
70364539402,70364539422,20,2531,1030,-40
70364737263,70364737250,-13,1300,286,-40
70366005804,70366005808,4,2120,1351,-40
70367850706,70367850711,5,2491,1343,-40
70368139710,70368139691,-19,1962,813,-40
70369028929,70369028934,5,2627,1489,-40
70370041233,70370041239,6,3633,1070,-40
70370393769,70370393773,4,2447,1583,-40
70370737622,70370737628,6,2852,1397,-40
70373965992,70373965995,3,2026,2123,-40
70374761009,70374761015,6,2721,1399,-40
70376929532,70376929539,7,4745,1811,-40
70381938650,70381938656,6,2968,1538,-40
70382645408,70382645414,6,1771,1393,-40
70387777974,70387777982,8,3034,780,-40
70392131745,70392131758,13,18470,58083,-40
70395369100,70395369106,6,3856,1748,-40
70400478770,70400478762,-8,1384,4945,-40
70401611590,70401611595,5,2583,1149,-40
70406483057,70406483040,-17,1964,873,-40
70407139580,70407139585,5,2995,1240,-40
70417435075,70417435079,4,2875,936,-40
70422634904,70422634910,6,3194,1517,-40
70425750857,70425750861,4,3306,1063,-40
70429776218,70429776225,7,2658,1326,-40
70430856805,70430856811,6,2610,1330,-40
70431012557,70431012563,6,4259,1136,-40
70436745582,70436745589,7,2641,823,-40
70437126078,70437126082,4,2902,1506,-40
70438911153,70438911158,5,2431,1049,-40
70439038747,70439038760,13,691,249,-40
70440023398,70440023393,-5,798,3687,-40
70443439103,70443439111,8,2901,1154,-40
70443518622,70443518628,6,2719,1277,-40
70443776869,70443776890,21,1147,833,-40
70449532086,70449532083,-3,761,993,-40
70451833885,70451833890,5,2338,1309,-40
70452619491,70452619480,-11,996,383,-40
70455230225,70455230230,5,3030,2123,-40
70455297466,70455297471,5,3750,1359,-40
70457650126,70457650132,6,4094,1319,-40
70458247913,70458247898,-15,1979,1131,-40
70463724686,70463724693,7,2481,1311,-40
70465636508,70465636513,5,3299,1515,-40
70467269785,70467269793,8,7253,1037,-40
70467665397,70467665403,6,4112,1878,-40
70467945751,70467945758,7,4274,1713,-40
70470296602,70470296608,6,2276,1316,-40
70472413915,70472413922,7,4050,1621,-40
70473708680,70473708687,7,2688,1410,-40
70473841330,70473841335,5,2599,1540,-40
70475638244,70475638250,6,3698,1624,-40
70481231874,70481231873,-1,1121,1215,-40
70482115638,70482115624,-14,530,479,-40
70482237146,70482237151,5,1473,1415,-40
70486783342,70486783342,0,1567,1743,-40
70487262014,70487262018,4,907,264,-40
70489386592,70489386598,6,1974,1197,-40
70490287438,70490287443,5,1972,1019,-40
70491320778,70491320786,8,3072,1194,-40
70496333531,70496333538,7,2955,1037,-40
70497086770,70497086776,6,2667,1337,-40
70498224114,70498224121,7,2692,1329,-40
70499120655,70499120661,6,2214,1606,-40
70501094673,70501094679,6,1964,795,-40
70501642674,70501642682,8,3355,1393,-40
70505426161,70505426161,0,1350,1683,-40
70507406517,70507406523,6,2260,1082,-40
70511014057,70511014062,5,3041,1183,-40
70512358094,70512358101,7,4165,1778,-40
70513749881,70513749887,6,2505,1046,-40
70518622554,70518622562,8,2456,1233,-40
70521727929,70521727935,6,2121,1300,-40
70526493129,70526493135,6,3720,1500,-40
70527310876,70527310874,-2,455,98,-40
70527735650,70527735657,7,2220,1180,-40
70527763510,70527763523,13,892,262,-40
70531716703,70531716683,-20,687,446,-40
70539405941,70539405946,5,3315,1336,-40
70543734275,70543734257,-18,844,352,-40
70544714036,70544714042,6,2978,1108,-40
70545173623,70545173630,7,2450,1349,-40
70545414368,70545414370,2,612,181,-40
70545837605,70545837609,4,3558,1802,-40
70546846087,70546846094,7,2618,1130,-40
70547647674,70547647681,7,2895,1616,-40
70550068814,70550068819,5,2935,1279,-40
70550508254,70550508235,-19,2625,1515,-40
70553491138,70553491144,6,3090,1836,-40
70553754082,70553754065,-17,3874,1224,-40
70560797687,70560797689,2,1589,2207,-40
70565032774,70565032781,7,2425,1044,-40
70567257507,70567257514,7,3851,1139,-40
70570834534,70570834542,8,3933,1422,-40
70571826900,70571826905,5,1915,1739,-40
70575585769,70575585775,6,2925,1104,-40
70575988869,70575988850,-19,662,177,-40
70582864397,70582864403,6,3353,1739,-40
70584275805,70584275810,5,2406,1400,-40
70591164289,70591164295,6,2653,989,-40
70592721705,70592721712,7,8040,2603,-40
70596209318,70596209323,5,2016,1318,-40
70598938553,70598938562,9,3303,1554,-40
70599345858,70599345854,-4,869,1594,-40
70601856542,70601856546,4,1419,1219,-40
70606630043,70606630050,7,2813,1666,-40
70607549661,70607549668,7,3048,1220,-40
70607639135,70607639116,-19,3042,1215,-40
70610434708,70610434714,6,1876,1180,-40
70614273010,70614273015,5,2434,1462,-40
70614700805,70614700811,6,5258,1884,-40
70616647558,70616647562,4,2262,958,-40
70622792313,70622792320,7,3379,1292,-40
70623096207,70623096186,-21,1586,459,-40
70623385057,70623385063,6,1957,627,-40
70627176652,70627176658,6,3201,1480,-40
70634920906,70634920914,8,3945,1388,-40
70635264870,70635264877,7,2477,1475,-40
70637205485,70637205490,5,2600,1364,-40
70645826402,70645826408,6,3314,1324,-40
70650688353,70650688358,5,2750,1401,-40
70652405901,70652405894,-7,1068,6610,-40
70661426850,70661426858,8,3397,1525,-40
70662481957,70662481962,5,2703,1440,-40
70663247026,70663247032,6,2187,1185,-40
70663696462,70663696480,18,2212,1082,-40
70664161569,70664161575,6,4085,1397,-40
70667668874,70667668892,18,778,230,-40
70668446585,70668446590,5,3404,1383,-40
70668605420,70668605427,7,2460,1150,-40
70668891873,70668891867,-6,837,334,-40
70671952962,70671952965,3,1867,1620,-40
70673072592,70673072598,6,4032,1653,-40
70678022785,70678022791,6,2278,1386,-40
70680353394,70680353396,2,2044,1519,-40
70680637387,70680637387,0,1418,2150,-40
70685244148,70685244155,7,3827,1599,-40
70687001065,70687001072,7,2924,1270,-40
70687317739,70687317743,4,1439,885,-40
70702871034,70702871034,0,7948,9267,-40
70705334187,70705334192,5,1822,1144,-40
70708974413,70708974419,6,2852,1255,-40
70713823282,70713823286,4,1643,1164,-40
70714101726,70714101706,-20,1984,1190,-40
70717745459,70717745464,5,1892,1341,-40
70721607880,70721607885,5,4889,2711,-40
70721908914,70721908919,5,2821,1369,-40
70727903246,70727903241,-5,1365,5701,-40
70732086438,70732086442,4,1891,1249,-40
70733953990,70733953996,6,1931,879,-40
70734663018,70734663025,7,962,218,-40
70735165691,70735165698,7,3520,1624,-40
70741584998,70741585006,8,3248,1343,-40
70744223168,70744223165,-3,908,1602,-40
70759635929,70759635934,5,2199,1115,-40
70761846842,70761846849,7,2980,1677,-40
70761942585,70761942590,5,2305,1504,-40
70764889022,70764889026,4,3148,1349,-40
70765135957,70765135962,5,2662,1685,-40
70769935649,70769935654,5,2270,1130,-40
70778059421,70778059428,7,2976,1156,-40
70779264230,70779264238,8,2885,1109,-40
70781382377,70781382383,6,2730,885,-40
70785070410,70785070418,8,2620,1189,-40
70791871174,70791871165,-9,613,4385,-40
70792759147,70792759160,13,8,1061,-40
70795368398,70795368405,7,2666,1648,-40
70797342809,70797342812,3,1748,1724,-40
70799310709,70799310714,5,2282,1229,-40
70800566057,70800566053,-4,1276,2710,-40
70801722718,70801722722,4,2159,1486,-40
70801811360,70801811365,5,2525,1005,-40
70805775942,70805775950,8,3179,1393,-40
70806587801,70806587804,3,2141,1321,-40
70807503058,70807503065,7,1953,1447,-40
70810157890,70810157897,7,1827,805,-40
70810255335,70810255313,-22,1184,504,-40
70814673361,70814673365,4,2592,1513,-40
70830697679,70830697681,2,1671,2264,-40
70830912471,70830912478,7,3637,1566,-40
70831542830,70831542836,6,3552,1435,-40
70839572111,70839572119,8,2574,1729,-40
70839622950,70839622955,5,2563,937,-40
70841272896,70841272902,6,2063,1083,-40
70843028092,70843028098,6,2655,1602,-40
70846595528,70846595534,6,3804,1558,-40
70849922561,70849922566,5,3290,1419,-40
70853241849,70853241854,5,3777,1794,-40
70856665920,70856665925,5,2857,1338,-40
70861200810,70861200817,7,2881,1744,-40
70877380913,70877380918,5,2765,1485,-40
70879752207,70879752204,-3,1440,2737,-40
70882042161,70882042167,6,2088,1352,-40
70885367954,70885367949,-5,1348,2866,-40
70885667654,70885667655,1,1118,822,-40
70886024997,70886025003,6,2494,1136,-40
70886650051,70886650034,-17,2287,943,-40
70890339165,70890339170,5,3577,1165,-40
70891064817,70891064822,5,2403,1274,-40
70891546389,70891546390,1,1928,1654,-40
70891964705,70891964711,6,2692,1293,-40
70893967341,70893967346,5,2905,1260,-40
70895508770,70895508777,7,3807,1538,-40
70898543502,70898543506,4,3127,1725,-40
70906289032,70906289035,3,5044,4314,-40
70907702853,70907702848,-5,1491,4571,-40
70914903938,70914903943,5,931,833,-40
70916689026,70916689031,5,3047,1651,-40
70919153897,70919153898,1,967,1305,-40
70923463469,70923463477,8,5153,1089,-40
70925869454,70925869460,6,2940,1493,-40
70926246962,70926246968,6,2945,1395,-40
70934570300,70934570307,7,3738,1488,-40
70935119542,70935119550,8,1515,786,-40
70936925570,70936925578,8,3287,1034,-40
70938512510,70938512514,4,5244,3130,-40
70944247262,70944247260,-2,1678,2698,-40
70945919659,70945919666,7,2821,1565,-40
70949355077,70949355082,5,3500,1410,-40
70951480181,70951480181,0,1380,2271,-40
70956445493,70956445494,1,2019,1354,-40
70965074758,70965074742,-16,1040,401,-40
70968152315,70968152320,5,5101,1630,-40
70970001189,70970001195,6,1398,1078,-40
70972057306,70972057313,7,2734,1320,-40
70972314778,70972314764,-14,1108,643,-40
70975204182,70975204188,6,2703,1134,-40
70975538998,70975539011,13,3807,1520,-40
70975893265,70975893273,8,905,445,-40
70976725971,70976725977,6,3088,1414,-40
70976834856,70976834866,10,794,326,-40
70979059267,70979059273,6,3411,1879,-40
70980393272,70980393275,3,2283,1530,-40
70988001441,70988001447,6,4544,1400,-40
70988679778,70988679782,4,2300,1014,-40
70993468857,70993468862,5,3475,1388,-40
70995344816,70995344822,6,3338,1327,-40
70995979947,70995979955,8,3221,1539,-40
70999659526,70999659529,3,2589,1390,-40
71000157138,71000157145,7,3313,1214,-40
71005326601,71005326607,6,3190,1004,-40
71008130886,71008130894,8,1977,1096,-40
71008407310,71008407298,-12,1263,454,-40
71014741110,71014741117,7,1971,1064,-40
71014862220,71014862242,22,1098,164,-40
71016117874,71016117872,-2,566,1686,-40
71017380634,71017380641,7,3220,1389,-40
71017911243,71017911250,7,2952,929,-40
71018165358,71018165336,-22,3314,1159,-40
71022155803,71022155810,7,2766,1254,-40
71022454202,71022454202,0,797,89,-40
71023148151,71023148157,6,3188,1710,-40
71023999493,71023999498,5,3491,1576,-40
71024481797,71024481802,5,1512,693,-40
71026068141,71026068141,0,4184,5853,-40
71028427924,71028427921,-3,21869,16645,-40
71029138851,71029138859,8,2259,1052,-40
71031891636,71031891642,6,3711,1561,-40
71031947761,71031947767,6,2213,1274,-40
71032296286,71032296267,-19,2722,1044,-40
71033649438,71033649445,7,3565,1569,-40
71041164963,71041164970,7,3814,1166,-40
71046777697,71046777705,8,2941,1482,-40
71047414074,71047414079,5,3369,1381,-40
71048547751,71048547758,7,3464,1917,-40
71053180709,71053180715,6,2467,904,-40
71054020075,71054020083,8,3814,1516,-40
71054124210,71054124216,6,2539,941,-40
71054607790,71054607795,5,1797,1101,-40
71059075924,71059075931,7,2553,1063,-40
71062842372,71062842378,6,3232,1520,-40
71067375692,71067375686,-6,832,2589,-40
71071067786,71071067790,4,2673,1291,-40
71072715886,71072715893,7,4426,1792,-40
71074417265,71074417271,6,2963,1414,-40
71075101775,71075101782,7,3793,1453,-40
71075222346,71075222329,-17,2788,949,-40
71078305870,71078305876,6,3190,1720,-40
71079261695,71079261672,-23,1166,516,-40
71079877536,71079877542,6,2705,1293,-40
71080473971,71080473978,7,2369,1318,-40
71082793918,71082793925,7,1248,509,-40
71087066002,71087066009,7,2442,1170,-40
71088498411,71088498423,12,917,319,-40
71088819480,71088819495,15,13108,45933,-40
71090470875,71090470870,-5,20836,8528,-40
71090850121,71090850126,5,3720,1663,-40
71091292863,71091292870,7,2349,828,-40
71098748728,71098748734,6,1708,1750,-40
71099144386,71099144372,-14,780,415,-40
71099580061,71099580066,5,2206,1210,-40
71103183000,71103183007,7,2392,753,-40
71111749203,71111749210,7,2246,1044,-40
71111855162,71111855171,9,3318,856,-40
71114137314,71114137319,5,3952,1403,-40
71114899636,71114899641,5,3031,1142,-40
71118167950,71118167955,5,4393,1503,-40
71121640881,71121640877,-4,1275,1970,-40
71124236561,71124236567,6,2742,1304,-40
71124295548,71124295554,6,2136,1236,-40
71124992121,71124992127,6,3462,1651,-40
71129882787,71129882793,6,2488,1092,-40
71129965870,71129965876,6,2870,1005,-40
71133208322,71133208329,7,2852,1201,-40
71136398399,71136398402,3,2663,1677,-40
71137837629,71137837634,5,3451,2063,-40
71142583926,71142583921,-5,850,2903,-40
71142639103,71142639110,7,3709,1876,-40
71146294362,71146294371,9,3710,1220,-40
71146832969,71146832976,7,3852,1315,-40
71147347810,71147347813,3,1882,1717,-40
71150238366,71150238374,8,3876,1547,-40
71152520297,71152520303,6,3002,1056,-40
71153398306,71153398311,5,3140,1019,-40
71159274449,71159274451,2,2712,1334,-40
71159501139,71159501146,7,3356,995,-40
71162298757,71162298762,5,3117,1509,-40
71162458486,71162458493,7,2087,1364,-40
71163425488,71163425495,7,2799,956,-40
71164401878,71164401882,4,878,361,-40
71164819063,71164819070,7,3488,1565,-40
71168388422,71168388432,10,13841,21952,-40
71170308587,71170308594,7,3287,1710,-40
71172378947,71172378955,8,1097,215,-40
71182170032,71182170038,6,2878,1115,-40
71186911638,71186911645,7,2372,1178,-40
71187730499,71187730506,7,3934,1058,-40
71188833534,71188833521,-13,2787,1006,-40
71191622682,71191622687,5,2460,1031,-40
71207263200,71207263206,6,3996,1352,-40
71216508521,71216508528,7,1820,793,-40
71218856425,71218856431,6,3228,1177,-40
71219705970,71219705953,-17,3080,807,-40
71220125166,71220125171,5,2960,1484,-40
71227702466,71227702473,7,2065,1317,-40
71229148006,71229148013,7,3353,1169,-40
71233027085,71233027090,5,3243,1523,-40
71236950580,71236950588,8,2423,857,-40
71238478027,71238478033,6,3564,1482,-40
71238971582,71238971594,12,461,47,-40
71240178410,71240178415,5,3050,1249,-40
71245941462,71245941467,5,3624,1811,-40
71247910509,71247910515,6,2573,1392,-40
71268321793,71268321799,6,2624,942,-40
71272919182,71272919182,0,1641,1971,-40
71274502861,71274502867,6,2901,1297,-40
71284228762,71284228769,7,4728,1484,-40
71284939753,71284939758,5,2446,1016,-40
71286319259,71286319252,-7,726,161,-40
71287755242,71287755246,4,1718,1321,-40
71290568547,71290568554,7,2166,1156,-40
71291527897,71291527903,6,2062,1009,-40
71292963863,71292963869,6,2934,1046,-40
71294252258,71294252262,4,1116,1022,-40
71296118889,71296118894,5,3588,1432,-40
71296583921,71296583927,6,3507,1139,-40
71296768954,71296768938,-16,2312,1156,-40
71297774376,71297774382,6,1994,1498,-40
71299925406,71299925413,7,2858,1290,-40
71304599746,71304599754,8,2035,1489,-40
71306145038,71306145043,5,2334,916,-40
71309323117,71309323123,6,1299,1003,-40
71309440676,71309440682,6,2844,1324,-40
71312590786,71312590790,4,2496,759,-40
71317026399,71317026405,6,2413,1243,-40
71319226272,71319226279,7,3068,1480,-40
71319752548,71319752553,5,2100,1360,-40
71325545290,71325545294,4,3092,1960,-40
71331422770,71331422777,7,3306,780,-40
71331628659,71331628674,15,924,229,-40
71340992542,71340992520,-22,6,437,-40
71342460096,71342460101,5,3169,1400,-40
71342723646,71342723654,8,2557,1116,-40
71344529398,71344529405,7,3206,1355,-40
71345449838,71345449845,7,3805,1675,-40
71346055470,71346055481,11,3015,1093,-40
71348220355,71348220353,-2,1292,1680,-40
71351455579,71351455585,6,2269,1187,-40
71352308201,71352308185,-16,818,303,-40
71358881775,71358881783,8,3388,1389,-40
71360208744,71360208750,6,2311,1438,-40
71363653386,71363653393,7,3661,1410,-40
71368575749,71368575750,1,2351,2611,-40
71372690111,71372690118,7,3437,2127,-40
71372765327,71372765335,8,2378,1036,-40
71374088181,71374088185,4,2732,1166,-40
71375547389,71375547394,5,2927,1453,-40
71382155098,71382155106,8,3602,1250,-40
71388177450,71388177455,5,2210,1328,-40
71389570299,71389570294,-5,913,2470,-40
71390658558,71390658563,5,2907,1213,-40
71407962512,71407962519,7,979,654,-40
71409562493,71409562501,8,2815,1263,-40
71414941038,71414941043,5,4217,2895,-40
71419788337,71419788337,0,1506,1700,-40
71426007826,71426007833,7,3211,1886,-40
71426635578,71426635568,-10,22276,17555,-40
71430074686,71430074690,4,2219,1305,-40
71430207660,71430207667,7,3520,1329,-40
71430637167,71430637146,-21,1374,542,-40
71432486571,71432486575,4,1089,775,-40
71436369635,71436369642,7,3004,1332,-40
71439802285,71439802292,7,2934,994,-40
71441419810,71441419815,5,1970,1342,-40
71445401672,71445401679,7,5533,1383,-40
71450347971,71450347977,6,2958,1109,-40
71451061457,71451061463,6,3126,1413,-40
71454174222,71454174222,0,1263,1073,-40
71462221957,71462221961,4,1503,1645,-40
71467848418,71467848423,5,2717,1596,-40
71468052047,71468052053,6,2090,1086,-40
71469190525,71469190536,11,2329,1262,-40
71475119052,71475119063,11,814,14706,-40
71475792328,71475792335,7,2633,822,-40
71476905490,71476905498,8,2381,1221,-40
71477106118,71477106114,-4,1402,229,-40
71477399102,71477399080,-22,2724,758,-40
71477980611,71477980615,4,2496,1016,-40
71489423701,71489423706,5,3809,1292,-40
71492362643,71492362651,8,4555,1551,-40
71492414618,71492414611,-7,862,299,-40
71493499618,71493499626,8,3440,1535,-40
71493645526,71493645534,8,3174,886,-40
71494388623,71494388629,6,3478,1555,-40
71495105190,71495105199,9,3052,1180,-40
71498656994,71498656998,4,2335,1598,-40
71503526433,71503526442,9,2132,683,-40
71505527020,71505527020,0,2893,3697,-40
71507138675,71507138682,7,3763,1324,-40
71510083535,71510083542,7,2886,1326,-40
71511192173,71511192181,8,3437,1212,-40
71514981362,71514981370,8,2418,1031,-40
71515697672,71515697679,7,2236,1124,-40
71517125542,71517125550,8,3020,1287,-40
71520913171,71520913175,4,1492,634,-40
71524139138,71524139146,8,3251,1230,-40
71530051341,71530051346,5,2926,1588,-40
71530572221,71530572217,-4,718,3214,-40
71530760354,71530760369,15,515,2657,-40
71531277314,71531277321,7,2417,1300,-40
71531841424,71531841430,6,4414,2323,-40
71532741793,71532741799,6,2615,1347,-40
71536111610,71536111616,6,2833,1410,-40
71539924174,71539924174,0,1533,1957,-40
71540669810,71540669809,-1,1375,1998,-40
71544612471,71544612474,3,1534,876,-40
71546072171,71546072177,6,2791,1279,-40
71557090845,71557090849,4,1923,922,-40
71560142211,71560142218,7,3343,1320,-40
71560420923,71560420917,-6,1058,6590,-40
71565910394,71565910394,0,1247,1533,-40
71566799958,71566799965,7,2273,1563,-40
71569014129,71569014135,6,4265,1820,-40
71569438332,71569438339,7,3707,1323,-40
71571598419,71571598425,6,3007,1265,-40
71575107446,71575107453,7,5155,1439,-40
71577582496,71577582489,-7,742,4592,-40
71581533718,71581533722,4,1900,1588,-40
71588671879,71588671884,5,2426,1689,-40
71592106821,71592106826,5,6273,2812,-40
71594133556,71594133562,6,3096,1238,-40
71602882388,71602882392,4,2316,1406,-40
71603948789,71603948794,5,1999,1165,-40
71604168836,71604168851,15,3086,1168,-40
71604823590,71604823598,8,4180,1681,-40
71604932234,71604932239,5,3025,1150,-40
71605540651,71605540658,7,1616,769,-40
71609940257,71609940262,5,2100,1402,-40
71614202141,71614202149,8,2781,1399,-40
71618159175,71618159182,7,3235,884,-40
71618216974,71618216995,21,2240,1353,-40
71622781083,71622781090,7,1338,1593,-40
71623407749,71623407754,5,1615,894,-40
71626490441,71626490446,5,3801,1473,-40
71626970598,71626970604,6,7246,2880,-40
71632494492,71632494498,6,4336,1792,-40
71632756802,71632756809,7,2995,1222,-40
71634882992,71634882998,6,2462,1350,-40
71638765686,71638765694,8,1530,793,-40
71642067900,71642067905,5,2843,1058,-40
71643460442,71643460447,5,3393,1187,-40
71650298858,71650298866,8,2132,1136,-40
71651929074,71651929079,5,2230,1413,-40
71653733506,71653733510,4,3652,2048,-40
71655551430,71655551434,4,2030,1452,-40
71659469330,71659469329,-1,1787,3257,-40
71661157227,71661157233,6,2211,847,-40
71663832045,71663832054,9,2962,1142,-40
71664045393,71664045398,5,2845,1643,-40
71669635802,71669635808,6,2767,1425,-40
71677582725,71677582729,4,2535,1643,-40
71679745662,71679745659,-3,19639,9609,-40
71680271898,71680271906,8,2539,1017,-40
71682035071,71682035072,1,1653,1904,-40
71686674543,71686674550,7,3149,1247,-40
71690922337,71690922341,4,2375,1024,-40
71696166998,71696167002,4,1431,841,-40
71700294453,71700294458,5,2216,1848,-40
71700408962,71700408962,0,1525,1796,-40
71701006278,71701006285,7,3199,1634,-40
71702254186,71702254195,9,3068,1422,-40
71707202638,71707202626,-12,809,2979,-40
71710168469,71710168475,6,3095,1161,-40
71711562701,71711562709,8,2799,1755,-40
71717005921,71717005928,7,3466,1192,-40
71718803547,71718803552,5,2259,1250,-40
71724861869,71724861875,6,2695,1015,-40
71725627700,71725627691,-9,958,190,-40
71732754285,71732754291,6,2876,1404,-40
71733226314,71733226321,7,3124,1449,-40
71735413894,71735413900,6,2757,1281,-40
71739097079,71739097086,7,3804,1445,-40
71740036235,71740036230,-5,1170,4068,-40
71745072346,71745072351,5,2492,1070,-40
71745400468,71745400452,-16,1079,17,-40
71746944078,71746944085,7,2896,1751,-40
71746983427,71746983434,7,3772,958,-40
71750211940,71750211946,6,1862,746,-40
71750433485,71750433491,6,2992,1854,-40
71751353881,71751353887,6,2524,1213,-40
71751443185,71751443187,2,2570,2179,-40
71753873214,71753873211,-3,1625,4269,-40
71755249894,71755249899,5,2801,914,-40
71757200045,71757200051,6,2557,1238,-40
71758169050,71758169055,5,1940,1270,-40
71760458651,71760458658,7,3275,1667,-40
71761066009,71761066014,5,1983,1010,-40
71762627605,71762627611,6,3444,1605,-40
71764470157,71764470163,6,2152,1233,-40
71766675489,71766675494,5,2295,1427,-40
71768496477,71768496484,7,3708,2139,-40
71773499033,71773499039,6,2954,1161,-40
71774072701,71774072706,5,699,133,-40
71780189360,71780189340,-20,3692,994,-40
71780285981,71780285963,-18,2392,952,-40
71788669565,71788669570,5,3003,1517,-40
71790073264,71790073270,6,3464,1310,-40
71793453422,71793453429,7,2153,1172,-40
71794216411,71794216418,7,2133,1352,-40
71797700215,71797700221,6,2448,1395,-40
71798029298,71798029304,6,3144,2139,-40
71799074973,71799074978,5,3225,1389,-40
71801520080,71801520085,5,2806,1008,-40
71804859718,71804859723,5,1910,1213,-40
71807045757,71807045762,5,3474,1604,-40
71808535725,71808535731,6,2780,1280,-40
71809403910,71809403932,22,2965,1104,-40
71814850347,71814850354,7,2743,1459,-40
71818130336,71818130342,6,4191,1205,-40
71819431058,71819431066,8,2476,1022,-40
71821217773,71821217778,5,3651,1637,-40
71822440343,71822440350,7,2948,1788,-40
71824436979,71824436966,-13,720,264,-40
71825001540,71825001546,6,3084,1289,-40
71825287287,71825287294,7,762,662,-40
71826699554,71826699561,7,2535,1252,-40
71826899511,71826899519,8,2750,1204,-40
71828639051,71828639058,7,3765,1303,-40
71835702069,71835702071,2,1457,1534,-40
71836503582,71836503587,5,4156,1644,-40
71837732557,71837732563,6,2661,1422,-40
71838110510,71838110488,-22,2435,907,-40
71841617191,71841617198,7,1949,1029,-40
71841937701,71841937694,-7,2521,9379,-40
71843356485,71843356491,6,2985,803,-40
71843567809,71843567813,4,1943,1311,-40
71846245946,71846245950,4,2816,1568,-40
71849490770,71849490774,4,1062,932,-40
71851286425,71851286433,8,2218,977,-40
71857489714,71857489719,5,1014,503,-40
71859428318,71859428323,5,3633,1166,-40
71861108415,71861108409,-6,1551,3258,-40
71865433031,71865433029,-2,971,2127,-40
71870868207,71870868213,6,2862,1175,-40
71872845367,71872845353,-14,1767,222,-40
71877912742,71877912747,5,2376,1070,-40
71885223522,71885223530,8,2969,1307,-40
71887368444,71887368449,5,1621,963,-40
71889534816,71889534822,6,2124,929,-40
71891241558,71891241564,6,3688,1476,-40
71893294777,71893294783,6,2467,999,-40
71897339508,71897339514,6,2307,1286,-40
71897473043,71897473054,11,12285,30848,-40
71897603506,71897603490,-16,640,118,-40
71901132999,71901133003,4,3033,1897,-40
71905542819,71905542827,8,3064,1385,-40
71905719549,71905719555,6,1832,1044,-40
71906029462,71906029470,8,2536,1009,-40
71907988853,71907988857,4,2758,1480,-40
71916091623,71916091630,7,3549,1071,-40
71916628184,71916628195,11,1895,1035,-40
71918155316,71918155322,6,2077,887,-40
71920057849,71920057855,6,1971,1136,-40
71921445466,71921445473,7,2764,1168,-40
71924038821,71924038829,8,2636,1024,-40
71924868444,71924868449,5,2651,1427,-40
71925187657,71925187655,-2,1530,3121,-40
71931521723,71931521721,-2,1032,1166,-40
71945020377,71945020382,5,2371,1081,-40
71947038969,71947038975,6,3334,1476,-40
71950346414,71950346421,7,2417,1283,-40
71950720104,71950720106,2,1375,1470,-40
71960482314,71960482323,9,3175,1543,-40
71960526847,71960526852,5,1853,1101,-40
71960567420,71960567433,13,2805,1031,-40
71962527560,71962527564,4,1835,1180,-40
71968028389,71968028394,5,2904,1271,-40
71968424760,71968424766,6,2451,1063,-40
71968830499,71968830482,-17,925,192,-40
71972648743,71972648750,7,3416,1074,-40
71973403270,71973403277,7,3484,1408,-40
71979715371,71979715374,3,2969,2938,-40
71980733651,71980733657,6,2864,1168,-40
71981718180,71981718171,-9,19385,26835,-40
71981924625,71981924631,6,3362,1888,-40
71984634521,71984634524,3,11211,23116,-40
71985360785,71985360790,5,2258,1325,-40
71988872865,71988872870,5,2973,1291,-40
71994797714,71994797722,8,2611,1063,-40
71996466210,71996466216,6,2780,1420,-40
71997683423,71997683428,5,1975,1664,-40
71998909062,71998909068,6,2799,975,-40
71999000234,71999000243,9,736,98,-40
72000570474,72000570480,6,1328,1192,-40
72008803806,72008803812,6,3282,1465,-40
72009713592,72009713593,1,1862,1954,-40
72010193969,72010193974,5,3177,1264,-40
72013090590,72013090592,2,1119,1498,-40
72015842945,72015842952,7,3176,1279,-40
72016559409,72016559413,4,2503,1150,-40
72017847602,72017847606,4,2354,1761,-40
72018169237,72018169244,7,2671,1447,-40
72019298443,72019298449,6,3669,1512,-40
72020737848,72020737848,0,1486,1446,-40
72028137825,72028137831,6,2011,1101,-40
72032267979,72032267986,7,3291,1138,-40
72032299126,72032299131,5,1524,1115,-40
72032377743,72032377747,4,2258,1036,-40
72033193613,72033193624,11,2375,1509,-40
72035505344,72035505350,6,2774,995,-40
72036454369,72036454375,6,2554,1513,-40
72041527469,72041527474,5,2350,1470,-40
72041654282,72041654291,9,3283,1157,-40
72047151474,72047151459,-15,1661,746,-40
72049417246,72049417255,9,3646,1242,-40
72051679543,72051679526,-17,84,1883,-40
72057675538,72057675545,7,3163,1167,-40
72057893025,72057893011,-14,2052,1028,-40
72060802017,72060802022,5,1792,1108,-40
72063168007,72063168012,5,1018,1046,-40
72069270128,72069270112,-16,3208,1017,-40
72069784297,72069784282,-15,1224,526,-40
72070323349,72070323355,6,2019,977,-40
72077491530,72077491538,8,3043,1497,-40
72080201751,72080201758,7,1276,664,-40
72087398914,72087398920,6,3461,1245,-40
72087438566,72087438548,-18,2829,1281,-40
72090095415,72090095409,-6,1261,3854,-40
72091342210,72091342210,0,2803,3597,-40
72094683346,72094683352,6,2725,1271,-40
72096356814,72096356817,3,2731,2070,-40
72099754570,72099754577,7,3408,1349,-40
72099840758,72099840765,7,3595,1616,-40
72104194126,72104194132,6,3645,1446,-40
72106044122,72106044127,5,3126,1315,-40
72110893930,72110893935,5,1877,1336,-40
72112397279,72112397286,7,4491,1334,-40
72117824020,72117824023,3,2025,1009,-40
72117963290,72117963296,6,3230,1096,-40
72122597181,72122597186,5,3098,1462,-40
72124370377,72124370383,6,2320,1211,-40
72125134243,72125134247,4,2380,898,-40
72126550858,72126550864,6,4348,1798,-40
72128497259,72128497265,6,3101,1300,-40
72132005807,72132005814,7,3112,1409,-40
72141758734,72141758742,8,3531,905,-40
72142540370,72142540365,-5,20846,13598,-40
72143839440,72143839431,-9,1318,260,-40
72146259476,72146259467,-9,1689,35331,-40
72149129258,72149129266,8,2554,1120,-40
72153822689,72153822691,2,2712,1553,-40
72157251601,72157251607,6,3289,1137,-40
72158145320,72158145326,6,2874,1489,-40
72159149526,72159149506,-20,645,89,-40
72171535766,72171535771,5,3751,1454,-40
72175026950,72175026955,5,4078,1806,-40
72175550460,72175550465,5,2931,1705,-40
72175619099,72175619081,-18,2625,786,-40
72178309354,72178309361,7,2996,1126,-40
72189013829,72189013825,-4,1292,2730,-40
72196471025,72196471030,5,2553,1250,-40
72202332128,72202332135,7,2547,1293,-40
72203392013,72203392013,0,1656,2060,-40
72204678228,72204678235,7,3435,1378,-40
72205161955,72205161961,6,2910,1365,-40
72206771706,72206771712,6,3207,1196,-40
72214898672,72214898678,6,3743,1908,-40
72215161331,72215161338,7,2296,983,-40
72217066184,72217066186,2,15965,17791,-40
72219471970,72219471975,5,2444,1074,-40
72219755511,72219755528,17,2544,853,-40
72219799650,72219799667,17,2713,1038,-40
72222533891,72222533898,7,2747,1749,-40
72224233713,72224233718,5,2773,1187,-40
72225076411,72225076416,5,3202,1879,-40
72227824752,72227824759,7,2991,1191,-40
72228152928,72228152935,7,3865,1412,-40
72231741631,72231741639,8,3048,1271,-40
72234068469,72234068475,6,2545,1031,-40
72235559461,72235559466,5,2718,1362,-40
72240677359,72240677365,6,3222,1287,-40
72242869614,72242869622,8,2348,1013,-40
72243245538,72243245546,8,2806,1248,-40
72243899484,72243899490,6,2263,1041,-40
72245575882,72245575887,5,3197,1101,-40
72245839373,72245839379,6,2952,1303,-40
72245893213,72245893218,5,1826,1007,-40
72245918699,72245918697,-2,1064,2625,-40
72247028514,72247028521,7,3336,1339,-40
72247621313,72247621319,6,2990,919,-40
72248835846,72248835844,-2,1288,2458,-40
72251974517,72251974524,7,4199,1151,-40
72254702242,72254702246,4,1681,1351,-40
72258618790,72258618793,3,3973,3111,-40
72259316534,72259316539,5,2438,1005,-40
72259852890,72259852895,5,3813,1453,-40
72260634043,72260634050,7,3610,1398,-40
72264569239,72264569245,6,2292,1821,-40
72277281278,72277281284,6,2826,1467,-40
72277346506,72277346491,-15,2007,917,-40
72277767368,72277767374,6,3024,1435,-40
72279119741,72279119746,5,3191,1414,-40
72282058051,72282058058,7,3378,1152,-40
72288430150,72288430156,6,2230,1404,-40
72294596816,72294596819,3,2148,1380,-40
72295980606,72295980612,6,2185,1747,-40
72306118250,72306118247,-3,1855,3391,-40
72306864664,72306864671,7,2329,1104,-40
72308579958,72308579966,8,3224,1494,-40
72309234358,72309234358,0,1024,1795,-40
72310228764,72310228772,8,3132,1352,-40
72314756717,72314756722,5,2482,1260,-40
72318377417,72318377423,6,2285,1237,-40
72319165763,72319165746,-17,1944,934,-40
72328815306,72328815311,5,2724,1463,-40
72345176429,72345176435,6,3358,1232,-40
72346869566,72346869573,7,2572,1247,-40
72348644612,72348644619,7,2574,941,-40
72348944032,72348944038,6,3057,1419,-40
72349533046,72349533052,6,3351,1673,-40
72350764001,72350764004,3,1679,1108,-40
72352427503,72352427505,2,13757,13434,-40
72353571787,72353571794,7,2627,1335,-40
72358651860,72358651867,7,1876,1404,-40
72360164912,72360164919,7,3687,1346,-40
72360220234,72360220238,4,3026,1328,-40
72361697790,72361697795,5,3222,1330,-40
72370293558,72370293565,7,3189,1258,-40
72377588867,72377588852,-15,2655,989,-40
72379610334,72379610339,5,1824,1119,-40
72379857478,72379857485,7,2107,1224,-40
72379931587,72379931571,-16,1030,417,-40
72382545075,72382545071,-4,882,1422,-40
72384008658,72384008663,5,2078,1161,-40
72386212445,72386212450,5,3568,1460,-40
72399323500,72399323506,6,3463,1368,-40
72399653982,72399653987,5,1659,904,-40
72403074414,72403074421,7,2875,1673,-40
72404883015,72404883021,6,2366,1041,-40
72407250481,72407250488,7,3264,1452,-40
72407335390,72407335376,-14,782,321,-40
72407802636,72407802622,-14,3390,1178,-40
72408467214,72408467220,6,4306,1604,-40
72412595262,72412595258,-4,712,1560,-40
72416026154,72416026162,8,3382,1764,-40
72416651692,72416651699,7,1771,783,-40
72423592671,72423592678,7,3069,1522,-40
72425209121,72425209119,-2,6615,10143,-40
72427770739,72427770745,6,2456,1227,-40
72430192685,72430192691,6,2701,974,-40
72432268197,72432268202,5,3652,1601,-40
72432915126,72432915125,-1,1207,1957,-40
72435371873,72435371880,7,4450,1171,-40
72435870928,72435870914,-14,2827,750,-40
72440001746,72440001753,7,3480,1220,-40
72444013697,72444013702,5,2462,871,-40
72445561532,72445561537,5,3355,1207,-40
72445731190,72445731197,7,1798,915,-40
72447301645,72447301651,6,3556,1850,-40
72449757684,72449757691,7,2557,1664,-40
72450122674,72450122682,8,2697,1482,-40
72454561142,72454561148,6,2934,1442,-40
72459665278,72459665281,3,1748,1112,-40
72461571994,72461572003,9,11121,19553,-40
72464861881,72464861887,6,3168,1663,-40
72467675231,72467675238,7,788,530,-40
72470181442,72470181458,16,14055,53265,-40
72470698001,72470698006,5,3058,1156,-40
72478313009,72478313015,6,3977,1324,-40
72478498350,72478498355,5,2396,1254,-40
72482058916,72482058913,-3,1396,3038,-40
72485221773,72485221779,6,1579,1228,-40
72488296113,72488296106,-7,920,340,-40
72489318702,72489318684,-18,1240,387,-40
72492319322,72492319330,8,2822,1381,-40
72496654407,72496654412,5,2159,1089,-40
72501211585,72501211591,6,2647,1566,-40
72502004193,72502004198,5,4430,1528,-40
72502560854,72502560859,5,2817,1254,-40
72506645525,72506645530,5,2278,1368,-40
72507727648,72507727654,6,2177,1236,-40
72508372610,72508372610,0,826,1235,-40
72510018372,72510018380,8,2573,1072,-40
72512860662,72512860668,6,3154,1357,-40
72513427642,72513427647,5,2750,1352,-40
72518890786,72518890791,5,2565,1047,-40
72522296407,72522296414,7,4135,1041,-40
72522890930,72522890914,-16,4765,1393,-40
72524461073,72524461078,5,2250,1078,-40
72526715149,72526715155,6,3312,1365,-40
72530102707,72530102714,7,3624,1464,-40
72530595666,72530595657,-9,20667,16667,-40
72532796333,72532796341,8,1745,834,-40
72536910086,72536910108,22,3115,954,-40
72539548783,72539548789,6,2410,1146,-40
72543664028,72543664036,8,1559,1036,-40
72546949049,72546949053,4,2943,1283,-40
72547312647,72547312635,-12,2780,1338,-40
72554076657,72554076662,5,34808,37654,-40
72560886982,72560886996,14,14750,56115,-40
72563537586,72563537593,7,2641,1576,-40
72570671152,72570671157,5,3216,1396,-40
72574968810,72574968817,7,963,1123,-40
72575884235,72575884241,6,3362,1648,-40
72576105474,72576105481,7,2750,1177,-40
72577097666,72577097674,8,2237,1401,-40
72578829254,72578829262,8,2993,1310,-40
72580478354,72580478362,8,3874,1604,-40
72582678883,72582678877,-6,1611,9305,-40
72585213372,72585213366,-6,1090,1423,-40
72588107684,72588107690,6,2105,1153,-40
72588647337,72588647343,6,3345,1157,-40
72592326834,72592326840,6,2198,1277,-40
72597023740,72597023746,6,4253,1314,-40
72597503274,72597503288,14,3568,887,-40
72606551343,72606551349,6,1713,1193,-40
72612424850,72612424855,5,3070,1440,-40
72613678657,72613678665,8,2344,1201,-40
72614451728,72614451734,6,2816,1170,-40
72614962351,72614962330,-21,1066,334,-40
72616584346,72616584352,6,2109,1201,-40
72617833690,72617833675,-15,1007,314,-40
72622189145,72622189150,5,1974,1762,-40
72623822137,72623822142,5,2773,1518,-40
72626953426,72626953434,8,3673,1598,-40
72630476522,72630476511,-11,1476,236,-40
72632439398,72632439404,6,3120,1493,-40
72634295860,72634295865,5,2020,1167,-40
72634399234,72634399235,1,1350,57,-40
72635337628,72635337608,-20,2235,730,-40
72635624869,72635624875,6,2183,796,-40
72637283035,72637283033,-2,1422,1756,-40
72639729120,72639729127,7,2699,1116,-40
72642179190,72642179198,8,3734,1160,-40
72642511830,72642511812,-18,3299,634,-40
72647481659,72647481666,7,2675,1446,-40
72648214858,72648214856,-2,1296,3332,-40
72650571596,72650571591,-5,29568,14222,-40
72652054690,72652054697,7,3202,1526,-40
72654665434,72654665439,5,2832,946,-40
72658024823,72658024829,6,2659,1456,-40
72658868597,72658868602,5,3526,1404,-40
72662294451,72662294469,18,470,1840,-40
72674043647,72674043654,7,2139,1192,-40
72678326029,72678326035,6,3240,1535,-40
72678427917,72678427922,5,2134,1019,-40
72678622026,72678622012,-14,1475,657,-40
72681893821,72681893828,7,3044,1214,-40
72684651733,72684651738,5,3149,1522,-40
72688291629,72688291635,6,3275,1789,-40
72689038365,72689038372,7,3050,1187,-40
72691665275,72691665282,7,2681,1078,-40
72695411538,72695411546,8,3199,1278,-40
72696247029,72696247035,6,2778,818,-40
72696940458,72696940467,9,1154,312,-40
72700382728,72700382730,2,1065,1257,-40
72705823003,72705823007,4,1734,847,-40
72705914324,72705914330,6,1855,1049,-40
72709923637,72709923634,-3,707,1336,-40
72711730419,72711730421,2,1707,1452,-40
72725791810,72725791818,8,3478,2036,-40
72730911655,72730911663,8,20448,46880,-40
72731221077,72731221083,6,2279,1426,-40
72732509577,72732509584,7,3529,1457,-40
72733309927,72733309934,7,3854,2021,-40
72734865054,72734865050,-4,622,1313,-40
72741174653,72741174659,6,2105,989,-40
72747943278,72747943285,7,3032,1188,-40
72747990913,72747990922,9,10049,37864,-40
72752014258,72752014265,7,2919,1467,-40
72754002546,72754002551,5,1333,461,-40
72754656130,72754656138,8,2756,1020,-40
72754791418,72754791425,7,1580,308,-40
72757704761,72757704769,8,4596,1824,-40
72758669983,72758669989,6,3870,1302,-40
72759820023,72759820031,8,2438,1594,-40
72760458518,72760458499,-19,3527,1186,-40
72761965359,72761965365,6,2896,1212,-40
72771791594,72771791599,5,2635,1307,-40
72772653686,72772653699,13,1987,219,-40
72773720926,72773720933,7,2687,1505,-40
72776614229,72776614234,5,2342,1143,-40
72780492152,72780492159,7,3621,979,-40
72784637478,72784637483,5,2102,1260,-40
72785180110,72785180116,6,2606,1219,-40
72787792806,72787792811,5,2500,1003,-40
72791439946,72791439953,7,4598,1998,-40
72792788119,72792788126,7,2223,1056,-40
72797641537,72797641542,5,2232,941,-40
72797868970,72797868984,14,2673,1153,-40
72803427870,72803427875,5,2740,1232,-40
72803458159,72803458166,7,2933,1410,-40
72820060783,72820060790,7,3084,1042,-40
72825011107,72825011114,7,2888,1115,-40
72827198595,72827198600,5,3228,1399,-40
72828383760,72828383748,-12,801,368,-40
72830124843,72830124849,6,3560,1474,-40
72836579451,72836579462,11,3623,1603,-40
72836888069,72836888075,6,2231,1114,-40
72837056673,72837056677,4,2182,1102,-40
72844246962,72844246968,6,3543,1271,-40
72844612289,72844612311,22,2904,995,-40
72845702714,72845702719,5,2707,1399,-40
72845736164,72845736148,-16,2504,821,-40
72846502357,72846502363,6,2368,1019,-40
72857385948,72857385953,5,1977,1867,-40
72857443442,72857443449,7,2567,1412,-40
72858967654,72858967662,8,3778,1112,-40
72861320566,72861320571,5,2927,1411,-40
72862069267,72862069250,-17,842,314,-40
72862869155,72862869155,0,1135,1524,-40
72864834751,72864834757,6,2863,1639,-40
72869658219,72869658226,7,2753,1011,-40
72873406558,72873406553,-5,1954,4885,-40
72873598534,72873598540,6,2182,1204,-40
72874922524,72874922530,6,2933,1375,-40
72877031184,72877031194,10,3090,675,-40
72879435178,72879435185,7,3242,1281,-40
72891711140,72891711145,5,2221,1293,-40
72895780293,72895780298,5,2394,1904,-40
72896007509,72896007515,6,2027,1124,-40
72897788014,72897788021,7,2968,1225,-40
72898849562,72898849567,5,3223,1435,-40
72900046905,72900046911,6,2844,1360,-40
72908080995,72908081002,7,1447,1043,-40
72923827935,72923827940,5,3352,1514,-40
72927753368,72927753374,6,3000,1145,-40
72928202494,72928202502,8,2279,1119,-40
72930499107,72930499113,6,3631,1411,-40
72931611967,72931611973,6,3956,1670,-40
72934413836,72934413842,6,2948,1231,-40
72935890601,72935890606,5,2597,917,-40
72938736518,72938736524,6,2467,1034,-40
72938882022,72938882033,11,612,106,-40
72943550270,72943550275,5,3042,1327,-40
72946608654,72946608655,1,1500,1571,-40
72948124359,72948124365,6,2085,1248,-40
72959413018,72959412997,-21,2642,1454,-40
72961792741,72961792747,6,4479,1471,-40
72963003207,72963003214,7,2053,1059,-40
72963065358,72963065358,0,1150,966,-40
72971419556,72971419562,6,3479,1453,-40
72975734885,72975734890,5,2594,1399,-40
72977439557,72977439563,6,2867,1333,-40
72983221894,72983221899,5,2263,1412,-40
72984282179,72984282199,20,1169,318,-40
72986252536,72986252542,6,2580,1458,-40
72986570901,72986570909,8,2935,1211,-40
72990196638,72990196646,8,3015,1141,-40
72991823051,72991823057,6,2771,1180,-40
72992718785,72992718790,5,2444,1271,-40
72994738201,72994738207,6,4272,1744,-40
72995222242,72995222248,6,3679,1312,-40
72995389209,72995389216,7,3222,1437,-40
72995744817,72995744826,9,1014,255,-40
73000729943,73000729951,8,3267,1560,-40
73004522378,73004522376,-2,719,1313,-40
73005151899,73005151905,6,2271,1012,-40
73006996957,73006996963,6,2404,733,-40
73011777698,73011777705,7,3316,1103,-40
73018421078,73018421084,6,2390,1126,-40
73019597849,73019597855,6,3259,1261,-40
73020452971,73020452971,0,2238,2360,-40
73022004055,73022004057,2,1490,1044,-40
73023060250,73023060243,-7,1778,4777,-40
73027651982,73027651987,5,2031,1473,-40
73027834018,73027834026,8,3740,1639,-40
73028279909,73028279915,6,1626,996,-40
73029986877,73029986881,4,1289,640,-40
73031241351,73031241359,8,3394,1397,-40
73032176039,73032176046,7,3036,1441,-40
73033196150,73033196155,5,1222,767,-40
73035084093,73035084100,7,3282,1689,-40
73035806153,73035806159,6,1473,1226,-40
73036551853,73036551857,4,1622,1235,-40
73044348917,73044348923,6,2728,1158,-40
73047883730,73047883735,5,1013,506,-40
73070132304,73070132309,5,2725,1394,-40
73070746942,73070746947,5,2016,1475,-40
73070796618,73070796622,4,2260,1357,-40
73072256027,73072256028,1,1155,1132,-40
73075406077,73075406082,5,2032,1036,-40
73076197133,73076197141,8,3987,1416,-40
73077967032,73077967038,6,4267,1520,-40
73079284566,73079284571,5,3680,1043,-40
73082375586,73082375591,5,3337,1474,-40
73085443313,73085443318,5,3494,1969,-40
73089283626,73089283626,0,998,1171,-40
73093032898,73093032904,6,2995,1416,-40
73093082624,73093082610,-14,2690,1360,-40
73094893229,73094893212,-17,3008,1267,-40
73107036965,73107036957,-8,874,4690,-40
73107283953,73107283958,5,2951,1481,-40
73108783797,73108783803,6,3634,1193,-40
73110701986,73110701992,6,2739,1139,-40
73119571300,73119571306,6,3176,1470,-40
73122535917,73122535925,8,3222,1445,-40
73126167852,73126167860,8,2361,788,-40
73129441602,73129441611,9,1725,1233,-40
73131768855,73131768863,8,2740,1485,-40
73132335237,73132335235,-2,1009,234,-40
73132384391,73132384409,18,4554,1451,-40
73132860487,73132860494,7,3613,1633,-40
73133062865,73133062862,-3,1439,3227,-40
73133257522,73133257527,5,1982,1168,-40
73134897479,73134897481,2,1582,1027,-40
73136243143,73136243150,7,2734,1574,-40
73138871411,73138871419,8,7264,965,-40
73139216432,73139216418,-14,3656,1223,-40
73139624066,73139624074,8,2401,1075,-40
73144674433,73144674439,6,2929,1114,-40
73155325898,73155325902,4,2840,1403,-40
73157045102,73157045107,5,2917,1640,-40
73159472244,73159472249,5,1595,914,-40
73169321378,73169321370,-8,36718,9597,-40
73171170789,73171170794,5,2885,1198,-40
73171244834,73171244832,-2,1066,309,-40
73176807930,73176807935,5,2129,1256,-40
73181149789,73181149797,8,2932,1345,-40
73181571985,73181571986,1,1436,2608,-40
73182550579,73182550585,6,3047,1885,-40
73183659752,73183659746,-6,1890,6538,-40
73184501406,73184501413,7,2879,1194,-40
73190380946,73190380953,7,2816,1141,-40
73195964366,73195964375,9,2090,1331,-40
73195998336,73195998331,-5,988,254,-40
73196697998,73196697998,0,1610,2164,-40
73199489210,73199489210,0,1648,1962,-40
73201795680,73201795687,7,2938,1221,-40
73203817084,73203817090,6,2563,1246,-40
73205365494,73205365500,6,3133,1433,-40
73212329333,73212329338,5,2649,1387,-40
73212396306,73212396320,14,3956,1690,-40
73212550192,73212550199,7,2592,1357,-40
73214168542,73214168547,5,1564,916,-40
73216015942,73216015949,7,3851,1764,-40
73225206255,73225206262,7,3107,1192,-40
73229895342,73229895349,7,2788,1552,-40
73229964939,73229964923,-16,2345,1052,-40
73230244663,73230244670,7,2535,1198,-40
73230608710,73230608715,5,3275,1685,-40
73231895095,73231895103,8,2137,1061,-40
73235057033,73235057038,5,1900,823,-40
73235285842,73235285847,5,2231,1113,-40
73246314391,73246314398,7,2922,1209,-40
73247364636,73247364637,1,2147,1781,-40
73249272744,73249272751,7,2900,1434,-40
73250724438,73250724438,0,1381,2243,-40
73252908539,73252908545,6,2754,1801,-40
73260948674,73260948681,7,3050,1100,-40
73266128833,73266128839,6,3278,988,-40
73269085175,73269085183,8,3282,1323,-40
73276695717,73276695723,6,2582,1164,-40
73277056749,73277056754,5,3381,1138,-40
73277582974,73277582954,-20,879,285,-40
73278635118,73278635121,3,2280,1651,-40
73279617473,73279617478,5,2470,1021,-40
73279762867,73279762873,6,2716,1784,-40
73279831461,73279831440,-21,2099,539,-40
73284308910,73284308917,7,2803,1474,-40
73284704903,73284704892,-11,737,152,-40
73286637719,73286637726,7,2354,1283,-40
73286719114,73286719117,3,1767,2076,-40
73291714761,73291714766,5,1589,2179,-40
73298049388,73298049394,6,2701,1125,-40
73298696161,73298696166,5,1958,1235,-40
73300719789,73300719794,5,2525,1477,-40
73301039903,73301039909,6,2607,1621,-40
73301089674,73301089659,-15,817,503,-40
73302167929,73302167935,6,3491,1293,-40
73305509092,73305509099,7,2716,1015,-40
73310383822,73310383829,7,2455,853,-40
73311899190,73311899195,5,2888,1389,-40
73314860444,73314860450,6,2891,1250,-40
73317384549,73317384555,6,2117,843,-40
73320827262,73320827269,7,2236,1378,-40
73326425710,73326425717,7,3950,1597,-40
73327450759,73327450766,7,2063,762,-40
73329698168,73329698187,19,694,1282,-40
73330022735,73330022742,7,3256,1719,-40
73330214537,73330214520,-17,1447,912,-40
73334138193,73334138197,4,1734,1119,-40
73336998978,73336998984,6,2409,1346,-40
73340553466,73340553474,8,2094,1060,-40
73340957618,73340957624,6,2505,1222,-40
73346303583,73346303589,6,2585,1078,-40
73352533887,73352533893,6,3430,1580,-40
73356914994,73356914997,3,1674,2103,-40
73369164982,73369164987,5,2742,1084,-40
73370136608,73370136626,18,4260,1389,-40
73373601266,73373601274,8,2208,812,-40
73378439935,73378439940,5,2329,1332,-40
73378615683,73378615689,6,656,350,-40
73382357083,73382357079,-4,2787,43794,-40
73387190057,73387190062,5,1775,1247,-40
73388502656,73388502663,7,2042,1009,-40
73389304338,73389304344,6,3456,1507,-40
73389777057,73389777075,18,1738,401,-40
73389841929,73389841946,17,807,162,-40
73391104702,73391104707,5,1925,1137,-40
73393114541,73393114547,6,3552,1541,-40
73398466171,73398466177,6,2938,1331,-40
73399988857,73399988863,6,3255,1117,-40
73404640102,73404640109,7,2789,1180,-40
73404854258,73404854265,7,2961,1127,-40
73404937438,73404937424,-14,687,467,-40
73409515655,73409515662,7,4713,1545,-40
73410906830,73410906828,-2,513,1232,-40
73413437819,73413437818,-1,1362,2418,-40
73413660890,73413660897,7,3400,1411,-40
73414448271,73414448278,7,4445,1712,-40
73415601249,73415601255,6,3228,1408,-40
73417634225,73417634231,6,3518,1971,-40
73417666718,73417666724,6,2448,1677,-40
73425928936,73425928941,5,1592,1129,-40
73427397031,73427397017,-14,3049,1285,-40
73427614650,73427614636,-14,2349,637,-40
73432638584,73432638590,6,2874,1367,-40
73434708404,73434708411,7,2025,961,-40
73435154658,73435154644,-14,1442,706,-40
73436679966,73436679971,5,1145,542,-40
73438330145,73438330149,4,2771,1232,-40
73447438859,73447438867,8,3794,1120,-40
73451739890,73451739896,6,3420,1396,-40
73453823785,73453823790,5,1823,845,-40
73455477066,73455477070,4,2002,1068,-40
73456180549,73456180532,-17,1093,258,-40
73461371112,73461371117,5,3160,1328,-40
73462111318,73462111296,-22,1613,795,-40
73464208381,73464208386,5,3674,1882,-40
73465420061,73465420066,5,2358,1531,-40
73470999282,73470999289,7,8239,38234,-40
73473383441,73473383447,6,2352,1011,-40
73475290005,73475290011,6,3637,1608,-40
73476130954,73476130961,7,2474,1292,-40
73480532679,73480532682,3,1710,1440,-40
73481528670,73481528674,4,1619,813,-40
73491772056,73491772063,7,1992,1087,-40
73492379166,73492379173,7,3354,1448,-40
73492957778,73492957783,5,2824,2256,-40
73496041138,73496041138,0,2061,1798,-40
73500032136,73500032130,-6,1552,7358,-40
73502214482,73502214491,9,13286,37261,-40
73502477591,73502477597,6,2692,1560,-40
73509958722,73509958728,6,974,499,-40
73512076134,73512076139,5,2914,1552,-40
73516369158,73516369165,7,2896,1233,-40
73521731504,73521731510,6,2914,1216,-40
73521801773,73521801754,-19,3618,1274,-40
73523178825,73523178831,6,2835,1239,-40
73523307090,73523307089,-1,1234,2073,-40
73526366631,73526366638,7,3475,1412,-40
73527003476,73527003484,8,3697,1010,-40
73527439381,73527439386,5,2375,1980,-40
73528224615,73528224617,2,1820,1604,-40
73528382946,73528382952,6,3675,1078,-40
73537101506,73537101514,8,2844,1250,-40
73541242606,73541242615,9,3501,1036,-40
73542091039,73542091046,7,2341,1097,-40
73544755774,73544755779,5,3698,1236,-40
73547694784,73547694791,7,3790,1483,-40
73547950703,73547950711,8,4363,1752,-40
73550083556,73550083558,2,1858,1727,-40
73551363085,73551363090,5,2395,1160,-40
73552611182,73552611187,5,2504,925,-40
73554206671,73554206678,7,3287,1093,-40
73555622917,73555622923,6,3646,1387,-40
73557357638,73557357646,8,3043,957,-40
73557569702,73557569682,-20,2212,742,-40
73560302218,73560302224,6,2383,1110,-40
73563037537,73563037543,6,3735,1921,-40
73567354594,73567354599,5,2342,1149,-40
73569154707,73569154714,7,1232,909,-40
73570250782,73570250772,-10,1207,387,-40
73576226911,73576226918,7,2359,1190,-40
73581354683,73581354690,7,5940,3276,-40
73582218802,73582218809,7,3140,1306,-40
73584797704,73584797710,6,3025,1024,-40
73586179521,73586179527,6,2349,1146,-40
73590184204,73590184210,6,4080,1437,-40
73591724250,73591724255,5,3176,1277,-40
73596236790,73596236796,6,2365,1825,-40
73603811334,73603811339,5,2980,1447,-40
73605692790,73605692768,-22,2081,962,-40
73605844594,73605844602,8,2960,732,-40
73606706329,73606706324,-5,1189,5127,-40
73609207696,73609207702,6,2897,1434,-40
73617515711,73617515718,7,2646,1358,-40
73618231767,73618231755,-12,2401,976,-40
73621697614,73621697618,4,1438,896,-40
73625821785,73625821790,5,1803,1299,-40
73626970048,73626970055,7,3125,1133,-40
73635485366,73635485372,6,2069,1408,-40
73637647305,73637647311,6,3025,1224,-40
73638154695,73638154703,8,2551,1190,-40
73639357327,73639357312,-15,1240,248,-40
73643966098,73643966105,7,2955,1242,-40
73644851605,73644851586,-19,3745,1463,-40
73645085048,73645085055,7,2102,1115,-40
73647174462,73647174466,4,1382,1622,-40
73650755685,73650755690,5,2630,1653,-40
73651556722,73651556729,7,3458,1236,-40
73654261254,73654261261,7,2707,1435,-40
73658289205,73658289211,6,3369,1914,-40
73658439256,73658439262,6,2522,857,-40
73659177172,73659177178,6,1594,1119,-40
73660258481,73660258486,5,2599,1269,-40
73662370978,73662370986,8,2543,1332,-40
73667190873,73667190878,5,3192,1295,-40
73667384639,73667384627,-12,924,568,-40
73668410701,73668410706,5,2030,1142,-40
73670553773,73670553778,5,2356,1032,-40
73671435920,73671435926,6,2803,1609,-40
73672203243,73672203226,-17,1179,604,-40
73673700295,73673700306,11,11943,26637,-40
73674051252,73674051257,5,3256,1725,-40
73675288726,73675288734,8,2537,744,-40
73677131145,73677131150,5,1926,1005,-40
73678584423,73678584408,-15,1428,604,-40
73679234285,73679234290,5,3285,1367,-40
73680600870,73680600877,7,2694,1590,-40
73683123041,73683123046,5,2210,1161,-40
73685873205,73685873212,7,3100,1714,-40
73687044462,73687044470,8,1820,961,-40
73687824422,73687824443,21,900,269,-40
73688792742,73688792747,5,3045,1472,-40
73689524637,73689524657,20,2846,1377,-40
73690896941,73690896946,5,2978,1534,-40
73693303853,73693303857,4,1691,1092,-40
73695081445,73695081450,5,2881,1330,-40
73699744730,73699744724,-6,1354,3621,-40
73700217125,73700217131,6,2846,1569,-40
73703784861,73703784865,4,2439,1235,-40
73705614150,73705614159,9,2954,1410,-40
73706939969,73706939974,5,3240,1492,-40
73710916211,73710916217,6,2615,1178,-40
73712532809,73712532811,2,1963,1535,-40
73717898966,73717898971,5,2305,1308,-40
73720611473,73720611482,9,3025,1382,-40
73722260382,73722260386,4,2954,1888,-40
73724269703,73724269711,8,3103,1304,-40
73724618322,73724618307,-15,2585,920,-40
73725670460,73725670467,7,2839,1295,-40
73725719777,73725719782,5,1814,750,-40
73727641467,73727641475,8,3453,1285,-40
73731393271,73731393277,6,3385,1311,-40
73734780726,73734780733,7,2893,1225,-40
73738744625,73738744632,7,2027,890,-40
73740815456,73740815473,17,2530,1300,-40
73741363237,73741363242,5,22501,18121,-40
73746108086,73746108097,11,15019,38728,-40
73746285181,73746285185,4,3066,1666,-40
73747263182,73747263187,5,3348,1315,-40
73749153427,73749153434,7,3602,1470,-40
73749246806,73749246816,10,681,468,-40
73754259425,73754259431,6,3565,1723,-40
73755672702,73755672703,1,3405,3454,-40
73758368742,73758368751,9,1789,965,-40
73759452391,73759452398,7,2649,1278,-40
73766695073,73766695079,6,2814,1305,-40
73775390878,73775390883,5,2189,1159,-40
73776139811,73776139819,8,2950,1424,-40
73776546417,73776546404,-13,3549,1218,-40
73777083286,73777083293,7,2805,1102,-40
73780882745,73780882741,-4,1482,2772,-40
73788006254,73788006258,4,2520,1183,-40
73792752070,73792752077,7,2793,1688,-40
73792809377,73792809383,6,2215,1350,-40
73793617622,73793617628,6,2514,906,-40
73795411551,73795411546,-5,2333,6330,-40
73796941214,73796941221,7,2707,1162,-40
73797159869,73797159880,11,3198,1043,-40
73803377706,73803377711,5,2446,1208,-40
73804142778,73804142784,6,3263,1311,-40
73808312641,73808312647,6,3600,1383,-40
73808614314,73808614300,-14,2963,913,-40
73810517572,73810517580,8,17141,33405,-40
73811322613,73811322608,-5,1722,7275,-40
73823837925,73823837931,6,3149,1373,-40
73827941011,73827941018,7,3084,1167,-40
73830021091,73830021097,6,2346,1208,-40
73831247611,73831247618,7,1990,1163,-40
73832351577,73832351585,8,3730,1050,-40
73835100982,73835100988,6,3564,1560,-40
73835987902,73835987907,5,1081,686,-40
73837923449,73837923437,-12,22,949,-40
73844036637,73844036643,6,4363,1623,-40
73846862009,73846862015,6,3226,954,-40
73849821459,73849821466,7,2857,1517,-40
73850333170,73850333177,7,2720,1244,-40
73851191993,73851191999,6,2450,1289,-40
73852361483,73852361489,6,3031,1217,-40
73853794466,73853794471,5,2199,1059,-40
73857758530,73857758536,6,2759,1420,-40
73858337824,73858337830,6,4027,2012,-40
73858541914,73858541920,6,2470,1316,-40
73863224861,73863224861,0,1117,1295,-40
73863795133,73863795120,-13,932,404,-40
73864690235,73864690238,3,1664,1393,-40
73866495947,73866495957,10,3671,1703,-40
73867685007,73867685014,7,3678,1094,-40
73868083427,73868083433,6,1973,846,-40
73868176258,73868176242,-16,858,340,-40
73869191223,73869191229,6,2030,1174,-40
73880071693,73880071701,8,3416,1627,-40
73880301610,73880301617,7,2293,1333,-40
73880419836,73880419819,-17,2318,1214,-40
73883275360,73883275366,6,3255,1446,-40
73886647514,73886647521,7,2911,1572,-40
73887123161,73887123167,6,2955,1325,-40
73888426992,73888426998,6,1911,1220,-40
73890367185,73890367191,6,2578,1179,-40
73891082464,73891082459,-5,2161,7195,-40
73891204613,73891204619,6,2561,1434,-40
73891576367,73891576355,-12,976,674,-40
73897893046,73897893053,7,3443,1207,-40
73901551778,73901551784,6,3014,2029,-40
73906673789,73906673793,4,2212,1312,-40
73906901275,73906901288,13,712,263,-40
73909436611,73909436613,2,3496,26159,-40
73910481666,73910481674,8,2998,1158,-40
73910830599,73910830605,6,4140,1728,-40
73911939823,73911939831,8,2898,1384,-40
73914815992,73914815992,0,1602,2033,-40
73917291325,73917291329,4,1782,933,-40
73917730413,73917730418,5,2460,1407,-40
73920284273,73920284279,6,2818,1508,-40
73923657228,73923657234,6,2235,1001,-40
73924818565,73924818569,4,3177,1752,-40
73924994447,73924994466,19,1271,249,-40
73932632254,73932632260,6,2943,1357,-40
73933508872,73933508878,6,2584,1741,-40
73936802559,73936802559,0,2110,2083,-40
73938881514,73938881508,-6,1277,816,-40
73940678961,73940678967,6,1938,761,-40
73941226172,73941226164,-8,1045,3088,-40
73945321564,73945321571,7,2519,1360,-40
73946497154,73946497163,9,3370,1566,-40
73947355402,73947355410,8,3963,1287,-40
73950504946,73950504953,7,3082,964,-40
73950732947,73950732929,-18,1335,462,-40
73954053258,73954053242,-16,2969,1002,-40
73954125978,73954125985,7,2872,1210,-40
73954834216,73954834203,-13,1992,856,-40
73957261337,73957261343,6,3170,1454,-40
73959908901,73959908905,4,3801,1453,-40
73962740614,73962740618,4,2544,1268,-40
73965560328,73965560334,6,2254,941,-40
73965948054,73965948051,-3,1135,351,-40
73968284671,73968284672,1,1659,1444,-40
73968358687,73968358665,-22,649,323,-40
73968525937,73968525932,-5,1108,4518,-40
73968748681,73968748687,6,3984,1379,-40
73970350719,73970350726,7,2496,866,-40
73970983826,73970983830,4,2822,1494,-40
73973613362,73973613369,7,2182,1379,-40
73977093722,73977093729,7,2598,1247,-40
73979779961,73979779966,5,2477,1556,-40
73985272928,73985272950,22,1995,1555,-40
73986205543,73986205542,-1,1913,2671,-40
73986515798,73986515805,7,3152,1539,-40
73988000362,73988000355,-7,710,6750,-40
73988445497,73988445500,3,2582,1655,-40
73992785187,73992785191,4,2832,1150,-40
73996576475,73996576482,7,1963,968,-40
73998643089,73998643095,6,2441,1291,-40
74002748143,74002748150,7,2965,1438,-40
74003646005,74003646009,4,1620,1337,-40
74004735793,74004735799,6,2550,1067,-40
74006217149,74006217153,4,2793,1251,-40
74008892246,74008892248,2,1916,3165,-40
74009777393,74009777399,6,3440,756,-40
74013931491,74013931497,6,1940,1055,-40
74023029569,74023029577,8,3262,1283,-40
74027582799,74027582805,6,3046,1319,-40
74027821959,74027821966,7,3302,1444,-40
74029198090,74029198096,6,3842,2001,-40
74029666547,74029666550,3,2879,1891,-40
74031490405,74031490410,5,3926,1352,-40
74031529874,74031529888,14,2825,1584,-40
74031615900,74031615882,-18,3162,1546,-40
74032096966,74032096976,10,1358,348,-40
74033219157,74033219146,-11,880,313,-40
74034288466,74034288474,8,3458,1265,-40
74037190398,74037190394,-4,22746,12171,-40
74038696012,74038696019,7,3248,1414,-40
74038778407,74038778413,6,2529,1279,-40
74040720256,74040720275,19,1950,1161,-40
74041642960,74041642968,8,3222,1442,-40
74047031082,74047031062,-20,1490,232,-40
74055836969,74055836974,5,2951,1408,-40
74057202284,74057202291,7,1551,754,-40
74058144945,74058144951,6,4766,1517,-40
74059154481,74059154487,6,2129,1045,-40
74062825806,74062825812,6,2127,1004,-40
74063276990,74063276991,1,1983,1351,-40
74063325937,74063325922,-15,710,285,-40
74069394941,74069394947,6,3307,1846,-40
74071573140,74071573138,-2,1136,2420,-40
74071792074,74071792078,4,3646,1545,-40
74075179250,74075179262,12,3708,1440,-40
74078050657,74078050663,6,3319,1527,-40
74082430918,74082430925,7,42843,14938,-40
74086206582,74086206589,7,2783,1567,-40
74087455449,74087455452,3,1469,1644,-40
74087493139,74087493143,4,2163,1036,-40
74094862976,74094862981,5,3023,1173,-40
74103128601,74103128607,6,2083,914,-40
74104030563,74104030544,-19,1512,642,-40
74105047271,74105047277,6,1384,938,-40
74107877159,74107877163,4,1799,1396,-40
74110510889,74110510894,5,2390,1986,-40
74110543727,74110543745,18,598,273,-40
74118191757,74118191763,6,3315,1401,-40
74120542498,74120542507,9,11178,32444,-40
74122167743,74122167746,3,1417,1945,-40
74126093095,74126093100,5,3560,1666,-40
74137434878,74137434882,4,2052,1262,-40
74146093165,74146093166,1,1458,1470,-40
74146622012,74146622018,6,2157,1517,-40
74153048493,74153048488,-5,2497,7502,-40
74153419655,74153419656,1,808,1253,-40
74161089605,74161089612,7,3788,1784,-40
74162677661,74162677667,6,2720,1499,-40
74167410335,74167410320,-15,2706,1038,-40
74169804998,74169805004,6,2906,1259,-40
74176592682,74176592687,5,2396,1346,-40
74178389121,74178389112,-9,1821,32121,-40
74186917438,74186917445,7,3262,1260,-40
74188565667,74188565674,7,3430,1250,-40
74191066718,74191066723,5,3913,1708,-40
74191446109,74191446092,-17,1299,253,-40
74194804707,74194804713,6,3299,1653,-40
74196358534,74196358542,8,2947,2225,-40
74203030307,74203030312,5,2915,1624,-40
74206079222,74206079203,-19,853,186,-40
74206726383,74206726390,7,2688,1129,-40
74211068614,74211068602,-12,1176,533,-40
74212061374,74212061381,7,4256,1420,-40
74212396143,74212396139,-4,1538,3414,-40
74214496881,74214496888,7,3217,1189,-40
74219378945,74219378953,8,3652,1288,-40
74225151728,74225151733,5,7868,36549,-40
74225808951,74225808953,2,3159,3467,-40
74228201654,74228201661,7,2082,838,-40
74228283492,74228283476,-16,1107,235,-40
74229326314,74229326320,6,2988,1421,-40
74232643240,74232643246,6,3570,1234,-40
74232984993,74232985003,10,15698,22652,-40
74237365130,74237365135,5,3382,1319,-40
74239628210,74239628218,8,3012,1462,-40
74257015375,74257015383,8,347,993,-40
74261831572,74261831577,5,2571,1151,-40
74267063919,74267063926,7,3100,1064,-40
74267204494,74267204500,6,2013,1590,-40
74267966775,74267966783,8,2347,918,-40
74272802479,74272802481,2,3260,4355,-40
74275064668,74275064674,6,2097,1489,-40
74275599919,74275599900,-19,5301,2909,-40
74279742494,74279742500,6,3107,1717,-40
74280760713,74280760697,-16,827,395,-40
74283499078,74283499083,5,2033,953,-40
74285549400,74285549405,5,2445,1401,-40
74287663638,74287663633,-5,1165,2260,-40
74291179053,74291179053,0,1452,1302,-40
74293254599,74293254607,8,4806,1477,-40
74301144570,74301144577,7,2785,1376,-40
74301171206,74301171192,-14,659,17,-40
74302915254,74302915261,7,2728,1270,-40
74306279799,74306279805,6,2531,1046,-40
74306560658,74306560673,15,2833,1307,-40
74308124130,74308124137,7,3116,1410,-40
74308367763,74308367770,7,3238,1002,-40
74317823298,74317823303,5,3539,1277,-40
74321385513,74321385494,-19,188,1096,-40
74322067383,74322067391,8,3870,1156,-40
74325834749,74325834757,8,2472,751,-40
74329639575,74329639581,6,2978,1438,-40
74331108690,74331108696,6,2677,1739,-40
74333486502,74333486509,7,2708,1208,-40
74333579082,74333579072,-10,892,247,-40
74335491113,74335491118,5,2784,1170,-40
74335704369,74335704355,-14,1008,305,-40
74340764734,74340764741,7,3375,1167,-40
74340849923,74340849926,3,1009,897,-40
74346555957,74346555964,7,3889,1644,-40
74351316471,74351316479,8,2655,893,-40
74352164366,74352164372,6,3476,1325,-40
74353599686,74353599671,-15,2366,1188,-40
74354470284,74354470288,4,2305,1048,-40
74357178240,74357178246,6,4028,1122,-40
74357323542,74357323548,6,2460,1309,-40
74360493579,74360493586,7,2255,1625,-40
74362828641,74362828647,6,2351,1130,-40
74363248718,74363248723,5,1218,1229,-40
74363289622,74363289629,7,4306,1621,-40
74364890833,74364890839,6,2710,1517,-40
74367526938,74367526945,7,2443,1349,-40
74367626759,74367626774,15,28162,12951,-40
74369727962,74369727962,0,1913,1853,-40
74372348876,74372348882,6,2214,1223,-40
74373108094,74373108087,-7,825,2889,-40
74373804215,74373804223,8,2309,978,-40
74384181733,74384181739,6,2262,1131,-40
74388450721,74388450727,6,2565,786,-40
74389144583,74389144591,8,1760,864,-40
74393696347,74393696354,7,625,604,-40
74395143266,74395143271,5,2868,1380,-40
74397250891,74397250891,0,1215,1159,-40
74397812950,74397812958,8,3848,1190,-40
74400808557,74400808562,5,2679,1374,-40
74404719356,74404719364,8,2683,1174,-40
74406752650,74406752655,5,4103,1797,-40
74407425162,74407425168,6,3160,1285,-40
74407547463,74407547449,-14,3412,1067,-40
74411248725,74411248725,0,2099,3141,-40
74418789264,74418789271,7,4313,1455,-40
74425223459,74425223467,8,1226,939,-40
74433625451,74433625458,7,3917,1476,-40
74436763618,74436763626,8,2428,1204,-40
74438106723,74438106730,7,1623,1369,-40
74439360145,74439360131,-14,2957,811,-40
74440646420,74440646426,6,1409,666,-40
74441109359,74441109361,2,1029,271,-40
74445082496,74445082503,7,2946,1408,-40
74454910453,74454910458,5,3575,1477,-40
74458429813,74458429819,6,4231,1923,-40
74459952444,74459952449,5,2625,1260,-40
74460821290,74460821275,-15,928,153,-40
74463967177,74463967182,5,2694,1322,-40
74466024281,74466024288,7,2673,1450,-40
74468698098,74468698105,7,2551,1288,-40
74469441668,74469441676,8,2674,1463,-40
74469546882,74469546864,-18,2851,1298,-40
74475369045,74475369051,6,3199,977,-40
74475732864,74475732869,5,3039,1485,-40
74475767546,74475767549,3,1913,1401,-40
74484723585,74484723590,5,3220,834,-40
74485972281,74485972286,5,3700,1675,-40
74490044118,74490044118,0,1328,1901,-40
74494299207,74494299213,6,2055,1086,-40
74499509554,74499509562,8,1546,1333,-40
74499646752,74499646768,16,3034,868,-40
74500705433,74500705453,20,82,7822,-40
74501702478,74501702486,8,2297,1178,-40
74503081326,74503081312,-14,3729,1369,-40
74508344214,74508344220,6,2441,1230,-40
74510679276,74510679282,6,3623,1533,-40
74511002965,74511002971,6,2744,1037,-40
74512259319,74512259317,-2,6790,16380,-40
74514031890,74514031896,6,2915,1491,-40
74521057601,74521057607,6,2091,1208,-40
74530285755,74530285762,7,1913,1298,-40
74531339421,74531339429,8,2326,925,-40
74540054434,74540054441,7,3811,1681,-40
74541083411,74541083416,5,8113,5111,-40
74543859513,74543859519,6,2655,1497,-40
74548995867,74548995874,7,2431,1272,-40
74554528483,74554528486,3,1796,1101,-40
74554677694,74554677692,-2,1568,4739,-40
74562397616,74562397622,6,2937,1070,-40
74562578833,74562578843,10,835,262,-40
74572975138,74572975143,5,1680,1312,-40
74575001468,74575001473,5,2150,1132,-40
74575558832,74575558838,6,2345,965,-40
74577426913,74577426918,5,2915,1301,-40
74578144902,74578144909,7,3632,1613,-40
74580668744,74580668740,-4,2118,6325,-40
74580828519,74580828527,8,2749,1042,-40
74582071764,74582071771,7,1983,931,-40
74582440283,74582440291,8,702,213,-40
74584215298,74584215301,3,1749,1291,-40
74584396186,74584396187,1,786,333,-40
74585411146,74585411150,4,1674,1216,-40
74586856786,74586856791,5,3884,1578,-40
74587289934,74587289913,-21,1336,271,-40
74587951274,74587951279,5,2055,1250,-40
74591396906,74591396913,7,2558,1809,-40
74598237498,74598237505,7,1625,1357,-40
74598398972,74598398955,-17,2940,971,-40
74602966792,74602966791,-1,1012,1550,-40
74603149545,74603149551,6,3157,1652,-40
74605736022,74605736030,8,2601,1075,-40
74606750974,74606750979,5,1480,632,-40
74608496762,74608496768,6,3168,1369,-40
74616096991,74616096998,7,3237,1198,-40
74623310945,74623310952,7,2878,1174,-40
74628573231,74628573235,4,1520,1356,-40
74641126725,74641126730,5,2151,1422,-40
74645354902,74645354909,7,2255,1000,-40
74650539466,74650539470,4,3036,1257,-40
74650708105,74650708112,7,2402,1325,-40
74651946489,74651946493,4,19711,19282,-40
74653756663,74653756667,4,3092,1091,-40
74655995870,74655995870,0,1000,1784,-40
74656270939,74656270946,7,3278,1031,-40
74663131524,74663131530,6,3890,1544,-40
74663723929,74663723935,6,3104,1406,-40
74664769250,74664769245,-5,34920,11058,-40
74677683112,74677683118,6,1141,562,-40
74681890870,74681890876,6,3723,1498,-40
74682497682,74682497666,-16,2967,1319,-40
74685295145,74685295153,8,4698,1615,-40
74690416078,74690416086,8,2793,1188,-40
74692855359,74692855369,10,2758,1128,-40
74693136495,74693136481,-14,1957,409,-40
74695654083,74695654088,5,2549,1624,-40
74703511857,74703511861,4,2449,1661,-40
74705401138,74705401144,6,2875,1110,-40
74708669903,74708669910,7,2899,1191,-40
74712661610,74712661616,6,2681,1695,-40
74715266446,74715266453,7,2376,1158,-40
74715872357,74715872363,6,2254,1330,-40
74726182270,74726182271,1,1209,1216,-40
74732157370,74732157377,7,2864,1262,-40
74734149357,74734149364,7,2494,1038,-40
74734480360,74734480366,6,3130,1481,-40
74735252734,74735252740,6,2954,1145,-40
74740252134,74740252139,5,2297,1023,-40
74746809793,74746809799,6,2680,1506,-40
74748388934,74748388941,7,3291,1513,-40
74748505055,74748505074,19,2485,1091,-40
74748559383,74748559386,3,1229,273,-40
74749777798,74749777805,7,2106,1643,-40
74752062118,74752062122,4,1846,1347,-40
74752132643,74752132657,14,2670,1060,-40
74756580626,74756580632,6,2668,1347,-40
74757764686,74757764692,6,2949,1253,-40
74758723330,74758723335,5,2234,1295,-40
74766070728,74766070734,6,2588,1254,-40
74766521849,74766521854,5,3262,2064,-40
74771588198,74771588205,7,2615,1424,-40
74775114281,74775114287,6,2439,1090,-40
74778231544,74778231541,-3,1313,3008,-40
74778778879,74778778884,5,1779,941,-40
74781138073,74781138082,9,2767,1298,-40
74781692863,74781692843,-20,3736,938,-40
74783845610,74783845616,6,3786,1434,-40
74784679182,74784679186,4,1510,938,-40
74784855782,74784855800,18,3381,1301,-40
74786456669,74786456673,4,1444,1354,-40
74787943191,74787943198,7,3066,1245,-40
74788436012,74788436017,5,1728,1102,-40
74789608189,74789608196,7,3143,1191,-40
74789849577,74789849562,-15,1724,837,-40
74796282409,74796282414,5,2308,1495,-40
74797742695,74797742702,7,2841,1161,-40
74808048486,74808048491,5,3088,1285,-40
74808216175,74808216181,6,2675,1365,-40
74812854683,74812854690,7,2507,970,-40
74816343284,74816343284,0,1925,1344,-40
74821833389,74821833395,6,2776,1459,-40
74830376143,74830376149,6,3474,1277,-40
74840845442,74840845450,8,2593,1049,-40
74844915345,74844915349,4,2030,1787,-40
74848678455,74848678462,7,2429,1288,-40
74856226087,74856226094,7,3404,1322,-40
74858419160,74858419166,6,3728,1363,-40
74863010885,74863010890,5,2433,1099,-40
74863964777,74863964782,5,2738,1249,-40
74864459330,74864459344,14,3499,1400,-40
74864535902,74864535881,-21,1172,496,-40
74867588221,74867588229,8,2487,984,-40
74868485865,74868485850,-15,1948,679,-40
74872518141,74872518147,6,3127,1472,-40
74873059554,74873059561,7,2744,858,-40
74873111106,74873111089,-17,955,349,-40
74875869694,74875869699,5,2527,1143,-40
74876560587,74876560596,9,3608,1244,-40
74878407008,74878407013,5,2927,1531,-40
74888009644,74888009650,6,3252,1352,-40
74888601209,74888601215,6,2317,920,-40
74888849166,74888849172,6,2598,1188,-40
74888956525,74888956523,-2,861,101,-40
74891489289,74891489294,5,2930,997,-40
74891577383,74891577395,12,913,159,-40
74894908106,74894908107,1,1902,2071,-40
74900649176,74900649179,3,2413,1207,-40
74906908495,74906908501,6,2801,1128,-40
74910197489,74910197495,6,3360,940,-40
74916191492,74916191497,5,2994,979,-40
74920439351,74920439359,8,2920,1456,-40
74925505949,74925505957,8,3384,1487,-40
74931341279,74931341286,7,3448,1758,-40
74933382954,74933382961,7,3394,1443,-40
74934103985,74934103991,6,1136,600,-40
74938457739,74938457746,7,2515,1181,-40
74940892450,74940892457,7,2470,1319,-40
74942848036,74942848039,3,1233,1110,-40
74943244490,74943244497,7,3826,1409,-40
74946109127,74946109134,7,2706,1461,-40
74950303898,74950303906,8,1880,1250,-40
74950589738,74950589721,-17,866,297,-40
74954346473,74954346478,5,3362,840,-40
74957036538,74957036545,7,2990,1316,-40
74958881590,74958881597,7,2634,1371,-40
74960617981,74960617987,6,2110,1406,-40
74961626963,74961626970,7,1056,163,-40
74968725758,74968725763,5,1896,883,-40
74973100999,74973101003,4,3710,1068,-40
74973342113,74973342131,18,3616,1555,-40
74974376841,74974376847,6,3064,929,-40
74974454177,74974454182,5,3450,1733,-40
74975803455,74975803458,3,2569,1425,-40
74976175090,74976175097,7,2477,1432,-40
74977340166,74977340179,13,3113,1015,-40
74980225434,74980225439,5,1308,926,-40
74983189598,74983189603,5,3165,1412,-40
74987010045,74987010052,7,2084,951,-40
74989780702,74989780710,8,2981,1278,-40
74989891760,74989891763,3,2036,1123,-40
74991985515,74991985522,7,2774,1261,-40
74994189142,74994189142,0,2421,2509,-40
74996344697,74996344702,5,2382,1320,-40
74997070103,74997070111,8,2172,934,-40
75020582724,75020582730,6,2455,1015,-40
75023603472,75023603479,7,3158,1093,-40
75029501185,75029501185,0,1637,2167,-40
75029727373,75029727386,13,2592,1102,-40
75031212768,75031212774,6,2328,1021,-40
75035613001,75035613006,5,2266,1708,-40
75036195359,75036195366,7,3338,1068,-40
75038696789,75038696792,3,1709,1664,-40
75040773533,75040773539,6,3507,1063,-40
75045052658,75045052658,0,1917,1450,-40
75045963821,75045963826,5,3188,1074,-40
75051725890,75051725895,5,3485,1334,-40
75052554936,75052554941,5,2102,1097,-40
75054588372,75054588378,6,2569,1451,-40
75057138274,75057138282,8,2796,1069,-40
75058823324,75058823330,6,3219,1013,-40
75059049919,75059049923,4,3601,1566,-40
75064530301,75064530308,7,4383,1484,-40
75069719153,75069719152,-1,3409,3790,-40
75072366409,75072366417,8,3000,899,-40
75073483888,75073483891,3,1904,934,-40
75078442970,75078442974,4,2007,1226,-40
75078629830,75078629809,-21,6260,2082,-40
75081224306,75081224313,7,2817,1138,-40
75082467585,75082467592,7,2514,1243,-40
75084635015,75084635022,7,3164,1649,-40
75085044482,75085044487,5,3477,1256,-40
75085285568,75085285574,6,2587,1351,-40
75088204427,75088204434,7,3919,1975,-40
75090294904,75090294910,6,2956,994,-40
75090729531,75090729530,-1,1288,1351,-40
75093581462,75093581470,8,3671,1549,-40
75097925134,75097925115,-19,34784,27578,-40
75104374338,75104374346,8,2915,1450,-40
75112697538,75112697543,5,2359,1002,-40
75113424391,75113424399,8,1530,745,-40
75113804212,75113804196,-16,3313,1623,-40
75115423513,75115423519,6,2113,893,-40
75115758236,75115758241,5,1937,971,-40
75118949363,75118949370,7,2414,1097,-40
75123986029,75123986033,4,1615,1073,-40
75127191858,75127191865,7,2031,1333,-40
75127572311,75127572305,-6,960,3600,-40
75132088942,75132088948,6,2396,1410,-40
75134039187,75134039194,7,2467,1214,-40
75134751375,75134751381,6,2401,1773,-40
75135970272,75135970274,2,1438,20712,-40
75136902145,75136902151,6,2315,946,-40
75139806483,75139806490,7,2604,1438,-40
75143699296,75143699299,3,1823,1291,-40
75147441161,75147441166,5,2024,1242,-40
75148565945,75148565948,3,1683,1196,-40
75149345555,75149345563,8,2082,1109,-40
75150150418,75150150422,4,1784,458,-40
75153787108,75153787113,5,3405,1465,-40
75154315590,75154315595,5,1594,796,-40
75158304370,75158304377,7,2272,1170,-40
75160282145,75160282150,5,2493,894,-40
75161455978,75161455981,3,1938,1572,-40
75165669606,75165669613,7,3166,1411,-40
75166066807,75166066788,-19,1072,505,-40
75170125229,75170125236,7,3463,1621,-40
75170328886,75170328874,-12,787,427,-40
75174499182,75174499190,8,2645,1063,-40
75175237986,75175237995,9,2572,738,-40
75181475650,75181475654,4,2392,1385,-40
75182426806,75182426793,-13,1173,344,-40
75188423830,75188423838,8,3664,1436,-40
75190456150,75190456155,5,1902,870,-40
75190944018,75190944001,-17,1164,487,-40
75191705429,75191705434,5,2426,1146,-40
75194366062,75194366070,8,2324,1049,-40
75201570360,75201570367,7,4905,2292,-40
75204739402,75204739408,6,2523,1272,-40
75204846873,75204846858,-15,4472,983,-40
75210797116,75210797122,6,1545,1085,-40
75211627609,75211627594,-15,991,544,-40
75211779419,75211779425,6,2962,1226,-40
75214462134,75214462139,5,2968,1070,-40
75221179687,75221179695,8,2824,863,-40
75222030435,75222030418,-17,2338,911,-40
75223737788,75223737791,3,2511,1118,-40
75229784417,75229784411,-6,10030,2628,-40
75232399831,75232399826,-5,800,3312,-40
75233249793,75233249801,8,2607,1219,-40
75234989299,75234989298,-1,1258,2103,-40
75235507141,75235507149,8,2675,1012,-40
75241593898,75241593903,5,2372,1121,-40
75242314861,75242314867,6,2290,746,-40
75242836326,75242836314,-12,1044,340,-40
75243655841,75243655847,6,2191,1081,-40
75244073318,75244073324,6,3145,1361,-40
75245987603,75245987611,8,3087,1188,-40
75246856241,75246856246,5,3086,1862,-40
75251087885,75251087891,6,2930,1129,-40
75251203557,75251203544,-13,1028,405,-40
75255077331,75255077338,7,3607,1925,-40
75255994710,75255994717,7,3685,1242,-40
75257037882,75257037878,-4,1113,3046,-40
75257963874,75257963882,8,12749,23248,-40
75260537206,75260537214,8,2216,1177,-40
75264131802,75264131806,4,1639,1461,-40
75266366138,75266366145,7,3048,1135,-40
75268487067,75268487074,7,3075,1371,-40
75269762188,75269762185,-3,1833,3593,-40
75279901982,75279901987,5,3970,1065,-40
75280183678,75280183684,6,2793,1390,-40
75281570497,75281570501,4,2355,1773,-40
75283244338,75283244343,5,2619,1122,-40
75283576446,75283576448,2,2295,1444,-40
75291474717,75291474722,5,2457,1154,-40
75291840863,75291840870,7,2035,1341,-40
75296202813,75296202818,5,1352,1481,-40
75296867434,75296867439,5,2405,975,-40
75298454650,75298454640,-10,821,198,-40
75298973644,75298973650,6,2656,1098,-40
75302410786,75302410791,5,2473,1110,-40
75303829698,75303829704,6,2698,1576,-40
75307451968,75307451975,7,3255,1013,-40
75311639741,75311639747,6,3083,1379,-40
75311928098,75311928105,7,4116,1874,-40
75312924178,75312924171,-7,802,390,-40
75317108798,75317108796,-2,1124,1824,-40
75323579229,75323579236,7,2403,1241,-40
75323752396,75323752401,5,2468,1195,-40
75327657890,75327657895,5,2086,1119,-40
75337664841,75337664846,5,3072,1093,-40
75339385553,75339385558,5,2589,1211,-40
75342586240,75342586244,4,20947,15910,-40
75343419914,75343419921,7,3311,1082,-40
75343677929,75343677944,15,2490,948,-40
75345181038,75345181043,5,2161,1493,-40
75369406059,75369406066,7,3852,1179,-40
75369974570,75369974552,-18,912,52,-40
75370882300,75370882306,6,2289,1335,-40
75376180224,75376180228,4,2326,1474,-40
75379049622,75379049617,-5,1232,6176,-40
75379913714,75379913718,4,2402,1366,-40
75383758918,75383758925,7,2920,1580,-40
75383809206,75383809210,4,2278,1355,-40
75384436680,75384436686,6,2598,1023,-40
75385081311,75385081298,-13,1005,342,-40
75386608800,75386608807,7,1630,856,-40
75387724022,75387724016,-6,1869,10062,-40
75395111613,75395111618,5,1908,1527,-40
75399198930,75399198934,4,3361,1531,-40
75404338736,75404338741,5,1844,809,-40
75404884916,75404884921,5,2147,1232,-40
75409288336,75409288342,6,1645,818,-40
75415950090,75415950096,6,3629,1283,-40
75416845902,75416845897,-5,1213,246,-40
75417997406,75417997394,-12,1724,738,-40
75419782255,75419782259,4,1088,625,-40
75421057586,75421057571,-15,1492,434,-40
75422811535,75422811539,4,1560,1146,-40
75427071185,75427071192,7,2210,1151,-40
75428289952,75428289958,6,2667,1100,-40
75428515779,75428515786,7,3016,1200,-40
75432967824,75432967842,18,30,5089,-40
75435319231,75435319238,7,2214,973,-40
75436119711,75436119714,3,2122,1193,-40
75437365386,75437365391,5,3685,1451,-40
75445542815,75445542822,7,2129,985,-40
75451253271,75451253278,7,2406,1125,-40
75453013641,75453013646,5,2614,1164,-40
75456679829,75456679830,1,1315,1311,-40
75458386891,75458386892,1,12922,15681,-40
75461423186,75461423193,7,3575,1309,-40
75466584742,75466584745,3,2305,1265,-40
75477670857,75477670865,8,3241,1288,-40
75480637930,75480637934,4,2665,1424,-40
75482459073,75482459079,6,3137,1252,-40
75485366875,75485366882,7,2628,1299,-40
75488183209,75488183214,5,2073,962,-40
75489285022,75489285028,6,3157,1356,-40
75489788217,75489788221,4,2032,869,-40
75489938177,75489938183,6,2567,1090,-40
75493080616,75493080623,7,4001,1350,-40
75495640625,75495640631,6,3470,1810,-40
75495874778,75495874787,9,3180,1300,-40
75499746503,75499746506,3,2088,2197,-40
75500805228,75500805234,6,1637,1097,-40
75501022138,75501022122,-16,1977,767,-40
75504787012,75504787018,6,3337,1575,-40
75504964257,75504964264,7,3953,1735,-40
75507486313,75507486319,6,2373,1203,-40
75509434387,75509434395,8,2776,1053,-40
75510446501,75510446489,-12,1415,25116,-40
75511052942,75511052937,-5,2253,6768,-40
75511470018,75511470026,8,2240,906,-40
75514999110,75514999115,5,3152,1672,-40
75517263958,75517263963,5,2657,1073,-40
75517741881,75517741887,6,2047,1095,-40
75519331973,75519331980,7,2378,1198,-40
75521372441,75521372449,8,2428,1415,-40
75521441366,75521441352,-14,1038,303,-40
75522955252,75522955259,7,2767,1365,-40
75523633758,75523633770,12,1053,190,-40
75525755642,75525755650,8,3992,1402,-40
75527911625,75527911632,7,3023,1194,-40
75535643054,75535643062,8,2095,1066,-40
75537583875,75537583870,-5,1162,4025,-40
75537680102,75537680089,-13,974,378,-40
75538012800,75538012800,0,22858,7088,-40
75544590095,75544590101,6,2782,1089,-40
75546667276,75546667282,6,4186,1518,-40
75554416174,75554416178,4,2240,1246,-40
75556265986,75556265994,8,2125,1508,-40
75556310292,75556310273,-19,4230,1494,-40
75559249908,75559249914,6,3976,1379,-40
75560705363,75560705369,6,2846,1301,-40
75567081725,75567081732,7,3913,1767,-40
75572048749,75572048755,6,2277,942,-40
75572241842,75572241849,7,3306,1508,-40
75572490289,75572490286,-3,1404,2508,-40
75573098642,75573098648,6,3031,1395,-40
75576566731,75576566738,7,3328,1059,-40
75577648533,75577648539,6,1744,965,-40
75578320274,75578320279,5,1736,833,-40
75578495925,75578495905,-20,3155,892,-40
75579696706,75579696710,4,2403,1182,-40
75581429862,75581429866,4,2297,1003,-40
75583154417,75583154423,6,3676,1168,-40
75583842501,75583842493,-8,980,7983,-40
75585596152,75585596158,6,3842,1342,-40
75587987958,75587987963,5,3799,1929,-40
75600443489,75600443498,9,1829,761,-40
75604458002,75604458004,2,2382,1716,-40
75607875174,75607875176,2,3616,2821,-40
75608767550,75608767553,3,3314,3288,-40
75609249634,75609249642,8,3730,1321,-40
75612559429,75612559434,5,2454,1301,-40
75620661099,75620661105,6,4089,1783,-40
75620895703,75620895707,4,2093,992,-40
75622136470,75622136477,7,2933,1110,-40
75622916199,75622916208,9,565,303,-40
75623985689,75623985695,6,4402,1837,-40
75625354116,75625354122,6,2539,1161,-40
75626216425,75626216431,6,2674,1044,-40
75634426902,75634426910,8,1580,677,-40
75640154366,75640154371,5,2441,1120,-40
75652478967,75652478973,6,2916,1375,-40
75655865374,75655865381,7,3421,1343,-40
75658516810,75658516814,4,1353,994,-40
75661386137,75661386139,2,2862,1127,-40
75661991940,75661991921,-19,1554,584,-40
75664667630,75664667637,7,2443,1482,-40
75666790001,75666790009,8,3002,848,-40
75676160375,75676160382,7,3149,952,-40
75680506389,75680506393,4,4606,1221,-40
75681651457,75681651457,0,559,283,-40
75682184550,75682184571,21,1011,195,-40
75682480845,75682480826,-19,3462,1446,-40
75684527826,75684527831,5,2273,1301,-40
75684993272,75684993259,-13,1966,873,-40
75689737515,75689737521,6,2567,1028,-40
75690985805,75690985785,-20,1219,581,-40
75700982325,75700982330,5,2415,1159,-40
75701212433,75701212416,-17,1126,514,-40
75701633409,75701633415,6,3015,1436,-40
75703467632,75703467634,2,2512,1585,-40
75707611051,75707611057,6,3111,1109,-40
75709705298,75709705298,0,1610,1862,-40
75716232249,75716232255,6,3510,1374,-40
75718289238,75718289242,4,2315,985,-40
75724641940,75724641948,8,3178,1092,-40
75730363166,75730363171,5,2752,1072,-40
75732971126,75732971133,7,2956,1807,-40
75736282474,75736282468,-6,1972,9558,-40
75750645778,75750645784,6,2653,1387,-40
75752449933,75752449939,6,2500,1199,-40
75757750528,75757750534,6,3242,1390,-40
75760360375,75760360373,-2,925,1734,-40
75764298868,75764298874,6,1669,925,-40
75765552693,75765552701,8,2637,1214,-40
75766843413,75766843418,5,2866,1575,-40
75770668119,75770668126,7,3607,1750,-40
75774086254,75774086259,5,2372,1501,-40
75775670205,75775670211,6,2478,1625,-40
75777732910,75777732916,6,3059,1746,-40
75790842006,75790842013,7,3423,1238,-40
75792299339,75792299346,7,2551,1641,-40
75797859724,75797859727,3,3732,3518,-40
75797942968,75797942976,8,2028,1405,-40
75801421660,75801421666,6,2353,1148,-40
75806168934,75806168941,7,3909,1846,-40
75808511384,75808511403,19,571,325,-40
75808650119,75808650126,7,2988,1160,-40
75809109258,75809109267,9,3069,1175,-40
75809874684,75809874691,7,2460,1153,-40
75811813834,75811813842,8,1893,944,-40
75813164310,75813164315,5,2417,1259,-40
75815169783,75815169782,-1,1244,1528,-40
75821738417,75821738424,7,3987,1469,-40
75825191669,75825191675,6,3049,1144,-40
75825317619,75825317626,7,5433,1207,-40
75827338455,75827338459,4,1690,1007,-40
75831760706,75831760712,6,2394,1412,-40
75832052503,75832052506,3,1614,1378,-40
75833879005,75833879011,6,2840,1212,-40
75834638696,75834638682,-14,2677,1075,-40
75835212103,75835212110,7,3080,1537,-40
75836277006,75836277011,5,2215,882,-40
75840158260,75840158266,6,3819,1300,-40
75848497169,75848497174,5,3198,1183,-40
75848715658,75848715642,-16,2855,1175,-40
75848857234,75848857239,5,2323,949,-40
75852051334,75852051340,6,2591,908,-40
75852589154,75852589160,6,2687,1258,-40
75853414329,75853414335,6,1263,461,-40
75856822564,75856822570,6,2411,49052,-40
75862951069,75862951074,5,2897,793,-40
75863064912,75863064917,5,2662,1425,-40
75866182662,75866182667,5,2226,1325,-40
75867157495,75867157479,-16,788,371,-40
75868616447,75868616454,7,2707,1379,-40
75868881397,75868881403,6,2988,1098,-40
75870884310,75870884317,7,3306,1697,-40
75872208246,75872208253,7,2538,1326,-40
75876364266,75876364270,4,1396,1282,-40
75877584291,75877584298,7,3264,1207,-40
75878343597,75878343603,6,4068,1326,-40
75878802483,75878802477,-6,1784,4951,-40
75879136550,75879136546,-4,1347,3424,-40
75883535001,75883535007,6,1348,1217,-40
75894066714,75894066722,8,3176,1159,-40
75895018470,75895018490,20,918,198,-40
75897445381,75897445388,7,3844,1763,-40
75898044312,75898044315,3,1911,2110,-40
75911858777,75911858781,4,1770,801,-40
75913719386,75913719390,4,2174,1440,-40
75914098975,75914098983,8,2829,1709,-40
75916963792,75916963798,6,2095,698,-40
75918371734,75918371739,5,2777,1482,-40
75918480161,75918480145,-16,1315,513,-40
75919486346,75919486353,7,2202,1090,-40
75924858062,75924858070,8,3760,1166,-40
75927006834,75927006825,-9,41369,16945,-40
75934214137,75934214142,5,2387,1634,-40
75934300401,75934300399,-2,21967,44723,-40
75935645485,75935645491,6,3622,1548,-40
75938314380,75938314386,6,2777,1039,-40
75941781203,75941781188,-15,1185,749,-40
75942099560,75942099557,-3,241,1948,-40
75944924873,75944924878,5,2117,1212,-40
75945678040,75945678046,6,2495,1572,-40
75945918128,75945918115,-13,1310,424,-40
75948315725,75948315730,5,2124,1422,-40
75951330814,75951330822,8,3086,1119,-40
75954533562,75954533569,7,2877,779,-40
75957328523,75957328528,5,2965,1260,-40
75959574026,75959574033,7,3068,1672,-40
75959813002,75959813006,4,2867,1604,-40
75961736478,75961736483,5,3956,1639,-40
75966042705,75966042711,6,2916,1106,-40
75967622297,75967622303,6,1468,674,-40
75968514031,75968514020,-11,932,164,-40
75969522072,75969522077,5,3302,1512,-40
75971011966,75971011971,5,3543,1598,-40
75974574086,75974574090,4,2932,1064,-40
75979427269,75979427274,5,3107,1563,-40
75986412748,75986412754,6,2472,807,-40
75990306818,75990306827,9,3302,1589,-40
75990364707,75990364714,7,3124,1270,-40
75990473286,75990473267,-19,1610,679,-40
75991125588,75991125594,6,3654,1401,-40
75991981212,75991981217,5,2659,915,-40
75993972864,75993972870,6,3441,1560,-40
75994166868,75994166874,6,2465,1544,-40
75994877618,75994877598,-20,2652,1121,-40
75997098459,75997098465,6,2682,1583,-40
75998149293,75998149306,13,2871,1049,-40
75998218189,75998218212,23,2416,865,-40
76001618879,76001618882,3,1978,1338,-40
76002655990,76002655994,4,2906,1381,-40
76002865570,76002865577,7,2845,1328,-40
76009249967,76009249973,6,2092,1036,-40
76009533116,76009533096,-20,2347,1484,-40
76015749789,76015749787,-2,3447,3867,-40
76019393957,76019393963,6,3035,696,-40
76021564635,76021564633,-2,1241,2986,-40
76026387213,76026387208,-5,2075,6399,-40
76040539199,76040539192,-7,974,4730,-40
76043873794,76043873802,8,3207,1285,-40
76044035340,76044035347,7,2298,1129,-40
76045283497,76045283504,7,3579,1220,-40
76047851110,76047851116,6,3210,1605,-40
76056280114,76056280120,6,2989,1083,-40
76056510565,76056510546,-19,2649,1002,-40
76059629963,76059629967,4,1349,1074,-40
76060141270,76060141275,5,3136,1569,-40
76064198091,76064198097,6,2014,809,-40
76065485790,76065485772,-18,1063,277,-40
76066411026,76066411032,6,2500,936,-40
76077186813,76077186818,5,2204,1627,-40
76077614710,76077614715,5,2709,1467,-40
76083541335,76083541341,6,1368,635,-40
76085551558,76085551566,8,3412,1684,-40
76085589968,76085589984,16,2946,1132,-40
76087489057,76087489063,6,2890,1564,-40
76087646862,76087646868,6,2975,888,-40
76093945641,76093945647,6,3788,1524,-40
76098480222,76098480222,0,1102,1717,-40
76099176677,76099176682,5,4449,1256,-40
76100565123,76100565129,6,8389,4543,-40
76102573749,76102573754,5,2522,1049,-40
76108663024,76108663029,5,1406,984,-40
76111460305,76111460311,6,2334,1063,-40
76121235157,76121235165,8,1203,815,-40
76122041983,76122041987,4,2402,1608,-40
76124616758,76124616766,8,4534,915,-40
76126227112,76126227118,6,2533,1433,-40
76126943139,76126943146,7,3419,1234,-40
76131172933,76131172940,7,2734,1192,-40
76132069237,76132069244,7,3226,1434,-40
76133993090,76133993095,5,2758,1292,-40
76141987080,76141987087,7,2718,1414,-40
76142646771,76142646764,-7,24727,14763,-40
76142959301,76142959307,6,3098,1020,-40
76143881021,76143881027,6,2654,1412,-40
76146431238,76146431243,5,2372,1550,-40
76148054689,76148054693,4,2104,1745,-40
76152158325,76152158330,5,2133,1366,-40
76156963869,76156963873,4,2524,935,-40
76157381825,76157381830,5,1957,1037,-40
76158636840,76158636845,5,2550,892,-40
76159731077,76159731083,6,2287,1418,-40
76160057083,76160057089,6,2114,1218,-40
76161975845,76161975853,8,2874,1323,-40
76162436286,76162436290,4,2226,934,-40
76163274958,76163274964,6,3224,1659,-40
76163339561,76163339546,-15,3190,1543,-40
76165891106,76165891112,6,3883,1680,-40
76169302619,76169302625,6,5331,2224,-40
76171294550,76171294550,0,2596,3608,-40
76172704633,76172704640,7,3157,1265,-40
76173978217,76173978204,-13,1253,833,-40
76176591482,76176591489,7,2716,1035,-40
76176814672,76176814677,5,3601,1677,-40
76176925299,76176925289,-10,1003,315,-40
76182724254,76182724258,4,1273,1489,-40
76183843161,76183843167,6,4177,1584,-40
76186648326,76186648327,1,811,1056,-40
76190533749,76190533754,5,2224,998,-40
76191876638,76191876646,8,2681,1262,-40
76193292390,76193292397,7,1836,1008,-40
76197075377,76197075382,5,1624,1026,-40
76198319082,76198319085,3,2361,1072,-40
76199187438,76199187442,4,2900,1212,-40
76199216106,76199216121,15,707,180,-40
76203612338,76203612342,4,2873,1566,-40
76211762795,76211762803,8,1874,1121,-40
76213104712,76213104718,6,2764,1038,-40
76213426242,76213426242,0,796,43,-40
76216532267,76216532274,7,2916,1128,-40
76223694233,76223694238,5,3077,1202,-40
76224617217,76224617223,6,2930,1609,-40
76234379899,76234379905,6,2899,952,-40
76235681603,76235681610,7,2871,1382,-40
76240172006,76240171999,-7,1258,3375,-40
76240802412,76240802408,-4,1599,1903,-40
76246246376,76246246382,6,2428,1452,-40
76246849941,76246849949,8,4385,1100,-40
76248781610,76248781614,4,3038,1743,-40
76250775235,76250775242,7,2374,1392,-40
76252033589,76252033595,6,2165,1291,-40
76254736070,76254736074,4,3425,1935,-40
76258301355,76258301353,-2,1544,2526,-40
76260626905,76260626910,5,1953,1222,-40
76276177765,76276177770,5,3720,1429,-40
76282817644,76282817650,6,2660,1502,-40
76292231093,76292231105,12,4177,1049,-40
76293167569,76293167577,8,3438,1227,-40
76294663370,76294663373,3,1918,1747,-40
76301296485,76301296490,5,2967,1531,-40
76303330424,76303330430,6,3096,1372,-40
76306878481,76306878486,5,2129,1183,-40
76307230215,76307230201,-14,881,235,-40
76310294708,76310294713,5,2198,1753,-40
76310867995,76310868002,7,2449,1099,-40
76320090448,76320090455,7,2679,1010,-40
76320223218,76320223208,-10,117,1808,-40
76320858690,76320858695,5,3354,1771,-40
76324533742,76324533749,7,3002,1165,-40
76325617386,76325617382,-4,4984,12749,-40
76328652722,76328652729,7,2057,1064,-40
76329234795,76329234802,7,2412,1173,-40
76329426119,76329426106,-13,3205,858,-40
76330950816,76330950823,7,4291,1413,-40
76333138514,76333138522,8,2689,1310,-40
76335839169,76335839163,-6,1673,5328,-40
76336639660,76336639666,6,3105,1218,-40
76338516661,76338516666,5,2945,1576,-40
76339070783,76339070801,18,1432,736,-40
76340229022,76340229020,-2,740,297,-40
76340598198,76340598205,7,2861,964,-40
76340964653,76340964659,6,3336,1193,-40
76341904118,76341904125,7,3746,1072,-40
76343008831,76343008816,-15,883,378,-40
76344675921,76344675926,5,1432,1052,-40
76345313041,76345313043,2,2122,1165,-40
76352857038,76352857036,-2,971,1686,-40
76358061545,76358061551,6,3185,1342,-40
76358276113,76358276119,6,2430,1085,-40
76364285501,76364285506,5,2805,1123,-40
76369873959,76369873963,4,781,1003,-40
76374219367,76374219374,7,1478,875,-40
76377997021,76377997028,7,2736,959,-40
76378877938,76378877944,6,1434,205,-40
76381043370,76381043377,7,2995,1243,-40
76381301072,76381301078,6,2835,1166,-40
76381740310,76381740317,7,3334,1922,-40
76382765213,76382765213,0,1828,971,-40
76384579796,76384579802,6,3206,1743,-40
76384768065,76384768073,8,2512,671,-40
76387297498,76387297504,6,2154,1023,-40
76387916334,76387916340,6,2373,1162,-40
76388071124,76388071116,-8,1004,162,-40
76391630145,76391630151,6,2763,1234,-40
76394757529,76394757516,-13,970,282,-40
76398382911,76398382917,6,3182,1360,-40
76401884757,76401884762,5,2523,981,-40
76401918933,76401918914,-19,1808,1126,-40
76405984740,76405984746,6,2873,1356,-40
76406201365,76406201363,-2,1472,2248,-40
76406315755,76406315761,6,1962,1483,-40
76414594478,76414594484,6,3738,1772,-40
76415799214,76415799219,5,1969,702,-40
76419999585,76419999593,8,3182,1559,-40
76423885329,76423885334,5,3579,1531,-40
76428795030,76428795024,-6,1581,4740,-40
76429542434,76429542442,8,2380,1301,-40
76430866367,76430866373,6,2045,861,-40
76431637909,76431637915,6,3359,1790,-40
76434927601,76434927607,6,2149,1220,-40
76438976034,76438976042,8,4657,1344,-40
76440985555,76440985561,6,2281,940,-40
76441403957,76441403963,6,1788,1190,-40
76444679889,76444679895,6,2283,891,-40
76447567805,76447567812,7,2690,1445,-40
76448844314,76448844319,5,2145,1114,-40
76448877801,76448877807,6,2816,1475,-40
76450118593,76450118602,9,3398,1090,-40
76454585887,76454585895,8,2734,1320,-40
76456631882,76456631887,5,2300,846,-40
76457194684,76457194690,6,2565,1219,-40
76459205862,76459205870,8,2318,1208,-40
76461801562,76461801566,4,1416,1332,-40
76461882850,76461882857,7,1325,881,-40
76463243694,76463243699,5,1378,1090,-40
76466186861,76466186844,-17,969,375,-40
76467539150,76467539149,-1,856,85,-40
76470293823,76470293830,7,2830,1124,-40
76472918873,76472918880,7,3318,1644,-40
76473232137,76473232154,17,889,298,-40
76475640415,76475640421,6,2534,1380,-40
76479348332,76479348324,-8,40428,16369,-40
76481425414,76481425421,7,737,678,-40
76483045615,76483045621,6,4495,1049,-40
76484329453,76484329458,5,2698,1419,-40
76496076749,76496076755,6,2637,850,-40
76499280467,76499280473,6,4013,1853,-40
76499712565,76499712570,5,2880,1419,-40
76501168715,76501168722,7,3313,1395,-40
76506645503,76506645511,8,3545,1100,-40
76507784864,76507784870,6,3030,1215,-40
76508177174,76508177179,5,2275,1229,-40
76513633368,76513633373,5,2393,1307,-40
76514320274,76514320281,7,4540,1647,-40
76517101511,76517101517,6,2200,1212,-40
76518766826,76518766832,6,2349,1055,-40
76523003698,76523003706,8,2010,868,-40
76524368819,76524368803,-16,696,669,-40
76526645680,76526645688,8,4063,1360,-40
76527081494,76527081495,1,1260,1525,-40
76530632655,76530632661,6,3505,1215,-40
76533240709,76533240714,5,3722,914,-40
76535203695,76535203703,8,3236,813,-40
76538346715,76538346722,7,3279,1709,-40
76541442385,76541442390,5,1690,639,-40
76542619192,76542619198,6,2773,1270,-40
76546329385,76546329391,6,1794,1110,-40
76546724233,76546724238,5,2846,1099,-40
76548244328,76548244334,6,2506,1048,-40
76550241229,76550241228,-1,1818,2866,-40
76551274637,76551274641,4,2312,1266,-40
76552900462,76552900457,-5,749,2315,-40
76554693933,76554693939,6,3415,1551,-40
76554871626,76554871609,-17,1883,997,-40
76559928371,76559928350,-21,1710,913,-40
76562277580,76562277586,6,2079,1088,-40
76565876046,76565876051,5,2789,1244,-40
76565972782,76565972790,8,3618,1414,-40
76567918128,76567918135,7,2905,1057,-40
76572340086,76572340093,7,4068,1806,-40
76582509906,76582509912,6,2584,1244,-40
76588343101,76588343110,9,3660,1391,-40
76589965277,76589965283,6,3831,1992,-40
76590153287,76590153294,7,2747,900,-40
76602837842,76602837848,6,3097,1563,-40
76603097245,76603097251,6,2431,732,-40
76607108607,76607108613,6,3007,1059,-40
76608129014,76608129018,4,903,179,-40
76608285687,76608285668,-19,2636,1007,-40
76610772781,76610772779,-2,1893,1742,-40
76615569123,76615569127,4,2358,1113,-40
76615943325,76615943331,6,2166,958,-40
76616638246,76616638252,6,2105,1210,-40
76627496991,76627496996,5,3738,1682,-40
76628025473,76628025478,5,2327,1286,-40
76633810485,76633810491,6,2448,896,-40
76634583426,76634583411,-15,1536,285,-40
76635172622,76635172604,-18,1575,959,-40
76635669486,76635669492,6,1937,1163,-40
76635785125,76635785147,22,2096,833,-40
76637265297,76637265299,2,2036,1334,-40
76637579586,76637579591,5,2143,1301,-40
76639100706,76639100710,4,1923,1129,-40
76639867825,76639867831,6,1497,775,-40
76641242049,76641242053,4,1449,1760,-40
76642986885,76642986890,5,2125,859,-40
76646875255,76646875241,-14,1023,190,-40
76647570177,76647570183,6,2218,1238,-40
76647643006,76647643016,10,3462,1347,-40
76652741025,76652741031,6,3222,1286,-40
76652780454,76652780456,2,745,199,-40
76654827557,76654827562,5,1710,1212,-40
76655240599,76655240603,4,837,329,-40
76659088421,76659088426,5,3266,1559,-40
76660807256,76660807262,6,2628,1147,-40
76662425390,76662425397,7,3161,1060,-40
76663265149,76663265129,-20,2670,1285,-40
76664756027,76664756033,6,2852,1223,-40
76665240974,76665240979,5,3657,1645,-40
76671952218,76671952223,5,1280,1242,-40
76672045278,76672045265,-13,848,255,-40
76673692111,76673692119,8,1149,580,-40
76674279018,76674279018,0,913,983,-40
76675853178,76675853177,-1,2105,3950,-40
76678300362,76678300368,6,3036,1158,-40
76679432797,76679432794,-3,2662,5156,-40
76680126646,76680126654,8,4109,1252,-40
76684464609,76684464615,6,2225,965,-40
76686503792,76686503798,6,2024,1425,-40
76687682601,76687682607,6,3271,1041,-40
76690133877,76690133883,6,3503,907,-40
76697722510,76697722516,6,2005,1317,-40
76698096186,76698096180,-6,1270,2786,-40
76700769994,76700770001,7,3757,1354,-40
76702246441,76702246445,4,1931,1199,-40
76703122049,76703122055,6,2796,1081,-40
76705002590,76705002592,2,2457,1294,-40
76705036907,76705036891,-16,1366,481,-40
76706318118,76706318124,6,1909,1236,-40
76710136831,76710136838,7,2793,1380,-40
76710717114,76710717121,7,3353,1449,-40
76712403899,76712403905,6,2291,1267,-40
76715127698,76715127705,7,3192,1051,-40
76716265205,76716265210,5,3269,1282,-40
76719074669,76719074676,7,3165,862,-40
76720431582,76720431588,6,3025,1504,-40
76720479782,76720479786,4,3667,1323,-40
76721231961,76721231966,5,2036,1121,-40
76722295347,76722295331,-16,1086,351,-40
76722507198,76722507199,1,1272,865,-40
76722562176,76722562156,-20,114,928,-40
76723115199,76723115206,7,2967,1436,-40
76723185710,76723185717,7,3788,1908,-40
76723278975,76723278982,7,3453,1082,-40
76724162623,76724162627,4,2892,1466,-40
76725163350,76725163356,6,3016,1228,-40
76729970502,76729970484,-18,740,165,-40
76735950958,76735950966,8,3524,1061,-40
76738113108,76738113115,7,2696,1018,-40
76741329404,76741329410,6,2495,1111,-40
76741705599,76741705612,13,942,342,-40
76747081280,76747081286,6,1572,1244,-40
76747501621,76747501626,5,3061,2527,-40
76748429910,76748429906,-4,2240,5158,-40
76749051210,76749051217,7,3783,1422,-40
76751994177,76751994178,1,1952,1694,-40
76752485986,76752485993,7,2325,753,-40
76753361170,76753361151,-19,1453,381,-40
76757043313,76757043318,5,3647,2071,-40
76764671793,76764671797,4,1983,1693,-40
76764963910,76764963916,6,2281,952,-40
76767351184,76767351178,-6,1850,5524,-40
76768572481,76768572462,-19,1337,3181,-40
76768744422,76768744429,7,2396,1600,-40
76778876260,76778876264,4,2548,1661,-40
76779411920,76779411925,5,4003,3138,-40
76787303294,76787303276,-18,2843,1194,-40
76790697025,76790697030,5,3884,2058,-40
76791879038,76791879046,8,2536,1054,-40
76792048757,76792048747,-10,1002,426,-40
76792427123,76792427130,7,3515,1460,-40
76794337322,76794337326,4,2181,1270,-40
76796876814,76796876822,8,1650,847,-40
76797738648,76797738635,-13,848,67,-40
76799288439,76799288446,7,1508,799,-40
76799318466,76799318465,-1,1315,227,-40
76799942405,76799942395,-10,2740,711,-40
76800197718,76800197724,6,2548,1730,-40
76801482925,76801482926,1,1663,1152,-40
76802212399,76802212406,7,4158,1733,-40
76802634215,76802634221,6,2821,1735,-40
76805508307,76805508315,8,2409,1271,-40
76805852968,76805852975,7,2363,1057,-40
76807706926,76807706933,7,2530,1168,-40
76813884248,76813884254,6,3811,1414,-40
76816314333,76816314339,6,3753,1757,-40
76819968069,76819968074,5,2971,1468,-40
76831973238,76831973246,8,3427,1066,-40
76838395486,76838395491,5,3982,1717,-40
76841531887,76841531881,-6,2726,8240,-40
76843255399,76843255405,6,3182,1422,-40
76845208464,76845208470,6,3021,1427,-40
76845522106,76845522098,-8,748,5491,-40
76846942276,76846942283,7,3030,1627,-40
76851974122,76851974130,8,3055,992,-40
76853271358,76853271363,5,2653,1088,-40
76853581215,76853581222,7,4405,1498,-40
76853641793,76853641797,4,1784,1335,-40
76855386708,76855386714,6,2540,1140,-40
76859720497,76859720485,-12,2015,35925,-40
76859858389,76859858397,8,3448,1365,-40
76863023767,76863023774,7,2336,1245,-40
76865388550,76865388557,7,2175,851,-40
76869222410,76869222407,-3,1361,3007,-40
76870172171,76870172177,6,1487,823,-40
76874931370,76874931375,5,2571,1212,-40
76876388158,76876388166,8,3195,1224,-40
76879790874,76879790882,8,1491,701,-40
76879983032,76879983048,16,3123,1288,-40
76884035869,76884035875,6,1835,911,-40
76885490553,76885490559,6,3575,1378,-40
76886808425,76886808407,-18,1162,347,-40
76888684902,76888684909,7,2683,910,-40
76889852027,76889852034,7,3411,1767,-40
76891339307,76891339314,7,2396,1278,-40
76893281233,76893281241,8,2453,1173,-40
76898580300,76898580305,5,3017,1266,-40
76904416801,76904416807,6,3507,993,-40
76908524653,76908524658,5,2675,1451,-40
76910515433,76910515441,8,3730,1408,-40
76911497374,76911497379,5,2617,1089,-40
76916350256,76916350261,5,2805,1061,-40
76918936883,76918936888,5,2096,1309,-40
76919523342,76919523350,8,2656,1616,-40
76920009133,76920009139,6,2893,1210,-40
76922354489,76922354497,8,3326,1150,-40
76922939724,76922939729,5,3151,1898,-40
76923236414,76923236416,2,1795,1830,-40
76925200586,76925200592,6,4249,1916,-40
76926975454,76926975459,5,1926,1422,-40
76930022940,76930022944,4,3278,1462,-40
76931834390,76931834397,7,3671,1865,-40
76933268670,76933268675,5,2432,1306,-40
76933743424,76933743430,6,2952,1494,-40
76943942251,76943942250,-1,2161,2907,-40
76944994268,76944994283,15,159,1372,-40
76946703487,76946703495,8,3273,1603,-40
76949909913,76949909918,5,3057,1352,-40
76950139049,76950139054,5,1265,816,-40
76953360498,76953360503,5,2660,1375,-40
76965261275,76965261281,6,3769,1396,-40
76966732577,76966732558,-19,2140,613,-40
76969491411,76969491407,-4,1952,4837,-40
76972726011,76972726018,7,3671,1496,-40
76975666413,76975666419,6,3746,1576,-40
76976236313,76976236296,-17,1432,571,-40
76977840332,76977840338,6,4169,1456,-40
76980542836,76980542842,6,2988,1121,-40
76981656672,76981656679,7,3106,1226,-40
76983268148,76983268155,7,1933,1028,-40
76984346196,76984346197,1,2110,2340,-40
76984426826,76984426811,-15,10649,55409,-40
76985389153,76985389161,8,3205,1096,-40
76989335822,76989335828,6,2044,928,-40
76989780628,76989780635,7,1422,1015,-40
76990817379,76990817363,-16,754,309,-40
76991910759,76991910767,8,1887,878,-40
76993808874,76993808879,5,3405,1344,-40
76996361182,76996361185,3,2249,1281,-40
76996498295,76996498301,6,1797,920,-40
76996949689,76996949694,5,2016,995,-40
76997428838,76997428847,9,15087,24619,-40
76998416101,76998416106,5,3224,1363,-40
77000606694,77000606702,8,3150,1133,-40
77006796830,77006796837,7,3391,1459,-40
77009515861,77009515866,5,2025,912,-40
77017019814,77017019822,8,3679,1261,-40
77021097765,77021097758,-7,1581,6268,-40
77021212572,77021212579,7,2553,1164,-40
77024032921,77024032926,5,2365,1420,-40
77028898449,77028898455,6,2222,783,-40
77031749485,77031749487,2,1748,1098,-40
77032762001,77032762007,6,3154,1267,-40
77040312234,77040312241,7,3088,1792,-40
77041342793,77041342797,4,1607,1009,-40
77046655150,77046655157,7,2455,1393,-40
77050328413,77050328418,5,1842,1316,-40
77052439826,77052439834,8,4995,1756,-40
77052509733,77052509747,14,4167,1302,-40
77052544890,77052544905,15,3492,1591,-40
77052751294,77052751284,-10,2098,575,-40
77053098442,77053098448,6,2768,955,-40
77056563853,77056563859,6,1933,1363,-40
77058017916,77058017916,0,2191,3042,-40
77059294491,77059294499,8,2880,1109,-40
77061611444,77061611451,7,2946,1507,-40
77061791909,77061791916,7,3464,1548,-40
77063751199,77063751206,7,2849,1100,-40
77066120826,77066120831,5,1792,1447,-40
77068113098,77068113101,3,912,1047,-40
77070954858,77070954867,9,2216,1036,-40
77071738125,77071738131,6,2263,1347,-40
77073194354,77073194355,1,1699,1392,-40
77073431079,77073431075,-4,848,2621,-40
77074040602,77074040606,4,2546,1393,-40
77074113407,77074113414,7,2978,1055,-40
77075790165,77075790170,5,2493,1404,-40
77076025934,77076025922,-12,843,316,-40
77076866559,77076866567,8,2645,1385,-40
77080256698,77080256703,5,2396,1436,-40
77081918345,77081918350,5,3376,1095,-40
77082432814,77082432818,4,2268,1350,-40
77082629951,77082629931,-20,1309,230,-40
77092936342,77092936349,7,1845,708,-40
77094227465,77094227471,6,2607,925,-40
77094678430,77094678449,19,852,268,-40
77097505997,77097506003,6,3513,2036,-40
77098560974,77098560981,7,3118,1411,-40
77099236258,77099236265,7,3115,1187,-40
77099615029,77099615012,-17,794,102,-40
77102611047,77102611054,7,2297,886,-40
77105886443,77105886450,7,2767,1551,-40
77107150920,77107150926,6,2853,2013,-40
77108672061,77108672066,5,3019,952,-40
77112806982,77112806990,8,2872,1196,-40
77115040987,77115040993,6,3797,1524,-40
77119781839,77119781845,6,4049,1626,-40
77121241931,77121241913,-18,2467,1573,-40
77122566670,77122566674,4,3032,1366,-40
77123036375,77123036381,6,3790,1802,-40
77123916298,77123916306,8,3133,1126,-40
77129137846,77129137851,5,2768,1384,-40
77129639034,77129639038,4,1746,912,-40
77130128117,77130128129,12,808,136,-40
77130488405,77130488411,6,2853,1144,-40
77133100531,77133100535,4,3318,1101,-40
77133938793,77133938778,-15,2387,1679,-40
77136151834,77136151842,8,2799,1343,-40
77136573329,77136573322,-7,1502,4648,-40
77138935583,77138935580,-3,1338,3133,-40
77139599996,77139600002,6,3974,1456,-40
77142555731,77142555738,7,2740,1745,-40
77145802261,77145802267,6,2420,1126,-40
77148367185,77148367191,6,3455,1339,-40
77150981626,77150981634,8,2882,1380,-40
77154161024,77154161030,6,1914,1068,-40
77159462528,77159462536,8,2643,968,-40
77161023994,77161024001,7,3405,1466,-40
77161105773,77161105778,5,2043,1041,-40
77162178399,77162178404,5,3463,1757,-40
77162239297,77162239301,4,2336,1055,-40
77163337185,77163337190,5,2576,1517,-40
77166794606,77166794610,4,1890,1403,-40
77166944978,77166944971,-7,1192,454,-40
77169040701,77169040707,6,1506,1181,-40
77169536610,77169536619,9,3722,908,-40
77177435322,77177435329,7,2099,843,-40
77180334050,77180334056,6,2427,959,-40
77183249918,77183249926,8,3371,1477,-40
77183318097,77183318101,4,2117,1508,-40
77185385711,77185385718,7,2723,1094,-40
77188249215,77188249206,-9,30185,17164,-40
77188999531,77188999536,5,2192,1120,-40
77193293332,77193293336,4,1960,1026,-40
77194497945,77194497951,6,2080,1525,-40
77200901377,77200901382,5,2173,1017,-40
77201763445,77201763451,6,2366,713,-40
77206829876,77206829882,6,3433,1907,-40
77207228478,77207228483,5,2763,1189,-40
77215681233,77215681239,6,3145,1313,-40
77216223439,77216223446,7,3494,1871,-40
77219594080,77219594085,5,3189,2043,-40
77220077290,77220077296,6,3217,1598,-40
77222654379,77222654385,6,2767,1142,-40
77229728424,77229728431,7,2463,1117,-40
77233782754,77233782758,4,2243,1010,-40
77235131316,77235131321,5,2468,1167,-40
77241675557,77241675562,5,2153,643,-40
77244536909,77244536918,9,2356,1066,-40
77244568773,77244568778,5,1490,937,-40
77244660969,77244660970,1,1287,1744,-40
77246624488,77246624495,7,6169,2368,-40
77246748514,77246748520,6,1888,1631,-40
77251174734,77251174740,6,2925,1262,-40
77252728863,77252728870,7,2107,1173,-40
77258182173,77258182178,5,2310,1407,-40
77258310354,77258310363,9,595,196,-40
77263155838,77263155846,8,3066,1233,-40
77265984937,77265984932,-5,2473,6308,-40
77266839679,77266839685,6,2158,1138,-40
77266983578,77266983562,-16,1591,465,-40
77268162878,77268162883,5,3064,1158,-40
77271291608,77271291611,3,1190,842,-40
77273379258,77273379264,6,3165,1677,-40
77273721206,77273721194,-12,845,304,-40
77274613345,77274613331,-14,1514,759,-40
77277659835,77277659842,7,3558,1495,-40
77283798261,77283798256,-5,1654,5906,-40
77283941899,77283941910,11,17035,15278,-40
77284749335,77284749340,5,3349,1530,-40
77291635162,77291635169,7,2935,1265,-40
77292262352,77292262346,-6,32721,13993,-40
77293545065,77293545064,-1,2405,4316,-40
77297315141,77297315147,6,3180,1342,-40
77302063758,77302063763,5,1505,1000,-40
77303972437,77303972441,4,1938,1516,-40
77304116533,77304116539,6,2862,1164,-40
77309039906,77309039911,5,3186,1223,-40
77309275628,77309275610,-18,1183,608,-40
77310092628,77310092651,23,2761,1122,-40
77312046381,77312046387,6,2814,1042,-40
77312110541,77312110547,6,2751,1344,-40
77312505126,77312505130,4,2432,1370,-40
77313117249,77313117243,-6,2358,7103,-40
77315110558,77315110564,6,1368,900,-40
77319414926,77319414933,7,4121,1499,-40
77321334959,77321334965,6,2369,1314,-40
77324548912,77324548917,5,2509,1144,-40
77327344565,77327344571,6,2723,792,-40
77327611789,77327611796,7,2561,1306,-40
77329680990,77329680995,5,1853,867,-40
77331873222,77331873228,6,2710,1439,-40
77333990682,77333990688,6,2282,931,-40
77340498119,77340498127,8,2936,1064,-40
77352525032,77352525037,5,2298,1365,-40
77354078870,77354078885,15,2103,1107,-40
77361595990,77361595985,-5,2232,5342,-40
77366777781,77366777787,6,2567,1242,-40
77367278927,77367278934,7,2913,1494,-40
77369724886,77369724891,5,1350,1077,-40
77371139823,77371139817,-6,797,3327,-40
77375827342,77375827349,7,4003,1019,-40
77378389181,77378389187,6,1571,1126,-40
77379082761,77379082766,5,2554,1460,-40
77381725269,77381725275,6,3200,1298,-40
77384032630,77384032631,1,3689,2875,-40
77385876062,77385876068,6,1457,1141,-40
77387677026,77387677032,6,2772,1451,-40
77394775611,77394775607,-4,1088,4055,-40
77396843068,77396843074,6,2684,1506,-40
77402832845,77402832853,8,3174,1426,-40
77408177454,77408177458,4,2114,1615,-40
77409542434,77409542441,7,3599,1680,-40
77410302038,77410302039,1,1871,1833,-40
77414010666,77414010671,5,2264,1555,-40
77414308738,77414308724,-14,3296,1072,-40
77414386191,77414386198,7,2438,1414,-40
77416156314,77416156299,-15,1333,743,-40
77416507627,77416507635,8,3657,1427,-40
77418948342,77418948347,5,3038,971,-40
77420336754,77420336758,4,3362,2469,-40
77421298290,77421298294,4,2332,1065,-40
77421682326,77421682330,4,3322,1289,-40
77421759279,77421759281,2,1375,1069,-40
77429687962,77429687966,4,2872,1048,-40
77430063655,77430063635,-20,2025,1219,-40
77435830548,77435830555,7,2514,1328,-40
77436376402,77436376410,8,2494,1681,-40
77436566663,77436566659,-4,652,112,-40
77439255832,77439255837,5,3042,1642,-40
77439629913,77439629921,8,2611,1176,-40
77440179692,77440179698,6,3635,1286,-40
77444149479,77444149486,7,2776,1873,-40
77444842118,77444842125,7,3169,1801,-40
77445075848,77445075854,6,2670,847,-40
77460830574,77460830581,7,2974,1162,-40
77465700474,77465700485,11,2409,875,-40
77465803889,77465803899,10,2100,1018,-40
77470743711,77470743716,5,2786,1006,-40
77472226097,77472226105,8,2471,879,-40
77472632510,77472632517,7,2742,1159,-40
77474408315,77474408321,6,2223,1100,-40
77475135189,77475135211,22,1219,274,-40
77481180304,77481180307,3,1298,954,-40
77482482229,77482482230,1,2077,1332,-40
77483042872,77483042879,7,2101,784,-40
77484187991,77484187986,-5,958,255,-40
77485853980,77485853986,6,2908,1483,-40
77500446934,77500446939,5,2982,1552,-40
77503614325,77503614333,8,2396,1395,-40
77513377097,77513377102,5,3671,1622,-40
77519228666,77519228672,6,2231,1023,-40
77525286733,77525286738,5,1707,1257,-40
77528736873,77528736877,4,1821,1041,-40
77530890810,77530890814,4,2989,1342,-40
77531220086,77531220092,6,2770,849,-40
77532987622,77532987629,7,1542,888,-40
77533955566,77533955571,5,2725,1446,-40
77535632257,77535632254,-3,1059,3279,-40
77537373209,77537373215,6,2732,1269,-40
77542716687,77542716694,7,2248,1129,-40
77547817567,77547817574,7,3058,1347,-40
77548784768,77548784774,6,3447,1385,-40
77548987666,77548987671,5,2703,1320,-40
77550860125,77550860131,6,2891,1043,-40
77552719226,77552719230,4,2576,1529,-40
77553801032,77553801029,-3,1489,2953,-40
77556261086,77556261090,4,2201,1808,-40
77556762781,77556762785,4,951,675,-40
77557506024,77557506030,6,1904,974,-40
77558387222,77558387227,5,3895,1397,-40
77566842820,77566842818,-2,19349,15809,-40
77576706671,77576706678,7,3087,1732,-40
77577026487,77577026494,7,4048,1111,-40
77579411383,77579411390,7,3107,1322,-40
77580034654,77580034662,8,2742,1469,-40
77580080356,77580080362,6,4187,1500,-40
77580297969,77580297975,6,1493,670,-40
77582624327,77582624326,-1,928,1564,-40
77583818245,77583818250,5,1402,953,-40
77590917601,77590917605,4,3230,1453,-40
77591326102,77591326108,6,4121,2542,-40
77593465428,77593465433,5,3223,1409,-40
77595741495,77595741502,7,1667,1117,-40
77596207423,77596207411,-12,1219,733,-40
77600109633,77600109614,-19,3679,1950,-40
77600818521,77600818528,7,3929,1285,-40
77603840818,77603840823,5,2162,1136,-40
77605541202,77605541210,8,2931,1504,-40
77606325499,77606325507,8,3175,1069,-40
77609403121,77609403128,7,2812,1382,-40
77610851196,77610851202,6,3648,1464,-40
77612725246,77612725251,5,1923,1114,-40
77612887751,77612887758,7,2533,1416,-40
77614879146,77614879152,6,2801,1715,-40
77619970649,77619970657,8,2260,1217,-40
77620938319,77620938325,6,2678,1163,-40
77621317522,77621317529,7,1442,670,-40
77621678003,77621677986,-17,2572,979,-40
77621840909,77621840891,-18,2417,939,-40
77622071466,77622071473,7,1998,1249,-40
77622877034,77622877042,8,3474,1427,-40
77627874401,77627874402,1,2557,3526,-40
77628499197,77628499204,7,5124,1898,-40
77641387054,77641387060,6,3224,1167,-40
77641718246,77641718234,-12,3310,1352,-40
77646736744,77646736749,5,2523,1221,-40
77651387778,77651387786,8,2251,993,-40
77652542422,77652542425,3,2166,2295,-40
77657012141,77657012145,4,1362,1189,-40
77659353536,77659353542,6,2722,1714,-40
77660588024,77660588032,8,4713,973,-40
77660860260,77660860267,7,2897,1307,-40
77666736274,77666736282,8,2501,995,-40
77667403947,77667403955,8,2807,1013,-40
77668978538,77668978543,5,1502,811,-40
77669310291,77669310292,1,659,28,-40
77671206733,77671206741,8,3471,1641,-40
77676260564,77676260569,5,2038,1315,-40
77676788647,77676788643,-4,1500,2013,-40
77679074538,77679074531,-7,806,376,-40
77680307398,77680307406,8,3063,1053,-40
77683127515,77683127521,6,3004,1970,-40
77683950725,77683950731,6,3089,1454,-40
77689596238,77689596243,5,2121,1178,-40
77694016347,77694016354,7,2350,1187,-40
77694695401,77694695407,6,2307,1061,-40
77695650241,77695650247,6,3012,1634,-40
77695726728,77695726731,3,2078,1052,-40
77698783243,77698783251,8,2407,1454,-40
77702373765,77702373771,6,3655,1061,-40
77707345486,77707345479,-7,2079,6165,-40
77709050497,77709050503,6,2740,957,-40
77709879692,77709879675,-17,903,408,-40
77710944742,77710944748,6,3208,1198,-40
77712801301,77712801308,7,2742,1274,-40
77718383873,77718383879,6,2117,1239,-40
77719562855,77719562875,20,1059,390,-40
77720686749,77720686751,2,1153,724,-40
77724071101,77724071106,5,3136,1411,-40
77724732183,77724732188,5,3845,1583,-40
77727569123,77727569130,7,2813,1408,-40
77732297487,77732297469,-18,960,345,-40
77734887918,77734887918,0,1313,1308,-40
77736283097,77736283102,5,2704,1040,-40
77739405390,77739405396,6,3571,1999,-40
77740876518,77740876519,1,1244,21673,-40
77746322986,77746322990,4,1978,979,-40
77748448358,77748448363,5,2375,1345,-40
77752463270,77752463275,5,2290,1434,-40
77753774575,77753774581,6,2217,896,-40
77754651198,77754651202,4,2935,1216,-40
77756664459,77756664465,6,2056,1370,-40
77757321038,77757321043,5,2939,1296,-40
77760534817,77760534825,8,5674,1984,-40
77761819741,77761819747,6,2325,1050,-40
77763644985,77763644991,6,2568,1314,-40
77764196870,77764196877,7,2497,1471,-40
77765511962,77765511969,7,2826,1015,-40
77769136460,77769136458,-2,503,1918,-40
77770867040,77770867047,7,2837,1439,-40
77773418523,77773418523,0,1694,13423,-40
77779244861,77779244869,8,3208,1269,-40
77782028317,77782028323,6,2095,1190,-40
77785135720,77785135723,3,1829,1273,-40
77789614873,77789614878,5,2687,1092,-40
77789822325,77789822332,7,3114,898,-40
77791263491,77791263498,7,3469,1826,-40
77793073009,77793073015,6,1810,1132,-40
77793362682,77793362667,-15,2867,1256,-40
77794990894,77794990902,8,3338,1363,-40
77795686868,77795686874,6,2282,652,-40
77796513250,77796513257,7,3691,1590,-40
77805277089,77805277094,5,3152,1589,-40
77810531446,77810531453,7,2055,1238,-40
77812279034,77812279033,-1,1495,2480,-40
77812938676,77812938674,-2,1142,256,-40
77813425828,77813425834,6,3093,1640,-40
77815416579,77815416585,6,2303,1244,-40
77819922694,77819922701,7,2626,1338,-40
77821467330,77821467337,7,2030,1008,-40
77825627303,77825627283,-20,1518,1042,-40
77828415230,77828415236,6,4077,1547,-40
77828584270,77828584277,7,2940,1004,-40
77829352342,77829352342,0,1730,1545,-40
77830640555,77830640563,8,2787,1050,-40
77833448356,77833448362,6,3484,1877,-40
77835484905,77835484911,6,3342,1789,-40
77847559236,77847559242,6,2753,1689,-40
77847994070,77847994077,7,2251,1152,-40
77848825350,77848825363,13,1697,269,-40
77855899094,77855899101,7,3357,1243,-40
77861549653,77861549659,6,2535,1018,-40
77862611462,77862611441,-21,1128,460,-40
77865324441,77865324449,8,1369,760,-40
77867285213,77867285219,6,2160,955,-40
77868981989,77868981991,2,1132,1826,-40
77872652068,77872652075,7,3231,878,-40
77874485318,77874485322,4,1656,1071,-40
77875075355,77875075362,7,3083,1760,-40
77875514095,77875514102,7,1649,1206,-40
77879347502,77879347507,5,2005,822,-40
77880854408,77880854414,6,3557,1511,-40
77881739491,77881739504,13,876,83,-40
77884849006,77884849013,7,2933,987,-40
77884874715,77884874722,7,2915,1288,-40
77888109659,77888109665,6,3474,1526,-40
77890532530,77890532534,4,1970,1174,-40
77891025089,77891025095,6,2510,1285,-40
77896478079,77896478086,7,3312,1412,-40
77898511845,77898511844,-1,92,1871,-40
77899402317,77899402314,-3,1494,3434,-40
77900414937,77900414942,5,1427,769,-40
77901496322,77901496326,4,2152,1040,-40
77907659736,77907659742,6,2461,1330,-40
77907745397,77907745402,5,1886,1208,-40
77914962893,77914962898,5,2492,873,-40
77919379271,77919379278,7,3155,1306,-40
77923410827,77923410834,7,3454,1097,-40
77929625056,77929625062,6,3150,880,-40
77930015690,77930015704,14,3073,1159,-40
77930358316,77930358297,-19,125,773,-40
77930675627,77930675634,7,2345,1205,-40
77930991226,77930991211,-15,2400,1107,-40
77933674487,77933674491,4,2768,1535,-40
77934100807,77934100814,7,2508,1263,-40
77934777665,77934777669,4,2275,1222,-40
77934825615,77934825595,-20,746,306,-40
77941625301,77941625305,4,2531,1135,-40
77942328406,77942328427,21,3483,1491,-40
77942970088,77942970095,7,2346,956,-40
77943044290,77943044289,-1,2178,3882,-40
77943268454,77943268450,-4,1344,2318,-40
77943361261,77943361266,5,2864,1729,-40
77943748330,77943748337,7,3403,1188,-40
77944080841,77944080859,18,1129,91,-40
77944771214,77944771218,4,1821,1276,-40
77944808697,77944808701,4,2465,1266,-40
77944954734,77944954739,5,2923,1093,-40
77945144190,77945144171,-19,3624,877,-40
77951798574,77951798575,1,746,793,-40
77954028969,77954028977,8,4028,1276,-40
77954225170,77954225178,8,927,273,-40
77957369336,77957369344,8,1436,864,-40
77958491458,77958491462,4,3144,1559,-40
77958716503,77958716510,7,3348,1573,-40
77960000647,77960000649,2,1671,1101,-40
77963132818,77963132823,5,2588,1375,-40
77963523780,77963523774,-6,2051,8519,-40
77963587956,77963587957,1,45250,34850,-40
77966354716,77966354724,8,2311,1225,-40
77966956198,77966956187,-11,2634,824,-40
77970777179,77970777187,8,3145,1352,-40
77974151924,77974151930,6,2485,1158,-40
77975260730,77975260735,5,2847,1440,-40
77975959942,77975959946,4,3391,1367,-40
77977749949,77977749950,1,1318,1430,-40
77977784762,77977784769,7,2663,1174,-40
77978808393,77978808399,6,3425,1127,-40
77979762041,77979762048,7,1827,856,-40
77981580883,77981580889,6,1413,700,-40
77993007592,77993007599,7,3196,1621,-40
77996220582,77996220587,5,3691,1581,-40
78002292546,78002292532,-14,1854,872,-40
78002394706,78002394712,6,2579,1542,-40
78003768542,78003768550,8,2149,1357,-40
78007472989,78007472968,-21,1672,679,-40
78009168666,78009168673,7,3337,1847,-40
78009704831,78009704834,3,2747,1402,-40
78010080002,78010080006,4,1879,888,-40
78010539274,78010539280,6,3198,1450,-40
78013359519,78013359526,7,10721,6870,-40
78015605702,78015605708,6,2449,1221,-40
78016651862,78016651862,0,2052,3178,-40
78017255393,78017255399,6,3807,1713,-40
78020305062,78020305066,4,2145,973,-40
78021955426,78021955434,8,2841,1235,-40
78024453086,78024453092,6,2762,1284,-40
78024660316,78024660314,-2,1798,3300,-40
78030821127,78030821135,8,2131,1004,-40
78032671704,78032671710,6,3291,1232,-40
78032858393,78032858400,7,969,256,-40
78034274788,78034274795,7,2021,1063,-40
78036126490,78036126498,8,1999,1125,-40
78036239278,78036239273,-5,740,219,-40
78040018709,78040018715,6,2840,1444,-40
78040330419,78040330402,-17,725,254,-40
78040448247,78040448235,-12,4008,1297,-40
78041029035,78041029016,-19,2960,1166,-40
78045450609,78045450614,5,2554,1677,-40
78047394368,78047394374,6,3526,1558,-40
78047715977,78047715994,17,2189,1186,-40
78049697985,78049697990,5,4970,3248,-40
78057105057,78057105062,5,2851,1224,-40
78057288779,78057288785,6,1892,991,-40
78062265249,78062265255,6,3726,1561,-40
78062676426,78062676431,5,3945,2092,-40
78065586206,78065586212,6,3836,1692,-40
78066107326,78066107333,7,3290,1547,-40
78066791309,78066791314,5,1995,1345,-40
78071617349,78071617355,6,4037,1526,-40
78073608176,78073608177,1,1893,1800,-40
78076243863,78076243866,3,2542,1355,-40
78076824075,78076824081,6,3408,1037,-40
78082044736,78082044742,6,2439,1379,-40
78094543392,78094543398,6,3994,1716,-40
78094772176,78094772183,7,3106,1304,-40
78096048116,78096048122,6,2947,1220,-40
78096773108,78096773089,-19,2617,1083,-40
78100265269,78100265274,5,2638,1970,-40
78102197472,78102197478,6,2743,1291,-40
78104837140,78104837146,6,2036,843,-40
78108063354,78108063363,9,2962,1284,-40
78110264860,78110264867,7,2291,1117,-40
78110952541,78110952547,6,3447,1607,-40
78112861865,78112861870,5,3536,1649,-40
78114383726,78114383725,-1,1141,1642,-40
78115145306,78115145313,7,620,416,-40
78115706911,78115706918,7,3436,1489,-40
78116603913,78116603913,0,1007,1461,-40
78118727245,78118727251,6,4271,1611,-40
78122665154,78122665162,8,2959,1249,-40
78125429765,78125429771,6,2725,1126,-40
78125467378,78125467383,5,2049,1353,-40
78129099573,78129099576,3,2406,1266,-40
78129222838,78129222844,6,2367,1735,-40
78129537526,78129537508,-18,2147,1400,-40
78133198766,78133198773,7,2548,1082,-40
78134746367,78134746371,4,1485,927,-40
78135924969,78135924984,15,3965,1530,-40
78136051299,78136051306,7,2642,1514,-40
78136156976,78136156979,3,3869,3597,-40
78136242686,78136242668,-18,1904,524,-40
78140613733,78140613737,4,2511,928,-40
78146095658,78146095663,5,1877,782,-40
78149245233,78149245235,2,1731,1423,-40
78151554704,78151554710,6,2491,1182,-40
78152213105,78152213110,5,2404,1053,-40
78157958351,78157958357,6,2254,1224,-40
78158415197,78158415203,6,3209,1423,-40
78163465990,78163465997,7,6824,1371,-40
78164330213,78164330220,7,2847,908,-40
78165562057,78165562068,11,2171,921,-40
78166127266,78166127273,7,4489,1327,-40
78166276818,78166276825,7,2808,1197,-40
78170081601,78170081607,6,1334,950,-40
78170731586,78170731591,5,1734,1203,-40
78171287707,78171287713,6,4180,1686,-40
78171475774,78171475781,7,1698,1110,-40
78171956924,78171956930,6,3857,2007,-40
78174577598,78174577607,9,3214,1109,-40
78176784044,78176784050,6,2466,1135,-40
78186320238,78186320254,16,280,1925,-40
78186597167,78186597174,7,3004,1275,-40
78187856829,78187856838,9,14799,21298,-40
78193782838,78193782846,8,2826,1260,-40
78193951646,78193951633,-13,923,412,-40
78195522101,78195522106,5,2123,1087,-40
78197626152,78197626154,2,10213,7546,-40
78199238054,78199238062,8,2151,973,-40
78200574086,78200574093,7,3662,1453,-40
78203199682,78203199688,6,3248,1104,-40
78207389808,78207389814,6,3617,1400,-40
78208985038,78208985042,4,1910,1435,-40
78209538324,78209538331,7,3039,1696,-40
78217196179,78217196186,7,3196,1296,-40
78220087012,78220087017,5,3057,1282,-40
78220210998,78220210978,-20,5907,3510,-40
78222069789,78222069794,5,2412,1028,-40
78222420839,78222420840,1,1013,240,-40
78224291906,78224291911,5,2682,1046,-40
78225371227,78225371234,7,2167,1220,-40
78225974074,78225974082,8,2751,953,-40
78226869887,78226869895,8,3010,1053,-40
78228333530,78228333515,-15,2786,1620,-40
78229316702,78229316708,6,3540,1084,-40
78230885484,78230885467,-17,3290,1464,-40
78232614094,78232614099,5,1399,787,-40
78236488054,78236488061,7,3213,1585,-40
78246422277,78246422271,-6,1118,4066,-40
78250369334,78250369339,5,2716,1370,-40
78254140409,78254140414,5,2016,1050,-40
78255372395,78255372402,7,3064,1515,-40
78257576537,78257576542,5,2490,1088,-40
78259777481,78259777487,6,3833,1353,-40
78264889438,78264889445,7,2332,1108,-40
78267924859,78267924863,4,2775,1201,-40
78268623736,78268623738,2,1891,1627,-40
78272365069,78272365074,5,2206,1450,-40
78273760399,78273760406,7,2828,1110,-40
78275857040,78275857027,-13,293,7122,-40
78276673548,78276673567,19,228,1033,-40
78279754686,78279754691,5,2357,1329,-40
78280093833,78280093839,6,2075,1277,-40
78280282840,78280282851,11,767,2703,-40
78280354489,78280354485,-4,730,1832,-40
78287225038,78287225046,8,3860,1662,-40
78288369280,78288369286,6,2651,1006,-40
78289628317,78289628323,6,3243,1579,-40
78290266933,78290266938,5,1211,441,-40
78291930121,78291930126,5,3493,1385,-40
78292216478,78292216465,-13,3859,651,-40
78292640281,78292640279,-2,1047,2475,-40
78298853912,78298853919,7,2677,1260,-40
78307478753,78307478759,6,3293,1070,-40
78309280862,78309280866,4,3041,1723,-40
78309361630,78309361635,5,2820,1326,-40
78310003893,78310003903,10,4278,1576,-40
78312057945,78312057950,5,2688,1407,-40
78313896826,78313896831,5,3243,1298,-40
78317565238,78317565232,-6,1895,6269,-40
78320339333,78320339336,3,1652,1155,-40
78324817172,78324817177,5,3437,1917,-40
78326518561,78326518566,5,2649,1314,-40
78330256472,78330256478,6,1485,882,-40
78331794103,78331794106,3,873,214,-40
78333788183,78333788190,7,3479,1256,-40
78334682144,78334682151,7,3027,1271,-40
78335236620,78335236622,2,2286,2667,-40
78335944221,78335944227,6,3180,1416,-40
78337507397,78337507405,8,2296,1194,-40
78338818061,78338818066,5,2456,1467,-40
78338912859,78338912865,6,2210,1370,-40
78350657589,78350657595,6,3790,1537,-40
78351383101,78351383105,4,1847,1168,-40
78351566927,78351566934,7,3083,1787,-40
78354173352,78354173358,6,3131,1380,-40
78355745238,78355745241,3,1285,1050,-40
78357332086,78357332090,4,3391,1574,-40
78358873710,78358873717,7,4287,2036,-40
78358969561,78358969545,-16,701,284,-40
78361999200,78361999207,7,3040,859,-40
78363849294,78363849292,-2,4249,50658,-40
78367623186,78367623193,7,3214,1385,-40
78373034711,78373034715,4,1737,1248,-40
78374534038,78374534045,7,1704,1079,-40
78375901235,78375901242,7,2696,1226,-40
78381495826,78381495835,9,3567,1499,-40
78383021322,78383021328,6,930,497,-40
78384079994,78384080001,7,4678,1690,-40
78384119550,78384119529,-21,2509,722,-40
78386200547,78386200554,7,4774,2000,-40
78387457330,78387457336,6,3027,1123,-40
78387869353,78387869359,6,2933,1549,-40
78388190318,78388190325,7,2227,1450,-40
78391933412,78391933419,7,3372,1171,-40
78392189012,78392189010,-2,27711,10091,-40
78392725064,78392725070,6,2643,1087,-40
78408451842,78408451849,7,2071,1201,-40
78411333874,78411333881,7,2635,1216,-40
78413182668,78413182674,6,2927,923,-40
78419033054,78419033060,6,986,350,-40
78419159498,78419159514,16,1172,128,-40
78419865703,78419865710,7,1499,929,-40
78421235787,78421235793,6,2313,970,-40
78423986273,78423986268,-5,2577,7054,-40
78425029277,78425029291,14,2923,1581,-40
78427597459,78427597465,6,1894,1030,-40
78433782278,78433782285,7,3093,1170,-40
78434955622,78434955626,4,2029,1109,-40
78443116230,78443116229,-1,1918,3620,-40
78448617128,78448617134,6,2713,1414,-40
78448962055,78448962036,-19,2071,566,-40
78451523702,78451523706,4,2600,1670,-40
78452217622,78452217627,5,1977,1339,-40
78452613536,78452613543,7,2342,1302,-40
78453053096,78453053101,5,1200,1149,-40
78453746534,78453746540,6,1873,1449,-40
78457360318,78457360320,2,3477,4159,-40
78459731094,78459731102,8,3571,1548,-40
78463754320,78463754317,-3,966,2902,-40
78466988917,78466988923,6,4549,1737,-40
78467701987,78467701985,-2,1570,3575,-40
78475843037,78475843045,8,3509,1651,-40
78480266479,78480266485,6,3838,1479,-40
78484450461,78484450468,7,3898,1258,-40
78484496120,78484496138,18,2943,1227,-40
78485381641,78485381642,1,1485,1762,-40
78488492193,78488492198,5,2557,1335,-40
78490555698,78490555705,7,3462,1903,-40
78490761950,78490761954,4,1965,1461,-40
78491915309,78491915309,0,1380,2223,-40
78491987558,78491987570,12,3261,1414,-40
78492431276,78492431258,-18,3687,1156,-40
78498179642,78498179650,8,2190,1354,-40
78499383824,78499383831,7,3264,1654,-40
78508062133,78508062129,-4,1088,1996,-40
78512842314,78512842309,-5,21471,8870,-40
78513310183,78513310189,6,2278,1507,-40
78513478178,78513478160,-18,1135,497,-40
78515300762,78515300770,8,1848,630,-40
78516793893,78516793905,12,13929,50739,-40
78517905722,78517905727,5,1906,1574,-40
78521931582,78521931589,7,3906,1505,-40
78524043690,78524043693,3,1861,1304,-40
78525373225,78525373232,7,2002,922,-40
78525741466,78525741466,0,2586,3582,-40
78529205964,78529205969,5,3603,1325,-40
78531227105,78531227109,4,1459,1234,-40
78532221307,78532221312,5,1003,1189,-40
78534148090,78534148097,7,2417,1464,-40
78535675123,78535675127,4,1595,1579,-40
78543824029,78543824035,6,2295,1046,-40
78545826642,78545826638,-4,1226,3279,-40
78549509157,78549509161,4,4232,3875,-40
78549572357,78549572362,5,1882,1166,-40
78551646229,78551646236,7,3995,1911,-40
78553538195,78553538179,-16,2595,1153,-40
78554458062,78554458068,6,2935,1652,-40
78565197402,78565197407,5,1609,946,-40
78568599546,78568599551,5,3061,1366,-40
78568890457,78568890464,7,4115,1264,-40
78569632869,78569632866,-3,1261,2566,-40
78572044044,78572044049,5,3246,1469,-40
78573568709,78573568714,5,2614,999,-40
78575090178,78575090183,5,3659,1788,-40
78576562954,78576562962,8,2165,1304,-40
78576909873,78576909880,7,3041,1297,-40
78579513085,78579513091,6,1878,1652,-40
78584914830,78584914822,-8,732,6300,-40
78585715235,78585715243,8,2742,998,-40
78588059177,78588059183,6,2575,1508,-40
78601985412,78601985417,5,2514,1213,-40
78603639706,78603639711,5,1664,1887,-40
78609561596,78609561603,7,2851,1502,-40
78610510198,78610510198,0,2292,1475,-40
78612641343,78612641349,6,2761,1352,-40
78614446005,78614446011,6,3165,793,-40
78622569693,78622569699,6,2420,959,-40
78623670574,78623670566,-8,1080,4751,-40
78625053165,78625053170,5,1666,752,-40
78625811864,78625811869,5,2625,1541,-40
78626259829,78626259835,6,2600,1183,-40
78638874389,78638874397,8,2941,1056,-40
78638911010,78638910993,-17,1546,570,-40
78655268262,78655268269,7,2243,1314,-40
78657002148,78657002155,7,3565,823,-40
78659505342,78659505347,5,1853,1105,-40
78671065742,78671065750,8,3163,1369,-40
78675695033,78675695041,8,2012,1279,-40
78677099555,78677099546,-9,35594,14710,-40
78677757842,78677757848,6,3870,1680,-40
78681375034,78681375042,8,3192,1359,-40
78684867842,78684867849,7,3166,1469,-40
78687258918,78687258925,7,2665,835,-40
78687360008,78687360014,6,2644,1422,-40
78691050350,78691050355,5,1196,626,-40
78691790267,78691790250,-17,1752,747,-40
78693507026,78693507032,6,2635,1287,-40
78693933238,78693933243,5,3135,1237,-40
78694438361,78694438367,6,3031,1103,-40
78709586928,78709586934,6,3636,1491,-40
78709656419,78709656425,6,2255,703,-40
78715262774,78715262769,-5,1556,6849,-40
78719789812,78719789818,6,3215,1338,-40
78720205821,78720205830,9,2653,993,-40
78723109889,78723109896,7,3195,1114,-40
78725300145,78725300150,5,2257,1046,-40
78725657025,78725657025,0,2664,4338,-40
78727554328,78727554333,5,3332,1184,-40
78733404678,78733404685,7,3370,1284,-40
78734507231,78734507237,6,2301,938,-40
78734948011,78734948019,8,2745,1148,-40
78741178097,78741178103,6,2796,1397,-40
78744427447,78744427454,7,3012,1345,-40
78744679778,78744679764,-14,951,501,-40
78744831130,78744831138,8,3056,1151,-40
78752882494,78752882496,2,1891,1136,-40
78753220575,78753220584,9,852,369,-40
78753776510,78753776499,-11,2377,1337,-40
78754822948,78754822954,6,2046,1231,-40
78756043117,78756043118,1,939,851,-40
78762477758,78762477755,-3,1616,3711,-40
78763625170,78763625175,5,3127,1279,-40
78766037597,78766037603,6,3031,858,-40
78768294900,78768294907,7,3091,1661,-40
78772405033,78772405033,0,1834,3642,-40
78780505551,78780505554,3,2423,1539,-40
78783593081,78783593087,6,2940,1593,-40
78784537202,78784537203,1,2213,3043,-40
78785542842,78785542842,0,1376,1771,-40
78786349378,78786349385,7,3607,1136,-40
78786925226,78786925232,6,2918,1371,-40
78787027194,78787027201,7,2471,1438,-40
78788757886,78788757890,4,2424,1802,-40
78794309081,78794309072,-9,3431,1144,-40
78795247582,78795247601,19,3168,1580,-40
78796906954,78796906951,-3,1309,1160,-40
78800070418,78800070423,5,2051,1598,-40
78801056875,78801056881,6,3719,1534,-40
78801621447,78801621453,6,3249,1478,-40
78813398523,78813398530,7,2604,944,-40
78815242538,78815242545,7,3478,1663,-40
78815685008,78815685011,3,1955,1000,-40
78816013478,78816013485,7,3121,1639,-40
78820259592,78820259598,6,1665,778,-40
78822245268,78822245274,6,3378,1228,-40
78825131677,78825131677,0,2953,4197,-40
78826968885,78826968890,5,3525,755,-40
78827149652,78827149632,-20,1850,677,-40
78827355251,78827355248,-3,757,1974,-40
78832450608,78832450614,6,3021,1013,-40
78835081850,78835081858,8,2616,996,-40
78837647208,78837647213,5,4881,2914,-40
78863357995,78863358001,6,2555,1788,-40
78867531980,78867531986,6,2083,1170,-40
78870861064,78870861071,7,2298,1080,-40
78873759656,78873759662,6,3719,1055,-40
78875198934,78875198941,7,2837,1340,-40
78878170350,78878170357,7,3223,1576,-40
78878852017,78878852023,6,2614,1593,-40
78879633081,78879633087,6,2436,1008,-40
78882208137,78882208142,5,2897,1284,-40
78891642880,78891642883,3,1897,1345,-40
78892844531,78892844537,6,3001,1192,-40
78893076889,78893076881,-8,724,266,-40
78893541671,78893541652,-19,1448,416,-40
78894431683,78894431689,6,3196,1252,-40
78897056482,78897056489,7,2420,1400,-40
78897746428,78897746418,-10,1306,805,-40
78897782229,78897782238,9,2351,1321,-40
78898836570,78898836582,12,2052,948,-40
78900111637,78900111637,0,3147,3632,-40
78904063821,78904063826,5,2410,1661,-40
78908384434,78908384441,7,2350,1532,-40
78912306537,78912306543,6,2407,1175,-40
78913229370,78913229375,5,2746,1559,-40
78920366892,78920366898,6,4491,1573,-40
78922433130,78922433137,7,2424,1747,-40
78928462674,78928462674,0,2856,3876,-40
78930526422,78930526421,-1,2377,3931,-40
78931974622,78931974627,5,2261,1141,-40
78935110530,78935110538,8,2501,1390,-40
78940538300,78940538306,6,3152,1514,-40
78941664646,78941664651,5,1240,1063,-40
78941933099,78941933089,-10,872,444,-40
78943516672,78943516681,9,2086,1136,-40
78945896982,78945896988,6,2522,1408,-40
78950776069,78950776052,-17,882,364,-40
78951373644,78951373638,-6,1005,2701,-40
78951602438,78951602443,5,4417,1559,-40
78954060141,78954060146,5,2928,1366,-40
78954383358,78954383356,-2,715,1468,-40
78955654358,78955654363,5,1542,893,-40
78957074420,78957074427,7,2653,963,-40
78957531242,78957531246,4,2870,1445,-40
78958276505,78958276511,6,2652,1256,-40
78960164586,78960164590,4,1911,935,-40
78963297742,78963297730,-12,690,264,-40
78963751621,78963751601,-20,1830,769,-40
78968955134,78968955142,8,4339,2279,-40
78979728569,78979728574,5,3458,1695,-40
78979974317,78979974321,4,1897,1741,-40
78983226799,78983226806,7,2888,1209,-40
78983901865,78983901872,7,2701,1437,-40
78991337842,78991337850,8,2885,1135,-40
78993256076,78993256082,6,3064,1405,-40
79000222836,79000222842,6,2390,857,-40
79000596280,79000596287,7,2651,1419,-40
79004355954,79004355958,4,3050,1466,-40
79008861292,79008861297,5,2662,1511,-40
79009794135,79009794142,7,2083,1611,-40
79011595847,79011595854,7,2934,1477,-40
79016780339,79016780346,7,2861,1362,-40
79017049262,79017049267,5,2132,1030,-40
79018444025,79018444032,7,3855,1693,-40
79028158007,79028158013,6,1668,1036,-40
79036115489,79036115497,8,2516,1245,-40
79041980161,79041980168,7,2994,1207,-40
79042605649,79042605636,-13,2387,737,-40
79043931246,79043931251,5,2607,1303,-40
79044776882,79044776887,5,3540,1187,-40
79047862780,79047862764,-16,1287,496,-40
79048081071,79048081072,1,1868,1668,-40
79049626841,79049626844,3,2031,1235,-40
79051965018,79051965024,6,3408,1235,-40
79053391696,79053391705,9,923,231,-40
79056843598,79056843604,6,3943,1447,-40
79064598758,79064598765,7,2630,1160,-40
79067346982,79067346988,6,4087,1906,-40
79074164611,79074164617,6,2285,901,-40
79076502038,79076502046,8,1908,868,-40
79078441474,79078441481,7,2367,833,-40
79080344131,79080344139,8,1957,900,-40
79082772041,79082772046,5,2069,1228,-40
79088207333,79088207338,5,2403,1039,-40
79092240165,79092240170,5,2632,1350,-40
79092970558,79092970562,4,1512,845,-40
79095320433,79095320426,-7,981,2901,-40
79097452341,79097452348,7,3585,1806,-40
79097791884,79097791890,6,2560,1560,-40
79100906387,79100906382,-5,554,2922,-40
79102432882,79102432886,4,3316,1160,-40
79103035055,79103035064,9,1717,1003,-40
79104653680,79104653686,6,1954,1010,-40
79107849039,79107849045,6,2715,1470,-40
79112990493,79112990500,7,4464,1819,-40
79113973265,79113973270,5,2615,1190,-40
79116427593,79116427597,4,1926,1360,-40
79117411639,79117411654,15,1271,923,-40
79119424754,79119424761,7,4023,2169,-40
79124103429,79124103434,5,3479,1223,-40
79124132802,79124132784,-18,3314,1207,-40
79128206502,79128206509,7,2588,923,-40
79129498254,79129498262,8,3980,1306,-40
79130212270,79130212281,11,3244,1291,-40
79131933171,79131933176,5,2701,1333,-40
79132086314,79132086321,7,2329,1393,-40
79136337449,79136337454,5,3202,1740,-40
79139015434,79139015440,6,2321,1267,-40
79142339936,79142339921,-15,1674,1627,-40
79143677334,79143677340,6,2923,1155,-40
79145359449,79145359454,5,2604,1324,-40
79163019193,79163019199,6,4638,1397,-40
79167008621,79167008627,6,2002,1253,-40
79167109595,79167109599,4,1502,1048,-40
79176865384,79176865390,6,2199,1229,-40
79182168581,79182168587,6,2469,1124,-40
79182597330,79182597335,5,5025,3744,-40
79183524545,79183524550,5,2438,1205,-40
79192443045,79192443051,6,1849,1664,-40
79193536482,79193536487,5,2660,1213,-40
79195346537,79195346527,-10,1202,5646,-40
79196265449,79196265457,8,3563,1558,-40
79198038395,79198038403,8,2613,1132,-40
79198689322,79198689306,-16,3316,1433,-40
79204985983,79204985990,7,2592,1124,-40
79207042911,79207042917,6,2507,1352,-40
79208185536,79208185531,-5,33721,14482,-40
79211750511,79211750518,7,1811,734,-40
79215049923,79215049927,4,1727,1020,-40
79215414097,79215414103,6,3414,1191,-40
79215919916,79215919922,6,4680,1322,-40
79217142438,79217142446,8,2305,909,-40
79224234925,79224234944,19,2035,966,-40
79226695023,79226695030,7,2164,1026,-40
79226731598,79226731576,-22,2546,1555,-40
79233757901,79233757907,6,3072,1057,-40
79235721377,79235721382,5,2610,847,-40
79236574657,79236574663,6,3033,889,-40
79239078098,79239078103,5,1898,971,-40
79240129731,79240129739,8,2373,969,-40
79241305325,79241305331,6,1261,577,-40
79243703105,79243703110,5,2858,1777,-40
79244051792,79244051798,6,1184,1072,-40
79247173021,79247173021,0,1406,1776,-40
79248356071,79248356069,-2,1049,1103,-40
79250436403,79250436405,2,2182,1167,-40
79251400742,79251400746,4,2176,1628,-40
79253866997,79253867002,5,1602,750,-40
79253907830,79253907835,5,4152,1172,-40
79254772094,79254772100,6,3825,1240,-40
79255206533,79255206540,7,3656,1364,-40
79256612387,79256612394,7,1885,1259,-40
79256787726,79256787733,7,2062,1172,-40
79257459378,79257459383,5,2582,1289,-40
79261655494,79261655498,4,2205,904,-40
79270418869,79270418875,6,3158,1730,-40
79273042521,79273042528,7,4640,1769,-40
79275938422,79275938408,-14,1455,33137,-40
79276452547,79276452554,7,2854,1209,-40
79280705933,79280705939,6,3073,1280,-40
79280914385,79280914379,-6,938,188,-40
79284369442,79284369443,1,1616,2015,-40
79287345638,79287345643,5,1830,1536,-40
79287912250,79287912256,6,3667,1082,-40
79300252290,79300252293,3,1030,1775,-40
79300964405,79300964410,5,3168,1319,-40
79301803626,79301803631,5,2936,1155,-40
79303905065,79303905073,8,2356,1115,-40
79307740927,79307740933,6,2701,1332,-40
79307782197,79307782204,7,2280,938,-40
79309288400,79309288406,6,3589,1535,-40
79309548321,79309548326,5,2040,861,-40
79311513877,79311513884,7,3428,1465,-40
79311904463,79311904467,4,983,594,-40
79312596705,79312596712,7,3169,1141,-40
79316724432,79316724447,15,15658,35802,-40
79317783783,79317783785,2,2194,2640,-40
79319071198,79319071205,7,1560,838,-40
79320485122,79320485127,5,2920,1397,-40
79324132298,79324132302,4,1771,1460,-40
79324673922,79324673907,-15,1811,559,-40
79324821563,79324821569,6,3620,1920,-40
79325995501,79325995499,-2,20896,9232,-40
79327361695,79327361701,6,2186,1370,-40
79336956325,79336956330,5,4210,1687,-40
79337159790,79337159793,3,1649,1098,-40
79338485101,79338485106,5,1703,868,-40
79338562687,79338562696,9,2717,1260,-40
79340837849,79340837854,5,3233,1285,-40
79341938705,79341938711,6,3011,1486,-40
79345484713,79345484733,20,15950,53034,-40
79345811862,79345811867,5,1661,1160,-40
79346469246,79346469252,6,2003,977,-40
79346770847,79346770859,12,720,264,-40
79349354190,79349354197,7,4080,1147,-40
79349873966,79349873974,8,3445,1541,-40
79355880034,79355880037,3,2386,1382,-40
79357982109,79357982115,6,1969,909,-40
79358443054,79358443036,-18,1683,317,-40
79359333452,79359333460,8,2291,1229,-40
79359697167,79359697173,6,3268,1940,-40
79361182973,79361182978,5,3142,1304,-40
79362491454,79362491459,5,2148,1233,-40
79365380265,79365380269,4,3098,1522,-40
79368833145,79368833150,5,3793,1402,-40
79370858812,79370858818,6,3163,1321,-40
79370990190,79370990171,-19,2205,712,-40
79374707668,79374707674,6,3456,1468,-40
79374742175,79374742160,-15,1720,743,-40
79381235419,79381235422,3,2382,1363,-40
79384022350,79384022350,0,2361,2878,-40
79388623270,79388623275,5,2593,1035,-40
79390728643,79390728650,7,2588,1590,-40
79390892870,79390892875,5,2233,938,-40
79392122594,79392122599,5,2950,1309,-40
79397120953,79397120958,5,3132,1684,-40
79398400221,79398400227,6,2055,1431,-40
79399896701,79399896707,6,3644,1171,-40
79400124682,79400124689,7,2806,1198,-40
79404306646,79404306654,8,2517,1367,-40
79408624509,79408624515,6,2939,1243,-40
79409519588,79409519591,3,1435,1299,-40
79410051878,79410051882,4,2897,1147,-40
79411661221,79411661227,6,3258,1514,-40
79412833097,79412833102,5,2982,1294,-40
79413325429,79413325436,7,2619,1621,-40
79416663198,79416663203,5,1830,1056,-40
79418524506,79418524513,7,1933,838,-40
79421620697,79421620705,8,811,666,-40
79422987978,79422987985,7,2886,1712,-40
79431857960,79431857966,6,4646,1850,-40
79434623259,79434623264,5,3241,1232,-40
79435369407,79435369414,7,1662,444,-40
79436632845,79436632854,9,2936,1236,-40
79440288712,79440288707,-5,1027,2768,-40
79440411110,79440411115,5,2732,1487,-40
79441133545,79441133537,-8,25855,16435,-40
79446676892,79446676898,6,2142,1029,-40
79447909354,79447909359,5,2265,1063,-40
79451468477,79451468491,14,165,1706,-40
79452564654,79452564662,8,2689,903,-40
79463448878,79463448887,9,2805,1113,-40
79464935806,79464935802,-4,843,3748,-40
79465158834,79465158833,-1,3191,3821,-40
79465348688,79465348691,3,3970,3189,-40
79470714297,79470714303,6,2338,1283,-40
79471299786,79471299792,6,3169,1353,-40
79472234806,79472234813,7,3294,1226,-40
79478462621,79478462625,4,2215,1082,-40
79478997722,79478997707,-15,1403,655,-40
79481802850,79481802857,7,2535,1397,-40
79482828605,79482828610,5,1753,1049,-40
79485975893,79485975893,0,1566,2212,-40
79486387138,79486387145,7,3402,1067,-40
79487130007,79487130014,7,2606,1104,-40
79487370773,79487370752,-21,1109,170,-40
79492732276,79492732282,6,3164,1259,-40
79496146486,79496146491,5,2728,988,-40
79497143586,79497143600,14,2352,1031,-40
79498304178,79498304185,7,3161,1340,-40
79499393317,79499393322,5,2788,1021,-40
79500697722,79500697727,5,3288,1327,-40
79501954400,79501954405,5,1719,1072,-40
79502221531,79502221547,16,3371,1213,-40
79503910029,79503910034,5,2557,1275,-40
79503940979,79503940986,7,1935,1125,-40
79505216303,79505216309,6,2835,1306,-40
79505441118,79505441113,-5,747,257,-40
79509113050,79509113058,8,3009,1589,-40
79509671757,79509671763,6,2698,1060,-40
79513640570,79513640569,-1,1273,2105,-40
79516768510,79516768517,7,3103,749,-40
79521735447,79521735454,7,2569,1316,-40
79521856109,79521856115,6,2608,1331,-40
79522482345,79522482351,6,2750,972,-40
79522798143,79522798162,19,2725,1289,-40
79523544711,79523544718,7,2830,917,-40
79524005973,79524005978,5,1957,1514,-40
79525828449,79525828458,9,4491,2088,-40
79526139354,79526139362,8,2728,1168,-40
79526986517,79526986522,5,3162,1493,-40
79530563751,79530563758,7,2625,1302,-40
79532065591,79532065598,7,2804,926,-40
79535735787,79535735794,7,3103,1602,-40
79536666627,79536666614,-13,1078,326,-40
79540588349,79540588356,7,2316,1610,-40
79544575757,79544575762,5,1865,1322,-40
79545104953,79545104938,-15,2272,848,-40
79549119816,79549119822,6,3130,1648,-40
79549406149,79549406156,7,2937,1494,-40
79550880244,79550880251,7,2713,1528,-40
79552811145,79552811150,5,2744,1357,-40
79554604230,79554604235,5,2251,1071,-40
79559568714,79559568721,7,4064,2427,-40
79559702991,79559702998,7,2253,1253,-40
79565583090,79565583096,6,3184,1720,-40
79565792806,79565792786,-20,2240,1700,-40
79567119382,79567119390,8,3578,1285,-40
79568393545,79568393550,5,2291,1429,-40
79569241415,79569241395,-20,1132,798,-40
79574403267,79574403274,7,3327,1067,-40
79576152222,79576152221,-1,2025,2463,-40
79577339752,79577339754,2,2021,1359,-40
79580170597,79580170602,5,2221,2006,-40
79580282947,79580282945,-2,1025,306,-40
79583169759,79583169766,7,3816,1311,-40
79583625745,79583625751,6,2068,1507,-40
79583691298,79583691306,8,2912,1273,-40
79583829202,79583829184,-18,1392,1025,-40
79584924609,79584924614,5,2859,1206,-40
79585406511,79585406515,4,2476,1136,-40
79587364164,79587364170,6,3132,1441,-40
79589866926,79589866931,5,2297,918,-40
79590823426,79590823433,7,2265,1348,-40
79592431389,79592431395,6,2177,1222,-40
79595291952,79595291958,6,2295,1325,-40
79604472413,79604472421,8,3507,1594,-40
79608976566,79608976571,5,2707,1451,-40
79610682362,79610682369,7,2382,1388,-40
79611284448,79611284454,6,2632,1321,-40
79612707066,79612707070,4,2431,1429,-40
79613338101,79613338106,5,2155,1249,-40
79616679146,79616679150,4,2640,1219,-40
79618015495,79618015495,0,1078,1440,-40
79619570140,79619570146,6,2589,1026,-40
79620527473,79620527480,7,3000,1546,-40
79621850225,79621850230,5,1687,1344,-40
79625215572,79625215578,6,2236,1177,-40
79626241798,79626241805,7,3072,1229,-40
79627382450,79627382457,7,2955,1387,-40
79632867241,79632867247,6,2857,1433,-40
79633576650,79633576654,4,3256,1415,-40
79640751489,79640751497,8,3108,1092,-40
79646732558,79646732566,8,3701,1071,-40
79648240175,79648240182,7,2531,1688,-40
79649548720,79649548718,-2,1078,1290,-40
79652904326,79652904305,-21,2945,627,-40
79653727618,79653727622,4,1647,995,-40
79658970008,79658970013,5,2692,1198,-40
79659573798,79659573778,-20,2544,1189,-40
79661998594,79661998599,5,2680,1215,-40
79667741509,79667741514,5,2841,1377,-40
79668411507,79668411508,1,1164,1761,-40
79668509801,79668509786,-15,1081,346,-40
79669061094,79669061099,5,2538,1895,-40
79670207987,79670207983,-4,1298,3619,-40
79672080805,79672080811,6,2231,1241,-40
79677794870,79677794877,7,2535,1172,-40
79683717614,79683717623,9,2977,1499,-40
79684836522,79684836531,9,1964,1460,-40
79688383161,79688383169,8,4462,1471,-40
79693381019,79693381026,7,2567,941,-40
79693673664,79693673670,6,2553,1396,-40
79695645038,79695645045,7,3403,1053,-40
79697054996,79697055001,5,4835,1577,-40
79698703594,79698703599,5,2745,1174,-40
79700063460,79700063466,6,2053,891,-40
79701090045,79701090066,21,3078,1366,-40
79707477886,79707477895,9,2552,1367,-40
79709045322,79709045326,4,1875,1928,-40
79709429638,79709429643,5,3442,1358,-40
79710935513,79710935506,-7,1134,4074,-40
79713307028,79713307035,7,2902,959,-40
79715171617,79715171623,6,1522,690,-40
79720252045,79720252046,1,3557,4056,-40
79723730233,79723730239,6,2662,1286,-40
79731062799,79731062794,-5,1115,4063,-40
79734585527,79734585533,6,5326,2672,-40
79736606582,79736606590,8,2916,1470,-40
79741511517,79741511522,5,2381,1283,-40
79743316110,79743316107,-3,1892,2680,-40
79744908253,79744908259,6,3228,1320,-40
79746397887,79746397893,6,3756,1310,-40
79746532583,79746532577,-6,585,2610,-40
79748420806,79748420813,7,4435,1428,-40
79749215081,79749215087,6,2448,1296,-40
79755353223,79755353227,4,2029,1430,-40
79755423539,79755423547,8,3406,1402,-40
79755941740,79755941746,6,2323,1025,-40
79757916422,79757916429,7,3231,1178,-40
79759420632,79759420638,6,3466,1643,-40
79761949710,79761949713,3,817,1389,-40
79762554305,79762554311,6,2378,1273,-40
79764170334,79764170329,-5,25204,11012,-40
79776272226,79776272234,8,1729,1214,-40
79776350086,79776350067,-19,2152,865,-40
79776554510,79776554488,-22,669,83,-40
79781928491,79781928497,6,3209,1099,-40
79782648952,79782648954,2,1682,1227,-40
79784132244,79784132225,-19,1148,194,-40
79784517361,79784517364,3,1268,969,-40
79784855127,79784855114,-13,945,419,-40
79792548190,79792548198,8,3609,1829,-40
79794171478,79794171483,5,2965,1682,-40
79794531341,79794531348,7,3541,1774,-40
79794603937,79794603942,5,2595,1137,-40
79796384486,79796384489,3,2867,1301,-40
79807603031,79807603035,4,2077,1089,-40
79807999240,79807999241,1,832,1117,-40
79811755645,79811755650,5,2722,1073,-40
79813322819,79813322825,6,2898,1181,-40
79813539417,79813539427,10,3855,1410,-40
79815097821,79815097825,4,1470,1751,-40
79816748016,79816747999,-17,739,612,-40
79817107190,79817107198,8,1531,887,-40
79822488221,79822488227,6,4165,1715,-40
79823507316,79823507323,7,2552,852,-40
79823843673,79823843679,6,3129,1315,-40
79823959289,79823959296,7,2336,962,-40
79825589718,79825589722,4,5096,2247,-40
79829185833,79829185835,2,755,718,-40
79830478567,79830478559,-8,852,4363,-40
79838318707,79838318701,-6,1046,3670,-40
79838432414,79838432419,5,2351,1143,-40
79847455957,79847455961,4,3685,1267,-40
79854822253,79854822260,7,2627,1126,-40
79854848163,79854848170,7,2530,1044,-40
79855072615,79855072593,-22,1539,398,-40
79855216983,79855216989,6,2930,1454,-40
79855509529,79855509534,5,2122,1120,-40
79856768096,79856768101,5,2483,941,-40
79865102157,79865102171,14,1575,290,-40
79866484106,79866484111,5,2506,1480,-40
79867017766,79867017771,5,2901,1535,-40
79867607622,79867607629,7,3076,1473,-40
79867913706,79867913711,5,1336,1131,-40
79876265391,79876265397,6,3403,1326,-40
79876805007,79876805014,7,2470,913,-40
79877690104,79877690107,3,4404,2714,-40
79881107213,79881107218,5,1676,1298,-40
79881227721,79881227726,5,1328,680,-40
79882561889,79882561894,5,1707,925,-40
79882887098,79882887114,16,900,47,-40
79885576753,79885576760,7,3301,1624,-40
79886788428,79886788434,6,1448,666,-40
79887029959,79887029944,-15,955,378,-40
79888219482,79888219486,4,1593,1299,-40
79890385874,79890385882,8,3129,941,-40
79890461185,79890461171,-14,934,426,-40
79890884489,79890884486,-3,1824,1700,-40
79893298079,79893298086,7,74459,31629,-40
79896431578,79896431584,6,2855,1455,-40
79896837362,79896837367,5,3092,1936,-40
79911995549,79911995555,6,3021,907,-40
79913667126,79913667130,4,1541,1155,-40
79915053572,79915053577,5,2894,1502,-40
79925432548,79925432553,5,2844,1030,-40
79933743938,79933743944,6,1315,1083,-40
79934861871,79934861889,18,3095,1398,-40
79935561867,79935561851,-16,856,421,-40
79937129374,79937129381,7,1980,1476,-40
79937365475,79937365481,6,3198,1255,-40
79939449173,79939449178,5,2652,1545,-40
79940340326,79940340332,6,2336,1029,-40
79941365334,79941365341,7,2311,842,-40
79942328259,79942328266,7,2892,1508,-40
79943143806,79943143820,14,2941,1166,-40
79947924169,79947924174,5,1737,685,-40
79949696137,79949696142,5,3162,1399,-40
79949724265,79949724272,7,3368,1348,-40
79951041007,79951041014,7,2949,1154,-40
79954753481,79954753487,6,2262,1171,-40
79957034982,79957034984,2,819,325,-40
79957157470,79957157475,5,2699,905,-40
79959961865,79959961871,6,3179,1303,-40
79964648515,79964648514,-1,24380,22107,-40
79965583278,79965583282,4,2408,1085,-40
79969014818,79969014825,7,2629,1362,-40
79971288930,79971288937,7,2385,1280,-40
79972077878,79972077886,8,3781,1529,-40
79972133177,79972133182,5,1883,1465,-40
79973559714,79973559712,-2,882,239,-40
79973811293,79973811301,8,2596,742,-40
79977681075,79977681081,6,2510,1227,-40
79977727819,79977727810,-9,1662,789,-40
79980617012,79980617017,5,2057,1577,-40
79987379472,79987379466,-6,1434,6720,-40
79992300830,79992300837,7,3230,1260,-40
79993652919,79993652925,6,2890,1247,-40
79993697522,79993697540,18,804,368,-40
79996850177,79996850183,6,2305,1193,-40
79997758422,79997758426,4,2537,899,-40
79999108249,79999108254,5,3013,1501,-40
80000516615,80000516621,6,1940,1095,-40
80000890070,80000890078,8,3071,1321,-40
80003544154,80003544158,4,2683,1708,-40
80010658691,80010658688,-3,1216,2323,-40
80015690927,80015690909,-18,2,1438,-40
80018991736,80018991741,5,3261,1354,-40
80019481953,80019481959,6,3122,1698,-40
80020211793,80020211801,8,2876,1421,-40
80022495573,80022495570,-3,1770,39620,-40
80025876230,80025876236,6,2933,1596,-40
80026767623,80026767631,8,2731,1026,-40
80032209021,80032209018,-3,1655,2580,-40
80034168250,80034168254,4,2992,1034,-40
80034313346,80034313331,-15,1705,683,-40
80034495599,80034495605,6,1910,1400,-40
80034667707,80034667713,6,1543,1099,-40
80037313092,80037313098,6,2681,1300,-40
80038933193,80038933198,5,2243,1141,-40
80039195769,80039195776,7,2564,1591,-40
80043102031,80043102038,7,2786,1357,-40
80045010467,80045010474,7,3168,982,-40
80045705814,80045705821,7,3177,1436,-40
80046836754,80046836752,-2,635,1865,-40
80056420970,80056420974,4,2706,1384,-40
80061029186,80061029194,8,3202,1237,-40
80065469920,80065469926,6,1457,552,-40
80066249280,80066249282,2,1752,1538,-40
80069044722,80069044728,6,3693,1520,-40
80070208646,80070208652,6,2735,1081,-40
80070638007,80070637984,-23,2828,1348,-40
80070939045,80070939050,5,2948,1291,-40
80076373844,80076373850,6,3137,1158,-40
80078905803,80078905809,6,2971,1646,-40
80085950185,80085950193,8,4120,1503,-40
80089827072,80089827058,-14,1584,594,-40
80094040850,80094040855,5,3645,1498,-40
80094325134,80094325141,7,1406,742,-40
80096395749,80096395754,5,2313,870,-40
80097589834,80097589834,0,18863,6186,-40
80100783598,80100783602,4,2761,1368,-40
80101498609,80101498601,-8,842,2972,-40
80105781501,80105781507,6,2917,1054,-40
80108686838,80108686844,6,3715,1562,-40
80112224036,80112224043,7,4361,1216,-40
80112383218,80112383223,5,3695,1275,-40
80113154504,80113154510,6,2412,968,-40
80115346127,80115346134,7,3036,1455,-40
80115448242,80115448247,5,3076,1040,-40
80116561625,80116561608,-17,1043,460,-40
80117717746,80117717754,8,4389,1099,-40
80118960838,80118960841,3,10837,8286,-40
80123849455,80123849462,7,4124,1163,-40
80124971186,80124971193,7,2656,1417,-40
80128674608,80128674625,17,958,3477,-40
80128827159,80128827166,7,2753,1246,-40
80135745762,80135745768,6,2663,1544,-40
80135930286,80135930306,20,820,129,-40
80141525429,80141525435,6,1522,1000,-40
80145886120,80145886125,5,2625,1539,-40
80146348474,80146348483,9,893,169,-40
80146373916,80146373900,-16,1952,659,-40
80152989489,80152989494,5,1143,880,-40
80153337219,80153337226,7,839,179,-40
80155822545,80155822550,5,1604,846,-40
80156504357,80156504362,5,2915,1685,-40
80164681618,80164681626,8,1886,773,-40
80165825584,80165825586,2,1669,1435,-40
80167679372,80167679373,1,2142,2073,-40
80173912036,80173912041,5,2228,1168,-40
80174121073,80174121058,-15,2546,942,-40
80176453578,80176453583,5,2583,1237,-40
80189309317,80189309319,2,2243,1622,-40
80192156468,80192156474,6,2624,1025,-40
80192184977,80192184960,-17,2072,816,-40
80192707064,80192707069,5,3082,1067,-40
80193956474,80193956481,7,6127,1738,-40
80195687064,80195687071,7,2758,1271,-40
80195895522,80195895507,-15,2729,1413,-40
80196303699,80196303705,6,2101,1233,-40
80201502106,80201502110,4,2068,1065,-40
80205211556,80205211556,0,2117,2815,-40
80211784086,80211784093,7,3843,1923,-40
80213467886,80213467894,8,2534,1046,-40
80213660010,80213660011,1,848,297,-40
80217577155,80217577163,8,4144,1142,-40
80217983834,80217983841,7,1149,578,-40
80221275677,80221275685,8,3512,1487,-40
80221719706,80221719713,7,3892,1192,-40
80225813618,80225813623,5,3005,1464,-40
80227852577,80227852582,5,2488,1325,-40
80229642740,80229642747,7,2800,1534,-40
80231435335,80231435341,6,1898,1172,-40
80231556004,80231555988,-16,2506,1011,-40
80232658865,80232658870,5,2271,1019,-40
80239146630,80239146636,6,2885,1371,-40
80239801865,80239801872,7,2390,1642,-40
80239901730,80239901731,1,2549,2157,-40
80240777419,80240777427,8,3379,1231,-40
80241375858,80241375863,5,3596,1933,-40
80243354660,80243354666,6,4632,1758,-40
80243430452,80243430457,5,3223,1053,-40
80244458000,80244458007,7,2328,1441,-40
80246210102,80246210106,4,1643,1353,-40
80248014367,80248014373,6,3244,1121,-40
80250946321,80250946335,14,5180,1140,-40
80251313014,80251313025,11,1613,804,-40
80253525557,80253525562,5,2958,1327,-40
80255540571,80255540578,7,3207,1314,-40
80255696897,80255696890,-7,852,239,-40
80256180844,80256180848,4,1801,845,-40
80256485502,80256485480,-22,2824,1208,-40
80259462074,80259462080,6,3217,1254,-40
80261638453,80261638455,2,1422,1219,-40
80261703635,80261703637,2,2522,2205,-40
80266910987,80266910994,7,3244,1335,-40
80269882811,80269882817,6,3132,1706,-40
80271754261,80271754267,6,2068,734,-40
80272926219,80272926225,6,2990,1466,-40
80274599184,80274599191,7,3907,1439,-40
80274932638,80274932644,6,3026,872,-40
80276746781,80276746786,5,2601,1675,-40
80279808932,80279808938,6,2117,890,-40
80280502134,80280502129,-5,2123,8084,-40
80281696345,80281696351,6,2589,1095,-40
80282456083,80282456090,7,3039,1455,-40
80285462734,80285462741,7,4120,1280,-40
80285919774,80285919777,3,2722,2822,-40
80287920343,80287920350,7,3903,1854,-40
80294613510,80294613511,1,46001,38999,-40
80296251778,80296251785,7,2245,1084,-40
80301344029,80301344034,5,2808,1285,-40
80301427983,80301427987,4,1554,1073,-40
80302158661,80302158667,6,2803,1243,-40
80302373126,80302373104,-22,633,398,-40
80303420517,80303420523,6,3932,1472,-40
80307975669,80307975675,6,2553,1154,-40
80310233294,80310233298,4,2333,1335,-40
80311068614,80311068615,1,628,1312,-40
80315665521,80315665527,6,1384,1294,-40
80318352584,80318352590,6,4092,1352,-40
80322793654,80322793659,5,2391,1197,-40
80324598777,80324598784,7,7910,1015,-40
80325721854,80325721862,8,3019,1563,-40
80326293037,80326293044,7,3053,1864,-40
80326381189,80326381198,9,3365,1243,-40
80327442603,80327442601,-2,719,983,-40
80335956798,80335956806,8,2654,1267,-40
80337202519,80337202527,8,3461,1464,-40
80338144844,80338144851,7,2317,776,-40
80338798101,80338798106,5,993,134,-40
80339823189,80339823170,-19,2564,1384,-40
80342326183,80342326190,7,4533,1622,-40
80352881078,80352881087,9,3153,1597,-40
80358963226,80358963231,5,2312,1365,-40
80360184135,80360184140,5,1719,1048,-40
80360345734,80360345738,4,2580,1496,-40
80362121357,80362121359,2,1143,745,-40
80362462238,80362462245,7,4162,1343,-40
80363378415,80363378396,-19,2775,1111,-40
80370009911,80370009920,9,13424,38972,-40
80370659019,80370659026,7,2195,1551,-40
80374807740,80374807747,7,2873,1247,-40
80376667313,80376667318,5,2602,946,-40
80378701463,80378701469,6,2624,1239,-40
80387991292,80387991297,5,1636,1177,-40
80388309755,80388309753,-2,798,55,-40
80393214233,80393214239,6,2001,1393,-40
80398768226,80398768230,4,2227,1614,-40
80399806924,80399806929,5,2431,1444,-40
80401632269,80401632276,7,3633,1544,-40
80405400298,80405400307,9,2233,883,-40
80405466171,80405466187,16,3924,1338,-40
80410562177,80410562182,5,2732,1001,-40
80411440113,80411440116,3,12005,8643,-40
80414138322,80414138331,9,1413,633,-40
80414223952,80414223939,-13,740,231,-40
80415730682,80415730681,-1,1469,2433,-40
80417809149,80417809155,6,3365,2063,-40
80418732989,80418732994,5,2802,1123,-40
80423492737,80423492744,7,3335,1374,-40
80424282684,80424282687,3,1634,1142,-40
80425256325,80425256330,5,2965,1568,-40
80425775063,80425775040,-23,908,348,-40
80425971989,80425971980,-9,1304,373,-40
80430940158,80430940162,4,2565,1135,-40
80441244301,80441244308,7,2663,1611,-40
80441473634,80441473641,7,2278,1203,-40
80441615190,80441615170,-20,3386,1142,-40
80442557549,80442557554,5,2603,1611,-40
80446421585,80446421592,7,2728,1359,-40
80447729486,80447729493,7,2158,1465,-40
80447906676,80447906682,6,2799,1177,-40
80449666817,80449666823,6,3129,1336,-40
80453225885,80453225889,4,2829,1253,-40
80454536063,80454536070,7,3354,1188,-40
80457897292,80457897299,7,2594,893,-40
80458216850,80458216859,9,5910,1409,-40
80458716530,80458716537,7,3648,1515,-40
80465970963,80465970967,4,2389,1087,-40
80468372407,80468372410,3,1315,627,-40
80470163713,80470163719,6,3425,1393,-40
80474704335,80474704341,6,3572,1435,-40
80480380026,80480380035,9,14172,35052,-40
80481607009,80481607014,5,1947,1150,-40
80488382149,80488382154,5,2190,1471,-40
80489028151,80489028158,7,2259,1401,-40
80489830125,80489830130,5,2265,1431,-40
80490209786,80490209785,-1,956,267,-40
80492316268,80492316274,6,1987,706,-40
80496165301,80496165308,7,3216,1554,-40
80496364105,80496364111,6,4063,941,-40
80497641389,80497641397,8,2605,1150,-40
80499322109,80499322113,4,1861,1207,-40
80499409462,80499409450,-12,1162,314,-40
80502271670,80502271670,0,1827,1999,-40
80506635786,80506635795,9,1894,911,-40
80507369277,80507369258,-19,2220,1211,-40
80509454969,80509454977,8,3203,1185,-40
80514566445,80514566450,5,2533,897,-40
80519444129,80519444137,8,3226,1320,-40
80520356893,80520356898,5,4170,1834,-40
80522274938,80522274943,5,2746,992,-40
80523418578,80523418585,7,3663,1355,-40
80523804549,80523804553,4,4156,3489,-40
80523993022,80523993029,7,5298,1118,-40
80524619442,80524619446,4,2284,1801,-40
80527070518,80527070526,8,3689,1337,-40
80536163562,80536163568,6,2773,1200,-40
80540229022,80540229027,5,3098,1261,-40
80540645009,80540645017,8,631,119,-40
80542154850,80542154835,-15,832,446,-40
80544985504,80544985512,8,2351,893,-40
80546722654,80546722659,5,2770,1141,-40
80551734197,80551734202,5,2159,1089,-40
80561375175,80561375180,5,3529,1285,-40
80562194211,80562194218,7,2700,1373,-40
80571160261,80571160266,5,2686,889,-40
80575017510,80575017515,5,2885,1655,-40
80578828650,80578828656,6,3019,1466,-40
80583479541,80583479548,7,2460,1279,-40
80584176952,80584176957,5,3033,815,-40
80585598577,80585598583,6,3047,1192,-40
80588064598,80588064603,5,1944,1208,-40
80589701275,80589701282,7,1887,825,-40
80589908423,80589908427,4,2613,1180,-40
80589985957,80589985955,-2,1484,1854,-40
80592103737,80592103743,6,2749,987,-40
80592161952,80592161936,-16,2120,977,-40
80595871307,80595871314,7,2914,909,-40
80597206601,80597206608,7,2688,1615,-40
80601183441,80601183447,6,3263,1245,-40
80606081939,80606081942,3,6386,5622,-40
80610679947,80610679946,-1,1196,1747,-40
80624458319,80624458326,7,3656,1442,-40
80628031355,80628031362,7,3266,1201,-40
80628807859,80628807867,8,2227,1253,-40
80630442702,80630442709,7,3031,2003,-40
80630930016,80630930021,5,2310,1053,-40
80639381137,80639381142,5,3685,1539,-40
80639895377,80639895383,6,2967,1027,-40
80641011263,80641011269,6,2817,1652,-40
80641784991,80641784987,-4,2215,37885,-40
80643852946,80643852953,7,2880,1587,-40
80646597445,80646597451,6,2696,1320,-40
80646932124,80646932130,6,904,225,-40
80650420118,80650420123,5,2092,796,-40
80652654399,80652654407,8,5205,1039,-40
80656001943,80656001951,8,4405,1398,-40
80657208030,80657208037,7,3667,1224,-40
80667428181,80667428187,6,1849,972,-40
80673918081,80673918084,3,2017,1454,-40
80674103789,80674103771,-18,2904,1331,-40
80676120261,80676120266,5,2396,1328,-40
80684514472,80684514479,7,3671,1743,-40
80685734903,80685734908,5,2429,1560,-40
80687755566,80687755572,6,4081,1539,-40
80688498577,80688498586,9,3571,1287,-40
80690383956,80690383963,7,3261,1124,-40
80695105186,80695105195,9,2433,1083,-40
80696036062,80696036066,4,3304,1754,-40
80699726137,80699726142,5,2538,1148,-40
80702634847,80702634851,4,2689,1173,-40
80703465511,80703465518,7,1417,554,-40
80703865058,80703865042,-16,2689,1253,-40
80707256993,80707256999,6,3323,1149,-40
80710304095,80710304097,2,1960,1310,-40
80710438973,80710438954,-19,2391,1125,-40
80711658952,80711658956,4,2304,1477,-40
80712227058,80712227054,-4,1234,3036,-40
80724692959,80724692965,6,2638,1098,-40
80724808060,80724808042,-18,2326,900,-40
80726527158,80726527166,8,3111,995,-40
80728272146,80728272151,5,3617,1627,-40
80731004829,80731004836,7,3459,1639,-40
80731717122,80731717130,8,876,171,-40
80732218094,80732218100,6,2498,1895,-40
80733322126,80733322131,5,2206,1116,-40
80738278350,80738278355,5,2826,1164,-40
80741627331,80741627335,4,1633,802,-40
80742510656,80742510661,5,3819,1898,-40
80748763187,80748763182,-5,1835,6006,-40
80748927938,80748927946,8,3724,1750,-40
80751269738,80751269744,6,3072,1428,-40
80752330501,80752330520,19,3403,1240,-40
80754611050,80754611055,5,2839,1291,-40
80755040635,80755040637,2,1737,2099,-40
80757273226,80757273226,0,2036,2504,-40
80757408965,80757408970,5,1116,767,-40
80764512447,80764512451,4,1917,756,-40
80764600034,80764600025,-9,1315,244,-40
80765273078,80765273083,5,3176,1547,-40
80766465269,80766465274,5,1615,1149,-40
80779880902,80779880906,4,2500,1556,-40
80781682616,80781682624,8,2062,1384,-40
80784518518,80784518526,8,4065,1578,-40
80784734525,80784734531,6,2876,1387,-40
80789340623,80789340630,7,2588,1277,-40
80796784417,80796784422,5,1885,745,-40
80797808350,80797808331,-19,1145,499,-40
80798771273,80798771279,6,3414,910,-40
80803480387,80803480392,5,2681,1033,-40
80811347899,80811347905,6,2937,1100,-40
80812515825,80812515821,-4,1432,2905,-40
80815847330,80815847338,8,3244,1474,-40
80816415893,80816415899,6,2150,1338,-40
80816587590,80816587588,-2,1807,2562,-40
80818816265,80818816273,8,2378,1172,-40
80819261823,80819261828,5,2608,1587,-40
80825623081,80825623078,-3,832,1635,-40
80828640512,80828640519,7,2564,1185,-40
80830777725,80830777730,5,3102,1040,-40
80831157389,80831157394,5,1671,1333,-40
80831371399,80831371405,6,2529,1384,-40
80833171177,80833171185,8,5826,1374,-40
80834460281,80834460286,5,2546,1371,-40
80838520030,80838520034,4,2912,917,-40
80841203661,80841203666,5,2449,1382,-40
80841429753,80841429758,5,2031,889,-40
80842078222,80842078229,7,3695,1483,-40
80847519981,80847519988,7,2704,1069,-40
80856563949,80856563957,8,2122,930,-40
80857340741,80857340746,5,2615,1045,-40
80858870659,80858870659,0,2324,2632,-40
80862251909,80862251915,6,3916,1273,-40
80862558499,80862558505,6,6187,2971,-40
80863241045,80863241051,6,2480,1206,-40
80865085095,80865085094,-1,2408,4580,-40
80865111720,80865111729,9,2850,1344,-40
80867615565,80867615571,6,3427,1582,-40
80869375342,80869375349,7,3733,1691,-40
80877144381,80877144389,8,3201,1246,-40
80889276077,80889276082,5,3063,1048,-40
80890566629,80890566636,7,2461,925,-40
80892438622,80892438630,8,2956,1216,-40
80894918981,80894918986,5,2296,1586,-40
80901472090,80901472095,5,3883,1241,-40
80901621290,80901621296,6,2537,1182,-40
80903602537,80903602543,6,2737,2063,-40
80904157134,80904157134,0,1819,2094,-40
80904270162,80904270169,7,2365,1595,-40
80907202355,80907202363,8,2351,876,-40
80909195262,80909195270,8,3163,1314,-40
80915436262,80915436269,7,2934,855,-40
80920830437,80920830443,6,3726,1465,-40
80933625312,80933625322,10,5615,1466,-40
80935893894,80935893896,2,1342,1115,-40
80936844258,80936844273,15,959,186,-40
80940940313,80940940319,6,2602,1435,-40
80942246138,80942246146,8,3543,1218,-40
80943118770,80943118777,7,2886,897,-40
80943485770,80943485775,5,2803,1122,-40
80946229697,80946229703,6,3150,1337,-40
80947475938,80947475938,0,1798,2917,-40
80950881070,80950881077,7,2785,1077,-40
80961732269,80961732274,5,3167,1322,-40
80963703863,80963703870,7,2599,1339,-40
80964874509,80964874515,6,1397,646,-40
80967770006,80967770010,4,3415,1518,-40
80968574810,80968574817,7,2466,1061,-40
80975284949,80975284954,5,1584,776,-40
80977972832,80977972838,6,3168,1130,-40
80980686820,80980686826,6,3188,1327,-40
80982154536,80982154541,5,3035,1310,-40
80985790021,80985790029,8,3358,1345,-40
80990381365,80990381370,5,2402,1226,-40
80991394269,80991394275,6,3626,1353,-40
80999466033,80999466039,6,3505,1326,-40
81000096171,81000096170,-1,39454,16564,-40
81003283741,81003283747,6,3063,1274,-40
81005179554,81005179561,7,3533,1504,-40
81010386038,81010386038,0,1739,1469,-40
81013063078,81013063086,8,3244,1822,-40
81014759855,81014759847,-8,1619,2213,-40
81016216722,81016216729,7,3159,1116,-40
81018327380,81018327387,7,3334,1430,-40
81024856202,81024856207,5,2325,1104,-40
81034761370,81034761377,7,2976,1131,-40
81037626001,81037626006,5,2642,918,-40
81038344774,81038344779,5,2510,1496,-40
81046194926,81046194933,7,3384,1711,-40
81047887357,81047887363,6,2147,898,-40
81049651380,81049651386,6,2468,1217,-40
81054786274,81054786278,4,2812,1138,-40
81060907803,81060907784,-19,3293,1583,-40
81062250001,81062249985,-16,1254,179,-40
81064908310,81064908317,7,3457,1640,-40
81066483942,81066483941,-1,1132,1189,-40
81066660860,81066660842,-18,817,687,-40
81067239875,81067239882,7,4131,1669,-40
81070267093,81070267099,6,3358,1127,-40
81072654629,81072654635,6,2588,884,-40
81078632325,81078632330,5,3042,1341,-40
81082475617,81082475624,7,2043,1368,-40
81085631290,81085631295,5,2811,1001,-40
81086148587,81086148593,6,2630,918,-40
81090289525,81090289530,5,2868,1777,-40
81093068657,81093068662,5,3607,1334,-40
81093760640,81093760651,11,1059,276,-40
81093883456,81093883456,0,930,298,-40
81096690075,81096690082,7,2395,1146,-40
81099879719,81099879725,6,2960,1470,-40
81110802060,81110802065,5,1952,1067,-40
81110829993,81110829977,-16,2799,1087,-40
81119930098,81119930104,6,3069,1484,-40
81120121180,81120121186,6,2853,1319,-40
81122276835,81122276841,6,3769,1289,-40
81123013205,81123013210,5,1893,1019,-40
81125649835,81125649841,6,2970,1301,-40
81126308785,81126308790,5,2896,1109,-40
81127986104,81127986106,2,1515,1632,-40
81132943078,81132943083,5,2021,974,-40
81133216962,81133216944,-18,2237,1586,-40
81133347061,81133347066,5,2268,1172,-40
81134052517,81134052523,6,3019,959,-40
81134438277,81134438282,5,3272,1631,-40
81134706634,81134706641,7,2587,1004,-40
81141088478,81141088485,7,2085,1121,-40
81142416598,81142416579,-19,974,100,-40
81145435950,81145435957,7,2205,1287,-40
81151023442,81151023449,7,2430,1404,-40
81151453597,81151453602,5,2751,1327,-40
81159122915,81159122921,6,2439,1462,-40
81164468231,81164468238,7,3430,1097,-40
81168392017,81168392017,0,2513,1765,-40
81170943577,81170943581,4,3980,1535,-40
81173472287,81173472295,8,1646,610,-40
81174484322,81174484326,4,2432,1442,-40
81175208126,81175208133,7,2555,1618,-40
81179209524,81179209530,6,3027,1431,-40
81180759100,81180759107,7,3290,1387,-40
81182900334,81182900340,6,4161,1869,-40
81188297770,81188297774,4,1943,1042,-40
81188879976,81188879982,6,3168,1520,-40
81193370549,81193370555,6,3327,1398,-40
81199116671,81199116679,8,2999,1039,-40
81204315596,81204315603,7,3549,1654,-40
81208306306,81208306311,5,3249,1275,-40
81213141803,81213141810,7,2039,969,-40
81215074925,81215074934,9,960,693,-40
81216516663,81216516671,8,3290,1592,-40
81217270119,81217270123,4,1579,1065,-40
81218056940,81218056946,6,3618,1051,-40
81218144317,81218144328,11,1149,152,-40
81221525225,81221525231,6,3387,1419,-40
81225149059,81225149066,7,4479,1631,-40
81226417925,81226417932,7,2713,1462,-40
81229456734,81229456738,4,2571,1799,-40
81230463334,81230463342,8,3164,1574,-40
81230690012,81230690017,5,2713,1380,-40
81234837206,81234837213,7,2929,1357,-40
81235795841,81235795846,5,4039,1048,-40
81237803378,81237803385,7,2778,1382,-40
81238451424,81238451432,8,3408,1140,-40
81241533078,81241533083,5,3228,1429,-40
81246441889,81246441894,5,2321,833,-40
81258147316,81258147322,6,1877,981,-40
81259299679,81259299686,7,3589,1647,-40
81262518626,81262518630,4,1716,1064,-40
81274459652,81274459658,6,3057,1124,-40
81281468526,81281468529,3,990,757,-40
81286471043,81286471053,10,2968,1406,-40
81288602859,81288602865,6,2787,1389,-40
81288668606,81288668614,8,2495,1367,-40
81289640490,81289640488,-2,936,229,-40
81294174150,81294174155,5,1886,1558,-40
81295798496,81295798503,7,2772,1149,-40
81301389932,81301389924,-8,1498,5959,-40
81309778504,81309778510,6,2626,812,-40
81316008099,81316008109,10,12644,48146,-40
81323174550,81323174555,5,2853,1563,-40
81326551646,81326551654,8,2827,1370,-40
81333432890,81333432895,5,2196,783,-40
81335590409,81335590415,6,1032,962,-40
81338582970,81338582975,5,2865,1565,-40
81339185206,81339185212,6,3913,1422,-40
81344277633,81344277639,6,2805,1235,-40
81344982270,81344982278,8,3205,1031,-40
81348458400,81348458407,7,2839,1173,-40
81351556352,81351556358,6,3027,1332,-40
81352871357,81352871361,4,1895,1135,-40
81353823307,81353823314,7,2310,927,-40
81354281173,81354281179,6,2071,1124,-40
81355040541,81355040548,7,2730,1295,-40
81368489886,81368489894,8,3821,1626,-40
81369819845,81369819851,6,2989,1265,-40
81370091479,81370091459,-20,902,287,-40
81371539591,81371539599,8,2083,958,-40
81372336375,81372336382,7,2563,1815,-40
81375680887,81375680894,7,3061,1619,-40
81376695217,81376695224,7,2546,1102,-40
81377529858,81377529854,-4,1189,3929,-40
81383732246,81383732253,7,1062,766,-40
81388463549,81388463552,3,1264,1121,-40
81388798538,81388798546,8,28206,4630,-40
81390498173,81390498168,-5,1455,4768,-40
81391130009,81391130016,7,3750,1546,-40
81391301231,81391301235,4,2649,1196,-40
81392700809,81392700795,-14,2331,1121,-40
81392907836,81392907843,7,3674,1303,-40
81397244261,81397244266,5,3758,1406,-40
81398888977,81398888983,6,4163,1655,-40
81402490422,81402490425,3,1790,19139,-40
81403095514,81403095510,-4,2413,5197,-40
81407446840,81407446846,6,2951,1507,-40
81407667731,81407667736,5,1520,1082,-40
81408785223,81408785204,-19,568,182,-40
81413135007,81413135006,-1,1722,2037,-40
81414254817,81414254825,8,2569,865,-40
81414820923,81414820926,3,2496,1507,-40
81417660270,81417660274,4,1694,1105,-40
81421141452,81421141457,5,1689,672,-40
81425095857,81425095863,6,2766,1053,-40
81428620724,81428620730,6,2631,1329,-40
81433637584,81433637589,5,1293,577,-40
81438870490,81438870496,6,2790,1804,-40
81441876009,81441876009,0,1333,1532,-40
81444392813,81444392821,8,5326,934,-40
81446561152,81446561156,4,24577,24297,-40
81448348869,81448348874,5,3143,1196,-40
81454082478,81454082494,16,1010,139,-40
81463459922,81463459942,20,1831,545,-40
81463510381,81463510363,-18,3146,1300,-40
81467599431,81467599437,6,2912,1240,-40
81468404599,81468404606,7,3570,1201,-40
81468980403,81468980388,-15,2635,807,-40
81469695710,81469695716,6,2450,1452,-40
81472702650,81472702655,5,1839,882,-40
81475059089,81475059094,5,2783,1159,-40
81475445192,81475445178,-14,3596,1171,-40
81476898755,81476898761,6,3185,1437,-40
81479623913,81479623919,6,1067,529,-40
81486033850,81486033855,5,2814,1306,-40
81489660262,81489660269,7,3373,1300,-40
81490801590,81490801595,5,1826,546,-40
81492629373,81492629379,6,2594,1095,-40
81493673261,81493673266,5,3406,1297,-40
81509096950,81509096957,7,3247,1650,-40
81509479557,81509479537,-20,2598,851,-40
81512376436,81512376440,4,2814,1769,-40
81515093007,81515093013,6,2176,1057,-40
81516423673,81516423678,5,2153,1177,-40
81516490533,81516490515,-18,2982,1181,-40
81518009688,81518009695,7,3186,775,-40
81518877249,81518877254,5,2827,1360,-40
81522164341,81522164347,6,1851,1188,-40
81530210783,81530210789,6,2228,1096,-40
81534913818,81534913817,-1,2650,3338,-40
81540398732,81540398741,9,2816,1162,-40
81540674358,81540674354,-4,771,1469,-40
81547738457,81547738464,7,3384,1722,-40
81548165293,81548165298,5,4095,1786,-40
81552857958,81552857963,5,1871,841,-40
81554611114,81554611121,7,3258,1209,-40
81556517094,81556517102,8,2392,930,-40
81557121750,81557121732,-18,2718,1276,-40
81557734910,81557734919,9,3337,1152,-40
81558137747,81558137753,6,2696,843,-40
81558260578,81558260563,-15,715,575,-40
81559383293,81559383301,8,3802,1541,-40
81559416497,81559416503,6,2325,1063,-40
81562691085,81562691091,6,4431,1687,-40
81567275654,81567275660,6,3490,1934,-40
81568948225,81568948231,6,3100,1232,-40
81571154290,81571154297,7,3150,1234,-40
81574112613,81574112619,6,2773,1215,-40
81578528006,81578528011,5,3860,1238,-40
81579911978,81579911960,-18,925,356,-40
81583491302,81583491309,7,2792,1112,-40
81585382155,81585382161,6,3507,1475,-40
81587441962,81587441970,8,4044,1296,-40
81590474295,81590474299,4,3687,1163,-40
81591917694,81591917701,7,3670,1386,-40
81591992658,81591992662,4,1781,898,-40
81592149588,81592149594,6,2298,1227,-40
81598994692,81598994683,-9,1647,28483,-40
81599299520,81599299526,6,4544,1226,-40
81599758730,81599758734,4,2896,1230,-40
81603660805,81603660811,6,9047,3460,-40
81604498439,81604498436,-3,961,2402,-40
81604969192,81604969191,-1,1307,805,-40
81606836343,81606836349,6,3289,1593,-40
81612073902,81612073907,5,2603,1028,-40
81612823745,81612823749,4,1276,981,-40
81613448838,81613448844,6,3066,1597,-40
81615428905,81615428910,5,2834,1616,-40
81618551236,81618551241,5,2640,1184,-40
81619380793,81619380798,5,2605,1305,-40
81619794489,81619794495,6,2987,1463,-40
81629649770,81629649777,7,2243,1239,-40
81629900648,81629900650,2,1099,1173,-40
81631608352,81631608358,6,2583,1420,-40
81634393528,81634393534,6,3314,1242,-40
81648749826,81648749830,4,2202,1384,-40
81651078045,81651078051,6,2769,1664,-40
81658559121,81658559128,7,3086,973,-40
81660459975,81660459981,6,3441,1536,-40
81663976223,81663976214,-9,41,615,-40
81665273583,81665273591,8,2980,1497,-40
81665697398,81665697404,6,1069,261,-40
81677991953,81677991959,6,1366,937,-40
81678099174,81678099162,-12,1364,538,-40
81680313866,81680313869,3,2264,2450,-40
81683145285,81683145294,9,2950,1299,-40
81684900194,81684900202,8,2218,1431,-40
81686841830,81686841836,6,3153,1092,-40
81688687644,81688687651,7,1692,756,-40
81691339561,81691339562,1,1822,1243,-40
81693729681,81693729689,8,3248,1180,-40
81694481988,81694481972,-16,2381,949,-40
81695231757,81695231763,6,3244,1442,-40
81697589462,81697589470,8,2645,956,-40
81703780097,81703780095,-2,2131,2673,-40
81705656700,81705656706,6,1634,755,-40
81708951503,81708951509,6,2604,1042,-40
81709184302,81709184288,-14,38639,16414,-40
81709910534,81709910541,7,3263,1378,-40
81714861428,81714861425,-3,2105,3579,-40
81718207882,81718207887,5,2096,1173,-40
81718620772,81718620755,-17,1010,354,-40
81720828940,81720828946,6,3570,1329,-40
81722426427,81722426433,6,2952,1082,-40
81727019191,81727019197,6,2789,1548,-40
81728086061,81728086065,4,2303,1045,-40
81730499730,81730499734,4,1941,1279,-40
81732915562,81732915567,5,2970,1175,-40
81740335862,81740335869,7,2148,1211,-40
81740852782,81740852790,8,3268,1169,-40
81742981874,81742981881,7,3087,1451,-40
81743742728,81743742725,-3,3534,10714,-40
81744277854,81744277860,6,2214,1376,-40
81745469585,81745469592,7,3188,1398,-40
81747512492,81747512499,7,1274,908,-40
81750236724,81750236731,7,30863,34614,-40
81750651651,81750651659,8,2223,750,-40
81751729162,81751729152,-10,1347,282,-40
81755044766,81755044772,6,3035,1369,-40
81755730248,81755730254,6,3011,906,-40
81756337294,81756337299,5,3059,1394,-40
81759135303,81759135307,4,2407,1784,-40
81759243463,81759243466,3,1803,1457,-40
81764400949,81764400955,6,3187,1235,-40
81767489358,81767489365,7,1445,870,-40
81767999971,81767999978,7,3973,1619,-40
81769567821,81769567822,1,1860,2282,-40
81770321151,81770321158,7,3429,1093,-40
81770558170,81770558155,-15,2343,1056,-40
81771767963,81771767968,5,3530,1003,-40
81776165188,81776165194,6,1998,757,-40
81776611031,81776611041,10,704,232,-40
81777853470,81777853478,8,2378,1487,-40
81783220303,81783220309,6,2953,1192,-40
81784334447,81784334446,-1,639,1735,-40
81785039481,81785039490,9,2826,1118,-40
81787242893,81787242898,5,2647,925,-40
81788046890,81788046896,6,2768,1018,-40
81789480645,81789480650,5,2686,1095,-40
81790799726,81790799734,8,5301,2166,-40
81790949002,81790949006,4,2962,1196,-40
81791086467,81791086472,5,9191,37020,-40
81795035334,81795035341,7,3832,1981,-40
81795069920,81795069921,1,972,156,-40
81798842529,81798842534,5,3678,1517,-40
81802365333,81802365340,7,3798,1453,-40
81803450599,81803450604,5,994,261,-40
81806025053,81806025059,6,2317,1164,-40
81807064819,81807064827,8,3103,1209,-40
81807532770,81807532753,-17,1993,973,-40
81810733302,81810733310,8,3354,1221,-40
81812049742,81812049746,4,1101,944,-40
81815118339,81815118334,-5,960,4882,-40
81815326790,81815326785,-5,23247,17511,-40
81817055705,81817055710,5,1186,725,-40
81820967467,81820967462,-5,1992,7454,-40
81823634403,81823634409,6,2460,1152,-40
81824261901,81824261908,7,9479,38436,-40
81824802562,81824802575,13,28838,56911,-40
81826120777,81826120782,5,2724,1687,-40
81827984823,81827984831,8,1877,809,-40
81829613672,81829613680,8,2017,1334,-40
81830655354,81830655351,-3,2374,5295,-40
81834266579,81834266586,7,3541,1476,-40
81834685631,81834685637,6,1456,550,-40
81838072042,81838072046,4,1961,877,-40
81839085802,81839085809,7,3705,1587,-40
81840978854,81840978859,5,3922,1566,-40
81842249678,81842249682,4,2187,1023,-40
81842275591,81842275598,7,4490,1307,-40
81845836517,81845836518,1,1330,1481,-40
81846143358,81846143365,7,3267,1649,-40
81846417767,81846417755,-12,531,137,-40
81854831778,81854831785,7,3880,1645,-40
81855147957,81855147939,-18,2890,1654,-40
81855296868,81855296875,7,2935,932,-40
81855534645,81855534649,4,1962,936,-40
81855722846,81855722834,-12,844,76,-40
81859294541,81859294546,5,2078,1680,-40
81860237239,81860237247,8,2625,1336,-40
81860865465,81860865473,8,1661,631,-40
81861577694,81861577703,9,2811,1499,-40
81865159761,81865159768,7,2413,1270,-40
81867047999,81867048005,6,3426,1852,-40
81867206104,81867206090,-14,2110,766,-40
81871008626,81871008631,5,2359,1094,-40
81871720962,81871720967,5,1759,715,-40
81872821817,81872821824,7,4496,1326,-40
81874767084,81874767090,6,1699,1142,-40
81875193875,81875193882,7,2202,1068,-40
81878841759,81878841766,7,2583,719,-40
81878990345,81878990350,5,3143,1712,-40
81882431722,81882431729,7,2894,1334,-40
81883279017,81883279000,-17,3194,1364,-40
81884400915,81884400913,-2,1149,2237,-40
81888562448,81888562454,6,2550,1483,-40
81890115227,81890115222,-5,737,2440,-40
81890691054,81890691061,7,1713,1052,-40
81890891286,81890891291,5,1394,145,-40
81891400927,81891400934,7,4120,1466,-40
81892418085,81892418090,5,2667,1203,-40
81893306435,81893306442,7,2833,1480,-40
81893783370,81893783374,4,2788,975,-40
81895795349,81895795354,5,2571,1334,-40
81898174235,81898174242,7,3385,1042,-40
81898381926,81898381914,-12,857,539,-40
81901788664,81901788670,6,2672,1845,-40
81903453777,81903453782,5,2177,1560,-40
81904510359,81904510380,21,749,112,-40
81908848897,81908848897,0,1374,1500,-40
81910731351,81910731328,-23,1105,333,-40
81912588261,81912588267,6,2071,1209,-40
81918119297,81918119303,6,3282,967,-40
81919006682,81919006689,7,3161,1250,-40
81921462665,81921462671,6,2606,1235,-40
81923186315,81923186313,-2,1412,2164,-40
81924701467,81924701474,7,2113,1573,-40
81928410373,81928410379,6,1866,1115,-40
81929243270,81929243248,-22,1733,626,-40
81930724152,81930724158,6,3149,1153,-40
81931429494,81931429501,7,2215,1139,-40
81931882086,81931882066,-20,1385,602,-40
81932962232,81932962226,-6,932,1338,-40
81933679356,81933679362,6,1858,851,-40
81937452297,81937452302,5,1762,1065,-40
81945304644,81945304648,4,2466,1115,-40
81948012341,81948012346,5,1671,1143,-40
81950027502,81950027509,7,2203,1488,-40
81950802914,81950802892,-22,1419,1103,-40
81953298151,81953298158,7,3177,1123,-40
81953695497,81953695502,5,3148,1062,-40
81953879779,81953879786,7,1994,1021,-40
81955503272,81955503278,6,1972,1081,-40
81955568730,81955568720,-10,1308,166,-40
81955798705,81955798724,19,2666,1431,-40
81959239797,81959239804,7,2816,1028,-40
81960612121,81960612126,5,1889,985,-40
81961655162,81961655167,5,2298,921,-40
81961971994,81961971985,-9,996,74,-40
81962456925,81962456931,6,1968,1103,-40
81965107471,81965107477,6,2921,1474,-40
81969207992,81969207999,7,75841,29258,-40
81973079748,81973079754,6,2706,1175,-40
81976818144,81976818151,7,2293,1213,-40
81978084620,81978084626,6,2794,1353,-40
81981239478,81981239483,5,1451,1114,-40
81982358695,81982358702,7,3283,1271,-40
81986948580,81986948588,8,4158,1727,-40
81987909379,81987909386,7,3042,46295,-40
81992751053,81992751058,5,41831,19574,-40
81994053726,81994053722,-4,1693,3317,-40
81994132242,81994132248,6,3531,1477,-40
81998642122,81998642126,4,1986,756,-40
82001440443,82001440450,7,4752,2407,-40
82001780773,82001780781,8,3338,1548,-40
82002588599,82002588604,5,1535,936,-40
82003315606,82003315588,-18,906,47,-40
82004478818,82004478825,7,3313,1441,-40
82006041420,82006041426,6,3853,1631,-40
82006137100,82006137110,10,15419,36373,-40
82006295400,82006295404,4,3242,2589,-40
82009075667,82009075675,8,4097,1951,-40
82015066926,82015066934,8,3154,1488,-40
82020360955,82020360962,7,2041,934,-40
82023909643,82023909660,17,1326,1886,-40
82030334062,82030334066,4,3062,1307,-40
82031018651,82031018664,13,390,142,-40
82033438601,82033438608,7,8609,1156,-40
82033963996,82033964002,6,3052,1819,-40
82039667509,82039667514,5,3253,1159,-40
82040500962,82040500965,3,3725,1576,-40
82042271269,82042271274,5,1707,1180,-40
82044417073,82044417079,6,2390,1073,-40
82045124815,82045124823,8,3413,1292,-40
82045198908,82045198914,6,2862,1338,-40
82045479991,82045479997,6,3327,1817,-40
82050239625,82050239627,2,974,1311,-40
82056650116,82056650124,8,3773,1355,-40
82058654778,82058654786,8,3714,1263,-40
82059374793,82059374799,6,2258,1573,-40
82062272321,82062272326,5,2831,1551,-40
82063819461,82063819467,6,2911,1666,-40
82064182828,82064182849,21,2131,821,-40
82064534502,82064534520,18,3009,1336,-40
82064713613,82064713632,19,1082,168,-40
82067377158,82067377162,4,2019,968,-40
82070481618,82070481613,-5,944,2942,-40
82070736037,82070736030,-7,1348,4027,-40
82070871642,82070871650,8,2023,564,-40
82072762723,82072762728,5,2858,1228,-40
82072913539,82072913521,-18,1808,980,-40
82075780505,82075780511,6,3493,1533,-40
82075816370,82075816377,7,2993,1299,-40
82076654045,82076654051,6,3664,1346,-40
82076718123,82076718107,-16,2224,943,-40
82077882139,82077882147,8,2814,1363,-40
82083126641,82083126647,6,2489,1258,-40
82085752042,82085752049,7,2624,878,-40
82085922685,82085922666,-19,1478,412,-40
82087153305,82087153311,6,2605,1296,-40
82087748184,82087748189,5,2492,1540,-40
82088770349,82088770355,6,2776,1529,-40
82089056183,82089056190,7,3417,1740,-40
82089420591,82089420597,6,2354,1467,-40
82089992269,82089992275,6,3226,1157,-40
82091304070,82091304075,5,2559,1733,-40
82095848249,82095848257,8,4452,1045,-40
82098325464,82098325471,7,3324,1415,-40
82098746373,82098746379,6,3204,1502,-40
82100632889,82100632893,4,2745,1369,-40
82104118968,82104118970,2,1553,1348,-40
82105043969,82105043974,5,2187,1125,-40
82105331969,82105331975,6,2216,933,-40
82105398849,82105398855,6,2820,921,-40
82106971896,82106971893,-3,1264,1933,-40
82112040822,82112040828,6,3048,1364,-40
82112848467,82112848451,-16,1010,255,-40
82114039434,82114039440,6,2291,1233,-40
82116200586,82116200590,4,3986,2149,-40
82123588414,82123588409,-5,1008,2336,-40
82128939587,82128939594,7,2231,1104,-40
82129437177,82129437187,10,3053,1134,-40
82130283609,82130283616,7,2520,1323,-40
82132456767,82132456766,-1,830,1660,-40
82134603819,82134603826,7,2209,830,-40
82135854919,82135854923,4,2125,1268,-40
82136462923,82136462916,-7,1536,416,-40
82138574442,82138574446,4,1416,681,-40
82143215764,82143215769,5,2250,1201,-40
82144583193,82144583193,0,2055,3465,-40
82145434526,82145434533,7,6933,2581,-40
82149218292,82149218302,10,1953,742,-40
82150650617,82150650623,6,2692,1334,-40
82154663153,82154663159,6,3545,1735,-40
82156529265,82156529272,7,2607,1315,-40
82157809675,82157809681,6,2828,1422,-40
82158044087,82158044095,8,2193,1022,-40
82167866779,82167866786,7,4604,1776,-40
82168319466,82168319466,0,1325,1548,-40
82169564466,82169564470,4,2261,1305,-40
82172342862,82172342863,1,1045,1202,-40
82172874482,82172874487,5,1720,1049,-40
82180278546,82180278554,8,2597,1372,-40
82180518997,82180519011,14,2155,1170,-40
82187368710,82187368715,5,3425,1082,-40
82188437627,82188437633,6,3308,1315,-40
82191305952,82191305958,6,3045,990,-40
82192318376,82192318394,18,2892,1176,-40
82193453650,82193453654,4,2569,1232,-40
82193639206,82193639213,7,1961,1533,-40
82197889427,82197889431,4,1064,965,-40
82200031435,82200031441,6,2326,1389,-40
82201642653,82201642660,7,3133,1489,-40
82201681329,82201681335,6,3656,1758,-40
82202294749,82202294755,6,2220,851,-40
82206657781,82206657786,5,3294,1489,-40
82206707587,82206707585,-2,1090,248,-40
82208027857,82208027843,-14,16988,43352,-40
82208290518,82208290524,6,2127,1346,-40
82208944634,82208944640,6,1533,705,-40
82216669804,82216669810,6,2525,1272,-40
82224344037,82224344042,5,2801,1336,-40
82225921292,82225921298,6,3655,2013,-40
82227279935,82227279943,8,1848,924,-40
82234559090,82234559094,4,2406,966,-40
82240538724,82240538720,-4,46182,3326,-40
82244011869,82244011874,5,2770,1377,-40
82245289318,82245289326,8,2389,1451,-40
82252543486,82252543492,6,2115,1064,-40
82252933198,82252933195,-3,1448,3624,-40
82253989761,82253989762,1,1564,1322,-40
82256708491,82256708485,-6,19028,14516,-40
82257824913,82257824919,6,3297,952,-40
82258457211,82258457194,-17,1069,160,-40
82259104314,82259104314,0,35929,19383,-40
82260200633,82260200630,-3,607,1425,-40
82262166346,82262166355,9,3458,1030,-40
82267669061,82267669066,5,2503,1091,-40
82272779625,82272779630,5,2954,1395,-40
82276775073,82276775067,-6,666,4978,-40
82277918427,82277918433,6,3265,1164,-40
82278642166,82278642173,7,3338,1487,-40
82283697052,82283697058,6,1806,1356,-40
82290846914,82290846919,5,2741,1272,-40
82291048362,82291048367,5,2725,797,-40
82291115689,82291115696,7,4385,1484,-40
82291238038,82291238027,-11,762,51,-40
82292161105,82292161110,5,3046,1550,-40
82292612159,82292612158,-1,1320,1130,-40
82297651022,82297651028,6,2394,1381,-40
82298280962,82298280967,5,3938,1267,-40
82299018030,82299018034,4,5144,20022,-40
82301171878,82301171883,5,1598,971,-40
82302078390,82302078395,5,2404,1022,-40
82302580489,82302580495,6,2094,1004,-40
82305071857,82305071865,8,2980,1057,-40
82306473077,82306473070,-7,52,746,-40
82307953667,82307953673,6,3027,1345,-40
82308659020,82308659026,6,2620,1285,-40
82314023488,82314023493,5,21503,28332,-40
82315068699,82315068705,6,2321,1539,-40
82320219494,82320219499,5,3882,895,-40
82321371594,82321371599,5,3122,1184,-40
82322403777,82322403783,6,2829,1358,-40
82322900529,82322900535,6,2553,1164,-40
82324022266,82324022274,8,2979,1274,-40
82324230306,82324230307,1,2879,3657,-40
82324498341,82324498346,5,3198,1553,-40
82331609749,82331609755,6,1890,909,-40
82333683190,82333683197,7,2858,1420,-40
82339135066,82339135070,4,2467,1268,-40
82340770389,82340770394,5,991,1181,-40
82341700033,82341700038,5,4179,2417,-40
82346406103,82346406109,6,3109,1250,-40
82348929982,82348929989,7,3447,1314,-40
82351809347,82351809353,6,3596,1222,-40
82352454677,82352454683,6,1911,1266,-40
82352745382,82352745387,5,1823,1430,-40
82354657330,82354657336,6,2646,720,-40
82358277590,82358277595,5,2402,1161,-40
82361165019,82361165021,2,1848,1252,-40
82361872827,82361872834,7,2884,943,-40
82364070489,82364070473,-16,856,496,-40
82368693648,82368693655,7,2554,944,-40
82369729173,82369729180,7,2169,975,-40
82371231222,82371231229,7,4323,1334,-40
82376122731,82376122732,1,1341,1926,-40
82376184197,82376184203,6,3025,987,-40
82380575596,82380575601,5,2139,855,-40
82382302141,82382302146,5,2886,1117,-40
82383499814,82383499822,8,2454,1615,-40
82385083155,82385083160,5,2032,1254,-40
82385245206,82385245186,-20,1937,1197,-40
82391948557,82391948563,6,3116,1082,-40
82395035970,82395035974,4,3016,1484,-40
82399701397,82399701402,5,1810,1011,-40
82423004254,82423004250,-4,1082,1853,-40
82425179186,82425179193,7,3069,1216,-40
82425559681,82425559665,-16,1673,808,-40
82428867332,82428867339,7,3877,1187,-40
82430388158,82430388163,5,2720,1398,-40
82433372550,82433372556,6,2269,1061,-40
82434054685,82434054691,6,1398,665,-40
82442328430,82442328434,4,2541,1161,-40
82443857731,82443857738,7,3697,1121,-40
82444107922,82444107921,-1,1101,1864,-40
82444452277,82444452283,6,2285,886,-40
82444877746,82444877728,-18,2817,1664,-40
82445689258,82445689265,7,3347,1139,-40
82447146709,82447146701,-8,32782,10097,-40
82449151402,82449151407,5,2658,1262,-40
82450497678,82450497684,6,3020,1210,-40
82451103154,82451103161,7,6098,2511,-40
82453456682,82453456687,5,1745,997,-40
82453652897,82453652884,-13,730,699,-40
82455109946,82455109952,6,3385,1375,-40
82455138074,82455138079,5,2016,1050,-40
82455546671,82455546674,3,643,240,-40
82455701833,82455701836,3,784,420,-40
82456621199,82456621200,1,1222,2401,-40
82458476128,82458476134,6,1696,1049,-40
82461027342,82461027348,6,905,904,-40
82466518282,82466518287,5,2055,997,-40
82466678358,82466678340,-18,1554,607,-40
82473426739,82473426746,7,2807,1148,-40
82476149865,82476149871,6,4358,1947,-40
82476743722,82476743738,16,11791,53293,-40
82479896427,82479896435,8,2725,1129,-40
82480367214,82480367193,-21,635,268,-40
82485340892,82485340896,4,2157,1023,-40
82485375618,82485375627,9,1857,960,-40
82485664659,82485664658,-1,1110,343,-40
82496119231,82496119219,-12,9188,38927,-40
82497179974,82497179974,0,34700,46505,-40
82497675381,82497675387,6,1113,814,-40
82498591677,82498591683,6,3368,1388,-40
82499485275,82499485282,7,3490,1565,-40
82504792152,82504792157,5,2623,1121,-40
82507142021,82507142027,6,3253,987,-40
82508632229,82508632237,8,3682,1289,-40
82509095294,82509095299,5,1984,943,-40
82509297317,82509297321,4,3500,1298,-40
82510365681,82510365687,6,2317,844,-40
82511551366,82511551356,-10,1439,503,-40
82512117045,82512117050,5,2143,1451,-40
82513343242,82513343248,6,3053,1423,-40
82515711652,82515711634,-18,1189,2130,-40
82520752300,82520752305,5,2446,1336,-40
82525379229,82525379234,5,2155,1110,-40
82528994311,82528994318,7,2941,1320,-40
82530632967,82530632974,7,2652,1250,-40
82530831203,82530831187,-16,962,226,-40
82532712347,82532712354,7,3807,1632,-40
82533698717,82533698722,5,2586,1164,-40
82536333864,82536333869,5,3620,1263,-40
82538769652,82538769657,5,2331,1731,-40
82542363514,82542363520,6,3075,1626,-40
82543130636,82543130642,6,2873,795,-40
82546782111,82546782117,6,3300,1617,-40
82553276371,82553276377,6,2427,1046,-40
82555318844,82555318850,6,3630,1287,-40
82557701417,82557701423,6,3347,1101,-40
82563286197,82563286202,5,2335,1162,-40
82569001268,82569001265,-3,1025,1101,-40
82570118153,82570118159,6,1305,733,-40
82570619498,82570619502,4,1985,1372,-40
82571265613,82571265620,7,4546,1816,-40
82580154641,82580154648,7,3456,882,-40
82580541476,82580541457,-19,1207,410,-40
82588031248,82588031253,5,2554,1259,-40
82593065501,82593065509,8,2871,1167,-40
82593216057,82593216057,0,750,130,-40
82595357249,82595357255,6,2446,1232,-40
82598118370,82598118377,7,2830,1243,-40
82600494225,82600494230,5,2712,1213,-40
82601313051,82601313059,8,3390,1086,-40
82609974354,82609974351,-3,1328,2206,-40
82618321099,82618321100,1,868,303,-40
82619750714,82619750722,8,3132,1205,-40
82619862990,82619862987,-3,1296,1704,-40
82625286190,82625286195,5,2773,1544,-40
82628882189,82628882190,1,1074,870,-40
82631375727,82631375724,-3,961,294,-40
82632796147,82632796141,-6,1740,5764,-40
82638673138,82638673147,9,3713,1064,-40
82639619254,82639619260,6,3545,1500,-40
82640184250,82640184241,-9,857,262,-40
82642613793,82642613799,6,3097,1607,-40
82643974397,82643974402,5,3192,1333,-40
82646341853,82646341858,5,2203,1090,-40
82648542949,82648542955,6,1988,906,-40
82651864944,82651864950,6,3101,1248,-40
82653558710,82653558730,20,809,4937,-40
82655025580,82655025585,5,4125,1440,-40
82655450359,82655450366,7,1346,976,-40
82660173877,82660173894,17,131,1199,-40
82662998541,82662998546,5,1905,1025,-40
82667167346,82667167354,8,2464,1012,-40
82669158345,82669158351,6,3146,2084,-40
82681348633,82681348640,7,2648,1576,-40
82681946657,82681946663,6,3060,968,-40
82682058753,82682058761,8,1250,217,-40
82683504406,82683504410,4,2193,1037,-40
82683745366,82683745347,-19,3650,1093,-40
82684449341,82684449346,5,3196,1548,-40
82686369170,82686369175,5,2794,1419,-40
82686447548,82686447528,-20,1621,508,-40
82689769733,82689769740,7,2763,1337,-40
82690878744,82690878753,9,15566,32538,-40
82697556923,82697556930,7,2530,871,-40
82697631898,82697631898,0,1429,2603,-40
82708000986,82708000993,7,2433,959,-40
82708263566,82708263577,11,2913,1009,-40
82709743073,82709743078,5,1944,1173,-40
82710293116,82710293122,6,3148,1021,-40
82710388734,82710388713,-21,2706,508,-40
82710650319,82710650323,4,2109,798,-40
82711392782,82711392791,9,3751,717,-40
82720189639,82720189647,8,4022,1191,-40
82721586414,82721586422,8,3886,1663,-40
82723282621,82723282627,6,2454,1555,-40
82729552854,82729552858,4,2053,834,-40
82732686418,82732686425,7,3372,1754,-40
82741999873,82741999869,-4,1418,3090,-40
82745761624,82745761635,11,305,1809,-40
82749323202,82749323206,4,2394,1949,-40
82749565577,82749565583,6,3776,1902,-40
82753159829,82753159836,7,2970,1403,-40
82755113763,82755113770,7,3643,1847,-40
82762336686,82762336691,5,2174,1013,-40
82765632094,82765632102,8,2230,1281,-40
82765863231,82765863237,6,2891,1429,-40
82768176969,82768176974,5,3212,1823,-40
82769168467,82769168474,7,3072,1368,-40
82774060506,82774060513,7,2044,1072,-40
82774343559,82774343545,-14,1548,515,-40
82776657376,82776657394,18,495,872,-40
82777301312,82777301319,7,2494,1005,-40
82777341154,82777341159,5,1058,953,-40
82785300450,82785300457,7,2714,1368,-40
82786263320,82786263324,4,2134,1433,-40
82788232091,82788232091,0,40023,16554,-40
82788351733,82788351738,5,2697,1149,-40
82791085497,82791085503,6,3229,1075,-40
82793695428,82793695435,7,2465,1014,-40
82794512599,82794512603,4,2259,1437,-40
82797096097,82797096103,6,2645,1422,-40
82801426413,82801426416,3,1733,1146,-40
82802570631,82802570617,-14,2537,1138,-40
82802766320,82802766325,5,2488,1008,-40
82807167925,82807167925,0,1275,2400,-40
82808340869,82808340874,5,2194,1575,-40
82808417362,82808417346,-16,1273,1040,-40
82815177446,82815177451,5,2594,1344,-40
82817394506,82817394511,5,3520,1530,-40
82818217342,82818217349,7,3870,1263,-40
82819335593,82819335600,7,3885,1562,-40
82820063616,82820063621,5,2841,1444,-40
82823540027,82823540046,19,643,1812,-40
82827262936,82827262943,7,2141,1328,-40
82843020644,82843020650,6,3022,1456,-40
82847936296,82847936303,7,3739,1690,-40
82850178913,82850178919,6,2611,1375,-40
82856179362,82856179358,-4,2713,5658,-40
82859150689,82859150696,7,4449,1847,-40
82860751737,82860751745,8,2764,1770,-40
82861034378,82861034387,9,2972,1392,-40
82861507734,82861507739,5,2476,746,-40
82864137012,82864137018,6,3655,1553,-40
82865014202,82865014205,3,1792,1040,-40
82865484653,82865484657,4,2044,1144,-40
82865567038,82865567038,0,1952,1425,-40
82866957353,82866957357,4,2518,1003,-40
82867407443,82867407427,-16,743,166,-40
82868167689,82868167695,6,3229,1480,-40
82869057956,82869057958,2,2428,2244,-40
82869890885,82869890890,5,2594,1283,-40
82870956821,82870956827,6,2547,1390,-40
82873464023,82873464029,6,2943,1638,-40
82873618806,82873618803,-3,1047,2157,-40
82880094803,82880094810,7,2816,1195,-40
82883896630,82883896635,5,39308,29196,-40
82884393748,82884393754,6,2652,1087,-40
82884927310,82884927315,5,2341,1276,-40
82890516139,82890516146,7,2861,1172,-40
82892080098,82892080106,8,2302,1112,-40
82894467737,82894467743,6,2922,1137,-40
82894611253,82894611259,6,2204,1137,-40
82894982510,82894982515,5,2337,1481,-40
82895931041,82895931046,5,2875,1346,-40
82896650431,82896650436,5,2293,1055,-40
82897155513,82897155514,1,823,304,-40
82902495305,82902495299,-6,2019,7448,-40
82904073802,82904073805,3,32653,21292,-40
82904612178,82904612184,6,3252,1210,-40
82905848733,82905848738,5,2065,928,-40
82906985009,82906985014,5,2534,1262,-40
82908274356,82908274361,5,3403,1901,-40
82909166874,82909166879,5,2341,1654,-40
82916183046,82916183053,7,3729,1479,-40
82917778250,82917778254,4,2397,1253,-40
82923501941,82923501947,6,2517,1134,-40
82923568753,82923568759,6,2231,1303,-40
82924502510,82924502517,7,2942,1538,-40
82928995565,82928995571,6,2893,988,-40
82936161793,82936161800,7,3113,1329,-40
82936521353,82936521358,5,3358,1592,-40
82936550092,82936550082,-10,1238,520,-40
82939276297,82939276305,8,2531,1632,-40
82941480313,82941480319,6,6541,2614,-40
82946994801,82946994803,2,1709,1999,-40
82948187093,82948187099,6,3014,899,-40
82948544491,82948544499,8,3809,1491,-40
82949227938,82949227945,7,899,655,-40
82951805655,82951805660,5,2595,1410,-40
82955488060,82955488066,6,3095,1252,-40
82956071095,82956071102,7,2759,1481,-40
82964385894,82964385900,6,2660,1138,-40
82968996888,82968996894,6,2774,1615,-40
82970403889,82970403892,3,1751,1627,-40
82973299567,82973299548,-19,2059,631,-40
82981037678,82981037683,5,2125,1007,-40
82981163952,82981163944,-8,1398,333,-40
82984367366,82984367371,5,2588,946,-40
82989229757,82989229763,6,3765,1153,-40
82990858810,82990858815,5,2405,1292,-40
82995118321,82995118327,6,4562,2050,-40
82998866497,82998866505,8,2681,1118,-40
83002731737,83002731742,5,1297,824,-40
83005985053,83005985058,5,3075,1206,-40
83006882129,83006882126,-3,2023,3855,-40
83007773620,83007773625,5,2839,1083,-40
83008754734,83008754741,7,3190,1240,-40
83010593883,83010593889,6,2467,992,-40
83012621952,83012621957,5,2708,1072,-40
83012916584,83012916600,16,858,316,-40
83014753072,83014753079,7,2785,1335,-40
83015761080,83015761086,6,3533,1393,-40
83015842896,83015842893,-3,1099,3428,-40
83027663493,83027663498,5,2243,1373,-40
83028939987,83028939993,6,2859,1352,-40
83029183481,83029183476,-5,878,602,-40
83031200537,83031200555,18,1318,3098,-40
83033022720,83033022725,5,2715,1425,-40
83041631345,83041631349,4,2510,1341,-40
83046640867,83046640873,6,3772,1539,-40
83052387262,83052387267,5,3433,1389,-40
83054047661,83054047665,4,2002,1333,-40
83057712846,83057712854,8,2078,1204,-40
83058422898,83058422892,-6,742,325,-40
83061450441,83061450439,-2,1456,2322,-40
83062900282,83062900288,6,2843,1575,-40
83063049334,83063049341,7,2947,1131,-40
83063331204,83063331210,6,2773,1317,-40
83065530096,83065530097,1,1465,2220,-40
83065699636,83065699641,5,2803,1705,-40
83065814777,83065814784,7,2089,1718,-40
83066258696,83066258702,6,3698,1087,-40
83068803859,83068803863,4,2995,1183,-40
83070106720,83070106726,6,2823,988,-40
83071116645,83071116666,21,785,132,-40
83071911277,83071911283,6,2973,867,-40
83074344014,83074344021,7,2847,1486,-40
83074505626,83074505608,-18,2759,1294,-40
83078058181,83078058187,6,1802,1126,-40
83078987649,83078987654,5,3829,1257,-40
83087408569,83087408575,6,2091,1033,-40
83088753033,83088753035,2,1558,963,-40
83090477301,83090477308,7,6957,1720,-40
83092085057,83092085063,6,3746,1218,-40
83095941715,83095941722,7,2634,1142,-40
83096231910,83096231913,3,1751,1331,-40
83097498386,83097498392,6,2836,1378,-40
83098836572,83098836560,-12,1013,501,-40
83102577286,83102577290,4,1842,1032,-40
83107452046,83107452053,7,3084,1070,-40
83109487403,83109487410,7,2636,1202,-40
83110032094,83110032101,7,3385,1544,-40
83111661469,83111661454,-15,2622,725,-40
83116783589,83116783596,7,3326,1388,-40
83120681007,83120681013,6,3665,1919,-40
83120988509,83120988514,5,3263,1661,-40
83125882110,83125882114,4,1796,839,-40
83130539050,83130539054,4,2516,1165,-40
83141122733,83141122739,6,5454,2587,-40
83141548393,83141548398,5,1869,1038,-40
83144381966,83144381974,8,3525,2042,-40
83147162755,83147162762,7,2483,1271,-40
83149451679,83149451686,7,1494,1002,-40
83150598903,83150598909,6,1961,968,-40
83153086673,83153086679,6,3468,1551,-40
83156439638,83156439646,8,2521,1214,-40
83157093661,83157093667,6,2824,1407,-40
83159497238,83159497245,7,3221,1808,-40
83161298984,83161298990,6,3078,1007,-40
83162834568,83162834571,3,2314,983,-40
83162958366,83162958387,21,2417,1447,-40
83168814353,83168814358,5,2814,1062,-40
83170808693,83170808698,5,2084,1241,-40
83173546977,83173546982,5,2083,1040,-40
83175235345,83175235352,7,3485,1598,-40
83177744805,83177744810,5,6052,3292,-40
83179224518,83179224513,-5,23481,10467,-40
83179883658,83179883662,4,2840,1020,-40
83184379698,83184379706,8,2498,1105,-40
83184544602,83184544606,4,2302,1578,-40
83187080367,83187080374,7,2785,1321,-40
83187453698,83187453704,6,2708,1372,-40
83189525894,83189525899,5,2594,1512,-40
83189936259,83189936272,13,731,233,-40
83191277937,83191277944,7,812,86,-40
83192010673,83192010679,6,3366,1457,-40
83192080818,83192080825,7,1299,261,-40
83192328262,83192328242,-20,1715,1118,-40
83194114742,83194114750,8,2627,1343,-40
83196552345,83196552351,6,2560,856,-40
83196965973,83196965986,13,835,191,-40
83199450606,83199450611,5,3023,1255,-40
83200634586,83200634592,6,3023,1330,-40
83201434386,83201434393,7,3112,1401,-40
83203119813,83203119817,4,2565,1441,-40
83203269470,83203269476,6,2975,1281,-40
83203546025,83203546030,5,2964,1365,-40
83210053838,83210053849,11,15955,40531,-40
83212987850,83212987858,8,2971,1591,-40
83213387718,83213387723,5,2505,1111,-40
83214734086,83214734090,4,1101,774,-40
83216083186,83216083193,7,3475,1678,-40
83219035667,83219035673,6,3316,1423,-40
83220711534,83220711538,4,1760,1441,-40
83226594784,83226594791,7,2712,1170,-40
83229174189,83229174197,8,3626,1229,-40
83229207791,83229207771,-20,889,440,-40
83234639378,83234639373,-5,1395,3497,-40
83234946168,83234946176,8,2537,1191,-40
83241465765,83241465773,8,2168,1024,-40
83242206650,83242206657,7,2195,1169,-40
83246871126,83246871133,7,3736,1419,-40
83248674762,83248674768,6,2721,1440,-40
83249128850,83249128844,-6,1741,8969,-40
83249727693,83249727689,-4,1149,1970,-40
83252572367,83252572374,7,2463,1041,-40
83252831366,83252831354,-12,919,320,-40
83256785457,83256785467,10,12108,24307,-40
83257341933,83257341938,5,3190,1374,-40
83259047967,83259047974,7,2338,1200,-40
83259352351,83259352356,5,3109,1550,-40
83259693226,83259693234,8,3242,1390,-40
83262352673,83262352678,5,3020,1131,-40
83263878385,83263878390,5,2617,1249,-40
83265773080,83265773087,7,2474,1046,-40
83267091286,83267091294,8,2231,948,-40
83268389683,83268389690,7,2737,1484,-40
83268600962,83268600971,9,3644,1193,-40
83269001174,83269001180,6,2559,1676,-40
83270551769,83270551776,7,3818,1635,-40
83281338626,83281338631,5,3635,1759,-40
83282065514,83282065521,7,4123,1637,-40
83284716949,83284716957,8,5851,1063,-40
83284767241,83284767234,-7,885,251,-40
83285126838,83285126846,8,2953,1093,-40
83286200422,83286200421,-1,2167,1415,-40
83287189858,83287189865,7,3307,910,-40
83289805098,83289805103,5,2875,1411,-40
83290080163,83290080170,7,2815,1355,-40
83299561278,83299561285,7,4936,1617,-40
83301373554,83301373561,7,2746,1123,-40
83302433613,83302433618,5,2562,1264,-40
83304458278,83304458284,6,2404,1213,-40
83305061289,83305061294,5,2962,1058,-40
83306677098,83306677104,6,1151,822,-40
83311842713,83311842719,6,4116,1566,-40
83313544229,83313544230,1,14913,18495,-40
83314581081,83314581086,5,3253,1405,-40
83315016558,83315016563,5,2437,1511,-40
83316774234,83316774230,-4,1106,1842,-40
83318255889,83318255895,6,1629,798,-40
83322228124,83322228130,6,2454,1097,-40
83325092140,83325092146,6,3695,1334,-40
83326278933,83326278937,4,1024,925,-40
83327781579,83327781586,7,3295,1017,-40
83333977695,83333977702,7,2700,1311,-40
83338337989,83338337997,8,3530,1503,-40
83338575915,83338575921,6,2832,1110,-40
83342006048,83342006068,20,17794,43691,-40
83342588081,83342588087,6,3866,1854,-40
83343596607,83343596611,4,1578,1070,-40
83343992268,83343992270,2,1761,1664,-40
83344669497,83344669494,-3,1346,2912,-40
83345608197,83345608202,5,2738,1034,-40
83346415943,83346415949,6,3256,1346,-40
83347792851,83347792858,7,939,600,-40
83356702985,83356702991,6,3095,1131,-40
83363585641,83363585651,10,1694,865,-40
83365919957,83365919954,-3,1623,4199,-40
83367094159,83367094166,7,2024,1169,-40
83367450532,83367450539,7,2537,1394,-40
83367958404,83367958410,6,1973,942,-40
83369020532,83369020538,6,2869,1469,-40
83369659850,83369659858,8,2179,1072,-40
83369687365,83369687386,21,1171,831,-40
83372363337,83372363343,6,1389,911,-40
83375482056,83375482061,5,2983,1198,-40
83377052091,83377052099,8,2248,1187,-40
83377507939,83377507946,7,4523,1783,-40
83377658013,83377658017,4,2121,1276,-40
83380410485,83380410490,5,3231,1282,-40
83381635960,83381635965,5,1790,1258,-40
83382288220,83382288226,6,2734,1508,-40
83382464730,83382464735,5,2841,1498,-40
83386087258,83386087263,5,1878,1120,-40
83389432025,83389432031,6,2011,1306,-40
83393271018,83393271024,6,2122,688,-40
83399519798,83399519803,5,3680,1792,-40
83403166268,83403166274,6,2865,1562,-40
83410613930,83410613938,8,2606,1150,-40
83412065067,83412065048,-19,2265,1171,-40
83414442388,83414442396,8,3068,1466,-40
83416247758,83416247764,6,1279,664,-40
83418597762,83418597768,6,3274,1136,-40
83420476268,83420476275,7,3779,1220,-40
83421624629,83421624629,0,10599,12241,-40
83425832558,83425832565,7,1882,895,-40
83429957954,83429957961,7,2506,1380,-40
83430827417,83430827422,5,2312,1283,-40
83430980686,83430980690,4,1823,865,-40
83431232392,83431232378,-14,706,109,-40
83436793060,83436793066,6,3260,1578,-40
83438012359,83438012365,6,2955,1816,-40
83438463285,83438463298,13,883,196,-40
83442542392,83442542398,6,4300,1565,-40
83444829453,83444829459,6,3152,1513,-40
83445093453,83445093458,5,2766,1071,-40
83448724914,83448724919,5,2560,1545,-40
83448896678,83448896683,5,2237,1491,-40
83455408733,83455408741,8,2773,1254,-40
83456954857,83456954863,6,3700,1415,-40
83461445797,83461445803,6,3026,1512,-40
83464176470,83464176478,8,2865,1169,-40
83465620333,83465620338,5,1430,947,-40
83466443281,83466443287,6,2718,1052,-40
83468178303,83468178310,7,3426,1296,-40
83471702138,83471702144,6,1909,1034,-40
83472049245,83472049250,5,3591,2586,-40
83475168090,83475168098,8,2411,1003,-40
83481378121,83481378129,8,1707,699,-40
83481523331,83481523338,7,3220,1142,-40
83489016108,83489016114,6,3414,1773,-40
83489734746,83489734751,5,1299,895,-40
83491973340,83491973361,21,2791,828,-40
83494031711,83494031718,7,2420,1616,-40
83494402023,83494402030,7,3119,1174,-40
83497254443,83497254437,-6,38305,10918,-40
83497596465,83497596464,-1,1749,3700,-40
83499066406,83499066410,4,2519,1545,-40
83505542095,83505542092,-3,1222,2838,-40
83506879929,83506879934,5,2204,1051,-40
83509431855,83509431861,6,1944,1550,-40
83511406113,83511406117,4,2957,2471,-40
83516290882,83516290888,6,3905,2100,-40
83516838743,83516838749,6,2845,2128,-40
83520034309,83520034313,4,2730,1104,-40
83521499430,83521499435,5,3311,1018,-40
83526277513,83526277519,6,3167,1205,-40
83528053013,83528053018,5,3050,1270,-40
83529384315,83529384318,3,1370,958,-40
83534393489,83534393497,8,3027,978,-40
83535016035,83535016042,7,2751,1324,-40
83540761742,83540761747,5,2432,1308,-40
83542145706,83542145713,7,2168,1648,-40
83542882869,83542882875,6,3248,1264,-40
83544046746,83544046752,6,2939,1015,-40
83545054437,83545054419,-18,2371,1103,-40
83549829822,83549829827,5,2488,773,-40
83561131345,83561131350,5,4012,1274,-40
83562037638,83562037643,5,2252,1065,-40
83562842982,83562842964,-18,3706,1814,-40
83564178145,83564178144,-1,1281,1325,-40
83566775105,83566775109,4,2821,2663,-40
83576023504,83576023498,-6,1982,7110,-40
83582996126,83582996131,5,2671,1184,-40
83587917770,83587917777,7,3871,1587,-40
83594067461,83594067461,0,1584,2386,-40
83595884971,83595884978,7,2209,1209,-40
83596905106,83596905106,0,796,1391,-40
83599623916,83599623917,1,1556,1491,-40
83600410417,83600410423,6,2470,919,-40
83601678882,83601678890,8,2116,927,-40
83603180874,83603180882,8,570,61,-40
83603909535,83603909545,10,3180,1051,-40
83604451610,83604451618,8,2752,1193,-40
83605412814,83605412819,5,4234,1739,-40
83610773957,83610773963,6,1564,731,-40
83612511339,83612511346,7,2518,1116,-40
83612945652,83612945658,6,3499,1621,-40
83620069247,83620069251,4,3371,2007,-40
83621478004,83621478010,6,1691,1202,-40
83621945979,83621945971,-8,1601,10857,-40
83623070365,83623070371,6,2121,1056,-40
83625300558,83625300565,7,2899,949,-40
83626333997,83626333980,-17,1907,449,-40
83626549869,83626549875,6,1598,1207,-40
83627629158,83627629165,7,3346,1192,-40
83631553931,83631553939,8,3526,1488,-40
83632669435,83632669439,4,2496,1142,-40
83632917413,83632917427,14,326,97,-40
83633419840,83633419847,7,3113,1289,-40
83641275357,83641275362,5,3248,1423,-40
83641378290,83641378298,8,2895,1222,-40
83642457236,83642457218,-18,1048,120,-40
83643683501,83643683507,6,3012,1099,-40
83643876223,83643876204,-19,2784,1146,-40
83644323036,83644323043,7,3853,935,-40
83646425279,83646425284,5,2898,1330,-40
83647063307,83647063320,13,776,252,-40
83650263541,83650263546,5,3011,1091,-40
83663115700,83663115702,2,1246,1012,-40
83663786172,83663786187,15,1407,218,-40
83665845410,83665845414,4,3089,48991,-40
83672129249,83672129257,8,3280,1340,-40
83674840926,83674840945,19,1148,2558,-40
83674980536,83674980542,6,2447,1105,-40
83677894402,83677894409,7,3271,1086,-40
83678262558,83678262544,-14,1878,631,-40
83681017589,83681017595,6,3372,1599,-40
83692546793,83692546798,5,2246,1283,-40
83692902006,83692902001,-5,1122,2886,-40
83697403170,83697403178,8,2024,1462,-40
83702880914,83702880921,7,3850,1087,-40
83703052929,83703052934,5,4469,1162,-40
83706232541,83706232547,6,3166,1014,-40
83708633654,83708633658,4,2230,820,-40
83717232324,83717232330,6,2536,974,-40
83719784909,83719784914,5,2713,903,-40
83724970734,83724970741,7,2333,1179,-40
83725045870,83725045875,5,2434,1388,-40
83729979405,83729979411,6,3157,1040,-40
83730276583,83730276588,5,2837,1262,-40
83733599535,83733599538,3,3597,2571,-40
83734065788,83734065794,6,4148,1454,-40
83734186966,83734186973,7,3827,1670,-40
83734696932,83734696937,5,3103,1392,-40
83735860086,83735860093,7,2530,1291,-40
83737095460,83737095466,6,2310,943,-40
83749664717,83749664723,6,2390,852,-40
83754928163,83754928171,8,2763,1265,-40
83756524839,83756524846,7,2427,1118,-40
83756563169,83756563175,6,2728,1096,-40
83756629679,83756629686,7,3402,1126,-40
83756766777,83756766782,5,2134,1186,-40
83759725885,83759725889,4,2281,888,-40
83760410541,83760410546,5,3009,1181,-40
83761732297,83761732301,4,3855,1404,-40
83761873069,83761873076,7,2900,1318,-40
83763909300,83763909306,6,1958,1262,-40
83764363910,83764363889,-21,2732,934,-40
83767812886,83767812892,6,3525,1732,-40
83771689274,83771689282,8,4831,2449,-40
83772379986,83772379992,6,1569,905,-40
83774102013,83774102019,6,3743,1257,-40
83774824432,83774824439,7,2678,1501,-40
83776838969,83776838973,4,2571,1293,-40
83780336706,83780336713,7,3782,1519,-40
83782815871,83782815878,7,2480,1020,-40
83784626097,83784626103,6,3012,1097,-40
83787002137,83787002142,5,2713,1240,-40
83787350884,83787350890,6,3098,1131,-40
83795489865,83795489869,4,1993,1016,-40
83796456029,83796456034,5,3736,1283,-40
83798104313,83798104335,22,2193,1257,-40
83798163497,83798163489,-8,992,347,-40
83800491126,83800491130,4,2452,1277,-40
83805347075,83805347081,6,2265,1418,-40
83806896702,83806896706,4,1635,1336,-40
83807430150,83807430153,3,646,97,-40
83809052703,83809052710,7,2807,1431,-40
83811697310,83811697314,4,2926,1056,-40
83815105575,83815105579,4,2409,948,-40
83815363414,83815363423,9,1664,1023,-40
83817054810,83817054814,4,2163,1308,-40
83817433519,83817433508,-11,1243,584,-40
83818980546,83818980554,8,3571,1433,-40
83819144583,83819144593,10,583,379,-40
83822544418,83822544423,5,2958,1517,-40
83822738279,83822738286,7,12446,33574,-40
83824426152,83824426158,6,2613,1201,-40
83824954530,83824954535,5,3423,1777,-40
83839757977,83839757982,5,2987,1705,-40
83842849182,83842849181,-1,1104,1987,-40
83843793884,83843793890,6,3106,1189,-40
83848579134,83848579139,5,2367,1111,-40
83848824638,83848824643,5,1917,855,-40
83852222123,83852222130,7,1759,901,-40
83855777614,83855777620,6,2683,937,-40
83857597085,83857597090,5,1313,875,-40
83861003263,83861003263,0,1354,1274,-40
83872078905,83872078907,2,3032,2718,-40
83873546242,83873546248,6,2388,1448,-40
83875716785,83875716788,3,1579,1094,-40
83876403558,83876403564,6,1530,1704,-40
83877954786,83877954791,5,3961,1238,-40
83880256476,83880256483,7,5110,1525,-40
83881401995,83881402002,7,3080,1058,-40
83885056929,83885056916,-13,1265,433,-40
83891458973,83891458981,8,1962,1083,-40
83893362978,83893362984,6,2695,1550,-40
83896577572,83896577577,5,3447,1416,-40
83898254255,83898254255,0,700,1230,-40
83906627625,83906627631,6,3286,1344,-40
83908035114,83908035118,4,1690,1035,-40
83908752710,83908752717,7,2776,1403,-40
83908976846,83908976853,7,2586,1622,-40
83913813757,83913813737,-20,1656,1030,-40
83922120558,83922120564,6,3023,1591,-40
83922466782,83922466790,8,1604,818,-40
83926603873,83926603866,-7,2288,7275,-40
83926958330,83926958335,5,2809,1301,-40
83927761055,83927761064,9,2803,1117,-40
83931694845,83931694850,5,2721,1566,-40
83931753170,83931753177,7,968,512,-40
83934057182,83934057190,8,3515,1284,-40
83935979674,83935979681,7,2966,1338,-40
83937006362,83937006362,0,631,980,-40
83938837826,83938837831,5,2334,1176,-40
83939543118,83939543125,7,2473,1559,-40
83941482676,83941482682,6,2907,1062,-40
83944472525,83944472532,7,3582,1385,-40
83946380075,83946380072,-3,1985,6037,-40
83949318128,83949318134,6,3191,1587,-40
83950985121,83950985127,6,3451,1023,-40
83953864349,83953864356,7,2236,1232,-40
83955444063,83955444069,6,3969,1878,-40
83955866861,83955866868,7,3570,1474,-40
83958584891,83958584886,-5,1950,4242,-40
83969274855,83969274863,8,5419,1009,-40
83975850177,83975850186,9,2961,1238,-40
83978306726,83978306731,5,2882,1287,-40
83978564188,83978564193,5,3339,2009,-40
83982779161,83982779162,1,1717,1305,-40
83987743069,83987743074,5,3877,1519,-40
83990185620,83990185625,5,2723,1494,-40
83991065253,83991065258,5,2825,1568,-40
83994604998,83994605006,8,2389,1187,-40
83996954966,83996954973,7,3081,1289,-40
83997050239,83997050244,5,3173,1837,-40
84000047174,84000047181,7,3334,1900,-40
84000297965,84000297970,5,3635,1475,-40
84000391218,84000391223,5,4307,1406,-40
84008780120,84008780127,7,4632,1335,-40
84012793162,84012793170,8,4174,1406,-40
84015140507,84015140511,4,7647,20420,-40
84015891645,84015891650,5,3062,1241,-40
84016259459,84016259449,-10,1357,387,-40
84017121958,84017121964,6,4394,1699,-40
84018422559,84018422565,6,3055,1551,-40
84034596553,84034596550,-3,921,2281,-40
84044053727,84044053733,6,2599,1104,-40
84047274691,84047274699,8,2836,1263,-40
84048382591,84048382598,7,3330,1176,-40
84048513143,84048513131,-12,2287,1082,-40
84050789953,84050789958,5,2076,1391,-40
84051158577,84051158583,6,2169,810,-40
84052038881,84052038888,7,1928,989,-40
84054708715,84054708720,5,3512,1512,-40
84056652590,84056652598,8,2936,1345,-40
84058195441,84058195445,4,2562,1145,-40
84058649197,84058649202,5,2318,1099,-40
84063237796,84063237803,7,3998,1187,-40
84065900329,84065900333,4,2393,2060,-40
84068965442,84068965462,20,1103,3540,-40
84070413814,84070413822,8,3446,1725,-40
84079499799,84079499806,7,2489,1207,-40
84080607403,84080607398,-5,967,2673,-40
84080711070,84080711065,-5,1879,5774,-40
84080808421,84080808417,-4,912,3049,-40
84082983734,84082983741,7,2566,918,-40
84085569725,84085569734,9,3104,1140,-40
84087884690,84087884696,6,2640,2249,-40
84088602561,84088602566,5,2805,1075,-40
84091096493,84091096493,0,1792,2877,-40
84093357373,84093357378,5,2454,1383,-40
84095528425,84095528430,5,2471,1198,-40
84095724454,84095724434,-20,1319,830,-40
84096034606,84096034610,4,1535,1201,-40
84096787064,84096787070,6,2487,1102,-40
84100347492,84100347498,6,2231,1386,-40
84101184513,84101184518,5,2130,1422,-40
84103760573,84103760579,6,2251,1186,-40
84104682195,84104682202,7,3162,1295,-40
84105638477,84105638483,6,1432,523,-40
84106630724,84106630738,14,3727,1300,-40
84108824634,84108824651,17,1814,1075,-40
84111063969,84111063974,5,2487,1466,-40
84113784670,84113784678,8,2660,1180,-40
84114146734,84114146716,-18,2784,1047,-40
84116859044,84116859050,6,3002,1569,-40
84117289152,84117289160,8,2837,1287,-40
84118018886,84118018894,8,2573,1426,-40
84118423673,84118423677,4,2315,1054,-40
84123045462,84123045470,8,3114,964,-40
84123115767,84123115772,5,1862,1148,-40
84125279061,84125279070,9,3194,984,-40
84126206352,84126206354,2,1061,209,-40
84132576981,84132576987,6,1289,810,-40
84135467652,84135467659,7,3189,1069,-40
84140618478,84140618485,7,3263,1337,-40
84143086481,84143086478,-3,1503,1855,-40
84144647176,84144647191,15,12857,50492,-40
84145614885,84145614887,2,1962,1509,-40
84150240999,84150241004,5,2476,1473,-40
84151522137,84151522142,5,3588,2269,-40
84153433993,84153433998,5,2782,1506,-40
84164193174,84164193173,-1,1367,2460,-40
84165766438,84165766448,10,3320,1576,-40
84168105181,84168105186,5,2613,1170,-40
84168528450,84168528454,4,2148,1623,-40
84169266414,84169266420,6,3104,1587,-40
84169475875,84169475880,5,2799,1582,-40
84170673949,84170673957,8,2947,1055,-40
84175553631,84175553638,7,3820,1793,-40
84177063750,84177063728,-22,1883,2138,-40
84177789886,84177789892,6,3783,1055,-40
84177997510,84177997515,5,3048,1281,-40
84178894203,84178894209,6,2843,1305,-40
84179468070,84179468074,4,2390,1114,-40
84182693952,84182693956,4,4782,2671,-40
84188682573,84188682580,7,2413,1275,-40
84191380124,84191380129,5,2647,1305,-40
84195949173,84195949179,6,1641,1017,-40
84196729955,84196729961,6,1804,678,-40
84198554369,84198554373,4,2533,1499,-40
84203769614,84203769622,8,3454,1853,-40
84206070486,84206070492,6,3057,1411,-40
84208513877,84208513882,5,2844,1533,-40
84209267558,84209267558,0,1244,1852,-40
84210973270,84210973269,-1,7148,15470,-40
84213410963,84213410970,7,3776,1597,-40
84213952673,84213952678,5,2793,944,-40
84214765597,84214765603,6,2136,755,-40
84216662190,84216662197,7,806,489,-40
84217334889,84217334891,2,1113,182,-40
84218345920,84218345925,5,2342,1414,-40
84220317989,84220317995,6,2061,885,-40
84223438018,84223438022,4,3937,2000,-40
84225027905,84225027912,7,3261,1287,-40
84226556526,84226556534,8,2665,1788,-40
84227871069,84227871075,6,3757,1224,-40
84228133657,84228133663,6,2723,1363,-40
84230628469,84230628469,0,2251,2429,-40
84231685805,84231685813,8,4426,1570,-40
84236903565,84236903571,6,4329,1763,-40
84240948334,84240948340,6,3107,2062,-40
84244140637,84244140642,5,4109,1121,-40
84245205105,84245205110,5,3100,1116,-40
84246718815,84246718822,7,2134,1121,-40
84255566638,84255566643,5,2386,1624,-40
84260460130,84260460128,-2,1194,2234,-40
84260870890,84260870895,5,3367,1317,-40
84266673891,84266673897,6,3195,883,-40
84268918993,84268918999,6,2373,1091,-40
84271878605,84271878611,6,4273,1710,-40
84276109570,84276109578,8,2778,1541,-40
84278584658,84278584665,7,2635,851,-40
84279259163,84279259171,8,2686,1376,-40
84280223601,84280223608,7,2942,1642,-40
84280981150,84280981158,8,2513,920,-40
84281707354,84281707368,14,1126,305,-40
84282118963,84282118971,8,2726,1585,-40
84285548155,84285548162,7,2845,1171,-40
84286307047,84286307053,6,3439,1229,-40
84287596839,84287596846,7,3140,1413,-40
84291346957,84291346963,6,2501,960,-40
84292079098,84292079105,7,3245,1173,-40
84294782125,84294782132,7,3524,1221,-40
84299183730,84299183736,6,3018,963,-40
84299852937,84299852944,7,3286,1114,-40
84300924744,84300924752,8,17289,16274,-40
84302541618,84302541626,8,4075,1347,-40
84305009595,84305009600,5,2206,914,-40
84308810020,84308810026,6,2251,745,-40
84316196150,84316196155,5,3291,1521,-40
84317066935,84317066941,6,2878,1158,-40
84318445875,84318445856,-19,1041,543,-40
84319456231,84319456238,7,2330,1004,-40
84321115154,84321115136,-18,761,300,-40
84323527434,84323527439,5,3485,1473,-40
84323914870,84323914876,6,3353,1271,-40
84325173459,84325173465,6,2354,1212,-40
84330586891,84330586898,7,3573,1178,-40
84330667030,84330667033,3,759,112,-40
84343629386,84343629393,7,3352,1162,-40
84344670875,84344670879,4,2001,1343,-40
84346180230,84346180225,-5,1159,3795,-40
84354297061,84354297062,1,4205,4562,-40
84365778246,84365778252,6,3145,1207,-40
84371053397,84371053403,6,3545,1395,-40
84371443721,84371443726,5,1163,567,-40
84372976859,84372976866,7,3001,1479,-40
84373458630,84373458619,-11,703,251,-40
84377968127,84377968134,7,2205,1014,-40
84382568179,84382568186,7,2729,1259,-40
84383557518,84383557525,7,3396,1116,-40
84384018733,84384018739,6,2173,1068,-40
84384216534,84384216535,1,1749,1178,-40
84385321179,84385321186,7,2647,1756,-40
84385452040,84385452047,7,3448,1449,-40
84386895082,84386895089,7,4220,2078,-40
84387655577,84387655582,5,2912,1453,-40
84388256841,84388256847,6,3004,872,-40
84388900157,84388900162,5,2905,1086,-40
84389634599,84389634604,5,2047,1095,-40
84391931565,84391931573,8,2604,1114,-40
84392312862,84392312863,1,914,1237,-40
84398009510,84398009518,8,3822,1134,-40
84400494747,84400494754,7,2900,1159,-40
84400787491,84400787480,-11,1440,250,-40
84402832193,84402832198,5,3205,1610,-40
84407922482,84407922487,5,3286,1351,-40
84408029167,84408029160,-7,895,123,-40
84409337021,84409337027,6,3257,1251,-40
84409860444,84409860450,6,2997,903,-40
84410379425,84410379431,6,2389,1177,-40
84410423541,84410423561,20,783,282,-40
84413363480,84413363468,-12,3691,1273,-40
84413869248,84413869254,6,3158,1339,-40
84414121313,84414121318,5,2615,1435,-40
84416229521,84416229527,6,2530,1490,-40
84416849919,84416849926,7,2585,1147,-40
84420316728,84420316721,-7,1250,8433,-40
84426494163,84426494171,8,2989,1442,-40
84429986110,84429986114,4,2675,1212,-40
84430378543,84430378536,-7,1158,339,-40
84435760630,84435760634,4,1189,885,-40
84436718222,84436718227,5,2659,1152,-40
84436746087,84436746094,7,2259,868,-40
84437229926,84437229906,-20,2670,989,-40
84439088355,84439088362,7,2610,1354,-40
84439657642,84439657646,4,2358,1399,-40
84448516450,84448516458,8,3364,1462,-40
84448554795,84448554802,7,2763,1133,-40
84451007864,84451007872,8,1563,882,-40
84451502770,84451502777,7,2646,1529,-40
84457984786,84457984793,7,2674,898,-40
84460716049,84460716055,6,2898,1146,-40
84461695213,84461695218,5,2922,1195,-40
84468472977,84468472970,-7,2140,11433,-40
84470375209,84470375214,5,3613,1517,-40
84470439095,84470439076,-19,1907,1123,-40
84471667190,84471667195,5,3785,1478,-40
84472819616,84472819622,6,4273,1638,-40
84476077851,84476077858,7,2465,1520,-40
84477923209,84477923214,5,2735,1079,-40
84478866330,84478866334,4,2327,1728,-40
84480390802,84480390806,4,2416,1518,-40
84480517029,84480517035,6,1932,936,-40
84484076514,84484076517,3,1145,853,-40
84484707398,84484707405,7,3112,1544,-40
84487368413,84487368419,6,3247,1171,-40
84489826424,84489826430,6,3362,1331,-40
84492973433,84492973442,9,2135,1007,-40
84493972197,84493972203,6,2960,1352,-40
84495892082,84495892088,6,3152,1264,-40
84502625048,84502625057,9,3204,1268,-40
84504994713,84504994719,6,2595,1497,-40
84505533684,84505533691,7,4330,967,-40
84509569909,84509569913,4,1243,1003,-40
84511583648,84511583654,6,1847,541,-40
84511878874,84511878880,6,3743,860,-40
84511998974,84511998953,-21,957,323,-40
84514689831,84514689837,6,2573,2073,-40
84515213770,84515213776,6,3643,1201,-40
84515440321,84515440326,5,3138,1320,-40
84516645073,84516645079,6,2823,976,-40
84526679814,84526679817,3,1560,1229,-40
84526847353,84526847359,6,3504,1625,-40
84529299169,84529299174,5,1586,875,-40
84530644551,84530644559,8,3028,1004,-40
84532377442,84532377446,4,2165,1474,-40
84533650057,84533650061,4,2775,1148,-40
84534257723,84534257729,6,1899,986,-40
84535123259,84535123258,-1,705,1491,-40
84535438281,84535438286,5,2561,1401,-40
84538135188,84538135194,6,3135,1542,-40
84539046955,84539046961,6,2116,1056,-40
84540062888,84540062895,7,2962,1117,-40
84543477889,84543477894,5,2146,1066,-40
84543573253,84543573259,6,2324,1019,-40
84545753148,84545753154,6,2613,1122,-40
84546963633,84546963639,6,2740,1223,-40
84550065928,84550065934,6,3447,1367,-40
84550509447,84550509425,-22,2499,1027,-40
84551924230,84551924236,6,3080,1441,-40
84552314726,84552314731,5,3084,1631,-40
84556931598,84556931603,5,2182,1430,-40
84558091951,84558091958,7,3907,1625,-40
84558193673,84558193679,6,2835,1060,-40
84562566081,84562566085,4,2822,1705,-40
84564975230,84564975237,7,1971,716,-40
84574504498,84574504504,6,3688,1837,-40
84579876676,84579876682,6,2007,905,-40
84580479582,84580479590,8,2861,1203,-40
84580535470,84580535480,10,896,92,-40
84587882344,84587882350,6,3723,1356,-40
84591563137,84591563142,5,2603,1266,-40
84592396889,84592396895,6,2346,1249,-40
84595046771,84595046779,8,4432,1317,-40
84601623314,84601623319,5,2321,947,-40
84601943415,84601943403,-12,1953,896,-40
84605829187,84605829190,3,1539,1011,-40
84607660565,84607660565,0,2775,3318,-40
84609563246,84609563251,5,2451,1496,-40
84611722683,84611722689,6,2915,1198,-40
84619238417,84619238423,6,2694,1056,-40
84621443676,84621443682,6,2274,1706,-40
84624599006,84624599010,4,2733,1209,-40
84626146421,84626146427,6,3534,2002,-40
84627748777,84627748785,8,3710,1440,-40
84629776166,84629776171,5,3255,2072,-40
84631128715,84631128722,7,3531,1479,-40
84631528538,84631528543,5,2127,1461,-40
84631772975,84631772981,6,2294,1191,-40
84633614738,84633614743,5,2981,1710,-40
84635892287,84635892292,5,2531,804,-40
84637684841,84637684848,7,2575,1698,-40
84638498714,84638498714,0,427,721,-40
84639132344,84639132351,7,8745,3142,-40
84639351092,84639351098,6,2431,1024,-40
84640793551,84640793558,7,4007,1590,-40
84642288846,84642288852,6,3144,1512,-40
84642976118,84642976139,21,2668,1186,-40
84646236153,84646236158,5,1835,591,-40
84649516154,84649516157,3,1912,915,-40
84650741959,84650741965,6,2489,1162,-40
84652202302,84652202307,5,3500,1699,-40
84653338489,84653338494,5,3656,1207,-40
84659100282,84659100281,-1,24076,19568,-40
84661035414,84661035420,6,1933,953,-40
84662226948,84662226955,7,2097,1202,-40
84665815082,84665815087,5,2173,1242,-40
84669816617,84669816623,6,3276,1336,-40
84669880166,84669880145,-21,1147,548,-40
84671959618,84671959625,7,3278,1253,-40
84679283024,84679283031,7,4579,1631,-40
84679389740,84679389745,5,1234,760,-40
84680991610,84680991600,-10,650,164,-40
84681940819,84681940826,7,2656,1263,-40
84683272277,84683272281,4,2317,1197,-40
84688724265,84688724269,4,2155,1562,-40
84691438575,84691438582,7,2097,912,-40
84691552372,84691552377,5,2537,1259,-40
84693158365,84693158372,7,2114,1018,-40
84704951118,84704951127,9,2351,1291,-40
84705652801,84705652809,8,4384,1184,-40
84705719274,84705719264,-10,1022,247,-40
84706986625,84706986630,5,3578,1318,-40
84709632515,84709632522,7,3806,1275,-40
84710714202,84710714206,4,2260,898,-40
84713287362,84713287366,4,2580,1188,-40
84714245044,84714245048,4,2514,1240,-40
84715468313,84715468320,7,2759,1196,-40
84716834858,84716834862,4,1796,1575,-40
84716911997,84716911994,-3,1040,2208,-40
84720409490,84720409495,5,1847,1415,-40
84722414253,84722414259,6,2928,1247,-40
84724066061,84724066067,6,3363,2180,-40
84724529961,84724529964,3,2108,1789,-40
84726082821,84726082829,8,1414,868,-40
84733377966,84733377974,8,3228,1407,-40
84741438988,84741438993,5,2138,1670,-40
84744737926,84744737934,8,4143,1454,-40
84746706944,84746706950,6,1969,1174,-40
84747297357,84747297363,6,2192,867,-40
84748076246,84748076234,-12,1583,498,-40
84748555591,84748555598,7,2805,1318,-40
84751425710,84751425709,-1,1057,2263,-40
84754232260,84754232254,-6,1123,3507,-40
84754970777,84754970782,5,2219,1036,-40
84755940441,84755940443,2,38825,21292,-40
84759725890,84759725898,8,2382,1158,-40
84761670179,84761670186,7,1205,512,-40
84762027701,84762027714,13,3062,1409,-40
84769656704,84769656713,9,3724,1679,-40
84774037168,84774037169,1,3347,3818,-40
84786997625,84786997630,5,2220,1219,-40
84795158152,84795158159,7,2521,1092,-40
84799757572,84799757579,7,2309,920,-40
84803162282,84803162277,-5,1174,3609,-40
84804885274,84804885280,6,2853,1023,-40
84808107005,84808107010,5,1956,1131,-40
84810994954,84810994960,6,2656,973,-40
84813797942,84813797950,8,2433,1337,-40
84816537528,84816537533,5,3227,1179,-40
84819465298,84819465305,7,3963,1464,-40
84820246322,84820246329,7,3073,930,-40
84824664874,84824664871,-3,921,2215,-40
84827439801,84827439807,6,2455,1168,-40
84830714876,84830714879,3,1610,1682,-40
84831104999,84831104995,-4,792,2226,-40
84832414645,84832414651,6,2419,1174,-40
84834985732,84834985737,5,2219,921,-40
84841384489,84841384485,-4,1433,2708,-40
84844112906,84844112911,5,2477,1094,-40
84844810517,84844810522,5,3850,991,-40
84847219069,84847219075,6,1982,1176,-40
84855086305,84855086311,6,3167,1269,-40
84856359599,84856359606,7,1919,1524,-40
84857613647,84857613643,-4,1077,2488,-40
84871590309,84871590315,6,3730,1317,-40
84872339222,84872339223,1,43711,47554,-40
84879054096,84879054102,6,2755,1001,-40
84881767137,84881767143,6,2915,1111,-40
84888130209,84888130217,8,2758,1307,-40
84890222111,84890222118,7,3711,1665,-40
84890474293,84890474298,5,3643,1692,-40
84891649113,84891649119,6,3618,1304,-40
84892752368,84892752375,7,2634,1002,-40
84892951563,84892951558,-5,1631,2052,-40
84896042298,84896042306,8,1509,983,-40
84900434962,84900434967,5,1563,1047,-40
84900796501,84900796506,5,1700,1141,-40
84902086604,84902086609,5,2995,1209,-40
84904202509,84904202514,5,2018,1154,-40
84905605747,84905605753,6,2162,1233,-40
84905881914,84905881921,7,2616,1120,-40
84908405098,84908405104,6,1955,929,-40
84910203822,84910203829,7,3424,1388,-40
84910684167,84910684173,6,909,616,-40
84914585118,84914585122,4,2762,1320,-40
84915212262,84915212267,5,3212,1670,-40
84917715838,84917715845,7,3901,1574,-40
84924355429,84924355435,6,3326,1031,-40
84924525433,84924525425,-8,1256,316,-40
84925672762,84925672769,7,2049,1102,-40
84929639399,84929639403,4,2247,1081,-40
84930055046,84930055058,12,3062,1570,-40
84932148489,84932148495,6,3353,1311,-40
84939257508,84939257515,7,3183,988,-40
84940116348,84940116354,6,3876,1980,-40
84943361301,84943361306,5,1990,1299,-40
84950911817,84950911823,6,1724,1277,-40
84951956118,84951956124,6,3488,1988,-40
84953761965,84953761954,-11,491,177,-40
84959135919,84959135926,7,2748,1319,-40
84960868453,84960868458,5,1708,1117,-40
84961635561,84961635567,6,2897,1245,-40
84970990990,84970990994,4,1884,1365,-40
84975515935,84975515941,6,2951,1539,-40
84978279060,84978279065,5,3092,1274,-40
84978525341,84978525342,1,1688,1517,-40
84982671438,84982671442,4,2339,1318,-40
84983542195,84983542200,5,2347,1435,-40
84986107935,84986107940,5,3153,1329,-40
84988493772,84988493778,6,2125,1666,-40
84990374647,84990374633,-14,2932,1113,-40
84990767529,84990767536,7,5319,1505,-40
84992541689,84992541695,6,1704,517,-40
84993397450,84993397447,-3,1310,3802,-40
84993899137,84993899143,6,3151,1298,-40
84995075133,84995075139,6,2661,641,-40
84996531334,84996531341,7,2806,1481,-40
84997517826,84997517833,7,3431,1742,-40
84997756990,84997756995,5,2017,799,-40
84999107376,84999107382,6,3910,1526,-40
84999530446,84999530454,8,3465,1388,-40
85000446854,85000446860,6,3281,1673,-40
85014610412,85014610418,6,2225,905,-40
85015940997,85015941003,6,1102,468,-40
85019553659,85019553666,7,2568,1123,-40
85019740258,85019740264,6,3200,1256,-40
85020651759,85020651767,8,1595,1050,-40
85024211975,85024211982,7,3532,1245,-40
85031162109,85031162115,6,2377,1866,-40
85032137007,85032137017,10,3008,1157,-40
85039052661,85039052668,7,4689,681,-40
85039649829,85039649837,8,3117,1067,-40
85039945969,85039945970,1,884,129,-40
85049007502,85049007506,4,52,686,-40
85052014883,85052014891,8,2700,1377,-40
85052196262,85052196258,-4,1184,3358,-40
85053878903,85053878907,4,2009,1057,-40
85054459922,85054459930,8,2066,1057,-40
85054699343,85054699328,-15,3264,1144,-40
85055033996,85055034002,6,3150,1324,-40
85055694987,85055694995,8,2854,1701,-40
85056625658,85056625662,4,2355,1357,-40
85056937654,85056937633,-21,1767,537,-40
85057441070,85057441078,8,1858,1240,-40
85058174379,85058174385,6,3189,1973,-40
85058532240,85058532247,7,4378,1536,-40
85062086613,85062086621,8,3327,1168,-40
85062788789,85062788797,8,4863,1722,-40
85065085833,85065085837,4,1691,1747,-40
85065288615,85065288622,7,2640,1212,-40
85066832877,85066832883,6,2315,1341,-40
85066964858,85066964857,-1,319,319,-40
85068473906,85068473913,7,2619,1117,-40
85073110365,85073110369,4,2047,1068,-40
85077236391,85077236398,7,2461,1061,-40
85083549703,85083549710,7,1956,974,-40
85093572665,85093572670,5,4029,1773,-40
85097799594,85097799588,-6,1887,7702,-40
85099912793,85099912797,4,3204,2313,-40
85103968061,85103968066,5,2420,846,-40
85107341056,85107341050,-6,1663,7444,-40
85111842965,85111842971,6,2363,1366,-40
85117577645,85117577647,2,1108,1417,-40
85117938675,85117938680,5,2272,2439,-40
85120167221,85120167226,5,1496,920,-40
85121114044,85121114050,6,2753,1026,-40
85121544139,85121544145,6,2557,1096,-40
85122872916,85122872922,6,3046,1185,-40
85123455090,85123455096,6,2422,1086,-40
85124577276,85124577282,6,3177,1019,-40
85127275096,85127275102,6,3882,1198,-40
85131593776,85131593781,5,1661,961,-40
85132435324,85132435330,6,2430,1038,-40
85132928163,85132928170,7,2824,1295,-40
85139312142,85139312136,-6,1509,7247,-40
85149308902,85149308901,-1,987,1860,-40
85151500132,85151500138,6,3534,1323,-40
85155032978,85155032984,6,2830,1153,-40
85157354186,85157354188,2,2317,1849,-40
85159276954,85159276955,1,1246,2015,-40
85159590021,85159590023,2,1616,1422,-40
85162269019,85162269026,7,2735,1278,-40
85162708177,85162708182,5,3649,965,-40
85164634399,85164634405,6,2688,1437,-40
85169836333,85169836338,5,1773,1683,-40
85170946040,85170946047,7,2081,802,-40
85171361383,85171361361,-22,3368,1186,-40
85174094747,85174094744,-3,1223,3525,-40
85185802204,85185802210,6,2407,1367,-40
85189851300,85189851306,6,3347,1171,-40
85189879523,85189879506,-17,766,416,-40
85191467615,85191467617,2,12520,12574,-40
85192919597,85192919602,5,3676,1505,-40
85193118938,85193118936,-2,38110,22987,-40
85193244301,85193244307,6,1537,967,-40
85207592228,85207592235,7,2802,1592,-40
85209782923,85209782929,6,2646,1242,-40
85214151986,85214151993,7,1919,1414,-40
85215380960,85215380967,7,2890,1485,-40
85223071489,85223071495,6,1964,663,-40
85224086973,85224086971,-2,1093,2405,-40
85232794195,85232794190,-5,2161,7863,-40
85233314177,85233314183,6,3175,1828,-40
85234478489,85234478494,5,2902,1259,-40
85240092313,85240092318,5,3256,1165,-40
85241159778,85241159784,6,3451,1177,-40
85241256863,85241256871,8,2368,1224,-40
85249926945,85249926951,6,2311,1229,-40
85254674942,85254674947,5,2222,895,-40
85254753813,85254753818,5,3796,1587,-40
85256503473,85256503481,8,3230,1404,-40
85259964407,85259964413,6,2632,1137,-40
85267880482,85267880489,7,12710,31878,-40
85270889200,85270889206,6,3350,1406,-40
85271506505,85271506513,8,4199,1286,-40
85272267907,85272267913,6,3522,866,-40
85273412016,85273412011,-5,1340,3623,-40
85275288721,85275288725,4,2192,1616,-40
85279162813,85279162818,5,2299,1235,-40
85280702541,85280702547,6,2166,1077,-40
85282360005,85282359999,-6,1843,7999,-40
85283990273,85283990279,6,2759,1047,-40
85285198082,85285198073,-9,879,129,-40
85290045522,85290045529,7,3438,1064,-40
85309103460,85309103465,5,2426,923,-40
85310251285,85310251290,5,3283,1348,-40
85315159750,85315159758,8,2406,974,-40
85315641790,85315641795,5,841,296,-40
85317482553,85317482561,8,2613,1056,-40
85318170829,85318170835,6,3495,2171,-40
85321319365,85321319371,6,2828,1527,-40
85322154909,85322154914,5,2968,1228,-40
85327265026,85327265033,7,2053,844,-40
85327488652,85327488647,-5,2669,47609,-40
85328899382,85328899389,7,3429,1234,-40
85332892345,85332892350,5,2493,1030,-40
85333967250,85333967234,-16,1370,347,-40
85337472888,85337472891,3,1469,938,-40
85347175710,85347175716,6,2657,2020,-40
85352266889,85352266894,5,2534,942,-40
85354577400,85354577406,6,2431,1411,-40
85355712954,85355712960,6,4061,1397,-40
85356756465,85356756472,7,2636,1333,-40
85357719543,85357719551,8,1579,641,-40
85358333862,85358333869,7,2810,1081,-40
85363433429,85363433434,5,3042,1560,-40
85364955484,85364955491,7,3173,973,-40
85366212193,85366212185,-8,1586,8804,-40
85372116118,85372116125,7,2776,1463,-40
85373881995,85373882003,8,1588,423,-40
85374679626,85374679631,5,2486,1386,-40
85378381430,85378381429,-1,894,1300,-40
85379894113,85379894119,6,1913,1174,-40
85380584206,85380584188,-18,1581,365,-40
85388526158,85388526165,7,2631,1325,-40
85389695398,85389695403,5,2652,1316,-40
85395918165,85395918171,6,2704,1395,-40
85396414598,85396414610,12,883,308,-40
85398892305,85398892311,6,2479,1516,-40
85400420955,85400420962,7,3209,975,-40
85401674041,85401674048,7,2830,1562,-40
85403248977,85403248978,1,922,1258,-40
85405934494,85405934501,7,1911,1262,-40
85408697117,85408697123,6,4643,2205,-40
85409658859,85409658866,7,2606,1135,-40
85413858252,85413858251,-1,22836,45552,-40
85418267922,85418267927,5,2251,979,-40
85418398030,85418398027,-3,1529,92,-40
85418955544,85418955537,-7,1338,2554,-40
85422476405,85422476411,6,3254,992,-40
85422724902,85422724881,-21,1229,511,-40
85432015634,85432015638,4,1753,1812,-40
85433158961,85433158967,6,2973,1552,-40
85435291638,85435291644,6,3239,1468,-40
85436670422,85436670429,7,2510,1633,-40
85440600871,85440600876,5,2991,1387,-40
85440752235,85440752242,7,854,235,-40
85445802546,85445802553,7,3417,1160,-40
85447095450,85447095459,9,3197,1664,-40
85450371317,85450371321,4,3511,2314,-40
85450622978,85450622961,-17,2155,669,-40
85453638637,85453638644,7,2192,1265,-40
85454500508,85454500513,5,2750,1410,-40
85454835525,85454835533,8,11044,26106,-40
85462821263,85462821270,7,3326,1543,-40
85474576925,85474576930,5,2547,1233,-40
85477069873,85477069879,6,3192,1654,-40
85477981319,85477981299,-20,322,1854,-40
85483594438,85483594447,9,3092,1323,-40
85487720019,85487720025,6,3143,1209,-40
85487858777,85487858770,-7,1300,362,-40
85489697661,85489697658,-3,1481,4038,-40
85490447480,85490447485,5,2720,1221,-40
85493109276,85493109282,6,1912,854,-40
85499144733,85499144739,6,3139,1550,-40
85500165553,85500165559,6,2807,802,-40
85501468672,85501468678,6,3486,1361,-40
85504295769,85504295776,7,2471,1389,-40
85504988394,85504988401,7,4193,1694,-40
85506112508,85506112511,3,2208,795,-40
85511638948,85511638941,-7,1584,6724,-40
85512096468,85512096473,5,2430,1589,-40
85516602471,85516602467,-4,845,1350,-40
85520505205,85520505211,6,1830,1482,-40
85522698209,85522698214,5,2191,793,-40
85522978424,85522978408,-16,2515,1102,-40
85527158227,85527158233,6,3044,1419,-40
85535035624,85535035629,5,3317,1555,-40
85536400199,85536400205,6,2476,1054,-40
85536996311,85536996317,6,2044,858,-40
85544395846,85544395851,5,1366,548,-40
85548210043,85548210051,8,1107,643,-40
85549426145,85549426142,-3,1542,1836,-40
85550712734,85550712738,4,2909,1364,-40
85551031602,85551031606,4,2625,1722,-40
85553068679,85553068684,5,2229,1215,-40
85553301278,85553301266,-12,948,355,-40
85554749820,85554749827,7,4391,1614,-40
85555157291,85555157298,7,2823,1062,-40
85555694830,85555694828,-2,1806,1727,-40
85557055030,85557055035,5,1741,1475,-40
85557170887,85557170883,-4,908,192,-40
85559584125,85559584131,6,1862,1042,-40
85560986391,85560986397,6,3052,1357,-40
85562990561,85562990566,5,3126,1370,-40
85565427032,85565427038,6,2574,1126,-40
85567416709,85567416715,6,2091,1263,-40
85570452278,85570452281,3,2340,978,-40
85571554185,85571554190,5,2886,947,-40
85572566678,85572566681,3,2109,1845,-40
85573818297,85573818302,5,3029,1234,-40
85574675748,85574675750,2,3198,1441,-40
85575819035,85575819040,5,1324,897,-40
85576558573,85576558552,-21,3415,1271,-40
85581297558,85581297565,7,2789,1310,-40
85582625833,85582625839,6,1986,1123,-40
85584119178,85584119185,7,3029,1404,-40
85590522754,85590522759,5,2287,1265,-40
85591470142,85591470147,5,1915,1115,-40
85593087754,85593087753,-1,2032,3980,-40
85596358670,85596358675,5,2433,730,-40
85597964436,85597964441,5,2292,1179,-40
85598364190,85598364196,6,43886,22211,-40
85604281026,85604281031,5,1919,934,-40
85605101113,85605101119,6,4476,991,-40
85606024571,85606024578,7,3677,1660,-40
85606257370,85606257352,-18,881,409,-40
85607468165,85607468170,5,2679,1860,-40
85608328143,85608328149,6,2194,1284,-40
85612760934,85612760940,6,2327,1091,-40
85614400127,85614400123,-4,885,2045,-40
85627124849,85627124857,8,3205,1393,-40
85632353686,85632353691,5,3242,1074,-40
85632415533,85632415540,7,3299,1554,-40
85633917605,85633917611,6,3156,1121,-40
85634417226,85634417235,9,4533,1088,-40
85637022389,85637022394,5,4326,1995,-40
85637715369,85637715375,6,2100,1125,-40
85640888340,85640888349,9,4050,1998,-40
85644934384,85644934389,5,1685,1383,-40
85645612786,85645612793,7,3140,1605,-40
85647987334,85647987342,8,2931,1198,-40
85649641073,85649641079,6,2415,939,-40
85650416003,85650415997,-6,1694,7425,-40
85651547594,85651547601,7,2910,1220,-40
85652264845,85652264851,6,1733,1143,-40
85655371145,85655371126,-19,3261,1036,-40
85656469394,85656469399,5,3130,1428,-40
85658392638,85658392645,7,2817,1431,-40
85660553898,85660553903,5,2930,1233,-40
85664161503,85664161510,7,4031,1351,-40
85664769529,85664769533,4,1952,911,-40
85666529238,85666529244,6,2864,1255,-40
85669177576,85669177574,-2,56519,43695,-40
85670301769,85670301766,-3,2467,6389,-40
85673042427,85673042433,6,2049,1225,-40
85673143743,85673143751,8,3655,1448,-40
85673364659,85673364667,8,2271,925,-40
85674800819,85674800800,-19,3220,1777,-40
85675907204,85675907211,7,2675,903,-40
85676545828,85676545823,-5,2127,5084,-40
85692029586,85692029591,5,2704,1176,-40
85692486633,85692486639,6,3149,734,-40
85692973991,85692973995,4,1950,1020,-40
85693251743,85693251735,-8,1674,6643,-40
85700457214,85700457210,-4,989,3050,-40
85705413020,85705413027,7,3204,1023,-40
85706203346,85706203353,7,3530,1657,-40
85706437837,85706437843,6,3538,1255,-40
85708436041,85708436047,6,2839,1336,-40
85709160378,85709160383,5,2029,1003,-40
85710507407,85710507411,4,1814,1309,-40
85718130528,85718130534,6,2893,1550,-40
85720175006,85720175011,5,3330,1261,-40
85721497616,85721497621,5,2596,1009,-40
85721795587,85721795594,7,2204,1084,-40
85724385638,85724385646,8,3629,1517,-40
85725773749,85725773754,5,5843,2103,-40
85726060874,85726060880,6,2699,1054,-40
85726470738,85726470745,7,2429,1089,-40
85732107138,85732107143,5,1822,1146,-40
85733354217,85733354222,5,2948,1589,-40
85739077171,85739077177,6,3134,1574,-40
85743941931,85743941936,5,2316,1455,-40
85744170395,85744170402,7,3278,1243,-40
85744955102,85744955107,5,2961,1395,-40
85747357255,85747357263,8,2897,1122,-40
85752596732,85752596737,5,3006,1816,-40
85752956860,85752956867,7,2299,1630,-40
85755142933,85755142937,4,3222,1168,-40
85756073685,85756073691,6,2176,1187,-40
85758285576,85758285581,5,1844,934,-40
85758747388,85758747395,7,3576,1095,-40
85758971683,85758971686,3,3137,945,-40
85759340242,85759340251,9,1944,889,-40
85761627561,85761627567,6,2653,1162,-40
85761772381,85761772401,20,2183,1042,-40
85763476189,85763476197,8,3778,1286,-40
85766973773,85766973781,8,4031,1343,-40
85767618215,85767618203,-12,652,370,-40
85769522891,85769522898,7,3430,972,-40
85769811745,85769811751,6,2381,826,-40
85769848985,85769848970,-15,2736,1173,-40
85771481638,85771481619,-19,1331,2403,-40
85774008486,85774008492,6,2551,1742,-40
85778558977,85778558983,6,3888,1271,-40
85781329598,85781329598,0,1278,2134,-40
85781797406,85781797413,7,2425,666,-40
85781982446,85781982427,-19,1608,362,-40
85785343232,85785343239,7,2587,1550,-40
85786933907,85786933915,8,3509,1295,-40
85787266796,85787266801,5,2854,1617,-40
85792618048,85792618054,6,2708,1146,-40
85795416183,85795416191,8,2545,1337,-40
85799289695,85799289701,6,2566,1565,-40
85799414726,85799414734,8,2317,942,-40
85799926805,85799926811,6,3373,1377,-40
85805094320,85805094326,6,1755,478,-40
85806925849,85806925855,6,2656,1094,-40
85807038003,85807038001,-2,784,162,-40
85808643955,85808643955,0,1232,1819,-40
85810969998,85810970005,7,2387,1238,-40
85811532681,85811532687,6,2210,900,-40
85811693757,85811693762,5,2041,1762,-40
85813207482,85813207487,5,3845,1697,-40
85814510358,85814510362,4,3233,1182,-40
85816428465,85816428471,6,2859,1003,-40
85816720867,85816720857,-10,810,259,-40
85819879731,85819879721,-10,864,128,-40
85821320194,85821320199,5,1808,962,-40
85828982642,85828982647,5,2975,570,-40
85830608214,85830608220,6,3209,1353,-40
85832867169,85832867176,7,4087,1496,-40
85837130345,85837130348,3,1075,1109,-40
85840831781,85840831789,8,3136,1114,-40
85841053398,85841053378,-20,540,32,-40
85845103759,85845103767,8,3306,1377,-40
85847256593,85847256599,6,1037,707,-40
85850820261,85850820266,5,1456,885,-40
85851769792,85851769798,6,2327,1080,-40
85852570919,85852570926,7,3514,957,-40
85854193466,85854193473,7,2322,1746,-40
85865929469,85865929474,5,2436,1374,-40
85869096841,85869096847,6,2417,941,-40
85870960075,85870960081,6,2163,1155,-40
85871737549,85871737555,6,2709,1673,-40
85874646912,85874646917,5,2614,910,-40
85878772067,85878772073,6,2326,1083,-40
85885762861,85885762866,5,2318,1149,-40
85886415422,85886415430,8,3631,1436,-40
85888073062,85888073067,5,2343,1214,-40
85892177036,85892177042,6,3768,1433,-40
85893897597,85893897603,6,2477,1341,-40
85896540486,85896540492,6,2400,1474,-40
85896699247,85896699250,3,2393,1457,-40
85898462927,85898462932,5,1730,1333,-40
85899273346,85899273351,5,2559,1337,-40
85900668423,85900668428,5,1810,1608,-40
85902746415,85902746416,1,13606,15750,-40
85903013392,85903013390,-2,1440,1884,-40
85903483525,85903483532,7,1943,1295,-40
85904872030,85904872037,7,3642,1213,-40
85908714159,85908714166,7,3419,1385,-40
85910262682,85910262688,6,2360,1278,-40
85911483210,85911483217,7,2565,1260,-40
85911934550,85911934555,5,2149,615,-40
85916002219,85916002221,2,1371,1501,-40
85919050469,85919050471,2,2040,1337,-40
85920971101,85920971108,7,2860,1412,-40
85922936919,85922936927,8,2489,1239,-40
85930664751,85930664735,-16,2750,1120,-40
85931025506,85931025492,-14,1490,993,-40
85931237983,85931237991,8,2666,1233,-40
85931905944,85931905937,-7,60,1232,-40
85936279970,85936279975,5,1723,963,-40
85936354799,85936354777,-22,1041,440,-40
85943001253,85943001259,6,1606,1182,-40
85944538685,85944538693,8,2483,1147,-40
85945628488,85945628494,6,3096,1819,-40
85948606108,85948606116,8,2389,1344,-40
85949490698,85949490704,6,1933,1218,-40
85952108598,85952108605,7,2786,1111,-40
85956155750,85956155757,7,1537,1034,-40
85964874257,85964874263,6,4071,1282,-40
85965574978,85965574986,8,2720,1063,-40
85966335518,85966335523,5,3008,1279,-40
85966504519,85966504506,-13,1277,173,-40
85967799722,85967799727,5,1956,567,-40
85969654098,85969654103,5,2253,1114,-40
85972211690,85972211697,7,3507,1172,-40
85976796612,85976796619,7,3416,1304,-40
85977399662,85977399670,8,3632,1315,-40
85981586709,85981586706,-3,1352,2159,-40
85981815686,85981815693,7,2969,1333,-40
85982150218,85982150225,7,2570,853,-40
85991762744,85991762750,6,3253,1581,-40
85992572596,85992572576,-20,2298,1118,-40
85998677015,85998677022,7,3366,1038,-40
86001876254,86001876261,7,3882,1296,-40
86002334806,86002334824,18,3576,1105,-40
86003865657,86003865664,7,2756,1722,-40
86005209681,86005209665,-16,3330,1095,-40
86005636271,86005636282,11,758,389,-40
86010198445,86010198435,-10,1488,25727,-40
86017017145,86017017151,6,2974,1216,-40
86025464537,86025464542,5,2293,1121,-40
86031532787,86031532786,-1,694,67,-40
86031792558,86031792565,7,4283,1070,-40
86032087650,86032087652,2,2038,1424,-40
86036505404,86036505409,5,2756,1605,-40
86042421373,86042421380,7,2866,1337,-40
86044128605,86044128610,5,3012,1574,-40
86046281625,86046281631,6,2647,1327,-40
86050730525,86050730529,4,2912,1078,-40
86064195441,86064195446,5,3921,1625,-40
86064417151,86064417153,2,5562,16211,-40
86065336557,86065336563,6,3815,1276,-40
86070407486,86070407491,5,2762,1128,-40
86070751923,86070751912,-11,1138,127,-40
86071089586,86071089577,-9,1106,297,-40
86076988490,86076988495,5,3388,2468,-40
86081221090,86081221096,6,3708,1050,-40
86082274729,86082274734,5,2291,1661,-40
86087394286,86087394293,7,1835,1248,-40
86094474725,86094474732,7,2587,1503,-40
86095730513,86095730530,17,3147,1708,-40
86096948059,86096948065,6,3211,1074,-40
86098750222,86098750227,5,2969,1676,-40
86099544038,86099544045,7,3145,1357,-40
86099603386,86099603392,6,3342,1261,-40
86100069762,86100069767,5,3762,1631,-40
86103011490,86103011495,5,2512,976,-40
86103847974,86103847981,7,1190,805,-40
86110222835,86110222838,3,1335,1403,-40
86116199993,86116199997,4,2455,726,-40
86118987598,86118987603,5,3059,1081,-40
86125292527,86125292533,6,4070,1315,-40
86125805310,86125805315,5,1798,775,-40
86128858873,86128858878,5,2249,1722,-40
86131320754,86131320759,5,2640,1261,-40
86131764686,86131764689,3,2121,1616,-40
86133935580,86133935583,3,1847,1779,-40
86140710543,86140710539,-4,1086,3791,-40
86141048822,86141048830,8,3298,1156,-40
86142165629,86142165635,6,2023,919,-40
86142383786,86142383768,-18,2375,1073,-40
86147090743,86147090747,4,2465,1326,-40
86150147933,86150147937,4,1372,1005,-40
86152538826,86152538834,8,2779,1383,-40
86155227739,86155227746,7,1464,646,-40
86158482093,86158482099,6,2247,1363,-40
86160265791,86160265785,-6,2336,9953,-40
86161637053,86161637059,6,2784,1188,-40
86163289186,86163289191,5,2231,1059,-40
86165060865,86165060871,6,2963,1179,-40
86165439309,86165439316,7,3058,1195,-40
86168000957,86168000963,6,3421,1127,-40
86168267611,86168267617,6,2733,1646,-40
86172387334,86172387339,5,2557,1699,-40
86174792831,86174792811,-20,1108,364,-40
86175812961,86175812969,8,2006,1100,-40
86179744810,86179744818,8,253,2547,-40
86180481369,86180481375,6,3895,1818,-40
86181720585,86181720590,5,3169,1456,-40
86183878124,86183878121,-3,1819,2600,-40
86184671163,86184671169,6,3085,1016,-40
86184765814,86184765821,7,3762,1610,-40
86185309829,86185309838,9,1832,1233,-40
86188308256,86188308261,5,1935,1170,-40
86190414654,86190414659,5,2802,1133,-40
86194192197,86194192204,7,4850,2082,-40
86195999574,86195999572,-2,2848,4534,-40
86200714102,86200714108,6,2291,1051,-40
86203252953,86203252959,6,3908,1441,-40
86205645766,86205645772,6,3489,1672,-40
86209673823,86209673830,7,2768,1404,-40
86211054327,86211054333,6,2147,971,-40
86211245353,86211245348,-5,867,221,-40
86213305248,86213305255,7,2354,1156,-40
86213493714,86213493715,1,2185,2398,-40
86215237358,86215237365,7,3064,1318,-40
86217604766,86217604774,8,4344,1318,-40
86217643979,86217643962,-17,1085,204,-40
86219531773,86219531779,6,3042,1650,-40
86221457066,86221457073,7,2842,1295,-40
86224856865,86224856872,7,2413,929,-40
86227736495,86227736502,7,2314,1232,-40
86228229938,86228229938,0,1747,1234,-40
86229526902,86229526922,20,475,2599,-40
86229899243,86229899248,5,1852,1349,-40
86230473054,86230473060,6,3527,2057,-40
86236003089,86236003097,8,2038,1129,-40
86236232339,86236232323,-16,1960,821,-40
86236361852,86236361864,12,2184,886,-40
86237991647,86237991653,6,3017,1066,-40
86243851482,86243851490,8,1974,923,-40
86245716993,86245716998,5,2698,1411,-40
86246172432,86246172431,-1,1856,2300,-40
86246767907,86246767913,6,2794,1278,-40
86247751023,86247751039,16,842,155,-40
86248483038,86248483059,21,3152,1206,-40
86250085397,86250085401,4,3519,1643,-40
86254135805,86254135810,5,3452,1280,-40
86254964166,86254964170,4,727,409,-40
86255820685,86255820692,7,2639,1091,-40
86257260222,86257260232,10,484,56,-40
86265065537,86265065532,-5,882,3035,-40
86265806322,86265806327,5,2567,1033,-40
86267137054,86267137060,6,3107,1497,-40
86269802842,86269802849,7,3741,1634,-40
86273984369,86273984349,-20,1577,560,-40
86277561057,86277561064,7,4226,1699,-40
86277802317,86277802322,5,2476,1078,-40
86278150022,86278150027,5,3000,1459,-40
86280240645,86280240651,6,3778,1652,-40
86284049529,86284049534,5,2672,1282,-40
86285787478,86285787485,7,1796,1135,-40
86288909905,86288909910,5,3400,1845,-40
86291854281,86291854287,6,3728,1719,-40
86300557902,86300557910,8,2321,1167,-40
86301366589,86301366594,5,3008,1254,-40
86301919943,86301919950,7,2073,866,-40
86303736694,86303736703,9,2185,917,-40
86306936931,86306936939,8,2479,1316,-40
86309675117,86309675122,5,3327,1143,-40
86317579709,86317579714,5,3157,1463,-40
86319182700,86319182706,6,2613,1364,-40
86326073862,86326073867,5,2755,1303,-40
86329273254,86329273259,5,2085,583,-40
86330193633,86330193634,1,1468,1781,-40
86330399098,86330399082,-16,1129,4510,-40
86330706038,86330706043,5,2225,1134,-40
86336176835,86336176842,7,3175,1311,-40
86336486091,86336486096,5,1398,589,-40
86337101753,86337101760,7,3221,1686,-40
86339628552,86339628558,6,2824,1117,-40
86339909538,86339909543,5,2107,1215,-40
86341285027,86341285032,5,2558,1116,-40
86341924914,86341924923,9,4016,1380,-40
86349381022,86349381029,7,3577,1533,-40
86351568130,86351568137,7,2605,1140,-40
86352064506,86352064510,4,1975,636,-40
86353084289,86353084295,6,1457,842,-40
86354280259,86354280266,7,3231,1238,-40
86356140765,86356140771,6,3408,1576,-40
86360562857,86360562859,2,2101,1418,-40
86362261621,86362261628,7,2315,1333,-40
86367114892,86367114897,5,3363,1991,-40
86372521437,86372521443,6,2016,1101,-40
86373362355,86373362360,5,4287,2291,-40
86376118228,86376118235,7,3569,1640,-40
86380710683,86380710689,6,3479,1572,-40
86381534077,86381534083,6,2782,1332,-40
86384100050,86384100057,7,2640,1134,-40
86384514518,86384514507,-11,1236,1026,-40
86385212174,86385212189,15,16313,26148,-40
86386788382,86386788364,-18,1068,483,-40
86387396533,86387396539,6,2573,1175,-40
86402279938,86402279947,9,3214,1044,-40
86404552181,86404552186,5,2777,1107,-40
86413392622,86413392628,6,3538,1205,-40
86417324608,86417324615,7,2583,991,-40
86418329554,86418329562,8,1413,989,-40
86426030682,86426030687,5,2090,1237,-40
86427710620,86427710626,6,3349,1671,-40
86434688825,86434688831,6,2215,1606,-40
86435824150,86435824156,6,4292,1979,-40
86436695082,86436695088,6,2301,982,-40
86441440469,86441440473,4,1673,963,-40
86448111890,86448111897,7,3878,1126,-40
86449316803,86449316800,-3,1097,2847,-40
86456712929,86456712938,9,3191,1041,-40
86457555687,86457555693,6,4324,1541,-40
86463284773,86463284780,7,4727,1975,-40
86463755446,86463755451,5,2532,1241,-40
86464343108,86464343092,-16,3094,1201,-40
86465309530,86465309531,1,2280,2781,-40
86468184853,86468184862,9,2160,1134,-40
86468781302,86468781281,-21,1060,280,-40
86470675419,86470675424,5,3290,1532,-40
86474820425,86474820429,4,1787,1379,-40
86477394627,86477394634,7,3498,1503,-40
86481684110,86481684117,7,4244,1820,-40
86493881177,86493881183,6,2650,1361,-40
86494746805,86494746812,7,4493,1752,-40
86498181531,86498181530,-1,992,2707,-40
86500891810,86500891817,7,3385,1315,-40
86503306871,86503306877,6,3209,1334,-40
86504379005,86504379009,4,2543,1135,-40
86504797950,86504797954,4,2470,1166,-40
86506332645,86506332653,8,2658,1215,-40
86506560547,86506560530,-17,2202,917,-40
86506926865,86506926872,7,2583,1598,-40
86508552906,86508552914,8,2546,1562,-40
86510538784,86510538788,4,2560,1128,-40
86515080019,86515080025,6,3768,1930,-40
86516360101,86516360106,5,2904,1048,-40
86516499407,86516499426,19,2953,1598,-40
86517942553,86517942558,5,3339,1447,-40
86518285170,86518285175,5,2420,1173,-40
86521325626,86521325632,6,3116,1496,-40
86530246213,86530246220,7,2516,899,-40
86533316122,86533316129,7,3317,1542,-40
86538105042,86538105050,8,2744,1233,-40
86543086445,86543086451,6,3112,1544,-40
86546361207,86546361214,7,2684,1190,-40
86546822026,86546822034,8,3510,1453,-40
86546865818,86546865832,14,517,101,-40
86548083612,86548083596,-16,3011,1125,-40
86552629369,86552629375,6,2225,763,-40
86556007310,86556007317,7,3283,1534,-40
86558418078,86558418081,3,1988,1882,-40
86559328429,86559328435,6,2177,770,-40
86579700967,86579700973,6,2097,1166,-40
86580112060,86580112064,4,1077,106,-40
86587174927,86587174934,7,3610,1671,-40
86590891864,86590891870,6,2696,1383,-40
86592255616,86592255623,7,2226,1349,-40
86593798170,86593798175,5,3279,1858,-40
86596572447,86596572453,6,2489,1076,-40
86599585930,86599585933,3,2771,1409,-40
86603610430,86603610436,6,1566,1114,-40
86610765207,86610765206,-1,1485,2971,-40
86618277829,86618277835,6,2456,1505,-40
86621074043,86621074049,6,2918,1134,-40
86623331515,86623331522,7,3777,1474,-40
86623920027,86623920034,7,2250,1396,-40
86624512694,86624512698,4,1710,978,-40
86625383341,86625383346,5,1924,1555,-40
86625752039,86625752058,19,581,179,-40
86627126078,86627126074,-4,1817,5076,-40
86636538289,86636538294,5,2158,1646,-40
86638229900,86638229903,3,2209,1356,-40
86640345478,86640345487,9,2336,1392,-40
86642039734,86642039742,8,5521,1854,-40
86644092610,86644092615,5,2580,1206,-40
86644627098,86644627106,8,3785,1575,-40
86647434849,86647434855,6,1954,798,-40
86648324719,86648324699,-20,3621,1679,-40
86650242135,86650242143,8,2181,1089,-40
86656864325,86656864331,6,3510,1095,-40
86658671224,86658671232,8,5153,1705,-40
86661689917,86661689919,2,1907,1238,-40
86662948040,86662948046,6,2924,1096,-40
86663457826,86663457831,5,3282,1197,-40
86665382201,86665382204,3,28866,119861,-40
86666474403,86666474409,6,2645,1497,-40
86667205114,86667205117,3,1758,1386,-40
86667768357,86667768368,11,2982,1056,-40
86668519644,86668519651,7,3065,1340,-40
86672344786,86672344794,8,2905,1391,-40
86672831398,86672831396,-2,902,30,-40
86675368666,86675368673,7,2909,1295,-40
86684659314,86684659322,8,1918,1059,-40
86685456703,86685456707,4,1458,657,-40
86687575494,86687575487,-7,1506,31851,-40
86693905937,86693905943,6,2008,900,-40
86694828804,86694828810,6,2303,1404,-40
86697154309,86697154315,6,3696,1410,-40
86700078733,86700078739,6,1714,1354,-40
86701362652,86701362657,5,2105,958,-40
86706622286,86706622290,4,4556,3155,-40
86708640070,86708640077,7,3022,1198,-40
86709860624,86709860631,7,2174,1090,-40
86710093977,86710093984,7,2509,1495,-40
86713251181,86713251187,6,2951,1310,-40
86715504806,86715504813,7,1861,1258,-40
86716242744,86716242739,-5,1169,309,-40
86716610969,86716610979,10,642,400,-40
86722733799,86722733804,5,3391,1354,-40
86725083334,86725083341,7,3506,1108,-40
86725547638,86725547616,-22,819,642,-40
86728279949,86728279953,4,2161,1243,-40
86729813499,86729813506,7,2142,1491,-40
86733242429,86733242436,7,4265,1514,-40
86733295652,86733295658,6,2299,1401,-40
86734170698,86734170705,7,3179,1207,-40
86737016829,86737016834,5,1871,1304,-40
86737869266,86737869274,8,2311,1247,-40
86738105943,86738105926,-17,252,1597,-40
86750559973,86750559979,6,2771,1382,-40
86751275420,86751275426,6,2837,1005,-40
86751695434,86751695439,5,2463,751,-40
86751941333,86751941340,7,1478,994,-40
86755528170,86755528179,9,3296,1403,-40
86761885394,86761885402,8,7811,1939,-40
86762237282,86762237289,7,4646,1530,-40
86763701791,86763701797,6,2504,1146,-40
86769635546,86769635550,4,2220,1397,-40
86769777856,86769777843,-13,2073,1321,-40
86771122490,86771122497,7,3081,1119,-40
86772333414,86772333419,5,2876,894,-40
86773456672,86773456679,7,3754,1165,-40
86774847837,86774847844,7,2410,1154,-40
86777347473,86777347478,5,2503,1620,-40
86777854229,86777854235,6,3550,1010,-40
86778350529,86778350534,5,1745,1051,-40
86778433530,86778433547,17,2023,1118,-40
86780156425,86780156432,7,2879,1376,-40
86784225186,86784225191,5,2232,1463,-40
86785635570,86785635578,8,3906,1459,-40
86786157189,86786157168,-21,1822,724,-40
86787530223,86787530230,7,3881,1127,-40
86797887163,86797887170,7,2839,1364,-40
86802762253,86802762261,8,2848,1049,-40
86803910591,86803910587,-4,1254,2487,-40
86804800247,86804800254,7,4010,1249,-40
86808550838,86808550843,5,2332,1366,-40
86810666281,86810666287,6,2128,946,-40
86815223594,86815223602,8,391,1171,-40
86820894782,86820894782,0,1398,1822,-40
86821493871,86821493889,18,27595,17813,-40
86822066863,86822066861,-2,948,2431,-40
86823218580,86823218586,6,3200,1172,-40
86824726254,86824726260,6,2279,1523,-40
86831022540,86831022544,4,1000,1064,-40
86831730779,86831730786,7,2953,1392,-40
86833152744,86833152761,17,2292,1049,-40
86836438000,86836438007,7,2383,882,-40
86837121515,86837121522,7,1489,745,-40
86837153984,86837153992,8,752,24,-40
86840305374,86840305381,7,2090,1245,-40
86840617627,86840617642,15,869,191,-40
86850268830,86850268835,5,2010,1030,-40
86851468674,86851468680,6,2965,1453,-40
86851920821,86851920826,5,1549,925,-40
86852361659,86852361666,7,3420,1466,-40
86853311141,86853311147,6,3004,1393,-40
86857128090,86857128095,5,2083,973,-40
86858620286,86858620291,5,2909,1153,-40
86859773088,86859773078,-10,174,806,-40
86861514018,86861514023,5,2313,1502,-40
86861998663,86861998667,4,1903,948,-40
86863379310,86863379314,4,3225,1425,-40
86864544211,86864544217,6,3745,2117,-40
86867216258,86867216264,6,3562,1857,-40
86873680423,86873680430,7,2563,1239,-40
86874261411,86874261415,4,2420,1232,-40
86879732634,86879732638,4,3421,1209,-40
86885621930,86885621936,6,1899,1321,-40
86885862557,86885862536,-21,2782,1099,-40
86887614549,86887614556,7,1524,760,-40
86889587024,86889587029,5,2445,935,-40
86892939601,86892939607,6,2080,996,-40
86896444343,86896444350,7,3082,1237,-40
86896956213,86896956193,-20,897,291,-40
86897976578,86897976585,7,2413,1786,-40
86899501777,86899501782,5,2208,1219,-40
86901316748,86901316750,2,2768,1715,-40
86903590510,86903590519,9,3816,1769,-40
86906469374,86906469378,4,2103,1610,-40
86907030725,86907030730,5,3201,1414,-40
86907489630,86907489650,20,925,2758,-40
86912755321,86912755326,5,2829,1190,-40
86913958078,86913958081,3,1206,242,-40
86916921065,86916921071,6,3590,1586,-40
86921941389,86921941397,8,2990,1195,-40
86923187630,86923187635,5,1942,1181,-40
86927683445,86927683450,5,2603,1363,-40
86938202010,86938202014,4,1871,1114,-40
86939122606,86939122611,5,2411,812,-40
86942873335,86942873343,8,3520,1616,-40
86944155541,86944155548,7,1362,712,-40
86963553181,86963553186,5,2789,1066,-40
86963687525,86963687530,5,3611,1596,-40
86964355986,86964355993,7,2097,779,-40
86966621614,86966621621,7,70766,29751,-40
86972699232,86972699239,7,2036,1161,-40
86973690510,86973690516,6,3398,1172,-40
86975579748,86975579757,9,3991,1388,-40
86976245838,86976245826,-12,1026,197,-40
86976872697,86976872715,18,2006,1099,-40
86978683771,86978683778,7,3059,1100,-40
86988682250,86988682246,-4,1143,3189,-40
86991030039,86991030046,7,4310,1622,-40
86993043927,86993043929,2,18584,17456,-40
87002852283,87002852289,6,3026,1233,-40
87004945368,87004945374,6,1497,840,-40
87005156565,87005156546,-19,3350,1044,-40
87005897225,87005897229,4,2007,1505,-40
87006070902,87006070906,4,936,855,-40
87006813664,87006813666,2,1735,1611,-40
87009027444,87009027450,6,3126,1236,-40
87010392543,87010392557,14,1113,211,-40
87015514554,87015514557,3,2355,1440,-40
87015760073,87015760080,7,2295,1535,-40
87027076137,87027076144,7,3492,1459,-40
87028285737,87028285729,-8,721,1396,-40
87031715532,87031715538,6,3113,1415,-40
87033517062,87033517067,5,2036,1577,-40
87038066094,87038066101,7,1290,919,-40
87038367906,87038367913,7,1743,1006,-40
87044080856,87044080850,-6,1174,742,-40
87046784183,87046784190,7,2760,902,-40
87049708273,87049708282,9,3364,992,-40
87053660946,87053660950,4,2834,1802,-40
87054657342,87054657346,4,3587,1569,-40
87054788869,87054788874,5,3518,2219,-40
87056999877,87056999882,5,2500,1057,-40
87057999129,87057999131,2,1336,1190,-40
87058743127,87058743134,7,2524,1407,-40
87059014074,87059014078,4,1551,930,-40
87059477799,87059477778,-21,1117,360,-40
87061660457,87061660449,-8,986,3827,-40
87074066181,87074066189,8,3491,1332,-40
87075460714,87075460715,1,1371,1411,-40
87075558582,87075558590,8,2979,1225,-40
87077908862,87077908863,1,3073,3597,-40
87081740516,87081740521,5,2521,1773,-40
87082770573,87082770579,6,2880,1443,-40
87082825282,87082825289,7,2175,977,-40
87083091028,87083091041,13,2443,1355,-40
87084675835,87084675842,7,2492,1048,-40
87085899456,87085899463,7,3189,1227,-40
87087190301,87087190310,9,3311,1352,-40
87087415335,87087415335,0,1359,33717,-40
87091421361,87091421367,6,2500,1272,-40
87093184451,87093184458,7,3044,880,-40
87097819020,87097819026,6,3195,1031,-40
87101944166,87101944173,7,2344,964,-40
87102492890,87102492897,7,3411,1530,-40
87106532759,87106532766,7,2267,1307,-40
87115115850,87115115857,7,2841,1513,-40
87120657044,87120657050,6,3431,1708,-40
87125049376,87125049383,7,3546,1194,-40
87129807385,87129807392,7,3105,1270,-40
87131806836,87131806842,6,2788,889,-40
87132779892,87132779899,7,2473,769,-40
87135084119,87135084126,7,2542,1195,-40
87145272298,87145272305,7,3121,1028,-40
87149653862,87149653869,7,3267,1722,-40
87150435587,87150435593,6,1549,1085,-40
87151021349,87151021349,0,1483,1600,-40
87160451082,87160451086,4,1875,708,-40
87160602689,87160602694,5,3137,1221,-40
87168828699,87168828703,4,1300,1412,-40
87172343474,87172343480,6,3311,1403,-40
87173447772,87173447777,5,2811,1404,-40
87180596730,87180596735,5,4417,3701,-40
87180742935,87180742941,6,2783,872,-40
87180807742,87180807760,18,674,210,-40
87181026036,87181026043,7,2237,728,-40
87182800617,87182800622,5,2184,1167,-40
87191154587,87191154590,3,1275,715,-40
87194290666,87194290672,6,3027,1126,-40
87195002367,87195002345,-22,1472,692,-40
87199790526,87199790531,5,2679,1295,-40
87200460847,87200460843,-4,903,845,-40
87200816470,87200816452,-18,2331,1813,-40
87205302766,87205302770,4,2065,1382,-40
87206894921,87206894917,-4,1003,1951,-40
87208579622,87208579618,-4,1116,2482,-40
87217426819,87217426825,6,2232,1219,-40
87219188149,87219188154,5,7770,3080,-40
87219975083,87219975090,7,1074,447,-40
87221758168,87221758174,6,2069,994,-40
87227926003,87227926010,7,2399,1003,-40
87229631822,87229631827,5,2186,1094,-40
87230389873,87230389879,6,3638,1349,-40
87231600925,87231600930,5,2952,1714,-40
87233017210,87233017216,6,3777,1701,-40
87236934286,87236934293,7,2838,1248,-40
87243942303,87243942297,-6,1696,10517,-40
87245733361,87245733367,6,2275,1125,-40
87249482945,87249482951,6,5176,1590,-40
87251241910,87251241916,6,2571,1209,-40
87251711494,87251711499,5,3068,1172,-40
87252550378,87252550386,8,2989,1645,-40
87253410369,87253410375,6,2384,1498,-40
87255232038,87255232041,3,1778,1424,-40
87255888090,87255888093,3,1012,1661,-40
87256304246,87256304226,-20,2246,1219,-40
87256783561,87256783568,7,2760,907,-40
87267067009,87267067015,6,3019,1428,-40
87271535943,87271535949,6,3784,1504,-40
87275612786,87275612788,2,2560,1674,-40
87281661318,87281661323,5,2519,1028,-40
87285350503,87285350510,7,2635,1153,-40
87285789810,87285789815,5,2771,1766,-40
87287225872,87287225878,6,3010,1176,-40
87293145197,87293145203,6,3694,1807,-40
87294627370,87294627375,5,2177,1395,-40
87297701631,87297701639,8,2374,789,-40
87302123493,87302123499,6,2977,1215,-40
87307473982,87307473988,6,1767,1557,-40
87310495250,87310495253,3,2583,1323,-40
87311973638,87311973637,-1,1591,2903,-40
87319169811,87319169818,7,3274,1101,-40
87320424350,87320424356,6,2593,823,-40
87322107909,87322107914,5,2176,920,-40
87323457533,87323457553,20,3721,1316,-40
87326013102,87326013107,5,2254,1457,-40
87326147319,87326147326,7,3175,1759,-40
87326438673,87326438679,6,3630,1631,-40
87327977531,87327977535,4,2515,955,-40
87329343889,87329343895,6,3190,1487,-40
87332788735,87332788737,2,33206,39604,-40
87333071487,87333071494,7,3160,944,-40
87334108315,87334108315,0,21668,17114,-40
87334432530,87334432537,7,7620,2496,-40
87336419211,87336419206,-5,951,2155,-40
87336492818,87336492826,8,2628,1088,-40
87336657915,87336657923,8,2213,1382,-40
87338656070,87338656078,8,4399,1435,-40
87338804161,87338804169,8,3364,1644,-40
87343528521,87343528526,5,3481,1447,-40
87347946206,87347946214,8,2987,1434,-40
87347988294,87347988282,-12,945,189,-40
87348094323,87348094330,7,2852,1479,-40
87349254790,87349254796,6,2302,736,-40
87350770181,87350770187,6,2779,1127,-40
87352716983,87352716991,8,1469,721,-40
87353976159,87353976165,6,3501,1365,-40
87355539489,87355539495,6,2128,1171,-40
87357343346,87357343351,5,3752,1311,-40
87362049225,87362049229,4,2016,1149,-40
87363967042,87363967044,2,2114,2197,-40
87368537833,87368537838,5,2997,1313,-40
87368931542,87368931547,5,2041,1017,-40
87372446735,87372446736,1,1708,1760,-40
87372641127,87372641115,-12,843,260,-40
87376633405,87376633411,6,1033,587,-40
87377579569,87377579575,6,2701,1511,-40
87378023164,87378023156,-8,1009,344,-40
87378544689,87378544695,6,2473,1155,-40
87379972039,87379972047,8,2129,1066,-40
87380015154,87380015149,-5,570,1616,-40
87380407462,87380407468,6,3175,1698,-40
87383921276,87383921278,2,1579,1453,-40
87384684810,87384684805,-5,896,1711,-40
87387320682,87387320691,9,2121,1255,-40
87388626700,87388626698,-2,25433,45525,-40
87392929538,87392929545,7,3342,1771,-40
87394927200,87394927207,7,3050,997,-40
87402498614,87402498622,8,1843,1026,-40
87407100138,87407100144,6,2617,1350,-40
87407156576,87407156568,-8,1137,296,-40
87408738162,87408738169,7,2824,1225,-40
87411854797,87411854802,5,3197,1618,-40
87412869174,87412869181,7,2700,1128,-40
87413132046,87413132053,7,3906,1955,-40
87413557445,87413557451,6,2402,1180,-40
87413870202,87413870207,5,1755,925,-40
87416487922,87416487923,1,1924,2507,-40
87417735325,87417735330,5,3649,1033,-40
87418316885,87418316891,6,2811,1125,-40
87418695939,87418695924,-15,2447,1461,-40
87418802910,87418802913,3,2328,1251,-40
87422466285,87422466292,7,2357,845,-40
87424903379,87424903385,6,3942,1444,-40
87425094874,87425094881,7,672,111,-40
87426386774,87426386781,7,3885,1684,-40
87429226464,87429226470,6,2576,1145,-40
87432051767,87432051772,5,2695,2136,-40
87436004273,87436004279,6,3802,1252,-40
87439519063,87439519067,4,2225,2383,-40
87439737996,87439738002,6,1381,782,-40
87442391458,87442391464,6,3334,1463,-40
87446050254,87446050260,6,2639,1314,-40
87447655246,87447655253,7,2532,1609,-40
87450028857,87450028863,6,3503,1271,-40
87451185616,87451185627,11,13966,9586,-40
87454521948,87454521954,6,3104,1605,-40
87455331207,87455331209,2,1032,1440,-40
87459241642,87459241649,7,2651,1248,-40
87460039719,87460039725,6,1972,673,-40
87461335678,87461335684,6,3058,1057,-40
87463095874,87463095879,5,2480,1249,-40
87467517544,87467517551,7,3047,1164,-40
87470038433,87470038441,8,2641,634,-40
87470820959,87470820966,7,2847,1312,-40
87473377671,87473377666,-5,915,1758,-40
87474505022,87474505030,8,14467,22230,-40
87476990932,87476990938,6,3074,1387,-40
87483026180,87483026186,6,2843,1188,-40
87484322415,87484322418,3,3571,2929,-40
87488358345,87488358350,5,1951,1272,-40
87491696625,87491696627,2,4206,3841,-40
87494443615,87494443621,6,2330,1132,-40
87500754033,87500754032,-1,23841,32878,-40
87502010366,87502010372,6,2907,1458,-40
87502740048,87502740054,6,3054,1149,-40
87502951628,87502951611,-17,2256,961,-40
87505127911,87505127918,7,3833,1387,-40
87506029149,87506029132,-17,2948,1284,-40
87512189512,87512189518,6,1644,932,-40
87514125345,87514125330,-15,1050,346,-40
87516033474,87516033479,5,3255,1781,-40
87518301399,87518301405,6,2904,1289,-40
87519100795,87519100794,-1,3605,3739,-40
87522195196,87522195202,6,3316,1553,-40
87531475497,87531475503,6,3616,1333,-40
87533343087,87533343092,5,2777,1567,-40
87540811830,87540811837,7,2764,996,-40
87541924130,87541924116,-14,1050,111,-40
87544491362,87544491370,8,3139,1059,-40
87549561060,87549561067,7,1731,682,-40
87562102511,87562102516,5,1245,648,-40
87562131539,87562131546,7,2252,1000,-40
87566396604,87566396611,7,4989,1934,-40
87571206091,87571206097,6,4159,1314,-40
87572255669,87572255676,7,2448,1477,-40
87579550392,87579550397,5,3228,1440,-40
87581860700,87581860707,7,2983,655,-40
87583096387,87583096394,7,2849,1627,-40
87583872198,87583872205,7,2678,1675,-40
87583983950,87583983957,7,3439,1037,-40
87584164243,87584164251,8,3144,1259,-40
87586606945,87586606950,5,4305,1743,-40
87586895565,87586895562,-3,1546,2323,-40
87591956983,87591956990,7,4622,1911,-40
87597726477,87597726483,6,2760,1336,-40
87605399372,87605399390,18,597,2123,-40
87606849778,87606849778,0,1527,1378,-40
87608163367,87608163374,7,2214,1176,-40
87609573199,87609573206,7,3103,1432,-40
87610231799,87610231785,-14,1491,362,-40
87610847414,87610847421,7,2585,1156,-40
87612809597,87612809603,6,4382,1703,-40
87614175471,87614175478,7,3395,1633,-40
87614593114,87614593097,-17,831,328,-40
87615462335,87615462328,-7,1565,5124,-40
87616243620,87616243625,5,2251,958,-40
87618102265,87618102271,6,2018,677,-40
87621162573,87621162579,6,1273,911,-40
87622573397,87622573403,6,2437,1218,-40
87623798566,87623798572,6,3712,1370,-40
87624161966,87624161974,8,3325,1387,-40
87624371917,87624371897,-20,2022,1167,-40
87627697990,87627697997,7,3144,1735,-40
87628058981,87628058987,6,3839,1369,-40
87630079650,87630079657,7,3454,1607,-40
87637006658,87637006664,6,2706,1242,-40
87638904682,87638904690,8,3654,1233,-40
87639231194,87639231199,5,2260,1129,-40
87642041761,87642041769,8,3285,1449,-40
87642880613,87642880618,5,3645,1126,-40
87643111138,87643111145,7,2842,1146,-40
87643169571,87643169586,15,2524,1094,-40
87644107602,87644107601,-1,1096,2215,-40
87647196022,87647196030,8,1593,940,-40
87647300325,87647300331,6,2836,1141,-40
87647331430,87647331410,-20,2557,953,-40
87651157559,87651157565,6,3557,1428,-40
87651280709,87651280717,8,3645,1467,-40
87660339242,87660339249,7,2189,901,-40
87660785864,87660785871,7,2900,1223,-40
87662129964,87662129971,7,4651,723,-40
87668212374,87668212381,7,3061,869,-40
87671163862,87671163869,7,2309,1518,-40
87671753823,87671753810,-13,2494,802,-40
87676480069,87676480074,5,2639,1142,-40
87678116471,87678116476,5,2790,1633,-40
87678476366,87678476372,6,3514,1204,-40
87680228761,87680228766,5,904,240,-40
87682500681,87682500687,6,2722,1899,-40
87682925790,87682925797,7,3930,1665,-40
87683172573,87683172587,14,3505,1499,-40
87683507485,87683507505,20,2676,1396,-40
87683536763,87683536770,7,3182,1137,-40
87684486058,87684486062,4,2649,1550,-40
87685018933,87685018940,7,2584,1200,-40
87688537739,87688537744,5,1534,855,-40
87693352231,87693352237,6,5514,3132,-40
87693470405,87693470384,-21,2904,1644,-40
87699420289,87699420294,5,2996,1876,-40
87704019006,87704019011,5,2060,1476,-40
87707355315,87707355320,5,9284,6469,-40
87707880093,87707880098,5,2553,1167,-40
87710649493,87710649498,5,3523,1478,-40
87710955443,87710955450,7,1273,406,-40
87711633045,87711633040,-5,1022,42,-40
87718220837,87718220843,6,1440,519,-40
87718888454,87718888461,7,2439,1488,-40
87719287891,87719287897,6,2874,990,-40
87719629501,87719629492,-9,1716,709,-40
87719670105,87719670111,6,2917,878,-40
87720279889,87720279873,-16,1436,501,-40
87720325482,87720325490,8,2908,1290,-40
87722227292,87722227298,6,3606,1443,-40
87730696381,87730696387,6,3705,1184,-40
87732432145,87732432150,5,2116,855,-40
87735635882,87735635886,4,2756,1410,-40
87737386565,87737386570,5,1596,1090,-40
87737413569,87737413570,1,680,109,-40
87740899027,87740899035,8,3416,1234,-40
87744272617,87744272623,6,2961,1006,-40
87744839879,87744839882,3,2942,1350,-40
87748980167,87748980173,6,3346,1603,-40
87750354545,87750354550,5,1015,445,-40
87750832530,87750832545,15,1164,4276,-40
87751833707,87751833702,-5,1833,7535,-40
87752165679,87752165683,4,2050,36686,-40
87753372894,87753372899,5,3149,1232,-40
87757681710,87757681714,4,2933,3632,-40
87759556203,87759556203,0,1243,1144,-40
87760082402,87760082401,-1,683,359,-40
87764798034,87764798035,1,1438,1038,-40
87765968079,87765968059,-20,2667,1232,-40
87768249571,87768249578,7,3309,1214,-40
87771998175,87771998181,6,3158,1299,-40
87772541090,87772541087,-3,1231,1737,-40
87774578656,87774578660,4,2423,1960,-40
87776634050,87776634055,5,1895,1110,-40
87779720885,87779720890,5,3467,1408,-40
87796630847,87796630854,7,2600,1416,-40
87797950799,87797950805,6,1973,1007,-40
87799809578,87799809585,7,2587,1473,-40
87799995259,87799995273,14,1622,788,-40
87811403013,87811403019,6,11375,4525,-40
87813217474,87813217481,7,2650,1286,-40
87820619011,87820619011,0,220,6443,-40
87821665390,87821665398,8,3155,1565,-40
87822708479,87822708482,3,1887,1250,-40
87823431229,87823431235,6,2990,788,-40
87827739547,87827739552,5,3242,1430,-40
87827819625,87827819629,4,2272,1224,-40
87830009221,87830009226,5,2679,1300,-40
87831135621,87831135628,7,1514,947,-40
87834849018,87834849025,7,2549,1220,-40
87836167224,87836167231,7,2641,747,-40
87836238644,87836238627,-17,2060,456,-40
87836955160,87836955166,6,1838,1148,-40
87838405210,87838405214,4,1711,947,-40
87844386010,87844386015,5,2562,1310,-40
87844467734,87844467742,8,1965,775,-40
87844944607,87844944592,-15,768,427,-40
87848787146,87848787151,5,2077,1311,-40
87850528938,87850528944,6,3906,1774,-40
87852547002,87852546997,-5,1176,4094,-40
87853389234,87853389239,5,2143,1353,-40
87857556236,87857556243,7,2953,1006,-40
87858054473,87858054456,-17,2712,1210,-40
87860721775,87860721782,7,2538,1509,-40
87861510236,87861510242,6,2750,1084,-40
87862281846,87862281860,14,1251,208,-40
87869376192,87869376199,7,4205,1498,-40
87869403115,87869403096,-19,1166,109,-40
87871201323,87871201330,7,2201,1263,-40
87872266465,87872266466,1,2293,2597,-40
87874899822,87874899830,8,3429,1393,-40
87875634443,87875634451,8,4592,1689,-40
87876842794,87876842793,-1,1400,2873,-40
87883653778,87883653784,6,3030,1512,-40
87886110422,87886110437,15,819,340,-40
87886325004,87886325011,7,3183,1182,-40
87886473224,87886473212,-12,2152,817,-40
87888552582,87888552589,7,4046,1171,-40
87890671570,87890671577,7,1911,1046,-40
87890951820,87890951825,5,4839,1655,-40
87894214386,87894214392,6,1907,863,-40
87897120249,87897120257,8,3450,1507,-40
87900039219,87900039223,4,1876,584,-40
87901286058,87901286043,-15,690,392,-40
87903537820,87903537814,-6,29460,15921,-40
87907493930,87907493937,7,3592,1391,-40
87909601894,87909601899,5,2410,1160,-40
87913994845,87913994851,6,3988,1186,-40
87915968133,87915968139,6,2379,1371,-40
87916532893,87916532899,6,3021,1519,-40
87918565140,87918565146,6,3156,1449,-40
87923520742,87923520751,9,3975,1381,-40
87924734346,87924734346,0,1674,1438,-40
87929823149,87929823155,6,1984,1142,-40
87931096478,87931096485,7,2565,1536,-40
87932358678,87932358666,-12,1499,998,-40
87933929021,87933929027,6,2953,1013,-40
87938279831,87938279838,7,3191,1105,-40
87939651784,87939651791,7,2504,1060,-40
87947023164,87947023167,3,1353,1135,-40
87947855509,87947855515,6,3436,1450,-40
87954513514,87954513522,8,2005,939,-40
87955092567,87955092572,5,1299,1153,-40
87956239133,87956239136,3,2063,1107,-40
87958421094,87958421101,7,3040,1586,-40
87958872370,87958872376,6,3107,1385,-40
87960082866,87960082873,7,3028,1117,-40
87962482109,87962482115,6,3016,1401,-40
87963285357,87963285354,-3,2020,5070,-40
87966604546,87966604538,-8,1490,4955,-40
87971312670,87971312677,7,3631,1276,-40
87978060453,87978060458,5,3522,1237,-40
87980962307,87980962314,7,2891,1506,-40
87986146906,87986146910,4,2143,832,-40
87986285627,87986285633,6,2951,1304,-40
87992620702,87992620706,4,1664,1391,-40
87992948855,87992948858,3,1092,306,-40
87994907779,87994907786,7,2179,1307,-40
87997775266,87997775273,7,3972,1107,-40
87999407407,87999407414,7,3987,1393,-40
88000771443,88000771449,6,2673,1130,-40
88002090530,88002090533,3,1796,1078,-40
88002498906,88002498912,6,2471,1503,-40
88007824741,88007824746,5,2600,1649,-40
88008691121,88008691122,1,1564,1939,-40
88009380786,88009380793,7,2895,1403,-40
88010920161,88010920165,4,3132,1665,-40
88014356170,88014356178,8,2746,1332,-40
88015494109,88015494106,-3,1610,3155,-40
88015797113,88015797120,7,2422,933,-40
88016381779,88016381785,6,846,238,-40
88016444970,88016444953,-17,1350,458,-40
88021831773,88021831780,7,2118,1090,-40
88027637310,88027637317,7,2940,1399,-40
88027745975,88027745971,-4,3729,9678,-40
88029795285,88029795291,6,3109,1070,-40
88031678539,88031678534,-5,2190,5523,-40
88032976702,88032976707,5,3180,1281,-40
88033965169,88033965178,9,3163,1258,-40
88037868651,88037868657,6,1127,729,-40
88039898559,88039898565,6,2145,749,-40
88044394378,88044394385,7,2744,935,-40
88047935888,88047935895,7,2178,1304,-40
88050642852,88050642858,6,2457,1099,-40
88051064371,88051064377,6,2779,1818,-40
88053514772,88053514769,-3,1269,2212,-40
88054189568,88054189575,7,3647,1285,-40
88055007527,88055007534,7,1376,874,-40
88056763830,88056763838,8,3087,1053,-40
88061193645,88061193650,5,2287,1411,-40
88064525965,88064525973,8,7128,1134,-40
88065245092,88065245098,6,1373,788,-40
88065735321,88065735326,5,2925,1099,-40
88066487408,88066487415,7,2720,995,-40
88066865742,88066865721,-21,1254,325,-40
88067506641,88067506636,-5,1514,7893,-40
88068341509,88068341516,7,2788,1151,-40
88069061593,88069061599,6,2080,947,-40
88069094236,88069094259,23,1840,1135,-40
88073159449,88073159455,6,2555,1325,-40
88075911942,88075911943,1,1874,1184,-40
88077431263,88077431271,8,2845,1356,-40
88081623317,88081623323,6,2624,1197,-40
88083592837,88083592842,5,2787,1154,-40
88084037718,88084037723,5,2076,1011,-40
88088829477,88088829481,4,3265,1199,-40
88089874654,88089874656,2,1254,582,-40
88090994859,88090994865,6,2049,999,-40
88099587565,88099587571,6,2602,1376,-40
88103216937,88103216943,6,5408,3029,-40
88106066369,88106066370,1,3582,2210,-40
88107598313,88107598320,7,1997,956,-40
88110751045,88110751051,6,2676,1290,-40
88116052281,88116052286,5,3293,1234,-40
88116706643,88116706646,3,1201,1285,-40
88116940006,88116940013,7,3468,1697,-40
88118755969,88118755975,6,3230,1405,-40
88120547086,88120547082,-4,1336,3696,-40
88120684561,88120684558,-3,1259,3413,-40
88125147459,88125147465,6,1728,818,-40
88125714822,88125714802,-20,1887,571,-40
88127352245,88127352246,1,54535,63922,-40
88127955604,88127955608,4,2410,1426,-40
88128238226,88128238209,-17,3103,1324,-40
88130530974,88130530979,5,3034,1667,-40
88133017657,88133017662,5,2380,1512,-40
88134237317,88134237324,7,2302,1443,-40
88140386775,88140386781,6,2390,1552,-40
88140508830,88140508838,8,3303,1643,-40
88143003005,88143003000,-5,1644,3356,-40
88143600665,88143600673,8,3255,1108,-40
88152836370,88152836366,-4,2005,5606,-40
88153583714,88153583720,6,1994,779,-40
88162838374,88162838378,4,1761,689,-40
88162996341,88162996322,-19,2043,691,-40
88165898422,88165898404,-18,2119,864,-40
88167684175,88167684182,7,1915,808,-40
88167741099,88167741083,-16,2282,919,-40
88169814313,88169814318,5,3185,1044,-40
88174497217,88174497224,7,2842,1276,-40
88175482949,88175482954,5,2818,1319,-40
88178398126,88178398129,3,1574,969,-40
88180329731,88180329738,7,3114,1407,-40
88180447713,88180447696,-17,3513,973,-40
88180688278,88180688283,5,3121,1751,-40
88180729027,88180729034,7,1498,862,-40
88194052771,88194052776,5,3158,1369,-40
88203544845,88203544850,5,2270,1359,-40
88204388444,88204388451,7,1464,766,-40
88206951723,88206951728,5,3759,1115,-40
88211132225,88211132230,5,2205,1269,-40
88212451850,88212451855,5,1743,1293,-40
88215438869,88215438874,5,2133,823,-40
88218769094,88218769101,7,1721,1267,-40
88226894590,88226894600,10,11365,45819,-40
88227178289,88227178294,5,2628,1069,-40
88227750342,88227750330,-12,1019,298,-40
88230017141,88230017141,0,1527,795,-40
88232802491,88232802499,8,2736,1179,-40
88235720829,88235720835,6,3000,1163,-40
88243287945,88243287931,-14,960,106,-40
88248200423,88248200421,-2,4167,7838,-40
88254857229,88254857235,6,1944,939,-40
88257498015,88257498024,9,3418,1424,-40
88261653862,88261653866,4,2971,1633,-40
88262314994,88262314998,4,2416,840,-40
88265369662,88265369661,-1,531,1316,-40
88267228713,88267228719,6,2805,1024,-40
88272510863,88272510870,7,1235,820,-40
88275208673,88275208679,6,3180,1071,-40
88276521201,88276521207,6,2544,1503,-40
88277673495,88277673503,8,2256,1055,-40
88278769969,88278769974,5,1655,960,-40
88279462747,88279462751,4,2187,1321,-40
88281351599,88281351606,7,2365,1153,-40
88283997745,88283997750,5,2272,1552,-40
88284921918,88284921913,-5,1395,5968,-40
88285806229,88285806234,5,2051,1407,-40
88287058687,88287058674,-13,2354,1190,-40
88288291318,88288291323,5,2378,1044,-40
88294412237,88294412242,5,2564,1268,-40
88295205429,88295205434,5,2981,1267,-40
88303468838,88303468845,7,2272,1212,-40
88305533610,88305533615,5,3879,1620,-40
88310434509,88310434514,5,1616,1030,-40
88324478850,88324478857,7,1628,1135,-40
88325120649,88325120656,7,3283,1515,-40
88325917021,88325917022,1,32534,33126,-40
88328044182,88328044189,7,2228,1800,-40
88329807919,88329807927,8,2827,1338,-40
88333576439,88333576446,7,3325,1414,-40
88334504152,88334504158,6,6179,2875,-40
88336323375,88336323383,8,3740,1326,-40
88336610400,88336610404,4,2777,1427,-40
88336683836,88336683830,-6,974,2692,-40
88338795217,88338795207,-10,779,1745,-40
88339910749,88339910756,7,7148,1014,-40
88340949910,88340949915,5,1623,655,-40
88353662538,88353662546,8,2354,1153,-40
88354421924,88354421931,7,3365,1155,-40
88359949730,88359949738,8,3139,1285,-40
88360932542,88360932548,6,2599,1439,-40
88364900370,88364900377,7,1942,662,-40
88365126552,88365126558,6,3327,1413,-40
88365933701,88365933706,5,2563,1454,-40
88370184336,88370184342,6,2588,1243,-40
88375145708,88375145715,7,2204,1450,-40
88377978890,88377978898,8,1679,1184,-40
88378418289,88378418285,-4,1299,3363,-40
88379880740,88379880747,7,4101,1557,-40
88384595436,88384595443,7,2188,1125,-40
88387489234,88387489243,9,3140,1039,-40
88391913331,88391913337,6,3497,1615,-40
88392095769,88392095778,9,2489,1000,-40
88397182917,88397182924,7,2140,53154,-40
88397532731,88397532738,7,2509,1205,-40
88398980510,88398980515,5,3537,1502,-40
88399192382,88399192387,5,2815,1604,-40
88401557881,88401557882,1,1548,1748,-40
88403954542,88403954549,7,4707,1505,-40
88404630953,88404630959,6,3927,1424,-40
88405598609,88405598615,6,2468,1293,-40
88406494831,88406494827,-4,1535,3692,-40
88406831787,88406831793,6,3089,1189,-40
88412935598,88412935605,7,2589,1339,-40
88413797870,88413797874,4,2831,1974,-40
88414876864,88414876869,5,3586,1222,-40
88422445627,88422445633,6,3847,1347,-40
88433493893,88433493898,5,2081,962,-40
88434415150,88434415155,5,2010,1425,-40
88436068972,88436068977,5,3306,1336,-40
88436434301,88436434305,4,2871,1253,-40
88439199037,88439199034,-3,740,388,-40
88440298784,88440298786,2,1394,979,-40
88448028859,88448028866,7,35330,2232,-40
88450763650,88450763655,5,2254,1468,-40
88451800022,88451800028,6,2548,1417,-40
88452125360,88452125347,-13,3106,1465,-40
88452808247,88452808236,-11,946,568,-40
88453172983,88453172987,4,1951,831,-40
88454406050,88454406055,5,1604,813,-40
88455531831,88455531816,-15,1279,462,-40
88458918995,88458918998,3,1162,1402,-40
88459097906,88459097914,8,3411,1581,-40
88459354595,88459354599,4,2372,2015,-40
88465586767,88465586773,6,3212,1046,-40
88468650517,88468650522,5,3027,1107,-40
88469487504,88469487507,3,2287,1501,-40
88478223882,88478223888,6,1990,1417,-40
88478483920,88478483927,7,3206,945,-40
88479831194,88479831199,5,2441,1293,-40
88480921007,88480921013,6,2327,1752,-40
88494539533,88494539538,5,1781,989,-40
88495795454,88495795462,8,3214,1543,-40
88496142994,88496142999,5,3816,1551,-40
88502409785,88502409791,6,2107,1185,-40
88502973503,88502973510,7,3499,914,-40
88509937085,88509937090,5,2670,1487,-40
88510644879,88510644885,6,2396,1128,-40
88513089151,88513089158,7,3279,1922,-40
88513453061,88513453065,4,2537,1088,-40
88513611589,88513611595,6,2784,1369,-40
88517583673,88517583678,5,3746,1443,-40
88521520662,88521520666,4,3044,1499,-40
88521785841,88521785849,8,3590,1343,-40
88523294830,88523294836,6,2382,1225,-40
88528628990,88528628998,8,2720,952,-40
88530229099,88530229102,3,1869,1108,-40
88533382297,88533382315,18,2276,741,-40
88536430492,88536430497,5,1391,1577,-40
88538429501,88538429505,4,2039,1111,-40
88538902865,88538902871,6,3580,1563,-40
88539072419,88539072428,9,3296,1067,-40
88541492718,88541492723,5,2865,1048,-40
88543129550,88543129557,7,3535,1244,-40
88544350237,88544350218,-19,1310,377,-40
88548761550,88548761557,7,2099,1226,-40
88548930874,88548930881,7,2369,780,-40
88553195554,88553195554,0,1358,1454,-40
88554953421,88554953427,6,2626,1332,-40
88555923806,88555923807,1,123513,130828,-40
88557000490,88557000482,-8,1588,6097,-40
88558183296,88558183302,6,2492,1039,-40
88561544690,88561544694,4,2511,1333,-40
88562545323,88562545318,-5,4538,14404,-40
88564231721,88564231729,8,3584,1545,-40
88568300803,88568300802,-1,846,1706,-40
88569723388,88569723395,7,2825,1409,-40
88573105086,88573105093,7,2857,1020,-40
88573740209,88573740215,6,2688,1199,-40
88574593068,88574593074,6,2592,1317,-40
88576476011,88576476017,6,3622,1611,-40
88577099319,88577099323,4,2085,1376,-40
88578915653,88578915658,5,2216,1295,-40
88579455941,88579455946,5,2719,1377,-40
88582268724,88582268731,7,3188,1488,-40
88582517274,88582517279,5,1610,1004,-40
88582912420,88582912425,5,3415,1400,-40
88588512483,88588512489,6,2880,1604,-40
88588929098,88588929105,7,2352,1391,-40
88593038178,88593038184,6,3253,1666,-40
88594853999,88594853987,-12,1164,584,-40
88600029769,88600029772,3,2245,1462,-40
88600659550,88600659554,4,59612,33640,-40
88600900969,88600900977,8,4233,1864,-40
88605568137,88605568143,6,1520,1109,-40
88607698152,88607698158,6,3522,1493,-40
88617243864,88617243858,-6,1095,1466,-40
88627725342,88627725350,8,3393,1858,-40
88629285978,88629285984,6,3417,1168,-40
88629936326,88629936331,5,1835,826,-40
88632315851,88632315858,7,3622,1986,-40
88635722759,88635722765,6,2125,1276,-40
88639284603,88639284610,7,2464,1332,-40
88647234825,88647234831,6,2623,1032,-40
88648299226,88648299232,6,3752,1085,-40
88649123071,88649123061,-10,761,936,-40
88654885407,88654885413,6,2744,1892,-40
88658947682,88658947689,7,3758,1500,-40
88660873913,88660873918,5,1967,1138,-40
88661193966,88661193953,-13,2700,1142,-40
88663265330,88663265336,6,3298,1404,-40
88665576349,88665576355,6,2427,1083,-40
88668029360,88668029367,7,4182,1811,-40
88671625709,88671625714,5,6163,3456,-40
88674991138,88674991145,7,3047,1199,-40
88675436740,88675436754,14,2403,1401,-40
88676017493,88676017491,-2,1742,2492,-40
88676536157,88676536162,5,2104,1286,-40
88678899925,88678899930,5,2857,1233,-40
88681451278,88681451285,7,2856,1638,-40
88681661058,88681661065,7,3141,1164,-40
88683594566,88683594572,6,2539,1414,-40
88685714682,88685714688,6,4121,1730,-40
88688367014,88688367006,-8,1376,7137,-40
88689659600,88689659596,-4,31506,17216,-40
88692977746,88692977750,4,1593,1162,-40
88694008155,88694008138,-17,678,81,-40
88695588694,88695588701,7,3000,1200,-40
88697575810,88697575820,10,4083,1725,-40
88701399801,88701399807,6,1709,889,-40
88702258338,88702258345,7,2668,1327,-40
88702620843,88702620851,8,3748,1385,-40
88703116131,88703116138,7,3739,961,-40
88707732198,88707732205,7,3703,1483,-40
88715828517,88715828523,6,1639,924,-40
88715878525,88715878513,-12,3043,1049,-40
88716071397,88716071410,13,856,172,-40
88721974034,88721974027,-7,954,15,-40
88723427462,88723427467,5,2500,1001,-40
88730364559,88730364565,6,1864,859,-40
88731800694,88731800698,4,2418,1429,-40
88735520573,88735520578,5,2822,1588,-40
88736606723,88736606729,6,3200,1423,-40
88744978492,88744978485,-7,998,4045,-40
88746618977,88746618983,6,3364,1854,-40
88752040484,88752040490,6,3048,931,-40
88752071169,88752071185,16,1684,234,-40
88753492734,88753492738,4,2664,931,-40
88754346426,88754346445,19,803,168,-40
88759695688,88759695693,5,3389,1187,-40
88760969671,88760969678,7,2826,1191,-40
88763692972,88763692978,6,2600,1198,-40
88765738499,88765738506,7,2720,1952,-40
88765960194,88765960194,0,1413,256,-40
88768132241,88768132248,7,6812,1316,-40
88768998690,88768998699,9,2866,1550,-40
88785765017,88785765015,-2,1713,2160,-40
88788040008,88788039991,-17,1279,541,-40
88795713105,88795713111,6,1911,1407,-40
88798189586,88798189593,7,2795,1228,-40
88798565150,88798565170,20,1304,905,-40
88801107784,88801107790,6,1554,494,-40
88807175895,88807175902,7,2315,1184,-40
88808567427,88808567433,6,3144,1325,-40
88811368930,88811368935,5,2092,940,-40
88814396898,88814396899,1,1404,1648,-40
88816675245,88816675250,5,3412,1462,-40
88819597905,88819597911,6,3368,1722,-40
88820084656,88820084673,17,14603,42525,-40
88822750050,88822750055,5,2414,1037,-40
88825069789,88825069795,6,2263,1556,-40
88825822993,88825823000,7,2837,1135,-40
88826213071,88826213075,4,961,258,-40
88828507513,88828507519,6,3968,1797,-40
88828710454,88828710458,4,2033,1030,-40
88832771715,88832771712,-3,1887,4295,-40
88833737749,88833737750,1,2524,1906,-40
88834244569,88834244574,5,2477,729,-40
88836034390,88836034395,5,2389,1165,-40
88840851532,88840851537,5,3201,1874,-40
88841088061,88841088059,-2,1774,168,-40
88846658311,88846658316,5,3033,1035,-40
88848223845,88848223850,5,3401,1332,-40
88848488537,88848488544,7,800,171,-40
88852750550,88852750554,4,3004,1388,-40
88853381558,88853381568,10,3880,1458,-40
88858922680,88858922682,2,1382,1725,-40
88862430203,88862430209,6,3574,1033,-40
88865344038,88865344046,8,2977,1516,-40
88869116175,88869116182,7,1436,780,-40
88870298191,88870298198,7,2613,1270,-40
88871266654,88871266664,10,3147,1164,-40
88872358024,88872358031,7,3365,1469,-40
88874556098,88874556104,6,3330,1618,-40
88877459551,88877459555,4,1327,850,-40
88880440089,88880440094,5,2714,1447,-40
88880939765,88880939747,-18,3566,1855,-40
88883121081,88883121089,8,4040,1327,-40
88888234634,88888234640,6,3903,1873,-40
88894696238,88894696234,-4,838,2046,-40
88897801973,88897801980,7,15126,18459,-40
88899249644,88899249645,1,3629,3478,-40
88901189270,88901189282,12,18121,57230,-40
88902185692,88902185699,7,1906,943,-40
88904677946,88904677955,9,2850,961,-40
88905547918,88905547929,11,1313,345,-40
88908941586,88908941578,-8,1056,4392,-40
88932446731,88932446737,6,1917,941,-40
88933011249,88933011255,6,2738,1235,-40
88935419213,88935419218,5,2920,1429,-40
88942399218,88942399224,6,3051,1701,-40
88943253545,88943253550,5,2545,1312,-40
88943437218,88943437226,8,2924,1254,-40
88944521353,88944521359,6,4080,1488,-40
88951061971,88951061976,5,29253,17418,-40
88954248013,88954248018,5,2222,989,-40
88954637796,88954637803,7,1248,215,-40
88955185522,88955185508,-14,925,271,-40
88955608290,88955608280,-10,753,211,-40
88958481159,88958481165,6,2204,1496,-40
88963585549,88963585554,5,3057,993,-40
88969420606,88969420617,11,11280,43399,-40
88970357329,88970357334,5,3385,1231,-40
88972786026,88972786032,6,2141,1450,-40
88973422302,88973422307,5,3312,1967,-40
88975691089,88975691094,5,3009,1867,-40
88977059477,88977059483,6,4501,897,-40
88978197126,88978197130,4,1974,1277,-40
88980068275,88980068277,2,1438,1363,-40
88980528447,88980528426,-21,1030,444,-40
88984618734,88984618740,6,2760,1357,-40
88987571248,88987571253,5,2501,1347,-40
88988832325,88988832330,5,5409,1632,-40
88989583830,88989583838,8,2712,1317,-40
88989753968,88989753976,8,16562,25645,-40
88995879444,88995879450,6,2645,1465,-40
88998303345,88998303343,-2,1566,160,-40
89002978458,89002978465,7,1465,751,-40
89004276384,89004276391,7,3089,1329,-40
89007005643,89007005651,8,3148,1143,-40
89007889163,89007889169,6,2826,1398,-40
89015298344,89015298349,5,2170,1251,-40
89016263382,89016263386,4,1948,1139,-40
89021742837,89021742842,5,2589,943,-40
89024309154,89024309159,5,2198,1173,-40
89026557808,89026557814,6,2859,1256,-40
89027021159,89027021166,7,3363,1952,-40
89041801324,89041801329,5,1956,1074,-40
89042379105,89042379107,2,2006,1549,-40
89044462514,89044462508,-6,1174,4490,-40
89048610301,89048610306,5,2844,1284,-40
89049304523,89049304530,7,2492,1121,-40
89050319070,89050319078,8,3434,1406,-40
89054118554,89054118553,-1,3059,4215,-40
89054351101,89054351106,5,2424,1359,-40
89054545454,89054545434,-20,702,395,-40
89056008863,89056008868,5,2268,1223,-40
89057341004,89057340987,-17,2340,1358,-40
89058706205,89058706213,8,3234,1465,-40
89060490234,89060490242,8,4257,1583,-40
89061152824,89061152830,6,1583,885,-40
89062750321,89062750327,6,2825,1037,-40
89062989802,89062989808,6,3105,1570,-40
89063839244,89063839248,4,3144,1648,-40
89064084157,89064084166,9,3798,1350,-40
89065053654,89065053643,-11,3610,1053,-40
89067300649,89067300654,5,1871,860,-40
89067597103,89067597108,5,3495,1358,-40
89070982558,89070982566,8,2657,1537,-40
89072131694,89072131699,5,4500,2793,-40
89073038979,89073038987,8,2606,1012,-40
89073521635,89073521619,-16,832,431,-40
89078688910,89078688915,5,2142,785,-40
89080057778,89080057786,8,2796,1303,-40
89084921116,89084921119,3,1535,1089,-40
89085483799,89085483806,7,2765,1619,-40
89087983068,89087983080,12,251,1289,-40
89090159763,89090159770,7,2616,1114,-40
89093677013,89093677006,-7,1465,3995,-40
89097808909,89097808914,5,2578,1441,-40
89098555449,89098555438,-11,864,112,-40
89099676618,89099676625,7,3756,1625,-40
89100355186,89100355192,6,2545,1317,-40
89101192788,89101192793,5,2757,1588,-40
89101492350,89101492343,-7,1288,9227,-40
89104125145,89104125153,8,3165,1150,-40
89107015830,89107015838,8,1856,1163,-40
89108137294,89108137280,-14,2575,1117,-40
89108383694,89108383701,7,2967,970,-40
89109349115,89109349099,-16,2122,1378,-40
89114701016,89114701023,7,2334,995,-40
89115071461,89115071467,6,2968,1111,-40
89117572628,89117572618,-10,1443,884,-40
89120479913,89120479918,5,3579,1649,-40
89123723198,89123723205,7,2790,1241,-40
89124449032,89124449028,-4,712,2199,-40
89132674477,89132674484,7,3722,1248,-40
89136678954,89136678962,8,4229,1256,-40
89137320397,89137320401,4,2421,1033,-40
89137662173,89137662186,13,1152,280,-40
89137771330,89137771315,-15,2290,749,-40
89138594662,89138594670,8,2642,1338,-40
89138634209,89138634214,5,3098,856,-40
89141463306,89141463307,1,1172,1233,-40
89141557108,89141557114,6,1919,980,-40
89145716427,89145716431,4,996,684,-40
89149306696,89149306702,6,3923,1508,-40
89149481260,89149481267,7,4081,1315,-40
89149673135,89149673142,7,2431,1519,-40
89157945301,89157945307,6,3100,1481,-40
89159537205,89159537210,5,2535,1182,-40
89162809973,89162809978,5,3361,1191,-40
89167999380,89167999386,6,3835,1400,-40
89169301129,89169301131,2,2919,2840,-40
89172730894,89172730900,6,2675,1174,-40
89175057773,89175057780,7,3118,1186,-40
89179366475,89179366479,4,1988,1322,-40
89179642380,89179642386,6,3652,1459,-40
89180291022,89180291032,10,1512,1328,-40
89186381273,89186381280,7,2425,1282,-40
89188673697,89188673702,5,1878,1431,-40
89193963675,89193963681,6,2537,1464,-40
89194591249,89194591256,7,1135,354,-40
89198744768,89198744774,6,3355,1467,-40
89198927405,89198927387,-18,2297,844,-40
89200648770,89200648775,5,2532,1038,-40
89201549923,89201549930,7,2883,1354,-40
89203576751,89203576757,6,3160,1186,-40
89204852337,89204852338,1,2102,1662,-40
89208570413,89208570419,6,2470,1302,-40
89208664398,89208664380,-18,3713,1035,-40
89209610502,89209610507,5,2826,1302,-40
89211255834,89211255841,7,3441,1421,-40
89211550626,89211550634,8,2822,1220,-40
89211749163,89211749169,6,2056,1387,-40
89211856002,89211856010,8,4457,1278,-40
89217293325,89217293332,7,3508,1703,-40
89218678971,89218678978,7,3040,1507,-40
89218964374,89218964362,-12,2931,784,-40
89221226988,89221226994,6,2628,1499,-40
89222026973,89222026979,6,2239,1120,-40
89222547459,89222547467,8,3094,1568,-40
89222974513,89222974498,-15,3226,1274,-40
89225096530,89225096536,6,1758,1016,-40
89225245152,89225245171,19,3502,1466,-40
89227207152,89227207159,7,3568,1318,-40
89227342889,89227342893,4,1261,816,-40
89234119878,89234119885,7,1521,1508,-40
89234260022,89234260028,6,1782,932,-40
89234511086,89234511094,8,1576,803,-40
89236744689,89236744695,6,2132,1117,-40
89238399973,89238399979,6,3368,1453,-40
89238622654,89238622662,8,3407,1336,-40
89245155642,89245155647,5,3438,1611,-40
89245835714,89245835720,6,3317,1630,-40
89247097688,89247097694,6,2557,1124,-40
89247160950,89247160928,-22,59,1296,-40
89248145229,89248145231,2,1957,1570,-40
89254737067,89254737073,6,2272,1066,-40
89255035079,89255035087,8,2908,1144,-40
89255468901,89255468883,-18,3989,1211,-40
89258387081,89258387086,5,3869,1310,-40
89262678321,89262678326,5,2889,1344,-40
89262775247,89262775258,11,2862,1183,-40
89266806950,89266806957,7,3719,1863,-40
89270371318,89270371326,8,2019,1130,-40
89271597189,89271597196,7,3034,1013,-40
89272012587,89272012594,7,2274,1077,-40
89272074741,89272074746,5,2665,1671,-40
89273022845,89273022850,5,2514,1433,-40
89273066857,89273066862,5,3210,1271,-40
89274644806,89274644813,7,2415,967,-40
89280640158,89280640165,7,3238,1264,-40
89280908175,89280908183,8,3521,1383,-40
89282106074,89282106075,1,3064,3512,-40
89282902810,89282902816,6,2133,841,-40
89283812030,89283812009,-21,1060,381,-40
89284978593,89284978598,5,2793,1164,-40
89285186143,89285186124,-19,2758,1071,-40
89286017459,89286017467,8,3254,1496,-40
89286180646,89286180653,7,2805,960,-40
89287566120,89287566126,6,3542,1242,-40
89293121623,89293121619,-4,1681,4387,-40
89294808069,89294808074,5,2654,949,-40
89295012962,89295012963,1,826,279,-40
89296076746,89296076751,5,1702,1460,-40
89303768502,89303768509,7,2541,1474,-40
89305171600,89305171603,3,1989,1335,-40
89308942321,89308942329,8,3438,1335,-40
89314471254,89314471259,5,2525,1171,-40
89321460424,89321460433,9,2693,1289,-40
89321829793,89321829801,8,3189,1308,-40
89323186277,89323186283,6,3341,1705,-40
89324872406,89324872405,-1,1002,2559,-40
89328235304,89328235311,7,2484,1471,-40
89330063102,89330063107,5,2208,1033,-40
89331588981,89331588987,6,3611,1416,-40
89333675434,89333675442,8,2208,1008,-40
89335058466,89335058472,6,3463,1547,-40
89335372097,89335372081,-16,607,277,-40
89337285402,89337285411,9,2489,1616,-40
89342201961,89342201957,-4,2087,4979,-40
89354372595,89354372603,8,1872,948,-40
89356126287,89356126293,6,2685,1145,-40
89356674481,89356674472,-9,1035,285,-40
89358643458,89358643465,7,2627,948,-40
89360434079,89360434084,5,4272,1558,-40
89364242329,89364242334,5,2519,1416,-40
89364860062,89364860065,3,1915,1110,-40
89366793650,89366793657,7,3903,1745,-40
89368079066,89368079071,5,3041,1774,-40
89368326478,89368326485,7,3393,1329,-40
89373078414,89373078415,1,1446,1759,-40
89373597194,89373597200,6,3377,1502,-40
89374083628,89374083641,13,449,1286,-40
89375389078,89375389070,-8,893,4182,-40
89375496203,89375496210,7,2125,996,-40
89377303221,89377303226,5,2103,1111,-40
89380421814,89380421823,9,4110,1315,-40
89381605087,89381605090,3,1511,382,-40
89382727756,89382727737,-19,2986,1027,-40
89386366072,89386366078,6,2030,1009,-40
89386662588,89386662591,3,3790,2212,-40
89386861900,89386861905,5,3740,1390,-40
89391966578,89391966584,6,3165,1461,-40
89392187707,89392187715,8,4421,1085,-40
89394875327,89394875339,12,3160,1532,-40
89398572304,89398572301,-3,902,2938,-40
89399525303,89399525310,7,3244,1462,-40
89400378822,89400378827,5,2221,1175,-40
89400580147,89400580162,15,2213,1022,-40
89411441665,89411441671,6,2421,1111,-40
89413324644,89413324650,6,2557,1048,-40
89414249885,89414249892,7,2746,1198,-40
89416164165,89416164171,6,3258,1116,-40
89420896677,89420896683,6,2980,1348,-40
89424101595,89424101598,3,1486,1381,-40
89425209290,89425209298,8,2526,1145,-40
89426175677,89426175683,6,2991,1282,-40
89433614622,89433614617,-5,807,3650,-40
89434014912,89434014917,5,2369,1513,-40
89436414330,89436414336,6,2212,1417,-40
89436745270,89436745276,6,2108,1028,-40
89439399038,89439399043,5,2287,1270,-40
89442691874,89442691880,6,3369,1584,-40
89442791765,89442791761,-4,1007,3214,-40
89445967998,89445968004,6,2397,1173,-40
89446597678,89446597688,10,2143,761,-40
89449091585,89449091589,4,1639,921,-40
89449949243,89449949249,6,3202,1423,-40
89450321690,89450321685,-5,1460,5139,-40
89450652002,89450652009,7,3061,1131,-40
89452963121,89452963127,6,2907,1072,-40
89457517485,89457517491,6,2367,1513,-40
89459147970,89459147975,5,2606,937,-40
89459679964,89459679971,7,2773,992,-40
89463649886,89463649891,5,2487,1270,-40
89467809095,89467809103,8,4485,1190,-40
89469850978,89469850982,4,2983,1251,-40
89470860271,89470860277,6,3462,1139,-40
89471600250,89471600260,10,2575,914,-40
89476091724,89476091731,7,2767,1155,-40
89479069378,89479069386,8,2692,1059,-40
89480051462,89480051442,-20,1154,564,-40
89484185918,89484185923,5,2813,1352,-40
89486704638,89486704645,7,1284,706,-40
89492199234,89492199242,8,3026,1090,-40
89492602227,89492602235,8,2076,1116,-40
89504034810,89504034795,-15,946,114,-40
89505308331,89505308338,7,3606,1709,-40
89508653673,89508653681,8,2427,1152,-40
89508889730,89508889721,-9,769,325,-40
89508996796,89508996802,6,2979,1250,-40
89516546966,89516546967,1,1399,1397,-40
89538092491,89538092485,-6,678,4096,-40
89539065925,89539065930,5,2764,1268,-40
89546474439,89546474439,0,2924,4080,-40
89548199084,89548199090,6,2777,1058,-40
89551219373,89551219377,4,3146,2105,-40
89551774674,89551774681,7,2631,1718,-40
89552727457,89552727462,5,2016,1185,-40
89553317061,89553317069,8,2718,1125,-40
89556303482,89556303477,-5,5271,14895,-40
89557013793,89557013786,-7,1543,5774,-40
89558326507,89558326513,6,2609,1182,-40
89558835766,89558835773,7,3555,1682,-40
89565094909,89565094914,5,2330,965,-40
89568073089,89568073095,6,2098,976,-40
89569188350,89569188356,6,2687,1000,-40
89575051165,89575051170,5,3267,1474,-40
89577303945,89577303952,7,3286,1725,-40
89578763431,89578763438,7,1730,583,-40
89584229889,89584229894,5,2109,1357,-40
89586651401,89586651409,8,2683,1426,-40
89589841911,89589841910,-1,2335,3435,-40
89592367257,89592367262,5,3054,1216,-40
89592683959,89592683936,-23,839,274,-40
89594712461,89594712460,-1,1614,1827,-40
89595266864,89595266879,15,131,796,-40
89598922623,89598922629,6,2217,1369,-40
89599147213,89599147192,-21,2469,908,-40
89602202059,89602202039,-20,1900,926,-40
89606736506,89606736511,5,1749,1037,-40
89607128593,89607128597,4,2815,1651,-40
89608446206,89608446213,7,1972,1181,-40
89614928762,89614928768,6,2919,1383,-40
89622755418,89622755426,8,3376,1292,-40
89623126366,89623126346,-20,1839,365,-40
89623221755,89623221762,7,1014,204,-40
89623865882,89623865898,16,484,154,-40
89624544185,89624544191,6,2657,1259,-40
89628344678,89628344687,9,3347,1170,-40
89628790706,89628790722,16,1900,1171,-40
89631973937,89631973942,5,3605,1456,-40
89632060157,89632060169,12,1818,1129,-40
89633063762,89633063769,7,2194,666,-40
89636794525,89636794522,-3,971,2094,-40
89638168088,89638168094,6,2426,1409,-40
89638310105,89638310111,6,2191,1250,-40
89638442934,89638442940,6,2825,1341,-40
89639666160,89639666146,-14,3191,1312,-40
89641086583,89641086590,7,3394,1196,-40
89641345589,89641345571,-18,2835,1641,-40
89643774637,89643774643,6,2488,904,-40
89643984205,89643984186,-19,2113,835,-40
89644705911,89644705905,-6,1422,7853,-40
89644946693,89644946699,6,950,495,-40
89648046610,89648046617,7,2274,1136,-40
89648809673,89648809680,7,2384,1109,-40
89650467514,89650467521,7,3961,1777,-40
89652510185,89652510191,6,1936,784,-40
89653924854,89653924862,8,3313,982,-40
89655311756,89655311763,7,2858,1065,-40
89658199797,89658199802,5,3414,2028,-40
89659316378,89659316382,4,1765,1062,-40
89660383933,89660383938,5,3022,877,-40
89660422451,89660422459,8,2277,948,-40
89663485865,89663485869,4,3059,2286,-40
89668674415,89668674421,6,3868,1549,-40
89669860606,89669860619,13,1174,348,-40
89670901065,89670901071,6,2033,1208,-40
89670984910,89670984915,5,2724,1464,-40
89674296430,89674296437,7,3427,2000,-40
89684469397,89684469401,4,1757,1112,-40
89687765370,89687765370,0,1351,2746,-40
89687925861,89687925867,6,2633,1298,-40
89688537826,89688537830,4,2079,747,-40
89690317522,89690317529,7,3039,1472,-40
89692117818,89692117825,7,2990,1192,-40
89705242903,89705242909,6,3653,1620,-40
89705643372,89705643379,7,4058,1241,-40
89708442626,89708442631,5,1945,1253,-40
89709943707,89709943713,6,3124,1011,-40
89710963161,89710963158,-3,1393,3069,-40
89717235194,89717235198,4,1663,1220,-40
89722383257,89722383265,8,3896,1886,-40
89722761973,89722761978,5,2015,761,-40
89723483785,89723483789,4,4338,2524,-40
89725110666,89725110671,5,3988,1294,-40
89725497106,89725497111,5,2879,1321,-40
89730076001,89730076007,6,2691,986,-40
89731039039,89731039043,4,1795,1027,-40
89732132015,89732132025,10,1355,617,-40
89735915318,89735915321,3,1687,1488,-40
89741865095,89741865090,-5,1354,4024,-40
89747927924,89747927925,1,1556,1095,-40
89750174797,89750174806,9,2193,1211,-40
89753466470,89753466477,7,2831,1378,-40
89754321596,89754321602,6,3587,1670,-40
89754584586,89754584591,5,3149,1498,-40
89757166410,89757166418,8,2975,875,-40
89758061890,89758061898,8,1858,1182,-40
89760715234,89760715239,5,1659,896,-40
89761178638,89761178642,4,1315,884,-40
89765960235,89765960242,7,3778,1402,-40
89766208125,89766208131,6,3414,1760,-40
89767982894,89767982899,5,4014,1446,-40
89770871906,89770871914,8,2869,1202,-40
89772558973,89772558993,20,439,2372,-40
89773135693,89773135699,6,1832,1057,-40
89774234885,89774234891,6,2453,1315,-40
89774416218,89774416224,6,3532,2173,-40
89774727815,89774727821,6,4377,1524,-40
89777624876,89777624882,6,2152,1361,-40
89781405112,89781405116,4,1946,1214,-40
89786437151,89786437156,5,3417,1775,-40
89789577978,89789577985,7,3529,1457,-40
89790166076,89790166081,5,2917,1134,-40
89793988854,89793988860,6,1929,1077,-40
89797184221,89797184226,5,2286,1439,-40
89797544695,89797544681,-14,592,568,-40
89799995975,89799995983,8,4291,1539,-40
89803168938,89803168927,-11,932,426,-40
89804586565,89804586571,6,3256,1392,-40
89816416965,89816416963,-2,1075,1506,-40
89816527328,89816527333,5,2196,1192,-40
89817952789,89817952794,5,3066,1387,-40
89821095332,89821095339,7,2353,1436,-40
89821182638,89821182626,-12,974,180,-40
89824823097,89824823102,5,2667,1516,-40
89824969730,89824969714,-16,1138,463,-40
89835271949,89835271957,8,3271,2034,-40
89835496293,89835496299,6,2213,1413,-40
89835692607,89835692592,-15,812,262,-40
89841561713,89841561728,15,13922,18830,-40
89844068828,89844068834,6,1822,834,-40
89844663633,89844663648,15,1995,942,-40
89846695537,89846695542,5,2645,1624,-40
89857898112,89857898121,9,3080,1343,-40
89858399345,89858399352,7,3666,1217,-40
89858546615,89858546592,-23,2122,784,-40
89863436452,89863436459,7,2414,955,-40
89864906194,89864906202,8,2813,1252,-40
89876789647,89876789653,6,2000,797,-40
89877506782,89877506789,7,2843,626,-40
89877859094,89877859099,5,3090,1612,-40
89881476598,89881476604,6,2564,1322,-40
89886842754,89886842759,5,2362,1326,-40
89889866171,89889866178,7,1410,1081,-40
89890755558,89890755558,0,1516,2235,-40
89891657196,89891657202,6,2702,1849,-40
89893283055,89893283062,7,3508,1203,-40
89894194385,89894194392,7,2542,1613,-40
89896478177,89896478183,6,3313,1445,-40
89898972411,89898972418,7,3600,1299,-40
89903347537,89903347543,6,2615,1307,-40
89904381427,89904381433,6,2055,1394,-40
89907824945,89907824933,-12,1249,187,-40
89911807033,89911807041,8,3978,1356,-40
89913566660,89913566664,4,2303,1167,-40
89914037817,89914037823,6,2443,1152,-40
89914900372,89914900378,6,2135,1177,-40
89918297962,89918297969,7,2422,1196,-40
89921070146,89921070151,5,2280,1339,-40
89922301369,89922301374,5,2321,1093,-40
89924021175,89924021170,-5,19059,8240,-40
89927022053,89927022059,6,2075,1036,-40
89928438022,89928438033,11,752,401,-40
89930862119,89930862126,7,2949,1493,-40
89936195016,89936195023,7,2495,1175,-40
89945473185,89945473191,6,2773,840,-40
89948369161,89948369145,-16,105,1584,-40
89951640557,89951640563,6,2370,979,-40
89954202634,89954202642,8,2890,849,-40
89955362739,89955362746,7,2481,1635,-40
89956539437,89956539431,-6,967,3642,-40
89957278133,89957278139,6,2433,828,-40
89963547925,89963547933,8,16975,26038,-40
89965091728,89965091734,6,2602,930,-40
89965914350,89965914329,-21,2105,550,-40
89969104370,89969104375,5,2394,832,-40
89969328135,89969328122,-13,2202,851,-40
89969543708,89969543711,3,1246,1249,-40
89974800126,89974800132,6,3275,1714,-40
89979284861,89979284867,6,2573,1097,-40
89980855826,89980855832,6,2590,1242,-40
89982103356,89982103350,-6,850,3209,-40
89983631676,89983631681,5,1583,1002,-40
89985109418,89985109424,6,2765,1052,-40
89987477804,89987477806,2,2377,3245,-40
89988391001,89988391006,5,2406,1427,-40
89989188625,89989188640,15,4388,1462,-40
89999701467,89999701472,5,2801,915,-40
90004650074,90004650082,8,3228,1005,-40
90005305804,90005305784,-20,2233,570,-40
90010081160,90010081151,-9,1822,32122,-40
90013009417,90013009424,7,3346,1797,-40
90013182161,90013182168,7,3237,1463,-40
90016087318,90016087325,7,1140,610,-40
90023643619,90023643618,-1,1605,2413,-40
90024153222,90024153229,7,5620,3559,-40
90036016544,90036016551,7,3279,1215,-40
90036212894,90036212899,5,3083,1644,-40
90043464073,90043464078,5,3047,1526,-40
90049724243,90049724247,4,2727,1526,-40
90055536927,90055536934,7,2293,865,-40
90061681746,90061681751,5,2920,1542,-40
90064275977,90064275983,6,3437,1281,-40
90064862290,90064862298,8,3547,1655,-40
90065259197,90065259203,6,3074,1161,-40
90065539681,90065539682,1,2492,3060,-40
90065806397,90065806406,9,2319,931,-40
90066172990,90066172986,-4,2811,6129,-40
90066217365,90066217371,6,3048,1317,-40
90068934598,90068934603,5,3327,1313,-40
90071609210,90071609215,5,2356,1201,-40
90074022318,90074022326,8,2440,1383,-40
90074201733,90074201735,2,1660,1359,-40
90080237913,90080237919,6,3291,1316,-40
90084987358,90084987362,4,1997,975,-40
90089650923,90089650929,6,3061,1099,-40
90090974137,90090974142,5,3001,1379,-40
90095425096,90095425102,6,3002,1638,-40
90096197586,90096197595,9,3538,1216,-40
90096750596,90096750601,5,2543,1008,-40
90101614402,90101614408,6,3827,1548,-40
90102286302,90102286291,-11,1809,513,-40
90106984562,90106984566,4,2242,1196,-40
90107127107,90107127097,-10,761,99,-40
90110062322,90110062328,6,2250,880,-40
90112135575,90112135582,7,2004,1027,-40
90123399143,90123399148,5,1511,1169,-40
90124289714,90124289719,5,4008,1306,-40
90127108604,90127108610,6,2746,1276,-40
90135136349,90135136356,7,3115,1380,-40
90135186404,90135186410,6,3596,1813,-40
90137596673,90137596679,6,3392,1385,-40
90137892851,90137892858,7,3834,1577,-40
90140378484,90140378490,6,1546,1436,-40
90140915319,90140915327,8,3400,1307,-40
90142291101,90142291109,8,3689,1094,-40
90142848958,90142848938,-20,1080,833,-40
90144787892,90144787899,7,1997,685,-40
90145030086,90145030083,-3,1039,343,-40
90147854433,90147854438,5,2160,730,-40
90158304248,90158304254,6,3166,1666,-40
90160250738,90160250746,8,2886,1373,-40
90160663347,90160663352,5,1232,1551,-40
90166310002,90166310009,7,5574,1943,-40
90167604977,90167604984,7,2786,1514,-40
90168085219,90168085202,-17,3322,1483,-40
90169760984,90169760979,-5,6492,3195,-40
90170937686,90170937693,7,2384,1050,-40
90171998134,90171998139,5,1775,799,-40
90172287278,90172287264,-14,1559,443,-40
90172882598,90172882603,5,2797,1194,-40
90173093622,90173093635,13,3437,1023,-40
90174127962,90174127970,8,2776,1456,-40
90178229181,90178229187,6,3002,1190,-40
90179227819,90179227804,-15,1467,428,-40
90181209761,90181209766,5,2679,1194,-40
90185893922,90185893927,5,2755,1577,-40
90189269705,90189269713,8,2866,1297,-40
90190052502,90190052510,8,3097,1466,-40
90191938457,90191938464,7,3463,1271,-40
90192781529,90192781534,5,2870,1236,-40
90199362818,90199362825,7,2518,1366,-40
90207995981,90207995986,5,2004,1430,-40
90210303685,90210303690,5,3966,2163,-40
90212514605,90212514610,5,3338,1143,-40
90216284902,90216284907,5,2080,1148,-40
90217429484,90217429491,7,3003,1123,-40
90218445291,90218445288,-3,1060,329,-40
90221364997,90221364993,-4,1847,6870,-40
90227636155,90227636153,-2,1814,2347,-40
90227670614,90227670622,8,3615,1458,-40
90229618856,90229618862,6,3541,1307,-40
90236075170,90236075177,7,3067,1457,-40
90244920968,90244920966,-2,935,2560,-40
90248224906,90248224910,4,1800,916,-40
90252252146,90252252155,9,1937,1112,-40
90252515517,90252515508,-9,515,148,-40
90254722294,90254722298,4,3464,1899,-40
90255810771,90255810776,5,1699,1072,-40
90257359369,90257359375,6,2606,1265,-40
90259186992,90259186995,3,3482,1477,-40
90263356692,90263356695,3,2149,1330,-40
90264782916,90264782922,6,2288,1185,-40
90266224198,90266224204,6,3044,1673,-40
90267223157,90267223163,6,2249,1014,-40
90267907582,90267907569,-13,925,231,-40
90268668869,90268668875,6,1151,816,-40
90270223639,90270223645,6,3199,981,-40
90275781760,90275781765,5,2671,943,-40
90288846342,90288846362,20,1572,1641,-40
90290202339,90290202345,6,2029,1064,-40
90290321318,90290321324,6,2347,1127,-40
90290953205,90290953218,13,661,138,-40
90297632222,90297632225,3,2438,1880,-40
90297846615,90297846628,13,3367,1417,-40
90298399984,90298399990,6,3285,1275,-40
90300597697,90300597702,5,3207,1463,-40
90300644169,90300644186,17,716,300,-40
90302305674,90302305659,-15,2466,858,-40
90302437845,90302437851,6,4165,1457,-40
90303012641,90303012647,6,2217,750,-40
90314362473,90314362480,7,4021,1572,-40
90315031970,90315031975,5,2083,841,-40
90315405337,90315405345,8,2873,1500,-40
90316941750,90316941755,5,2360,1550,-40
90319484357,90319484363,6,2188,1051,-40
90321090049,90321090032,-17,1758,967,-40
90328792198,90328792205,7,2069,875,-40
90343719259,90343719265,6,2380,1202,-40
90349454368,90349454371,3,1352,1389,-40
90362436458,90362436466,8,2227,1073,-40
90362481956,90362481962,6,2742,1092,-40
90362632070,90362632079,9,2274,1043,-40
90362724882,90362724890,8,3870,1460,-40
90363242094,90363242075,-19,968,620,-40
90363977966,90363977970,4,1623,626,-40
90366008853,90366008858,5,2531,1167,-40
90366691004,90366691012,8,4499,1179,-40
90369090381,90369090389,8,4814,1349,-40
90373648154,90373648161,7,2752,1140,-40
90375128782,90375128794,12,1183,247,-40
90381494050,90381494055,5,1241,26985,-40
90383934638,90383934645,7,4297,1670,-40
90384661284,90384661289,5,3115,1364,-40
90388534370,90388534377,7,3239,1008,-40
90388912244,90388912258,14,2577,1154,-40
90393972642,90393972647,5,2903,1526,-40
90397624865,90397624872,7,2652,1069,-40
90401897397,90401897402,5,1606,1547,-40
90407473056,90407473062,6,2398,1187,-40
90408253335,90408253340,5,2613,1528,-40
90408540662,90408540643,-19,2911,705,-40
90412376306,90412376306,0,1247,1945,-40
90414758890,90414758896,6,2255,1160,-40
90416338586,90416338583,-3,1254,1650,-40
90419499578,90419499585,7,2817,1161,-40
90420029912,90420029918,6,2000,1088,-40
90426421538,90426421545,7,2529,1239,-40
90426748390,90426748397,7,3303,1360,-40
90430068144,90430068149,5,2582,1519,-40
90432383569,90432383575,6,3397,1349,-40
90436223189,90436223196,7,3427,1627,-40
90437991886,90437991891,5,3062,1431,-40
90439494109,90439494115,6,2834,1224,-40
90440249385,90440249368,-17,2661,1373,-40
90445536324,90445536318,-6,37122,12513,-40
90446950538,90446950546,8,2234,953,-40
90449766274,90449766283,9,2595,884,-40
90452253459,90452253467,8,1887,1149,-40
90452709886,90452709873,-13,941,535,-40
90453960671,90453960665,-6,1252,3656,-40
90454301288,90454301299,11,10694,37794,-40
90455753143,90455753151,8,2496,1433,-40
90458471620,90458471628,8,2151,1220,-40
90464164657,90464164663,6,3707,1629,-40
90464582879,90464582881,2,2191,1495,-40
90473213614,90473213619,5,2778,1248,-40
90473317901,90473317907,6,1884,1499,-40
90475517173,90475517177,4,3514,1081,-40
90476048987,90476048995,8,2561,1568,-40
90478711531,90478711537,6,2770,1239,-40
90484991833,90484991838,5,2221,813,-40
90486395949,90486395954,5,2861,1292,-40
90488910793,90488910800,7,2850,1273,-40
90494222924,90494222911,-13,4251,1069,-40
90494307409,90494307424,15,1809,824,-40
90496043983,90496043989,6,2067,1359,-40
90496094889,90496094894,5,3939,1177,-40
90498240722,90498240704,-18,1398,509,-40
90500075147,90500075153,6,4009,1594,-40
90503081202,90503081203,1,1502,1716,-40
90509305988,90509305993,5,2235,905,-40
90509462957,90509462963,6,2742,962,-40
90509701705,90509701692,-13,924,469,-40
90517762459,90517762465,6,2638,1003,-40
90531907099,90531907104,5,1670,1337,-40
90533977829,90533977835,6,2673,1102,-40
90534713556,90534713562,6,1335,913,-40
90540313511,90540313517,6,2796,1393,-40
90544671853,90544671860,7,2651,1888,-40
90545423017,90545423022,5,3113,1285,-40
90545924638,90545924646,8,2532,1671,-40
90546411274,90546411291,17,719,188,-40
90546762229,90546762234,5,3181,1260,-40
90547033071,90547033078,7,4465,1456,-40
90547291678,90547291684,6,3000,1501,-40
90550636157,90550636164,7,3472,1147,-40
90555360592,90555360598,6,3254,1124,-40
90556901183,90556901178,-5,1187,283,-40
90566827143,90566827150,7,2071,1133,-40
90567354658,90567354643,-15,1041,438,-40
90568759378,90568759386,8,3038,1349,-40
90569353762,90569353745,-17,1982,663,-40
90569993162,90569993170,8,2793,994,-40
90571304890,90571304897,7,990,709,-40
90582537984,90582537990,6,3654,1325,-40
90583556163,90583556169,6,2657,1291,-40
90583790561,90583790578,17,2878,1444,-40
90587554816,90587554822,6,2583,1628,-40
90588389797,90588389803,6,938,218,-40
90593810006,90593810005,-1,2333,3254,-40
90594989113,90594989118,5,3246,1318,-40
90595391111,90595391118,7,3253,1231,-40
90595795467,90595795471,4,2622,1405,-40
90596651482,90596651475,-7,20338,14957,-40
90605028134,90605028139,5,2380,995,-40
90608660874,90608660881,7,2991,1264,-40
90608980293,90608980299,6,4463,1640,-40
90613644218,90613644225,7,3258,1147,-40
90614241010,90614241015,5,2174,1076,-40
90614850286,90614850290,4,2982,1050,-40
90618857527,90618857527,0,1003,1260,-40
90625776669,90625776675,6,2350,1738,-40
90625911482,90625911487,5,2720,1177,-40
90628235933,90628235938,5,3690,1815,-40
90629450195,90629450201,6,2499,1454,-40
90629708845,90629708850,5,1136,223,-40
90640984874,90640984878,4,1841,915,-40
90645173082,90645173085,3,46072,39366,-40
90645949926,90645949908,-18,2673,1653,-40
90648198840,90648198847,7,2914,1035,-40
90649276155,90649276162,7,2940,1400,-40
90650579091,90650579083,-8,46595,12424,-40
90650737037,90650737042,5,2551,1301,-40
90652628113,90652628117,4,2269,1749,-40
90654426678,90654426683,5,1948,968,-40
90654459616,90654459634,18,2175,1171,-40
90655438065,90655438058,-7,1675,7241,-40
90659824093,90659824098,5,3001,1142,-40
90661479774,90661479773,-1,1492,3135,-40
90665686452,90665686456,4,1743,1161,-40
90668419081,90668419087,6,2694,1372,-40
90676015434,90676015438,4,3249,746,-40
90678939907,90678939913,6,3041,1272,-40
90695251041,90695251047,6,2583,1041,-40
90695483004,90695483011,7,3985,1417,-40
90704721546,90704721542,-4,1097,105,-40
90709108605,90709108600,-5,2041,5452,-40
90712160343,90712160347,4,3051,2385,-40
90713723929,90713723938,9,2655,1557,-40
90714728845,90714728851,6,3232,1302,-40
90717720031,90717720037,6,2589,1266,-40
90717835302,90717835304,2,858,368,-40
90720960035,90720960040,5,2664,1768,-40
90725061187,90725061194,7,5963,2333,-40
90725179486,90725179490,4,2083,1191,-40
90731184669,90731184674,5,2862,1420,-40
90732731573,90732731579,6,2590,1584,-40
90733468655,90733468659,4,2030,1099,-40
90735520842,90735520847,5,1358,1196,-40
90736346493,90736346474,-19,1020,1128,-40
90738528095,90738528099,4,796,419,-40
90738656358,90738656362,4,1761,1349,-40
90738830930,90738830915,-15,1340,268,-40
90741337838,90741337842,4,2448,896,-40
90741386831,90741386831,0,1927,1301,-40
90743940092,90743940099,7,5460,1421,-40
90744403178,90744403179,1,894,146,-40
90753372450,90753372456,6,3071,1697,-40
90758192706,90758192710,4,1947,1474,-40
90759856110,90759856118,8,2834,1674,-40
90770437090,90770437097,7,3719,1510,-40
90771406549,90771406529,-20,1887,654,-40
90777303171,90777303177,6,2918,1362,-40
90779828980,90779828986,6,4390,1461,-40
90781230855,90781230863,8,3095,1213,-40
90781799078,90781799058,-20,1310,571,-40
90784005890,90784005897,7,2599,1235,-40
90786406516,90786406514,-2,910,1486,-40
90789478728,90789478734,6,3399,1311,-40
90794896669,90794896675,6,2254,1058,-40
90799363681,90799363684,3,1661,1139,-40
90801615393,90801615399,6,2042,1158,-40
90804520995,90804521002,7,2503,1084,-40
90806230132,90806230138,6,2842,1329,-40
90808230172,90808230177,5,1493,996,-40
90810985093,90810985099,6,2463,1024,-40
90815357138,90815357144,6,4351,1807,-40
90819713646,90819713646,0,1299,1404,-40
90821331406,90821331415,9,2602,856,-40
90824237755,90824237759,4,2438,989,-40
90824480854,90824480859,5,2419,1242,-40
90826673367,90826673365,-2,1435,2463,-40
90827672402,90827672408,6,2327,1682,-40
90829679466,90829679472,6,2514,1291,-40
90830267941,90830267942,1,1514,1349,-40
90831774510,90831774519,9,3471,1361,-40
90832113574,90832113564,-10,2657,1342,-40
90832552071,90832552077,6,2616,1466,-40
90834607121,90834607107,-14,1188,470,-40
90836252399,90836252406,7,2239,1215,-40
90836980411,90836980410,-1,927,1223,-40
90837554573,90837554578,5,1599,1407,-40
90838267752,90838267737,-15,1177,549,-40
90839524017,90839524024,7,2853,1089,-40
90841381066,90841381071,5,1844,616,-40
90843352320,90843352326,6,1970,801,-40
90848582061,90848582066,5,2972,1311,-40
90849691261,90849691257,-4,908,3528,-40
90850715756,90850715763,7,3222,1801,-40
90855781105,90855781110,5,1185,891,-40
90857224631,90857224636,5,3396,1079,-40
90857278498,90857278513,15,3305,1300,-40
90858410974,90858410982,8,2222,1067,-40
90858528477,90858528457,-20,3454,1437,-40
90859143508,90859143495,-13,1006,2754,-40
90862362389,90862362394,5,3137,1726,-40
90862550862,90862550869,7,3134,1233,-40
90865033029,90865033035,6,2123,679,-40
90866366085,90866366090,5,3688,1440,-40
90867881664,90867881650,-14,802,660,-40
90873046476,90873046482,6,3141,1443,-40
90873747803,90873747786,-17,887,504,-40
90877393911,90877393914,3,1722,1660,-40
90882158437,90882158442,5,2331,1738,-40
90886285651,90886285660,9,3278,1136,-40
90887025496,90887025491,-5,1165,3519,-40
90887459830,90887459837,7,2999,1350,-40
90890957439,90890957447,8,2911,1279,-40
90892815951,90892815957,6,2733,953,-40
90895084316,90895084323,7,11537,31333,-40
90895715890,90895715897,7,3363,1702,-40
90897250293,90897250298,5,2096,1794,-40
90899244114,90899244122,8,1813,1104,-40
90901674129,90901674135,6,2795,1799,-40
90902694833,90902694838,5,3007,1204,-40
90905881043,90905881050,7,2605,1218,-40
90906109614,90906109621,7,2787,1039,-40
90912068514,90912068519,5,1725,1941,-40
90915564095,90915564102,7,3532,1566,-40
90918336673,90918336677,4,3345,1530,-40
90921763329,90921763334,5,2608,1767,-40
90922621635,90922621640,5,2785,1641,-40
90922889190,90922889195,5,1488,773,-40
90926164538,90926164546,8,3609,1479,-40
90928179138,90928179145,7,2634,763,-40
90930902122,90930902128,6,1806,1079,-40
90931224923,90931224907,-16,1236,339,-40
90932231242,90932231249,7,4345,1290,-40
90932258166,90932258153,-13,1355,445,-40
90934765937,90934765938,1,1427,1453,-40
90934979621,90934979626,5,2208,1240,-40
90937989362,90937989366,4,2132,1342,-40
90939548986,90939548991,5,1937,1368,-40
90942649703,90942649702,-1,3906,8796,-40
90944946505,90944946515,10,12201,35370,-40
90945199924,90945199930,6,2527,1190,-40
90947908662,90947908666,4,3829,1393,-40
90951223084,90951223090,6,2527,1220,-40
90951378002,90951378008,6,2301,1266,-40
90952431727,90952431734,7,3226,1571,-40
90953835673,90953835679,6,3868,1475,-40
90955671607,90955671612,5,2468,1201,-40
90956535162,90956535166,4,1671,758,-40
90960578863,90960578862,-1,1674,1615,-40
90961028173,90961028179,6,2942,1219,-40
90961195174,90961195180,6,2723,1498,-40
90964215218,90964215222,4,1950,1396,-40
90966306594,90966306599,5,2674,1489,-40
90968676910,90968676916,6,2760,1290,-40
90978267406,90978267411,5,2374,1285,-40
90979934826,90979934826,0,1176,1487,-40
90981940297,90981940305,8,3108,1633,-40
90982158045,90982158058,13,3766,1341,-40
90983474334,90983474343,9,14,170,-40
90987346882,90987346890,8,2614,1076,-40
90987944227,90987944226,-1,1047,95,-40
90988520720,90988520729,9,902,193,-40
90989531254,90989531259,5,4068,1394,-40
90989803846,90989803851,5,3347,1353,-40
90990815014,90990815022,8,2796,1073,-40
90992655834,90992655826,-8,955,3475,-40
90994674213,90994674218,5,2981,1387,-40
90995237482,90995237487,5,3926,1797,-40
90995665000,90995665011,11,3485,53654,-40
90997171656,90997171662,6,2834,1462,-40
90997665298,90997665312,14,2508,1523,-40
90999901887,90999901896,9,2141,914,-40
91001675230,91001675237,7,3492,1306,-40
91001998589,91001998595,6,3288,1216,-40
91002715445,91002715450,5,2064,1617,-40
91011449139,91011449146,7,3750,1382,-40
91013886777,91013886785,8,2460,1104,-40
91014813086,91014813068,-18,3121,1216,-40
91016904255,91016904258,3,1060,1097,-40
91020487774,91020487775,1,2287,1391,-40
91028118538,91028118543,5,3261,1196,-40
91028323453,91028323454,1,1879,2235,-40
91033271364,91033271371,7,2757,1476,-40
91035595172,91035595178,6,3006,1582,-40
91036576640,91036576662,22,456,2032,-40
91037605079,91037605087,8,3941,1639,-40
91040068890,91040068897,7,2793,1348,-40
91041952062,91041952067,5,3061,1325,-40
91043298021,91043298028,7,2652,1191,-40
91049650736,91049650742,6,2393,1281,-40
91049797169,91049797175,6,2223,1510,-40
91053109044,91053109049,5,2780,887,-40
91055142726,91055142732,6,3173,1221,-40
91056444150,91056444154,4,2801,1749,-40
91056822730,91056822737,7,3592,1708,-40
91060277894,91060277880,-14,2208,838,-40
91061276119,91061276124,5,2058,1475,-40
91062848600,91062848602,2,1144,1454,-40
91066504562,91066504561,-1,2644,4291,-40
91068481398,91068481403,5,2558,1370,-40
91068635590,91068635597,7,2885,856,-40
91073572313,91073572319,6,2934,1140,-40
91074783330,91074783330,0,545,166,-40
91077751406,91077751414,8,3231,1334,-40
91077912409,91077912415,6,3962,1644,-40
91078109382,91078109390,8,3664,1436,-40
91086575268,91086575274,6,1581,959,-40
91087367845,91087367850,5,3185,1527,-40
91089433372,91089433378,6,3086,1261,-40
91091617033,91091617039,6,2556,809,-40
91092760217,91092760222,5,1646,1006,-40
91093155352,91093155368,16,3449,1372,-40
91094745278,91094745285,7,3694,2445,-40
91096898255,91096898260,5,1082,1014,-40
91098442336,91098442335,-1,1864,2941,-40
91098844901,91098844907,6,2642,1589,-40
91100192729,91100192734,5,2003,1207,-40
91100890638,91100890643,5,2875,1508,-40
91100943541,91100943560,19,3188,1302,-40
91102110146,91102110155,9,4528,1424,-40
91102666354,91102666357,3,2317,1369,-40
91104029258,91104029256,-2,1534,1651,-40
91104791100,91104791082,-18,1472,553,-40
91105133439,91105133446,7,3308,1086,-40
91105572723,91105572729,6,2338,1311,-40
91111798921,91111798922,1,2049,1706,-40
91115338936,91115338942,6,2564,1407,-40
91116774181,91116774188,7,2927,1088,-40
91120424181,91120424161,-20,1223,913,-40
91126987072,91126987078,6,2271,1656,-40
91129866226,91129866234,8,2777,1369,-40
91130727810,91130727817,7,2206,1189,-40
91133725449,91133725455,6,4228,1172,-40
91136269877,91136269882,5,3048,1071,-40
91141017545,91141017550,5,2692,1210,-40
91142139153,91142139159,6,2078,1350,-40
91142781746,91142781754,8,2383,1050,-40
91143752014,91143752020,6,3212,1386,-40
91145016612,91145016603,-9,1188,337,-40
91146754525,91146754522,-3,2310,5479,-40
91147053585,91147053592,7,3184,1185,-40
91150377182,91150377190,8,7833,1185,-40
91167571047,91167571053,6,3426,1580,-40
91168712322,91168712326,4,2895,1029,-40
91178992911,91178992915,4,2504,1118,-40
91181313639,91181313642,3,1965,1494,-40
91189353572,91189353579,7,2708,1537,-40
91192051492,91192051498,6,2035,1153,-40
91195645353,91195645358,5,2118,1349,-40
91199865664,91199865669,5,1584,790,-40
91204904921,91204904921,0,6461,8365,-40
91214365022,91214365029,7,2231,1051,-40
91219089141,91219089146,5,2322,1179,-40
91219985478,91219985483,5,3307,1285,-40
91224536145,91224536151,6,3103,1139,-40
91225801633,91225801633,0,1356,1610,-40
91227407584,91227407589,5,2406,1347,-40
91228769553,91228769560,7,2270,1237,-40
91231760397,91231760402,5,3164,1389,-40
91231923840,91231923847,7,2921,1172,-40
91235384866,91235384871,5,2923,1312,-40
91235956044,91235956050,6,2319,1161,-40
91238243610,91238243616,6,11069,22630,-40
91240004165,91240004171,6,2906,1256,-40
91244671858,91244671864,6,2955,1549,-40
91249904898,91249904904,6,3446,1767,-40
91251231589,91251231594,5,2959,1378,-40
91257322425,91257322431,6,2197,1139,-40
91258045827,91258045830,3,777,889,-40
91258937968,91258937974,6,1948,935,-40
91259211402,91259211411,9,3291,1224,-40
91264356680,91264356686,6,3340,1025,-40
91267459574,91267459579,5,3216,1715,-40
91267743202,91267743209,7,4159,1100,-40
91270547623,91270547631,8,2099,1331,-40
91271555759,91271555763,4,1791,1280,-40
91271846445,91271846450,5,2173,1151,-40
91274910457,91274910463,6,4045,1596,-40
91276762852,91276762857,5,3768,1089,-40
91278903673,91278903669,-4,21839,17977,-40
91283189146,91283189152,6,3515,1512,-40
91284680483,91284680491,8,2475,1129,-40
91289177293,91289177299,6,3576,1194,-40
91292743371,91292743378,7,3135,1122,-40
91292850221,91292850203,-18,1222,421,-40
91300060390,91300060398,8,3395,1364,-40
91304724466,91304724472,6,2498,1124,-40
91304933154,91304933160,6,3012,1296,-40
91306478344,91306478349,5,2628,1353,-40
91309476858,91309476854,-4,2355,5243,-40
91311677810,91311677814,4,3375,1582,-40
91313339871,91313339879,8,2650,1294,-40
91314861231,91314861210,-21,2106,1103,-40
91317316783,91317316784,1,33247,25170,-40
91317670629,91317670636,7,3199,1716,-40
91322231151,91322231158,7,3083,1352,-40
91322326745,91322326750,5,3609,1512,-40
91326295697,91326295702,5,2247,1508,-40
91330089795,91330089795,0,1865,2168,-40
91334561248,91334561253,5,2356,1437,-40
91339079607,91339079614,7,2924,1381,-40
91340336704,91340336710,6,2729,1022,-40
91340469948,91340469929,-19,2435,1050,-40
91341403786,91341403792,6,3721,1989,-40
91341546793,91341546798,5,2733,1235,-40
91342586198,91342586203,5,2339,1161,-40
91344432940,91344432946,6,2690,1086,-40
91344878286,91344878264,-22,2677,1310,-40
91345142897,91345142883,-14,1725,923,-40
91357759173,91357759179,6,3227,1263,-40
91362089308,91362089313,5,3648,1554,-40
91364971544,91364971551,7,1707,1011,-40
91367458070,91367458079,9,2761,1533,-40
91376405042,91376405047,5,2445,1432,-40
91378927984,91378927985,1,1083,1273,-40
91380621990,91380621994,4,3119,803,-40
91382320313,91382320319,6,1401,980,-40
91383931817,91383931823,6,3865,1507,-40
91391659741,91391659747,6,3869,1148,-40
91393661486,91393661493,7,2302,1267,-40
91394263929,91394263913,-16,1889,1566,-40
91400340637,91400340644,7,1944,915,-40
91404765165,91404765150,-15,1269,457,-40
91405472593,91405472598,5,2684,629,-40
91406055896,91406055913,17,3005,1013,-40
91410202880,91410202885,5,3078,1390,-40
91418819262,91418819262,0,892,1208,-40
91420488217,91420488223,6,2668,1082,-40
91421520793,91421520799,6,8653,3670,-40
91424109104,91424109110,6,2993,1244,-40
91425094473,91425094478,5,2759,1350,-40
91426653272,91426653278,6,2261,1249,-40
91430652575,91430652579,4,2861,1435,-40
91432801795,91432801802,7,3968,1956,-40
91435931870,91435931877,7,2415,826,-40
91446367241,91446367247,6,3917,1513,-40
91448114962,91448114969,7,3261,1379,-40
91448349326,91448349330,4,1103,181,-40
91448894422,91448894444,22,909,12,-40
91449550676,91449550682,6,2520,1534,-40
91451707813,91451707819,6,3875,1205,-40
91452094190,91452094197,7,2309,1258,-40
91454936198,91454936204,6,3398,1314,-40
91460434232,91460434238,6,2180,1199,-40
91468006311,91468006317,6,3087,1554,-40
91469817321,91469817327,6,2279,964,-40
91470133234,91470133238,4,2454,1326,-40
91472349754,91472349761,7,2532,1346,-40
91476526922,91476526927,5,2035,992,-40
91477112190,91477112196,6,2304,950,-40
91482618087,91482618092,5,2895,1223,-40
91485016245,91485016250,5,3151,1268,-40
91485412945,91485412951,6,4330,1864,-40
91489721544,91489721531,-13,1770,1585,-40
91495005856,91495005852,-4,47083,27737,-40
91495923947,91495923954,7,3077,1389,-40
91498534880,91498534887,7,2968,1323,-40
91499200433,91499200441,8,2185,1337,-40
91500085379,91500085386,7,4134,2263,-40
91502211074,91502211082,8,2741,1143,-40
91503305167,91503305170,3,2333,963,-40
91503655430,91503655438,8,3944,1252,-40
91509481422,91509481428,6,3583,1503,-40
91510592574,91510592582,8,2794,1136,-40
91512683393,91512683398,5,3025,1006,-40
91512784225,91512784231,6,2732,1382,-40
91519276169,91519276176,7,2986,1404,-40
91520695571,91520695578,7,2387,1080,-40
91521153890,91521153897,7,3685,1554,-40
91522060285,91522060291,6,3219,1343,-40
91523681158,91523681165,7,3290,1687,-40
91529690582,91529690591,9,2736,1432,-40
91532552470,91532552475,5,3002,1698,-40
91533266004,91533266001,-3,2177,4413,-40
91533510558,91533510565,7,3988,1392,-40
91534728530,91534728535,5,2512,1096,-40
91544384955,91544384962,7,2571,1136,-40
91550653105,91550653111,6,1464,537,-40
91561730987,91561730994,7,2989,1499,-40
91568737439,91568737445,6,5233,2485,-40
91576547378,91576547386,8,2997,1519,-40
91577115313,91577115296,-17,1666,467,-40
91577529359,91577529366,7,3211,1293,-40
91578257386,91578257389,3,4662,3934,-40
91580958267,91580958274,7,3248,1346,-40
91581184171,91581184178,7,1621,1103,-40
91583459285,91583459290,5,4232,1563,-40
91584199267,91584199281,14,3023,944,-40
91584476977,91584476987,10,2667,1031,-40
91585953490,91585953497,7,3203,1591,-40
91589471885,91589471890,5,2330,1561,-40
91592286962,91592286969,7,2964,987,-40
91594106682,91594106672,-10,844,162,-40
91595811260,91595811283,23,944,112,-40
91596363203,91596363208,5,1991,1103,-40
91599938761,91599938766,5,2722,1316,-40
91602245544,91602245550,6,2236,1302,-40
91605754830,91605754829,-1,872,2176,-40
91610677473,91610677478,5,3772,1351,-40
91611173405,91611173412,7,2857,1418,-40
91613917702,91613917684,-18,909,462,-40
91617689762,91617689766,4,3490,966,-40
91618987301,91618987282,-19,2486,969,-40
91621014616,91621014621,5,2049,1305,-40
91621835374,91621835379,5,3345,1678,-40
91624824774,91624824781,7,2397,1577,-40
91629879362,91629879361,-1,2150,3280,-40
91631506507,91631506514,7,2318,713,-40
91633681446,91633681451,5,3277,1631,-40
91634488747,91634488754,7,4426,1482,-40
91636756706,91636756714,8,2311,1225,-40
91637398846,91637398850,4,2660,1406,-40
91643399904,91643399907,3,2271,998,-40
91647891517,91647891522,5,2840,1518,-40
91649711171,91649711178,7,1608,1105,-40
91650651612,91650651617,5,2399,1125,-40
91656238373,91656238379,6,2133,1122,-40
91657040386,91657040393,7,3999,1261,-40
91657972170,91657972175,5,2361,765,-40
91665474749,91665474756,7,5340,2824,-40
91669198533,91669198527,-6,1735,32671,-40
91669538730,91669538714,-16,938,134,-40
91673382110,91673382116,6,2013,1185,-40
91675718570,91675718574,4,2380,1224,-40
91678812927,91678812934,7,2571,1359,-40
91683125719,91683125726,7,3801,1197,-40
91684988670,91684988676,6,2682,879,-40
91686380622,91686380601,-21,689,424,-40
91690059417,91690059423,6,3802,1198,-40
91694336957,91694336963,6,3377,1482,-40
91696226745,91696226741,-4,1548,3926,-40
91702293322,91702293320,-2,4933,8408,-40
91705173286,91705173291,5,3025,1423,-40
91705557980,91705557998,18,780,1803,-40
91706761093,91706761098,5,2762,1365,-40
91713393386,91713393390,4,2674,1032,-40
91718002169,91718002174,5,2174,1435,-40
91723826099,91723826097,-2,1096,1447,-40
91727465829,91727465835,6,2468,956,-40
91729469813,91729469818,5,2354,887,-40
91730248406,91730248413,7,2431,1368,-40
91733368911,91733368916,5,2103,1058,-40
91735881070,91735881077,7,3646,1519,-40
91746175618,91746175622,4,1939,1082,-40
91748407445,91748407451,6,3063,1263,-40
91749994182,91749994187,5,1802,1239,-40
91750783851,91750783858,7,2555,1161,-40
91758519124,91758519131,7,3073,1467,-40
91758738754,91758738753,-1,2048,3575,-40
91766696983,91766696985,2,26993,24287,-40
91767573226,91767573232,6,2686,1438,-40
91771166045,91771166063,18,578,3369,-40
91771662877,91771662884,7,2365,1441,-40
91777585571,91777585577,6,2456,1265,-40
91780649326,91780649331,5,3718,1354,-40
91790676765,91790676770,5,1379,945,-40
91796630342,91796630334,-8,26443,15435,-40
91797625218,91797625225,7,3719,1572,-40
91798570006,91798569999,-7,885,4715,-40
91802068867,91802068869,2,980,1223,-40
91802278083,91802278079,-4,1128,2994,-40
91802648645,91802648641,-4,1920,5314,-40
91802929774,91802929782,8,3437,763,-40
91811161273,91811161279,6,2210,1031,-40
91812417321,91812417327,6,3725,1386,-40
91813166951,91813166958,7,2117,953,-40
91813965110,91813965117,7,3333,1224,-40
91814151218,91814151225,7,2434,1278,-40
91815083167,91815083171,4,2603,1251,-40
91815339875,91815339883,8,2632,794,-40
91821074485,91821074490,5,3202,1228,-40
91822240829,91822240835,6,2366,908,-40
91822330122,91822330136,14,3917,2011,-40
91823040280,91823040286,6,2630,1252,-40
91823472221,91823472226,5,2910,1126,-40
91832614190,91832614198,8,2920,1342,-40
91834982630,91834982637,7,2557,1644,-40
91835419318,91835419325,7,2943,1110,-40
91835619541,91835619549,8,2882,1386,-40
91838058794,91838058799,5,2268,1175,-40
91838663441,91838663428,-13,1717,302,-40
91840972455,91840972459,4,1930,1135,-40
91841410499,91841410484,-15,4676,1390,-40
91846175345,91846175347,2,13373,9116,-40
91846916491,91846916496,5,2147,1328,-40
91847470147,91847470153,6,3128,1075,-40
91848790071,91848790077,6,3219,1365,-40
91853018179,91853018178,-1,1134,1010,-40
91857009606,91857009612,6,3415,1370,-40
91859501600,91859501607,7,1940,1055,-40
91859616485,91859616490,5,1073,225,-40
91861007369,91861007375,6,2768,1136,-40
91865635802,91865635809,7,6101,1530,-40
91867935512,91867935518,6,3213,1200,-40
91869705246,91869705252,6,3511,1221,-40
91871166440,91871166447,7,3171,1210,-40
91871836239,91871836246,7,2487,816,-40
91874959377,91874959384,7,2499,1213,-40
91879013740,91879013745,5,2099,1401,-40
91879783403,91879783409,6,2863,1079,-40
91880081940,91880081947,7,3524,1426,-40
91883275981,91883275989,8,3569,1653,-40
91884563068,91884563075,7,2673,1244,-40
91884920139,91884920124,-15,1288,495,-40
91885368205,91885368212,7,2734,1225,-40
91885439433,91885439416,-17,2013,919,-40
91888880481,91888880487,6,2116,1439,-40
91888911489,91888911494,5,1208,1161,-40
91889738486,91889738492,6,2794,1541,-40
91889951348,91889951346,-2,884,1577,-40
91891334509,91891334507,-2,1272,565,-40
91892044736,91892044742,6,2590,959,-40
91892437273,91892437260,-13,1166,341,-40
91900394315,91900394322,7,2796,1363,-40
91903242805,91903242810,5,2347,740,-40
91908729265,91908729271,6,2287,1588,-40
91909734842,91909734848,6,2236,794,-40
91915869322,91915869330,8,3840,1168,-40
91919241914,91919241920,6,2834,1226,-40
91922065767,91922065774,7,2564,977,-40
91926272294,91926272302,8,2834,1022,-40
91931707753,91931707746,-7,1148,3554,-40
91932958939,91932958946,7,3527,1398,-40
91934500910,91934500915,5,3441,1148,-40
91935074119,91935074126,7,1900,1332,-40
91935220476,91935220498,22,3168,1473,-40
91935319209,91935319215,6,2920,1363,-40
91940256919,91940256914,-5,857,2998,-40
91949851210,91949851214,4,1546,937,-40
91951065757,91951065757,0,864,1628,-40
91953019594,91953019597,3,2037,956,-40
91961367472,91961367478,6,6540,2722,-40
91962016394,91962016401,7,2478,1517,-40
91962816321,91962816323,2,1045,1122,-40
91963629586,91963629592,6,12312,24967,-40
91968651904,91968651909,5,2260,904,-40
91969480742,91969480750,8,2137,1156,-40
91970834042,91970834049,7,2813,1398,-40
91976353638,91976353644,6,2300,1085,-40
91977176892,91977176899,7,2829,919,-40
91978065338,91978065343,5,2420,1133,-40
91978564650,91978564654,4,3783,1373,-40
91979790350,91979790358,8,3174,1414,-40
91980823736,91980823741,5,2310,1105,-40
91981556747,91981556754,7,2885,1264,-40
91989958343,91989958351,8,2730,955,-40
91997179805,91997179811,6,1363,787,-40
92003698594,92003698599,5,1952,987,-40
92005033213,92005033212,-1,1806,3242,-40
92012779678,92012779683,5,2705,1087,-40
92015216041,92015216046,5,2972,1275,-40
92016098192,92016098198,6,3006,1356,-40
92018832526,92018832531,5,2333,1138,-40
92020773193,92020773201,8,2037,653,-40
92021224791,92021224795,4,1303,886,-40
92021280022,92021280019,-3,1147,280,-40
92021600694,92021600698,4,1371,394,-40
92022982839,92022982819,-20,996,510,-40
92024277249,92024277257,8,2183,1235,-40
92024801601,92024801584,-17,1101,88,-40
92029035004,92029035026,22,876,5404,-40
92030805871,92030805878,7,2780,1257,-40
92031451387,92031451389,2,1041,549,-40
92034296901,92034296907,6,2892,1188,-40
92034459778,92034459785,7,3868,1633,-40
92036637031,92036637038,7,2921,1130,-40
92036706906,92036706911,5,2980,1758,-40
92037438510,92037438518,8,2933,1570,-40
92045393742,92045393738,-4,1235,3785,-40
92046744576,92046744582,6,2820,1595,-40
92047309922,92047309920,-2,1288,1779,-40
92053088229,92053088236,7,3493,1406,-40
92054032105,92054032110,5,1831,1233,-40
92054309962,92054309969,7,2670,1168,-40
92054338444,92054338451,7,2569,1314,-40
92057850919,92057850918,-1,1088,741,-40
92061615482,92061615490,8,3321,1567,-40
92067040269,92067040276,7,2845,1100,-40
92076226181,92076226186,5,2541,1303,-40
92078286769,92078286775,6,2623,876,-40
92080454506,92080454510,4,2464,1535,-40
92083954934,92083954935,1,2317,2079,-40
92085435766,92085435772,6,2291,936,-40
92087969014,92087969019,5,2693,832,-40
92088035389,92088035395,6,2538,1410,-40
92091246458,92091246463,5,2050,1666,-40
92095540246,92095540250,4,4449,3677,-40
92098912889,92098912894,5,4387,1767,-40
92098959814,92098959818,4,2594,1461,-40
92100510049,92100510054,5,2574,1202,-40
92100847463,92100847466,3,594,323,-40
92101051261,92101051266,5,1066,900,-40
92110871726,92110871731,5,2850,1439,-40
92113665961,92113665966,5,2110,950,-40
92114907134,92114907121,-13,4752,1125,-40
92114979894,92114979874,-20,832,376,-40
92116513382,92116513387,5,2560,1124,-40
92116736814,92116736802,-12,2190,801,-40
92118165639,92118165648,9,3850,1549,-40
92118491464,92118491459,-5,1304,2152,-40
92123438563,92123438569,6,3244,1190,-40
92126278202,92126278209,7,2250,962,-40
92127208649,92127208654,5,2216,1673,-40
92127288371,92127288378,7,3433,1365,-40
92127422583,92127422560,-23,1120,343,-40
92128715881,92128715887,6,3272,1569,-40
92129265773,92129265781,8,3179,1246,-40
92134880119,92134880122,3,2886,1190,-40
92138251802,92138251810,8,4456,1632,-40
92142475561,92142475566,5,1794,1038,-40
92145261573,92145261578,5,1962,907,-40
92151351253,92151351261,8,4585,1272,-40
92152632913,92152632921,8,2588,1310,-40
92154685681,92154685687,6,2837,943,-40
92156201524,92156201527,3,1837,2127,-40
92166139897,92166139903,6,2232,1534,-40
92167319490,92167319497,7,2904,1567,-40
92169948384,92169948390,6,2803,1139,-40
92172626855,92172626861,6,3323,1401,-40
92175075350,92175075358,8,4620,2131,-40
92176918186,92176918193,7,2524,1316,-40
92177960605,92177960610,5,3259,930,-40
92179250693,92179250694,1,28400,21005,-40
92182777214,92182777217,3,1001,978,-40
92183968865,92183968871,6,3236,1452,-40
92184807585,92184807591,6,3282,1046,-40
92185446113,92185446120,7,2894,1498,-40
92185577315,92185577331,16,1051,83,-40
92186546681,92186546687,6,3151,1390,-40
92189310250,92189310255,5,3134,1526,-40
92190717199,92190717205,6,3807,1618,-40
92196743986,92196743988,2,2047,1842,-40
92198021829,92198021835,6,2302,1306,-40
92201720948,92201720954,6,3122,1174,-40
92208387523,92208387530,7,2945,1108,-40
92208719572,92208719577,5,2586,1396,-40
92212344925,92212344931,6,3225,1525,-40
92213140638,92213140643,5,2048,1229,-40
92217395746,92217395751,5,2148,794,-40
92219089174,92219089177,3,25449,16088,-40
92220518466,92220518471,5,2181,1427,-40
92221620018,92221620025,7,2929,1424,-40
92222645888,92222645894,6,2826,1275,-40
92223812798,92223812806,8,1770,874,-40
92223924077,92223924091,14,2821,1380,-40
92224926398,92224926403,5,2223,942,-40
92228523661,92228523665,4,1269,933,-40
92235472654,92235472662,8,2893,1138,-40
92236904873,92236904881,8,2684,1142,-40
92245190057,92245190062,5,3791,1387,-40
92248687818,92248687825,7,2280,1276,-40
92251966437,92251966444,7,2017,1225,-40
92254302418,92254302425,7,2821,1745,-40
92261899285,92261899293,8,2498,1071,-40
92264088154,92264088159,5,2179,1041,-40
92267399641,92267399647,6,1277,593,-40
92269509233,92269509243,10,2365,992,-40
92270475150,92270475156,6,2629,1156,-40
92270645279,92270645289,10,2877,1282,-40
92274524001,92274524006,5,2450,983,-40
92278997003,92278997010,7,2630,1146,-40
92285349227,92285349247,20,309,1913,-40
92286059531,92286059535,4,1373,920,-40
92289265273,92289265279,6,2508,1084,-40
92293212697,92293212702,5,2845,1496,-40
92293261654,92293261633,-21,972,669,-40
92296331455,92296331462,7,3599,1697,-40
92297649197,92297649203,6,2541,1024,-40
92300054489,92300054494,5,2856,1083,-40
92303831795,92303831799,4,2006,37688,-40
92304609629,92304609635,6,2870,1146,-40
92305126133,92305126138,5,1560,771,-40
92309824607,92309824602,-5,1072,2292,-40
92311352082,92311352087,5,2448,880,-40
92317526573,92317526579,6,3224,1749,-40
92319584928,92319584932,4,2212,1602,-40
92324193785,92324193790,5,3604,1245,-40
92326837902,92326837908,6,3488,1987,-40
92328012755,92328012760,5,1634,958,-40
92329268793,92329268799,6,2109,623,-40
92334070071,92334070069,-2,5154,9916,-40
92337636449,92337636454,5,2718,1546,-40
92347405597,92347405602,5,3274,989,-40
92347438932,92347438939,7,3753,1695,-40
92354712346,92354712351,5,2471,1143,-40
92356889719,92356889717,-2,1199,1859,-40
92357224775,92357224782,7,2796,1185,-40
92360236936,92360236943,7,2322,1435,-40
92361513337,92361513342,5,2088,1171,-40
92364698014,92364698019,5,3491,1305,-40
92367123081,92367123088,7,2825,1116,-40
92371504865,92371504871,6,2446,1419,-40
92373038729,92373038735,6,2242,1460,-40
92373110322,92373110323,1,1676,220,-40
92374561481,92374561487,6,3327,1446,-40
92376443280,92376443286,6,2875,1298,-40
92377797359,92377797365,6,2127,1188,-40
92378687565,92378687571,6,1851,490,-40
92382087287,92382087293,6,2137,1287,-40
92382198932,92382198914,-18,3527,1550,-40
92382523796,92382523801,5,3414,1637,-40
92385461493,92385461498,5,1112,960,-40
92386328474,92386328481,7,2920,1310,-40
92386656654,92386656633,-21,1867,961,-40
92386719659,92386719665,6,2692,1378,-40
92402887510,92402887516,6,2039,1036,-40
92403387231,92403387238,7,1568,967,-40
92404498546,92404498553,7,2129,1284,-40
92411232017,92411232021,4,2639,1770,-40
92413420043,92413420049,6,4042,1418,-40
92413502030,92413502009,-21,2261,950,-40
92414489806,92414489813,7,3341,1280,-40
92414650026,92414650011,-15,1549,433,-40
92416807507,92416807514,7,2977,1147,-40
92417472521,92417472527,6,3610,1326,-40
92419657774,92419657779,5,2851,1308,-40
92419809249,92419809258,9,2654,1427,-40
92421606686,92421606693,7,3259,1422,-40
92423515542,92423515549,7,2716,1075,-40
92424390921,92424390926,5,2768,1326,-40
92426418716,92426418722,6,2898,1357,-40
92428785098,92428785077,-21,597,159,-40
92432301666,92432301674,8,2075,1185,-40
92433641540,92433641546,6,2965,1606,-40
92438960647,92438960653,6,4602,1556,-40
92438986077,92438986084,7,2194,1084,-40
92439457049,92439457036,-13,2588,887,-40
92439636453,92439636456,3,2399,1456,-40
92442066445,92442066452,7,2576,1373,-40
92444597841,92444597847,6,2650,964,-40
92445150989,92445150968,-21,1486,229,-40
92455381812,92455381819,7,2745,1341,-40
92455629619,92455629626,7,2621,1041,-40
92456918382,92456918388,6,4606,1816,-40
92457226187,92457226185,-2,890,314,-40
92457328230,92457328212,-18,1608,956,-40
92461991762,92461991770,8,3025,1198,-40
92463797014,92463797018,4,2286,1438,-40
92463913937,92463913921,-16,2528,1500,-40
92467354249,92467354254,5,3020,1321,-40
92467810093,92467810099,6,3399,1469,-40
92467929964,92467929969,5,2509,1040,-40
92470348329,92470348333,4,1711,1332,-40
92470555085,92470555084,-1,1137,1228,-40
92471663528,92471663533,5,3060,1664,-40
92472059621,92472059626,5,2890,1599,-40
92477849577,92477849581,4,2940,1306,-40
92478248066,92478248070,4,1955,1828,-40
92479104758,92479104763,5,3438,1231,-40
92481315150,92481315155,5,2060,837,-40
92491033055,92491033053,-2,1426,2682,-40
92493061440,92493061445,5,3176,1516,-40
92499010800,92499010803,3,1694,1522,-40
92500944953,92500944958,5,2425,1219,-40
92501815027,92501815034,7,3231,1198,-40
92507572301,92507572306,5,1643,1020,-40
92507654539,92507654554,15,1933,1205,-40
92513477450,92513477457,7,2984,1138,-40
92522611414,92522611421,7,2377,905,-40
92524595699,92524595705,6,2501,776,-40
92525396993,92525396993,0,1958,2317,-40
92526071314,92526071311,-3,2560,5585,-40
92528780225,92528780225,0,1538,1860,-40
92532789170,92532789171,1,1696,1556,-40
92536946919,92536946915,-4,1813,2088,-40
92538771821,92538771828,7,3411,1390,-40
92539176957,92539176963,6,3239,1424,-40
92541683087,92541683093,6,1263,1155,-40
92543413006,92543412987,-19,982,464,-40
92545237580,92545237586,6,3161,1142,-40
92550222063,92550222070,7,2841,1112,-40
92551202799,92551202805,6,3011,1427,-40
92553561394,92553561401,7,2513,844,-40
92558736014,92558736019,5,2314,1333,-40
92565744881,92565744889,8,2852,1217,-40
92567051567,92567051573,6,2319,1114,-40
92569591182,92569591189,7,1855,1119,-40
92569950583,92569950587,4,741,229,-40
92571608451,92571608457,6,3064,1012,-40
92577803638,92577803646,8,3139,1287,-40
92580875984,92580875990,6,2604,999,-40
92580909871,92580909876,5,2829,1021,-40
92581232215,92581232221,6,3283,1519,-40
92585454075,92585454079,4,1872,1204,-40
92590259198,92590259202,4,2785,1340,-40
92590341661,92590341642,-19,2015,773,-40
92590424124,92590424130,6,1896,983,-40
92591023189,92591023187,-2,3093,4948,-40
92594829354,92594829359,5,2641,883,-40
92597019025,92597019031,6,2590,791,-40
92598699605,92598699610,5,2460,1289,-40
92599732146,92599732152,6,3312,1453,-40
92599926138,92599926148,10,2169,944,-40
92600983901,92600983906,5,2318,1443,-40
92601100963,92601100971,8,2992,1154,-40
92604436058,92604436065,7,2989,1175,-40
92605295503,92605295508,5,1591,799,-40
92607186750,92607186756,6,2249,950,-40
92608515488,92608515494,6,2361,928,-40
92610587462,92610587464,2,3892,3420,-40
92611559281,92611559279,-2,1349,1728,-40
92620115269,92620115275,6,2995,1368,-40
92620399274,92620399279,5,3188,1267,-40
92620791313,92620791322,9,3476,1329,-40
92625054870,92625054875,5,2408,875,-40
92625863013,92625863018,5,3609,1412,-40
92630245578,92630245586,8,1845,691,-40
92630339080,92630339085,5,2015,1237,-40
92631898931,92631898916,-15,876,322,-40
92634579728,92634579730,2,3547,3150,-40
92634829373,92634829381,8,3723,1100,-40
92635012309,92635012331,22,603,311,-40
92636287671,92636287677,6,4385,1954,-40
92637936131,92637936139,8,2680,1595,-40
92647561051,92647561050,-1,804,14626,-40
92649873182,92649873189,7,2160,1048,-40
92650464239,92650464246,7,2647,1466,-40
92655002390,92655002395,5,2246,1541,-40
92655362808,92655362814,6,3174,824,-40
92659485955,92659485961,6,2749,1062,-40
92660631127,92660631134,7,3449,1615,-40
92661352485,92661352491,6,2157,1164,-40
92662199838,92662199845,7,3445,1623,-40
92668432001,92668432009,8,4053,1624,-40
92671308254,92671308257,3,2846,2019,-40
92679540150,92679540154,4,2651,1044,-40
92679945627,92679945635,8,3586,1515,-40
92680697171,92680697178,7,4226,1233,-40
92682925969,92682925977,8,3428,1263,-40
92683339551,92683339557,6,1468,655,-40
92684116952,92684116959,7,2800,1171,-40
92684501891,92684501898,7,3577,1021,-40
92688381441,92688381448,7,3310,1889,-40
92690155926,92690155933,7,1484,663,-40
92693024572,92693024575,3,1444,1440,-40
92693901238,92693901245,7,2720,1537,-40
92696082542,92696082549,7,1333,983,-40
92703070303,92703070309,6,2524,881,-40
92703685513,92703685499,-14,1533,469,-40
92703886406,92703886411,5,3001,2212,-40
92708068522,92708068529,7,2675,1303,-40
92708798402,92708798406,4,3151,1001,-40
92709005561,92709005561,0,1182,1568,-40
92714006030,92714006045,15,1062,238,-40
92717547293,92717547299,6,2261,1236,-40
92728949809,92728949830,21,961,2535,-40
92731017626,92731017633,7,3312,1620,-40
92731537117,92731537123,6,2818,874,-40
92733005283,92733005290,7,3308,1837,-40
92733148590,92733148598,8,2522,1142,-40
92736882687,92736882694,7,4051,1681,-40
92740595511,92740595506,-5,1278,4149,-40
92741846549,92741846554,5,1602,693,-40
92742122273,92742122290,17,3235,1112,-40
92742783215,92742783227,12,929,192,-40
92743511598,92743511579,-19,2649,988,-40
92744198631,92744198638,7,2036,836,-40
92746752985,92746752964,-21,200,5799,-40
92748772319,92748772328,9,30949,5195,-40
92749579066,92749579074,8,4542,1663,-40
92749696334,92749696314,-20,836,226,-40
92754847522,92754847529,7,2675,1327,-40
92758646761,92758646762,1,12111,13863,-40
92760621830,92760621837,7,1989,956,-40
92761025086,92761025105,19,1039,286,-40
92763763824,92763763830,6,3498,2010,-40
92765345597,92765345602,5,2731,1026,-40
92774506459,92774506467,8,2370,951,-40
92777970202,92777970206,4,1974,1303,-40
92778411419,92778411426,7,2481,1267,-40
92780672548,92780672554,6,2446,1453,-40
92781059427,92781059432,5,1950,1023,-40
92786098417,92786098423,6,2763,1474,-40
92786868852,92786868859,7,3180,1244,-40
92788793610,92788793617,7,3757,1353,-40
92789337407,92789337386,-21,2577,1169,-40
92790272010,92790272016,6,2312,1221,-40
92792880615,92792880622,7,3674,1327,-40
92798244466,92798244472,6,2358,831,-40
92802416734,92802416727,-7,1916,5162,-40
92805701128,92805701123,-5,1208,3972,-40
92809843874,92809843878,4,2248,1249,-40
92812922789,92812922794,5,3180,1203,-40
92815385577,92815385583,6,3004,1410,-40
92815511469,92815511475,6,3215,1090,-40
92823236229,92823236234,5,1783,1005,-40
92826124830,92826124839,9,3355,1443,-40
92826479069,92826479076,7,2750,1063,-40
92827895699,92827895706,7,1583,872,-40
92828203202,92828203219,17,1008,138,-40
92831533356,92831533362,6,3303,1198,-40
92836092969,92836092975,6,2726,779,-40
92841850470,92841850476,6,2932,1466,-40
92847792018,92847792025,7,3122,1355,-40
92848914482,92848914487,5,3462,2149,-40
92850097309,92850097314,5,2425,1179,-40
92850216288,92850216294,6,2331,1181,-40
92850759931,92850759914,-17,673,313,-40
92855442702,92855442709,7,1974,804,-40
92856674981,92856674986,5,3579,1331,-40
92858362151,92858362155,4,2221,1396,-40
92859695765,92859695757,-8,1099,3769,-40
92870148214,92870148220,6,2786,950,-40
92870438994,92870438994,0,1397,2391,-40
92871254465,92871254470,5,3108,1309,-40
92877125133,92877125138,5,2483,1153,-40
92877910092,92877910098,6,2411,1696,-40
92878041685,92878041690,5,2559,1384,-40
92886301514,92886301522,8,4133,903,-40
92886536657,92886536662,5,2625,1971,-40
92888854763,92888854767,4,2076,950,-40
92890552121,92890552128,7,3402,915,-40
92891193317,92891193322,5,1494,1169,-40
92893122837,92893122843,6,3048,1363,-40
92893518600,92893518606,6,2935,1196,-40
92893658037,92893658017,-20,663,322,-40
92895594765,92895594771,6,2589,1197,-40
92907362226,92907362233,7,3833,1202,-40
92908667141,92908667149,8,3381,1009,-40
92910952936,92910952943,7,3684,1215,-40
92911750993,92911751000,7,4831,1822,-40
92913573168,92913573174,6,2935,1348,-40
92914455001,92914455009,8,3553,1308,-40
92917188517,92917188523,6,2129,663,-40
92919542738,92919542746,8,2320,1103,-40
92922867906,92922867911,5,1153,574,-40
92927336309,92927336316,7,2364,1239,-40
92927922755,92927922762,7,3954,895,-40
92929977564,92929977568,4,1420,997,-40
92931205285,92931205291,6,2611,1336,-40
92931687933,92931687939,6,2992,905,-40
92932510883,92932510889,6,3677,1824,-40
92933066011,92933066018,7,1076,549,-40
92934111050,92934111057,7,2473,1158,-40
92939545420,92939545426,6,2475,1259,-40
92949269608,92949269614,6,2273,1148,-40
92958507923,92958507930,7,3019,1572,-40
92961941518,92961941525,7,2991,1513,-40
92962361269,92962361276,7,3155,1409,-40
92962497015,92962496992,-23,1478,296,-40
92964575631,92964575638,7,2866,1015,-40
92965844296,92965844278,-18,2241,31590,-40
92967739638,92967739645,7,2311,1148,-40
92969020629,92969020633,4,1689,998,-40
92971296626,92971296634,8,3561,1483,-40
92974616866,92974616872,6,2654,1121,-40
92985847278,92985847285,7,3574,917,-40
92986017834,92986017848,14,2972,1476,-40
92987896842,92987896843,1,1641,1801,-40
93003085870,93003085877,7,2883,1433,-40
93004528378,93004528386,8,2957,1183,-40
93007229668,93007229675,7,1897,792,-40
93010517111,93010517117,6,3310,2005,-40
93012606682,93012606688,6,3591,1801,-40
93014805792,93014805812,20,806,343,-40
93017102837,93017102842,5,1674,1447,-40
93029035156,93029035162,6,3569,1119,-40
93033686760,93033686768,8,2830,1018,-40
93034540984,93034540990,6,2731,1123,-40
93034724941,93034724947,6,1741,987,-40
93036860310,93036860317,7,2501,914,-40
93039679641,93039679646,5,2521,1750,-40
93044727829,93044727834,5,1750,1077,-40
93045587981,93045587986,5,2569,1195,-40
93047995463,93047995463,0,1732,1241,-40
93063187010,93063187016,6,1870,1246,-40
93070463567,93070463563,-4,794,264,-40
93073990317,93073990323,6,1821,1420,-40
93075666455,93075666460,5,2580,1185,-40
93076588276,93076588283,7,2203,1088,-40
93078752171,93078752177,6,3761,1602,-40
93079682525,93079682531,6,1773,1148,-40
93090480902,93090480909,7,5580,1820,-40
93094028181,93094028186,5,3233,1330,-40
93096830207,93096830211,4,2574,897,-40
93096921966,93096921972,6,2489,1158,-40
93097730889,93097730870,-19,1453,628,-40
93101207759,93101207766,7,4512,1525,-40
93106116125,93106116134,9,3436,969,-40
93108375257,93108375263,6,2423,1486,-40
93111021405,93111021411,6,3913,1678,-40
93111191570,93111191575,5,2074,1048,-40
93111438057,93111438063,6,2838,1362,-40
93112703818,93112703813,-5,1058,3052,-40
93123614257,93123614263,6,2853,1225,-40
93134545836,93134545842,6,2128,1385,-40
93136892529,93136892534,5,2443,1110,-40
93144733226,93144733230,4,1421,1107,-40
93145231595,93145231592,-3,775,2067,-40
93145717818,93145717825,7,3376,1158,-40
93146276231,93146276235,4,1061,120,-40
93148608036,93148608043,7,2883,1757,-40
93149508750,93149508756,6,3438,1455,-40
93151052949,93151052955,6,2921,1058,-40
93152905211,93152905217,6,2652,1372,-40
93155379690,93155379697,7,2903,1038,-40
93159537469,93159537476,7,3999,1016,-40
93161319386,93161319392,6,3484,1147,-40
93166574633,93166574633,0,2530,3819,-40
93171981142,93171981150,8,2725,901,-40
93178164749,93178164754,5,2835,1267,-40
93179643725,93179643729,4,1997,1456,-40
93181071699,93181071706,7,2288,1298,-40
93181902548,93181902554,6,3488,1183,-40
93185685984,93185685991,7,2193,794,-40
93186245673,93186245675,2,2570,3201,-40
93193188981,93193188985,4,1336,1037,-40
93195671885,93195671891,6,2511,1266,-40
93195750989,93195750979,-10,1009,189,-40
93195777680,93195777698,18,1081,69,-40
93199017321,93199017326,5,3387,749,-40
93199652873,93199652879,6,3378,1745,-40
93200009182,93200009185,3,1751,1549,-40
93200166424,93200166430,6,2140,1339,-40
93202679359,93202679364,5,2475,1294,-40
93203929647,93203929642,-5,2045,7544,-40
93210189927,93210189934,7,2912,1482,-40
93211798297,93211798295,-2,1201,1916,-40
93220062889,93220062894,5,2931,1500,-40
93220315474,93220315490,16,471,429,-40
93223923484,93223923490,6,2904,1069,-40
93224270874,93224270890,16,2940,1361,-40
93226728650,93226728657,7,2669,1778,-40
93226881243,93226881245,2,1557,1429,-40
93228704576,93228704582,6,2162,1054,-40
93235151458,93235151466,8,7966,1093,-40
93235252254,93235252260,6,4118,1676,-40
93237331169,93237331174,5,1698,883,-40
93237859230,93237859235,5,3193,1290,-40
93241624124,93241624130,6,3762,1781,-40
93245684423,93245684430,7,3384,1229,-40
93251724132,93251724135,3,1607,980,-40
93253463532,93253463539,7,2671,1140,-40
93258192347,93258192353,6,2871,1097,-40
93261110909,93261110916,7,3502,1505,-40
93261575127,93261575133,6,2434,1141,-40
93263321889,93263321897,8,4245,1602,-40
93263688318,93263688323,5,2581,1370,-40
93265842811,93265842809,-2,619,2205,-40
93266025021,93266025026,5,2589,1475,-40
93268206618,93268206620,2,3162,3028,-40
93269755785,93269755790,5,2309,1256,-40
93277859420,93277859426,6,3014,1877,-40
93283457364,93283457370,6,2153,1477,-40
93285834121,93285834125,4,2351,1058,-40
93299688238,93299688244,6,3058,1290,-40
93299790567,93299790554,-13,1239,313,-40
93304142233,93304142238,5,3666,1881,-40
93306546007,93306546005,-2,1602,2117,-40
93307344893,93307344898,5,2338,1099,-40
93308362882,93308362886,4,3161,1414,-40
93311607730,93311607734,4,3377,1193,-40
93313344941,93313344946,5,2835,1265,-40
93313557897,93313557903,6,2744,828,-40
93316970541,93316970546,5,2078,1172,-40
93318948281,93318948287,6,2964,1315,-40
93321250499,93321250507,8,3882,1332,-40
93324662474,93324662478,4,2588,1258,-40
93325919465,93325919469,4,2828,973,-40
93330091983,93330091988,5,3230,885,-40
93331577282,93331577294,12,13172,23120,-40
93331655199,93331655204,5,1723,835,-40
93331779233,93331779238,5,2102,1314,-40
93333725469,93333725476,7,2765,1360,-40
93339772293,93339772295,2,1555,1780,-40
93343280050,93343280056,6,2510,1834,-40
93343334815,93343334823,8,2964,1347,-40
93346238221,93346238222,1,1811,2648,-40
93346356152,93346356157,5,2743,1933,-40
93350118025,93350118030,5,3005,1132,-40
93350160250,93350160241,-9,1040,264,-40
93352273003,93352273010,7,2755,1191,-40
93355868107,93355868112,5,2493,1203,-40
93356639705,93356639710,5,3677,1930,-40
93359572791,93359572788,-3,817,1822,-40
93359637050,93359637057,7,3189,1556,-40
93360630822,93360630827,5,1513,912,-40
93361566036,93361566042,6,2447,1255,-40
93361764984,93361764989,5,3180,1524,-40
93364328150,93364328136,-14,2003,1255,-40
93365813738,93365813741,3,2065,1028,-40
93373232687,93373232693,6,2439,1389,-40
93373747228,93373747234,6,2410,1271,-40
93379230117,93379230138,21,784,141,-40
93384014981,93384014986,5,3421,1928,-40
93387953573,93387953575,2,2462,1469,-40
93391231871,93391231873,2,1336,1191,-40
93391852529,93391852536,7,2651,1460,-40
93391914870,93391914875,5,2228,924,-40
93391997358,93391997363,5,1311,1078,-40
93399670294,93399670301,7,3844,1585,-40
93400841830,93400841808,-22,589,79,-40
93403216579,93403216585,6,3327,1224,-40
93413944750,93413944757,7,3292,1425,-40
93416815545,93416815551,6,1787,763,-40
93417009593,93417009598,5,4120,1567,-40
93418345699,93418345700,1,24712,29036,-40
93421337289,93421337296,7,3419,1389,-40
93422086658,93422086666,8,1548,1086,-40
93423136593,93423136599,6,3635,1208,-40
93423880802,93423880798,-4,670,2154,-40
93424676558,93424676563,5,2903,1521,-40
93436648993,93436648999,6,2738,1327,-40
93437736955,93437736962,7,4094,1010,-40
93449320499,93449320505,6,3840,2326,-40
93449960358,93449960365,7,3519,1575,-40
93454710733,93454710737,4,1860,991,-40
93457922294,93457922298,4,2281,1532,-40
93460307192,93460307198,6,2528,796,-40
93460976443,93460976449,6,2935,1295,-40
93462590436,93462590443,7,2934,1175,-40
93462658633,93462658624,-9,1180,256,-40
93477368766,93477368774,8,2257,991,-40
93479598223,93479598231,8,2418,1143,-40
93479903277,93479903283,6,3124,1144,-40
93483342171,93483342178,7,1911,1029,-40
93484460190,93484460170,-20,2352,1074,-40
93486400738,93486400744,6,2756,1128,-40
93488179349,93488179356,7,7887,2168,-40
93488310054,93488310059,5,2184,1400,-40
93489759017,93489759025,8,2850,1414,-40
93489945351,93489945356,5,3147,1631,-40
93490273149,93490273170,21,3109,1395,-40
93492006964,93492006971,7,3596,1588,-40
93494219997,93494219996,-1,1343,2328,-40
93498085173,93498085179,6,2339,990,-40
93498475001,93498475008,7,2167,1178,-40
93500843042,93500843047,5,2595,1152,-40
93504918387,93504918392,5,2588,1417,-40
93505022578,93505022585,7,3253,1326,-40
93510227420,93510227426,6,2803,1765,-40
93511480386,93511480392,6,2117,1045,-40
93511747630,93511747634,4,978,181,-40
93512704095,93512704098,3,1623,1207,-40
93513330566,93513330573,7,1714,786,-40
93513657049,93513657054,5,2404,1141,-40
93514189487,93514189493,6,3148,1259,-40
93515025196,93515025201,5,2644,591,-40
93516662493,93516662499,6,2178,1239,-40
93518363871,93518363878,7,2245,1185,-40
93519489848,93519489853,5,1829,1127,-40
93519551285,93519551266,-19,656,221,-40
93520307917,93520307922,5,3179,1330,-40
93520828590,93520828603,13,1264,249,-40
93523960509,93523960517,8,12465,27509,-40
93526409574,93526409582,8,2524,982,-40
93527602019,93527602026,7,3374,1387,-40
93529020153,93529020160,7,3088,1216,-40
93529105951,93529105964,13,963,311,-40
93531404725,93531404731,6,1696,753,-40
93531782554,93531782561,7,3703,1328,-40
93533705993,93533705999,6,2692,1600,-40
93534391427,93534391410,-17,206,970,-40
93534917303,93534917309,6,3032,1032,-40
93540622770,93540622777,7,3079,1495,-40
93540871253,93540871251,-2,1057,37,-40
93541926466,93541926472,6,1987,876,-40
93542625686,93542625692,6,1865,1580,-40
93542780770,93542780755,-15,1285,731,-40
93551111854,93551111862,8,2574,1334,-40
93552678346,93552678343,-3,1408,9274,-40
93554330377,93554330382,5,2549,861,-40
93560069237,93560069242,5,3188,827,-40
93564034783,93564034780,-3,784,2286,-40
93569547987,93569547981,-6,1428,4770,-40
93571796392,93571796398,6,2726,1354,-40
93572598125,93572598111,-14,1193,441,-40
93582899901,93582899908,7,2543,1406,-40
93583132152,93583132159,7,3681,1405,-40
93583949985,93583949989,4,3294,1601,-40
93584142402,93584142409,7,3210,1203,-40
93593101410,93593101416,6,3901,1776,-40
93597704670,93597704678,8,2736,1154,-40
93598025132,93598025145,13,1884,466,-40
93599949946,93599949952,6,2718,1200,-40
93603356445,93603356450,5,3360,1414,-40
93603703030,93603703037,7,2139,1195,-40
93608822936,93608822929,-7,1867,44887,-40
93616383817,93616383823,6,2938,1220,-40
93616665929,93616665935,6,4048,1496,-40
93617665241,93617665247,6,2388,951,-40
93617790114,93617790119,5,2093,1043,-40
93618075323,93618075305,-18,1442,331,-40
93619209762,93619209769,7,1890,1004,-40
93619805271,93619805280,9,1142,110,-40
93623118844,93623118848,4,1865,962,-40
93624129809,93624129803,-6,749,161,-40
93624405576,93624405582,6,3041,1630,-40
93632841083,93632841083,0,2410,2977,-40
93633379609,93633379615,6,2653,1285,-40
93637205044,93637205051,7,3561,1051,-40
93637374266,93637374273,7,3165,1306,-40
93641483618,93641483625,7,2856,1223,-40
93642083957,93642083961,4,2061,1402,-40
93646673637,93646673620,-17,161,2857,-40
93650337962,93650337964,2,2692,1711,-40
93651121890,93651121897,7,2602,1135,-40
93651555987,93651555987,0,868,235,-40
93652670854,93652670863,9,3297,1062,-40
93653458066,93653458070,4,2286,1189,-40
93653542298,93653542282,-16,698,462,-40
93658003878,93658003877,-1,1367,3260,-40
93659401357,93659401364,7,3380,985,-40
93660316901,93660316907,6,3689,1545,-40
93664125739,93664125737,-2,1647,3330,-40
93664344405,93664344410,5,2379,1178,-40
93664485470,93664485470,0,974,1993,-40
93665451410,93665451416,6,2067,1238,-40
93668798121,93668798132,11,2264,1166,-40
93670102311,93670102317,6,1674,966,-40
93679522142,93679522147,5,1930,1095,-40
93679925962,93679925967,5,2415,1481,-40
93685700577,93685700570,-7,1410,6167,-40
93685922747,93685922746,-1,2215,2194,-40
93692087039,93692087046,7,3801,1520,-40
93696444406,93696444411,5,2457,943,-40
93699053446,93699053445,-1,1497,3149,-40
93703171986,93703171992,6,2539,1391,-40
93707787202,93707787211,9,5150,1517,-40
93708411606,93708411611,5,2799,1173,-40
93711483569,93711483576,7,2217,799,-40
93721759139,93721759147,8,4050,1568,-40
93721815065,93721815070,5,2673,727,-40
93723332493,93723332498,5,2101,927,-40
93728390586,93728390593,7,4294,1857,-40
93729304517,93729304523,6,3029,1541,-40
93730299900,93730299907,7,3810,1354,-40
93731296107,93731296105,-2,1414,2745,-40
93735551241,93735551247,6,2808,1389,-40
93735649259,93735649254,-5,1638,5379,-40
93735865534,93735865541,7,2826,1235,-40
93742339777,93742339782,5,2764,1243,-40
93743327063,93743327070,7,3689,1741,-40
93747107886,93747107895,9,2798,1032,-40
93747423882,93747423887,5,3064,1227,-40
93747908326,93747908326,0,1055,1776,-40
93748313833,93748313840,7,3482,1407,-40
93748634570,93748634552,-18,760,572,-40
93750256973,93750256981,8,3718,1304,-40
93751289645,93751289628,-17,846,608,-40
93751813683,93751813678,-5,1217,2777,-40
93753214293,93753214302,9,2873,1092,-40
93753268722,93753268705,-17,2360,1288,-40
93754668950,93754668956,6,2498,1640,-40
93757002201,93757002209,8,4004,1554,-40
93763458492,93763458501,9,3557,1074,-40
93767596361,93767596367,6,2723,1023,-40
93767960161,93767960177,16,1061,1181,-40
93773540094,93773540099,5,3106,1617,-40
93778792874,93778792881,7,2775,1331,-40
93781656885,93781656891,6,2177,1216,-40
93783552861,93783552869,8,2614,1370,-40
93786864897,93786864904,7,2903,1250,-40
93793014729,93793014736,7,2482,1208,-40
93793417422,93793417434,12,2783,1204,-40
93795992066,93795992073,7,2236,1149,-40
93799370141,93799370162,21,270,891,-40
93799848721,93799848725,4,2441,2112,-40
93802575891,93802575897,6,2442,1567,-40
93805154442,93805154449,7,3926,1539,-40
93809654426,93809654432,6,3403,1187,-40
93813225342,93813225348,6,2911,1591,-40
93819302939,93819302946,7,3877,1008,-40
93820929182,93820929160,-22,703,334,-40
93822321763,93822321751,-12,1055,2206,-40
93823917268,93823917274,6,2623,1492,-40
93825122062,93825122069,7,5231,1177,-40
93825313482,93825313467,-15,1624,996,-40
93828073914,93828073918,4,2816,1341,-40
93830015241,93830015248,7,4531,1539,-40
93831129221,93831129226,5,2917,1858,-40
93831662466,93831662473,7,4039,1725,-40
93834245378,93834245385,7,3444,1562,-40
93835479612,93835479618,6,2569,1446,-40
93836542685,93836542693,8,2573,1563,-40
93837041096,93837041093,-3,982,2245,-40
93838340564,93838340571,7,3634,2211,-40
93841027413,93841027421,8,2307,1350,-40
93845890385,93845890385,0,915,631,-40
93849611242,93849611249,7,3365,1649,-40
93850543809,93850543814,5,1948,1304,-40
93850965243,93850965225,-18,3423,1120,-40
93851690621,93851690627,6,3516,1898,-40
93853897707,93853897714,7,2554,1150,-40
93854049126,93854049132,6,2165,834,-40
93859986882,93859986889,7,3764,1558,-40
93866204831,93866204839,8,2826,818,-40
93867951147,93867951153,6,3644,1535,-40
93868855878,93868855883,5,963,361,-40
93870096115,93870096122,7,2868,1222,-40
93870334502,93870334513,11,3323,866,-40
93879251893,93879251898,5,2269,1486,-40
93883318582,93883318586,4,2579,1417,-40
93886547333,93886547339,6,2526,1336,-40
93886841716,93886841697,-19,3168,1291,-40
93887940126,93887940134,8,2275,1209,-40
93888631662,93888631665,3,1521,1190,-40
93888893526,93888893532,6,3212,1837,-40
93893430023,93893430023,0,920,1814,-40
93899454558,93899454564,6,2060,1041,-40
93904222526,93904222526,0,1248,2230,-40
93905034702,93905034705,3,2777,1594,-40
93906709750,93906709753,3,2363,1516,-40
93906869465,93906869470,5,2734,1364,-40
93908074515,93908074522,7,1699,1187,-40
93908272286,93908272306,20,1689,1459,-40
93909419130,93909419129,-1,2335,3172,-40
93915196629,93915196640,11,15462,8818,-40
93919039391,93919039398,7,3006,1268,-40
93921692797,93921692802,5,2499,1339,-40
93929197599,93929197607,8,2926,1143,-40
93929755351,93929755356,5,2401,1074,-40
93930446270,93930446277,7,3245,1377,-40
93930948875,93930948859,-16,1062,345,-40
93933146688,93933146693,5,1769,715,-40
93933500683,93933500665,-18,733,156,-40
93934331865,93934331872,7,1052,231,-40
93935727754,93935727761,7,2640,1311,-40
93936134683,93936134681,-2,1246,2121,-40
93938724179,93938724184,5,2447,1141,-40
93938843844,93938843828,-16,1987,977,-40
93940176874,93940176881,7,2538,1261,-40
93941187613,93941187618,5,3780,1054,-40
93943060526,93943060531,5,1771,1116,-40
93944157602,93944157611,9,2573,885,-40
93945191660,93945191666,6,4307,1463,-40
93946608687,93946608694,7,2307,600,-40
93948799150,93948799156,6,1468,845,-40
93949170444,93949170458,14,770,99,-40
93949200635,93949200626,-9,763,13,-40
93951970567,93951970571,4,1542,726,-40
93953261559,93953261565,6,4556,1476,-40
93958941885,93958941891,6,2739,1219,-40
93961214506,93961214512,6,2886,1041,-40
93963177759,93963177762,3,1659,1557,-40
93966768745,93966768738,-7,898,4226,-40
93971731682,93971731692,10,3651,1289,-40
93977050299,93977050305,6,2283,1230,-40
93977260498,93977260503,5,2832,1217,-40
93977435307,93977435314,7,2891,971,-40
93984589256,93984589262,6,2786,1283,-40
93991907682,93991907678,-4,888,2122,-40
93993764480,93993764487,7,2179,1293,-40
93998325282,93998325275,-7,1941,7010,-40
94001545307,94001545314,7,2695,1186,-40
94002226625,94002226633,8,2480,941,-40
94003857558,94003857562,4,2039,1003,-40
94004519517,94004519522,5,2307,1485,-40
94005546078,94005546085,7,2396,1187,-40
94006762645,94006762651,6,2335,1111,-40
94009384683,94009384690,7,2638,1200,-40
94010543336,94010543337,1,19558,20370,-40
94014398738,94014398744,6,3074,1432,-40
94015379698,94015379707,9,1820,812,-40
94017769879,94017769895,16,2743,1005,-40
94021239105,94021239110,5,2656,788,-40
94023629889,94023629894,5,2990,1576,-40
94025975542,94025975541,-1,849,1979,-40
94026073329,94026073335,6,4046,1316,-40
94028103368,94028103374,6,3391,1535,-40
94028483466,94028483472,6,1989,930,-40
94028721835,94028721833,-2,696,1487,-40
94032405618,94032405623,5,2773,980,-40
94032697647,94032697653,6,2594,1436,-40
94035385486,94035385490,4,2930,1785,-40
94037140287,94037140294,7,3282,1261,-40
94037981099,94037981083,-16,1164,1017,-40
94043103776,94043103782,6,3910,742,-40
94045992625,94045992630,5,2445,1540,-40
94046238463,94046238469,6,2395,1412,-40
94046412261,94046412266,5,3579,1033,-40
94047238194,94047238179,-15,631,358,-40
94048162328,94048162314,-14,1419,596,-40
94049362251,94049362257,6,2204,1249,-40
94051391911,94051391917,6,1566,918,-40
94053210902,94053210909,7,4396,1812,-40
94053238156,94053238162,6,2556,1065,-40
94055297166,94055297173,7,2945,1588,-40
94060404548,94060404555,7,3866,1238,-40
94062344770,94062344777,7,3082,1936,-40
94064577049,94064577055,6,3184,1549,-40
94065045948,94065045948,0,1488,2906,-40
94066439761,94066439766,5,2891,1328,-40
94067789330,94067789332,2,1707,2407,-40
94070852093,94070852091,-2,1199,513,-40
94073874173,94073874174,1,1607,1915,-40
94075301722,94075301729,7,2924,1206,-40
94076933809,94076933816,7,3101,1348,-40
94081980410,94081980408,-2,986,2100,-40
94082166981,94082166962,-19,1158,401,-40
94083643547,94083643554,7,3025,1152,-40
94083773818,94083773813,-5,18170,16178,-40
94092919442,94092919448,6,3913,1501,-40
94095125010,94095125018,8,2411,1026,-40
94100671366,94100671373,7,3090,1569,-40
94111622382,94111622389,7,2718,1096,-40
94112016118,94112016122,4,1264,934,-40
94116015111,94116015118,7,3653,1029,-40
94117650938,94117650946,8,3785,1928,-40
94118952550,94118952555,5,2559,1123,-40
94118985685,94118985700,15,1168,238,-40
94122386313,94122386318,5,3071,1606,-40
94126570485,94126570490,5,8920,4981,-40
94128222149,94128222155,6,2338,1263,-40
94137767505,94137767501,-4,29804,15101,-40
94138012164,94138012171,7,3373,1366,-40
94138865698,94138865683,-15,2057,481,-40
94146342367,94146342374,7,3362,1171,-40
94146630499,94146630489,-10,671,97,-40
94151885919,94151885925,6,3057,1222,-40
94152157757,94152157761,4,2784,1238,-40
94153150046,94153150053,7,3747,1643,-40
94156068248,94156068253,5,2959,1058,-40
94157511920,94157511926,6,2503,1278,-40
94158363018,94158363026,8,1132,513,-40
94159052638,94159052620,-18,2153,1229,-40
94160605968,94160605974,6,3742,1037,-40
94166539731,94166539737,6,2622,1434,-40
94168122990,94168122999,9,2049,1100,-40
94170404074,94170404081,7,2365,1206,-40
94180365643,94180365644,1,1310,2016,-40
94180727343,94180727350,7,3552,1457,-40
94185158984,94185158990,6,2097,1110,-40
94186034716,94186034721,5,2868,1204,-40
94186216127,94186216136,9,2713,1355,-40
94191859869,94191859875,6,2087,1304,-40
94195230433,94195230438,5,2980,983,-40
94195911806,94195911819,13,1415,316,-40
94200207043,94200207050,7,3151,1196,-40
94201429537,94201429543,6,2738,1012,-40
94204887085,94204887091,6,2017,1145,-40
94207408673,94207408678,5,2571,1556,-40
94208990432,94208990438,6,2989,1215,-40
94209912573,94209912577,4,1804,1239,-40
94211392886,94211392892,6,3728,1954,-40
94212003399,94212003377,-22,686,216,-40
94213121754,94213121761,7,3155,1078,-40
94214793103,94214793107,4,1732,995,-40
94220488581,94220488587,6,3475,1573,-40
94221480471,94221480469,-2,1566,2965,-40
94233549394,94233549401,7,2894,849,-40
94235353360,94235353367,7,2900,1374,-40
94237558128,94237558133,5,2441,1139,-40
94238137657,94238137663,6,3441,1255,-40
94238169346,94238169351,5,2539,1270,-40
94243131865,94243131870,5,2626,1258,-40
94244246410,94244246412,2,1604,1328,-40
94244281855,94244281862,7,2533,1168,-40
94245161014,94245161022,8,3603,1306,-40
94245728403,94245728410,7,3584,1247,-40
94245993183,94245993201,18,1032,477,-40
94255969678,94255969684,6,2043,692,-40
94256116713,94256116719,6,1679,971,-40
94258657744,94258657750,6,3020,1497,-40
94259376211,94259376215,4,3824,1400,-40
94260378762,94260378767,5,2358,1164,-40
94262929579,94262929585,6,2288,1235,-40
94267220793,94267220801,8,1209,433,-40
94268237271,94268237250,-21,2201,838,-40
94269128993,94269128999,6,2651,1250,-40
94269749100,94269749080,-20,2698,882,-40
94276753316,94276753322,6,2808,1070,-40
94277388658,94277388674,16,4499,1370,-40
94278680555,94278680561,6,2331,1046,-40
94278917138,94278917130,-8,731,252,-40
94282915038,94282915047,9,3678,1763,-40
94283745637,94283745643,6,2633,1395,-40
94284127599,94284127603,4,3908,1646,-40
94293347385,94293347394,9,1890,1226,-40
94293967277,94293967283,6,3040,1106,-40
94295675303,94295675310,7,2960,1342,-40
94299780514,94299780521,7,3118,1101,-40
94300496820,94300496826,6,2871,1180,-40
94304764446,94304764450,4,2005,656,-40
94305186930,94305186938,8,2356,1576,-40
94307485354,94307485359,5,1982,1038,-40
94308022722,94308022730,8,3033,1644,-40
94322891536,94322891543,7,2540,1618,-40
94327387111,94327387118,7,5005,1595,-40
94333176131,94333176138,7,2642,1367,-40
94335294562,94335294566,4,4978,3178,-40
94336530660,94336530666,6,4094,1733,-40
94340779827,94340779834,7,1911,1448,-40
94343290328,94343290334,6,2670,890,-40
94349551912,94349551917,5,1938,1221,-40
94353593165,94353593173,8,2236,1027,-40
94356528796,94356528803,7,2797,1320,-40
94359865580,94359865587,7,1748,1066,-40
94360138588,94360138611,23,1960,1058,-40
94363070180,94363070187,7,3722,1466,-40
94363345059,94363345063,4,4399,2441,-40
94363677081,94363677089,8,3169,1523,-40
94363715598,94363715605,7,3857,1317,-40
94364432282,94364432289,7,3438,1197,-40
94367483462,94367483470,8,3037,1205,-40
94368637358,94368637365,7,3956,1546,-40
94369661122,94369661122,0,1370,2076,-40
94371627138,94371627145,7,4230,1224,-40
94371820886,94371820899,13,3169,1667,-40
94371995095,94371995092,-3,1763,4299,-40
94372936174,94372936180,6,1791,1368,-40
94380840193,94380840190,-3,19799,6875,-40
94382073910,94382073918,8,3097,1464,-40
94382446790,94382446798,8,4331,1715,-40
94383405904,94383405911,7,2138,913,-40
94384370493,94384370502,9,4736,1500,-40
94388652207,94388652201,-6,1140,3456,-40
94394335811,94394335818,7,4277,1734,-40
94396605452,94396605449,-3,1799,4571,-40
94397586541,94397586550,9,2605,908,-40
94397674796,94397674803,7,2669,1247,-40
94399243710,94399243715,5,2893,1019,-40
94399964804,94399964810,6,2306,1306,-40
94400980227,94400980232,5,2169,1611,-40
94402098617,94402098624,7,2986,1478,-40
94402192329,94402192346,17,2418,1463,-40
94402589206,94402589186,-20,3003,1084,-40
94403316142,94403316147,5,2433,1468,-40
94406478225,94406478231,6,2670,1004,-40
94406705166,94406705172,6,4744,1686,-40
94411599562,94411599569,7,2471,1407,-40
94412531102,94412531081,-21,1172,626,-40
94416664666,94416664662,-4,1789,3880,-40
94417434983,94417434989,6,3005,1317,-40
94421042249,94421042254,5,2540,1060,-40
94423080730,94423080736,6,3097,1366,-40
94423291239,94423291242,3,2688,1023,-40
94426665184,94426665169,-15,277,1278,-40
94427558833,94427558839,6,2566,1060,-40
94434912714,94434912719,5,2002,1174,-40
94438647749,94438647756,7,3550,1547,-40
94441382967,94441382974,7,2462,1871,-40
94442706551,94442706547,-4,746,1826,-40
94448715713,94448715718,5,2473,1055,-40
94449138283,94449138283,0,910,176,-40
94450816383,94450816391,8,2869,1686,-40
94456169830,94456169837,7,3301,1268,-40
94456831905,94456831910,5,3031,1427,-40
94464514798,94464514804,6,3020,1335,-40
94465210306,94465210310,4,10608,18524,-40
94466212032,94466212039,7,2323,948,-40
94469922734,94469922741,7,1817,1364,-40
94471688943,94471688921,-22,864,750,-40
94474119237,94474119242,5,2050,1111,-40
94478497433,94478497438,5,1986,1000,-40
94481603369,94481603375,6,3387,1301,-40
94483858497,94483858505,8,2908,1372,-40
94486480223,94486480230,7,2311,1433,-40
94492278037,94492278042,5,2240,1104,-40
94496560444,94496560451,7,2701,1002,-40
94496634789,94496634794,5,3563,1269,-40
94499182221,94499182227,6,4424,1875,-40
94504744716,94504744721,5,3356,984,-40
94505094697,94505094704,7,4146,2074,-40
94505653356,94505653363,7,2088,974,-40
94507294370,94507294376,6,3316,1098,-40
94509565245,94509565251,6,3397,1289,-40
94509626374,94509626378,4,944,305,-40
94509711545,94509711555,10,3175,1469,-40
94509776534,94509776521,-13,2451,881,-40
94510273611,94510273594,-17,1200,762,-40
94519259137,94519259147,10,3055,1732,-40
94521128622,94521128626,4,4239,3201,-40
94523179083,94523179090,7,2354,1216,-40
94525752203,94525752210,7,3169,1162,-40
94528393040,94528393047,7,2851,1559,-40
94529861489,94529861495,6,3160,1432,-40
94531376367,94531376382,15,17141,30148,-40
94533547308,94533547314,6,2514,1318,-40
94533859517,94533859530,13,3166,1629,-40
94534380922,94534380927,5,2310,1175,-40
94534733518,94534733522,4,2331,1254,-40
94535725911,94535725919,8,2444,802,-40
94537801630,94537801635,5,1981,1171,-40
94539336100,94539336099,-1,1976,2852,-40
94546905171,94546905178,7,2432,993,-40
94548575399,94548575405,6,3013,1370,-40
94553439356,94553439362,6,3059,1320,-40
94555821966,94555821961,-5,823,179,-40
94559743805,94559743810,5,2170,1253,-40
94563370936,94563370942,6,6752,2177,-40
94563578978,94563578987,9,2022,766,-40
94567051588,94567051593,5,4023,1124,-40
94568826142,94568826146,4,1556,1389,-40
94569499507,94569499507,0,1001,1471,-40
94571299010,94571299015,5,2371,1893,-40
94571579212,94571579219,7,2212,1117,-40
94575927509,94575927516,7,3582,1143,-40
94578431645,94578431653,8,3230,1144,-40
94579082128,94579082134,6,3181,1312,-40
94579684697,94579684703,6,2013,923,-40
94579970662,94579970655,-7,1404,6706,-40
94584976891,94584976900,9,2148,913,-40
94589868298,94589868303,5,2853,1066,-40
94593453212,94593453219,7,3523,1483,-40
94597441581,94597441586,5,2563,1455,-40
94599036519,94599036526,7,2727,1227,-40
94602502341,94602502346,5,3588,1195,-40
94604126544,94604126548,4,2175,1509,-40
94605827130,94605827133,3,1113,767,-40
94607497829,94607497834,5,2000,969,-40
94607690034,94607690038,4,2748,1307,-40
94615598685,94615598691,6,3500,1516,-40
94624401405,94624401413,8,2990,924,-40
94630167218,94630167220,2,1776,1845,-40
94631378906,94631378903,-3,18443,8146,-40
94633112219,94633112225,6,2375,809,-40
94635731324,94635731331,7,4186,1432,-40
94637455549,94637455555,6,2272,1499,-40
94640405319,94640405316,-3,2393,6408,-40
94640524604,94640524609,5,2373,976,-40
94641251871,94641251878,7,2453,1272,-40
94643392093,94643392099,6,1796,992,-40
94647329138,94647329144,6,2819,1284,-40
94647936977,94647936982,5,1281,940,-40
94659759911,94659759918,7,3343,1493,-40
94662481994,94662482000,6,3076,1191,-40
94665319365,94665319366,1,2992,4103,-40
94665981566,94665981573,7,2191,1419,-40
94672104689,94672104689,0,2624,2479,-40
94673528018,94673528023,5,2281,848,-40
94674178935,94674178930,-5,2246,7232,-40
94675701270,94675701277,7,2804,865,-40
94676292809,94676292811,2,1920,1317,-40
94681513862,94681513869,7,3277,1049,-40
94682628132,94682628137,5,2534,1237,-40
94682724174,94682724181,7,3680,1481,-40
94689776769,94689776775,6,4767,1339,-40
94691347106,94691347115,9,2406,1064,-40
94692726033,94692726035,2,1418,177,-40
94695497542,94695497547,5,3450,1298,-40
94706156842,94706156846,4,3397,2926,-40
94706330198,94706330202,4,2065,1253,-40
94707438239,94707438245,6,1947,1149,-40
94708801805,94708801813,8,3200,1276,-40
94708998274,94708998278,4,2730,1180,-40
94711231604,94711231613,9,2020,775,-40
94720978952,94720978957,5,2891,1561,-40
94728806500,94728806511,11,13670,34007,-40
94733279169,94733279174,5,2932,1399,-40
94736558542,94736558538,-4,756,2030,-40
94736985910,94736985917,7,2396,1160,-40
94740386702,94740386707,5,1994,953,-40
94742688666,94742688658,-8,1870,10273,-40
94753062895,94753062901,6,2833,958,-40
94755203329,94755203337,8,2782,1146,-40
94759844737,94759844743,6,2823,1151,-40
94761902699,94761902707,8,2718,1039,-40
94762713124,94762713130,6,2949,1077,-40
94762876101,94762876107,6,2119,1185,-40
94765920186,94765920189,3,3614,2815,-40
94767764518,94767764525,7,5970,772,-40
94769270109,94769270117,8,3978,1565,-40
94771612488,94771612493,5,3501,1204,-40
94774335689,94774335695,6,2581,1305,-40
94774578847,94774578850,3,2120,1513,-40
94775231763,94775231769,6,3803,1544,-40
94776248655,94776248662,7,4640,1402,-40
94776638792,94776638779,-13,2820,847,-40
94779462299,94779462305,6,7103,26652,-40
94782094259,94782094265,6,2284,1277,-40
94786850988,94786850990,2,1631,1831,-40
94791189437,94791189442,5,3577,1451,-40
94791481446,94791481451,5,2664,1200,-40
94796950677,94796950682,5,2367,1302,-40
94800253590,94800253596,6,3316,1417,-40
94804993157,94804993163,6,2615,1009,-40
94806087123,94806087107,-16,2989,943,-40
94806794277,94806794283,6,5025,2317,-40
94808676532,94808676538,6,3534,1496,-40
94809315570,94809315577,7,2174,1114,-40
94809834986,94809834991,5,3255,1491,-40
94815324817,94815324818,1,1239,1005,-40
94822528158,94822528165,7,2078,1230,-40
94823223246,94823223251,5,2524,1472,-40
94827670987,94827670992,5,2888,1042,-40
94829136670,94829136652,-18,825,279,-40
94830988062,94830988069,7,3807,1373,-40
94831367518,94831367523,5,2786,1538,-40
94834414503,94834414505,2,1114,1358,-40
94836794244,94836794250,6,3876,1794,-40
94837275577,94837275585,8,841,406,-40
94840555597,94840555601,4,1661,1092,-40
94842848541,94842848547,6,2355,1219,-40
94848212870,94848212878,8,3380,1906,-40
94850423897,94850423899,2,1354,1215,-40
94851043442,94851043446,4,2716,1338,-40
94852146570,94852146578,8,3593,1461,-40
94854929135,94854929142,7,2731,1637,-40
94857205237,94857205237,0,1913,1831,-40
94857521142,94857521147,5,2562,1015,-40
94862049878,94862049884,6,2907,722,-40
94867669638,94867669645,7,2686,1434,-40
94868107428,94868107434,6,2609,1261,-40
94870839474,94870839479,5,1525,34408,-40
94872181041,94872181041,0,1160,1901,-40
94876566910,94876566917,7,3316,1318,-40
94878698751,94878698757,6,3036,955,-40
94879378230,94879378235,5,3311,1587,-40
94881279445,94881279450,5,3650,2030,-40
94884565897,94884565901,4,2677,909,-40
94890442674,94890442681,7,2973,1385,-40
94892343497,94892343490,-7,1075,4616,-40
94892402447,94892402453,6,2588,1439,-40
94892503467,94892503466,-1,1192,288,-40
94894931329,94894931331,2,1487,1490,-40
94895846268,94895846273,5,2988,1927,-40
94895972907,94895972914,7,2902,1457,-40
94896910706,94896910700,-6,1234,5378,-40
94900357169,94900357175,6,2929,1363,-40
94903511743,94903511750,7,2933,1428,-40
94907112370,94907112374,4,3105,973,-40
94909968371,94909968378,7,2271,998,-40
94913497666,94913497671,5,2783,1307,-40
94914193549,94914193553,4,1247,1250,-40
94914591311,94914591319,8,2823,1002,-40
94919642630,94919642637,7,2902,1439,-40
94923150514,94923150521,7,2393,1136,-40
94923701149,94923701154,5,2784,1195,-40
94927564114,94927564122,8,2658,743,-40
94929411626,94929411633,7,3341,1364,-40
94931262440,94931262446,6,3623,1336,-40
94932151843,94932151850,7,1218,764,-40
94934848747,94934848755,8,3586,819,-40
94940154502,94940154509,7,2858,1361,-40
94940573486,94940573493,7,2614,1098,-40
94941020844,94941020826,-18,2576,941,-40
94944565874,94944565881,7,2865,1296,-40
94946427904,94946427911,7,4579,1374,-40
94951175185,94951175186,1,2940,3581,-40
94951443418,94951443423,5,2619,1148,-40
94953590426,94953590433,7,2410,1477,-40
94956660573,94956660577,4,2891,1169,-40
94967304221,94967304228,7,4037,1680,-40
94967611277,94967611282,5,2561,1149,-40
94967793614,94967793622,8,2591,1594,-40
94968412557,94968412564,7,2995,1523,-40
94988326511,94988326519,8,2118,828,-40
94988634859,94988634844,-15,2599,1192,-40
94990974420,94990974427,7,4240,960,-40
94991129462,94991129442,-20,3880,1569,-40
94999323729,94999323736,7,3175,1469,-40
95005190167,95005190166,-1,1186,1866,-40
95007689641,95007689646,5,3093,1072,-40
95014536045,95014536051,6,2758,962,-40
95018246165,95018246172,7,3462,1448,-40
95023040525,95023040526,1,1142,1349,-40
95024598596,95024598602,6,2849,1250,-40
95026116789,95026116786,-3,2042,4408,-40
95031795263,95031795270,7,3671,1095,-40
95031970105,95031970107,2,694,964,-40
95034336889,95034336896,7,3579,1296,-40
95037338985,95037338991,6,2579,1386,-40
95038498449,95038498454,5,2559,1228,-40
95040217473,95040217479,6,3030,1604,-40
95043621733,95043621739,6,3148,1341,-40
95043852738,95043852744,6,2283,1263,-40
95045161995,95045161998,3,2322,1113,-40
95046515925,95046515930,5,2693,1250,-40
95050002563,95050002569,6,2332,1145,-40
95051143454,95051143453,-1,1117,1485,-40
95052430453,95052430462,9,2146,1337,-40
95053032030,95053032035,5,2079,868,-40
95055954973,95055954979,6,2824,1550,-40
95056219692,95056219673,-19,1096,363,-40
95060277519,95060277525,6,3138,1752,-40
95060659810,95060659818,8,1984,918,-40
95061143343,95061143349,6,2646,1395,-40
95061651554,95061651563,9,3180,1236,-40
95061760161,95061760166,5,3325,1408,-40
95062718061,95062718068,7,2121,905,-40
95069785966,95069785975,9,1182,667,-40
95076699815,95076699812,-3,6020,10726,-40
95077545402,95077545409,7,3939,1423,-40
95080575280,95080575286,6,2076,1059,-40
95081146858,95081146858,0,1204,2778,-40
95085148285,95085148289,4,1951,1705,-40
95085551266,95085551271,5,2877,1298,-40
95085945965,95085945971,6,3920,1763,-40
95087476293,95087476294,1,1351,1333,-40
95098067823,95098067831,8,3515,1767,-40
95101047094,95101047089,-5,1341,3915,-40
95107200390,95107200396,6,3105,1299,-40
95111152581,95111152587,6,3642,1665,-40
95115639458,95115639466,8,3812,1331,-40
95115843139,95115843153,14,1120,217,-40
95119191849,95119191856,7,2912,1774,-40
95119586868,95119586875,7,2164,1031,-40
95121673069,95121673074,5,2252,1439,-40
95121798876,95121798881,5,2528,1349,-40
95122771782,95122771787,5,1727,1237,-40
95136215082,95136215084,2,17820,44262,-40
95136504075,95136504080,5,1651,905,-40
95139959025,95139959030,5,2918,1186,-40
95144432371,95144432374,3,1402,1112,-40
95144641021,95144641002,-19,1686,878,-40
95144699628,95144699634,6,2019,941,-40
95147370253,95147370258,5,412,4602,-40
95148528066,95148528074,8,3014,993,-40
95149740923,95149740931,8,3773,1249,-40
95149975394,95149975399,5,2120,1033,-40
95158816402,95158816386,-16,479,298,-40
95160288205,95160288212,7,3180,1281,-40
95162401204,95162401210,6,3488,1597,-40
95164263306,95164263314,8,2833,1291,-40
95169591341,95169591347,6,1679,1004,-40
95177347953,95177347959,6,2912,1133,-40
95178706345,95178706351,6,2998,1191,-40
95181215982,95181215986,4,4273,2800,-40
95182943769,95182943776,7,3518,1481,-40
95183063511,95183063517,6,3104,874,-40
95192918667,95192918673,6,3876,2148,-40
95194411281,95194411286,5,3088,953,-40
95194838262,95194838266,4,1908,945,-40
95195689734,95195689740,6,1832,783,-40
95197001786,95197001782,-4,1064,3168,-40
95204250637,95204250643,6,1660,940,-40
95208840520,95208840525,5,3842,1283,-40
95209615998,95209616002,4,2008,1054,-40
95216976366,95216976357,-9,29354,14535,-40
95218779747,95218779752,5,3580,1058,-40
95220126533,95220126539,6,2891,958,-40
95223821770,95223821776,6,2695,1214,-40
95223907991,95223907999,8,2078,855,-40
95226464551,95226464559,8,2356,1011,-40
95226832465,95226832452,-13,972,283,-40
95227906929,95227906937,8,1423,1262,-40
95228426472,95228426478,6,2935,1138,-40
95229371969,95229371954,-15,1695,424,-40
95233489970,95233489978,8,3049,1388,-40
95234115710,95234115718,8,2815,1699,-40
95235060447,95235060454,7,2901,1238,-40
95236861531,95236861534,3,1261,839,-40
95242373598,95242373606,8,6549,2803,-40
95243426532,95243426538,6,2694,1536,-40
95249917463,95249917470,7,1963,1229,-40
95250524682,95250524698,16,12070,51927,-40
95251990725,95251990724,-1,7538,22365,-40
95253220262,95253220269,7,2725,1285,-40
95260931227,95260931234,7,3668,1206,-40
95261845972,95261845981,9,2744,1199,-40
95262926502,95262926509,7,2425,1376,-40
95268046154,95268046161,7,3072,1069,-40
95270490971,95270490978,7,2032,1043,-40
95273329511,95273329489,-22,2031,893,-40
95276054914,95276054920,6,3162,1705,-40
95294159059,95294159057,-2,1216,1692,-40
95298190097,95298190103,6,2957,955,-40
95301149218,95301149223,5,2364,1043,-40
95306743598,95306743603,5,1959,940,-40
95308139006,95308139007,1,2416,2533,-40
95315047612,95315047618,6,2595,1366,-40
95316843521,95316843527,6,2265,1320,-40
95318597322,95318597329,7,2587,1327,-40
95318905273,95318905274,1,795,256,-40
95319944337,95319944342,5,3326,1239,-40
95322348049,95322348057,8,3474,1421,-40
95329975873,95329975879,6,13752,17731,-40
95334993850,95334993855,5,2107,1265,-40
95335360614,95335360621,7,3513,1240,-40
95336166134,95336166143,9,3474,1336,-40
95342285968,95342285974,6,2321,882,-40
95343818764,95343818769,5,3406,1163,-40
95350919686,95350919691,5,1981,972,-40
95354441512,95354441520,8,3506,1228,-40
95357158226,95357158236,10,2205,780,-40
95359397554,95359397556,2,1099,1145,-40
95365677653,95365677659,6,2216,1233,-40
95366242839,95366242845,6,2623,1361,-40
95369480505,95369480511,6,2505,1332,-40
95370420258,95370420263,5,2754,1042,-40
95374428415,95374428422,7,3274,1823,-40
95386062330,95386062338,8,1720,971,-40
95395418414,95395418421,7,2097,1286,-40
95395530436,95395530426,-10,1289,199,-40
95399275399,95399275405,6,3478,1278,-40
95400010806,95400010811,5,3615,1376,-40
95400349317,95400349323,6,2155,1105,-40
95403532513,95403532519,6,3441,1231,-40
95407639093,95407639099,6,3069,1494,-40
95408090886,95408090893,7,1111,580,-40
95408729733,95408729738,5,2050,1149,-40
95410925968,95410925974,6,2022,1029,-40
95411740911,95411740890,-21,1050,285,-40
95413221859,95413221866,7,2407,1139,-40
95413755042,95413755051,9,2697,1119,-40
95413809455,95413809462,7,3260,1226,-40
95416727294,95416727301,7,2966,1110,-40
95418412613,95418412619,6,3667,1204,-40
95419599375,95419599382,7,2574,1184,-40
95419632590,95419632570,-20,1549,1769,-40
95419720149,95419720155,6,1719,1092,-40
95421780541,95421780548,7,2306,704,-40
95421946813,95421946792,-21,2979,1222,-40
95424260771,95424260780,9,3580,1306,-40
95427379205,95427379210,5,2800,1233,-40
95430173214,95430173218,4,3450,1580,-40
95432428762,95432428770,8,2626,1466,-40
95434934802,95434934807,5,2561,1686,-40
95435455393,95435455398,5,2925,1369,-40
95441585234,95441585242,8,3955,1587,-40
95443852029,95443852034,5,1648,934,-40
95444103031,95444103037,6,2080,1424,-40
95448430222,95448430229,7,2911,1318,-40
95452104004,95452104010,6,4311,2416,-40
95454345999,95454346007,8,3703,788,-40
95455627117,95455627123,6,3078,981,-40
95458771323,95458771329,6,2928,1424,-40
95462121933,95462121938,5,2755,983,-40
95468036398,95468036396,-2,1319,3343,-40
95472502187,95472502193,6,2909,1418,-40
95480418435,95480418438,3,1513,1164,-40
95483611526,95483611532,6,2946,1287,-40
95484015518,95484015523,5,4225,1714,-40
95484562853,95484562859,6,2282,1150,-40
95486473154,95486473159,5,1267,686,-40
95488476236,95488476242,6,3130,1358,-40
95489256789,95489256794,5,2177,1007,-40
95496005826,95496005833,7,1666,1357,-40
95496415072,95496415059,-13,4219,1488,-40
95496501373,95496501354,-19,1281,823,-40
95500115771,95500115774,3,4209,3624,-40
95500423820,95500423825,5,2975,1329,-40
95503245581,95503245585,4,1261,1223,-40
95505883786,95505883786,0,976,1591,-40
95506408136,95506408142,6,4024,1462,-40
95506806806,95506806810,4,1864,26748,-40
95509404338,95509404343,5,2745,1923,-40
95517550238,95517550245,7,3602,1272,-40
95519334893,95519334899,6,3404,1330,-40
95521944534,95521944541,7,2261,1618,-40
95524868258,95524868266,8,3294,1385,-40
95526174682,95526174688,6,2706,1174,-40
95526311671,95526311660,-11,834,324,-40
95526545843,95526545840,-3,1599,3080,-40
95527883797,95527883803,6,2507,994,-40
95531985289,95531985296,7,2376,973,-40
95532193791,95532193785,-6,1047,104,-40
95533364778,95533364782,4,1395,1133,-40
95533490205,95533490211,6,3127,1002,-40
95534007151,95534007151,0,874,1371,-40
95535642377,95535642383,6,3259,1235,-40
95545280786,95545280790,4,1856,1385,-40
95545915334,95545915339,5,2316,1457,-40
95550518235,95550518243,8,1893,1016,-40
95550748438,95550748445,7,3491,1260,-40
95558214909,95558214914,5,3678,1651,-40
95560786226,95560786208,-18,2493,1026,-40
95561154751,95561154757,6,3429,1626,-40
95562724037,95562724042,5,3306,1330,-40
95564507563,95564507568,5,2676,1212,-40
95567571393,95567571398,5,1957,1392,-40
95571927042,95571927045,3,1450,1081,-40
95579950361,95579950368,7,3076,1178,-40
95583427861,95583427867,6,1562,982,-40
95583638937,95583638943,6,2422,1273,-40
95587963324,95587963330,6,4334,1079,-40
95594394042,95594394049,7,3003,1510,-40
95597197554,95597197562,8,2752,1143,-40
95600593726,95600593726,0,1404,1322,-40
95601447434,95601447440,6,3821,1829,-40
95604289848,95604289855,7,3279,1421,-40
95614993397,95614993404,7,2550,1212,-40
95617775662,95617775668,6,1715,788,-40
95618417258,95618417262,4,2606,981,-40
95618711565,95618711573,8,3000,984,-40
95619674241,95619674232,-9,1036,281,-40
95627014439,95627014446,7,2470,1317,-40
95632876465,95632876472,7,3382,1075,-40
95637502885,95637502890,5,31210,17230,-40
95642314014,95642314014,0,1401,1126,-40
95646877798,95646877805,7,1959,1075,-40
95647658746,95647658753,7,4046,1512,-40
95651682093,95651682099,6,3458,1493,-40
95655014817,95655014822,5,2796,1044,-40
95662438632,95662438631,-1,756,918,-40
95665500886,95665500893,7,2578,1320,-40
95668448826,95668448831,5,2603,1441,-40
95671138606,95671138611,5,3023,1644,-40
95671198606,95671198584,-22,906,522,-40
95674069103,95674069110,7,1949,955,-40
95676347335,95676347341,6,4584,1714,-40
95676700803,95676700808,5,1826,1092,-40
95682151734,95682151741,7,4516,1766,-40
95683554295,95683554303,8,1879,776,-40
95684522740,95684522746,6,1886,1169,-40
95686101750,95686101757,7,3538,1690,-40
95689815309,95689815318,9,2838,1337,-40
95690263782,95690263789,7,2337,988,-40
95694965666,95694965672,6,3290,1008,-40
95695234204,95695234209,5,620,169,-40
95696756558,95696756566,8,2246,1100,-40
95696789661,95696789666,5,2066,1345,-40
95699054566,95699054573,7,3133,1161,-40
95700928866,95700928872,6,2840,1480,-40
95705810945,95705810951,6,3018,1280,-40
95708400382,95708400388,6,2050,821,-40
95711169326,95711169334,8,1532,690,-40
95715875747,95715875752,5,3216,1310,-40
95716201822,95716201842,20,1189,187,-40
95720333991,95720333999,8,2856,1270,-40
95720617428,95720617409,-19,2261,652,-40
95721535582,95721535587,5,2954,847,-40
95722038581,95722038580,-1,1816,2993,-40
95724031312,95724031317,5,2801,1248,-40
95727516245,95727516251,6,2862,1155,-40
95728464246,95728464253,7,4209,1603,-40
95732694394,95732694398,4,3025,1218,-40
95733113039,95733113045,6,2976,1604,-40
95735143545,95735143551,6,2897,1175,-40
95737066006,95737066006,0,1782,2165,-40
95737442100,95737442106,6,2373,653,-40
95738085888,95738085894,6,4669,1558,-40
95741532642,95741532625,-17,841,394,-40
95745579147,95745579153,6,3085,1419,-40
95747694818,95747694823,5,1102,763,-40
95748658601,95748658585,-16,1989,965,-40
95753410908,95753410917,9,3521,1038,-40
95756496828,95756496834,6,2541,1017,-40
95759594701,95759594706,5,2795,1245,-40
95762598546,95762598554,8,3215,1171,-40
95764320612,95764320618,6,2690,1485,-40
95771690365,95771690371,6,1461,737,-40
95774274906,95774274911,5,2386,1433,-40
95778716336,95778716337,1,891,980,-40
95780273853,95780273859,6,2511,1149,-40
95785729637,95785729641,4,1396,810,-40
95788142494,95788142500,6,2963,1266,-40
95789126526,95789126531,5,1849,1121,-40
95789295357,95789295358,1,1440,2470,-40
95793880975,95793880979,4,2685,1306,-40
95795057411,95795057417,6,2341,1328,-40
95795473725,95795473731,6,2368,1137,-40
95797828930,95797828935,5,3564,2477,-40
95799612709,95799612716,7,3741,1431,-40
95799994722,95799994730,8,2933,1202,-40
95804549463,95804549470,7,1446,946,-40
95810744854,95810744858,4,1809,1280,-40
95810783543,95810783521,-22,983,25,-40
95813521495,95813521501,6,2937,1091,-40
95813970930,95813970938,8,2337,1765,-40
95815163773,95815163777,4,2498,1652,-40
95819654768,95819654775,7,3939,1322,-40
95821087507,95821087514,7,2561,1047,-40
95821306961,95821306954,-7,1151,4196,-40
95823054734,95823054739,5,2934,1297,-40
95823874614,95823874621,7,1901,1351,-40
95833360242,95833360251,9,2,2894,-40
95839060740,95839060736,-4,682,2134,-40
95841172791,95841172797,6,2492,1376,-40
95842871313,95842871319,6,2030,955,-40
95843253421,95843253421,0,1269,1614,-40
95849901647,95849901654,7,2319,1138,-40
95859832162,95859832169,7,2108,1255,-40
95868968956,95868968962,6,2548,1050,-40
95869064840,95869064846,6,2745,1015,-40
95869759825,95869759808,-17,1273,779,-40
95871095342,95871095350,8,3293,1561,-40
95873340266,95873340273,7,2137,1109,-40
95873976951,95873976951,0,1612,1983,-40
95874354232,95874354237,5,2753,1684,-40
95877983609,95877983613,4,3207,1519,-40
95878854255,95878854263,8,3352,1081,-40
95879015946,95879015953,7,3370,1315,-40
95879217826,95879217834,8,2235,1417,-40
95880792421,95880792426,5,1437,779,-40
95884535508,95884535513,5,1738,1287,-40
95885003113,95885003118,5,2097,1041,-40
95894985295,95894985303,8,3100,1210,-40
95895013312,95895013318,6,3317,1364,-40
95896571188,95896571196,8,2419,991,-40
95896724305,95896724292,-13,1484,834,-40
95902387399,95902387405,6,2508,1445,-40
95903869384,95903869390,6,3155,1338,-40
95907592815,95907592822,7,2142,761,-40
95908115834,95908115842,8,3380,1140,-40
95908457165,95908457146,-19,1815,479,-40
95909162907,95909162904,-3,864,3073,-40
95918629966,95918629974,8,2809,1021,-40
95918875186,95918875195,9,2577,1351,-40
95921491038,95921491046,8,2159,912,-40
95930880050,95930880057,7,2377,1205,-40
95934469090,95934469098,8,2523,1302,-40
95935131591,95935131569,-22,4558,1309,-40
95938522886,95938522891,5,2986,1044,-40
95947226085,95947226091,6,2614,1625,-40
95949715937,95949715941,4,3410,1007,-40
95955222378,95955222385,7,2854,1403,-40
95959270923,95959270928,5,6521,2610,-40
95964313339,95964313345,6,2431,1255,-40
95964693584,95964693591,7,3208,1198,-40
95965286185,95965286180,-5,492,1618,-40
95973008308,95973008305,-3,2183,4463,-40
95973329250,95973329255,5,1497,892,-40
95975958514,95975958519,5,3439,1237,-40
95981000733,95981000739,6,2678,845,-40
95982156799,95982156794,-5,884,1441,-40
95983800374,95983800379,5,3560,1574,-40
95983998773,95983998766,-7,1155,5992,-40
95984603733,95984603739,6,1713,771,-40
95990226529,95990226536,7,3603,1491,-40
95991640923,95991640930,7,1808,1078,-40
95993881842,95993881849,7,3543,1576,-40
95994162014,95994162015,1,1077,746,-40
95994662965,95994662970,5,3805,1366,-40
95999317970,95999317970,0,1575,1454,-40
95999799770,95999799775,5,2064,1177,-40
96001449221,96001449222,1,2029,1156,-40
96003449812,96003449798,-14,1235,929,-40
96004633261,96004633267,6,2080,1165,-40
96007022150,96007022157,7,2436,959,-40
96007783849,96007783854,5,3239,1445,-40
96009920809,96009920815,6,2621,1352,-40
96012300199,96012300206,7,4834,1188,-40
96012981347,96012981353,6,2231,1041,-40
96017097802,96017097798,-4,825,2116,-40
96017548573,96017548569,-4,971,2544,-40
96018184289,96018184296,7,2485,869,-40
96021008305,96021008311,6,1404,995,-40
96023141993,96023141998,5,1662,888,-40
96024673430,96024673435,5,2765,1646,-40
96024735721,96024735726,5,1745,989,-40
96029116736,96029116742,6,4140,1754,-40
96029271290,96029271293,3,16684,15284,-40
96032497405,96032497401,-4,1283,3379,-40
96035363040,96035363046,6,2343,1915,-40
96036671118,96036671123,5,2139,1282,-40
96037703301,96037703307,6,4240,2237,-40
96040857496,96040857502,6,3759,1302,-40
96043083979,96043083982,3,1536,1781,-40
96045130301,96045130309,8,2785,1667,-40
96048472484,96048472491,7,3097,1438,-40
96052103495,96052103502,7,2689,644,-40
96052918339,96052918343,4,1222,990,-40
96053003817,96053003835,18,2364,951,-40
96055131015,96055131022,7,4467,1842,-40
96055659677,96055659685,8,2167,1243,-40
96055843081,96055843064,-17,1842,1499,-40
96057899091,96057899098,7,2827,815,-40
96059377490,96059377496,6,3361,1402,-40
96068292681,96068292689,8,4070,1822,-40
96071979951,96071979955,4,33751,31247,-40
96079385376,96079385383,7,3094,1192,-40
96079842425,96079842408,-17,2261,975,-40
96080306864,96080306860,-4,1794,3656,-40
96086936476,96086936482,6,3752,1274,-40
96088233442,96088233446,4,4323,2073,-40
96091146055,96091146060,5,2885,1605,-40
96093398676,96093398682,6,3266,1140,-40
96094701253,96094701259,6,2024,977,-40
96095688089,96095688095,6,2628,1093,-40
96100744326,96100744335,9,2770,999,-40
96100864066,96100864071,5,3608,1494,-40
96102283303,96102283307,4,1615,1326,-40
96102326046,96102326052,6,2743,948,-40
96103798727,96103798734,7,2382,1165,-40
96105686546,96105686550,4,3240,1786,-40
96111578355,96111578361,6,2198,1296,-40
96119158561,96119158569,8,2065,886,-40
96124714246,96124714254,8,3622,1357,-40
96126056969,96126056975,6,4667,1650,-40
96128260272,96128260279,7,3235,1308,-40
96130433073,96130433077,4,2449,1323,-40
96130835515,96130835521,6,2564,1632,-40
96131096777,96131096762,-15,3299,1857,-40
96141857887,96141857892,5,2295,1063,-40
96144865637,96144865642,5,924,641,-40
96145938428,96145938442,14,3124,930,-40
96150144455,96150144459,4,1882,1094,-40
96151331441,96151331445,4,2757,1188,-40
96154287803,96154287810,7,3813,893,-40
96163037591,96163037599,8,4106,1691,-40
96168428885,96168428893,8,3027,1480,-40
96169001626,96169001636,10,2322,980,-40
96172354109,96172354114,5,2403,1470,-40
96173032472,96173032472,0,2015,2988,-40
96177356287,96177356293,6,2923,1419,-40
96181796838,96181796835,-3,1415,2257,-40
96182647106,96182647111,5,3370,1426,-40
96183701756,96183701763,7,3244,1090,-40
96184641549,96184641555,6,2943,1547,-40
96184866821,96184866826,5,2462,1049,-40
96190991346,96190991353,7,3651,1739,-40
96192520406,96192520412,6,2333,1007,-40
96201631091,96201631097,6,3660,1391,-40
96209330394,96209330399,5,2735,1151,-40
96213645796,96213645802,6,2283,980,-40
96214023170,96214023177,7,2634,847,-40
96214491189,96214491194,5,1807,1400,-40
96215179518,96215179523,5,1901,1007,-40
96216502139,96216502119,-20,1226,1217,-40
96221182691,96221182701,10,3201,1011,-40
96223381809,96223381814,5,2030,1039,-40
96224442379,96224442388,9,3030,1232,-40
96228309329,96228309329,0,1396,1880,-40
96229901125,96229901130,5,2193,1265,-40
96231289079,96231289066,-13,1504,1053,-40
96232430545,96232430551,6,3045,1339,-40
96232678174,96232678156,-18,1205,190,-40
96240086740,96240086746,6,3126,1333,-40
96240241342,96240241330,-12,665,418,-40
96242599371,96242599376,5,2160,948,-40
96244158016,96244158022,6,900,544,-40
96244958966,96244958971,5,2990,1452,-40
96245915039,96245915046,7,2799,1074,-40
96246107371,96246107353,-18,1084,433,-40
96246976508,96246976514,6,3069,1237,-40
96247461977,96247461963,-14,3062,1248,-40
96248742545,96248742551,6,2736,1214,-40
96249388729,96249388747,18,1282,193,-40
96249606581,96249606595,14,2687,1100,-40
96249640449,96249640457,8,1942,895,-40
96249889862,96249889842,-20,988,285,-40
96251720605,96251720598,-7,1970,38735,-40
96252461646,96252461650,4,1454,761,-40
96255243505,96255243511,6,2530,1127,-40
96255621990,96255622008,18,732,40,-40
96257056470,96257056478,8,3034,1136,-40
96262929810,96262929791,-19,971,183,-40
96263552539,96263552544,5,4963,2615,-40
96263596758,96263596761,3,1692,1156,-40
96264931729,96264931738,9,2876,1111,-40
96265064394,96265064402,8,6521,2499,-40
96268622594,96268622601,7,2464,991,-40
96268804831,96268804834,3,2597,87,-40
96274357360,96274357363,3,1893,1822,-40
96274531173,96274531178,5,2430,1608,-40
96280276046,96280276051,5,2019,884,-40
96280892966,96280892970,4,1153,980,-40
96283205056,96283205055,-1,1438,1188,-40
96284142143,96284142126,-17,2048,1004,-40
96287171153,96287171159,6,3828,1325,-40
96290522781,96290522786,5,3298,1298,-40
96293912409,96293912417,8,3645,1291,-40
96298406750,96298406755,5,1906,1781,-40
96301780087,96301780094,7,2360,1197,-40
96305244868,96305244873,5,2109,1243,-40
96306834694,96306834702,8,4020,1253,-40
96318248371,96318248378,7,2139,1066,-40
96319252424,96319252431,7,2924,1541,-40
96321796208,96321796214,6,2301,813,-40
96323587600,96323587606,6,2111,1724,-40
96324840017,96324840023,6,2770,1412,-40
96325128335,96325128339,4,733,1121,-40
96326760717,96326760722,5,3346,1681,-40
96332681215,96332681223,8,3392,1541,-40
96337021222,96337021228,6,4825,2262,-40
96340475381,96340475390,9,2070,875,-40
96342256753,96342256759,6,2613,1317,-40
96343083630,96343083633,3,1802,1319,-40
96343332080,96343332086,6,4982,1050,-40
96349787238,96349787245,7,2997,1380,-40
96356358527,96356358533,6,2396,1197,-40
96358338001,96358338006,5,1982,1374,-40
96360692766,96360692770,4,2812,1092,-40
96361985539,96361985544,5,2401,1415,-40
96363426537,96363426543,6,2547,979,-40
96364137402,96364137410,8,2739,1240,-40
96366975268,96366975275,7,2112,996,-40
96368319916,96368319918,2,1896,1728,-40
96369231152,96369231159,7,2278,948,-40
96376713069,96376713073,4,2388,1204,-40
96378534623,96378534625,2,1524,1958,-40
96379096266,96379096273,7,3354,1423,-40
96379769326,96379769334,8,2755,1332,-40
96379956201,96379956208,7,3277,1233,-40
96385183537,96385183544,7,2804,1009,-40
96385270462,96385270452,-10,1508,718,-40
96385799080,96385799086,6,3304,1133,-40
96387513525,96387513530,5,2920,1529,-40
96387630955,96387630962,7,3706,1446,-40
96390379081,96390379087,6,3452,1546,-40
96391205349,96391205342,-7,1585,6739,-40
96396300650,96396300655,5,2682,1050,-40
96397394873,96397394879,6,2317,1082,-40
96397742553,96397742558,5,3009,1109,-40
96399572646,96399572628,-18,2272,1039,-40
96400106215,96400106234,19,706,351,-40
96405583310,96405583314,4,2671,1024,-40
96405692524,96405692525,1,1366,1135,-40
96409472561,96409472565,4,3051,1154,-40
96413867862,96413867868,6,3108,1155,-40
96415929052,96415929058,6,3834,1635,-40
96421278230,96421278236,6,2206,853,-40
96421946534,96421946540,6,1941,691,-40
96423576303,96423576309,6,3338,1464,-40
96423747133,96423747112,-21,1054,415,-40
96424836055,96424836051,-4,1507,3219,-40
96425840281,96425840285,4,3123,1606,-40
96435446464,96435446458,-6,1289,4522,-40
96439367770,96439367774,4,4245,1526,-40
96440134378,96440134383,5,2553,1310,-40
96440397529,96440397537,8,5832,1927,-40
96448161217,96448161222,5,2644,1603,-40
96450454845,96450454851,6,3700,1411,-40
96453120969,96453120953,-16,1728,509,-40
96454328582,96454328589,7,3682,1477,-40
96454643856,96454643861,5,3320,1366,-40
96455252271,96455252277,6,2987,1400,-40
96455397226,96455397208,-18,1023,93,-40
96456482562,96456482560,-2,1770,3571,-40
96458814643,96458814649,6,3423,1157,-40
96459877495,96459877501,6,5307,2454,-40
96461348126,96461348133,7,3510,1418,-40
96462250706,96462250711,5,1227,573,-40
96462555660,96462555666,6,2687,880,-40
96466062539,96466062544,5,2923,892,-40
96475212192,96475212198,6,2226,1543,-40
96477679047,96477679053,6,943,306,-40
96479733962,96479733958,-4,1265,3169,-40
96480896850,96480896855,5,1992,813,-40
96484029787,96484029782,-5,2241,5750,-40
96486664887,96486664892,5,3024,1261,-40
96493051714,96493051719,5,3131,1823,-40
96494820709,96494820714,5,2671,1102,-40
96498099334,96498099342,8,4216,1515,-40
96498585988,96498585993,5,1928,1300,-40
96502484411,96502484415,4,2732,1147,-40
96503263583,96503263569,-14,2121,829,-40
96503836406,96503836386,-20,581,165,-40
96504298061,96504298068,7,2940,1228,-40
96514272885,96514272891,6,1329,855,-40
96524903519,96524903523,4,2740,1596,-40
96525285887,96525285894,7,3759,1295,-40
96527079196,96527079191,-5,1438,5004,-40
96530532187,96530532205,18,29123,21277,-40
96533623619,96533623623,4,2696,1120,-40
96535718585,96535718585,0,13879,16406,-40
96536508950,96536508957,7,2694,1595,-40
96536820802,96536820807,5,2574,1641,-40
96537405947,96537405952,5,2442,992,-40
96540184568,96540184574,6,2640,1051,-40
96540734311,96540734318,7,2239,1470,-40
96542037150,96542037145,-5,1553,3506,-40
96554343230,96554343236,6,3089,1384,-40
96554392379,96554392385,6,2424,1213,-40
96554553401,96554553407,6,2111,1322,-40
96557003169,96557003175,6,2649,1441,-40
96558975796,96558975802,6,52599,14458,-40
96562420097,96562420103,6,1902,769,-40
96564250403,96564250409,6,3370,1813,-40
96565875402,96565875410,8,2423,928,-40
96567952546,96567952552,6,3547,1671,-40
96568439432,96568439437,5,3027,972,-40
96569153622,96569153602,-20,1346,904,-40
96573851437,96573851431,-6,1847,9218,-40
96574359202,96574359210,8,3011,826,-40
96580665606,96580665613,7,3641,1475,-40
96585328258,96585328263,5,1032,1039,-40
96585394862,96585394867,5,3072,1342,-40
96585590722,96585590726,4,1920,1432,-40
96587719648,96587719655,7,1913,1605,-40
96588068984,96588068989,5,3005,1582,-40
96596291232,96596291246,14,14297,5046,-40
96601246041,96601246044,3,1387,1068,-40
96612768305,96612768307,2,1696,1356,-40
96615452432,96615452439,7,4120,1631,-40
96617262281,96617262287,6,2229,908,-40
96619536885,96619536892,7,2929,1499,-40
96625753495,96625753501,6,3478,1815,-40
96625924981,96625924988,7,3498,1560,-40
96627124502,96627124510,8,1373,778,-40
96629186819,96629186826,7,4453,1755,-40
96630016402,96630016385,-17,1425,768,-40
96632350686,96632350694,8,2742,1859,-40
96635123241,96635123250,9,2883,1451,-40
96636204263,96636204270,7,2603,1661,-40
96636252246,96636252251,5,2724,1820,-40
96638599989,96638599994,5,3802,1930,-40
96643404176,96643404181,5,1540,1156,-40
96643578336,96643578343,7,2506,858,-40
96651771279,96651771283,4,2026,1071,-40
96652121908,96652121914,6,2634,1157,-40
96660948839,96660948846,7,3088,944,-40
96661210531,96661210515,-16,1731,553,-40
96666073534,96666073542,8,1109,335,-40
96666747885,96666747890,5,3117,1053,-40
96667202029,96667202037,8,1987,822,-40
96673906514,96673906520,6,3521,956,-40
96675727885,96675727891,6,2525,955,-40
96676268922,96676268927,5,2677,1202,-40
96681103753,96681103760,7,1963,1011,-40
96686731101,96686731107,6,3692,1419,-40
96687732039,96687732044,5,2206,1601,-40
96688001171,96688001154,-17,2906,978,-40
96689094254,96689094258,4,2114,905,-40
96691292833,96691292837,4,1814,1388,-40
96692166842,96692166848,6,3051,1330,-40
96704992998,96704993004,6,1686,1152,-40
96705582774,96705582753,-21,3214,1070,-40
96708421629,96708421635,6,2730,883,-40
96708857890,96708857897,7,3289,1256,-40
96712358342,96712358348,6,2664,1579,-40
96717885982,96717885991,9,2437,790,-40
96719589426,96719589433,7,3330,1246,-40
96720524429,96720524435,6,3305,1459,-40
96722313127,96722313134,7,2186,1198,-40
96722491438,96722491443,5,2265,1180,-40
96725444535,96725444541,6,2852,1434,-40
96725515740,96725515746,6,746,54,-40
96728261349,96728261354,5,4181,1722,-40
96729568723,96729568729,6,2650,1325,-40
96733832998,96733833003,5,4047,1621,-40
96735913222,96735913227,5,1470,991,-40
96738072979,96738072985,6,2591,1315,-40
96739403966,96739403974,8,3094,1479,-40
96739653064,96739653069,5,2485,1423,-40
96739838172,96739838178,6,1954,1371,-40
96744261852,96744261858,6,2500,1476,-40
96744364929,96744364933,4,2445,1043,-40
96749501013,96749501020,7,2584,937,-40
96751586164,96751586170,6,2947,1999,-40
96752004466,96752004472,6,5058,2240,-40
96752410865,96752410870,5,2735,867,-40
96752912214,96752912223,9,2663,1394,-40
96754569609,96754569614,5,2565,1404,-40
96760319825,96760319832,7,2928,1564,-40
96766819242,96766819248,6,2818,1338,-40
96770667382,96770667386,4,3307,1252,-40
96770694014,96770694001,-13,1288,399,-40
96771141144,96771141150,6,3029,1557,-40
96773519517,96773519525,8,2985,1015,-40
96776507950,96776507953,3,931,175,-40
96777445045,96777445058,13,1030,140,-40
96778330990,96778330997,7,3030,1337,-40
96783001653,96783001644,-9,1300,398,-40
96792056593,96792056598,5,2889,1542,-40
96793436443,96793436447,4,1269,407,-40
96794575310,96794575315,5,2930,1089,-40
96806161686,96806161693,7,3127,1499,-40
96806362597,96806362602,5,1684,770,-40
96809326899,96809326903,4,3325,1325,-40
96814445283,96814445289,6,3289,1985,-40
96816973010,96816973016,6,3542,1424,-40
96823409623,96823409627,4,2478,1321,-40
96824650200,96824650206,6,4639,2124,-40
96827034829,96827034835,6,2979,1045,-40
96827152118,96827152121,3,618,89,-40
96829530564,96829530569,5,2419,1226,-40
96831088364,96831088371,7,2615,1124,-40
96831138621,96831138604,-17,1961,1010,-40
96831367211,96831367220,9,471,2493,-40
96841673634,96841673641,7,3759,1401,-40
96842199778,96842199793,15,2548,1341,-40
96848907270,96848907268,-2,31184,22700,-40
96852470540,96852470536,-4,1429,3950,-40
96857376931,96857376938,7,3581,997,-40
96857846046,96857846054,8,3163,1098,-40
96857877368,96857877374,6,3903,1373,-40
96866731773,96866731768,-5,879,2672,-40
96868903340,96868903346,6,3125,1780,-40
96873902388,96873902392,4,2658,1439,-40
96879445926,96879445933,7,3193,1032,-40
96881869550,96881869556,6,3900,1650,-40
96882588830,96882588838,8,3008,1094,-40
96890918860,96890918866,6,2780,1299,-40
96892515781,96892515787,6,3329,1213,-40
96895828985,96895828991,6,3538,1859,-40
96897096766,96897096773,7,3246,1777,-40
96898614438,96898614443,5,2571,1184,-40
96902231282,96902231289,7,2432,1238,-40
96905822254,96905822261,7,902,832,-40
96907950386,96907950394,8,3337,1277,-40
96913077838,96913077847,9,1046,681,-40
96914783358,96914783362,4,2125,1239,-40
96919597665,96919597671,6,1451,745,-40
96920240810,96920240792,-18,4829,1755,-40
96926992606,96926992614,8,2232,1021,-40
96928038140,96928038145,5,3300,1422,-40
96931896501,96931896506,5,3559,1668,-40
96932267327,96932267333,6,2452,1133,-40
96934317127,96934317133,6,5492,2624,-40
96934479780,96934479786,6,2304,1116,-40
96935892345,96935892350,5,3436,1392,-40
96938469208,96938469214,6,1331,947,-40
96939869018,96939869021,3,2925,2188,-40
96941143878,96941143885,7,3833,1175,-40
96945029721,96945029726,5,2856,1725,-40
96946273857,96946273862,5,2681,1312,-40
96947028410,96947028407,-3,1427,3635,-40
96951987814,96951987819,5,1608,860,-40
96953943263,96953943243,-20,1099,552,-40
96954577330,96954577338,8,3650,1142,-40
96955179764,96955179761,-3,42854,18744,-40
96957094605,96957094611,6,2533,877,-40
96958930491,96958930498,7,2735,1587,-40
96959296021,96959296026,5,2879,1157,-40
96959750198,96959750206,8,3666,1027,-40
96961829408,96961829393,-15,2623,1058,-40
96963009133,96963009139,6,3251,1455,-40
96963713215,96963713221,6,2609,874,-40
96963755195,96963755194,-1,737,222,-40
96967228343,96967228350,7,2985,1551,-40
96967403068,96967403072,4,1181,880,-40
96972932751,96972932757,6,1915,702,-40
96974465568,96974465575,7,2756,1068,-40
96974916973,96974916975,2,1627,1242,-40
96978032358,96978032343,-15,2658,45412,-40
96979442114,96979442121,7,3398,1383,-40
96980570569,96980570576,7,6273,2680,-40
96981438702,96981438710,8,3051,1232,-40
96981506843,96981506850,7,3291,1362,-40
96982724474,96982724481,7,3015,1732,-40
96984684881,96984684888,7,3497,1034,-40
96984755965,96984755955,-10,757,281,-40
96987756576,96987756582,6,3141,1191,-40
96987978802,96987978809,7,2097,950,-40
96988123066,96988123073,7,2239,1224,-40
96989052526,96989052543,17,2482,1047,-40
96989945042,96989945026,-16,3908,1373,-40
96990424640,96990424647,7,2088,1024,-40
96999470501,96999470509,8,3516,1200,-40
96999685362,96999685379,17,2699,2120,-40
97004523353,97004523360,7,2832,1162,-40
97012678145,97012678151,6,3304,1202,-40
97014384627,97014384635,8,2545,980,-40
97015099084,97015099089,5,2329,1368,-40
97015359916,97015359922,6,3221,1819,-40
97017626859,97017626862,3,931,437,-40
97022073162,97022073166,4,3590,1424,-40
97024961637,97024961641,4,1768,1528,-40
97029186605,97029186611,6,2558,1065,-40
97030218537,97030218543,6,4266,1036,-40
97038783385,97038783391,6,3058,1370,-40
97039254245,97039254253,8,3777,1395,-40
97040755450,97040755455,5,3027,1101,-40
97047045555,97047045561,6,3462,1395,-40
97048307268,97048307266,-2,1129,1525,-40
97052443977,97052443984,7,1015,281,-40
97052935359,97052935378,19,1933,1080,-40
97053610904,97053610909,5,2408,1426,-40
97054393469,97054393475,6,1927,1557,-40
97057397426,97057397434,8,4119,1312,-40
97058159396,97058159403,7,3586,1598,-40
97058199811,97058199818,7,2611,1553,-40
97060289521,97060289527,6,2868,1409,-40
97060535494,97060535498,4,2878,1188,-40
97061787103,97061787107,4,1795,971,-40
97064834545,97064834551,6,3718,1179,-40
97066437374,97066437380,6,2731,1408,-40
97067254815,97067254792,-23,2640,575,-40
97071410102,97071410109,7,4123,1189,-40
97076256665,97076256669,4,2373,1217,-40
97083419717,97083419713,-4,788,1729,-40
97083737070,97083737073,3,2332,1185,-40
97084938883,97084938891,8,2790,1194,-40
97087437817,97087437826,9,2962,1122,-40
97089086436,97089086442,6,2174,1395,-40
97096018253,97096018258,5,2336,1144,-40
97098284331,97098284350,19,1095,330,-40
97106107019,97106107015,-4,881,2297,-40
97108799770,97108799776,6,2178,1479,-40
97113001050,97113001057,7,3265,1794,-40
97116559896,97116559903,7,3413,1490,-40
97117316390,97117316396,6,3391,1419,-40
97117381150,97117381168,18,3299,1253,-40
97119314304,97119314310,6,2759,1437,-40
97121572885,97121572891,6,2256,673,-40
97123497025,97123497030,5,2198,1440,-40
97125675099,97125675102,3,21311,48913,-40
97127285257,97127285264,7,3024,1681,-40
97130261767,97130261773,6,3370,1651,-40
97134123413,97134123418,5,2398,1305,-40
97135147349,97135147355,6,1479,871,-40
97136176689,97136176693,4,2759,1474,-40
97139097857,97139097863,6,3757,2258,-40
97146193186,97146193193,7,11331,4594,-40
97149085704,97149085713,9,4282,936,-40
97149342517,97149342536,19,4747,1817,-40
97150281862,97150281851,-11,969,124,-40
97151742193,97151742198,5,3300,1205,-40
97153222022,97153222027,5,2018,1415,-40
97153925960,97153925966,6,3211,1342,-40
97158505457,97158505440,-17,1097,643,-40
97159445284,97159445290,6,3387,1340,-40
97161813816,97161813822,6,2924,1086,-40
97169682592,97169682598,6,3703,1080,-40
97171393596,97171393602,6,2660,1401,-40
97171595869,97171595851,-18,1335,422,-40
97172777043,97172777051,8,5143,894,-40
97180327251,97180327257,6,2817,1226,-40
97187974998,97187974997,-1,2545,3881,-40
97205033882,97205033889,7,2481,1441,-40
97209228065,97209228074,9,4492,1600,-40
97210952630,97210952637,7,2047,1035,-40
97211360710,97211360706,-4,968,240,-40
97214652345,97214652352,7,2106,1077,-40
97215019500,97215019481,-19,2718,1256,-40
97219652227,97219652235,8,2665,1123,-40
97221329977,97221329985,8,2622,1357,-40
97222926053,97222926058,5,2921,1246,-40
97224191605,97224191611,6,1616,960,-40
97224659795,97224659778,-17,798,207,-40
97226797225,97226797230,5,2467,1266,-40
97228683454,97228683461,7,3636,1715,-40
97229077706,97229077711,5,1918,1300,-40
97232435129,97232435135,6,2057,1158,-40
97234888335,97234888339,4,1668,900,-40
97237532439,97237532446,7,2767,1416,-40
97238634593,97238634599,6,2646,1159,-40
97238892381,97238892386,5,3275,1270,-40
97241691790,97241691795,5,3070,1274,-40
97241886551,97241886558,7,3308,1103,-40
97242698067,97242698074,7,3494,1938,-40
97249792903,97249792909,6,5236,2093,-40
97252550714,97252550718,4,2555,1142,-40
97255702746,97255702749,3,33350,35516,-40
97256588437,97256588444,7,114076,61447,-40
97257262147,97257262148,1,1347,1759,-40
97257652272,97257652273,1,3249,3756,-40
97260352650,97260352657,7,3120,1236,-40
97261285425,97261285430,5,2666,1215,-40
97262099663,97262099660,-3,1435,3405,-40
97262652013,97262652018,5,3174,1526,-40
97262745881,97262745887,6,3098,1446,-40
97264436174,97264436176,2,1955,1642,-40
97266629383,97266629378,-5,1282,2812,-40
97267114418,97267114425,7,3269,1250,-40
97269578808,97269578814,6,3038,1357,-40
97270678674,97270678681,7,3230,1441,-40
97270707018,97270707027,9,3046,1189,-40
97271357365,97271357354,-11,1098,265,-40
97272066422,97272066428,6,1903,1290,-40
97275353805,97275353811,6,3261,1594,-40
97275826134,97275826142,8,3033,1187,-40
97280601672,97280601679,7,2845,899,-40
97281133705,97281133711,6,1113,486,-40
97286800132,97286800139,7,2694,1093,-40
97287463090,97287463099,9,2327,1088,-40
97290395823,97290395829,6,3455,1264,-40
97290454822,97290454843,21,3629,1759,-40
97292553750,97292553757,7,2795,1141,-40
97292601412,97292601413,1,1981,1869,-40
97293274201,97293274206,5,2943,1653,-40
97297973503,97297973521,18,3200,1255,-40
97309743645,97309743651,6,3390,1216,-40
97309849194,97309849177,-17,2811,748,-40
97310417950,97310417957,7,2623,1287,-40
97312410009,97312410011,2,23073,57119,-40
97312763846,97312763851,5,2480,1051,-40
97317676865,97317676872,7,3037,1514,-40
97319219425,97319219431,6,2624,798,-40
97319689918,97319689923,5,2813,1529,-40
97320282736,97320282741,5,3358,1722,-40
97320990653,97320990658,5,3445,1102,-40
97321357558,97321357548,-10,939,113,-40
97321948775,97321948773,-2,3276,6476,-40
97322697702,97322697702,0,1370,1245,-40
97325039617,97325039622,5,2350,1206,-40
97326722252,97326722258,6,2014,995,-40
97327998142,97327998146,4,2365,914,-40
97331336402,97331336408,6,3171,1678,-40
97331517318,97331517325,7,3867,1403,-40
97335703748,97335703749,1,1687,1845,-40
97347799872,97347799879,7,3089,953,-40
97352060373,97352060379,6,2771,1201,-40
97353016505,97353016510,5,2802,1331,-40
97354193298,97354193303,5,4297,1139,-40
97356200809,97356200808,-1,1130,1819,-40
97359188755,97359188763,8,2153,1025,-40
97360770252,97360770258,6,2846,1215,-40
97361749465,97361749470,5,2170,898,-40
97362142357,97362142371,14,4312,1304,-40
97365403050,97365403049,-1,2783,5308,-40
97374316705,97374316711,6,3340,976,-40
97380275181,97380275187,6,3696,1262,-40
97380500722,97380500712,-10,1060,334,-40
97383450126,97383450131,5,2300,1004,-40
97383890826,97383890842,16,3114,1271,-40
97384203374,97384203395,21,1888,930,-40
97384713717,97384713716,-1,1725,2541,-40
97388743090,97388743095,5,1253,1387,-40
97388909233,97388909239,6,3413,1202,-40
97395295805,97395295809,4,1524,782,-40
97396316021,97396316028,7,3076,993,-40
97400069957,97400069963,6,3854,1464,-40
97400190343,97400190350,7,1874,1194,-40
97401706418,97401706426,8,3451,1934,-40
97403175258,97403175258,0,2806,4419,-40
97404750886,97404750884,-2,979,2814,-40
97407730645,97407730653,8,3047,1182,-40
97409143691,97409143697,6,4070,1684,-40
97414011533,97414011540,7,1387,548,-40
97416579286,97416579271,-15,3299,805,-40
97419152014,97419152019,5,1315,830,-40
97421045344,97421045351,7,4403,1398,-40
97426990047,97426990054,7,2108,800,-40
97427635141,97427635146,5,2843,1329,-40
97430364633,97430364632,-1,3518,4647,-40
97431358983,97431358966,-17,1555,622,-40
97432642394,97432642399,5,2424,1402,-40
97433506538,97433506537,-1,1291,2633,-40
97434738493,97434738498,5,2096,1086,-40
97436509454,97436509456,2,939,140,-40
97437189430,97437189448,18,2319,1644,-40
97444967821,97444967827,6,2159,923,-40
97448811849,97448811855,6,3256,1319,-40
97457248855,97457248862,7,3145,1089,-40
97457941101,97457941090,-11,726,324,-40
97462044420,97462044426,6,1868,1539,-40
97464478690,97464478696,6,2710,1358,-40
97465624205,97465624210,5,2806,1220,-40
97470457573,97470457580,7,11972,43874,-40
97477988518,97477988519,1,903,732,-40
97479269519,97479269525,6,3492,1171,-40
97479498935,97479498942,7,1732,892,-40
97481205573,97481205571,-2,1059,1365,-40
97483337549,97483337557,8,3734,1210,-40
97486724166,97486724173,7,2905,782,-40
97487400437,97487400429,-8,2125,8983,-40
97496021762,97496021766,4,2569,1192,-40
97499633483,97499633487,4,2804,1271,-40
97502971490,97502971497,7,4430,1649,-40
97503140533,97503140541,8,3533,1309,-40
97507265471,97507265478,7,2184,1149,-40
97508337757,97508337763,6,2626,1053,-40
97511524200,97511524214,14,15619,8001,-40
97513279298,97513279300,2,7223,6057,-40
97515894431,97515894429,-2,1117,2230,-40
97520240109,97520240114,5,2967,954,-40
97520272891,97520272895,4,2329,1022,-40
97525010911,97525010917,6,3882,834,-40
97525204104,97525204097,-7,1224,6425,-40
97528192116,97528192121,5,2754,1299,-40
97534544268,97534544274,6,3354,1315,-40
97536404675,97536404682,7,2826,853,-40
97537327236,97537327242,6,3367,1080,-40
97538120157,97538120154,-3,1339,2336,-40
97545542041,97545542047,6,2698,1373,-40
97546469794,97546469801,7,3563,1339,-40
97549559083,97549559077,-6,1198,3578,-40
97552061489,97552061494,5,1726,1747,-40
97552632573,97552632578,5,2306,1326,-40
97552895477,97552895483,6,2655,1163,-40
97557084862,97557084867,5,2765,1190,-40
97557294411,97557294418,7,3091,1300,-40
97560120322,97560120328,6,2691,766,-40
97560725063,97560725058,-5,1090,129,-40
97571506733,97571506739,6,2310,1034,-40
97571799916,97571799899,-17,2948,1182,-40
97572493481,97572493487,6,2730,1165,-40
97572996192,97572996198,6,3067,1065,-40
97573933031,97573933035,4,882,150,-40
97575641213,97575641220,7,2463,1246,-40
97577325334,97577325333,-1,34621,48085,-40
97577642621,97577642617,-4,1135,3144,-40
97579645802,97579645808,6,3443,1418,-40
97585850882,97585850889,7,2872,1585,-40
97586188941,97586188946,5,3300,1114,-40
97594508845,97594508851,6,2427,1081,-40
97595276783,97595276789,6,2239,1304,-40
97597618116,97597618125,9,3048,1365,-40
97597800043,97597800045,2,3954,16955,-40
97598139446,97598139447,1,1405,22906,-40
97601264153,97601264159,6,3055,1626,-40
97602353564,97602353570,6,1039,634,-40
97602825710,97602825715,5,2587,1030,-40
97603373637,97603373638,1,2828,3689,-40
97608457721,97608457728,7,3566,1814,-40
97609056347,97609056354,7,2793,1232,-40
97609517909,97609517914,5,3161,1350,-40
97616026932,97616026947,15,910,3658,-40
97617751174,97617751181,7,3230,1111,-40
97622915557,97622915562,5,1989,995,-40
97624858805,97624858811,6,2504,1223,-40
97627496717,97627496724,7,3281,1264,-40
97628056102,97628056089,-13,2026,684,-40
97628930166,97628930162,-4,27224,10449,-40
97629146915,97629146919,4,1613,950,-40
97634166559,97634166566,7,2885,1210,-40
97634784774,97634784779,5,652,192,-40
97635485769,97635485775,6,2837,1497,-40
97635560926,97635560933,7,3477,1741,-40
97636017582,97636017588,6,2625,1006,-40
97636227210,97636227213,3,3254,1762,-40
97641505113,97641505121,8,2846,1250,-40
97646449186,97646449193,7,2468,1418,-40
97651149525,97651149531,6,3443,1476,-40
97651613867,97651613872,5,3090,1836,-40
97651830531,97651830538,7,3492,1557,-40
97654101589,97654101594,5,2880,1378,-40
97654587533,97654587539,6,2553,1148,-40
97655318373,97655318381,8,4730,1244,-40
97656139905,97656139902,-3,1154,3534,-40
97658617409,97658617414,5,3021,1392,-40
97660560683,97660560689,6,2389,1244,-40
97665334395,97665334403,8,3080,1493,-40
97667255302,97667255297,-5,953,4463,-40
97668881266,97668881262,-4,1400,3168,-40
97669924277,97669924284,7,3087,1057,-40
97672971595,97672971593,-2,47,1217,-40
97673030910,97673030913,3,1519,1547,-40
97673845490,97673845495,5,2485,1357,-40
97678980222,97678980227,5,2994,1222,-40
97683511190,97683511196,6,3521,1561,-40
97683761600,97683761584,-16,2152,865,-40
97685460462,97685460467,5,1715,1020,-40
97685515163,97685515163,0,774,308,-40
97686777790,97686777802,12,3019,1140,-40
97692795459,97692795467,8,2403,554,-40
97699716005,97699716011,6,3840,1544,-40
97700614557,97700614558,1,2291,1912,-40
97700820426,97700820421,-5,18951,14718,-40
97701037495,97701037501,6,2936,1191,-40
97705286514,97705286513,-1,905,2084,-40
97708980286,97708980291,5,3161,1576,-40
97709554832,97709554838,6,2117,1033,-40
97713274732,97713274738,6,3154,1425,-40
97714269661,97714269667,6,2778,1292,-40
97715116895,97715116903,8,3039,1058,-40
97715763565,97715763577,12,2237,1328,-40
97718000399,97718000395,-4,1196,1910,-40
97728408522,97728408521,-1,930,1457,-40
97728763094,97728763100,6,4084,1680,-40
97729078810,97729078817,7,3826,1642,-40
97734842864,97734842871,7,2278,909,-40
97734938333,97734938316,-17,2907,1371,-40
97741959425,97741959430,5,2363,1118,-40
97744045962,97744045969,7,2717,1440,-40
97744773219,97744773227,8,2608,1396,-40
97745446401,97745446406,5,3067,1590,-40
97745646997,97745647002,5,2815,1505,-40
97748423769,97748423775,6,2299,1410,-40
97752701421,97752701426,5,3701,1304,-40
97752808078,97752808057,-21,1857,865,-40
97753073376,97753073382,6,3432,1172,-40
97754650602,97754650610,8,2716,1024,-40
97757820638,97757820642,4,2095,1596,-40
97758208664,97758208671,7,2890,1193,-40
97760234913,97760234918,5,2555,966,-40
97760321297,97760321303,6,1564,764,-40
97760627322,97760627327,5,3825,1364,-40
97762102303,97762102309,6,2811,1730,-40
97764313998,97764314005,7,3070,1248,-40
97765427484,97765427493,9,4404,1696,-40
97769298365,97769298370,5,3763,1453,-40
97772334362,97772334369,7,2284,1115,-40
97775633028,97775633033,5,2479,1134,-40
97776646105,97776646098,-7,938,226,-40
97777076799,97777076806,7,4533,1321,-40
97778941448,97778941455,7,3508,1568,-40
97782267775,97782267781,6,2678,1748,-40
97783700997,97783701003,6,3538,1656,-40
97786598270,97786598278,8,1140,263,-40
97793317915,97793317922,7,2144,1211,-40
97799015317,97799015322,5,2794,1227,-40
97800939029,97800939034,5,2036,1045,-40
97801420677,97801420683,6,2739,1169,-40
97802528417,97802528426,9,1883,1135,-40
97804997057,97804997063,6,2121,492,-40
97808343063,97808343081,18,1842,7891,-40
97820874426,97820874433,7,2999,1342,-40
97823606673,97823606680,7,2407,1509,-40
97823708439,97823708417,-22,4849,1757,-40
97827859954,97827859957,3,3753,3814,-40
97832356085,97832356091,6,3408,1303,-40
97833524914,97833524922,8,3909,1117,-40
97835723291,97835723298,7,1964,1250,-40
97840553958,97840553966,8,4792,1848,-40
97843186012,97843186013,1,5301,6354,-40
97843570463,97843570469,6,3136,1409,-40
97844463414,97844463418,4,2265,1299,-40
97848446840,97848446845,5,2559,2063,-40
97848646879,97848646887,8,1981,1255,-40
97852483842,97852483848,6,2564,1136,-40
97858122073,97858122078,5,2720,1232,-40
97864524042,97864524047,5,3012,1114,-40
97868080695,97868080701,6,3750,1421,-40
97878301488,97878301495,7,2929,1183,-40
97878868602,97878868587,-15,2871,1040,-40
97879383403,97879383410,7,2660,842,-40
97880018633,97880018618,-15,889,450,-40
97887318718,97887318724,6,2375,1443,-40
97888848310,97888848315,5,2161,1252,-40
97890416735,97890416742,7,2998,881,-40
97891107461,97891107466,5,2408,1399,-40
97892716683,97892716690,7,3218,1101,-40
97897666576,97897666582,6,2636,1045,-40
97899723302,97899723306,4,2503,1148,-40
97901900077,97901900083,6,2253,1261,-40
97902517902,97902517910,8,2901,924,-40
97903390534,97903390521,-13,1315,382,-40
97907205421,97907205427,6,3225,1265,-40
97909110634,97909110641,7,2180,1331,-40
97909986828,97909986835,7,3008,1178,-40
97913766093,97913766099,6,3889,1606,-40
97915280889,97915280894,5,3268,1070,-40
97916058705,97916058710,5,2718,1325,-40
97919584405,97919584411,6,1587,753,-40
97920102247,97920102256,9,883,298,-40
97923736817,97923736823,6,2516,828,-40
97924251361,97924251366,5,1848,1027,-40
97924600882,97924600890,8,3681,1526,-40
97925510245,97925510250,5,2264,1234,-40
97925975105,97925975106,1,819,280,-40
97932398444,97932398447,3,1928,1038,-40
97933601258,97933601265,7,2316,1719,-40
97935009217,97935009222,5,2846,1510,-40
97935200589,97935200569,-20,3231,1522,-40
97935489713,97935489719,6,1729,33599,-40
97935617111,97935617119,8,3916,1795,-40
97941074448,97941074454,6,2589,1030,-40
97943595840,97943595845,5,2442,1277,-40
97945172046,97945172053,7,3430,1797,-40
97948786708,97948786709,1,1600,2061,-40
97951017534,97951017541,7,2124,925,-40
97953595155,97953595161,6,2706,1058,-40
97958619902,97958619906,4,2590,1381,-40
97958800293,97958800315,22,1276,270,-40
97970757304,97970757310,6,3713,1465,-40
97971168774,97971168782,8,3067,1277,-40
97971286798,97971286804,6,3174,1274,-40
97972037158,97972037153,-5,1892,5005,-40
97975973350,97975973351,1,1487,1505,-40
97978040653,97978040658,5,2619,1006,-40
97982279507,97982279514,7,2273,1218,-40
97984080705,97984080711,6,2641,1111,-40
97984136139,97984136120,-19,2490,1123,-40
97984312471,97984312475,4,1427,878,-40
97986347722,97986347726,4,2242,1457,-40
97988825241,97988825249,8,2555,1106,-40
97990565769,97990565754,-15,3315,846,-40
97990641685,97990641690,5,3652,1161,-40
97997790865,97997790871,6,2211,1130,-40
97999947939,97999947945,6,3431,1507,-40
98008367680,98008367681,1,1240,2258,-40
98009809231,98009809238,7,3943,1591,-40
98015439635,98015439639,4,3212,1506,-40
98020537779,98020537786,7,3988,1479,-40
98023036442,98023036447,5,3029,1167,-40
98026556815,98026556821,6,2796,1047,-40
98027349989,98027349996,7,3260,1905,-40
98034479948,98034479955,7,2432,1480,-40
98041245183,98041245189,6,2885,1193,-40
98051087134,98051087139,5,2423,1537,-40
98052850050,98052850055,5,1910,646,-40
98054900437,98054900445,8,3078,1193,-40
98055507174,98055507179,5,2518,943,-40
98056532238,98056532242,4,2342,858,-40
98057761021,98057761027,6,3865,1887,-40
98058088988,98058088997,9,2962,1327,-40
98059278346,98059278351,5,2612,1290,-40
98060884777,98060884782,5,2901,1216,-40
98064688326,98064688333,7,2081,1112,-40
98065196230,98065196241,11,2692,824,-40
98065390074,98065390090,16,489,89,-40
98065888494,98065888501,7,2753,1421,-40
98065980021,98065980027,6,2101,957,-40
98066783946,98066783953,7,1282,288,-40
98071361697,98071361703,6,2804,1329,-40
98071887970,98071887975,5,2142,1357,-40
98074594629,98074594635,6,3686,1473,-40
98083515486,98083515490,4,2306,1376,-40
98087379335,98087379341,6,3557,1564,-40
98087734403,98087734410,7,3086,1295,-40
98087966358,98087966363,5,2540,1328,-40
98095701333,98095701349,16,13696,35842,-40
98101760744,98101760737,-7,1729,7588,-40
98105268781,98105268786,5,2902,1395,-40
98106209465,98106209470,5,1650,1224,-40
98109825887,98109825893,6,3954,1726,-40
98110674050,98110674044,-6,742,3052,-40
98112651422,98112651426,4,2603,1145,-40
98112845819,98112845802,-17,1413,724,-40
98117613008,98117613014,6,2415,1042,-40
98127663333,98127663340,7,3563,1988,-40
98136600097,98136600103,6,2297,1323,-40
98139394363,98139394358,-5,1442,3163,-40
98139623410,98139623415,5,3029,993,-40
98143938667,98143938673,6,1857,1094,-40
98147867758,98147867765,7,2901,1673,-40
98148244919,98148244925,6,4146,1282,-40
98149679254,98149679262,8,2195,812,-40
98149842497,98149842484,-13,1277,503,-40
98157518743,98157518750,7,2749,1557,-40
98158067380,98158067362,-18,1497,653,-40
98159763350,98159763355,5,2817,1134,-40
98159911949,98159911955,6,3149,1522,-40
98167000671,98167000670,-1,7201,9764,-40
98167257026,98167257033,7,11988,28342,-40
98167611245,98167611252,7,2587,1578,-40
98168423679,98168423675,-4,1724,5136,-40
98168507673,98168507677,4,2842,1402,-40
98169530864,98169530870,6,3183,1075,-40
98169602788,98169602795,7,580,331,-40
98177403745,98177403751,6,2205,1178,-40
98179577951,98179577957,6,3013,1436,-40
98186203629,98186203634,5,1713,542,-40
98186525062,98186525070,8,2911,1512,-40
98187945066,98187945074,8,2956,1252,-40
98189019901,98189019902,1,1566,1365,-40
98192147926,98192147933,7,2455,1068,-40
98192555461,98192555474,13,3359,1006,-40
98193725761,98193725762,1,2619,2385,-40
98196565316,98196565322,6,2649,1016,-40
98196698665,98196698673,8,2945,1389,-40
98198231978,98198231986,8,3509,1635,-40
98201517127,98201517130,3,1332,1762,-40
98202668714,98202668719,5,2683,1225,-40
98203865034,98203865038,4,2075,1307,-40
98205502019,98205502027,8,2540,1341,-40
98206529061,98206529066,5,2541,1518,-40
98207904142,98207904147,5,2783,1318,-40
98208056055,98208056044,-11,1995,658,-40
98208327233,98208327242,9,2843,1112,-40
98210564942,98210564937,-5,2210,6677,-40
98210867041,98210867047,6,3316,1137,-40
98211278434,98211278439,5,2860,2008,-40
98215166366,98215166373,7,1822,1237,-40
98216582115,98216582122,7,3707,1292,-40
98217326244,98217326250,6,3353,1176,-40
98224129349,98224129353,4,2686,1271,-40
98227957190,98227957195,5,2283,1522,-40
98228303424,98228303427,3,1890,1250,-40
98231531293,98231531297,4,1952,1325,-40
98233707812,98233707818,6,5527,2548,-40
98249370054,98249370059,5,2773,1109,-40
98251578121,98251578127,6,4141,1836,-40
98253293694,98253293699,5,4604,1504,-40
98257405188,98257405196,8,2825,1442,-40
98257643469,98257643475,6,3275,1114,-40
98260278782,98260278787,5,3535,1301,-40
98262906689,98262906695,6,1323,403,-40
98263694650,98263694657,7,2784,1440,-40
98264494812,98264494820,8,3210,1505,-40
98266720906,98266720910,4,2934,1280,-40
98269119087,98269119094,7,3902,1413,-40
98269891719,98269891726,7,2419,1387,-40
98271744985,98271744991,6,1953,915,-40
98272459285,98272459290,5,960,771,-40
98273667933,98273667936,3,1191,751,-40
98275777011,98275777018,7,3758,1260,-40
98275998465,98275998470,5,3242,1986,-40
98284715082,98284715088,6,3078,1299,-40
98291242891,98291242897,6,2729,948,-40
98293096349,98293096355,6,3288,1654,-40
98297398222,98297398229,7,2395,1140,-40
98298070869,98298070872,3,777,266,-40
98301615243,98301615250,7,3099,1556,-40
98302744645,98302744652,7,3393,1387,-40
98303039969,98303039974,5,2921,1058,-40
98304857001,98304857007,6,2920,1697,-40
98312265690,98312265697,7,2670,1476,-40
98312414670,98312414677,7,3512,1340,-40
98317036565,98317036572,7,2827,1406,-40
98319244633,98319244638,5,2740,1489,-40
98324970242,98324970246,4,2717,1479,-40
98325456510,98325456507,-3,2751,4906,-40
98327191591,98327191596,5,2402,1756,-40
98327512945,98327512950,5,3072,1275,-40
98328453551,98328453559,8,2362,1229,-40
98329541187,98329541195,8,1970,1014,-40
98333363962,98333363968,6,2300,1060,-40
98334537798,98334537803,5,3552,1313,-40
98336473342,98336473330,-12,907,449,-40
98337172403,98337172410,7,2794,1360,-40
98339164592,98339164599,7,3066,1125,-40
98340267220,98340267227,7,4128,1090,-40
98346474662,98346474667,5,2652,1121,-40
98347963477,98347963482,5,2149,684,-40
98352734573,98352734578,5,3425,1259,-40
98355518032,98355518038,6,3237,1332,-40
98356115696,98356115690,-6,22134,45909,-40
98368872181,98368872186,5,1911,1188,-40
98370836488,98370836494,6,2823,1361,-40
98373222242,98373222249,7,3028,1561,-40
98375460446,98375460452,6,2598,1474,-40
98380201823,98380201829,6,3790,1498,-40
98381171443,98381171450,7,2731,1400,-40
98381450997,98381451003,6,2496,1520,-40
98381736093,98381736091,-2,1389,1748,-40
98382698201,98382698205,4,2883,1641,-40
98385726946,98385726953,7,2768,1025,-40
98389859063,98389859069,6,2346,775,-40
98391103929,98391103934,5,1550,934,-40
98394161565,98394161573,8,5630,1136,-40
98395863862,98395863842,-20,2856,1190,-40
98400399082,98400399085,3,2059,1650,-40
98403113570,98403113577,7,2998,1115,-40
98404891873,98404891856,-17,1396,337,-40
98406860252,98406860258,6,3137,1473,-40
98407065187,98407065195,8,3108,1200,-40
98408174909,98408174914,5,1663,1235,-40
98410658633,98410658640,7,3173,1037,-40
98413240075,98413240082,7,3106,1777,-40
98413795591,98413795609,18,515,187,-40
98416514759,98416514766,7,1674,1061,-40
98417375090,98417375095,5,2828,1599,-40
98420812595,98420812594,-1,873,1473,-40
98422456865,98422456870,5,2104,1261,-40
98422496574,98422496587,13,918,90,-40
98428592453,98428592457,4,3689,1808,-40
98429514069,98429514076,7,2444,1401,-40
98431925671,98431925674,3,1767,1132,-40
98439115742,98439115750,8,3377,1432,-40
98441061363,98441061367,4,2584,1301,-40
98442756649,98442756655,6,1817,1291,-40
98444510022,98444510027,5,4044,1633,-40
98449644461,98449644466,5,2937,1092,-40
98450333616,98450333597,-19,1899,882,-40
98451827089,98451827095,6,2471,1017,-40
98452221562,98452221566,4,3928,1495,-40
98458174433,98458174434,1,1029,1404,-40
98463146202,98463146223,21,1022,993,-40
98467892337,98467892342,5,2024,1286,-40
98468593910,98468593914,4,1831,1830,-40
98470242192,98470242183,-9,1057,4959,-40
98475459957,98475459963,6,2678,798,-40
98481478294,98481478298,4,1868,1033,-40
98482733481,98482733486,5,2265,870,-40
98486753645,98486753651,6,3600,1465,-40
98490890671,98490890671,0,15646,54793,-40
98494159913,98494159920,7,3161,973,-40
98498661047,98498661053,6,3999,1501,-40
98503331082,98503331090,8,2696,1047,-40
98503526299,98503526284,-15,3553,1683,-40
98506494925,98506494930,5,2899,1452,-40
98507703625,98507703632,7,2810,1212,-40
98510741990,98510741995,5,4892,2374,-40
98512068789,98512068794,5,1521,1103,-40
98512148732,98512148737,5,2770,1256,-40
98512889670,98512889677,7,3713,1532,-40
98515403013,98515403017,4,3297,1174,-40
98518236213,98518236221,8,2131,683,-40
98519414061,98519414068,7,4469,1471,-40
98519585125,98519585112,-13,1984,741,-40
98520079793,98520079799,6,3373,1333,-40
98522142772,98522142778,6,2307,1457,-40
98522615890,98522615895,5,3101,1100,-40
98525633325,98525633333,8,3556,1542,-40
98526028902,98526028922,20,2597,1187,-40
98528081455,98528081462,7,3996,1443,-40
98533883039,98533883041,2,2575,1818,-40
98534634610,98534634611,1,951,1625,-40
98536193882,98536193888,6,4215,1669,-40
98536289049,98536289054,5,2926,1566,-40
98537303900,98537303907,7,3619,1549,-40
98538895050,98538895043,-7,966,3812,-40
98539175553,98539175560,7,3452,1410,-40
98540312833,98540312839,6,4317,2055,-40
98542497049,98542497055,6,3208,1230,-40
98543152451,98543152457,6,2490,1179,-40
98544493866,98544493874,8,4364,1316,-40
98544598407,98544598395,-12,1162,580,-40
98545766101,98545766108,7,4373,1897,-40
98545895390,98545895394,4,2439,834,-40
98549481013,98549481017,4,36047,24522,-40
98551391474,98551391480,6,2428,1755,-40
98556783182,98556783191,9,1587,790,-40
98558445923,98558445930,7,548,39,-40
98560163865,98560163872,7,2082,1172,-40
98562415937,98562415943,6,2321,971,-40
98566530506,98566530504,-2,745,1770,-40
98567250817,98567250823,6,1134,637,-40
98570825892,98570825898,6,2296,1405,-40
98571419990,98571419972,-18,1895,992,-40
98577398593,98577398599,6,3224,1115,-40
98577954204,98577954208,4,2443,1539,-40
98579674466,98579674472,6,2925,1445,-40
98580810380,98580810370,-10,882,187,-40
98584426608,98584426614,6,1925,1497,-40
98584528457,98584528442,-15,1177,187,-40
98584590494,98584590498,4,1077,140,-40
98584635070,98584635066,-4,826,282,-40
98589171688,98589171694,6,2069,839,-40
98595467459,98595467465,6,3003,1459,-40
98597554974,98597554980,6,2770,1440,-40
98597910792,98597910777,-15,1894,664,-40
98598724225,98598724232,7,2522,802,-40
98600697721,98600697726,5,3361,1162,-40
98602202717,98602202725,8,2933,1186,-40
98604320386,98604320392,6,5185,2001,-40
98607015984,98607015989,5,2988,1242,-40
98607437015,98607437019,4,3306,1236,-40
98612734276,98612734282,6,1004,906,-40
98614763031,98614763037,6,3310,1865,-40
98619051053,98619051059,6,3671,1128,-40
98620279147,98620279143,-4,1190,3054,-40
98622385069,98622385076,7,3852,1358,-40
98624086944,98624086949,5,2344,1669,-40
98624789766,98624789775,9,5113,1135,-40
98628653535,98628653530,-5,20729,13539,-40
98632013606,98632013612,6,3276,1515,-40
98632041755,98632041761,6,3359,1446,-40
98633044578,98633044586,8,3568,1336,-40
98634713337,98634713343,6,2616,1070,-40
98635257136,98635257141,5,3339,1125,-40
98640461716,98640461721,5,1958,852,-40
98645088109,98645088116,7,2500,1126,-40
98646678384,98646678386,2,1158,1249,-40
98647013172,98647013177,5,3083,1185,-40
98647412798,98647412805,7,2978,859,-40
98648198866,98648198873,7,2785,1486,-40
98649873548,98649873553,5,2691,1210,-40
98651998405,98651998413,8,3101,1031,-40
98654989857,98654989865,8,2749,1525,-40
98658308487,98658308493,6,2090,1271,-40
98659975302,98659975307,5,2642,1173,-40
98666823936,98666823943,7,2826,1447,-40
98667096308,98667096315,7,1018,870,-40
98676412166,98676412174,8,3380,1159,-40
98679036434,98679036442,8,2878,1579,-40
98679488112,98679488118,6,5956,1454,-40
98680732996,98680733003,7,2877,1098,-40
98685300234,98685300240,6,4062,1691,-40
98687342385,98687342393,8,2654,676,-40
98690155048,98690155067,19,562,4310,-40
98690866854,98690866863,9,2983,1020,-40
98693635230,98693635237,7,2237,1128,-40
98693729474,98693729480,6,2023,1403,-40
98694229221,98694229222,1,1940,1279,-40
98695615177,98695615182,5,3453,1674,-40
98697565812,98697565812,0,1670,2006,-40
98699027998,98699028006,8,1696,724,-40
98700027319,98700027326,7,3617,1399,-40
98706361755,98706361763,8,3219,1467,-40
98713890950,98713890947,-3,1071,1938,-40
98714384385,98714384392,7,1039,913,-40
98716534412,98716534410,-2,1135,1800,-40
98721413039,98721413040,1,100,654,-40
98723062656,98723062662,6,3125,1409,-40
98723223002,98723223009,7,2426,1460,-40
98725323122,98725323117,-5,1307,1325,-40
98726142285,98726142287,2,1543,1123,-40
98731839586,98731839591,5,3150,1551,-40
98732961442,98732961451,9,2612,1039,-40
98733105472,98733105478,6,4016,1592,-40
98734748808,98734748815,7,2599,1196,-40
98738418113,98738418118,5,3371,1346,-40
98739349474,98739349482,8,2521,930,-40
98742170975,98742170980,5,2983,1719,-40
98746581198,98746581204,6,2761,1319,-40
98746629234,98746629240,6,2332,1476,-40
98750899010,98750899016,6,2965,1134,-40
98751025655,98751025667,12,645,181,-40
98752612101,98752612109,8,3221,1117,-40
98752843590,98752843597,7,3654,1708,-40
98757452622,98757452629,7,2823,1090,-40
98761783105,98761783111,6,1937,889,-40
98772665239,98772665236,-3,1067,1573,-40
98774251645,98774251626,-19,1060,248,-40
98776583073,98776583079,6,2508,1125,-40
98777665481,98777665487,6,2584,1237,-40
98778753334,98778753342,8,3906,1410,-40
98779831974,98779831980,6,2277,1549,-40
98783945506,98783945513,7,1738,1404,-40
98786204109,98786204115,6,2797,1279,-40
98787274183,98787274188,5,3061,1181,-40
98790416037,98790416038,1,1158,1753,-40
98795110519,98795110526,7,3419,1500,-40
98796288236,98796288242,6,3468,1375,-40
98797995281,98797995288,7,4390,1337,-40
98798758726,98798758704,-22,1143,420,-40
98807706947,98807706954,7,2356,1121,-40
98808427730,98808427746,16,691,1298,-40
98810682436,98810682441,5,1926,1771,-40
98811699435,98811699438,3,1862,1782,-40
98813248126,98813248134,8,2603,1429,-40
98815172803,98815172811,8,2558,915,-40
98823897630,98823897637,7,3666,1144,-40
98824688435,98824688441,6,3632,1230,-40
98827980703,98827980707,4,1736,1343,-40
98828462719,98828462725,6,2361,883,-40
98832604148,98832604144,-4,48936,65559,-40
98834490776,98834490783,7,2592,1462,-40
98835204888,98835204894,6,2106,934,-40
98835594782,98835594768,-14,1714,609,-40
98835710249,98835710254,5,2748,1428,-40
98838479849,98838479855,6,2593,1227,-40
98842839984,98842839978,-6,2061,10076,-40
98844332005,98844332011,6,2547,1165,-40
98845050219,98845050226,7,5286,1248,-40
98846580377,98846580384,7,2356,1151,-40
98850142129,98850142135,6,2231,926,-40
98850176392,98850176378,-14,2782,1033,-40
98851141994,98851142003,9,2437,1114,-40
98853811165,98853811170,5,1603,675,-40
98857122138,98857122143,5,2348,1339,-40
98860018134,98860018139,5,2827,1564,-40
98862760123,98862760131,8,4147,1811,-40
98865052617,98865052624,7,12230,25421,-40
98865742326,98865742334,8,2458,1065,-40
98867794461,98867794466,5,2364,1111,-40
98870834156,98870834162,6,3293,1247,-40
98871388230,98871388234,4,3415,1681,-40
98876645122,98876645127,5,2804,1515,-40
98878641980,98878641985,5,2784,966,-40
98878893068,98878893050,-18,1794,772,-40
98879310705,98879310702,-3,1054,1338,-40
98883738317,98883738323,6,1671,1059,-40
98883799488,98883799496,8,3883,1562,-40
98885231749,98885231756,7,3187,1993,-40
98892853139,98892853145,6,3584,1116,-40
98893020379,98893020386,7,2608,1165,-40
98894087071,98894087077,6,1604,739,-40
98897738990,98897738996,6,2827,1621,-40
98900414581,98900414587,6,2020,1274,-40
98903933256,98903933265,9,2890,1108,-40
98907014721,98907014726,5,3209,1387,-40
98914365158,98914365166,8,3403,1163,-40
98918898654,98918898648,-6,1807,4455,-40
98920079961,98920079967,6,3713,1539,-40
98920336754,98920336762,8,2529,1009,-40
98924960514,98924960521,7,3908,1459,-40
98925233136,98925233142,6,2607,1360,-40
98925517644,98925517648,4,2630,1940,-40
98926713866,98926713873,7,2178,1205,-40
98926936797,98926936801,4,2056,1900,-40
98927906188,98927906193,5,2399,1456,-40
98929712825,98929712832,7,2373,1187,-40
98930478412,98930478415,3,2511,1208,-40
98930939841,98930939857,16,1883,927,-40
98936041685,98936041691,6,2484,1069,-40
98936356418,98936356402,-16,653,225,-40
98942021949,98942021955,6,2874,1318,-40
98944309875,98944309882,7,2743,1490,-40
98944372821,98944372826,5,2512,787,-40
98947205648,98947205655,7,3148,1296,-40
98949917153,98949917158,5,2072,1035,-40
98952772675,98952772683,8,2494,1296,-40
98953295510,98953295520,10,3066,1404,-40
98960590751,98960590753,2,2204,1362,-40
98966244813,98966244819,6,3385,1472,-40
98968564205,98968564211,6,4750,1229,-40
98973729679,98973729681,2,1686,1727,-40
98975416324,98975416330,6,2849,1453,-40
98975457058,98975457064,6,2091,1020,-40
98978455309,98978455315,6,1591,799,-40
98979175581,98979175587,6,2247,1076,-40
98981005326,98981005341,15,12457,46138,-40
98981964521,98981964528,7,2787,1535,-40
98982121786,98982121792,6,2905,1172,-40
98982306601,98982306618,17,1419,160,-40
98984679596,98984679598,2,3217,2505,-40
98984899736,98984899739,3,3702,2859,-40
98985902515,98985902522,7,3682,1804,-40
98990053811,98990053818,7,2038,807,-40
98991753962,98991753969,7,3146,1449,-40
98993058960,98993058967,7,2857,1013,-40
98994381180,98994381186,6,3369,1126,-40
99004218895,99004218902,7,3445,1362,-40
99004661341,99004661346,5,2346,1107,-40
99009173561,99009173566,5,2775,1095,-40
99010295038,99010295043,5,2947,916,-40
99012972240,99012972246,6,2368,1527,-40
99013231269,99013231279,10,1102,58,-40
99014970421,99014970429,8,3422,1526,-40
99016648848,99016648849,1,1958,1756,-40
99017696596,99017696601,5,3156,1390,-40
99019543905,99019543911,6,3278,1569,-40
99023152030,99023152036,6,2753,1686,-40
99023231323,99023231305,-18,3446,592,-40
99031126963,99031126962,-1,1485,2126,-40
99034453186,99034453193,7,3859,1678,-40
99035670530,99035670534,4,3155,1174,-40
99036258413,99036258419,6,3222,1647,-40
99037787838,99037787846,8,2307,758,-40
99039173683,99039173689,6,2742,1321,-40
99044682515,99044682522,7,3836,1196,-40
99045150402,99045150407,5,2860,975,-40
99047984014,99047984018,4,3137,979,-40
99048313870,99048313875,5,2460,1147,-40
99052547607,99052547614,7,3309,1285,-40
99054657643,99054657649,6,3496,1899,-40
99055456732,99055456739,7,3817,1039,-40
99059912645,99059912651,6,1572,777,-40
99063503575,99063503582,7,3794,1414,-40
99063631728,99063631714,-14,2275,689,-40
99065560326,99065560334,8,1127,798,-40
99070495564,99070495571,7,2863,911,-40
99071587234,99071587235,1,1626,1299,-40
99072696742,99072696750,8,2794,1320,-40
99073216410,99073216417,7,2168,1225,-40
99077632794,99077632796,2,1191,1539,-40
99099328485,99099328490,5,2399,1225,-40
99099427791,99099427796,5,3331,1316,-40
99101189064,99101189066,2,2685,2831,-40
99109672419,99109672417,-2,765,1659,-40
99110115283,99110115277,-6,747,1914,-40
99113339073,99113339078,5,1712,1063,-40
99120186534,99120186541,7,3231,1713,-40
99123464987,99123464995,8,2447,714,-40
99132566325,99132566333,8,1612,1334,-40
99133662798,99133662794,-4,12072,28045,-40
99134594874,99134594879,5,2098,1258,-40
99135113950,99135113958,8,5704,1050,-40
99140516230,99140516231,1,1160,1510,-40
99141923270,99141923252,-18,870,444,-40
99144676914,99144676922,8,1712,1132,-40
99147068046,99147068053,7,3622,1723,-40
99149939448,99149939453,5,4362,1258,-40
99154806174,99154806182,8,2754,1429,-40
99162610054,99162610061,7,3247,1440,-40
99162899011,99162898992,-19,2569,1291,-40
99163859102,99163859108,6,2591,1270,-40
99167465813,99167465819,6,2749,1550,-40
99169809761,99169809767,6,2924,1760,-40
99170817354,99170817360,6,2344,1382,-40
99171329057,99171329062,5,2481,1432,-40
99174590794,99174590774,-20,220,2274,-40
99176472063,99176472060,-3,1749,2363,-40
99178165517,99178165522,5,2679,1205,-40
99182294468,99182294473,5,1896,929,-40
99182857953,99182857970,17,2591,1405,-40
99185737494,99185737499,5,2091,1160,-40
99185929901,99185929908,7,4466,1477,-40
99186304714,99186304722,8,2684,1437,-40
99186370284,99186370267,-17,1264,267,-40
99188456469,99188456474,5,2219,1267,-40
99189954873,99189954879,6,3101,1700,-40
99192511087,99192511094,7,2366,1009,-40
99194132841,99194132843,2,1775,1452,-40
99194829073,99194829078,5,1395,770,-40
99196400633,99196400643,10,2253,1290,-40
99197006514,99197006515,1,1830,1857,-40
99197623546,99197623554,8,2394,1621,-40
99197826892,99197826899,7,3109,1649,-40
99197950989,99197950995,6,2878,1030,-40
99200964626,99200964631,5,1982,1368,-40
99202654499,99202654476,-23,853,119,-40
99205206470,99205206479,9,3535,1076,-40
99206314032,99206314038,6,2923,1222,-40
99206561770,99206561786,16,1029,452,-40
99206821480,99206821485,5,2772,1136,-40
99207133596,99207133602,6,3201,1382,-40
99207522050,99207522055,5,1415,818,-40
99209389590,99209389597,7,3568,1661,-40
99215989662,99215989668,6,3083,1288,-40
99217393398,99217393404,6,2176,986,-40
99224484910,99224484916,6,2931,1505,-40
99225225297,99225225302,5,1854,1419,-40
99226716950,99226716949,-1,967,1417,-40
99227525303,99227525310,7,1636,769,-40
99230104342,99230104346,4,2683,1216,-40
99233146773,99233146778,5,2474,1049,-40
99236706836,99236706842,6,2122,1016,-40
99240453747,99240453752,5,2643,1361,-40
99243741333,99243741338,5,3546,978,-40
99245311136,99245311143,7,2384,1077,-40
99245897828,99245897820,-8,925,133,-40
99248455618,99248455624,6,3273,1522,-40
99249056736,99249056742,6,2959,1117,-40
99249162694,99249162702,8,3178,1524,-40
99252199771,99252199778,7,2238,1543,-40
99252716550,99252716555,5,1397,689,-40
99253691714,99253691718,4,1878,1205,-40
99255606115,99255606121,6,2791,834,-40
99255861649,99255861650,1,1027,226,-40
99256046863,99256046859,-4,939,420,-40
99257407355,99257407348,-7,823,148,-40
99260004637,99260004643,6,2543,1260,-40
99261971473,99261971478,5,3265,1160,-40
99265475445,99265475451,6,1375,1635,-40
99267888169,99267888175,6,2500,1084,-40
99270167102,99270167108,6,2178,1130,-40
99271935190,99271935189,-1,1261,2156,-40
99273304930,99273304937,7,2589,1288,-40
99274680772,99274680778,6,1861,1240,-40
99275106017,99275106020,3,1611,1418,-40
99275726153,99275726159,6,2664,1030,-40
99277041164,99277041170,6,3035,874,-40
99277793133,99277793138,5,1585,753,-40
99278153418,99278153421,3,1184,1163,-40
99279360881,99279360886,5,2285,973,-40
99280926097,99280926105,8,2525,1357,-40
99282391189,99282391195,6,2466,1477,-40
99283316518,99283316501,-17,3266,980,-40
99283990775,99283990792,17,545,170,-40
99284555462,99284555469,7,2572,1447,-40
99286949569,99286949574,5,1906,1176,-40
99287527880,99287527887,7,2624,995,-40
99292420753,99292420758,5,2965,1697,-40
99293243122,99293243130,8,2851,1993,-40
99293277231,99293277237,6,2091,1327,-40
99293383807,99293383813,6,2834,1091,-40
99297374129,99297374135,6,3696,1838,-40
99297624988,99297624995,7,3372,1079,-40
99302630268,99302630274,6,2652,1103,-40
99307922741,99307922743,2,1639,1204,-40
99310237399,99310237405,6,3230,1253,-40
99313517215,99313517222,7,3192,1338,-40
99314755268,99314755275,7,3298,1856,-40
99315731910,99315731915,5,2861,1114,-40
99320977371,99320977375,4,1763,918,-40
99321243165,99321243169,4,1661,1640,-40
99324584377,99324584382,5,2493,1962,-40
99325713467,99325713473,6,3001,1513,-40
99327155830,99327155835,5,3033,1041,-40
99327723726,99327723731,5,14238,5636,-40
99328073878,99328073883,5,2989,1570,-40
99331364226,99331364233,7,2423,970,-40
99332772663,99332772667,4,2137,1587,-40
99334844234,99334844239,5,2212,1540,-40
99334928222,99334928226,4,2802,1167,-40
99340089016,99340089022,6,3292,1181,-40
99340439683,99340439686,3,908,1117,-40
99346188015,99346188022,7,2427,949,-40
99348517214,99348517220,6,2381,44492,-40
99351136997,99351137004,7,1878,1295,-40
99353640835,99353640843,8,2572,721,-40
99353684151,99353684160,9,882,149,-40
99355829769,99355829775,6,2096,1541,-40
99356811960,99356811966,6,2295,1054,-40
99359361509,99359361516,7,2328,1282,-40
99363014124,99363014115,-9,25596,16400,-40
99369523394,99369523401,7,3652,1033,-40
99372467497,99372467503,6,2698,1104,-40
99377979720,99377979725,5,2417,1166,-40
99382147821,99382147827,6,3469,1282,-40
99382673348,99382673355,7,2699,1144,-40
99382935856,99382935841,-15,1702,458,-40
99383701654,99383701658,4,1832,935,-40
99385557869,99385557878,9,2393,908,-40
99389285673,99389285678,5,1299,473,-40
99390362617,99390362625,8,2227,950,-40
99390693006,99390692987,-19,1794,1077,-40
99396268621,99396268635,14,11294,47169,-40
99396548937,99396548943,6,3650,1141,-40
99404064324,99404064331,7,2937,1195,-40
99407158285,99407158290,5,2613,1309,-40
99407402068,99407402058,-10,585,44,-40
99409372983,99409372989,6,1806,1416,-40
99411877551,99411877536,-15,1264,1365,-40
99412303127,99412303139,12,776,252,-40
99412651842,99412651848,6,3267,1348,-40
99413207909,99413207914,5,2068,1289,-40
99413274021,99413274035,14,3536,905,-40
99417553293,99417553298,5,2665,1641,-40
99419341291,99419341298,7,3897,1561,-40
99419930943,99419930950,7,4100,2132,-40
99420730551,99420730558,7,4499,1505,-40
99423040493,99423040499,6,3312,1352,-40
99423470009,99423470027,18,681,146,-40
99426258401,99426258406,5,3111,1608,-40
99426452531,99426452537,6,3619,980,-40
99426748306,99426748288,-18,896,241,-40
99429553169,99429553175,6,3139,1581,-40
99433693134,99433693140,6,2277,1139,-40
99435391130,99435391138,8,2937,1682,-40
99438384441,99438384448,7,2233,1337,-40
99439493797,99439493802,5,3006,1460,-40
99442173186,99442173192,6,2881,1568,-40
99445558069,99445558076,7,3335,1987,-40
99447483970,99447483978,8,2505,1523,-40
99447816498,99447816505,7,2241,1217,-40
99449297342,99449297349,7,3364,1292,-40
99450622423,99450622429,6,2087,1206,-40
99452266772,99452266778,6,4048,1286,-40
99459961439,99459961446,7,3930,1631,-40
99460740750,99460740755,5,2937,982,-40
99460888448,99460888453,5,3183,1672,-40
99468797205,99468797198,-7,2252,9604,-40
99469208362,99469208344,-18,2919,1208,-40
99474790939,99474790947,8,4051,1276,-40
99475093177,99475093179,2,581,229,-40
99480204937,99480204942,5,2680,908,-40
99483580438,99483580443,5,2943,1434,-40
99486104779,99486104785,6,3830,1730,-40
99490099574,99490099582,8,2695,1015,-40
99490354061,99490354067,6,2693,1306,-40
99492038822,99492038830,8,3279,1051,-40
99493890274,99493890280,6,2550,1514,-40
99495604929,99495604937,8,4713,1436,-40
99499674706,99499674725,19,2421,4042,-40
99502209313,99502209319,6,3078,1249,-40
99503222464,99503222470,6,3974,924,-40
99503547513,99503547499,-14,2445,1468,-40
99504862782,99504862787,5,1619,714,-40
99507194921,99507194926,5,2807,1311,-40
99507920943,99507920948,5,2396,1367,-40
99513469711,99513469714,3,1041,962,-40
99514245868,99514245845,-23,1275,1361,-40
99521823851,99521823858,7,2956,1371,-40
99521944614,99521944619,5,2325,1297,-40
99523425525,99523425523,-2,1159,2374,-40
99524441698,99524441703,5,2148,917,-40
99532125451,99532125458,7,2811,1218,-40
99532357185,99532357191,6,2540,1420,-40
99535100855,99535100861,6,2835,1614,-40
99536729105,99536729111,6,3895,2335,-40
99538535886,99538535885,-1,1244,1630,-40
99538797664,99538797648,-16,1101,542,-40
99539157590,99539157598,8,3251,1060,-40
99540866780,99540866786,6,4302,1796,-40
99544973198,99544973203,5,1338,650,-40
99545381303,99545381303,0,970,909,-40
99545496029,99545496040,11,3440,1274,-40
99545742181,99545742163,-18,1148,217,-40
99551598628,99551598635,7,2628,1195,-40
99552904742,99552904751,9,2288,836,-40
99555926897,99555926903,6,3095,1243,-40
99559126090,99559126098,8,2702,1219,-40
99559197231,99559197208,-23,2925,835,-40
99561962110,99561962115,5,2686,1676,-40
99564542882,99564542888,6,3483,1416,-40
99567759050,99567759058,8,1916,1092,-40
99568768301,99568768282,-19,1604,2067,-40
99569456508,99569456515,7,1924,1041,-40
99571170102,99571170109,7,2049,941,-40
99572689746,99572689751,5,2739,1007,-40
99574505839,99574505846,7,4030,1350,-40
99575308169,99575308185,16,3370,1204,-40
99575627957,99575627937,-20,2899,1116,-40
99576013835,99576013829,-6,1541,4372,-40
99577505050,99577505054,4,2956,1524,-40
99577575159,99577575165,6,2481,1366,-40
99578536459,99578536466,7,3498,1917,-40
99586896404,99586896409,5,2932,912,-40
99587368847,99587368851,4,782,122,-40
99589685694,99589685690,-4,1113,379,-40
99592325834,99592325842,8,2744,1232,-40
99595896203,99595896209,6,2085,1519,-40
99596155234,99596155242,8,981,252,-40
99601746046,99601746054,8,1435,626,-40
99603384265,99603384272,7,4085,1541,-40
99604292623,99604292601,-22,2845,980,-40
99604643063,99604643070,7,2861,1164,-40
99605126725,99605126722,-3,1535,2488,-40
99606759584,99606759589,5,2224,1662,-40
99608929986,99608929991,5,3045,1237,-40
99612580148,99612580157,9,2774,541,-40
99612699773,99612699779,6,2811,1606,-40
99612997170,99612997176,6,2015,1391,-40
99616768363,99616768371,8,3035,1206,-40
99617190866,99617190874,8,2356,1637,-40
99620519118,99620519121,3,2509,1118,-40
99620627885,99620627892,7,3768,1393,-40
99622252893,99622252897,4,2307,1909,-40
99628324122,99628324127,5,3597,1186,-40
99630344381,99630344386,5,2277,672,-40
99638076362,99638076369,7,3092,1312,-40
99638613043,99638613048,5,2734,1408,-40
99639707396,99639707401,5,3076,1228,-40
99643080264,99643080270,6,2772,784,-40
99645436401,99645436407,6,2081,1236,-40
99646772009,99646772016,7,1603,949,-40
99647154413,99647154415,2,1631,1433,-40
99654038949,99654038955,6,3475,1395,-40
99654455091,99654455098,7,2170,914,-40
99657341689,99657341694,5,3124,1491,-40
99662761849,99662761854,5,2808,1377,-40
99665640016,99665640010,-6,36716,15417,-40
99666286899,99666286896,-3,829,2864,-40
99668187936,99668187942,6,2178,1449,-40
99668414759,99668414753,-6,1469,6143,-40
99670341383,99670341381,-2,1909,3446,-40
99671624661,99671624666,5,2206,1025,-40
99681433874,99681433881,7,2351,1124,-40
99683668217,99683668222,5,2982,1184,-40
99685877594,99685877601,7,2923,1626,-40
99692297518,99692297518,0,1387,2542,-40
99692538519,99692538517,-2,1482,2367,-40
99696949685,99696949689,4,4167,1403,-40
99698306014,99698306022,8,3947,1483,-40
99702271856,99702271861,5,1874,1182,-40
99703732138,99703732145,7,4270,1233,-40
99718417699,99718417697,-2,1453,2279,-40
99719415509,99719415515,6,2109,1235,-40
99720639515,99720639514,-1,1622,1616,-40
99722096394,99722096401,7,3261,1602,-40
99728818790,99728818798,8,3372,877,-40
99731943840,99731943845,5,3989,1749,-40
99732755905,99732755910,5,1123,1177,-40
99739417772,99739417782,10,215,1109,-40
99740700733,99740700739,6,2068,982,-40
99740881836,99740881819,-17,712,260,-40
99744269729,99744269734,5,1766,1094,-40
99745321208,99745321213,5,1382,1149,-40
99747595365,99747595370,5,2185,1261,-40
99748191053,99748191075,22,1036,303,-40
99748395724,99748395730,6,3926,1271,-40
99749136882,99749136889,7,3351,959,-40
99750401692,99750401688,-4,984,2542,-40
99754383503,99754383510,7,1835,800,-40
99755804230,99755804238,8,2069,1666,-40
99758596527,99758596534,7,3030,1050,-40
99761589668,99761589675,7,3082,1012,-40
99766272418,99766272424,6,2584,1511,-40
99766374925,99766374924,-1,27723,48929,-40
99772423522,99772423530,8,2251,1540,-40
99773493029,99773493026,-3,885,3146,-40
99775579030,99775579033,3,1878,2186,-40
99776245919,99776245926,7,3937,1375,-40
99781152375,99781152382,7,2915,1375,-40
99782121055,99782121043,-12,1058,340,-40
99788720856,99788720862,6,3459,1363,-40
99788931025,99788931030,5,2003,870,-40
99789196151,99789196159,8,3626,1460,-40
99790832386,99790832393,7,2838,1253,-40
99793173133,99793173138,5,2880,1128,-40
99794515835,99794515817,-18,1871,1068,-40
99795130151,99795130148,-3,898,1992,-40
99795176537,99795176539,2,1563,1285,-40
99797720456,99797720461,5,4079,1693,-40
99798721846,99798721854,8,3401,1784,-40
99802857059,99802857055,-4,861,2378,-40
99806155593,99806155600,7,3023,1235,-40
99811945992,99811945998,6,3437,1252,-40
99812284285,99812284273,-12,875,423,-40
99816726000,99816726006,6,2712,1266,-40
99818291734,99818291742,8,3502,1291,-40
99819661554,99819661539,-15,2589,1277,-40
99820784494,99820784500,6,3688,1317,-40
99827748816,99827748821,5,1700,1204,-40
99828516930,99828516936,6,2402,1229,-40
99834120534,99834120531,-3,968,244,-40
99834224287,99834224291,4,2470,1286,-40
99836699358,99836699363,5,1901,1269,-40
99839711122,99839711127,5,4294,1808,-40
99845527655,99845527661,6,2653,1379,-40
99849313617,99849313624,7,3015,1592,-40
99849678890,99849678897,7,3404,1487,-40
99850490190,99850490194,4,14192,8651,-40
99853520345,99853520351,6,3398,1328,-40
99855817958,99855817966,8,16192,20554,-40
99856831206,99856831212,6,2925,1002,-40
99862043524,99862043530,6,3104,1557,-40
99862746919,99862746927,8,2621,1205,-40
99862973730,99862973744,14,2995,1167,-40
99865148591,99865148597,6,3222,1263,-40
99865201753,99865201759,6,2970,1464,-40
99866257870,99866257875,5,3003,1614,-40
99870030681,99870030686,5,1361,1314,-40
99878293498,99878293505,7,1476,976,-40
99878582462,99878582458,-4,15475,16589,-40
99884744728,99884744735,7,3118,1657,-40
99886819369,99886819375,6,4634,1370,-40
99889250142,99889250147,5,3167,1510,-40
99889970042,99889970034,-8,1034,6366,-40
99890200402,99890200409,7,3845,1698,-40
99890511201,99890511209,8,2235,1076,-40
99895796655,99895796651,-4,651,1819,-40
99896918522,99896918527,5,2859,1041,-40
99897535654,99897535659,5,2350,751,-40
99903963312,99903963315,3,1606,814,-40
99905053861,99905053866,5,2666,1270,-40
99905834505,99905834514,9,712,245,-40
99908707621,99908707627,6,2783,870,-40
99912985846,99912985853,7,3285,1130,-40
99917826582,99917826590,8,2625,928,-40
99918987876,99918987882,6,2684,1192,-40
99920641958,99920641965,7,2900,1223,-40
99926172531,99926172538,7,2966,1174,-40
99927728616,99927728621,5,2635,1104,-40
99932027247,99932027254,7,3865,1345,-40
99936943735,99936943741,6,3000,1549,-40
99941213267,99941213276,9,876,579,-40
99941380462,99941380459,-3,862,55,-40
99942176599,99942176611,12,1374,1499,-40
99942695906,99942695911,5,3290,1508,-40
99943939150,99943939157,7,2795,1333,-40
99944033809,99944033815,6,1275,1318,-40
99945127815,99945127822,7,2976,985,-40
99947261412,99947261418,6,3244,1303,-40
99948782751,99948782757,6,2681,1173,-40
99950995149,99950995154,5,4069,1716,-40
99952902617,99952902623,6,1845,789,-40
99955817044,99955817049,5,2330,1362,-40
99958514376,99958514381,5,2364,997,-40
99959779007,99959779010,3,768,397,-40
99965397930,99965397936,6,2810,1191,-40
99969146819,99969146825,6,3276,1061,-40
99970169354,99970169359,5,2421,1428,-40
99973319231,99973319234,3,1785,1190,-40
99974098845,99974098847,2,2333,2154,-40
99976948657,99976948663,6,1594,875,-40
99983480009,99983480014,5,1068,927,-40
99984606290,99984606297,7,2053,1014,-40
99996739529,99996739533,4,2971,1020,-40
99999172943,99999172948,5,3989,1203,-40
100003184520,100003184526,6,3306,1427,-40
100012045930,100012045935,5,3050,1511,-40
100017568926,100017568931,5,3723,2086,-40
100018800704,100018800711,7,3264,1454,-40
100022930784,100022930790,6,2416,1108,-40
100025526785,100025526790,5,1413,936,-40
100026011630,100026011629,-1,2317,2801,-40
100028845191,100028845197,6,2954,1519,-40
100031570166,100031570170,4,2628,1291,-40
100031992783,100031992790,7,2132,1136,-40
100036112917,100036112923,6,4373,1737,-40
100036529798,100036529806,8,2783,1481,-40
100037327590,100037327596,6,2060,966,-40
100040322053,100040322047,-6,747,3092,-40
100040986633,100040986639,6,2709,1199,-40
100041503181,100041503187,6,2343,943,-40
100049161786,100049161778,-8,26176,13875,-40
100050789891,100050789897,6,3441,1710,-40
100056017930,100056017938,8,1504,1215,-40
100057865288,100057865293,5,2990,1531,-40
100062964761,100062964767,6,2334,1229,-40
100066853815,100066853821,6,2949,1247,-40
100073489730,100073489725,-5,1027,5837,-40
100075022239,100075022247,8,3183,960,-40
100075468297,100075468283,-14,2819,1020,-40
100081315583,100081315589,6,2641,1390,-40
100084223105,100084223109,4,2849,1233,-40
100085140130,100085140137,7,3001,1290,-40
100085319794,100085319798,4,2887,1494,-40
100085888731,100085888712,-19,796,435,-40
100093091242,100093091249,7,2120,1195,-40
100093433266,100093433275,9,11275,29615,-40
100094517383,100094517389,6,2620,1454,-40
100094583885,100094583881,-4,644,2813,-40
100099185802,100099185808,6,2247,1234,-40
100099547413,100099547419,6,3745,1599,-40
100102378585,100102378591,6,1812,793,-40
100105217793,100105217798,5,3079,1504,-40
100109492740,100109492746,6,2637,1173,-40
100114257595,100114257596,1,1556,2206,-40
100116980006,100116980012,6,2803,1562,-40
100117540322,100117540321,-1,1319,2586,-40
100119019049,100119019055,6,2903,1383,-40
100122848590,100122848594,4,3003,977,-40
100123832030,100123832038,8,3978,1363,-40
100126268237,100126268244,7,4707,1487,-40
100127242270,100127242276,6,2854,1045,-40
100127839406,100127839416,10,1206,372,-40
100128580354,100128580370,16,3435,1348,-40
100134801442,100134801447,5,2346,1152,-40
100135284844,100135284828,-16,1254,1584,-40
100135660001,100135660005,4,1536,1124,-40
100136772066,100136772071,5,2868,1369,-40
100136979654,100136979649,-5,946,5251,-40
100137824008,100137824013,5,2325,1648,-40
100142710012,100142710014,2,1692,2068,-40
100147143944,100147143949,5,3963,1360,-40
100147656251,100147656254,3,1905,1499,-40
100148937797,100148937802,5,3188,1579,-40
100149031398,100149031379,-19,3075,848,-40
100149831202,100149831208,6,2421,1316,-40
100151866064,100151866071,7,2796,843,-40
100154582850,100154582858,8,9245,2447,-40
100159020754,100159020757,3,1588,2244,-40
100159667577,100159667583,6,1985,956,-40
100162061410,100162061416,6,2556,1551,-40
100165429425,100165429430,5,3661,1221,-40
100170212643,100170212650,7,2844,1217,-40
100177675954,100177675959,5,1951,1323,-40
100181186861,100181186868,7,2712,1458,-40
100185190694,100185190699,5,2566,921,-40
100186018019,100186018002,-17,1722,743,-40
100186064039,100186064046,7,3023,1194,-40
100187810621,100187810627,6,2506,1708,-40
100191436643,100191436648,5,2637,1051,-40
100191863273,100191863279,6,3448,1221,-40
100193250217,100193250222,5,3915,1535,-40
100200248857,100200248861,4,2427,1862,-40
100200995785,100200995791,6,2998,1374,-40
100201733011,100201733018,7,3344,1101,-40
100207427906,100207427913,7,4650,1773,-40
100207689750,100207689738,-12,13537,39502,-40
100208039327,100208039333,6,2885,1620,-40
100208389230,100208389234,4,2181,1469,-40
100214143545,100214143551,6,2760,987,-40
100214620259,100214620266,7,3080,999,-40
100215110433,100215110418,-15,2552,1106,-40
100217471249,100217471254,5,2785,1329,-40
100217740515,100217740521,6,1967,1295,-40
100217838630,100217838611,-19,2604,1515,-40
100218911029,100218911035,6,4932,1464,-40
100220702410,100220702413,3,2986,1697,-40
100220751338,100220751344,6,2743,1479,-40
100222077515,100222077521,6,2568,959,-40
100223825886,100223825893,7,3190,1132,-40
100224157095,100224157101,6,2513,1185,-40
100224558526,100224558534,8,3827,1432,-40
100225596955,100225596961,6,2638,1025,-40
100230643297,100230643303,6,3175,2106,-40
100232654778,100232654781,3,2410,1710,-40
100241995250,100241995257,7,2157,1013,-40
100242416469,100242416480,11,2452,1216,-40
100244440277,100244440282,5,3769,1423,-40
100245157914,100245157922,8,2936,1067,-40
100248848499,100248848493,-6,1860,4388,-40
100252407410,100252407417,7,1895,869,-40
100255379014,100255379019,5,2390,1382,-40
100256689572,100256689577,5,1785,1045,-40
100257023185,100257023190,5,2891,1253,-40
100260077966,100260077971,5,2348,1365,-40
100260527455,100260527453,-2,1303,2315,-40
100262495861,100262495867,6,2815,1358,-40
100265550409,100265550415,6,2586,1209,-40
100266094566,100266094566,0,2179,1302,-40
100266482159,100266482166,7,2717,1539,-40
100270885178,100270885183,5,3228,1250,-40
100275228410,100275228415,5,2276,1410,-40
100277775523,100277775531,8,3482,945,-40
100278467978,100278467985,7,2842,1127,-40
100278497194,100278497202,8,2951,926,-40
100278598107,100278598123,16,13684,688,-40
100278927597,100278927618,21,2192,985,-40
100280003917,100280003896,-21,2919,973,-40
100280743346,100280743328,-18,1004,373,-40
100281405360,100281405363,3,1939,1273,-40
100285551424,100285551430,6,4218,1674,-40
100293810382,100293810389,7,4695,1520,-40
100296803495,100296803500,5,2258,1153,-40
100300671718,100300671725,7,2498,1432,-40
100300878490,100300878498,8,4069,1402,-40
100304110684,100304110679,-5,61,843,-40
100305511513,100305511518,5,3694,1731,-40
100310701379,100310701386,7,3310,1256,-40
100314960205,100314960211,6,2039,1089,-40
100315231776,100315231782,6,2547,1506,-40
100319124261,100319124265,4,2527,1112,-40
100320848678,100320848685,7,3611,1091,-40
100321337663,100321337660,-3,1103,3630,-40
100323082272,100323082254,-18,1419,594,-40
100323655828,100323655834,6,3628,1517,-40
100324163311,100324163318,7,2689,1083,-40
100328015222,100328015227,5,1645,985,-40
100329147259,100329147265,6,3815,1664,-40
100332195290,100332195295,5,3009,1161,-40
100333902049,100333902054,5,2227,1199,-40
100342124814,100342124815,1,1951,1966,-40
100343549702,100343549707,5,2883,1264,-40
100345635036,100345635042,6,2715,1334,-40
100347744009,100347744014,5,1803,1139,-40
100348276174,100348276178,4,2126,843,-40
100351283902,100351283910,8,2592,1659,-40
100357555752,100357555758,6,2520,1049,-40
100358437728,100358437734,6,2672,1591,-40
100358485703,100358485710,7,3518,1123,-40
100361743564,100361743571,7,2178,1224,-40
100362799252,100362799257,5,3254,1224,-40
100363503438,100363503446,8,1633,687,-40
100368500545,100368500550,5,3174,1297,-40
100375110865,100375110871,6,1933,883,-40
100375370215,100375370234,19,3687,1709,-40
100375562934,100375562931,-3,847,267,-40
100376207410,100376207417,7,2738,1443,-40
100376549632,100376549638,6,2293,1242,-40
100382124734,100382124739,5,2031,942,-40
100382796489,100382796474,-15,752,559,-40
100383501975,100383501974,-1,2450,3652,-40
100390613394,100390613399,5,1183,601,-40
100391330202,100391330209,7,3106,1759,-40
100392000498,100392000503,5,2411,1148,-40
100393426496,100393426502,6,3065,1336,-40
100396524392,100396524398,6,3871,1643,-40
100398473902,100398473908,6,2632,1201,-40
100399785603,100399785597,-6,28732,14803,-40
100405448637,100405448642,5,2442,1271,-40
100411842014,100411842021,7,2083,833,-40
100415627918,100415627925,7,2517,1153,-40
100419676013,100419676018,5,2832,1763,-40
100428091486,100428091493,7,2671,1879,-40
100429630431,100429630438,7,3069,1270,-40
100430127824,100430127830,6,2689,1002,-40
100430218502,100430218510,8,2886,1102,-40
100432447090,100432447096,6,2706,1265,-40
100434056320,100434056317,-3,1186,2441,-40
100436395453,100436395460,7,2748,1168,-40
100436572711,100436572717,6,3568,1278,-40
100440314671,100440314677,6,1944,1509,-40
100442477733,100442477739,6,3249,1256,-40
100442576060,100442576067,7,1738,1077,-40
100447827066,100447827074,8,2640,1315,-40
100452075874,100452075882,8,712,1190,-40
100453536701,100453536709,8,2414,1157,-40
100462361466,100462361473,7,2167,954,-40
100464251101,100464251106,5,2934,1484,-40
100465786166,100465786172,6,2133,743,-40
100474452954,100474452963,9,2465,1492,-40
100477208652,100477208659,7,1880,900,-40
100479044669,100479044674,5,2405,1327,-40
100480559858,100480559865,7,2776,972,-40
100481468583,100481468589,6,3240,1072,-40
100485823289,100485823294,5,2266,1333,-40
100486509738,100486509744,6,2690,1559,-40
100487829388,100487829390,2,1930,1248,-40
100489940359,100489940364,5,2927,1180,-40
100492791154,100492791159,5,3372,1302,-40
100493602025,100493602044,19,844,211,-40
100496490378,100496490385,7,5401,2137,-40
100497217938,100497217943,5,1488,941,-40
100498121582,100498121582,0,1402,2233,-40
100499199362,100499199354,-8,1322,3202,-40
100501634215,100501634201,-14,49694,7870,-40
100503031966,100503031970,4,1846,600,-40
100504854785,100504854790,5,3439,1381,-40
100505879994,100505880000,6,2229,711,-40
100516594987,100516594994,7,3272,1324,-40
100519909705,100519909710,5,3590,1289,-40
100526323249,100526323257,8,4096,1696,-40
100526600535,100526600541,6,3796,1212,-40
100535683730,100535683734,4,2487,1157,-40
100544507494,100544507499,5,2416,1473,-40
100545599517,100545599523,6,1817,1243,-40
100547931518,100547931525,7,5386,2677,-40
100551764319,100551764326,7,3237,912,-40
100553038952,100553038958,6,3412,1273,-40
100554473930,100554473937,7,2445,1442,-40
100558198816,100558198815,-1,3953,50575,-40
100559410060,100559410067,7,3390,1486,-40
100560655606,100560655612,6,3226,1187,-40
100560723962,100560723969,7,1980,982,-40
100561700245,100561700246,1,5871,6000,-40
100562147775,100562147778,3,2107,1509,-40
100565743731,100565743738,7,3329,1102,-40
100568275498,100568275505,7,2765,1556,-40
100568624483,100568624490,7,2196,1024,-40
100569178932,100569178914,-18,2117,840,-40
100570385254,100570385260,6,2886,1115,-40
100570506743,100570506721,-22,2191,748,-40
100574243412,100574243418,6,3575,1462,-40
100575117679,100575117685,6,2368,1255,-40
100575402699,100575402684,-15,1250,375,-40
100578843542,100578843539,-3,1464,4435,-40
100578947103,100578947112,9,1924,997,-40
100579995198,100579995203,5,3028,1565,-40
100583690091,100583690099,8,4125,1176,-40
100584438146,100584438150,4,2367,1295,-40
100586760519,100586760527,8,3661,1447,-40
100591125334,100591125339,5,3146,1093,-40
100594578365,100594578372,7,2350,1118,-40
100599186074,100599186081,7,3193,1879,-40
100601988994,100601989003,9,3532,1114,-40
100603271978,100603271984,6,2791,1136,-40
100603390868,100603390874,6,3267,1354,-40
100606124792,100606124799,7,3274,1417,-40
100606741524,100606741528,4,2150,823,-40
100608411093,100608411098,5,2464,1312,-40
100611278148,100611278154,6,2278,1097,-40
100613984834,100613984842,8,3051,1062,-40
100624976562,100624976567,5,2976,984,-40
100625565722,100625565727,5,2357,1473,-40
100633268877,100633268882,5,2982,2010,-40
100633617105,100633617110,5,1904,730,-40
100636302630,100636302632,2,9377,20316,-40
100641339210,100641339215,5,3135,1760,-40
100642084446,100642084453,7,2399,1291,-40
100646219572,100646219578,6,5326,1637,-40
100646492359,100646492366,7,3876,1254,-40
100648039646,100648039645,-1,900,1277,-40
100654260252,100654260245,-7,2758,8454,-40
100655911479,100655911485,6,2430,1216,-40
100658327751,100658327757,6,2436,1146,-40
100658478778,100658478786,8,2734,1336,-40
100663920249,100663920267,18,1237,1500,-40
100664914476,100664914482,6,2438,1309,-40
100669408888,100669408895,7,4064,886,-40
100681317112,100681317117,5,3345,1133,-40
100681552094,100681552097,3,3242,1824,-40
100683528542,100683528551,9,3364,1221,-40
100684466206,100684466211,5,2288,1081,-40
100689741980,100689741986,6,4292,1409,-40
100691581601,100691581606,5,3320,1256,-40
100696755554,100696755554,0,1122,1646,-40
100697936795,100697936800,5,2468,1345,-40
100700051019,100700051025,6,2975,1704,-40
100705220710,100705220716,6,3182,1140,-40
100705470390,100705470394,4,1911,1137,-40
100705854809,100705854818,9,3684,1607,-40
100710855969,100710855977,8,2066,799,-40
100713535737,100713535738,1,1208,1724,-40
100715549583,100715549589,6,1984,1190,-40
100718148309,100718148314,5,4097,1587,-40
100719037367,100719037362,-5,1399,6959,-40
100719726942,100719726946,4,2588,1425,-40
100720887680,100720887686,6,2413,829,-40
100722479769,100722479774,5,2451,1445,-40
100723222038,100723222042,4,2844,1321,-40
100723779949,100723779971,22,1080,198,-40
100725061978,100725061976,-2,1264,217,-40
100730799858,100730799865,7,3975,1650,-40
100733809648,100733809654,6,1766,1270,-40
100734156090,100734156098,8,2129,1011,-40
100738949665,100738949670,5,2818,1873,-40
100742397768,100742397774,6,2823,1182,-40
100744504373,100744504379,6,3457,1131,-40
100745476350,100745476355,5,2149,963,-40
100746712986,100746712992,6,2620,1478,-40
100746948457,100746948463,6,4180,1760,-40
100747080913,100747080920,7,9904,37374,-40
100750639040,100750639046,6,1813,966,-40
100752950030,100752950034,4,1661,334,-40
100756734477,100756734483,6,2819,1380,-40
100758066640,100758066645,5,2477,1261,-40
100764482329,100764482336,7,2204,1114,-40
100765328534,100765328542,8,3136,1613,-40
100765881190,100765881195,5,1405,1481,-40
100766034308,100766034289,-19,958,352,-40
100768570561,100768570567,6,2556,1390,-40
100773803574,100773803575,1,1755,2718,-40
100776824627,100776824635,8,3873,1424,-40
100777521587,100777521593,6,7682,32097,-40
100779520489,100779520497,8,8443,1335,-40
100786770149,100786770155,6,3877,1368,-40
100789486313,100789486321,8,3350,1506,-40
100790307458,100790307463,5,2465,1232,-40
100793136506,100793136512,6,2784,1092,-40
100793455746,100793455740,-6,654,243,-40
100797903898,100797903906,8,4767,1501,-40
100804959005,100804959011,6,2758,1662,-40
100805208622,100805208627,5,3200,1344,-40
100807815422,100807815427,5,3208,1040,-40
100808006935,100808006920,-15,728,266,-40
100808590315,100808590296,-19,662,246,-40
100812746415,100812746421,6,3268,1402,-40
100814202206,100814202212,6,3129,1650,-40
100815562516,100815562524,8,3918,1492,-40
100815649041,100815649047,6,3783,1617,-40
100817825992,100817826003,11,332,817,-40
100827539834,100827539831,-3,1467,2249,-40
100833506351,100833506356,5,4104,1491,-40
100834069423,100834069429,6,2800,1252,-40
100837230873,100837230879,6,3588,1183,-40
100842574369,100842574374,5,3083,1711,-40
100843077543,100843077550,7,3201,1353,-40
100844359678,100844359686,8,2759,1290,-40
100847668190,100847668198,8,2851,1508,-40
100858104012,100858104018,6,2554,993,-40
100860325184,100860325190,6,4167,1297,-40
100862214196,100862214201,5,1952,1205,-40
100864731067,100864731074,7,3179,958,-40
100866831033,100866831037,4,2576,2063,-40
100872346450,100872346456,6,2521,981,-40
100873713179,100873713185,6,3590,1212,-40
100877686360,100877686367,7,3470,1259,-40
100879676238,100879676243,5,2740,1070,-40
100882877454,100882877460,6,3512,996,-40
100884613842,100884613849,7,4849,1389,-40
100885847746,100885847744,-2,1070,1068,-40
100888113501,100888113506,5,3048,1247,-40
100888834961,100888834967,6,2349,1445,-40
100890687874,100890687881,7,2887,1386,-40
100893995474,100893995471,-3,1154,2585,-40
100896525329,100896525334,5,3151,1692,-40
100899189503,100899189511,8,4113,1366,-40
100900010782,100900010788,6,1775,831,-40
100900060779,100900060779,0,991,226,-40
100900941827,100900941834,7,2405,1013,-40
100901845118,100901845122,4,3081,1192,-40
100908953031,100908953038,7,3458,1237,-40
100910016910,100910016917,7,2071,691,-40
100910355709,100910355720,11,1302,317,-40
100911535558,100911535563,5,2245,1148,-40
100916989482,100916989485,3,2835,2723,-40
100922948658,100922948666,8,2895,1228,-40
100923094958,100923094947,-11,2621,1081,-40
100928843993,100928843998,5,3352,1348,-40
100932615709,100932615714,5,2238,1227,-40
100933859630,100933859610,-20,2028,554,-40
100934075298,100934075303,5,2651,1543,-40
100943215780,100943215785,5,3081,1059,-40
100948414039,100948414045,6,3138,1170,-40
100952463668,100952463674,6,3477,1454,-40
100959943696,100959943686,-10,1720,1362,-40
100962970147,100962970153,6,2961,1447,-40
100967478658,100967478664,6,2764,1033,-40
100969000836,100969000843,7,33493,56525,-40
100969766446,100969766453,7,2533,1220,-40
100969906241,100969906250,9,2485,1256,-40
100970726486,100970726482,-4,25045,14899,-40
100971010704,100971010710,6,2507,1209,-40
100971053571,100971053579,8,1695,787,-40
100975560149,100975560155,6,2678,1286,-40
100975662398,100975662404,6,1488,1463,-40
100978445498,100978445503,5,3158,1467,-40
100981563653,100981563658,5,2258,1173,-40
100987702289,100987702288,-1,7092,10681,-40
100990283776,100990283781,5,3674,1459,-40
100991825092,100991825099,7,2646,1096,-40
100996909598,100996909594,-4,1066,4005,-40
100997684384,100997684390,6,3084,1183,-40
100999239938,100999239945,7,2569,1332,-40
100999334331,100999334337,6,893,307,-40
101004869280,101004869287,7,3244,1119,-40
101021817702,101021817701,-1,1517,1249,-40
101022633546,101022633542,-4,985,2086,-40
101023115657,101023115664,7,3324,1469,-40
101023261774,101023261753,-21,1283,330,-40
101028979648,101028979654,6,2584,965,-40
101031191147,101031191155,8,1846,1346,-40
101031494902,101031494910,8,2197,1156,-40
101031732549,101031732528,-21,3184,937,-40
101031801470,101031801451,-19,950,523,-40
101037647086,101037647093,7,3139,1643,-40
101038538982,101038538989,7,6518,1505,-40
101043143690,101043143695,5,2495,1365,-40
101043516198,101043516202,4,3377,1369,-40
101044341662,101044341657,-5,1778,7473,-40
101052004917,101052004924,7,4429,2147,-40
101052614881,101052614886,5,3152,1396,-40
101054754764,101054754769,5,2634,1461,-40
101054865094,101054865101,7,2995,1562,-40
101055388913,101055388920,7,2587,1062,-40
101055789318,101055789326,8,3918,1577,-40
101055915297,101055915303,6,3288,1363,-40
101059862189,101059862195,6,2303,1356,-40
101060090660,101060090665,5,3287,2019,-40
101062848602,101062848607,5,2172,1222,-40
101064046474,101064046479,5,2149,1100,-40
101079046705,101079046710,5,3664,2042,-40
101079149949,101079149950,1,2894,3627,-40
101091025129,101091025135,6,3050,1419,-40
101092262654,101092262663,9,1936,953,-40
101095676227,101095676230,3,3296,1081,-40
101095862756,101095862761,5,1867,577,-40
101096519800,101096519807,7,2595,1490,-40
101104996690,101104996697,7,3179,1449,-40
101105575870,101105575874,4,1094,1157,-40
101110010536,101110010542,6,2921,1443,-40
101110282340,101110282346,6,2068,1048,-40
101110554058,101110554065,7,4716,1735,-40
101111076926,101111076933,7,2867,1439,-40
101113081695,101113081703,8,2326,1211,-40
101113887301,101113887307,6,2390,1277,-40
101116239518,101116239518,0,1007,828,-40
101116506862,101116506865,3,39664,36356,-40
101117464918,101117464922,4,2065,1993,-40
101120325265,101120325270,5,3087,1342,-40
101121296295,101121296302,7,3923,1843,-40
101121646829,101121646820,-9,1248,677,-40
101124410772,101124410766,-6,2980,11334,-40
101126385377,101126385382,5,3554,1430,-40
101127209469,101127209465,-4,1450,2328,-40
101128212877,101128212895,18,1633,916,-40
101128798061,101128798066,5,1894,1480,-40
101129037242,101129037228,-14,690,532,-40
101131493958,101131493961,3,2626,1455,-40
101134290143,101134290130,-13,3189,1512,-40
101134590889,101134590882,-7,1373,222,-40
101139669942,101139669950,8,3314,1893,-40
101143610918,101143610922,4,2600,1388,-40
101147530041,101147530047,6,2380,1051,-40
101147641670,101147641675,5,2719,1184,-40
101147739613,101147739618,5,3093,1500,-40
101150760490,101150760486,-4,1069,2171,-40
101151423233,101151423241,8,1930,964,-40
101151519910,101151519888,-22,1713,775,-40
101151770186,101151770194,8,1636,983,-40
101153870350,101153870355,5,2831,1168,-40
101155215885,101155215890,5,3273,1793,-40
101155562449,101155562454,5,2360,813,-40
101156748104,101156748106,2,1602,1725,-40
101157424484,101157424491,7,2397,1279,-40
101161343847,101161343853,6,3319,1312,-40
101161595453,101161595456,3,2815,1430,-40
101162619068,101162619066,-2,2497,2770,-40
101165599430,101165599438,8,2204,1144,-40
101166504569,101166504575,6,2718,1191,-40
101169474010,101169474012,2,26556,19135,-40
101170190246,101170190251,5,2802,1342,-40
101171547542,101171547548,6,2452,1178,-40
101176717258,101176717266,8,2470,1148,-40
101177298362,101177298369,7,3651,1595,-40
101181715159,101181715166,7,3516,1550,-40
101185806411,101185806418,7,1832,1196,-40
101186056574,101186056569,-5,1254,3258,-40
101186173866,101186173873,7,1512,1045,-40
101187614749,101187614754,5,2787,958,-40
101194412679,101194412686,7,1782,693,-40
101195241298,101195241301,3,1602,1052,-40
101199197715,101199197722,7,1915,1202,-40
101199812029,101199812035,6,2478,1006,-40
101200596235,101200596235,0,1103,191,-40
101201080450,101201080457,7,3784,1364,-40
101202314225,101202314233,8,3279,1491,-40
101202427635,101202427639,4,3104,1598,-40
101205935358,101205935344,-14,1240,25422,-40
101205983475,101205983494,19,975,2500,-40
101206058942,101206058949,7,2621,1652,-40
101208909658,101208909665,7,3527,1507,-40
101209024039,101209024025,-14,1190,387,-40
101210485190,101210485189,-1,1185,1920,-40
101215244602,101215244607,5,2545,1153,-40
101216472306,101216472311,5,2371,624,-40
101216896662,101216896669,7,2845,1270,-40
101217318610,101217318617,7,2531,1470,-40
101217986754,101217986762,8,695,264,-40
101219997529,101219997534,5,2219,1108,-40
101228759586,101228759593,7,2382,1063,-40
101229697178,101229697186,8,2992,1411,-40
101231839537,101231839541,4,1935,1533,-40
101234598314,101234598319,5,2614,952,-40
101235263230,101235263235,5,3699,1545,-40
101235561686,101235561691,5,1528,1048,-40
101236264852,101236264857,5,3022,1488,-40
101246823020,101246823025,5,3560,1370,-40
101249303274,101249303281,7,2151,1588,-40
101250050520,101250050525,5,1807,1145,-40
101250291926,101250291930,4,3636,2456,-40
101250565100,101250565095,-5,843,1375,-40
101252840729,101252840735,6,3015,1079,-40
101263302469,101263302474,5,3876,578,-40
101264618653,101264618659,6,1798,1304,-40
101265918429,101265918435,6,2111,1620,-40
101266495130,101266495137,7,3309,926,-40
101267421337,101267421322,-15,1259,791,-40
101269788197,101269788205,8,2131,1556,-40
101277812349,101277812355,6,3035,1210,-40
101281349244,101281349251,7,2144,1050,-40
101281867952,101281867962,10,1135,354,-40
101282342233,101282342238,5,2382,881,-40
101282555202,101282555186,-16,1163,462,-40
101288508425,101288508430,5,3686,1071,-40
101291638121,101291638126,5,2400,1112,-40
101298996406,101298996411,5,2611,875,-40
101303871933,101303871938,5,2853,1307,-40
101304797394,101304797401,7,3062,1240,-40
101305773135,101305773143,8,2992,1370,-40
101306998774,101306998781,7,1743,798,-40
101308206406,101308206384,-22,1078,766,-40
101311060698,101311060706,8,4591,1361,-40
101314554906,101314554914,8,2987,1639,-40
101314844052,101314844041,-11,727,324,-40
101316429274,101316429282,8,3307,1651,-40
101321340482,101321340490,8,4705,1175,-40
101323574396,101323574401,5,2780,2053,-40
101325374174,101325374176,2,1736,1473,-40
101325806327,101325806334,7,4453,1435,-40
101330419378,101330419385,7,2816,1365,-40
101330655535,101330655524,-11,3049,1874,-40
101334905191,101334905192,1,1814,1759,-40
101336007143,101336007152,9,3557,1628,-40
101336284153,101336284137,-16,1713,828,-40
101338334653,101338334659,6,2455,1482,-40
101348926000,101348926006,6,1377,1189,-40
101353382992,101353382999,7,3954,1646,-40
101359518395,101359518402,7,2515,1095,-40
101360419597,101360419599,2,3318,3467,-40
101362516698,101362516704,6,2532,1337,-40
101364390314,101364390321,7,2727,1471,-40
101365343350,101365343356,6,4030,1289,-40
101369320318,101369320322,4,2430,1481,-40
101373896823,101373896824,1,1958,1971,-40
101374093217,101374093224,7,3319,1139,-40
101374529879,101374529859,-20,1750,791,-40
101374735202,101374735210,8,2733,975,-40
101379625678,101379625686,8,2352,1324,-40
101379788315,101379788328,13,2130,920,-40
101380936290,101380936275,-15,2361,985,-40
101381139243,101381139250,7,2621,1395,-40
101381313119,101381313125,6,2096,1154,-40
101384012461,101384012464,3,2369,1254,-40
101385681103,101385681110,7,3917,1631,-40
101390829931,101390829938,7,2835,1094,-40
101391210280,101391210264,-16,3491,1568,-40
101392261454,101392261460,6,2586,1497,-40
101392592202,101392592201,-1,844,314,-40
101393625044,101393625049,5,3060,1116,-40
101393832294,101393832288,-6,1029,235,-40
101394922227,101394922235,8,8636,2403,-40
101399599214,101399599221,7,2087,1286,-40
101402910358,101402910364,6,4141,1483,-40
101407194725,101407194731,6,2854,1021,-40
101410540249,101410540250,1,1134,773,-40
101414069027,101414069034,7,3416,1566,-40
101414590571,101414590577,6,2409,1134,-40
101415035911,101415035899,-12,1655,573,-40
101427891683,101427891687,4,1622,1082,-40
101428550743,101428550748,5,2132,1339,-40
101430126873,101430126881,8,2945,1444,-40
101430189840,101430189847,7,3282,1397,-40
101432989503,101432989507,4,1885,891,-40
101433040473,101433040458,-15,2520,1049,-40
101433577147,101433577154,7,2231,1002,-40
101439451266,101439451269,3,2344,1239,-40
101440072530,101440072538,8,3410,1311,-40
101440298979,101440298984,5,2238,887,-40
101440339254,101440339235,-19,2286,695,-40
101440412164,101440412170,6,2209,1022,-40
101443298557,101443298561,4,34922,23661,-40
101443617981,101443617987,6,3070,1045,-40
101444493682,101444493688,6,3894,1906,-40
101447791137,101447791132,-5,2755,7083,-40
101448237997,101448238006,9,3673,800,-40
101449183458,101449183465,7,3440,1384,-40
101454124238,101454124241,3,2135,1367,-40
101461066483,101461066489,6,2472,1521,-40
101462615962,101462615968,6,2327,1048,-40
101462932900,101462932906,6,2889,1400,-40
101465678705,101465678711,6,2469,924,-40
101467604549,101467604554,5,1605,967,-40
101469886499,101469886504,5,2746,1873,-40
101472382431,101472382437,6,2972,1771,-40
101473811941,101473811947,6,1413,1024,-40
101475875295,101475875302,7,3270,1296,-40
101476113805,101476113786,-19,2898,1095,-40
101477048646,101477048626,-20,1190,557,-40
101481574212,101481574217,5,2408,1127,-40
101482022506,101482022512,6,1580,1071,-40
101483823469,101483823477,8,2729,1275,-40
101487486373,101487486378,5,1866,1064,-40
101491666462,101491666469,7,3093,1011,-40
101491992306,101491992315,9,1711,1306,-40
101496424918,101496424922,4,2708,2049,-40
101496836216,101496836222,6,4219,1469,-40
101497426681,101497426685,4,48100,35705,-40
101515600138,101515600145,7,3250,1680,-40
101515943482,101515943464,-18,1074,313,-40
101518889199,101518889196,-3,2622,5243,-40
101519349328,101519349334,6,2433,1318,-40
101525979365,101525979370,5,2341,1333,-40
101526505276,101526505283,7,2713,1406,-40
101526749680,101526749686,6,2847,1610,-40
101530389302,101530389309,7,2808,1984,-40
101537034868,101537034873,5,2834,1062,-40
101538055302,101538055309,7,3213,1376,-40
101538627737,101538627743,6,3274,1784,-40
101543864462,101543864466,4,2573,1498,-40
101544485669,101544485670,1,2924,3170,-40
101549759989,101549759993,4,3689,1468,-40
101549812394,101549812394,0,8502,10383,-40
101551941655,101551941662,7,2611,1379,-40
101553469753,101553469759,6,2174,1183,-40
101553509798,101553509811,13,1334,307,-40
101553717422,101553717424,2,2948,2371,-40
101557354330,101557354338,8,2809,1278,-40
101559479119,101559479126,7,2725,1157,-40
101559896405,101559896410,5,15236,9013,-40
101560203191,101560203197,6,1731,1246,-40
101565441525,101565441532,7,2682,1568,-40
101567644978,101567644979,1,1394,1676,-40
101575706349,101575706355,6,2793,1302,-40
101576234220,101576234234,14,2207,916,-40
101577125637,101577125641,4,2834,1080,-40
101577629811,101577629818,7,2613,1299,-40
101577722226,101577722241,15,661,97,-40
101578449842,101578449828,-14,1083,523,-40
101582164666,101582164671,5,1422,597,-40
101585018254,101585018260,6,3946,1532,-40
101587318814,101587318821,7,3406,1284,-40
101590361794,101590361799,5,2943,1745,-40
101590699238,101590699235,-3,1100,2848,-40
101590810183,101590810189,6,3985,1276,-40
101591386665,101591386671,6,4089,1492,-40
101591547014,101591547021,7,2714,1186,-40
101595211654,101595211662,8,1986,1355,-40
101596812702,101596812706,4,2649,739,-40
101599252367,101599252374,7,1815,894,-40
101604817119,101604817126,7,3155,1163,-40
101605031134,101605031141,7,3317,1312,-40
101609460859,101609460864,5,2821,1375,-40
101609971860,101609971861,1,1540,1657,-40
101610539398,101610539387,-11,1360,686,-40
101610688951,101610688959,8,3568,1353,-40
101614406217,101614406223,6,2058,896,-40
101616701432,101616701421,-11,1109,2148,-40
101619286130,101619286135,5,3488,1271,-40
101623533950,101623533958,8,3023,1182,-40
101625764110,101625764106,-4,1273,3176,-40
101626911629,101626911634,5,2402,1367,-40
101628414021,101628414026,5,3250,1416,-40
101629111352,101629111361,9,12480,36127,-40
101629764106,101629764110,4,1303,1008,-40
101633202122,101633202127,5,1744,1014,-40
101633686455,101633686462,7,4187,1441,-40
101634689339,101634689347,8,1343,320,-40
101635138232,101635138238,6,2201,1607,-40
101637792890,101637792897,7,2469,1386,-40
101640184568,101640184575,7,3599,1073,-40
101640460490,101640460490,0,1791,2585,-40
101641609689,101641609693,4,2027,696,-40
101643134358,101643134367,9,1981,708,-40
101644418610,101644418617,7,1209,733,-40
101647665757,101647665763,6,2096,1158,-40
101648420283,101648420291,8,2901,1245,-40
101649932889,101649932895,6,3137,1505,-40
101651430865,101651430871,6,2911,1241,-40
101652532820,101652532827,7,2917,1185,-40
101656616810,101656616814,4,1408,1205,-40
101657246602,101657246601,-1,1307,1803,-40
101658701200,101658701202,2,3004,2555,-40
101659338214,101659338220,6,4003,1590,-40
101660872762,101660872769,7,2509,786,-40
101662697046,101662697054,8,1970,689,-40
101665889073,101665889084,11,10162,47145,-40
101669679954,101669679959,5,2599,868,-40
101672275125,101672275130,5,2540,1183,-40
101672436477,101672436483,6,1958,1051,-40
101673459060,101673459065,5,2180,1187,-40
101674550573,101674550577,4,4416,2796,-40
101676373890,101676373896,6,3190,1290,-40
101678706286,101678706290,4,1091,519,-40
101679169554,101679169536,-18,3391,1152,-40
101679241549,101679241531,-18,1066,1038,-40
101682496887,101682496894,7,2119,949,-40
101683295529,101683295539,10,1203,744,-40
101684337956,101684337950,-6,1041,4140,-40
101685923569,101685923575,6,3670,1634,-40
101689223159,101689223153,-6,1098,5479,-40
101692680450,101692680455,5,2006,1449,-40
101696850599,101696850604,5,2580,1047,-40
101697569649,101697569664,15,961,114,-40
101699427567,101699427574,7,2214,1045,-40
101702572463,101702572468,5,2520,1262,-40
101702677442,101702677448,6,2422,1452,-40
101704766456,101704766462,6,2422,1446,-40
101705703770,101705703775,5,3048,1156,-40
101709108039,101709108045,6,2153,1198,-40
101713693502,101713693507,5,2115,1043,-40
101715229174,101715229181,7,3724,1533,-40
101716640706,101716640714,8,2729,1166,-40
101718558398,101718558405,7,3141,1160,-40
101719738133,101719738122,-11,674,205,-40
101721348719,101721348725,6,2572,1232,-40
101721636819,101721636823,4,3538,1293,-40
101722576570,101722576575,5,3018,1389,-40
101727435209,101727435215,6,1409,1078,-40
101730363978,101730363977,-1,1933,3938,-40
101734509283,101734509281,-2,1106,1914,-40
101735546662,101735546667,5,1229,1047,-40
101735920061,101735920080,19,2749,1612,-40
101750317409,101750317416,7,8017,38171,-40
101751506407,101751506413,6,3383,1489,-40
101755168405,101755168409,4,2734,1044,-40
101755930427,101755930433,6,3501,1405,-40
101759689127,101759689133,6,3309,1445,-40
101761949276,101761949283,7,2826,810,-40
101762610591,101762610597,6,2340,1292,-40
101765536149,101765536154,5,2759,832,-40
101766649629,101766649649,20,2591,1025,-40
101767542591,101767542571,-20,807,153,-40
101770435765,101770435770,5,2879,1318,-40
101773049917,101773049923,6,3376,1326,-40
101773201008,101773201017,9,14925,27673,-40
101773566939,101773566948,9,2410,1416,-40
101774069256,101774069241,-15,1887,811,-40
101775454097,101775454104,7,4013,1451,-40
101776337738,101776337740,2,1585,1525,-40
101784142759,101784142766,7,2843,1165,-40
101784631300,101784631282,-18,873,347,-40
101791931358,101791931364,6,2606,1372,-40
101800134303,101800134313,10,13362,42525,-40
101800173431,101800173437,6,2852,1486,-40
101801578132,101801578135,3,2080,1248,-40
101802785890,101802785897,7,3042,1125,-40
101803987958,101803987965,7,3654,1078,-40
101805938491,101805938497,6,1582,612,-40
101808425702,101808425705,3,1256,1195,-40
101808581250,101808581258,8,2374,1373,-40
101809663797,101809663800,3,2043,1531,-40
101813987191,101813987198,7,4441,1290,-40
101814286773,101814286778,5,1710,1167,-40
101816377001,101816377003,2,1218,1501,-40
101821164234,101821164240,6,2539,781,-40
101822393001,101822393007,6,3916,1423,-40
101824762988,101824762993,5,2684,1275,-40
101830020843,101830020844,1,1979,2172,-40
101831076253,101831076257,4,1707,1165,-40
101834398888,101834398895,7,3378,1783,-40
101840406161,101840406164,3,1856,1467,-40
101843172011,101843172013,2,1513,1872,-40
101848604277,101848604279,2,2177,1725,-40
101852414113,101852414117,4,2349,1227,-40
101852559051,101852559049,-2,699,271,-40
101853524425,101853524432,7,2418,1153,-40
101853848330,101853848337,7,2903,1307,-40
101860419169,101860419177,8,2365,1499,-40
101862504189,101862504184,-5,1152,254,-40
101863419881,101863419888,7,2537,1209,-40
101864922620,101864922627,7,1856,1073,-40
101865706576,101865706584,8,3182,1000,-40
101866704118,101866704124,6,3521,1268,-40
101871115890,101871115897,7,3147,1386,-40
101873723136,101873723130,-6,1726,8460,-40
101878333162,101878333171,9,3115,1137,-40
101880584895,101880584898,3,1152,1202,-40
101886409985,101886409990,5,1882,1254,-40
101888726603,101888726611,8,3283,1167,-40
101890090891,101890090898,7,2748,1589,-40
101890266380,101890266364,-16,2220,1221,-40
101890966357,101890966364,7,4176,1814,-40
101895926653,101895926652,-1,985,1935,-40
101902552070,101902552075,5,2418,1170,-40
101903613822,101903613829,7,2575,1358,-40
101909193020,101909193026,6,3407,1115,-40
101909458027,101909458010,-17,2655,1154,-40
101913692777,101913692783,6,2850,1442,-40
101915415133,101915415138,5,3430,1138,-40
101917628378,101917628377,-1,1349,1832,-40
101919858413,101919858419,6,3158,1231,-40
101919913179,101919913163,-16,1893,511,-40
101924962008,101924962015,7,3977,1733,-40
101927392923,101927392929,6,3295,1467,-40
101930285477,101930285483,6,2927,1057,-40
101930802375,101930802379,4,1219,800,-40
101933937731,101933937737,6,3269,1170,-40
101940304063,101940304048,-15,2444,843,-40
101941081754,101941081755,1,2756,1785,-40
101942451828,101942451834,6,3239,1587,-40
101944294073,101944294080,7,3847,1828,-40
101956654872,101956654878,6,2659,1067,-40
101958274623,101958274625,2,1791,1863,-40
101960568977,101960568983,6,2832,1626,-40
101963330969,101963330976,7,1837,1070,-40
101975138096,101975138106,10,3127,883,-40
101976198143,101976198136,-7,24229,13200,-40
101980818777,101980818778,1,1797,3457,-40
101986750011,101986750018,7,5108,1358,-40
101988156258,101988156266,8,2905,1364,-40
101993888378,101993888387,9,2313,1216,-40
101996323843,101996323850,7,2673,943,-40
102000330006,102000330014,8,1172,542,-40
102001031102,102001031108,6,4224,1418,-40
102003348249,102003348250,1,1126,1678,-40
102003451286,102003451291,5,2491,1032,-40
102003478847,102003478864,17,3069,1324,-40
102009389879,102009389885,6,2433,1218,-40
102010167909,102010167915,6,2859,1222,-40
102011225349,102011225355,6,3321,1021,-40
102013608336,102013608339,3,23938,676,-40
102013705270,102013705273,3,1157,231,-40
102013886772,102013886777,5,3393,1217,-40
102015276538,102015276545,7,2122,1243,-40
102019468451,102019468458,7,3646,1330,-40
102023877596,102023877602,6,2723,1097,-40
102025196043,102025196034,-9,853,12646,-40
102029554106,102029554114,8,2575,1100,-40
102031608405,102031608411,6,2830,1144,-40
102032841599,102032841607,8,1801,695,-40
102033060309,102033060314,5,1994,1093,-40
102033110921,102033110927,6,4081,1220,-40
102036734937,102036734942,5,2273,849,-40
102039014478,102039014483,5,2583,1034,-40
102039155036,102039155039,3,1125,1056,-40
102040679495,102040679498,3,2089,1372,-40
102041018305,102041018309,4,2047,1074,-40
102048404910,102048404916,6,3630,1251,-40
102052171663,102052171669,6,3283,907,-40
102057183689,102057183695,6,3023,781,-40
102061697694,102061697700,6,2930,1289,-40
102061930759,102061930767,8,2814,1386,-40
102063738516,102063738522,6,2315,577,-40
102064124082,102064124089,7,3130,1103,-40
102072572210,102072572217,7,73456,33184,-40
102075707706,102075707712,6,2118,986,-40
102079991202,102079991209,7,1597,679,-40
102081942882,102081942886,4,1410,848,-40
102082480008,102082480013,5,1992,1197,-40
102082816456,102082816462,6,2602,956,-40
102087734245,102087734251,6,3539,1762,-40
102088407001,102088407006,5,2408,1321,-40
102089780071,102089780077,6,2984,1552,-40
102090873003,102090873010,7,2873,1344,-40
102095752364,102095752370,6,3072,1080,-40
102101167381,102101167387,6,3928,1771,-40
102104833386,102104833386,0,1740,2045,-40
102106100477,102106100482,5,3112,1222,-40
102107697862,102107697870,8,3218,924,-40
102110839762,102110839769,7,3840,1368,-40
102111635192,102111635195,3,1305,1085,-40
102112154353,102112154338,-15,2400,569,-40
102115574700,102115574705,5,3295,1529,-40
102116077328,102116077335,7,1968,1542,-40
102116913003,102116912986,-17,2066,530,-40
102123984790,102123984795,5,3355,1533,-40
102126877926,102126877931,5,1164,828,-40
102134968465,102134968469,4,2392,1785,-40
102137029057,102137029063,6,3708,1357,-40
102140043705,102140043714,9,9653,34511,-40
102146322667,102146322673,6,2033,1376,-40
102148277395,102148277402,7,2089,1305,-40
102152698378,102152698387,9,2670,1081,-40
102158424989,102158424994,5,3835,1149,-40
102163185257,102163185263,6,3397,1255,-40
102171559362,102171559368,6,3476,1338,-40
102175817269,102175817275,6,2654,1067,-40
102176089421,102176089426,5,2631,1333,-40
102177256116,102177256117,1,27741,19689,-40
102177301154,102177301159,5,2856,1038,-40
102185886349,102185886355,6,2332,994,-40
102188668273,102188668270,-3,1827,3912,-40
102194072364,102194072363,-1,19915,11242,-40
102194960178,102194960184,6,1990,970,-40
102195249828,102195249841,13,2409,1329,-40
102195551132,102195551116,-16,1039,285,-40
102196779442,102196779447,5,2165,1324,-40
102196969126,102196969114,-12,1856,730,-40
102197857856,102197857862,6,3594,1667,-40
102198085651,102198085658,7,3528,1888,-40
102201268098,102201268104,6,2487,1785,-40
102201577321,102201577326,5,2794,1225,-40
102203818508,102203818502,-6,906,2368,-40
102205910941,102205910947,6,3225,1000,-40
102209462825,102209462822,-3,2138,44914,-40
102210721812,102210721818,6,3026,1427,-40
102212947572,102212947578,6,3381,1059,-40
102219888965,102219888970,5,1755,1117,-40
102220033682,102220033666,-16,2485,710,-40
102221090537,102221090543,6,2115,1004,-40
102221282717,102221282722,5,2371,962,-40
102223416165,102223416173,8,2951,1352,-40
102225495502,102225495506,4,2266,1329,-40
102229078451,102229078455,4,1907,1439,-40
102229690174,102229690179,5,2683,745,-40
102230297677,102230297682,5,2093,980,-40
102232789340,102232789346,6,2763,1470,-40
102233353003,102233353007,4,1955,1203,-40
102234386693,102234386699,6,2820,1227,-40
102242501210,102242501216,6,3440,1193,-40
102242759493,102242759480,-13,1603,366,-40
102245212667,102245212674,7,2844,1094,-40
102246257169,102246257173,4,1611,1253,-40
102246425817,102246425823,6,3058,1208,-40
102248495276,102248495282,6,2122,1096,-40
102250798451,102250798457,6,2084,1631,-40
102257648098,102257648078,-20,2083,1083,-40
102258370581,102258370587,6,3570,1600,-40
102259092375,102259092383,8,1881,887,-40
102259197400,102259197406,6,2215,1417,-40
102259846213,102259846219,6,3099,1460,-40
102262946282,102262946276,-6,44092,28083,-40
102263677859,102263677853,-6,945,3430,-40
102263873391,102263873395,4,2360,1106,-40
102264003615,102264003592,-23,2774,1115,-40
102273081334,102273081339,5,1731,967,-40
102274935540,102274935547,7,3609,1374,-40
102277171975,102277171982,7,3405,1556,-40
102278859693,102278859699,6,3044,1667,-40
102282937770,102282937777,7,3107,1561,-40
102284417666,102284417670,4,2542,1276,-40
102286914872,102286914878,6,1911,1190,-40
102286984499,102286984505,6,2866,1476,-40
102290495714,102290495721,7,2731,985,-40
102292860612,102292860630,18,2909,926,-40
102295084401,102295084406,5,3002,1505,-40
102298502672,102298502678,6,2491,1470,-40
102299621925,102299621933,8,1630,845,-40
102299693998,102299694001,3,1196,308,-40
102302374785,102302374788,3,3462,2952,-40
102303379148,102303379153,5,1651,801,-40
102312885426,102312885434,8,3469,1071,-40
102314085363,102314085363,0,1805,2265,-40
102314956785,102314956790,5,2744,931,-40
102315217222,102315217229,7,2390,1232,-40
102315890514,102315890520,6,2507,1373,-40
102317835909,102317835905,-4,1140,2795,-40
102318584828,102318584832,4,1520,1279,-40
102320105922,102320105930,8,3512,1283,-40
102320334251,102320334240,-11,653,39,-40
102325006114,102325006119,5,2951,967,-40
102328049065,102328049071,6,3472,1238,-40
102329876251,102329876255,4,1051,630,-40
102333854020,102333854025,5,2394,1297,-40
102336964775,102336964781,6,3157,1607,-40
102337432378,102337432385,7,2491,1162,-40
102342186582,102342186590,8,6345,2545,-40
102342799845,102342799848,3,2096,1424,-40
102345276831,102345276839,8,3618,1562,-40
102346071201,102346071205,4,1513,739,-40
102349728369,102349728374,5,3786,1645,-40
102354000994,102354000999,5,3721,1536,-40
102355876109,102355876114,5,2669,1049,-40
102357278988,102357278999,11,12874,36782,-40
102358437617,102358437615,-2,1128,2578,-40
102358998041,102358998047,6,3616,1500,-40
102359518270,102359518278,8,2566,1032,-40
102365891932,102365891939,7,2546,1169,-40
102366204449,102366204454,5,3320,1284,-40
102370144502,102370144507,5,2213,1249,-40
102374961431,102374961435,4,2493,1223,-40
102375079393,102375079398,5,3096,1102,-40
102378515773,102378515778,5,2449,1618,-40
102379293791,102379293798,7,3074,1258,-40
102382531165,102382531170,5,2633,1434,-40
102386492363,102386492369,6,3279,950,-40
102388348862,102388348842,-20,826,428,-40
102390573632,102390573638,6,2184,798,-40
102401427929,102401427935,6,3507,1373,-40
102402542486,102402542491,5,2941,715,-40
102411566444,102411566451,7,3979,1542,-40
102416490615,102416490618,3,2724,1613,-40
102416683942,102416683948,6,3690,1710,-40
102417296838,102417296842,4,7576,3607,-40
102418718406,102418718414,8,4527,1721,-40
102420163459,102420163467,8,2708,1056,-40
102420199250,102420199251,1,947,419,-40
102422417258,102422417263,5,2194,1489,-40
102423103010,102423103017,7,3314,1371,-40
102425335731,102425335735,4,2206,1299,-40
102426210980,102426210987,7,3233,1431,-40
102428523058,102428523064,6,4071,1179,-40
102430411141,102430411146,5,2303,1039,-40
102430995774,102430995779,5,2562,1351,-40
102431449576,102431449583,7,3370,2077,-40
102432722834,102432722841,7,3849,1588,-40
102434377767,102434377767,0,1726,2588,-40
102435350649,102435350654,5,3060,1122,-40
102435563146,102435563154,8,4149,1313,-40
102437009402,102437009402,0,1127,1461,-40
102441484748,102441484753,5,2805,1146,-40
102441947433,102441947439,6,4273,1417,-40
102443163946,102443163952,6,2295,1487,-40
102444077306,102444077312,6,2539,1478,-40
102450962041,102450962046,5,2548,1407,-40
102452040695,102452040674,-21,2700,1493,-40
102452840594,102452840601,7,3056,1382,-40
102457393330,102457393331,1,2954,3660,-40
102459237868,102459237870,2,1993,1466,-40
102462927681,102462927689,8,3039,1352,-40
102464267454,102464267461,7,2731,1201,-40
102467023247,102467023254,7,2947,1150,-40
102468549791,102468549797,6,2301,1497,-40
102472405250,102472405257,7,3173,1137,-40
102478048658,102478048663,5,1972,1236,-40
102479398395,102479398402,7,3323,1036,-40
102480980838,102480980846,8,4801,2472,-40
102481370829,102481370833,4,1537,1128,-40
102485111864,102485111869,5,2991,1729,-40
102486784791,102486784797,6,2923,1061,-40
102488199582,102488199587,5,2620,1604,-40
102490063951,102490063958,7,3136,1989,-40
102492846773,102492846779,6,3814,1093,-40
102495012694,102495012700,6,2996,1587,-40
102495783757,102495783762,5,1571,678,-40
102496002377,102496002378,1,1036,424,-40
102497388010,102497388017,7,3444,1800,-40
102497488850,102497488858,8,3120,1302,-40
102501554257,102501554262,5,2177,1173,-40
102510273169,102510273178,9,2419,1652,-40
102511364806,102511364784,-22,1117,923,-40
102515024457,102515024466,9,2497,1125,-40
102518898953,102518898959,6,2275,1010,-40
102520303747,102520303750,3,2244,1324,-40
102521695971,102521695970,-1,1800,3148,-40
102521858044,102521858046,2,10383,8717,-40
102522246309,102522246313,4,2876,1394,-40
102522847406,102522847406,0,2530,3466,-40
102523241023,102523241029,6,2953,1317,-40
102526206460,102526206467,7,2822,1062,-40
102532229135,102532229131,-4,1234,3397,-40
102534841094,102534841100,6,2602,1311,-40
102539668226,102539668230,4,2134,991,-40
102540722759,102540722766,7,2762,1164,-40
102541316720,102541316723,3,1799,1028,-40
102543211737,102543211741,4,2507,1270,-40
102547125280,102547125287,7,4315,1548,-40
102551939209,102551939208,-1,2631,3882,-40
102554876894,102554876899,5,3714,1392,-40
102563033043,102563033050,7,2841,1385,-40
102563697388,102563697394,6,3246,1160,-40
102565542746,102565542747,1,1657,2009,-40
102568191260,102568191265,5,3727,1634,-40
102568567864,102568567870,6,2810,1459,-40
102571352922,102571352929,7,3712,1541,-40
102573500302,102573500309,7,2852,812,-40
102577592489,102577592498,9,2882,1366,-40
102578266642,102578266649,7,2487,1587,-40
102578416569,102578416578,9,724,178,-40
102579466230,102579466237,7,2242,1135,-40
102581156209,102581156214,5,3354,1907,-40
102582166935,102582166942,7,2043,1208,-40
102585077677,102585077683,6,3248,1446,-40
102586125813,102586125818,5,3645,1720,-40
102589876293,102589876299,6,2563,1037,-40
102592071438,102592071447,9,2373,965,-40
102592307678,102592307685,7,5754,1799,-40
102593421197,102593421194,-3,1491,5115,-40
102596324785,102596324793,8,1705,960,-40
102597163430,102597163434,4,3424,3244,-40
102599823070,102599823077,7,3542,854,-40
102600649650,102600649658,8,1190,258,-40
102606291013,102606291018,5,3046,1301,-40
102609355317,102609355326,9,2432,1192,-40
102609708690,102609708676,-14,945,177,-40
102616157093,102616157097,4,3547,1469,-40
102617450782,102617450784,2,34929,42832,-40
102619983346,102619983354,8,6995,1203,-40
102621016041,102621016047,6,3177,1059,-40
102622798738,102622798743,5,2577,1217,-40
102640209690,102640209695,5,1539,958,-40
102643881965,102643881971,6,2977,1635,-40
102648198444,102648198450,6,2534,1026,-40
102648306017,102648306022,5,1997,911,-40
102649594506,102649594505,-1,1181,366,-40
102651076370,102651076374,4,2274,1810,-40
102654185533,102654185540,7,3244,1957,-40
102659139081,102659139087,6,2029,1202,-40
102659468909,102659468912,3,2032,1286,-40
102661781818,102661781825,7,2749,1401,-40
102663816270,102663816276,6,2588,1096,-40
102671125756,102671125762,6,2859,964,-40
102672083090,102672083098,8,3938,1453,-40
102676172214,102676172220,6,2934,1285,-40
102682658358,102682658362,4,1230,911,-40
102682977014,102682977019,5,3805,1081,-40
102684432426,102684432433,7,2805,1267,-40
102684716527,102684716534,7,2905,1086,-40
102684831758,102684831764,6,3104,1708,-40
102685096726,102685096734,8,3840,1487,-40
102688931478,102688931486,8,2979,1266,-40
102690141002,102690141009,7,2545,1182,-40
102691145466,102691145482,16,560,1508,-40
102695292816,102695292822,6,1825,801,-40
102697108006,102697108013,7,4391,1658,-40
102698005102,102698005108,6,3170,1473,-40
102698625901,102698625907,6,1925,1078,-40
102700887982,102700887988,6,2970,1315,-40
102701018053,102701018058,5,2524,1079,-40
102701615879,102701615886,7,3149,1545,-40
102702866893,102702866898,5,2357,1331,-40
102704112849,102704112855,6,3214,1384,-40
102704325900,102704325906,6,3216,1438,-40
102704572137,102704572120,-17,1112,399,-40
102705243867,102705243874,7,2378,1349,-40
102705375621,102705375628,7,3345,1645,-40
102707302919,102707302926,7,3383,1222,-40
102708215985,102708216001,16,3671,1539,-40
102708857551,102708857555,4,1713,1212,-40
102711468933,102711468933,0,6434,8012,-40
102711556160,102711556164,4,1552,1067,-40
102713627163,102713627171,8,1475,908,-40
102714195864,102714195852,-12,1887,1096,-40
102714228582,102714228579,-3,897,220,-40
102714926711,102714926717,6,2294,1216,-40
102715427495,102715427503,8,1722,639,-40
102717591814,102717591819,5,2700,1283,-40
102718742790,102718742797,7,2731,1677,-40
102720894641,102720894645,4,2128,1258,-40
102722090331,102722090338,7,1565,810,-40
102729564215,102729564222,7,2700,1447,-40
102732244847,102732244845,-2,956,2163,-40
102734963410,102734963417,7,2007,701,-40
102735954707,102735954713,6,2581,1021,-40
102736372705,102736372723,18,1924,1342,-40
102736646959,102736646969,10,2220,897,-40
102739228982,102739228982,0,1210,2362,-40
102739798624,102739798624,0,45669,29316,-40
102744619134,102744619132,-2,1560,2454,-40
102748720354,102748720359,5,2408,1412,-40
102749869398,102749869405,7,2199,995,-40
102752918515,102752918523,8,2272,855,-40
102753352109,102753352115,6,2468,1526,-40
102754318346,102754318351,5,2560,1715,-40
102757673978,102757673985,7,3476,1685,-40
102759952417,102759952422,5,2388,1283,-40
102760669996,102760670004,8,2593,844,-40
102761972322,102761972328,6,3086,1038,-40
102762212323,102762212329,6,3381,1330,-40
102763730221,102763730227,6,3503,1795,-40
102764253309,102764253314,5,3436,1974,-40
102765309438,102765309443,5,1591,1118,-40
102765866213,102765866221,8,2321,1337,-40
102772653526,102772653534,8,3438,1100,-40
102778665227,102778665233,6,2955,1507,-40
102783902911,102783902931,20,925,377,-40
102785035305,102785035310,5,3211,1277,-40
102792133977,102792133983,6,4057,1818,-40
102792693126,102792693131,5,2425,883,-40
102794724043,102794724050,7,2988,967,-40
102799787220,102799787226,6,4003,1518,-40
102802877488,102802877494,6,2739,1333,-40
102803192836,102803192841,5,2652,1060,-40
102803895894,102803895872,-22,1438,617,-40
102818703505,102818703510,5,1810,1301,-40
102821479934,102821479939,5,1995,766,-40
102823467874,102823467879,5,2891,995,-40
102824556182,102824556185,3,2482,1707,-40
102824831414,102824831420,6,2303,1002,-40
102824890530,102824890531,1,1655,2161,-40
102828644135,102828644142,7,3405,1380,-40
102831780610,102831780611,1,1780,2015,-40
102834678854,102834678861,7,1999,1146,-40
102834963960,102834963953,-7,820,147,-40
102838950157,102838950163,6,3607,1286,-40
102841330638,102841330643,5,3083,1031,-40
102841758928,102841758930,2,2503,2732,-40
102845740253,102845740259,6,2682,975,-40
102852682906,102852682909,3,1180,1269,-40
102861206874,102861206881,7,3407,1455,-40
102866234714,102866234719,5,2816,1464,-40
102867252929,102867252937,8,2572,1264,-40
102871076274,102871076282,8,3244,1533,-40
102873584983,102873584990,7,3551,1336,-40
102873881885,102873881891,6,3682,1472,-40
102876818045,102876818054,9,3860,1365,-40
102877057793,102877057793,0,1226,1886,-40
102879371350,102879371358,8,1703,1066,-40
102879489169,102879489177,8,4027,1542,-40
102885823265,102885823270,5,3649,1720,-40
102892581102,102892581108,6,2528,1193,-40
102898185745,102898185753,8,3472,1469,-40
102898498998,102898498980,-18,2868,695,-40
102904816973,102904816979,6,3279,1578,-40
102906369558,102906369566,8,4927,1030,-40
102908436594,102908436594,0,20684,36047,-40
102911997531,102911997536,5,2184,1177,-40
102917122019,102917122017,-2,1004,917,-40
102920785347,102920785355,8,2568,1272,-40
102921296498,102921296504,6,3705,1281,-40
102921972325,102921972332,7,2435,1213,-40
102924857166,102924857173,7,3548,1055,-40
102925050399,102925050392,-7,723,211,-40
102927599452,102927599465,13,417,1850,-40
102930207901,102930207907,6,2661,1069,-40
102933201017,102933201015,-2,1254,1985,-40
102934402923,102934402930,7,2052,472,-40
102937123555,102937123563,8,3138,1006,-40
102938026140,102938026146,6,2314,1459,-40
102938852196,102938852202,6,2995,1481,-40
102939137269,102939137252,-17,1658,953,-40
102939192826,102939192806,-20,1106,3850,-40
102939929113,102939929121,8,2494,1037,-40
102945459048,102945459053,5,1765,640,-40
102948811716,102948811723,7,1443,1003,-40
102952981649,102952981667,18,2121,1273,-40
102962233126,102962233134,8,3321,1229,-40
102968982409,102968982415,6,3551,1247,-40
102972948843,102972948849,6,4946,1443,-40
102979311796,102979311802,6,1805,1010,-40
102979340593,102979340576,-17,2145,1342,-40
102982199542,102982199547,5,1994,1475,-40
102986864396,102986864402,6,3085,1413,-40
102993973132,102993973139,7,4270,1252,-40
102994039214,102994039221,7,1706,619,-40
102994446455,102994446475,20,818,300,-40
102996505869,102996505875,6,1981,909,-40
102998155378,102998155381,3,1541,1365,-40
102999216573,102999216578,5,2564,1679,-40
103000123312,103000123318,6,2767,1723,-40
103002411760,103002411765,5,4530,1605,-40
103005868479,103005868466,-13,1794,1191,-40
103006375605,103006375611,6,2580,1254,-40
103008957190,103008957195,5,3005,1116,-40
103009484118,103009484125,7,1562,724,-40
103010643309,103010643296,-13,1096,461,-40
103014964636,103014964642,6,2408,1227,-40
103016202513,103016202519,6,2708,1300,-40
103016901955,103016901961,6,2998,980,-40
103017108914,103017108915,1,935,236,-40
103017607898,103017607902,4,2562,1541,-40
103027279568,103027279575,7,2493,1210,-40
103028377025,103028377030,5,1473,1188,-40
103029111099,103029111106,7,2761,1212,-40
103029266645,103029266651,6,2827,1587,-40
103031460793,103031460799,6,2162,907,-40
103036988265,103036988269,4,2428,1179,-40
103041835241,103041835246,5,2915,1291,-40
103042442566,103042442574,8,2298,1065,-40
103043445916,103043445923,7,3231,1356,-40
103046126833,103046126838,5,3572,1786,-40
103048946906,103048946913,7,4414,1747,-40
103049801381,103049801389,8,2886,1491,-40
103056907384,103056907390,6,2312,936,-40
103059332405,103059332411,6,2915,1389,-40
103060149883,103060149890,7,3109,1066,-40
103062850581,103062850588,7,2902,1216,-40
103063411995,103063412002,7,3394,1562,-40
103065200093,103065200099,6,3036,1333,-40
103066927334,103066927339,5,2099,923,-40
103070858750,103070858749,-1,734,1060,-40
103072247230,103072247235,5,2151,1344,-40
103072321424,103072321423,-1,2836,4524,-40
103076662822,103076662830,8,4278,688,-40
103076897614,103076897619,5,3173,1440,-40
103076942312,103076942317,5,2442,1307,-40
103077886984,103077886989,5,2362,1236,-40
103078018982,103078018964,-18,1146,454,-40
103079609532,103079609538,6,2801,1218,-40
103082605370,103082605378,8,3506,1381,-40
103091495907,103091495922,15,16600,27608,-40
103093913781,103093913789,8,3564,1280,-40
103099255986,103099255991,5,3480,1349,-40
103102470494,103102470502,8,2924,1325,-40
103103088294,103103088302,8,2636,1375,-40
103105948672,103105948677,5,2984,1408,-40
103106414638,103106414645,7,2237,899,-40
103110293540,103110293546,6,2410,1508,-40
103116738066,103116738072,6,2999,1571,-40
103116988709,103116988714,5,3046,1317,-40
103122309867,103122309862,-5,806,2042,-40
103124060161,103124060166,5,2711,1203,-40
103124346786,103124346793,7,3890,1319,-40
103126432714,103126432719,5,1719,859,-40
103126803730,103126803735,5,2439,1637,-40
103131229353,103131229355,2,3069,2416,-40
103132135155,103132135161,6,2444,1177,-40
103136590432,103136590437,5,2810,1816,-40
103137614139,103137614143,4,2945,1326,-40
103140531926,103140531931,5,2080,1209,-40
103144136866,103144136874,8,2839,1038,-40
103144721840,103144721827,-13,2939,770,-40
103144910245,103144910249,4,2675,1535,-40
103145993430,103145993435,5,2396,994,-40
103147236553,103147236561,8,3973,1544,-40
103148635594,103148635599,5,2021,1313,-40
103152186323,103152186329,6,2173,1856,-40
103153116265,103153116271,6,3436,1350,-40
103153669325,103153669346,21,3661,1424,-40
103154429266,103154429270,4,2872,1314,-40
103158313631,103158313636,5,2406,1115,-40
103159390098,103159390105,7,4103,1800,-40
103159453896,103159453902,6,3287,974,-40
103165833484,103165833492,8,4015,981,-40
103169196189,103169196190,1,1318,1267,-40
103169626587,103169626578,-9,737,320,-40
103171620173,103171620182,9,2531,1138,-40
103173168892,103173168886,-6,932,5010,-40
103173976382,103173976388,6,1453,642,-40
103175630245,103175630256,11,2364,1615,-40
103177478508,103177478490,-18,3119,564,-40
103180775969,103180775975,6,3062,1087,-40
103182710149,103182710155,6,2462,842,-40
103186431675,103186431681,6,4134,1701,-40
103190504109,103190504114,5,1818,1036,-40
103192463918,103192463925,7,3189,808,-40
103192860629,103192860618,-11,1214,370,-40
103193581006,103193581011,5,3280,1582,-40
103196195591,103196195597,6,2597,1307,-40
103199119627,103199119635,8,3153,987,-40
103199607982,103199607987,5,2181,858,-40
103199874330,103199874337,7,3317,1066,-40
103200201791,103200201772,-19,1576,419,-40
103201334573,103201334570,-3,859,1378,-40
103206942354,103206942361,7,2103,1084,-40
103208013188,103208013169,-19,2260,1327,-40
103212013654,103212013662,8,1257,831,-40
103213867133,103213867127,-6,840,2236,-40
103216063901,103216063906,5,2638,844,-40
103216164126,103216164108,-18,1086,513,-40
103219447792,103219447786,-6,1210,4424,-40
103221885112,103221885118,6,3825,1446,-40
103227224791,103227224787,-4,1086,1901,-40
103228566651,103228566635,-16,2202,1675,-40
103230658932,103230658938,6,2667,1071,-40
103232298171,103232298177,6,2654,1064,-40
103232458334,103232458342,8,3149,981,-40
103238593803,103238593809,6,2885,1114,-40
103239857489,103239857485,-4,2670,4926,-40
103243204594,103243204600,6,3167,1315,-40
103243580751,103243580750,-1,690,1420,-40
103244634950,103244634958,8,1771,1231,-40
103249829309,103249829309,0,1260,1720,-40
103251533572,103251533579,7,1911,772,-40
103253651203,103253651210,7,3055,1293,-40
103256983726,103256983747,21,2206,568,-40
103257015245,103257015257,12,1809,1153,-40
103258389534,103258389542,8,2643,1021,-40
103258886710,103258886697,-13,876,344,-40
103260967622,103260967630,8,3646,1370,-40
103262195856,103262195862,6,3125,1122,-40
103266178886,103266178887,1,1030,1423,-40
103267945906,103267945910,4,1808,1274,-40
103268502550,103268502557,7,1867,1057,-40
103269992551,103269992557,6,2528,1605,-40
103270052547,103270052529,-18,681,236,-40
103271730822,103271730831,9,13200,1204,-40
103277287311,103277287314,3,1800,1062,-40
103281133792,103281133798,6,2451,933,-40
103286074266,103286074274,8,2656,1232,-40
103287819234,103287819220,-14,1646,794,-40
103288141717,103288141721,4,2297,1287,-40
103299340098,103299340104,6,2080,937,-40
103299935202,103299935185,-17,3878,1193,-40
103311303780,103311303787,7,3100,1554,-40
103317789829,103317789836,7,2315,1178,-40
103324128714,103324128718,4,2146,1233,-40
103324211361,103324211346,-15,3455,1511,-40
103324689754,103324689762,8,2998,1313,-40
103324723644,103324723626,-18,1835,887,-40
103326722126,103326722131,5,1809,1237,-40
103327234307,103327234309,2,3748,3426,-40
103328370193,103328370198,5,1112,1280,-40
103330432946,103330432952,6,2728,1466,-40
103333337360,103333337356,-4,1146,2854,-40
103336864826,103336864832,6,2357,1176,-40
103338917574,103338917582,8,2664,1375,-40
103343836688,103343836693,5,2315,1051,-40
103345817825,103345817832,7,2482,1348,-40
103347888861,103347888867,6,2564,1277,-40
103361873996,103361874019,23,519,917,-40
103363713406,103363713414,8,3066,1337,-40
103366735884,103366735891,7,2460,1065,-40
103367409062,103367409067,5,2051,1361,-40
103368090270,103368090277,7,2854,977,-40
103368384964,103368384969,5,4146,1948,-40
103372812833,103372812840,7,2395,1250,-40
103373765130,103373765137,7,2581,821,-40
103381442911,103381442918,7,3235,1767,-40
103382964217,103382964223,6,3520,1743,-40
103384063976,103384063982,6,1841,911,-40
103384490159,103384490164,5,2307,1430,-40
103385383327,103385383333,6,1915,1159,-40
103385556377,103385556382,5,2176,733,-40
103386863218,103386863224,6,1546,1237,-40
103387192029,103387192034,5,2794,1544,-40
103387374426,103387374425,-1,1542,1587,-40
103388055590,103388055596,6,1231,930,-40
103388372542,103388372560,18,873,234,-40
103396490285,103396490291,6,1372,957,-40
103404338452,103404338457,5,2404,1457,-40
103408698817,103408698823,6,3748,1387,-40
103409694926,103409694938,12,3653,1666,-40
103410475899,103410475903,4,2430,1216,-40
103414634470,103414634478,8,3278,1426,-40
103416469237,103416469240,3,2034,1658,-40
103417076164,103417076170,6,3261,1466,-40
103422781514,103422781520,6,1918,1272,-40
103424496923,103424496928,5,2259,1303,-40
103426444620,103426444626,6,2685,1093,-40
103427086735,103427086745,10,1158,381,-40
103427919651,103427919657,6,2898,1613,-40
103430782026,103430782006,-20,1577,705,-40
103431306654,103431306654,0,1397,917,-40
103431886430,103431886420,-10,461,232,-40
103433566080,103433566089,9,3331,1550,-40
103435186477,103435186483,6,3440,1245,-40
103435389430,103435389435,5,2934,1496,-40
103437712605,103437712612,7,2781,1063,-40
103442014246,103442014250,4,15559,10530,-40
103446012222,103446012230,8,3089,1238,-40
103446591383,103446591368,-15,2160,272,-40
103446763052,103446763046,-6,2113,7211,-40
103447770318,103447770323,5,2075,816,-40
103455375242,103455375248,6,3222,1446,-40
103459324275,103459324280,5,2301,1058,-40
103460310090,103460310096,6,2730,1364,-40
103462469137,103462469143,6,2768,1616,-40
103463687538,103463687537,-1,1167,2021,-40
103468163629,103468163635,6,1854,856,-40
103474623438,103474623445,7,2295,1000,-40
103479070630,103479070635,5,2503,1059,-40
103479247671,103479247682,11,2055,737,-40
103480869354,103480869363,9,2553,1171,-40
103481746686,103481746691,5,2469,1465,-40
103482296525,103482296507,-18,3639,1404,-40
103482357613,103482357602,-11,1443,456,-40
103485248823,103485248831,8,2591,1702,-40
103485516174,103485516166,-8,1060,4412,-40
103489314145,103489314151,6,3920,1468,-40
103494220308,103494220315,7,2947,1134,-40
103494509799,103494509807,8,2083,1311,-40
103495048673,103495048677,4,2615,1300,-40
103496601835,103496601841,6,2099,1338,-40
103500804404,103500804405,1,1019,1933,-40
103504636846,103504636852,6,3373,1680,-40
103515111813,103515111818,5,1801,632,-40
103517048841,103517048847,6,2762,1352,-40
103517741604,103517741605,1,138,4563,-40
103519262344,103519262351,7,4268,1702,-40
103520845398,103520845397,-1,877,2312,-40
103522328394,103522328399,5,1948,1293,-40
103524042133,103524042138,5,1602,955,-40
103525804877,103525804873,-4,146,2119,-40
103526551146,103526551153,7,2882,1663,-40
103526962526,103526962532,6,3779,1713,-40
103531881614,103531881621,7,2800,934,-40
103532053306,103532053307,1,1452,1107,-40
103533416061,103533416065,4,1560,1458,-40
103533477966,103533477972,6,2914,1231,-40
103536301033,103536301040,7,3449,1680,-40
103536585855,103536585862,7,2390,1396,-40
103537881237,103537881242,5,4073,2021,-40
103539716229,103539716235,6,3004,1457,-40
103542147320,103542147326,6,2771,1480,-40
103547196825,103547196832,7,2269,1357,-40
103555058827,103555058833,6,2331,1073,-40
103558032616,103558032622,6,2933,1428,-40
103558588306,103558588291,-15,1235,930,-40
103563805250,103563805257,7,2839,1137,-40
103573955409,103573955417,8,2530,1284,-40
103575758758,103575758766,8,4811,1923,-40
103587271603,103587271610,7,832,901,-40
103588003222,103588003202,-20,3257,1101,-40
103588605596,103588605599,3,2783,1136,-40
103593142526,103593142531,5,2008,978,-40
103593942249,103593942257,8,2077,1234,-40
103594391355,103594391363,8,2566,1155,-40
103596062611,103596062618,7,1393,536,-40
103596636136,103596636142,6,4214,1672,-40
103598231843,103598231850,7,1608,979,-40
103600312453,103600312461,8,3372,1607,-40
103600879681,103600879687,6,3033,926,-40
103601274829,103601274834,5,2801,1347,-40
103601399433,103601399419,-14,2900,1047,-40
103601810785,103601810790,5,3591,1721,-40
103603949070,103603949078,8,3581,1541,-40
103605858306,103605858311,5,1766,1158,-40
103606182922,103606182906,-16,2826,1289,-40
103606814447,103606814442,-5,612,2629,-40
103615001550,103615001556,6,3044,1305,-40
103621481570,103621481574,4,5205,1755,-40
103622012359,103622012366,7,3633,1476,-40
103622489485,103622489506,21,2699,1207,-40
103623356842,103623356849,7,3957,1641,-40
103629033443,103629033450,7,2483,883,-40
103629111480,103629111486,6,3246,1473,-40
103629282134,103629282147,13,994,61,-40
103637410410,103637410415,5,2356,1305,-40
103638206489,103638206497,8,4074,1089,-40
103639212426,103639212433,7,1980,1423,-40
103643425642,103643425646,4,1372,1051,-40
103644536334,103644536331,-3,1114,3198,-40
103646204442,103646204447,5,2601,1298,-40
103646266112,103646266119,7,3366,951,-40
103649863987,103649863991,4,2090,1441,-40
103651944056,103651944062,6,3346,1342,-40
103656161717,103656161724,7,2239,1240,-40
103658102075,103658102081,6,3416,1483,-40
103663423961,103663423967,6,2179,1192,-40
103665865397,103665865403,6,3679,1644,-40
103674318718,103674318723,5,2598,1072,-40
103674811420,103674811426,6,2976,1214,-40
103679576625,103679576630,5,2689,808,-40
103679805222,103679805227,5,2469,1142,-40
103688999418,103688999423,5,2310,1126,-40
103693019601,103693019606,5,2527,1282,-40
103703290901,103703290907,6,1664,966,-40
103708139299,103708139305,6,3253,1484,-40
103712542861,103712542868,7,2229,1081,-40
103712766492,103712766475,-17,2975,1099,-40
103715322135,103715322143,8,2624,1225,-40
103716386608,103716386613,5,2692,1393,-40
103717683685,103717683691,6,2220,706,-40
103720277656,103720277658,2,1610,1423,-40
103728875269,103728875275,6,3701,1463,-40
103729287664,103729287670,6,3463,2070,-40
103730284025,103730284032,7,2041,1071,-40
103731171759,103731171770,11,544,111,-40
103736244718,103736244725,7,3134,1095,-40
103738373530,103738373534,4,1702,1286,-40
103739328527,103739328534,7,3912,1355,-40
103739654002,103739654009,7,3640,1120,-40
103743023855,103743023861,6,2816,1321,-40
103743275723,103743275737,14,3311,1468,-40
103745808926,103745808929,3,2009,1699,-40
103752826302,103752826309,7,4464,1657,-40
103753344789,103753344781,-8,1134,9159,-40
103757712943,103757712951,8,2272,1010,-40
103759018770,103759018778,8,2975,977,-40
103760438636,103760438642,6,3291,1366,-40
103766532471,103766532465,-6,769,1190,-40
103767954945,103767954951,6,3179,1453,-40
103771628790,103771628796,6,3911,1117,-40
103772003236,103772003218,-18,1134,522,-40
103774835410,103774835417,7,3225,1283,-40
103776051486,103776051491,5,775,967,-40
103777366662,103777366666,4,2721,855,-40
103779820721,103779820726,5,1557,1581,-40
103779949047,103779949049,2,566,38,-40
103791367399,103791367404,5,2747,1493,-40
103795517338,103795517342,4,2139,979,-40
103796654978,103796654984,6,2986,1263,-40
103796736462,103796736470,8,3339,1467,-40
103799843279,103799843286,7,3012,1022,-40
103800705295,103800705302,7,2203,1035,-40
103804070451,103804070453,2,1769,2035,-40
103806352161,103806352166,5,2279,758,-40
103808866004,103808866010,6,3772,1310,-40
103817456850,103817456855,5,3936,1417,-40
103818200321,103818200324,3,5592,4020,-40
103818351199,103818351204,5,3105,1216,-40
103820147853,103820147834,-19,1000,502,-40
103824300090,103824300096,6,2946,1040,-40
103825146471,103825146472,1,1454,1251,-40
103826809414,103826809421,7,1959,1100,-40
103826854146,103826854129,-17,3421,1115,-40
103828067722,103828067731,9,1296,699,-40
103829606628,103829606634,6,2753,902,-40
103832422887,103832422894,7,3761,1399,-40
103834629690,103834629691,1,2247,2944,-40
103835054457,103835054463,6,3273,1263,-40
103837317462,103837317457,-5,1254,2745,-40
103843626986,103843626992,6,2660,1189,-40
103846086745,103846086750,5,3851,1339,-40
103847801233,103847801238,5,3025,1367,-40
103849333661,103849333666,5,2322,884,-40
103854005590,103854005597,7,1440,747,-40
103854047714,103854047714,0,765,86,-40
103857504472,103857504480,8,2976,1289,-40
103859624648,103859624656,8,3574,1621,-40
103862240505,103862240511,6,4046,1386,-40
103865877149,103865877156,7,1715,784,-40
103866984966,103866984973,7,3078,1326,-40
103873275263,103873275267,4,2946,1463,-40
103874044451,103874044457,6,3165,1323,-40
103877030010,103877030017,7,3127,1128,-40
103877261657,103877261642,-15,932,441,-40
103881195498,103881195497,-1,1220,1919,-40
103883865511,103883865513,2,1052,1141,-40
103884470278,103884470290,12,2423,925,-40
103884981147,103884981132,-15,1279,241,-40
103887498549,103887498554,5,2172,912,-40
103894367502,103894367508,6,898,921,-40
103896004396,103896004401,5,3035,1394,-40
103898533438,103898533445,7,2184,1424,-40
103899188954,103899188959,5,3307,1536,-40
103902351657,103902351665,8,1498,1172,-40
103906504739,103906504745,6,2251,928,-40
103908392333,103908392338,5,2285,1178,-40
103909280863,103909280843,-20,1823,751,-40
103913196597,103913196602,5,2865,1587,-40
103914419321,103914419325,4,2091,1101,-40
103914804029,103914804031,2,1570,673,-40
103916422586,103916422594,8,2359,1050,-40
103919602903,103919602897,-6,904,4807,-40
103920682694,103920682698,4,2886,1711,-40
103923102066,103923102074,8,2703,1614,-40
103923927778,103923927784,6,2303,1358,-40
103923974763,103923974770,7,1783,980,-40
103925078784,103925078790,6,3268,1254,-40
103925485113,103925485118,5,2440,972,-40
103927480005,103927480013,8,3411,1291,-40
103929501038,103929501045,7,2769,882,-40
103930462160,103930462161,1,1701,1524,-40
103934025238,103934025242,4,2940,1284,-40
103937872951,103937872957,6,3714,1930,-40
103939753860,103939753862,2,2002,1598,-40
103945619173,103945619179,6,2029,1136,-40
103948052803,103948052816,13,384,1968,-40
103948700619,103948700633,14,14234,43528,-40
103951196307,103951196313,6,3315,1409,-40
103954320200,103954320184,-16,3717,1152,-40
103954928898,103954928899,1,2129,1315,-40
103956798631,103956798635,4,2357,828,-40
103959158158,103959158161,3,2270,35496,-40
103962353934,103962353941,7,3036,1606,-40
103962561849,103962561854,5,3548,1252,-40
103963176906,103963176913,7,2853,1155,-40
103963385418,103963385422,4,2218,1539,-40
103965673184,103965673189,5,2467,988,-40
103966386470,103966386490,20,2994,1404,-40
103967474117,103967474122,5,2481,1136,-40
103968428475,103968428482,7,4165,1360,-40
103971827389,103971827394,5,2523,1210,-40
103980415165,103980415170,5,2926,1510,-40
103982839516,103982839522,6,2346,1467,-40
103983820270,103983820276,6,1972,1091,-40
103983896557,103983896568,11,2608,988,-40
103984550267,103984550273,6,3716,1442,-40
103990494122,103990494126,4,3060,1425,-40
103993940746,103993940753,7,2686,1523,-40
103996251250,103996251258,8,2072,769,-40
103996436000,103996436006,6,2884,1353,-40
103996466545,103996466547,2,1430,1715,-40
103998240277,103998240282,5,1450,1132,-40
104002213658,104002213666,8,4052,1131,-40
104004026420,104004026426,6,2713,1743,-40
104012120388,104012120394,6,2882,1291,-40
104012269267,104012269273,6,2834,1079,-40
104014574434,104014574440,6,3814,1961,-40
104020283529,104020283535,6,2955,1313,-40
104022765456,104022765462,6,2512,1261,-40
104023003094,104023003084,-10,1518,860,-40
104032363254,104032363262,8,2244,1271,-40
104033577293,104033577295,2,1646,1813,-40
104035840951,104035840957,6,2425,745,-40
104036285797,104036285804,7,2497,1053,-40
104036402001,104036401985,-16,2287,1035,-40
104039513943,104039513949,6,3224,1161,-40
104040683826,104040683832,6,3289,1267,-40
104045348213,104045348219,6,3219,1337,-40
104047728175,104047728181,6,2741,1063,-40
104049766573,104049766580,7,3481,1250,-40
104050047697,104050047698,1,18922,3421,-40
104053832697,104053832711,14,23589,57651,-40
104055223665,104055223666,1,1888,1819,-40
104055872495,104055872494,-1,820,2079,-40
104058659250,104058659254,4,2533,1276,-40
104062882068,104062882068,0,22245,9883,-40
104065572421,104065572428,7,2989,906,-40
104065764783,104065764790,7,2926,903,-40
104070758834,104070758831,-3,530,1021,-40
104077222502,104077222506,4,1937,999,-40
104083269686,104083269692,6,4218,1603,-40
104084861392,104084861398,6,3145,1999,-40
104090182033,104090182039,6,3011,1625,-40
104091298593,104091298599,6,2324,1112,-40
104093714671,104093714678,7,2701,952,-40
104094937709,104094937709,0,2152,3752,-40
104099846314,104099846319,5,3551,1531,-40
104100819450,104100819459,9,2244,1022,-40
104101218065,104101218072,7,3771,985,-40
104101309217,104101309200,-17,1395,608,-40
104106206937,104106206943,6,2106,1211,-40
104106997633,104106997638,5,2672,1185,-40
104109872405,104109872411,6,2932,1427,-40
104110609642,104110609635,-7,1322,5219,-40
104111053141,104111053148,7,2246,1289,-40
104111241675,104111241668,-7,1201,377,-40
104114465370,104114465378,8,3058,1353,-40
104116740088,104116740090,2,2410,1777,-40
104123377870,104123377869,-1,1284,1667,-40
104126634033,104126634038,5,2278,1376,-40
104134873750,104134873755,5,2991,1208,-40
104135793154,104135793162,8,3961,1526,-40
104135949524,104135949531,7,3528,1264,-40
104139485821,104139485821,0,2246,3130,-40
104140424830,104140424834,4,1862,800,-40
104142714125,104142714131,6,2011,1026,-40
104152316325,104152316327,2,1337,1553,-40
104154708150,104154708156,6,2365,1253,-40
104158327188,104158327186,-2,521,472,-40
104161055361,104161055366,5,2574,1442,-40
104165033769,104165033774,5,1964,816,-40
104165330980,104165330960,-20,1691,829,-40
104165712141,104165712121,-20,3691,1835,-40
104165994583,104165994589,6,3593,1364,-40
104166855715,104166855719,4,1960,1262,-40
104167630797,104167630802,5,2958,1427,-40
104168541879,104168541886,7,3039,1286,-40
104171935614,104171935629,15,384,1276,-40
104172801918,104172801904,-14,2723,1145,-40
104173013226,104173013230,4,3359,965,-40
104173403294,104173403301,7,4003,1411,-40
104174228589,104174228594,5,2210,1181,-40
104174779225,104174779233,8,1923,955,-40
104179454468,104179454474,6,3150,1510,-40
104180177178,104180177185,7,3277,1411,-40
104185421838,104185421846,8,2366,823,-40
104187910477,104187910483,6,3115,1024,-40
104188764570,104188764576,6,1128,721,-40
104189484392,104189484387,-5,1168,389,-40
104190116022,104190116029,7,3633,1131,-40
104191449985,104191449970,-15,1175,126,-40
104192349705,104192349720,15,3090,1349,-40
104195843726,104195843733,7,2815,1017,-40
104196423173,104196423178,5,2982,1358,-40
104197432094,104197432101,7,3797,1231,-40
104198213574,104198213582,8,3041,1069,-40
104198937130,104198937139,9,2643,1510,-40
104199937316,104199937323,7,2976,1056,-40
104200861363,104200861369,6,2822,1609,-40
104202935478,104202935485,7,4511,1139,-40
104204319370,104204319376,6,1938,1367,-40
104207949719,104207949725,6,2968,1083,-40
104208279140,104208279146,6,2247,1074,-40
104208510106,104208510113,7,3965,1558,-40
104210066122,104210066130,8,2390,1079,-40
104211959769,104211959775,6,2283,1164,-40
104214430745,104214430738,-7,874,3867,-40
104220065304,104220065310,6,3159,1330,-40
104225098143,104225098149,6,2936,1462,-40
104231584893,104231584900,7,2443,1343,-40
104245503475,104245503482,7,3076,1229,-40
104246299270,104246299249,-21,2709,1212,-40
104248194278,104248194286,8,3517,1061,-40
104248492865,104248492870,5,2869,1216,-40
104249218517,104249218523,6,932,179,-40
104251598715,104251598722,7,2595,1300,-40
104251762469,104251762467,-2,1458,2030,-40
104253861646,104253861653,7,6714,2014,-40
104255856842,104255856849,7,3133,1173,-40
104257594641,104257594645,4,2999,1694,-40
104260068226,104260068232,6,2615,1396,-40
104261166439,104261166446,7,3044,1256,-40
104261788565,104261788570,5,2586,1101,-40
104262839641,104262839648,7,2066,1243,-40
104264694910,104264694917,7,3595,1200,-40
104266211197,104266211203,6,2691,1324,-40
104267065572,104267065578,6,3085,1221,-40
104267190261,104267190259,-2,1147,316,-40
104268607444,104268607451,7,3226,1092,-40
104271308620,104271308626,6,3275,1271,-40
104271422566,104271422553,-13,1113,279,-40
104274722004,104274722009,5,2918,1630,-40
104276146642,104276146646,4,3391,1350,-40
104276843246,104276843252,6,2373,1108,-40
104284211930,104284211934,4,1535,813,-40
104286569474,104286569481,7,2721,1527,-40
104290531966,104290531970,4,3394,1321,-40
104298233453,104298233457,4,2263,1282,-40
104306309493,104306309501,8,3274,1271,-40
104306526075,104306526083,8,4901,1591,-40
104311355001,104311354993,-8,726,2117,-40
104313475190,104313475198,8,2929,1269,-40
104314577633,104314577638,5,2495,959,-40
104319733610,104319733617,7,2807,986,-40
104320044410,104320044394,-16,937,372,-40
104320582718,104320582724,6,3090,857,-40
104320968876,104320968859,-17,1658,475,-40
104324185386,104324185392,6,1589,1903,-40
104330555631,104330555637,6,1885,1016,-40
104333378642,104333378642,0,1640,1443,-40
104334577986,104334577993,7,2590,1352,-40
104336435009,104336434994,-15,1077,1704,-40
104337811374,104337811381,7,3686,1378,-40
104339743682,104339743688,6,1268,690,-40
104340077229,104340077234,5,3011,1716,-40
104340188341,104340188346,5,2262,1457,-40
104340593887,104340593892,5,4619,2077,-40
104350327394,104350327399,5,2746,1180,-40
104351610061,104351610066,5,2658,1012,-40
104355467398,104355467402,4,2325,1116,-40
104360880055,104360880055,0,814,1024,-40
104361437709,104361437715,6,2616,1694,-40
104361514574,104361514582,8,3521,1331,-40
104362579363,104362579369,6,2256,992,-40
104362684355,104362684369,14,673,139,-40
104363087084,104363087078,-6,910,3107,-40
104363470722,104363470725,3,1082,879,-40
104367072387,104367072381,-6,1781,7863,-40
104368079458,104368079466,8,2361,989,-40
104369983712,104369983710,-2,1618,2799,-40
104372497171,104372497178,7,2692,1345,-40
104380176869,104380176875,6,5088,1960,-40
104381284241,104381284248,7,3045,1036,-40
104381746707,104381746712,5,2305,1772,-40
104382078066,104382078070,4,2710,1085,-40
104392595569,104392595574,5,2591,986,-40
104397023685,104397023691,6,3414,1674,-40
104400224749,104400224755,6,2051,1047,-40
104400368475,104400368490,15,664,129,-40
104404984449,104404984453,4,84,932,-40
104410483397,104410483402,5,2569,1357,-40
104411778227,104411778234,7,3699,1390,-40
104415302969,104415302978,9,2155,1053,-40
104415839895,104415839883,-12,937,346,-40
104416177757,104416177737,-20,3237,1564,-40
104417815468,104417815475,7,1979,926,-40
104418020495,104418020504,9,937,366,-40
104419490854,104419490858,4,3025,1281,-40
104423533879,104423533881,2,1154,1564,-40
104429035251,104429035249,-2,1130,1929,-40
104429353530,104429353536,6,2237,1303,-40
104430442285,104430442297,12,2110,1255,-40
104438541294,104438541300,6,2732,1752,-40
104438683067,104438683075,8,2122,627,-40
104439220309,104439220314,5,2076,1240,-40
104441132681,104441132685,4,2000,1714,-40
104443393042,104443393049,7,7777,2491,-40
104447475105,104447475111,6,3788,1583,-40
104450268589,104450268594,5,2157,805,-40
104452199092,104452199090,-2,1339,1498,-40
104454306025,104454306031,6,2885,1836,-40
104456847519,104456847525,6,2366,1347,-40
104458855958,104458855963,5,2197,865,-40
104460082271,104460082278,7,2729,1390,-40
104462806547,104462806554,7,2944,1285,-40
104463532349,104463532336,-13,726,303,-40
104464334364,104464334371,7,3197,1201,-40
104465291713,104465291718,5,3607,1699,-40
104477406188,104477406194,6,3576,1179,-40
104477662839,104477662824,-15,1358,192,-40
104482234402,104482234408,6,2464,1366,-40
104483815645,104483815651,6,3398,1680,-40
104484104017,104484104022,5,1456,897,-40
104490625662,104490625669,7,2341,1640,-40
104498063234,104498063240,6,3243,1661,-40
104499929718,104499929722,4,2170,1166,-40
104500160181,104500160188,7,2746,949,-40
104502958127,104502958127,0,1829,2834,-40
104503307218,104503307227,9,3726,1524,-40
104508528577,104508528583,6,2131,899,-40
104509593251,104509593256,5,2477,1579,-40
104512323752,104512323759,7,3150,1419,-40
104512537381,104512537386,5,1956,793,-40
104519881661,104519881669,8,2457,1050,-40
104520504829,104520504831,2,2662,2111,-40
104520733686,104520733692,6,2694,1504,-40
104523884842,104523884847,5,3221,1297,-40
104526041245,104526041249,4,1761,1185,-40
104527502788,104527502794,6,3113,1419,-40
104528532572,104528532578,6,1817,807,-40
104531120545,104531120550,5,2303,829,-40
104532936431,104532936422,-9,1289,5523,-40
104535759890,104535759896,6,3148,1177,-40
104540225399,104540225406,7,1899,1133,-40
104544728452,104544728459,7,3557,2021,-40
104546788826,104546788831,5,2367,1152,-40
104549726752,104549726755,3,2666,982,-40
104552260793,104552260801,8,2968,1574,-40
104553649585,104553649591,6,2492,877,-40
104554356087,104554356094,7,1259,700,-40
104554444546,104554444528,-18,2426,1436,-40
104554817466,104554817482,16,706,351,-40
104555255516,104555255519,3,1427,850,-40
104561507397,104561507402,5,2080,1170,-40
104564505133,104564505139,6,2967,1393,-40
104564860774,104564860781,7,2780,1233,-40
104565818821,104565818829,8,2404,980,-40
104566119459,104566119465,6,2658,1136,-40
104567849062,104567849069,7,2257,932,-40
104572001951,104572001958,7,2435,871,-40
104575306145,104575306150,5,2777,1360,-40
104578541832,104578541837,5,2320,1279,-40
104583069714,104583069719,5,2698,779,-40
104587484774,104587484781,7,2002,1535,-40
104588026690,104588026682,-8,1409,35887,-40
104593334025,104593334028,3,23407,50565,-40
104596972188,104596972194,6,2812,1323,-40
104600405378,104600405385,7,3258,1387,-40
104601274057,104601274066,9,2992,812,-40
104604370078,104604370083,5,2685,1317,-40
104604554006,104604553992,-14,931,241,-40
104605145482,104605145490,8,2549,1298,-40
104605429210,104605429193,-17,2015,546,-40
104605569746,104605569751,5,3295,1297,-40
104608324251,104608324260,9,2750,1332,-40
104609025775,104609025752,-23,1040,234,-40
104609541651,104609541649,-2,1237,1605,-40
104610804205,104610804210,5,1924,1067,-40
104611106276,104611106299,23,2543,1389,-40
104614071073,104614071065,-8,821,4873,-40
104615820496,104615820503,7,2979,1085,-40
104617755961,104617755965,4,2658,1553,-40
104617870531,104617870537,6,3204,1354,-40
104625097574,104625097579,5,4296,1327,-40
104628881644,104628881653,9,2133,1329,-40
104634015450,104634015454,4,1974,1471,-40
104645105589,104645105595,6,2199,912,-40
104645527393,104645527400,7,3266,1445,-40
104645750134,104645750137,3,4900,2848,-40
104650356334,104650356340,6,2397,1295,-40
104650654290,104650654297,7,1136,245,-40
104652298475,104652298481,6,2371,1386,-40
104652958174,104652958181,7,3010,1456,-40
104654657501,104654657505,4,2681,1066,-40
104654827115,104654827121,6,2783,674,-40
104656288206,104656288212,6,2288,1363,-40
104659186386,104659186391,5,1916,1568,-40
104660306666,104660306673,7,3341,1109,-40
104660643851,104660643849,-2,1221,243,-40
104661501055,104661501064,9,10579,49339,-40
104663853493,104663853501,8,4283,1368,-40
104671839441,104671839435,-6,1466,7622,-40
104684250930,104684250937,7,2866,1601,-40
104693923046,104693923053,7,2332,1416,-40
104696161624,104696161630,6,2771,1042,-40
104697586956,104697586963,7,2415,1136,-40
104702223834,104702223843,9,2754,1402,-40
104702709273,104702709278,5,1757,920,-40
104713992644,104713992650,6,2612,1264,-40
104717333286,104717333280,-6,1039,4164,-40
104719424910,104719424915,5,2040,698,-40
104720645960,104720645968,8,45,2170,-40
104722888924,104722888929,5,1224,476,-40
104725245631,104725245638,7,2994,1236,-40
104731228841,104731228846,5,2563,1313,-40
104736488917,104736488922,5,1703,860,-40
104736737832,104736737833,1,1392,1558,-40
104738217249,104738217257,8,3186,1747,-40
104741655669,104741655675,6,2779,1400,-40
104753628866,104753628862,-4,2410,6099,-40
104754697427,104754697433,6,2862,1393,-40
104755395606,104755395614,8,3616,1255,-40
104755756518,104755756525,7,4088,1652,-40
104756208634,104756208641,7,2692,1051,-40
104757139141,104757139146,5,2740,1452,-40
104759461502,104759461509,7,2731,1027,-40
104761919885,104761919890,5,1832,998,-40
104764303286,104764303293,7,62841,25364,-40
104767257167,104767257174,7,1290,790,-40
104772868213,104772868221,8,2854,1235,-40
104776325721,104776325727,6,2372,1154,-40
104778848989,104778848993,4,3300,1213,-40
104779046059,104779046065,6,3417,1657,-40
104784458333,104784458338,5,2409,1004,-40
104794354136,104794354142,6,1400,919,-40
104795960815,104795960821,6,3752,1323,-40
104796733748,104796733754,6,1965,1059,-40
104804584639,104804584644,5,2678,1073,-40
104806523589,104806523593,4,949,492,-40
104809859923,104809859931,8,1597,887,-40
104809892464,104809892451,-13,3462,1396,-40
104813349845,104813349847,2,1629,1190,-40
104813496936,104813496938,2,460,204,-40
104816344860,104816344867,7,1955,904,-40
104816667566,104816667548,-18,1842,561,-40
104820127354,104820127359,5,1903,1061,-40
104823466179,104823466185,6,4021,1609,-40
104825807401,104825807407,6,2322,1046,-40
104826298650,104826298657,7,2538,860,-40
104828162146,104828162152,6,2559,1573,-40
104833278771,104833278777,6,3462,1404,-40
104837318221,104837318227,6,3676,1203,-40
104838198809,104838198815,6,1487,1329,-40
104842825654,104842825654,0,1050,1109,-40
104844308853,104844308859,6,3442,1341,-40
104846562988,104846562996,8,2787,1257,-40
104848215891,104848215894,3,1938,1009,-40
104850074230,104850074236,6,9863,28946,-40
104850215723,104850215719,-4,1064,3253,-40
104851726813,104851726828,15,2500,1253,-40
104851946273,104851946260,-13,1271,288,-40
104852898365,104852898371,6,2077,1315,-40
104855899549,104855899557,8,2748,1403,-40
104859482057,104859482060,3,1983,1576,-40
104862733611,104862733618,7,3821,1356,-40
104865694728,104865694735,7,2729,1083,-40
104866167839,104866167845,6,4221,1510,-40
104868197079,104868197090,11,3268,976,-40
104868786860,104868786844,-16,2536,1196,-40
104869272701,104869272707,6,2126,1431,-40
104871263938,104871263931,-7,1047,3362,-40
104871969127,104871969133,6,2206,858,-40
104874955613,104874955618,5,3398,1259,-40
104879075015,104879075022,7,3307,1494,-40
104881600201,104881600208,7,2896,1057,-40
104884138431,104884138439,8,2856,1189,-40
104884790471,104884790477,6,1469,1034,-40
104885354996,104885355002,6,2710,1289,-40
104889047097,104889047102,5,1309,1399,-40
104896590428,104896590435,7,2466,1264,-40
104899581794,104899581799,5,3275,1299,-40
104912453761,104912453766,5,2800,1608,-40
104912814171,104912814177,6,2959,1242,-40
104916460147,104916460154,7,2854,1242,-40
104927181102,104927181108,6,3738,1446,-40
104931137006,104931137012,6,2238,1504,-40
104934083510,104934083515,5,2018,1029,-40
104938601223,104938601231,8,4381,1191,-40
104942690453,104942690459,6,3767,1168,-40
104946758423,104946758431,8,2735,1228,-40
104947578937,104947578942,5,294,11295,-40
104948487705,104948487710,5,3668,1493,-40
104949516084,104949516090,6,1732,1024,-40
104951487405,104951487411,6,3020,981,-40
104955957999,104955958006,7,3421,1693,-40
104961944749,104961944755,6,2576,1031,-40
104962410470,104962410477,7,2847,1276,-40
104962594613,104962594627,14,3396,894,-40
104966229029,104966229035,6,3858,1239,-40
104967685250,104967685258,8,1529,926,-40
104972106849,104972106855,6,2902,1395,-40
104972252079,104972252087,8,3106,1515,-40
104976378770,104976378777,7,3664,1273,-40
104977866204,104977866210,6,3547,1314,-40
104981060777,104981060783,6,3784,1149,-40
104984263342,104984263345,3,2733,1307,-40
104984475991,104984475994,3,2498,1022,-40
104989128985,104989128991,6,5665,2758,-40
104990258471,104990258477,6,2657,910,-40
104994039195,104994039201,6,2176,852,-40
104994092335,104994092312,-23,1290,354,-40
104994589249,104994589257,8,2915,1198,-40
104996154093,104996154100,7,2546,741,-40
104999491806,104999491811,5,3019,1489,-40
105002483127,105002483130,3,3191,1136,-40
105005420376,105005420370,-6,956,3781,-40
105011188130,105011188136,6,2881,1485,-40
105013847480,105013847486,6,2612,1469,-40
105015923654,105015923659,5,2109,1859,-40
105016471156,105016471162,6,2653,1405,-40
105016521197,105016521203,6,2927,1193,-40
105016584027,105016584010,-17,809,247,-40
105018035817,105018035824,7,3119,1084,-40
105020364841,105020364845,4,3300,1473,-40
105022410031,105022410038,7,2866,1112,-40
105023343677,105023343683,6,2826,1164,-40
105023740437,105023740455,18,918,230,-40
105028313513,105028313518,5,2068,1138,-40
105028930820,105028930826,6,2451,1238,-40
105029165794,105029165809,15,2909,1579,-40
105029630286,105029630298,12,20225,26180,-40
105030383670,105030383679,9,2404,1452,-40
105035786979,105035786981,2,2305,2187,-40
105038405998,105038406004,6,1576,1763,-40
105039484738,105039484743,5,3164,966,-40
105045926500,105045926506,6,2784,1186,-40
105052099175,105052099181,6,3907,1448,-40
105052821334,105052821313,-21,864,341,-40
105053688445,105053688455,10,5257,1124,-40
105054238212,105054238219,7,2655,1110,-40
105056178910,105056178917,7,2873,988,-40
105057839226,105057839210,-16,1050,545,-40
105073159345,105073159350,5,3220,1287,-40
105076176501,105076176502,1,1655,1815,-40
105082833235,105082833242,7,3578,885,-40
105083076161,105083076144,-17,3247,823,-40
105085495407,105085495411,4,2623,1248,-40
105086830846,105086830851,5,3272,1548,-40
105092765985,105092765986,1,708,1123,-40
105100168535,105100168541,6,2383,1151,-40
105100776964,105100776963,-1,925,151,-40
105101686879,105101686896,17,400,1656,-40
105104083105,105104083112,7,2825,1149,-40
105105822226,105105822234,8,2623,1058,-40
105109833410,105109833416,6,2986,1470,-40
105117783870,105117783876,6,2546,1064,-40
105118736362,105118736370,8,2890,1401,-40
105119394617,105119394621,4,1892,1479,-40
105120632658,105120632666,8,2290,1200,-40
105121243978,105121243985,7,3890,1060,-40
105125394011,105125394018,7,1902,1312,-40
105127491199,105127491206,7,2976,938,-40
105131899346,105131899350,4,962,856,-40
105134562665,105134562669,4,2901,1216,-40
105137059702,105137059707,5,2617,1165,-40
105137325415,105137325417,2,2509,2593,-40
105137853792,105137853794,2,1748,1241,-40
105139313335,105139313343,8,2197,1002,-40
105149344117,105149344122,5,3952,1389,-40
105152016992,105152016997,5,2375,1144,-40
105155284463,105155284470,7,2793,1422,-40
105158801342,105158801349,7,3826,1084,-40
105158872464,105158872469,5,3126,1729,-40
105161450725,105161450731,6,1643,967,-40
105161981674,105161981682,8,3033,1132,-40
105166426989,105166426995,6,3170,1318,-40
105170226511,105170226515,4,3313,1190,-40
105177065733,105177065738,5,3835,1673,-40
105177644335,105177644341,6,2756,1031,-40
105177687372,105177687377,5,2574,1314,-40
105189259370,105189259378,8,2825,1338,-40
105198408713,105198408722,9,3134,1505,-40
105200499226,105200499234,8,3091,985,-40
105201516321,105201516326,5,2267,1249,-40
105204007799,105204007807,8,2704,994,-40
105207455129,105207455136,7,2801,1013,-40
105212207957,105212207962,5,3827,1094,-40
105223804769,105223804774,5,2217,970,-40
105224475676,105224475695,19,390,1410,-40
105225841196,105225841203,7,1602,785,-40
105226079698,105226079690,-8,843,344,-40
105228863548,105228863554,6,2096,970,-40
105229265739,105229265721,-18,1386,634,-40
105231336400,105231336397,-3,46597,2997,-40
105233062285,105233062291,6,1530,781,-40
105235976890,105235976895,5,1880,878,-40
105243286897,105243286901,4,3172,1615,-40
105247289218,105247289225,7,3217,1605,-40
105249473344,105249473351,7,2686,1409,-40
105249873757,105249873738,-19,655,405,-40
105251163310,105251163306,-4,1079,4298,-40
105253310637,105253310643,6,2999,1303,-40
105253979661,105253979666,5,2854,960,-40
105255228442,105255228449,7,3294,1372,-40
105257125426,105257125432,6,2889,1314,-40
105258340747,105258340753,6,2523,1465,-40
105261139854,105261139862,8,6812,2116,-40
105267766049,105267766057,8,3421,1141,-40
105272175565,105272175571,6,2372,1221,-40
105274939856,105274939841,-15,974,776,-40
105277626228,105277626234,6,3350,1532,-40
105280342162,105280342167,5,3831,1612,-40
105291652803,105291652810,7,2485,1374,-40
105293128055,105293128060,5,2775,1149,-40
105294316393,105294316399,6,2537,1518,-40
105295957269,105295957249,-20,3037,1001,-40
105296376006,105296376011,5,3077,1323,-40
105296711110,105296711111,1,679,1703,-40
105306265535,105306265538,3,995,759,-40
105309151843,105309151850,7,3115,1248,-40
105310363771,105310363775,4,1826,888,-40
105310560022,105310560029,7,2359,1337,-40
105310828879,105310828899,20,1891,1108,-40
105311060686,105311060664,-22,1908,793,-40
105312248488,105312248494,6,2441,1222,-40
105317382057,105317382062,5,1710,974,-40
105317540439,105317540435,-4,707,247,-40
105320151127,105320151134,7,1981,1002,-40
105321809550,105321809558,8,2006,1073,-40
105324807689,105324807694,5,3036,1695,-40
105326406186,105326406190,4,2980,1731,-40
105329967700,105329967703,3,2051,1170,-40
105333664174,105333664180,6,2962,1551,-40
105334245954,105334245959,5,887,552,-40
105334718822,105334718821,-1,1632,2224,-40
105341613945,105341613951,6,2332,1056,-40
105342267263,105342267271,8,3123,1068,-40
105343146645,105343146650,5,2903,1953,-40
105349024058,105349024065,7,3042,1147,-40
105349667701,105349667697,-4,1898,5134,-40
105355300331,105355300331,0,5444,7568,-40
105359517949,105359517955,6,1974,1760,-40
105359837543,105359837541,-2,1075,2202,-40
105363919702,105363919711,9,2803,885,-40
105364295966,105364295954,-12,1828,761,-40
105365774309,105365774316,7,1157,882,-40
105366417069,105366417073,4,2618,1478,-40
105369474489,105369474495,6,2487,1111,-40
105371670202,105371670207,5,3225,1743,-40
105373368602,105373368607,5,2338,1165,-40
105381655218,105381655225,7,3029,1471,-40
105383559689,105383559694,5,3750,1308,-40
105385607102,105385607107,5,2211,1199,-40
105387833405,105387833409,4,2167,1208,-40
105389720470,105389720476,6,2327,1352,-40
105389749543,105389749539,-4,1093,229,-40
105389844908,105389844888,-20,1024,230,-40
105390755749,105390755755,6,3268,1056,-40
105395155193,105395155199,6,1931,982,-40
105397278678,105397278687,9,2149,962,-40
105402901590,105402901591,1,1646,1421,-40
105406131282,105406131289,7,3448,1693,-40
105408074110,105408074114,4,3247,1704,-40
105408388859,105408388873,14,753,334,-40
105409094251,105409094256,5,2181,856,-40
105409806985,105409806991,6,2560,1116,-40
105412605683,105412605688,5,2554,1390,-40
105413989802,105413989810,8,2518,1267,-40
105417122309,105417122315,6,3432,1674,-40
105423619468,105423619473,5,2486,977,-40
105427410574,105427410578,4,5483,3053,-40
105432374959,105432374966,7,997,546,-40
105439285515,105439285522,7,2631,1050,-40
105441206156,105441206157,1,1329,1552,-40
105444709352,105444709357,5,2652,1342,-40
105447003378,105447003379,1,1203,1338,-40
105447453612,105447453606,-6,1418,2651,-40
105449815539,105449815543,4,2952,1101,-40
105449868090,105449868073,-17,727,195,-40
105453343701,105453343707,6,2335,1350,-40
105453957760,105453957754,-6,1821,5807,-40
105455909540,105455909547,7,2899,1471,-40
105464798362,105464798368,6,3157,1449,-40
105466486841,105466486846,5,3167,1139,-40
105467448444,105467448451,7,2941,1426,-40
105468433283,105468433289,6,2096,1658,-40
105469054908,105469054903,-5,1233,3285,-40
105473830772,105473830778,6,6023,2673,-40
105474658210,105474658217,7,3167,1413,-40
105474971724,105474971730,6,1708,834,-40
105477177213,105477177222,9,3038,1216,-40
105479594377,105479594382,5,3763,1575,-40
105485675701,105485675705,4,3870,1534,-40
105488212102,105488212105,3,1407,1520,-40
105488399349,105488399330,-19,733,342,-40
105491361641,105491361648,7,2491,1459,-40
105492649789,105492649797,8,3594,1370,-40
105496099174,105496099179,5,2510,1702,-40
105500755881,105500755887,6,3471,1864,-40
105504178508,105504178514,6,2310,1824,-40
105510632743,105510632745,2,1731,1471,-40
105511701905,105511701910,5,2535,1207,-40
105512883158,105512883165,7,3590,1258,-40
105515326495,105515326493,-2,45531,22387,-40
105516013453,105516013461,8,3490,1047,-40
105517033597,105517033603,6,3339,1653,-40
105520760381,105520760384,3,2492,1377,-40
105522976540,105522976546,6,2882,1132,-40
105523526153,105523526171,18,2612,1133,-40
105523856766,105523856773,7,3228,1245,-40
105525082194,105525082201,7,3430,1283,-40
105525312734,105525312741,7,2057,1083,-40
105525634829,105525634834,5,3293,1705,-40
105528621219,105528621228,9,2708,977,-40
105530981353,105530981359,6,1965,641,-40
105532486878,105532486882,4,1394,1267,-40
105533817750,105533817757,7,2344,826,-40
105535164491,105535164497,6,2542,1546,-40
105538767214,105538767221,7,7334,888,-40
105547327656,105547327640,-16,835,10737,-40
105549086226,105549086219,-7,26074,13694,-40
105556074938,105556074945,7,3677,1613,-40
105556501231,105556501239,8,2721,1686,-40
105556947154,105556947159,5,2761,1003,-40
105557949742,105557949749,7,4749,1778,-40
105559848860,105559848867,7,2285,1025,-40
105560057455,105560057461,6,2251,1095,-40
105561208705,105561208712,7,1872,1087,-40
105562282830,105562282835,5,2449,1072,-40
105564802387,105564802365,-22,3097,1475,-40
105565359033,105565359018,-15,2225,976,-40
105566327992,105566327997,5,2793,1243,-40
105566663449,105566663454,5,3238,1422,-40
105566788614,105566788621,7,3238,1277,-40
105570594659,105570594667,8,2702,1129,-40
105571799022,105571799004,-18,2045,842,-40
105572117579,105572117586,7,2913,1601,-40
105579024325,105579024329,4,3169,1460,-40
105584652845,105584652852,7,2900,1381,-40
105585044009,105585044017,8,2797,1419,-40
105588812405,105588812411,6,1567,742,-40
105592416178,105592416184,6,1863,1120,-40
105592589982,105592589970,-12,2839,1056,-40
105593072077,105593072082,5,2608,740,-40
105594714735,105594714716,-19,1600,499,-40
105596209310,105596209317,7,3229,1337,-40
105597091815,105597091818,3,1207,1322,-40
105602899235,105602899241,6,2225,932,-40
105603466809,105603466814,5,2266,1316,-40
105608410964,105608410971,7,4191,1695,-40
105610865339,105610865343,4,2394,1240,-40
105611613841,105611613848,7,3252,1308,-40
105612688015,105612688021,6,3204,1297,-40
105615126703,105615126709,6,2425,1198,-40
105617659520,105617659526,6,3285,1298,-40
105617778500,105617778507,7,1692,891,-40
105619681058,105619681067,9,3600,1321,-40
105620529361,105620529366,5,2418,1421,-40
105624159626,105624159630,4,1975,1140,-40
105625386964,105625386969,5,3119,1841,-40
105626909090,105626909094,4,2535,1084,-40
105628704740,105628704745,5,2488,1237,-40
105628798211,105628798211,0,1339,1853,-40
105632152258,105632152264,6,4102,1572,-40
105632885585,105632885592,7,2655,1013,-40
105635524843,105635524850,7,4198,963,-40
105641650919,105641650924,5,2639,1045,-40
105643927550,105643927539,-11,2324,1027,-40
105645829558,105645829563,5,2310,854,-40
105646725246,105646725264,18,2200,1135,-40
105651577615,105651577621,6,2743,1107,-40
105652207365,105652207370,5,3780,1100,-40
105652630963,105652630971,8,7711,994,-40
105654084301,105654084306,5,2151,706,-40
105654774496,105654774503,7,2322,1128,-40
105656311081,105656311087,6,3795,1505,-40
105661185076,105661185081,5,2536,1409,-40
105666237576,105666237583,7,1595,641,-40
105670290823,105670290830,7,2936,1269,-40
105670501665,105670501671,6,2308,1107,-40
105672025243,105672025251,8,3120,1308,-40
105677377526,105677377530,4,2347,1244,-40
105679170695,105679170699,4,2842,1691,-40
105681544990,105681544997,7,3128,1468,-40
105682652213,105682652220,7,2867,977,-40
105683937141,105683937149,8,3155,1412,-40
105684656518,105684656524,6,2513,1264,-40
105686750774,105686750780,6,3644,1730,-40
105690820785,105690820790,5,1622,666,-40
105693842646,105693842653,7,3543,1675,-40
105695849563,105695849568,5,2443,1033,-40
105700524785,105700524792,7,2675,1135,-40
105712788219,105712788225,6,3206,1189,-40
105712894531,105712894522,-9,575,309,-40
105715431162,105715431168,6,2731,1488,-40
105715882693,105715882694,1,1549,1481,-40
105716919398,105716919403,5,2485,1376,-40
105717940702,105717940709,7,3123,1358,-40
105718125749,105718125754,5,2909,1189,-40
105721345093,105721345099,6,2328,1277,-40
105726277448,105726277453,5,2400,1501,-40
105731946337,105731946340,3,20499,28969,-40
105735755789,105735755794,5,1663,627,-40
105740016187,105740016193,6,2200,1231,-40
105746924705,105746924710,5,3885,1982,-40
105749838500,105749838506,6,3370,1412,-40
105750673891,105750673898,7,2745,1402,-40
105760375012,105760375010,-2,1409,3235,-40
105770111897,105770111904,7,2841,1088,-40
105775041791,105775041795,4,2606,1756,-40
105775838187,105775838193,6,2437,1221,-40
105776597167,105776597171,4,2889,1962,-40
105778789871,105778789879,8,2202,1061,-40
105783728736,105783728741,5,1620,1336,-40
105784440565,105784440552,-13,920,286,-40
105787035078,105787035085,7,2313,1148,-40
105787982235,105787982244,9,2221,770,-40
105789360947,105789360951,4,1659,1397,-40
105793092446,105793092450,4,3042,1454,-40
105793609242,105793609243,1,2676,2616,-40
105794386523,105794386530,7,2993,1295,-40
105795875257,105795875266,9,3240,1242,-40
105795955370,105795955356,-14,1152,623,-40
105797389164,105797389170,6,3051,1227,-40
105805625077,105805625085,8,11238,32862,-40
105808727377,105808727380,3,2817,1888,-40
105809882513,105809882519,6,3399,1144,-40
105812766443,105812766440,-3,34010,53959,-40
105813791349,105813791354,5,3583,1122,-40
105814041158,105814041171,13,2029,677,-40
105816474109,105816474096,-13,2509,968,-40
105821860089,105821860090,1,1183,1551,-40
105823066482,105823066487,5,2203,1572,-40
105834513893,105834513898,5,3670,1168,-40
105836531621,105836531628,7,2219,1316,-40
105840920097,105840920105,8,1578,774,-40
105849076370,105849076375,5,2376,1209,-40
105849416796,105849416808,12,947,342,-40
105850336748,105850336745,-3,2024,4429,-40
105851156862,105851156867,5,2258,1103,-40
105852698130,105852698136,6,3327,1549,-40
105853088705,105853088708,3,10674,32617,-40
105854946090,105854946096,6,3630,1130,-40
105857986694,105857986699,5,3108,1910,-40
105861668720,105861668726,6,3000,1037,-40
105863974930,105863974938,8,3177,1199,-40
105867397823,105867397830,7,3600,1527,-40
105867508415,105867508396,-19,1803,1114,-40
105868168093,105868168099,6,2320,887,-40
105868271639,105868271647,8,1033,414,-40
105868983243,105868983250,7,3040,1309,-40
105869128467,105869128473,6,1002,154,-40
105872243869,105872243850,-19,1153,1856,-40
105872499783,105872499789,6,2792,1437,-40
105873738739,105873738745,6,3034,1139,-40
105874515720,105874515726,6,1822,829,-40
105874736246,105874736256,10,1802,778,-40
105874834565,105874834586,21,3504,1388,-40
105877863765,105877863764,-1,1711,2068,-40
105882006283,105882006279,-4,660,1143,-40
105885197519,105885197518,-1,1702,1889,-40
105887634902,105887634899,-3,1046,1995,-40
105889022515,105889022518,3,1264,958,-40
105890221490,105890221497,7,2409,1071,-40
105891301955,105891301962,7,2919,1160,-40
105900349472,105900349479,7,3637,1352,-40
105901824478,105901824486,8,3234,1743,-40
105907777723,105907777729,6,2930,1213,-40
105907820063,105907820042,-21,2082,405,-40
105908941783,105908941790,7,2824,1352,-40
105909088758,105909088737,-21,2534,781,-40
105910857058,105910857063,5,3864,1599,-40
105915694339,105915694344,5,2904,1368,-40
105915805745,105915805750,5,2720,1183,-40
105917089570,105917089577,7,2616,1322,-40
105919955637,105919955643,6,1951,1554,-40
105920058540,105920058547,7,2919,1237,-40
105920110118,105920110122,4,2027,1731,-40
105925154413,105925154418,5,2574,1101,-40
105926873716,105926873723,7,1598,782,-40
105927747701,105927747701,0,970,1677,-40
105930316074,105930316082,8,2115,1219,-40
105930449649,105930449659,10,3287,1443,-40
105932506117,105932506122,5,2255,1244,-40
105933585297,105933585288,-9,1186,4508,-40
105934909782,105934909789,7,2565,1746,-40
105938007290,105938007295,5,3223,1328,-40
105939365155,105939365152,-3,1640,3594,-40
105939607881,105939607890,9,2968,970,-40
105946148257,105946148263,6,1634,672,-40
105946532989,105946533000,11,2376,1352,-40
105948591743,105948591750,7,2543,1659,-40
105951220086,105951220093,7,2182,1069,-40
105953093986,105953093993,7,3264,1308,-40
105955970109,105955970115,6,2289,1226,-40
105957391361,105957391367,6,2292,1194,-40
105958959533,105958959538,5,2190,939,-40
105970869350,105970869332,-18,2512,704,-40
105974814554,105974814534,-20,783,258,-40
105975446378,105975446362,-16,1447,1011,-40
105976292119,105976292126,7,2921,1946,-40
105980556816,105980556822,6,3641,1124,-40
105981731754,105981731759,5,2800,1074,-40
105982096726,105982096734,8,2700,1173,-40
105982296870,105982296877,7,3172,1742,-40
105982506682,105982506689,7,1997,1180,-40
105987429334,105987429340,6,3966,1054,-40
105988471082,105988471090,8,2373,1422,-40
105997188569,105997188575,6,1714,1362,-40
106001533217,106001533222,5,2357,855,-40
106002993939,106002993935,-4,1384,3454,-40
106007594532,106007594533,1,32584,18181,-40
106012751098,106012751106,8,3554,1737,-40
106019800585,106019800593,8,1817,1170,-40
106022094420,106022094425,5,3926,1729,-40
106023248566,106023248561,-5,957,3539,-40
106023857667,106023857674,7,2544,1583,-40
106025540615,106025540612,-3,1113,3173,-40
106025737643,106025737650,7,3428,1099,-40
106027677746,106027677741,-5,628,2923,-40
106028686207,106028686213,6,1779,1464,-40
106029569010,106029569014,4,4027,1616,-40
106032282871,106032282876,5,2980,1303,-40
106032957501,106032957491,-10,3375,780,-40
106034051282,106034051288,6,3723,1090,-40
106035242429,106035242434,5,3301,1581,-40
106037222142,106037222150,8,3296,1441,-40
106054659854,106054659860,6,3225,1186,-40
106061566080,106061566082,2,4301,3742,-40
106062989942,106062989949,7,1179,693,-40
106068819918,106068819915,-3,3157,7893,-40
106069809609,106069809615,6,2343,1188,-40
106072445076,106072445082,6,1682,823,-40
106074294130,106074294138,8,3127,974,-40
106076547942,106076547947,5,1735,1052,-40
106078705823,106078705830,7,2561,1284,-40
106079709834,106079709838,4,3193,1218,-40
106080594332,106080594337,5,3357,1334,-40
106081368441,106081368446,5,1142,810,-40
106084891672,106084891679,7,4341,1629,-40
106085111617,106085111624,7,2510,962,-40
106089754172,106089754178,6,1476,1122,-40
106093476218,106093476222,4,2325,1134,-40
106094121102,106094121123,21,2147,1417,-40
106099802573,106099802577,4,1329,978,-40
106100503058,106100503063,5,1664,1113,-40
106101184724,106101184732,8,3115,811,-40
106102040364,106102040352,-12,1114,271,-40
106104000127,106104000126,-1,2274,4145,-40
106106409500,106106409491,-9,154,1061,-40
106108259952,106108259958,6,2558,1177,-40
106108488978,106108488985,7,1653,798,-40
106109826398,106109826402,4,1286,771,-40
106114467288,106114467293,5,2716,1628,-40
106116429605,106116429610,5,1830,894,-40
106119554724,106119554731,7,3030,1157,-40
106120841486,106120841492,6,4287,1344,-40
106123392643,106123392650,7,2130,1161,-40
106125048564,106125048569,5,2441,1029,-40
106125717450,106125717458,8,3982,1879,-40
106125818026,106125818042,16,1531,246,-40
106127580330,106127580336,6,3563,1542,-40
106130525414,106130525419,5,1755,893,-40
106131744754,106131744738,-16,1450,294,-40
106132708141,106132708148,7,3065,1599,-40
106133677150,106133677157,7,2631,1534,-40
106136779972,106136779978,6,2972,1685,-40
106143147418,106143147422,4,2195,1479,-40
106143249967,106143249970,3,742,350,-40
106143437857,106143437860,3,2352,1487,-40
106145117129,106145117134,5,3272,1085,-40
106147900945,106147900953,8,1816,730,-40
106148488044,106148488046,2,2461,2663,-40
106150284194,106150284202,8,2743,1113,-40
106151346448,106151346453,5,1940,1288,-40
106152580046,106152580028,-18,1421,582,-40
106155515606,106155515613,7,2828,1943,-40
106156261758,106156261762,4,1869,957,-40
106156507254,106156507259,5,1964,1200,-40
106157084405,106157084384,-21,2118,562,-40
106157150318,106157150324,6,2581,1209,-40
106160991651,106160991657,6,1486,1033,-40
106161991158,106161991154,-4,1856,7407,-40
106162174646,106162174654,8,2805,1648,-40
106162560167,106162560162,-5,925,358,-40
106164043303,106164043309,6,2114,1286,-40
106168120810,106168120817,7,1667,1216,-40
106168919460,106168919465,5,3553,1770,-40
106169344201,106169344207,6,2118,1709,-40
106175198253,106175198259,6,3008,1281,-40
106179976332,106179976338,6,1999,871,-40
106181793296,106181793290,-6,1140,5439,-40
106185316577,106185316583,6,2511,836,-40
106197600150,106197600158,8,6306,1651,-40
106210527732,106210527739,7,2406,1032,-40
106215627626,106215627634,8,3902,1401,-40
106218553720,106218553727,7,3684,2048,-40
106220657372,106220657379,7,4208,1260,-40
106222681055,106222681063,8,2453,759,-40
106228397961,106228397970,9,3738,1148,-40
106229106376,106229106381,5,1608,1268,-40
106232617187,106232617181,-6,849,2425,-40
106233224859,106233224866,7,3505,1226,-40
106233885902,106233885908,6,2289,1148,-40
106234700550,106234700537,-13,774,124,-40
106238164205,106238164211,6,1933,1001,-40
106239916785,106239916791,6,2824,1211,-40
106242448142,106242448146,4,2390,1474,-40
106242890726,106242890732,6,2919,1945,-40
106245587613,106245587619,6,3251,1229,-40
106246879272,106246879281,9,3577,1112,-40
106250838451,106250838443,-8,973,271,-40
106259238404,106259238407,3,4285,2889,-40
106264538740,106264538746,6,1794,1270,-40
106270811545,106270811550,5,3648,1225,-40
106271148198,106271148205,7,1663,861,-40
106276045350,106276045358,8,3849,1068,-40
106276616421,106276616427,6,4203,1915,-40
106277489994,106277489998,4,3027,1749,-40
106279277070,106279277077,7,1599,917,-40
106284750765,106284750770,5,2338,1500,-40
106284783770,106284783775,5,3232,1444,-40
106286261980,106286261988,8,2915,1360,-40
106288705450,106288705454,4,2838,1215,-40
106289711093,106289711098,5,30127,35301,-40
106290544636,106290544642,6,3505,1583,-40
106293295383,106293295391,8,2864,1413,-40
106295396249,106295396255,6,2501,1092,-40
106298673006,106298673006,0,1169,1748,-40
106301953693,106301953698,5,3529,1745,-40
106302158901,106302158907,6,3598,1366,-40
106305680851,106305680858,7,4301,1801,-40
106305731052,106305731057,5,1463,1289,-40
106306255000,106306255001,1,1632,1744,-40
106307973891,106307973898,7,3168,1561,-40
106309300262,106309300267,5,1835,1278,-40
106311072684,106311072690,6,2646,1406,-40
106315929477,106315929483,6,2735,1386,-40
106318946135,106318946141,6,2190,1043,-40
106321972719,106321972719,0,2316,3795,-40
106324769939,106324769946,7,3575,1584,-40
106325767222,106325767236,14,4429,1626,-40
106326126319,106326126314,-5,609,1653,-40
106327174294,106327174299,5,2698,1129,-40
106328337344,106328337350,6,2168,1234,-40
106329740751,106329740755,4,1633,429,-40
106330699950,106330699961,11,1359,150,-40
106336568527,106336568535,8,2896,1352,-40
106337288002,106337288009,7,3293,1401,-40
106337779116,106337779123,7,2982,1258,-40
106340327202,106340327206,4,2819,1349,-40
106342536564,106342536571,7,2838,1128,-40
106342979309,106342979298,-11,2275,576,-40
106349045049,106349045054,5,3128,1431,-40
106350917717,106350917721,4,3328,1539,-40
106362418435,106362418432,-3,1742,2352,-40
106362476075,106362476082,7,3657,1377,-40
106363339814,106363339799,-15,1260,428,-40
106366655110,106366655105,-5,1473,1895,-40
106367344670,106367344652,-18,1160,1610,-40
106369708393,106369708398,5,2785,1374,-40
106370234991,106370234977,-14,805,424,-40
106371312426,106371312434,8,4456,1143,-40
106371517423,106371517416,-7,893,320,-40
106372283672,106372283678,6,3089,1296,-40
106376649026,106376649033,7,3464,1227,-40
106378315123,106378315129,6,2838,1025,-40
106378355413,106378355419,6,2904,1068,-40
106378465414,106378465410,-4,1508,135,-40
106379399701,106379399708,7,2931,1776,-40
106388255606,106388255611,5,3010,1214,-40
106398362698,106398362705,7,3532,1607,-40
106403912547,106403912555,8,2992,1035,-40
106404166514,106404166498,-16,1425,527,-40
106406543815,106406543801,-14,990,701,-40
106408018792,106408018798,6,2927,1603,-40
106409080760,106409080766,6,2134,1113,-40
106410510341,106410510322,-19,3247,1429,-40
106413147913,106413147919,6,52439,14231,-40
106417620185,106417620190,5,1698,712,-40
106418576997,106418576989,-8,1540,5231,-40
106423278149,106423278155,6,3401,1206,-40
106424563971,106424563977,6,2856,1247,-40
106425554883,106425554888,5,1852,879,-40
106426283689,106426283695,6,2538,966,-40
106426339890,106426339875,-15,1638,917,-40
106435507548,106435507554,6,2914,1388,-40
106436112150,106436112157,7,1873,716,-40
106445148612,106445148620,8,3232,1307,-40
106445227318,106445227323,5,3339,1705,-40
106447337899,106447337906,7,988,687,-40
106447798655,106447798635,-20,1566,411,-40
106450703633,106450703638,5,1851,1168,-40
106451771929,106451771935,6,2865,1139,-40
106454917594,106454917599,5,1401,27468,-40
106457105234,106457105241,7,4015,1294,-40
106459704637,106459704643,6,3926,1228,-40
106462453143,106462453150,7,1891,644,-40
106462642878,106462642866,-12,1738,422,-40
106464810198,106464810205,7,2836,1461,-40
106465811989,106465811982,-7,866,2141,-40
106466270354,106466270362,8,1691,771,-40
106469238780,106469238778,-2,1847,2242,-40
106473839062,106473839069,7,2227,960,-40
106475232770,106475232778,8,4778,1241,-40
106479596173,106479596178,5,2717,1635,-40
106479656165,106479656172,7,2414,1487,-40
106482876866,106482876871,5,2878,976,-40
106483790854,106483790859,5,2321,1265,-40
106484963408,106484963415,7,2477,1353,-40
106485339485,106485339491,6,4569,1606,-40
106486999402,106486999383,-19,1201,386,-40
106488834527,106488834521,-6,1137,4541,-40
106492122800,106492122817,17,3238,1594,-40
106495487554,106495487558,4,2507,1253,-40
106496914045,106496914050,5,3154,1471,-40
106499357933,106499357938,5,2007,836,-40
106500408073,106500408078,5,2443,1104,-40
106500972734,106500972738,4,2436,1400,-40
106510396470,106510396475,5,3326,1644,-40
106510709161,106510709167,6,1218,402,-40
106513120314,106513120310,-4,730,1846,-40
106515325354,106515325359,5,2590,1662,-40
106516525682,106516525695,13,718,447,-40
106528448422,106528448426,4,2435,1431,-40
106531696749,106531696753,4,2457,1436,-40
106534408055,106534408061,6,2363,1266,-40
106534530110,106534530099,-11,1064,434,-40
106534951976,106534951982,6,3038,1251,-40
106540226422,106540226419,-3,1413,2509,-40
106540879522,106540879527,5,2961,1054,-40
106541551230,106541551235,5,2506,1160,-40
106543974982,106543974976,-6,1408,5597,-40
106545974536,106545974542,6,4148,1887,-40
106547025920,106547025914,-6,1047,4429,-40
106552815838,106552815844,6,2593,1360,-40
106553550393,106553550402,9,3717,1608,-40
106555179077,106555179085,8,2737,1098,-40
106555307426,106555307409,-17,3355,719,-40
106556019330,106556019334,4,1480,1007,-40
106558116773,106558116792,19,236,2152,-40
106563428551,106563428557,6,2235,1189,-40
106568491872,106568491879,7,1496,866,-40
106573158523,106573158529,6,1844,1062,-40
106577214858,106577214867,9,2454,746,-40
106582769847,106582769850,3,1639,1400,-40
106583006446,106583006466,20,2666,1553,-40
106584716337,106584716339,2,3820,3244,-40
106586570771,106586570768,-3,8598,14535,-40
106591309839,106591309846,7,2389,785,-40
106591451293,106591451298,5,3060,1833,-40
106592675685,106592675691,6,4108,1445,-40
106593021234,106593021229,-5,1231,3040,-40
106593157317,106593157323,6,3599,1808,-40
106595462522,106595462527,5,2332,1056,-40
106595912801,106595912807,6,2145,1072,-40
106598304346,106598304351,5,1698,1060,-40
106599925332,106599925337,5,1627,952,-40
106600152258,106600152263,5,2454,1258,-40
106600425317,106600425321,4,2494,1268,-40
106602544280,106602544286,6,2888,1169,-40
106604960930,106604960937,7,3753,1814,-40
106606471942,106606471946,4,4549,2317,-40
106607357782,106607357785,3,2239,1429,-40
106609719631,106609719638,7,2317,907,-40
106611649093,106611649099,6,3364,1284,-40
106616711120,106616711126,6,3057,1024,-40
106616786080,106616786086,6,3210,1297,-40
106619808003,106619808010,7,3939,1337,-40
106620948900,106620948907,7,2383,934,-40
106621795275,106621795282,7,3103,1035,-40
106623770759,106623770766,7,3673,1090,-40
106626487566,106626487571,5,1833,887,-40
106627523006,106627523013,7,3361,1283,-40
106628542018,106628542025,7,2539,564,-40
106631430398,106631430402,4,2569,993,-40
106636309830,106636309838,8,3112,1423,-40
106646681417,106646681418,1,1393,1553,-40
106647572273,106647572278,5,2113,880,-40
106648941314,106648941300,-14,626,355,-40
106651548791,106651548797,6,3113,1460,-40
106652228030,106652228028,-2,1128,2246,-40
106661356110,106661356108,-2,1628,2299,-40
106662673202,106662673210,8,2017,1219,-40
106663753805,106663753811,6,952,165,-40
106665166026,106665166007,-19,2502,713,-40
106666170149,106666170151,2,3589,2260,-40
106669661802,106669661810,8,1932,1131,-40
106670979899,106670979905,6,2359,1008,-40
106671317880,106671317899,19,3285,1227,-40
106678863535,106678863538,3,2351,1711,-40
106689190662,106689190669,7,4459,2149,-40
106691298269,106691298275,6,1517,992,-40
106693277222,106693277228,6,2939,1554,-40
106696135589,106696135592,3,2363,2299,-40
106696993865,106696993871,6,2566,1443,-40
106697512103,106697512109,6,2784,1067,-40
106700784857,106700784865,8,1099,1350,-40
106701162334,106701162340,6,1871,843,-40
106701741215,106701741196,-19,2574,1482,-40
106703124222,106703124229,7,2055,1180,-40
106707200173,106707200177,4,1625,1371,-40
106707814089,106707814093,4,10948,7571,-40
106710306277,106710306282,5,3225,1165,-40
106710511921,106710511927,6,3578,1424,-40
106715653683,106715653690,7,2774,1544,-40
106716062534,106716062541,7,2974,1293,-40
106716215787,106716215793,6,3566,2040,-40
106716435885,106716435892,7,2970,1322,-40
106720819532,106720819550,18,1056,3285,-40
106725609959,106725609969,10,4203,1164,-40
106725980906,106725980888,-18,2460,1215,-40
106727510378,106727510383,5,1099,652,-40
106728262053,106728262033,-20,3173,1041,-40
106732103714,106732103721,7,1341,995,-40
106733593480,106733593485,5,2932,1406,-40
106738270517,106738270523,6,2993,1105,-40
106740911346,106740911351,5,2028,1233,-40
106742647773,106742647779,6,2200,1208,-40
106747003718,106747003722,4,1731,1305,-40
106752289707,106752289713,6,2615,1406,-40
106760223442,106760223446,4,2757,1204,-40
106762380254,106762380262,8,5083,1334,-40
106764803689,106764803670,-19,2450,717,-40
106765227949,106765227946,-3,1169,2328,-40
106768634566,106768634574,8,3304,1168,-40
106770598079,106770598086,7,3172,1237,-40
106771481587,106771481593,6,2714,1386,-40
106772919345,106772919351,6,2173,875,-40
106773120940,106773120922,-18,1082,274,-40
106777512248,106777512254,6,2015,1269,-40
106777737356,106777737361,5,2103,1021,-40
106778875782,106778875785,3,2585,1158,-40
106780009697,106780009704,7,2801,1337,-40
106780495421,106780495441,20,2841,1130,-40
106790347428,106790347435,7,2431,1154,-40
106792152651,106792152645,-6,1191,2975,-40
106794354346,106794354353,7,2748,1295,-40
106804598017,106804598024,7,3437,1469,-40
106805371083,106805371090,7,2363,1025,-40
106806636561,106806636568,7,3159,1467,-40
106807626025,106807626032,7,3201,1166,-40
106812738918,106812738921,3,3632,2421,-40
106821014127,106821014122,-5,359,872,-40
106824434438,106824434442,4,1532,840,-40
106825149348,106825149354,6,1907,1423,-40
106830943641,106830943638,-3,2130,4728,-40
106831988441,106831988424,-17,2114,784,-40
106836667562,106836667567,5,3008,838,-40
106840690663,106840690654,-9,1296,3753,-40
106842988366,106842988364,-2,1600,2480,-40
106844613266,106844613273,7,6679,2695,-40
106845746722,106845746727,5,2482,1312,-40
106845786507,106845786510,3,2087,1093,-40
106849813860,106849813866,6,1836,971,-40
106849989228,106849989234,6,2051,1319,-40
106850264190,106850264196,6,2488,1410,-40
106856972486,106856972493,7,2734,1206,-40
106862365793,106862365799,6,3323,1123,-40
106862680375,106862680375,0,1892,2411,-40
106865989909,106865989915,6,4526,1710,-40
106867349998,106867350005,7,3118,1734,-40
106867529950,106867529957,7,2957,1076,-40
106867802796,106867802799,3,1987,1235,-40
106868031642,106868031649,7,2350,1289,-40
106875894338,106875894343,5,2529,1033,-40
106879478009,106879478018,9,2935,1425,-40
106879579617,106879579624,7,3169,1392,-40
106880142552,106880142559,7,3055,1552,-40
106883462133,106883462138,5,2131,1132,-40
106886264683,106886264686,3,2491,1054,-40
106891100062,106891100066,4,3019,1085,-40
106893653158,106893653167,9,2865,601,-40
106897993930,106897993937,7,3163,1442,-40
106901084390,106901084396,6,2014,788,-40
106902853380,106902853386,6,2943,1389,-40
106902881413,106902881419,6,1458,901,-40
106906895969,106906895974,5,1902,1250,-40
106907438317,106907438326,9,2434,1393,-40
106911213829,106911213836,7,2256,1205,-40
106930039319,106930039323,4,2386,1403,-40
106930808998,106930808978,-20,1439,574,-40
106932243738,106932243734,-4,836,1759,-40
106941942095,106941942102,7,2697,1131,-40
106942217701,106942217706,5,1832,1007,-40
106944880476,106944880482,6,2108,957,-40
106948364172,106948364179,7,3580,1328,-40
106948510113,106948510123,10,1095,122,-40
106949414246,106949414252,6,4118,1736,-40
106952473254,106952473259,5,3610,1340,-40
106954209261,106954209267,6,2664,1410,-40
106954746806,106954746810,4,1059,796,-40
106962796226,106962796234,8,2956,941,-40
106967980398,106967980401,3,1459,1073,-40
106969775702,106969775707,5,2409,1448,-40
106971479438,106971479442,4,1686,1115,-40
106977464145,106977464150,5,2524,1327,-40
106985945969,106985945975,6,2234,1051,-40
106987730353,106987730360,7,1786,1259,-40
106988600964,106988600963,-1,869,192,-40
106989064337,106989064344,7,2529,1357,-40
106990474331,106990474336,5,1609,888,-40
106997133876,106997133875,-1,19057,14543,-40
106997406279,106997406286,7,2750,1422,-40
107000983331,107000983338,7,2182,1132,-40
107001010762,107001010770,8,2785,1547,-40
107001076580,107001076585,5,2363,1138,-40
107002582362,107002582367,5,2555,1166,-40
107002811010,107002811015,5,2141,1784,-40
107014959578,107014959585,7,3216,1360,-40
107015072810,107015072795,-15,2433,1243,-40
107021491164,107021491169,5,1886,1088,-40
107025309900,107025309906,6,4061,1413,-40
107030816608,107030816613,5,3631,1260,-40
107033995650,107033995657,7,2569,1542,-40
107036099968,107036099974,6,2912,1392,-40
107036439829,107036439834,5,1995,1104,-40
107041751927,107041751934,7,3538,1798,-40
107044141917,107044141922,5,3706,1503,-40
107045410281,107045410285,4,2048,1184,-40
107046390731,107046390739,8,3512,919,-40
107048245119,107048245126,7,2727,1009,-40
107048285133,107048285140,7,2126,1169,-40
107051020897,107051020904,7,2315,1127,-40
107051265040,107051265046,6,3131,1534,-40
107052648410,107052648413,3,2690,1509,-40
107056588517,107056588523,6,1706,1128,-40
107057140728,107057140734,6,1959,763,-40
107058552040,107058552046,6,2930,1297,-40
107066855830,107066855835,5,1398,1115,-40
107068870952,107068870959,7,4019,1534,-40
107071970328,107071970333,5,2787,1013,-40
107075674155,107075674146,-9,1377,32690,-40
107078252321,107078252326,5,2164,1535,-40
107079699501,107079699502,1,2280,2188,-40
107080143403,107080143409,6,1533,1168,-40
107080195131,107080195129,-2,1090,176,-40
107080328289,107080328294,5,2946,1235,-40
107083721409,107083721414,5,2631,1510,-40
107085358874,107085358880,6,2086,1229,-40
107088210454,107088210459,5,2109,1447,-40
107088778998,107088779005,7,5142,2148,-40
107091383451,107091383449,-2,1272,1575,-40
107091433286,107091433299,13,736,129,-40
107092721521,107092721526,5,2525,1256,-40
107092940805,107092940811,6,2578,1038,-40
107101798633,107101798640,7,3176,1249,-40
107104693893,107104693898,5,1795,1213,-40
107110212810,107110212815,5,2883,1373,-40
107115093292,107115093297,5,2477,790,-40
107115825378,107115825385,7,3592,1296,-40
107123186205,107123186211,6,2498,1251,-40
107123328696,107123328711,15,299,1379,-40
107123432217,107123432203,-14,1144,578,-40
107128114506,107128114512,6,2691,978,-40
107130332306,107130332314,8,3241,1548,-40
107132532972,107132532983,11,17789,27078,-40
107134532501,107134532505,4,2594,1292,-40
107137380074,107137380080,6,2252,1519,-40
107137626493,107137626498,5,3280,1169,-40
107138305079,107138305085,6,2769,1341,-40
107142184950,107142184946,-4,868,2066,-40
107150309019,107150309026,7,2582,1269,-40
107150769259,107150769266,7,3330,1234,-40
107152171805,107152171811,6,1994,1147,-40
107156667474,107156667481,7,4658,2054,-40
107158945439,107158945418,-21,1408,453,-40
107160606260,107160606266,6,2744,1638,-40
107161416606,107161416612,6,2924,1680,-40
107167486786,107167486793,7,3051,1179,-40
107174922492,107174922500,8,5348,1121,-40
107176074674,107176074680,6,3057,1291,-40
107177105781,107177105788,7,17813,28702,-40
107179364429,107179364434,5,2621,1340,-40
107181218998,107181219001,3,2054,1855,-40
107191178328,107191178334,6,3318,1506,-40
107193513497,107193513502,5,1542,802,-40
107200480233,107200480238,5,2719,972,-40
107201554327,107201554308,-19,2261,1749,-40
107202582111,107202582118,7,1996,462,-40
107205150942,107205150951,9,3086,952,-40
107208194298,107208194304,6,3627,1307,-40
107208722632,107208722638,6,4495,1193,-40
107210667195,107210667203,8,3020,1460,-40
107215129527,107215129531,4,2985,1459,-40
107217234502,107217234510,8,2581,1035,-40
107220299502,107220299509,7,2819,1294,-40
107221424041,107221424047,6,2137,1043,-40
107222644110,107222644107,-3,816,288,-40
107226949386,107226949382,-4,1024,2571,-40
107234041106,107234041103,-3,2437,3516,-40
107234499422,107234499418,-4,2053,5425,-40
107234785649,107234785654,5,2748,1205,-40
107235168787,107235168793,6,1237,527,-40
107237221937,107237221945,8,3848,1334,-40
107237565039,107237565027,-12,1684,844,-40
107244497121,107244497127,6,3695,1421,-40
107244527575,107244527576,1,1288,270,-40
107247675049,107247675054,5,2255,1261,-40
107250246471,107250246478,7,1256,969,-40
107250866486,107250866465,-21,883,320,-40
107252571972,107252571978,6,3339,1133,-40
107254411481,107254411487,6,3779,1521,-40
107258187604,107258187602,-2,9582,16173,-40
107260160789,107260160795,6,2544,1081,-40
107260917729,107260917735,6,3964,1593,-40
107261401385,107261401391,6,2562,868,-40
107261528286,107261528292,6,3332,1074,-40
107261726998,107261726987,-11,805,242,-40
107269923045,107269923050,5,2901,794,-40
107270490837,107270490842,5,3205,1359,-40
107274679677,107274679685,8,5267,1412,-40
107276638495,107276638502,7,4086,1726,-40
107276797593,107276797600,7,2091,1395,-40
107279192429,107279192434,5,2492,1024,-40
107281671705,107281671709,4,2263,1276,-40
107283069969,107283069969,0,1153,86,-40
107304560539,107304560544,5,1372,575,-40
107310065962,107310065965,3,1858,1182,-40
107314106101,107314106107,6,2393,984,-40
107314702589,107314702595,6,2675,1182,-40
107318451942,107318451942,0,967,1307,-40
107326158322,107326158316,-6,1776,5889,-40
107326783767,107326783774,7,3431,1429,-40
107332543104,107332543110,6,2682,950,-40
107338403465,107338403471,6,3419,1714,-40
107339596950,107339596956,6,2258,937,-40
107340420290,107340420296,6,3540,1381,-40
107343527070,107343527075,5,3124,1210,-40
107344457770,107344457775,5,2394,753,-40
107344906381,107344906400,19,3467,1240,-40
107345497242,107345497238,-4,698,2293,-40
107350861618,107350861618,0,967,1463,-40
107357607547,107357607542,-5,1156,3446,-40
107357743996,107357743995,-1,740,1321,-40
107361100352,107361100358,6,3285,960,-40
107362069981,107362069987,6,3447,1373,-40
107363462366,107363462370,4,2009,1856,-40
107364395595,107364395602,7,3443,1314,-40
107366100490,107366100496,6,2420,1073,-40
107366183473,107366183478,5,2774,926,-40
107368507500,107368507506,6,2556,1395,-40
107373865834,107373865839,5,3236,1341,-40
107377059170,107377059178,8,3248,1426,-40
107382195909,107382195916,7,3172,1514,-40
107382546341,107382546347,6,2839,1397,-40
107383159212,107383159217,5,2895,1042,-40
107384077418,107384077426,8,3291,1125,-40
107386464746,107386464753,7,7800,2721,-40
107388001490,107388001495,5,2958,1494,-40
107394734817,107394734822,5,2555,1206,-40
107395778499,107395778505,6,2371,1408,-40
107396198613,107396198626,13,2249,915,-40
107399219938,107399219947,9,2869,1001,-40
107401675134,107401675139,5,2239,1194,-40
107403305374,107403305382,8,2276,919,-40
107408074305,107408074310,5,2095,1125,-40
107408225215,107408225194,-21,2845,507,-40
107414086049,107414086050,1,1044,1535,-40
107414441073,107414441079,6,3524,1426,-40
107415793113,107415793118,5,1669,816,-40
107416011491,107416011497,6,2601,1280,-40
107419397699,107419397706,7,3933,1573,-40
107420953829,107420953834,5,2108,950,-40
107424212183,107424212190,7,2700,1412,-40
107429645861,107429645867,6,3579,1409,-40
107433154467,107433154474,7,4430,1416,-40
107435624765,107435624770,5,2514,1387,-40
107436376367,107436376375,8,2775,1132,-40
107437475085,107437475082,-3,41404,21890,-40
107440936119,107440936125,6,3359,1672,-40
107441272962,107441272970,8,3192,1335,-40
107447720258,107447720264,6,3955,1640,-40
107454869851,107454869852,1,17913,18862,-40
107460084574,107460084582,8,3607,1611,-40
107460476866,107460476872,6,2405,1391,-40
107464362858,107464362861,3,3266,1528,-40
107466209719,107466209726,7,1566,723,-40
107466451035,107466451042,7,2577,1072,-40
107467047930,107467047937,7,1966,712,-40
107472256743,107472256740,-3,1193,3000,-40
107474224226,107474224231,5,2063,1086,-40
107475713209,107475713217,8,1905,757,-40
107477454845,107477454828,-17,1808,691,-40
107479975836,107479975841,5,2884,1267,-40
107480880565,107480880571,6,2753,1105,-40
107483987674,107483987681,7,1897,1033,-40
107484254525,107484254531,6,3043,1521,-40
107492585578,107492585586,8,2270,974,-40
107493098865,107493098867,2,6637,7614,-40
107497326950,107497326956,6,2471,1524,-40
107499191061,107499191066,5,3323,1249,-40
107504347354,107504347358,4,2887,1104,-40
107505151066,107505151073,7,3488,1145,-40
107510185338,107510185346,8,3873,1300,-40
107515278689,107515278696,7,2368,1510,-40
107519933548,107519933555,7,3242,1026,-40
107520158126,107520158122,-4,1286,190,-40
107523696632,107523696637,5,3621,1611,-40
107524676871,107524676882,11,18282,56826,-40
107526929392,107526929397,5,2535,1374,-40
107529647566,107529647572,6,1968,1005,-40
107538083893,107538083899,6,3304,1362,-40
107539386876,107539386878,2,1829,928,-40
107542008955,107542008962,7,4138,1423,-40
107542088015,107542088021,6,2711,1314,-40
107543107517,107543107522,5,2922,653,-40
107544133618,107544133625,7,4045,1483,-40
107547254041,107547254048,7,2893,1562,-40
107548313981,107548313962,-19,1195,422,-40
107549346108,107549346114,6,2399,1092,-40
107554412046,107554412053,7,3181,1225,-40
107557764049,107557764054,5,2601,1767,-40
107560957351,107560957358,7,3273,1115,-40
107566135669,107566135674,5,2075,1284,-40
107567065730,107567065735,5,1799,941,-40
107569633529,107569633529,0,1583,1718,-40
107570290837,107570290820,-17,1238,282,-40
107575280304,107575280310,6,2554,913,-40
107575749819,107575749813,-6,21107,13931,-40
107577157246,107577157251,5,2156,1042,-40
107577683583,107577683579,-4,4018,6990,-40
107577840282,107577840290,8,2330,1040,-40
107578578863,107578578843,-20,2464,1177,-40
107579723494,107579723498,4,1987,1171,-40
107588853495,107588853495,0,1791,2135,-40
107590663413,107590663396,-17,795,348,-40
107592142464,107592142449,-15,935,2146,-40
107598821881,107598821886,5,1986,1280,-40
107602658501,107602658507,6,1948,956,-40
107603036572,107603036578,6,3570,1101,-40
107604708953,107604708961,8,2371,973,-40
107604873269,107604873276,7,3622,1671,-40
107605750650,107605750656,6,3473,1620,-40
107606656978,107606656983,5,2461,1192,-40
107606948798,107606948804,6,4215,1533,-40
107610126404,107610126411,7,2860,1661,-40
107610515009,107610514995,-14,2343,1140,-40
107610621664,107610621671,7,2492,1224,-40
107613866491,107613866498,7,2477,1634,-40
107618334713,107618334720,7,4064,1489,-40
107620340116,107620340121,5,3182,1382,-40
107626736442,107626736444,2,5723,19554,-40
107631263029,107631263035,6,3974,1869,-40
107632726966,107632726971,5,3375,1290,-40
107637481343,107637481342,-1,1583,2078,-40
107640583706,107640583712,6,3742,1660,-40
107642786308,107642786313,5,2866,1351,-40
107643498489,107643498495,6,2175,956,-40
107644452333,107644452338,5,2664,1167,-40
107644804610,107644804610,0,937,1693,-40
107644945945,107644945961,16,626,1854,-40
107659003683,107659003689,6,1689,1065,-40
107661762071,107661762075,4,2084,703,-40
107662176522,107662176530,8,3576,1400,-40
107662428306,107662428305,-1,23754,33678,-40
107667464712,107667464717,5,2652,1377,-40
107668945469,107668945473,4,2522,1192,-40
107673307198,107673307203,5,3420,1315,-40
107673657818,107673657823,5,3059,1059,-40
107673712142,107673712147,5,3462,1332,-40
107676560206,107676560211,5,1657,882,-40
107676887752,107676887758,6,3147,1041,-40
107679056601,107679056606,5,3322,1366,-40
107679261829,107679261835,6,3064,1741,-40
107684318449,107684318457,8,2409,1221,-40
107684857507,107684857520,13,2619,1248,-40
107687357936,107687357942,6,3443,1677,-40
107690852109,107690852115,6,3034,1496,-40
107693214361,107693214367,6,3699,1320,-40
107696661749,107696661753,4,1854,1224,-40
107697104310,107697104290,-20,987,209,-40
107703813421,107703813426,5,2432,1073,-40
107704720966,107704720971,5,3032,1165,-40
107706030488,107706030489,1,1275,1136,-40
107706641686,107706641692,6,2946,1218,-40
107707711521,107707711527,6,3579,1825,-40
107708963635,107708963640,5,2138,1433,-40
107711497760,107711497767,7,2578,1455,-40
107713068723,107713068730,7,1928,1031,-40
107714154101,107714154082,-19,952,319,-40
107714498909,107714498917,8,5929,2292,-40
107718748862,107718748867,5,2193,900,-40
107720894023,107720894030,7,3782,1401,-40
107721823515,107721823523,8,2867,1200,-40
107723395075,107723395082,7,2871,806,-40
107726351218,107726351225,7,1888,1045,-40
107728018755,107728018756,1,1922,1251,-40
107732684534,107732684539,5,2042,1091,-40
107733287613,107733287621,8,3744,1607,-40
107733884526,107733884532,6,4045,1503,-40
107733933538,107733933553,15,11489,49109,-40
107735369665,107735369672,7,2236,1150,-40
107735835886,107735835873,-13,486,54,-40
107737885588,107737885595,7,2634,1463,-40
107738663926,107738663931,5,3421,1396,-40
107739033234,107739033241,7,2685,1623,-40
107740042834,107740042839,5,1655,1036,-40
107740419954,107740419947,-7,806,310,-40
107746977998,107746978003,5,1356,1499,-40
107750249733,107750249739,6,2871,1451,-40
107753141630,107753141635,5,3149,1192,-40
107754519432,107754519438,6,3289,1542,-40
107758924202,107758924209,7,2815,1051,-40
107764861325,107764861331,6,3086,1229,-40
107765959552,107765959547,-5,1381,4086,-40
107771018309,107771018315,6,1827,1300,-40
107771185356,107771185362,6,1694,1378,-40
107771352729,107771352714,-15,2452,1333,-40
107773376733,107773376739,6,3961,1564,-40
107776136818,107776136828,10,798,111,-40
107777390466,107777390470,4,2335,1102,-40
107781374952,107781374958,6,4391,1641,-40
107781639983,107781639979,-4,1194,1987,-40
107783804250,107783804257,7,2332,1194,-40
107784741252,107784741259,7,2635,1151,-40
107787033965,107787033973,8,2796,1584,-40
107787375690,107787375697,7,4398,1240,-40
107790583625,107790583634,9,1190,457,-40
107795372846,107795372854,8,716,530,-40
107804355076,107804355082,6,2356,1125,-40
107804397973,107804397978,5,2764,1547,-40
107805691870,107805691875,5,2477,929,-40
107814031528,107814031534,6,4092,1160,-40
107814578521,107814578526,5,2876,1459,-40
107817579214,107817579222,8,3700,1905,-40
107821621394,107821621402,8,2091,952,-40
107821676055,107821676062,7,3254,1268,-40
107821764194,107821764199,5,2786,1059,-40
107825747268,107825747275,7,2914,1230,-40
107831002774,107831002774,0,3467,3735,-40
107835775889,107835775894,5,2199,1311,-40
107845661301,107845661306,5,1792,818,-40
107846364983,107846364961,-22,1035,276,-40
107849348378,107849348375,-3,2463,4774,-40
107851006781,107851006786,5,2064,1270,-40
107853345689,107853345693,4,1852,836,-40
107857329484,107857329490,6,2818,1527,-40
107859132003,107859132002,-1,21393,20599,-40
107859257228,107859257234,6,1432,1093,-40
107859907465,107859907469,4,2844,1230,-40
107860930545,107860930551,6,2998,1111,-40
107863016393,107863016400,7,4005,1543,-40
107863703160,107863703166,6,2808,1455,-40
107864255058,107864255042,-16,922,362,-40
107864734648,107864734654,6,3010,1457,-40
107869028448,107869028452,4,3057,1243,-40
107878981605,107878981614,9,1640,881,-40
107879276797,107879276788,-9,1169,614,-40
107881781290,107881781294,4,2291,978,-40
107881877314,107881877319,5,2506,1418,-40
107881994074,107881994082,8,2501,954,-40
107882551359,107882551367,8,2491,1366,-40
107883116127,107883116120,-7,30980,15786,-40
107889403803,107889403809,6,3878,1618,-40
107889620620,107889620620,0,1487,2447,-40
107893402520,107893402525,5,2330,1614,-40
107893679491,107893679493,2,1601,1445,-40
107893861894,107893861898,4,2295,1039,-40
107897966066,107897966072,6,3380,1528,-40
107899627090,107899627095,5,2257,1927,-40
107899999245,107899999250,5,3868,1202,-40
107901793555,107901793562,7,2926,1274,-40
107902701864,107902701870,6,988,599,-40
107902751406,107902751425,19,807,255,-40
107909884301,107909884306,5,2891,1214,-40
107914216484,107914216490,6,2030,1061,-40
107914248574,107914248579,5,3139,1162,-40
107915441087,107915441091,4,1977,1187,-40
107915916146,107915916153,7,3239,1272,-40
107916507985,107916507990,5,2414,1225,-40
107926352248,107926352254,6,3654,1529,-40
107928052886,107928052907,21,1894,728,-40
107931114913,107931114920,7,2626,993,-40
107933058663,107933058670,7,2550,1279,-40
107933908415,107933908434,19,1088,176,-40
107943279818,107943279823,5,1414,647,-40
107945921174,107945921178,4,1850,1268,-40
107946696233,107946696240,7,2636,1024,-40
107949940554,107949940536,-18,888,202,-40
107954585741,107954585746,5,2383,1148,-40
107955887307,107955887313,6,2916,1357,-40
107960324174,107960324181,7,2675,1243,-40
107969438839,107969438845,6,2255,1185,-40
107969666429,107969666434,5,3024,1351,-40
107970384074,107970384059,-15,5361,1191,-40
107975743424,107975743418,-6,774,321,-40
107977980866,107977980871,5,1957,996,-40
107978445103,107978445110,7,3497,1131,-40
107979689833,107979689839,6,3202,1255,-40
107980835297,107980835303,6,3095,1150,-40
107981198070,107981198058,-12,803,182,-40
107982558669,107982558675,6,3395,1086,-40
107987157313,107987157319,6,2340,1205,-40
107993119833,107993119839,6,3097,1423,-40
107995076481,107995076487,6,2657,1085,-40
107997334112,107997334114,2,1307,1743,-40
107998031865,107998031871,6,2872,1582,-40
108003597040,108003597046,6,2475,955,-40
108005949827,108005949834,7,3510,1425,-40
108006000117,108006000124,7,5230,1616,-40
108006990538,108006990538,0,3687,5366,-40
108007959242,108007959247,5,2710,1566,-40
108009128125,108009128130,5,2942,1466,-40
108010103585,108010103589,4,17971,14472,-40
108011866529,108011866534,5,3376,1258,-40
108012175536,108012175535,-1,25689,48243,-40
108013717657,108013717665,8,3229,1513,-40
108013763806,108013763817,11,3261,1308,-40
108014268127,108014268130,3,758,212,-40
108016720508,108016720514,6,2515,1157,-40
108017082361,108017082366,5,1834,789,-40
108021419372,108021419378,6,2636,1283,-40
108023893134,108023893144,10,3073,1569,-40
108025315395,108025315402,7,2945,1410,-40
108028691502,108028691509,7,4008,1435,-40
108029208146,108029208150,4,831,481,-40
108029752514,108029752514,0,3040,4026,-40
108031772789,108031772795,6,2464,1670,-40
108033652555,108033652559,4,1445,848,-40
108035193262,108035193267,5,1590,1018,-40
108035883862,108035883869,7,2991,1401,-40
108042792912,108042792917,5,2780,1269,-40
108044782157,108044782162,5,2189,1198,-40
108046506363,108046506365,2,13342,12119,-40
108048677539,108048677544,5,3162,1316,-40
108053341052,108053341059,7,3943,1541,-40
108053584071,108053584060,-11,2427,883,-40
108054726824,108054726831,7,2410,1457,-40
108057299061,108057299050,-11,1052,277,-40
108060654006,108060654011,5,3854,1551,-40
108060780466,108060780464,-2,532,225,-40
108066316038,108066316044,6,2672,1463,-40
108066787098,108066787104,6,2546,1041,-40
108071068410,108071068419,9,36996,9088,-40
108072576446,108072576452,6,3384,1656,-40
108073828754,108073828751,-3,970,2178,-40
108074669131,108074669138,7,3567,1120,-40
108081207185,108081207191,6,1779,528,-40
108082552450,108082552456,6,2119,910,-40
108090529757,108090529763,6,2477,1126,-40
108095936322,108095936326,4,3104,852,-40
108097092350,108097092355,5,2646,1355,-40
108097118480,108097118491,11,3364,1284,-40
108098640669,108098640677,8,3307,1652,-40
108099065221,108099065228,7,3011,920,-40
108099450419,108099450401,-18,1778,926,-40
108102774299,108102774300,1,1815,1957,-40
108103698357,108103698362,5,3336,1459,-40
108105346806,108105346810,4,1847,1059,-40
108105840891,108105840897,6,2497,1355,-40
108108693647,108108693655,8,3309,1159,-40
108109999439,108109999447,8,3884,1573,-40
108110651938,108110651943,5,2960,1508,-40
108113632763,108113632770,7,3587,1271,-40
108119422314,108119422318,4,2931,1482,-40
108120414565,108120414572,7,1908,1070,-40
108123752296,108123752302,6,2211,964,-40
108124224526,108124224545,19,980,203,-40
108126879748,108126879753,5,2583,1300,-40
108130439126,108130439133,7,3986,1356,-40
108133589082,108133589087,5,2349,877,-40
108138654619,108138654623,4,1944,1467,-40
108138728253,108138728255,2,1198,1419,-40
108139544612,108139544618,6,2143,969,-40
108143440781,108143440786,5,3592,1486,-40
108147199457,108147199462,5,3980,1447,-40
108149006962,108149006966,4,1466,747,-40
108149812175,108149812181,6,4421,1892,-40
108155270941,108155270947,6,2913,1402,-40
108155319709,108155319715,6,2979,1329,-40
108159539381,108159539387,6,3596,1332,-40
108161006613,108161006619,6,2357,1043,-40
108163303890,108163303894,4,1869,1094,-40
108165519088,108165519095,7,2982,1311,-40
108165882822,108165882809,-13,2003,991,-40
108172119902,108172119908,6,3003,1283,-40
108173873842,108173873849,7,4246,1820,-40
108178704202,108178704189,-13,548,127,-40
108180851711,108180851719,8,3259,1317,-40
108182397130,108182397125,-5,992,2563,-40
108187397797,108187397802,5,3628,1351,-40
108187642744,108187642751,7,3132,1308,-40
108193990470,108193990477,7,3468,1141,-40
108195679074,108195679080,6,2939,1771,-40
108198443674,108198443681,7,3679,1351,-40
108199607392,108199607399,7,2768,1228,-40
108200913677,108200913682,5,3545,1233,-40
108202025979,108202025986,7,1980,1357,-40
108205228268,108205228272,4,2329,1517,-40
108206039826,108206039834,8,1475,1157,-40
108209432754,108209432760,6,2955,1388,-40
108213421801,108213421808,7,1974,893,-40
108216604698,108216604702,4,2755,1192,-40
108222756379,108222756385,6,2387,1444,-40
108227840699,108227840705,6,2952,1030,-40
108231384243,108231384251,8,3573,1478,-40
108231888090,108231888095,5,4456,1249,-40
108232269898,108232269902,4,3296,1538,-40
108232406006,108232406014,8,2182,961,-40
108232553470,108232553478,8,2252,1166,-40
108233945601,108233945608,7,3753,1139,-40
108235197494,108235197473,-21,2619,1692,-40
108236182391,108236182397,6,1112,1295,-40
108236716063,108236716044,-19,1515,695,-40
108244961641,108244961650,9,3410,1142,-40
108248927047,108248927052,5,924,260,-40
108250045791,108250045795,4,1227,747,-40
108250291905,108250291891,-14,2619,888,-40
108250693155,108250693161,6,3689,1463,-40
108253339924,108253339930,6,4464,1575,-40
108255548376,108255548382,6,3068,1035,-40
108256165677,108256165682,5,3328,1225,-40
108262453122,108262453109,-13,1137,25720,-40
108264316211,108264316210,-1,1390,2860,-40
108265189863,108265189869,6,2977,863,-40
108266293814,108266293818,4,2324,1171,-40
108266600837,108266600843,6,5479,1253,-40
108268789786,108268789790,4,2442,1170,-40
108268952208,108268952196,-12,1519,945,-40
108270260724,108270260731,7,3310,1077,-40
108271925522,108271925536,14,2189,1269,-40
108272038173,108272038170,-3,808,316,-40
108276456500,108276456507,7,3650,1153,-40
108278458800,108278458805,5,1455,1029,-40
108284757133,108284757139,6,2679,1470,-40
108285188883,108285188890,7,2189,1462,-40
108287226983,108287226988,5,2910,1321,-40
108288374771,108288374774,3,3355,1585,-40
108289805460,108289805466,6,3557,1258,-40
108294211037,108294211039,2,1057,1006,-40
108296019277,108296019282,5,3798,1139,-40
108296968654,108296968660,6,2084,1082,-40
108300703838,108300703842,4,2153,886,-40
108300946252,108300946264,12,996,407,-40
108302591973,108302591979,6,4213,1633,-40
108304872026,108304872031,5,3018,1063,-40
108305694861,108305694867,6,1750,870,-40
108308281149,108308281151,2,1764,1546,-40
108309266686,108309266693,7,3304,1554,-40
108309670340,108309670341,1,1835,1910,-40
108311733542,108311733549,7,3072,1142,-40
108313762716,108313762713,-3,22228,13392,-40
108314790458,108314790465,7,1885,824,-40
108317310158,108317310161,3,1465,1760,-40
108319489918,108319489922,4,1028,1088,-40
108320408462,108320408468,6,3313,1587,-40
108322283456,108322283464,8,2626,1302,-40
108323493452,108323493458,6,3620,1554,-40
108325270224,108325270230,6,2621,1551,-40
108325913897,108325913904,7,3916,1466,-40
108329428473,108329428478,5,1842,1006,-40
108332158442,108332158438,-4,1274,1387,-40
108334590429,108334590435,6,3098,1375,-40
108338062816,108338062822,6,2438,1263,-40
108341399271,108341399272,1,866,1529,-40
108344918650,108344918655,5,2842,980,-40
108349028637,108349028642,5,3064,1492,-40
108349067759,108349067738,-21,3036,933,-40
108349815830,108349815837,7,1809,901,-40
108350454295,108350454304,9,2813,1162,-40
108353068075,108353068078,3,1776,1794,-40
108354193107,108354193114,7,4221,1753,-40
108362725766,108362725771,5,4033,2145,-40
108367070111,108367070118,7,3768,1263,-40
108368442262,108368442269,7,3816,1490,-40
108376472786,108376472794,8,3381,1141,-40
108376597678,108376597666,-12,2323,1063,-40
108377945796,108377945803,7,2867,1156,-40
108384923341,108384923347,6,2167,1376,-40
108385123489,108385123482,-7,724,373,-40
108389840259,108389840255,-4,1247,2693,-40
108390190835,108390190843,8,2424,1417,-40
108398353379,108398353381,2,2084,2044,-40
108399309929,108399309934,5,2786,1133,-40
108403592805,108403592810,5,2504,1141,-40
108404245616,108404245619,3,2376,1109,-40
108407739185,108407739166,-19,2717,1546,-40
108409586113,108409586118,5,3526,1350,-40
108409866130,108409866135,5,2065,1265,-40
108414834832,108414834830,-2,1167,2232,-40
108416039270,108416039275,5,2604,1348,-40
108416888201,108416888206,5,2285,1243,-40
108417855306,108417855311,5,2496,1394,-40
108421074057,108421074063,6,2952,1220,-40
108421618924,108421618932,8,285,1344,-40
108440217746,108440217751,5,2996,1099,-40
108441996494,108441996498,4,2124,853,-40
108442454969,108442454975,6,1757,1115,-40
108442570008,108442570014,6,1770,1067,-40
108448740918,108448740922,4,2244,1145,-40
108450081456,108450081462,6,3610,2397,-40
108452842002,108452842009,7,2840,887,-40
108456695358,108456695365,7,3293,1555,-40
108458147739,108458147747,8,3887,1147,-40
108462162077,108462162083,6,2150,1207,-40
108463098994,108463098998,4,2398,1474,-40
108466196055,108466196062,7,4267,1262,-40
108466492685,108466492689,4,1387,648,-40
108469025692,108469025698,6,2921,1313,-40
108471622923,108471622930,7,3059,1549,-40
108471951042,108471951049,7,2044,1037,-40
108475762446,108475762452,6,3404,1568,-40
108475906518,108475906524,6,2319,993,-40
108477299998,108477300002,4,1435,1131,-40
108479976808,108479976815,7,3534,1513,-40
108480930417,108480930423,6,3353,1123,-40
108486826486,108486826491,5,3391,1136,-40
108489549473,108489549476,3,1874,1060,-40
108489882505,108489882520,15,1499,275,-40
108490602425,108490602430,5,3315,1382,-40
108492283041,108492283047,6,3289,1081,-40
108493546798,108493546805,7,2836,1365,-40
108496416927,108496416931,4,2215,1101,-40
108499447647,108499447651,4,2291,974,-40
108499917008,108499917016,8,4492,1641,-40
108500943537,108500943543,6,3185,1614,-40
108503530526,108503530533,7,3192,1219,-40
108508167245,108508167249,4,3127,1243,-40
108508488609,108508488615,6,2985,1523,-40
108511882334,108511882341,7,3797,1102,-40
108512068646,108512068653,7,3764,1512,-40
108512399613,108512399620,7,4453,1703,-40
108518255929,108518255934,5,3130,1040,-40
108520053690,108520053697,7,2931,1391,-40
108522354671,108522354677,6,3148,1545,-40
108523181549,108523181546,-3,660,189,-40
108524821673,108524821679,6,2349,1001,-40
108531927163,108531927167,4,2871,2047,-40
108536607524,108536607517,-7,2189,7382,-40
108539589531,108539589538,7,2150,917,-40
108540932735,108540932731,-4,950,2011,-40
108541025166,108541025174,8,2622,1166,-40
108541487097,108541487112,15,754,2123,-40
108553506966,108553506971,5,2722,1178,-40
108554079462,108554079442,-20,877,220,-40
108554463225,108554463231,6,2831,956,-40
108556192922,108556192922,0,2206,5556,-40
108560221412,108560221418,6,3402,1111,-40
108561686957,108561686954,-3,1143,1921,-40
108562727630,108562727635,5,1474,1178,-40
108565559326,108565559334,8,3061,1251,-40
108566127116,108566127122,6,2007,1117,-40
108569369021,108569369027,6,5492,2100,-40
108569435070,108569435078,8,2318,1296,-40
108569608510,108569608518,8,3928,1463,-40
108572154669,108572154673,4,2688,1510,-40
108573246693,108573246698,5,3086,956,-40
108580528852,108580528858,6,2685,1015,-40
108581460583,108581460563,-20,1828,940,-40
108582209471,108582209478,7,3529,1228,-40
108583907177,108583907182,5,3085,1910,-40
108586567862,108586567868,6,3586,1474,-40
108588861861,108588861867,6,3400,1266,-40
108590024431,108590024435,4,2335,911,-40
108593351802,108593351809,7,3692,1525,-40
108593529103,108593529111,8,3849,1582,-40
108594019958,108594019966,8,3454,1405,-40
108594576678,108594576689,11,844,315,-40
108595361170,108595361177,7,2101,1030,-40
108604320881,108604320890,9,2697,1304,-40
108606208786,108606208794,8,2274,771,-40
108609392351,108609392358,7,3477,1137,-40
108611762157,108611762163,6,2729,1000,-40
108614216019,108614216026,7,2215,1436,-40
108614514813,108614514819,6,2450,1267,-40
108615744350,108615744363,13,967,249,-40
108618498286,108618498291,5,2121,1002,-40
108620916015,108620916018,3,2790,1125,-40
108621938931,108621938937,6,3029,1449,-40
108624489155,108624489159,4,3726,2062,-40
108625664067,108625664075,8,3399,1444,-40
108626041342,108626041330,-12,1708,572,-40
108628511346,108628511352,6,3238,1316,-40
108632409052,108632409057,5,2681,1649,-40
108639751736,108639751735,-1,2349,2990,-40
108644838856,108644838862,6,2993,1323,-40
108646723819,108646723826,7,3628,1488,-40
108647507518,108647507499,-19,1264,548,-40
108648865514,108648865519,5,3542,1720,-40
108650018910,108650018888,-22,738,254,-40
108650838087,108650838093,6,2435,1461,-40
108654644713,108654644719,6,2152,654,-40
108659872242,108659872237,-5,1842,5703,-40
108665057296,108665057303,7,4800,1554,-40
108666589174,108666589179,5,2470,826,-40
108666723646,108666723649,3,710,393,-40
108667366926,108667366933,7,2915,1832,-40
108672851388,108672851391,3,4022,3120,-40
108675499851,108675499858,7,2966,1207,-40
108678123785,108678123792,7,3790,1560,-40
108679626368,108679626373,5,2775,1544,-40
108680317446,108680317451,5,2278,1098,-40
108680418437,108680418443,6,2971,1375,-40
108681264186,108681264189,3,2172,1283,-40
108691193380,108691193383,3,1457,1285,-40
108693651497,108693651501,4,2063,1128,-40
108697325494,108697325499,5,2616,1294,-40
108698922233,108698922240,7,8610,3598,-40
108701622789,108701622794,5,2709,1182,-40
108702667517,108702667523,6,2589,1059,-40
108706752758,108706752757,-1,1781,2852,-40
108711377612,108711377595,-17,40103,25447,-40
108714060953,108714060958,5,4691,1623,-40
108716438523,108716438530,7,3793,1335,-40
108720500682,108720500689,7,1490,773,-40
108722326085,108722326091,6,3807,1474,-40
108722850955,108722850967,12,219,967,-40
108724645177,108724645183,6,2017,734,-40
108724815664,108724815651,-13,2964,799,-40
108726282146,108726282153,7,4176,1735,-40
108727465727,108727465733,6,2311,1178,-40
108727535610,108727535593,-17,1097,486,-40
108734023754,108734023760,6,3901,1718,-40
108735559302,108735559309,7,1917,1378,-40
108736441357,108736441363,6,3401,1733,-40
108737326737,108737326742,5,2143,1310,-40
108739326458,108739326462,4,2119,1177,-40
108741707135,108741707143,8,4108,1716,-40
108746043179,108746043180,1,7253,10244,-40
108749642054,108749642061,7,3159,1543,-40
108752138144,108752138151,7,3580,1237,-40
108755493898,108755493895,-3,5267,11421,-40
108758493823,108758493807,-16,36059,17720,-40
108764926149,108764926154,5,3339,1687,-40
108766138030,108766138038,8,2482,1077,-40
108767325505,108767325509,4,2126,1564,-40
108767548419,108767548426,7,2574,1486,-40
108767923944,108767923945,1,982,899,-40
108768715216,108768715222,6,2194,890,-40
108769437775,108769437781,6,2607,1275,-40
108769487922,108769487927,5,2954,1089,-40
108769664010,108769664014,4,2362,1673,-40
108773388981,108773388985,4,1778,1278,-40
108774420829,108774420835,6,2765,1347,-40
108774621758,108774621736,-22,1670,913,-40
108785549266,108785549274,8,2648,957,-40
108786310949,108786310955,6,3331,1922,-40
108786426951,108786426957,6,2267,843,-40
108786846558,108786846559,1,1912,1514,-40
108791560678,108791560682,4,1327,598,-40
108801108286,108801108291,5,2991,1589,-40
108804458783,108804458789,6,3328,1794,-40
108807779480,108807779482,2,26525,20818,-40
108808598325,108808598338,13,9432,43920,-40
108808637640,108808637645,5,2874,1434,-40
108810046501,108810046506,5,3011,1053,-40
108819062180,108819062186,6,3072,1623,-40
108819573038,108819573045,7,1878,758,-40
108820772637,108820772642,5,3264,2174,-40
108827143849,108827143853,4,3985,1459,-40
108827481137,108827481123,-14,2385,901,-40
108828132673,108828132679,6,5266,1872,-40
108828755748,108828755753,5,2172,1082,-40
108829641383,108829641379,-4,810,323,-40
108830567022,108830567025,3,1739,1414,-40
108831142368,108831142378,10,2321,1081,-40
108835266568,108835266575,7,2394,1261,-40
108837601915,108837601918,3,1686,903,-40
108838111337,108838111345,8,2743,1080,-40
108844907158,108844907165,7,2392,1317,-40
108847360544,108847360549,5,2766,1070,-40
108848268137,108848268143,6,2444,1178,-40
108849876561,108849876566,5,2301,1229,-40
108850433704,108850433709,5,2700,1033,-40
108858787914,108858787922,8,2239,839,-40
108860174741,108860174747,6,2653,1140,-40
108862973682,108862973689,7,2470,941,-40
108864087741,108864087747,6,1863,1290,-40
108864702993,108864702998,5,1997,1248,-40
108869940266,108869940274,8,4902,1345,-40
108872043609,108872043616,7,2149,1293,-40
108872867538,108872867543,5,3316,1376,-40
108875434409,108875434416,7,2521,1323,-40
108879073111,108879073118,7,3204,1373,-40
108879655349,108879655354,5,4147,1740,-40
108880139513,108880139519,6,3207,1606,-40
108885789681,108885789689,8,4517,1197,-40
108885924269,108885924275,6,3648,997,-40
108890018999,108890019005,6,4246,1399,-40
108893812134,108893812139,5,2696,1698,-40
108898673469,108898673475,6,3246,1180,-40
108898704617,108898704604,-13,4052,869,-40
108899408441,108899408447,6,7308,2722,-40
108908070918,108908070924,6,3969,1458,-40
108912545093,108912545097,4,2994,954,-40
108917215475,108917215482,7,2493,976,-40
108917605106,108917605110,4,2535,1143,-40
108920983339,108920983345,6,2894,1454,-40
108924445825,108924445827,2,1784,1069,-40
108930728852,108930728858,6,2860,1295,-40
108932577467,108932577470,3,1917,2128,-40
108933486377,108933486383,6,2585,1588,-40
108938158701,108938158707,6,3034,1316,-40
108938749638,108938749642,4,2754,921,-40
108939868312,108939868318,6,2557,1592,-40
108939919179,108939919187,8,1938,855,-40
108941446457,108941446463,6,1669,1032,-40
108943095282,108943095289,7,3524,1617,-40
108944928604,108944928610,6,2934,1280,-40
108945461352,108945461356,4,13203,8580,-40
108945825038,108945825043,5,4097,1305,-40
108948286293,108948286300,7,2860,1692,-40
108948835243,108948835231,-12,21857,19468,-40
108949258058,108949258065,7,2079,1193,-40
108952143685,108952143687,2,1665,954,-40
108959013961,108959013967,6,2988,1429,-40
108959522594,108959522602,8,2168,1051,-40
108961436032,108961436038,6,3870,1642,-40
108964868414,108964868422,8,1676,1215,-40
108965865850,108965865857,7,2637,1132,-40
108966475357,108966475337,-20,1707,1021,-40
108967003794,108967003800,6,4605,1434,-40
108967800424,108967800432,8,1476,1067,-40
108974160254,108974160262,8,3149,1357,-40
108976640134,108976640152,18,1630,198,-40
108978461342,108978461351,9,4079,1492,-40
108979841671,108979841678,7,4223,1403,-40
108989960574,108989960581,7,2076,1178,-40
108990957878,108990957883,5,2938,995,-40
108991095906,108991095911,5,2617,1184,-40
108992520750,108992520755,5,1500,811,-40
108992723054,108992723063,9,3074,1643,-40
108993086059,108993086063,4,2425,1137,-40
108995843344,108995843350,6,1864,1097,-40
108996333189,108996333196,7,2944,1095,-40
109001361448,109001361453,5,2994,1199,-40
109001488554,109001488562,8,2230,831,-40
109001599366,109001599372,6,2562,1575,-40
109002468736,109002468721,-15,1273,1232,-40
109005610315,109005610321,6,2922,1457,-40
109012922025,109012922033,8,2385,875,-40
109015489366,109015489372,6,4001,1868,-40
109016682390,109016682398,8,3713,1310,-40
109018970515,109018970522,7,5576,2894,-40
109021704190,109021704196,6,3406,1165,-40
109024263902,109024263907,5,3417,1446,-40
109033316270,109033316267,-3,1145,2800,-40
109034412244,109034412251,7,4219,1152,-40
109034878587,109034878594,7,2935,1281,-40
109042354338,109042354344,6,3020,1532,-40
109042786178,109042786184,6,3451,1730,-40
109045297261,109045297267,6,3805,1399,-40
109049129700,109049129707,7,3856,1457,-40
109049333450,109049333455,5,2743,1520,-40
109055622389,109055622396,7,3748,1396,-40
109057655708,109057655715,7,2062,1098,-40
109060822616,109060822622,6,3009,1229,-40
109063460164,109063460170,6,2380,1290,-40
109065151412,109065151418,6,2093,1269,-40
109069190050,109069190058,8,3154,1479,-40
109069222057,109069222062,5,1750,954,-40
109070280914,109070280919,5,1683,751,-40
109071610186,109071610190,4,1271,1266,-40
109077453061,109077453067,6,4014,1298,-40
109079613756,109079613762,6,2854,1056,-40
109082480658,109082480664,6,2185,980,-40
109087155613,109087155618,5,2688,943,-40
109090411346,109090411351,5,3259,1210,-40
109091733777,109091733782,5,2838,1694,-40
109092812019,109092812017,-2,3004,4818,-40
109093257014,109093257019,5,2646,958,-40
109095220784,109095220790,6,2275,1208,-40
109095961977,109095961984,7,3633,1004,-40
109097927630,109097927621,-9,16567,1819,-40
109100711269,109100711264,-5,1518,5098,-40
109106186085,109106186091,6,2540,1053,-40
109106498601,109106498608,7,2428,1453,-40
109109282776,109109282782,6,3099,1349,-40
109112863861,109112863866,5,2413,1344,-40
109120340382,109120340387,5,1950,1153,-40
109122684467,109122684470,3,1838,1247,-40
109123755411,109123755418,7,2638,1135,-40
109128214329,109128214334,5,1781,642,-40
109132540205,109132540213,8,1703,624,-40
109137067784,109137067790,6,1950,992,-40
109139535670,109139535671,1,1934,2882,-40
109140457676,109140457680,4,7367,5123,-40
109143114010,109143114008,-2,1130,2467,-40
109144058882,109144058889,7,2789,1237,-40
109155615951,109155615957,6,2423,1449,-40
109155924230,109155924235,5,983,243,-40
109157651712,109157651716,4,2830,1443,-40
109160967332,109160967338,6,2314,1109,-40
109167829522,109167829527,5,2103,980,-40
109170431361,109170431364,3,2067,1272,-40
109171055977,109171055985,8,2610,1208,-40
109173483244,109173483250,6,2774,1279,-40
109174438833,109174438839,6,2315,1110,-40
109181513270,109181513276,6,2628,1350,-40
109181541477,109181541482,5,1717,950,-40
109183293817,109183293825,8,3696,1760,-40
109187916952,109187916958,6,3145,1411,-40
109188828868,109188828875,7,3027,1183,-40
109189224771,109189224752,-19,1646,933,-40
109190002006,109190002013,7,2929,2007,-40
109190808877,109190808889,12,18427,24196,-40
109194972796,109194972803,7,1324,972,-40
109196810242,109196810248,6,2523,1380,-40
109196960877,109196960899,22,2118,1091,-40
109199991798,109199991803,5,2375,744,-40
109200828018,109200828026,8,3092,1472,-40
109201199023,109201199041,18,2306,1125,-40
109204262020,109204262040,20,1028,151,-40
109206001357,109206001362,5,3282,1860,-40
109208492444,109208492442,-2,1530,1747,-40
109210857467,109210857474,7,2992,1196,-40
109212015659,109212015642,-17,2642,1206,-40
109217873382,109217873386,4,2216,1808,-40
109218149192,109218149197,5,2397,1360,-40
109220174226,109220174230,4,2495,1383,-40
109220457891,109220457890,-1,675,1622,-40
109223822401,109223822406,5,3611,1394,-40
109224281890,109224281895,5,1393,1513,-40
109224515298,109224515304,6,3155,1099,-40
109225083355,109225083362,7,4724,1352,-40
109226854912,109226854918,6,2265,1299,-40
109232912350,109232912355,5,4528,32092,-40
109235376060,109235376066,6,2741,969,-40
109238345837,109238345843,6,2190,1127,-40
109242727979,109242727983,4,1905,882,-40
109246832881,109246832887,6,3541,1321,-40
109251041380,109251041387,7,3561,1365,-40
109254013758,109254013763,5,3054,1363,-40
109257070364,109257070370,6,2368,1225,-40
109260940648,109260940654,6,2678,1529,-40
109262408827,109262408834,7,2796,1168,-40
109264952028,109264952035,7,4250,1389,-40
109270811793,109270811798,5,2288,1186,-40
109275521833,109275521840,7,2684,1194,-40
109278412115,109278412121,6,3005,1172,-40
109287833439,109287833446,7,3962,1678,-40
109290695421,109290695425,4,2237,1311,-40
109293612937,109293612943,6,1861,1092,-40
109295069166,109295069174,8,3298,1478,-40
109295241543,109295241561,18,812,274,-40
109297026951,109297026958,7,2807,1523,-40
109297735294,109297735303,9,651,643,-40
109299123920,109299123914,-6,2254,8225,-40
109299664243,109299664250,7,2970,1637,-40
109299834962,109299834967,5,2073,870,-40
109300537270,109300537276,6,2187,971,-40
109302785502,109302785506,4,2837,1311,-40
109306826745,109306826753,8,3387,957,-40
109307715167,109307715174,7,2865,1232,-40
109308119754,109308119761,7,2702,1668,-40
109309634933,109309634937,4,2141,1383,-40
109310838247,109310838249,2,18214,21752,-40
109313440637,109313440641,4,2237,1631,-40
109314668646,109314668654,8,3441,1789,-40
109317375545,109317375551,6,2653,1476,-40
109317717622,109317717627,5,1673,951,-40
109317926444,109317926450,6,758,278,-40
109319564809,109319564814,5,2222,1730,-40
109320920197,109320920202,5,3329,1940,-40
109323915648,109323915670,22,343,2153,-40
109329389118,109329389122,4,2760,1562,-40
109329931153,109329931158,5,2429,1223,-40
109330289289,109330289305,16,827,57,-40
109336104007,109336104014,7,2954,1415,-40
109342266081,109342266088,7,3329,1752,-40
109343895311,109343895317,6,3333,1736,-40
109349002193,109349002198,5,2993,1828,-40
109351427094,109351427099,5,1567,1157,-40
109351488915,109351488915,0,1305,2867,-40
109352231698,109352231705,7,2594,1293,-40
109359269642,109359269647,5,3383,1236,-40
109360647958,109360647959,1,25758,17688,-40
109363779122,109363779127,5,2358,1040,-40
109365681562,109365681568,6,2985,1558,-40
109372107530,109372107535,5,2821,1109,-40
109372152050,109372152053,3,1684,1174,-40
109374311927,109374311932,5,1285,1000,-40
109382320421,109382320428,7,3914,1939,-40
109385565093,109385565101,8,2847,1199,-40
109387547337,109387547341,4,2275,1678,-40
109392336986,109392336994,8,2658,1083,-40
109392443686,109392443676,-10,3335,1033,-40
109398345936,109398345942,6,2675,1651,-40
109398947852,109398947836,-16,1889,797,-40
109400457481,109400457487,6,2514,972,-40
109406885830,109406885835,5,3579,1362,-40
109407436517,109407436523,6,3278,1307,-40
109407980646,109407980624,-22,986,403,-40
109408537354,109408537361,7,3145,1011,-40
109410509263,109410509270,7,3361,1016,-40
109414524445,109414524451,6,1320,863,-40
109414863945,109414863950,5,2762,1640,-40
109415191439,109415191446,7,2973,1002,-40
109416010245,109416010251,6,2128,1081,-40
109420888070,109420888078,8,2907,1116,-40
109421025904,109421025908,4,1094,1424,-40
109424617761,109424617768,7,4179,1845,-40
109425910095,109425910102,7,2132,1090,-40
109426720077,109426720086,9,1827,938,-40
109429979355,109429979362,7,2909,1276,-40
109430041469,109430041450,-19,883,401,-40
109432030962,109432030969,7,3700,1363,-40
109434365633,109434365639,6,2252,1162,-40
109437475177,109437475182,5,1706,1516,-40
109438522326,109438522330,4,11406,6043,-40
109441019378,109441019385,7,3994,1809,-40
109443774126,109443774134,8,2766,1100,-40
109453670709,109453670714,5,1535,860,-40
109454834516,109454834523,7,2214,1099,-40
109456923607,109456923610,3,2592,1217,-40
109457152036,109457152043,7,3507,1697,-40
109457309921,109457309926,5,2713,1061,-40
109461949193,109461949198,5,2481,1033,-40
109463094358,109463094364,6,2635,1062,-40
109463659201,109463659205,4,2162,884,-40
109463889689,109463889676,-13,949,191,-40
109464201687,109464201668,-19,3561,1368,-40
109466700301,109466700307,6,2545,1234,-40
109469732746,109469732754,8,3853,1558,-40
109473049241,109473049247,6,3013,993,-40
109474787722,109474787727,5,2326,1214,-40
109476957681,109476957686,5,3136,1319,-40
109477067931,109477067914,-17,2148,2022,-40
109477986351,109477986353,2,2017,1740,-40
109481074383,109481074389,6,1926,888,-40
109483510056,109483510062,6,2288,1328,-40
109484510408,109484510407,-1,2420,4627,-40
109490011298,109490011298,0,1189,1808,-40
109492478805,109492478809,4,2194,1047,-40
109492637357,109492637377,20,2642,1317,-40
109493576001,109493576007,6,4325,1558,-40
109495029692,109495029698,6,3934,1639,-40
109496916595,109496916603,8,3137,1107,-40
109497317066,109497317062,-4,820,2121,-40
109498977914,109498977919,5,2269,687,-40
109501406060,109501406066,6,2363,1047,-40
109501455917,109501455923,6,2948,1721,-40
109512828944,109512828948,4,29008,23297,-40
109514665946,109514665953,7,3110,1130,-40
109518499353,109518499361,8,4107,1960,-40
109521212286,109521212291,5,2165,830,-40
109521407378,109521407386,8,1168,33,-40
109523307221,109523307225,4,2206,1151,-40
109528448529,109528448534,5,1125,756,-40
109529056015,109529055993,-22,3594,1605,-40
109529980870,109529980876,6,2873,961,-40
109530500406,109530500414,8,3209,1386,-40
109530831127,109530831106,-21,3661,1572,-40
109532294022,109532294029,7,3756,1747,-40
109533053945,109533053928,-17,735,366,-40
109534226143,109534226150,7,5902,2929,-40
109534839185,109534839181,-4,1682,3146,-40
109538229879,109538229883,4,1921,1173,-40
109540330314,109540330322,8,3100,1203,-40
109542002569,109542002575,6,2619,1365,-40
109543398891,109543398898,7,5542,1359,-40
109546509358,109546509364,6,2675,1018,-40
109551834348,109551834356,8,2784,1091,-40
109551991293,109551991299,6,2143,759,-40
109553674947,109553674946,-1,1670,2617,-40
109558213691,109558213690,-1,1120,1495,-40
109561079614,109561079614,0,1705,1847,-40
109563277112,109563277119,7,3080,1203,-40
109564431891,109564431897,6,3215,1162,-40
109565531190,109565531170,-20,2122,1109,-40
109567000689,109567000697,8,3036,1408,-40
109567205589,109567205594,5,3321,1189,-40
109568571230,109568571235,5,1418,671,-40
109570647115,109570647106,-9,1530,32326,-40
109573917777,109573917783,6,34298,12831,-40
109575135869,109575135875,6,2830,1122,-40
109578219947,109578219953,6,2485,1090,-40
109578731527,109578731531,4,1921,1516,-40
109579589313,109579589321,8,3385,1308,-40
109580770557,109580770564,7,2723,1193,-40
109582045640,109582045646,6,3430,1449,-40
109587167804,109587167810,6,3301,1347,-40
109587729279,109587729290,11,1259,64,-40
109591379956,109591379961,5,2637,1551,-40
109599273503,109599273510,7,2239,1061,-40
109601071528,109601071521,-7,682,3165,-40
109605004777,109605004782,5,3206,1102,-40
109609526138,109609526145,7,3807,1380,-40
109611766232,109611766239,7,3101,1425,-40
109613744801,109613744803,2,2156,1522,-40
109614102827,109614102831,4,1918,1368,-40
109616264028,109616264033,5,2139,1194,-40
109618109346,109618109351,5,2348,988,-40
109621956866,109621956875,9,2007,832,-40
109623337979,109623337986,7,3208,1319,-40
109623758075,109623758074,-1,2576,4714,-40
109624608702,109624608710,8,3059,1045,-40
109624782300,109624782306,6,2754,1402,-40
109625789731,109625789710,-21,950,523,-40
109630894666,109630894674,8,4458,3087,-40
109634888238,109634888245,7,2346,1129,-40
109636591234,109636591238,4,2552,1535,-40
109637060911,109637060913,2,215,3240,-40
109639956625,109639956642,17,333,803,-40
109642828619,109642828621,2,2449,1554,-40
109645036304,109645036309,5,2290,1139,-40
109645166669,109645166649,-20,1133,609,-40
109645997495,109645997500,5,3315,1430,-40
109648415121,109648415126,5,3152,1081,-40
109650626885,109650626886,1,2047,2668,-40
109651459166,109651459172,6,3322,979,-40
109654641032,109654641026,-6,2297,7110,-40
109658370526,109658370533,7,2407,910,-40
109662324607,109662324615,8,3741,1111,-40
109662649737,109662649743,6,3898,1812,-40
109663849174,109663849180,6,3272,1564,-40
109664186666,109664186671,5,4773,948,-40
109666690529,109666690535,6,2672,988,-40
109667077144,109667077150,6,3462,1734,-40
109668224861,109668224866,5,3026,1388,-40
109669170066,109669170060,-6,36646,17554,-40
109669900662,109669900667,5,2305,1499,-40
109670608540,109670608546,6,2416,1135,-40
109672466191,109672466197,6,2959,1120,-40
109675214738,109675214744,6,3696,1354,-40
109675697365,109675697361,-4,1264,4673,-40
109678246817,109678246823,6,2301,1174,-40
109680101578,109680101585,7,2711,1437,-40
109682704506,109682704509,3,1166,754,-40
109686958305,109686958310,5,3150,1536,-40
109688944923,109688944930,7,2749,1123,-40
109692144714,109692144721,7,2461,1565,-40
109693725610,109693725615,5,2555,1528,-40
109694883814,109694883819,5,4115,1618,-40
109696591851,109696591858,7,3050,1480,-40
109698918642,109698918647,5,3027,1277,-40
109699743062,109699743069,7,2796,1125,-40
109705443441,109705443447,6,2375,1214,-40
109708197970,109708197977,7,2087,1129,-40
109708477078,109708477076,-2,2143,3875,-40
109714011305,109714011313,8,3092,937,-40
109714304637,109714304620,-17,1982,818,-40
109715513718,109715513725,7,2419,1331,-40
109716126753,109716126756,3,1735,1485,-40
109717135766,109717135784,18,3078,1448,-40
109718631885,109718631888,3,2276,1684,-40
109719919990,109719919996,6,3170,1152,-40
109721109737,109721109729,-8,937,3912,-40
109721990852,109721990838,-14,1363,618,-40
109727807701,109727807705,4,2750,1515,-40
109729715265,109729715270,5,2782,986,-40
109733720062,109733720063,1,1468,1296,-40
109735030586,109735030591,5,2836,1070,-40
109736081008,109736081011,3,2049,972,-40
109738557435,109738557443,8,2432,1033,-40
109740068161,109740068167,6,2818,1138,-40
109740959937,109740959943,6,2824,1405,-40
109741281941,109741281946,5,1892,950,-40
109742521933,109742521942,9,6887,1292,-40
109746644133,109746644140,7,2639,1478,-40
109746777107,109746777113,6,3285,1106,-40
109747043462,109747043443,-19,1145,202,-40
109750073497,109750073502,5,2314,997,-40
109750709973,109750709979,6,1823,826,-40
109755624405,109755624410,5,2466,1124,-40
109760419813,109760419820,7,2301,1252,-40
109761724521,109761724526,5,2024,925,-40
109763563233,109763563239,6,3153,1233,-40
109763823149,109763823130,-19,1418,449,-40
109765388081,109765388086,5,3218,1731,-40
109771337022,109771337026,4,1845,1669,-40
109783880579,109783880585,6,3381,1541,-40
109784011087,109784011075,-12,1225,718,-40
109784271141,109784271120,-21,2573,772,-40
109786165337,109786165343,6,1524,942,-40
109786603710,109786603715,5,2579,820,-40
109788309537,109788309542,5,4220,1506,-40
109788425371,109788425378,7,1745,715,-40
109790396145,109790396151,6,3172,1194,-40
109797361666,109797361671,5,3319,1839,-40
109801255711,109801255718,7,3136,1249,-40
109812083486,109812083492,6,2982,1853,-40
109812219726,109812219734,8,2639,1527,-40
109813380899,109813380906,7,3627,1638,-40
109819054521,109819054527,6,3000,820,-40
109824889930,109824889935,5,3003,1326,-40
109825987945,109825987951,6,2697,1356,-40
109828350577,109828350583,6,2108,1446,-40
109829377359,109829377365,6,3660,1928,-40
109829629065,109829629067,2,2414,1815,-40
109830160102,109830160106,4,2016,894,-40
109830763648,109830763636,-12,775,250,-40
109831416068,109831416074,6,2560,1262,-40
109834646262,109834646267,5,3257,1509,-40
109834989093,109834989097,4,3208,1442,-40
109840197784,109840197791,7,2844,813,-40
109842402478,109842402483,5,3258,1116,-40
109844496317,109844496318,1,1555,995,-40
109851025634,109851025641,7,3327,1340,-40
109851111758,109851111766,8,2670,1140,-40
109853274197,109853274203,6,2792,1573,-40
109854454222,109854454229,7,2794,989,-40
109854695230,109854695211,-19,851,423,-40
109855417622,109855417628,6,2091,816,-40
109862685314,109862685320,6,2373,910,-40
109867451804,109867451812,8,2537,1612,-40
109868413837,109868413844,7,3942,1621,-40
109873282249,109873282254,5,2742,1326,-40
109877168359,109877168362,3,1555,1416,-40
109880385294,109880385299,5,4178,2123,-40
109882994865,109882994871,6,2038,935,-40
109883827705,109883827688,-17,3178,1628,-40
109884235262,109884235270,8,2799,850,-40
109885951246,109885951251,5,2933,1421,-40
109886428397,109886428403,6,1802,1127,-40
109886480557,109886480562,5,2300,1094,-40
109889147745,109889147754,9,2096,132,-40
109893815686,109893815692,6,1858,1036,-40
109894233906,109894233889,-17,2255,1049,-40
109895307937,109895307944,7,6733,2183,-40
109895813215,109895813220,5,3759,1392,-40
109898954599,109898954606,7,3127,1319,-40
109910952054,109910952061,7,2597,1229,-40
109912680410,109912680419,9,1124,569,-40
109915128214,109915128219,5,2236,1505,-40
109915266244,109915266250,6,3674,1438,-40
109915868546,109915868532,-14,1526,797,-40
109917092522,109917092527,5,2272,933,-40
109917636296,109917636305,9,3128,1246,-40
109919039058,109919039066,8,3132,1215,-40
109922293308,109922293312,4,1532,1097,-40
109923455877,109923455882,5,2797,978,-40
109930418490,109930418499,9,3014,1280,-40
109933034346,109933034351,5,2337,1271,-40
109933625936,109933625936,0,3015,4533,-40
109935325153,109935325134,-19,3562,1334,-40
109941908686,109941908691,5,3076,1227,-40
109945946191,109945946200,9,2690,1655,-40
109947047018,109947047027,9,2357,1060,-40
109948123265,109948123270,5,3241,1293,-40
109949499722,109949499729,7,3432,1103,-40
109955512025,109955512030,5,3480,1537,-40
109959456839,109959456846,7,1518,692,-40
109960444962,109960444947,-15,2554,930,-40
109962492085,109962492090,5,2543,872,-40
109967387822,109967387817,-5,1650,9075,-40
109969656447,109969656453,6,2816,1601,-40
109970488047,109970488048,1,1785,2234,-40
109974900679,109974900686,7,3355,1916,-40
109975277999,109975277988,-11,2082,1053,-40
109982612890,109982612896,6,2343,1460,-40
109983631414,109983631413,-1,2024,2382,-40
109993743984,109993743991,7,2619,1332,-40
109995569549,109995569554,5,2897,1220,-40
109995631854,109995631861,7,2096,638,-40
110000162390,110000162396,6,3623,1321,-40
110009595949,110009595955,6,3222,1604,-40
110016302863,110016302868,5,2774,1469,-40
110016836437,110016836443,6,3914,1443,-40
110020521842,110020521850,8,2207,1080,-40
110021599507,110021599514,7,2283,958,-40
110033953045,110033953035,-10,37271,14559,-40
110035797314,110035797318,4,2565,1308,-40
110039306893,110039306898,5,3178,1495,-40
110042677635,110042677642,7,2722,1250,-40
110047375708,110047375714,6,3963,1675,-40
110049377570,110049377576,6,2932,1366,-40
110049662434,110049662439,5,2321,1337,-40
110055905237,110055905242,5,2619,1002,-40
110056148716,110056148714,-2,2320,3959,-40
110063751361,110063751367,6,2811,1209,-40
110072123729,110072123735,6,2080,1286,-40
110074819522,110074819529,7,3680,1807,-40
110074960451,110074960432,-19,1679,598,-40
110076718285,110076718286,1,2117,3585,-40
110079207316,110079207320,4,1672,1462,-40
110079496014,110079496020,6,3457,1688,-40
110080790049,110080790053,4,1751,1145,-40
110081853578,110081853580,2,37396,41046,-40
110090550387,110090550394,7,3619,1499,-40
110094980745,110094980751,6,2879,1477,-40
110095410825,110095410831,6,3755,1488,-40
110096510826,110096510833,7,3095,1467,-40
110100907160,110100907167,7,2235,941,-40
110101478195,110101478202,7,1589,1134,-40
110108774911,110108774918,7,2660,1434,-40
110112240830,110112240826,-4,1109,2180,-40
110112699883,110112699889,6,2703,1141,-40
110113074697,110113074703,6,2343,1201,-40
110113768718,110113768704,-14,2587,885,-40
110118800715,110118800719,4,2451,1073,-40
110119348964,110119348945,-19,1233,598,-40
110122798941,110122798945,4,2409,1215,-40
110124361396,110124361402,6,2688,1458,-40
110125974635,110125974629,-6,888,5248,-40
110129895028,110129895035,7,2915,1778,-40
110131141994,110131142001,7,3083,1159,-40
110135195678,110135195683,5,2320,1256,-40
110136139124,110136139130,6,3718,1350,-40
110136292261,110136292275,14,2703,1232,-40
110137934123,110137934128,5,2115,1333,-40
110138589634,110138589638,4,2555,1147,-40
110138666378,110138666360,-18,2366,867,-40
110139221491,110139221497,6,3504,1684,-40
110139792058,110139792064,6,2558,1452,-40
110141254946,110141254950,4,2536,1252,-40
110142166075,110142166082,7,2945,1252,-40
110142997003,110142997009,6,2887,1902,-40
110144887396,110144887402,6,4663,1440,-40
110145719240,110145719246,6,3352,1799,-40
110146833954,110146833960,6,3281,1481,-40
110150386889,110150386895,6,2443,1107,-40
110152200583,110152200590,7,2910,1282,-40
110152604008,110152604015,7,3328,1181,-40
110152956838,110152956844,6,2878,1305,-40
110155032634,110155032629,-5,1469,4374,-40
110156500901,110156500907,6,3311,1407,-40
110157044438,110157044435,-3,703,145,-40
110159021498,110159021505,7,2215,1071,-40
110159454874,110159454878,4,2803,1441,-40
110161396683,110161396689,6,3369,1532,-40
110163839997,110163840003,6,4201,2102,-40
110164533477,110164533484,7,3392,1222,-40
110166596455,110166596455,0,1304,1614,-40
110168668841,110168668846,5,2791,1459,-40
110169545470,110169545477,7,3153,1310,-40
110176741384,110176741390,6,1990,1331,-40
110177300089,110177300086,-3,2627,50253,-40
110177336569,110177336574,5,2893,1154,-40
110190413930,110190413935,5,3395,1095,-40
110209895794,110209895808,14,1914,1546,-40
110212096650,110212096654,4,2955,1530,-40
110217372522,110217372527,5,2971,1510,-40
110219899454,110219899464,10,2465,1175,-40
110221160021,110221160027,6,2803,1287,-40
110222768946,110222768951,5,1725,859,-40
110222941435,110222941421,-14,176,1477,-40
110223054697,110223054703,6,2619,1485,-40
110223949696,110223949703,7,3552,1466,-40
110224851372,110224851378,6,4246,2000,-40
110227771297,110227771302,5,3207,1148,-40
110230356213,110230356219,6,1580,1131,-40
110230395298,110230395304,6,2634,995,-40
110232615106,110232615112,6,2687,1232,-40
110238101455,110238101462,7,2293,1091,-40
110242969006,110242969013,7,3096,1005,-40
110243702107,110243702110,3,1780,1153,-40
110246239633,110246239638,5,3467,1299,-40
110246338965,110246338969,4,2055,1535,-40
110246648942,110246648930,-12,2623,645,-40
110248756220,110248756222,2,1523,1365,-40
110248978826,110248978834,8,2455,972,-40
110260517438,110260517442,4,2579,1080,-40
110264532588,110264532593,5,2860,1120,-40
110265147175,110265147182,7,2974,1493,-40
110267468263,110267468270,7,3045,1378,-40
110267515088,110267515094,6,2133,1161,-40
110268530590,110268530596,6,4224,1850,-40
110274400603,110274400610,7,2740,1184,-40
110277294141,110277294145,4,1967,1634,-40
110283495816,110283495822,6,3115,1629,-40
110286399962,110286399968,6,3433,1726,-40
110289426174,110289426178,4,1890,1511,-40
110290132197,110290132204,7,2675,1005,-40
110297551095,110297551100,5,3144,1505,-40
110298942426,110298942431,5,3008,1269,-40
110301372985,110301372991,6,2220,1139,-40
110308398665,110308398671,6,3514,1302,-40
110313153123,110313153129,6,2420,1424,-40
110314793534,110314793539,5,3921,1297,-40
110316860396,110316860403,7,2812,929,-40
110318105772,110318105778,6,1931,1194,-40
110319374957,110319374962,5,2777,1699,-40
110324131853,110324131859,6,2016,848,-40
110327682417,110327682422,5,2627,993,-40
110327855353,110327855358,5,2176,1201,-40
110328742725,110328742707,-18,2134,784,-40
110335077246,110335077253,7,3413,1241,-40
110336455150,110336455141,-9,36330,15561,-40
110338625700,110338625706,6,3537,1836,-40
110339203498,110339203501,3,2154,1249,-40
110341295623,110341295630,7,2693,1184,-40
110342428131,110342428131,0,30319,21970,-40
110345716851,110345716858,7,4127,919,-40
110348905250,110348905256,6,3254,1043,-40
110349123593,110349123599,6,3044,710,-40
110355537346,110355537351,5,3239,1273,-40
110359882164,110359882167,3,1465,1777,-40
110359930924,110359930929,5,1452,694,-40
110360235952,110360235959,7,2027,1175,-40
110368095820,110368095827,7,2662,1570,-40
110368665624,110368665630,6,3720,1281,-40
110371039493,110371039501,8,1894,1281,-40
110373059607,110373059615,8,2558,1408,-40
110378392190,110378392191,1,48034,21214,-40
110379556970,110379556976,6,2130,1019,-40
110381252739,110381252746,7,2730,1381,-40
110382732521,110382732526,5,2623,1137,-40
110382906342,110382906353,11,3517,1383,-40
110383849476,110383849482,6,3914,1405,-40
110392822362,110392822348,-14,1782,590,-40
110394310012,110394310017,5,1907,852,-40
110399780718,110399780724,6,3460,965,-40
110410059893,110410059899,6,2613,1335,-40
110411495870,110411495866,-4,943,2200,-40
110412477297,110412477303,6,3078,1647,-40
110412806798,110412806805,7,2420,1400,-40
110413098074,110413098080,6,2501,1408,-40
110417981522,110417981527,5,2196,1883,-40
110420706903,110420706909,6,3044,1470,-40
110424146985,110424146991,6,2277,1051,-40
110428129831,110428129838,7,2870,1106,-40
110428854765,110428854770,5,2273,1047,-40
110430466607,110430466585,-22,1086,673,-40
110434507247,110434507255,8,2856,1385,-40
110435338105,110435338110,5,1443,1024,-40
110435718318,110435718323,5,2609,1357,-40
110438389495,110438389494,-1,34908,21391,-40
110438724409,110438724414,5,1684,1004,-40
110439699167,110439699175,8,3991,1296,-40
110443268033,110443268039,6,2181,902,-40
110447580294,110447580301,7,2460,1380,-40
110450883868,110450883875,7,2972,971,-40
110451678542,110451678547,5,2214,941,-40
110458525997,110458526003,6,3514,1326,-40
110458725214,110458725214,0,1663,1969,-40
110461639852,110461639859,7,3195,1221,-40
110464086726,110464086733,7,1820,1033,-40
110464314925,110464314922,-3,1295,2338,-40
110469333514,110469333518,4,3620,885,-40
110470631364,110470631371,7,2360,1331,-40
110471001238,110471001245,7,2652,998,-40
110472091218,110472091227,9,3583,1165,-40
110473924208,110473924214,6,2290,1005,-40
110476034407,110476034405,-2,2202,3186,-40
110478671205,110478671211,6,2832,1724,-40
110479992193,110479992197,4,2035,1416,-40
110483587857,110483587861,4,3036,1601,-40
110486839902,110486839909,7,2987,1433,-40
110491938334,110491938339,5,1924,1067,-40
110494191219,110494191225,6,1645,1030,-40
110496527303,110496527310,7,2961,1181,-40
110496593490,110496593474,-16,1826,739,-40
110500576226,110500576234,8,3110,982,-40
110501167609,110501167607,-2,829,1922,-40
110501448342,110501448346,4,2125,1294,-40
110501925865,110501925866,1,1652,1542,-40
110505831310,110505831318,8,2449,1362,-40
110506311774,110506311781,7,2440,954,-40
110507230702,110507230709,7,2973,1445,-40
110507353854,110507353858,4,2610,2588,-40
110508048500,110508048506,6,2763,1317,-40
110509128530,110509128529,-1,1114,1859,-40
110513407934,110513407915,-19,2505,849,-40
110515077988,110515077994,6,4149,1539,-40
110515744919,110515744925,6,3812,1099,-40
110516065009,110516065010,1,1071,112,-40
110516277789,110516277795,6,2535,1332,-40
110518046717,110518046723,6,2530,1136,-40
110521592622,110521592630,8,2858,1203,-40
110523129277,110523129283,6,3871,1613,-40
110524295523,110524295529,6,1575,1117,-40
110527847741,110527847747,6,2827,1283,-40
110530046407,110530046405,-2,970,1813,-40
110530160955,110530160962,7,3049,1139,-40
110535805162,110535805165,3,2580,1557,-40
110539874552,110539874558,6,3324,1376,-40
110542846747,110542846752,5,991,598,-40
110544728061,110544728066,5,2223,1234,-40
110545960356,110545960363,7,2843,1325,-40
110547396457,110547396461,4,3694,1706,-40
110549990399,110549990402,3,1845,1058,-40
110550097078,110550097085,7,2804,1363,-40
110552933452,110552933454,2,1902,1717,-40
110556522046,110556522053,7,2274,901,-40
110559295346,110559295355,9,865,399,-40
110561039765,110561039772,7,2531,1284,-40
110561461825,110561461830,5,3180,1181,-40
110561940481,110561940486,5,3375,1023,-40
110564976140,110564976147,7,2652,1466,-40
110567218588,110567218594,6,1958,831,-40
110572903103,110572903111,8,3253,1105,-40
110573247767,110573247770,3,1442,999,-40
110578252874,110578252881,7,2615,1533,-40
110579031781,110579031787,6,3323,1480,-40
110585263700,110585263706,6,3232,1355,-40
110587748388,110587748394,6,3452,1170,-40
110589711284,110589711291,7,2564,1171,-40
110591892491,110591892497,6,3737,1712,-40
110598090497,110598090502,5,3024,1311,-40
110600511325,110600511330,5,3023,1174,-40
110601557940,110601557946,6,2923,1177,-40
110602105701,110602105707,6,2702,1066,-40
110603623347,110603623336,-11,865,377,-40
110606983329,110606983320,-9,1129,305,-40
110611756712,110611756710,-2,1625,1958,-40
110615373399,110615373407,8,2133,1180,-40
110615606819,110615606826,7,2879,1353,-40
110617420833,110617420841,8,2962,1405,-40
110617714655,110617714674,19,2093,1167,-40
110620358254,110620358260,6,2758,872,-40
110621329818,110621329800,-18,2916,1298,-40
110622123569,110622123576,7,3058,1209,-40
110630866398,110630866390,-8,1525,5580,-40
110634414029,110634414044,15,13659,50843,-40
110634890654,110634890656,2,899,1230,-40
110635616004,110635616010,6,2733,1184,-40
110636614552,110636614559,7,4911,1759,-40
110641193882,110641193889,7,93181,51663,-40
110645142086,110645142090,4,2277,1145,-40
110645719489,110645719506,17,2014,1843,-40
110649634189,110649634194,5,2118,909,-40
110654229899,110654229906,7,3274,2182,-40
110654775189,110654775196,7,3190,1308,-40
110655584483,110655584490,7,3647,1427,-40
110657882674,110657882680,6,5932,1168,-40
110658025029,110658025034,5,3244,1102,-40
110658925949,110658925950,1,1582,1810,-40
110666319247,110666319253,6,2925,1158,-40
110668420271,110668420277,6,5285,1727,-40
110670154617,110670154621,4,2856,1573,-40
110675041685,110675041696,11,3769,1297,-40
110675234305,110675234298,-7,1136,280,-40
110678642605,110678642611,6,2445,1410,-40
110678952862,110678952869,7,3819,1542,-40
110683506330,110683506337,7,3162,788,-40
110683786193,110683786200,7,2538,1004,-40
110683862132,110683862114,-18,1123,974,-40
110691252588,110691252594,6,3079,1178,-40
110693117977,110693117981,4,2282,1270,-40
110694694899,110694694901,2,11281,12468,-40
110695687420,110695687426,6,3058,1151,-40
110707624582,110707624589,7,866,623,-40
110708015014,110708014995,-19,1700,708,-40
110712114501,110712114512,11,11550,44398,-40
110713837971,110713837978,7,3379,1084,-40
110713919333,110713919314,-19,2870,1332,-40
110714095241,110714095246,5,1935,826,-40
110717481544,110717481549,5,1943,1410,-40
110720444077,110720444081,4,3863,1418,-40
110721033115,110721033121,6,3857,1488,-40
110721159703,110721159723,20,907,181,-40
110723032365,110723032370,5,2158,1281,-40
110725043382,110725043388,6,3439,1515,-40
110725215067,110725215057,-10,634,64,-40
110729427608,110729427607,-1,1652,2474,-40
110729912914,110729912921,7,1651,428,-40
110730685205,110730685211,6,2071,1331,-40
110730846089,110730846095,6,2909,1383,-40
110737453186,110737453192,6,4196,1768,-40
110739666797,110739666801,4,4495,2847,-40
110742430846,110742430842,-4,1917,4959,-40
110746450497,110746450502,5,2758,1213,-40
110753071326,110753071321,-5,2251,7950,-40
110756512379,110756512387,8,4207,1434,-40
110759346617,110759346623,6,4274,1550,-40
110764570681,110764570686,5,2699,1200,-40
110770802901,110770802906,5,3717,1687,-40
110772643102,110772643107,5,2434,2072,-40
110772691127,110772691134,7,3106,1321,-40
110772815960,110772815960,0,2312,4215,-40
110773270255,110773270262,7,2979,1136,-40
110781025254,110781025260,6,1839,1108,-40
110783203489,110783203494,5,1983,1215,-40
110785044393,110785044400,7,2407,1131,-40
110788229938,110788229945,7,2689,1284,-40
110788345814,110788345792,-22,2036,1046,-40
110791202883,110791202887,4,2516,1268,-40
110793306126,110793306127,1,1850,2758,-40
110794495855,110794495862,7,3213,1158,-40
110794687392,110794687401,9,3044,1114,-40
110796207874,110796207877,3,1797,568,-40
110797470458,110797470463,5,1416,844,-40
110799170878,110799170886,8,3542,1750,-40
110799472658,110799472664,6,3537,1568,-40
110800579883,110800579890,7,4035,1409,-40
110803599038,110803599019,-19,2197,1293,-40
110809952225,110809952210,-15,1537,389,-40
110820384472,110820384474,2,1410,1495,-40
110820601426,110820601433,7,2696,1542,-40
110825078893,110825078898,5,4480,1720,-40
110826571797,110826571802,5,785,619,-40
110828098293,110828098290,-3,1537,2967,-40
110829705972,110829705978,6,3945,1488,-40
110833253237,110833253243,6,1616,759,-40
110840339712,110840339719,7,2420,1102,-40
110841010033,110841010038,5,2281,1071,-40
110841436682,110841436689,7,3715,1070,-40
110845312915,110845312920,5,2134,746,-40
110850932913,110850932920,7,2646,1008,-40
110853216579,110853216572,-7,1213,5120,-40
110855667721,110855667726,5,2953,1019,-40
110864595837,110864595845,8,2833,1610,-40
110867460753,110867460760,7,1883,1353,-40
110868625114,110868625118,4,3060,1156,-40
110871343294,110871343298,4,2220,999,-40
110871672431,110871672408,-23,797,413,-40
110871795417,110871795422,5,4545,1247,-40
110881477452,110881477459,7,1621,1072,-40
110881768101,110881768106,5,1764,1110,-40
110884285683,110884285690,7,3221,1106,-40
110888947207,110888947211,4,2814,1010,-40
110893505829,110893505835,6,3002,871,-40
110894085371,110894085372,1,1245,1848,-40
110896463460,110896463467,7,2790,864,-40
110900178284,110900178290,6,3086,1540,-40
110906025215,110906025213,-2,28821,61034,-40
110910188782,110910188786,4,1789,1083,-40
110911483185,110911483191,6,2118,1358,-40
110912708810,110912708817,7,3738,1270,-40
110913987031,110913987041,10,2798,1161,-40
110917324079,110917324085,6,3119,1474,-40
110923508320,110923508326,6,2587,1070,-40
110924797451,110924797457,6,3093,1082,-40
110926560735,110926560739,4,2564,1013,-40
110926927726,110926927734,8,3910,1638,-40
110928402757,110928402761,4,2101,1448,-40
110932000726,110932000734,8,2836,1358,-40
110935797741,110935797747,6,2754,1009,-40
110936925531,110936925537,6,2517,1480,-40
110938392409,110938392414,5,2758,1112,-40
110940588503,110940588510,7,2737,1170,-40
110947798118,110947798125,7,2828,958,-40
110948292849,110948292834,-15,1936,729,-40
110954523641,110954523646,5,3133,1586,-40
110956663623,110956663630,7,4271,1808,-40
110957090490,110957090498,8,2879,1569,-40
110957230935,110957230922,-13,2804,1111,-40
110962589345,110962589351,6,2045,1013,-40
110963744855,110963744859,4,2161,1429,-40
110964815627,110964815634,7,1994,865,-40
110965104483,110965104475,-8,1169,371,-40
110974761839,110974761843,4,1753,1422,-40
110976919418,110976919425,7,2732,1031,-40
110978899951,110978899928,-23,4425,1611,-40
110979654850,110979654867,17,4352,1077,-40
110979885912,110979885915,3,760,112,-40
110981253540,110981253545,5,2422,1097,-40
110982750605,110982750592,-13,3061,1021,-40
110985733757,110985733742,-15,3307,1750,-40
110987504061,110987504065,4,2616,1483,-40
110989133685,110989133691,6,3008,1432,-40
110989371667,110989371649,-18,1451,754,-40
110989557063,110989557069,6,2835,1303,-40
110994516613,110994516619,6,3308,1326,-40
110995126619,110995126627,8,3564,1436,-40
111002302514,111002302521,7,3194,1321,-40
111003541287,111003541293,6,2487,1292,-40
111004122191,111004122197,6,3784,1510,-40
111004325854,111004325862,8,2765,1384,-40
111004498881,111004498886,5,3465,1282,-40
111007436312,111007436318,6,3699,1231,-40
111008523090,111008523094,4,1780,910,-40
111008783119,111008783130,11,754,173,-40
111013746701,111013746707,6,5286,2218,-40
111013937076,111013937076,0,22384,21130,-40
111014237618,111014237623,5,3321,1415,-40
111018970189,111018970194,5,3186,963,-40
111019795332,111019795337,5,2512,711,-40
111020012246,111020012227,-19,1614,556,-40
111023361005,111023361010,5,2369,1384,-40
111028435967,111028435973,6,2440,1122,-40
111029057401,111029057406,5,2657,1523,-40
111029327437,111029327443,6,4315,933,-40
111031263536,111031263543,7,4250,1278,-40
111039445445,111039445451,6,1631,846,-40
111044170824,111044170831,7,2049,975,-40
111044223984,111044223990,6,2483,1170,-40
111046121052,111046121058,6,3303,808,-40
111047866922,111047866925,3,1727,972,-40
111048977831,111048977837,6,5221,2531,-40
111051535617,111051535622,5,3088,970,-40
111052053005,111052053010,5,2720,862,-40
111053244777,111053244786,9,3010,1326,-40
111054685203,111054685211,8,2851,1322,-40
111055444744,111055444750,6,2923,1803,-40
111056642959,111056642963,4,2435,1725,-40
111058292280,111058292287,7,2072,834,-40
111059044579,111059044584,5,2848,1180,-40
111059322175,111059322171,-4,2570,5750,-40
111060080778,111060080783,5,3410,1645,-40
111061262505,111061262511,6,3891,1440,-40
111061907265,111061907269,4,3062,1740,-40
111062419431,111062419434,3,2100,1637,-40
111069383263,111069383271,8,3055,1407,-40
111069871297,111069871303,6,3006,1184,-40
111070520617,111070520614,-3,583,1510,-40
111074138577,111074138584,7,3863,1835,-40
111077523426,111077523433,7,2564,1066,-40
111078256294,111078256277,-17,2468,803,-40
111078525073,111078525079,6,2699,1233,-40
111081713582,111081713587,5,3769,1589,-40
111082000658,111082000664,6,5331,2134,-40
111087803809,111087803805,-4,1350,3470,-40
111089381613,111089381619,6,3114,1325,-40
111089439271,111089439290,19,1837,1352,-40
111092446128,111092446122,-6,2468,7803,-40
111096724740,111096724745,5,3399,1803,-40
111097753730,111097753736,6,2183,1196,-40
111100407596,111100407602,6,2476,1232,-40
111101413068,111101413074,6,2427,881,-40
111101483197,111101483177,-20,1278,205,-40
111106658231,111106658237,6,2540,1347,-40
111107805062,111107805070,8,1844,599,-40
111107973334,111107973338,4,1863,1116,-40
111111173066,111111173072,6,2582,1082,-40
111113593641,111113593645,4,3053,1392,-40
111113808535,111113808513,-22,1345,588,-40
111114090657,111114090663,6,2253,1123,-40
111115442840,111115442840,0,1856,2642,-40
111115662438,111115662416,-22,435,146,-40
111115779056,111115779073,17,2357,1624,-40
111116745835,111116745816,-19,807,378,-40
111116910106,111116910114,8,3118,1507,-40
111118422998,111118422991,-7,1627,7150,-40
111118946529,111118946535,6,2550,1133,-40
111122444889,111122444894,5,2107,1387,-40
111126083892,111126083899,7,5555,1760,-40
111127783810,111127783790,-20,1217,651,-40
111133614775,111133614777,2,2238,1334,-40
111135857010,111135857016,6,2541,1112,-40
111142149049,111142149054,5,2702,1093,-40
111144246581,111144246587,6,2229,989,-40
111148138032,111148138039,7,2684,1275,-40
111151774388,111151774394,6,2900,1368,-40
111153939971,111153939978,7,3489,1434,-40
111155758177,111155758185,8,2558,1060,-40
111157828447,111157828454,7,2332,1229,-40
111158587083,111158587090,7,3263,1243,-40
111161689424,111161689430,6,2820,1704,-40
111162027186,111162027190,4,2737,1758,-40
111162949018,111162949022,4,1903,1376,-40
111166653918,111166653926,8,4464,1574,-40
111166721406,111166721411,5,2668,1048,-40
111171112650,111171112654,4,1191,638,-40
111173431142,111173431150,8,2188,895,-40
111183234508,111183234514,6,3770,1499,-40
111186480423,111186480430,7,2419,978,-40
111186786259,111186786265,6,2629,1636,-40
111188746190,111188746199,9,2020,1056,-40
111193678306,111193678311,5,2706,1177,-40
111195768789,111195768795,6,1894,932,-40
111200540806,111200540813,7,4341,1662,-40
111202431659,111202431663,4,928,311,-40
111202636956,111202636963,7,3263,1258,-40
111206190383,111206190394,11,10398,31775,-40
111207059155,111207059162,7,3057,997,-40
111211672654,111211672662,8,2328,1003,-40
111212057081,111212057068,-13,1757,721,-40
111215359046,111215359051,5,1262,1162,-40
111218610121,111218610129,8,2011,845,-40
111224242101,111224242107,6,3002,1098,-40
111224515673,111224515678,5,2325,1126,-40
111226934280,111226934288,8,3060,1176,-40
111227762942,111227762947,5,3138,1573,-40
111228917153,111228917159,6,2162,973,-40
111236543505,111236543510,5,2095,1496,-40
111237124599,111237124606,7,3721,1311,-40
111239012868,111239012874,6,3144,1303,-40
111240099685,111240099692,7,3490,1407,-40
111246127450,111246127456,6,2872,1633,-40
111250518798,111250518805,7,2270,1228,-40
111255780322,111255780322,0,1355,1793,-40
111258184957,111258184963,6,1049,951,-40
111262424358,111262424363,5,2869,1740,-40
111262782667,111262782675,8,2593,1185,-40
111264197341,111264197346,5,2105,1308,-40
111269012743,111269012750,7,2925,1153,-40
111272635566,111272635569,3,1828,1025,-40
111273132021,111273132018,-3,1706,3491,-40
111275859203,111275859208,5,2220,1101,-40
111278699871,111278699865,-6,2639,11997,-40
111285327994,111285328003,9,3149,1230,-40
111287510266,111287510272,6,2933,1331,-40
111290237687,111290237691,4,1602,1012,-40
111295091395,111295091402,7,2384,1124,-40
111295369818,111295369827,9,1729,1547,-40
111296756142,111296756148,6,2977,1223,-40
111300835461,111300835467,6,2598,1136,-40
111301412230,111301412223,-7,1309,6010,-40
111301699038,111301699044,6,2708,1387,-40
111302968238,111302968244,6,3009,1078,-40
111306947982,111306947986,4,1372,1270,-40
111308000053,111308000057,4,2782,1063,-40
111308142073,111308142078,5,1889,945,-40
111310403391,111310403387,-4,1901,3463,-40
111311537033,111311537038,5,2312,1103,-40
111312586205,111312586211,6,2001,1191,-40
111312884607,111312884601,-6,1028,259,-40
111319005722,111319005727,5,2574,1454,-40
111319624379,111319624386,7,1958,1290,-40
111320613741,111320613747,6,1947,1184,-40
111336971323,111336971330,7,3549,1279,-40
111338927354,111338927359,5,2392,1016,-40
111340901954,111340901962,8,6575,1294,-40
111340945414,111340945415,1,1491,2831,-40
111342173473,111342173477,4,2351,1045,-40
111342817429,111342817435,6,3411,1194,-40
111344672782,111344672787,5,2467,1127,-40
111348625125,111348625130,5,1998,936,-40
111352843929,111352843934,5,3009,2001,-40
111356867046,111356867052,6,2950,983,-40
111365296802,111365296809,7,2722,1159,-40
111368717454,111368717459,5,2287,1149,-40
111373432920,111373432925,5,2340,743,-40
111373931495,111373931492,-3,2488,5954,-40
111378375695,111378375702,7,3092,1228,-40
111381283176,111381283181,5,4439,1599,-40
111383558870,111383558876,6,3987,1723,-40
111391180203,111391180206,3,2148,1144,-40
111394825260,111394825267,7,887,690,-40
111396908358,111396908379,21,3575,1161,-40
111398427001,111398427006,5,2198,804,-40
111400031962,111400031954,-8,736,334,-40
111402276037,111402276042,5,2070,1066,-40
111404640547,111404640554,7,2744,1141,-40
111404862212,111404862193,-19,3872,1736,-40
111407693799,111407693803,4,1902,1303,-40
111407961058,111407961044,-14,2393,1295,-40
111408894683,111408894689,6,2245,1151,-40
111409131980,111409131986,6,3771,1365,-40
111409797270,111409797276,6,3488,1143,-40
111410034845,111410034851,6,2889,1213,-40
111410729014,111410729022,8,3661,1499,-40
111412320240,111412320246,6,2606,1182,-40
111412774420,111412774440,20,2848,1305,-40
111413115715,111413115714,-1,1329,2125,-40
111420161516,111420161517,1,1975,1999,-40
111421358508,111421358515,7,3485,1050,-40
111427092934,111427092941,7,3510,1443,-40
111431903030,111431903035,5,2381,987,-40
111432022642,111432022646,4,2074,1684,-40
111433572304,111433572310,6,3916,2098,-40
111434874645,111434874651,6,3433,1256,-40
111437206467,111437206473,6,2311,1246,-40
111439212356,111439212362,6,3228,1365,-40
111441471753,111441471758,5,2573,954,-40
111447127538,111447127539,1,1970,1928,-40
111447733077,111447733083,6,2150,1111,-40
111448416330,111448416335,5,2630,920,-40
111453949560,111453949566,6,2738,1555,-40
111457801394,111457801398,4,2732,1145,-40
111458338074,111458338056,-18,2748,1038,-40
111460015861,111460015868,7,2447,765,-40
111462964145,111462964151,6,2020,1304,-40
111463489636,111463489634,-2,1217,1829,-40
111463585716,111463585722,6,3339,1390,-40
111464423814,111464423822,8,3058,1353,-40
111465572838,111465572844,6,3299,1576,-40
111466167380,111466167394,14,1932,960,-40
111468660361,111468660367,6,2332,1372,-40
111469367438,111469367443,5,2758,996,-40
111472724878,111472724885,7,2093,1247,-40
111477766553,111477766559,6,2850,987,-40
111480521658,111480521665,7,1732,1049,-40
111481688851,111481688857,6,2640,1305,-40
111482198328,111482198335,7,3166,1581,-40
111482868041,111482868048,7,2622,974,-40
111489652551,111489652557,6,3027,1280,-40
111495783345,111495783350,5,2695,1250,-40
111495932860,111495932866,6,3996,1189,-40
111496606157,111496606138,-19,854,150,-40
111504172883,111504172890,7,2355,1241,-40
111509991953,111509991963,10,1996,594,-40
111511491104,111511491112,8,3305,1300,-40
111520410630,111520410635,5,966,429,-40
111526470769,111526470775,6,3852,1295,-40
111527788037,111527788042,5,3308,1605,-40
111529615280,111529615285,5,2560,1452,-40
111532911899,111532911905,6,3263,1254,-40
111533171080,111533171086,6,3965,1388,-40
111534462593,111534462598,5,2725,1120,-40
111534711898,111534711884,-14,1272,484,-40
111535004641,111535004647,6,3477,1704,-40
111537548310,111537548315,5,2644,1097,-40
111538353730,111538353738,8,2190,823,-40
111538707971,111538707954,-17,2422,1049,-40
111541213510,111541213515,5,2091,1010,-40
111542083332,111542083339,7,2733,953,-40
111544318850,111544318844,-6,1553,5931,-40
111548404238,111548404243,5,1918,1532,-40
111549045132,111549045135,3,1801,1286,-40
111553843417,111553843422,5,2961,1033,-40
111554640442,111554640447,5,2556,1244,-40
111556723133,111556723139,6,4470,1716,-40
111557313365,111557313369,4,2265,808,-40
111560446321,111560446326,5,2130,1450,-40
111561564815,111561564821,6,3072,1458,-40
111562080789,111562080796,7,3655,1519,-40
111562209047,111562209053,6,3179,1609,-40
111563146059,111563146067,8,2060,1347,-40
111563783370,111563783375,5,2876,1437,-40
111565633057,111565633063,6,1995,988,-40
111568516034,111568516040,6,2106,1283,-40
111570722094,111570722102,8,2582,1293,-40
111576127794,111576127799,5,2714,1124,-40
111576181642,111576181625,-17,1993,961,-40
111586572957,111586572962,5,865,462,-40
111587480014,111587479995,-19,1130,287,-40
111596124877,111596124858,-19,1479,778,-40
111596421815,111596421820,5,2185,904,-40
111597929355,111597929358,3,174,1372,-40
111599045857,111599045863,6,3290,830,-40
111599241150,111599241152,2,1633,1829,-40
111599290233,111599290239,6,2747,1804,-40
111603033782,111603033774,-8,23200,15362,-40
111603344504,111603344510,6,2966,1513,-40
111606002838,111606002843,5,4160,1427,-40
111608369806,111608369813,7,2287,1436,-40
111612421078,111612421084,6,2817,1263,-40
111612465474,111612465460,-14,2432,825,-40
111616172707,111616172714,7,2680,1162,-40
111619285317,111619285317,0,1780,1953,-40
111630571394,111630571402,8,2395,932,-40
111634507871,111634507877,6,3069,1506,-40
111634534454,111634534461,7,2821,1080,-40
111636790383,111636790390,7,2527,950,-40
111637314117,111637314138,21,5377,1817,-40
111637825414,111637825421,7,2680,1356,-40
111639381656,111639381662,6,2016,1121,-40
111641048768,111641048773,5,3201,1286,-40
111642489168,111642489174,6,2593,1252,-40
111642791942,111642791949,7,2363,1311,-40
111645819257,111645819237,-20,1145,1382,-40
111647571690,111647571694,4,2481,1415,-40
111651951197,111651951203,6,1958,1099,-40
111656109797,111656109803,6,2442,870,-40
111657201023,111657201008,-15,1483,258,-40
111658618294,111658618302,8,3301,1300,-40
111660538747,111660538755,8,3207,1526,-40
111661642398,111661642404,6,3106,1106,-40
111661904524,111661904504,-20,2147,561,-40
111666205865,111666205858,-7,1384,4079,-40
111666429057,111666429064,7,3089,1432,-40
111673173286,111673173292,6,2786,1068,-40
111673968629,111673968625,-4,1127,2768,-40
111675662906,111675662913,7,4551,1761,-40
111677099684,111677099690,6,2339,941,-40
111679440057,111679440062,5,3367,1328,-40
111679653415,111679653395,-20,2454,603,-40
111685706848,111685706846,-2,53511,21839,-40
111686160378,111686160384,6,2240,1258,-40
111687021246,111687021243,-3,1383,2479,-40
111691276431,111691276438,7,3126,1042,-40
111691498541,111691498552,11,2948,1070,-40
111693747933,111693747942,9,2575,1329,-40
111694612917,111694612922,5,2519,1587,-40
111699746002,111699746008,6,1679,796,-40
111700189670,111700189649,-21,1860,1235,-40
111702063817,111702063833,16,149,1951,-40
111704927247,111704927264,17,27368,23711,-40
111706834830,111706834830,0,1513,2149,-40
111707061742,111707061747,5,2701,1300,-40
111707550945,111707550940,-5,581,168,-40
111710375972,111710375977,5,3022,1396,-40
111712018166,111712018171,5,4164,1624,-40
111712423342,111712423346,4,1762,1369,-40
111713533367,111713533374,7,2713,1490,-40
111720632676,111720632683,7,2870,1126,-40
111727011817,111727011826,9,3284,1261,-40
111727391021,111727391000,-21,1205,311,-40
111730278936,111730278942,6,1665,779,-40
111731839449,111731839455,6,1913,872,-40
111732546750,111732546755,5,3365,1254,-40
111735692726,111735692730,4,3466,1823,-40
111738723081,111738723085,4,1959,1217,-40
111739705134,111739705139,5,2543,1411,-40
111740478471,111740478479,8,2422,1337,-40
111740645345,111740645353,8,3153,1422,-40
111740708363,111740708353,-10,982,253,-40
111743270551,111743270556,5,1990,1140,-40
111743878646,111743878651,5,2272,1031,-40
111747471054,111747471060,6,3291,1033,-40
111748106122,111748106126,4,1518,960,-40
111759068277,111759068283,6,2513,1514,-40
111759728106,111759728113,7,2920,1215,-40
111776845611,111776845616,5,1915,1008,-40
111779038495,111779038502,7,2369,1164,-40
111779403387,111779403372,-15,669,479,-40
111780198948,111780198953,5,2425,1173,-40
111781290120,111781290126,6,3458,1561,-40
111784255306,111784255314,8,2488,1142,-40
111787336798,111787336804,6,3134,1176,-40
111787460866,111787460871,5,2441,930,-40
111788978807,111788978813,6,2814,1049,-40
111789872837,111789872831,-6,2034,8782,-40
111791167811,111791167818,7,3242,1391,-40
111792659622,111792659630,8,2829,1460,-40
111792755343,111792755360,17,3573,1606,-40
111792854742,111792854744,2,1169,66,-40
111793685853,111793685858,5,1509,1114,-40
111796423941,111796423948,7,2756,1654,-40
111804763638,111804763645,7,3018,1789,-40
111806221495,111806221502,7,2278,723,-40
111806424712,111806424709,-3,1622,3021,-40
111809125534,111809125542,8,2976,1007,-40
111809676782,111809676793,11,771,275,-40
111810122951,111810122956,5,2440,1063,-40
111816461461,111816461466,5,2363,1035,-40
111818480269,111818480273,4,2073,917,-40
111819202563,111819202569,6,3481,1786,-40
111820463122,111820463107,-15,1308,494,-40
111829105762,111829105767,5,3211,1235,-40
111829650997,111829651003,6,3303,2096,-40
111832189466,111832189473,7,3588,1613,-40
111833498757,111833498762,5,1482,1110,-40
111839843578,111839843583,5,2646,1379,-40
111845423662,111845423667,5,2219,1198,-40
111846013004,111846013010,6,2409,1218,-40
111847420657,111847420662,5,2956,1207,-40
111847570312,111847570296,-16,888,574,-40
111848658926,111848658934,8,3006,959,-40
111849407181,111849407177,-4,1488,3876,-40
111852883523,111852883530,7,2376,1256,-40
111858796477,111858796483,6,3642,1634,-40
111862705614,111862705621,7,2964,688,-40
111867874699,111867874705,6,873,229,-40
111871897405,111871897411,6,1895,776,-40
111873662889,111873662893,4,3090,1764,-40
111874701529,111874701535,6,2671,1357,-40
111876654101,111876654107,6,2040,949,-40
111878188297,111878188304,7,2651,889,-40
111881442162,111881442167,5,3107,1534,-40
111884016062,111884016070,8,1976,1049,-40
111885936338,111885936342,4,1982,1046,-40
111888599815,111888599821,6,3229,1006,-40
111888898743,111888898749,6,2754,1616,-40
111890183572,111890183578,6,1806,871,-40
111890481317,111890481322,5,2005,1198,-40
111891173812,111891173817,5,2191,1221,-40
111893692142,111893692147,5,2462,922,-40
111900965054,111900965061,7,3677,1349,-40
111903412379,111903412379,0,1012,1217,-40
111905544688,111905544690,2,1606,1956,-40
111907974301,111907974306,5,2382,1752,-40
111909533431,111909533437,6,2376,1000,-40
111909798839,111909798842,3,2645,2852,-40
111918057749,111918057754,5,1411,776,-40
111919727023,111919727030,7,3153,1177,-40
111923582029,111923582035,6,1658,1046,-40
111924114993,111924114999,6,2851,1516,-40
111925198315,111925198322,7,3964,1940,-40
111927457473,111927457479,6,1900,903,-40
111929104034,111929104041,7,4388,1517,-40
111930361018,111930361023,5,2964,1406,-40
111932538658,111932538662,4,2466,803,-40
111933780306,111933780320,14,13235,54065,-40
111934612108,111934612114,6,3115,1623,-40
111935620856,111935620858,2,2058,1638,-40
111937555366,111937555361,-5,1673,4204,-40
111943476880,111943476886,6,2972,1278,-40
111948660045,111948660053,8,2575,1031,-40
111952544854,111952544860,6,3178,1097,-40
111952860446,111952860451,5,2293,1063,-40
111953200858,111953200863,5,1632,893,-40
111955153598,111955153605,7,2517,1009,-40
111955203054,111955203066,12,1829,225,-40
111955275618,111955275620,2,1529,970,-40
111961852782,111961852785,3,1509,1573,-40
111967417317,111967417324,7,3330,1337,-40
111971268944,111971268953,9,1165,639,-40
111973502771,111973502777,6,2185,666,-40
111974237387,111974237394,7,2891,1059,-40
111976499204,111976499206,2,1917,1844,-40
111976935026,111976935033,7,2420,1150,-40
111979871097,111979871102,5,2827,1417,-40
111980255570,111980255555,-15,1207,566,-40
111991109209,111991109214,5,3249,1048,-40
111993195732,111993195731,-1,1226,2431,-40
111994955143,111994955149,6,2673,1054,-40
111995050087,111995050064,-23,2102,547,-40
111999685409,111999685413,4,1506,1315,-40
112007208161,112007208168,7,3532,1296,-40
112007812197,112007812203,6,3285,1122,-40
112008871781,112008871789,8,2796,1028,-40
112011719141,112011719141,0,1077,1257,-40
112013124038,112013124033,-5,1755,5784,-40
112017313886,112017313893,7,3208,1662,-40
112018779694,112018779701,7,3637,1813,-40
112020755890,112020755897,7,2667,1016,-40
112021328812,112021328819,7,2489,1229,-40
112032184207,112032184213,6,2857,1274,-40
112036361004,112036361010,6,3491,1554,-40
112039521010,112039521016,6,3001,1604,-40
112046761867,112046761871,4,1658,1233,-40
112049581074,112049581082,8,2298,1186,-40
112054003445,112054003446,1,1315,1192,-40
112057702219,112057702226,7,3066,1255,-40
112057730761,112057730767,6,17020,6719,-40
112058377202,112058377208,6,2622,920,-40
112058650038,112058650045,7,2963,836,-40
112058821623,112058821628,5,1509,940,-40
112063055821,112063055826,5,2132,1115,-40
112064303998,112064304006,8,2813,1085,-40
112068704457,112068704462,5,2561,1359,-40
112069757486,112069757493,7,3844,1348,-40
112071300633,112071300639,6,3090,1255,-40
112071978841,112071978849,8,1104,260,-40
112075877766,112075877774,8,2299,999,-40
112077989562,112077989565,3,1208,748,-40
112078406218,112078406202,-16,2527,1109,-40
112080792011,112080792010,-1,2168,3981,-40
112082171051,112082171058,7,2699,851,-40
112082299202,112082299195,-7,1115,464,-40
112083570045,112083570044,-1,11802,15337,-40
112090457661,112090457669,8,2250,1136,-40
112090823868,112090823881,13,2601,1389,-40
112096462266,112096462271,5,1909,1088,-40
112097064088,112097064094,6,2551,1261,-40
112104347845,112104347851,6,3182,1502,-40
112105070054,112105070055,1,1761,242,-40
112107197114,112107197119,5,3834,1283,-40
112112151641,112112151647,6,2330,1185,-40
112112588190,112112588197,7,2398,1088,-40
112114415262,112114415240,-22,2901,513,-40
112115832416,112115832411,-5,2273,6725,-40
112119776099,112119776105,6,2705,1058,-40
112120507087,112120507091,4,3326,1833,-40
112122436259,112122436266,7,1579,1009,-40
112125229002,112125229010,8,2960,1267,-40
112129328817,112129328822,5,2396,1235,-40
112129540577,112129540582,5,2827,1435,-40
112131682543,112131682550,7,2679,1319,-40
112132784233,112132784227,-6,1035,2365,-40
112136275092,112136275097,5,2406,1772,-40
112140692459,112140692467,8,2778,1546,-40
112140868055,112140868062,7,2580,966,-40
112141696189,112141696177,-12,1127,416,-40
112141816516,112141816523,7,2889,1047,-40
112144508574,112144508570,-4,1050,2489,-40
112147015641,112147015645,4,2755,1330,-40
112147431893,112147431890,-3,17006,15464,-40
112148813570,112148813576,6,2676,1759,-40
112149370278,112149370285,7,2319,1420,-40
112152318669,112152318669,0,1514,1611,-40
112153819275,112153819282,7,3409,916,-40
112154004457,112154004440,-17,4099,1164,-40
112158688697,112158688704,7,2582,909,-40
112166138778,112166138786,8,2948,1064,-40
112166870791,112166870798,7,2961,947,-40
112167201501,112167201506,5,2950,820,-40
112169727133,112169727141,8,3707,1244,-40
112171437230,112171437238,8,3793,1411,-40
112171818123,112171818130,7,2884,1725,-40
112173595297,112173595305,8,2405,1366,-40
112176385961,112176385966,5,1998,1012,-40
112176439936,112176439943,7,2769,886,-40
112178756732,112178756740,8,3176,1215,-40
112183680872,112183680879,7,3243,1395,-40
112184116305,112184116311,6,3496,1586,-40
112184445222,112184445227,5,2547,1530,-40
112186687094,112186687105,11,2167,1333,-40
112188896313,112188896317,4,1792,1513,-40
112192540843,112192540847,4,1590,1360,-40
112192569141,112192569147,6,2091,1124,-40
112197679990,112197679994,4,2406,1316,-40
112200484130,112200484137,7,2529,1538,-40
112201254457,112201254461,4,2294,1265,-40
112201957185,112201957190,5,2686,1099,-40
112204955253,112204955258,5,2577,1713,-40
112206876252,112206876256,4,2627,1864,-40
112210171133,112210171140,7,2729,1718,-40
112211224859,112211224866,7,2674,1121,-40
112211733701,112211733706,5,2207,1175,-40
112212491161,112212491169,8,2650,1014,-40
112216780805,112216780810,5,2828,759,-40
112217380402,112217380409,7,1492,776,-40
112218920247,112218920254,7,2674,1103,-40
112219196341,112219196345,4,4045,1519,-40
112219883278,112219883283,5,2133,1147,-40
112223065594,112223065599,5,5205,2649,-40
112225581672,112225581678,6,2874,1071,-40
112226309091,112226309098,7,3282,1556,-40
112226394858,112226394863,5,2266,1293,-40
112226496610,112226496594,-16,3193,1170,-40
112228248127,112228248133,6,2509,1032,-40
112236102977,112236102983,6,2925,1481,-40
112237839510,112237839494,-16,1044,300,-40
112241375863,112241375870,7,2958,1264,-40
112243824939,112243824942,3,3185,1038,-40
112248967118,112248967123,5,3395,1574,-40
112252129097,112252129103,6,1742,808,-40
112253336393,112253336397,4,2811,1463,-40
112258135168,112258135171,3,2504,1207,-40
112263806151,112263806155,4,1455,1227,-40
112269959323,112269959322,-1,1305,2104,-40
112270952745,112270952751,6,3534,1283,-40
112274854602,112274854607,5,3060,1500,-40
112280652795,112280652799,4,4777,2481,-40
112280719730,112280719737,7,3653,1402,-40
112285505249,112285505257,8,2087,1138,-40
112288928865,112288928869,4,3521,2314,-40
112289626470,112289626474,4,2620,1319,-40
112290244186,112290244190,4,2435,1183,-40
112294723657,112294723665,8,4424,1763,-40
112298560974,112298560980,6,2315,1008,-40
112299523442,112299523448,6,2500,1690,-40
112300142989,112300142994,5,2354,1227,-40
112300794751,112300794763,12,981,444,-40
112301505966,112301505962,-4,1102,2918,-40
112304308027,112304308030,3,2356,1607,-40
112306159953,112306159958,5,3659,1178,-40
112307032011,112307031993,-18,3751,1055,-40
112316360298,112316360303,5,2542,1738,-40
112316819517,112316819523,6,2786,1345,-40
112318843427,112318843419,-8,1673,580,-40
112323655395,112323655402,7,2889,1000,-40
112331454515,112331454521,6,2162,1230,-40
112332740387,112332740368,-19,694,67,-40
112334529441,112334529444,3,9256,16506,-40
112334801351,112334801358,7,5200,1624,-40
112334857252,112334857259,7,3310,1560,-40
112340508489,112340508494,5,2483,1135,-40
112343284294,112343284299,5,1669,725,-40
112343533958,112343533966,8,2410,1044,-40
112346876431,112346876438,7,3399,1304,-40
112350996339,112350996345,6,2501,1162,-40
112352001483,112352001490,7,3474,1414,-40
112353221479,112353221484,5,2705,1897,-40
112361045802,112361045807,5,2983,1419,-40
112365873572,112365873581,9,2706,1201,-40
112365952091,112365952098,7,2163,1268,-40
112373018671,112373018678,7,4156,1032,-40
112376290058,112376290065,7,5482,976,-40
112378056134,112378056141,7,2806,1571,-40
112378208470,112378208477,7,2584,1662,-40
112378398906,112378398914,8,3119,1527,-40
112379250502,112379250508,6,2730,1290,-40
112384862869,112384862875,6,2827,1156,-40
112385115010,112385114992,-18,852,60,-40
112387800377,112387800383,6,3541,1391,-40
112395563027,112395563034,7,3949,1540,-40
112400136993,112400136999,6,3371,1566,-40
112405067354,112405067361,7,2755,865,-40
112407510398,112407510402,4,1695,1592,-40
112412131513,112412131519,6,2775,968,-40
112415810684,112415810690,6,2745,1528,-40
112422997044,112422997051,7,1984,1256,-40
112426835806,112426835805,-1,1616,2616,-40
112429298085,112429298090,5,3706,1702,-40
112430297585,112430297590,5,3362,1506,-40
112432048122,112432048130,8,2655,1192,-40
112439287617,112439287622,5,1886,816,-40
112442436454,112442436457,3,2336,1420,-40
112444957949,112444957955,6,3659,1251,-40
112445380867,112445380873,6,1832,900,-40
112445513090,112445513098,8,3479,984,-40
112445779615,112445779619,4,981,312,-40
112450100259,112450100265,6,2604,1168,-40
112454530791,112454530798,7,2700,1413,-40
112455708908,112455708915,7,3203,988,-40
112456649095,112456649102,7,1193,913,-40
112457426110,112457426114,4,2269,1589,-40
112460613813,112460613818,5,3542,1177,-40
112462077097,112462077104,7,2101,887,-40
112463440756,112463440762,6,2105,1152,-40
112470156643,112470156650,7,2252,1267,-40
112472700320,112472700325,5,2590,1019,-40
112474896077,112474896083,6,4664,1868,-40
112479959045,112479959052,7,2843,1259,-40
112480000085,112480000066,-19,957,387,-40
112483755571,112483755582,11,1383,862,-40
112486538571,112486538578,7,2954,1703,-40
112488940805,112488940813,8,2967,1517,-40
112492061822,112492061826,4,2264,1232,-40
112492197406,112492197414,8,2392,1042,-40
112492281765,112492281771,6,2926,1601,-40
112496502510,112496502517,7,2924,1531,-40
112497979221,112497979226,5,2579,1725,-40
112505232808,112505232815,7,4002,1101,-40
112507540323,112507540329,6,4814,1806,-40
112508521325,112508521330,5,2812,1698,-40
112509008475,112509008479,4,2452,937,-40
112509166190,112509166197,7,3504,1470,-40
112515335882,112515335889,7,2968,1004,-40
112515843950,112515843955,5,1251,800,-40
112516427472,112516427478,6,2281,1373,-40
112518716418,112518716423,5,3112,1551,-40
112521498430,112521498439,9,2061,957,-40
112524460754,112524460761,7,3133,1094,-40
112525131178,112525131184,6,3104,1667,-40
112526799487,112526799494,7,3742,1578,-40
112528057654,112528057661,7,2565,1377,-40
112530477645,112530477653,8,2471,1621,-40
112531431306,112531431311,5,3007,1201,-40
112532367781,112532367783,2,33362,28545,-40
112534752038,112534752046,8,4634,1661,-40
112537333683,112537333683,0,976,189,-40
112540229546,112540229550,4,3797,1211,-40
112540463986,112540464002,16,2372,1325,-40
112545986705,112545986711,6,2258,1038,-40
112548543586,112548543593,7,2189,1342,-40
112551694857,112551694866,9,2257,906,-40
112551735535,112551735545,10,705,303,-40
112552741726,112552741734,8,2400,1165,-40
112552807322,112552807327,5,2371,1050,-40
112552970800,112552970786,-14,938,482,-40
112555727547,112555727553,6,3226,1301,-40
112557048995,112557049001,6,1773,1075,-40
112557904752,112557904757,5,2891,2471,-40
112563215298,112563215305,7,2434,1467,-40
112563414517,112563414530,13,2947,932,-40
112565338007,112565338014,7,3888,1678,-40
112570540373,112570540375,2,1641,1288,-40
112572180782,112572180777,-5,910,2634,-40
112573221826,112573221831,5,2176,1197,-40
112574953118,112574953124,6,3145,1408,-40
112581037116,112581037122,6,3256,1899,-40
112584765975,112584765981,6,1899,532,-40
112586627646,112586627652,6,2614,1131,-40
112588684861,112588684866,5,1535,989,-40
112592656692,112592656687,-5,1140,3412,-40
112595355874,112595355878,4,1586,1586,-40
112602676201,112602676209,8,3065,1582,-40
112605308905,112605308907,2,1491,1349,-40
112606825028,112606825029,1,1787,2637,-40
112611773638,112611773643,5,2201,1311,-40
112612619477,112612619483,6,3740,1226,-40
112615448780,112615448787,7,2475,1118,-40
112615862774,112615862760,-14,2315,939,-40
112619879769,112619879776,7,1917,1510,-40
112620219577,112620219595,18,2885,1556,-40
112621924178,112621924185,7,12990,37260,-40
112622944362,112622944366,4,2572,1093,-40
112623217602,112623217610,8,3944,1180,-40
112623328074,112623328080,6,2705,1063,-40
112623399597,112623399577,-20,2790,1230,-40
112627644759,112627644765,6,1593,1335,-40
112629990917,112629990922,5,2498,1462,-40
112631114414,112631114420,6,2007,756,-40
112632604638,112632604643,5,2345,883,-40
112632901326,112632901306,-20,1226,247,-40
112642002638,112642002646,8,2533,1549,-40
112642839667,112642839673,6,3355,1221,-40
112643112243,112643112242,-1,841,142,-40
112647932913,112647932915,2,2192,1266,-40
112652453425,112652453431,6,3073,1339,-40
112654826878,112654826884,6,1657,1104,-40
112656402128,112656402130,2,1432,1229,-40
112657858562,112657858570,8,2248,1433,-40
112662342624,112662342630,6,2901,1395,-40
112663459465,112663459470,5,2678,1001,-40
112664193767,112664193762,-5,1968,6320,-40
112666518718,112666518722,4,2372,1595,-40
112667494105,112667494109,4,1544,1540,-40
112668451339,112668451346,7,2895,1101,-40
112668835413,112668835417,4,1464,295,-40
112670165924,112670165924,0,1709,2164,-40
112673049131,112673049135,4,1959,914,-40
112681762110,112681762115,5,2266,1356,-40
112682853637,112682853660,23,1642,276,-40
112684202891,112684202897,6,2180,1360,-40
112689187721,112689187726,5,2852,1215,-40
112694361589,112694361594,5,2533,1293,-40
112701449029,112701449035,6,3207,1138,-40
112702853585,112702853591,6,1872,1211,-40
112704129134,112704129142,8,2436,1113,-40
112704400828,112704400834,6,3813,1625,-40
112705478959,112705478953,-6,1079,3172,-40
112706515504,112706515511,7,1647,1055,-40
112707663857,112707663858,1,1887,1420,-40
112711706026,112711706034,8,2971,1380,-40
112712193519,112712193500,-19,1521,888,-40
112712389471,112712389479,8,2646,792,-40
112714408733,112714408741,8,6649,2641,-40
112715901907,112715901913,6,2831,1314,-40
112716156349,112716156355,6,3349,942,-40
112718467489,112718467496,7,2332,1234,-40
112719553852,112719553859,7,1581,1015,-40
112719816303,112719816301,-2,1519,3277,-40
112720310858,112720310858,0,1612,2901,-40
112722009550,112722009557,7,2694,1335,-40
112722979077,112722979082,5,2845,1447,-40
112730190301,112730190308,7,3023,984,-40
112731823987,112731823993,6,6439,2957,-40
112734255350,112734255358,8,2913,1259,-40
112734621858,112734621858,0,777,80,-40
112737151942,112737151946,4,2409,1815,-40
112739748761,112739748767,6,3309,1743,-40
112746897472,112746897491,19,2044,910,-40
112747471629,112747471635,6,2962,1400,-40
112748475820,112748475827,7,2260,1134,-40
112750346106,112750346110,4,2746,1051,-40
112752106170,112752106175,5,2468,1323,-40
112757341278,112757341286,8,3144,1273,-40
112765433657,112765433651,-6,892,2494,-40
112766495108,112766495110,2,2029,1318,-40
112773280522,112773280525,3,998,1958,-40
112774737126,112774737133,7,2443,1244,-40
112774801031,112774801041,10,850,160,-40
112780726605,112780726609,4,1346,978,-40
112784489526,112784489533,7,3265,1391,-40
112784811775,112784811776,1,468,101,-40
112789054641,112789054646,5,1670,1248,-40
112792446416,112792446422,6,4188,1442,-40
112800458829,112800458835,6,2587,1025,-40
112802632044,112802632049,5,2884,1582,-40
112805384594,112805384599,5,1238,701,-40
112806886559,112806886565,6,3774,1790,-40
112809275803,112809275810,7,2214,1028,-40
112809341458,112809341461,3,2760,1588,-40
112814051645,112814051650,5,3587,1520,-40
112817482230,112817482234,4,3083,1455,-40
112820573835,112820573843,8,2847,993,-40
112827105165,112827105170,5,3744,1102,-40
112827607304,112827607308,4,8656,18561,-40
112829398750,112829398755,5,2812,1252,-40
112831776917,112831776925,8,2921,1895,-40
112838155929,112838155937,8,2252,1690,-40
112840409455,112840409459,4,1406,1417,-40
112841676548,112841676554,6,3155,1359,-40
112843008238,112843008246,8,3348,1659,-40
112847964024,112847964029,5,4715,1788,-40
112854770289,112854770294,5,3285,1355,-40
112857422498,112857422506,8,2479,1320,-40
112860943825,112860943830,5,1665,897,-40
112862994298,112862994305,7,5646,1417,-40
112865005636,112865005641,5,2184,1179,-40
112866976807,112866976812,5,2239,1101,-40
112868481066,112868481072,6,1929,993,-40
112869149194,112869149211,17,3934,1317,-40
112874313618,112874313626,8,2656,1079,-40
112875532341,112875532347,6,2836,1793,-40
112878617103,112878617096,-7,2641,9135,-40
112879350919,112879350925,6,3081,1807,-40
112880216413,112880216418,5,958,784,-40
112883383785,112883383792,7,3002,1421,-40
112883918378,112883918385,7,3162,1742,-40
112884906857,112884906862,5,3066,1253,-40
112888133741,112888133747,6,2327,1285,-40
112888600354,112888600357,3,3860,3519,-40
112898377116,112898377126,10,13984,41357,-40
112898561993,112898561993,0,2160,3028,-40
112899974015,112899974022,7,3636,1589,-40
112902793199,112902793200,1,2000,2390,-40
112903062774,112903062779,5,1864,759,-40
112908575167,112908575175,8,2614,1334,-40
112911860170,112911860178,8,2252,1260,-40
112912791186,112912791190,4,2399,1749,-40
112917544661,112917544664,3,28548,50717,-40
112919140401,112919140408,7,2338,1157,-40
112929623530,112929623537,7,3053,1453,-40
112930148319,112930148325,6,1785,1017,-40
112930551842,112930551849,7,4356,1321,-40
112932348037,112932348042,5,2738,1416,-40
112937824409,112937824414,5,2304,1733,-40
112939061469,112939061473,4,3281,1256,-40
112939672923,112939672928,5,1942,1173,-40
112939895094,112939895097,3,1089,273,-40
112940479759,112940479770,11,12540,5573,-40
112942618905,112942618911,6,2790,1182,-40
112947450709,112947450714,5,3193,1146,-40
112952175701,112952175708,7,1643,1149,-40
112953449825,112953449832,7,3042,1119,-40
112954013631,112954013638,7,1729,975,-40
112957481323,112957481327,4,25009,46356,-40
112958989592,112958989594,2,1673,1862,-40
112959880090,112959880095,5,3152,1746,-40
112962150909,112962150914,5,2849,1250,-40
112966570365,112966570367,2,1070,1352,-40
112974356366,112974356371,5,3027,1517,-40
112974541183,112974541193,10,754,126,-40
112978690499,112978690505,6,2924,1363,-40
112980733830,112980733835,5,2683,1647,-40
112984142982,112984142989,7,3065,1074,-40
112990919568,112990919587,19,344,814,-40
112993355775,112993355769,-6,1256,4438,-40
112997131722,112997131728,6,2912,1417,-40
113003376600,113003376606,6,3074,1132,-40
113006985259,113006985266,7,2193,962,-40
113013915421,113013915429,8,3419,1246,-40
113017397424,113017397430,6,2205,1241,-40
113019238780,113019238786,6,2813,1157,-40
113019907418,113019907423,5,1837,867,-40
113025090295,113025090301,6,2850,1227,-40
113026620605,113026620611,6,3569,1524,-40
113027095315,113027095322,7,2914,1231,-40
113029282091,113029282095,4,2305,1556,-40
113034334715,113034334722,7,2942,1463,-40
113034727404,113034727387,-17,2053,647,-40
113036655253,113036655259,6,3216,1321,-40
113038891573,113038891578,5,2914,1145,-40
113041402931,113041402937,6,3026,1573,-40
113042563778,113042563784,6,3414,1465,-40
113044061308,113044061317,9,3548,1163,-40
113044362870,113044362875,5,2958,1272,-40
113049871809,113049871815,6,4000,1004,-40
113052834757,113052834767,10,3747,1392,-40
113055548553,113055548557,4,2235,1361,-40
113056580670,113056580675,5,2748,1322,-40
113057458862,113057458870,8,2982,1402,-40
113060106393,113060106399,6,2921,871,-40
113060709176,113060709182,6,3259,1118,-40
113067937006,113067937010,4,1939,1334,-40
113068207822,113068207802,-20,1252,382,-40
113071706113,113071706119,6,2471,1022,-40
113072041403,113072041418,15,740,56,-40
113074152308,113074152314,6,3416,1251,-40
113074891708,113074891702,-6,2224,5833,-40
113080878203,113080878211,8,5332,23651,-40
113085460174,113085460179,5,1756,813,-40
113087109817,113087109823,6,4124,1665,-40
113091090773,113091090779,6,3544,1264,-40
113091639891,113091639897,6,4060,1845,-40
113094411053,113094411058,5,1614,788,-40
113096817113,113096817121,8,2995,1138,-40
113099173273,113099173279,6,4026,1113,-40
113104009315,113104009322,7,1248,623,-40
113107182549,113107182555,6,1870,1339,-40
113110639760,113110639765,5,3040,1199,-40
113116295375,113116295382,7,3606,1458,-40
113116858725,113116858731,6,3037,1178,-40
113116906134,113116906130,-4,1139,241,-40
113120426252,113120426258,6,1100,513,-40
113125078009,113125078015,6,2964,1146,-40
113129310637,113129310642,5,2724,821,-40
113129781707,113129781689,-18,1672,1165,-40
113130148181,113130148161,-20,2307,1079,-40
113130549842,113130549849,7,2923,1193,-40
113130716490,113130716498,8,3232,1152,-40
113133690653,113133690658,5,2360,1259,-40
113138984291,113138984299,8,2623,1144,-40
113142296885,113142296890,5,2050,979,-40
113147455955,113147455962,7,2085,1217,-40
113149072402,113149072407,5,3579,1485,-40
113149682611,113149682613,2,1429,1670,-40
113151055069,113151055065,-4,1164,2467,-40
113153400811,113153400817,6,2502,930,-40
113154039697,113154039698,1,2045,1879,-40
113154731742,113154731749,7,2665,1148,-40
113157795809,113157795815,6,2845,1265,-40
113160608928,113160608931,3,36888,32724,-40
113160868871,113160868877,6,4246,1356,-40
113161231605,113161231584,-21,2759,1908,-40
113161259444,113161259450,6,3146,1768,-40
113166020473,113166020479,6,3181,1300,-40
113166857803,113166857810,7,2615,1031,-40
113168441898,113168441904,6,2538,1373,-40
113168542119,113168542107,-12,2829,1749,-40
113169322198,113169322202,4,2724,2010,-40
113169622428,113169622435,7,2314,1190,-40
113169978394,113169978379,-15,1092,729,-40
113171309569,113171309575,6,3965,1932,-40
113172511048,113172511059,11,3522,49776,-40
113173872973,113173872977,4,3404,1221,-40
113174291665,113174291660,-5,964,304,-40
113176468339,113176468346,7,2719,1023,-40
113177664246,113177664251,5,2480,1071,-40
113179861678,113179861685,7,2906,846,-40
113182110403,113182110410,7,2072,1358,-40
113182236901,113182236910,9,1772,1062,-40
113184152133,113184152139,6,2918,1086,-40
113184493649,113184493636,-13,929,341,-40
113185489271,113185489272,1,1372,1730,-40
113190095430,113190095437,7,2684,1360,-40
113190677080,113190677074,-6,1728,3771,-40
113196879329,113196879337,8,3520,1475,-40
113197214704,113197214690,-14,2705,736,-40
113197293582,113197293586,4,2294,845,-40
113199198411,113199198410,-1,2382,3963,-40
113199560461,113199560466,5,2461,1123,-40
113202565816,113202565822,6,2410,1119,-40
113205422564,113205422570,6,3367,1148,-40
113207016322,113207016330,8,2642,1096,-40
113209426100,113209426106,6,2963,1240,-40
113212805750,113212805758,8,3756,1683,-40
113213058803,113213058803,0,2622,3837,-40
113220142167,113220142175,8,1976,1080,-40
113222883769,113222883778,9,3232,1698,-40
113224610953,113224610957,4,2689,1736,-40
113227393356,113227393362,6,3475,1327,-40
113227883285,113227883291,6,3207,1230,-40
113228190794,113228190802,8,3133,1065,-40
113229392906,113229392905,-1,2245,4013,-40
113234723142,113234723149,7,2071,1364,-40
113234867789,113234867795,6,3803,1322,-40
113239193733,113239193739,6,3691,997,-40
113242960001,113242960006,5,2941,1380,-40
113243346786,113243346793,7,2194,1460,-40
113246843874,113246843866,-8,1454,6896,-40
113250581489,113250581494,5,3606,1831,-40
113253823949,113253823957,8,2851,1785,-40
113254059838,113254059851,13,2944,919,-40
113255774005,113255774010,5,2853,1062,-40
113256612661,113256612667,6,2208,1210,-40
113256638956,113256638947,-9,1283,462,-40
113258888882,113258888888,6,2546,1059,-40
113271050490,113271050495,5,1928,694,-40
113272410569,113272410571,2,1557,1242,-40
113276780300,113276780306,6,2245,926,-40
113277008203,113277008186,-17,3361,1344,-40
113280335421,113280335428,7,3189,1289,-40
113281270069,113281270075,6,3122,1230,-40
113287908633,113287908638,5,1458,1150,-40
113290512746,113290512752,6,3692,1543,-40
113290840198,113290840204,6,2155,1238,-40
113291494374,113291494379,5,1858,807,-40
113292670214,113292670214,0,1051,1297,-40
113293464131,113293464113,-18,3195,1406,-40
113295823767,113295823773,6,1777,1304,-40
113296281586,113296281571,-15,1099,476,-40
113296898213,113296898219,6,2679,902,-40
113299466167,113299466147,-20,671,665,-40
113305263387,113305263393,6,2343,1330,-40
113306677197,113306677190,-7,1092,4727,-40
113317721915,113317721909,-6,1153,2896,-40
113318518105,113318518098,-7,1358,7278,-40
113320357517,113320357520,3,1697,1380,-40
113324621485,113324621491,6,3042,1130,-40
113324684718,113324684718,0,2701,2515,-40
113329204249,113329204256,7,9855,2756,-40
113330201802,113330201806,4,2333,1066,-40
113330859294,113330859298,4,3062,1219,-40
113334400246,113334400252,6,2899,921,-40
113338184681,113338184688,7,4218,1303,-40
113339011578,113339011585,7,2386,1083,-40
113342754996,113342755002,6,3228,1162,-40
113343105726,113343105713,-13,969,780,-40
113348880582,113348880589,7,1473,697,-40
113350565886,113350565891,5,909,177,-40
113354239649,113354239654,5,1712,1661,-40
113354637422,113354637402,-20,954,612,-40
113358328951,113358328947,-4,987,196,-40
113360387493,113360387499,6,3511,1624,-40
113368352408,113368352410,2,3361,3883,-40
113368860830,113368860834,4,2457,1552,-40
113371885287,113371885294,7,3288,1586,-40
113373997854,113373997853,-1,3085,4871,-40
113379614999,113379615006,7,2827,1627,-40
113380025975,113380025982,7,2385,987,-40
113383406692,113383406697,5,1895,1392,-40
113385650042,113385650047,5,2751,1238,-40
113388507275,113388507281,6,3145,1393,-40
113388999002,113388999016,14,1382,413,-40
113393026309,113393026314,5,909,754,-40
113395387453,113395387457,4,3172,975,-40
113395528667,113395528651,-16,793,243,-40
113399333646,113399333647,1,864,1165,-40
113402476150,113402476154,4,1507,1321,-40
113410111452,113410111457,5,2964,1606,-40
113417452705,113417452713,8,4082,1285,-40
113417625664,113417625674,10,3126,1321,-40
113418867439,113418867442,3,1802,1285,-40
113419178528,113419178522,-6,833,2451,-40
113421785798,113421785799,1,1532,1431,-40
113426330293,113426330298,5,1179,986,-40
113428284345,113428284350,5,4085,1594,-40
113429127864,113429127878,14,690,1368,-40
113432827982,113432827987,5,3047,1290,-40
113435503665,113435503670,5,2246,1642,-40
113446184800,113446184802,2,1517,1145,-40
113446831868,113446831870,2,1902,1200,-40
113449035114,113449035119,5,1460,1113,-40
113449102914,113449102922,8,2713,1416,-40
113449351715,113449351722,7,3679,1444,-40
113453744405,113453744411,6,2742,1306,-40
113454727958,113454727963,5,2801,897,-40
113456046333,113456046343,10,2191,963,-40
113456160928,113456160937,9,854,206,-40
113460529069,113460529074,5,2285,993,-40
113462307334,113462307339,5,1550,607,-40
113462540821,113462540832,11,894,385,-40
113463976897,113463976902,5,1473,1053,-40
113464503754,113464503761,7,3003,1389,-40
113472141454,113472141459,5,3629,1479,-40
113475385754,113475385758,4,3372,2099,-40
113476135427,113476135427,0,1487,995,-40
113479441883,113479441887,4,1707,923,-40
113481521389,113481521397,8,3076,830,-40
113481691158,113481691144,-14,565,595,-40
113486031033,113486031033,0,1468,1226,-40
113487912568,113487912575,7,1775,915,-40
113489188629,113489188632,3,2890,1894,-40
113493161277,113493161282,5,2441,846,-40
113494878412,113494878417,5,3290,1520,-40
113496331387,113496331394,7,1997,1298,-40
113499802449,113499802457,8,3371,1544,-40
113500473873,113500473867,-6,2552,6942,-40
113504790422,113504790426,4,2742,1219,-40
113509967810,113509967816,6,2544,1483,-40
113513056944,113513056948,4,2407,1151,-40
113518771918,113518771924,6,1507,1528,-40
113524414640,113524414646,6,2872,1479,-40
113526544217,113526544236,19,1222,396,-40
113527228163,113527228160,-3,325,125,-40
113527436675,113527436681,6,2815,1516,-40
113527956393,113527956399,6,2797,1077,-40
113529531091,113529531099,8,2430,973,-40
113529997873,113529997879,6,3396,1212,-40
113532643899,113532643907,8,3108,1555,-40
113534761097,113534761102,5,2798,1614,-40
113536061855,113536061850,-5,2543,7331,-40
113540073741,113540073746,5,4294,1300,-40
113541107530,113541107536,6,2466,1232,-40
113543913029,113543913035,6,6731,2481,-40
113545399757,113545399762,5,3241,943,-40
113548112386,113548112391,5,3260,1336,-40
113559448614,113559448623,9,1075,756,-40
113560469442,113560469449,7,3920,873,-40
113570447099,113570447102,3,1184,942,-40
113575505270,113575505264,-6,1186,3737,-40
113577077030,113577077037,7,4167,1326,-40
113586916222,113586916228,6,2445,1145,-40
113587065012,113587065018,6,2949,1597,-40
113589658821,113589658827,6,1989,995,-40
113590419182,113590419185,3,1772,1115,-40
113599185755,113599185763,8,2947,1207,-40
113601507263,113601507269,6,2033,941,-40
113602451709,113602451690,-19,2306,862,-40
113606482762,113606482770,8,2685,1054,-40
113608728749,113608728756,7,3167,1045,-40
113609107549,113609107554,5,1973,812,-40
113610994975,113610994982,7,3130,1272,-40
113618270757,113618270762,5,4279,1622,-40
113627449413,113627449420,7,3341,1431,-40
113629809469,113629809474,5,1950,1200,-40
113630556865,113630556870,5,2143,936,-40
113634383420,113634383426,6,2158,816,-40
113634949534,113634949539,5,1661,1167,-40
113642127395,113642127398,3,2895,1509,-40
113642222618,113642222614,-4,1510,2662,-40
113644982582,113644982590,8,1892,1068,-40
113646828033,113646828040,7,2670,1225,-40
113646920134,113646920141,7,3344,1558,-40
113649342825,113649342830,5,3256,1387,-40
113653581742,113653581750,8,3237,1306,-40
113658757535,113658757542,7,3337,1705,-40
113663104809,113663104816,7,4108,1766,-40
113665168101,113665168107,6,2733,1013,-40
113665427357,113665427377,20,752,206,-40
113666912338,113666912343,5,2523,1167,-40
113678635852,113678635857,5,2569,857,-40
113684828891,113684828897,6,3116,1643,-40
113684916266,113684916282,16,3834,1385,-40
113688791029,113688791035,6,4649,1479,-40
113689240739,113689240724,-15,757,29,-40
113693791846,113693791855,9,1634,1464,-40
113699860721,113699860721,0,1147,1191,-40
113701432863,113701432870,7,3981,1745,-40
113705190989,113705190994,5,2613,913,-40
113709266698,113709266703,5,2403,1138,-40
113709452573,113709452581,8,3879,1503,-40
113712270833,113712270831,-2,688,1622,-40
113713150426,113713150423,-3,1001,2451,-40
113716537882,113716537888,6,3433,1515,-40
113717850345,113717850350,5,2107,801,-40
113718040175,113718040163,-12,3201,1130,-40
113733555545,113733555550,5,2129,1066,-40
113734369305,113734369313,8,2646,805,-40
113734701134,113734701115,-19,1256,178,-40
113736741320,113736741326,6,2957,1445,-40
113737656365,113737656368,3,1693,1377,-40
113737882682,113737882690,8,2364,1133,-40
113738539193,113738539199,6,2903,888,-40
113741088778,113741088781,3,2103,1312,-40
113741506656,113741506640,-16,2509,670,-40
113742212594,113742212601,7,3095,1425,-40
113744669499,113744669505,6,1702,807,-40
113745175894,113745175897,3,1638,1309,-40
113745449224,113745449229,5,1675,948,-40
113745907616,113745907604,-12,3034,1646,-40
113745956160,113745956171,11,2906,1325,-40
113748558797,113748558802,5,2795,1163,-40
113749003645,113749003650,5,3348,1725,-40
113750215970,113750215977,7,4021,1765,-40
113753286492,113753286497,5,2612,1013,-40
113754565406,113754565414,8,3539,1353,-40
113755404065,113755404071,6,2757,1131,-40
113759476645,113759476651,6,2490,1020,-40
113769970026,113769970032,6,1907,1130,-40
113770547699,113770547705,6,1534,773,-40
113775878309,113775878315,6,4478,1277,-40
113776694898,113776694904,6,2235,1144,-40
113776812892,113776812915,23,3059,1275,-40
113776882506,113776882506,0,3027,3861,-40
113778411681,113778411686,5,2626,1197,-40
113780871910,113780871915,5,2930,1214,-40
113786282899,113786282903,4,1371,1497,-40
113789179106,113789179112,6,3419,1127,-40
113789859798,113789859804,6,2555,1058,-40
113793313591,113793313598,7,2681,1134,-40
113797103081,113797103083,2,5024,5375,-40
113799444505,113799444511,6,3350,1610,-40
113800149498,113800149506,8,3043,1078,-40
113802031690,113802031697,7,2839,1089,-40
113802849441,113802849448,7,3083,1401,-40
113804594946,113804594953,7,2172,1170,-40
113804857950,113804857970,20,2041,1212,-40
113805669396,113805669379,-17,23097,28143,-40
113806742386,113806742372,-14,2494,1054,-40
113808562102,113808562110,8,2433,1050,-40
113808854098,113808854114,16,1027,210,-40
113814461026,113814461032,6,2066,684,-40
113815617447,113815617454,7,1646,988,-40
113821376542,113821376547,5,1410,853,-40
113822441316,113822441323,7,1856,918,-40
113825707010,113825707017,7,2729,756,-40
113825926106,113825926115,9,1386,542,-40
113828494295,113828494302,7,2820,1560,-40
113832644625,113832644630,5,3392,1387,-40
113834204815,113834204822,7,3044,1502,-40
113841520302,113841520309,7,3332,1188,-40
113842074229,113842074234,5,4203,1539,-40
113842864468,113842864471,3,1248,706,-40
113844419711,113844419718,7,2841,1247,-40
113846771653,113846771658,5,3274,1182,-40
113848722730,113848722737,7,3827,1187,-40
113851520938,113851520937,-1,1361,2662,-40
113851744609,113851744616,7,2707,1277,-40
113854482742,113854482747,5,2424,1503,-40
113858912652,113858912658,6,2829,1295,-40
113861226375,113861226382,7,3245,1650,-40
113862232298,113862232303,5,2960,1235,-40
113865542421,113865542425,4,651,965,-40
113865995878,113865995858,-20,817,337,-40
113866865736,113866865742,6,2995,1483,-40
113871762819,113871762825,6,3264,1609,-40
113872794756,113872794762,6,3119,1305,-40
113873676887,113873676894,7,1996,980,-40
113874483173,113874483170,-3,1371,2606,-40
113877749449,113877749454,5,2321,1174,-40
113878052333,113878052340,7,3161,1744,-40
113880756179,113880756178,-1,943,853,-40
113882115463,113882115469,6,3079,1427,-40
113891742564,113891742570,6,3106,1674,-40
113892029769,113892029775,6,2009,1263,-40
113904284714,113904284721,7,3155,982,-40
113908990150,113908990155,5,2498,1293,-40
113909598622,113909598630,8,2621,1145,-40
113910824450,113910824455,5,3474,1151,-40
113911470592,113911470598,6,3025,1355,-40
113912122237,113912122242,5,3240,1415,-40
113912470180,113912470185,5,2235,1743,-40
113912664998,113912665004,6,2537,1437,-40
113928167646,113928167652,6,2650,1587,-40
113931765053,113931765059,6,2352,1192,-40
113934185705,113934185711,6,2325,1379,-40
113935072776,113935072782,6,3541,1260,-40
113935445858,113935445859,1,813,326,-40
113938364953,113938364960,7,6561,1829,-40
113939877139,113939877145,6,2208,873,-40
113940000775,113940000782,7,3762,1087,-40
113941024298,113941024305,7,2176,1187,-40
113941915534,113941915541,7,3563,1358,-40
113942028123,113942028129,6,2221,997,-40
113948109889,113948109895,6,2292,1344,-40
113949999189,113949999195,6,2488,1279,-40
113951254610,113951254614,4,2819,879,-40
113952889236,113952889243,7,2978,1728,-40
113953270593,113953270590,-3,1951,2856,-40
113956797306,113956797313,7,2452,1634,-40
113958547682,113958547688,6,3338,1255,-40
113958798306,113958798313,7,3577,1862,-40
113961720144,113961720150,6,3151,1106,-40
113963839782,113963839781,-1,1479,3458,-40
113963947076,113963947080,4,33596,21487,-40
113964338454,113964338462,8,2293,1034,-40
113965084919,113965084926,7,2729,1246,-40
113967096258,113967096263,5,2049,1326,-40
113968792938,113968792945,7,3460,1079,-40
113969349918,113969349923,5,2914,1569,-40
113979788174,113979788179,5,2634,1094,-40
113980232044,113980232050,6,1930,766,-40
113983479974,113983479978,4,3016,1179,-40
113983810423,113983810435,12,1033,150,-40
113984845187,113984845195,8,857,149,-40
113985057802,113985057806,4,2854,1279,-40
113985435478,113985435458,-20,226,1935,-40
113990392814,113990392818,4,2459,1220,-40
113990751433,113990751449,16,613,396,-40
113993412109,113993412115,6,2611,1097,-40
113993931915,113993931922,7,2738,985,-40
113994647269,113994647277,8,173,1518,-40
114006827711,114006827719,8,6230,2670,-40
114008163375,114008163383,8,3602,1259,-40
114014029678,114014029684,6,2265,1433,-40
114017405688,114017405694,6,3010,1332,-40
114022456405,114022456414,9,3233,1425,-40
114026175398,114026175405,7,2307,1219,-40
114026589590,114026589569,-21,3062,1286,-40
114028990275,114028990282,7,2984,1539,-40
114031662214,114031662222,8,2039,950,-40
114036991517,114036991524,7,2982,1367,-40
114037782625,114037782634,9,1329,636,-40
114039238922,114039238928,6,4163,1420,-40
114040577266,114040577258,-8,900,4173,-40
114041377377,114041377385,8,1637,886,-40
114042478110,114042478118,8,1871,879,-40
114045965117,114045965119,2,1993,1791,-40
114047718274,114047718281,7,2441,1411,-40
114057728636,114057728637,1,1452,1964,-40
114062054217,114062054223,6,1665,1352,-40
114064295255,114064295262,7,1703,895,-40
114065845434,114065845440,6,3022,1312,-40
114068300133,114068300137,4,1805,895,-40
114073056854,114073056837,-17,2268,981,-40
114073798154,114073798140,-14,3116,1320,-40
114077638506,114077638512,6,3573,1790,-40
114078090606,114078090611,5,2743,1525,-40
114079593450,114079593451,1,1415,1471,-40
114081782809,114081782814,5,3410,776,-40
114083330500,114083330505,5,1919,1111,-40
114083849273,114083849282,9,2806,1152,-40
114087818566,114087818571,5,2408,1278,-40
114096099631,114096099630,-1,1373,2825,-40
114101574035,114101574042,7,1820,1165,-40
114103993442,114103993446,4,3006,1335,-40
114105640908,114105640914,6,3282,1025,-40
114106645585,114106645590,5,2671,1090,-40
114106796184,114106796190,6,2217,1159,-40
114106928363,114106928369,6,3025,871,-40
114110067086,114110067083,-3,745,1520,-40
114113527701,114113527706,5,3604,1456,-40
114120136865,114120136870,5,3719,1429,-40
114123127841,114123127847,6,2110,1012,-40
114123247078,114123247098,20,3220,1207,-40
114123313279,114123313268,-11,2397,1356,-40
114135146001,114135146009,8,3378,1159,-40
114136238406,114136238413,7,3223,777,-40
114138382032,114138382039,7,3269,1260,-40
114139070766,114139070772,6,2614,1078,-40
114151366745,114151366750,5,3917,1590,-40
114157210086,114157210093,7,1828,900,-40
114159711125,114159711130,5,2289,1175,-40
114159979062,114159979040,-22,708,275,-40
114160132266,114160132275,9,2069,917,-40
114160395299,114160395292,-7,1276,342,-40
114167896670,114167896675,5,1994,1084,-40
114172958589,114172958594,5,3508,1546,-40
114180429069,114180429074,5,2631,1544,-40
114180531534,114180531538,4,2874,1606,-40
114181104666,114181104674,8,3453,1151,-40
114190336269,114190336275,6,2777,1379,-40
114197554445,114197554430,-15,3768,1844,-40
114198636091,114198636098,7,3680,1478,-40
114202757535,114202757539,4,2270,1787,-40
114203797832,114203797838,6,2587,907,-40
114203865605,114203865584,-21,988,355,-40
114205585290,114205585287,-3,836,1698,-40
114213403309,114213403315,6,3618,1738,-40
114213688069,114213688077,8,2811,1057,-40
114216264264,114216264263,-1,1513,1010,-40
114220257001,114220257007,6,3248,1254,-40
114228340781,114228340786,5,1845,1329,-40
114229710321,114229710327,6,2445,1168,-40
114231526960,114231526961,1,2121,1811,-40
114232153038,114232153044,6,3051,1367,-40
114234653081,114234653082,1,1935,3139,-40
114245131694,114245131701,7,4040,1513,-40
114246634861,114246634869,8,2854,1174,-40
114246724648,114246724648,0,1010,413,-40
114248903351,114248903357,6,1624,1169,-40
114254248417,114254248410,-7,2270,7773,-40
114256918461,114256918466,5,2331,1124,-40
114257527627,114257527623,-4,1177,2530,-40
114265164609,114265164617,8,3807,1395,-40
114269186942,114269186950,8,1997,1271,-40
114269647445,114269647432,-13,1054,264,-40
114271428010,114271428015,5,3071,1627,-40
114272941470,114272941475,5,4211,1411,-40
114273017925,114273017931,6,1703,754,-40
114274248491,114274248497,6,1999,1149,-40
114275739002,114275739009,7,1499,800,-40
114276146571,114276146553,-18,1157,437,-40
114278113890,114278113896,6,2281,1344,-40
114286005779,114286005785,6,2634,1263,-40
114286489489,114286489494,5,3307,1710,-40
114297490061,114297490067,6,3299,965,-40
114300390986,114300390990,4,3072,1168,-40
114301441589,114301441595,6,2277,958,-40
114303338739,114303338745,6,1837,1043,-40
114303393026,114303393012,-14,1472,527,-40
114304442435,114304442442,7,3190,1218,-40
114318281923,114318281930,7,2065,1458,-40
114320160677,114320160680,3,1272,1286,-40
114320361233,114320361230,-3,1268,2330,-40
114332165746,114332165746,0,5236,5657,-40
114335282344,114335282339,-5,2042,42971,-40
114335748594,114335748600,6,13908,27995,-40
114337627502,114337627509,7,2408,1030,-40
114340644156,114340644162,6,2694,1159,-40
114342234285,114342234282,-3,1235,4069,-40
114343206357,114343206362,5,1491,916,-40
114343931413,114343931418,5,2310,903,-40
114345134025,114345134022,-3,1349,2701,-40
114346177917,114346177921,4,1934,884,-40
114347841407,114347841414,7,2733,1243,-40
114350318884,114350318885,1,33429,16938,-40
114351168539,114351168547,8,2451,1064,-40
114351207121,114351207114,-7,728,436,-40
114353282422,114353282416,-6,1521,10147,-40
114358244615,114358244621,6,2248,1740,-40
114362083254,114362083261,7,3627,1245,-40
114363963314,114363963319,5,2831,1313,-40
114364344570,114364344577,7,3759,1976,-40
114368322756,114368322765,9,2367,1109,-40
114369047866,114369047871,5,1429,1080,-40
114370195053,114370195059,6,2415,781,-40
114373233779,114373233785,6,3371,1460,-40
114373737046,114373737053,7,2643,903,-40
114374719634,114374719639,5,1727,1540,-40
114382076262,114382076262,0,1357,1663,-40
114382724053,114382724062,9,2493,1275,-40
114389259249,114389259256,7,3465,1468,-40
114391420128,114391420132,4,3103,2500,-40
114393429998,114393430003,5,2488,1142,-40
114398837284,114398837290,6,3000,1582,-40
114401026096,114401026106,10,293,1251,-40
114403099377,114403099383,6,3118,1425,-40
114410983656,114410983662,6,2485,1316,-40
114413666338,114413666345,7,2541,1447,-40
114417891841,114417891846,5,2532,1574,-40
114419662590,114419662594,4,3254,1741,-40
114429492753,114429492760,7,4254,1744,-40
114434603694,114434603699,5,3422,1506,-40
114434764631,114434764639,8,3810,1227,-40
114435901299,114435901305,6,2479,1177,-40
114442516824,114442516829,5,3543,1340,-40
114442605727,114442605734,7,3307,1168,-40
114443073290,114443073274,-16,2979,1525,-40
114447244726,114447244733,7,2719,1363,-40
114448381782,114448381789,7,3288,1472,-40
114448628633,114448628638,5,2827,1294,-40
114449885670,114449885673,3,1453,1325,-40
114451721798,114451721806,8,2592,1240,-40
114452457051,114452457058,7,2640,814,-40
114452682940,114452682920,-20,891,327,-40
114454494322,114454494328,6,2648,1464,-40
114455903886,114455903892,6,2970,1478,-40
114457117766,114457117773,7,2279,853,-40
114460558298,114460558303,5,2621,1007,-40
114466515621,114466515626,5,2081,757,-40
114469364528,114469364535,7,2984,1174,-40
114469548303,114469548307,4,2602,1335,-40
114471960538,114471960537,-1,695,1176,-40
114478420547,114478420559,12,5296,50741,-40
114478583415,114478583422,7,2051,1359,-40
114481333602,114481333608,6,3000,1333,-40
114486208364,114486208356,-8,1000,4862,-40
114488097661,114488097667,6,2349,1165,-40
114492110982,114492110989,7,3696,973,-40
114494339520,114494339526,6,2237,833,-40
114494617330,114494617333,3,1209,1132,-40
114496069567,114496069573,6,1599,1069,-40
114497362626,114497362632,6,4005,1764,-40
114497742624,114497742630,6,3156,1526,-40
114498163130,114498163135,5,2312,1155,-40
114502544134,114502544139,5,2744,675,-40
114502650208,114502650192,-16,1241,337,-40
114503223909,114503223915,6,2428,1239,-40
114511793374,114511793381,7,1973,940,-40
114513379576,114513379571,-5,1378,2864,-40
114516345869,114516345875,6,2769,1599,-40
114516917395,114516917400,5,2479,2081,-40
114522452333,114522452319,-14,1748,978,-40
114523069773,114523069779,6,2424,1104,-40
114523644733,114523644747,14,682,103,-40
114527152081,114527152087,6,3142,1122,-40
114528808768,114528808774,6,2104,1038,-40
114529811306,114529811322,16,2695,1253,-40
114530095417,114530095426,9,9807,25847,-40
114531694149,114531694150,1,3167,4399,-40
114533953118,114533953123,5,2320,1277,-40
114536026433,114536026438,5,3136,1890,-40
114538722038,114538722043,5,1540,1040,-40
114539077046,114539077026,-20,2613,1285,-40
114539395006,114539395011,5,2773,1240,-40
114540085299,114540085307,8,2526,1327,-40
114541196431,114541196436,5,2186,1386,-40
114548062226,114548062231,5,8017,23055,-40
114549807233,114549807238,5,2886,1176,-40
114551770426,114551770424,-2,2734,5109,-40
114560014245,114560014232,-13,1334,255,-40
114560917009,114560917013,4,3285,1302,-40
114566567134,114566567141,7,3570,921,-40
114567841402,114567841418,16,1015,363,-40
114568544714,114568544719,5,3001,1599,-40
114570557373,114570557381,8,2998,1208,-40
114571492129,114571492136,7,2826,1121,-40
114571558009,114571558015,6,1637,967,-40
114574896820,114574896826,6,2326,1208,-40
114575322723,114575322706,-17,1309,718,-40
114577777211,114577777205,-6,706,2429,-40
114578158757,114578158756,-1,1094,1876,-40
114580046672,114580046677,5,2594,1537,-40
114585334891,114585334897,6,3402,1449,-40
114587324002,114587324010,8,2611,1546,-40
114589757168,114589757169,1,37669,23431,-40
114597861374,114597861380,6,2311,1454,-40
114599311709,114599311714,5,1725,1264,-40
114599804942,114599804949,7,2311,1224,-40
114602273421,114602273422,1,920,1852,-40
114602474845,114602474851,6,3009,1346,-40
114604566385,114604566391,6,2728,1151,-40
114612459670,114612459677,7,3300,1517,-40
114615396322,114615396318,-4,1373,1427,-40
114616963929,114616963942,13,12022,51276,-40
114622397931,114622397950,19,588,77,-40
114624314785,114624314790,5,2603,951,-40
114624999705,114624999711,6,1447,765,-40
114625742238,114625742242,4,1279,184,-40
114630874320,114630874328,8,3995,1171,-40
114632403060,114632403054,-6,1268,2857,-40
114634600487,114634600492,5,2384,1362,-40
114635537565,114635537570,5,2879,1487,-40
114636825837,114636825842,5,3286,1181,-40
114642668225,114642668230,5,3020,1578,-40
114650341019,114650341015,-4,3334,10776,-40
114656150135,114656150141,6,3176,1099,-40
114657041954,114657041961,7,2902,1484,-40
114662227693,114662227701,8,2610,1433,-40
114662471039,114662471035,-4,755,73,-40
114678163461,114678163466,5,3502,1167,-40
114678412033,114678412038,5,2181,890,-40
114678490274,114678490281,7,3026,1173,-40
114679120004,114679120010,6,2871,1483,-40
114680606159,114680606163,4,2668,1699,-40
114682168274,114682168281,7,1641,1078,-40
114687167689,114687167697,8,1366,600,-40
114687770050,114687770058,8,2433,1504,-40
114688994561,114688994567,6,2294,1058,-40
114693331325,114693331324,-1,1238,2609,-40
114698392443,114698392438,-5,977,2459,-40
114698691418,114698691424,6,2342,1462,-40
114699673093,114699673098,5,3265,1775,-40
114700210534,114700210542,8,2407,1145,-40
114701545758,114701545766,8,1397,645,-40
114701573258,114701573240,-18,1327,427,-40
114710254403,114710254409,6,3876,2159,-40
114711274376,114711274382,6,2707,1259,-40
114712555862,114712555867,5,2515,1042,-40
114714024005,114714024011,6,1954,844,-40
114714365826,114714365832,6,3924,1648,-40
114715876014,114715876022,8,2997,1545,-40
114717132267,114717132252,-15,1012,298,-40
114718453684,114718453682,-2,1812,2890,-40
114722751906,114722751900,-6,16695,15382,-40
114723078575,114723078580,5,3080,1694,-40
114727019288,114727019294,6,2098,1007,-40
114728318574,114728318581,7,2496,1080,-40
114732783584,114732783588,4,1652,782,-40
114733743173,114733743178,5,3215,1690,-40
114735108500,114735108508,8,2904,1042,-40
114736296895,114736296901,6,3109,1135,-40
114740976196,114740976202,6,2915,1392,-40
114743266028,114743266033,5,6672,2580,-40
114747213886,114747213889,3,2434,1367,-40
114748346679,114748346686,7,3064,1288,-40
114749757157,114749757163,6,2391,1139,-40
114752124856,114752124862,6,2927,996,-40
114752214738,114752214740,2,1693,1782,-40
114752557498,114752557505,7,2111,1118,-40
114752788430,114752788408,-22,2891,1206,-40
114755154861,114755154868,7,2126,1397,-40
114755317966,114755317945,-21,2355,1004,-40
114756468015,114756468021,6,3150,1324,-40
114759403301,114759403288,-13,1486,362,-40
114764409803,114764409809,6,3075,1255,-40
114765662787,114765662790,3,2243,1363,-40
114766831648,114766831655,7,5700,1569,-40
114767829502,114767829507,5,2198,1349,-40
114769904955,114769904960,5,2542,1215,-40
114770027517,114770027513,-4,1320,2694,-40
114775089093,114775089099,6,2734,1276,-40
114775637330,114775637336,6,3408,1285,-40
114779697140,114779697146,6,2349,1133,-40
114780952238,114780952239,1,2742,4432,-40
114781087030,114781087035,5,2727,1249,-40
114782020982,114782020989,7,3287,1052,-40
114782692970,114782692977,7,1993,810,-40
114782840383,114782840387,4,2425,1085,-40
114785163743,114785163749,6,2773,1288,-40
114785260794,114785260779,-15,3338,1423,-40
114785577802,114785577810,8,3034,1120,-40
114787620757,114787620762,5,1738,872,-40
114788452758,114788452764,6,2850,1486,-40
114788845384,114788845391,7,1848,737,-40
114790063677,114790063697,20,541,203,-40
114791208615,114791208610,-5,956,3619,-40
114791456229,114791456248,19,3779,1619,-40
114791876451,114791876459,8,4149,1554,-40
114791912059,114791912066,7,3397,1196,-40
114803227449,114803227454,5,2817,1493,-40
114805068878,114805068883,5,3339,1316,-40
114806687395,114806687405,10,3374,1314,-40
114809115217,114809115218,1,2272,974,-40
114810953010,114810953017,7,3789,1504,-40
114812285094,114812285100,6,2831,1453,-40
114812905842,114812905858,16,760,23,-40
114815165171,114815165178,7,3422,1346,-40
114820913950,114820913957,7,3542,1248,-40
114822038238,114822038243,5,1564,1213,-40
114823896513,114823896519,6,2791,1448,-40
114830141573,114830141578,5,3123,1195,-40
114830778913,114830778896,-17,1336,445,-40
114832727542,114832727548,6,2900,1320,-40
114837523534,114837523538,4,3409,1421,-40
114838005087,114838005094,7,2719,1400,-40
114840082989,114840082995,6,3171,1340,-40
114845220576,114845220581,5,2907,1059,-40
114845645446,114845645451,5,3196,1403,-40
114845852545,114845852551,6,4414,1129,-40
114846029382,114846029403,21,1209,215,-40
114859533809,114859533814,5,2286,824,-40
114861729513,114861729520,7,2649,1431,-40
114862330562,114862330569,7,2986,1100,-40
114864985463,114864985470,7,1259,788,-40
114868526055,114868526050,-5,547,1833,-40
114870660234,114870660242,8,2234,1209,-40
114870997446,114870997466,20,2166,1207,-40
114875538648,114875538654,6,1607,1249,-40
114880781746,114880781751,5,1793,1281,-40
114881900152,114881900159,7,2961,851,-40
114882549344,114882549330,-14,1745,933,-40
114887334208,114887334214,6,2784,1127,-40
114888142254,114888142261,7,2825,972,-40
114892403759,114892403744,-15,1172,515,-40
114898704654,114898704635,-19,1038,292,-40
114902221048,114902221056,8,2418,1249,-40
114902604394,114902604408,14,2701,1192,-40
114904042134,114904042142,8,2580,905,-40
114905315910,114905315917,7,3946,1586,-40
114908038077,114908038082,5,2076,888,-40
114911203987,114911203994,7,2765,929,-40
114912089516,114912089522,6,2831,904,-40
114922302337,114922302344,7,4252,1435,-40
114924185691,114924185695,4,2678,1291,-40
114927100042,114927100047,5,2530,1394,-40
114927174869,114927174849,-20,4011,1460,-40
114931583201,114931583204,3,2865,1616,-40
114931619879,114931619886,7,3252,1376,-40
114932876254,114932876258,4,3113,1649,-40
114936036749,114936036757,8,3989,1525,-40
114937072692,114937072697,5,2436,1508,-40
114938406290,114938406295,5,1185,955,-40
114939294229,114939294231,2,2974,1561,-40
114941517086,114941517094,8,3470,1179,-40
114946233773,114946233778,5,2590,1439,-40
114953704791,114953704797,6,2055,932,-40
114959007894,114959007891,-3,1928,3779,-40
114962271234,114962271230,-4,1964,2562,-40
114963706063,114963706070,7,2306,927,-40
114968776509,114968776517,8,2177,1172,-40
114972632732,114972632736,4,2605,1562,-40
114979561348,114979561354,6,2471,915,-40
114980660785,114980660790,5,3487,1897,-40
114985911285,114985911286,1,748,18416,-40
114986944002,114986944010,8,3200,1077,-40
114990762392,114990762398,6,3408,1530,-40
114991098020,114991098025,5,3624,1391,-40
114991795843,114991795850,7,2387,1060,-40
114992658801,114992658807,6,2429,1081,-40
114995593881,114995593886,5,2533,1211,-40
114997362599,114997362612,13,1017,227,-40
114998301810,114998301803,-7,1261,307,-40
115000908609,115000908614,5,2885,868,-40
115006250338,115006250343,5,3471,1550,-40
115007974181,115007974202,21,224,954,-40
115008196421,115008196428,7,2910,1364,-40
115008575175,115008575182,7,2525,1336,-40
115008766682,115008766689,7,2789,1269,-40
115009125110,115009125115,5,2031,1137,-40
115011180007,115011180013,6,3339,1399,-40
115014888333,115014888338,5,2714,1278,-40
115019321908,115019321914,6,2646,1236,-40
115020756455,115020756461,6,2553,1016,-40
115021399243,115021399249,6,2659,1066,-40
115021777274,115021777281,7,2326,1811,-40
115022084389,115022084395,6,1801,808,-40
115025021610,115025021618,8,3180,1346,-40
115027841468,115027841471,3,2683,1625,-40
115029399135,115029399143,8,2497,1274,-40
115037227244,115037227236,-8,59,876,-40
115037320880,115037320891,11,1855,827,-40
115037653554,115037653562,8,3554,1235,-40
115039338802,115039338808,6,2709,1235,-40
115039660993,115039660998,5,2648,973,-40
115045572570,115045572574,4,1970,1469,-40
115047515899,115047515905,6,2619,1297,-40
115048837109,115048837115,6,2475,1016,-40
115049217831,115049217834,3,4065,1409,-40
115050094138,115050094143,5,3583,1255,-40
115052133329,115052133335,6,3563,1530,-40
115057948978,115057948985,7,2492,1214,-40
115060296602,115060296609,7,1644,619,-40
115061025910,115061025922,12,945,221,-40
115061522042,115061522046,4,2240,1445,-40
115064393510,115064393503,-7,1053,5630,-40
115065939694,115065939698,4,2990,1366,-40
115066528881,115066528878,-3,1361,3723,-40
115067869461,115067869466,5,3407,1785,-40
115069174648,115069174654,6,2857,1170,-40
115072686900,115072686906,6,3989,1476,-40
115075722368,115075722369,1,2396,2274,-40
115075787554,115075787562,8,2444,1208,-40
115076288459,115076288454,-5,1245,3371,-40
115076657622,115076657623,1,26483,19946,-40
115082053113,115082053118,5,2502,905,-40
115083042713,115083042718,5,2409,1637,-40
115083231284,115083231282,-2,959,290,-40
115085137810,115085137816,6,2531,1177,-40
115086025594,115086025578,-16,999,382,-40
115089119702,115089119709,7,2698,1229,-40
115089251073,115089251057,-16,4533,1874,-40
115089507217,115089507222,5,1460,821,-40
115091553882,115091553876,-6,3586,8801,-40
115092493372,115092493379,7,3572,1668,-40
115093676674,115093676680,6,2669,1615,-40
115095514729,115095514734,5,3277,1462,-40
115096723196,115096723202,6,2942,1531,-40
115097681857,115097681859,2,855,180,-40
115100744110,115100744118,8,3828,1395,-40
115102431112,115102431119,7,2719,1393,-40
115111231730,115111231735,5,2597,1229,-40
115112764981,115112764986,5,2520,1297,-40
115112792793,115112792798,5,2773,1188,-40
115119108262,115119108269,7,2939,1649,-40
115119488122,115119488129,7,3262,1303,-40
115120924295,115120924295,0,20720,18547,-40
115125542164,115125542172,8,2010,1337,-40
115127288308,115127288301,-7,1112,3953,-40
115128885521,115128885537,16,1971,1040,-40
115129464462,115129464441,-21,2997,1254,-40
115137918088,115137918094,6,2891,1545,-40
115138345031,115138345038,7,2853,1325,-40
115141492455,115141492458,3,2304,1221,-40
115147404548,115147404554,6,2371,1116,-40
115147600413,115147600419,6,2040,868,-40
115149062014,115149062018,4,1409,539,-40
115152546561,115152546567,6,2498,908,-40
115156085798,115156085805,7,2689,1437,-40
115158580554,115158580560,6,3354,1230,-40
115164555178,115164555184,6,3602,1746,-40
115172037299,115172037306,7,2830,948,-40
115173569556,115173569561,5,1087,122,-40
115175203940,115175203943,3,42585,29296,-40
115177256095,115177256102,7,3564,1567,-40
115177731794,115177731799,5,2318,1304,-40
115178922571,115178922553,-18,1149,152,-40
115179155331,115179155337,6,4017,1599,-40
115182834701,115182834706,5,2191,1398,-40
115183325738,115183325721,-17,3123,1557,-40
115184296061,115184296069,8,2401,1662,-40
115192509340,115192509347,7,3178,1173,-40
115193199182,115193199186,4,1582,1212,-40
115194414602,115194414609,7,3724,1196,-40
115194532293,115194532281,-12,2214,644,-40
115195753774,115195753779,5,3090,1277,-40
115201536470,115201536476,6,3477,1580,-40
115202811021,115202811026,5,2503,1456,-40
115204819650,115204819655,5,2634,1023,-40
115207210199,115207210183,-16,1933,35617,-40
115212314695,115212314703,8,3797,1261,-40
115213896261,115213896268,7,3990,1506,-40
115214640107,115214640113,6,2587,1330,-40
115215006759,115215006764,5,15611,53122,-40
115217465485,115217465491,6,2845,1010,-40
115218844512,115218844516,4,2264,1283,-40
115222223959,115222223965,6,3059,955,-40
115222943616,115222943622,6,3305,1168,-40
115223792414,115223792426,12,405,19,-40
115226895028,115226895031,3,4519,3364,-40
115227227874,115227227882,8,3262,1121,-40
115229010069,115229010075,6,3477,1626,-40
115234237635,115234237638,3,1703,1243,-40
115237530273,115237530279,6,1694,817,-40
115240934181,115240934178,-3,2649,6307,-40
115242375610,115242375617,7,3099,1131,-40
115248408507,115248408514,7,3813,1100,-40
115251982832,115251982838,6,3240,974,-40
115252142678,115252142696,18,2960,986,-40
115252782169,115252782178,9,2416,1094,-40
115252976909,115252976889,-20,2454,814,-40
115259199299,115259199307,8,3060,1245,-40
115259481967,115259481954,-13,1000,512,-40
115259590562,115259590569,7,2993,1019,-40
115266673523,115266673530,7,2093,1032,-40
115270465296,115270465302,6,3889,1790,-40
115272656301,115272656306,5,1933,1065,-40
115284673785,115284673789,4,1987,1428,-40
115284830159,115284830147,-12,845,148,-40
115285583158,115285583161,3,3021,1687,-40
115285894685,115285894692,7,2515,1414,-40
115286955174,115286955178,4,1823,1045,-40
115287387579,115287387581,2,30827,45146,-40
115299401378,115299401383,5,2559,1483,-40
115299511479,115299511485,6,2409,1364,-40
115305227591,115305227605,14,3438,1323,-40
115305342842,115305342826,-16,815,497,-40
115306770951,115306770954,3,916,830,-40
115309416466,115309416474,8,3644,1383,-40
115312247821,115312247826,5,1438,680,-40
115314376522,115314376527,5,2658,1315,-40
115315580217,115315580223,6,2668,1304,-40
115319872971,115319872979,8,2953,1715,-40
115321033778,115321033786,8,2967,1236,-40
115322830912,115322830930,18,383,1996,-40
115323227472,115323227478,6,3198,1249,-40
115326233517,115326233523,6,2857,1170,-40
115328531967,115328531973,6,2816,1047,-40
115329115821,115329115826,5,3662,1087,-40
115333696435,115333696434,-1,1532,1649,-40
115335396180,115335396186,6,3420,1355,-40
115338297834,115338297841,7,2857,1651,-40
115340643517,115340643524,7,3084,1826,-40
115343158132,115343158138,6,2902,1612,-40
115343287822,115343287811,-11,949,251,-40
115343742829,115343742834,5,2504,1078,-40
115344687729,115344687736,7,1350,744,-40
115347535297,115347535302,5,3096,783,-40
115349835771,115349835778,7,2151,718,-40
115350026375,115350026363,-12,1075,475,-40
115353106550,115353106558,8,3122,1376,-40
115353162026,115353162016,-10,1040,492,-40
115353225686,115353225693,7,2703,1101,-40
115353368696,115353368705,9,1020,455,-40
115353638390,115353638396,6,3712,1237,-40
115354208772,115354208752,-20,2353,738,-40
115355567309,115355567316,7,2161,1183,-40
115356199181,115356199186,5,2330,1181,-40
115358018922,115358018929,7,3676,1262,-40
115360333973,115360333980,7,2598,1121,-40
115360503218,115360503202,-16,244,12,-40
115367951857,115367951861,4,2679,1061,-40
115377320978,115377320983,5,2382,1066,-40
115378313508,115378313508,0,1286,1671,-40
115382555986,115382555993,7,2779,1661,-40
115384968662,115384968667,5,2298,1167,-40
115385129943,115385129923,-20,2290,1736,-40
115386453217,115386453224,7,3626,1349,-40
115387881531,115387881514,-17,2998,1750,-40
115388665484,115388665490,6,2945,1265,-40
115389581267,115389581256,-11,822,279,-40
115391924122,115391924125,3,2277,1058,-40
115392815567,115392815574,7,3236,1589,-40
115393594379,115393594385,6,2706,1228,-40
115397405820,115397405827,7,5271,1317,-40
115397863300,115397863306,6,3124,1243,-40
115400703295,115400703291,-4,775,1977,-40
115401037750,115401037758,8,2209,1378,-40
115401849899,115401849906,7,3239,1523,-40
115402035429,115402035431,2,1723,1319,-40
115402299083,115402299091,8,4028,1289,-40
115404813681,115404813687,6,2435,918,-40
115407823981,115407823986,5,2540,1301,-40
115408280519,115408280526,7,2521,1234,-40
115411051801,115411051805,4,1343,1422,-40
115411501376,115411501382,6,2018,1270,-40
115412033150,115412033154,4,2202,1181,-40
115413032035,115413032041,6,3812,1858,-40
115414237549,115414237556,7,3262,1662,-40
115414614979,115414614985,6,2444,1413,-40
115420655546,115420655549,3,1707,1748,-40
115421127506,115421127510,4,2269,994,-40
115433437978,115433437982,4,2908,1328,-40
115433822438,115433822434,-4,1274,338,-40
115435443086,115435443092,6,1413,1246,-40
115435626015,115435625995,-20,965,1292,-40
115437729005,115437729010,5,2411,1361,-40
115437762307,115437762313,6,2505,1079,-40
115439257342,115439257346,4,2664,726,-40
115443504828,115443504833,5,2837,1715,-40
115444059226,115444059233,7,3296,1311,-40
115444848541,115444848522,-19,3684,1027,-40
115445139073,115445139079,6,3340,1847,-40
115449674325,115449674331,6,2729,1731,-40
115449891100,115449891105,5,2852,1034,-40
115454823293,115454823298,5,3594,1923,-40
115456572977,115456572983,6,3368,1202,-40
115461103233,115461103237,4,2512,1553,-40
115462652253,115462652259,6,3200,1132,-40
115465361862,115465361870,8,3523,1574,-40
115469448206,115469448214,8,2735,1437,-40
115470323847,115470323846,-1,1210,1719,-40
115472039227,115472039234,7,3323,1394,-40
115474076136,115474076131,-5,978,3269,-40
115475566605,115475566611,6,2416,1485,-40
115478587999,115478588006,7,3468,1417,-40
115484259927,115484259933,6,2236,1267,-40
115488190460,115488190440,-20,834,398,-40
115489196805,115489196813,8,2972,1013,-40
115490322116,115490322122,6,2845,1834,-40
115492785730,115492785735,5,2919,1596,-40
115494249705,115494249711,6,1604,814,-40
115497913329,115497913336,7,4787,1471,-40
115500070649,115500070656,7,4195,1540,-40
115503467422,115503467426,4,1916,1190,-40
115506209021,115506209027,6,2670,1121,-40
115510175778,115510175785,7,1365,680,-40
115514617516,115514617521,5,2507,933,-40
115515233182,115515233188,6,3309,1405,-40
115515484630,115515484638,8,3293,1381,-40
115520017177,115520017158,-19,955,439,-40
115520652230,115520652237,7,3408,1240,-40
115521290183,115521290176,-7,611,95,-40
115521862610,115521862607,-3,1984,4438,-40
115522146142,115522146143,1,1768,1506,-40
115522807601,115522807582,-19,907,3931,-40
115522838814,115522838809,-5,15965,64064,-40
115523754250,115523754257,7,3649,1008,-40
115524845446,115524845442,-4,1362,3505,-40
115525055845,115525055851,6,1864,1202,-40
115528914338,115528914334,-4,1661,5043,-40
115529769605,115529769610,5,2385,1168,-40
115531695433,115531695441,8,3329,953,-40
115532344376,115532344382,6,3146,1333,-40
115532688530,115532688535,5,2124,1245,-40
115535532337,115535532345,8,3177,1912,-40
115540655862,115540655869,7,2491,825,-40
115541838933,115541838940,7,2893,1148,-40
115542895662,115542895669,7,3495,1644,-40
115545126135,115545126142,7,2828,1078,-40
115545966743,115545966747,4,1513,1096,-40
115548253894,115548253900,6,2056,1376,-40
115549254054,115549254052,-2,18769,3674,-40
115549975091,115549975098,7,2254,1381,-40
115559308602,115559308609,7,3912,1212,-40
115562134167,115562134164,-3,2615,15237,-40
115563211700,115563211707,7,2520,1080,-40
115563850393,115563850398,5,2597,1449,-40
115567088939,115567088936,-3,1108,2156,-40
115570304934,115570304939,5,2398,862,-40
115571034037,115571034034,-3,1301,133,-40
115573589316,115573589317,1,1686,1703,-40
115576400341,115576400348,7,2679,1408,-40
115577329121,115577329125,4,2190,739,-40
115588241457,115588241462,5,4536,2591,-40
115589415928,115589415935,7,1677,1445,-40
115591760557,115591760563,6,3756,1229,-40
115597603164,115597603171,7,2112,972,-40
115599539414,115599539417,3,2768,2058,-40
115605166761,115605166766,5,3398,1429,-40
115607251857,115607251861,4,2744,986,-40
115610216097,115610216103,6,3683,823,-40
115610324053,115610324059,6,2689,1306,-40
115612260782,115612260787,5,3370,1212,-40
115619051769,115619051775,6,3684,1060,-40
115623329013,115623329018,5,2233,1344,-40
115624111707,115624111690,-17,2908,788,-40
115627465238,115627465242,4,1287,905,-40
115628123069,115628123075,6,2527,1070,-40
115631520538,115631520545,7,2403,906,-40
115632424741,115632424746,5,2519,1379,-40
115633026326,115633026333,7,3496,1512,-40
115634653634,115634653641,7,6523,2265,-40
115639268945,115639268951,6,3998,1898,-40
115642428026,115642428032,6,2831,1671,-40
115648799049,115648799055,6,2690,730,-40
115649007635,115649007634,-1,1055,1392,-40
115649239194,115649239199,5,2670,1306,-40
115650452046,115650452033,-13,1918,706,-40
115650810917,115650810922,5,2088,1348,-40
115650995104,115650995110,6,2736,1526,-40
115655913214,115655913219,5,2500,1076,-40
115657783856,115657783861,5,1888,1130,-40
115658732478,115658732483,5,2413,1459,-40
115665402531,115665402537,6,3026,1507,-40
115668796453,115668796457,4,2275,1302,-40
115669052815,115669052821,6,2966,1107,-40
115670837258,115670837273,15,17303,22621,-40
115672093033,115672093038,5,2597,1542,-40
115675984696,115675984702,6,2664,1445,-40
115676312403,115676312416,13,921,30,-40
115679396021,115679396027,6,2322,984,-40
115684567302,115684567308,6,3984,1402,-40
115691545177,115691545183,6,2553,879,-40
115697218837,115697218843,6,2966,1808,-40
115699078154,115699078161,7,3334,1267,-40
115705630303,115705630296,-7,3281,12044,-40
115706644698,115706644703,5,2329,1095,-40
115707801252,115707801259,7,2935,1016,-40
115713640005,115713640008,3,2793,1150,-40
115714794535,115714794543,8,2586,792,-40
115717619950,115717619945,-5,1023,5136,-40
115720913959,115720913966,7,2219,1381,-40
115722415955,115722415960,5,3216,1711,-40
115724318078,115724318083,5,2424,1452,-40
115724383179,115724383186,7,2519,1073,-40
115724490808,115724490825,17,901,181,-40
115730858208,115730858213,5,3164,1395,-40
115732096274,115732096283,9,2056,778,-40
115732476648,115732476659,11,2251,1047,-40
115733008742,115733008749,7,3223,1458,-40
115734086941,115734086947,6,3008,1579,-40
115734247183,115734247195,12,3481,1565,-40
115735384596,115735384603,7,3190,1635,-40
115744162558,115744162565,7,3249,1579,-40
115744500858,115744500842,-16,1167,748,-40
115747039157,115747039161,4,3302,1548,-40
115748348723,115748348717,-6,1047,4414,-40
115748471525,115748471530,5,3019,1207,-40
115749992120,115749992123,3,2175,947,-40
115750765878,115750765857,-21,5394,895,-40
115751946508,115751946516,8,3083,1369,-40
115758088580,115758088586,6,2338,1048,-40
115761733849,115761733854,5,2236,1146,-40
115762449777,115762449777,0,1662,2019,-40
115762674281,115762674297,16,2365,1321,-40
115762757654,115762757660,6,3110,1488,-40
115763250627,115763250623,-4,1061,2314,-40
115765109846,115765109853,7,2931,1656,-40
115771666313,115771666318,5,2437,1124,-40
115772069030,115772069035,5,2715,866,-40
115772416353,115772416359,6,2261,1088,-40
115773077550,115773077555,5,2427,1356,-40
115778606877,115778606884,7,3769,1266,-40
115778999654,115778999655,1,3510,4041,-40
115783610386,115783610392,6,3258,1040,-40
115784682924,115784682929,5,3881,1322,-40
115784756077,115784756083,6,3061,1287,-40
115785104310,115785104297,-13,1519,199,-40
115785857055,115785857062,7,2073,740,-40
115786526150,115786526160,10,3108,1337,-40
115788551736,115788551737,1,2119,1494,-40
115793897585,115793897595,10,2319,1098,-40
115799278403,115799278407,4,1722,1763,-40
115807964092,115807964090,-2,1823,2698,-40
115811161753,115811161756,3,1623,1012,-40
115815033506,115815033511,5,2841,1105,-40
115817972934,115817972938,4,1337,880,-40
115821490005,115821490010,5,1574,1009,-40
115822629087,115822629073,-14,950,246,-40
115823034702,115823034706,4,2452,1243,-40
115824657862,115824657867,5,4007,1530,-40
115826658742,115826658750,8,3493,847,-40
115828012874,115828012879,5,2198,1263,-40
115829695277,115829695292,15,389,2835,-40
115832553566,115832553570,4,3054,1684,-40
115839497493,115839497498,5,3675,1271,-40
115841356155,115841356161,6,1445,699,-40
115844246753,115844246758,5,2370,1013,-40
115845054349,115845054354,5,2018,981,-40
115846860912,115846860918,6,2691,988,-40
115847121798,115847121805,7,1564,821,-40
115848320256,115848320262,6,2677,1238,-40
115850879721,115850879727,6,2493,1326,-40
115851659686,115851659694,8,2588,1232,-40
115853554879,115853554884,5,3326,1453,-40
115854806946,115854806954,8,2695,1302,-40
115857468777,115857468785,8,3122,1418,-40
115857628178,115857628171,-7,512,387,-40
115865904409,115865904415,6,2114,1208,-40
115876150130,115876150136,6,2589,1322,-40
115880499314,115880499319,5,3208,1345,-40
115880649297,115880649302,5,3008,1475,-40
115881576922,115881576929,7,3103,891,-40
115882008146,115882008139,-7,610,44,-40
115884401367,115884401387,20,2382,1267,-40
115887275788,115887275793,5,2017,1364,-40
115888368065,115888368070,5,1935,1388,-40
115889115362,115889115369,7,2289,979,-40
115891485323,115891485331,8,3185,969,-40
115893557549,115893557554,5,2634,1338,-40
115894348413,115894348419,6,3087,1160,-40
115897946847,115897946849,2,1433,1478,-40
115899534955,115899534959,4,2617,1154,-40
115899709410,115899709416,6,3266,1171,-40
115903713728,115903713733,5,2018,933,-40
115904712100,115904712105,5,2354,1304,-40
115905880241,115905880247,6,2975,956,-40
115907312394,115907312401,7,2819,1376,-40
115917742479,115917742487,8,2390,1090,-40
115919232601,115919232606,5,2598,1303,-40
115919415325,115919415331,6,879,615,-40
115919781658,115919781641,-17,1301,385,-40
115920055097,115920055103,6,1739,996,-40
115921854936,115921854941,5,3517,1106,-40
115921963797,115921963780,-17,2032,424,-40
115926537377,115926537379,2,924,122,-40
115929527959,115929527967,8,3244,968,-40
115930555638,115930555645,7,3487,1195,-40
115930643042,115930643024,-18,2398,1210,-40
115931067037,115931067051,14,1039,164,-40
115932474400,115932474387,-13,1089,594,-40
115934717888,115934717894,6,3397,1355,-40
115935077412,115935077417,5,2078,1169,-40
115941774589,115941774594,5,3801,1345,-40
115943057559,115943057562,3,3262,2681,-40
115944576746,115944576730,-16,2658,928,-40
115944994125,115944994130,5,1602,724,-40
115946552010,115946551992,-18,2615,1295,-40
115946646375,115946646356,-19,4095,3361,-40
115952446094,115952446078,-16,1202,518,-40
115955957462,115955957461,-1,1433,1870,-40
115961126437,115961126442,5,2000,1138,-40
115963780305,115963780311,6,2850,1045,-40
115964836764,115964836770,6,2408,1079,-40
115966380926,115966380934,8,3375,1547,-40
115968745538,115968745540,2,1519,1574,-40
115971449942,115971449946,4,2085,1084,-40
115972318302,115972318309,7,2723,1423,-40
115972596874,115972596882,8,1793,853,-40
115973023796,115973023819,23,2363,1173,-40
115974007004,115974007010,6,1830,1093,-40
115975690047,115975690054,7,1400,1206,-40
115976506218,115976506217,-1,763,123,-40
115977826569,115977826575,6,2414,1487,-40
115980414393,115980414400,7,4411,2181,-40
115984988711,115984988717,6,2324,1074,-40
115985694927,115985694932,5,2938,1579,-40
115990385018,115990385025,7,2359,785,-40
115990459559,115990459544,-15,1119,507,-40
115994225553,115994225560,7,2356,1468,-40
115994609738,115994609743,5,1647,684,-40
115995533474,115995533482,8,2562,1050,-40
115997246051,115997246052,1,1059,1489,-40
115998980490,115998980497,7,2068,885,-40
115999851037,115999851051,14,2473,1153,-40
116002279913,116002279921,8,6310,2927,-40
116002447433,116002447439,6,3266,1524,-40
116005883491,116005883497,6,2573,782,-40
116006117682,116006117668,-14,887,326,-40
116009517025,116009517033,8,3089,1460,-40
116010352944,116010352931,-13,2135,1062,-40
116016525265,116016525271,6,3000,1249,-40
116016555454,116016555459,5,2475,1283,-40
116016833575,116016833581,6,2845,1110,-40
116019894080,116019894086,6,1821,1054,-40
116020084755,116020084749,-6,1283,3304,-40
116022002501,116022002506,5,4074,1445,-40
116030962652,116030962659,7,2473,1553,-40
116031367175,116031367182,7,2801,1148,-40
116042506105,116042506113,8,5048,948,-40
116042995292,116042995298,6,2450,1293,-40
116043120441,116043120449,8,1829,1134,-40
116050821062,116050821070,8,4094,1537,-40
116053118034,116053118040,6,2952,720,-40
116053934453,116053934459,6,2911,1248,-40
116054074016,116054074036,20,921,2394,-40
116054851113,116054851119,6,2679,907,-40
116055314749,116055314755,6,3155,1423,-40
116056305309,116056305314,5,2674,922,-40
116056412698,116056412714,16,3392,1213,-40
116057567034,116057567040,6,2281,1341,-40
116061094984,116061094997,13,2421,1013,-40
116062586117,116062586123,6,3046,908,-40
116064199816,116064199818,2,1723,1435,-40
116070589184,116070589191,7,2611,1199,-40
116078449774,116078449779,5,18831,36270,-40
116080385879,116080385886,7,3334,1542,-40
116080783339,116080783343,4,2394,1461,-40
116082325374,116082325374,0,2719,4284,-40
116083207237,116083207244,7,1952,870,-40
116088578338,116088578345,7,2664,1243,-40
116088826354,116088826340,-14,2696,1293,-40
116090535810,116090535817,7,2429,1517,-40
116095938397,116095938403,6,2475,715,-40
116096664485,116096664492,7,2081,1438,-40
116098077422,116098077404,-18,1111,686,-40
116102030250,116102030255,5,2518,1203,-40
116106992953,116106992958,5,3279,682,-40
116109416650,116109416658,8,2783,1272,-40
116111484701,116111484706,5,3090,1164,-40
116111823787,116111823794,7,2963,1344,-40
116112722121,116112722129,8,4015,1613,-40
116113188240,116113188245,5,2871,1242,-40
116113353644,116113353628,-16,1181,482,-40
116114569682,116114569691,9,5011,1405,-40
116117913679,116117913682,3,2115,1677,-40
116118127988,116118127994,6,3297,1080,-40
116120984486,116120984493,7,2707,1182,-40
116121739757,116121739763,6,2057,1269,-40
116123727207,116123727209,2,1501,1271,-40
116124777938,116124777942,4,3978,1376,-40
116126066432,116126066438,6,3192,1445,-40
116128489012,116128489019,7,3237,1680,-40
116128621108,116128621115,7,3079,1325,-40
116129846381,116129846388,7,3546,1777,-40
116130694003,116130694010,7,2487,1124,-40
116131867814,116131867821,7,2053,997,-40
116133732546,116133732554,8,3312,1445,-40
116142221662,116142221667,5,2726,1737,-40
116144888508,116144888515,7,2514,1450,-40
116147466342,116147466349,7,1699,931,-40
116148365239,116148365246,7,3200,1341,-40
116150052296,116150052302,6,3184,1100,-40
116150830754,116150830756,2,17538,14652,-40
116154149063,116154149069,6,2844,1682,-40
116155053614,116155053606,-8,757,151,-40
116156802238,116156802243,5,2865,991,-40
116163160130,116163160136,6,2860,1313,-40
116163727201,116163727196,-5,1817,7692,-40
116164692232,116164692239,7,3386,1056,-40
116166227627,116166227622,-5,1630,4145,-40
116169033134,116169033141,7,2519,2120,-40
116174883001,116174883008,7,3246,1240,-40
116174978383,116174978363,-20,2623,761,-40
116175095393,116175095401,8,2386,1012,-40
116175505489,116175505495,6,2828,1013,-40
116177511502,116177511507,5,1667,890,-40
116181809841,116181809846,5,1948,1149,-40
116182375711,116182375690,-21,1446,1030,-40
116184415510,116184415522,12,102,2424,-40
116185981287,116185981290,3,1517,1177,-40
116186246330,116186246337,7,3525,1435,-40
116186835741,116186835749,8,2643,937,-40
116189783755,116189783762,7,2615,1086,-40
116190413313,116190413319,6,2983,1517,-40
116192357153,116192357159,6,2452,1081,-40
116194434014,116194434021,7,2242,1167,-40
116198676302,116198676290,-12,1142,534,-40
116200648405,116200648411,6,1971,1189,-40
116206009601,116206009605,4,2362,1285,-40
116207071970,116207071973,3,1522,1569,-40
116208831970,116208831976,6,3440,1412,-40
116208907991,116208907998,7,3238,1251,-40
116212844182,116212844166,-16,4162,1005,-40
116216318622,116216318627,5,2377,1102,-40
116227547367,116227547374,7,3089,1211,-40
116234862120,116234862127,7,2841,904,-40
116236350870,116236350875,5,2885,1398,-40
116236793203,116236793208,5,2109,890,-40
116242826118,116242826123,5,2829,1187,-40
116244535565,116244535572,7,3661,1546,-40
116246009677,116246009684,7,3222,1554,-40
116250924345,116250924349,4,2392,714,-40
116251260916,116251260896,-20,2713,930,-40
116252065077,116252065064,-13,1712,1075,-40
116254026226,116254026231,5,3032,1143,-40
116254059805,116254059811,6,2223,1338,-40
116254489192,116254489198,6,2727,1215,-40
116254782412,116254782401,-11,1355,296,-40
116254969850,116254969855,5,2125,972,-40
116259463130,116259463138,8,3215,1062,-40
116260662160,116260662166,6,3185,1301,-40
116265412802,116265412791,-11,1224,2378,-40
116272064739,116272064742,3,1577,1670,-40
116277182172,116277182176,4,19195,14436,-40
116277517301,116277517307,6,2465,1789,-40
116277926256,116277926262,6,3615,1280,-40
116281425509,116281425514,5,3255,991,-40
116287166437,116287166443,6,3707,1335,-40
116289403658,116289403663,5,2653,1647,-40
116289892189,116289892188,-1,20336,12176,-40
116294785693,116294785699,6,2379,1396,-40
116295325223,116295325227,4,2462,1686,-40
116299070795,116299070802,7,3394,1705,-40
116299147643,116299147624,-19,4431,806,-40
116299338429,116299338435,6,2039,1154,-40
116302842460,116302842466,6,1868,1258,-40
116311354444,116311354451,7,2709,1039,-40
116315140178,116315140182,4,3496,1685,-40
116318484519,116318484526,7,1909,1284,-40
116320609800,116320609807,7,2398,1026,-40
116322441909,116322441914,5,1657,1450,-40
116325471271,116325471277,6,2363,1075,-40
116329855312,116329855315,3,4162,2653,-40
116332365410,116332365417,7,2286,932,-40
116334182950,116334182954,4,2905,1250,-40
116338121830,116338121833,3,2361,1724,-40
116339444314,116339444320,6,3437,1319,-40
116340537021,116340537027,6,4334,1917,-40
116345028658,116345028661,3,1818,1276,-40
116345717194,116345717201,7,2115,1162,-40
116347186348,116347186354,6,2763,1453,-40
116348508402,116348508407,5,2350,1095,-40
116348801599,116348801610,11,783,304,-40
116349157036,116349157045,9,17238,49519,-40
116350745424,116350745430,6,3652,1289,-40
116354258230,116354258237,7,3238,1620,-40
116354421150,116354421155,5,2572,1990,-40
116355120502,116355120507,5,2275,1118,-40
116357477293,116357477296,3,3116,1503,-40
116359003582,116359003587,5,3023,960,-40
116360016239,116360016220,-19,2292,2980,-40
116360939930,116360939938,8,3905,1457,-40
116361285410,116361285418,8,3601,1730,-40
116373492453,116373492459,6,2444,1148,-40
116374091778,116374091761,-17,1058,382,-40
116374561204,116374561210,6,2315,1170,-40
116382940182,116382940197,15,42983,13789,-40
116383590821,116383590823,2,2536,1249,-40
116391365436,116391365443,7,2777,1118,-40
116400782826,116400782835,9,2650,1253,-40
116405694565,116405694570,5,3433,1275,-40
116409180369,116409180381,12,13975,26275,-40
116413744398,116413744402,4,39805,34190,-40
116418407843,116418407826,-17,922,301,-40
116425971018,116425971025,7,2710,1414,-40
116426713789,116426713796,7,2705,1243,-40
116426997966,116426997976,10,3288,1380,-40
116427068112,116427068131,19,2964,1087,-40
116427261513,116427261499,-14,3601,1432,-40
116429916064,116429916070,6,1894,996,-40
116430766053,116430766060,7,2465,1020,-40
116433661060,116433661066,6,3944,1550,-40
116437292254,116437292262,8,3356,797,-40
116439473043,116439473050,7,2559,1257,-40
116440596842,116440596846,4,2296,1285,-40
116442225418,116442225425,7,3002,1567,-40
116442299655,116442299659,4,40647,8626,-40
116442814441,116442814438,-3,1025,2006,-40
116444565810,116444565818,8,2580,1216,-40
116444873128,116444873135,7,2751,1587,-40
116446691865,116446691871,6,3540,1204,-40
116446909262,116446909270,8,3771,896,-40
116448577438,116448577433,-5,2519,6916,-40
116453173025,116453173032,7,1690,982,-40
116453776828,116453776834,6,3130,1455,-40
116455572525,116455572539,14,2682,1095,-40
116456753409,116456753415,6,3620,1604,-40
116457494834,116457494839,5,3008,1123,-40
116461670753,116461670759,6,2362,1095,-40
116464300978,116464300979,1,1025,1164,-40
116466337105,116466337111,6,3381,1320,-40
116469351000,116469351006,6,3185,1404,-40
116470489651,116470489653,2,2359,1197,-40
116470815082,116470815083,1,1218,1475,-40
116472237320,116472237327,7,5534,1260,-40
116472317774,116472317792,18,1263,363,-40
116473762587,116473762591,4,1968,1333,-40
116483863584,116483863590,6,2822,764,-40
116487596222,116487596233,11,2685,804,-40
116496323434,116496323442,8,2776,1328,-40
116499081025,116499081032,7,3203,1553,-40
116499107272,116499107277,5,2064,1190,-40
116499656233,116499656239,6,2160,1732,-40
116503518145,116503518150,5,2401,984,-40
116504072014,116504071995,-19,2927,1229,-40
116506233781,116506233787,6,1921,1295,-40
116508327063,116508327067,4,2551,1190,-40
116510063078,116510063094,16,1375,2758,-40
116512045082,116512045087,5,2526,1939,-40
116512793519,116512793523,4,2336,1623,-40
116518978267,116518978273,6,1518,911,-40
116527629143,116527629149,6,3301,1929,-40
116532018267,116532018273,6,2875,1028,-40
116532658448,116532658453,5,2611,1392,-40
116534074218,116534074214,-4,908,2126,-40
116535263163,116535263167,4,1340,716,-40
116538606010,116538606014,4,2144,857,-40
116541062567,116541062574,7,3088,1240,-40
116542323573,116542323579,6,3099,1468,-40
116543205781,116543205777,-4,1062,2982,-40
116546002174,116546002178,4,2302,1730,-40
116546383682,116546383688,6,2427,1103,-40
116546985950,116546985969,19,1287,203,-40
116547172765,116547172770,5,1087,898,-40
116548533402,116548533407,5,1633,1243,-40
116555289177,116555289185,8,2705,1391,-40
116556970903,116556970905,2,1270,876,-40
116558480161,116558480167,6,2928,1055,-40
116562150575,116562150581,6,2190,1446,-40
116562471129,116562471136,7,2422,1111,-40
116562548998,116562549005,7,2862,876,-40
116565491333,116565491338,5,1622,1205,-40
116568146553,116568146558,5,2861,1594,-40
116571295250,116571295257,7,3298,1217,-40
116572548316,116572548321,5,1291,562,-40
116575632929,116575632934,5,2322,1694,-40
116575923210,116575923217,7,3391,1176,-40
116576843387,116576843386,-1,654,1415,-40
116582014029,116582014021,-8,1884,13946,-40
116584160370,116584160375,5,2939,1362,-40
116588202573,116588202581,8,2898,1143,-40
116588466718,116588466724,6,2068,1034,-40
116590554686,116590554692,6,2632,1210,-40
116591152173,116591152179,6,2959,1415,-40
116594937765,116594937771,6,3347,1477,-40
116598208290,116598208297,7,2305,1192,-40
116603445115,116603445123,8,12310,29103,-40
116605253153,116605253158,5,3172,1217,-40
116605961139,116605961146,7,2937,1224,-40
116606513766,116606513746,-20,1052,248,-40
116607676201,116607676207,6,2139,1045,-40
116612583601,116612583607,6,2414,984,-40
116614900423,116614900430,7,3528,1659,-40
116615463845,116615463845,0,2065,3004,-40
116617101765,116617101773,8,2915,1361,-40
116619028701,116619028703,2,2444,3222,-40
116620023630,116620023638,8,3520,1749,-40
116620672556,116620672553,-3,770,1988,-40
116621469266,116621469281,15,973,246,-40
116623052766,116623052771,5,2554,1269,-40
116623191760,116623191766,6,3322,813,-40
116625029402,116625029403,1,1177,1004,-40
116626334615,116626334595,-20,2036,1435,-40
116629382023,116629382031,8,2384,1397,-40
116629598749,116629598770,21,987,179,-40
116631136744,116631136750,6,2154,1252,-40
116632609776,116632609782,6,3545,1109,-40
116635447425,116635447429,4,3075,1615,-40
116636544090,116636544096,6,2988,1795,-40
116636710259,116636710265,6,2158,1350,-40
116653851626,116653851632,6,2466,1130,-40
116665277310,116665277316,6,3025,1267,-40
116675981441,116675981447,6,2711,1157,-40
116678544957,116678544962,5,3530,1719,-40
116681449531,116681449538,7,2928,1808,-40
116684774376,116684774383,7,2799,1411,-40
116685413581,116685413585,4,4244,1115,-40
116686332014,116686331996,-18,2988,1956,-40
116687847718,116687847723,5,2605,1688,-40
116693182387,116693182385,-2,1688,4348,-40
116696924945,116696924950,5,1597,1211,-40
116698628106,116698628104,-2,731,31,-40
116698970241,116698970245,4,1779,1231,-40
116700552671,116700552668,-3,635,1776,-40
116701155805,116701155807,2,1202,1022,-40
116704487380,116704487385,5,2309,558,-40
116705030843,116705030849,6,3730,1458,-40
116707225593,116707225599,6,3427,1408,-40
116708341268,116708341274,6,2104,1048,-40
116710190341,116710190346,5,3302,1353,-40
116710698467,116710698473,6,2521,1367,-40
116710738436,116710738442,6,2653,1197,-40
116722322779,116722322785,6,2401,1132,-40
116722504873,116722504874,1,791,177,-40
116725401917,116725401922,5,857,413,-40
116729407185,116729407191,6,3582,1256,-40
116729467602,116729467592,-10,1917,407,-40
116736803666,116736803673,7,2901,944,-40
116738973446,116738973454,8,2767,1301,-40
116739170782,116739170789,7,2357,1169,-40
116739623901,116739623880,-21,631,229,-40
116744518775,116744518781,6,3663,1547,-40
116746521354,116746521354,0,1311,1990,-40
116747453783,116747453788,5,2686,1657,-40
116749975869,116749975875,6,2306,1256,-40
116754841522,116754841527,5,3289,1484,-40
116757950085,116757950091,6,2970,1298,-40
116759132658,116759132664,6,3022,1369,-40
116760816962,116760816968,6,3573,1751,-40
116767926338,116767926345,7,3769,1598,-40
116768976884,116768976891,7,2455,1298,-40
116772793286,116772793292,6,3578,1865,-40
116773917223,116773917228,5,1823,1593,-40
116778347036,116778347044,8,2630,1410,-40
116783077188,116783077190,2,1199,1063,-40
116783434206,116783434198,-8,2207,9728,-40
116783808937,116783808942,5,3590,1139,-40
116784148380,116784148386,6,2658,1165,-40
116786169023,116786169031,8,1887,1012,-40
116789399139,116789399145,6,2975,1042,-40
116789593446,116789593424,-22,1149,372,-40
116789927705,116789927711,6,3065,1601,-40
116791130773,116791130778,5,2770,1662,-40
116792124171,116792124150,-21,944,3148,-40
116794957245,116794957253,8,1466,597,-40
116798420280,116798420288,8,2502,1334,-40
116798495562,116798495578,16,842,149,-40
116800051378,116800051385,7,3530,1587,-40
116806395135,116806395141,6,2987,1411,-40
116811629737,116811629742,5,1427,1176,-40
116813456299,116813456305,6,1938,1049,-40
116814330702,116814330709,7,3351,1503,-40
116814429907,116814429911,4,2414,1021,-40
116818085932,116818085938,6,3005,878,-40
116820268910,116820268915,5,2394,1494,-40
116820484194,116820484197,3,1934,1347,-40
116823489733,116823489741,8,2668,1079,-40
116825080542,116825080548,6,3114,1617,-40
116827804818,116827804825,7,1614,932,-40
116830817179,116830817185,6,2760,1273,-40
116833486724,116833486731,7,3955,1372,-40
116833632636,116833632643,7,2374,1112,-40
116834898234,116834898233,-1,1202,2129,-40
116835036973,116835036978,5,2243,924,-40
116835158532,116835158539,7,3416,1586,-40
116835974312,116835974318,6,3724,1255,-40
116836150804,116836150809,5,3290,1556,-40
116838693764,116838693770,6,3271,1764,-40
116840606176,116840606170,-6,1099,3673,-40
116846994269,116846994275,6,2561,1069,-40
116847543579,116847543585,6,2675,1103,-40
116848039662,116848039642,-20,1077,532,-40
116849780857,116849780862,5,2843,1600,-40
116850134447,116850134454,7,2844,1420,-40
116851048005,116851048010,5,3103,1251,-40
116851332614,116851332624,10,2084,1021,-40
116852601450,116852601457,7,2871,1449,-40
116854892418,116854892425,7,2397,1070,-40
116857816213,116857816219,6,2323,1277,-40
116862166095,116862166101,6,2551,1516,-40
116863904522,116863904529,7,2032,825,-40
116864743922,116864743929,7,2925,1578,-40
116868039647,116868039653,6,1127,1433,-40
116868683566,116868683545,-21,2977,991,-40
116871719571,116871719577,6,2860,1175,-40
116871884015,116871884003,-12,787,343,-40
116874932734,116874932741,7,2399,1143,-40
116876599669,116876599674,5,1733,896,-40
116885387019,116885387024,5,1720,1103,-40
116886799005,116886799010,5,2384,1277,-40
116887259289,116887259296,7,2917,1049,-40
116888658437,116888658442,5,4278,1767,-40
116892188163,116892188169,6,1958,1147,-40
116892466049,116892466066,17,2276,1178,-40
116893382850,116893382850,0,6430,6685,-40
116894800115,116894800122,7,3218,1030,-40
116898155489,116898155495,6,1960,924,-40
116902872886,116902872891,5,2600,1112,-40
116903293872,116903293879,7,1686,726,-40
116903776685,116903776691,6,3470,1507,-40
116904526562,116904526569,7,2806,1221,-40
116905990555,116905990562,7,4129,1435,-40
116908028742,116908028748,6,2777,1237,-40
116913160494,116913160500,6,2644,937,-40
116914714490,116914714497,7,1452,1497,-40
116915654445,116915654452,7,3303,1126,-40
116919516922,116919516927,5,2720,1402,-40
116919973072,116919973068,-4,1137,4573,-40
116920292588,116920292594,6,1920,831,-40
116921091758,116921091763,5,2014,1238,-40
116927091743,116927091750,7,2287,1192,-40
116929772848,116929772851,3,2026,1011,-40
116932352949,116932352946,-3,3266,4741,-40
116932833217,116932833223,6,3194,1337,-40
116935457274,116935457279,5,2841,1289,-40
116936991882,116936991881,-1,883,1520,-40
116939225490,116939225496,6,2657,1449,-40
116940461968,116940461953,-15,2613,710,-40
116940547359,116940547364,5,3289,1563,-40
116945017941,116945017946,5,2406,1209,-40
116946908445,116946908449,4,5783,3486,-40
116952673800,116952673807,7,2699,1445,-40
116960061298,116960061304,6,1621,1289,-40
116961426029,116961426034,5,2217,1125,-40
116965540461,116965540467,6,2019,1100,-40
116965824715,116965824698,-17,1611,947,-40
116966380577,116966380581,4,2356,1451,-40
116966959348,116966959354,6,3476,1262,-40
116971082378,116971082383,5,2688,1100,-40
116981322081,116981322087,6,3086,1689,-40
116983963574,116983963581,7,2792,1355,-40
116990346181,116990346185,4,1588,813,-40
116993422510,116993422517,7,3223,1393,-40
116994557658,116994557643,-15,1233,382,-40
116995371925,116995371931,6,1820,1135,-40
116996380625,116996380631,6,2265,1029,-40
116997874136,116997874143,7,2991,1088,-40
117001966492,117001966499,7,1431,836,-40
117002706623,117002706629,6,2024,1200,-40
117003797910,117003797913,3,925,1066,-40
117004680117,117004680123,6,3075,992,-40
117004922829,117004922835,6,3572,1374,-40
117008402181,117008402189,8,3085,1047,-40
117009774184,117009774190,6,3495,1284,-40
117009845218,117009845200,-18,1837,707,-40
117010377194,117010377201,7,2461,1031,-40
117012218502,117012218485,-17,2034,1253,-40
117012702970,117012702973,3,11687,19511,-40
117017116939,117017116945,6,2658,1514,-40
117018381947,117018381942,-5,1441,3578,-40
117020467349,117020467354,5,1918,919,-40
117022571159,117022571137,-22,3724,909,-40
117025813031,117025813038,7,2939,1130,-40
117026615438,117026615444,6,3013,1475,-40
117027384374,117027384381,7,3159,1385,-40
117032289738,117032289742,4,2558,1149,-40
117053452215,117053452212,-3,1243,2925,-40
117054194937,117054194943,6,3144,674,-40
117056782031,117056782039,8,1890,961,-40
117057987195,117057987201,6,2728,1179,-40
117058122742,117058122748,6,3714,1824,-40
117061255702,117061255709,7,3041,1716,-40
117061811201,117061811207,6,2666,1027,-40
117064641657,117064641662,5,2768,1526,-40
117066063700,117066063706,6,2962,1300,-40
117068007427,117068007433,6,2700,1602,-40
117071141585,117071141591,6,2750,1208,-40
117074177855,117074177857,2,1030,801,-40
117078918154,117078918162,8,2033,1352,-40
117079823654,117079823658,4,1048,172,-40
117081276096,117081276101,5,2607,1555,-40
117082035882,117082035889,7,2855,1245,-40
117082138374,117082138394,20,1010,441,-40
117082592653,117082592659,6,2804,1290,-40
117084507186,117084507194,8,3832,1253,-40
117087537914,117087537919,5,2299,959,-40
117088806281,117088806282,1,1285,2106,-40
117089658082,117089658088,6,2502,1045,-40
117090493948,117090493942,-6,1397,23583,-40
117095577483,117095577489,6,2298,713,-40
117096109722,117096109737,15,3336,1111,-40
117096964163,117096964166,3,1258,872,-40
117101815126,117101815130,4,8956,29027,-40
117103060353,117103060359,6,2118,1166,-40
117103645622,117103645628,6,3174,1675,-40
117103690812,117103690819,7,2576,1037,-40
117103869276,117103869260,-16,967,390,-40
117104679730,117104679734,4,1611,1134,-40
117104957434,117104957435,1,1262,174,-40
117110735515,117110735522,7,4289,976,-40
117111627362,117111627355,-7,933,4050,-40
117112544457,117112544462,5,3039,1209,-40
117113870390,117113870395,5,4252,1621,-40
117114343879,117114343881,2,1421,1234,-40
117116483100,117116483107,7,3055,1337,-40
117120222910,117120222915,5,1596,592,-40
117120461587,117120461595,8,1464,242,-40
117121222243,117121222228,-15,1105,383,-40
117128025450,117128025456,6,3302,1626,-40
117130443991,117130443994,3,228,1307,-40
117131614377,117131614381,4,2485,877,-40
117131939442,117131939448,6,1635,1078,-40
117132427974,117132427972,-2,1719,2335,-40
117133086949,117133086942,-7,1413,4413,-40
117133186868,117133186875,7,2672,1830,-40
117136496461,117136496468,7,3506,1415,-40
117137511225,117137511211,-14,2363,952,-40
117141056577,117141056569,-8,1081,3071,-40
117142336540,117142336546,6,2227,1002,-40
117142453495,117142453497,2,1814,1900,-40
117143208800,117143208799,-1,1071,1488,-40
117144610918,117144610922,4,1615,1207,-40
117144926083,117144926066,-17,854,513,-40
117146179134,117146179131,-3,1273,3267,-40
117148228985,117148228992,7,3433,1405,-40
117148922903,117148922910,7,2932,1689,-40
117149710346,117149710351,5,1764,829,-40
117155777174,117155777179,5,1593,1087,-40
117156550065,117156550073,8,3263,1691,-40
117163339698,117163339702,4,2126,1490,-40
117163904378,117163904385,7,3414,1544,-40
117164233526,117164233532,6,2815,1379,-40
117168737905,117168737906,1,35,710,-40
117170313322,117170313330,8,2743,1397,-40
117175167713,117175167720,7,3571,1657,-40
117175571895,117175571901,6,2270,1098,-40
117185162668,117185162673,5,3435,1170,-40
117187372149,117187372155,6,2956,1212,-40
117188081371,117188081378,7,3483,1458,-40
117188967914,117188967919,5,2170,1239,-40
117194032378,117194032383,5,2506,1235,-40
117200377583,117200377590,7,3106,1127,-40
117202548819,117202548825,6,1634,1355,-40
117203482697,117203482702,5,3540,1267,-40
117205976653,117205976651,-2,3013,4192,-40
117206797978,117206797981,3,1752,1464,-40
117210448726,117210448731,5,3212,1373,-40
117214573538,117214573542,4,1584,1207,-40
117215222571,117215222577,6,2418,1224,-40
117218174769,117218174767,-2,1011,1698,-40
117220737550,117220737557,7,1382,923,-40
117224267269,117224267274,5,2937,1408,-40
117227271646,117227271654,8,2324,912,-40
117229463930,117229463936,6,3292,1597,-40
117233825170,117233825177,7,2342,1077,-40
117234357963,117234357970,7,2064,1036,-40
117234771336,117234771320,-16,1837,813,-40
117236365902,117236365902,0,913,1769,-40
117237444150,117237444157,7,2273,988,-40
117238846218,117238846223,5,2391,1261,-40
117242550034,117242550039,5,2724,1503,-40
117247000721,117247000727,6,3114,1294,-40
117248575387,117248575393,6,4507,1975,-40
117253469586,117253469591,5,3178,1707,-40
117253869736,117253869741,5,1901,1244,-40
117254253662,117254253669,7,3736,1241,-40
117255361970,117255361977,7,3569,945,-40
117258295167,117258295166,-1,1501,1708,-40
117258948590,117258948596,6,2155,1231,-40
117260781670,117260781675,5,2652,1145,-40
117262238781,117262238788,7,3256,1773,-40
117262396377,117262396394,17,700,244,-40
117264084477,117264084483,6,3032,1147,-40
117268938769,117268938775,6,2427,1142,-40
117271003497,117271003503,6,1774,687,-40
117271167885,117271167883,-2,1328,1385,-40
117271450882,117271450887,5,2778,1203,-40
117275108503,117275108509,6,2760,982,-40
117279464549,117279464555,6,4013,1335,-40
117280471341,117280471347,6,2934,1443,-40
117291104518,117291104519,1,2477,3295,-40
117294702614,117294702622,8,2447,1233,-40
117295553370,117295553377,7,3217,1042,-40
117296221095,117296221082,-13,810,321,-40
117296849462,117296849467,5,2795,1335,-40
117301566602,117301566604,2,2120,1208,-40
117303754665,117303754674,9,4341,1170,-40
117307521314,117307521319,5,3180,1646,-40
117307747060,117307747066,6,3146,957,-40
117312580431,117312580437,6,3880,1337,-40
117313257506,117313257513,7,2542,1392,-40
117321190593,117321190599,6,2351,1279,-40
117322025088,117322025096,8,1697,949,-40
117324873564,117324873569,5,2365,749,-40
117325633323,117325633331,8,2970,1295,-40
117325690564,117325690569,5,2708,897,-40
117330803526,117330803546,20,555,3072,-40
117332049974,117332049982,8,2482,1515,-40
117340555549,117340555549,0,1370,979,-40
117341246058,117341246063,5,3139,908,-40
117342949973,117342949980,7,2221,1053,-40
117351162231,117351162229,-2,1070,2491,-40
117353382354,117353382360,6,3197,1128,-40
117354818236,117354818236,0,1603,1911,-40
117355569590,117355569586,-4,1055,2658,-40
117358815105,117358815109,4,4632,2029,-40
117359642427,117359642434,7,3654,1616,-40
117363258498,117363258506,8,2560,1273,-40
117371932378,117371932382,4,1949,1233,-40
117372113675,117372113682,7,2493,1226,-40
117373685832,117373685837,5,2846,1352,-40
117379511602,117379511611,9,3334,1307,-40
117379660566,117379660578,12,2846,1256,-40
117381086027,117381086032,5,1813,1117,-40
117384771596,117384771602,6,1716,825,-40
117387519482,117387519489,7,2923,1118,-40
117388524420,117388524426,6,2630,1396,-40
117394436528,117394436534,6,6026,2795,-40
117395140664,117395140669,5,2189,851,-40
117396343161,117396343168,7,2833,1613,-40
117402244154,117402244159,5,2002,990,-40
117406735640,117406735645,5,2733,1633,-40
117406903805,117406903811,6,2194,1091,-40
117408571090,117408571090,0,1410,205,-40
117408780854,117408780875,21,3481,1123,-40
117409106700,117409106722,22,994,268,-40
117411427753,117411427757,4,3836,1353,-40
117411463363,117411463348,-15,3099,1269,-40
117411869739,117411869745,6,3441,1222,-40
117415680163,117415680167,4,3041,855,-40
117418694261,117418694266,5,2560,1168,-40
117420367229,117420367235,6,2124,1060,-40
117420928462,117420928458,-4,1346,3557,-40
117422374505,117422374511,6,2951,1150,-40
117431492993,117431493001,8,3828,1252,-40
117432170614,117432170593,-21,836,480,-40
117433728309,117433728315,6,2817,1211,-40
117435332753,117435332759,6,2704,1283,-40
117438005023,117438005031,8,2486,1391,-40
117440340677,117440340683,6,2324,792,-40
117444866658,117444866668,10,15041,31139,-40
117447714299,117447714304,5,3458,1804,-40
117452338973,117452338980,7,2755,1341,-40
117457934567,117457934574,7,3751,2147,-40
117459623501,117459623507,6,2862,1645,-40
117460337164,117460337170,6,3625,1589,-40
117463806003,117463806003,0,3536,3416,-40
117464144994,117464144999,5,2816,1106,-40
117464705001,117464705002,1,1575,1501,-40
117465240751,117465240758,7,4171,1354,-40
117465374479,117465374458,-21,1017,559,-40
117466366355,117466366361,6,2508,1567,-40
117466549234,117466549241,7,3894,1262,-40
117469608706,117469608702,-4,1757,3700,-40
117470725878,117470725883,5,1773,676,-40
117476623979,117476623986,7,3180,1075,-40
117478687198,117478687202,4,1451,588,-40
117480523787,117480523792,5,2778,1274,-40
117480606669,117480606674,5,1924,1283,-40
117483888102,117483888109,7,2655,1081,-40
117483962066,117483962052,-14,1692,526,-40
117491286044,117491286042,-2,1046,2067,-40
117494345538,117494345546,8,2509,883,-40
117497117814,117497117818,4,2932,1239,-40
117497361203,117497361209,6,2106,1293,-40
117497968125,117497968132,7,3321,1383,-40
117498450953,117498450940,-13,3132,886,-40
117499736507,117499736502,-5,945,2002,-40
117502109189,117502109195,6,3605,1394,-40
117511490762,117511490767,5,3052,1315,-40
117511955825,117511955810,-15,1466,314,-40
117512255233,117512255239,6,3912,1503,-40
117519082893,117519082899,6,2010,726,-40
117520456074,117520456056,-18,1890,1120,-40
117521578289,117521578297,8,2142,1096,-40
117522852570,117522852569,-1,641,2959,-40
117524027102,117524027109,7,2732,1376,-40
117525919264,117525919271,7,6091,2102,-40
117527858679,117527858686,7,4652,1491,-40
117531197147,117531197150,3,6096,6746,-40
117531359044,117531359050,6,3546,1386,-40
117534842461,117534842443,-18,3328,1211,-40
117537669770,117537669778,8,3820,1278,-40
117538372123,117538372139,16,2905,1119,-40
117538668966,117538668966,0,684,1295,-40
117540222857,117540222861,4,2736,1243,-40
117544357471,117544357466,-5,1179,3422,-40
117548366023,117548366031,8,3933,1557,-40
117550833493,117550833499,6,2597,685,-40
117552732606,117552732613,7,3505,1019,-40
117553466230,117553466219,-11,1492,454,-40
117557192407,117557192413,6,2981,1321,-40
117558105063,117558105062,-1,39460,29231,-40
117559158485,117559158490,5,2902,1006,-40
117562777581,117562777588,7,2104,1235,-40
117563083790,117563083801,11,683,130,-40
117568058504,117568058510,6,2238,1391,-40
117568421133,117568421138,5,3656,1373,-40
117568676893,117568676908,15,1475,421,-40
117568791134,117568791140,6,2204,990,-40
117570912237,117570912242,5,2352,1571,-40
117573567365,117573567371,6,2207,808,-40
117574795030,117574795030,0,1904,2363,-40
117576338292,117576338298,6,2911,1035,-40
117576732629,117576732634,5,3051,1143,-40
117581249562,117581249558,-4,1070,2724,-40
117585782932,117585782935,3,1322,1078,-40
117588678100,117588678106,6,2473,1557,-40
117588889854,117588889857,3,912,352,-40
117596390222,117596390227,5,2192,1156,-40
117596465495,117596465513,18,1271,389,-40
117596636532,117596636533,1,1064,1147,-40
117596996027,117596996018,-9,841,3899,-40
117598553434,117598553442,8,2906,1093,-40
117601510850,117601510856,6,3419,1078,-40
117605955973,117605955975,2,1197,24350,-40
117607502048,117607502054,6,2939,1336,-40
117607880054,117607880074,20,2797,1564,-40
117609228962,117609228946,-16,3184,821,-40
117609974056,117609974061,5,2754,1357,-40
117612590330,117612590338,8,3053,1771,-40
117614848283,117614848289,6,2302,1347,-40
117615135806,117615135810,4,1988,1433,-40
117618292686,117618292691,5,2002,1019,-40
117619194967,117619194973,6,2893,1673,-40
117619506744,117619506756,12,1796,1059,-40
117621592843,117621592850,7,3577,1193,-40
117626333922,117626333927,5,3130,1531,-40
117631097518,117631097521,3,3340,978,-40
117631493462,117631493468,6,2331,1132,-40
117631574481,117631574464,-17,981,581,-40
117635359300,117635359306,6,3013,1562,-40
117637836204,117637836211,7,3016,1235,-40
117641405075,117641405080,5,1950,1060,-40
117643048707,117643048712,5,1779,812,-40
117646232625,117646232631,6,1830,978,-40
117646445529,117646445534,5,2757,1450,-40
117649139860,117649139866,6,2746,990,-40
117649382645,117649382651,6,2295,1144,-40
117653690117,117653690125,8,3377,1360,-40
117654978025,117654978031,6,2870,1185,-40
117655484587,117655484592,5,1534,918,-40
117656033303,117656033307,4,3159,1271,-40
117656077463,117656077440,-23,1240,152,-40
117662160625,117662160631,6,2268,897,-40
117664488449,117664488454,5,2850,1348,-40
117665956532,117665956535,3,1486,1309,-40
117669808915,117669808921,6,3154,988,-40
117673563218,117673563225,7,2759,1334,-40
117674296561,117674296567,6,2913,1118,-40
117674776765,117674776777,12,2387,1122,-40
117680019158,117680019163,5,2928,1252,-40
117681670505,117681670512,7,3820,1389,-40
117687715150,117687715146,-4,994,1793,-40
117688135812,117688135817,5,1568,1395,-40
117688832111,117688832109,-2,1570,1850,-40
117689114976,117689114977,1,3740,3716,-40
117695014785,117695014793,8,3074,1734,-40
117697870874,117697870872,-2,1905,5314,-40
117701565757,117701565763,6,3699,1381,-40
117702636839,117702636842,3,2538,2887,-40
117702808262,117702808266,4,2531,1547,-40
117705142535,117705142541,6,3347,1349,-40
117705719422,117705719429,7,2159,897,-40
117706184195,117706184190,-5,1990,6581,-40
117707550050,117707550054,4,2330,1119,-40
117708498187,117708498191,4,1642,913,-40
117709736714,117709736718,4,1985,1101,-40
117709850297,117709850303,6,1976,1166,-40
117711720656,117711720663,7,2646,944,-40
117713275318,117713275324,6,2382,1281,-40
117715931194,117715931199,5,2851,1164,-40
117718546828,117718546826,-2,23608,44839,-40
117719691135,117719691143,8,3651,1389,-40
117721850349,117721850350,1,1020,1507,-40
117722878682,117722878690,8,2546,784,-40
117725291940,117725291949,9,12640,31993,-40
117728047511,117728047519,8,3605,1444,-40
117731821888,117731821895,7,2440,1027,-40
117732376467,117732376457,-10,35672,15258,-40
117736946921,117736946927,6,2339,1268,-40
117739065489,117739065494,5,3802,1481,-40
117739841766,117739841771,5,942,1023,-40
117742154410,117742154388,-22,1190,503,-40
117743064955,117743064954,-1,1497,2175,-40
117743426292,117743426297,5,1980,1591,-40
117746928770,117746928773,3,1414,1208,-40
117749975533,117749975538,5,1914,1245,-40
117752463732,117752463739,7,2146,1162,-40
117756869651,117756869656,5,3157,1246,-40
117759276970,117759276977,7,2408,880,-40
117761272262,117761272270,8,2689,1469,-40
117767363486,117767363494,8,3577,1470,-40
117768593141,117768593143,2,44507,18625,-40
117773470693,117773470702,9,2492,1380,-40
117780417594,117780417602,8,2362,775,-40
117780673039,117780673040,1,1439,2558,-40
117781593203,117781593206,3,3214,3006,-40
117791160673,117791160678,5,3648,1338,-40
117795222343,117795222351,8,3170,1456,-40
117796490881,117796490888,7,8633,42132,-40
117798345687,117798345693,6,3064,1707,-40
117798509407,117798509395,-12,2569,1806,-40
117800027427,117800027433,6,3990,1675,-40
117801482044,117801482052,8,4789,997,-40
117804273157,117804273163,6,1891,1272,-40
117806050533,117806050538,5,3986,1532,-40
117807309541,117807309559,18,1449,252,-40
117807785214,117807785220,6,2700,760,-40
117816623380,117816623395,15,1366,415,-40
117817426061,117817426062,1,1117,995,-40
117819088398,117819088388,-10,432,1649,-40
117820455089,117820455094,5,3566,1686,-40
117825435803,117825435810,7,1900,1131,-40
117826584202,117826584187,-15,830,207,-40
117830771441,117830771447,6,2963,1083,-40
117830860354,117830860360,6,778,238,-40
117834332674,117834332669,-5,1223,2175,-40
117834812556,117834812562,6,3212,1143,-40
117838348873,117838348879,6,2739,991,-40
117840953005,117840953010,5,2152,923,-40
117845374962,117845374970,8,2907,1323,-40
117848492842,117848492848,6,3381,1489,-40
117853162675,117853162680,5,2744,1252,-40
117853465394,117853465402,8,2488,1192,-40
117857985134,117857985139,5,2810,951,-40
117859215250,117859215254,4,2746,1460,-40
117861134370,117861134376,6,1929,1481,-40
117861668641,117861668646,5,1954,1330,-40
117862528619,117862528624,5,2654,1194,-40
117871294478,117871294485,7,2538,1392,-40
117872896398,117872896402,4,2007,1326,-40
117878466139,117878466146,7,3579,1454,-40
117879463941,117879463947,6,3733,1602,-40
117887504529,117887504534,5,2541,1091,-40
117888106711,117888106720,9,2381,1327,-40
117892469404,117892469409,5,2167,1561,-40
117894110770,117894110775,5,2219,1045,-40
117899251405,117899251410,5,1997,659,-40
117900664833,117900664839,6,2438,1128,-40
117902208367,117902208370,3,881,20893,-40
117904437217,117904437223,6,2677,1369,-40
117906139855,117906139862,7,2981,1129,-40
117907806141,117907806147,6,2504,1051,-40
117907865305,117907865311,6,2266,1261,-40
117912327650,117912327655,5,2522,1392,-40
117915945431,117915945438,7,4089,1365,-40
117918581757,117918581762,5,2851,1104,-40
117919876509,117919876514,5,3438,1417,-40
117921039645,117921039650,5,1619,1124,-40
117925827591,117925827598,7,3096,1322,-40
117926206922,117926206929,7,2711,1457,-40
117929873518,117929873523,5,2589,1205,-40
117931999013,117931999021,8,3729,1055,-40
117932197914,117932197909,-5,24130,16950,-40
117933514995,117933514998,3,988,884,-40
117933836206,117933836187,-19,1038,288,-40
117936653067,117936653074,7,2194,1313,-40
117938465158,117938465162,4,2487,1189,-40
117940180761,117940180767,6,2302,1425,-40
117941037481,117941037487,6,2869,1749,-40
117941967690,117941967684,-6,1426,4626,-40
117944307721,117944307727,6,3118,1057,-40
117946548969,117946548972,3,2441,1090,-40
117947354597,117947354576,-21,1849,426,-40
117950884295,117950884291,-4,2615,6283,-40
117951440910,117951440915,5,2038,1001,-40
117953020001,117953020005,4,2093,1034,-40
117953653267,117953653270,3,2055,900,-40
117955390643,117955390642,-1,774,1202,-40
117955652844,117955652867,23,2462,1278,-40
117956795294,117956795300,6,2290,1308,-40
117960087074,117960087079,5,2570,1596,-40
117966852057,117966852062,5,2808,1146,-40
117970072788,117970072789,1,2764,3559,-40
117970618809,117970618818,9,3209,1438,-40
117974278223,117974278230,7,1768,857,-40
117976854023,117976854031,8,2271,1718,-40
117976934701,117976934708,7,3384,1169,-40
117981116684,117981116690,6,3143,1222,-40
117982512504,117982512512,8,2828,1393,-40
117982810673,117982810678,5,3238,1901,-40
117989066046,117989066052,6,2955,1295,-40
117991086583,117991086590,7,3885,1808,-40
117991367658,117991367661,3,2016,1371,-40
117997475682,117997475686,4,1554,812,-40
117997515386,117997515401,15,1036,174,-40
118000344783,118000344791,8,3246,1354,-40
118003037926,118003037931,5,3282,1231,-40
118003617019,118003617026,7,2489,1279,-40
118006677590,118006677597,7,2764,1050,-40
118006777468,118006777474,6,4387,1198,-40
118010531289,118010531295,6,2918,775,-40
118010884154,118010884163,9,1057,250,-40
118012866183,118012866179,-4,22613,12316,-40
118023543434,118023543441,7,1862,1147,-40
118030335030,118030335034,4,2280,1097,-40
118030895434,118030895442,8,3604,1090,-40
118034897738,118034897745,7,2656,1373,-40
118036799634,118036799639,5,2914,1210,-40
118036843691,118036843675,-16,512,229,-40
118042113984,118042113986,2,1639,1416,-40
118043711209,118043711213,4,2322,1264,-40
118054322650,118054322657,7,3156,1781,-40
118055232687,118055232695,8,2721,1133,-40
118056181293,118056181300,7,3385,1490,-40
118058070456,118058070462,6,1492,749,-40
118061209280,118061209298,18,39,1013,-40
118063336991,118063336992,1,1591,1680,-40
118063924209,118063924218,9,5293,1435,-40
118065428173,118065428180,7,14358,23857,-40
118067454727,118067454733,6,2142,892,-40
118068808618,118068808625,7,2268,898,-40
118070890880,118070890886,6,2034,1130,-40
118074180690,118074180694,4,3266,1201,-40
118074997122,118074997129,7,3251,1174,-40
118078602764,118078602769,5,3199,1205,-40
118083167234,118083167238,4,1022,907,-40
118083720615,118083720600,-15,1185,270,-40
118084165390,118084165403,13,1392,1785,-40
118085884930,118085884935,5,1601,1236,-40
118092690033,118092690042,9,10570,2261,-40
118092837637,118092837642,5,1560,882,-40
118097388093,118097388098,5,2498,1265,-40
118099773389,118099773390,1,1064,1388,-40
118105077606,118105077611,5,1960,1125,-40
118106297249,118106297257,8,2616,1026,-40
118110921330,118110921334,4,2653,1524,-40
118113180134,118113180139,5,2589,1152,-40
118113527651,118113527632,-19,2112,932,-40
118117301204,118117301210,6,4907,1009,-40
118117955004,118117955009,5,3601,1319,-40
118122000306,118122000313,7,2550,1086,-40
118122713910,118122713918,8,2685,1337,-40
118123429530,118123429537,7,3570,1404,-40
118127898378,118127898383,5,2331,1287,-40
118129138974,118129138979,5,2497,1011,-40
118129247925,118129247915,-10,982,201,-40
118129962995,118129962977,-18,1073,234,-40
118131085406,118131085405,-1,1832,4163,-40
118133321279,118133321285,6,2462,1227,-40
118133944461,118133944466,5,2809,1190,-40
118135287274,118135287281,7,4087,1859,-40
118146169320,118146169327,7,3182,1455,-40
118146627665,118146627651,-14,1078,330,-40
118148851995,118148852001,6,1760,937,-40
118149390241,118149390249,8,3352,1984,-40
118152235548,118152235555,7,2651,1325,-40
118155161522,118155161528,6,3240,1028,-40
118155289841,118155289856,15,2225,862,-40
118157549360,118157549367,7,2977,1168,-40
118168503878,118168503877,-1,990,1878,-40
118168899250,118168899255,5,3415,1435,-40
118172582623,118172582628,5,3707,1937,-40
118176949444,118176949451,7,3160,1054,-40
118181276639,118181276620,-19,1153,371,-40
118182583745,118182583751,6,1926,936,-40
118182905290,118182905297,7,3182,1273,-40
118183673282,118183673287,5,3317,1788,-40
118184039498,118184039493,-5,1167,4614,-40
118185891282,118185891290,8,3871,1009,-40
118186236554,118186236555,1,1658,1439,-40
118187606794,118187606802,8,2338,1019,-40
118190358986,118190358990,4,1266,1922,-40
118191304676,118191304682,6,3429,1475,-40
118191714064,118191714049,-15,1992,712,-40
118196043250,118196043256,6,2969,1427,-40
118199170828,118199170826,-2,1449,2243,-40
118202985488,118202985494,6,5239,2150,-40
118203680794,118203680789,-5,2524,7639,-40
118207450406,118207450414,8,4000,1578,-40
118210172873,118210172878,5,1551,566,-40
118211112542,118211112545,3,3531,2014,-40
118211369058,118211369066,8,3340,925,-40
118219063618,118219063625,7,4073,1224,-40
118222211414,118222211421,7,2970,1390,-40
118226616278,118226616270,-8,889,3501,-40
118229337961,118229337967,6,1811,866,-40
118235489633,118235489639,6,2423,1364,-40
118241046341,118241046347,6,3911,1397,-40
118247461233,118247461236,3,4466,3304,-40
118247642143,118247642147,4,5145,2661,-40
118248247565,118248247570,5,2176,2060,-40
118248410653,118248410658,5,2077,1064,-40
118249320772,118249320778,6,3586,1802,-40
118249892166,118249892148,-18,3720,1758,-40
118250115302,118250115290,-12,690,85,-40
118251296056,118251296062,6,3044,1808,-40
118251692986,118251692991,5,3656,1216,-40
118254751222,118254751229,7,3790,1559,-40
118259999851,118259999855,4,27576,17820,-40
118260847079,118260847082,3,1437,1129,-40
118261252092,118261252098,6,1591,659,-40
118263513885,118263513890,5,3076,1702,-40
118265984098,118265984104,6,6371,1289,-40
118271818582,118271818589,7,2722,1232,-40
118276566986,118276566993,7,6006,1866,-40
118287333273,118287333281,8,3927,1481,-40
118291502751,118291502758,7,3273,1253,-40
118304232057,118304232063,6,2917,985,-40
