fTNear,fTFar,fDelT,fQNear,fQFar,d
0,0,0,216,37,30
2723844,2723842,-2,912,2346,30
13061606,13061603,-3,1082,2681,30
13492949,13492942,-7,1241,4579,30
18988811,18988809,-2,1031,2463,30
19907075,19907095,20,410,1524,30
23395677,23395673,-4,749,2742,30
23655620,23655634,14,954,3193,30
31345038,31345033,-5,1003,2648,30
32353767,32353762,-5,619,1516,30
38014788,38014783,-5,702,1128,30
41674126,41674122,-4,712,1613,30
42200201,42200201,0,216,1023,30
47138307,47138305,-2,1161,1744,30
48717202,48717198,-4,894,2343,30
56312307,56312302,-5,721,3276,30
57211154,57211134,-20,1145,2765,30
63541606,63541602,-4,1089,2611,30
64757972,64757967,-5,996,2488,30
81319930,81319927,-3,1065,3827,30
82053072,82053089,17,876,2528,30
84607778,84607784,6,11357,21343,30
85004152,85004147,-5,673,2423,30
88109949,88109947,-2,752,1433,30
90074091,90074077,-14,153,996,30
92233946,92233925,-21,114,892,30
92674711,92674705,-6,893,2871,30
93916589,93916583,-6,1160,2663,30
97906678,97906674,-4,719,2004,30
98598049,98598055,6,2751,936,30
100774091,100774086,-5,1596,4791,30
100950229,100950229,0,1489,1392,30
101133676,101133670,-6,1182,2939,30
101498928,101498914,-14,1002,3670,30
109648622,109648616,-6,1403,12461,30
114964522,114964528,6,3653,1864,30
116990186,116990181,-5,786,2681,30
120218116,120218110,-6,1074,2716,30
121172233,121172228,-5,1162,2479,30
124967463,124967460,-3,1011,2862,30
140861197,140861198,1,1443,1477,30
143935803,143935797,-6,1071,3601,30
146010635,146010629,-6,720,1875,30
150066663,150066660,-3,611,2242,30
150969658,150969640,-18,196,893,30
171401514,171401513,-1,1872,3245,30
174477331,174477332,1,1021,1493,30
175119785,175119779,-6,998,2715,30
186662776,186662773,-3,1191,1931,30
186919571,186919566,-5,931,3538,30
187592704,187592702,-2,1540,2555,30
190412994,190412990,-4,641,1918,30
198749987,198749983,-4,1004,2275,30
200904171,200904165,-6,784,2790,30
201039602,201039594,-8,1224,1799,30
205812732,205812727,-5,1543,3089,30
214796234,214796229,-5,881,3265,30
220323820,220323815,-5,1219,5165,30
221270305,221270293,-12,1396,3642,30
221312425,221312421,-4,979,2280,30
221823689,221823686,-3,1057,2901,30
222431901,222431896,-5,1109,2779,30
229773408,229773407,-1,690,1861,30
230211454,230211460,6,4966,2068,30
230777950,230777950,0,1280,1884,30
231838091,231838084,-7,1107,3201,30
232450514,232450509,-5,549,1206,30
238386875,238386871,-4,859,2888,30
238655807,238655802,-5,1005,3887,30
239428992,239428989,-3,1297,3312,30
245470275,245470270,-5,1471,3664,30
245899110,245899105,-5,954,1808,30
246111769,246111762,-7,284,786,30
255493130,255493125,-5,1189,2910,30
269084242,269084237,-5,1177,4182,30
269592231,269592229,-2,964,2218,30
270925267,270925262,-5,1122,2860,30
272373900,272373896,-4,777,2760,30
273363047,273363044,-3,850,2247,30
274067113,274067110,-3,1364,3315,30
274735622,274735616,-6,1202,2259,30
276242899,276242893,-6,1405,5050,30
277252342,277252339,-3,1317,2106,30
279477081,279477076,-5,932,2836,30
280488339,280488338,-1,995,1769,30
282012607,282012601,-6,735,2002,30
284104982,284104978,-4,1285,2714,30
290723127,290723130,3,1946,1402,30
290974106,290974101,-5,776,4032,30
293402820,293402814,-6,1105,2941,30
294460769,294460765,-4,1262,2925,30
296746343,296746339,-4,1033,2002,30
299951175,299951170,-5,1149,2343,30
302705343,302705338,-5,1108,2927,30
304466894,304466891,-3,1173,2376,30
312031439,312031433,-6,865,1627,30
315256915,315256911,-4,746,3271,30
317147294,317147291,-3,1212,2299,30
317905114,317905106,-8,1795,8948,30
324194262,324194266,4,3205,3491,30
328970714,328970712,-2,1730,3551,30
330224551,330224549,-2,1052,1695,30
337581200,337581197,-3,1388,4769,30
337773115,337773110,-5,1388,2407,30
337897993,337897988,-5,1082,3530,30
343142371,343142365,-6,1124,2388,30
347579152,347579152,0,9108,12870,30
350434663,350434659,-4,1021,3595,30
356492531,356492526,-5,588,2249,30
356585912,356585905,-7,1144,3007,30
357071747,357071747,0,166,1348,30
360371851,360371845,-6,504,2418,30
361508704,361508721,17,355,2228,30
363277158,363277155,-3,1949,2953,30
381737302,381737299,-3,1372,3649,30
384615663,384615664,1,1363,1257,30
392009270,392009266,-4,886,2472,30
395241659,395241653,-6,1080,3297,30
395608703,395608698,-5,759,2229,30
400468282,400468277,-5,983,2406,30
400753534,400753531,-3,824,2423,30
401459872,401459866,-6,536,3011,30
401801949,401801944,-5,861,3912,30
401919100,401919094,-6,866,3934,30
402040912,402040917,5,3638,1593,30
414644603,414644598,-5,720,1817,30
414727507,414727502,-5,780,2857,30
422019886,422019882,-4,1085,2290,30
424607266,424607262,-4,1445,3661,30
425065122,425065120,-2,814,3403,30
426274378,426274375,-3,1081,3430,30
426395795,426395773,-22,901,4433,30
430317870,430317868,-2,1150,2407,30
430969682,430969673,-9,649,1656,30
433734299,433734294,-5,924,2989,30
439491990,439491986,-4,1582,3047,30
440739225,440739221,-4,409,2521,30
441054420,441054438,18,1109,3405,30
442596754,442596753,-1,1090,1436,30
443334435,443334426,-9,45038,14651,30
443860549,443860545,-4,970,2564,30
445440442,445440437,-5,1693,3274,30
446092159,446092154,-5,917,2588,30
449576173,449576170,-3,1038,1582,30
453295078,453295073,-5,932,3109,30
453746133,453746129,-4,1082,2474,30
458718107,458718113,6,2585,1407,30
462186998,462186996,-2,813,1589,30
462869453,462869474,21,4144,149,30
466844261,466844253,-8,23938,17676,30
467174991,467174988,-3,1188,2918,30
467718137,467718133,-4,786,2531,30
472633283,472633278,-5,723,1511,30
475201300,475201297,-3,1633,1725,30
476994050,476994048,-2,1222,3433,30
477651843,477651837,-6,1345,2775,30
478298465,478298460,-5,1057,2675,30
490352701,490352694,-7,1121,2809,30
493054166,493054161,-5,968,2311,30
493374920,493374935,15,938,2766,30
494170330,494170326,-4,1025,2538,30
494942157,494942155,-2,923,2165,30
500815388,500815382,-6,1435,3228,30
502271200,502271194,-6,1135,3721,30
510050974,510050970,-4,1067,2900,30
510429714,510429726,12,147,1061,30
512961094,512961088,-6,864,4384,30
516170061,516170055,-6,1167,4630,30
528540085,528540086,1,1546,1478,30
533701415,533701411,-4,1074,1776,30
542383397,542383393,-4,1659,2972,30
543632260,543632255,-5,812,1990,30
544746256,544746246,-10,1116,3195,30
555180081,555180078,-3,855,2572,30
560646730,560646726,-4,1187,2652,30
560767136,560767155,19,299,1060,30
563000052,563000047,-5,1323,3086,30
564285575,564285571,-4,1330,3448,30
567078249,567078244,-5,1141,2553,30
567254624,567254604,-20,878,3486,30
569392651,569392648,-3,1326,3119,30
574332721,574332716,-5,1124,3188,30
575665662,575665657,-5,1073,2986,30
579037591,579037587,-4,1064,3089,30
581314294,581314290,-4,1106,2672,30
584375392,584375388,-4,1020,2722,30
594105189,594105186,-3,1017,3186,30
594498666,594498662,-4,691,2540,30
603298253,603298247,-6,1174,2979,30
603952610,603952625,15,658,1922,30
608734274,608734272,-2,1388,2930,30
611570740,611570734,-6,913,2625,30
611669643,611669629,-14,708,2298,30
615718709,615718704,-5,1096,2504,30
617588303,617588298,-5,1459,3166,30
618607601,618607592,-9,42010,12468,30
619840947,619840944,-3,1108,2849,30
620773235,620773230,-5,912,2497,30
622917313,622917307,-6,1223,2558,30
631391280,631391303,23,864,2646,30
633045555,633045549,-6,804,1151,30
637110318,637110312,-6,999,2835,30
641159502,641159497,-5,1192,2095,30
644948085,644948077,-8,1624,4759,30
645581691,645581686,-5,979,2578,30
654519563,654519557,-6,1002,2837,30
655403985,655403985,0,326,832,30
658056439,658056437,-2,854,1973,30
660389267,660389278,11,19122,18996,30
661381585,661381581,-4,1150,2285,30
662406240,662406247,7,8070,22134,30
664479739,664479726,-13,4054,1606,30
666335961,666335962,1,2619,3369,30
667789578,667789574,-4,914,4035,30
671065519,671065514,-5,1463,3547,30
672687778,672687782,4,1147,957,30
672854693,672854690,-3,1276,3419,30
673001355,673001350,-5,625,1759,30
675100554,675100546,-8,1142,3632,30
684109239,684109234,-5,914,2634,30
687768326,687768321,-5,1309,3317,30
689609853,689609850,-3,873,1769,30
691858807,691858802,-5,1111,3770,30
695254399,695254394,-5,1191,4308,30
696969096,696969093,-3,1235,2909,30
699181043,699181038,-5,975,4162,30
708197590,708197590,0,1611,1603,30
709091741,709091734,-7,1141,4507,30
710336017,710336014,-3,1243,2980,30
711226623,711226618,-5,1231,2638,30
713953267,713953261,-6,1102,2942,30
714812233,714812229,-4,1442,3858,30
716732662,716732658,-4,1350,3671,30
722875673,722875669,-4,1184,2819,30
723178913,723178906,-7,1133,1597,30
726378489,726378485,-4,1178,3013,30
731460113,731460109,-4,899,2218,30
738111855,738111851,-4,848,2706,30
738503120,738503119,-1,169,1222,30
744153551,744153546,-5,888,1941,30
744778628,744778641,13,264,725,30
746320187,746320182,-5,1048,2854,30
749941339,749941334,-5,364,987,30
756440946,756440941,-5,1262,3089,30
757322481,757322478,-3,870,2752,30
766407866,766407859,-7,753,2599,30
771446115,771446112,-3,795,1530,30
771907443,771907438,-5,1165,2835,30
775195188,775195183,-5,1071,3407,30
775779466,775779449,-17,1380,998,30
776858634,776858629,-5,799,2504,30
783204783,783204783,0,2716,2605,30
789916372,789916366,-6,1068,2422,30
790426743,790426739,-4,1102,2093,30
792176601,792176602,1,2657,2961,30
797863502,797863498,-4,1323,2998,30
798264110,798264110,0,1515,1865,30
799555331,799555329,-2,507,1772,30
804296509,804296515,6,6251,3161,30
808178754,808178753,-1,1691,2485,30
813547432,813547426,-6,919,2078,30
815134217,815134210,-7,1528,4314,30
815261542,815261538,-4,1422,2794,30
817745838,817745833,-5,988,3198,30
828241734,828241730,-4,885,2422,30
831293077,831293074,-3,1058,3026,30
834510077,834510073,-4,2349,7374,30
835387096,835387097,1,864,1361,30
835506654,835506649,-5,866,1929,30
842421970,842421968,-2,1191,2792,30
849042129,849042125,-4,1086,1891,30
850410748,850410742,-6,1718,3134,30
850979734,850979730,-4,1180,2425,30
860252654,860252649,-5,677,1345,30
873665888,873665885,-3,1372,2693,30
874168956,874168969,13,371,768,30
881370558,881370562,4,1548,1408,30
882408055,882408049,-6,852,2389,30
882951912,882951935,23,809,3201,30
883210766,883210759,-7,1549,4291,30
884654177,884654172,-5,1461,3618,30
886470875,886470871,-4,824,2295,30
888727364,888727356,-8,160,2910,30
891209014,891209010,-4,965,1722,30
895097470,895097465,-5,1702,3716,30
899396974,899396989,15,470,1824,30
903891755,903891750,-5,1338,3751,30
905796727,905796724,-3,1585,2462,30
909774904,909774898,-6,1072,2979,30
910141189,910141179,-10,20971,14718,30
912312547,912312541,-6,1063,2876,30
914844541,914844544,3,1066,1441,30
917422550,917422545,-5,1338,3139,30
930056038,930056033,-5,753,2503,30
932592811,932592806,-5,1085,2123,30
933291510,933291505,-5,1337,3626,30
933530463,933530460,-3,1488,2965,30
937150869,937150869,0,1229,1827,30
937603435,937603449,14,529,1822,30
940366614,940366610,-4,1209,3430,30
940501201,940501197,-4,1143,4343,30
946445970,946445966,-4,1033,2527,30
947362579,947362574,-5,925,2708,30
951199025,951199020,-5,646,2211,30
953370473,953370469,-4,953,2060,30
953560007,953560005,-2,1197,1903,30
954447985,954447981,-4,1082,3178,30
955530542,955530538,-4,1017,2113,30
955785197,955785193,-4,1338,3228,30
956316432,956316415,-17,829,1622,30
968151799,968151796,-3,1288,1578,30
972194064,972194061,-3,1043,1856,30
974365003,974364997,-6,1045,2609,30
975651790,975651798,8,13723,28542,30
977640787,977640783,-4,1100,2216,30
978198281,978198277,-4,979,2425,30
988636859,988636855,-4,876,2660,30
991103388,991103385,-3,936,2204,30
994861326,994861322,-4,885,1855,30
995902986,995902981,-5,1178,2682,30
997671878,997671874,-4,874,2189,30
998594278,998594275,-3,765,3382,30
1004271855,1004271849,-6,1109,3345,30
1004538200,1004538195,-5,1109,2984,30
1007862298,1007862314,16,9869,52950,30
1012785588,1012785596,8,168,1120,30
1014884813,1014884807,-6,1112,2738,30
1015687646,1015687639,-7,1436,6456,30
1016759214,1016759206,-8,504,1368,30
1018056436,1018056430,-6,1190,3684,30
1019940607,1019940602,-5,971,2623,30
1025154795,1025154790,-5,1235,3442,30
1029036819,1029036813,-6,758,2605,30
1037154742,1037154736,-6,878,4153,30
1045104366,1045104362,-4,1070,2329,30
1048547323,1048547319,-4,976,3161,30
1057766550,1057766545,-5,816,1997,30
1063077781,1063077783,2,1619,1130,30
1069801319,1069801315,-4,889,1665,30
1073819484,1073819480,-4,1092,2714,30
1077562073,1077562067,-6,1039,2288,30
1080522778,1080522775,-3,1105,3126,30
1082745609,1082745606,-3,757,1477,30
1084174054,1084174049,-5,1150,3466,30
1087096578,1087096574,-4,1126,2772,30
1093532119,1093532118,-1,23251,17540,30
1093966410,1093966411,1,874,1176,30
1094343810,1094343805,-5,897,3261,30
1103899885,1103899882,-3,726,3045,30
1104772689,1104772684,-5,1124,2521,30
1105192958,1105192954,-4,984,2410,30
1105363378,1105363385,7,299,922,30
1109466670,1109466669,-1,17220,82663,30
1109840967,1109840962,-5,1442,3644,30
1112131681,1112131674,-7,904,3081,30
1120417735,1120417731,-4,1400,3145,30
1124100475,1124100471,-4,824,1911,30
1124377025,1124377041,16,408,938,30
1128580591,1128580586,-5,1356,3387,30
1129893930,1129893926,-4,1010,2789,30
1133115737,1133115734,-3,895,1801,30
1133468098,1133468100,2,2538,2378,30
1139262353,1139262350,-3,1622,2440,30
1140916639,1140916643,4,2381,1400,30
1149646532,1149646529,-3,1391,3150,30
1153065475,1153065471,-4,1052,3455,30
1155651041,1155651038,-3,1489,3551,30
1161733582,1161733578,-4,1136,2686,30
1162470080,1162470081,1,1668,1392,30
1162965497,1162965491,-6,1077,3413,30
1163005650,1163005646,-4,1033,3073,30
1163713675,1163713690,15,678,2844,30
1164194493,1164194489,-4,869,2560,30
1167267050,1167267070,20,745,1026,30
1170390135,1170390134,-1,1271,3098,30
1186523574,1186523570,-4,1398,3787,30
1195083503,1195083498,-5,1395,3517,30
1198913066,1198913066,0,1685,2660,30
1202184671,1202184667,-4,904,2976,30
1202824035,1202824015,-20,30738,27010,30
1210258741,1210258736,-5,974,3170,30
1212498746,1212498741,-5,899,1953,30
1214414063,1214414060,-3,836,2901,30
1214468840,1214468834,-6,813,3001,30
1217102822,1217102818,-4,985,3389,30
1221455302,1221455298,-4,976,2886,30
1222532968,1222532989,21,763,2968,30
1223795046,1223795040,-6,1377,3417,30
1224192460,1224192471,11,441,902,30
1224525630,1224525624,-6,1213,3027,30
1224680115,1224680121,6,163,915,30
1232445225,1232445219,-6,1385,3041,30
1233817688,1233817685,-3,1212,2710,30
1235479379,1235479373,-6,1153,3186,30
1236021557,1236021553,-4,1540,3328,30
1242319873,1242319869,-4,769,2890,30
1243431659,1243431654,-5,813,2542,30
1245614510,1245614506,-4,878,2760,30
1246133624,1246133622,-2,1575,4215,30
1246381122,1246381117,-5,1244,1739,30
1259350875,1259350871,-4,1145,2760,30
1262153913,1262153906,-7,884,3245,30
1269778424,1269778420,-4,1156,2764,30
1270459881,1270459877,-4,1186,2561,30
1271495160,1271495162,2,8353,18987,30
1272549070,1272549074,4,5265,2741,30
1275898638,1275898633,-5,1394,3492,30
1275988305,1275988301,-4,1356,3417,30
1276854492,1276854510,18,1237,3364,30
1279544254,1279544250,-4,1080,2384,30
1282116932,1282116927,-5,1050,3492,30
1283148678,1283148673,-5,1118,3341,30
1283223672,1283223691,19,447,851,30
1285754290,1285754285,-5,933,2569,30
1291086507,1291086504,-3,1012,2783,30
1292228571,1292228586,15,685,1128,30
1296598257,1296598253,-4,2399,4492,30
1303099410,1303099409,-1,1293,1362,30
1303856026,1303856024,-2,920,1598,30
1304663265,1304663285,20,233,1473,30
1304888038,1304888033,-5,933,2168,30
1305256958,1305256956,-2,1880,4072,30
1314485254,1314485251,-3,1282,2624,30
1319901116,1319901115,-1,1379,1913,30
1319933299,1319933294,-5,216,631,30
1320836684,1320836695,11,209,741,30
1321154714,1321154729,15,714,1099,30
1321650491,1321650487,-4,1350,2341,30
1323023405,1323023400,-5,1096,2257,30
1323247697,1323247682,-15,35,1255,30
1323361580,1323361579,-1,182,1061,30
1323622233,1323622229,-4,832,1632,30
1326277202,1326277204,2,1238,2255,30
1326397681,1326397674,-7,834,3738,30
1326893038,1326893035,-3,1076,2914,30
1330553454,1330553449,-5,968,3058,30
1331593123,1331593118,-5,827,3425,30
1339012983,1339012980,-3,1372,3589,30
1344455094,1344455090,-4,1120,2497,30
1353606382,1353606377,-5,1505,3762,30
1357420467,1357420462,-5,1245,3057,30
1362395887,1362395882,-5,1540,3791,30
1363941129,1363941122,-7,1300,3916,30
1364639624,1364639621,-3,768,2278,30
1365297005,1365297001,-4,969,2876,30
1368359479,1368359473,-6,1076,2757,30
1370599139,1370599136,-3,1319,2913,30
1372637901,1372637915,14,11303,37018,30
1377524850,1377524846,-4,844,855,30
1379815188,1379815187,-1,1540,2134,30
1386696466,1386696461,-5,1216,2775,30
1389719189,1389719182,-7,998,3502,30
1395587661,1395587658,-3,990,2768,30
1396038736,1396038751,15,264,1154,30
1396807422,1396807417,-5,1048,3188,30
1397537961,1397537954,-7,1198,2722,30
1399940820,1399940814,-6,1290,3695,30
1401903601,1401903595,-6,907,3425,30
1405082929,1405082923,-6,1179,3407,30
1408518941,1408518937,-4,1670,3425,30
1408642938,1408642933,-5,935,1956,30
1409358733,1409358728,-5,1180,3524,30
1409874099,1409874095,-4,1131,2460,30
1411084073,1411084068,-5,1443,3359,30
1413634515,1413634511,-4,1398,3744,30
1426478814,1426478810,-4,846,1985,30
1430279579,1430279575,-4,1568,3381,30
1430665539,1430665534,-5,1552,2890,30
1435656014,1435655997,-17,1781,1247,30
1437470847,1437470843,-4,959,3066,30
1449807685,1449807678,-7,2134,8064,30
1451028038,1451028034,-4,1239,4009,30
1451800962,1451800956,-6,594,2814,30
1455453549,1455453546,-3,1391,3882,30
1457211098,1457211095,-3,1360,2699,30
1458303089,1458303085,-4,1136,3564,30
1459600418,1459600414,-4,1453,3666,30
1464188741,1464188738,-3,1296,2506,30
1468225815,1468225811,-4,1052,2387,30
1468567546,1468567525,-21,1078,816,30
1468649110,1468649102,-8,1106,2723,30
1478066978,1478066980,2,2302,1264,30
1480970652,1480970648,-4,1456,2156,30
1484209845,1484209840,-5,1047,3639,30
1485366315,1485366312,-3,407,2326,30
1486471058,1486471079,21,547,1854,30
1488037381,1488037385,4,4120,2690,30
1491506731,1491506732,1,1916,2520,30
1493631784,1493631780,-4,1036,2426,30
1498208498,1498208501,3,1139,1325,30
1498605690,1498605683,-7,1155,2968,30
1503119439,1503119435,-4,1396,2919,30
1504327427,1504327426,-1,1017,1285,30
1507048277,1507048273,-4,1086,2567,30
1507585846,1507585843,-3,612,2624,30
1508543589,1508543584,-5,1113,2937,30
1511441221,1511441221,0,23240,20179,30
1512568661,1512568657,-4,877,2543,30
1512871322,1512871313,-9,359,1363,30
1513521658,1513521659,1,1690,1869,30
1520283903,1520283900,-3,1076,3164,30
1521021633,1521021653,20,1333,3912,30
1529010855,1529010849,-6,1409,2815,30
1537921321,1537921315,-6,931,3430,30
1546833313,1546833311,-2,38364,17181,30
1549111518,1549111513,-5,996,1834,30
1550108900,1550108893,-7,557,1993,30
1552442347,1552442351,4,203,876,30
1558615591,1558615589,-2,1286,2199,30
1564232251,1564232246,-5,979,2597,30
1570010167,1570010162,-5,856,2685,30
1570156155,1570156174,19,702,2958,30
1570997575,1570997571,-4,723,3250,30
1572653704,1572653698,-6,872,3123,30
1574540061,1574540055,-6,1007,2404,30
1574881939,1574881954,15,730,3088,30
1578089360,1578089358,-2,1350,3324,30
1578397304,1578397297,-7,988,2723,30
1585340849,1585340846,-3,805,2795,30
1586230830,1586230826,-4,1181,3529,30
1588630194,1588630190,-4,849,2793,30
1594023086,1594023082,-4,1325,2691,30
1596940863,1596940858,-5,1244,3133,30
1597333551,1597333547,-4,1280,3025,30
1597705588,1597705585,-3,1465,2710,30
1599959115,1599959110,-5,780,2265,30
1601949247,1601949242,-5,822,3815,30
1602795587,1602795584,-3,921,3355,30
1607401982,1607401978,-4,637,3995,30
1612925757,1612925755,-2,1229,2412,30
1615119911,1615119908,-3,911,1800,30
1615269702,1615269699,-3,1222,3584,30
1615513217,1615513212,-5,1767,2896,30
1618086785,1618086791,6,2519,853,30
1621206896,1621206891,-5,976,1787,30
1623699959,1623699955,-4,920,2072,30
1628513059,1628513057,-2,1181,2667,30
1637658918,1637658913,-5,822,3395,30
1649993909,1649993903,-6,1134,3607,30
1651067895,1651067890,-5,880,1916,30
1656883658,1656883654,-4,984,2720,30
1659159633,1659159639,6,4273,1521,30
1665458194,1665458193,-1,1073,2474,30
1665738495,1665738493,-2,1195,3143,30
1666241994,1666241991,-3,1489,3008,30
1667382729,1667382725,-4,992,2944,30
1679416782,1679416778,-4,2493,5654,30
1681792302,1681792299,-3,1100,2526,30
1685590921,1685590916,-5,1535,3177,30
1687301883,1687301878,-5,979,3035,30
1687757537,1687757533,-4,971,4510,30
1688688918,1688688912,-6,1521,2948,30
1697984604,1697984599,-5,1017,3238,30
1698688994,1698688989,-5,1040,1935,30
1701686579,1701686573,-6,598,2249,30
1702508034,1702508037,3,2996,2043,30
1709453399,1709453398,-1,1014,2252,30
1721700210,1721700205,-5,857,2964,30
1722152078,1722152073,-5,1229,3386,30
1722749450,1722749444,-6,836,4378,30
1725329094,1725329089,-5,942,3003,30
1726226638,1726226631,-7,991,3649,30
1732317659,1732317653,-6,1064,2869,30
1732688503,1732688498,-5,1353,3511,30
1733345544,1733345562,18,372,1226,30
1734093862,1734093857,-5,930,3010,30
1738292717,1738292714,-3,909,1691,30
1739612402,1739612423,21,718,2771,30
1740924875,1740924870,-5,1233,3012,30
1742974856,1742974852,-4,940,2580,30
1745230893,1745230895,2,1573,1588,30
1751796783,1751796778,-5,1109,3232,30
1756784714,1756784713,-1,1084,1263,30
1757401319,1757401315,-4,1028,2335,30
1760480470,1760480465,-5,1160,3623,30
1762947178,1762947171,-7,1305,3791,30
1763811080,1763811075,-5,1706,3582,30
1766845608,1766845605,-3,1085,2307,30
1769416556,1769416554,-2,713,2403,30
1769491367,1769491362,-5,1030,3574,30
1771274995,1771274993,-2,1203,2643,30
1773447279,1773447275,-4,1037,3304,30
1785897071,1785897065,-6,921,2577,30
1790555286,1790555282,-4,1186,3104,30
1792622845,1792622839,-6,1491,3884,30
1793145270,1793145270,0,1194,1820,30
1795562205,1795562208,3,1839,1279,30
1795884233,1795884230,-3,1348,3005,30
1797550314,1797550309,-5,807,2270,30
1807963781,1807963781,0,22820,21514,30
1808405423,1808405417,-6,743,3419,30
1812854118,1812854114,-4,967,2597,30
1814105319,1814105314,-5,865,2537,30
1820230631,1820230624,-7,869,2781,30
1821401691,1821401686,-5,860,2503,30
1823769581,1823769577,-4,1145,3004,30
1824959998,1824959994,-4,1054,3377,30
1830857281,1830857277,-4,882,2997,30
1847862447,1847862442,-5,948,3273,30
1849768527,1849768523,-4,917,2794,30
1852132453,1852132459,6,2057,1226,30
1854240801,1854240795,-6,1188,3847,30
1854876731,1854876727,-4,855,2551,30
1859143866,1859143862,-4,1017,3255,30
1862068743,1862068737,-6,1108,2920,30
1865728101,1865728084,-17,3063,1326,30
1866144269,1866144262,-7,952,3461,30
1873290282,1873290279,-3,1283,1878,30
1873417456,1873417462,6,264,1095,30
1881644658,1881644650,-8,765,5253,30
1883529594,1883529593,-1,1260,1728,30
1885885991,1885885989,-2,1235,2486,30
1893421627,1893421621,-6,900,3253,30
1893665326,1893665321,-5,1371,3026,30
1894460190,1894460185,-5,1135,2800,30
1895349754,1895349748,-6,1140,4174,30
1895977567,1895977561,-6,1279,3229,30
1899932439,1899932434,-5,1254,4225,30
1900740971,1900740962,-9,312,1466,30
1904576055,1904576049,-6,767,3428,30
1906050439,1906050444,5,2333,1276,30
1908796042,1908796037,-5,1154,3662,30
1917650342,1917650338,-4,754,2564,30
1919404914,1919404908,-6,1102,2878,30
1923040213,1923040208,-5,1503,3008,30
1923066378,1923066374,-4,935,2861,30
1927925246,1927925240,-6,852,3780,30
1928343827,1928343821,-6,990,2258,30
1929456278,1929456274,-4,1253,2415,30
1931731275,1931731273,-2,1250,2880,30
1932645602,1932645618,16,576,1038,30
1938020761,1938020763,2,3270,2715,30
1942686894,1942686897,3,1469,1521,30
1943781547,1943781552,5,10462,24496,30
1947114368,1947114363,-5,961,3393,30
1949628802,1949628796,-6,1341,3892,30
1949677721,1949677719,-2,1206,2727,30
1950712153,1950712149,-4,948,2427,30
1952246538,1952246533,-5,1584,3817,30
1952318695,1952318692,-3,1065,2220,30
1953264188,1953264182,-6,1058,2615,30
1956695359,1956695354,-5,1018,2910,30
1958347086,1958347085,-1,1001,2656,30
1965360915,1965360910,-5,1171,2951,30
1970143014,1970143008,-6,1195,3233,30
1973493017,1973493010,-7,890,4310,30
1974227939,1974227935,-4,1195,3154,30
1975029636,1975029631,-5,1243,2501,30
1975532654,1975532650,-4,901,4477,30
1993003475,1993003470,-5,902,3132,30
1993874022,1993874018,-4,839,2705,30
1995702267,1995702262,-5,1553,3275,30
1997202017,1997202014,-3,1267,3350,30
1999568006,1999568003,-3,837,2786,30
2001924999,2001924995,-4,880,2885,30
2001990011,2001990030,19,619,1580,30
2002063268,2002063261,-7,778,1933,30
2005144891,2005144886,-5,955,3322,30
2005751491,2005751510,19,505,1325,30
2006607251,2006607247,-4,953,3835,30
2006636029,2006636029,0,1525,1603,30
2008097241,2008097235,-6,1344,2456,30
2010602771,2010602768,-3,777,3199,30
2010974606,2010974601,-5,1060,3256,30
2014858969,2014858961,-8,1238,3014,30
2018184118,2018184121,3,1946,1711,30
2018942373,2018942368,-5,919,2206,30
2022554033,2022554029,-4,812,2920,30
2024165798,2024165793,-5,839,3179,30
2029296232,2029296234,2,2175,3035,30
2034420414,2034420411,-3,1025,3532,30
2034684423,2034684409,-14,880,134,30
2042508016,2042508012,-4,1368,1734,30
2042852689,2042852685,-4,1043,2037,30
2045706835,2045706830,-5,888,2846,30
2049156257,2049156252,-5,1020,2860,30
2052304211,2052304205,-6,744,2893,30
2060112438,2060112435,-3,818,2378,30
2062355826,2062355822,-4,1362,3382,30
2066838890,2066838887,-3,1504,3208,30
2067093219,2067093213,-6,885,3719,30
2067124401,2067124398,-3,857,2430,30
2067291035,2067291054,19,549,1317,30
2067360502,2067360483,-19,1798,1656,30
2074810634,2074810630,-4,1294,4023,30
2077057850,2077057845,-5,1077,2529,30
2077223714,2077223726,12,388,1154,30
2078771188,2078771182,-6,1346,2303,30
2079859978,2079859973,-5,1129,3255,30
2086848815,2086848814,-1,1197,1511,30
2091412568,2091412565,-3,1072,2525,30
2096096556,2096096553,-3,577,1938,30
2098847036,2098847030,-6,1133,3263,30
2103057661,2103057658,-3,836,2460,30
2103485993,2103485989,-4,618,327,30
2108571727,2108571722,-5,752,3960,30
2109322193,2109322188,-5,1234,2499,30
2109628697,2109628717,20,671,4623,30
2114454262,2114454257,-5,1401,3187,30
2115770098,2115770094,-4,1176,3086,30
2117067275,2117067289,14,1281,3161,30
2118466910,2118466905,-5,1053,3557,30
2128696390,2128696386,-4,1051,1681,30
2130813490,2130813488,-2,785,2786,30
2133912317,2133912314,-3,2058,4322,30
2143290282,2143290276,-6,46977,19488,30
2147691251,2147691249,-2,21327,34892,30
2148013722,2148013718,-4,942,2891,30
2148371670,2148371676,6,2189,1416,30
2151396801,2151396795,-6,907,3009,30
2151825276,2151825294,18,1160,2684,30
2153368626,2153368621,-5,698,2419,30
2153483704,2153483727,23,368,1105,30
2156433185,2156433182,-3,869,1992,30
2156635579,2156635569,-10,752,2350,30
2162706969,2162706963,-6,1166,3134,30
2164827054,2164827049,-5,904,2020,30
2172435526,2172435521,-5,934,2840,30
2177220499,2177220494,-5,696,2408,30
2182993743,2182993738,-5,990,3133,30
2191829922,2191829918,-4,1679,4280,30
2203667971,2203667969,-2,1029,2252,30
2209055870,2209055870,0,779,1936,30
2209397747,2209397744,-3,180,1649,30
2210209717,2210209713,-4,1268,2687,30
2213980492,2213980486,-6,1011,3127,30
2215268547,2215268542,-5,967,2286,30
2216082415,2216082410,-5,816,1902,30
2218381804,2218381797,-7,994,4298,30
2232086166,2232086166,0,1475,1353,30
2233087785,2233087779,-6,965,4074,30
2235086641,2235086634,-7,872,2182,30
2237093366,2237093360,-6,1213,3251,30
2242216204,2242216206,2,2015,1279,30
2249564800,2249564795,-5,974,3606,30
2249643123,2249643118,-5,1318,3159,30
2252527385,2252527381,-4,824,3970,30
2252678032,2252678054,22,167,970,30
2253754706,2253754704,-2,572,2446,30
2256448976,2256448972,-4,749,3268,30
2258447273,2258447269,-4,1063,2621,30
2260336833,2260336834,1,1570,2161,30
2262005505,2262005497,-8,1317,3416,30
2262395119,2262395114,-5,1458,3556,30
2268466074,2268466070,-4,829,2366,30
2271748007,2271748002,-5,1003,2492,30
2271882066,2271882062,-4,1188,2842,30
2272097419,2272097400,-19,66,1411,30
2272884392,2272884386,-6,1075,3136,30
2274404723,2274404718,-5,2323,4880,30
2288212971,2288212965,-6,1535,3528,30
2293040725,2293040721,-4,1185,2043,30
2310349243,2310349236,-7,590,2230,30
2312458225,2312458227,2,3491,3489,30
2317666891,2317666886,-5,1676,3718,30
2317986990,2317986985,-5,1221,3199,30
2318635974,2318635970,-4,1229,3070,30
2331190959,2331190953,-6,1207,2665,30
2332632035,2332632035,0,1193,1874,30
2334290855,2334290850,-5,1077,3128,30
2348516818,2348516814,-4,867,2656,30
2348834569,2348834565,-4,671,2111,30
2349561822,2349561816,-6,819,2647,30
2352272785,2352272780,-5,1153,4294,30
2354562319,2354562314,-5,1043,2540,30
2354649327,2354649323,-4,1148,1902,30
2367575311,2367575307,-4,858,2664,30
2368890973,2368890977,4,3313,2338,30
2370834122,2370834117,-5,835,1894,30
2371344912,2371344934,22,853,2518,30
2373547900,2373547893,-7,998,3044,30
2376501230,2376501225,-5,941,3221,30
2376960993,2376960978,-15,898,2555,30
2379775825,2379775828,3,3686,2583,30
2382134265,2382134270,5,2301,1130,30
2384723845,2384723838,-7,1109,3270,30
2386721151,2386721161,10,13238,44523,30
2387648285,2387648279,-6,1080,2743,30
2388138624,2388138638,14,355,1113,30
2388794265,2388794258,-7,719,2568,30
2391005174,2391005170,-4,636,2046,30
2392168573,2392168569,-4,722,3246,30
2392327618,2392327625,7,200,837,30
2394618522,2394618519,-3,1084,2483,30
2398464199,2398464194,-5,784,2270,30
2401849068,2401849062,-6,1188,2262,30
2405558267,2405558261,-6,822,2657,30
2406571091,2406571106,15,418,1111,30
2411431315,2411431309,-6,1197,2937,30
2411716168,2411716162,-6,840,3058,30
2418499086,2418499082,-4,717,1830,30
2422052437,2422052432,-5,659,1828,30
2424298158,2424298153,-5,915,1395,30
2429044366,2429044368,2,1902,1689,30
2435625311,2435625306,-5,866,2731,30
2440073486,2440073471,-15,1241,1092,30
2442424514,2442424511,-3,929,2942,30
2442517706,2442517713,7,167,1613,30
2442875483,2442875471,-12,262,1410,30
2444663413,2444663406,-7,882,3019,30
2448043937,2448043940,3,2337,2777,30
2454726478,2454726474,-4,1246,3183,30
2455224902,2455224904,2,544,239,30
2455883080,2455883097,17,1073,2564,30
2455911200,2455911210,10,493,858,30
2456013102,2456013095,-7,975,2796,30
2456925111,2456925107,-4,1235,3336,30
2457144392,2457144410,18,438,1071,30
2457957938,2457957932,-6,1120,2303,30
2459522445,2459522441,-4,1355,4330,30
2460189191,2460189187,-4,1335,2649,30
2460759298,2460759293,-5,1139,2419,30
2461830454,2461830446,-8,1720,10072,30
2467593167,2467593160,-7,788,2429,30
2468114666,2468114661,-5,918,2824,30
2472305806,2472305803,-3,1124,2112,30
2474524650,2474524646,-4,501,1943,30
2475333380,2475333374,-6,918,4195,30
2476255009,2476255003,-6,530,2294,30
2476369678,2476369673,-5,866,2961,30
2477763155,2477763150,-5,1049,3274,30
2484787238,2484787252,14,1006,665,30
2486861811,2486861803,-8,810,2735,30
2492894226,2492894221,-5,929,2593,30
2496448330,2496448324,-6,1014,2222,30
2500767773,2500767767,-6,1115,4014,30
2505929475,2505929469,-6,1382,2897,30
2508438290,2508438286,-4,1174,2894,30
2514398606,2514398613,7,6078,2635,30
2525877570,2525877566,-4,567,1727,30
2526174763,2526174780,17,279,941,30
2526279029,2526279024,-5,953,2806,30
2539729897,2539729893,-4,976,2872,30
2542858285,2542858281,-4,1352,2465,30
2543173851,2543173870,19,1428,3034,30
2547052590,2547052586,-4,1197,2820,30
2548603964,2548603955,-9,1303,4223,30
2550116185,2550116181,-4,903,2491,30
2553058783,2553058779,-4,773,2224,30
2554953466,2554953461,-5,1282,3839,30
2560877232,2560877247,15,408,1050,30
2561229451,2561229447,-4,1062,2272,30
2561790116,2561790134,18,258,1140,30
2563406451,2563406446,-5,983,3805,30
2569998236,2569998230,-6,1001,2428,30
2579031167,2579031166,-1,2295,3724,30
2580663421,2580663418,-3,1283,3321,30
2585664215,2585664211,-4,1472,3926,30
2591175484,2591175480,-4,1127,2211,30
2593009958,2593009955,-3,560,1996,30
2593612446,2593612442,-4,831,2810,30
2593840092,2593840087,-5,1297,2738,30
2598784366,2598784361,-5,1356,2880,30
2604463587,2604463590,3,2013,1800,30
2604711602,2604711597,-5,880,2064,30
2607810668,2607810665,-3,1307,1983,30
2609490702,2609490713,11,176,1030,30
2614821861,2614821858,-3,1349,2113,30
2615108779,2615108798,19,240,880,30
2624335992,2624335989,-3,962,2543,30
2629457223,2629457219,-4,1205,3264,30
2630847121,2630847116,-5,860,2303,30
2631901782,2631901774,-8,966,4678,30
2632555209,2632555204,-5,988,4324,30
2635264505,2635264501,-4,1017,3101,30
2640052443,2640052440,-3,1096,2286,30
2646538063,2646538060,-3,839,2926,30
2649010990,2649010987,-3,246,944,30
2651322885,2651322901,16,683,2396,30
2656297510,2656297503,-7,815,2300,30
2656636936,2656636917,-19,1235,2435,30
2660136313,2660136310,-3,1071,2033,30
2661147101,2661147097,-4,1176,3254,30
2661488319,2661488314,-5,1053,2102,30
2662528670,2662528666,-4,1258,2211,30
2664305525,2664305520,-5,1167,3208,30
2670635941,2670635944,3,1588,1866,30
2672338152,2672338148,-4,1491,2593,30
2685343263,2685343259,-4,989,3349,30
2691420953,2691420949,-4,702,1411,30
2696014727,2696014730,3,1968,2194,30
2701276298,2701276293,-5,538,1465,30
2703659007,2703659006,-1,2413,3090,30
2704056719,2704056714,-5,1355,3470,30
2712395371,2712395364,-7,2163,7881,30
2712863019,2712863013,-6,1141,3095,30
2716385826,2716385820,-6,772,2272,30
2719782418,2719782411,-7,906,3002,30
2719869273,2719869293,20,1265,3082,30
2724012337,2724012334,-3,1249,1923,30
2729086746,2729086742,-4,844,2345,30
2729514930,2729514950,20,540,2093,30
2730807297,2730807292,-5,698,2811,30
2732122745,2732122741,-4,931,2687,30
2735021129,2735021126,-3,1393,2211,30
2735567293,2735567289,-4,1328,3035,30
2737698547,2737698543,-4,1139,2928,30
2740384125,2740384124,-1,25105,22411,30
2743542230,2743542226,-4,921,2848,30
2745925594,2745925590,-4,664,1977,30
2748461712,2748461710,-2,770,2845,30
2751810233,2751810234,1,1253,1493,30
2753232154,2753232150,-4,690,1919,30
2753381702,2753381696,-6,1152,2861,30
2753689930,2753689950,20,1335,2162,30
2755370791,2755370788,-3,1053,2682,30
2756869533,2756869538,5,2412,1117,30
2758281878,2758281873,-5,725,2431,30
2765708899,2765708895,-4,632,1189,30
2770566050,2770566047,-3,1390,2451,30
2770745881,2770745868,-13,863,3118,30
2771178663,2771178665,2,705,1333,30
2771275816,2771275809,-7,252,765,30
2776140705,2776140702,-3,982,1597,30
2777310523,2777310518,-5,844,2231,30
2780255213,2780255210,-3,924,2538,30
2780484721,2780484739,18,957,3323,30
2783087432,2783087427,-5,905,2708,30
2783434833,2783434851,18,626,2149,30
2784967329,2784967327,-2,972,2419,30
2791126793,2791126788,-5,938,3197,30
2791428650,2791428645,-5,1227,3221,30
2791791109,2791791105,-4,1193,3479,30
2794334817,2794334824,7,13198,25388,30
2794674439,2794674435,-4,1372,3115,30
2795320538,2795320554,16,808,2291,30
2796055318,2796055314,-4,62310,51588,30
2804377162,2804377157,-5,1074,2199,30
2804656517,2804656523,6,2060,656,30
2810831155,2810831150,-5,1641,3683,30
2817778916,2817778910,-6,1138,2966,30
2819574426,2819574422,-4,932,2046,30
2825369055,2825369050,-5,1411,3463,30
2825713662,2825713669,7,3237,2437,30
2826757274,2826757270,-4,1281,3644,30
2829423979,2829423974,-5,1265,2998,30
2830083879,2830083875,-4,938,2499,30
2832661941,2832661937,-4,966,2602,30
2832710011,2832710006,-5,885,1824,30
2833529752,2833529743,-9,200,831,30
2836346706,2836346700,-6,1272,4137,30
2837043134,2837043130,-4,1000,2589,30
2842509695,2842509690,-5,849,2891,30
2842695809,2842695801,-8,779,1485,30
2843777377,2843777373,-4,1094,3014,30
2843956250,2843956246,-4,1197,2531,30
2846234107,2846234104,-3,972,3230,30
2857983145,2857983141,-4,1084,2766,30
2858820342,2858820336,-6,1192,3382,30
2859177482,2859177470,-12,685,2649,30
2876799150,2876799147,-3,658,2462,30
2891454990,2891454985,-5,986,2110,30
2892247597,2892247596,-1,1294,1667,30
2894345865,2894345859,-6,718,3711,30
2894485715,2894485707,-8,86,1075,30
2894698295,2894698291,-4,449,1246,30
2896625081,2896625086,5,2445,2379,30
2896853347,2896853343,-4,840,2196,30
2910344369,2910344369,0,1511,2740,30
2911930545,2911930540,-5,668,2806,30
2915295155,2915295150,-5,726,2034,30
2916030393,2916030413,20,858,2605,30
2919038769,2919038764,-5,798,2479,30
2920032661,2920032654,-7,753,4352,30
2923377995,2923377994,-1,1226,2364,30
2928055321,2928055315,-6,1440,3365,30
2932098529,2932098535,6,1472,1165,30
2932671326,2932671322,-4,906,2211,30
2937723964,2937723961,-3,860,2076,30
2937944306,2937944321,15,494,3522,30
2938407051,2938407046,-5,838,3377,30
2938480563,2938480578,15,62,869,30
2941662458,2941662455,-3,785,2103,30
2944298559,2944298556,-3,1075,2421,30
2953200495,2953200493,-2,2099,4308,30
2955801803,2955801798,-5,872,2750,30
2956685443,2956685442,-1,889,2079,30
2959250155,2959250151,-4,862,1354,30
2959537384,2959537405,21,712,2601,30
2965130377,2965130373,-4,955,2704,30
2966681794,2966681789,-5,942,3343,30
2969843170,2969843167,-3,1007,2324,30
2971498158,2971498154,-4,1269,2506,30
2973877344,2973877337,-7,1075,2963,30
2975087418,2975087422,4,1075,736,30
2989104151,2989104149,-2,1108,2197,30
2990198205,2990198201,-4,817,1997,30
2990576634,2990576623,-11,1196,2948,30
2991920963,2991920958,-5,1158,3250,30
2992594301,2992594301,0,1999,2446,30
2993365751,2993365746,-5,958,3125,30
2994817630,2994817625,-5,1136,4990,30
2996153639,2996153633,-6,1320,2873,30
3003112440,3003112434,-6,1165,3836,30
3011924736,3011924730,-6,68,1105,30
3016679879,3016679873,-6,1472,6934,30
3021059508,3021059504,-4,1304,3585,30
3028537332,3028537326,-6,940,2555,30
3029466862,3029466859,-3,664,1980,30
3032648340,3032648336,-4,910,3258,30
3040219711,3040219707,-4,1139,2717,30
3041775147,3041775145,-2,1406,2466,30
3044278709,3044278706,-3,1102,1642,30
3044766065,3044766061,-4,951,2342,30
3047659583,3047659577,-6,1488,3005,30
3048600323,3048600317,-6,1049,2808,30
3050765443,3050765439,-4,1382,3430,30
3050855900,3050855915,15,202,1029,30
3058983446,3058983444,-2,989,2011,30
3059116294,3059116290,-4,1073,3254,30
3070586415,3070586408,-7,907,3061,30
3071526464,3071526485,21,393,1731,30
3072125739,3072125734,-5,824,2888,30
3076563063,3076563058,-5,626,1838,30
3079974658,3079974655,-3,1131,2302,30
3082563889,3082563890,1,3563,3131,30
3087515122,3087515119,-3,667,2646,30
3094033352,3094033348,-4,1040,3045,30
3094585819,3094585817,-2,702,1285,30
3100362678,3100362674,-4,1022,2696,30
3114771911,3114771905,-6,1357,3296,30
3116725938,3116725935,-3,1884,4888,30
3118415877,3118415873,-4,1415,3006,30
3127638259,3127638254,-5,651,2876,30
3131972167,3131972162,-5,844,3172,30
3134660345,3134660347,2,39747,17843,30
3136293509,3136293506,-3,1324,1820,30
3140479586,3140479581,-5,1100,3435,30
3143334469,3143334464,-5,944,2584,30
3146325810,3146325810,0,10351,14128,30
3147940693,3147940688,-5,1241,2199,30
3148387083,3148387078,-5,977,3247,30
3154466311,3154466307,-4,1186,3798,30
3155047905,3155047900,-5,798,3340,30
3159190858,3159190854,-4,1041,2392,30
3165021686,3165021681,-5,1101,3121,30
3167284313,3167284310,-3,1025,3681,30
3168286834,3168286829,-5,927,2711,30
3169880615,3169880610,-5,1310,2548,30
3172834601,3172834597,-4,1118,3453,30
3181048225,3181048221,-4,711,2593,30
3201065190,3201065185,-5,703,2174,30
3206545352,3206545348,-4,1121,2587,30
3211083279,3211083279,0,2616,3346,30
3218589634,3218589627,-7,1112,3552,30
3218858322,3218858318,-4,1551,3986,30
3226250266,3226250264,-2,1033,2378,30
3229187511,3229187508,-3,844,2407,30
3230325005,3230325000,-5,1407,3074,30
3232091370,3232091366,-4,950,3087,30
3234615491,3234615503,12,1160,1007,30
3240106773,3240106774,1,1284,1491,30
3240195678,3240195674,-4,995,3347,30
3241445712,3241445730,18,1030,3753,30
3243424680,3243424676,-4,914,2632,30
3243539816,3243539811,-5,836,2556,30
3246102539,3246102531,-8,833,2745,30
3249058422,3249058417,-5,1402,3057,30
3254488099,3254488101,2,944,1573,30
3256784698,3256784693,-5,1086,3610,30
3257942477,3257942471,-6,790,4120,30
3262132674,3262132669,-5,856,2864,30
3262298025,3262298027,2,20490,20519,30
3262921669,3262921668,-1,43542,31884,30
3264433726,3264433724,-2,803,2723,30
3268859542,3268859542,0,871,2024,30
3269393946,3269393965,19,820,3622,30
3269607991,3269607986,-5,1197,3438,30
3269694839,3269694834,-5,970,2500,30
3270062787,3270062782,-5,1043,3281,30
3271195909,3271195905,-4,1078,2322,30
3273626734,3273626729,-5,1317,2923,30
3281171402,3281171398,-4,1076,3187,30
3281403538,3281403533,-5,836,3010,30
3282322567,3282322563,-4,806,2149,30
3282478785,3282478781,-4,1449,1936,30
3283106314,3283106329,15,549,3437,30
3284872466,3284872461,-5,1132,2458,30
3288987921,3288987916,-5,1202,3783,30
3295870855,3295870849,-6,765,1806,30
3296781686,3296781683,-3,1380,3400,30
3303165277,3303165273,-4,547,2011,30
3303902866,3303902887,21,265,1031,30
3309311897,3309311894,-3,1429,1796,30
3312668877,3312668873,-4,904,1488,30
3314680171,3314680166,-5,891,3094,30
3332346818,3332346814,-4,1516,3776,30
3334035614,3334035610,-4,1091,1845,30
3341467155,3341467152,-3,585,1802,30
3342348899,3342348901,2,1449,2021,30
3348970771,3348970766,-5,1144,3493,30
3351806915,3351806907,-8,835,2196,30
3360007075,3360007071,-4,1038,3040,30
3363883251,3363883255,4,1210,949,30
3365405805,3365405808,3,1602,1282,30
3365714867,3365714862,-5,1199,3181,30
3369256782,3369256786,4,26638,21115,30
3372201719,3372201713,-6,458,1188,30
3372481963,3372481971,8,275,1138,30
3374480496,3374480491,-5,1466,4101,30
3382798631,3382798622,-9,895,3418,30
3400019719,3400019716,-3,1361,2477,30
3402591426,3402591432,6,2129,1353,30
3405883569,3405883565,-4,1391,2376,30
3409968697,3409968694,-3,1824,3780,30
3410609974,3410609971,-3,810,1365,30
3410874860,3410874854,-6,2705,8783,30
3412796342,3412796338,-4,1297,1837,30
3416300725,3416300721,-4,905,2281,30
3423851423,3423851429,6,1775,1289,30
3429643046,3429643048,2,2144,1928,30
3430914207,3430914202,-5,1174,3081,30
3432935719,3432935714,-5,1433,2736,30
3434913309,3434913304,-5,1358,4009,30
3436755337,3436755331,-6,1083,3054,30
3442264472,3442264469,-3,269,1151,30
3442882654,3442882649,-5,1166,3491,30
3444175368,3444175366,-2,1458,2731,30
3447664003,3447663997,-6,36814,2009,30
3448603462,3448603458,-4,865,3172,30
3451581346,3451581342,-4,858,3011,30
3455247934,3455247931,-3,404,1851,30
3461073057,3461073058,1,819,1878,30
3472560605,3472560603,-2,2024,2573,30
3477255662,3477255657,-5,994,3022,30
3479495911,3479495905,-6,1074,3508,30
3483354306,3483354302,-4,673,1746,30
3484893339,3484893334,-5,1343,3992,30
3486020307,3486020301,-6,1228,3379,30
3489840032,3489840027,-5,570,2094,30
3491938138,3491938158,20,820,1825,30
3492977621,3492977617,-4,1289,2496,30
3494016262,3494016257,-5,744,3553,30
3494054298,3494054313,15,957,2915,30
3501050729,3501050734,5,3175,1596,30
3503181871,3503181879,8,2848,692,30
3503739115,3503739110,-5,906,2554,30
3504853362,3504853357,-5,1097,2578,30
3508672147,3508672141,-6,1314,3142,30
3510380556,3510380552,-4,1351,3724,30
3522342556,3522342569,13,1545,4373,30
3528628734,3528628730,-4,847,3587,30
3529250304,3529250310,6,1269,732,30
3529941054,3529941061,7,8639,3089,30
3531619787,3531619781,-6,1161,3329,30
3533201462,3533201459,-3,987,2409,30
3536626198,3536626194,-4,1194,2740,30
3536800811,3536800807,-4,727,1217,30
3537557504,3537557485,-19,1368,3844,30
3539142590,3539142586,-4,940,2217,30
3539836178,3539836174,-4,998,3701,30
3540258466,3540258462,-4,713,2626,30
3541286555,3541286571,16,401,1808,30
3542929370,3542929366,-4,953,2245,30
3544353034,3544353029,-5,1139,3710,30
3548930778,3548930774,-4,674,2572,30
3553207538,3553207546,8,4641,1956,30
3556079075,3556079069,-6,1060,2921,30
3557617703,3557617697,-6,1215,3098,30
3569800319,3569800314,-5,1065,2610,30
3570729774,3570729774,0,1027,1649,30
3571250647,3571250641,-6,773,3164,30
3573505974,3573505981,7,11084,2620,30
3574589824,3574589843,19,108,903,30
3575334687,3575334682,-5,1085,3258,30
3576302660,3576302657,-3,1139,3268,30
3579712027,3579712023,-4,1112,2559,30
3580940583,3580940578,-5,527,1841,30
3581054532,3581054549,17,1685,3359,30
3583548618,3583548614,-4,976,3216,30
3588343837,3588343833,-4,1018,2786,30
3590920050,3590920044,-6,1212,2682,30
3591112651,3591112638,-13,1287,1120,30
3596075155,3596075150,-5,1000,3246,30
3600380263,3600380258,-5,1160,3507,30
3606404365,3606404371,6,1735,1178,30
3608621639,3608621634,-5,1271,3395,30
3612358918,3612358917,-1,860,860,30
3619294376,3619294371,-5,1138,2472,30
3619408547,3619408565,18,814,1570,30
3619902048,3619902047,-1,1201,1407,30
3621199370,3621199356,-14,1118,2810,30
3627289505,3627289502,-3,1031,2535,30
3627614937,3627614933,-4,1093,2318,30
3635317190,3635317185,-5,1515,2518,30
3640830743,3640830737,-6,1016,2609,30
3641244577,3641244573,-4,1272,2680,30
3645326346,3645326341,-5,1116,3576,30
3645714784,3645714770,-14,213,1106,30
3661384996,3661384990,-6,1099,3286,30
3661604233,3661604220,-13,69,978,30
3663826302,3663826300,-2,688,1708,30
3666401251,3666401247,-4,693,2945,30
3668188387,3668188383,-4,1088,2919,30
3668215766,3668215760,-6,1412,4165,30
3669165323,3669165331,8,355,1280,30
3670846208,3670846204,-4,1056,2797,30
3673832923,3673832920,-3,751,1652,30
3677589327,3677589322,-5,1062,3016,30
3678297193,3678297189,-4,1350,3142,30
3681536227,3681536223,-4,995,3046,30
3682197726,3682197726,0,1398,2055,30
3684743239,3684743233,-6,919,2729,30
3684810663,3684810658,-5,862,2470,30
3689581963,3689581962,-1,1057,2006,30
3707769266,3707769264,-2,2508,3940,30
3710399083,3710399078,-5,839,2589,30
3711853750,3711853745,-5,970,2972,30
3714616050,3714616033,-17,2211,873,30
3717433274,3717433270,-4,869,2439,30
3719552750,3719552745,-5,1393,2811,30
3720091531,3720091526,-5,943,2750,30
3720993321,3720993316,-5,912,3159,30
3726650648,3726650642,-6,2137,10648,30
3727668856,3727668851,-5,1270,2714,30
3730262371,3730262368,-3,594,1409,30
3732845777,3732845784,7,14652,4994,30
3733436878,3733436873,-5,1402,2830,30
3737656343,3737656339,-4,1328,2834,30
3738302350,3738302346,-4,2124,5836,30
3761193913,3761193909,-4,796,3059,30
3763268370,3763268366,-4,1409,3949,30
3772203395,3772203393,-2,996,2237,30
3772390187,3772390177,-10,1090,1375,30
3776376730,3776376726,-4,989,2421,30
3776518592,3776518614,22,929,2521,30
3778874234,3778874231,-3,609,2200,30
3780232863,3780232861,-2,1298,3159,30
3781032102,3781032109,7,2045,1293,30
3783793322,3783793318,-4,934,2338,30
3788144551,3788144546,-5,1024,3455,30
3790298591,3790298592,1,1283,1163,30
3791278769,3791278764,-5,609,2543,30
3795659472,3795659478,6,3773,2141,30
3796463330,3796463330,0,1657,2613,30
3805796961,3805796956,-5,1333,3283,30
3811905285,3811905282,-3,989,2473,30
3812697668,3812697665,-3,1330,3261,30
3816657465,3816657461,-4,948,3281,30
3826208643,3826208639,-4,987,1735,30
3829638336,3829638330,-6,1155,3191,30
3831552571,3831552566,-5,1306,3684,30
3832522906,3832522908,2,615,1451,30
3834417707,3834417699,-8,327,2222,30
3836555561,3836555561,0,2569,4003,30
3841897763,3841897758,-5,996,3204,30
3849105889,3849105885,-4,1108,2588,30
3851433913,3851433907,-6,750,2468,30
3852089150,3852089163,13,183,1280,30
3853078065,3853078061,-4,1046,3780,30
3857446347,3857446346,-1,1239,2034,30
3857882298,3857882293,-5,1037,2540,30
3859797115,3859797109,-6,781,1902,30
3859918336,3859918335,-1,11,1129,30
3860911231,3860911228,-3,1399,3391,30
3861159950,3861159946,-4,459,2575,30
3865695987,3865695981,-6,1093,3111,30
3867214685,3867214681,-4,1184,2816,30
3868097058,3868097053,-5,1923,8497,30
3871788134,3871788130,-4,781,2238,30
3878637054,3878637057,3,4403,2236,30
3880520357,3880520360,3,30760,112519,30
3896865865,3896865861,-4,1315,2558,30
3902759462,3902759455,-7,757,2608,30
3908443166,3908443158,-8,1181,3961,30
3909728729,3909728734,5,3911,1806,30
3913230457,3913230458,1,6464,7851,30
3913498414,3913498396,-18,2123,2073,30
3916236327,3916236343,16,898,3207,30
3916816554,3916816545,-9,686,2283,30
3917901137,3917901158,21,241,1442,30
3920157075,3920157068,-7,772,4207,30
3921056287,3921056282,-5,1327,3351,30
3923969666,3923969662,-4,850,2304,30
3928459133,3928459129,-4,934,2679,30
3933366130,3933366134,4,2092,1723,30
3934540503,3934540498,-5,1492,3205,30
3939174966,3939174959,-7,1107,2513,30
3939524285,3939524285,0,1516,2356,30
3942411813,3942411809,-4,1346,3450,30
3945810019,3945810013,-6,1033,2832,30
3946669242,3946669258,16,999,2597,30
3948905084,3948905082,-2,1082,2383,30
3951426851,3951426846,-5,569,3031,30
3955125367,3955125361,-6,762,2118,30
3962027109,3962027102,-7,732,4760,30
3963823784,3963823780,-4,1278,2488,30
3964709910,3964709906,-4,831,2876,30
3969831887,3969831886,-1,1201,1778,30
3969861623,3969861620,-3,1283,2573,30
3970854730,3970854726,-4,1241,3071,30
3976690526,3976690520,-6,698,2554,30
3977626994,3977626989,-5,1025,2248,30
3978063577,3978063586,9,5,5894,30
3980924944,3980924950,6,5717,1782,30
3983192759,3983192761,2,1964,1880,30
3991265770,3991265772,2,1541,1673,30
3992847565,3992847559,-6,1117,2767,30
4004806347,4004806344,-3,946,3107,30
4007676667,4007676659,-8,85,718,30
4008094718,4008094713,-5,1317,2362,30
4009889057,4009889054,-3,1086,3122,30
4015770295,4015770292,-3,702,1520,30
4027402005,4027402011,6,1708,966,30
4031000681,4031000677,-4,883,1835,30
4031636922,4031636922,0,1474,2174,30
4041491713,4041491707,-6,1213,3265,30
4042127409,4042127404,-5,916,3314,30
4047251986,4047251981,-5,1067,3403,30
4047657516,4047657502,-14,1661,11671,30
4048427095,4048427091,-4,1122,2514,30
4053038397,4053038394,-3,928,2190,30
4054044640,4054044641,1,129,1222,30
4056522937,4056522931,-6,1162,3969,30
4060252826,4060252823,-3,585,1863,30
4061725498,4061725494,-4,923,2109,30
4062097913,4062097912,-1,756,1363,30
4063980918,4063980911,-7,888,2621,30
4064596016,4064596010,-6,1134,3093,30
4064704859,4064704839,-20,91,714,30
4064920354,4064920349,-5,1095,3180,30
4071947699,4071947694,-5,834,3178,30
4079481607,4079481603,-4,739,2750,30
4083150850,4083150861,11,13607,18649,30
4091085067,4091085062,-5,1090,4525,30
4093788094,4093788099,5,2027,1400,30
4094250885,4094250882,-3,1104,2771,30
4098430382,4098430378,-4,1222,2570,30
4115378451,4115378450,-1,607,2049,30
4115468808,4115468815,7,167,956,30
4119149046,4119149041,-5,913,2924,30
4127440350,4127440343,-7,733,1924,30
4132905665,4132905661,-4,1318,3141,30
4147825154,4147825151,-3,1246,4171,30
4147925206,4147925202,-4,1376,4045,30
4149812662,4149812662,0,1040,922,30
4150718100,4150718095,-5,897,3693,30
4154940395,4154940389,-6,1492,3151,30
4160489195,4160489189,-6,999,2937,30
4162291610,4162291607,-3,1300,2884,30
4170175414,4170175413,-1,1109,1750,30
4173379487,4173379480,-7,1208,3344,30
4176665953,4176665948,-5,1179,2869,30
4178763069,4178763065,-4,1441,3938,30
4180310023,4180310018,-5,846,3221,30
4182251994,4182251994,0,1666,2361,30
4188656022,4188656018,-4,846,2657,30
4191223397,4191223391,-6,946,2964,30
4191380859,4191380878,19,913,3140,30
4195002293,4195002289,-4,1551,3714,30
4200752686,4200752682,-4,1159,2988,30
4201447215,4201447209,-6,719,2665,30
4203441722,4203441719,-3,1820,2977,30
4207700352,4207700349,-3,1022,2472,30
4212735683,4212735679,-4,737,2806,30
4214164688,4214164694,6,5783,2704,30
4214522400,4214522398,-2,947,2149,30
4218404590,4218404586,-4,1114,2792,30
4220690846,4220690841,-5,19899,55147,30
4228643197,4228643198,1,1820,1665,30
4232904314,4232904311,-3,627,1359,30
4233673237,4233673242,5,3102,986,30
4248307126,4248307122,-4,1178,2917,30
4248453426,4248453419,-7,927,2586,30
4251542582,4251542576,-6,1138,4201,30
4252434586,4252434581,-5,1312,3098,30
4252518814,4252518809,-5,1268,2100,30
4256825629,4256825633,4,1933,1011,30
4258933559,4258933555,-4,920,1270,30
4259074507,4259074521,14,740,1720,30
4263146710,4263146713,3,1194,1896,30
4265107728,4265107722,-6,1205,3227,30
4267504809,4267504805,-4,817,2606,30
4268455239,4268455234,-5,865,2646,30
4268936550,4268936551,1,1563,1761,30
4284640899,4284640895,-4,830,2656,30
4285954262,4285954257,-5,1008,3139,30
4286081291,4286081310,19,891,2691,30
4293141646,4293141642,-4,1058,2378,30
4293471666,4293471686,20,725,2237,30
4293588145,4293588147,2,3291,3456,30
4295910011,4295910009,-2,992,1752,30
4302812536,4302812530,-6,1334,3761,30
4305909592,4305909586,-6,982,3060,30
4309173617,4309173612,-5,1093,3333,30
4310377059,4310377057,-2,1074,3765,30
4321139247,4321139241,-6,697,3039,30
4322281785,4322281782,-3,862,1879,30
4331655299,4331655295,-4,1090,2886,30
4337113675,4337113665,-10,44200,14355,30
4339069706,4339069702,-4,1296,2357,30
4346761859,4346761856,-3,1170,3268,30
4349498081,4349498074,-7,828,2406,30
4356181055,4356181050,-5,1575,3216,30
4356885969,4356885970,1,40784,17625,30
4358412757,4358412752,-5,1322,1991,30
4360239173,4360239170,-3,978,2697,30
4366065448,4366065445,-3,1588,2087,30
4366431620,4366431638,18,622,2485,30
4367793898,4367793893,-5,945,2430,30
4368226068,4368226084,16,1090,2555,30
4370824178,4370824172,-6,880,2133,30
4372210332,4372210325,-7,1097,4603,30
4373703661,4373703657,-4,1180,3113,30
4375002915,4375002912,-3,1160,2788,30
4381330108,4381330105,-3,865,1783,30
4381593243,4381593230,-13,1678,1512,30
4382103465,4382103465,0,2174,3535,30
4382954344,4382954336,-8,1036,1923,30
4385123314,4385123321,7,334,1406,30
4387256955,4387256961,6,1666,920,30
4388244989,4388244982,-7,1048,3114,30
4391056414,4391056410,-4,1052,1757,30
4394927046,4394927045,-1,1098,1728,30
4400342523,4400342519,-4,761,2377,30
4405796140,4405796134,-6,846,2950,30
4407059569,4407059566,-3,826,3337,30
4416925003,4416924998,-5,829,2438,30
4417127299,4417127286,-13,1185,3022,30
4417832628,4417832623,-5,1380,3348,30
4419768980,4419768977,-3,656,2432,30
4423717770,4423717764,-6,685,2367,30
4425409051,4425409048,-3,1135,2888,30
4432527410,4432527408,-2,1566,1700,30
4433027225,4433027221,-4,1215,3021,30
4434130078,4434130074,-4,802,2247,30
4435359270,4435359265,-5,921,2462,30
4436575350,4436575346,-4,639,1548,30
4437610896,4437610917,21,503,2063,30
4441613739,4441613734,-5,771,2497,30
4445245074,4445245082,8,2860,1176,30
4448922294,4448922289,-5,790,2897,30
4452369526,4452369521,-5,972,4167,30
4454045855,4454045848,-7,887,3428,30
4455310689,4455310685,-4,897,3406,30
4455468207,4455468201,-6,1292,3121,30
4455670781,4455670783,2,2792,2417,30
4456481002,4456480997,-5,1139,2771,30
4459974492,4459974482,-10,47,822,30
4460977570,4460977588,18,920,2477,30
4463423033,4463423025,-8,1426,3890,30
4466381310,4466381314,4,1865,1963,30
4467351215,4467351210,-5,907,3001,30
4468744470,4468744465,-5,1501,5022,30
4469274150,4469274147,-3,968,2428,30
4470355387,4470355383,-4,679,2116,30
4471147600,4471147623,23,1131,2884,30
4472585866,4472585861,-5,1137,2393,30
4473378726,4473378719,-7,899,3073,30
4474195567,4474195561,-6,887,2958,30
4479579271,4479579266,-5,841,3275,30
4479798888,4479798897,9,267,1441,30
4484525575,4484525568,-7,1146,2851,30
4497579247,4497579243,-4,1029,3821,30
4497851811,4497851830,19,1029,2205,30
4500231548,4500231560,12,403,2230,30
4503942755,4503942749,-6,680,3458,30
4509997039,4509997034,-5,1103,3534,30
4514330861,4514330855,-6,1030,1872,30
4514892289,4514892270,-19,1152,3088,30
4516352808,4516352816,8,4643,1599,30
4518460067,4518460060,-7,796,2960,30
4521061672,4521061674,2,17049,16657,30
4523495099,4523495094,-5,1012,2756,30
4540191111,4540191106,-5,1302,2934,30
4540946334,4540946332,-2,1009,2550,30
4549529067,4549529062,-5,880,2125,30
4549735825,4549735822,-3,962,2189,30
4550534379,4550534369,-10,167,648,30
4556745227,4556745221,-6,1050,2700,30
4558545511,4558545507,-4,1104,3060,30
4559173635,4559173631,-4,1133,2916,30
4566698946,4566698942,-4,1140,2112,30
4570555144,4570555139,-5,659,1792,30
4571590386,4571590384,-2,1043,2445,30
4571919667,4571919662,-5,514,2898,30
4577525770,4577525766,-4,927,2764,30
4581348642,4581348639,-3,1039,3177,30
4582112203,4582112205,2,3428,3931,30
4583312146,4583312139,-7,484,1611,30
4583553706,4583553727,21,259,1188,30
4585110633,4585110626,-7,1195,4032,30
4585455711,4585455716,5,3167,1997,30
4586050307,4586050303,-4,1172,2802,30
4586785306,4586785298,-8,182,636,30
4592811427,4592811422,-5,739,2393,30
4598370346,4598370343,-3,994,1869,30
4600301303,4600301301,-2,1228,2466,30
4606874814,4606874796,-18,738,354,30
4609666376,4609666373,-3,850,2281,30
4612494999,4612494992,-7,919,3439,30
4618882697,4618882693,-4,1341,2464,30
4620194930,4620194933,3,2795,2508,30
4621532416,4621532418,2,1512,1439,30
4625219187,4625219183,-4,1110,2395,30
4629081690,4629081685,-5,1390,3267,30
4630642079,4630642075,-4,746,1901,30
4632019172,4632019170,-2,1490,1888,30
4633327777,4633327774,-3,3859,8184,30
4633757981,4633757981,0,17371,8340,30
4634024382,4634024375,-7,943,3703,30
4636039689,4636039686,-3,501,2369,30
4636545415,4636545411,-4,1025,2745,30
4640719083,4640719078,-5,1000,3029,30
4641051006,4641051002,-4,947,1711,30
4642260384,4642260393,9,134,2034,30
4643097514,4643097509,-5,960,1580,30
4646642102,4646642111,9,2128,714,30
4647547647,4647547642,-5,830,2904,30
4656953722,4656953718,-4,886,2762,30
4660470734,4660470729,-5,871,1902,30
4665724210,4665724204,-6,947,2446,30
4668796550,4668796556,6,13374,24817,30
4671378491,4671378487,-4,1420,3969,30
4677264818,4677264813,-5,1167,3697,30
4681243035,4681243031,-4,960,3989,30
4681368674,4681368671,-3,1216,3168,30
4686479842,4686479838,-4,1067,2223,30
4687898662,4687898659,-3,1562,2477,30
4689670618,4689670614,-4,838,2339,30
4701270674,4701270670,-4,1310,2971,30
4708789710,4708789709,-1,911,2705,30
4710577681,4710577676,-5,694,2099,30
4712825670,4712825666,-4,1016,2242,30
4718499064,4718499060,-4,1269,4214,30
4719808478,4719808471,-7,1093,3692,30
4720136867,4720136886,19,718,1731,30
4720450996,4720450991,-5,1130,3469,30
4725994405,4725994402,-3,2432,4316,30
4726905489,4726905482,-7,765,4745,30
4733096890,4733096887,-3,1339,2870,30
4733267266,4733267248,-18,976,2743,30
4733994289,4733994310,21,1137,3255,30
4735461187,4735461186,-1,991,915,30
4738154378,4738154374,-4,1255,3679,30
4739654591,4739654587,-4,1191,2844,30
4740960312,4740960308,-4,1089,2237,30
4742317010,4742317007,-3,1089,2537,30
4742640973,4742640979,6,2830,1398,30
4746177985,4746177982,-3,940,2596,30
4754222147,4754222145,-2,814,2147,30
4757403906,4757403923,17,440,1963,30
4757603107,4757603099,-8,828,2890,30
4758524152,4758524170,18,482,1022,30
4760154059,4760154057,-2,1322,2196,30
4773701175,4773701170,-5,1175,1906,30
4776346114,4776346122,8,4456,1567,30
4778789949,4778789955,6,5023,2281,30
4780689114,4780689109,-5,1200,2912,30
4781355618,4781355613,-5,1237,3522,30
4782606268,4782606273,5,5719,2647,30
4784598133,4784598127,-6,1166,3155,30
4790218723,4790218719,-4,1007,2424,30
4792299273,4792299270,-3,878,2932,30
4792413490,4792413475,-15,111,1198,30
4801726862,4801726858,-4,943,2776,30
4802019392,4802019375,-17,1136,2316,30
4802300946,4802300942,-4,941,3783,30
4802387418,4802387439,21,158,779,30
4804425367,4804425363,-4,957,2291,30
4806005282,4806005279,-3,1132,2457,30
4809726165,4809726161,-4,1032,1967,30
4814623106,4814623113,7,2410,947,30
4817545710,4817545705,-5,910,3657,30
4818078584,4818078579,-5,783,1730,30
4834410182,4834410178,-4,871,2571,30
4834583531,4834583525,-6,918,2243,30
4840013255,4840013251,-4,1171,2714,30
4847244082,4847244078,-4,889,1930,30
4852632411,4852632405,-6,779,3112,30
4854762089,4854762086,-3,867,3204,30
4862962049,4862962045,-4,1139,3390,30
4865599210,4865599207,-3,1115,2387,30
4868991179,4868991173,-6,925,2938,30
4885009581,4885009574,-7,898,3513,30
4887255866,4887255863,-3,1138,2573,30
4893648366,4893648368,2,1464,938,30
4901114522,4901114519,-3,708,1515,30
4901401873,4901401886,13,784,1995,30
4908321473,4908321469,-4,832,2624,30
4913374736,4913374732,-4,1417,2510,30
4917397007,4917397002,-5,1052,2963,30
4917556054,4917556049,-5,1088,3153,30
4918878856,4918878878,22,1187,3677,30
4922869743,4922869739,-4,1305,3373,30
4923818881,4923818876,-5,846,1669,30
4924119865,4924119860,-5,841,1768,30
4925409714,4925409715,1,1844,1549,30
4929932861,4929932866,5,3270,1478,30
4936271288,4936271282,-6,1363,4363,30
4936663254,4936663249,-5,1612,3566,30
4941473733,4941473729,-4,730,1745,30
4950238861,4950238856,-5,1192,2532,30
4953219062,4953219069,7,13382,4492,30
4956982871,4956982866,-5,1031,2568,30
4964639956,4964639951,-5,845,2164,30
4970632571,4970632568,-3,924,2435,30
4971590179,4971590173,-6,1080,2860,30
4979179034,4979179030,-4,1056,3452,30
4979543809,4979543804,-5,851,1556,30
4983981783,4983981778,-5,562,1977,30
4986901653,4986901647,-6,1033,3667,30
4989210691,4989210684,-7,1003,2779,30
4991008358,4991008351,-7,1292,2577,30
4991978710,4991978705,-5,1252,2271,30
4993916913,4993916909,-4,989,3524,30
4994330456,4994330477,21,371,2425,30
4999518119,4999518114,-5,973,2296,30
5004427618,5004427615,-3,793,3135,30
5005819153,5005819148,-5,1150,2964,30
5006447874,5006447869,-5,1211,3971,30
5013009166,5013009159,-7,804,1818,30
5013169113,5013169106,-7,713,3069,30
5014540642,5014540637,-5,1401,3547,30
5017094226,5017094226,0,1317,1972,30
5023729339,5023729337,-2,1140,2132,30
5027202547,5027202551,4,1872,908,30
5032112950,5032112947,-3,958,3274,30
5033670774,5033670779,5,5433,2984,30
5036465373,5036465367,-6,1118,3504,30
5037094656,5037094650,-6,803,1869,30
5037817311,5037817307,-4,955,2643,30
5040152579,5040152575,-4,961,2998,30
5040582171,5040582166,-5,822,2168,30
5043261056,5043261054,-2,1135,2025,30
5044803779,5044803773,-6,618,2638,30
5044984861,5044984861,0,721,1446,30
5047635662,5047635655,-7,1140,3517,30
5048538766,5048538762,-4,711,1953,30
5049039330,5049039325,-5,1115,3557,30
5052674751,5052674746,-5,1222,2346,30
5053066065,5053066061,-4,51,1218,30
5054366206,5054366201,-5,1173,2866,30
5055840325,5055840319,-6,1060,3423,30
5056121337,5056121346,9,120,1014,30
5056274695,5056274690,-5,1051,3468,30
5061656343,5061656338,-5,1154,2702,30
5062139346,5062139343,-3,883,1763,30
5063814028,5063814022,-6,957,3227,30
5064730633,5064730629,-4,1074,3756,30
5068237363,5068237359,-4,1280,3625,30
5069356795,5069356801,6,200,1061,30
5074759767,5074759762,-5,990,2658,30
5075232009,5075232027,18,891,2683,30
5075559026,5075559047,21,310,1004,30
5076025187,5076025181,-6,3262,15130,30
5077093742,5077093738,-4,868,3573,30
5077660053,5077660050,-3,1489,2871,30
5081157996,5081157992,-4,1135,3127,30
5083333508,5083333502,-6,1047,2446,30
5084963706,5084963721,15,1021,2639,30
5090763509,5090763505,-4,1413,3779,30
5093212952,5093212949,-3,906,2708,30
5093571492,5093571507,15,1132,2808,30
5097185384,5097185381,-3,1028,2733,30
5098793597,5098793589,-8,1157,1411,30
5099708972,5099708974,2,1852,1286,30
5100854324,5100854321,-3,899,1897,30
5101712326,5101712322,-4,695,2778,30
5102445000,5102445006,6,7363,2338,30
5103845425,5103845419,-6,977,2800,30
5104072344,5104072362,18,822,2457,30
5104674643,5104674640,-3,1113,2732,30
5108376742,5108376738,-4,958,3298,30
5108654020,5108654014,-6,769,1976,30
5113137665,5113137666,1,1496,1403,30
5122699019,5122699017,-2,1132,3664,30
5127684846,5127684842,-4,1349,2289,30
5127958591,5127958586,-5,419,2019,30
5128074769,5128074766,-3,899,1258,30
5128145919,5128145909,-10,36194,13150,30
5130423327,5130423321,-6,1172,4096,30
5136235118,5136235112,-6,734,1949,30
5151910192,5151910188,-4,33128,12273,30
5153191544,5153191541,-3,1129,3679,30
5153280899,5153280898,-1,235,891,30
5154113327,5154113333,6,2524,1105,30
5156685486,5156685486,0,1798,1846,30
5158110563,5158110558,-5,819,2163,30
5158823793,5158823789,-4,1040,2063,30
5161478351,5161478348,-3,1682,3691,30
5162784092,5162784088,-4,1397,5986,30
5166276759,5166276754,-5,1752,3862,30
5172956766,5172956759,-7,1325,2621,30
5173683154,5173683156,2,6898,22937,30
5174343043,5174343039,-4,823,2616,30
5175380132,5175380140,8,1826,1375,30
5179919959,5179919956,-3,1145,2373,30
5180063373,5180063367,-6,974,3908,30
5181173907,5181173902,-5,738,2142,30
5182940006,5182940002,-4,1221,4327,30
5190158267,5190158262,-5,826,2319,30
5192920529,5192920526,-3,906,3178,30
5194559846,5194559842,-4,1115,2922,30
5195309511,5195309509,-2,1152,1897,30
5203144554,5203144549,-5,694,2341,30
5203947550,5203947550,0,1337,1754,30
5204566048,5204566042,-6,992,2469,30
5205539605,5205539601,-4,1340,2740,30
5212860874,5212860868,-6,804,1714,30
5217095215,5217095211,-4,894,3256,30
5221051874,5221051871,-3,1090,2730,30
5221672354,5221672349,-5,1295,3824,30
5222742431,5222742426,-5,511,2437,30
5222912922,5222912918,-4,748,1391,30
5230872882,5230872880,-2,1362,2243,30
5231364187,5231364182,-5,868,1756,30
5233796476,5233796473,-3,1021,3115,30
5234693091,5234693094,3,232,1680,30
5235322024,5235322025,1,1506,2842,30
5239417774,5239417770,-4,1173,2305,30
5240613376,5240613392,16,310,1658,30
5241685287,5241685283,-4,789,2537,30
5242154906,5242154902,-4,1219,2687,30
5244686391,5244686386,-5,1279,3159,30
5244746695,5244746690,-5,778,1495,30
5253755955,5253755952,-3,1045,2801,30
5259963929,5259963925,-4,1167,2905,30
5266920688,5266920682,-6,1106,3059,30
5275239335,5275239341,6,10050,24560,30
5278708061,5278708056,-5,1287,4791,30
5286528785,5286528782,-3,1406,2651,30
5289518758,5289518754,-4,895,4152,30
5290591103,5290591098,-5,1102,3987,30
5291032051,5291032048,-3,937,2571,30
5292664770,5292664765,-5,873,2558,30
5293065930,5293065911,-19,856,1876,30
5310472663,5310472661,-2,1975,2413,30
5322027575,5322027572,-3,720,2425,30
5324346689,5324346682,-7,1237,6415,30
5325662509,5325662506,-3,1858,3122,30
5336262413,5336262408,-5,1167,3383,30
5340875037,5340875040,3,17457,14291,30
5343196514,5343196510,-4,994,4471,30
5344582270,5344582267,-3,800,2278,30
5349710443,5349710440,-3,854,2503,30
5351067636,5351067630,-6,796,2525,30
5352130069,5352130062,-7,1434,3627,30
5353554251,5353554246,-5,603,2248,30
5354852670,5354852665,-5,1093,2964,30
5356550069,5356550065,-4,938,2983,30
5356591431,5356591430,-1,828,2296,30
5361340649,5361340645,-4,1215,2501,30
5361377491,5361377487,-4,1335,3267,30
5362118023,5362118019,-4,1180,4532,30
5363211282,5363211278,-4,1566,3677,30
5364376127,5364376124,-3,1291,3650,30
5370570107,5370570102,-5,1206,3080,30
5371002557,5371002553,-4,1104,3830,30
5372363961,5372363956,-5,1232,3820,30
5383078249,5383078246,-3,843,3416,30
5389620662,5389620657,-5,813,2551,30
5391919997,5391919990,-7,1601,6044,30
5396729790,5396729785,-5,1373,2789,30
5400178383,5400178378,-5,664,1784,30
5404252126,5404252123,-3,852,2608,30
5405356372,5405356366,-6,1317,3334,30
5409015042,5409015038,-4,4110,39705,30
5411195093,5411195088,-5,943,3492,30
5413133335,5413133331,-4,885,2339,30
5416936730,5416936725,-5,1079,3522,30
5419538762,5419538758,-4,1109,2783,30
5419998082,5419998077,-5,810,2519,30
5420750063,5420750058,-5,946,2746,30
5423300134,5423300129,-5,919,3354,30
5424177163,5424177152,-11,13,1387,30
5424345282,5424345263,-19,77,642,30
5428437811,5428437806,-5,1339,3570,30
5430999961,5430999953,-8,902,3842,30
5431064931,5431064934,3,1863,1561,30
5431115946,5431115950,4,4147,2098,30
5431165786,5431165781,-5,822,2476,30
5431570086,5431570082,-4,916,2461,30
5442916257,5442916253,-4,907,3573,30
5443712030,5443712023,-7,916,3794,30
5446167986,5446167981,-5,977,3594,30
5446309425,5446309421,-4,1051,3196,30
5447074859,5447074874,15,897,2620,30
5450846681,5450846677,-4,1458,1905,30
5455820297,5455820313,16,878,3351,30
5458869413,5458869407,-6,1100,3284,30
5461772027,5461772022,-5,1060,2715,30
5462251459,5462251454,-5,1442,3337,30
5463774387,5463774382,-5,886,2673,30
5469577873,5469577871,-2,1787,2920,30
5472319258,5472319253,-5,1175,2219,30
5472873846,5472873845,-1,1793,2261,30
5474820969,5474820966,-3,862,2825,30
5475309338,5475309345,7,7746,2537,30
5479402833,5479402833,0,1062,1650,30
5480293304,5480293303,-1,1219,2441,30
5483619578,5483619574,-4,898,2584,30
5484797503,5484797500,-3,937,2904,30
5489004349,5489004345,-4,1244,2174,30
5493017030,5493017026,-4,1545,3589,30
5496391318,5496391315,-3,1190,3232,30
5496423754,5496423749,-5,1273,2537,30
5508941431,5508941427,-4,1214,3513,30
5510748969,5510748963,-6,1286,1649,30
5514491932,5514491928,-4,1291,3680,30
5526094622,5526094619,-3,768,2124,30
5527634754,5527634749,-5,780,1628,30
5527746396,5527746391,-5,1309,4333,30
5529324837,5529324834,-3,767,2452,30
5530616307,5530616305,-2,1541,2123,30
5539682269,5539682266,-3,1335,2412,30
5541489175,5541489174,-1,779,2912,30
5542870318,5542870314,-4,942,2075,30
5552444388,5552444383,-5,642,2893,30
5552479788,5552479807,19,662,2475,30
5554052413,5554052408,-5,882,1952,30
5561468323,5561468330,7,3524,1211,30
5562559658,5562559653,-5,1121,2182,30
5565272999,5565272993,-6,1287,2918,30
5578010915,5578010910,-5,1007,3636,30
5581010955,5581010950,-5,998,2474,30
5581278906,5581278907,1,1110,1460,30
5582677769,5582677766,-3,945,3073,30
5585064882,5585064877,-5,954,2464,30
5588189401,5588189397,-4,1463,4013,30
5588496970,5588496966,-4,1098,2161,30
5592442525,5592442525,0,1226,2552,30
5600496965,5600496960,-5,728,2817,30
5602055395,5602055397,2,2401,2176,30
5602970041,5602970037,-4,823,2716,30
5607546594,5607546594,0,1450,2585,30
5608753601,5608753609,8,5865,2789,30
5612043579,5612043574,-5,1087,2610,30
5613599738,5613599734,-4,1066,3326,30
5615552059,5615552053,-6,960,2309,30
5620849147,5620849142,-5,861,2886,30
5621516223,5621516218,-5,1076,3223,30
5639298238,5639298259,21,733,1729,30
5639506497,5639506494,-3,845,3278,30
5644633671,5644633667,-4,1020,2418,30
5646183094,5646183091,-3,1312,2717,30
5647265422,5647265419,-3,1346,2921,30
5647296125,5647296119,-6,1125,2759,30
5649748746,5649748739,-7,572,2775,30
5649952770,5649952771,1,264,745,30
5654282554,5654282550,-4,996,2653,30
5656129389,5656129385,-4,1239,2655,30
5656499278,5656499286,8,4876,2523,30
5659722615,5659722611,-4,1184,2231,30
5661234237,5661234233,-4,1229,2239,30
5663807283,5663807276,-7,828,2298,30
5663937099,5663937095,-4,1112,2664,30
5665276497,5665276489,-8,1227,3884,30
5665971608,5665971630,22,404,1073,30
5675888759,5675888756,-3,835,2829,30
5677375110,5677375108,-2,1106,2146,30
5680189617,5680189610,-7,1216,4071,30
5690085614,5690085610,-4,1730,3695,30
5693113430,5693113428,-2,943,2429,30
5693395354,5693395350,-4,85,1053,30
5698273527,5698273521,-6,1138,2791,30
5700127003,5700126998,-5,841,1443,30
5700155729,5700155724,-5,956,3516,30
5701365218,5701365214,-4,1096,2001,30
5704334027,5704334022,-5,1547,4120,30
5705620338,5705620334,-4,1145,2515,30
5706408702,5706408697,-5,986,2422,30
5706853345,5706853365,20,587,2658,30
5707096694,5707096690,-4,959,2438,30
5708896940,5708896954,14,996,3281,30
5709768478,5709768481,3,2128,1511,30
5722202971,5722202966,-5,1208,2863,30
5727034931,5727034926,-5,1083,2742,30
5727491337,5727491358,21,919,2873,30
5735158798,5735158794,-4,1328,2454,30
5737016563,5737016557,-6,447,1172,30
5738210158,5738210154,-4,831,2737,30
5741004759,5741004754,-5,1092,2325,30
5742226186,5742226207,21,564,1518,30
5743768926,5743768923,-3,1195,2949,30
5745555903,5745555897,-6,1196,2418,30
5749233170,5749233166,-4,484,2325,30
5751501032,5751501027,-5,1434,3258,30
5758881875,5758881873,-2,990,3043,30
5765504703,5765504700,-3,641,2082,30
5773908495,5773908488,-7,2184,7988,30
5779256496,5779256491,-5,777,2765,30
5780350976,5780350972,-4,796,2390,30
5782894127,5782894123,-4,1590,3732,30
5796023610,5796023604,-6,1352,3764,30
5798353825,5798353818,-7,784,1656,30
5801069403,5801069398,-5,1070,3522,30
5802430133,5802430130,-3,1264,2658,30
5805816118,5805816121,3,1699,1699,30
5814825928,5814825921,-7,768,2763,30
5817082351,5817082347,-4,1089,3801,30
5818922326,5818922322,-4,951,3251,30
5821072469,5821072465,-4,866,3676,30
5831693511,5831693506,-5,1073,3528,30
5831868931,5831868925,-6,1090,2919,30
5834013439,5834013422,-17,1707,790,30
5836398231,5836398222,-9,1128,2435,30
5842295945,5842295941,-4,1255,3318,30
5848974098,5848974094,-4,834,1439,30
5855788110,5855788105,-5,1169,2536,30
5856474303,5856474298,-5,1394,3530,30
5857601991,5857601987,-4,1285,2755,30
5858778234,5858778229,-5,847,2859,30
5859311630,5859311631,1,760,1360,30
5859622775,5859622770,-5,1068,3245,30
5859664268,5859664281,13,844,2791,30
5860987562,5860987557,-5,1405,3795,30
5863567684,5863567678,-6,1455,4405,30
5864162387,5864162383,-4,1478,4249,30
5865099877,5865099873,-4,1322,3471,30
5865404028,5865404041,13,1313,2789,30
5870812258,5870812254,-4,941,2473,30
5873327248,5873327244,-4,898,2455,30
5873832815,5873832815,0,1188,1686,30
5876334959,5876334955,-4,1043,2278,30
5878984350,5878984347,-3,1372,1678,30
5881788467,5881788462,-5,1044,3531,30
5884010718,5884010713,-5,1007,4309,30
5887833170,5887833165,-5,844,3338,30
5892223205,5892223201,-4,689,2056,30
5908256868,5908256864,-4,903,2367,30
5908371071,5908371066,-5,1050,3685,30
5914400940,5914400936,-4,729,2418,30
5924782568,5924782562,-6,1560,3992,30
5932535043,5932535038,-5,937,2397,30
5943968199,5943968193,-6,1416,3309,30
5945588367,5945588362,-5,712,2734,30
5947249750,5947249751,1,1263,1360,30
5953536907,5953536909,2,2162,2560,30
5954725207,5954725202,-5,661,2771,30
5958182778,5958182773,-5,885,1402,30
5958579832,5958579851,19,325,941,30
5958913069,5958913062,-7,905,2769,30
5960187922,5960187910,-12,153,973,30
5961432510,5961432506,-4,752,2201,30
5964317686,5964317685,-1,830,2609,30
5965457664,5965457661,-3,1073,2177,30
5969571721,5969571716,-5,788,1987,30
5969782418,5969782410,-8,1214,4162,30
5972787610,5972787607,-3,1128,1933,30
5973296526,5973296522,-4,389,1271,30
5983895825,5983895820,-5,952,2535,30
5984055757,5984055751,-6,1005,3006,30
5986322018,5986322011,-7,1038,1533,30
5991995530,5991995527,-3,535,1519,30
5995134805,5995134801,-4,819,2790,30
6002244994,6002244989,-5,1097,3128,30
6011397079,6011397073,-6,751,2301,30
6012230682,6012230678,-4,667,2489,30
6016085507,6016085503,-4,432,1199,30
6018610914,6018610910,-4,1389,4125,30
6020054809,6020054803,-6,1170,2862,30
6022357758,6022357754,-4,747,1614,30
6022407456,6022407477,21,1014,3233,30
6022646798,6022646792,-6,753,2977,30
6025396550,6025396544,-6,994,1906,30
6026579266,6026579262,-4,1003,3028,30
6026979515,6026979527,12,275,1270,30
6028913198,6028913190,-8,1473,6857,30
6029877927,6029877922,-5,963,2683,30
6031461499,6031461494,-5,1188,4029,30
6034409663,6034409658,-5,1537,5210,30
6034857908,6034857925,17,1338,3208,30
6042138288,6042138284,-4,1396,2983,30
6043142607,6043142606,-1,914,1885,30
6044907344,6044907339,-5,1001,2085,30
6046719354,6046719359,5,4546,2004,30
6048352519,6048352515,-4,1397,3072,30
6052122382,6052122377,-5,1106,2725,30
6055926695,6055926691,-4,1046,2391,30
6057156802,6057156798,-4,1129,2253,30
6058931921,6058931915,-6,1209,2141,30
6062127840,6062127834,-6,889,2505,30
6068364701,6068364696,-5,1585,3535,30
6074046477,6074046474,-3,1186,2254,30
6077672056,6077672074,18,1290,2802,30
6082067386,6082067382,-4,782,2787,30
6084674713,6084674709,-4,934,3051,30
6085040270,6085040269,-1,1173,1637,30
6085521499,6085521494,-5,865,3657,30
6099904266,6099904268,2,1921,2209,30
6101458471,6101458468,-3,1229,2981,30
6102757950,6102757947,-3,1177,2737,30
6110822710,6110822714,4,17426,43430,30
6112235984,6112235980,-4,1090,3402,30
6113192007,6113192001,-6,1286,3049,30
6119790439,6119790431,-8,992,3835,30
6122065691,6122065688,-3,767,2805,30
6129405111,6129405108,-3,704,982,30
6130559919,6130559917,-2,1015,2466,30
6132889142,6132889148,6,1416,6916,30
6134676667,6134676661,-6,786,2281,30
6134857166,6134857162,-4,835,3120,30
6140803731,6140803725,-6,1032,3678,30
6141188931,6141188925,-6,1069,2319,30
6148428581,6148428575,-6,867,2622,30
6155614484,6155614481,-3,909,1659,30
6155720826,6155720831,5,2489,1517,30
6155874185,6155874181,-4,1022,2889,30
6159072865,6159072861,-4,1108,1970,30
6160464495,6160464488,-7,740,4120,30
6160535652,6160535666,14,426,1707,30
6160883259,6160883278,19,1052,2712,30
6160929841,6160929859,18,15860,47044,30
6161504671,6161504666,-5,1020,2845,30
6162456626,6162456645,19,639,1636,30
6167488889,6167488883,-6,586,1812,30
6167781427,6167781442,15,334,2620,30
6169020926,6169020919,-7,856,3058,30
6175230585,6175230586,1,1875,2016,30
6176638355,6176638355,0,1165,1723,30
6178753186,6178753182,-4,899,2456,30
6179273768,6179273759,-9,1142,3138,30
6186646026,6186646026,0,1102,1437,30
6189206534,6189206531,-3,1355,2414,30
6189668370,6189668364,-6,1101,2658,30
6192421106,6192421101,-5,982,3434,30
6194773298,6194773284,-14,43930,99596,30
6197205044,6197205040,-4,800,2370,30
6198067082,6198067075,-7,1164,1751,30
6199188148,6199188145,-3,1319,3101,30
6208361051,6208361045,-6,1103,2876,30
6212574715,6212574713,-2,1169,3352,30
6213297281,6213297283,2,2417,1872,30
6215033406,6215033400,-6,894,4156,30
6222799137,6222799132,-5,1192,4507,30
6224911789,6224911784,-5,1474,3972,30
6228727654,6228727650,-4,1264,4125,30
6229009081,6229009074,-7,817,1718,30
6230772770,6230772766,-4,762,2516,30
6233634055,6233634051,-4,1001,2640,30
6235781987,6235781983,-4,1435,2926,30
6236105048,6236105030,-18,144,500,30
6236838346,6236838341,-5,869,1846,30
6238421881,6238421882,1,1236,1961,30
6239513559,6239513555,-4,1084,2329,30
6249158664,6249158669,5,2443,1883,30
6251569090,6251569110,20,556,1391,30
6253511824,6253511820,-4,2258,6385,30
6254580094,6254580100,6,10464,28808,30
6262432694,6262432690,-4,1116,3639,30
6262863368,6262863390,22,139,863,30
6267930287,6267930306,19,1435,3149,30
6269880289,6269880291,2,2155,2253,30
6271864794,6271864791,-3,1364,2498,30
6273417283,6273417278,-5,1036,3064,30
6275331433,6275331428,-5,697,2615,30
6275490962,6275490941,-21,146,1318,30
6277245530,6277245529,-1,920,1917,30
6278646899,6278646898,-1,1095,1998,30
6281904657,6281904658,1,1091,1296,30
6282284725,6282284718,-7,929,2085,30
6284619880,6284619875,-5,759,2631,30
6286773008,6286773019,11,14358,24571,30
6288600530,6288600530,0,1162,1471,30
6290855442,6290855437,-5,1145,3017,30
6290998554,6290998554,0,107,841,30
6295030823,6295030819,-4,794,2876,30
6296731423,6296731418,-5,938,3355,30
6296913794,6296913807,13,809,4219,30
6302592557,6302592550,-7,796,1914,30
6305947394,6305947389,-5,780,2572,30
6310446908,6310446925,17,378,2216,30
6311950110,6311950103,-7,1053,3570,30
6314257277,6314257270,-7,910,3086,30
6318302841,6318302838,-3,1456,2870,30
6323813831,6323813827,-4,1195,3142,30
6323843755,6323843738,-17,2013,4089,30
6326721270,6326721265,-5,903,2382,30
6328679170,6328679168,-2,1852,2851,30
6332607475,6332607475,0,882,1079,30
6336459254,6336459260,6,2392,1719,30
6337412815,6337412812,-3,1658,3201,30
6340061115,6340061110,-5,1115,4050,30
6342282303,6342282301,-2,1108,3519,30
6344100314,6344100306,-8,861,3255,30
6348079569,6348079565,-4,1291,3369,30
6349567282,6349567278,-4,1073,2564,30
6352042487,6352042482,-5,1096,3784,30
6357775531,6357775525,-6,513,775,30
6358615569,6358615576,7,19089,55276,30
6365707349,6365707346,-3,1360,2086,30
6368442607,6368442601,-6,608,2698,30
6374325874,6374325869,-5,1243,2489,30
6378333751,6378333747,-4,1112,3789,30
6379288662,6379288662,0,1116,1628,30
6391059259,6391059254,-5,729,3075,30
6392767046,6392767042,-4,1047,3030,30
6394616354,6394616349,-5,1240,2665,30
6404842312,6404842308,-4,1363,3569,30
6409768234,6409768231,-3,1220,3350,30
6412685037,6412685033,-4,1168,3205,30
6413899934,6413899932,-2,1066,2060,30
6414720082,6414720103,21,757,1986,30
6415078857,6415078858,1,3380,3082,30
6420260447,6420260442,-5,1047,3453,30
6422454502,6422454496,-6,1149,3112,30
6428463770,6428463766,-4,1482,3454,30
6429445371,6429445368,-3,847,1952,30
6431405264,6431405259,-5,1225,2974,30
6431701021,6431701017,-4,1371,2894,30
6436558505,6436558498,-7,711,2813,30
6440428998,6440429003,5,2160,1007,30
6445170402,6445170396,-6,943,2695,30
6449788066,6449788062,-4,1214,3190,30
6452044990,6452044986,-4,1135,3447,30
6453638647,6453638645,-2,1404,2252,30
6455406903,6455406899,-4,986,2585,30
6457730417,6457730413,-4,916,2996,30
6458023457,6458023459,2,4187,3575,30
6461763985,6461763978,-7,1010,2829,30
6470704286,6470704285,-1,1864,2852,30
6479884447,6479884455,8,4849,32176,30
6481081978,6481081972,-6,1255,4160,30
6485511725,6485511720,-5,1054,2711,30
6488280103,6488280098,-5,1159,3615,30
6488366760,6488366782,22,254,1287,30
6490853821,6490853817,-4,1216,2469,30
6492373355,6492373349,-6,464,1975,30
6493002963,6493002959,-4,1068,1809,30
6495069368,6495069383,15,1003,1581,30
6497536343,6497536339,-4,997,2720,30
6497919320,6497919314,-6,1153,2967,30
6505775713,6505775713,0,1312,1997,30
6512744798,6512744781,-17,1412,400,30
6523339622,6523339615,-7,1213,3118,30
6524121309,6524121305,-4,938,2966,30
6537983887,6537983882,-5,920,2944,30
6538771459,6538771454,-5,1109,2636,30
6543043711,6543043707,-4,1262,2621,30
6544385533,6544385528,-5,1563,2648,30
6545330226,6545330222,-4,940,2001,30
6551222786,6551222778,-8,799,5336,30
6552854856,6552854842,-14,46,865,30
6555583214,6555583211,-3,1416,3246,30
6557953305,6557953301,-4,1179,1841,30
6561314568,6561314566,-2,20915,10903,30
6567306874,6567306879,5,4726,1851,30
6569837063,6569837061,-2,1135,2220,30
6573773329,6573773327,-2,754,1944,30
6576921526,6576921522,-4,1691,4157,30
6578980983,6578980980,-3,966,2865,30
6581690599,6581690593,-6,1313,3619,30
6582246936,6582246959,23,390,791,30
6583636767,6583636762,-5,1116,3044,30
6592225743,6592225749,6,3108,1515,30
6600080667,6600080662,-5,926,3056,30
6601370742,6601370739,-3,1308,2509,30
6611347215,6611347210,-5,688,2701,30
6616060639,6616060642,3,3819,3110,30
6618896601,6618896602,1,20995,9543,30
6623839538,6623839533,-5,1018,3100,30
6624767570,6624767566,-4,1461,3510,30
6625751174,6625751171,-3,1077,2055,30
6625811240,6625811258,18,618,1031,30
6626856827,6626856822,-5,908,2949,30
6627386274,6627386270,-4,1138,1804,30
6635534227,6635534221,-6,995,3760,30
6640397011,6640397007,-4,1452,3319,30
6640562501,6640562497,-4,1054,2503,30
6640843178,6640843193,15,558,2470,30
6648867450,6648867443,-7,1421,2964,30
6656813569,6656813565,-4,793,2123,30
6660123019,6660123014,-5,1256,3468,30
6660434104,6660434098,-6,726,2830,30
6662198725,6662198724,-1,2147,3287,30
6667060107,6667060102,-5,1487,4137,30
6674867565,6674867565,0,2157,3021,30
6677578534,6677578528,-6,857,2913,30
6678770136,6678770127,-9,1352,3613,30
6680154282,6680154278,-4,1090,2773,30
6680553537,6680553529,-8,850,3561,30
6681178492,6681178487,-5,1298,4513,30
6685714644,6685714642,-2,1420,2170,30
6687211918,6687211914,-4,1312,3166,30
6690132815,6690132810,-5,855,3351,30
6690444547,6690444567,20,261,1701,30
6690911519,6690911514,-5,1200,2824,30
6693896749,6693896754,5,3044,1308,30
6695525782,6695525787,5,1995,1398,30
6701249815,6701249809,-6,716,2591,30
6701585416,6701585412,-4,1653,2650,30
6706706561,6706706554,-7,956,4131,30
6711052997,6711052993,-4,1185,2725,30
6712669731,6712669726,-5,1007,3219,30
6712906548,6712906541,-7,1202,2558,30
6716742776,6716742782,6,4047,2011,30
6730217708,6730217704,-4,452,2719,30
6730478175,6730478177,2,45088,47027,30
6732936743,6732936739,-4,1094,1826,30
6734468906,6734468902,-4,1223,2229,30
6739451413,6739451420,7,1088,1078,30
6739842786,6739842781,-5,985,3724,30
6742776003,6742775999,-4,1068,2744,30
6748126546,6748126559,13,12058,47542,30
6754554972,6754554969,-3,1173,2577,30
6754799177,6754799177,0,1249,4047,30
6757296531,6757296527,-4,1107,2766,30
6761825214,6761825208,-6,1386,3990,30
6762471025,6762471017,-8,190,1074,30
6770936663,6770936670,7,2524,1128,30
6774183947,6774183942,-5,1146,2805,30
6775134418,6775134434,16,690,2792,30
6777641552,6777641547,-5,2019,4651,30
6778373762,6778373758,-4,1284,2594,30
6781783559,6781783552,-7,1040,2797,30
6783807072,6783807077,5,2395,1119,30
6784040790,6784040788,-2,1188,2298,30
6784412507,6784412507,0,773,1069,30
6784590010,6784590019,9,93,917,30
6786000658,6786000662,4,1549,1235,30
6786180019,6786180017,-2,1165,2198,30
6787797003,6787796997,-6,777,5238,30
6788496397,6788496391,-6,1247,3157,30
6792320872,6792320867,-5,1427,3107,30
6800959225,6800959227,2,1721,1981,30
6801972826,6801972822,-4,1400,2863,30
6802427265,6802427285,20,612,3367,30
6809197074,6809197068,-6,1124,2407,30
6810135195,6810135190,-5,717,1538,30
6813037647,6813037643,-4,1002,2160,30
6813243632,6813243617,-15,174,1191,30
6814162018,6814162017,-1,1868,3429,30
6815444163,6815444161,-2,1195,2479,30
6817191381,6817191377,-4,612,1478,30
6820388339,6820388334,-5,743,2931,30
6824597839,6824597834,-5,846,1589,30
6825037072,6825037065,-7,1201,7582,30
6825556445,6825556440,-5,855,2943,30
6828399545,6828399540,-5,920,2417,30
6829985074,6829985070,-4,1098,2926,30
6830522266,6830522251,-15,738,2539,30
6831727517,6831727512,-5,584,2151,30
6836038082,6836038081,-1,14004,19378,30
6839071498,6839071492,-6,1186,3920,30
6840198253,6840198247,-6,1212,4031,30
6849150732,6849150729,-3,1109,2226,30
6857124693,6857124687,-6,813,2467,30
6864946698,6864946693,-5,1070,2503,30
6866345631,6866345643,12,380,1182,30
6868680369,6868680366,-3,1142,3911,30
6869547120,6869547117,-3,1179,3288,30
6869809776,6869809799,23,1228,1725,30
6871296567,6871296571,4,2150,1402,30
6872537885,6872537880,-5,1506,3535,30
6875528878,6875528866,-12,990,2715,30
6876013987,6876013993,6,162,1028,30
6881150276,6881150271,-5,516,1513,30
6883771314,6883771309,-5,934,3516,30
6887474143,6887474137,-6,919,3880,30
6892756331,6892756326,-5,1189,3249,30
6894051502,6894051498,-4,1210,3060,30
6896061391,6896061388,-3,1210,3301,30
6903590835,6903590830,-5,1233,3947,30
6905633739,6905633746,7,4087,1933,30
6911047730,6911047725,-5,416,1624,30
6914243619,6914243614,-5,697,2196,30
6916472914,6916472911,-3,1008,2769,30
6917094211,6917094208,-3,686,1434,30
6921503436,6921503431,-5,889,3371,30
6921701264,6921701257,-7,839,2217,30
6922146069,6922146065,-4,1092,2064,30
6924421395,6924421415,20,1458,2409,30
6925290370,6925290366,-4,1003,1911,30
6930776374,6930776376,2,2654,1733,30
6939067725,6939067720,-5,1177,2561,30
6939201955,6939201973,18,1043,2625,30
6950708560,6950708553,-7,831,4201,30
6955202759,6955202753,-6,916,2696,30
6958009054,6958009047,-7,1127,3943,30
6961945824,6961945838,14,110,847,30
6963036995,6963036990,-5,1138,3921,30
6972749984,6972749978,-6,1459,6199,30
6973178360,6973178378,18,1031,3053,30
6974914838,6974914833,-5,748,2419,30
6979853675,6979853670,-5,1208,2165,30
6988513539,6988513534,-5,1343,4396,30
6990436289,6990436294,5,1477,1313,30
6993349786,6993349781,-5,1297,2925,30
6993873498,6993873494,-4,814,2939,30
6994130372,6994130387,15,1145,1486,30
6998795770,6998795765,-5,1417,3336,30
6999963406,6999963401,-5,997,2489,30
7003378982,7003378977,-5,1001,3210,30
7003546092,7003546111,19,853,2885,30
7003796847,7003796846,-1,745,2508,30
7024780502,7024780499,-3,971,1927,30
7024806681,7024806694,13,360,1194,30
7025150521,7025150524,3,31926,19501,30
7028143924,7028143930,6,13646,5903,30
7028991818,7028991813,-5,1037,3785,30
7032830893,7032830889,-4,1079,2920,30
7033012617,7033012622,5,3614,2155,30
7038428517,7038428513,-4,1212,3331,30
7041473656,7041473653,-3,24002,12568,30
7041710982,7041710978,-4,1416,3020,30
7043525019,7043525002,-17,546,2255,30
7044232513,7044232528,15,696,2592,30
7045316557,7045316553,-4,742,2815,30
7047252995,7047252988,-7,1227,4260,30
7047423211,7047423207,-4,891,2545,30
7047802868,7047802863,-5,1319,2825,30
7047939330,7047939324,-6,919,3192,30
7049674927,7049674924,-3,1006,2229,30
7068366636,7068366631,-5,1193,3797,30
7069060706,7069060702,-4,936,3512,30
7069507970,7069507968,-2,1015,3314,30
7075122656,7075122650,-6,558,2950,30
7075421147,7075421165,18,980,2635,30
7075463136,7075463126,-10,354,1004,30
7083842594,7083842589,-5,823,3284,30
7085064359,7085064354,-5,1267,3173,30
7095181278,7095181274,-4,969,2212,30
7110155307,7110155291,-16,1497,428,30
7111634842,7111634839,-3,871,2357,30
7115992238,7115992234,-4,725,2062,30
7119616381,7119616375,-6,1005,2545,30
7119843770,7119843766,-4,873,2848,30
7124016482,7124016478,-4,1190,3519,30
7129622862,7129622857,-5,1265,3242,30
7133639195,7133639191,-4,1283,2775,30
7138135894,7138135890,-4,1067,3649,30
7140207638,7140207634,-4,1049,2319,30
7142185638,7142185634,-4,1279,3677,30
7147843506,7147843498,-8,981,3990,30
7147960651,7147960633,-18,188,1701,30
7148088603,7148088598,-5,807,4249,30
7152718769,7152718764,-5,1060,2010,30
7160422535,7160422531,-4,611,2180,30
7160488541,7160488535,-6,997,2915,30
7160531329,7160531345,16,854,3280,30
7163769638,7163769634,-4,1286,3791,30
7164992898,7164992892,-6,882,2433,30
7166479554,7166479546,-8,927,2185,30
7166560802,7166560799,-3,1347,2378,30
7171398242,7171398238,-4,806,2514,30
7174527500,7174527495,-5,1432,3887,30
7181986863,7181986882,19,817,2951,30
7183207466,7183207464,-2,1065,2227,30
7184361987,7184362006,19,663,2219,30
7185474148,7185474143,-5,1550,3191,30
7192878123,7192878121,-2,774,1876,30
7194536155,7194536150,-5,784,2575,30
7201805742,7201805738,-4,1329,3059,30
7203573283,7203573278,-5,1012,2875,30
7208747211,7208747206,-5,1109,2996,30
7211209949,7211209945,-4,1001,2354,30
7214969615,7214969611,-4,1242,4147,30
7215148586,7215148578,-8,980,5179,30
7221869882,7221869879,-3,738,2323,30
7223117577,7223117574,-3,953,2382,30
7223157359,7223157353,-6,1269,3759,30
7224209299,7224209318,19,922,3016,30
7230538630,7230538627,-3,718,1960,30
7232749154,7232749150,-4,1381,2957,30
7236364366,7236364358,-8,2431,10632,30
7238444785,7238444781,-4,896,2079,30
7238497035,7238497054,19,271,847,30
7244125950,7244125946,-4,1097,2282,30
7245541265,7245541261,-4,1309,2809,30
7248592857,7248592852,-5,1054,3733,30
7254163267,7254163262,-5,768,3146,30
7254398361,7254398357,-4,1536,2338,30
7256853957,7256853954,-3,921,2297,30
7257447042,7257447039,-3,1019,3262,30
7265136945,7265136940,-5,822,3950,30
7265618508,7265618523,15,266,944,30
7265863105,7265863102,-3,833,2233,30
7266465395,7266465390,-5,1016,2390,30
7267962682,7267962702,20,984,2317,30
7270355519,7270355514,-5,816,2655,30
7271710661,7271710658,-3,1201,3187,30
7272089289,7272089285,-4,970,1586,30
7272580405,7272580401,-4,1097,3486,30
7272937751,7272937755,4,2302,1602,30
7275757038,7275757032,-6,592,2078,30
7276322233,7276322219,-14,988,1408,30
7277234751,7277234748,-3,744,2058,30
7278642812,7278642812,0,2026,3631,30
7280250281,7280250278,-3,1348,2490,30
7283035729,7283035726,-3,763,2137,30
7286343527,7286343542,15,10313,47295,30
7289022437,7289022433,-4,1178,1952,30
7294605293,7294605288,-5,1470,3776,30
7298289671,7298289667,-4,847,2521,30
7298496953,7298496975,22,749,3008,30
7300246627,7300246621,-6,1695,3211,30
7300418565,7300418561,-4,885,2840,30
7302885631,7302885626,-5,997,3364,30
7306840155,7306840154,-1,806,1457,30
7307341056,7307341050,-6,1274,2672,30
7308581991,7308581987,-4,1134,2383,30
7310802899,7310802894,-5,691,2418,30
7312528731,7312528726,-5,1198,2733,30
7315938369,7315938363,-6,1144,2524,30
7318265279,7318265275,-4,1270,3279,30
7320054727,7320054723,-4,1272,3769,30
7325094282,7325094274,-8,1073,5370,30
7329532559,7329532555,-4,1109,2776,30
7330342149,7330342149,0,2156,2772,30
7330857150,7330857146,-4,1400,3617,30
7331473613,7331473617,4,2076,2008,30
7333059617,7333059612,-5,1334,3892,30
7335376649,7335376643,-6,1202,3268,30
7335629494,7335629493,-1,1161,1903,30
7335725739,7335725734,-5,1132,2659,30
7336157524,7336157535,11,307,1170,30
7336904606,7336904602,-4,899,2333,30
7342125265,7342125262,-3,799,3208,30
7347815176,7347815172,-4,857,2939,30
7355177763,7355177758,-5,1451,3220,30
7360195890,7360195886,-4,952,2376,30
7362110891,7362110888,-3,1424,2884,30
7362882296,7362882297,1,1860,2485,30
7363497849,7363497845,-4,1036,3519,30
7365475431,7365475425,-6,1091,3248,30
7368858462,7368858458,-4,892,2543,30
7376109342,7376109345,3,1629,1569,30
7376951997,7376951993,-4,1208,2683,30
7377083153,7377083162,9,198,1302,30
7383620246,7383620243,-3,1092,2046,30
7386723143,7386723139,-4,1083,3381,30
7387317854,7387317849,-5,1345,2355,30
7397307463,7397307460,-3,1312,2016,30
7398236058,7398236062,4,2117,2167,30
7400480433,7400480426,-7,532,2340,30
7400639577,7400639563,-14,874,2697,30
7401032882,7401032880,-2,865,2236,30
7403029647,7403029642,-5,1112,3037,30
7405118612,7405118618,6,17,882,30
7411118949,7411118945,-4,798,2498,30
7412951275,7412951269,-6,945,2380,30
7418878723,7418878720,-3,1124,1995,30
7421076865,7421076867,2,939,1632,30
7424472715,7424472709,-6,1065,3547,30
7426657281,7426657287,6,3423,1697,30
7427521611,7427521609,-2,495,1821,30
7430422547,7430422542,-5,565,2000,30
7435317969,7435317964,-5,1013,2773,30
7435367816,7435367836,20,739,1116,30
7436494982,7436494977,-5,1209,3589,30
7439813874,7439813870,-4,803,2439,30
7441209657,7441209653,-4,897,3603,30
7442023285,7442023282,-3,1117,2204,30
7446862627,7446862621,-6,776,2957,30
7450030725,7450030722,-3,1051,1962,30
7454611174,7454611169,-5,845,2796,30
7468140859,7468140852,-7,556,1851,30
7473706427,7473706422,-5,825,1774,30
7477852139,7477852133,-6,1272,3564,30
7487464103,7487464108,5,1575,1367,30
7488025552,7488025548,-4,842,1849,30
7490299074,7490299079,5,14370,6039,30
7491565257,7491565254,-3,1527,4038,30
7493376634,7493376634,0,1107,2333,30
7502633829,7502633823,-6,1127,3762,30
7502826475,7502826469,-6,988,3112,30
7507779141,7507779136,-5,572,2666,30
7508320802,7508320802,0,1218,2378,30
7509068685,7509068681,-4,1112,1618,30
7512109900,7512109896,-4,1683,3151,30
7513264946,7513264954,8,183,795,30
7513693238,7513693237,-1,918,2153,30
7518973687,7518973682,-5,957,2891,30
7520459002,7520458995,-7,1162,3778,30
7523752005,7523751999,-6,1204,2838,30
7528271987,7528271982,-5,935,3190,30
7528656659,7528656653,-6,1549,3337,30
7529683621,7529683618,-3,1006,2585,30
7534222917,7534222910,-7,1451,3648,30
7538060891,7538060887,-4,947,2040,30
7538096579,7538096566,-13,1414,3113,30
7544328159,7544328153,-6,939,3037,30
7544527808,7544527826,18,1144,3523,30
7547024805,7547024801,-4,997,3554,30
7554514354,7554514351,-3,996,2800,30
7554812986,7554813003,17,574,2755,30
7554892394,7554892389,-5,919,3516,30
7555564555,7555564550,-5,1129,4216,30
7561536166,7561536161,-5,1104,2924,30
7561929882,7561929903,21,164,945,30
7563028105,7563028105,0,2367,3554,30
7563418613,7563418610,-3,980,2386,30
7570913724,7570913721,-3,1013,2518,30
7575663804,7575663803,-1,310,2120,30
7576706576,7576706595,19,766,3174,30
7577133534,7577133529,-5,1879,4298,30
7577240590,7577240586,-4,1050,3356,30
7583810094,7583810089,-5,1403,4492,30
7584400791,7584400784,-7,1338,4794,30
7587003870,7587003866,-4,1307,3135,30
7587716158,7587716166,8,6918,2815,30
7589869041,7589869037,-4,800,2883,30
7608141504,7608141501,-3,835,2644,30
7608940739,7608940745,6,5667,3076,30
7611506545,7611506533,-12,299,1142,30
7612165203,7612165200,-3,1137,3504,30
7618992678,7618992673,-5,1063,2616,30
7619241530,7619241542,12,296,1388,30
7622683793,7622683790,-3,717,2889,30
7624077736,7624077750,14,1522,3454,30
7624284984,7624284978,-6,995,2571,30
7628878398,7628878393,-5,1137,2502,30
7629423735,7629423729,-6,975,2808,30
7631244837,7631244843,6,3623,1827,30
7632249753,7632249747,-6,1671,3493,30
7637848500,7637848497,-3,1406,2651,30
7643331920,7643331937,17,959,2869,30
7643650538,7643650545,7,177,757,30
7649311166,7649311160,-6,902,2851,30
7651060339,7651060336,-3,713,2156,30
7652100582,7652100584,2,1177,1763,30
7652771337,7652771331,-6,760,1841,30
7660115808,7660115804,-4,1725,4366,30
7665058759,7665058753,-6,1111,3342,30
7665204602,7665204595,-7,235,855,30
7667352686,7667352682,-4,801,2412,30
7676045557,7676045553,-4,1251,2011,30
7676191448,7676191458,10,134,716,30
7686619187,7686619182,-5,988,3026,30
7689834922,7689834942,20,889,2271,30
7690441441,7690441434,-7,1363,3772,30
7690949517,7690949513,-4,1149,2891,30
7693073490,7693073488,-2,805,1838,30
7705530122,7705530118,-4,1483,2134,30
7707853975,7707853973,-2,950,2277,30
7707931561,7707931579,18,807,2305,30
7711440050,7711440049,-1,405,1436,30
7711707433,7711707418,-15,960,2434,30
7718809070,7718809066,-4,1239,3679,30
7722875006,7722875003,-3,1315,3684,30
7725984991,7725984995,4,3373,1643,30
7727724241,7727724234,-7,1077,2445,30
7729334476,7729334488,12,266,1261,30
7732720427,7732720423,-4,1231,2244,30
7737184831,7737184828,-3,1484,3948,30
7737474422,7737474418,-4,830,3425,30
7739122179,7739122174,-5,966,2926,30
7739882813,7739882808,-5,1795,2473,30
7740076314,7740076309,-5,1077,2180,30
7745889327,7745889322,-5,1374,4038,30
7748240911,7748240906,-5,849,2834,30
7751126213,7751126209,-4,1113,2303,30
7751314104,7751314123,19,500,1705,30
7753140570,7753140568,-2,1231,2118,30
7753652825,7753652819,-6,737,2661,30
7756859037,7756859034,-3,918,2713,30
7762354146,7762354152,6,3347,1505,30
7764249663,7764249659,-4,852,2493,30
7768194213,7768194207,-6,620,1644,30
7774135012,7774135018,6,4348,2426,30
7774919199,7774919194,-5,1053,1948,30
7779614727,7779614723,-4,825,1751,30
7781693374,7781693374,0,2495,2087,30
7787411826,7787411821,-5,536,1375,30
7789882849,7789882844,-5,978,4332,30
7789936298,7789936293,-5,789,2393,30
7793130621,7793130616,-5,1042,3177,30
7796152769,7796152767,-2,1432,4599,30
7799877307,7799877302,-5,967,2372,30
7801627465,7801627459,-6,1273,3016,30
7809401564,7809401559,-5,728,1753,30
7809739025,7809739011,-14,164,897,30
7810675242,7810675259,17,669,1465,30
7815341985,7815341981,-4,1381,3230,30
7820423260,7820423256,-4,1523,3570,30
7826747798,7826747795,-3,1000,2443,30
7829294947,7829294944,-3,550,1787,30
7836382578,7836382573,-5,963,3356,30
7839802262,7839802257,-5,896,2156,30
7839992073,7839992062,-11,79,753,30
7847336406,7847336401,-5,783,3398,30
7848495325,7848495321,-4,1277,3339,30
7855632574,7855632570,-4,1158,2381,30
7855879218,7855879215,-3,1378,2215,30
7859743926,7859743925,-1,667,1479,30
7860671033,7860671036,3,731,1497,30
7866172291,7866172290,-1,1567,3073,30
7872085758,7872085754,-4,1192,2019,30
7874767814,7874767810,-4,1168,2391,30
7874829199,7874829193,-6,848,2757,30
7875317586,7875317593,7,3909,2192,30
7875678761,7875678756,-5,1023,3079,30
7876332061,7876332054,-7,498,2427,30
7881696058,7881696055,-3,928,2145,30
7882094781,7882094780,-1,599,1854,30
7889392719,7889392717,-2,1117,2882,30
7890637574,7890637571,-3,1665,3321,30
7892029266,7892029263,-3,1142,2772,30
7892202956,7892202968,12,132,880,30
7902588619,7902588619,0,2057,3453,30
7911938210,7911938211,1,1304,1738,30
7912171760,7912171754,-6,1064,2341,30
7912427981,7912427977,-4,1322,3036,30
7915190130,7915190126,-4,780,1775,30
7922842751,7922842750,-1,820,2194,30
7924604633,7924604626,-7,1220,4116,30
7926891366,7926891358,-8,1035,2837,30
7929785714,7929785711,-3,463,1963,30
7932002355,7932002349,-6,1339,2934,30
7934291105,7934291098,-7,1521,3258,30
7934912203,7934912182,-21,283,765,30
7935524281,7935524278,-3,962,2398,30
7939777422,7939777418,-4,1058,2789,30
7941888577,7941888569,-8,1239,4235,30
7942400424,7942400419,-5,1129,2715,30
7943292973,7943292969,-4,881,2755,30
7943470354,7943470334,-20,1139,4163,30
7944901259,7944901254,-5,771,3646,30
7947046718,7947046717,-1,1232,3673,30
7953169073,7953169068,-5,665,2185,30
7961846635,7961846631,-4,1151,4065,30
7962826223,7962826218,-5,968,3232,30
7964820223,7964820219,-4,1143,2919,30
7965121586,7965121605,19,229,1347,30
7981403741,7981403736,-5,1023,2177,30
7982751197,7982751218,21,1096,1820,30
7987231809,7987231805,-4,783,1966,30
7991176320,7991176341,21,1886,8121,30
7991506625,7991506622,-3,1387,2048,30
7998294299,7998294294,-5,1279,2450,30
8001436692,8001436697,5,239,981,30
8012795882,8012795877,-5,1217,3487,30
8013510433,8013510446,13,240,742,30
8017174751,8017174745,-6,946,3017,30
8017209328,8017209350,22,774,3045,30
8021319966,8021319962,-4,825,2719,30
8022527811,8022527797,-14,1459,3332,30
8022855866,8022855880,14,311,1331,30
8024010003,8024010006,3,1631,1662,30
8024282513,8024282510,-3,1134,3176,30
8024385082,8024385081,-1,2060,3812,30
8031652847,8031652842,-5,752,3352,30
8032847289,8032847281,-8,1115,10160,30
8034971905,8034971901,-4,995,2917,30
8036560766,8036560762,-4,1201,4035,30
8038263299,8038263294,-5,1114,2403,30
8038292620,8038292624,4,590,72,30
8040838951,8040838949,-2,1005,2209,30
8041184258,8041184255,-3,1154,2101,30
8051426131,8051426125,-6,1233,3741,30
8057022428,8057022423,-5,1166,3314,30
8063364325,8063364318,-7,1806,9837,30
8068507004,8068507000,-4,1839,5920,30
8068644512,8068644507,-5,901,2205,30
8072117859,8072117854,-5,1154,2262,30
8073599594,8073599589,-5,1021,2595,30
8083252271,8083252267,-4,759,2598,30
8083523258,8083523246,-12,49402,59235,30
8085235575,8085235571,-4,1034,2682,30
8087461362,8087461357,-5,950,2763,30
8093076390,8093076386,-4,598,3284,30
8097180578,8097180575,-3,1024,1762,30
8100279867,8100279864,-3,1476,3205,30
8101127237,8101127234,-3,1319,3257,30
8105758527,8105758523,-4,1353,2160,30
8108725782,8108725792,10,11524,44545,30
8114252788,8114252785,-3,914,4016,30
8115968328,8115968322,-6,896,2272,30
8117386511,8117386506,-5,837,1947,30
8117799376,8117799367,-9,1062,2250,30
8118677567,8118677564,-3,1092,2191,30
8132143853,8132143855,2,1852,1607,30
8134350055,8134350052,-3,871,2523,30
8136605742,8136605737,-5,985,2441,30
8137402731,8137402727,-4,1135,3065,30
8137479600,8137479617,17,288,1118,30
8143071939,8143071934,-5,875,2461,30
8145262175,8145262186,11,11430,43756,30
8148300175,8148300169,-6,655,3094,30
8149419264,8149419285,21,1050,2766,30
8158393114,8158393110,-4,1245,3293,30
8172298390,8172298388,-2,769,3045,30
8177003758,8177003754,-4,874,3569,30
8183659739,8183659734,-5,1269,2783,30
8188091687,8188091686,-1,1096,2795,30
8192173541,8192173539,-2,643,1494,30
8195202882,8195202884,2,14254,11665,30
8195604351,8195604343,-8,1094,3073,30
8196449849,8196449844,-5,1291,3322,30
8196690407,8196690405,-2,1186,2694,30
8198178157,8198178153,-4,1485,2777,30
8199299163,8199299158,-5,893,2938,30
8200815936,8200815918,-18,194,1140,30
8201997771,8201997767,-4,748,2718,30
8203436254,8203436247,-7,748,4280,30
8208082634,8208082633,-1,945,2363,30
8208234418,8208234418,0,42853,44694,30
8211032711,8211032705,-6,1300,3152,30
8217324642,8217324636,-6,1072,4851,30
8217618666,8217618655,-11,28,1053,30
8218623535,8218623533,-2,970,2248,30
8218997545,8218997541,-4,1036,2265,30
8220153805,8220153801,-4,1190,2701,30
8221394535,8221394531,-4,2580,5678,30
8226064355,8226064350,-5,1054,3305,30
8229726339,8229726333,-6,1272,2935,30
8231347714,8231347713,-1,1362,2384,30
8232872011,8232872006,-5,1042,2959,30
8237815497,8237815493,-4,1047,3419,30
8239101450,8239101446,-4,767,2103,30
8239731105,8239731104,-1,1099,1950,30
8241401337,8241401326,-11,271,760,30
8241981946,8241981943,-3,273,1097,30
8247182077,8247182073,-4,905,1916,30
8249858907,8249858914,7,2659,915,30
8250981296,8250981291,-5,1302,2331,30
8254557330,8254557329,-1,983,1619,30
8260106718,8260106714,-4,1310,2973,30
8261202530,8261202547,17,785,3648,30
8262079281,8262079275,-6,970,3892,30
8269326373,8269326372,-1,4912,7887,30
8272742390,8272742393,3,1744,1981,30
8281616378,8281616372,-6,1907,6529,30
8282634197,8282634194,-3,1315,3149,30
8283581561,8283581555,-6,386,1002,30
8287226419,8287226413,-6,968,2649,30
8290588203,8290588198,-5,1102,2923,30
8291054550,8291054546,-4,955,2832,30
8292224905,8292224900,-5,1522,2839,30
8295725205,8295725202,-3,1260,2021,30
8296202839,8296202834,-5,921,2279,30
8297963529,8297963522,-7,1298,4492,30
8306378959,8306378954,-5,793,2674,30
8313151516,8313151514,-2,1589,2178,30
8317262251,8317262247,-4,832,2904,30
8317824643,8317824638,-5,1047,3678,30
8318893506,8318893500,-6,1164,3299,30
8321500858,8321500855,-3,796,2264,30
8325782566,8325782562,-4,1101,1571,30
8333304123,8333304117,-6,1098,2608,30
8333783669,8333783664,-5,1183,3480,30
8338209682,8338209679,-3,1261,1698,30
8339577562,8339577556,-6,1223,3382,30
8340071066,8340071083,17,465,1229,30
8344087406,8344087403,-3,992,2605,30
8355473739,8355473735,-4,811,2664,30
8355619651,8355619645,-6,726,2908,30
8355699596,8355699607,11,170,1148,30
8358672746,8358672741,-5,915,2573,30
8365300555,8365300559,4,1563,1292,30
8366055022,8366055015,-7,1121,2433,30
8368512467,8368512463,-4,1253,2809,30
8370198490,8370198486,-4,668,2900,30
8371833010,8371833027,17,158,901,30
8374966110,8374966108,-2,913,2100,30
8380488619,8380488615,-4,1278,4141,30
8385546323,8385546318,-5,1088,2662,30
8386201207,8386201204,-3,1089,1959,30
8387116807,8387116804,-3,1071,3349,30
8393715137,8393715132,-5,1080,2984,30
8397516043,8397516038,-5,1213,2394,30
8400368291,8400368286,-5,863,1614,30
8401454038,8401454030,-8,1035,4182,30
8421307745,8421307742,-3,875,2990,30
8421423153,8421423159,6,1603,950,30
8422048154,8422048153,-1,1329,3161,30
8424443239,8424443235,-4,1215,3810,30
8426227257,8426227262,5,4294,22880,30
8428304542,8428304538,-4,934,3080,30
8429739505,8429739500,-5,958,3114,30
8430490951,8430490955,4,2436,1587,30
8435607253,8435607249,-4,1027,3231,30
8436664455,8436664457,2,2037,1501,30
8437247775,8437247785,10,5940,49146,30
8441735115,8441735111,-4,1524,3816,30
8445782260,8445782255,-5,1164,2740,30
8445982102,8445982098,-4,894,2561,30
8450407825,8450407826,1,2116,1968,30
8452173905,8452173899,-6,843,3462,30
8452753697,8452753690,-7,1732,4955,30
8456564346,8456564348,2,16616,15747,30
8461158966,8461158961,-5,1155,3243,30
8461396921,8461396937,16,472,1399,30
8461741797,8461741792,-5,1586,2964,30
8463549795,8463549789,-6,1213,2924,30
8467116167,8467116161,-6,851,2896,30
8467224713,8467224731,18,459,1419,30
8469777622,8469777618,-4,980,1533,30
8470822648,8470822645,-3,1090,2553,30
8475633025,8475633020,-5,1115,2088,30
8475814440,8475814453,13,192,1315,30
8483746642,8483746638,-4,1270,3039,30
8488285340,8488285337,-3,952,1775,30
8491966227,8491966218,-9,33749,13359,30
8495843928,8495843929,1,2731,3115,30
8498918676,8498918673,-3,1217,2148,30
8506612226,8506612221,-5,925,2315,30
8510688795,8510688790,-5,1452,3279,30
8516726935,8516726931,-4,1036,2481,30
8519846761,8519846763,2,824,866,30
8520530017,8520530011,-6,998,3347,30
8524447531,8524447525,-6,1077,3005,30
8528414346,8528414345,-1,39259,28249,30
8532968855,8532968850,-5,1130,3580,30
8537299614,8537299630,16,416,1146,30
8538675954,8538675950,-4,1052,2500,30
8539745089,8539745084,-5,978,3161,30
8542254646,8542254646,0,1154,2105,30
8547356734,8547356727,-7,1185,3243,30
8548709889,8548709885,-4,848,2596,30
8553320410,8553320406,-4,1090,3510,30
8553502803,8553502801,-2,718,2614,30
8560203030,8560203027,-3,1156,2483,30
8570782890,8570782887,-3,1230,2136,30
8578697445,8578697439,-6,1464,6216,30
8579926099,8579926092,-7,1127,2570,30
8581006542,8581006538,-4,1249,3549,30
8583279664,8583279658,-6,1708,4606,30
8584809519,8584809515,-4,1257,3690,30
8592387757,8592387753,-4,1546,4087,30
8593725088,8593725082,-6,1316,3344,30
8597255045,8597255049,4,2289,1353,30
8600988603,8600988598,-5,945,2668,30
8601022420,8601022434,14,1003,2115,30
8602215104,8602215098,-6,780,3139,30
8605836015,8605836013,-2,1115,2294,30
8606612871,8606612866,-5,944,2755,30
8609683955,8609683949,-6,890,2907,30
8613740474,8613740470,-4,906,1898,30
8614510419,8614510433,14,784,3272,30
8615577393,8615577390,-3,1515,3722,30
8616474731,8616474734,3,1604,1688,30
8618244158,8618244153,-5,1666,3948,30
8621898224,8621898218,-6,1232,3075,30
8624644296,8624644291,-5,1266,4065,30
8625369954,8625369949,-5,1090,3111,30
8625472073,8625472095,22,906,2788,30
8625579362,8625579363,1,1275,1977,30
8627504141,8627504137,-4,617,2465,30
8635113741,8635113746,5,2139,1267,30
8640798006,8640798001,-5,819,2044,30
8644705410,8644705406,-4,777,2406,30
8646807922,8646807917,-5,1136,2455,30
8650784158,8650784154,-4,1257,4022,30
8659000871,8659000865,-6,1372,3744,30
8660746774,8660746767,-7,1259,5284,30
8667687115,8667687113,-2,1039,2075,30
8672288737,8672288735,-2,1996,3480,30
8677777731,8677777726,-5,1395,2602,30
8678381064,8678381057,-7,156,613,30
8678731053,8678731047,-6,1358,3558,30
8682461965,8682461958,-7,1135,3487,30
8684004698,8684004704,6,1904,1079,30
8686184223,8686184218,-5,786,3304,30
8690005096,8690005092,-4,1131,2926,30
8691292780,8691292776,-4,788,2352,30
8692241758,8692241758,0,701,1106,30
8694458731,8694458735,4,3230,2737,30
8698333719,8698333717,-2,1019,3044,30
8701276137,8701276135,-2,967,1830,30
8706816683,8706816678,-5,1094,3878,30
8710183585,8710183583,-2,1313,2088,30
8710553498,8710553494,-4,643,1742,30
8710881652,8710881666,14,400,724,30
8711203317,8711203314,-3,955,2296,30
8718631886,8718631883,-3,1369,3519,30
8722421876,8722421882,6,14332,4977,30
8722915891,8722915886,-5,720,2359,30
8725216465,8725216461,-4,899,2742,30
8725661118,8725661114,-4,1062,2669,30
8728669318,8728669313,-5,1287,2897,30
8729134412,8729134399,-13,206,702,30
8732551326,8732551322,-4,1026,2214,30
8742982655,8742982650,-5,1089,4183,30
8744973565,8744973562,-3,982,2231,30
8745442304,8745442298,-6,1165,3217,30
8745943343,8745943337,-6,820,1411,30
8751909588,8751909583,-5,476,2305,30
8752272443,8752272437,-6,1118,2734,30
8754430183,8754430178,-5,1220,3171,30
8755739951,8755739954,3,818,985,30
8756052576,8756052594,18,506,1968,30
8757781655,8757781651,-4,1805,3070,30
8760412016,8760412013,-3,1187,3945,30
8763192409,8763192426,17,387,1712,30
8766671026,8766671022,-4,800,1662,30
8772479046,8772479041,-5,1258,2942,30
8777239382,8777239379,-3,979,2486,30
8779401166,8779401162,-4,1089,2813,30
8782048146,8782048142,-4,727,1874,30
8788507440,8788507435,-5,1281,3027,30
8793446031,8793446026,-5,1161,2812,30
8794433874,8794433870,-4,840,2891,30
8794714190,8794714186,-4,1024,3820,30
8798047803,8798047798,-5,921,1902,30
8807859300,8807859302,2,1586,1298,30
8808907222,8808907217,-5,931,2687,30
8811065994,8811065990,-4,1127,3614,30
8821856216,8821856208,-8,1469,2679,30
8826459704,8826459700,-4,2477,5278,30
8829569506,8829569499,-7,760,2717,30
8833988769,8833988765,-4,1285,2050,30
8835749986,8835749982,-4,1225,2970,30
8842575266,8842575248,-18,1074,634,30
8844676544,8844676540,-4,1064,1917,30
8848125646,8848125651,5,3254,1327,30
8851263472,8851263468,-4,1280,3212,30
8851626269,8851626265,-4,1365,3225,30
8853854459,8853854454,-5,1709,1800,30
8856629747,8856629743,-4,966,2446,30
8859358591,8859358586,-5,1228,4418,30
8860413698,8860413705,7,290,879,30
8866367980,8866367975,-5,1249,3062,30
8868207452,8868207447,-5,1033,3387,30
8871688147,8871688143,-4,724,2266,30
8874702973,8874702971,-2,1296,2128,30
8875061380,8875061397,17,267,1490,30
8879986490,8879986486,-4,1016,1710,30
8880558540,8880558536,-4,977,2538,30
8881213860,8881213872,12,644,3082,30
8886600009,8886600013,4,2399,1373,30
8896319831,8896319852,21,1063,2702,30
8898677118,8898677114,-4,980,2499,30
8898970658,8898970674,16,292,1334,30
8913201134,8913201129,-5,966,2262,30
8924344941,8924344941,0,1389,2012,30
8927892262,8927892254,-8,1386,5199,30
8930993785,8930993801,16,698,2643,30
8931561036,8931561036,0,2566,3568,30
8935612931,8935612927,-4,948,2489,30
8936309483,8936309501,18,306,923,30
8946109131,8946109127,-4,1106,2171,30
8949449021,8949449016,-5,1376,3523,30
8951670094,8951670092,-2,722,2338,30
8953713780,8953713775,-5,1446,3941,30
8955249816,8955249813,-3,1055,2725,30
8956658884,8956658897,13,964,2540,30
8960924618,8960924615,-3,569,1668,30
8964561794,8964561790,-4,1239,3065,30
8967037856,8967037842,-14,927,2791,30
8970520109,8970520104,-5,1337,3166,30
8970675745,8970675739,-6,1099,3642,30
8973470826,8973470821,-5,676,3042,30
8973841036,8973841033,-3,1190,2573,30
8975414675,8975414673,-2,1048,1997,30
8977349195,8977349192,-3,1125,1693,30
8980644539,8980644533,-6,1146,3741,30
8983509885,8983509881,-4,1020,2673,30
8987776668,8987776665,-3,1321,4096,30
8992101438,8992101434,-4,1073,3391,30
9001394779,9001394781,2,1205,1468,30
9002988195,9002988197,2,1599,1662,30
9005237295,9005237290,-5,1298,2739,30
9005524231,9005524228,-3,844,2403,30
9014327026,9014327034,8,6732,2655,30
9014626601,9014626596,-5,960,3005,30
9023237955,9023237952,-3,1122,2032,30
9023629105,9023629102,-3,2453,6965,30
9023955032,9023955031,-1,1773,2118,30
9030602999,9030602995,-4,1194,3577,30
9032426665,9032426660,-5,1188,2666,30
9038893639,9038893634,-5,737,3176,30
9041482118,9041482114,-4,1133,2788,30
9044735606,9044735601,-5,1023,3182,30
9044848810,9044848829,19,332,1325,30
9045372994,9045372987,-7,1268,5022,30
9048887982,9048887978,-4,599,2505,30
9055550575,9055550570,-5,1105,3110,30
9061186401,9061186401,0,1491,1830,30
9068271066,9068271052,-14,812,517,30
9068324276,9068324294,18,385,1500,30
9079336992,9079336987,-5,1054,3173,30
9081383104,9081383099,-5,1067,2145,30
9086956023,9086956018,-5,835,3113,30
9087360411,9087360411,0,2670,3256,30
9090130529,9090130526,-3,996,2708,30
9090461573,9090461569,-4,1632,3479,30
9090677842,9090677846,4,1660,895,30
9092432347,9092432341,-6,635,2416,30
9093659973,9093659970,-3,1049,2904,30
9093755035,9093755035,0,360,1165,30
9096525426,9096525422,-4,1175,3059,30
9098866794,9098866793,-1,38627,33192,30
9104785587,9104785582,-5,897,2126,30
9104882907,9104882897,-10,1142,3140,30
9106353575,9106353570,-5,766,1842,30
9109586067,9109586062,-5,982,3433,30
9114377780,9114377775,-5,1255,3574,30
9118699655,9118699659,4,1322,1058,30
9120891600,9120891603,3,7853,18326,30
9127277431,9127277426,-5,797,2513,30
9127539757,9127539755,-2,1261,2565,30
9127753329,9127753346,17,224,885,30
9129978826,9129978821,-5,1199,2904,30
9131967831,9131967826,-5,1182,2865,30
9140016739,9140016743,4,1075,943,30
9150187346,9150187340,-6,1213,2813,30
9158949087,9158949083,-4,1205,2416,30
9160478210,9160478192,-18,789,298,30
9161120479,9161120475,-4,638,2624,30
9170704205,9170704197,-8,1149,5863,30
9175339799,9175339793,-6,1300,2577,30
9175820518,9175820515,-3,899,2693,30
9180935187,9180935182,-5,1010,3232,30
9180979365,9180979360,-5,1350,3321,30
9187292757,9187292753,-4,1413,3386,30
9190292015,9190292013,-2,1091,2481,30
9190997285,9190997280,-5,889,2937,30
9192828991,9192828986,-5,703,2546,30
9193259779,9193259774,-5,1128,2864,30
9209997890,9209997886,-4,958,2514,30
9214886186,9214886182,-4,1146,2802,30
9229907264,9229907259,-5,1221,4088,30
9229964470,9229964477,7,3940,1443,30
9231591882,9231591880,-2,3364,14523,30
9232645885,9232645881,-4,1003,2399,30
9239276813,9239276810,-3,1277,2527,30
9240756303,9240756298,-5,910,3135,30
9242752409,9242752414,5,1172,1184,30
9244878967,9244878961,-6,767,2987,30
9248439309,9248439306,-3,1097,2663,30
9257865640,9257865638,-2,1658,2916,30
9261684983,9261684979,-4,954,2722,30
9262217226,9262217241,15,1045,3082,30
9262484288,9262484269,-19,1184,2812,30
9262911723,9262911721,-2,925,3008,30
9270385460,9270385455,-5,1313,4383,30
9270514642,9270514638,-4,900,2684,30
9272880994,9272880989,-5,966,2526,30
9275939032,9275939029,-3,1035,2242,30
9279479664,9279479661,-3,923,1625,30
9281802634,9281802629,-5,1066,3010,30
9281970801,9281970797,-4,942,1810,30
9286298458,9286298453,-5,1082,2709,30
9291049559,9291049557,-2,776,1988,30
9291087450,9291087466,16,885,2916,30
9291388642,9291388656,14,572,1489,30
9296703503,9296703497,-6,597,2038,30
9298087627,9298087622,-5,938,4270,30
9306886759,9306886753,-6,1071,2453,30
9315464195,9315464190,-5,1235,3211,30
9315818157,9315818152,-5,1921,3396,30
9316876383,9316876381,-2,1310,2843,30
9323189342,9323189337,-5,1026,4079,30
9325815342,9325815347,5,2921,1490,30
9327786051,9327786047,-4,1310,3546,30
9337054890,9337054899,9,12750,32770,30
9342657718,9342657713,-5,883,2321,30
9346256422,9346256418,-4,1130,2782,30
9361907866,9361907862,-4,1175,2396,30
9365005658,9365005653,-5,1005,3794,30
9367426913,9367426910,-3,931,2919,30
9368115522,9368115528,6,5625,2032,30
9368828304,9368828299,-5,1268,4202,30
9372114013,9372114010,-3,941,1917,30
9384510943,9384510939,-4,1037,1807,30
9393309722,9393309718,-4,814,2761,30
9395153632,9395153628,-4,1194,3176,30
9399594969,9399594965,-4,1144,3619,30
9400269153,9400269170,17,245,1240,30
9400828514,9400828522,8,6713,2605,30
9400980378,9400980373,-5,867,2527,30
9401273393,9401273409,16,619,2135,30
9406217197,9406217190,-7,885,3691,30
9407062047,9407062045,-2,501,753,30
9408223330,9408223335,5,1535,457,30
9412554775,9412554774,-1,894,1487,30
9412803385,9412803406,21,775,1641,30
9415975642,9415975648,6,5496,2354,30
9417455270,9417455266,-4,494,2371,30
9419688199,9419688194,-5,1073,2772,30
9424644587,9424644584,-3,1136,3069,30
9425987438,9425987435,-3,984,2574,30
9428302321,9428302316,-5,917,3531,30
9430566919,9430566916,-3,1061,3076,30
9434364257,9434364253,-4,1134,3426,30
9434989993,9434989989,-4,1199,3166,30
9438763833,9438763829,-4,971,3686,30
9440786783,9440786778,-5,704,2156,30
9444667400,9444667394,-6,1062,3364,30
9445710343,9445710338,-5,978,3160,30
9446341755,9446341750,-5,840,2533,30
9450337470,9450337463,-7,1384,9310,30
9450907666,9450907663,-3,1158,2173,30
9451665642,9451665638,-4,1256,3846,30
9455683031,9455683028,-3,741,1920,30
9466108348,9466108354,6,5381,3005,30
9477010474,9477010479,5,3930,2172,30
9478049915,9478049910,-5,1277,2418,30
9479082242,9479082240,-2,683,2228,30
9481548357,9481548354,-3,794,2972,30
9482258767,9482258761,-6,1088,2341,30
9482694255,9482694250,-5,937,3034,30
9484375909,9484375904,-5,1435,3413,30
9487217483,9487217479,-4,686,2357,30
9493906906,9493906911,5,4904,2374,30
9495363874,9495363869,-5,1248,3466,30
9496704474,9496704470,-4,576,2262,30
9497634911,9497634918,7,1600,873,30
9500597010,9500597005,-5,1146,3078,30
9518009547,9518009542,-5,911,2047,30
9518109467,9518109464,-3,708,2465,30
9519289579,9519289582,3,3060,2976,30
9519479326,9519479321,-5,1079,1978,30
9519857593,9519857591,-2,1035,1757,30
9529735832,9529735819,-13,90,854,30
9534074554,9534074550,-4,1073,2291,30
9541605743,9541605738,-5,1191,3640,30
9546832663,9546832658,-5,1500,3079,30
9547709762,9547709760,-2,1051,2701,30
9553158610,9553158606,-4,1096,3029,30
9559549867,9559549862,-5,899,3944,30
9564835489,9564835486,-3,957,1847,30
9565932710,9565932706,-4,1372,2869,30
9568853843,9568853837,-6,904,3066,30
9572094983,9572094977,-6,1222,3226,30
9575044015,9575044013,-2,798,2320,30
9576624929,9576624926,-3,543,1444,30
9581327310,9581327307,-3,754,1450,30
9582173811,9582173831,20,886,2122,30
9585887605,9585887601,-4,1257,2443,30
9589062583,9589062579,-4,1232,3367,30
9589793286,9589793283,-3,1114,3076,30
9590155723,9590155719,-4,1154,3544,30
9592599994,9592599990,-4,848,2534,30
9596340497,9596340490,-7,1062,3215,30
9600111382,9600111378,-4,965,3174,30
9601103916,9601103913,-3,2196,4970,30
9601770687,9601770683,-4,1492,3032,30
9603711083,9603711080,-3,1118,2561,30
9607193662,9607193654,-8,1096,2816,30
9607713376,9607713362,-14,871,2539,30
9608572651,9608572646,-5,715,2892,30
9608690187,9608690182,-5,1254,3037,30
9608879677,9608879673,-4,1386,3819,30
9614050905,9614050898,-7,808,2267,30
9615194283,9615194279,-4,1117,2711,30
9615238904,9615238901,-3,1079,2207,30
9624525766,9624525762,-4,882,2207,30
9625190540,9625190533,-7,1319,4307,30
9626313549,9626313545,-4,1157,2447,30
9629413315,9629413309,-6,897,2518,30
9630017044,9630017038,-6,1206,4230,30
9630341940,9630341937,-3,794,2335,30
9630944070,9630944079,9,1099,1190,30
9632618125,9632618121,-4,918,1412,30
9647284109,9647284105,-4,1183,3916,30
9652511255,9652511251,-4,652,2019,30
9652898923,9652898909,-14,30,780,30
9655628636,9655628630,-6,2143,6907,30
9660704962,9660704957,-5,1142,2997,30
9661465973,9661465991,18,15105,29657,30
9666386933,9666386928,-5,955,1432,30
9671272662,9671272657,-5,854,2313,30
9671525738,9671525754,16,901,2359,30
9674152666,9674152661,-5,758,2092,30
9677527026,9677527022,-4,930,2319,30
9678150751,9678150748,-3,1111,3199,30
9678385254,9678385249,-5,1494,3586,30
9679053819,9679053814,-5,1930,3039,30
9679601413,9679601408,-5,1263,3415,30
9681512231,9681512226,-5,1098,2630,30
9691579575,9691579571,-4,923,2444,30
9692430773,9692430770,-3,695,2998,30
9695257418,9695257414,-4,957,2522,30
9696844932,9696844930,-2,1361,2598,30
9701136148,9701136142,-6,1452,3043,30
9704362960,9704362955,-5,647,1767,30
9706254007,9706254003,-4,1262,2554,30
9710431914,9710431910,-4,758,1930,30
9711830954,9711830953,-1,872,2710,30
9722444803,9722444797,-6,1215,3554,30
9728025143,9728025138,-5,1622,3578,30
9738402053,9738402059,6,3640,1425,30
9738615079,9738615074,-5,900,2834,30
9739208954,9739208950,-4,882,3475,30
9739676422,9739676421,-1,826,1445,30
9741152035,9741152030,-5,846,2364,30
9743600228,9743600222,-6,716,2993,30
9746418773,9746418769,-4,1319,3347,30
9746926538,9746926531,-7,1002,3040,30
9749131944,9749131950,6,3177,1121,30
9751365366,9751365358,-8,1470,6964,30
9752707443,9752707438,-5,1097,3391,30
9754945934,9754945930,-4,1046,3203,30
9755848834,9755848826,-8,1052,2237,30
9756060722,9756060726,4,42081,25582,30
9758195131,9758195128,-3,1090,2296,30
9767568526,9767568521,-5,603,2597,30
9769355125,9769355119,-6,908,2071,30
9769453823,9769453819,-4,667,2022,30
9778859244,9778859240,-4,1225,1949,30
9785494401,9785494396,-5,939,2705,30
9786352035,9786352029,-6,797,2956,30
9787404786,9787404782,-4,896,1848,30
9788171085,9788171082,-3,480,2398,30
9788990797,9788990793,-4,721,2561,30
9795816027,9795816019,-8,842,2873,30
9797124692,9797124687,-5,1273,2576,30
9799377073,9799377070,-3,604,1400,30
9800143224,9800143219,-5,1025,2640,30
9804279719,9804279714,-5,830,2303,30
9807218314,9807218310,-4,1280,2942,30
9812457219,9812457214,-5,789,2796,30
9818054527,9818054521,-6,842,3745,30
9822064993,9822064990,-3,1264,4895,30
9824439689,9824439685,-4,576,1306,30
9824492130,9824492151,21,1103,2333,30
9824725014,9824725010,-4,1276,3742,30
9827582985,9827582978,-7,1099,3170,30
9827792188,9827792194,6,1433,1017,30
9829463557,9829463574,17,667,2139,30
9837574088,9837574083,-5,818,3533,30
9842576882,9842576885,3,1700,1738,30
9848425670,9848425665,-5,1135,2531,30
9849213277,9849213277,0,1290,1874,30
9849288609,9849288630,21,1050,3081,30
9855903274,9855903270,-4,852,2539,30
9856747471,9856747465,-6,998,3036,30
9860087558,9860087554,-4,1141,3120,30
9862801725,9862801722,-3,1257,2741,30
9864610806,9864610809,3,6547,15454,30
9866390654,9866390653,-1,741,1923,30
9868345391,9868345406,15,677,2628,30
9869999498,9869999490,-8,958,6910,30
9876906375,9876906375,0,1229,1862,30
9878556954,9878556948,-6,1153,3379,30
9879932325,9879932322,-3,976,3554,30
9881677775,9881677769,-6,873,2236,30
9882604338,9882604347,9,13,1082,30
9882785739,9882785742,3,250,1187,30
9883914334,9883914330,-4,694,3068,30
9884372690,9884372688,-2,1114,3581,30
9884553490,9884553486,-4,878,1907,30
9885432645,9885432638,-7,1321,3766,30
9886454283,9886454279,-4,1551,3076,30
9889618814,9889618809,-5,1144,3838,30
9891483346,9891483365,19,1012,2425,30
9899026086,9899026082,-4,1038,1740,30
9903338365,9903338346,-19,233,860,30
9918920733,9918920730,-3,1250,4055,30
9920261318,9920261311,-7,806,2810,30
9920812161,9920812157,-4,1295,3577,30
9922412602,9922412602,0,1262,1973,30
9923395144,9923395144,0,1973,2159,30
9923934519,9923934513,-6,1224,3104,30
9926945818,9926945812,-6,901,3095,30
9927822167,9927822159,-8,794,2562,30
9928074139,9928074125,-14,808,1684,30
9930113600,9930113595,-5,952,2767,30
9933632126,9933632122,-4,1109,2214,30
9943649231,9943649229,-2,573,1717,30
9949241690,9949241686,-4,1103,3084,30
9956312807,9956312804,-3,911,1696,30
9957349027,9957349022,-5,1238,2786,30
9958087458,9958087453,-5,801,2439,30
9959945464,9959945483,19,971,2823,30
9964087666,9964087662,-4,939,3043,30
9964209965,9964209958,-7,727,2491,30
9965595711,9965595705,-6,715,2702,30
9970897271,9970897273,2,1483,1056,30
9971225343,9971225345,2,1454,1917,30
9974593799,9974593794,-5,977,2401,30
9975188027,9975188022,-5,1057,3428,30
9980303635,9980303630,-5,1195,3233,30
9982588358,9982588357,-1,1241,2121,30
9986604027,9986604021,-6,907,2092,30
9991813973,9991813966,-7,1024,5900,30
9994630954,9994630947,-7,675,2104,30
9995374686,9995374683,-3,1001,3346,30
9995602322,9995602329,7,178,1119,30
9997038761,9997038758,-3,974,3317,30
10006669943,10006669962,19,1698,1543,30
10008283295,10008283290,-5,880,3134,30
10010020741,10010020737,-4,657,2329,30
10010070488,10010070509,21,1163,3572,30
10014315983,10014315977,-6,1405,3513,30
10014405479,10014405474,-5,1402,3519,30
10015290586,10015290582,-4,640,1976,30
10015890909,10015890901,-8,1312,4446,30
10018100441,10018100433,-8,1227,3645,30
10024528323,10024528318,-5,1393,3726,30
10026593207,10026593202,-5,727,3520,30
10027109370,10027109380,10,286,1470,30
10028073557,10028073554,-3,1547,2432,30
10028267498,10028267495,-3,906,2891,30
10032125647,10032125643,-4,826,2120,30
10032691108,10032691122,14,348,1816,30
10033007459,10033007453,-6,945,3044,30
10035222263,10035222258,-5,2400,7271,30
10035425294,10035425289,-5,953,2778,30
10055959051,10055959047,-4,947,3367,30
10065908641,10065908635,-6,1388,4261,30
10066545689,10066545685,-4,1106,3567,30
10069132438,10069132438,0,1108,1808,30
10077893292,10077893286,-6,1225,3280,30
10081371054,10081371050,-4,863,3136,30
10081720850,10081720831,-19,114,1123,30
10084765291,10084765285,-6,1404,3289,30
10090307614,10090307611,-3,1627,3723,30
10093849208,10093849203,-5,1515,3571,30
10095125233,10095125229,-4,1023,2878,30
10095155647,10095155645,-2,881,2326,30
10095860688,10095860710,22,644,1780,30
10097380184,10097380182,-2,915,2064,30
10099189444,10099189439,-5,911,3181,30
10101213343,10101213348,5,2396,1216,30
10101592061,10101592057,-4,949,2604,30
10103763950,10103763946,-4,843,3806,30
10104724822,10104724817,-5,1051,4241,30
10107029310,10107029310,0,10347,11174,30
10111948602,10111948597,-5,1474,4046,30
10113984392,10113984396,4,2088,1307,30
10117144447,10117144441,-6,1022,3264,30
10119942602,10119942598,-4,729,2072,30
10121094481,10121094475,-6,1100,2801,30
10127497285,10127497278,-7,1390,5072,30
10127711384,10127711367,-17,139,1104,30
10127902750,10127902747,-3,1079,2459,30
10135180150,10135180143,-7,775,2622,30
10148319646,10148319641,-5,1123,3491,30
10152944259,10152944254,-5,1009,3048,30
10157393131,10157393125,-6,712,3014,30
10159082759,10159082754,-5,444,3069,30
10165860607,10165860602,-5,692,1833,30
10170838390,10170838385,-5,1174,4204,30
10171039722,10171039703,-19,1112,2347,30
10172174571,10172174566,-5,960,2906,30
10174599278,10174599274,-4,1015,3221,30
10176239053,10176239052,-1,1406,1816,30
10178290007,10178290002,-5,991,3082,30
10181122119,10181122117,-2,1068,2635,30
10192442074,10192442070,-4,940,2973,30
10192538482,10192538503,21,76,884,30
10193179362,10193179358,-4,1282,2347,30
10193628250,10193628249,-1,4656,8337,30
10203558827,10203558822,-5,1217,2711,30
10211058033,10211058029,-4,1257,2821,30
10217772962,10217772957,-5,746,2081,30
10220863133,10220863134,1,2433,2210,30
10234308598,10234308594,-4,1255,4094,30
10236526658,10236526654,-4,979,1854,30
10237457233,10237457230,-3,3239,4557,30
10242808078,10242808060,-18,1180,457,30
10246021935,10246021933,-2,1150,1828,30
10247444578,10247444599,21,683,2686,30
10254702978,10254702973,-5,1254,2954,30
10262104752,10262104749,-3,1036,2686,30
10262332541,10262332544,3,1738,1865,30
10266717564,10266717567,3,2589,1556,30
10269866659,10269866654,-5,1865,4850,30
10272207639,10272207634,-5,1146,3536,30
10274796001,10274795998,-3,1368,2690,30
10278377546,10278377541,-5,1120,2587,30
10282940848,10282940845,-3,870,3250,30
10287536570,10287536566,-4,824,2788,30
10290782303,10290782297,-6,540,2745,30
10290830897,10290830919,22,745,1691,30
10290995040,10290995034,-6,1427,4055,30
10291879238,10291879232,-6,1070,3632,30
10295854913,10295854908,-5,1208,3610,30
10296129659,10296129654,-5,842,2298,30
10296471356,10296471352,-4,1506,3187,30
10296764529,10296764525,-4,1417,2648,30
10297370974,10297370970,-4,849,3190,30
10301039130,10301039130,0,37822,46715,30
10307208482,10307208478,-4,819,2070,30
10311006341,10311006337,-4,829,3201,30
10317013279,10317013276,-3,712,2148,30
10320184301,10320184297,-4,919,2499,30
10322134710,10322134714,4,1049,882,30
10323279231,10323279226,-5,1226,3297,30
10326818897,10326818892,-5,920,2635,30
10331703281,10331703278,-3,1058,2983,30
10335395095,10335395101,6,3722,1396,30
10338825106,10338825102,-4,894,2201,30
10342551653,10342551659,6,7354,2349,30
10342589800,10342589796,-4,1216,2438,30
10352374850,10352374845,-5,1568,3459,30
10353628650,10353628650,0,7762,11196,30
10355193210,10355193217,7,1251,497,30
10359828311,10359828309,-2,1151,3015,30
10365310006,10365310002,-4,1009,3124,30
10366233275,10366233274,-1,876,1798,30
10368646909,10368646906,-3,1146,3074,30
10370529633,10370529646,13,202,793,30
10382003982,10382003977,-5,1052,2375,30
10382202058,10382202051,-7,1191,6652,30
10387019269,10387019262,-7,1231,4030,30
10394084073,10394084069,-4,1047,2103,30
10394952777,10394952782,5,3477,2163,30
10395857522,10395857522,0,1429,1922,30
10401252776,10401252771,-5,1253,3591,30
10405006702,10405006699,-3,944,2597,30
10405489349,10405489345,-4,2381,5566,30
10406491296,10406491291,-5,1042,2315,30
10407154490,10407154493,3,1432,1421,30
10407486208,10407486205,-3,1193,2545,30
10408095308,10408095305,-3,523,1983,30
10409315054,10409315050,-4,1279,2455,30
10410010591,10410010586,-5,628,2961,30
10411801652,10411801648,-4,907,3193,30
10412652233,10412652222,-11,304,1006,30
10417393203,10417393206,3,1425,1637,30
10418297672,10418297666,-6,921,3161,30
10423430134,10423430126,-8,1134,4798,30
10427686601,10427686621,20,1034,2279,30
10428907039,10428907035,-4,1033,2449,30
10429038241,10429038254,13,164,990,30
10429813258,10429813254,-4,1062,2613,30
10433947858,10433947852,-6,644,2711,30
10439494558,10439494553,-5,1078,3119,30
10448396047,10448396042,-5,812,3232,30
10450854779,10450854773,-6,823,2291,30
10453333123,10453333119,-4,918,2895,30
10455126530,10455126527,-3,948,3235,30
10455199849,10455199829,-20,113,849,30
10457515451,10457515445,-6,943,3144,30
10460508224,10460508220,-4,1019,2547,30
10460588917,10460588913,-4,529,1711,30
10461710027,10461710046,19,757,2500,30
10468483222,10468483225,3,1331,1510,30
10469070551,10469070546,-5,1403,3617,30
10470289443,10470289438,-5,1110,3304,30
10478932650,10478932646,-4,1488,2250,30
10486172565,10486172562,-3,869,2632,30
10486851439,10486851435,-4,1009,2681,30
10488498614,10488498610,-4,950,2629,30
10491555498,10491555491,-7,1319,3858,30
10498723598,10498723593,-5,812,3806,30
10499843881,10499843878,-3,1185,4118,30
10503633375,10503633369,-6,1347,3971,30
10504292678,10504292674,-4,878,2707,30
10504455659,10504455643,-16,158,1187,30
10506516309,10506516313,4,2009,1231,30
10509826591,10509826587,-4,766,3001,30
10510563073,10510563082,9,220,626,30
10512244179,10512244175,-4,936,3336,30
10512356042,10512356027,-15,361,1125,30
10514324259,10514324274,15,571,2053,30
10517964967,10517964962,-5,879,2775,30
10522186357,10522186362,5,1320,1119,30
10522710594,10522710590,-4,1076,2898,30
10523312742,10523312738,-4,1051,1925,30
10529277660,10529277655,-5,1297,3171,30
10532961793,10532961801,8,2035,900,30
10537376239,10537376234,-5,730,1586,30
10549513421,10549513417,-4,1382,3186,30
10550180976,10550180986,10,294,803,30
10552566702,10552566698,-4,1366,3103,30
10553181618,10553181611,-7,984,2864,30
10553630183,10553630175,-8,578,2666,30
10557658886,10557658887,1,1467,1810,30
10561805137,10561805137,0,1989,2404,30
10568155714,10568155710,-4,1037,2875,30
10569135224,10569135231,7,167,1628,30
10574805739,10574805733,-6,1119,4077,30
10576045210,10576045207,-3,780,2984,30
10578351024,10578351019,-5,1194,2792,30
10581149199,10581149194,-5,741,2770,30
10581471251,10581471269,18,228,877,30
10589015295,10589015292,-3,835,2715,30
10592813446,10592813442,-4,754,3592,30
10597550567,10597550565,-2,900,3207,30
10602388742,10602388738,-4,553,2707,30
10603239218,10603239215,-3,775,1943,30
10612215368,10612215365,-3,989,2106,30
10615173558,10615173554,-4,1149,2988,30
10620718935,10620718932,-3,943,2445,30
10627587493,10627587489,-4,1606,4001,30
10631235277,10631235271,-6,727,3174,30
10636738865,10636738861,-4,1472,3223,30
10639330891,10639330886,-5,4456,10747,30
10643530610,10643530607,-3,700,1753,30
10645381826,10645381823,-3,1415,3102,30
10650703351,10650703345,-6,802,2153,30
10663300403,10663300399,-4,1065,2463,30
10666057690,10666057690,0,956,2376,30
10667176314,10667176311,-3,817,2171,30
10673554056,10673554050,-6,1028,2844,30
10677667999,10677667992,-7,899,1953,30
10679837201,10679837194,-7,1101,2597,30
10681022159,10681022154,-5,861,3011,30
10683144810,10683144807,-3,1081,3624,30
10685617615,10685617610,-5,1515,2675,30
10688537983,10688537979,-4,816,1607,30
10690157189,10690157194,5,5693,2535,30
10691955033,10691955029,-4,1210,3130,30
10692423449,10692423443,-6,1242,2883,30
10699801549,10699801545,-4,1260,2967,30
10701527816,10701527810,-6,1071,2486,30
10703414219,10703414215,-4,840,2857,30
10704484062,10704484058,-4,1039,4115,30
10708305879,10708305875,-4,1118,3135,30
10708836443,10708836454,11,175,1313,30
10709286005,10709286002,-3,637,1834,30
10709390287,10709390282,-5,576,2184,30
10717466467,10717466485,18,1141,2981,30
10721994670,10721994666,-4,1032,2882,30
10723768413,10723768409,-4,1601,3445,30
10725401729,10725401708,-21,1946,926,30
10728970689,10728970690,1,10492,11289,30
10730425838,10730425833,-5,1371,3581,30
10733521775,10733521771,-4,1180,3756,30
10738166019,10738166014,-5,715,3061,30
10747601642,10747601635,-7,1041,4235,30
10751514593,10751514593,0,1593,1219,30
10752487327,10752487323,-4,897,2299,30
10752535694,10752535689,-5,1230,2979,30
10752633344,10752633335,-9,102,1159,30
10753213699,10753213694,-5,1180,2584,30
10766178102,10766178109,7,3276,1253,30
10768848409,10768848406,-3,897,3200,30
10769183760,10769183761,1,1187,1325,30
10775043554,10775043550,-4,1350,3046,30
10781433327,10781433319,-8,925,3712,30
10784802827,10784802822,-5,746,2259,30
10785407779,10785407773,-6,913,1962,30
10789626551,10789626547,-4,504,1795,30
10790661100,10790661094,-6,1582,3446,30
10791175111,10791175102,-9,1402,2713,30
10799756573,10799756569,-4,995,2559,30
10800397341,10800397334,-7,881,2363,30
10802397807,10802397801,-6,757,1503,30
10804902167,10804902166,-1,947,1374,30
10805416131,10805416129,-2,1003,2771,30
10811406002,10811405997,-5,851,2966,30
10811782651,10811782658,7,2776,1558,30
10812909878,10812909877,-1,713,2800,30
10816369774,10816369768,-6,1207,3151,30
10818175510,10818175505,-5,1196,2565,30
10840645548,10840645543,-5,996,2406,30
10840736629,10840736623,-6,674,875,30
10843648586,10843648582,-4,1018,2580,30
10848801291,10848801286,-5,1599,4159,30
10850228398,10850228403,5,3626,1519,30
10852159089,10852159085,-4,861,2222,30
10854385582,10854385577,-5,1265,4337,30
10855164622,10855164629,7,4299,1409,30
10862182914,10862182909,-5,1162,3661,30
10864866221,10864866216,-5,1023,1973,30
10866795532,10866795541,9,15044,15914,30
10867588355,10867588349,-6,816,2515,30
10870552063,10870552069,6,3895,2054,30
10876099635,10876099636,1,931,1126,30
10878402537,10878402531,-6,1007,2320,30
10881202156,10881202151,-5,1257,3303,30
10886759742,10886759747,5,2132,1279,30
10886970243,10886970236,-7,905,3491,30
10888792521,10888792518,-3,1196,1883,30
10899120816,10899120811,-5,1488,2693,30
10901746551,10901746548,-3,783,2077,30
10903577396,10903577389,-7,986,1987,30
10908115312,10908115309,-3,1213,3796,30
10908392442,10908392432,-10,114,864,30
10911192162,10911192155,-7,1357,4484,30
10911995674,10911995666,-8,1222,3942,30
10912355353,10912355349,-4,1020,2536,30
10913292157,10913292161,4,1665,1341,30
10922442168,10922442164,-4,1161,2469,30
10923620737,10923620734,-3,992,2649,30
10927899507,10927899504,-3,1020,2274,30
10930531275,10930531270,-5,1286,3529,30
10930756947,10930756936,-11,1091,3343,30
10931372425,10931372427,2,250,864,30
10932599715,10932599719,4,97,795,30
10937488281,10937488280,-1,1003,1994,30
10937640129,10937640149,20,787,2143,30
10938539346,10938539329,-17,370,1153,30
10940049042,10940049025,-17,1258,5038,30
10940095432,10940095450,18,444,1400,30
10940414362,10940414358,-4,980,3510,30
10946182111,10946182110,-1,1103,1977,30
10949001686,10949001680,-6,1302,5883,30
10950421548,10950421565,17,840,2005,30
10951317947,10951317944,-3,1205,2747,30
10955914874,10955914870,-4,1405,4017,30
10959630239,10959630234,-5,1110,2436,30
10964128295,10964128290,-5,812,1675,30
10965061435,10965061417,-18,881,3280,30
10965714162,10965714177,15,538,3063,30
10966554313,10966554315,2,822,911,30
10974798492,10974798492,0,18412,10402,30
10984483326,10984483323,-3,1492,2684,30
10989764318,10989764315,-3,1214,2237,30
10992020857,10992020854,-3,862,2868,30
10992180675,10992180695,20,338,1285,30
10997692421,10997692416,-5,1609,3373,30
11000295951,11000295947,-4,953,3125,30
11012878554,11012878548,-6,790,2686,30
11019502479,11019502476,-3,744,2597,30
11021324705,11021324698,-7,650,2831,30
11028602642,11028602638,-4,923,3108,30
11028827065,11028827085,20,337,815,30
11029911486,11029911481,-5,1143,4009,30
11032430492,11032430491,-1,1443,1415,30
11033675968,11033675958,-10,1051,2312,30
11036241015,11036241020,5,4196,2693,30
11040294128,11040294123,-5,1087,3658,30
11043441854,11043441853,-1,1171,2939,30
11045283852,11045283846,-6,800,3864,30
11047638240,11047638234,-6,1137,3074,30
11051989754,11051989752,-2,938,2565,30
11060868774,11060868767,-7,932,3325,30
11062968819,11062968814,-5,1147,2718,30
11067342313,11067342313,0,616,1179,30
11070104697,11070104676,-21,818,305,30
11071158510,11071158506,-4,971,1970,30
11071452673,11071452678,5,101,908,30
11072260634,11072260634,0,178,877,30
11074318464,11074318458,-6,1565,2808,30
11076505022,11076505017,-5,1043,2431,30
11078379260,11078379278,18,556,1048,30
11081812293,11081812292,-1,838,1446,30
11085816672,11085816664,-8,1123,2968,30
11091447893,11091447888,-5,797,2912,30
11093896835,11093896833,-2,1172,2050,30
11095664484,11095664479,-5,859,3351,30
11095992010,11095992006,-4,2400,5557,30
11096034834,11096034827,-7,1367,3797,30
11100631715,11100631710,-5,738,3666,30
11101263086,11101263091,5,2062,841,30
11102467611,11102467615,4,1994,1194,30
11112495710,11112495705,-5,1158,2884,30
11118524703,11118524697,-6,1489,3250,30
11119331122,11119331104,-18,131,706,30
11122860623,11122860617,-6,862,3093,30
11124183047,11124183042,-5,916,2955,30
11127836775,11127836774,-1,1107,1699,30
11133819026,11133819022,-4,769,3267,30
11135599693,11135599688,-5,479,1290,30
11135995155,11135995171,16,214,1330,30
11139324998,11139325014,16,493,1066,30
11141786709,11141786705,-4,1014,2857,30
11145832251,11145832245,-6,890,3363,30
11147195138,11147195131,-7,1186,3270,30
11150566390,11150566384,-6,726,2625,30
11151189778,11151189774,-4,919,2192,30
11153678066,11153678071,5,1160,1317,30
11162965145,11162965138,-7,1508,3482,30
11163468879,11163468875,-4,937,2969,30
11171096788,11171096783,-5,765,3209,30
11174303605,11174303601,-4,969,3218,30
11179677034,11179677030,-4,797,3250,30
11181744566,11181744572,6,2275,1213,30
11191010333,11191010326,-7,1105,2781,30
11191500442,11191500443,1,2063,1652,30
11199877425,11199877426,1,593,1149,30
11200870933,11200870935,2,2495,2216,30
11202798101,11202798098,-3,1222,3830,30
11202902626,11202902621,-5,1082,3019,30
11203464727,11203464726,-1,923,1777,30
11206127666,11206127653,-13,3577,14571,30
11209815110,11209815106,-4,650,2275,30
11211607816,11211607810,-6,1096,3148,30
11211780449,11211780465,16,1091,2874,30
11212644562,11212644559,-3,559,1718,30
11216455643,11216455644,1,1404,1824,30
11220523167,11220523163,-4,1005,2840,30
11221326673,11221326670,-3,1740,2712,30
11227879995,11227879990,-5,1420,3586,30
11230271349,11230271343,-6,1199,2874,30
11232892815,11232892811,-4,931,2284,30
11239798986,11239798981,-5,1637,3168,30
11258467282,11258467278,-4,1024,3673,30
11259161918,11259161916,-2,865,1277,30
11263649550,11263649547,-3,967,2723,30
11264147035,11264147036,1,1361,1679,30
11268296378,11268296356,-22,1331,389,30
11275748775,11275748778,3,1288,757,30
11276157414,11276157418,4,2836,2054,30
11276988930,11276988929,-1,1086,1456,30
11277966028,11277966042,14,397,993,30
11278444121,11278444103,-18,329,913,30
11279469019,11279469022,3,1753,1098,30
11281044383,11281044379,-4,797,2923,30
11285508603,11285508595,-8,1076,3383,30
11287391350,11287391346,-4,1136,2411,30
11291217956,11291217952,-4,796,2738,30
11293340887,11293340885,-2,1187,2857,30
11298076529,11298076526,-3,732,2386,30
11304422491,11304422488,-3,930,2544,30
11308243047,11308243040,-7,1549,3621,30
11308570661,11308570657,-4,1071,2051,30
11311404338,11311404333,-5,876,3221,30
11312253299,11312253294,-5,955,2423,30
11316181719,11316181714,-5,1133,2045,30
11319083844,11319083843,-1,1061,1744,30
11321718317,11321718314,-3,1071,2318,30
11323051938,11323051933,-5,733,2338,30
11333069279,11333069274,-5,979,3614,30
11335236677,11335236673,-4,759,2334,30
11337797566,11337797560,-6,512,2170,30
11340079798,11340079794,-4,862,2797,30
11348526173,11348526166,-7,1258,5637,30
11350736434,11350736429,-5,1432,3386,30
11351596040,11351596050,10,222,777,30
11360214882,11360214863,-19,900,700,30
11361894230,11361894226,-4,1088,2286,30
11363672805,11363672802,-3,1305,1243,30
11363737913,11363737913,0,374,1224,30
11365361736,11365361730,-6,1123,3460,30
11368639075,11368639070,-5,925,2235,30
11368748012,11368748019,7,177,707,30
11368981059,11368981040,-19,364,1273,30
11369746686,11369746681,-5,768,3379,30
11369932782,11369932778,-4,973,2448,30
11372168942,11372168940,-2,806,1764,30
11373229388,11373229383,-5,980,1602,30
11373667410,11373667419,9,75,889,30
11374703953,11374703969,16,422,1552,30
11376902801,11376902798,-3,878,1605,30
11377374462,11377374457,-5,685,2476,30
11378664502,11378664497,-5,1063,3443,30
11381569820,11381569818,-2,1239,2622,30
11383922617,11383922613,-4,778,2696,30
11386023263,11386023267,4,127,582,30
11394537009,11394537004,-5,1367,2810,30
11400072865,11400072859,-6,1279,4115,30
11401848210,11401848218,8,3256,1146,30
11407241728,11407241750,22,449,2050,30
11412995370,11412995366,-4,824,3365,30
11421120372,11421120370,-2,1373,2487,30
11425263367,11425263360,-7,1013,3529,30
11429646117,11429646113,-4,1003,2963,30
11429721689,11429721710,21,1440,3268,30
11431043691,11431043698,7,1166,900,30
11436046907,11436046901,-6,1187,2645,30
11436983723,11436983718,-5,1149,2555,30
11437581490,11437581510,20,102,967,30
11441551195,11441551210,15,12785,47790,30
11443176451,11443176446,-5,768,2961,30
11443785482,11443785477,-5,904,2666,30
11450989497,11450989505,8,5088,1228,30
11452411333,11452411327,-6,1308,3012,30
11454501490,11454501487,-3,970,2459,30
11457447373,11457447369,-4,1243,2198,30
11465595550,11465595546,-4,781,2022,30
11466226050,11466226037,-13,113,835,30
11467280731,11467280726,-5,1395,3564,30
11470921043,11470921038,-5,1699,3319,30
11471849465,11471849460,-5,1285,3712,30
11472025313,11472025334,21,953,3170,30
11484247374,11484247368,-6,759,2431,30
11488735553,11488735549,-4,1256,3301,30
11495820203,11495820201,-2,878,2271,30
11496028980,11496028993,13,931,3589,30
11497966719,11497966714,-5,971,2959,30
11498331444,11498331462,18,858,2206,30
11508899303,11508899301,-2,1004,2758,30
11513355133,11513355126,-7,842,2751,30
11514262942,11514262950,8,2563,1170,30
11515564449,11515564445,-4,1117,3177,30
11516512908,11516512911,3,5709,3839,30
11521152028,11521152022,-6,1048,4538,30
11522625162,11522625160,-2,1866,3332,30
11527295726,11527295722,-4,1004,1891,30
11529695154,11529695152,-2,1209,3853,30
11530641190,11530641185,-5,1186,3286,30
11537563245,11537563242,-3,837,2728,30
11538449474,11538449470,-4,1166,3374,30
11541743941,11541743934,-7,1121,5106,30
11541785482,11541785461,-21,896,3392,30
11544490235,11544490229,-6,1173,3092,30
11545148590,11545148582,-8,1132,2722,30
11548423067,11548423073,6,2870,1428,30
11549544363,11549544361,-2,878,1273,30
11556242006,11556242001,-5,1299,2142,30
11557148322,11557148317,-5,993,3740,30
11563244798,11563244806,8,1117,1045,30
11563660653,11563660650,-3,970,2719,30
11564899456,11564899451,-5,115,856,30
11570933282,11570933276,-6,838,2676,30
11575114846,11575114842,-4,1157,2600,30
11577235278,11577235285,7,3570,1742,30
11577887017,11577887011,-6,1186,3862,30
11586891073,11586891066,-7,1237,3015,30
11589082613,11589082606,-7,825,3588,30
11593168436,11593168433,-3,1059,2158,30
11595312890,11595312869,-21,1017,1046,30
11596218971,11596218965,-6,1091,2942,30
11597317913,11597317911,-2,1861,2584,30
11599644523,11599644518,-5,1009,2709,30
11600081523,11600081517,-6,1099,2851,30
11601341946,11601341941,-5,1477,3207,30
11602665297,11602665293,-4,1306,3681,30
11605366303,11605366298,-5,467,1934,30
11606339865,11606339860,-5,1132,3531,30
11606796708,11606796722,14,897,2475,30
11615561697,11615561689,-8,472,1753,30
11616488442,11616488437,-5,1053,3972,30
11616682952,11616682947,-5,1181,3231,30
11616910928,11616910951,23,274,749,30
11619732632,11619732629,-3,824,2005,30
11622297303,11622297305,2,3081,3064,30
11632533850,11632533846,-4,780,2725,30
11637998303,11637998298,-5,950,2723,30
11638738878,11638738873,-5,1323,3714,30
11640124574,11640124580,6,5908,3069,30
11643715063,11643715060,-3,816,1877,30
11649196939,11649196936,-3,1240,2611,30
11652383715,11652383710,-5,1284,3453,30
11662098921,11662098917,-4,1044,2506,30
11662169793,11662169811,18,661,1270,30
11671118535,11671118530,-5,1094,3164,30
11678529225,11678529229,4,11152,8242,30
11679985169,11679985166,-3,1868,3011,30
11684058148,11684058142,-6,1259,3524,30
11684353006,11684353002,-4,1091,3309,30
11684723683,11684723694,11,521,2903,30
11684824130,11684824146,16,443,1024,30
11686049461,11686049457,-4,1876,5412,30
11688297450,11688297442,-8,969,1494,30
11689812042,11689812024,-18,2847,944,30
11692649962,11692649959,-3,908,2044,30
11701020881,11701020902,21,686,1578,30
11703530554,11703530549,-5,1052,2504,30
11704216223,11704216219,-4,1001,2764,30
11706562107,11706562112,5,2311,1531,30
11709772490,11709772491,1,45438,3742,30
11716434102,11716434098,-4,776,2358,30
11718491236,11718491232,-4,1102,3113,30
11724239338,11724239332,-6,1253,3894,30
11726412690,11726412686,-4,1145,3350,30
11726608792,11726608809,17,201,716,30
11729211105,11729211101,-4,1214,2744,30
11733455642,11733455637,-5,900,2612,30
11734425474,11734425470,-4,945,2633,30
11738192424,11738192421,-3,599,1968,30
11738365465,11738365457,-8,1504,2132,30
11752076489,11752076483,-6,1068,2859,30
11755658803,11755658798,-5,966,2639,30
11755937305,11755937304,-1,5186,6831,30
11759067399,11759067394,-5,1287,3777,30
11761879066,11761879062,-4,889,2684,30
11770515646,11770515638,-8,1064,3294,30
11770616899,11770616894,-5,907,2445,30
11772528490,11772528485,-5,876,1867,30
11775049642,11775049637,-5,1127,2677,30
11775548835,11775548832,-3,920,3101,30
11777819139,11777819135,-4,877,2570,30
11778501859,11778501857,-2,1553,2759,30
11778596816,11778596810,-6,936,2657,30
11783781830,11783781828,-2,1107,2438,30
11787791611,11787791619,8,11766,19109,30
11791082859,11791082854,-5,941,3189,30
11792202558,11792202555,-3,936,2712,30
11792293762,11792293760,-2,1966,10305,30
11794982162,11794982158,-4,1317,2623,30
11795166241,11795166235,-6,831,2697,30
11795704794,11795704789,-5,1174,3302,30
11798624250,11798624245,-5,1367,2562,30
11806072891,11806072889,-2,297,1572,30
11810762591,11810762587,-4,490,1050,30
11811272514,11811272509,-5,545,2130,30
11819224947,11819224941,-6,1221,2128,30
11827854854,11827854850,-4,1280,4200,30
11835041245,11835041240,-5,1062,4171,30
11845320635,11845320629,-6,965,2962,30
11853064425,11853064419,-6,781,2754,30
11855563902,11855563897,-5,949,2269,30
11857545143,11857545150,7,10369,7215,30
11858032981,11858032981,0,2415,3271,30
11861073679,11861073671,-8,955,2930,30
11863787701,11863787707,6,5409,2570,30
11872493473,11872493468,-5,1089,3098,30
11874751909,11874751905,-4,1016,2832,30
11876135953,11876135946,-7,1113,4810,30
11878089189,11878089194,5,2174,1065,30
11879638114,11879638109,-5,980,3115,30
11882601783,11882601778,-5,1109,3038,30
11882881704,11882881703,-1,47571,31234,30
11884308731,11884308725,-6,1175,2753,30
11886935527,11886935523,-4,880,2165,30
11888078507,11888078508,1,1849,3764,30
11889815181,11889815174,-7,1231,3256,30
11890466162,11890466154,-8,841,3203,30
11891475964,11891475982,18,423,1620,30
11891511101,11891511094,-7,816,3671,30
11895355750,11895355744,-6,853,3516,30
11902253684,11902253689,5,1971,1309,30
11910674362,11910674358,-4,1149,3878,30
11912117666,11912117661,-5,806,3003,30
11912478462,11912478457,-5,1124,2429,30
11918529906,11918529902,-4,1195,3697,30
11920911959,11920911954,-5,1026,2458,30
11929856254,11929856247,-7,919,2648,30
11935708510,11935708505,-5,1048,2358,30
11943440830,11943440826,-4,1086,3079,30
11944136437,11944136430,-7,1216,3766,30
11944487964,11944487983,19,1011,2547,30
11947570054,11947570052,-2,18316,13973,30
11947775540,11947775535,-5,947,3368,30
11950463516,11950463513,-3,948,3200,30
11956272390,11956272387,-3,878,3516,30
11957757869,11957757864,-5,942,3022,30
11961392343,11961392338,-5,891,1789,30
11962166694,11962166689,-5,1080,3850,30
11963675278,11963675285,7,4058,2237,30
11965661142,11965661136,-6,12763,18711,30
11965814734,11965814729,-5,1079,2996,30
11966081634,11966081629,-5,1319,3818,30
11977698821,11977698817,-4,813,3113,30
11981248325,11981248331,6,6145,21274,30
11981965041,11981965034,-7,1128,3288,30
11982270968,11982270956,-12,322,1159,30
11984225355,11984225352,-3,641,2060,30
11986276864,11986276861,-3,937,2345,30
11987118854,11987118851,-3,1325,2357,30
11989237260,11989237264,4,2539,1527,30
11994457051,11994457055,4,1051,1192,30
11999334855,11999334850,-5,1020,2344,30
12002941631,12002941626,-5,1448,3929,30
12010589066,12010589061,-5,930,3379,30
12012573954,12012573950,-4,1290,3469,30
12014431231,12014431226,-5,553,2438,30
12017821413,12017821409,-4,1328,2577,30
12024393582,12024393578,-4,1615,3864,30
12031786063,12031786059,-4,1351,3303,30
12037582200,12037582195,-5,1057,2547,30
12048893762,12048893757,-5,1171,3267,30
12053454796,12053454794,-2,833,2225,30
12055036623,12055036629,6,5586,2624,30
12056145830,12056145839,9,18071,44116,30
12056481403,12056481402,-1,792,1877,30
12063859008,12063859010,2,781,813,30
12070051369,12070051366,-3,740,1884,30
12070392879,12070392877,-2,1292,1832,30
12072456294,12072456290,-4,1313,2900,30
12074277169,12074277164,-5,1302,2958,30
12078716524,12078716525,1,2909,2927,30
12083671740,12083671737,-3,1195,2295,30
12083976660,12083976672,12,362,1471,30
12084388402,12084388399,-3,740,1529,30
12089581495,12089581489,-6,1200,3820,30
12093033079,12093033074,-5,905,2624,30
12094281183,12094281180,-3,721,3271,30
12100638350,12100638357,7,4030,2923,30
12101716382,12101716378,-4,1531,3342,30
12106046514,12106046511,-3,626,2803,30
12109236416,12109236410,-6,1291,3841,30
12109389140,12109389135,-5,854,3046,30
12111309788,12111309785,-3,1540,3406,30
12111447520,12111447518,-2,213,806,30
12111553390,12111553384,-6,776,2389,30
12114246502,12114246499,-3,1912,4161,30
12116782119,12116782115,-4,949,2666,30
12118919713,12118919710,-3,1203,2191,30
12120162027,12120162022,-5,629,2242,30
12123846663,12123846658,-5,1080,2312,30
12124405750,12124405745,-5,928,2190,30
12135262811,12135262806,-5,1229,3205,30
12135621610,12135621606,-4,1230,3532,30
12142337191,12142337192,1,1455,2416,30
12142800015,12142800010,-5,1236,3632,30
12148243634,12148243628,-6,1256,2756,30
12156792434,12156792431,-3,1181,2239,30
12163676255,12163676250,-5,1058,3166,30
12163905927,12163905924,-3,1169,2564,30
12166491970,12166491965,-5,1130,2675,30
12167559875,12167559872,-3,980,2418,30
12167639387,12167639382,-5,1157,2449,30
12169852539,12169852534,-5,1129,2571,30
12173315339,12173315334,-5,1021,3439,30
12178051615,12178051610,-5,990,3288,30
12180167094,12180167091,-3,1401,3302,30
12184997443,12184997438,-5,926,2774,30
12187784894,12187784886,-8,1168,4783,30
12188393041,12188393036,-5,2109,6898,30
12188699976,12188699975,-1,1208,2269,30
12192441201,12192441197,-4,942,3749,30
12194978360,12194978352,-8,1558,3525,30
12195663410,12195663405,-5,1071,2849,30
12200792939,12200792938,-1,1215,1362,30
12206017017,12206017015,-2,982,1780,30
12211341714,12211341710,-4,1175,2748,30
12213383920,12213383917,-3,1057,3656,30
12216188645,12216188640,-5,2004,3912,30
12221926959,12221926949,-10,936,2844,30
12225437269,12225437266,-3,592,1749,30
12227313880,12227313874,-6,1065,3744,30
12238628386,12238628381,-5,796,2540,30
12239057817,12239057813,-4,854,2896,30
12240810777,12240810784,7,4696,2779,30
12242947901,12242947898,-3,968,3045,30
12246781187,12246781186,-1,1221,1978,30
12247189215,12247189211,-4,1281,3095,30
12250197082,12250197086,4,2244,1302,30
12251173463,12251173461,-2,813,2535,30
12252043482,12252043485,3,1398,1721,30
12252773062,12252773075,13,310,853,30
12256057394,12256057389,-5,1292,4611,30
12261577449,12261577442,-7,1076,2903,30
12262176010,12262176006,-4,843,2456,30
12263861342,12263861338,-4,2288,4960,30
12265947987,12265947981,-6,1191,2393,30
12266296786,12266296782,-4,1277,3411,30
12266763597,12266763593,-4,905,2790,30
12267003523,12267003540,17,511,2772,30
12268984102,12268984099,-3,1253,2953,30
12269128378,12269128374,-4,737,3023,30
12271368675,12271368677,2,3149,2597,30
12276541902,12276541897,-5,1210,2663,30
12283690179,12283690173,-6,985,2397,30
12292885203,12292885198,-5,1026,2870,30
12293511576,12293511582,6,418,996,30
12298823936,12298823941,5,6712,2780,30
12300156170,12300156167,-3,1233,2668,30
12301564453,12301564447,-6,927,3262,30
12305813270,12305813264,-6,807,3716,30
12311229149,12311229144,-5,1337,2559,30
12316002037,12316002032,-5,997,3107,30
12317815776,12317815769,-7,1216,3910,30
12318268857,12318268854,-3,1210,3034,30
12322455572,12322455567,-5,1284,3592,30
12326605193,12326605190,-3,1473,2969,30
12333271186,12333271184,-2,1844,2967,30
12336252311,12336252308,-3,1038,2843,30
12339340353,12339340350,-3,738,2757,30
12340589500,12340589495,-5,1582,3836,30
12341456575,12341456570,-5,975,2779,30
12341638566,12341638560,-6,1152,2410,30
12343252159,12343252157,-2,961,2312,30
12348440394,12348440390,-4,1220,3425,30
12350720221,12350720225,4,2235,1524,30
12354380824,12354380821,-3,1391,3665,30
12360198675,12360198666,-9,786,1957,30
12362558671,12362558666,-5,1037,2336,30
12363001849,12363001844,-5,837,2274,30
12369507998,12369507997,-1,992,2340,30
12370099071,12370099066,-5,667,3207,30
12373318654,12373318650,-4,817,2057,30
12375812303,12375812300,-3,1011,2332,30
12376485139,12376485128,-11,858,1848,30
12376540235,12376540240,5,2410,1614,30
12376873925,12376873922,-3,1178,2911,30
12377325530,12377325550,20,843,2309,30
12379743116,12379743112,-4,1027,3191,30
12379866425,12379866422,-3,1089,2235,30
12383295515,12383295510,-5,993,2757,30
12384191746,12384191765,19,1009,3943,30
12389912074,12389912067,-7,962,2333,30
12390834371,12390834367,-4,1019,3146,30
12391422922,12391422937,15,1076,2384,30
12397477433,12397477432,-1,982,947,30
12399429116,12399429127,11,32764,44666,30
12406571074,12406571070,-4,1078,2662,30
12419406279,12419406273,-6,701,3874,30
12423287507,12423287503,-4,1102,2697,30
12425206456,12425206454,-2,1429,2370,30
12431050239,12431050234,-5,1281,4309,30
12437207682,12437207677,-5,838,2191,30
12439571642,12439571643,1,924,1135,30
12442381143,12442381149,6,2462,1956,30
12445967672,12445967667,-5,1146,1920,30
12447694378,12447694372,-6,777,2503,30
12447765653,12447765648,-5,1634,3400,30
12447990042,12447990038,-4,1135,3240,30
12458342276,12458342272,-4,961,2378,30
12458728554,12458728550,-4,1578,2769,30
12460806911,12460806908,-3,985,1807,30
12461067376,12461067398,22,658,2183,30
12464978015,12464978010,-5,851,3438,30
12465334195,12465334182,-13,200,1059,30
12468558947,12468558943,-4,1034,2940,30
12469996827,12469996823,-4,984,2533,30
12473794707,12473794715,8,20277,41986,30
12481974184,12481974180,-4,1212,3130,30
12484496730,12484496729,-1,2371,4471,30
12485334557,12485334550,-7,1208,3087,30
12493911601,12493911598,-3,1022,3001,30
12497665162,12497665157,-5,1168,3060,30
12497733073,12497733070,-3,1290,2644,30
12502854675,12502854670,-5,1015,2888,30
12503180332,12503180347,15,1068,2030,30
12506345342,12506345339,-3,1130,3275,30
12506654821,12506654816,-5,1101,4260,30
12512386955,12512386951,-4,1004,1937,30
12516781939,12516781933,-6,1102,2977,30
12518218651,12518218671,20,195,1284,30
12519664254,12519664250,-4,1512,2384,30
12524095995,12524095989,-6,1151,3201,30
12525795423,12525795418,-5,1138,4617,30
12527321210,12527321203,-7,871,2098,30
12529379019,12529379016,-3,1260,3334,30
12535731518,12535731511,-7,983,2525,30
12536294313,12536294309,-4,1556,3445,30
12536910822,12536910818,-4,1123,2942,30
12540667332,12540667313,-19,1189,3774,30
12540836169,12540836182,13,47,1654,30
12545975437,12545975433,-4,1118,2185,30
12547489432,12547489425,-7,1353,2546,30
12547702478,12547702474,-4,1228,3439,30
12557763195,12557763203,8,2140,1127,30
12559274035,12559274029,-6,1227,4038,30
12563544509,12563544511,2,2478,2080,30
12566495590,12566495585,-5,1176,2881,30
12566888082,12566888090,8,3262,1552,30
12567163001,12567162996,-5,1143,2579,30
12569591486,12569591483,-3,1164,3393,30
12570929793,12570929790,-3,890,2613,30
12576141109,12576141106,-3,1243,2391,30
12586638935,12586638930,-5,1091,2799,30
12589657830,12589657837,7,2204,1152,30
12599848365,12599848361,-4,1052,2918,30
12602776240,12602776235,-5,1201,3365,30
12604236629,12604236625,-4,1416,2323,30
12613735714,12613735710,-4,974,2563,30
12615076062,12615076065,3,1104,1149,30
12619437720,12619437716,-4,1403,2699,30
12619766442,12619766437,-5,896,3655,30
12620078517,12620078511,-6,859,3360,30
12620747082,12620747080,-2,1167,2840,30
12621812301,12621812295,-6,810,1965,30
12623861123,12623861119,-4,939,3040,30
12627484138,12627484133,-5,960,2663,30
12628605772,12628605771,-1,2227,3883,30
12630514038,12630514033,-5,1220,2653,30
12637622226,12637622211,-15,51,819,30
12646860750,12646860742,-8,965,4483,30
12646958976,12646958995,19,803,2234,30
12649420947,12649420940,-7,862,2790,30
12650287712,12650287706,-6,1100,2750,30
12652541989,12652541984,-5,1407,3009,30
12652756715,12652756730,15,82,1356,30
12653734575,12653734570,-5,1364,3488,30
12654418425,12654418421,-4,928,2505,30
12658153809,12658153790,-19,909,2532,30
12661172049,12661172043,-6,1057,2120,30
12661220891,12661220887,-4,80,1012,30
12664579435,12664579433,-2,982,2762,30
12668890418,12668890412,-6,1267,3186,30
12671181201,12671181197,-4,894,2698,30
12678074387,12678074380,-7,1230,3772,30
12683211168,12683211179,11,11240,39330,30
12684171077,12684171073,-4,1043,2886,30
12686144930,12686144925,-5,1053,3313,30
12688361426,12688361421,-5,1053,2979,30
12693811960,12693811955,-5,1410,3137,30
12700905169,12700905163,-6,720,3296,30
12704011522,12704011518,-4,830,3281,30
12704521790,12704521786,-4,929,2710,30
12709579978,12709579974,-4,1038,2224,30
12713086579,12713086575,-4,861,3184,30
12713712032,12713712026,-6,1108,3875,30
12714783439,12714783434,-5,721,2776,30
12718978851,12718978847,-4,690,1896,30
12722197097,12722197090,-7,676,3522,30
12728727699,12728727681,-18,951,2281,30
12730279163,12730279160,-3,1052,2195,30
12735124573,12735124569,-4,980,3511,30
12743304210,12743304205,-5,955,2198,30
12746585963,12746585958,-5,1025,2892,30
12747334794,12747334790,-4,968,2521,30
12747414503,12747414497,-6,902,2262,30
12747974497,12747974498,1,2101,2412,30
12749172969,12749172962,-7,1420,4991,30
12763606042,12763606038,-4,1072,2252,30
12765464073,12765464069,-4,1115,2612,30
12769687088,12769687082,-6,1089,2022,30
12774436519,12774436514,-5,1284,4249,30
12776332723,12776332721,-2,1893,2591,30
12780503578,12780503577,-1,1599,1950,30
12784207447,12784207442,-5,888,2891,30
12785140975,12785140988,13,39881,15379,30
12786081497,12786081493,-4,1316,2714,30
12786232699,12786232691,-8,824,4732,30
12798302441,12798302437,-4,1225,2307,30
12805577465,12805577461,-4,1040,3028,30
12810632781,12810632778,-3,713,2888,30
12813132434,12813132429,-5,1691,3279,30
12819318426,12819318422,-4,1340,3098,30
12821278629,12821278625,-4,663,3168,30
12821809675,12821809690,15,337,1291,30
12823819922,12823819917,-5,854,1699,30
12830943862,12830943858,-4,939,2694,30
12831072283,12831072277,-6,779,2580,30
12832913906,12832913901,-5,729,1893,30
12840118072,12840118067,-5,1147,3738,30
12840344964,12840344960,-4,1025,2488,30
12843355650,12843355647,-3,1015,2597,30
12846696464,12846696458,-6,1081,2819,30
12850873246,12850873241,-5,706,1905,30
12852240338,12852240338,0,2292,3235,30
12857491635,12857491633,-2,1070,2091,30
12858416934,12858416931,-3,1232,2795,30
12860303809,12860303804,-5,1012,3014,30
12860336225,12860336219,-6,1317,3705,30
12867596450,12867596447,-3,1065,3181,30
12868086397,12868086396,-1,1513,2156,30
12873206543,12873206535,-8,963,3570,30
12878640735,12878640730,-5,860,2100,30
12880031466,12880031465,-1,1263,2526,30
12881120130,12881120126,-4,1464,4029,30
12882636382,12882636379,-3,1313,2520,30
12883551933,12883551930,-3,956,1125,30
12885157798,12885157791,-7,1010,2511,30
12885325288,12885325308,20,174,1071,30
12885911991,12885911989,-2,997,3553,30
12895157534,12895157528,-6,1024,2961,30
12895258689,12895258711,22,281,1690,30
12896940378,12896940373,-5,768,2187,30
12899021217,12899021217,0,1651,2058,30
12899948763,12899948762,-1,6497,13345,30
12905510804,12905510821,17,493,1521,30
12910757532,12910757529,-3,1372,2701,30
12912872374,12912872370,-4,784,2378,30
12915532361,12915532357,-4,1062,2805,30
12916053186,12916053166,-20,1331,3328,30
12916466847,12916466843,-4,1117,4570,30
12923149483,12923149478,-5,803,1965,30
12923320915,12923320922,7,15,681,30
12928988157,12928988152,-5,1220,4088,30
12929416247,12929416242,-5,1147,2913,30
12933176470,12933176473,3,1876,1883,30
12934233410,12934233406,-4,911,3498,30
12935137477,12935137473,-4,787,2336,30
12935227771,12935227766,-5,879,3133,30
12936918135,12936918130,-5,1952,6794,30
12939244172,12939244190,18,1079,2722,30
12940290524,12940290522,-2,1038,2522,30
12942526266,12942526264,-2,992,1783,30
12951076362,12951076382,20,1053,3564,30
12956874850,12956874845,-5,854,3707,30
12957689893,12957689886,-7,1091,2551,30
12960288746,12960288741,-5,1124,2536,30
12964072490,12964072486,-4,1138,3048,30
12968008018,12968008013,-5,1347,3225,30
12968510293,12968510287,-6,1502,3336,30
12973397618,12973397613,-5,1091,2453,30
12977778437,12977778433,-4,827,2195,30
12978544634,12978544614,-20,14,1217,30
12979561563,12979561577,14,948,2736,30
12979649778,12979649760,-18,938,2878,30
12985089935,12985089930,-5,788,2946,30
12986343167,12986343163,-4,980,2184,30
12987566803,12987566798,-5,520,2380,30
12989555212,12989555205,-7,1246,2812,30
13003949730,13003949725,-5,979,2301,30
13009147997,13009147998,1,1934,2158,30
13017059449,13017059444,-5,1214,3195,30
13018779696,13018779691,-5,32151,13434,30
13019443609,13019443605,-4,738,2326,30
13019821152,13019821146,-6,881,2771,30
13021926809,13021926803,-6,816,2471,30
13024686239,13024686234,-5,1305,2899,30
13025758798,13025758793,-5,874,1903,30
13032700333,13032700331,-2,431,392,30
13034571527,13034571533,6,2383,1570,30
13040906417,13040906413,-4,1049,3642,30
13042679075,13042679070,-5,885,2539,30
13042709481,13042709501,20,246,1061,30
13051033123,13051033118,-5,902,2580,30
13051696747,13051696759,12,841,3257,30
13053197709,13053197690,-19,327,897,30
13057553285,13057553280,-5,827,3356,30
13064931995,13064931990,-5,1065,2912,30
13065776502,13065776496,-6,1000,3381,30
13074114377,13074114374,-3,697,1700,30
13074702126,13074702119,-7,792,2360,30
13076180130,13076180125,-5,856,4664,30
13077279891,13077279885,-6,1294,3606,30
13078532314,13078532309,-5,1504,3021,30
13083718227,13083718225,-2,1792,2422,30
13084897095,13084897090,-5,1046,3114,30
13085298012,13085298029,17,1052,3418,30
13086773778,13086773773,-5,1164,3901,30
13087123621,13087123626,5,2754,1455,30
13088279673,13088279676,3,3247,2453,30
13091761338,13091761334,-4,871,2309,30
13095681680,13095681687,7,3319,1315,30
13097126008,13097126004,-4,1002,2405,30
13099658557,13099658553,-4,1198,3303,30
13099802347,13099802341,-6,1043,3713,30
13102928935,13102928930,-5,996,3165,30
13104493634,13104493630,-4,1037,3669,30
13104789740,13104789733,-7,972,4378,30
13106402454,13106402451,-3,923,2735,30
13109813239,13109813239,0,982,1880,30
13109903045,13109903041,-4,779,1118,30
13123328461,13123328463,2,2715,2005,30
13123397846,13123397841,-5,698,2559,30
13126211848,13126211843,-5,766,2182,30
13128614809,13128614806,-3,1204,3770,30
13130295733,13130295729,-4,831,2921,30
13137846356,13137846351,-5,1065,2717,30
13139123156,13139123153,-3,932,3156,30
13139175448,13139175451,3,114,950,30
13141685955,13141685949,-6,1020,2365,30
13141997990,13141997985,-5,1297,2715,30
13145840405,13145840400,-5,894,2879,30
13147692446,13147692441,-5,725,3330,30
13150171371,13150171366,-5,1373,2753,30
13151128608,13151128610,2,1393,1315,30
13162027591,13162027588,-3,1086,2124,30
13163898926,13163898931,5,1006,979,30
13167578239,13167578234,-5,638,2217,30
13170789334,13170789330,-4,917,2725,30
13177296136,13177296132,-4,1341,3744,30
13179591502,13179591497,-5,1024,2793,30
13185974769,13185974764,-5,1074,2931,30
13189129471,13189129467,-4,757,1982,30
13196298239,13196298234,-5,1506,3742,30
13205406505,13205406500,-5,1556,4223,30
13208047126,13208047121,-5,989,2755,30
13211148110,13211148114,4,1470,1144,30
13220229034,13220229031,-3,670,1726,30
13220301316,13220301311,-5,1265,2292,30
13232198113,13232198109,-4,1271,3805,30
13235843139,13235843134,-5,1019,3065,30
13237281711,13237281709,-2,1161,3291,30
13239713765,13239713767,2,3505,2884,30
13242443135,13242443134,-1,7370,11011,30
13247395199,13247395194,-5,1357,4072,30
13247810378,13247810373,-5,1131,2711,30
13261882378,13261882373,-5,967,2546,30
13263260238,13263260235,-3,1108,2770,30
13267396691,13267396685,-6,941,1747,30
13268270463,13268270459,-4,779,1640,30
13268368138,13268368155,17,1010,2218,30
13270232570,13270232567,-3,1156,2083,30
13272984107,13272984104,-3,526,1363,30
13276111951,13276111948,-3,1134,2568,30
13278853238,13278853230,-8,5189,15137,30
13279631243,13279631237,-6,814,3033,30
13280106492,13280106489,-3,1355,4502,30
13282726167,13282726162,-5,805,2934,30
13285607523,13285607526,3,1500,1065,30
13290149071,13290149067,-4,559,2517,30
13290884376,13290884382,6,12339,2581,30
13293565887,13293565882,-5,974,1792,30
13293971509,13293971503,-6,1263,3465,30
13294906203,13294906200,-3,796,2386,30
13296541163,13296541161,-2,870,2985,30
13296966510,13296966506,-4,1023,2732,30
13300978401,13300978398,-3,1129,3345,30
13301913567,13301913564,-3,1035,2976,30
13303343739,13303343735,-4,1124,3252,30
13306132947,13306132942,-5,870,2982,30
13306928714,13306928701,-13,201,940,30
13310260863,13310260858,-5,796,1888,30
13310369600,13310369587,-13,1320,2253,30
13311186143,13311186139,-4,1499,3663,30
13316781178,13316781175,-3,1614,3452,30
13320439113,13320439111,-2,1237,1386,30
13321207378,13321207375,-3,1085,3014,30
13322017562,13322017558,-4,1414,4060,30
13327034262,13327034260,-2,1668,3105,30
13327112856,13327112859,3,205,728,30
13335689027,13335689021,-6,751,1917,30
13335764651,13335764670,19,124,1141,30
13336028449,13336028457,8,294,1683,30
13344475170,13344475174,4,3212,2585,30
13346541874,13346541869,-5,578,2683,30
13353864142,13353864137,-5,1425,2043,30
13364375867,13364375862,-5,700,1813,30
13368831666,13368831668,2,3308,2468,30
13376881763,13376881758,-5,972,1950,30
13376986790,13376986787,-3,811,2385,30
13379616366,13379616362,-4,918,2972,30
13389814322,13389814320,-2,816,2095,30
13390795962,13390795960,-2,887,1943,30
13391513358,13391513354,-4,1329,2870,30
13397849813,13397849811,-2,863,2108,30
13398091954,13398091950,-4,1152,3334,30
13398509078,13398509073,-5,1060,2560,30
13401596415,13401596414,-1,839,2300,30
13403565707,13403565701,-6,1062,3346,30
13407533741,13407533737,-4,1212,2988,30
13408171597,13408171590,-7,1136,3686,30
13409602342,13409602337,-5,589,1421,30
13411858349,13411858358,9,15257,23973,30
13416797484,13416797480,-4,1296,3543,30
13419243081,13419243076,-5,1124,2932,30
13420883942,13420883942,0,4161,6242,30
13426172400,13426172414,14,664,2773,30
13427608010,13427608005,-5,1053,2945,30
13431892892,13431892888,-4,917,4446,30
13437110693,13437110695,2,19395,25071,30
13439519678,13439519673,-5,2061,7015,30
13442553517,13442553511,-6,877,4128,30
13443588034,13443588054,20,532,1419,30
13444661882,13444661881,-1,2393,3225,30
13445986534,13445986529,-5,1240,4407,30
13451241944,13451241959,15,578,2374,30
13452077646,13452077640,-6,1481,3004,30
13455291630,13455291626,-4,987,2149,30
13455434839,13455434835,-4,750,1559,30
13455553851,13455553835,-16,814,1735,30
13455864482,13455864470,-12,1228,3277,30
13458890611,13458890606,-5,1012,2761,30
13464100838,13464100834,-4,972,2781,30
13464594874,13464594860,-14,182,921,30
13464724250,13464724245,-5,1348,2678,30
13465595273,13465595274,1,2091,1479,30
13466809492,13466809497,5,4793,1320,30
13468718815,13468718810,-5,1297,2725,30
13475411841,13475411837,-4,960,3338,30
13477199327,13477199322,-5,1345,4351,30
13481085869,13481085878,9,1879,753,30
13481464189,13481464193,4,1606,1542,30
13484212741,13484212746,5,2154,1319,30
13486015021,13486015017,-4,341,1269,30
13489534995,13489534990,-5,1144,3500,30
13490973433,13490973429,-4,1566,3467,30
13495693641,13495693646,5,2382,1211,30
13503256069,13503256064,-5,886,2731,30
13513893003,13513892999,-4,1001,3200,30
13514965577,13514965574,-3,1343,3004,30
13525522117,13525522112,-5,917,2078,30
13537631086,13537631080,-6,1287,3566,30
13540156819,13540156814,-5,928,1912,30
13540299548,13540299567,19,744,2171,30
13542731915,13542731909,-6,858,2552,30
13546391835,13546391832,-3,687,2529,30
13551333748,13551333743,-5,1083,2729,30
13554200726,13554200721,-5,1468,2857,30
13556042878,13556042876,-2,564,1323,30
13564470443,13564470439,-4,1188,3079,30
13578506394,13578506389,-5,1234,2725,30
13580572386,13580572385,-1,1213,2494,30
13580975161,13580975157,-4,1329,2856,30
13584694934,13584694930,-4,746,3293,30
13585091590,13585091587,-3,1296,1999,30
13586598478,13586598473,-5,757,2801,30
13587192793,13587192789,-4,1105,2811,30
13590411562,13590411558,-4,995,2948,30
13594055471,13594055466,-5,1141,2452,30
13598711611,13598711609,-2,905,3006,30
13601781944,13601781938,-6,1135,2599,30
13602348102,13602348098,-4,744,2461,30
13607900760,13607900755,-5,3752,10507,30
13611395783,13611395778,-5,1305,3815,30
13612007541,13612007537,-4,1280,4662,30
13617612016,13617612011,-5,738,1911,30
13621011075,13621011071,-4,773,2754,30
13636354279,13636354274,-5,1127,2429,30
13637939259,13637939258,-1,85,914,30
13641668963,13641668959,-4,811,1699,30
13644816686,13644816682,-4,1038,3594,30
13649335872,13649335890,18,659,2965,30
13652846197,13652846191,-6,946,3591,30
13654367802,13654367809,7,7509,2796,30
13659138066,13659138061,-5,1164,3344,30
13661155598,13661155594,-4,634,1613,30
13666248456,13666248452,-4,968,2679,30
13669333907,13669333902,-5,879,1333,30
13670036077,13670036072,-5,1301,2605,30
13670326356,13670326375,19,368,1346,30
13672505433,13672505429,-4,957,3299,30
13672913358,13672913353,-5,1042,4297,30
13675115774,13675115771,-3,806,1924,30
13678792915,13678792918,3,3544,3740,30
13684775320,13684775314,-6,1177,3095,30
13686622880,13686622875,-5,1186,2894,30
13690432393,13690432390,-3,1554,3156,30
13693713505,13693713500,-5,1095,2941,30
13694018525,13694018523,-2,957,1274,30
13699076447,13699076446,-1,1055,2059,30
13702005303,13702005299,-4,1051,2366,30
13708451126,13708451122,-4,1019,3399,30
13708491993,13708491973,-20,1129,3348,30
13710145897,13710145892,-5,1316,3393,30
13716271304,13716271307,3,1502,1214,30
13721694770,13721694772,2,1956,1734,30
13722223073,13722223069,-4,986,2474,30
13722965785,13722965781,-4,1065,2144,30
13727362170,13727362174,4,1385,1238,30
13737918200,13737918213,13,371,1209,30
13738110015,13738109992,-23,2388,1346,30
13741023461,13741023456,-5,634,2598,30
13747487926,13747487922,-4,1021,3309,30
13749552675,13749552692,17,660,2893,30
13754190171,13754190165,-6,921,2497,30
13756344806,13756344801,-5,618,2705,30
13757849182,13757849179,-3,1246,2729,30
13757968002,13757968019,17,537,1849,30
13758094522,13758094515,-7,227,984,30
13758647419,13758647414,-5,1903,3436,30
13759414009,13759414012,3,307,1049,30
13763212289,13763212282,-7,933,2876,30
13764871094,13764871089,-5,802,2989,30
13765497590,13765497585,-5,1465,6513,30
13774107695,13774107686,-9,772,2412,30
13782257990,13782257986,-4,962,3528,30
13784234196,13784234191,-5,1247,3066,30
13785772371,13785772367,-4,867,1567,30
13789934022,13789934017,-5,1280,3073,30
13791974587,13791974582,-5,959,2769,30
13796747810,13796747805,-5,1304,4166,30
13803130456,13803130452,-4,868,1973,30
13807204478,13807204474,-4,1350,2967,30
13812350431,13812350426,-5,1136,3391,30
13813716920,13813716915,-5,1018,2966,30
13824031117,13824031111,-6,819,3506,30
13831155146,13831155143,-3,1171,2908,30
13835891201,13835891204,3,7950,20893,30
13837396587,13837396583,-4,915,3581,30
13839449495,13839449494,-1,785,1659,30
13850513775,13850513770,-5,761,3294,30
13850868420,13850868438,18,1149,3164,30
13857975595,13857975593,-2,959,1864,30
13862954377,13862954373,-4,862,3336,30
13868677846,13868677842,-4,1461,3442,30
13869570626,13869570623,-3,1045,1911,30
13871363338,13871363335,-3,773,2931,30
13872950545,13872950538,-7,1233,3306,30
13876295307,13876295304,-3,1175,2686,30
13878713714,13878713710,-4,721,1995,30
13878777003,13878777006,3,360,1048,30
13885365798,13885365798,0,1120,978,30
13889662518,13889662515,-3,1000,3033,30
13890338614,13890338610,-4,942,2303,30
13892138767,13892138762,-5,951,3526,30
13898686218,13898686217,-1,1589,2284,30
13898996531,13898996528,-3,1033,2204,30
13907200545,13907200545,0,2819,3107,30
13908915407,13908915402,-5,1217,2912,30
13913220971,13913220968,-3,1060,1660,30
13920059708,13920059698,-10,405,31,30
13923819105,13923819113,8,3016,1321,30
13927034442,13927034438,-4,805,2419,30
13928188786,13928188781,-5,931,3189,30
13930765966,13930765962,-4,591,1517,30
13933748613,13933748616,3,932,2076,30
13938184426,13938184421,-5,1039,3076,30
13945694830,13945694834,4,2242,1105,30
13947541187,13947541181,-6,1208,2961,30
13947649259,13947649278,19,618,3768,30
13947774519,13947774522,3,35432,43387,30
13958067064,13958067058,-6,826,2030,30
13960905789,13960905784,-5,975,2883,30
13966802697,13966802697,0,2735,2733,30
13967892703,13967892698,-5,1184,2968,30
13971148575,13971148571,-4,975,2542,30
13971348086,13971348080,-6,857,2948,30
13973088510,13973088506,-4,812,1797,30
13973944466,13973944464,-2,679,1928,30
13975446174,13975446170,-4,869,1929,30
13976255779,13976255773,-6,1186,3305,30
13977349313,13977349309,-4,1389,4399,30
13979500776,13979500757,-19,938,3239,30
13982307231,13982307225,-6,1060,4054,30
13993986674,13993986669,-5,1137,3926,30
13997501373,13997501370,-3,1593,2831,30
13998189093,13998189091,-2,1825,2348,30
13999205266,13999205262,-4,803,1615,30
13999614297,13999614317,20,919,2827,30
14004201631,14004201626,-5,845,2558,30
14009995803,14009995798,-5,938,2567,30
14013217843,14013217838,-5,1216,3044,30
14015308116,14015308113,-3,756,2771,30
14025184425,14025184418,-7,857,3024,30
14025504080,14025504089,9,318,1642,30
14027565531,14027565533,2,1087,1669,30
14028353140,14028353134,-6,769,2610,30
14030618210,14030618206,-4,706,2059,30
14032017978,14032017977,-1,959,1948,30
14033861533,14033861528,-5,1027,3243,30
14037786832,14037786827,-5,823,3200,30
14043125088,14043125086,-2,1475,3003,30
14052249148,14052249142,-6,1070,2026,30
14056309794,14056309789,-5,701,2425,30
14056663255,14056663253,-2,929,2395,30
14061742783,14061742780,-3,687,2462,30
14065595035,14065595029,-6,1165,3515,30
14070951039,14070951035,-4,1162,2663,30
14079041526,14079041522,-4,1121,2321,30
14079563506,14079563503,-3,1305,2319,30
14080984218,14080984212,-6,838,3079,30
14082854090,14082854086,-4,1166,2530,30
14086121018,14086121010,-8,991,2870,30
14086917914,14086917907,-7,1143,3964,30
14088501975,14088501971,-4,1369,3595,30
14089269592,14089269585,-7,845,1904,30
14095433774,14095433774,0,1291,1535,30
14095846330,14095846346,16,210,952,30
14100108625,14100108625,0,978,2277,30
14101725124,14101725118,-6,842,3065,30
14103765299,14103765296,-3,1111,2240,30
14111838366,14111838363,-3,959,2887,30
14120269935,14120269931,-4,796,2933,30
14121098565,14121098559,-6,1429,2913,30
14127011497,14127011493,-4,1178,2212,30
14132245235,14132245233,-2,1369,2532,30
14136895015,14136895009,-6,956,2267,30
14137503145,14137503161,16,888,2896,30
14138729292,14138729295,3,2072,1316,30
14159830329,14159830325,-4,1438,2475,30
14163894265,14163894260,-5,1079,3508,30
14167463867,14167463864,-3,773,2145,30
14171828126,14171828121,-5,712,3819,30
14185228459,14185228457,-2,6503,11466,30
14188529174,14188529169,-5,1437,3337,30
14190516591,14190516587,-4,810,2375,30
14192167967,14192167962,-5,1239,3371,30
14193980303,14193980298,-5,1293,2729,30
14197418541,14197418536,-5,1332,3158,30
14204546162,14204546154,-8,1424,7865,30
14215213118,14215213124,6,9141,41209,30
14216892705,14216892702,-3,969,1825,30
14219385311,14219385307,-4,606,3121,30
14221750739,14221750734,-5,958,3412,30
14223310767,14223310762,-5,769,3126,30
14228473687,14228473682,-5,922,2963,30
14228647811,14228647806,-5,1035,2629,30
14228988916,14228988910,-6,1513,4190,30
14233118847,14233118841,-6,831,1907,30
14237599486,14237599483,-3,1608,3117,30
14247195271,14247195269,-2,881,2392,30
14248555032,14248555026,-6,920,1904,30
14252357206,14252357204,-2,1041,2156,30
14256385058,14256385057,-1,1090,1839,30
14258367605,14258367600,-5,1231,3710,30
14259449402,14259449398,-4,1210,2717,30
14260156419,14260156427,8,273,1528,30
14261655757,14261655751,-6,1079,2645,30
14262407250,14262407245,-5,823,2478,30
14262465457,14262465457,0,1339,1306,30
14265141043,14265141038,-5,1072,3064,30
14270522630,14270522635,5,3290,1559,30
14271511415,14271511411,-4,1149,2402,30
14273574135,14273574133,-2,720,1466,30
14274253112,14274253101,-11,15,1868,30
14274739232,14274739253,21,561,2418,30
14275399449,14275399444,-5,1163,1838,30
14277241358,14277241357,-1,968,1378,30
14278399773,14278399762,-11,3835,13669,30
14293476673,14293476669,-4,2761,5402,30
14294286350,14294286350,0,1294,2464,30
14295228101,14295228098,-3,1024,1960,30
14297023332,14297023326,-6,1098,3378,30
14297776573,14297776576,3,2797,2971,30
14298068597,14298068594,-3,1030,3251,30
14303714667,14303714662,-5,945,1979,30
14305498659,14305498653,-6,991,3430,30
14307073510,14307073506,-4,957,2662,30
14310211764,14310211760,-4,1011,2751,30
14314758710,14314758702,-8,881,4258,30
14315611547,14315611549,2,99,737,30
14318835491,14318835487,-4,731,2583,30
14323084910,14323084909,-1,19352,34130,30
14324015663,14324015659,-4,1125,2534,30
14338065442,14338065439,-3,680,1734,30
14338179421,14338179417,-4,805,2883,30
14344020284,14344020278,-6,1197,3182,30
14344935801,14344935809,8,6176,2428,30
14347863711,14347863704,-7,1231,4247,30
14349287526,14349287517,-9,840,3036,30
14349581554,14349581549,-5,1419,2798,30
14350100399,14350100394,-5,1002,2562,30
14361105202,14361105199,-3,1572,2065,30
14364951126,14364951122,-4,1478,2294,30
14366191001,14366190997,-4,664,2899,30
14370075365,14370075361,-4,897,2351,30
14383099881,14383099875,-6,1020,3786,30
14384623667,14384623686,19,473,1119,30
14386448237,14386448239,2,1961,2210,30
14387021328,14387021347,19,1095,3859,30
14387614941,14387614938,-3,930,2290,30
14388071474,14388071470,-4,1312,3223,30
14390286242,14390286238,-4,631,2558,30
14395642003,14395641991,-12,1114,152,30
14396858114,14396858117,3,1451,1001,30
14407535728,14407535725,-3,1121,2920,30
14408504059,14408504051,-8,951,2749,30
14409592198,14409592193,-5,1265,3377,30
14410713430,14410713426,-4,837,3101,30
14415671183,14415671178,-5,1285,3591,30
14417874014,14417874011,-3,749,2215,30
14425668553,14425668549,-4,938,2310,30
14426939559,14426939555,-4,1126,2513,30
14436412699,14436412695,-4,1225,2995,30
14440930277,14440930271,-6,807,2609,30
14443938063,14443938061,-2,1219,2429,30
14453585397,14453585391,-6,665,2461,30
14457850518,14457850513,-5,1346,4134,30
14458358806,14458358799,-7,1097,2232,30
14463874290,14463874286,-4,1512,3419,30
14467155575,14467155571,-4,898,2484,30
14468480966,14468480962,-4,1280,3541,30
14468797615,14468797609,-6,670,2330,30
14469000436,14469000419,-17,225,1299,30
14475446217,14475446213,-4,1009,2847,30
14479055723,14479055720,-3,1069,2102,30
14480581263,14480581259,-4,1863,3902,30
14480855947,14480855947,0,898,1363,30
14481422482,14481422477,-5,1016,2385,30
14481574665,14481574659,-6,30554,12453,30
14483163673,14483163669,-4,1012,2688,30
14483306788,14483306802,14,844,2969,30
14484601694,14484601688,-6,1018,3219,30
14491383826,14491383823,-3,1678,2655,30
14495152427,14495152422,-5,1254,2962,30
14504963365,14504963357,-8,960,3741,30
14507165653,14507165648,-5,1097,2620,30
14515618159,14515618156,-3,883,1817,30
14526872790,14526872785,-5,1422,2496,30
14528607202,14528607198,-4,587,2806,30
14528895851,14528895851,0,311,1266,30
14529553899,14529553897,-2,1048,2413,30
14531259393,14531259387,-6,1116,2552,30
14538997790,14538997795,5,2604,2115,30
14545115793,14545115791,-2,1452,2022,30
14546229061,14546229056,-5,1121,2357,30
14547958795,14547958802,7,1562,747,30
14559902858,14559902855,-3,771,2457,30
14560357770,14560357772,2,1911,1816,30
14565567386,14565567393,7,3337,1309,30
14567230842,14567230859,17,910,1778,30
14572225415,14572225409,-6,1090,2530,30
14594243656,14594243653,-3,1584,2465,30
14595272086,14595272094,8,4771,1162,30
14601624778,14601624780,2,1600,1627,30
14605357168,14605357185,17,1202,3765,30
14611190266,14611190258,-8,1078,2811,30
14611613121,14611613117,-4,929,3037,30
14611842636,14611842620,-16,50,2187,30
14612460442,14612460447,5,1056,224,30
14613791990,14613791989,-1,992,3129,30
14614912407,14614912418,11,1293,1499,30
14615281974,14615281970,-4,910,2298,30
14624646885,14624646881,-4,1487,3484,30
14628789389,14628789382,-7,1305,3909,30
14632570317,14632570310,-7,24196,16395,30
14640672251,14640672246,-5,947,3191,30
14641462286,14641462282,-4,1172,2470,30
14644807785,14644807782,-3,1579,3311,30
14645950634,14645950642,8,2394,1513,30
14646489594,14646489574,-20,188,702,30
14646603520,14646603510,-10,923,2214,30
14647391856,14647391850,-6,2001,9049,30
14650528322,14650528318,-4,723,3246,30
14651712477,14651712483,6,2027,852,30
14661014622,14661014618,-4,1208,2744,30
14663477723,14663477721,-2,862,1586,30
14665315246,14665315243,-3,1185,2858,30
14667820862,14667820858,-4,931,3931,30
14667856953,14667856949,-4,1063,2951,30
14670947837,14670947833,-4,840,2059,30
14680038186,14680038184,-2,844,2242,30
14680188016,14680188034,18,407,2148,30
14680524018,14680524034,16,829,2575,30
14681684206,14681684203,-3,920,2090,30
14682435171,14682435166,-5,900,2671,30
14684381719,14684381713,-6,833,2967,30
14691316340,14691316345,5,1635,1030,30
14703518974,14703518969,-5,998,2619,30
14706545158,14706545153,-5,611,1583,30
14707902355,14707902350,-5,710,3222,30
14708909018,14708909015,-3,1109,2204,30
14718719841,14718719835,-6,814,2550,30
14725471734,14725471729,-5,1593,4063,30
14729894986,14729894984,-2,1204,3521,30
14739734778,14739734774,-4,1065,3718,30
14740759607,14740759602,-5,916,3292,30
14744771654,14744771651,-3,1434,3919,30
14747247778,14747247785,7,3869,1950,30
14757069431,14757069427,-4,1100,2791,30
14757298459,14757298475,16,160,1033,30
14761622375,14761622378,3,1779,1145,30
14764102171,14764102166,-5,694,2214,30
14764340378,14764340374,-4,1073,2600,30
14766205667,14766205662,-5,1053,2839,30
14775818496,14775818492,-4,1169,2987,30
14777772371,14777772371,0,1158,2274,30
14785830450,14785830447,-3,1501,2068,30
14786537753,14786537734,-19,133,1032,30
14787824707,14787824726,19,910,2418,30
14792800861,14792800853,-8,877,2421,30
14796455315,14796455309,-6,931,3696,30
14800385687,14800385682,-5,1739,3994,30
14801137535,14801137530,-5,1121,2290,30
14807463551,14807463546,-5,658,3573,30
14816423083,14816423078,-5,1174,3239,30
14819722499,14819722495,-4,1195,2970,30
14820799533,14820799534,1,2539,1705,30
14822707191,14822707186,-5,1152,3417,30
14824340556,14824340566,10,237,2881,30
14824543336,14824543357,21,220,1521,30
14828354625,14828354619,-6,1153,3355,30
14829120647,14829120642,-5,977,2933,30
14837437925,14837437920,-5,1340,4544,30
14838515460,14838515454,-6,1066,3072,30
14839259666,14839259661,-5,502,1798,30
14840527383,14840527378,-5,1151,2421,30
14852400865,14852400860,-5,1305,2272,30
14853498494,14853498489,-5,16890,16900,30
14856186853,14856186850,-3,1102,2277,30
14857157881,14857157875,-6,923,2965,30
14859653293,14859653289,-4,907,2291,30
14862181010,14862181006,-4,753,1932,30
14862211033,14862211050,17,579,1257,30
14865140355,14865140350,-5,895,2412,30
14866831253,14866831250,-3,899,2122,30
14872792799,14872792793,-6,983,3143,30
14873687125,14873687120,-5,1109,2505,30
14874245745,14874245742,-3,984,2774,30
14874992954,14874992950,-4,1502,3169,30
14881316500,14881316494,-6,1019,2615,30
14902611194,14902611190,-4,2519,3974,30
14904418977,14904418973,-4,1344,3020,30
14906880536,14906880533,-3,828,2252,30
14908720490,14908720485,-5,1215,3026,30
14913168623,14913168619,-4,691,2426,30
14913702366,14913702361,-5,1369,3317,30
14923464968,14923464963,-5,1045,3514,30
14925539546,14925539542,-4,869,2344,30
14925657841,14925657837,-4,1315,2757,30
14928404661,14928404654,-7,1033,3673,30
14936405577,14936405572,-5,1366,3956,30
14938434887,14938434881,-6,1791,2881,30
14940719677,14940719672,-5,1427,3024,30
14941894445,14941894444,-1,1396,1389,30
14942423111,14942423108,-3,580,1336,30
14942546569,14942546567,-2,618,1616,30
14945224865,14945224862,-3,891,1835,30
14946157300,14946157294,-6,1106,3316,30
14950044987,14950044982,-5,1045,3490,30
14950670929,14950670925,-4,1046,4008,30
14952368574,14952368571,-3,1148,2502,30
14953184223,14953184221,-2,1024,2099,30
14956294346,14956294341,-5,1402,4318,30
14958755959,14958755954,-5,1385,3397,30
14958968679,14958968675,-4,914,1878,30
14963276715,14963276713,-2,1553,2588,30
14964230150,14964230146,-4,877,2889,30
14967176621,14967176619,-2,922,1372,30
14968107591,14968107587,-4,1211,2244,30
14976903305,14976903301,-4,792,1703,30
14979187692,14979187687,-5,1417,7351,30
14981901168,14981901171,3,1594,1772,30
14984176098,14984176094,-4,1327,2299,30
14984964050,14984964047,-3,778,2540,30
14989893790,14989893785,-5,812,2959,30
14990901971,14990901953,-18,1170,2468,30
14992114347,14992114341,-6,1075,2293,30
14994529422,14994529417,-5,1180,3116,30
15001256762,15001256757,-5,995,2976,30
15001475964,15001475958,-6,919,2903,30
15003969324,15003969320,-4,787,2497,30
15007225319,15007225315,-4,509,2437,30
15010552005,15010552002,-3,1533,3150,30
15011091963,15011091958,-5,998,2849,30
15011656801,15011656803,2,6532,4873,30
15013226103,15013226098,-5,1638,5257,30
15019538277,15019538272,-5,664,2793,30
15019790099,15019790093,-6,1084,3889,30
15021930209,15021930205,-4,793,2647,30
15031559194,15031559198,4,1451,1419,30
15032425988,15032425984,-4,1178,2899,30
15033014818,15033014813,-5,1017,2612,30
15034981691,15034981684,-7,688,3115,30
15035113139,15035113153,14,504,1775,30
15038051039,15038051035,-4,721,2207,30
15040554383,15040554379,-4,1084,2041,30
15041073594,15041073590,-4,1198,2116,30
15045428875,15045428879,4,3012,2025,30
15046031818,15046031813,-5,489,1831,30
15046060354,15046060366,12,290,944,30
15047710506,15047710501,-5,1158,2787,30
15049512372,15049512370,-2,1038,1570,30
15049808841,15049808834,-7,212,793,30
15051388513,15051388509,-4,895,3134,30
15053410435,15053410448,13,39209,14705,30
15055267542,15055267538,-4,1068,3312,30
15055600585,15055600580,-5,939,2360,30
15061620802,15061620797,-5,1075,2252,30
15065345620,15065345613,-7,967,3517,30
15066256586,15066256607,21,635,2627,30
15068572626,15068572622,-4,955,3357,30
15069240437,15069240437,0,2257,1923,30
15070062262,15070062263,1,3380,4268,30
15073412883,15073412877,-6,1038,3653,30
15076228938,15076228933,-5,1291,3596,30
15076608797,15076608793,-4,1004,2617,30
15078569206,15078569210,4,734,1474,30
15079114058,15079114079,21,522,1277,30
15082381088,15082381095,7,2505,1275,30
15083218898,15083218894,-4,973,3004,30
15084298970,15084298967,-3,1064,2616,30
15084489164,15084489163,-1,1631,1942,30
15085572486,15085572482,-4,799,2233,30
15085830554,15085830535,-19,915,2420,30
15086332608,15086332625,17,710,2698,30
15086949469,15086949465,-4,1958,7900,30
15089428563,15089428558,-5,1128,2427,30
15090691001,15090690997,-4,1025,2401,30
15093870838,15093870833,-5,880,3146,30
15096892497,15096892494,-3,1116,2524,30
15096963354,15096963353,-1,1116,1601,30
15097067314,15097067310,-4,868,1399,30
15107211987,15107211981,-6,1243,2686,30
15108521518,15108521514,-4,1051,3533,30
15108871553,15108871553,0,1589,2350,30
15109202101,15109202094,-7,1095,3592,30
15109328984,15109328973,-11,1919,10502,30
15113074478,15113074474,-4,1125,1815,30
15119419989,15119419985,-4,1064,2829,30
15120041512,15120041501,-11,1119,3986,30
15121036578,15121036575,-3,250,1008,30
15122588849,15122588866,17,615,1748,30
15123918150,15123918146,-4,1553,3489,30
15124841667,15124841665,-2,1349,1975,30
15127142099,15127142093,-6,828,3339,30
15128473795,15128473790,-5,961,2730,30
15128911290,15128911290,0,168,967,30
15130272381,15130272378,-3,1051,2524,30
15131276386,15131276381,-5,762,2396,30
15133155014,15133155012,-2,1394,2335,30
15134188365,15134188354,-11,5365,15322,30
15137875455,15137875450,-5,1034,2757,30
15138547689,15138547689,0,2923,4551,30
15143229681,15143229677,-4,1072,3143,30
15145085318,15145085315,-3,959,2918,30
15147203975,15147203971,-4,923,3054,30
15150493543,15150493538,-5,1404,2968,30
15150956506,15150956501,-5,1250,2802,30
15151305277,15151305272,-5,1078,3602,30
15152771091,15152771087,-4,782,1907,30
15153609527,15153609521,-6,808,3016,30
15157047713,15157047711,-2,5938,9405,30
15158268983,15158268978,-5,825,2772,30
15159460799,15159460796,-3,907,2358,30
15162953957,15162953967,10,2303,1151,30
15167317923,15167317917,-6,1377,3914,30
15176393573,15176393593,20,1119,2665,30
15177192345,15177192341,-4,914,2539,30
15181362697,15181362693,-4,868,2452,30
15185309457,15185309452,-5,1468,3122,30
15188985609,15188985610,1,1417,1168,30
15190410107,15190410103,-4,1337,3693,30
15191094558,15191094554,-4,1205,3672,30
15192653124,15192653130,6,2281,1336,30
15196416730,15196416725,-5,936,3456,30
15200155654,15200155632,-22,8346,3095,30
15200330743,15200330742,-1,1101,1574,30
15202184700,15202184697,-3,1803,4649,30
15202861860,15202861858,-2,92,1009,30
15205928986,15205928982,-4,1118,2887,30
15211603309,15211603305,-4,895,2657,30
15212091486,15212091481,-5,1263,3372,30
15213011095,15213011093,-2,860,1651,30
15214470448,15214470445,-3,838,1668,30
15216174238,15216174234,-4,1225,2829,30
15219631783,15219631778,-5,1247,3060,30
15226791339,15226791336,-3,1254,2922,30
15231166426,15231166421,-5,1077,3723,30
15235226149,15235226145,-4,1536,2667,30
15237043302,15237043297,-5,1319,2936,30
15247011210,15247011206,-4,951,2011,30
15249428629,15249428623,-6,1291,3641,30
15252065382,15252065377,-5,816,3031,30
15259845120,15259845117,-3,2677,5628,30
15260593638,15260593636,-2,743,1461,30
15263090053,15263090049,-4,1325,2392,30
15265318252,15265318246,-6,1354,4239,30
15267210477,15267210470,-7,1470,2881,30
15268964223,15268964215,-8,639,2914,30
15269948087,15269948082,-5,1115,2039,30
15271401307,15271401305,-2,998,3188,30
15277975536,15277975532,-4,1300,2927,30
15279840921,15279840918,-3,948,1823,30
15282309255,15282309250,-5,1139,3052,30
15283786118,15283786114,-4,872,2854,30
15290160624,15290160624,0,3018,16955,30
15290949518,15290949510,-8,1107,3097,30
15299861863,15299861858,-5,641,2563,30
15307796777,15307796774,-3,790,1848,30
15309637423,15309637430,7,1602,930,30
15311246323,15311246300,-23,1145,1684,30
15314989518,15314989519,1,1234,1892,30
15315695762,15315695757,-5,1039,2703,30
15320496138,15320496133,-5,1005,2859,30
15321761718,15321761710,-8,1579,8262,30
15324135982,15324135976,-6,962,2658,30
15324247411,15324247418,7,329,1268,30
15327859789,15327859784,-5,1056,2796,30
15328183856,15328183845,-11,828,2275,30
15329740325,15329740331,6,67183,30988,30
15331054203,15331054199,-4,1298,3420,30
15333757057,15333757053,-4,1327,2804,30
15334871532,15334871526,-6,1438,3073,30
15334990978,15334990998,20,830,2741,30
15339182563,15339182557,-6,1138,3128,30
15343054258,15343054253,-5,957,2388,30
15344319639,15344319638,-1,897,1162,30
15349299339,15349299334,-5,999,2891,30
15351425677,15351425673,-4,870,1693,30
15352230228,15352230224,-4,901,1584,30
15353310037,15353310030,-7,2755,11645,30
15359602011,15359602011,0,1315,1842,30
15364301163,15364301158,-5,1163,3705,30
15373307619,15373307614,-5,854,2889,30
15374217707,15374217702,-5,930,4410,30
15378562521,15378562514,-7,1337,3829,30
15382559916,15382559911,-5,1162,3171,30
15389891435,15389891430,-5,1068,3186,30
15393480947,15393480942,-5,784,1970,30
15397412885,15397412890,5,3734,1991,30
15398907787,15398907785,-2,698,2053,30
15403413731,15403413730,-1,1670,2013,30
15409763951,15409763945,-6,1182,3513,30
15417066039,15417066034,-5,739,2840,30
15422648668,15422648668,0,1557,2082,30
15423996672,15423996692,20,1304,3675,30
15425906838,15425906835,-3,1121,3297,30
15427769543,15427769538,-5,1135,2892,30
15428310738,15428310736,-2,1428,2706,30
15431264142,15431264127,-15,1891,671,30
15434160094,15434160092,-2,865,2954,30
15436249634,15436249655,21,542,1533,30
15438496947,15438496943,-4,1366,3348,30
15439071100,15439071118,18,952,2166,30
15441008455,15441008449,-6,944,3266,30
15445572046,15445572041,-5,736,3661,30
15455770316,15455770313,-3,824,2766,30
15463909842,15463909836,-6,1152,4271,30
15465366966,15465366960,-6,955,3379,30
15466488021,15466488022,1,725,1757,30
15467607863,15467607857,-6,946,1555,30
15468865098,15468865092,-6,1228,3268,30
15470911063,15470911070,7,4903,1953,30
15472585806,15472585802,-4,1158,3116,30
15474427179,15474427173,-6,1565,4534,30
15474803016,15474803013,-3,380,859,30
15483787763,15483787758,-5,1335,3177,30
15483968066,15483968062,-4,697,2905,30
15483997707,15483997720,13,430,1017,30
15484474406,15484474402,-4,1151,2991,30
15491424333,15491424338,5,3369,1756,30
15491767357,15491767353,-4,1042,2993,30
15492197987,15492198001,14,514,1341,30
15493414023,15493414018,-5,1214,2636,30
15496731073,15496731071,-2,1039,2343,30
15498318169,15498318164,-5,1171,2988,30
15501850608,15501850602,-6,718,2783,30
15503261577,15503261573,-4,966,2804,30
15504535148,15504535141,-7,1155,1899,30
15505495074,15505495057,-17,1024,2855,30
15515877812,15515877809,-3,1533,3242,30
15516286581,15516286574,-7,1098,3141,30
15519131334,15519131330,-4,1324,3510,30
15526891735,15526891730,-5,1082,2974,30
15533699973,15533699969,-4,900,2333,30
15535940451,15535940445,-6,895,2367,30
15540596542,15540596537,-5,722,1392,30
15541956628,15541956621,-7,1611,5641,30
15543519382,15543519378,-4,703,1767,30
15543793336,15543793358,22,1176,3996,30
15550518389,15550518383,-6,1053,2349,30
15557325198,15557325194,-4,512,1046,30
15565703726,15565703719,-7,761,2403,30
15582409032,15582409027,-5,870,3036,30
15583447299,15583447294,-5,925,4175,30
15585937112,15585937107,-5,1356,3201,30
15586946669,15586946674,5,1595,1034,30
15590901177,15590901173,-4,932,2471,30
15594320966,15594320960,-6,1103,3280,30
15598366950,15598366945,-5,842,2599,30
15599887224,15599887220,-4,1114,2435,30
15602550387,15602550385,-2,851,2487,30
15603179177,15603179173,-4,650,2104,30
15605861053,15605861046,-7,956,2563,30
15608253897,15608253893,-4,1567,3133,30
15610097505,15610097492,-13,865,2237,30
15613088474,15613088471,-3,667,1885,30
15615652758,15615652766,8,2591,1177,30
15623736482,15623736478,-4,1245,4982,30
15626897529,15626897523,-6,681,3011,30
15627595097,15627595092,-5,1308,4559,30
15632674385,15632674382,-3,879,1589,30
15632835246,15632835242,-4,734,2242,30
15633496962,15633496957,-5,964,2531,30
15643906118,15643906114,-4,687,1573,30
15651221058,15651221054,-4,1062,2990,30
15651543547,15651543562,15,633,1904,30
15653665483,15653665463,-20,167,1091,30
15655303655,15655303652,-3,1149,2873,30
15656994590,15656994585,-5,782,2600,30
15658012167,15658012165,-2,1029,2294,30
15658482226,15658482222,-4,1103,3038,30
15659240265,15659240281,16,107,785,30
15660571439,15660571434,-5,985,2038,30
15668366330,15668366326,-4,1303,2559,30
15668746611,15668746628,17,1245,3487,30
15674396859,15674396854,-5,825,2695,30
15678164095,15678164091,-4,1291,2795,30
15683899510,15683899504,-6,1157,2310,30
15685112122,15685112126,4,2874,1913,30
15686343629,15686343624,-5,823,2334,30
15688099591,15688099586,-5,1205,3031,30
15697253527,15697253522,-5,1093,2662,30
15697294490,15697294484,-6,1066,2154,30
15700572063,15700572060,-3,1002,2396,30
15703546704,15703546700,-4,1115,3328,30
15704745865,15704745858,-7,1375,3472,30
15707411630,15707411625,-5,933,2889,30
15707792997,15707792997,0,10231,15205,30
15713866246,15713866239,-7,1101,4636,30
15716244014,15716244008,-6,855,2985,30
15732695240,15732695234,-6,1442,4479,30
15733304480,15733304497,17,579,1390,30
15739218705,15739218701,-4,1417,3436,30
15740496673,15740496675,2,2946,2599,30
15741913918,15741913914,-4,1081,3229,30
15751027248,15751027242,-6,1409,2974,30
15758164585,15758164578,-7,732,2348,30
15758598872,15758598868,-4,898,1686,30
15762338550,15762338545,-5,1051,2888,30
15764128570,15764128570,0,1510,1450,30
15764857353,15764857349,-4,1156,3679,30
15768255775,15768255771,-4,941,2743,30
15769244548,15769244563,15,267,564,30
15769466006,15769466002,-4,889,2269,30
15772148362,15772148358,-4,644,1712,30
15774206414,15774206412,-2,1276,2501,30
15776497890,15776497894,4,2679,1383,30
15777983861,15777983857,-4,1034,2772,30
15783969075,15783969073,-2,829,1912,30
15784252875,15784252890,15,880,2407,30
15787735539,15787735534,-5,1299,2654,30
15787972106,15787972105,-1,1357,1534,30
15791911392,15791911388,-4,851,2375,30
15794166533,15794166527,-6,1151,3362,30
15798967989,15798967985,-4,997,2421,30
15799498986,15799499003,17,140,1065,30
15799794138,15799794132,-6,816,2698,30
15800951978,15800951972,-6,1298,3072,30
15804476093,15804476088,-5,1292,2982,30
15806659044,15806659039,-5,1275,3800,30
15813173090,15813173088,-2,1070,2300,30
15813340577,15813340573,-4,498,3077,30
15816038875,15816038869,-6,931,2519,30
15816895938,15816895934,-4,1155,2076,30
15832576886,15832576879,-7,1008,2643,30
15836167506,15836167503,-3,892,3080,30
15836694378,15836694398,20,291,1102,30
15837972261,15837972256,-5,1202,3123,30
15842830653,15842830650,-3,1281,2474,30
15845233574,15845233569,-5,1011,2535,30
15846368338,15846368333,-5,915,3036,30
15850542778,15850542773,-5,950,2405,30
15854259570,15854259565,-5,1177,3061,30
15857266270,15857266267,-3,745,2294,30
15857864827,15857864826,-1,42511,23841,30
15859231726,15859231721,-5,1492,6285,30
15862364427,15862364422,-5,1419,4916,30
15863750126,15863750123,-3,715,1982,30
15869660351,15869660347,-4,856,2492,30
15871083677,15871083671,-6,935,2963,30
15871524926,15871524920,-6,1118,2862,30
15877304483,15877304481,-2,1354,2950,30
15877846210,15877846207,-3,1391,3262,30
15878115835,15878115832,-3,846,2508,30
15878816514,15878816533,19,459,1189,30
15879214210,15879214207,-3,818,2672,30
15879634952,15879634969,17,783,2662,30
15879946893,15879946885,-8,696,2320,30
15880617418,15880617414,-4,1246,2884,30
15880908071,15880908069,-2,824,1789,30
15887524377,15887524374,-3,1152,2883,30
15891588536,15891588533,-3,1233,2610,30
15893994306,15893994302,-4,1150,3648,30
15894496727,15894496727,0,18937,9062,30
15900003415,15900003410,-5,993,3220,30
15903082111,15903082106,-5,1161,2917,30
15911078651,15911078646,-5,1044,3390,30
15912870103,15912870106,3,2340,1721,30
15914676707,15914676701,-6,1086,1973,30
15915198584,15915198600,16,1192,3187,30
15915240217,15915240213,-4,1655,3472,30
15919158986,15919158981,-5,1384,3336,30
15921049586,15921049581,-5,1146,4311,30
15923700673,15923700669,-4,1194,2773,30
15924282409,15924282429,20,777,2347,30
15927443330,15927443325,-5,505,1793,30
15931688697,15931688690,-7,1477,3857,30
15934868093,15934868089,-4,955,2729,30
15938563009,15938563006,-3,1341,3210,30
15938827897,15938827888,-9,106,806,30
15946264081,15946264076,-5,1231,3486,30
15946780298,15946780301,3,1826,1100,30
15954162299,15954162294,-5,557,1420,30
15967679669,15967679665,-4,1616,4806,30
15971724265,15971724260,-5,765,2875,30
15989359503,15989359498,-5,988,3192,30
15990166774,15990166770,-4,976,3464,30
15992562122,15992562117,-5,1395,2790,30
15994476518,15994476516,-2,498,1405,30
15997003738,15997003733,-5,431,1913,30
15997816954,15997816934,-20,17756,41327,30
15998384996,15998384995,-1,2102,2935,30
16000871183,16000871178,-5,1138,3134,30
16000953523,16000953521,-2,2566,4416,30
16001936491,16001936486,-5,1283,3126,30
16002101654,16002101651,-3,392,1213,30
16002413579,16002413598,19,603,1990,30
16007927450,16007927455,5,1822,1404,30
16010655562,16010655562,0,8353,8772,30
16013824953,16013824959,6,3410,2101,30
16014769631,16014769628,-3,887,2689,30
16015366098,16015366117,19,1190,3078,30
16015668159,16015668153,-6,1158,3506,30
16015937410,16015937427,17,1300,3957,30
16017137669,16017137662,-7,546,2355,30
16026442646,16026442642,-4,1005,2566,30
16028664353,16028664350,-3,1297,2417,30
16031159609,16031159606,-3,1106,3413,30
16032895147,16032895142,-5,1022,2721,30
16035499789,16035499786,-3,1037,2902,30
16036521298,16036521298,0,796,1676,30
16038872597,16038872593,-4,1535,3940,30
16040013526,16040013522,-4,21331,9239,30
16041969567,16041969574,7,5511,1864,30
16046372086,16046372091,5,3739,1915,30
16048897327,16048897323,-4,976,3001,30
16049008994,16049008979,-15,133,788,30
16050069970,16050069968,-2,1095,2352,30
16058633324,16058633320,-4,867,2235,30
16062854389,16062854385,-4,1031,3163,30
16063966904,16063966898,-6,1140,3920,30
16064012049,16064012066,17,1223,2898,30
16065383173,16065383167,-6,1096,2764,30
16065909776,16065909769,-7,1133,3268,30
16066514510,16066514506,-4,1276,3322,30
16066819962,16066819957,-5,846,2486,30
16067987766,16067987762,-4,535,1535,30
16070838642,16070838642,0,1380,1705,30
16071263148,16071263144,-4,1035,3169,30
16075255964,16075255960,-4,860,3170,30
16077309686,16077309681,-5,985,3151,30
16077802985,16077802978,-7,1023,3256,30
16079605073,16079605071,-2,1532,2076,30
16080842329,16080842326,-3,1405,3468,30
16086049429,16086049426,-3,967,1940,30
16089511100,16089511097,-3,865,2447,30
16090013977,16090013973,-4,1251,4078,30
16090088514,16090088519,5,8069,22003,30
16091409967,16091409963,-4,838,2964,30
16092364363,16092364358,-5,1297,2292,30
16093687234,16093687227,-7,1424,4989,30
16099998338,16099998339,1,1888,1770,30
16102478753,16102478749,-4,1167,2753,30
16109734556,16109734552,-4,1346,4278,30
16121122811,16121122807,-4,350,1330,30
16123004760,16123004767,7,2389,1666,30
16125611960,16125611955,-5,1231,3307,30
16126053343,16126053341,-2,1294,3778,30
16130434425,16130434420,-5,1165,3476,30
16132145668,16132145662,-6,778,2146,30
16139954403,16139954405,2,7856,17096,30
16143049072,16143049067,-5,1100,2863,30
16150670931,16150670926,-5,901,3442,30
16153908855,16153908858,3,1518,1291,30
16154850281,16154850274,-7,731,3146,30
16155118539,16155118538,-1,688,1191,30
16159144489,16159144494,5,2146,1505,30
16163356003,16163355999,-4,1019,1747,30
16164349857,16164349850,-7,778,3560,30
16177538778,16177538773,-5,1002,2364,30
16178881471,16178881468,-3,993,2148,30
16183337368,16183337367,-1,1766,1781,30
16184496444,16184496439,-5,1082,2299,30
16191684095,16191684098,3,1722,1448,30
16194084410,16194084405,-5,1048,3155,30
16195499042,16195499062,20,706,1932,30
16198214593,16198214576,-17,999,2916,30
16210237910,16210237905,-5,1112,3025,30
16210626779,16210626756,-23,712,2612,30
16218173676,16218173673,-3,665,3698,30
16218676450,16218676441,-9,1294,2956,30
16219312626,16219312622,-4,1452,3656,30
16228043365,16228043370,5,16142,7100,30
16244132482,16244132477,-5,1422,3161,30
16248445489,16248445483,-6,648,2536,30
16254960014,16254960017,3,2400,1477,30
16256934158,16256934152,-6,661,1485,30
16261710753,16261710749,-4,1295,3092,30
16272916574,16272916574,0,1359,1616,30
16274970675,16274970670,-5,776,2767,30
16288666909,16288666903,-6,903,3736,30
16293393998,16293393994,-4,1099,3348,30
16297891343,16297891341,-2,983,2984,30
16300002919,16300002913,-6,1014,2641,30
16300318245,16300318241,-4,893,2723,30
16304171706,16304171702,-4,1284,2952,30
16305480401,16305480397,-4,1413,2584,30
16313175143,16313175138,-5,975,2497,30
16313210585,16313210570,-15,869,3269,30
16317561523,16317561541,18,894,2125,30
16322424238,16322424234,-4,783,3112,30
16325122575,16325122578,3,2291,2537,30
16326099867,16326099861,-6,2004,6674,30
16326591234,16326591230,-4,795,3499,30
16328671335,16328671332,-3,1132,3291,30
16330494167,16330494161,-6,1528,3591,30
16330590091,16330590107,16,1150,3500,30
16341420962,16341420957,-5,968,2897,30
16350283322,16350283318,-4,1352,2697,30
16350325797,16350325792,-5,2662,6678,30
16354952386,16354952382,-4,1060,3126,30
16362778076,16362778071,-5,807,1117,30
16367010467,16367010460,-7,621,1663,30
16375589006,16375589001,-5,955,2868,30
16376628105,16376628101,-4,704,1849,30
16378495134,16378495130,-4,1187,3275,30
16382640822,16382640816,-6,2690,8670,30
16385015982,16385015984,2,52345,80933,30
16390614946,16390614951,5,1614,1194,30
16391016259,16391016255,-4,840,2211,30
16395054486,16395054481,-5,1242,3454,30
16396701050,16396701045,-5,1201,2844,30
16399473955,16399473952,-3,1065,1606,30
16400936057,16400936074,17,775,2120,30
16401206606,16401206601,-5,1338,3006,30
16408478435,16408478432,-3,1012,2256,30
16411402607,16411402602,-5,880,3093,30
16415280657,16415280653,-4,1092,3421,30
16416407267,16416407262,-5,1037,3547,30
16417262086,16417262082,-4,947,2651,30
16428535453,16428535449,-4,1225,2500,30
16429207619,16429207638,19,1409,2160,30
16431786474,16431786476,2,2576,1760,30
16431883606,16431883601,-5,1042,2338,30
16432985990,16432985985,-5,1360,3847,30
16435468356,16435468353,-3,1207,3191,30
16435655057,16435655063,6,3311,1271,30
16435943693,16435943697,4,270,1075,30
16437901361,16437901357,-4,1630,2960,30
16440967098,16440967092,-6,1218,2974,30
16442169521,16442169516,-5,1023,2125,30
16442836920,16442836916,-4,1245,2233,30
16443376242,16443376238,-4,1181,3490,30
16445500070,16445500065,-5,933,3567,30
16445633099,16445633082,-17,1166,3184,30
16447238042,16447238038,-4,891,2950,30
16451007901,16451007894,-7,670,3423,30
16451234242,16451234251,9,56,832,30
16458521374,16458521369,-5,943,2584,30
16459491987,16459491991,4,2483,1432,30
16460197874,16460197873,-1,1735,2333,30
16466263683,16466263682,-1,724,1810,30
16466913086,16466913080,-6,990,3610,30
16467930516,16467930534,18,676,1407,30
16469658729,16469658723,-6,1519,3343,30
16473373163,16473373159,-4,1218,2881,30
16476207922,16476207917,-5,671,1958,30
16481063657,16481063654,-3,839,2852,30
16482918838,16482918841,3,9201,8677,30
16487430239,16487430238,-1,1207,1408,30
16492591606,16492591601,-5,1187,3463,30
16494259877,16494259874,-3,1176,2518,30
16502039219,16502039213,-6,1084,4272,30
16502208058,16502208049,-9,1115,3760,30
16503083422,16503083417,-5,1465,3323,30
16504082879,16504082873,-6,1079,3217,30
16504381320,16504381325,5,2930,1680,30
16508966722,16508966714,-8,699,2448,30
16509302408,16509302427,19,613,1754,30
16509609132,16509609130,-2,2665,4175,30
16511593901,16511593903,2,1107,1650,30
16512990633,16512990641,8,13861,37472,30
16513385958,16513385962,4,1508,1120,30
16514582068,16514582062,-6,862,3541,30
16515988584,16515988565,-19,806,2474,30
16519926842,16519926837,-5,912,4572,30
16523233395,16523233390,-5,628,1227,30
16531043259,16531043253,-6,973,2721,30
16534610218,16534610213,-5,1220,2418,30
16555069933,16555069929,-4,1583,2968,30
16556916561,16556916558,-3,1216,2993,30
16570533638,16570533654,16,884,2123,30
16570991126,16570991123,-3,1055,1994,30
16578124114,16578124109,-5,1030,2680,30
16578398087,16578398084,-3,985,3434,30
16578907243,16578907262,19,270,1078,30
16580331326,16580331320,-6,1194,2991,30
16581895805,16581895803,-2,2620,4290,30
16581978550,16581978545,-5,911,1642,30
16583421086,16583421082,-4,1089,2920,30
16586611271,16586611266,-5,863,2930,30
16587921092,16587921089,-3,1715,3951,30
16589144154,16589144148,-6,1301,4400,30
16589680727,16589680722,-5,739,2095,30
16597816561,16597816558,-3,693,2614,30
16603819898,16603819896,-2,707,1806,30
16605715905,16605715902,-3,759,2267,30
16607529223,16607529219,-4,866,3250,30
16612979846,16612979843,-3,896,2483,30
16615521811,16615521806,-5,1908,4576,30
16619245225,16619245219,-6,1027,2942,30
16626471998,16626471994,-4,1113,3335,30
16626891490,16626891510,20,180,932,30
16628821078,16628821074,-4,1132,3019,30
16635256611,16635256611,0,2374,3262,30
16637312003,16637311998,-5,1381,3380,30
16640367043,16640367049,6,2858,1291,30
16642074519,16642074513,-6,1376,4401,30
16642264736,16642264732,-4,781,1948,30
16642365083,16642365073,-10,1112,2016,30
16642432352,16642432374,22,369,1852,30
16644615662,16644615657,-5,778,3508,30
16647108226,16647108218,-8,587,3404,30
16651016190,16651016185,-5,1275,2115,30
16657802983,16657802980,-3,1055,3269,30
16659041916,16659041911,-5,1142,3569,30
16666783597,16666783593,-4,1070,3140,30
16670956719,16670956714,-5,1304,3799,30
16674525293,16674525287,-6,1169,3126,30
16676645352,16676645349,-3,31693,12736,30
16679303203,16679303190,-13,284,1077,30
16680558821,16680558818,-3,1178,2216,30
16682534251,16682534245,-6,622,2288,30
16682904306,16682904322,16,819,2134,30
16683464003,16683463999,-4,1105,2764,30
16685734014,16685734009,-5,928,2516,30
16689615377,16689615378,1,1659,1702,30
16689994123,16689994138,15,904,2687,30
16698603068,16698603063,-5,966,2860,30
16699010967,16699010963,-4,1176,3298,30
16703049160,16703049156,-4,1654,3553,30
16704766259,16704766253,-6,1038,4470,30
16705544171,16705544173,2,110,780,30
16706435096,16706435077,-19,979,2670,30
16707033220,16707033217,-3,605,2160,30
16711755770,16711755766,-4,1583,3709,30
16713553226,16713553221,-5,976,4018,30
16716894943,16716894939,-4,1390,3819,30
16717166033,16717166035,2,1889,1518,30
16724920905,16724920900,-5,898,3035,30
16725788672,16725788679,7,222,969,30
16727730913,16727730915,2,1032,1206,30
16730468717,16730468711,-6,1058,2474,30
16739897772,16739897768,-4,1194,2403,30
16742464369,16742464366,-3,975,2883,30
16745024673,16745024654,-19,24505,43950,30
16745548209,16745548206,-3,842,2488,30
16752714619,16752714626,7,1973,1039,30
16757069494,16757069490,-4,883,1974,30
16761021187,16761021181,-6,891,2351,30
16764812794,16764812790,-4,1083,3201,30
16769832642,16769832637,-5,887,4173,30
16774027390,16774027384,-6,921,4329,30
16774084194,16774084189,-5,272,1765,30
16774908089,16774908083,-6,852,2715,30
16775574241,16775574237,-4,744,2567,30
16777071327,16777071325,-2,679,2084,30
16780953586,16780953587,1,1423,1559,30
16782042628,16782042624,-4,1239,2708,30
16787563002,16787562997,-5,1571,3326,30
16789418563,16789418557,-6,1011,4426,30
16795183782,16795183782,0,1542,1563,30
16797732613,16797732608,-5,1423,3017,30
16799917241,16799917246,5,2081,1056,30
16802231483,16802231478,-5,1188,2977,30
16804326242,16804326237,-5,1192,3094,30
16809412175,16809412172,-3,951,2146,30
16817079210,16817079206,-4,1423,3052,30
16822015959,16822015955,-4,1161,2727,30
16822905746,16822905741,-5,1203,2588,30
16823767670,16823767667,-3,1515,2033,30
16830166758,16830166752,-6,1039,2976,30
16833906569,16833906563,-6,1112,2783,30
16838959719,16838959715,-4,1201,2722,30
16854572835,16854572830,-5,832,3211,30
16854620763,16854620783,20,864,2190,30
16855914161,16855914155,-6,819,2455,30
16861105435,16861105431,-4,1069,1602,30
16863979626,16863979622,-4,1354,3376,30
16864702658,16864702655,-3,1204,3196,30
16879892717,16879892713,-4,770,2165,30
16885895221,16885895217,-4,1044,2566,30
16887910314,16887910315,1,1493,1766,30
16888127351,16888127345,-6,1062,3851,30
16889118127,16889118122,-5,865,2566,30
16890669401,16890669396,-5,1129,2875,30
16891456283,16891456278,-5,1232,1792,30
16896456667,16896456665,-2,776,1542,30
16896535123,16896535103,-20,821,2648,30
16898689591,16898689590,-1,1239,2572,30
16900664949,16900664944,-5,1312,2548,30
16900776426,16900776445,19,762,1985,30
16901533371,16901533366,-5,895,3403,30
16906208418,16906208413,-5,1267,3142,30
16908148807,16908148803,-4,860,2531,30
16915315202,16915315197,-5,852,1904,30
16916310254,16916310249,-5,1180,3220,30
16918683290,16918683288,-2,1343,1677,30
16919182277,16919182273,-4,1472,3819,30
16929593246,16929593241,-5,1132,5165,30
16930354832,16930354818,-14,1247,4092,30
16930574744,16930574741,-3,234,1269,30
16934697507,16934697502,-5,1081,3515,30
16935512860,16935512854,-6,1149,3970,30
16935764117,16935764115,-2,1165,1764,30
16939422677,16939422671,-6,1011,3147,30
16943174083,16943174088,5,3376,1644,30
16948838068,16948838064,-4,1325,2367,30
16951563921,16951563917,-4,960,3213,30
16952310486,16952310482,-4,917,2741,30
16954570807,16954570801,-6,885,1264,30
16959363474,16959363478,4,2353,1496,30
16962225293,16962225289,-4,1129,2361,30
16962376418,16962376406,-12,944,2768,30
16965132881,16965132886,5,2089,1503,30
16979762659,16979762653,-6,919,3249,30
16980516399,16980516395,-4,984,2227,30
16987653573,16987653568,-5,1079,2747,30
16987969713,16987969707,-6,1272,3708,30
16989242546,16989242547,1,2574,2724,30
16990203095,16990203093,-2,1144,4122,30
16991586328,16991586323,-5,1194,3703,30
16992071200,16992071214,14,347,1419,30
17003879607,17003879603,-4,885,3123,30
17004544323,17004544316,-7,1075,2691,30
17008247398,17008247394,-4,981,2784,30
17014325332,17014325329,-3,1042,1892,30
17015491736,17015491729,-7,1311,3491,30
17024183440,17024183434,-6,992,3501,30
17027546184,17027546181,-3,1055,3306,30
17030584385,17030584379,-6,1097,2415,30
17035483241,17035483236,-5,749,2282,30
17035651124,17035651117,-7,1321,2686,30
17038178582,17038178577,-5,941,2898,30
17038285933,17038285929,-4,1244,2438,30
17042544951,17042544946,-5,665,3617,30
17045958150,17045958148,-2,1192,2099,30
17053120280,17053120277,-3,670,2550,30
17061920922,17061920917,-5,985,2732,30
17066212462,17066212458,-4,821,1780,30
17066381012,17066381025,13,282,1446,30
17067237738,17067237733,-5,1080,2541,30
17073432403,17073432399,-4,1013,2941,30
17074224427,17074224418,-9,825,1954,30
17074694033,17074694048,15,896,1984,30
17075040008,17075040027,19,940,1921,30
17075929443,17075929439,-4,857,2491,30
17075963218,17075963214,-4,1161,1714,30
17079859627,17079859622,-5,1116,2656,30
17080131771,17080131767,-4,880,2591,30
17094534634,17094534632,-2,918,2657,30
17099299077,17099299083,6,2181,1302,30
17100751133,17100751136,3,29031,21708,30
17100883791,17100883785,-6,828,3511,30
17101133172,17101133185,13,539,2401,30
17101542733,17101542729,-4,1289,3380,30
17102441685,17102441707,22,612,1238,30
17102609744,17102609741,-3,1032,2168,30
17108414686,17108414681,-5,814,3325,30
17111977559,17111977554,-5,1021,2050,30
17117304387,17117304384,-3,1505,3589,30
17131390867,17131390863,-4,703,2382,30
17132355442,17132355437,-5,812,2444,30
17137839518,17137839512,-6,1019,3011,30
17138720638,17138720637,-1,9261,11493,30
17151222656,17151222654,-2,1177,1998,30
17152005033,17152005026,-7,1129,2936,30
17152824718,17152824714,-4,898,2323,30
17153358710,17153358705,-5,1300,2728,30
17155661146,17155661143,-3,42194,17559,30
17156438671,17156438669,-2,931,1988,30
17166770631,17166770626,-5,1153,3379,30
17167669657,17167669653,-4,867,2747,30
17169612290,17169612271,-19,1548,4086,30
17170688054,17170688050,-4,707,2334,30
17174866954,17174866950,-4,962,2694,30
17178938921,17178938918,-3,2267,2621,30
17179192502,17179192498,-4,1079,2183,30
17185637520,17185637514,-6,1060,3364,30
17186195880,17186195861,-19,987,2901,30
17191431472,17191431472,0,1367,2497,30
17192444258,17192444253,-5,745,2510,30
17193072505,17193072525,20,712,1837,30
17193807160,17193807167,7,3063,1384,30
17198320250,17198320247,-3,1048,3397,30
17200929036,17200929029,-7,1064,3039,30
17203836886,17203836881,-5,767,2779,30
17204972200,17204972218,18,273,743,30
17212705823,17212705818,-5,769,2082,30
17213711376,17213711371,-5,734,2818,30
17224289386,17224289379,-7,759,3339,30
17230384703,17230384699,-4,784,1712,30
17231934930,17231934926,-4,1002,2471,30
17238411266,17238411262,-4,1185,2859,30
17240620930,17240620926,-4,1167,2494,30
17241460972,17241460966,-6,916,2511,30
17243905738,17243905735,-3,961,2647,30
17244232646,17244232643,-3,1159,1978,30
17247406247,17247406241,-6,1717,6586,30
17251226986,17251226981,-5,980,3834,30
17252015423,17252015420,-3,1261,2355,30
17252198611,17252198607,-4,774,2716,30
17252233577,17252233598,21,739,2734,30
17253837384,17253837385,1,1900,2160,30
17260237097,17260237092,-5,663,1618,30
17267967128,17267967122,-6,979,2730,30
17277764959,17277764954,-5,2698,8475,30
17280323632,17280323628,-4,880,2780,30
17281761835,17281761822,-13,60,1380,30
17284835898,17284835894,-4,1238,3013,30
17285795211,17285795207,-4,996,2110,30
17286229719,17286229726,7,8910,25959,30
17288479429,17288479426,-3,1306,3038,30
17290886894,17290886889,-5,884,3135,30
17295781167,17295781163,-4,1476,2881,30
17296133796,17296133812,16,901,2850,30
17299041236,17299041233,-3,961,2497,30
17300487495,17300487490,-5,1457,3478,30
17303477135,17303477130,-5,1053,2806,30
17304431301,17304431297,-4,1243,3446,30
17305578269,17305578264,-5,1102,2715,30
17306091403,17306091402,-1,1499,2257,30
17309865065,17309865059,-6,969,2351,30
17311396310,17311396306,-4,734,2914,30
17311599446,17311599443,-3,26379,10262,30
17317035489,17317035483,-6,1074,3868,30
17317834863,17317834859,-4,844,2112,30
17318789410,17318789395,-15,870,2327,30
17319235354,17319235374,20,117,1031,30
17320029885,17320029903,18,678,2169,30
17324978955,17324978950,-5,1129,2920,30
17336855543,17336855540,-3,1268,2845,30
17342888687,17342888682,-5,895,3840,30
17342937138,17342937134,-4,755,2789,30
17343199577,17343199562,-15,920,2292,30
17347666567,17347666564,-3,1064,2606,30
17351862950,17351862947,-3,788,1363,30
17356651231,17356651224,-7,502,1192,30
17358658667,17358658662,-5,906,2749,30
17360983162,17360983169,7,1697,985,30
17362439994,17362439990,-4,993,1409,30
17372669463,17372669465,2,3603,3735,30
17374478814,17374478809,-5,763,2750,30
17375667278,17375667272,-6,778,3155,30
17376047458,17376047439,-19,257,1088,30
17376684315,17376684311,-4,909,3878,30
17382180147,17382180144,-3,785,2471,30
17382611640,17382611630,-10,1251,2672,30
17385066474,17385066478,4,986,1039,30
17386556051,17386556047,-4,641,2723,30
17388488063,17388488058,-5,741,2407,30
17390353142,17390353138,-4,888,2309,30
17390400729,17390400722,-7,1062,2909,30
17390697039,17390697036,-3,1526,4217,30
17393103979,17393103974,-5,1175,3811,30
17394559959,17394559957,-2,1021,3203,30
17398595664,17398595682,18,1281,1872,30
17405423279,17405423274,-5,1292,2997,30
17407516790,17407516785,-5,1152,3546,30
17407634713,17407634709,-4,864,2806,30
17412037577,17412037570,-7,1211,2569,30
17422753260,17422753255,-5,1120,2947,30
17423042723,17423042702,-21,830,2015,30
17424406282,17424406262,-20,1122,3288,30
17428918392,17428918386,-6,971,3192,30
17429117135,17429117132,-3,783,2733,30
17436103425,17436103422,-3,950,2705,30
17436176954,17436176949,-5,698,2149,30
17438282547,17438282526,-21,253,1830,30
17439990557,17439990554,-3,1239,2941,30
17442336125,17442336122,-3,1192,2474,30
17446030390,17446030385,-5,1542,3543,30
17446182703,17446182698,-5,1137,2781,30
17451255266,17451255258,-8,509,243,30
17456860489,17456860486,-3,1332,2995,30
17458843257,17458843254,-3,926,3272,30
17460407789,17460407785,-4,1054,2919,30
17460677428,17460677441,13,479,1982,30
17461638329,17461638327,-2,1138,2828,30
17461675074,17461675095,21,1261,1899,30
17462729009,17462729009,0,1720,2120,30
17467725492,17467725498,6,22355,33645,30
17471302240,17471302237,-3,674,2393,30
17473674682,17473674680,-2,1585,2181,30
17476183378,17476183370,-8,847,2335,30
17481043322,17481043317,-5,1104,2397,30
17482038414,17482038412,-2,1149,3236,30
17487233228,17487233208,-20,1374,3387,30
17488941731,17488941726,-5,837,2042,30
17491489062,17491489058,-4,796,2157,30
17492406689,17492406685,-4,1170,2666,30
17504176871,17504176868,-3,1188,3400,30
17504249470,17504249466,-4,1206,2865,30
17505017393,17505017407,14,763,2367,30
17505282674,17505282688,14,839,1583,30
17505701822,17505701818,-4,857,2607,30
17510915314,17510915314,0,2284,2915,30
17511785437,17511785431,-6,1002,3013,30
17512737923,17512737943,20,630,2542,30
17515062925,17515062921,-4,730,2376,30
17516985233,17516985229,-4,1208,2147,30
17517425178,17517425198,20,583,1838,30
17523864970,17523864958,-12,122,879,30
17524452719,17524452716,-3,1269,3470,30
17524977555,17524977550,-5,1315,5328,30
17525689107,17525689102,-5,1038,3123,30
17526015606,17526015602,-4,1177,2665,30
17531933180,17531933194,14,656,847,30
17537063034,17537063031,-3,569,2093,30
17541221586,17541221581,-5,907,2974,30
17546112787,17546112786,-1,1400,1816,30
17546458890,17546458885,-5,950,2699,30
17547141295,17547141287,-8,821,2703,30
17549287717,17549287713,-4,842,3145,30
17549589276,17549589293,17,962,2930,30
17552046122,17552046117,-5,1133,2635,30
17552158043,17552158038,-5,870,2469,30
17554494979,17554494975,-4,1258,3116,30
17554962377,17554962374,-3,763,1373,30
17562135866,17562135860,-6,1211,3086,30
17562691162,17562691158,-4,1009,1895,30
17569469310,17569469305,-5,1111,2717,30
17573189062,17573189058,-4,859,2290,30
17580324283,17580324279,-4,933,3098,30
17583070176,17583070170,-6,1123,3552,30
17588034413,17588034410,-3,760,2110,30
17588061265,17588061255,-10,993,4079,30
17591284118,17591284115,-3,1393,2315,30
17596868605,17596868599,-6,1132,2959,30
17597759664,17597759660,-4,1057,2443,30
17603946558,17603946553,-5,753,2840,30
17604647843,17604647842,-1,1692,3074,30
17611124794,17611124788,-6,800,2791,30
17614148382,17614148378,-4,6450,12066,30
17616285931,17616285926,-5,1184,2593,30
17622883845,17622883838,-7,674,1976,30
17623154168,17623154158,-10,531,3747,30
17623316913,17623316934,21,787,1685,30
17635051133,17635051133,0,1515,1792,30
17641335743,17641335738,-5,765,1878,30
17645768891,17645768886,-5,1005,3176,30
17645854355,17645854358,3,110,1184,30
17649127470,17649127467,-3,700,1990,30
17650067746,17650067741,-5,1323,3360,30
17650653552,17650653558,6,1765,1149,30
17655954319,17655954317,-2,997,1817,30
17656832203,17656832197,-6,1208,2422,30
17659578853,17659578849,-4,844,2937,30
17660633714,17660633710,-4,1225,2908,30
17660964203,17660964196,-7,1372,5675,30
17665358226,17665358221,-5,889,1851,30
17666884586,17666884586,0,10258,15070,30
17668584901,17668584896,-5,1000,4917,30
17669816771,17669816766,-5,600,1758,30
17676918538,17676918542,4,2271,1657,30
17677236445,17677236430,-15,1040,3889,30
17682146031,17682146026,-5,767,3002,30
17683936034,17683936029,-5,752,1875,30
17686309403,17686309399,-4,580,1608,30
17689050766,17689050762,-4,863,3456,30
17689938318,17689938311,-7,1098,2994,30
17690582508,17690582512,4,2622,1698,30
17693287668,17693287648,-20,569,500,30
17694420922,17694420939,17,298,1430,30
17700477050,17700477043,-7,528,3947,30
17704284814,17704284812,-2,970,2242,30
17704421010,17704421007,-3,1020,2087,30
17704633340,17704633335,-5,945,3403,30
17705518031,17705518030,-1,488,1265,30
17715231307,17715231307,0,2238,2892,30
17716609460,17716609458,-2,22650,10677,30
17717553912,17717553908,-4,1696,3707,30
17718101866,17718101863,-3,1114,3330,30
17724776914,17724776912,-2,1325,3103,30
17726955514,17726955524,10,1722,1229,30
17727121537,17727121540,3,1512,1960,30
17740404123,17740404121,-2,1160,2123,30
17748085618,17748085614,-4,1075,2709,30
17748197820,17748197802,-18,813,1745,30
17748455107,17748455102,-5,869,2487,30
17752082354,17752082350,-4,31108,12327,30
17752233999,17752233995,-4,1059,1896,30
17754852258,17754852253,-5,937,2465,30
17762793845,17762793843,-2,1354,2498,30
17764195564,17764195559,-5,1182,3825,30
17765083478,17765083474,-4,924,2979,30
17770019586,17770019584,-2,1032,1636,30
17771991389,17771991386,-3,1031,2008,30
17773022422,17773022417,-5,949,2594,30
17791478566,17791478561,-5,997,2676,30
17793012777,17793012772,-5,737,2669,30
17797658705,17797658698,-7,1350,3487,30
17802053976,17802053971,-5,899,2493,30
17804366078,17804366076,-2,848,1895,30
17807947256,17807947250,-6,1323,5572,30
17808271860,17808271873,13,791,2297,30
17808508235,17808508229,-6,869,2357,30
17808996515,17808996513,-2,664,1947,30
17809642418,17809642422,4,1457,1522,30
17811037762,17811037757,-5,971,3636,30
17812921135,17812921130,-5,950,3579,30
17817188861,17817188857,-4,794,2709,30
17819119261,17819119258,-3,1599,2456,30
17820720403,17820720401,-2,876,2691,30
17821055138,17821055134,-4,1211,2519,30
17827269518,17827269514,-4,875,2989,30
17834967351,17834967346,-5,604,1704,30
17835982369,17835982365,-4,1222,3408,30
17844429019,17844429016,-3,1292,3148,30
17849360598,17849360594,-4,972,2746,30
17850280309,17850280317,8,3904,3061,30
17851200142,17851200142,0,2091,2365,30
17851674543,17851674538,-5,845,2119,30
17852580295,17852580290,-5,943,3028,30
17857824854,17857824849,-5,1263,2061,30
17865017610,17865017605,-5,1522,3460,30
17867363215,17867363209,-6,1006,2761,30
17869403143,17869403137,-6,804,2738,30
17870414570,17870414565,-5,1578,4329,30
17872767663,17872767659,-4,810,1863,30
17872814289,17872814281,-8,1073,3001,30
17875815189,17875815194,5,3759,1821,30
17879458649,17879458645,-4,1058,2417,30
17888498753,17888498753,0,7571,13026,30
17893571767,17893571763,-4,1062,3547,30
17902196206,17902196210,4,3764,2729,30
17903607586,17903607582,-4,767,2020,30
17905362523,17905362519,-4,1135,2009,30
17906645077,17906645072,-5,916,2607,30
17908795642,17908795639,-3,974,2754,30
17909500699,17909500698,-1,1069,2042,30
17909711641,17909711638,-3,724,2511,30
17919117474,17919117470,-4,926,2189,30
17922248624,17922248618,-6,1395,2758,30
17931477178,17931477170,-8,1026,2077,30
17931858985,17931858978,-7,729,3564,30
17933473986,17933473981,-5,1376,4363,30
17935863210,17935863214,4,9041,6224,30
17939922194,17939922190,-4,728,2346,30
17944331653,17944331653,0,35856,22354,30
17944765650,17944765642,-8,26708,12570,30
17959073670,17959073664,-6,1085,3758,30
17960610991,17960610988,-3,1402,2978,30
17970068070,17970068064,-6,1072,3081,30
17971930088,17971930085,-3,994,2305,30
17973263788,17973263811,23,1296,1223,30
17973852314,17973852313,-1,994,155,30
17984577892,17984577895,3,1884,1628,30
17984638662,17984638657,-5,1092,2986,30
17985479847,17985479841,-6,898,4744,30
17988765611,17988765606,-5,1195,3262,30
17999088250,17999088244,-6,1199,3791,30
18004509754,18004509749,-5,1201,1762,30
18010453525,18010453519,-6,697,1531,30
18011023040,18011023025,-15,664,2408,30
18012399970,18012399962,-8,933,2807,30
18013489067,18013489062,-5,609,2643,30
18013685550,18013685542,-8,967,3789,30
18014867882,18014867878,-4,1160,3555,30
18016962986,18016962979,-7,915,4597,30
18017530468,18017530483,15,819,1891,30
18019647377,18019647374,-3,1043,3247,30
18029162591,18029162587,-4,995,2030,30
18034158102,18034158099,-3,1184,3032,30
18045708261,18045708256,-5,1238,2309,30
18046465102,18046465101,-1,1277,2763,30
18047043740,18047043735,-5,784,1950,30
18050498959,18050498954,-5,216,1790,30
18058908620,18058908624,4,2093,1916,30
18062162977,18062162974,-3,1623,4341,30
18063053786,18063053791,5,1832,1212,30
18067078942,18067078938,-4,967,2398,30
18068828743,18068828742,-1,1004,1236,30
18074155089,18074155085,-4,865,3291,30
18075192443,18075192438,-5,1254,2017,30
18080887772,18080887754,-18,3520,3203,30
18081362183,18081362178,-5,1041,3722,30
18085029226,18085029232,6,3648,1462,30
18090369863,18090369858,-5,884,2498,30
18116323533,18116323529,-4,1397,4256,30
18118907108,18118907125,17,919,2697,30
18121166287,18121166290,3,1980,1717,30
18121465935,18121465930,-5,1179,3898,30
18125140670,18125140666,-4,1149,2265,30
18132817902,18132817910,8,3689,1876,30
18134873583,18134873578,-5,1226,3071,30
18140638813,18140638813,0,1064,1177,30
18141622111,18141622106,-5,1013,2768,30
18141745922,18141745936,14,646,1483,30
18142892502,18142892498,-4,1038,3115,30
18143710106,18143710123,17,771,3130,30
18145496083,18145496078,-5,1428,2805,30
18145851005,18145850999,-6,3429,12119,30
18150215410,18150215405,-5,897,3778,30
18153291621,18153291617,-4,1038,2466,30
18163901694,18163901691,-3,878,2010,30
18168131608,18168131604,-4,1277,3617,30
18171227420,18171227425,5,2047,1252,30
18180780739,18180780737,-2,854,1693,30
18182248571,18182248565,-6,652,3538,30
18192709634,18192709629,-5,975,2172,30
18197525623,18197525626,3,3151,2497,30
18198262518,18198262515,-3,1215,2910,30
18201670238,18201670233,-5,1247,2788,30
18206151903,18206151900,-3,1107,2086,30
18207589745,18207589740,-5,1257,3260,30
18210004193,18210004188,-5,1382,2824,30
18213474653,18213474649,-4,1515,3678,30
18214053307,18214053302,-5,2006,3204,30
18215955834,18215955836,2,2739,2294,30
18215987939,18215987932,-7,740,1787,30
18217727870,18217727866,-4,1001,2268,30
18218824751,18218824746,-5,866,2159,30
18218918082,18218918063,-19,1032,1605,30
18221324846,18221324841,-5,944,2761,30
18222338078,18222338074,-4,898,3125,30
18225429608,18225429606,-2,1045,2099,30
18227651537,18227651559,22,67,1232,30
18228899559,18228899555,-4,815,1933,30
18230221214,18230221209,-5,1119,3453,30
18231833791,18231833786,-5,1130,2608,30
18233315010,18233315006,-4,1562,3364,30
18234999438,18234999434,-4,528,1111,30
18238474071,18238474067,-4,949,2383,30
18242005449,18242005444,-5,37058,18347,30
18243734606,18243734602,-4,1141,2857,30
18244950618,18244950614,-4,1304,2586,30
18247983491,18247983487,-4,728,2546,30
18251361812,18251361812,0,14293,18635,30
18252612843,18252612838,-5,1132,3081,30
18252663410,18252663425,15,480,1972,30
18256747366,18256747361,-5,1327,2350,30
18261439682,18261439676,-6,698,3786,30
18262787126,18262787122,-4,1251,3751,30
18262841385,18262841405,20,709,1247,30
18268728375,18268728370,-5,1079,3435,30
18272451273,18272451269,-4,1084,2353,30
18272960627,18272960645,18,572,1745,30
18278593553,18278593549,-4,1266,2566,30
18285735779,18285735777,-2,1328,2629,30
18286803753,18286803747,-6,1045,2370,30
18295203254,18295203251,-3,1284,2237,30
18305385149,18305385142,-7,685,2170,30
18308264538,18308264549,11,10679,41993,30
18311928666,18311928661,-5,905,2437,30
18312313065,18312313060,-5,1034,2787,30
18315848738,18315848732,-6,959,3254,30
18323571268,18323571265,-3,763,2315,30
18329410860,18329410857,-3,1263,2704,30
18332040498,18332040494,-4,949,3353,30
18334844551,18334844547,-4,1014,2196,30
18345283694,18345283690,-4,1511,3524,30
18348353139,18348353134,-5,1487,3773,30
18349930767,18349930763,-4,635,2619,30
18351560227,18351560223,-4,804,2259,30
18351976506,18351976527,21,41,962,30
18352010578,18352010594,16,830,3078,30
18358828416,18358828413,-3,567,1963,30
18359243737,18359243758,21,1058,2184,30
18364639495,18364639490,-5,1354,2896,30
18364677723,18364677734,11,171,1527,30
18365318345,18365318341,-4,1343,2694,30
18365540070,18365540066,-4,1629,4105,30
18371575926,18371575922,-4,650,3416,30
18371767129,18371767123,-6,233,3410,30
18371940722,18371940742,20,678,2224,30
18372116225,18372116218,-7,1145,3018,30
18373068510,18373068518,8,3989,1484,30
18376699695,18376699693,-2,859,1927,30
18379129242,18379129243,1,3659,3937,30
18382166091,18382166094,3,1565,2021,30
18387734955,18387734950,-5,1078,1712,30
18394319535,18394319542,7,6199,2525,30
18396721971,18396721965,-6,800,2105,30
18396862201,18396862218,17,1057,2808,30
18399174858,18399174853,-5,845,2115,30
18400656034,18400656032,-2,964,2642,30
18411947974,18411947969,-5,1157,2568,30
18417712771,18417712767,-4,1395,3345,30
18418048752,18418048747,-5,1005,3199,30
18418421234,18418421235,1,1215,1447,30
18421429094,18421429090,-4,1008,3177,30
18425365173,18425365177,4,2782,1606,30
18425980958,18425980951,-7,1262,4207,30
18426884435,18426884455,20,696,2079,30
18434108953,18434108950,-3,767,2619,30
18434494457,18434494455,-2,3056,3807,30
18435936615,18435936612,-3,891,2573,30
18436387937,18436387933,-4,974,3187,30
18437532839,18437532834,-5,1782,5146,30
18441491065,18441491061,-4,1093,3061,30
18444819458,18444819452,-6,994,3707,30
18445822507,18445822502,-5,857,2804,30
18449930506,18449930502,-4,1562,2336,30
18452467991,18452467983,-8,613,2638,30
18456435854,18456435854,0,827,2549,30
18456588485,18456588483,-2,1005,2576,30
18458205078,18458205074,-4,1011,2576,30
18464129298,18464129300,2,18312,21271,30
18464438712,18464438709,-3,761,2231,30
18465931442,18465931438,-4,964,1432,30
18466474543,18466474542,-1,964,1091,30
18472202687,18472202683,-4,828,2353,30
18473487654,18473487648,-6,817,3226,30
18479185158,18479185154,-4,1029,3810,30
18482100303,18482100298,-5,824,3090,30
18489078499,18489078495,-4,837,2688,30
18491801026,18491801023,-3,824,2123,30
18494747802,18494747799,-3,721,2938,30
18498285834,18498285829,-5,997,2460,30
18498318737,18498318717,-20,1076,2279,30
18498779618,18498779624,6,8119,2744,30
18502571143,18502571137,-6,878,3194,30
18502954658,18502954653,-5,778,2419,30
18503793964,18503793976,12,731,2104,30
18503979971,18503979966,-5,1485,4048,30
18508106274,18508106269,-5,1256,3472,30
18508242292,18508242287,-5,1183,2985,30
18510930718,18510930713,-5,917,3367,30
18512671559,18512671555,-4,1273,3387,30
18512823180,18512823174,-6,808,1925,30
18514272180,18514272174,-6,1463,3739,30
18514329322,18514329307,-15,255,590,30
18515151091,18515151086,-5,1098,4142,30
18515583517,18515583511,-6,1100,3476,30
18519895983,18519895980,-3,1430,2841,30
18520268761,18520268756,-5,1175,3599,30
18522067695,18522067689,-6,1026,2804,30
18522166563,18522166559,-4,853,2585,30
18528196974,18528196968,-6,1793,3063,30
18531419437,18531419433,-4,961,1457,30
18534309853,18534309851,-2,1181,1992,30
18537288343,18537288340,-3,1283,1661,30
18538461453,18538461455,2,1002,1268,30
18539372714,18539372709,-5,1286,3107,30
18545419874,18545419870,-4,1412,3007,30
18558207728,18558207750,22,192,884,30
18562781887,18562781883,-4,976,3795,30
18564253857,18564253853,-4,957,2859,30
18565570259,18565570254,-5,880,2303,30
18565929429,18565929425,-4,990,2807,30
18567515563,18567515567,4,2051,1885,30
18567603766,18567603763,-3,1228,1830,30
18578494616,18578494610,-6,968,2994,30
18579707891,18579707906,15,613,1051,30
18581349618,18581349613,-5,1631,3909,30
18581385752,18581385747,-5,1078,3597,30
18582117153,18582117152,-1,203,738,30
18587052142,18587052135,-7,710,1294,30
18587980559,18587980557,-2,833,2701,30
18588019649,18588019643,-6,1377,3513,30
18589304855,18589304853,-2,1237,3468,30
18589941208,18589941216,8,409,1328,30
18595565023,18595565019,-4,972,2603,30
18595725655,18595725642,-13,1190,678,30
18605385962,18605385958,-4,1322,2524,30
18615047733,18615047731,-2,849,1053,30
18615511230,18615511226,-4,868,2379,30
18616131457,18616131454,-3,1267,2851,30
18634493959,18634493954,-5,1059,3988,30
18636781402,18636781395,-7,921,4199,30
18637537310,18637537307,-3,1423,3153,30
18639525499,18639525517,18,595,2045,30
18639766837,18639766831,-6,1028,2556,30
18641651978,18641651974,-4,1188,3558,30
18641939427,18641939410,-17,1279,3411,30
18642104137,18642104156,19,838,1815,30
18646432779,18646432773,-6,1563,2811,30
18647690693,18647690688,-5,1089,1937,30
18647773562,18647773578,16,986,3191,30
18651256494,18651256490,-4,847,2356,30
18657579036,18657579042,6,3532,1349,30
18658408389,18658408381,-8,826,3112,30
18667271394,18667271389,-5,1057,2996,30
18668422234,18668422230,-4,1225,3018,30
18678462611,18678462606,-5,1220,3602,30
18681016215,18681016212,-3,1302,2853,30
18684502119,18684502115,-4,1469,4742,30
18685320750,18685320755,5,3690,1745,30
18696036330,18696036327,-3,1326,3754,30
18702468174,18702468169,-5,1120,1592,30
18703298077,18703298080,3,3679,2695,30
18703376246,18703376242,-4,1021,2370,30
18708037390,18708037385,-5,988,2048,30
18721076124,18721076120,-4,509,1398,30
18722464709,18722464703,-6,1565,2589,30
18723620378,18723620373,-5,865,2470,30
18728585370,18728585366,-4,877,2878,30
18728807454,18728807450,-4,872,2615,30
18728893923,18728893900,-23,912,2652,30
18729577217,18729577213,-4,1204,2948,30
18730087815,18730087817,2,2697,2706,30
18735254624,18735254622,-2,916,2073,30
18738217278,18738217275,-3,821,2347,30
18738728691,18738728674,-17,213,782,30
18751752457,18751752452,-5,1302,5028,30
18754263454,18754263457,3,2780,1716,30
18756011601,18756011603,2,1544,1459,30
18762347537,18762347532,-5,637,2834,30
18764842154,18764842150,-4,870,2468,30
18765639318,18765639315,-3,943,2054,30
18767280773,18767280769,-4,1242,2453,30
18768116997,18768116991,-6,743,2277,30
18768225260,18768225273,13,920,3339,30
18771436360,18771436355,-5,1269,2622,30
18772815618,18772815613,-5,1010,3532,30
18780505548,18780505542,-6,737,3044,30
18782455310,18782455305,-5,1375,2925,30
18789696907,18789696919,12,402,800,30
18790188163,18790188159,-4,1136,2129,30
18793810305,18793810319,14,1022,1229,30
18796722386,18796722380,-6,1474,4177,30
18797089272,18797089270,-2,190,1081,30
18799261729,18799261720,-9,37346,15577,30
18801606517,18801606514,-3,1169,2802,30
18816616855,18816616854,-1,1850,2247,30
18822378737,18822378732,-5,1138,2391,30
18828379921,18828379907,-14,1423,915,30
18839564919,18839564916,-3,751,1522,30
18839763848,18839763865,17,656,2577,30
18842979150,18842979158,8,4669,2573,30
18855936313,18855936312,-1,1981,2501,30
18859743005,18859743002,-3,1090,2096,30
18871976753,18871976754,1,1683,1384,30
18872240161,18872240156,-5,1186,2571,30
18872433966,18872433962,-4,1079,3913,30
18878088563,18878088561,-2,618,1190,30
18880135769,18880135764,-5,1228,2965,30
18880477556,18880477569,13,1381,2970,30
18890456898,18890456892,-6,1028,5929,30
18890527050,18890527042,-8,984,2413,30
18894800474,18894800471,-3,946,2575,30
18897162446,18897162441,-5,1149,3083,30
18903019796,18903019797,1,1022,1557,30
18903925436,18903925450,14,297,864,30
18904716096,18904716091,-5,804,2268,30
18910838421,18910838418,-3,1056,2506,30
18911880881,18911880875,-6,787,2995,30
18913583276,18913583291,15,567,2562,30
18916618366,18916618362,-4,1196,2574,30
18919947357,18919947353,-4,1128,3480,30
18924248217,18924248213,-4,949,3417,30
18924875372,18924875376,4,4534,2642,30
18925547646,18925547641,-5,1048,3272,30
18931893489,18931893485,-4,1282,3064,30
18931953707,18931953710,3,117,1133,30
18936642999,18936642993,-6,835,2677,30
18939177741,18939177735,-6,993,1858,30
18951016057,18951016062,5,3055,1128,30
18951631807,18951631802,-5,1210,2512,30
18951959317,18951959313,-4,1996,5384,30
18952393726,18952393722,-4,1124,2448,30
18952688714,18952688711,-3,1261,2292,30
18954233020,18954233015,-5,891,2672,30
18955699898,18955699905,7,1736,975,30
18957393738,18957393733,-5,727,1924,30
18958952255,18958952250,-5,1214,3978,30
18961385977,18961385972,-5,1131,2644,30
18964973208,18964973204,-4,1738,3247,30
18965697251,18965697247,-4,1037,3238,30
18968165629,18968165625,-4,1100,3293,30
18977889006,18977889001,-5,1091,2848,30
18980912307,18980912289,-18,303,928,30
18983270882,18983270877,-5,924,2672,30
18983502314,18983502309,-5,959,1818,30
18989391613,18989391610,-3,770,2290,30
18990548765,18990548758,-7,1036,2955,30
18994085599,18994085595,-4,1243,2936,30
18995993471,18995993469,-2,2520,4393,30
18999338350,18999338347,-3,747,2685,30
19007939667,19007939660,-7,1197,4115,30
19008297635,19008297631,-4,793,3946,30
19015305729,19015305726,-3,524,1427,30
19015976049,19015976068,19,831,3240,30
19019799879,19019799875,-4,1124,2716,30
19019940747,19019940742,-5,483,2155,30
19020079120,19020079113,-7,1268,7957,30
19020440106,19020440121,15,316,2172,30
19030919374,19030919369,-5,780,1661,30
19034785479,19034785475,-4,1128,2848,30
19036311455,19036311450,-5,716,3042,30
19037957111,19037957107,-4,798,2917,30
19047914815,19047914834,19,583,2799,30
19047977094,19047977090,-4,1029,3249,30
19054736640,19054736635,-5,666,2309,30
19055020487,19055020485,-2,1354,2470,30
19056398053,19056398050,-3,893,3302,30
19058227871,19058227874,3,828,910,30
19059978274,19059978271,-3,994,2250,30
19060496718,19060496714,-4,1109,2515,30
19060756599,19060756595,-4,772,3837,30
19065874569,19065874565,-4,1263,3023,30
19067891497,19067891490,-7,1204,3434,30
19077095185,19077095183,-2,2640,3174,30
19080693867,19080693862,-5,880,3057,30
19087142022,19087142018,-4,648,2054,30
19088473903,19088473905,2,1266,1464,30
19090288492,19090288490,-2,35940,12285,30
19098438358,19098438350,-8,1018,2547,30
19102706694,19102706689,-5,2544,7002,30
19104476079,19104476075,-4,1029,1803,30
19105047018,19105047016,-2,1813,2804,30
19111722681,19111722685,4,2320,1404,30
19112281146,19112281142,-4,1220,3115,30
19112350053,19112350048,-5,1344,3175,30
19119063650,19119063645,-5,852,2269,30
19120703251,19120703245,-6,709,3409,30
19121199237,19121199237,0,1179,2035,30
19126004986,19126004983,-3,840,3174,30
19129757126,19129757122,-4,1100,3417,30
19129923995,19129923991,-4,615,1882,30
19130649683,19130649702,19,483,2402,30
19130944931,19130944924,-7,1076,2951,30
19134013275,19134013270,-5,1325,3240,30
19146607542,19146607537,-5,1026,2837,30
19146897674,19146897694,20,689,2587,30
19149657158,19149657159,1,1506,1156,30
19159841906,19159841902,-4,1108,3185,30
19166497080,19166497079,-1,857,2941,30
19168069811,19168069806,-5,1264,3673,30
19173717346,19173717343,-3,1245,1375,30
19174920002,19174919998,-4,1145,2894,30
19177699735,19177699730,-5,837,3452,30
19178960813,19178960806,-7,2068,6032,30
19180281492,19180281486,-6,958,3076,30
19180500251,19180500269,18,639,1799,30
19180895079,19180895074,-5,1093,4242,30
19183377006,19183377002,-4,1090,2824,30
19187123963,19187123959,-4,688,2332,30
19187441457,19187441479,22,791,3787,30
19191287950,19191287946,-4,760,1868,30
19191435250,19191435246,-4,1417,3666,30
19191793410,19191793406,-4,1021,2910,30
19192255914,19192255906,-8,1534,1556,30
19197197499,19197197493,-6,1345,4172,30
19199398968,19199398961,-7,999,2617,30
19200825538,19200825534,-4,959,1539,30
19204466381,19204466375,-6,839,3095,30
19210088319,19210088314,-5,721,3092,30
19210593298,19210593278,-20,622,2178,30
19211350716,19211350733,17,94,1712,30
19216437690,19216437682,-8,871,1939,30
19217798923,19217798921,-2,1417,2098,30
19220781370,19220781365,-5,831,2231,30
19226870077,19226870077,0,1613,2116,30
19238355666,19238355662,-4,1278,3409,30
19240006601,19240006597,-4,722,2349,30
19242428312,19242428306,-6,980,3531,30
19248322337,19248322343,6,1605,980,30
19250099614,19250099609,-5,1376,4485,30
19250686547,19250686542,-5,945,2140,30
19251534571,19251534567,-4,1421,3310,30
19254402048,19254402046,-2,905,1989,30
19254537730,19254537725,-5,1450,5559,30
19257553665,19257553658,-7,1364,3332,30
19260118331,19260118327,-4,1105,2261,30
19268041606,19268041601,-5,1130,3631,30
19271854933,19271854933,0,1182,1013,30
19272319823,19272319819,-4,752,1544,30
19276062581,19276062575,-6,1150,2218,30
19276661355,19276661350,-5,913,2395,30
19277792227,19277792222,-5,1136,2960,30
19278948858,19278948851,-7,1062,2347,30
19281302430,19281302435,5,1611,1100,30
19282127557,19282127553,-4,1148,3381,30
19284363607,19284363604,-3,462,1190,30
19287469666,19287469662,-4,1140,2657,30
19287780034,19287780030,-4,1085,2377,30
19292421293,19292421299,6,1644,952,30
19293982598,19293982602,4,2186,1620,30
19305129501,19305129497,-4,1040,1658,30
19307688613,19307688607,-6,1201,2681,30
19311445325,19311445329,4,1565,1440,30
19312271388,19312271372,-16,1719,912,30
19329190416,19329190421,5,12393,18584,30
19331550963,19331550964,1,1663,1634,30
19334265651,19334265642,-9,473,808,30
19335727487,19335727481,-6,1038,3252,30
19341681290,19341681289,-1,1178,3140,30
19347457091,19347457089,-2,1190,2047,30
19356716221,19356716226,5,2398,1204,30
19356939003,19356939017,14,847,889,30
19358061526,19358061521,-5,1103,4057,30
19360686363,19360686359,-4,777,2933,30
19363166729,19363166725,-4,923,2665,30
19369196415,19369196418,3,3347,2054,30
19373274925,19373274922,-3,1046,2657,30
19376977755,19376977750,-5,752,2729,30
19380214497,19380214498,1,44936,26027,30
19382903189,19382903185,-4,1021,2160,30
19385673738,19385673735,-3,671,1951,30
19386024353,19386024370,17,1142,2588,30
19388756785,19388756781,-4,1294,3649,30
19389764123,19389764118,-5,1217,3511,30
19391789358,19391789357,-1,1207,2182,30
19396495390,19396495386,-4,1018,3145,30
19398532953,19398532949,-4,1581,3880,30
19400394009,19400394009,0,27854,34117,30
19401452538,19401452535,-3,1332,2798,30
19407966858,19407966860,2,1216,778,30
19410043586,19410043583,-3,1250,2673,30
19411455467,19411455463,-4,910,2867,30
19413748102,19413748098,-4,900,3030,30
19414535898,19414535895,-3,934,2971,30
19418603307,19418603302,-5,1092,3435,30
19420273294,19420273293,-1,840,2547,30
19422322327,19422322322,-5,1127,2600,30
19427046246,19427046240,-6,1342,5674,30
19428370998,19428370994,-4,1085,2902,30
19434580915,19434580910,-5,1062,3605,30
19444417058,19444417054,-4,979,2537,30
19446045277,19446045274,-3,645,2096,30
19455668395,19455668391,-4,638,1524,30
19461638371,19461638367,-4,1110,3140,30
19464439636,19464439642,6,3032,650,30
19469810815,19469810810,-5,1203,4313,30
19472564785,19472564781,-4,992,3609,30
19473293897,19473293893,-4,726,1583,30
19474413448,19474413445,-3,797,2610,30
19475463854,19475463850,-4,1640,3140,30
19478835210,19478835206,-4,931,2456,30
19480562015,19480562013,-2,657,1517,30
19487318506,19487318500,-6,1347,3858,30
19489918865,19489918861,-4,1433,3616,30
19490408659,19490408653,-6,1152,3448,30
19492576376,19492576372,-4,982,2672,30
19495819590,19495819586,-4,937,4144,30
19505995749,19505995745,-4,1447,2819,30
19506440018,19506440014,-4,1094,2641,30
19525944800,19525944795,-5,919,2306,30
19526103610,19526103627,17,250,813,30
19526966593,19526966591,-2,226,791,30
19527516685,19527516679,-6,1278,3656,30
19531532932,19531532928,-4,1284,3283,30
19546880833,19546880828,-5,785,2903,30
19549802350,19549802345,-5,1612,3522,30
19553785335,19553785329,-6,951,3249,30
19553830986,19553830983,-3,838,1585,30
19553953268,19553953273,5,211,1004,30
19556869455,19556869450,-5,1191,3131,30
19565297889,19565297886,-3,1004,2433,30
19565371065,19565371085,20,792,3124,30
19568487093,19568487089,-4,923,2967,30
19569031293,19569031288,-5,1536,2814,30
19569663040,19569663055,15,248,1161,30
19573271171,19573271166,-5,1422,3217,30
19577179938,19577179933,-5,1203,2312,30
19585985533,19585985528,-5,838,2807,30
19586161618,19586161631,13,3,1083,30
19586852112,19586852107,-5,1114,2723,30
19587123818,19587123835,17,390,1164,30
19592185115,19592185110,-5,974,1954,30
19592636721,19592636743,22,886,1843,30
19596850780,19596850776,-4,1023,3298,30
19602073146,19602073137,-9,23225,16069,30
19605120045,19605120038,-7,1257,2046,30
19609958741,19609958736,-5,979,4921,30
19613900028,19613900051,23,888,2600,30
19619465938,19619465934,-4,1414,4612,30
19619729302,19619729298,-4,1453,3422,30
19628343230,19628343233,3,2206,1140,30
19630783848,19630783846,-2,1386,2365,30
19632680815,19632680811,-4,1815,2853,30
19635545606,19635545598,-8,1080,2368,30
19645484623,19645484616,-7,1040,2217,30
19650700638,19650700634,-4,1361,3747,30
19650783566,19650783563,-3,717,2117,30
19655530482,19655530478,-4,799,2475,30
19655669807,19655669801,-6,891,3345,30
19656723842,19656723837,-5,1124,2834,30
19657928914,19657928906,-8,928,4960,30
19663130058,19663130054,-4,955,2000,30
19664272073,19664272094,21,1025,3600,30
19666404515,19666404510,-5,1171,3222,30
19681401353,19681401346,-7,1169,2489,30
19682969783,19682969778,-5,793,1990,30
19683720109,19683720104,-5,963,3152,30
19684242897,19684242891,-6,837,2127,30
19689373019,19689373013,-6,682,1610,30
19690594959,19690594956,-3,1157,2230,30
19691429733,19691429729,-4,873,3035,30
19693210710,19693210706,-4,822,4447,30
19694888851,19694888848,-3,735,2010,30
19699743302,19699743298,-4,1476,3437,30
19700041414,19700041409,-5,745,2110,30
19703297850,19703297843,-7,912,4729,30
19707607923,19707607918,-5,1323,5193,30
19710874641,19710874641,0,1744,3054,30
19711221930,19711221926,-4,1116,2453,30
19712426991,19712426988,-3,1026,2756,30
19713012554,19713012549,-5,1306,3627,30
19715357859,19715357851,-8,923,2685,30
19716296014,19716296009,-5,1116,2774,30
19725175998,19725175994,-4,969,2297,30
19727108344,19727108347,3,1921,1521,30
19727567493,19727567491,-2,1231,2689,30
19730776176,19730776170,-6,829,2912,30
19731536779,19731536773,-6,861,2856,30
19737551046,19737551042,-4,1139,4507,30
19744956926,19744956925,-1,1215,2666,30
19746524607,19746524601,-6,817,2923,30
19746868306,19746868321,15,685,1932,30
19751644428,19751644424,-4,1378,1309,30
19760764940,19760764936,-4,1155,2580,30
19761593547,19761593541,-6,1089,2916,30
19762935932,19762935927,-5,1053,2490,30
19763140483,19763140475,-8,1096,3377,30
19763432632,19763432635,3,156,840,30
19765679300,19765679294,-6,712,2400,30
19766301142,19766301138,-4,971,2135,30
19766894875,19766894895,20,1000,2594,30
19773250991,19773250986,-5,1703,7239,30
19774203319,19774203314,-5,774,2061,30
19776011613,19776011606,-7,774,4089,30
19778774462,19778774458,-4,1067,3221,30
19789991276,19789991281,5,1462,1456,30
19792627562,19792627566,4,4576,2653,30
19795476426,19795476422,-4,785,1805,30
19796794514,19796794510,-4,1032,2686,30
19797207070,19797207066,-4,1279,3233,30
19800096223,19800096217,-6,869,3311,30
19802890090,19802890085,-5,918,2870,30
19805195738,19805195733,-5,1554,3331,30
19806962314,19806962309,-5,989,3355,30
19810125696,19810125690,-6,1151,2682,30
19811396226,19811396220,-6,1195,2617,30
19812080780,19812080790,10,372,1262,30
19813837182,19813837178,-4,915,3122,30
19814603667,19814603650,-17,268,1180,30
19819456289,19819456285,-4,1544,3788,30
19820055519,19820055516,-3,1000,3031,30
19820806909,19820806928,19,656,2320,30
19821749405,19821749401,-4,1210,3956,30
19823663186,19823663183,-3,970,3351,30
19826440669,19826440666,-3,1171,2332,30
19826612100,19826612107,7,249,982,30
19828199539,19828199536,-3,870,2573,30
19832903305,19832903300,-5,1307,2764,30
19837042158,19837042153,-5,1298,3027,30
19837422679,19837422673,-6,798,2365,30
19838403021,19838403016,-5,1093,2940,30
19839559674,19839559667,-7,27748,13834,30
19841912932,19841912928,-4,859,2800,30
19842730219,19842730218,-1,1406,1388,30
19844175558,19844175552,-6,852,2852,30
19846685107,19846685101,-6,1187,4055,30
19850902461,19850902467,6,3376,1152,30
19858611615,19858611610,-5,2388,5212,30
19863045421,19863045418,-3,1326,2266,30
19865383703,19865383706,3,3472,3591,30
19867188193,19867188188,-5,1016,2626,30
19869061070,19869061066,-4,1278,3553,30
19869509605,19869509601,-4,1221,2080,30
19869953912,19869953926,14,350,1346,30
19872317023,19872317018,-5,832,2246,30
19876651191,19876651186,-5,1142,2597,30
19878738847,19878738844,-3,1111,2937,30
19879282516,19879282526,10,673,2778,30
19880387238,19880387235,-3,1339,2997,30
19884042606,19884042601,-5,742,2751,30
19890069481,19890069476,-5,1116,3654,30
19890609618,19890609611,-7,1184,2712,30
19892945499,19892945498,-1,1478,2662,30
19893299146,19893299143,-3,944,2339,30
19903239918,19903239914,-4,978,2527,30
19904087216,19904087211,-5,873,1808,30
19907393926,19907393921,-5,722,3586,30
19907845849,19907845846,-3,1666,2053,30
19907986706,19907986703,-3,1246,3335,30
19908627073,19908627069,-4,951,2733,30
19909278883,19909278886,3,1085,1267,30
19909502726,19909502723,-3,1109,2713,30
19911292434,19911292430,-4,858,3752,30
19915008284,19915008279,-5,1033,2702,30
19922395666,19922395663,-3,1643,3331,30
19923272091,19923272087,-4,1170,3406,30
19929929795,19929929789,-6,889,2669,30
19940976493,19940976493,0,1427,1922,30
19943650179,19943650173,-6,827,2232,30
19945283774,19945283769,-5,1183,3366,30
19950285951,19950285946,-5,647,2193,30
19950892961,19950892957,-4,760,1657,30
19951553291,19951553285,-6,1180,2386,30
19956219944,19956219945,1,20641,20412,30
19957228404,19957228402,-2,590,2405,30
19959949826,19959949825,-1,1166,2432,30
19960395922,19960395918,-4,870,2969,30
19962205401,19962205402,1,1453,1195,30
19965698943,19965698941,-2,1199,2521,30
19966576884,19966576899,15,642,804,30
19972550695,19972550692,-3,966,2797,30
19985979158,19985979154,-4,1138,3031,30
19993038494,19993038489,-5,1046,2306,30
19993150430,19993150426,-4,960,3462,30
19995458806,19995458803,-3,1010,2864,30
19995924005,19995923999,-6,1348,3038,30
19996224377,19996224369,-8,545,2084,30
19996533332,19996533351,19,161,1291,30
19998285458,19998285453,-5,1105,2884,30
19999274695,19999274691,-4,1021,2299,30
20001833099,20001833094,-5,1108,2256,30
20001860292,20001860306,14,1043,3347,30
20002242554,20002242575,21,969,3102,30
20002583682,20002583667,-15,3317,1320,30
20008475350,20008475345,-5,1206,3213,30
20009461807,20009461803,-4,793,2599,30
20009552182,20009552178,-4,626,2085,30
20019820822,20019820817,-5,1794,7837,30
20023037664,20023037653,-11,30699,14093,30
20023593563,20023593559,-4,1090,2613,30
20024101139,20024101158,19,434,1220,30
20025725939,20025725933,-6,687,2891,30
20027603034,20027603030,-4,790,2930,30
20029539994,20029539989,-5,1568,4218,30
20032182107,20032182102,-5,790,2664,30
20035637307,20035637302,-5,1109,2900,30
20037105467,20037105462,-5,988,2809,30
20039650274,20039650270,-4,1129,4072,30
20045716894,20045716889,-5,514,2831,30
20046066059,20046066053,-6,407,1921,30
20049690391,20049690386,-5,1164,4140,30
20051096412,20051096409,-3,1093,2775,30
20052062637,20052062630,-7,1319,7356,30
20059698687,20059698687,0,4123,3532,30
20061569599,20061569595,-4,732,1831,30
20064959130,20064959125,-5,1209,3545,30
20067684649,20067684645,-4,867,2503,30
20068063197,20068063193,-4,1329,3551,30
20068675782,20068675778,-4,842,2628,30
20073680890,20073680885,-5,952,2550,30
20078114699,20078114695,-4,827,2204,30
20080808460,20080808456,-4,1017,2922,30
20087847107,20087847103,-4,1024,1879,30
20088320319,20088320317,-2,1466,1856,30
20097329372,20097329366,-6,1390,2216,30
20098790304,20098790297,-7,1271,10336,30
20099598413,20099598406,-7,823,2554,30
20101816766,20101816763,-3,1012,3218,30
20103519547,20103519544,-3,1142,3234,30
20107937635,20107937631,-4,869,2745,30
20113065171,20113065165,-6,736,2520,30
20123036783,20123036778,-5,1355,3426,30
20125181381,20125181378,-3,1015,3204,30
20130477194,20130477190,-4,988,3121,30
20136276245,20136276239,-6,873,1655,30
20138490777,20138490774,-3,1420,3602,30
20139542063,20139542058,-5,984,2347,30
20145551072,20145551070,-2,1286,2474,30
20156068016,20156068013,-3,1570,1871,30
20158628457,20158628449,-8,1164,6030,30
20158955601,20158955620,19,883,2743,30
20160185910,20160185910,0,1237,1698,30
20162886683,20162886679,-4,1059,2397,30
20167378190,20167378186,-4,922,5053,30
20170593166,20170593162,-4,906,2959,30
20173709749,20173709745,-4,1044,2757,30
20177743778,20177743773,-5,941,3036,30
20179904214,20179904209,-5,1196,2839,30
20187509994,20187509989,-5,1875,3761,30
20188108606,20188108606,0,1366,1803,30
20192560818,20192560818,0,2128,2815,30
20192986624,20192986619,-5,1018,4047,30
20196945559,20196945556,-3,948,3016,30
20197871379,20197871374,-5,1193,2590,30
20206356361,20206356359,-2,1276,2344,30
20210489734,20210489730,-4,1696,2613,30
20211663266,20211663262,-4,1490,3726,30
20217117321,20217117316,-5,1542,3606,30
20218423763,20218423760,-3,948,2854,30
20218851415,20218851410,-5,731,2820,30
20219482202,20219482187,-15,409,897,30
20220488683,20220488677,-6,1073,4474,30
20225354687,20225354682,-5,1103,2610,30
20225739532,20225739526,-6,1514,3724,30
20228281183,20228281180,-3,984,3193,30
20235898394,20235898390,-4,966,2071,30
20236896074,20236896071,-3,860,1836,30
20239998344,20239998339,-5,1281,4220,30
20245734984,20245734978,-6,687,1951,30
20247711513,20247711509,-4,676,2466,30
20255730571,20255730566,-5,691,2202,30
20255882883,20255882878,-5,1047,3053,30
20256194555,20256194551,-4,1106,2816,30
20258397329,20258397330,1,1054,2003,30
20260144341,20260144337,-4,770,2270,30
20261268546,20261268540,-6,1510,3572,30
20265633206,20265633202,-4,1210,3289,30
20266685543,20266685538,-5,971,3345,30
20268128189,20268128190,1,1598,1715,30
20271510570,20271510565,-5,1080,2500,30
20271947355,20271947351,-4,795,2430,30
20276331494,20276331490,-4,1098,2572,30
20281570713,20281570710,-3,1261,2750,30
20283016035,20283016033,-2,645,1362,30
20284093314,20284093309,-5,1069,3654,30
20290717753,20290717749,-4,1107,2556,30
20293132189,20293132194,5,2809,1854,30
20293747379,20293747375,-4,831,2780,30
20294734039,20294734034,-5,846,1303,30
20298237546,20298237542,-4,2725,3958,30
20298428847,20298428845,-2,1230,2382,30
20301454637,20301454630,-7,858,2216,30
20303465738,20303465733,-5,962,2384,30
20306000541,20306000540,-1,820,2380,30
20309219510,20309219510,0,1108,1892,30
20312472555,20312472549,-6,1460,3986,30
20312775306,20312775299,-7,979,4098,30
20326607143,20326607137,-6,1021,2964,30
20327195383,20327195378,-5,1059,3440,30
20329858119,20329858114,-5,1023,1879,30
20334805080,20334805098,18,1845,1321,30
20335013738,20335013738,0,1874,2750,30
20338689366,20338689347,-19,1727,1434,30
20339722451,20339722450,-1,958,2029,30
20340020081,20340020076,-5,700,2158,30
20343934318,20343934313,-5,1201,3231,30
20346028771,20346028773,2,1484,1976,30
20351654479,20351654476,-3,560,1981,30
20354822998,20354822993,-5,846,2462,30
20354852043,20354852039,-4,1012,2546,30
20355513813,20355513809,-4,1412,3418,30
20359775810,20359775805,-5,1038,3180,30
20364334067,20364334061,-6,952,3889,30
20366039468,20366039462,-6,1454,4668,30
20367311818,20367311814,-4,714,2712,30
20371657379,20371657387,8,3756,1379,30
20376585192,20376585189,-3,1347,3494,30
20387011701,20387011698,-3,854,2653,30
20392013571,20392013574,3,20771,46267,30
20393554114,20393554110,-4,1056,2613,30
20397900763,20397900762,-1,699,1540,30
20398065089,20398065083,-6,1156,3374,30
20401383328,20401383324,-4,998,2589,30
20401473709,20401473705,-4,1014,3822,30
20403239117,20403239114,-3,1016,2616,30
20403962705,20403962701,-4,1228,2892,30
20405971550,20405971552,2,2017,2044,30
20412795086,20412795078,-8,745,4175,30
20415693666,20415693659,-7,1081,2841,30
20416889557,20416889552,-5,1610,3723,30
20421122779,20421122780,1,1763,1944,30
20428568522,20428568518,-4,892,2288,30
20429080066,20429080065,-1,1343,2314,30
20429758130,20429758125,-5,651,2325,30
20437218959,20437218955,-4,1080,3822,30
20443409878,20443409874,-4,1052,2500,30
20447831615,20447831610,-5,895,2634,30
20448669041,20448669052,11,501,2003,30
20449518878,20449518873,-5,1076,3751,30
20454231293,20454231283,-10,15713,26959,30
20455145690,20455145687,-3,1088,2175,30
20458140485,20458140480,-5,604,2575,30
20461604178,20461604176,-2,1503,3746,30
20463548107,20463548102,-5,1514,3908,30
20464867465,20464867462,-3,978,2689,30
20466162750,20466162746,-4,860,2142,30
20474786682,20474786678,-4,816,2129,30
20475039616,20475039610,-6,973,2246,30
20475762343,20475762339,-4,1077,3073,30
20480163803,20480163800,-3,881,2741,30
20500434380,20500434377,-3,1350,2294,30
20501726226,20501726221,-5,911,3906,30
20507196671,20507196666,-5,584,1989,30
20511737602,20511737598,-4,801,2402,30
20522277186,20522277182,-4,1173,3248,30
20522461434,20522461446,12,83,852,30
20525699439,20525699434,-5,1067,3138,30
20531042161,20531042156,-5,877,2183,30
20531857898,20531857894,-4,798,2771,30
20535731817,20535731812,-5,1303,2471,30
20537276785,20537276780,-5,1092,3216,30
20543561520,20543561530,10,20648,57732,30
20544349262,20544349265,3,1955,1532,30
20545950915,20545950910,-5,1314,3375,30
20548958220,20548958218,-2,1057,3084,30
20553618051,20553618049,-2,932,3071,30
20556754382,20556754378,-4,1009,3096,30
20560691990,20560691986,-4,851,2279,30
20560858235,20560858252,17,781,2741,30
20563453754,20563453749,-5,1118,2887,30
20565663519,20565663513,-6,1114,4287,30
20566806784,20566806780,-4,1002,3492,30
20566919474,20566919468,-6,820,4019,30
20567670763,20567670758,-5,1121,3545,30
20572444555,20572444548,-7,1477,5570,30
20573422075,20573422069,-6,943,3968,30
20575152618,20575152614,-4,1002,2038,30
20578691897,20578691893,-4,974,2719,30
20581824753,20581824749,-4,1180,3084,30
20594508575,20594508569,-6,739,2835,30
20597427584,20597427585,1,1329,1917,30
20598966339,20598966334,-5,1197,3017,30
20599346672,20599346666,-6,1432,4362,30
20600673845,20600673841,-4,1179,3710,30
20604002310,20604002306,-4,746,1685,30
20604214539,20604214534,-5,173,1109,30
20605053916,20605053929,13,672,3259,30
20605726403,20605726397,-6,950,2325,30
20606932428,20606932444,16,1152,3764,30
20608709135,20608709138,3,1861,1063,30
20608939268,20608939266,-2,821,2377,30
20611965721,20611965715,-6,1383,4010,30
20612515938,20612515931,-7,1069,2264,30
20613328003,20613327998,-5,1064,3706,30
20613516235,20613516251,16,21,1205,30
20613741972,20613741987,15,282,882,30
20617546011,20617546005,-6,959,3146,30
20628519932,20628519947,15,1355,4797,30
20632449677,20632449677,0,1089,1193,30
20634220794,20634220791,-3,1245,2275,30
20648378657,20648378653,-4,675,2500,30
20651446525,20651446523,-2,2748,3929,30
20652346554,20652346548,-6,991,2805,30
20652887826,20652887840,14,382,1137,30
20662629582,20662629577,-5,694,3242,30
20667577681,20667577674,-7,1229,3287,30
20670990053,20670990050,-3,1205,2912,30
20672065769,20672065789,20,2187,160,30
20672486937,20672486941,4,1439,965,30
20678834226,20678834221,-5,1200,3558,30
20681682906,20681682902,-4,1953,4304,30
20689909086,20689909078,-8,729,3383,30
20705984741,20705984737,-4,1410,3387,30
20707489383,20707489378,-5,662,2186,30
20711211463,20711211461,-2,1245,3110,30
20712217042,20712217038,-4,1122,3655,30
20712976790,20712976786,-4,1165,3110,30
20713361003,20713360993,-10,346,919,30
20726774639,20726774635,-4,1069,2172,30
20726886882,20726886879,-3,1223,3981,30
20727105986,20727105982,-4,1083,1362,30
20727930119,20727930114,-5,870,2432,30
20732721067,20732721062,-5,851,3410,30
20735522786,20735522782,-4,1143,1901,30
20735779695,20735779691,-4,795,2537,30
20737486153,20737486149,-4,1132,1841,30
20738651915,20738651910,-5,1040,2554,30
20741484247,20741484242,-5,1125,2812,30
20755310538,20755310534,-4,1194,3981,30
20758899731,20758899728,-3,1106,2671,30
20759334182,20759334178,-4,708,2814,30
20762044154,20762044159,5,3347,1473,30
20771364761,20771364755,-6,1003,2769,30
20776636222,20776636215,-7,1120,2681,30
20780997367,20780997349,-18,984,2083,30
20787262858,20787262853,-5,1063,2501,30
20788634338,20788634334,-4,1140,3490,30
20789359660,20789359662,2,1714,1518,30
20791044967,20791044962,-5,1189,2548,30
20791371720,20791371715,-5,979,3058,30
20792476466,20792476485,19,919,3409,30
20794769658,20794769653,-5,1345,2983,30
20795291218,20795291207,-11,16525,27060,30
20797094235,20797094232,-3,1030,2473,30
20797690854,20797690849,-5,1398,3852,30
20801640650,20801640655,5,3302,1106,30
20807190847,20807190843,-4,917,2367,30
20813738334,20813738326,-8,931,2568,30
20814708381,20814708381,0,1149,2450,30
20821914922,20821914918,-4,1155,3148,30
20822886729,20822886724,-5,710,2554,30
20822971471,20822971466,-5,2111,5728,30
20824180140,20824180135,-5,1349,3637,30
20825981387,20825981382,-5,763,2744,30
20826787915,20826787911,-4,1218,2569,30
20831416960,20831416954,-6,1835,4256,30
20832075670,20832075673,3,19922,24170,30
20836413711,20836413706,-5,1143,3601,30
20838268278,20838268274,-4,1242,3201,30
20838793584,20838793580,-4,1187,2798,30
20839269675,20839269670,-5,1065,2455,30
20841444468,20841444463,-5,1140,3319,30
20843051466,20843051462,-4,526,2367,30
20845593645,20845593641,-4,1307,4465,30
20846039968,20846039990,22,696,2835,30
20853752437,20853752432,-5,1324,3139,30
20854788906,20854788901,-5,764,1822,30
20855116951,20855116949,-2,1174,1765,30
20866114518,20866114515,-3,888,2626,30
20867721974,20867721970,-4,791,3298,30
20867902631,20867902626,-5,1112,3406,30
20869214649,20869214644,-5,1289,2989,30
20872790702,20872790697,-5,716,2463,30
20879947500,20879947495,-5,1068,5168,30
20885016942,20885016938,-4,1389,2806,30
20895554044,20895554039,-5,996,4091,30
20895959573,20895959570,-3,1265,2592,30
20896903576,20896903571,-5,1036,2597,30
20898430086,20898430088,2,1642,1306,30
20903336450,20903336453,3,2850,1386,30
20906768074,20906768069,-5,821,3060,30
20907321584,20907321607,23,154,934,30
20909070226,20909070222,-4,975,2051,30
20918809263,20918809259,-4,985,3113,30
20918934434,20918934432,-2,805,2831,30
20924399427,20924399425,-2,1114,2464,30
20927440838,20927440834,-4,994,2978,30
20928569130,20928569126,-4,474,1949,30
20935154263,20935154259,-4,1182,3147,30
20938155123,20938155117,-6,993,3445,30
20941214629,20941214625,-4,959,3012,30
20945540190,20945540186,-4,1149,2925,30
20945748054,20945748052,-2,999,2428,30
20946837361,20946837354,-7,1052,2959,30
20953774687,20953774682,-5,1036,2566,30
20957402862,20957402858,-4,1311,3141,30
20961874347,20961874343,-4,1072,3140,30
20962578770,20962578791,21,634,2391,30
20963387052,20963387046,-6,1112,2175,30
20964022742,20964022740,-2,878,2404,30
20970265774,20970265769,-5,750,2321,30
20970853169,20970853165,-4,1549,3004,30
20979960406,20979960403,-3,20040,13288,30
20982213473,20982213467,-6,1296,3576,30
20982716811,20982716806,-5,775,2446,30
20982775009,20982775030,21,731,1458,30
20985342770,20985342766,-4,1318,3183,30
20991910417,20991910412,-5,1276,3228,30
20993759038,20993759032,-6,1284,3147,30
20995521077,20995521071,-6,1321,4490,30
20997437077,20997437072,-5,4645,13188,30
20998574475,20998574473,-2,1022,3366,30
20999981652,20999981649,-3,1019,2746,30
21004300615,21004300608,-7,921,2471,30
21004962162,21004962181,19,397,2144,30
21006994901,21006994897,-4,1100,2986,30
21007661591,21007661589,-2,1187,2564,30
21008958583,21008958579,-4,1140,2542,30
21009729494,21009729487,-7,469,1662,30
21015221946,21015221941,-5,836,1757,30
21017033869,21017033887,18,290,945,30
21018104943,21018104937,-6,691,1867,30
21032767179,21032767179,0,2995,3934,30
21033232987,21033232981,-6,1229,3182,30
21033334604,21033334599,-5,1175,3190,30
21033543328,21033543346,18,955,2701,30
21034493242,21034493231,-11,3900,17191,30
21034745187,21034745182,-5,1309,2861,30
21045413564,21045413560,-4,819,2451,30
21050782842,21050782838,-4,1012,2906,30
21051243679,21051243686,7,2591,1713,30
21052213166,21052213168,2,1978,2659,30
21054048552,21054048554,2,1343,1451,30
21057781415,21057781413,-2,651,1403,30
21059159471,21059159466,-5,1285,3369,30
21059829707,21059829704,-3,904,2618,30
21064534518,21064534516,-2,1575,2456,30
21069551091,21069551087,-4,944,2500,30
21074299903,21074299898,-5,985,3378,30
21075536791,21075536786,-5,1214,2979,30
21078029925,21078029922,-3,1187,1889,30
21080254422,21080254430,8,1690,589,30
21083515794,21083515791,-3,1544,3785,30
21090924652,21090924653,1,2064,2538,30
21094152538,21094152535,-3,1249,2555,30
21094435047,21094435042,-5,948,2837,30
21094545660,21094545676,16,930,2531,30
21099116632,21099116629,-3,893,2719,30
21100735724,21100735719,-5,1175,3248,30
21101537306,21101537302,-4,1458,3288,30
21101658194,21101658211,17,593,2277,30
21103156593,21103156586,-7,1040,2882,30
21104474439,21104474438,-1,1398,2084,30
21106054234,21106054230,-4,799,2840,30
21106120974,21106120970,-4,1385,2605,30
21106688437,21106688432,-5,1511,2413,30
21110130177,21110130198,21,860,1463,30
21110833351,21110833345,-6,1879,5888,30
21113394910,21113394906,-4,818,4775,30
21116672135,21116672131,-4,1282,2912,30
21118320318,21118320321,3,4825,2859,30
21119439611,21119439608,-3,985,3252,30
21133180828,21133180822,-6,1181,2631,30
21133489663,21133489659,-4,1490,2449,30
21140877464,21140877458,-6,1181,3970,30
21143667236,21143667234,-2,1429,1461,30
21149282222,21149282218,-4,1169,2563,30
21149401383,21149401381,-2,1117,1008,30
21150609935,21150609931,-4,777,2664,30
21151799563,21151799562,-1,2203,4934,30
21151939921,21151939918,-3,1494,4066,30
21153152023,21153152018,-5,1201,3180,30
21158781856,21158781854,-2,1143,2706,30
21160206626,21160206622,-4,1167,2881,30
21162109221,21162109215,-6,1118,2636,30
21164077670,21164077664,-6,1039,4093,30
21164940141,21164940137,-4,787,1810,30
21165902047,21165902062,15,239,1282,30
21169105830,21169105825,-5,1219,4128,30
21171313234,21171313231,-3,870,1896,30
21172260012,21172260006,-6,982,3715,30
21174966362,21174966357,-5,645,2267,30
21175524971,21175524966,-5,1329,3291,30
21176626663,21176626661,-2,860,2064,30
21181402640,21181402634,-6,736,2862,30
21183041299,21183041294,-5,887,2372,30
21183613540,21183613537,-3,1150,2007,30
21186664542,21186664547,5,2516,990,30
21189654474,21189654472,-2,863,2704,30
21195808584,21195808581,-3,1389,3485,30
21201131818,21201131811,-7,720,2296,30
21204191514,21204191509,-5,886,2959,30
21208997346,21208997341,-5,1166,2829,30
21220245331,21220245327,-4,1013,3318,30
21228090780,21228090776,-4,4155,9999,30
21231509234,21231509230,-4,1068,3206,30
21234441847,21234441846,-1,1957,3014,30
21236716979,21236716975,-4,904,2582,30
21238176707,21238176705,-2,1010,2320,30
21249025175,21249025169,-6,871,2280,30
21252040090,21252040085,-5,1890,4011,30
21252073234,21252073222,-12,991,1850,30
21252284267,21252284254,-13,1036,1390,30
21255831288,21255831286,-2,938,2539,30
21257127137,21257127132,-5,888,1755,30
21257476575,21257476568,-7,913,10350,30
21260557669,21260557655,-14,245,1095,30
21262373351,21262373343,-8,983,2503,30
21266688374,21266688371,-3,816,1725,30
21270377659,21270377653,-6,564,3391,30
21275383961,21275383957,-4,730,1848,30
21276261815,21276261813,-2,1216,2252,30
21278260860,21278260856,-4,1355,3208,30
21279830995,21279830993,-2,1371,1772,30
21280765007,21280765002,-5,1123,3341,30
21281105633,21281105631,-2,169,1311,30
21284118983,21284118977,-6,978,3450,30
21285032477,21285032474,-3,1253,1608,30
21287124822,21287124819,-3,936,2125,30
21290793629,21290793626,-3,1129,2197,30
21291145729,21291145751,22,798,1994,30
21291199271,21291199273,2,2892,1178,30
21291863117,21291863117,0,1658,2129,30
21300650509,21300650504,-5,918,1965,30
21302470098,21302470092,-6,1524,2995,30
21303080563,21303080557,-6,1332,2021,30
21313409375,21313409370,-5,787,2680,30
21316502233,21316502237,4,36747,30495,30
21319736314,21319736310,-4,1402,2456,30
21329080715,21329080711,-4,1381,2906,30
21329146592,21329146593,1,268,1175,30
21329669079,21329669074,-5,1130,2189,30
21329819326,21329819321,-5,1154,3715,30
21329855823,21329855819,-4,1271,2513,30
21329986544,21329986543,-1,790,1774,30
21333654582,21333654578,-4,592,3761,30
21337391363,21337391357,-6,1572,5003,30
21338151562,21338151541,-21,905,1287,30
21338646874,21338646890,16,441,1869,30
21343217095,21343217090,-5,1257,3650,30
21345291524,21345291524,0,4926,22885,30
21351579226,21351579223,-3,837,2067,30
21353673830,21353673825,-5,1116,4076,30
21356545918,21356545911,-7,940,5313,30
21366741709,21366741706,-3,1156,2907,30
21367114658,21367114653,-5,1094,2013,30
21369943487,21369943483,-4,1097,2710,30
21373018378,21373018373,-5,980,3675,30
21373455119,21373455114,-5,692,3117,30
21377101382,21377101378,-4,1338,3691,30
21381391830,21381391826,-4,1052,1902,30
21381851366,21381851364,-2,1742,2408,30
21384739842,21384739838,-4,1675,3119,30
21388426017,21388426014,-3,1253,3261,30
21391304559,21391304554,-5,1363,4317,30
21393814805,21393814811,6,6470,1855,30
21395572434,21395572433,-1,12056,16668,30
21395653421,21395653418,-3,928,2366,30
21395680563,21395680545,-18,1349,3673,30
21398431454,21398431451,-3,911,2050,30
21404422213,21404422207,-6,687,2899,30
21405665765,21405665763,-2,1290,1982,30
21406275195,21406275209,14,1137,2652,30
21407938501,21407938497,-4,1235,2584,30
21408106136,21408106122,-14,853,2755,30
21408681730,21408681749,19,591,2094,30
21412018693,21412018689,-4,1160,2815,30
21413221012,21413221006,-6,508,1116,30
21415103246,21415103246,0,1756,2309,30
21418361744,21418361738,-6,816,2836,30
21419367427,21419367422,-5,1216,3045,30
21420678821,21420678820,-1,2038,2164,30
21421151373,21421151368,-5,1134,3125,30
21426913856,21426913852,-4,1428,2930,30
21431314162,21431314155,-7,1035,3980,30
21432392498,21432392492,-6,2030,7723,30
21440856832,21440856829,-3,1610,3996,30
21442508548,21442508551,3,70,992,30
21448987248,21448987244,-4,976,2505,30
21455462114,21455462120,6,756,533,30
21456838298,21456838295,-3,1282,2966,30
21470525748,21470525742,-6,1460,3677,30
21470976035,21470976030,-5,869,1839,30
21474208896,21474208893,-3,1500,3011,30
21487645285,21487645279,-6,819,2372,30
21496499032,21496499037,5,4342,1992,30
21499708075,21499708070,-5,673,2131,30
21500506340,21500506354,14,105,1796,30
21501052938,21501052933,-5,751,2267,30
21502428066,21502428086,20,867,3151,30
21502783914,21502783912,-2,1075,3088,30
21503011610,21503011606,-4,928,2942,30
21503078546,21503078567,21,246,975,30
21512133011,21512133006,-5,1164,2184,30
21518189530,21518189524,-6,1534,2546,30
21519005377,21519005372,-5,1222,3556,30
21520650243,21520650238,-5,1228,2217,30
21520974823,21520974818,-5,1074,2291,30
21523345340,21523345333,-7,1152,3653,30
21524446817,21524446838,21,759,2992,30
21525673063,21525673058,-5,873,1768,30
21528750697,21528750693,-4,1414,2983,30
21529853431,21529853427,-4,669,2509,30
21534422074,21534422069,-5,909,2313,30
21538687000,21538686994,-6,1168,3574,30
21542572534,21542572529,-5,1043,3340,30
21549626622,21549626619,-3,534,2290,30
21550031761,21550031781,20,283,1617,30
21553882230,21553882237,7,5561,2075,30
21561733010,21561733002,-8,1088,2788,30
21561864754,21561864751,-3,974,2514,30
21562355922,21562355917,-5,852,2585,30
21565786951,21565786949,-2,964,2613,30
21566050050,21566050045,-5,1138,3191,30
21567862998,21567862976,-22,1243,1276,30
21569877232,21569877226,-6,811,2997,30
21570283626,21570283642,16,1275,2847,30
21573210135,21573210129,-6,1432,3993,30
21575720991,21575721008,17,30380,21890,30
21579920922,21579920920,-2,984,2388,30
21581341492,21581341487,-5,1409,3796,30
21584144930,21584144927,-3,862,2212,30
21585600124,21585600141,17,679,1975,30
21586530500,21586530497,-3,2549,5817,30
21587138323,21587138319,-4,1345,3738,30
21587230227,21587230226,-1,816,1778,30
21591900859,21591900855,-4,1594,2889,30
21595269859,21595269854,-5,1006,4227,30
21595811458,21595811459,1,1561,1372,30
21596160732,21596160751,19,520,845,30
21604701174,21604701173,-1,1020,1883,30
21609571633,21609571626,-7,1620,3478,30
21610455257,21610455261,4,2569,2181,30
21612182010,21612182006,-4,1535,3231,30
21613098679,21613098672,-7,1151,2445,30
21615415335,21615415331,-4,1146,3638,30
21619348531,21619348526,-5,1052,2748,30
21619466632,21619466642,10,322,460,30
21619740011,21619740014,3,2079,1747,30
21625659606,21625659613,7,2559,1370,30
21627512929,21627512925,-4,1245,2272,30
21632562787,21632562782,-5,705,3195,30
21634094426,21634094421,-5,1254,3133,30
21634232164,21634232177,13,315,1148,30
21634474620,21634474615,-5,887,2331,30
21638878181,21638878174,-7,1202,4594,30
21642506126,21642506121,-5,1404,3033,30
21642988536,21642988532,-4,1331,3261,30
21646476534,21646476529,-5,1105,3617,30
21647842718,21647842719,1,2848,3179,30
21649772279,21649772276,-3,743,2510,30
21655210446,21655210442,-4,1128,2901,30
21656083122,21656083121,-1,1368,2501,30
21657668221,21657668239,18,85,486,30
21658286323,21658286318,-5,1107,2793,30
21660038746,21660038742,-4,641,3276,30
21662918459,21662918456,-3,1058,2379,30
21667121877,21667121870,-7,973,4387,30
21669151821,21669151814,-7,1110,2818,30
21670427386,21670427381,-5,1146,3018,30
21670505892,21670505906,14,1366,2964,30
21674851558,21674851553,-5,1158,3404,30
21683016144,21683016141,-3,1035,2548,30
21686145758,21686145755,-3,1073,3025,30
21687982931,21687982919,-12,201,1351,30
21689971695,21689971694,-1,1587,2315,30
21691531734,21691531729,-5,1194,3664,30
21694914928,21694914926,-2,905,2134,30
21695902132,21695902128,-4,988,2747,30
21697562303,21697562299,-4,1075,1561,30
21697738023,21697738017,-6,1076,2506,30
21702445743,21702445738,-5,1158,4012,30
21704909698,21704909694,-4,767,1557,30
21706645549,21706645546,-3,839,2443,30
21712269050,21712269046,-4,1167,2411,30
21713581605,21713581601,-4,1300,2704,30
21718253225,21718253220,-5,902,2497,30
21718849841,21718849849,8,130,1304,30
21720458220,21720458214,-6,1247,2766,30
21720601249,21720601245,-4,1108,3161,30
21721851239,21721851235,-4,956,3206,30
21729250346,21729250347,1,1540,1184,30
21730298707,21730298702,-5,984,2514,30
21735447769,21735447772,3,4120,3107,30
21737594777,21737594773,-4,1197,2637,30
21743713025,21743713021,-4,1024,2376,30
21743801707,21743801722,15,956,3354,30
21746387752,21746387748,-4,505,2456,30
21750625391,21750625385,-6,1422,3093,30
21751865871,21751865868,-3,990,2718,30
21753489413,21753489409,-4,1016,2998,30
21753900265,21753900284,19,240,1003,30
21754992795,21754992791,-4,612,2301,30
21755535074,21755535054,-20,825,3192,30
21761504533,21761504535,2,1438,1145,30
21765022183,21765022178,-5,1221,4918,30
21771943890,21771943883,-7,1208,3196,30
21775564249,21775564246,-3,1041,2100,30
21778030856,21778030851,-5,926,2675,30
21778177425,21778177421,-4,689,2979,30
21780540735,21780540729,-6,921,2556,30
21780804177,21780804165,-12,226,1251,30
21785604257,21785604251,-6,1141,3343,30
21790922183,21790922178,-5,1087,2814,30
21791127256,21791127252,-4,1364,2963,30
21791518313,21791518311,-2,738,1696,30
21792722754,21792722750,-4,966,2210,30
21795438120,21795438114,-6,1305,2290,30
21796903022,21796903018,-4,738,1868,30
21797998840,21797998845,5,11845,6807,30
21807221327,21807221329,2,3047,3927,30
21808849495,21808849494,-1,983,1947,30
21809681127,21809681122,-5,800,3028,30
21819669973,21819669967,-6,988,2728,30
21821963151,21821963148,-3,1289,3761,30
21829736640,21829736634,-6,1047,2618,30
21833679779,21833679776,-3,837,2373,30
21838060537,21838060530,-7,793,2549,30
21841893310,21841893305,-5,1184,3488,30
21849144134,21849144131,-3,542,1349,30
21852262827,21852262821,-6,1014,2365,30
21852460843,21852460838,-5,855,2033,30
21853342583,21853342579,-4,1343,2942,30
21856178175,21856178172,-3,1159,2773,30
21856444747,21856444747,0,1255,2098,30
21858842806,21858842801,-5,1405,3405,30
21859490722,21859490716,-6,838,2643,30
21860066650,21860066658,8,192,792,30
21863818397,21863818394,-3,1288,2719,30
21864216271,21864216267,-4,940,3101,30
21867469489,21867469490,1,2980,2071,30
21867909991,21867909985,-6,1151,2754,30
21869135546,21869135566,20,125,673,30
21873666091,21873666087,-4,1388,2694,30
21874603363,21874603358,-5,964,3826,30
21889510046,21889510051,5,4449,2762,30
21895816845,21895816841,-4,899,2271,30
21897265650,21897265646,-4,1015,3276,30
21900996937,21900996933,-4,958,2735,30
21901112650,21901112650,0,1287,1770,30
21902151051,21902151047,-4,978,2546,30
21902227707,21902227703,-4,1111,3346,30
21903093808,21903093814,6,14,562,30
21905183399,21905183395,-4,906,3029,30
21912713090,21912713087,-3,1102,1995,30
21916278970,21916278966,-4,808,2741,30
21916555280,21916555303,23,896,2247,30
21918315912,21918315907,-5,1031,3385,30
21918608941,21918608937,-4,817,4194,30
21922094448,21922094442,-6,1843,7806,30
21925941748,21925941766,18,529,1517,30
21925979796,21925979779,-17,25206,28208,30
21928146801,21928146796,-5,829,3576,30
21929071590,21929071589,-1,479,954,30
21929746499,21929746501,2,3160,4426,30
21930954199,21930954197,-2,666,1428,30
21936390006,21936390001,-5,856,2175,30
21938074021,21938074018,-3,1308,2785,30
21938934394,21938934390,-4,657,3067,30
21951162155,21951162150,-5,743,3338,30
21953172766,21953172782,16,719,2138,30
21954224196,21954224197,1,5153,18032,30
21956763966,21956763969,3,1383,1500,30
21958983917,21958983910,-7,1345,4286,30
21965172129,21965172126,-3,827,3714,30
21967785961,21967785963,2,1483,1328,30
21977327747,21977327742,-5,750,2617,30
21984003307,21984003301,-6,1114,3353,30
21987159224,21987159219,-5,783,1822,30
21992448863,21992448858,-5,637,2689,30
21992555690,21992555687,-3,773,3369,30
21994981547,21994981541,-6,856,3424,30
21999287778,21999287772,-6,1466,4352,30
22012229936,22012229937,1,1604,1781,30
22014808247,22014808242,-5,892,2585,30
22016770400,22016770394,-6,1283,2625,30
22021113122,22021113121,-1,983,2085,30
22031687564,22031687558,-6,732,2745,30
22040504945,22040504941,-4,656,2061,30
22041268923,22041268920,-3,1156,2738,30
22044733947,22044733942,-5,1549,4143,30
22052479454,22052479453,-1,821,1399,30
22057831132,22057831128,-4,1269,3318,30
22058042314,22058042310,-4,1552,3762,30
22060744446,22060744442,-4,1050,1494,30
22064128786,22064128782,-4,973,2622,30
22065280385,22065280383,-2,1247,2229,30
22067708257,22067708253,-4,1296,2452,30
22071605378,22071605371,-7,954,2234,30
22071897195,22071897205,10,358,1153,30
22077441302,22077441298,-4,822,1314,30
22079518619,22079518613,-6,1136,3986,30
22079942706,22079942700,-6,159,890,30
22082754537,22082754532,-5,1193,2576,30
22086401264,22086401266,2,1591,1398,30
22088404463,22088404462,-1,1145,1576,30
22089408727,22089408724,-3,890,2518,30
22091960242,22091960238,-4,547,1758,30
22095307205,22095307206,1,3016,2840,30
22101537766,22101537760,-6,1043,2728,30
22109714202,22109714198,-4,818,1723,30
22113020151,22113020149,-2,1076,2052,30
22116078747,22116078742,-5,1254,3138,30
22116191962,22116191958,-4,1296,2981,30
22117683538,22117683519,-19,403,1197,30
22119028167,22119028161,-6,1100,2605,30
22119627999,22119627994,-5,947,2928,30
22120784194,22120784178,-16,83,865,30
22124816064,22124816059,-5,2107,7838,30
22125303913,22125303932,19,742,2548,30
22126105749,22126105744,-5,1095,3228,30
22129884370,22129884365,-5,1720,3083,30
22131182817,22131182811,-6,1042,3678,30
22131742939,22131742942,3,2724,1966,30
22132068367,22132068363,-4,592,1438,30
22134440775,22134440771,-4,1488,3597,30
22136072082,22136072078,-4,1003,2243,30
22137818490,22137818485,-5,990,2974,30
22138403153,22138403169,16,572,1420,30
22139726865,22139726862,-3,826,2688,30
22142583642,22142583637,-5,697,2704,30
22146933679,22146933674,-5,959,3893,30
22147676446,22147676448,2,3724,3135,30
22149266286,22149266281,-5,1291,2746,30
22150179591,22150179585,-6,1328,3103,30
22154169069,22154169065,-4,950,1825,30
22159308621,22159308614,-7,993,2556,30
22159844758,22159844758,0,1052,2406,30
22160504973,22160504968,-5,1245,3215,30
22166952737,22166952739,2,1289,1150,30
22168027682,22168027678,-4,1019,1999,30
22169594795,22169594791,-4,1082,2898,30
22173776015,22173776012,-3,1072,2765,30
22174812083,22174812079,-4,839,2327,30
22181798822,22181798818,-4,845,2723,30
22182986802,22182986796,-6,1371,3832,30
22186582830,22186582826,-4,779,3609,30
22187040193,22187040181,-12,112,1118,30
22195540199,22195540196,-3,1058,1715,30
22196145407,22196145406,-1,1151,1700,30
22199511513,22199511518,5,4505,2716,30
22200657685,22200657678,-7,1309,3333,30
22203275361,22203275357,-4,970,2416,30
22204191078,22204191074,-4,855,2799,30
22205635699,22205635694,-5,1098,2149,30
22207116594,22207116587,-7,836,2640,30
22207775062,22207775071,9,230,742,30
22212119898,22212119892,-6,1092,3097,30
22213837076,22213837070,-6,1285,3175,30
22215175537,22215175533,-4,1113,3199,30
22215361897,22215361919,22,931,3027,30
22217533972,22217533957,-15,1218,3931,30
22217881560,22217881543,-17,393,1469,30
22222653046,22222653046,0,1154,1346,30
22222692378,22222692374,-4,1009,2836,30
22223477489,22223477486,-3,1219,2722,30
22225032563,22225032558,-5,1338,3092,30
22225838938,22225838921,-17,33,1020,30
22233350832,22233350827,-5,1018,3585,30
22240879558,22240879555,-3,1373,3673,30
22241254426,22241254436,10,2711,1133,30
22246046499,22246046494,-5,859,3587,30
22251322169,22251322165,-4,949,3735,30
22254301617,22254301612,-5,1527,3958,30
22254504408,22254504405,-3,21313,8539,30
22254714463,22254714457,-6,998,4463,30
22260104972,22260104966,-6,816,2517,30
22261514498,22261514494,-4,1416,3509,30
22272241250,22272241254,4,2102,1590,30
22274398749,22274398745,-4,1271,2864,30
22274432408,22274432403,-5,909,2848,30
22279289773,22279289766,-7,820,2121,30
22281373986,22281373982,-4,1512,2247,30
22284448669,22284448673,4,2510,2032,30
22286486943,22286486937,-6,837,3269,30
22290488110,22290488107,-3,896,2379,30
22292963350,22292963351,1,1718,2410,30
22293253194,22293253189,-5,1302,2523,30
22295878451,22295878443,-8,995,3012,30
22296373808,22296373803,-5,1138,2904,30
22297330922,22297330918,-4,1121,3278,30
22299355709,22299355706,-3,1459,2437,30
22306886427,22306886424,-3,1404,2051,30
22307904105,22307904101,-4,758,1759,30
22309063778,22309063773,-5,990,2450,30
22309152483,22309152483,0,34033,49516,30
22309658985,22309658982,-3,1633,2936,30
22316786771,22316786769,-2,990,2739,30
22316990314,22316990333,19,431,2998,30
22317205882,22317205878,-4,1098,3217,30
22323369218,22323369214,-4,850,2800,30
22326968000,22326967994,-6,1360,3693,30
22338899499,22338899495,-4,1159,2842,30
22340773281,22340773278,-3,1152,2160,30
22341499515,22341499520,5,4339,2772,30
22347757831,22347757826,-5,1098,2325,30
22348533634,22348533630,-4,1085,2484,30
22348662057,22348662052,-5,76,1094,30
22355058163,22355058157,-6,1226,4483,30
22359161249,22359161244,-5,1203,2899,30
22364017063,22364017058,-5,1125,2940,30
22364076978,22364076975,-3,940,2221,30
22366118258,22366118253,-5,981,2294,30
22366419628,22366419641,13,555,1539,30
22383255064,22383255060,-4,1305,3875,30
22386883898,22386883894,-4,758,3327,30
22387023120,22387023105,-15,235,938,30
22389605557,22389605552,-5,782,2519,30
22395692178,22395692170,-8,1464,4178,30
22395826238,22395826234,-4,1028,3438,30
22396180304,22396180298,-6,108,740,30
22398544891,22398544899,8,3036,1720,30
22402079717,22402079712,-5,990,2564,30
22402964217,22402964213,-4,907,3079,30
22405730007,22405730012,5,2259,1654,30
22409896722,22409896716,-6,1104,3456,30
22414728325,22414728321,-4,1096,2927,30
22415853337,22415853334,-3,1099,2851,30
22416692832,22416692848,16,765,2759,30
22418317491,22418317485,-6,1246,3741,30
22424593318,22424593313,-5,905,1799,30
22429020206,22429020197,-9,765,1816,30
22431573535,22431573525,-10,37426,15361,30
22432400726,22432400730,4,4759,2735,30
22435988502,22435988510,8,4282,1258,30
22437184284,22437184282,-2,1431,2508,30
22437503079,22437503075,-4,1256,3382,30
22443672432,22443672428,-4,1155,3045,30
22443800947,22443800943,-4,958,3132,30
22448474191,22448474188,-3,942,3015,30
22450386470,22450386467,-3,943,2264,30
22451098225,22451098223,-2,1376,2009,30
22453460262,22453460257,-5,1138,3917,30
22453630296,22453630286,-10,193,1140,30
22464530403,22464530406,3,3612,1767,30
22464592250,22464592245,-5,1318,3634,30
22464812545,22464812539,-6,996,4154,30
22471226119,22471226113,-6,726,2336,30
22471692553,22471692573,20,1023,2511,30
22474578687,22474578681,-6,1223,3208,30
22475122375,22475122367,-8,627,2606,30
22477644470,22477644465,-5,1060,3389,30
22479586268,22479586264,-4,1475,2931,30
22482763094,22482763090,-4,917,3075,30
22482888729,22482888746,17,961,3251,30
22486322750,22486322746,-4,626,1574,30
22488775076,22488775071,-5,1323,2851,30
22499690449,22499690445,-4,1267,2832,30
22499900905,22499900898,-7,1334,2452,30
22500431622,22500431618,-4,1182,2774,30
22500770831,22500770826,-5,977,2680,30
22525185370,22525185363,-7,1160,3009,30
22525576214,22525576210,-4,1122,3392,30
22528235026,22528235021,-5,1157,2510,30
22528359852,22528359870,18,47,788,30
22532723299,22532723295,-4,1155,3028,30
22534251557,22534251554,-3,1219,2981,30
22542499803,22542499798,-5,1194,2087,30
22545416214,22545416210,-4,1188,3749,30
22547053314,22547053311,-3,748,2566,30
22554871734,22554871746,12,12055,34026,30
22582130214,22582130211,-3,857,2578,30
22586968838,22586968834,-4,1343,3415,30
22589468448,22589468442,-6,878,3350,30
22589571130,22589571126,-4,947,2449,30
22589741891,22589741887,-4,72,1176,30
22597084837,22597084843,6,3315,1318,30
22600193279,22600193277,-2,1072,3537,30
22602495261,22602495256,-5,1058,3318,30
22603087385,22603087387,2,2994,2100,30
22603316707,22603316702,-5,1251,3404,30
22608049886,22608049881,-5,1133,3712,30
22608094026,22608094027,1,1609,1641,30
22619312555,22619312550,-5,886,2503,30
22622057686,22622057682,-4,1104,2766,30
22623372587,22623372583,-4,1234,2978,30
22624112903,22624112897,-6,791,1687,30
22625078540,22625078516,-24,893,2270,30
22626073375,22626073370,-5,1223,2522,30
22628595222,22628595218,-4,1024,2940,30
22629530551,22629530554,3,7239,16146,30
22631608050,22631608046,-4,1398,2841,30
22644475540,22644475534,-6,1260,3896,30
22646783074,22646783070,-4,779,1934,30
22647139333,22647139329,-4,1075,2383,30
22647208859,22647208862,3,1632,1394,30
22648117613,22648117605,-8,642,2275,30
22649007267,22649007279,12,431,1146,30
22650483222,22650483218,-4,675,1754,30
22652833654,22652833650,-4,996,2703,30
22652882845,22652882849,4,2479,1864,30
22653601462,22653601458,-4,1032,2225,30
22657379545,22657379539,-6,1172,4514,30
22657770107,22657770102,-5,706,3050,30
22659152983,22659152978,-5,823,3183,30
22661362558,22661362554,-4,978,1838,30
22663032831,22663032833,2,1615,1162,30
22664983974,22664983971,-3,1344,1969,30
22666452703,22666452706,3,3276,2536,30
22670242231,22670242225,-6,1210,2910,30
22673412484,22673412479,-5,1066,2708,30
22674667754,22674667751,-3,1210,2130,30
22675027405,22675027401,-4,639,2663,30
22676675134,22676675126,-8,1029,2982,30
22677970772,22677970767,-5,1078,2709,30
22679809155,22679809153,-2,1064,3021,30
22679949769,22679949778,9,270,1145,30
22680267534,22680267529,-5,887,3101,30
22694709422,22694709418,-4,1099,3535,30
22696692741,22696692735,-6,1194,3065,30
22699040491,22699040487,-4,1191,2515,30
22699354199,22699354194,-5,1065,2965,30
22703151119,22703151114,-5,1000,1519,30
22705174525,22705174518,-7,1022,3122,30
22708288290,22708288286,-4,1188,3393,30
22708494424,22708494443,19,802,2370,30
22711350230,22711350226,-4,865,2973,30
22712097195,22712097190,-5,974,2778,30
22715546349,22715546346,-3,671,2331,30
22720286930,22720286937,7,2286,1744,30
22722223575,22722223569,-6,1620,4518,30
22722572998,22722572993,-5,817,3080,30
22726094770,22726094767,-3,817,2175,30
22730274613,22730274610,-3,1153,2023,30
22730861342,22730861337,-5,1562,3517,30
22731451715,22731451696,-19,1128,2853,30
22731819897,22731819917,20,767,2219,30
22733447932,22733447929,-3,1143,3020,30
22734203097,22734203094,-3,1173,3758,30
22741196195,22741196190,-5,1178,3117,30
22742596675,22742596693,18,523,1535,30
22749179282,22749179277,-5,979,3653,30
22753774892,22753774888,-4,1137,3582,30
22754911217,22754911208,-9,1107,2970,30
22760936906,22760936901,-5,1039,3564,30
22761165891,22761165910,19,898,5577,30
22761467302,22761467297,-5,1324,2883,30
22766651339,22766651334,-5,1065,2308,30
22774734002,22774733997,-5,858,2810,30
22779114034,22779114027,-7,826,2350,30
22784296517,22784296513,-4,1212,2481,30
22784422874,22784422889,15,623,2793,30
22785612493,22785612488,-5,1098,3615,30
22789842134,22789842129,-5,904,2692,30
22790836559,22790836553,-6,759,2398,30
22792240433,22792240450,17,799,3022,30
22792466625,22792466620,-5,1513,3701,30
22805503618,22805503620,2,2451,1958,30
22806806560,22806806563,3,2391,2097,30
22807312533,22807312526,-7,1394,3448,30
22810598731,22810598725,-6,728,1788,30
22814221313,22814221310,-3,1132,2203,30
22820610374,22820610370,-4,1224,2995,30
22829645409,22829645403,-6,960,4185,30
22834036211,22834036207,-4,954,1947,30
22834949350,22834949346,-4,1025,2232,30
22841068610,22841068606,-4,2343,5951,30
22841916075,22841916071,-4,784,2869,30
22842146890,22842146885,-5,1321,3058,30
22843520691,22843520689,-2,839,2400,30
22845206193,22845206194,1,2283,1477,30
22847481182,22847481178,-4,731,2228,30
22848587922,22848587917,-5,679,2605,30
22849740638,22849740633,-5,1052,2524,30
22850617194,22850617189,-5,1118,3305,30
22851103974,22851103978,4,1473,1589,30
22851179514,22851179510,-4,1180,3136,30
22851637555,22851637574,19,591,3141,30
22861564689,22861564682,-7,1046,2966,30
22867223211,22867223206,-5,859,2712,30
22868418389,22868418382,-7,1649,5336,30
22872814402,22872814401,-1,1222,2244,30
22882436996,22882436993,-3,963,2130,30
22896272290,22896272288,-2,1670,3315,30
22902269349,22902269342,-7,1323,4137,30
22904727866,22904727872,6,11628,29533,30
22905892721,22905892717,-4,1146,2832,30
22906420410,22906420390,-20,208,1269,30
22907129923,22907129905,-18,988,2666,30
22918783190,22918783186,-4,1213,3143,30
22924631422,22924631417,-5,841,2311,30
22930192970,22930192966,-4,1229,2765,30
22933409693,22933409689,-4,1207,3046,30
22933670053,22933670049,-4,823,3113,30
22942586834,22942586841,7,3442,1773,30
22951242367,22951242363,-4,1330,3584,30
22953619954,22953619950,-4,928,1825,30
22954035366,22954035361,-5,940,2531,30
22956885522,22956885518,-4,809,1294,30
22957259746,22957259742,-4,1096,3953,30
22957577385,22957577397,12,329,848,30
22957775048,22957775042,-6,1117,2657,30
22959922762,22959922765,3,16066,44566,30
22961332119,22961332115,-4,960,2985,30
22963339727,22963339722,-5,1489,3508,30
22968189301,22968189297,-4,1553,3678,30
22968622309,22968622304,-5,1417,3803,30
22971226785,22971226780,-5,1096,2318,30
22976847398,22976847393,-5,979,2998,30
22983692572,22983692567,-5,1128,3702,30
22985199307,22985199302,-5,880,2462,30
22986173320,22986173326,6,3714,1435,30
22992483267,22992483263,-4,626,1793,30
22993359254,22993359250,-4,797,2132,30
22997602367,22997602367,0,2505,2118,30
22998291062,22998291057,-5,1178,2705,30
23000663116,23000663117,1,2939,3445,30
23002207402,23002207404,2,1815,1640,30
23004959675,23004959694,19,530,1559,30
23006123622,23006123617,-5,1526,3626,30
23013183057,23013183053,-4,1234,2535,30
23020310227,23020310229,2,1348,1336,30
23020423977,23020423973,-4,976,2259,30
23025086945,23025086941,-4,1006,2085,30
23025781119,23025781113,-6,1248,4046,30
23027203274,23027203269,-5,353,1947,30
23030835015,23030835011,-4,671,2444,30
23032995590,23032995586,-4,1445,4651,30
23036105273,23036105269,-4,953,2401,30
23040613849,23040613846,-3,1089,2943,30
23043857552,23043857563,11,1293,1227,30
23044728738,23044728757,19,1191,2785,30
23045090869,23045090865,-4,1040,2613,30
23045857601,23045857605,4,2141,1427,30
23046038884,23046038890,6,3401,962,30
23049041686,23049041682,-4,994,3656,30
23056034265,23056034260,-5,1006,3163,30
23058093771,23058093763,-8,1159,3378,30
23066258089,23066258086,-3,1162,2444,30
23067335023,23067335018,-5,1068,3130,30
23070057106,23070057101,-5,1254,2990,30
23074497190,23074497184,-6,784,2863,30
23075574890,23075574886,-4,957,2562,30
23076342529,23076342545,16,873,2587,30
23080619995,23080619998,3,1782,1566,30
23092785903,23092785898,-5,1287,3425,30
23095273986,23095273982,-4,1150,2755,30
23097406365,23097406360,-5,932,2539,30
23098902072,23098902066,-6,1008,2416,30
23100547159,23100547154,-5,1206,2748,30
23102560085,23102560082,-3,1343,2609,30
23108720041,23108720046,5,1719,965,30
23111538310,23111538307,-3,995,3075,30
23114622453,23114622453,0,1741,1760,30
23120744039,23120744034,-5,886,2410,30
23126766473,23126766468,-5,1340,2980,30
23130676366,23130676359,-7,1201,2753,30
23130932173,23130932170,-3,896,3313,30
23131129905,23131129924,19,1191,3009,30
23131874105,23131874126,21,690,2829,30
23133032251,23133032243,-8,634,2468,30
23133366928,23133366950,22,160,849,30
23133687539,23133687525,-14,833,3280,30
23138143313,23138143319,6,2577,705,30
23139895679,23139895674,-5,985,3774,30
23141708682,23141708678,-4,1514,3343,30
23142983970,23142983965,-5,2292,7033,30
23143577017,23143577012,-5,1252,3165,30
23144297426,23144297406,-20,1012,3660,30
23146210327,23146210322,-5,980,3045,30
23147551649,23147551647,-2,831,2238,30
23149962574,23149962569,-5,903,2327,30
23150181954,23150181966,12,491,1999,30
23152436837,23152436834,-3,1288,1777,30
23153649126,23153649124,-2,1008,1418,30
23156955502,23156955497,-5,928,2667,30
23179448929,23179448925,-4,976,2799,30
23179798777,23179798799,22,1342,3621,30
23182537994,23182537990,-4,1155,2458,30
23189119566,23189119560,-6,1185,2696,30
23189908641,23189908639,-2,805,2899,30
23195301775,23195301769,-6,1009,2249,30
23196048266,23196048259,-7,628,1981,30
23198449454,23198449451,-3,865,3030,30
23207807929,23207807947,18,732,1903,30
23210475359,23210475354,-5,1131,2490,30
23213073715,23213073711,-4,999,2558,30
23213457978,23213457974,-4,1300,3795,30
23214151505,23214151502,-3,1085,2252,30
23214390990,23214390984,-6,1391,2970,30
23215593624,23215593619,-5,1339,3086,30
23215916850,23215916839,-11,1067,3932,30
23217230589,23217230585,-4,5652,16303,30
23219912289,23219912285,-4,1091,2660,30
23222152894,23222152889,-5,1071,2652,30
23226508912,23226508909,-3,1183,2949,30
23228251753,23228251748,-5,1072,3291,30
23232843829,23232843821,-8,786,2691,30
23235654722,23235654717,-5,1066,2964,30
23236980981,23236980972,-9,1133,4833,30
23243166557,23243166562,5,12336,7021,30
23248305162,23248305155,-7,926,2651,30
23248689780,23248689775,-5,1079,2005,30
23251952163,23251952158,-5,975,3009,30
23265620070,23265620067,-3,1045,1867,30
23267140166,23267140162,-4,1232,1978,30
23268842864,23268842867,3,2150,1633,30
23276271492,23276271486,-6,1120,3153,30
23282317107,23282317103,-4,1324,3183,30
23285220205,23285220199,-6,1201,2673,30
23285615121,23285615139,18,482,2334,30
23289908405,23289908402,-3,1170,3266,30
23294205599,23294205593,-6,604,1683,30
23296568326,23296568320,-6,882,2240,30
23300471853,23300471849,-4,848,2334,30
23303124484,23303124498,14,731,2122,30
23305514740,23305514733,-7,770,2048,30
23308243039,23308243034,-5,1113,1754,30
23309587624,23309587618,-6,1319,3677,30
23313809599,23313809593,-6,875,3185,30
23316586707,23316586712,5,3857,1976,30
23318305758,23318305753,-5,816,3031,30
23318714784,23318714801,17,353,1152,30
23319566919,23319566914,-5,774,2150,30
23320484483,23320484478,-5,853,2407,30
23321264755,23321264749,-6,648,3039,30
23331507635,23331507631,-4,1202,2483,30
23333112462,23333112470,8,2121,903,30
23334525779,23334525797,18,301,1053,30
23336650614,23336650610,-4,955,3108,30
23341667619,23341667614,-5,920,2874,30
23343742057,23343742046,-11,1085,2976,30
23343951460,23343951478,18,1056,1827,30
23344639011,23344639007,-4,919,2971,30
23348501565,23348501561,-4,1321,2859,30
23353850679,23353850674,-5,993,1758,30
23355100865,23355100860,-5,1322,3329,30
23357861281,23357861278,-3,1336,2265,30
23358162783,23358162777,-6,1054,3407,30
23361390502,23361390498,-4,1424,3030,30
23362433154,23362433149,-5,822,3503,30
23365540955,23365540951,-4,995,2923,30
23366619574,23366619570,-4,1067,3544,30
23370067153,23370067149,-4,1351,2435,30
23370899314,23370899310,-4,743,1948,30
23371830766,23371830770,4,1236,1022,30
23372401920,23372401915,-5,543,1532,30
23377887467,23377887461,-6,604,2198,30
23379006275,23379006269,-6,1118,2600,30
23385140437,23385140433,-4,1098,3848,30
23388922190,23388922185,-5,1329,2747,30
23392331926,23392331922,-4,552,2146,30
23394326066,23394326061,-5,1135,3192,30
23394581019,23394580997,-22,96,616,30
23395005649,23395005670,21,379,1873,30
23401906222,23401906229,7,4909,1944,30
23404706250,23404706252,2,1834,1675,30
23408666251,23408666246,-5,1016,3302,30
23412749504,23412749500,-4,1049,2698,30
23428321511,23428321506,-5,1089,3285,30
23429572966,23429572961,-5,1214,3087,30
23433927822,23433927818,-4,1013,3010,30
23434784720,23434784717,-3,809,2333,30
23435066408,23435066423,15,876,3084,30
23435749654,23435749649,-5,1125,1694,30
23439336575,23439336571,-4,753,2039,30
23440489795,23440489783,-12,338,1061,30
23442218954,23442218949,-5,871,2717,30
23447500346,23447500340,-6,1439,3486,30
23456565509,23456565505,-4,1581,3697,30
23457551025,23457551022,-3,863,1303,30
23463432691,23463432670,-21,184,1123,30
23463710240,23463710233,-7,1509,4179,30
23467410201,23467410199,-2,1321,1932,30
23468531826,23468531821,-5,786,2179,30
23470795472,23470795469,-3,1035,3379,30
23475974438,23475974434,-4,1320,1747,30
23480939466,23480939472,6,4435,2465,30
23485795545,23485795539,-6,1443,3238,30
23489676314,23489676310,-4,1350,4689,30
23494742476,23494742474,-2,1916,2658,30
23497487643,23497487638,-5,649,2133,30
23499564147,23499564142,-5,1480,4345,30
23505516488,23505516485,-3,907,2906,30
23507197953,23507197949,-4,1369,4158,30
23515287702,23515287697,-5,590,2381,30
23520142898,23520142894,-4,954,3314,30
23520818774,23520818770,-4,1181,2594,30
23521452633,23521452646,13,67,964,30
23525093372,23525093367,-5,694,3017,30
23526732302,23526732297,-5,1304,4802,30
23531548979,23531548975,-4,1071,2569,30
23535860937,23535860934,-3,776,1950,30
23540257366,23540257361,-5,881,2549,30
23541125905,23541125902,-3,1186,2787,30
23548076814,23548076809,-5,1079,3602,30
23548405954,23548405951,-3,611,2182,30
23554010546,23554010539,-7,1171,3208,30
23554349439,23554349434,-5,1223,3894,30
23556828510,23556828504,-6,1022,2150,30
23559511824,23559511830,6,2388,1150,30
23561014805,23561014798,-7,1474,2814,30
23561876763,23561876759,-4,1350,3156,30
23562481990,23562481985,-5,739,2834,30
23564992018,23564992011,-7,709,2497,30
23571597490,23571597489,-1,1371,3296,30
23573400942,23573400937,-5,1009,3570,30
23579234496,23579234493,-3,1355,3903,30
23579547354,23579547351,-3,1043,2860,30
23583251282,23583251278,-4,1018,4377,30
23583686435,23583686431,-4,899,2803,30
23584853434,23584853426,-8,1104,4147,30
23588416498,23588416494,-4,808,2114,30
23593437321,23593437316,-5,1076,2759,30
23595221285,23595221281,-4,846,2622,30
23595587017,23595587026,9,101,1051,30
23596418925,23596418921,-4,1051,2585,30
23597629581,23597629578,-3,1023,3416,30
23601558007,23601558005,-2,1336,3050,30
23607969171,23607969163,-8,944,2729,30
23610533226,23610533221,-5,1113,3106,30
23615260619,23615260615,-4,890,4040,30
23615555794,23615555810,16,718,1193,30
23615997843,23615997837,-6,1708,3685,30
23618403602,23618403602,0,1971,2730,30
23622323310,23622323327,17,1503,2139,30
23622965014,23622965010,-4,1001,3677,30
23626686929,23626686925,-4,840,2745,30
23629143225,23629143221,-4,1169,2978,30
23634553248,23634553245,-3,1536,2319,30
23635799052,23635799048,-4,838,1485,30
23638578551,23638578547,-4,998,1353,30
23639733426,23639733421,-5,1237,3748,30
23644815516,23644815522,6,4441,1697,30
23650276165,23650276161,-4,1207,3138,30
23650736844,23650736859,15,618,1361,30
23650926392,23650926389,-3,792,1581,30
23656095280,23656095275,-5,1205,3121,30
23672163739,23672163733,-6,914,3871,30
23672739098,23672739094,-4,1038,2674,30
23674569054,23674569058,4,3046,1954,30
23683267242,23683267237,-5,966,3365,30
23683637435,23683637427,-8,693,2668,30
23684227900,23684227897,-3,2290,4388,30
23686481639,23686481634,-5,644,2419,30
23687560315,23687560317,2,2474,2990,30
23691449166,23691449161,-5,1068,3035,30
23701234915,23701234907,-8,1221,3934,30
23709610815,23709610810,-5,1256,3238,30
23710248896,23710248883,-13,981,3045,30
23716568383,23716568378,-5,1248,3546,30
23716727187,23716727182,-5,124,1064,30
23727261710,23727261710,0,2285,2192,30
23730302987,23730302988,1,2517,2481,30
23735893101,23735893095,-6,1218,3923,30
23737803023,23737803018,-5,989,3294,30
23738753028,23738753025,-3,842,2678,30
23740448079,23740448086,7,4878,1866,30
23742361584,23742361580,-4,1000,2642,30
23742746284,23742746295,11,321,1220,30
23744588490,23744588489,-1,833,2420,30
23746887791,23746887786,-5,923,3029,30
23747095459,23747095443,-16,306,1301,30
23747562281,23747562299,18,327,1705,30
23749101778,23749101773,-5,789,3589,30
23753858382,23753858379,-3,684,1367,30
23754096336,23754096321,-15,1046,2204,30
23756138122,23756138118,-4,862,2215,30
23772053407,23772053403,-4,859,2276,30
23774396142,23774396141,-1,1206,2346,30
23776403682,23776403678,-4,1286,3012,30
23776527404,23776527421,17,940,2280,30
23778017478,23778017474,-4,1321,3350,30
23778330912,23778330918,6,2999,1319,30
23779591318,23779591313,-5,1088,3310,30
23779924410,23779924422,12,414,1046,30
23783391861,23783391858,-3,1241,1600,30
23784779410,23784779407,-3,1102,2497,30
23786334641,23786334653,12,14539,50700,30
23789592988,23789592989,1,2900,3914,30
23790575210,23790575208,-2,2719,5081,30
23791999024,23791999029,5,3331,1363,30
23795069867,23795069862,-5,764,4153,30
23795340443,23795340440,-3,936,2781,30
23796723674,23796723670,-4,1011,2709,30
23802396726,23802396721,-5,1168,4344,30
23805220590,23805220586,-4,783,2249,30
23805763204,23805763197,-7,33328,15291,30
23811715926,23811715923,-3,1166,2802,30
23812786398,23812786394,-4,777,4027,30
23813337182,23813337182,0,823,1895,30
23816036666,23816036659,-7,959,2495,30
23818200311,23818200298,-13,12211,42354,30
23818394289,23818394283,-6,1078,3094,30
23819286010,23819286005,-5,846,3218,30
23819815768,23819815763,-5,973,2379,30
23822778677,23822778669,-8,2663,8899,30
23829888014,23829888009,-5,1085,2990,30
23830942979,23830942981,2,3152,2621,30
23837920688,23837920683,-5,1179,2373,30
23838429760,23838429754,-6,909,3274,30
23839544838,23839544834,-4,896,2806,30
23843166715,23843166709,-6,1472,4348,30
23849177259,23849177255,-4,1431,3704,30
23850096679,23850096674,-5,1264,3294,30
23854830841,23854830837,-4,559,2516,30
23861194143,23861194139,-4,796,2800,30
23867834163,23867834164,1,1704,1568,30
23868642343,23868642341,-2,1348,1463,30
23879671935,23879671930,-5,1740,6638,30
23890359562,23890359581,19,848,1315,30
23891029942,23891029939,-3,798,2820,30
23891689898,23891689897,-1,925,2063,30
23899589907,23899589903,-4,1085,2691,30
23900414051,23900414051,0,1103,1652,30
23901920639,23901920641,2,1672,1624,30
23906199558,23906199561,3,1987,2050,30
23906941755,23906941751,-4,1367,3251,30
23907893598,23907893597,-1,1401,1461,30
23908647470,23908647478,8,7150,3135,30
23909363261,23909363258,-3,1062,2362,30
23917210287,23917210282,-5,1245,3772,30
23921730728,23921730730,2,1781,1700,30
23923080442,23923080436,-6,1185,2814,30
23923495538,23923495533,-5,719,2095,30
23926335742,23926335738,-4,1396,3158,30
23929292621,23929292617,-4,1453,3754,30
23931061435,23931061433,-2,942,1925,30
23937522757,23937522748,-9,21101,17423,30
23941448212,23941448220,8,16244,30856,30
23941829742,23941829744,2,1907,1773,30
23942415087,23942415081,-6,652,2968,30
23947186297,23947186290,-7,1189,5150,30
23953453954,23953453950,-4,943,3582,30
23956255775,23956255769,-6,1166,2939,30
23962837871,23962837867,-4,1064,2412,30
23972041466,23972041462,-4,1206,3198,30
23972728234,23972728230,-4,1624,4095,30
23975979951,23975979946,-5,1054,2882,30
23978988899,23978988893,-6,753,1728,30
23988576195,23988576191,-4,1213,2092,30
23989190810,23989190791,-19,862,1630,30
23992564081,23992564078,-3,962,2310,30
23995840031,23995840034,3,1454,1256,30
23996472199,23996472195,-4,984,2081,30
23997126518,23997126516,-2,1191,2963,30
24000409274,24000409269,-5,1081,2950,30
24002038162,24002038155,-7,974,3013,30
24005748051,24005748046,-5,978,2883,30
24009859390,24009859386,-4,619,2695,30
24015833330,24015833326,-4,972,2924,30
24016126214,24016126210,-4,780,2827,30
24018666801,24018666795,-6,1072,2572,30
24018699563,24018699563,0,305,788,30
24019159136,24019159121,-15,241,762,30
24025005007,24025005007,0,1443,1168,30
24030619565,24030619560,-5,1100,2768,30
24031651470,24031651458,-12,12012,43826,30
24032380139,24032380135,-4,1167,3741,30
24037999514,24037999510,-4,1433,2429,30
24039991833,24039991831,-2,762,1994,30
24040678815,24040678811,-4,1543,3263,30
24041072052,24041072053,1,1194,1520,30
24044868636,24044868632,-4,992,3120,30
24050632537,24050632533,-4,1218,2714,30
24059678665,24059678661,-4,831,2632,30
24063189189,24063189185,-4,1336,2119,30
24063419439,24063419434,-5,772,2504,30
24064730331,24064730326,-5,1019,1990,30
24068702293,24068702289,-4,1281,3259,30
24084878812,24084878807,-5,1278,3380,30
24086021534,24086021531,-3,739,3203,30
24086179907,24086179925,18,543,1478,30
24086410009,24086410005,-4,446,2541,30
24087085537,24087085530,-7,92,955,30
24088603013,24088603007,-6,1000,2712,30
24089754903,24089754899,-4,1064,3031,30
24093554223,24093554218,-5,939,3445,30
24103676230,24103676224,-6,940,3688,30
24104960953,24104960950,-3,1193,3792,30
24105302500,24105302503,3,1551,1221,30
24117021558,24117021554,-4,1227,2928,30
24121490545,24121490538,-7,1374,1966,30
24126028439,24126028433,-6,827,3257,30
24136850222,24136850221,-1,1033,1719,30
24139960159,24139960155,-4,818,2642,30
24140369082,24140369081,-1,1061,1914,30
24144409072,24144409068,-4,1477,3079,30
24145590056,24145590051,-5,1199,3458,30
24147009566,24147009587,21,408,2544,30
24148080755,24148080750,-5,1234,1953,30
24150631529,24150631525,-4,1028,1707,30
24151184385,24151184381,-4,1180,3395,30
24151341478,24151341474,-4,544,1899,30
24151649369,24151649378,9,142,1236,30
24154361296,24154361292,-4,1349,3540,30
24155815858,24155815859,1,1231,1290,30
24169112338,24169112333,-5,691,2492,30
24170052922,24170052917,-5,1106,3488,30
24171353157,24171353151,-6,866,2397,30
24171541866,24171541869,3,205,769,30
24172848016,24172848007,-9,155,1132,30
24172978795,24172978813,18,1621,4421,30
24179187929,24179187927,-2,844,1547,30
24181454111,24181454106,-5,1268,3232,30
24182865886,24182865881,-5,938,2071,30
24194461558,24194461554,-4,749,2868,30
24195808000,24195808005,5,1707,1500,30
24203251603,24203251599,-4,1352,2885,30
24204621306,24204621299,-7,934,3750,30
24205082704,24205082691,-13,881,2010,30
24208873686,24208873681,-5,1168,3480,30
24209022409,24209022427,18,260,805,30
24211394578,24211394573,-5,964,2158,30
24212492551,24212492547,-4,1401,4114,30
24220802850,24220802855,5,1790,1506,30
24233459822,24233459815,-7,603,1500,30
24233488250,24233488246,-4,653,2072,30
24234575316,24234575311,-5,1386,4073,30
24235770639,24235770634,-5,1268,3803,30
24236229344,24236229327,-17,1004,2232,30
24237306534,24237306527,-7,972,2875,30
24237810757,24237810778,21,846,1808,30
24241194027,24241194027,0,1406,2049,30
24241864373,24241864370,-3,951,2370,30
24246451974,24246451971,-3,1206,2948,30
24251658076,24251658075,-1,129,1371,30
24252004350,24252004346,-4,983,2534,30
24255213390,24255213386,-4,1021,3485,30
24262690040,24262690037,-3,791,2105,30
24268891003,24268890998,-5,890,2701,30
24270414438,24270414435,-3,1311,3239,30
24272252285,24272252281,-4,1014,2686,30
24276622053,24276622047,-6,1318,3000,30
24281642383,24281642380,-3,1342,2366,30
24283193714,24283193709,-5,1123,2127,30
24284170037,24284170034,-3,898,1833,30
24285801519,24285801517,-2,1417,2968,30
24291201021,24291201019,-2,2427,4122,30
24295993523,24295993519,-4,829,1866,30
24298562585,24298562590,5,5262,2805,30
24300358058,24300358051,-7,747,2861,30
24303743275,24303743273,-2,859,1690,30
24316997723,24316997726,3,2854,1873,30
24317284006,24317284000,-6,925,2993,30
24319616579,24319616574,-5,770,1682,30
24322106286,24322106282,-4,1201,2832,30
24328556775,24328556772,-3,1683,3970,30
24329755170,24329755166,-4,959,2180,30
24330337049,24330337044,-5,824,2542,30
24330707569,24330707566,-3,890,1124,30
24331560177,24331560187,10,16679,20453,30
24331854793,24331854797,4,2122,1290,30
24334622546,24334622542,-4,1414,3230,30
24338875864,24338875860,-4,1115,2794,30
24340524030,24340524027,-3,1480,3925,30
24342398687,24342398683,-4,783,2879,30
24342447233,24342447245,12,271,974,30
24345196218,24345196211,-7,1265,3187,30
24347107628,24347107618,-10,1967,3947,30
24348620735,24348620731,-4,1229,4413,30
24364285882,24364285878,-4,649,2971,30
24364910098,24364910110,12,271,2547,30
24365823432,24365823426,-6,937,2453,30
24366878019,24366878013,-6,949,2755,30
24370355698,24370355693,-5,1019,3135,30
24371330357,24371330362,5,3877,1134,30
24377468131,24377468127,-4,772,2957,30
24379261613,24379261609,-4,796,3684,30
24379429776,24379429759,-17,287,1820,30
24380410360,24380410355,-5,934,2718,30
24380901618,24380901620,2,361,1577,30
24386444959,24386444955,-4,844,1447,30
24389482506,24389482502,-4,1182,2653,30
24400571412,24400571408,-4,809,1713,30
24400994345,24400994338,-7,2301,9293,30
24401809695,24401809695,0,1213,2312,30
24404835150,24404835146,-4,1133,2096,30
24406251462,24406251458,-4,855,2363,30
24408459686,24408459682,-4,1217,2793,30
24413786606,24413786601,-5,1087,3556,30
24421385085,24421385087,2,3003,2011,30
24427157616,24427157609,-7,1064,4201,30
24427549106,24427549102,-4,1000,2741,30
24429096982,24429096978,-4,644,1996,30
24429153544,24429153562,18,722,1527,30
24440251251,24440251249,-2,1085,2698,30
24444693963,24444693944,-19,1870,513,30
24445100827,24445100830,3,2950,1992,30
24448052707,24448052684,-23,1208,3233,30
24451654791,24451654788,-3,1162,3353,30
24452937318,24452937319,1,1576,1419,30
24456139603,24456139598,-5,1136,3015,30
24458518147,24458518142,-5,781,2303,30
24459735958,24459735966,8,7849,3312,30
24460917402,24460917397,-5,830,2910,30
24466668469,24466668464,-5,886,2864,30
24467743440,24467743437,-3,1183,1936,30
24468498662,24468498666,4,618,1264,30
24473747855,24473747850,-5,972,3096,30
24478969165,24478969164,-1,341,1045,30
24483175476,24483175471,-5,1226,3372,30
24483879700,24483879694,-6,946,4015,30
24488815581,24488815576,-5,1221,3233,30
24495032881,24495032878,-3,1042,3209,30
24495697692,24495697687,-5,1200,3027,30
24495925411,24495925405,-6,970,3687,30
24496255819,24496255822,3,284,821,30
24501662839,24501662835,-4,897,2124,30
24507833998,24507833993,-5,478,2995,30
24508451670,24508451665,-5,1052,2631,30
24510183197,24510183194,-3,714,2199,30
24510972383,24510972380,-3,839,1992,30
24512913647,24512913642,-5,608,2158,30
24513224525,24513224525,0,1066,1834,30
24513380973,24513380969,-4,1080,2415,30
24513503632,24513503653,21,642,2539,30
24516115911,24516115906,-5,1294,2160,30
24517270889,24517270885,-4,1266,3202,30
24521295163,24521295163,0,1156,1072,30
24523863094,24523863090,-4,1019,2947,30
24525034547,24525034542,-5,1251,3150,30
24527075627,24527075622,-5,809,2646,30
24527667778,24527667798,20,275,791,30
24529049813,24529049809,-4,1196,2152,30
24529679715,24529679710,-5,1329,3480,30
24536365315,24536365312,-3,946,2273,30
24536453081,24536453096,15,627,2682,30
24538785919,24538785914,-5,1036,2362,30
24540326066,24540326086,20,753,2254,30
24547131058,24547131055,-3,1218,2091,30
24548041213,24548041217,4,4260,2602,30
24550013286,24550013283,-3,852,2803,30
24550403610,24550403605,-5,1250,2798,30
24557176100,24557176095,-5,1110,2239,30
24561132432,24561132426,-6,1240,3205,30
24561272159,24561272154,-5,774,2569,30
24561605393,24561605387,-6,193,805,30
24565557857,24565557852,-5,688,2626,30
24567884941,24567884943,2,2040,2213,30
24570769826,24570769824,-2,995,2044,30
24572771790,24572771784,-6,1105,2984,30
24572827730,24572827727,-3,157,892,30
24573856490,24573856486,-4,1069,2136,30
24574936874,24574936870,-4,1206,2713,30
24576307441,24576307435,-6,1363,4276,30
24576393436,24576393450,14,189,1253,30
24581872655,24581872651,-4,1061,2228,30
24582737415,24582737411,-4,988,2165,30
24599032426,24599032421,-5,1196,2833,30
24605805735,24605805729,-6,1129,4497,30
24615352027,24615352021,-6,705,2012,30
24617996006,24617996003,-3,1484,3595,30
24618397016,24618397005,-11,943,2975,30
24620486228,24620486224,-4,482,2583,30
24622136614,24622136629,15,1024,239,30
24623641649,24623641654,5,2819,1612,30
24624290280,24624290274,-6,1009,2839,30
24628321005,24628321002,-3,915,1965,30
24629300475,24629300471,-4,904,2084,30
24630119132,24630119129,-3,1267,2769,30
24638889975,24638889970,-5,966,2832,30
24640089367,24640089363,-4,1000,2094,30
24640789654,24640789651,-3,1137,2405,30
24643681761,24643681757,-4,988,3197,30
24643945066,24643945046,-20,1101,2982,30
24644486482,24644486487,5,84,750,30
24644748619,24644748616,-3,1171,2580,30
24646970132,24646970149,17,372,1092,30
24647841886,24647841881,-5,678,1671,30
24655638230,24655638227,-3,1172,3040,30
24656286153,24656286165,12,265,944,30
24659411343,24659411339,-4,1045,2559,30
24662370491,24662370486,-5,656,2609,30
24662738289,24662738274,-15,631,2684,30
24664248831,24664248827,-4,1089,2377,30
24669595557,24669595552,-5,988,3368,30
24678755582,24678755580,-2,916,1928,30
24679868979,24679868977,-2,846,1146,30
24684472897,24684472891,-6,1448,4462,30
24688289810,24688289805,-5,1629,6364,30
24689642903,24689642899,-4,842,3030,30
24692436742,24692436738,-4,974,2096,30
24702688941,24702688938,-3,1040,2797,30
24706365697,24706365693,-4,678,2703,30
24706650171,24706650185,14,350,3399,30
24715368011,24715368006,-5,1242,1967,30
24716041191,24716041188,-3,1326,1467,30
24725059826,24725059820,-6,1126,4397,30
24725688074,24725688070,-4,957,2263,30
24728643505,24728643501,-4,1183,2445,30
24729356175,24729356171,-4,1010,2746,30
24736251030,24736251031,1,1121,1250,30
24741408649,24741408646,-3,891,2700,30
24746180061,24746180058,-3,1203,1985,30
24748269028,24748269025,-3,1049,2982,30
24749201020,24749201039,19,349,932,30
24750135454,24750135450,-4,851,1408,30
24752319255,24752319250,-5,1026,3244,30
24754730689,24754730683,-6,1395,3574,30
24763931728,24763931724,-4,1284,2946,30
24767070430,24767070426,-4,1040,3232,30
24770467265,24770467263,-2,1442,2752,30
24771099307,24771099304,-3,880,2292,30
24771943050,24771943046,-4,896,2578,30
24774167174,24774167173,-1,969,2551,30
24775793642,24775793638,-4,994,2564,30
24781342404,24781342422,18,1100,2505,30
24783330774,24783330770,-4,984,2203,30
24785423479,24785423456,-23,341,1009,30
24786933155,24786933151,-4,795,2840,30
24794983101,24794983097,-4,1150,3362,30
24795047058,24795047050,-8,292,613,30
24805189281,24805189277,-4,680,1723,30
24806519891,24806519887,-4,1210,3641,30
24808421530,24808421527,-3,819,1746,30
24810256353,24810256357,4,2272,1595,30
24812566852,24812566846,-6,1326,3936,30
24813468235,24813468232,-3,655,2900,30
24814081315,24814081332,17,585,1652,30
24816517973,24816517967,-6,647,2640,30
24821026757,24821026753,-4,1348,3409,30
24823559670,24823559662,-8,912,3000,30
24828861533,24828861529,-4,1324,3621,30
24838627673,24838627669,-4,1121,2778,30
24838865585,24838865585,0,257,957,30
24843438324,24843438319,-5,1266,3487,30
24843844842,24843844837,-5,1042,2235,30
24854506424,24854506432,8,20600,40039,30
24861782250,24861782255,5,4077,2135,30
24869808731,24869808726,-5,1562,3813,30
24873240454,24873240449,-5,815,3260,30
24874245887,24874245882,-5,1074,3185,30
24878685231,24878685226,-5,1107,2186,30
24878751007,24878751001,-6,972,4123,30
24885948058,24885948056,-2,658,2080,30
24888477801,24888477795,-6,1487,3447,30
24892296954,24892296970,16,763,2067,30
24894784903,24894784899,-4,1528,2796,30
24899064749,24899064745,-4,815,2267,30
24903184104,24903184098,-6,999,3749,30
24903342788,24903342782,-6,1104,3581,30
24906300692,24906300689,-3,793,2266,30
24915486034,24915486029,-5,1254,2017,30
24923059834,24923059830,-4,852,2437,30
24929333444,24929333440,-4,1422,3226,30
24942915245,24942915241,-4,1272,3550,30
24943894846,24943894847,1,1970,2016,30
24945682473,24945682469,-4,1037,3394,30
24947353315,24947353308,-7,1523,3412,30
24947827769,24947827771,2,212,704,30
24949996130,24949996125,-5,1007,2377,30
24950209207,24950209202,-5,1260,3281,30
24951013378,24951013375,-3,398,1069,30
24959053513,24959053507,-6,747,2509,30
24963612430,24963612425,-5,1292,3390,30
24964205117,24964205113,-4,1401,3504,30
24964878991,24964878985,-6,462,1503,30
24971926278,24971926273,-5,1373,3908,30
24979206446,24979206439,-7,923,2402,30
24979293393,24979293413,20,1087,2186,30
24980832001,24980831998,-3,1893,3334,30
24981557357,24981557353,-4,1102,3357,30
24990613161,24990613162,1,1827,1637,30
24991587979,24991587974,-5,402,2237,30
24991695814,24991695810,-4,1612,5681,30
24993429431,24993429425,-6,682,3877,30
24994439670,24994439666,-4,748,5036,30
24994971578,24994971590,12,384,998,30
24995652067,24995652064,-3,1045,3056,30
24996723687,24996723682,-5,1377,3689,30
25000683891,25000683886,-5,909,3093,30
25006475712,25006475709,-3,1259,3642,30
25011928734,25011928734,0,851,1625,30
25015305554,25015305575,21,1595,2808,30
25018944879,25018944874,-5,1426,3406,30
25019878830,25019878825,-5,881,3516,30
25020437794,25020437790,-4,1019,3404,30
25025059698,25025059693,-5,573,1576,30
25026157089,25026157085,-4,774,2481,30
25026362659,25026362655,-4,859,2938,30
25027233087,25027233080,-7,680,2531,30
25027683809,25027683803,-6,812,2343,30
25028340966,25028340963,-3,708,2596,30
25030629256,25030629254,-2,1395,2509,30
25034657739,25034657745,6,19219,47990,30
25042850832,25042850827,-5,1347,2800,30
25043533754,25043533765,11,478,1669,30
25044479603,25044479595,-8,403,1046,30
25045784275,25045784270,-5,687,2874,30
25051780913,25051780909,-4,1229,2815,30
25056624162,25056624155,-7,1118,4091,30
25058719862,25058719858,-4,935,2008,30
25061832219,25061832213,-6,629,2280,30
25065676214,25065676219,5,2684,1142,30
25070454503,25070454502,-1,1062,1979,30
25076276995,25076276991,-4,1202,2569,30
25077529417,25077529410,-7,835,2400,30
25078070095,25078070092,-3,1518,2364,30
25081864554,25081864550,-4,1362,2780,30
25087198583,25087198577,-6,735,2825,30
25093111369,25093111369,0,1136,1484,30
25093894492,25093894470,-22,145,1143,30
25103080416,25103080418,2,9467,6731,30
25105363495,25105363491,-4,889,2592,30
25110273633,25110273633,0,1188,2445,30
25116821091,25116821089,-2,950,2980,30
25118823486,25118823482,-4,1318,3276,30
25121711330,25121711327,-3,890,2547,30
25121812106,25121812102,-4,1170,3854,30
25122670671,25122670666,-5,838,2441,30
25125515158,25125515157,-1,1580,3733,30
25127224632,25127224630,-2,1412,2172,30
25127784310,25127784305,-5,1084,3010,30
25130838518,25130838513,-5,1195,3265,30
25131190538,25131190533,-5,885,3862,30
25136964886,25136964882,-4,1417,3672,30
25142228090,25142228085,-5,840,3059,30
25142842560,25142842558,-2,136,877,30
25143406467,25143406461,-6,782,2387,30
25144646769,25144646766,-3,1264,3661,30
25152135162,25152135157,-5,940,3367,30
25152945775,25152945772,-3,1285,2644,30
25153097005,25153097009,4,7658,21542,30
25159267739,25159267737,-2,1294,2297,30
25159884184,25159884190,6,3501,1401,30
25161328851,25161328845,-6,629,2358,30
25167887490,25167887485,-5,1205,3425,30
25171471390,25171471386,-4,1065,2022,30
25173771566,25173771561,-5,960,2652,30
25174847794,25174847786,-8,98,901,30
25178866087,25178866080,-7,890,2440,30
25184067159,25184067155,-4,1305,3164,30
25184701269,25184701265,-4,733,2564,30
25185089135,25185089132,-3,1320,2060,30
25185410467,25185410482,15,1063,2634,30
25189042202,25189042198,-4,1220,3971,30
25189733498,25189733496,-2,1479,3433,30
25192324851,25192324846,-5,1165,3342,30
25192815009,25192815004,-5,821,2493,30
25193716764,25193716768,4,2983,1399,30
25197273342,25197273338,-4,2233,4077,30
25201213746,25201213741,-5,968,3174,30
25203469470,25203469465,-5,832,2492,30
25205045545,25205045542,-3,1290,2381,30
25208258278,25208258276,-2,1036,2706,30
25210308145,25210308142,-3,1005,3202,30
25233972217,25233972213,-4,1427,2549,30
25234376398,25234376393,-5,497,2373,30
25236770274,25236770271,-3,1147,3158,30
25237633243,25237633262,19,104,866,30
25238468045,25238468052,7,10265,34403,30
25240129664,25240129660,-4,1061,2852,30
25241351558,25241351554,-4,1060,2255,30
25245069984,25245069978,-6,1046,2902,30
25254613771,25254613770,-1,1219,1663,30
25254784242,25254784241,-1,1941,2348,30
25257500053,25257500061,8,12150,1833,30
25258893456,25258893459,3,1284,740,30
25259499643,25259499641,-2,903,2546,30
25260108704,25260108699,-5,602,1815,30
25265721007,25265721003,-4,954,2181,30
25269502567,25269502558,-9,953,2842,30
25286805550,25286805548,-2,1432,1962,30
25287070392,25287070389,-3,1098,2468,30
25287135178,25287135173,-5,1079,3352,30
25287865331,25287865334,3,409,1157,30
25291284569,25291284568,-1,1370,2541,30
25291413232,25291413246,14,785,3404,30
25295194471,25295194470,-1,2938,3657,30
25299611290,25299611290,0,1150,1567,30
25299915201,25299915210,9,185,1203,30
25312006539,25312006535,-4,1151,2829,30
25320333451,25320333446,-5,1328,3117,30
25321597390,25321597384,-6,971,2138,30
25329703110,25329703107,-3,942,2598,30
25333581814,25333581809,-5,1085,2588,30
25333745466,25333745446,-20,60,1281,30
25336570715,25336570710,-5,616,2284,30
25337106567,25337106558,-9,793,4067,30
25341545091,25341545086,-5,1239,3514,30
25345406135,25345406128,-7,1268,2400,30
25360758410,25360758408,-2,1183,2619,30
25371147376,25371147372,-4,1056,3405,30
25373935606,25373935605,-1,1322,3026,30
25379891215,25379891209,-6,976,2798,30
25380943762,25380943757,-5,805,2245,30
25384157940,25384157947,7,2032,1047,30
25386626122,25386626118,-4,1043,2419,30
25389334826,25389334822,-4,790,1929,30
25391636466,25391636462,-4,1272,3290,30
25392428612,25392428607,-5,1076,2842,30
25392749803,25392749823,20,442,1007,30
25394200422,25394200422,0,1320,2791,30
25394553434,25394553432,-2,1134,2063,30
25395934754,25395934754,0,40732,18670,30
25397123701,25397123695,-6,1671,4070,30
25397676411,25397676407,-4,911,2643,30
25398055110,25398055106,-4,1231,3368,30
25399332658,25399332654,-4,968,3624,30
25399749019,25399749017,-2,1026,2635,30
25400804498,25400804496,-2,1370,2311,30
25400981881,25400981874,-7,1201,2493,30
25406782177,25406782175,-2,895,2246,30
25410996450,25410996445,-5,975,2737,30
25417695278,25417695277,-1,1004,1543,30
25419091373,25419091369,-4,1552,2822,30
25423254462,25423254457,-5,951,3653,30
25424925824,25424925818,-6,1071,2671,30
25427910496,25427910500,4,1,452,30
25432053565,25432053562,-3,1176,2364,30
25432278870,25432278875,5,1656,1077,30
25433210414,25433210411,-3,924,2359,30
25435131547,25435131542,-5,707,2503,30
25435275712,25435275729,17,183,608,30
25437383942,25437383937,-5,1003,3344,30
25437640039,25437640043,4,816,872,30
25444135359,25444135354,-5,891,1858,30
25446615586,25446615583,-3,1261,3369,30
25448311659,25448311656,-3,1076,2679,30
25450074748,25450074743,-5,1496,3305,30
25452827004,25452827000,-4,2046,3996,30
25454659995,25454659990,-5,986,2019,30
25458421598,25458421595,-3,1574,2922,30
25459633879,25459633876,-3,957,1719,30
25465830052,25465830048,-4,1316,4569,30
25471934954,25471934943,-11,52,909,30
25473985270,25473985275,5,2495,1048,30
25474386599,25474386594,-5,1233,2859,30
25477479418,25477479414,-4,1597,3035,30
25478987187,25478987182,-5,1001,3103,30
25484227606,25484227600,-6,1302,3194,30
25498584890,25498584890,0,1264,1577,30
25499369223,25499369219,-4,561,2591,30
25499477777,25499477773,-4,1433,2821,30
25499803193,25499803215,22,534,1254,30
25513438734,25513438729,-5,975,2879,30
25514512698,25514512695,-3,853,2631,30
25521048896,25521048891,-5,988,3596,30
25524003539,25524003543,4,1597,1414,30
25525249712,25525249709,-3,1138,3206,30
25525831784,25525831787,3,141,774,30
25527917902,25527917909,7,5384,1353,30
25529774613,25529774609,-4,1150,3431,30
25541995383,25541995377,-6,989,3768,30
25542814023,25542814018,-5,854,2930,30
25543552911,25543552907,-4,1023,2509,30
25544851797,25544851794,-3,1171,1759,30
25545102058,25545102055,-3,1013,2597,30
25549859551,25549859546,-5,1184,3162,30
25550120913,25550120908,-5,558,2472,30
25552736114,25552736121,7,3917,2578,30
25557362483,25557362476,-7,782,1608,30
25559022797,25559022798,1,2011,2198,30
25561718827,25561718821,-6,979,2414,30
25562145158,25562145154,-4,783,2592,30
25563697678,25563697675,-3,459,1664,30
25564091647,25564091641,-6,1148,2981,30
25565775580,25565775576,-4,1109,2885,30
25566010809,25566010806,-3,1489,2340,30
25567011654,25567011650,-4,851,3417,30
25569088790,25569088787,-3,753,2624,30
25573079465,25573079461,-4,1311,3403,30
25573871246,25573871241,-5,805,5699,30
25580734589,25580734590,1,1552,1532,30
25582808286,25582808281,-5,1010,3142,30
25587365370,25587365367,-3,1227,3759,30
25588099213,25588099205,-8,725,2044,30
25588487630,25588487626,-4,1224,3054,30
25593314675,25593314669,-6,739,3720,30
25595148898,25595148896,-2,1311,3238,30
25602921389,25602921385,-4,678,1752,30
25605436270,25605436268,-2,1967,3168,30
25608980876,25608980873,-3,1269,3040,30
25610423698,25610423693,-5,1026,3471,30
25612716824,25612716813,-11,1446,4179,30
25617677613,25617677609,-4,1465,3105,30
25627684952,25627684954,2,3778,2537,30
25633200970,25633200973,3,11126,8836,30
25633578368,25633578350,-18,142,1276,30
25634759075,25634759068,-7,818,2900,30
25634875978,25634875989,11,304,1162,30
25638814750,25638814752,2,2015,2442,30
25640551850,25640551844,-6,1231,3731,30
25642302918,25642302913,-5,975,4265,30
25645840050,25645840045,-5,1162,2751,30
25645926184,25645926202,18,601,984,30
25651042046,25651042042,-4,1033,3601,30
25655407445,25655407439,-6,1699,3602,30
25664879056,25664879051,-5,1145,4735,30
25667018145,25667018143,-2,816,2767,30
25668675802,25668675780,-22,1523,11808,30
25673749113,25673749107,-6,719,2250,30
25678866247,25678866242,-5,1195,3705,30
25687474173,25687474167,-6,878,3313,30
25689289394,25689289390,-4,756,1966,30
25705175842,25705175837,-5,1919,3005,30
25706616594,25706616590,-4,889,2645,30
25709975073,25709975069,-4,978,2669,30
25711755958,25711755954,-4,1125,2196,30
25714512590,25714512585,-5,1303,2963,30
25715575091,25715575081,-10,824,2787,30
25716035243,25716035245,2,42,962,30
25720081371,25720081366,-5,794,2898,30
25720450711,25720450707,-4,836,2957,30
25722751858,25722751854,-4,1405,2519,30
25722896505,25722896501,-4,1068,2034,30
25726651424,25726651419,-5,762,2145,30
25727053451,25727053430,-21,928,2313,30
25731480242,25731480236,-6,787,3582,30
25731839066,25731839063,-3,838,2584,30
25734737473,25734737470,-3,1130,2290,30
25738727026,25738727025,-1,1443,1675,30
25741031691,25741031685,-6,1872,6524,30
25745344859,25745344854,-5,690,2522,30
25745525411,25745525397,-14,219,848,30
25748104650,25748104646,-4,1114,3078,30
25752918378,25752918373,-5,978,3307,30
25753557606,25753557602,-4,1321,3026,30
25757386059,25757386054,-5,814,2305,30
25757684018,25757684027,9,116,2245,30
25760290662,25760290657,-5,898,2195,30
25765370590,25765370591,1,900,677,30
25765805522,25765805518,-4,1452,2827,30
25766425826,25766425819,-7,827,2020,30
25766511146,25766511139,-7,602,1587,30
25773748798,25773748809,11,1471,1057,30
25775837775,25775837778,3,2197,1420,30
25780354309,25780354303,-6,1064,2633,30
25783122033,25783122029,-4,1126,2767,30
25783486280,25783486261,-19,314,1203,30
25784233782,25784233780,-2,1561,2673,30
25785594330,25785594325,-5,946,2511,30
25785845731,25785845746,15,358,1246,30
25793111888,25793111884,-4,920,2435,30
25793226682,25793226694,12,209,1036,30
25793921042,25793921045,3,1767,1430,30
25794752310,25794752309,-1,2193,4619,30
25796783585,25796783588,3,1448,1876,30
25802903533,25802903527,-6,968,1880,30
25803047747,25803047730,-17,297,1539,30
25803449214,25803449209,-5,984,2801,30
25803920443,25803920438,-5,983,3278,30
25810797467,25810797462,-5,1383,2094,30
25814978623,25814978618,-5,1323,3313,30
25820107875,25820107882,7,5077,2020,30
25821700933,25821700929,-4,1007,3127,30
25822782741,25822782738,-3,891,3740,30
25823086131,25823086137,6,1965,917,30
25826592622,25826592617,-5,1109,2476,30
25828809378,25828809399,21,271,564,30
25838702145,25838702140,-5,935,4151,30
25848705360,25848705362,2,1630,1151,30
25862710173,25862710175,2,730,840,30
25870855846,25870855844,-2,800,3092,30
25871876057,25871876054,-3,1109,2459,30
25881673769,25881673765,-4,1131,3159,30
25885025795,25885025789,-6,1002,4648,30
25887600088,25887600089,1,1534,1072,30
25889615840,25889615837,-3,16938,81626,30
25898743283,25898743281,-2,696,1664,30
25904212381,25904212375,-6,1267,3232,30
25906718435,25906718429,-6,874,3724,30
25906907844,25906907839,-5,1012,2671,30
25907440415,25907440412,-3,1103,2067,30
25912838421,25912838422,1,32324,34177,30
25913961190,25913961185,-5,1295,3237,30
25914104443,25914104447,4,335,852,30
25914402285,25914402282,-3,1104,2056,30
25915316677,25915316673,-4,806,2552,30
25917270545,25917270540,-5,856,3301,30
25917551755,25917551766,11,99,1067,30
25918437507,25918437502,-5,1124,2779,30
25919402135,25919402152,17,631,1403,30
25921679891,25921679887,-4,1003,1742,30
25922591083,25922591076,-7,1165,4611,30
25922838982,25922838977,-5,829,3593,30
25935405442,25935405437,-5,682,2344,30
25936114283,25936114278,-5,1478,3168,30
25943380644,25943380639,-5,948,1960,30
25951068533,25951068527,-6,991,2439,30
25952830088,25952830083,-5,1184,3049,30
25959724791,25959724787,-4,913,2022,30
25966663719,25966663718,-1,1458,1474,30
25971818794,25971818804,10,11245,47251,30
25974401315,25974401312,-3,1027,2459,30
25974748414,25974748419,5,3764,2021,30
25978400667,25978400663,-4,620,2750,30
25978636562,25978636574,12,240,706,30
25981424376,25981424370,-6,1284,3590,30
25982621614,25982621610,-4,1032,3414,30
25984120519,25984120514,-5,1077,3565,30
25988662649,25988662645,-4,1771,5399,30
25991134789,25991134784,-5,925,2281,30
25991596138,25991596123,-15,913,2069,30
25992624227,25992624215,-12,903,1848,30
25993375258,25993375271,13,696,1947,30
25995230270,25995230266,-4,1248,3282,30
25999699719,25999699716,-3,1402,2744,30
26000726982,26000726979,-3,1299,4764,30
26001296129,26001296125,-4,987,1879,30
26001417668,26001417684,16,263,1637,30
26004644963,26004644959,-4,1203,3073,30
26009389693,26009389701,8,5430,1749,30
26014532891,26014532886,-5,1211,2352,30
26022584818,26022584819,1,1627,1474,30
26023701223,26023701220,-3,858,2189,30
26023817019,26023817013,-6,11,1517,30
26024776699,26024776693,-6,775,1856,30
26043840806,26043840802,-4,900,3192,30
26045982792,26045982790,-2,1313,1872,30
26048448303,26048448298,-5,1172,3844,30
26050146109,26050146106,-3,2023,4382,30
26054557185,26054557179,-6,1416,3630,30
26055113769,26055113767,-2,1379,1769,30
26056001664,26056001662,-2,911,2314,30
26056823838,26056823833,-5,1130,3375,30
26060301445,26060301440,-5,1016,2451,30
26061644619,26061644625,6,986,1343,30
26064635754,26064635749,-5,1253,3714,30
26065890054,26065890066,12,16986,28524,30
26071284593,26071284591,-2,1280,2470,30
26072933485,26072933491,6,4950,2920,30
26075556938,26075556934,-4,1269,3018,30
26075604053,26075604058,5,2374,1236,30
26077039355,26077039351,-4,1107,2246,30
26078906098,26078906095,-3,841,2796,30
26081632126,26081632122,-4,1092,3448,30
26082610768,26082610790,22,992,2606,30
26085565102,26085565098,-4,1629,3390,30
26085754947,26085754942,-5,643,1831,30
26087439119,26087439114,-5,1298,3405,30
26089668640,26089668636,-4,1249,3192,30
26093874326,26093874323,-3,1107,2614,30
26094846682,26094846701,19,545,3337,30
26095761244,26095761237,-7,918,4129,30
26102059302,26102059297,-5,1268,2119,30
26102208363,26102208358,-5,1155,3416,30
26104710598,26104710594,-4,1049,2710,30
26105036635,26105036630,-5,1015,2242,30
26106822882,26106822893,11,213,1578,30
26109800295,26109800292,-3,973,1526,30
26120999171,26120999166,-5,1355,3010,30
26121396350,26121396347,-3,519,1828,30
26126912310,26126912311,1,3559,3150,30
26128873870,26128873864,-6,987,2881,30
26129741653,26129741659,6,10970,19550,30
26129903983,26129903981,-2,996,2992,30
26130450716,26130450713,-3,1502,2061,30
26134813774,26134813770,-4,828,3278,30
26135264020,26135264027,7,6203,2770,30
26135911282,26135911277,-5,870,1963,30
26142514547,26142514543,-4,620,1927,30
26144264304,26144264299,-5,844,2097,30
26144439050,26144439059,9,106,1190,30
26147656009,26147656006,-3,698,1627,30
26148353041,26148353042,1,207,2925,30
26149105902,26149105896,-6,1249,4125,30
26149221073,26149221088,15,432,2335,30
26157549252,26157549245,-7,1172,2536,30
26157605241,26157605225,-16,983,2653,30
26159482094,26159482091,-3,1328,2930,30
26167960386,26167960385,-1,851,1695,30
26172030351,26172030348,-3,573,1731,30
26172806098,26172806077,-21,689,2484,30
26174684812,26174684800,-12,1618,3913,30
26175016658,26175016651,-7,140,985,30
26176746740,26176746745,5,3406,1546,30
26178582618,26178582610,-8,1186,3472,30
26182697923,26182697918,-5,1143,2647,30
26188244061,26188244057,-4,1286,3369,30
26190530494,26190530489,-5,813,1596,30
26192514795,26192514791,-4,886,2147,30
26195584262,26195584262,0,1237,2097,30
26197057978,26197057989,11,248,1655,30
26200441990,26200441987,-3,784,1825,30
26204417425,26204417431,6,6111,2114,30
26206370497,26206370489,-8,1608,4884,30
26206813217,26206813214,-3,1021,2642,30
26207757759,26207757755,-4,945,2409,30
26209862530,26209862523,-7,1244,2762,30
26210897907,26210897903,-4,1168,2496,30
26218001771,26218001765,-6,906,2442,30
26219069984,26219069980,-4,1356,3506,30
26219244296,26219244306,10,353,2141,30
26224650420,26224650415,-5,950,1880,30
26226089537,26226089533,-4,1194,4160,30
26234930079,26234930078,-1,1032,2019,30
26240489701,26240489697,-4,1237,3322,30
26245135602,26245135597,-5,951,2706,30
26245335737,26245335756,19,1133,2708,30
26247566176,26247566173,-3,1064,2970,30
26252976853,26252976851,-2,589,1421,30
26257195762,26257195758,-4,874,2492,30
26260639666,26260639662,-4,1193,3083,30
26261682538,26261682533,-5,1418,3312,30
26261927662,26261927657,-5,1000,2587,30
26262113683,26262113661,-22,1133,1909,30
26265834726,26265834721,-5,1259,2926,30
26272190031,26272190026,-5,892,2923,30
26272535006,26272535002,-4,715,1570,30
26272690162,26272690150,-12,1085,2217,30
26281279866,26281279863,-3,1036,2372,30
26283959239,26283959235,-4,1503,3899,30
26284274232,26284274217,-15,1316,3898,30
26284406160,26284406182,22,245,659,30
26285286590,26285286586,-4,662,1926,30
26288069517,26288069517,0,2124,2345,30
26290218458,26290218454,-4,1362,2801,30
26291448209,26291448204,-5,1397,3106,30
26291673806,26291673801,-5,856,2527,30
26295659634,26295659629,-5,841,1970,30
26298281546,26298281542,-4,962,2176,30
26299046219,26299046214,-5,1074,3536,30
26299347684,26299347699,15,270,944,30
26301027221,26301027242,21,900,2263,30
26302508937,26302508955,18,789,1707,30
26306907231,26306907225,-6,978,3073,30
26309039359,26309039354,-5,1148,2918,30
26315824018,26315824014,-4,1088,2104,30
26322673354,26322673350,-4,1187,4328,30
26324011028,26324011025,-3,2574,5193,30
26326926156,26326926149,-7,1012,2741,30
26330728586,26330728591,5,3000,1975,30
26334149351,26334149346,-5,1080,2686,30
26334422148,26334422145,-3,730,1710,30
26341235334,26341235328,-6,1053,2971,30
26342580147,26342580142,-5,927,2755,30
26344572954,26344572948,-6,743,2472,30
26345910762,26345910756,-6,750,2246,30
26347678535,26347678531,-4,1137,2809,30
26356804139,26356804134,-5,729,2140,30
26360805938,26360805934,-4,1068,2929,30
26361885353,26361885348,-5,1336,3409,30
26362464263,26362464258,-5,798,2328,30
26363266889,26363266884,-5,759,2317,30
26364578329,26364578324,-5,1065,3078,30
26368525166,26368525166,0,3087,4138,30
26369076765,26369076765,0,3589,4840,30
26369137632,26369137626,-6,1098,3812,30
26371574195,26371574190,-5,707,2118,30
26372536384,26372536406,22,325,924,30
26376601758,26376601754,-4,1139,3268,30
26380601790,26380601775,-15,1850,920,30
26387131202,26387131215,13,575,2777,30
26388269422,26388269418,-4,971,3393,30
26396440874,26396440871,-3,955,3479,30
26398551920,26398551917,-3,697,2819,30
26405927569,26405927565,-4,1045,2382,30
26407085311,26407085305,-6,1038,2957,30
26408290418,26408290416,-2,1228,1632,30
26413873905,26413873902,-3,870,2282,30
26415789255,26415789250,-5,1020,2561,30
26418409493,26418409489,-4,1676,3344,30
26418972609,26418972610,1,1982,1352,30
26419879546,26419879549,3,51636,41536,30
26427606407,26427606403,-4,1008,1783,30
26428711240,26428711222,-18,1302,3851,30
26441095489,26441095495,6,3139,1359,30
26446493377,26446493376,-1,942,1592,30
26456978500,26456978494,-6,801,2822,30
26459990551,26459990547,-4,1256,2632,30
26461062934,26461062928,-6,1184,2937,30
26462669294,26462669290,-4,1252,2819,30
26475609240,26475609250,10,456,1643,30
26480223012,26480223007,-5,960,2062,30
26483719118,26483719113,-5,898,2484,30
26484553147,26484553143,-4,1471,2406,30
26485824389,26485824383,-6,894,2401,30
26489251253,26489251248,-5,927,2194,30
26498867227,26498867223,-4,1000,2600,30
26499040299,26499040291,-8,833,3350,30
26501022954,26501022951,-3,826,3245,30
26501065266,26501065245,-21,853,2635,30
26503157579,26503157573,-6,1098,2417,30
26503297811,26503297830,19,1105,2916,30
26504789014,26504789010,-4,1428,3940,30
26505434179,26505434174,-5,875,2073,30
26510201954,26510201949,-5,1194,3019,30
26512419098,26512419093,-5,924,2717,30
26512521987,26512521981,-6,550,2181,30
26517421515,26517421510,-5,1207,2198,30
26537260527,26537260519,-8,887,2989,30
26545545778,26545545774,-4,871,2224,30
26545993212,26545993194,-18,162,902,30
26546383642,26546383624,-18,1089,3068,30
26546674065,26546674049,-16,793,4398,30
26547850333,26547850332,-1,1628,2928,30
26558797767,26558797763,-4,756,3037,30
26568865362,26568865357,-5,864,2532,30
26569763437,26569763433,-4,825,2829,30
26570123951,26570123948,-3,725,1542,30
26574144252,26574144249,-3,1432,2769,30
26578826611,26578826606,-5,1091,3254,30
26583778671,26583778669,-2,1061,3206,30
26591893089,26591893090,1,1308,2827,30
26595693119,26595693114,-5,1354,3244,30
26603983562,26603983558,-4,1594,3206,30
26606372605,26606372600,-5,1009,3058,30
26607640165,26607640162,-3,960,2970,30
26607685738,26607685754,16,457,1217,30
26609644735,26609644728,-7,873,1736,30
26616283122,26616283118,-4,1252,2563,30
26622035057,26622035053,-4,893,2827,30
26622665548,26622665546,-2,1057,1702,30
26623081873,26623081875,2,191,516,30
26629934503,26629934501,-2,1107,2538,30
26632089118,26632089113,-5,817,2551,30
26640603811,26640603806,-5,907,3038,30
26643737848,26643737843,-5,1642,3499,30
26652058984,26652058990,6,6074,2660,30
26668286211,26668286207,-4,1185,3668,30
26670242249,26670242243,-6,1248,2932,30
26671587890,26671587911,21,725,1163,30
26672387676,26672387663,-13,9169,38700,30
26677848762,26677848758,-4,1223,4111,30
26682332995,26682333000,5,1723,982,30
26682737533,26682737529,-4,905,2381,30
26683088309,26683088306,-3,1200,3469,30
26686680422,26686680417,-5,1308,3100,30
26687043134,26687043140,6,3761,1596,30
26687093888,26687093894,6,2006,1139,30
26694118005,26694117998,-7,1129,2689,30
26694194200,26694194218,18,75,848,30
26699081220,26699081215,-5,818,2963,30
26699329659,26699329653,-6,992,2596,30
26699895028,26699895043,15,323,771,30
26702222569,26702222564,-5,1392,2787,30
26702925264,26702925284,20,515,2022,30
26714746113,26714746122,9,17152,17836,30
26719075066,26719075062,-4,1263,2888,30
26720769974,26720769974,0,717,1212,30
26725463494,26725463489,-5,1155,3495,30
26729113545,26729113541,-4,1446,3488,30
26732635771,26732635768,-3,783,2336,30
26733208101,26733208109,8,2835,1450,30
26737467196,26737467191,-5,624,2857,30
26738992007,26738992004,-3,1059,1675,30
26741455088,26741455081,-7,610,1742,30
26742442282,26742442286,4,1772,927,30
26743131407,26743131406,-1,1851,3058,30
26743900822,26743900818,-4,1142,2921,30
26744474482,26744474477,-5,744,2896,30
26744568791,26744568785,-6,974,4092,30
26749882371,26749882365,-6,984,2559,30
26749993658,26749993651,-7,318,1780,30
26751604538,26751604539,1,639,828,30
26753493832,26753493825,-7,1086,3320,30
26753688211,26753688217,6,2152,1571,30
26754104090,26754104086,-4,1107,2294,30
26756038258,26756038250,-8,543,133,30
26756589440,26756589445,5,26,1304,30
26759846104,26759846099,-5,1446,3699,30
26765766195,26765766189,-6,767,2495,30
26768052873,26768052867,-6,1001,1808,30
26771545633,26771545628,-5,1027,2447,30
26772655513,26772655509,-4,757,2173,30
26777039543,26777039538,-5,1064,2659,30
26781949798,26781949793,-5,1065,4612,30
26781981163,26781981177,14,464,1420,30
26782351946,26782351942,-4,1338,3174,30
26782898257,26782898252,-5,1457,3736,30
26795079949,26795079944,-5,965,2114,30
26798267520,26798267515,-5,1155,4624,30
26803367809,26803367805,-4,964,2148,30
26805666174,26805666169,-5,1004,2978,30
26806178890,26806178885,-5,706,2444,30
26807876635,26807876631,-4,1239,2753,30
26815565714,26815565710,-4,1001,2068,30
26816182375,26816182373,-2,945,1696,30
26817976878,26817976876,-2,847,1858,30
26822104099,26822104095,-4,755,3134,30
26822140312,26822140303,-9,1755,1342,30
26824447743,26824447740,-3,1369,2861,30
26837411718,26837411714,-4,670,2854,30
26847318701,26847318698,-3,1010,1951,30
26853103668,26853103664,-4,1066,2528,30
26857058103,26857058101,-2,997,1914,30
26866717393,26866717388,-5,1264,2694,30
26869949598,26869949595,-3,1093,1971,30
26871199281,26871199277,-4,1107,3037,30
26871463787,26871463790,3,234,920,30
26871895148,26871895143,-5,1018,2299,30
26873879902,26873879898,-4,878,2247,30
26874278997,26874278992,-5,702,2628,30
26877230091,26877230085,-6,1032,2759,30
26883934613,26883934601,-12,631,2682,30
26884067459,26884067462,3,19378,33853,30
26888168713,26888168719,6,2016,1347,30
26896718172,26896718169,-3,878,1812,30
26897532023,26897532019,-4,923,2435,30
26899576679,26899576675,-4,1164,3935,30
26900341745,26900341742,-3,1596,3264,30
26902103414,26902103411,-3,1167,2742,30
26911607044,26911607038,-6,1400,3793,30
26914894434,26914894436,2,1295,1899,30
26915556697,26915556693,-4,1039,2467,30
26923322197,26923322191,-6,888,1524,30
26927354885,26927354879,-6,1324,3210,30
26928975981,26928975974,-7,1084,3326,30
26930286113,26930286106,-7,1098,2783,30
26936388498,26936388492,-6,1448,4700,30
26943308773,26943308769,-4,1033,2668,30
26945003039,26945003034,-5,1237,3770,30
26945821473,26945821469,-4,1452,3993,30
26951272339,26951272334,-5,1157,3265,30
26957530149,26957530145,-4,1066,2583,30
26963142154,26963142149,-5,1545,3715,30
26963599893,26963599890,-3,1113,2644,30
26964269187,26964269182,-5,1355,2979,30
26978737944,26978737939,-5,1024,2483,30
26979024585,26979024582,-3,804,2031,30
26980001166,26980001166,0,1118,2552,30
26980405010,26980405024,14,507,1231,30
26984613163,26984613158,-5,1321,2927,30
26985200228,26985200243,15,148,710,30
26987125225,26987125227,2,1249,1148,30
26987449779,26987449757,-22,1245,6147,30
26990231801,26990231818,17,1120,3131,30
26993779137,26993779132,-5,1096,2909,30
26994719279,26994719274,-5,754,2559,30
26995223559,26995223555,-4,885,1546,30
27000311409,27000311404,-5,1144,2197,30
27005463892,27005463885,-7,892,3323,30
27009051209,27009051206,-3,869,2921,30
27009431197,27009431193,-4,1252,2185,30
27013297026,27013297021,-5,1127,3699,30
27013520954,27013520950,-4,1372,3492,30
27014492902,27014492898,-4,904,2950,30
27018815409,27018815404,-5,2238,5039,30
27028285074,27028285070,-4,879,2491,30
27041719276,27041719270,-6,1008,2446,30
27049634100,27049634104,4,2950,1628,30
27050470742,27050470738,-4,1099,1925,30
27052284481,27052284477,-4,761,2094,30
27057727205,27057727204,-1,3547,16158,30
27059890078,27059890082,4,2000,1328,30
27064259369,27064259365,-4,920,3142,30
27064647451,27064647447,-4,793,2302,30
27064861891,27064861910,19,1304,3006,30
27065237701,27065237698,-3,880,2681,30
27066672694,27066672687,-7,1404,3971,30
27068720764,27068720765,1,31105,23602,30
27071842129,27071842124,-5,1298,3436,30
27076400679,27076400674,-5,1323,3205,30
27079964958,27079964955,-3,1090,2646,30
27082358230,27082358226,-4,824,3646,30
27091510725,27091510727,2,1709,1521,30
27091787255,27091787251,-4,773,1893,30
27105255222,27105255221,-1,1215,2518,30
27112807190,27112807197,7,3896,1100,30
27113195790,27113195786,-4,1303,3249,30
27114396358,27114396362,4,4250,2359,30
27116575361,27116575355,-6,1134,2468,30
27125472642,27125472635,-7,1359,3139,30
27131791615,27131791610,-5,1045,2701,30
27135708698,27135708694,-4,517,1992,30
27136000664,27136000657,-7,2135,11570,30
27146802937,27146802947,10,12183,29106,30
27151419815,27151419810,-5,1025,3357,30
27156235397,27156235392,-5,1078,3598,30
27157452358,27157452353,-5,1022,2070,30
27164319524,27164319521,-3,1120,2498,30
27174046887,27174046882,-5,838,2084,30
27180344406,27180344398,-8,2952,9101,30
27182076151,27182076150,-1,3295,4457,30
27182491224,27182491220,-4,1564,3507,30
27196245023,27196245014,-9,890,2297,30
27205991728,27205991725,-3,1202,2711,30
27208156982,27208156978,-4,1027,2641,30
27213818370,27213818369,-1,1011,2041,30
27218553685,27218553679,-6,968,2908,30
27221216471,27221216467,-4,587,2568,30
27225310001,27225309996,-5,1411,2917,30
27232930759,27232930754,-5,598,1352,30
27239622242,27239622238,-4,1207,4461,30
27241858518,27241858514,-4,1410,3289,30
27243810754,27243810755,1,1552,1459,30
27247036534,27247036530,-4,893,3289,30
27247963911,27247963906,-5,1646,3627,30
27248676254,27248676249,-5,1222,2852,30
27249102517,27249102513,-4,695,2162,30
27249233725,27249233721,-4,1196,3610,30
27255961750,27255961746,-4,1583,3845,30
27257808299,27257808296,-3,850,2893,30
27268190011,27268190011,0,885,1123,30
27269499577,27269499570,-7,825,3167,30
27270685178,27270685174,-4,1340,2653,30
27274048035,27274048030,-5,845,2423,30
27280966907,27280966899,-8,1141,3020,30
27281665609,27281665606,-3,1173,2575,30
27283323718,27283323714,-4,1519,3802,30
27283620020,27283620014,-6,1044,2639,30
27287219780,27287219774,-6,1043,3174,30
27289495775,27289495768,-7,1063,3076,30
27293099029,27293099024,-5,803,2512,30
27295292638,27295292647,9,11857,28633,30
27301503816,27301503811,-5,990,2475,30
27301771546,27301771545,-1,921,2125,30
27306017001,27306016994,-7,1309,3638,30
27306219060,27306219073,13,1285,3211,30
27314297586,27314297583,-3,910,1983,30
27315230955,27315230953,-2,1048,1929,30
27320416851,27320416846,-5,1031,2252,30
27320748123,27320748118,-5,187,1177,30
27321741388,27321741382,-6,955,2851,30
27325037747,27325037742,-5,1048,3202,30
27325276089,27325276106,17,540,1946,30
27329955843,27329955839,-4,714,2395,30
27332469366,27332469360,-6,816,3305,30
27334512327,27334512323,-4,1136,2972,30
27335971983,27335971976,-7,728,1933,30
27337740967,27337740972,5,2589,1988,30
27340919266,27340919270,4,1931,1328,30
27349129193,27349129188,-5,986,2849,30
27355284626,27355284623,-3,1168,4063,30
27355423659,27355423648,-11,1028,3202,30
27357558198,27357558193,-5,722,1709,30
27357651912,27357651929,17,567,944,30
27361684293,27361684288,-5,1092,3760,30
27367527642,27367527638,-4,1047,2252,30
27367710756,27367710761,5,1892,1145,30
27371705029,27371705026,-3,927,2114,30
27373685805,27373685802,-3,1024,2740,30
27376086674,27376086671,-3,1349,2520,30
27380584306,27380584302,-4,1267,4572,30
27383229778,27383229788,10,1156,774,30
27383583083,27383583078,-5,898,2690,30
27385131482,27385131477,-5,1125,2383,30
27387460519,27387460513,-6,1112,4901,30
27389816689,27389816685,-4,860,2982,30
27390769177,27390769167,-10,1238,3463,30
27391397981,27391397978,-3,1333,2456,30
27393142689,27393142685,-4,972,2219,30
27393693513,27393693501,-12,116,1180,30
27395765650,27395765651,1,44794,21054,30
27399677377,27399677373,-4,1189,1773,30
27400623552,27400623533,-19,1171,2281,30
27406822659,27406822653,-6,1018,2483,30
27414292421,27414292417,-4,1031,2577,30
27416355801,27416355797,-4,975,2548,30
27417787371,27417787366,-5,1125,3099,30
27419732447,27419732445,-2,815,1626,30
27422951654,27422951650,-4,1078,3717,30
27427573321,27427573318,-3,1172,2294,30
27431365753,27431365748,-5,1110,2707,30
27431538698,27431538694,-4,671,2572,30
27433123489,27433123475,-14,1065,2744,30
27433511183,27433511178,-5,786,2869,30
27435452481,27435452485,4,3509,2227,30
27438826738,27438826732,-6,1263,6366,30
27439646903,27439646899,-4,1074,3122,30
27443655840,27443655835,-5,932,3036,30
27446218636,27446218650,14,242,1023,30
27450336304,27450336301,-3,1165,2304,30
27457340936,27457340931,-5,951,2165,30
27457409504,27457409521,17,722,2364,30
27459026782,27459026779,-3,782,2241,30
27461017107,27461017113,6,4113,1528,30
27461347488,27461347482,-6,861,3273,30
27461772602,27461772598,-4,219,1326,30
27471713689,27471713685,-4,1473,3126,30
27473373376,27473373372,-4,926,2873,30
27473895449,27473895439,-10,445,718,30
27474292163,27474292160,-3,962,2199,30
27474424522,27474424517,-5,1016,3002,30
27479694973,27479694969,-4,1300,3541,30
27480320102,27480320102,0,1308,1458,30
27481385954,27481385951,-3,1163,2257,30
27482045354,27482045361,7,5481,2147,30
27485912003,27485912009,6,3398,1926,30
27490553879,27490553875,-4,1262,3346,30
27496816432,27496816438,6,4635,1250,30
27498377126,27498377123,-3,767,2313,30
27499572380,27499572375,-5,805,1836,30
27505726253,27505726248,-5,1289,2484,30
27506142231,27506142226,-5,989,2933,30
27507194800,27507194799,-1,7379,12631,30
27512819593,27512819589,-4,1734,2515,30
27516301305,27516301302,-3,1042,2511,30
27524049146,27524049142,-4,1010,2163,30
27531412303,27531412300,-3,1308,2948,30
27534759506,27534759503,-3,1258,2235,30
27535500862,27535500866,4,2830,1932,30
27536073674,27536073670,-4,1084,3560,30
27537649298,27537649293,-5,894,3381,30
27545436110,27545436105,-5,1316,3497,30
27545689764,27545689778,14,685,3958,30
27546017051,27546017047,-4,1226,3311,30
27550217065,27550217062,-3,1488,3635,30
27554892746,27554892752,6,4403,1663,30
27556247461,27556247454,-7,522,1884,30
27559284367,27559284361,-6,861,3021,30
27562066581,27562066567,-14,259,1719,30
27563751385,27563751381,-4,917,3268,30
27564468591,27564468586,-5,905,3731,30
27573755488,27573755481,-7,1030,2443,30
27573801738,27573801753,15,433,2054,30
27574429399,27574429408,9,12767,41483,30
27575773614,27575773611,-3,1117,2606,30
27575839578,27575839572,-6,938,3030,30
27575876287,27575876282,-5,926,3562,30
27576358512,27576358508,-4,1075,2190,30
27577935448,27577935444,-4,2423,5657,30
27579891246,27579891242,-4,917,1536,30
27580914362,27580914360,-2,1113,2445,30
27583437438,27583437435,-3,1027,2870,30
27586903239,27586903230,-9,837,2704,30
27589072594,27589072597,3,3792,3234,30
27589744510,27589744492,-18,2644,629,30
27591464972,27591464967,-5,3446,10148,30
27593312783,27593312779,-4,1159,3217,30
27601963876,27601963872,-4,1297,2734,30
27604788990,27604788984,-6,1010,2903,30
27610529359,27610529354,-5,1139,2612,30
27611798289,27611798284,-5,767,2889,30
27613936059,27613936055,-4,1091,3741,30
27615158339,27615158334,-5,778,2060,30
27617838762,27617838757,-5,1616,3013,30
27617901293,27617901304,11,225,1049,30
27631537167,27631537167,0,2087,2613,30
27632871459,27632871455,-4,1071,4259,30
27633290955,27633290973,18,482,1665,30
27635407034,27635407032,-2,859,2270,30
27636720742,27636720726,-16,161,1858,30
27641408410,27641408410,0,1104,786,30
27642464436,27642464449,13,909,2977,30
27643946891,27643946888,-3,790,2732,30
27645919628,27645919623,-5,1233,2850,30
27649003160,27649003167,7,1146,701,30
27654526220,27654526219,-1,1221,1516,30
27658109261,27658109260,-1,943,2025,30
27659379631,27659379626,-5,1446,3678,30
27661639277,27661639282,5,2173,1525,30
27666388763,27666388758,-5,723,1737,30
27667843919,27667843915,-4,1444,2097,30
27668945581,27668945576,-5,1768,4377,30
27670093562,27670093559,-3,739,2203,30
27675400550,27675400544,-6,661,2869,30
27678891635,27678891631,-4,990,3728,30
27687567434,27687567428,-6,741,2118,30
27702209119,27702209121,2,1837,1585,30
27702729561,27702729558,-3,676,2108,30
27710958575,27710958570,-5,1108,2079,30
27715242251,27715242246,-5,758,2884,30
27717533067,27717533061,-6,583,2165,30
27719010004,27719010022,18,688,1817,30
27720504953,27720504949,-4,1099,3134,30
27726346617,27726346614,-3,732,2039,30
27728930378,27728930373,-5,1134,4105,30
27730990052,27730990066,14,14569,5219,30
27733997576,27733997569,-7,937,3084,30
27735027475,27735027471,-4,950,1061,30
27738073497,27738073492,-5,1106,3279,30
27738728240,27738728230,-10,162,933,30
27740849545,27740849543,-2,2366,4033,30
27745551111,27745551106,-5,1023,3821,30
27746188638,27746188633,-5,1359,3193,30
27751530319,27751530326,7,3409,1901,30
27757785813,27757785810,-3,1201,3046,30
27758803530,27758803517,-13,855,3185,30
27759674032,27759674055,23,795,3077,30
27759838694,27759838690,-4,1262,3858,30
27769083583,27769083587,4,3778,2499,30
27770525655,27770525651,-4,1025,2855,30
27773231610,27773231603,-7,332,1211,30
27773654406,27773654399,-7,503,2445,30
27777173666,27777173662,-4,1189,3104,30
27783992826,27783992822,-4,1105,2911,30
27789408710,27789408704,-6,1223,2513,30
27791983716,27791983710,-6,1204,2997,30
27792692985,27792692981,-4,230,749,30
27798054872,27798054868,-4,680,2512,30
27802003210,27802003205,-5,1030,2480,30
27803240142,27803240137,-5,817,2770,30
27810048747,27810048751,4,1265,1313,30
27831672129,27831672125,-4,1234,2473,30
27833035413,27833035408,-5,1607,2823,30
27847116096,27847116090,-6,818,1685,30
27853855764,27853855762,-2,871,2664,30
27858994480,27858994475,-5,1270,2243,30
27859444473,27859444468,-5,990,3338,30
27868264177,27868264171,-6,1063,2853,30
27868321610,27868321629,19,761,2759,30
27868962247,27868962244,-3,807,2792,30
27869134443,27869134445,2,248,1278,30
27873255653,27873255645,-8,811,2231,30
27873363201,27873363195,-6,977,3798,30
27873735800,27873735793,-7,852,2272,30
27873882514,27873882495,-19,1253,4040,30
27878648480,27878648474,-6,975,3199,30
27880906571,27880906559,-12,1141,3315,30
27893053417,27893053413,-4,949,3507,30
27898182898,27898182891,-7,1275,3392,30
27898397049,27898397065,16,846,1528,30
27903045837,27903045831,-6,937,2609,30
27912177285,27912177279,-6,816,3648,30
27912989002,27912988998,-4,845,1681,30
27913252449,27913252469,20,814,1703,30
27915610469,27915610464,-5,1120,4438,30
27917335751,27917335754,3,3953,2923,30
27920022223,27920022217,-6,878,2530,30
27920487076,27920487071,-5,1368,3751,30
27927847131,27927847134,3,2434,1640,30
27930307262,27930307257,-5,907,2631,30
27930796386,27930796390,4,5864,24137,30
27933723422,27933723418,-4,985,2516,30
27936630866,27936630861,-5,1421,3518,30
27947945496,27947945491,-5,1328,2499,30
27948719763,27948719758,-5,1366,3001,30
27954152946,27954152943,-3,1145,2080,30
27959614585,27959614581,-4,1133,2596,30
27959771570,27959771582,12,569,2095,30
27964217358,27964217361,3,1198,1198,30
27964695201,27964695199,-2,886,3164,30
27971204262,27971204258,-4,774,2123,30
27972640306,27972640301,-5,947,2649,30
27975769007,27975769002,-5,1038,2623,30
27980281287,27980281281,-6,1149,2435,30
27982636033,27982636029,-4,968,3206,30
27982768825,27982768806,-19,1280,3253,30
27986635438,27986635433,-5,922,3131,30
27990627446,27990627441,-5,1106,3265,30
27990825420,27990825414,-6,1307,1697,30
27992984639,27992984636,-3,1240,3435,30
27996500062,27996500058,-4,1303,2691,30
27999802719,27999802715,-4,1339,3129,30
28000288974,28000288968,-6,1040,4654,30
28000682497,28000682512,15,595,3119,30
28002026078,28002026073,-5,739,2793,30
28002497882,28002497877,-5,1016,4053,30
28009290915,28009290909,-6,1098,2811,30
28010374433,28010374426,-7,1382,3353,30
28011999237,28011999234,-3,710,2194,30
28014278142,28014278141,-1,810,1355,30
28022897740,28022897739,-1,907,1149,30
28033220511,28033220508,-3,1118,2083,30
28037565499,28037565496,-3,708,1861,30
28039950881,28039950877,-4,1626,4531,30
28051159258,28051159254,-4,832,1867,30
28051498942,28051498937,-5,915,2599,30
28056003295,28056003292,-3,1402,2905,30
28056671689,28056671685,-4,1074,2302,30
28056808129,28056808127,-2,874,2332,30
28067396622,28067396618,-4,818,3616,30
28070184096,28070184091,-5,1727,3306,30
28075946519,28075946514,-5,1433,3862,30
28078958798,28078958794,-4,1038,2581,30
28086726437,28086726433,-4,1131,1870,30
28097695342,28097695339,-3,593,1722,30
28104619998,28104619994,-4,969,2720,30
28104780289,28104780280,-9,282,1021,30
28107312723,28107312717,-6,1235,2816,30
28115196435,28115196432,-3,1054,3332,30
28119172726,28119172722,-4,758,1827,30
28119203657,28119203654,-3,178,1053,30
28120531665,28120531662,-3,1322,3391,30
28125536671,28125536666,-5,832,2864,30
28127268322,28127268317,-5,632,3477,30
28127473498,28127473519,21,450,1558,30
28128035894,28128035890,-4,866,2433,30
28134499382,28134499375,-7,2054,10668,30
28136990915,28136990921,6,2762,1308,30
28138148939,28138148934,-5,1135,3484,30
28143034865,28143034860,-5,1156,4099,30
28148708803,28148708799,-4,1399,2525,30
28164084623,28164084621,-2,843,2361,30
28165496279,28165496274,-5,1538,3541,30
28165928082,28165928077,-5,916,2907,30
28166045051,28166045049,-2,795,1679,30
28167027264,28167027259,-5,1444,3958,30
28169542167,28169542162,-5,1125,2703,30
28176561995,28176561994,-1,1172,2257,30
28177603650,28177603646,-4,334,1480,30
28179771369,28179771363,-6,1104,3444,30
28181053162,28181053158,-4,1555,3509,30
28181313308,28181313302,-6,1168,3519,30
28183960364,28183960371,7,4407,1133,30
28188286431,28188286438,7,53671,20936,30
28188532007,28188532001,-6,757,2664,30
28195933188,28195933182,-6,1010,3244,30
28197723177,28197723175,-2,854,2376,30
28212930236,28212930236,0,767,1288,30
28219979514,28219979510,-4,1207,2972,30
28234087954,28234087959,5,1625,1105,30
28235926398,28235926392,-6,1354,3787,30
28239885385,28239885389,4,19222,25076,30
28241369703,28241369698,-5,998,3123,30
28242924534,28242924543,9,17155,11141,30
28244939193,28244939189,-4,996,3111,30
28245344577,28245344597,20,270,967,30
28255093542,28255093537,-5,1154,2500,30
28255140963,28255140957,-6,1306,3161,30
28255257959,28255257952,-7,2094,7442,30
28258984467,28258984461,-6,1080,2596,30
28259720697,28259720691,-6,698,2127,30
28259840960,28259840955,-5,1094,2323,30
28260182601,28260182594,-7,319,1014,30
28262323861,28262323857,-4,2659,6097,30
28265818494,28265818493,-1,1066,2423,30
28266377646,28266377638,-8,1372,3125,30
28270301541,28270301535,-6,861,3215,30
28273784156,28273784153,-3,1057,2270,30
28275283758,28275283751,-7,927,2679,30
28292138389,28292138385,-4,1222,2728,30
28294354719,28294354715,-4,1391,3046,30
28297122509,28297122504,-5,1185,2672,30
28297304403,28297304389,-14,781,9353,30
28297820630,28297820633,3,1842,976,30
28302142086,28302142083,-3,1164,2622,30
28302415610,28302415597,-13,625,3471,30
28303577422,28303577418,-4,837,2651,30
28306382086,28306382083,-3,1632,4366,30
28306571916,28306571909,-7,841,1984,30
28313404092,28313404087,-5,1153,2732,30
28322023929,28322023927,-2,1125,1469,30
28325465451,28325465446,-5,667,2122,30
28328603150,28328603145,-5,1292,2633,30
28330915914,28330915918,4,4839,3169,30
28336237528,28336237525,-3,1251,2541,30
28340240421,28340240417,-4,1022,3327,30
28343205206,28343205210,4,1422,1381,30
28343304050,28343304046,-4,1004,3263,30
28349412735,28349412730,-5,817,2428,30
28354715462,28354715458,-4,661,2138,30
28355785886,28355785881,-5,1033,2504,30
28355936503,28355936497,-6,934,2669,30
28360694754,28360694750,-4,710,3482,30
28360893978,28360893959,-19,290,824,30
28360965631,28360965626,-5,1027,2413,30
28361165954,28361165971,17,505,1931,30
28361417849,28361417844,-5,891,2074,30
28365763657,28365763651,-6,316,921,30
28366099918,28366099913,-5,1534,2950,30
28367859062,28367859058,-4,1542,2850,30
28373099232,28373099234,2,1104,1243,30
28376809655,28376809650,-5,1189,3453,30
28377825555,28377825551,-4,839,2497,30
28383427994,28383428013,19,909,3606,30
28392287754,28392287752,-2,651,2126,30
28393709441,28393709457,16,264,886,30
28393775539,28393775519,-20,44729,25677,30
28394155770,28394155758,-12,425,1110,30
28396619748,28396619753,5,4427,2237,30
28398977415,28398977409,-6,2510,9159,30
28401865498,28401865496,-2,30811,20294,30
28401959194,28401959191,-3,911,3088,30
28405732764,28405732759,-5,1314,2249,30
28407345934,28407345931,-3,897,1915,30
28409224064,28409224060,-4,1755,3934,30
28417842459,28417842455,-4,732,1857,30
28417942563,28417942577,14,169,920,30
28423588324,28423588321,-3,787,2719,30
28428628451,28428628449,-2,750,1807,30
28428852897,28428852887,-10,696,2016,30
28428969560,28428969579,19,392,785,30
28430996113,28430996119,6,2466,1185,30
28432152035,28432152029,-6,1387,3110,30
28434609095,28434609090,-5,872,2751,30
28439348582,28439348577,-5,774,2481,30
28441997020,28441997017,-3,1103,2102,30
28443261498,28443261493,-5,1149,2921,30
28443645447,28443645443,-4,1053,3032,30
28448854789,28448854784,-5,1832,3559,30
28449899070,28449899067,-3,956,2820,30
28450142640,28450142622,-18,192,1511,30
28450742140,28450742147,7,209,947,30
28456398377,28456398373,-4,1075,2394,30
28456562563,28456562545,-18,1045,2983,30
28458160149,28458160146,-3,1136,2845,30
28462338393,28462338389,-4,1040,2003,30
28463448482,28463448477,-5,1099,2674,30
28473109100,28473109098,-2,2516,5751,30
28476282350,28476282345,-5,1281,3483,30
28478711981,28478711977,-4,1116,2737,30
28480499598,28480499593,-5,1201,2946,30
28480590241,28480590235,-6,1420,2971,30
28483726341,28483726335,-6,863,2651,30
28484356572,28484356569,-3,17719,16889,30
28484979105,28484979099,-6,1476,5507,30
28493737023,28493737018,-5,952,2357,30
28499584414,28499584410,-4,1430,4680,30
28507889655,28507889651,-4,1135,2671,30
28508254057,28508254053,-4,1046,3309,30
28508426128,28508426123,-5,869,2777,30
28509785970,28509785970,0,726,2244,30
28514053055,28514053050,-5,1065,2675,30
28516844211,28516844206,-5,857,3046,30
28520786134,28520786131,-3,1166,2107,30
28520909466,28520909485,19,1070,3776,30
28524704718,28524704714,-4,681,2826,30
28529309450,28529309457,7,3102,1421,30
28533441563,28533441557,-6,2629,9334,30
28539264117,28539264112,-5,983,1793,30
28541041878,28541041871,-7,1051,3380,30
28544127754,28544127750,-4,1173,2869,30
28545164367,28545164366,-1,894,1813,30
28551458614,28551458609,-5,710,2547,30
28555932432,28555932429,-3,897,2381,30
28557352068,28557352062,-6,1420,2574,30
28557490542,28557490538,-4,1016,2786,30
28558433460,28558433455,-5,1756,3615,30
28565236913,28565236911,-2,992,3017,30
28565902411,28565902418,7,166,1165,30
28572367854,28572367848,-6,733,3522,30
28576514918,28576514914,-4,1060,2888,30
28580275638,28580275635,-3,996,1874,30
28586913143,28586913138,-5,753,2641,30
28587310695,28587310693,-2,1279,3744,30
28601176549,28601176543,-6,745,2469,30
28605935405,28605935402,-3,685,2172,30
28606534324,28606534334,10,169,754,30
28613452746,28613452754,8,21374,31869,30
28615263224,28615263218,-6,1342,3337,30
28622017007,28622017000,-7,667,3606,30
28627435333,28627435329,-4,1349,3856,30
28628640330,28628640325,-5,839,2765,30
28628672562,28628672550,-12,240,1208,30
28630432006,28630432002,-4,1181,2575,30
28636147182,28636147174,-8,945,2503,30
28637622703,28637622698,-5,1211,2969,30
28638552529,28638552546,17,740,2224,30
28639190807,28639190801,-6,974,2982,30
28647037126,28647037121,-5,667,1705,30
28647178372,28647178369,-3,1095,2406,30
28652562362,28652562358,-4,1082,2824,30
28657189784,28657189778,-6,809,2630,30
28660499665,28660499663,-2,1615,1926,30
28668798061,28668798054,-7,941,3399,30
28676313432,28676313427,-5,1150,2918,30
28676417810,28676417826,16,697,1510,30
28678740629,28678740628,-1,951,2342,30
28678969226,28678969234,8,447,952,30
28681212158,28681212153,-5,1164,3455,30
28685541728,28685541729,1,2126,1948,30
28688972219,28688972215,-4,920,3816,30
28689612539,28689612531,-8,1085,3616,30
28689942654,28689942651,-3,992,3316,30
28693600985,28693600981,-4,449,1865,30
28693975360,28693975381,21,811,2554,30
28695087406,28695087402,-4,814,3196,30
28697961259,28697961266,7,3599,1444,30
28701519805,28701519798,-7,622,2484,30
28703099203,28703099202,-1,427,930,30
28703406805,28703406801,-4,1265,2660,30
28705019878,28705019874,-4,1071,3298,30
28710155714,28710155715,1,1502,1660,30
28717535557,28717535553,-4,1191,2868,30
28725590522,28725590518,-4,1185,1115,30
28729504337,28729504333,-4,1289,2341,30
28729656955,28729656935,-20,1030,3443,30
28730893253,28730893249,-4,958,2223,30
28731122582,28731122577,-5,1191,3644,30
28731152139,28731152145,6,3750,1249,30
28731295947,28731295943,-4,892,2248,30
28731632256,28731632265,9,125,1016,30
28732105087,28732105094,7,7367,2640,30
28733774445,28733774442,-3,2291,6213,30
28734224663,28734224657,-6,856,3678,30
28736140227,28736140222,-5,943,3330,30
28738527913,28738527909,-4,1402,2539,30
28739953642,28739953639,-3,948,3063,30
28742640765,28742640762,-3,1025,2171,30
28745363994,28745363989,-5,935,3934,30
28745775138,28745775158,20,254,1381,30
28746074427,28746074421,-6,1167,2788,30
28747458817,28747458833,16,1343,3446,30
28750973394,28750973391,-3,1356,2887,30
28751694039,28751694033,-6,1081,2245,30
28756414651,28756414645,-6,906,4035,30
28760418002,28760417998,-4,790,3677,30
28760735691,28760735687,-4,1376,3154,30
28762540475,28762540469,-6,881,3090,30
28762945719,28762945714,-5,993,2278,30
28768150836,28768150833,-3,511,1419,30
28771471994,28771471987,-7,1186,3277,30
28776922954,28776922950,-4,745,2327,30
28778770878,28778770874,-4,1165,2398,30
28781039298,28781039294,-4,888,2700,30
28782243150,28782243146,-4,1234,4388,30
28787612038,28787612037,-1,1045,1977,30
28789171005,28789171010,5,2550,879,30
28790446988,28790446979,-9,889,2403,30
28791425586,28791425594,8,8077,3196,30
28792806327,28792806334,7,12849,4510,30
28792928590,28792928587,-3,888,3436,30
28793704868,28793704879,11,231,1574,30
28794251470,28794251466,-4,1200,3016,30
28797759594,28797759587,-7,1355,4593,30
28799126201,28799126196,-5,1111,3740,30
28800310067,28800310062,-5,1389,2769,30
28805215582,28805215583,1,1851,1711,30
28809899979,28809899977,-2,322,1143,30
28814585045,28814585049,4,36053,23326,30
28816060493,28816060491,-2,1677,1831,30
28818952201,28818952198,-3,1142,2549,30
28826511485,28826511481,-4,1040,2965,30
28833180974,28833180970,-4,962,3245,30
28834868291,28834868309,18,350,894,30
28840687336,28840687328,-8,2602,9666,30
28847348719,28847348714,-5,1068,2296,30
28853617743,28853617738,-5,887,2859,30
28855093497,28855093495,-2,1354,2541,30
28855831608,28855831605,-3,1443,2675,30
28856756114,28856756109,-5,870,2923,30
28858140493,28858140487,-6,912,5470,30
28858658102,28858658098,-4,723,2884,30
28862877623,28862877617,-6,1095,2557,30
28863963383,28863963379,-4,1405,3037,30
28864855842,28864855836,-6,1188,2558,30
28866774087,28866774084,-3,900,2008,30
28868890869,28868890865,-4,1246,4548,30
28871505529,28871505527,-2,1237,2478,30
28872085458,28872085454,-4,1203,3433,30
28874757471,28874757467,-4,1351,2818,30
28877286965,28877286959,-6,1315,3945,30
28877768714,28877768709,-5,763,2980,30
28878469730,28878469722,-8,802,1547,30
28882734853,28882734849,-4,776,2499,30
28885387729,28885387723,-6,1153,2600,30
28885838665,28885838686,21,792,3097,30
28887691574,28887691567,-7,766,3163,30
28888392626,28888392622,-4,1043,2519,30
28907623680,28907623679,-1,1307,1767,30
28908922883,28908922878,-5,1295,4607,30
28911479482,28911479489,7,2961,1349,30
28911987877,28911987873,-4,1004,2161,30
28913020102,28913020099,-3,1492,4421,30
28918927362,28918927361,-1,738,2617,30
28919305490,28919305486,-4,1210,3542,30
28925258086,28925258081,-5,997,2641,30
28928961410,28928961406,-4,1378,2833,30
28932857988,28932857982,-6,913,3253,30
28938379031,28938379029,-2,1215,2553,30
28940211788,28940211784,-4,1116,2923,30
28940703138,28940703155,17,627,3209,30
28941194102,28941194098,-4,945,2568,30
28948415223,28948415209,-14,27242,13732,30
28949774757,28949774751,-6,1272,3726,30
28950121721,28950121729,8,336,891,30
28955453542,28955453538,-4,1007,3100,30
28956490349,28956490346,-3,1087,2903,30
28956879169,28956879190,21,745,3267,30
28957898298,28957898293,-5,1025,3603,30
28960025139,28960025134,-5,1144,3397,30
28965906721,28965906721,0,1726,1510,30
28966685606,28966685602,-4,689,3186,30
28967455992,28967455987,-5,910,3103,30
28967867376,28967867397,21,945,3565,30
28972093778,28972093778,0,1109,2063,30
28973510883,28973510879,-4,488,1278,30
28973582810,28973582807,-3,940,3247,30
28975193599,28975193596,-3,1168,2888,30
28980294905,28980294901,-4,1334,3152,30
28981770282,28981770279,-3,749,2558,30
28982467542,28982467534,-8,738,2711,30
28982586361,28982586343,-18,238,1177,30
28984238305,28984238305,0,160,2115,30
28984664098,28984664096,-2,1046,2832,30
28986028567,28986028564,-3,984,2257,30
28987419367,28987419361,-6,911,2517,30
28991256015,28991256012,-3,1137,3378,30
28996176322,28996176323,1,3194,3330,30
28996738198,28996738203,5,2130,1450,30
28997635474,28997635482,8,11804,31333,30
28999311087,28999311085,-2,875,1616,30
29001698507,29001698503,-4,912,1961,30
29002599154,29002599151,-3,1002,2031,30
29007963710,29007963706,-4,1438,3434,30
29009032730,29009032724,-6,708,2953,30
29012614129,29012614122,-7,972,2462,30
29016536707,29016536703,-4,1492,3243,30
29019513118,29019513116,-2,1386,2637,30
29022923142,29022923139,-3,925,2744,30
29023354169,29023354163,-6,968,2108,30
29034030767,29034030762,-5,892,1593,30
29036440941,29036440935,-6,763,3669,30
29039890980,29039890975,-5,1443,3359,30
29041019214,29041019208,-6,834,2343,30
29042527185,29042527193,8,4647,1360,30
29048560849,29048560847,-2,1221,2038,30
29049569250,29049569248,-2,1106,1905,30
29049975791,29049975785,-6,811,3508,30
29050302017,29050302011,-6,1056,2676,30
29050544636,29050544614,-22,226,815,30
29050732385,29050732370,-15,161,703,30
29051782295,29051782290,-5,1100,2356,30
29053455769,29053455765,-4,627,1787,30
29056238291,29056238286,-5,874,2203,30
29060727343,29060727337,-6,858,3244,30
29061435698,29061435712,14,373,1160,30
29066788677,29066788684,7,3381,1886,30
29069403633,29069403639,6,4075,2598,30
29077348666,29077348662,-4,1182,2469,30
29082946728,29082946721,-7,3301,13380,30
29083005078,29083005073,-5,1092,3377,30
29084533756,29084533761,5,36987,21006,30
29088957325,29088957319,-6,773,1793,30
29089586720,29089586717,-3,237,699,30
29091338799,29091338794,-5,992,2332,30
29095277026,29095277019,-7,735,3102,30
29100103835,29100103830,-5,841,2975,30
29102129045,29102129042,-3,1260,2616,30
29104868843,29104868841,-2,954,2664,30
29104934770,29104934786,16,957,1727,30
29107640993,29107640986,-7,1202,4120,30
29114896741,29114896736,-5,1041,3102,30
29126280583,29126280577,-6,995,2322,30
29126342089,29126342103,14,376,1323,30
29127456303,29127456298,-5,1124,2617,30
29127729106,29127729127,21,519,1316,30
29128541390,29128541384,-6,1614,8046,30
29131747547,29131747542,-5,1379,2654,30
29131847074,29131847095,21,1430,2316,30
29138368061,29138368069,8,2794,1411,30
29146060984,29146060978,-6,695,2890,30
29147732279,29147732279,0,1224,1633,30
29147985306,29147985322,16,1197,5128,30
29150892350,29150892346,-4,1195,3239,30
29153973193,29153973188,-5,921,2848,30
29162157346,29162157342,-4,1104,2472,30
29164280863,29164280860,-3,1204,2630,30
29170643890,29170643887,-3,985,2850,30
29173375084,29173375087,3,44617,28301,30
29177058395,29177058391,-4,949,3850,30
29181111661,29181111657,-4,1213,2351,30
29181913426,29181913441,15,554,1773,30
29183018170,29183018166,-4,874,1679,30
29189415749,29189415744,-5,1077,2694,30
29193771897,29193771894,-3,874,1063,30
29198247815,29198247813,-2,1036,2243,30
29200836051,29200836046,-5,994,3349,30
29203493127,29203493122,-5,803,3444,30
29204612608,29204612602,-6,1259,2741,30
29207492200,29207492195,-5,1005,3507,30
29208702930,29208702927,-3,653,2194,30
29219049774,29219049770,-4,1005,2233,30
29221359894,29221359886,-8,1293,9716,30
29221873129,29221873125,-4,1480,2747,30
29229550468,29229550472,4,11958,25432,30
29229818531,29229818535,4,2110,1738,30
29231469764,29231469758,-6,812,2687,30
29231653977,29231653970,-7,1075,3215,30
29232295235,29232295253,18,316,1644,30
29233419338,29233419334,-4,923,2759,30
29238016186,29238016182,-4,1451,4306,30
29241857650,29241857650,0,1238,1429,30
29245499506,29245499501,-5,1110,1273,30
29245624886,29245624882,-4,1077,3704,30
29247871572,29247871569,-3,1316,2299,30
29248044668,29248044662,-6,1163,2750,30
29250680827,29250680822,-5,993,2794,30
29251376947,29251376951,4,34,528,30
29254591151,29254591146,-5,858,2621,30
29255848750,29255848757,7,4664,1945,30
29258250061,29258250054,-7,1065,2809,30
29258293378,29258293398,20,402,2075,30
29258571383,29258571379,-4,1083,2568,30
29261049175,29261049171,-4,1193,2874,30
29263299469,29263299463,-6,1335,3705,30
29264722878,29264722873,-5,1391,2291,30
29267478474,29267478469,-5,722,2658,30
29267669636,29267669654,18,895,1853,30
29275162219,29275162214,-5,504,1530,30
29275757342,29275757334,-8,564,2767,30
29278194821,29278194814,-7,1079,2393,30
29278469838,29278469833,-5,1520,4067,30
29288869912,29288869906,-6,1276,3542,30
29293223633,29293223629,-4,1208,3274,30
29298563419,29298563413,-6,605,2315,30
29299910758,29299910754,-4,1250,2816,30
29301165155,29301165150,-5,1028,2687,30
29309311719,29309311716,-3,1116,2522,30
29309824286,29309824285,-1,574,2441,30
29310735475,29310735471,-4,736,2371,30
29314073923,29314073914,-9,909,2879,30
29317223395,29317223390,-5,726,1438,30
29320047853,29320047850,-3,899,2569,30
29321448727,29321448723,-4,860,1905,30
29323425229,29323425221,-8,649,2807,30
29325789151,29325789145,-6,1120,2646,30
29327639970,29327639967,-3,875,2915,30
29328183939,29328183937,-2,826,2481,30
29328492267,29328492262,-5,907,2947,30
29332873414,29332873418,4,1810,1212,30
29333991303,29333991298,-5,1036,2463,30
29336904459,29336904458,-1,1172,2329,30
29338185733,29338185738,5,3002,1209,30
29340631055,29340631050,-5,1404,2513,30
29347068471,29347068467,-4,725,2113,30
29350323024,29350323019,-5,830,2405,30
29350583758,29350583752,-6,1231,3362,30
29352013830,29352013829,-1,2261,4053,30
29357040867,29357040862,-5,862,2476,30
29357880424,29357880419,-5,1238,2617,30
29359156602,29359156597,-5,919,3176,30
29363194427,29363194422,-5,1011,2859,30
29365812714,29365812709,-5,1243,3451,30
29369567894,29369567891,-3,517,1594,30
29369903641,29369903636,-5,671,1840,30
29375717309,29375717305,-4,980,3002,30
29377159083,29377159078,-5,619,2263,30
29379307164,29379307161,-3,1227,3011,30
29380919858,29380919853,-5,1110,3866,30
29381342198,29381342194,-4,770,3078,30
29383016976,29383016971,-5,1207,3415,30
29389183743,29389183739,-4,953,3377,30
29389552978,29389552973,-5,1128,4153,30
29395189790,29395189786,-4,1069,3570,30
29395674286,29395674281,-5,1246,2726,30
29396722338,29396722341,3,2120,1612,30
29402893896,29402893890,-6,985,2796,30
29406368709,29406368705,-4,1133,3080,30
29410260000,29410259996,-4,1110,2192,30
29410286633,29410286626,-7,1020,3142,30
29416984235,29416984229,-6,1074,2693,30
29417591793,29417591810,17,452,1074,30
29421461504,29421461501,-3,1221,4083,30
29426883339,29426883336,-3,36990,17953,30
29428642757,29428642753,-4,1280,2634,30
29439062878,29439062874,-4,1060,3283,30
29440021268,29440021246,-22,1461,2832,30
29440437116,29440437135,19,810,2720,30
29442158395,29442158390,-5,942,2830,30
29442366401,29442366405,4,17581,22955,30
29446251778,29446251774,-4,969,3433,30
29447677407,29447677404,-3,1226,2119,30
29451233316,29451233310,-6,1391,3500,30
29455223278,29455223274,-4,984,2503,30
29465437963,29465437965,2,1722,1911,30
29474582082,29474582087,5,2175,1524,30
29480110539,29480110534,-5,1106,3166,30
29480268785,29480268781,-4,1011,2772,30
29483125587,29483125582,-5,1208,2633,30
29486479841,29486479840,-1,1193,2433,30
29490960394,29490960393,-1,2015,4039,30
29491027771,29491027770,-1,1559,3209,30
29493081129,29493081125,-4,1189,2918,30
29493260111,29493260106,-5,757,1919,30
29496941299,29496941294,-5,819,2693,30
29498692011,29498692006,-5,639,2220,30
29511242331,29511242327,-4,1243,3262,30
29513908447,29513908441,-6,793,3216,30
29516260903,29516260898,-5,852,3439,30
29516338345,29516338366,21,268,802,30
29518279415,29518279414,-1,1270,3332,30
29522306433,29522306430,-3,1804,4885,30
29524062914,29524062908,-6,1169,2766,30
29525345213,29525345206,-7,649,1791,30
29525985841,29525985861,20,979,2423,30
29531428781,29531428788,7,8304,1260,30
29532210699,29532210695,-4,591,1078,30
29534499343,29534499338,-5,1276,2946,30
29536028695,29536028691,-4,922,2791,30
29536950802,29536950796,-6,1106,2940,30
29540504289,29540504294,5,2946,1226,30
29543186346,29543186342,-4,1197,3002,30
29548921021,29548921030,9,3650,1903,30
29549980801,29549980797,-4,1210,3237,30
29550208391,29550208389,-2,1042,2617,30
29554870157,29554870153,-4,1336,2873,30
29554968878,29554968873,-5,931,3353,30
29555113735,29555113730,-5,1074,3713,30
29562044613,29562044610,-3,689,1971,30
29565395552,29565395546,-6,1088,3466,30
29568583934,29568583930,-4,771,2671,30
29573012009,29573012016,7,2020,1245,30
29573840655,29573840650,-5,1028,3258,30
29575193074,29575193093,19,1094,3275,30
29576505890,29576505885,-5,722,2417,30
29585022939,29585022937,-2,687,3063,30
29588898502,29588898498,-4,1372,4060,30
29589387022,29589387020,-2,778,3388,30
29589425261,29589425254,-7,1455,3733,30
29589560030,29589560028,-2,1520,3032,30
29590705974,29590705970,-4,1106,2737,30
29594143682,29594143677,-5,1234,2532,30
29595558221,29595558225,4,4596,2533,30
29599121457,29599121451,-6,918,4858,30
29601319238,29601319238,0,1513,2263,30
29602679531,29602679525,-6,931,2468,30
29607053766,29607053760,-6,1148,3046,30
29611034032,29611034026,-6,1154,4396,30
29611806055,29611806060,5,2918,2192,30
29620443735,29620443755,20,917,239,30
29621502977,29621502983,6,1656,1384,30
29627894540,29627894536,-4,725,2828,30
29631585333,29631585335,2,1407,1819,30
29633344135,29633344134,-1,1593,2422,30
29637919391,29637919386,-5,1217,2513,30
29641719896,29641719891,-5,927,2364,30
29647322911,29647322906,-5,1243,3433,30
29647841037,29647841041,4,1531,1574,30
29648620283,29648620277,-6,1040,3087,30
29650078411,29650078406,-5,763,1607,30
29650752313,29650752309,-4,1353,2897,30
29653220558,29653220558,0,6599,6823,30
29658193278,29658193274,-4,850,2589,30
29663120666,29663120662,-4,1262,3365,30
29663807291,29663807298,7,3207,1579,30
29664288975,29664288970,-5,1551,4401,30
29667076383,29667076387,4,3143,2624,30
29668756878,29668756874,-4,1063,1724,30
29673250666,29673250662,-4,882,2472,30
29674541256,29674541273,17,1409,5314,30
29685109923,29685109918,-5,913,2439,30
29685505371,29685505367,-4,844,2176,30
29693014651,29693014647,-4,1112,1841,30
29696935098,29696935093,-5,649,3988,30
29697590706,29697590686,-20,278,675,30
29698943719,29698943714,-5,769,1792,30
29700147859,29700147854,-5,829,2563,30
29700335668,29700335674,6,3729,1886,30
29704515219,29704515214,-5,1098,3078,30
29709835162,29709835159,-3,592,980,30
29710811940,29710811951,11,357,895,30
29716548317,29716548322,5,2799,1510,30
29716914667,29716914664,-3,1083,2094,30
29740228021,29740228025,4,4000,2028,30
29742808060,29742808064,4,10331,33599,30
29743016758,29743016764,6,1718,1169,30
29749939649,29749939642,-7,2682,14060,30
29750198483,29750198478,-5,1274,3751,30
29752089834,29752089831,-3,883,3162,30
29752835152,29752835175,23,1216,2148,30
29753562745,29753562741,-4,1401,3549,30
29753697699,29753697715,16,390,1183,30
29764072163,29764072160,-3,23769,77278,30
29764891634,29764891630,-4,499,1079,30
29778320522,29778320517,-5,539,1137,30
29787883353,29787883350,-3,1333,2697,30
29789716135,29789716130,-5,905,2351,30
29792312214,29792312209,-5,581,2056,30
29793814522,29793814529,7,4989,1357,30
29796349301,29796349296,-5,1197,3070,30
29796899688,29796899709,21,339,991,30
29801755769,29801755789,20,438,1503,30
29807288694,29807288693,-1,763,1767,30
29807537802,29807537811,9,13742,22230,30
29810051245,29810051242,-3,1702,3084,30
29816936354,29816936348,-6,1549,3192,30
29822249166,29822249163,-3,1008,2752,30
29823998828,29823998824,-4,713,2161,30
29829676523,29829676519,-4,1187,2359,30
29834002846,29834002842,-4,694,2209,30
29834591299,29834591302,3,465,1466,30
29834770362,29834770375,13,621,1491,30
29839201002,29839200998,-4,918,2794,30
29845249867,29845249883,16,106,1051,30
29848648590,29848648586,-4,661,4396,30
29849699419,29849699424,5,1227,1015,30
29851386676,29851386671,-5,903,2974,30
29852779265,29852779263,-2,1315,2653,30
29853771588,29853771591,3,1748,1614,30
29864176402,29864176397,-5,836,2720,30
29864248859,29864248870,11,200,538,30
29866573062,29866573057,-5,1139,3055,30
29866644028,29866644046,18,238,973,30
29869718854,29869718848,-6,1109,3358,30
29871385637,29871385633,-4,954,3007,30
29881968137,29881968140,3,1844,1666,30
29883293630,29883293628,-2,918,2154,30
29883703714,29883703698,-16,891,2175,30
29883762682,29883762682,0,165,1104,30
29886628119,29886628117,-2,904,2247,30
29891778167,29891778163,-4,1039,3383,30
29892584601,29892584597,-4,1126,3132,30
29906209682,29906209678,-4,1347,2914,30
29908617393,29908617389,-4,1417,3193,30
29908744095,29908744093,-2,733,1354,30
29908986235,29908986230,-5,873,2820,30
29912236645,29912236641,-4,1187,2447,30
29916682183,29916682178,-5,1258,3519,30
29927663019,29927663017,-2,1268,2169,30
29929736041,29929736038,-3,1278,2668,30
29935454829,29935454823,-6,1164,3590,30
29935795665,29935795670,5,2500,1228,30
29940214357,29940214352,-5,1235,3223,30
29943320137,29943320139,2,1347,1066,30
29943892084,29943892101,17,265,1033,30
29947825763,29947825782,19,1024,2605,30
29950410069,29950410065,-4,1107,3189,30
29950920351,29950920342,-9,1084,13369,30
29952180836,29952180831,-5,1322,3568,30
29952393640,29952393653,13,192,1254,30
29953363951,29953363947,-4,962,2372,30
29954102302,29954102298,-4,1196,2866,30
29957217122,29957217118,-4,765,2945,30
29957470599,29957470595,-4,980,3139,30
29958809818,29958809814,-4,660,1875,30
29958837970,29958837983,13,605,1798,30
29964088260,29964088258,-2,1111,2264,30
29969599530,29969599528,-2,800,1876,30
29970136579,29970136592,13,733,2093,30
29972708663,29972708658,-5,568,1940,30
29975649882,29975649874,-8,1121,2795,30
29976520186,29976520194,8,1998,910,30
29979230924,29979230919,-5,1100,3012,30
29980770214,29980770212,-2,1227,2473,30
29982825347,29982825341,-6,652,1590,30
29987011732,29987011727,-5,1105,2424,30
29987557342,29987557338,-4,719,3067,30
29987772068,29987772086,18,1123,3832,30
29989602509,29989602506,-3,1378,3587,30
30003797351,30003797347,-4,987,2267,30
30005892222,30005892216,-6,707,2698,30
30008343344,30008343347,3,2267,976,30
30010751603,30010751589,-14,887,2349,30
30015942090,30015942085,-5,1103,2988,30
30017975193,30017975187,-6,1114,2926,30
30024620263,30024620260,-3,1220,2552,30
30026037074,30026037077,3,1431,1719,30
30026252966,30026252961,-5,757,2708,30
30029510868,30029510866,-2,1202,2157,30
30033400578,30033400575,-3,859,2701,30
30034375976,30034375973,-3,804,1571,30
30034532533,30034532538,5,1804,1056,30
30035087587,30035087582,-5,675,2202,30
30040199686,30040199684,-2,934,1941,30
30042128681,30042128676,-5,1148,2239,30
30042471619,30042471604,-15,875,3482,30
30055020469,30055020463,-6,980,2191,30
30055582391,30055582389,-2,1268,2253,30
30059022615,30059022610,-5,928,3449,30
30062155267,30062155265,-2,861,1616,30
30074319424,30074319421,-3,1252,3519,30
30074783608,30074783595,-13,176,850,30
30082583258,30082583254,-4,1270,3862,30
30083310553,30083310549,-4,1009,2252,30
30088983584,30088983578,-6,586,2914,30
30090361859,30090361857,-2,1135,2464,30
30093516939,30093516934,-5,1476,4555,30
30095478323,30095478322,-1,1722,2390,30
30097251330,30097251326,-4,1396,3662,30
30101486851,30101486844,-7,595,2173,30
30102742987,30102742985,-2,1045,1906,30
30112865722,30112865718,-4,991,2511,30
30119488725,30119488721,-4,1362,3470,30
30125281078,30125281073,-5,1243,3511,30
30128767575,30128767570,-5,1063,2764,30
30129502353,30129502347,-6,1009,3438,30
30131668169,30131668164,-5,1018,2236,30
30135992126,30135992122,-4,1661,2804,30
30138070183,30138070179,-4,1270,2729,30
30139695813,30139695814,1,1027,902,30
30146071377,30146071374,-3,935,2891,30
30147516746,30147516750,4,1616,1325,30
30149034230,30149034227,-3,2704,4909,30
30162405911,30162405909,-2,727,2834,30
30164780159,30164780154,-5,992,1928,30
30172871097,30172871102,5,2712,959,30
30179365913,30179365909,-4,1693,4383,30
30179478163,30179478182,19,739,2134,30
30180398487,30180398484,-3,1243,2376,30
30188163533,30188163526,-7,1199,3038,30
30190250435,30190250431,-4,1357,2558,30
30193124723,30193124719,-4,828,2985,30
30194658486,30194658481,-5,920,2283,30
30206078087,30206078083,-4,959,3103,30
30211351205,30211351197,-8,977,4081,30
30212077650,30212077646,-4,1021,1687,30
30214006067,30214006063,-4,927,1998,30
30214323612,30214323614,2,5961,19591,30
30216519934,30216519928,-6,1282,4204,30
30219114248,30219114247,-1,1129,1914,30
30219235568,30219235551,-17,891,2410,30
30224139965,30224139963,-2,913,2948,30
30225470709,30225470715,6,3104,1283,30
30225651366,30225651363,-3,1008,2248,30
30227354856,30227354850,-6,768,3030,30
30231335891,30231335886,-5,1360,3965,30
30231504250,30231504235,-15,910,2407,30
30238700235,30238700238,3,1585,1391,30
30240774927,30240774923,-4,801,2739,30
30243274518,30243274514,-4,1869,3904,30
30245081142,30245081137,-5,928,3190,30
30248010900,30248010914,14,313,1220,30
30253597834,30253597829,-5,982,2746,30
30256056766,30256056762,-4,1446,2233,30
30258306813,30258306818,5,2792,1080,30
30260270620,30260270618,-2,1315,2388,30
30261478773,30261478770,-3,890,2446,30
30263408352,30263408346,-6,985,3177,30
30268515014,30268515013,-1,1181,2789,30
30269465816,30269465811,-5,1044,2325,30
30270268055,30270268050,-5,1007,2674,30
30271028763,30271028757,-6,1189,2988,30
30274739661,30274739655,-6,1625,4429,30
30276743715,30276743712,-3,899,2867,30
30277951407,30277951395,-12,1486,874,30
30280398753,30280398749,-4,1243,2836,30
30282389488,30282389482,-6,1018,3908,30
30282623244,30282623245,1,11660,14465,30
30286385217,30286385217,0,2793,2502,30
30286984421,30286984417,-4,1411,2847,30
30289044753,30289044750,-3,1292,2679,30
30293417886,30293417881,-5,817,3061,30
30296462943,30296462941,-2,904,2635,30
30301829639,30301829636,-3,865,3216,30
30303653477,30303653473,-4,984,2772,30
30305134094,30305134100,6,2928,887,30
30307807377,30307807374,-3,755,2488,30
30312011768,30312011763,-5,834,3659,30
30313494220,30313494218,-2,2600,4904,30
30314008224,30314008217,-7,1382,3274,30
30318940997,30318940993,-4,865,1911,30
30320228590,30320228585,-5,16583,14913,30
30320794261,30320794253,-8,1100,2731,30
30321141992,30321142005,13,234,726,30
30324892047,30324892041,-6,834,2329,30
30328797431,30328797428,-3,1405,2254,30
30337634238,30337634232,-6,1449,2823,30
30339800023,30339800019,-4,1014,3153,30
30342963664,30342963658,-6,913,3727,30
30344298189,30344298185,-4,1122,2640,30
30346055287,30346055282,-5,1005,3257,30
30346389031,30346389036,5,4336,2361,30
30351029854,30351029851,-3,1062,2326,30
30351712482,30351712477,-5,162,1152,30
30351949099,30351949095,-4,752,3083,30
30352874961,30352874957,-4,1212,2709,30
30357051286,30357051286,0,4215,18066,30
30368178639,30368178640,1,10012,22409,30
30368788355,30368788349,-6,850,2255,30
30372146239,30372146233,-6,2665,11077,30
30372627122,30372627130,8,1326,513,30
30378655070,30378655068,-2,609,2388,30
30388121444,30388121437,-7,1109,2864,30
30389020490,30389020487,-3,318,780,30
30390467682,30390467677,-5,1080,3149,30
30391094866,30391094867,1,1748,2165,30
30395421647,30395421643,-4,867,2853,30
30397727605,30397727601,-4,797,1916,30
30404229453,30404229449,-4,1216,3644,30
30405112002,30405111980,-22,134,942,30
30405333352,30405333375,23,1282,3148,30
30410355251,30410355246,-5,557,912,30
30411188624,30411188627,3,18623,19340,30
30411407338,30411407333,-5,1061,1843,30
30420836034,30420836039,5,1605,1054,30
30421956158,30421956153,-5,1115,2932,30
30422171511,30422171507,-4,1212,3770,30
30422549798,30422549799,1,2390,2620,30
30422977075,30422977070,-5,1322,2978,30
30428260706,30428260698,-8,905,2876,30
30428742843,30428742826,-17,180,628,30
30433425462,30433425457,-5,1069,2421,30
30440157846,30440157850,4,2103,1052,30
30442932184,30442932180,-4,1081,3038,30
30444470065,30444470071,6,4480,2213,30
30445063390,30445063384,-6,993,2248,30
30445473280,30445473294,14,471,1076,30
30447216878,30447216870,-8,1002,4040,30
30448297773,30448297770,-3,1519,3670,30
30457712242,30457712239,-3,1190,3318,30
30458862321,30458862315,-6,1143,3637,30
30460478049,30460478049,0,1042,1328,30
30465274613,30465274608,-5,1217,3899,30
30467121073,30467121078,5,1617,764,30
30472714369,30472714364,-5,1171,3179,30
30473044540,30473044536,-4,2176,14352,30
30475584297,30475584293,-4,651,2152,30
30486392459,30486392454,-5,849,2095,30
30487168029,30487168025,-4,1244,3178,30
30491723794,30491723786,-8,945,6428,30
30491811705,30491811719,14,324,793,30
30493231742,30493231738,-4,1295,3323,30
30493892010,30493892006,-4,917,2769,30
30494156848,30494156842,-6,703,3322,30
30503753195,30503753190,-5,928,2310,30
30503960886,30503960882,-4,1331,3488,30
30507638042,30507638038,-4,1286,3444,30
30510825703,30510825692,-11,890,348,30
30510940119,30510940115,-4,722,2698,30
30511640114,30511640111,-3,952,1436,30
30512207985,30512207993,8,14173,25376,30
30516812195,30516812188,-7,912,2133,30
30517377369,30517377358,-11,291,1075,30
30520884702,30520884697,-5,1678,3345,30
30526737775,30526737771,-4,994,2627,30
30530183149,30530183144,-5,852,2719,30
30539876991,30539876986,-5,1036,3187,30
30541818140,30541818136,-4,1457,4278,30
30547233309,30547233305,-4,825,2141,30
30547412514,30547412529,15,679,2264,30
30556199682,30556199678,-4,1342,3381,30
30556769285,30556769279,-6,1376,5095,30
30556971723,30556971716,-7,1160,2880,30
30559318527,30559318521,-6,750,3024,30
30562486880,30562486877,-3,936,3060,30
30565682902,30565682897,-5,989,3372,30
30573120915,30573120915,0,1035,1583,30
30573188623,30573188619,-4,1230,2522,30
30580101749,30580101744,-5,1323,4669,30
30586826457,30586826453,-4,1040,3316,30
30587101184,30587101176,-8,329,1145,30
30587312534,30587312530,-4,577,3014,30
30595238766,30595238762,-4,1142,2961,30
30597150319,30597150314,-5,1075,2662,30
30603871002,30603870999,-3,959,2261,30
30605307151,30605307148,-3,1239,3390,30
30605597917,30605597919,2,693,1025,30
30611476658,30611476656,-2,595,2395,30
30612492945,30612492942,-3,1381,2574,30
30612621035,30612621038,3,109,920,30
30613931439,30613931433,-6,692,3006,30
30614044640,30614044645,5,2125,1288,30
30615006342,30615006338,-4,1179,3446,30
30618356057,30618356053,-4,834,1775,30
30627862942,30627862947,5,2494,1555,30
30633334051,30633334046,-5,1025,2328,30
30634511898,30634511894,-4,950,2103,30
30635175281,30635175294,13,529,841,30
30636231507,30636231522,15,261,1538,30
30639380279,30639380285,6,4106,1728,30
30646989287,30646989284,-3,1449,2344,30
30647282729,30647282726,-3,1192,3239,30
30647908625,30647908621,-4,992,3252,30
30653929218,30653929213,-5,973,3892,30
30654299771,30654299765,-6,1425,4907,30
30655944244,30655944238,-6,966,2423,30
30656667373,30656667354,-19,570,1973,30
30657519923,30657519921,-2,718,2788,30
30658389656,30658389651,-5,136,465,30
30659205889,30659205883,-6,1237,2713,30
30659961974,30659961969,-5,969,2961,30
30674532888,30674532881,-7,1205,2679,30
30675247539,30675247553,14,958,3178,30
30676625746,30676625743,-3,1329,2922,30
30677063551,30677063546,-5,1389,2580,30
30677261904,30677261887,-17,115,1063,30
30686429803,30686429799,-4,1156,3345,30
30689432789,30689432769,-20,1004,2893,30
30690479857,30690479852,-5,1521,4226,30
30694929255,30694929249,-6,1022,2841,30
30695081482,30695081477,-5,967,3347,30
30696208404,30696208407,3,1413,1542,30
30696988857,30696988838,-19,228,971,30
30697340433,30697340434,1,143,738,30
30698915397,30698915391,-6,1200,3115,30
30701889005,30701889009,4,2517,1090,30
30701981149,30701981143,-6,1072,4110,30
30702524237,30702524234,-3,1047,2991,30
30707279525,30707279522,-3,1266,3428,30
30707799497,30707799491,-6,764,2324,30
30712888918,30712888914,-4,843,3233,30
30714143033,30714143029,-4,1190,3229,30
30716372839,30716372838,-1,849,1652,30
30729827001,30729826997,-4,1168,3160,30
30733148711,30733148709,-2,1031,1929,30
30734024910,30734024904,-6,1049,3684,30
30734607378,30734607376,-2,908,2461,30
30734916827,30734916823,-4,932,2278,30
30737680345,30737680349,4,219,1629,30
30740639374,30740639370,-4,1268,2747,30
30741522718,30741522717,-1,966,2066,30
30747673380,30747673377,-3,1211,3077,30
30749543894,30749543889,-5,1318,3228,30
30752079391,30752079386,-5,1014,1866,30
30758519462,30758519457,-5,813,2337,30
30762678847,30762678844,-3,794,1851,30
30765509734,30765509730,-4,1013,2315,30
30768345879,30768345875,-4,803,3607,30
30769609259,30769609237,-22,184,1259,30
30771369764,30771369762,-2,862,2124,30
30771915450,30771915470,20,846,2203,30
30774378442,30774378436,-6,970,2536,30
30782468187,30782468182,-5,1026,3188,30
30783886460,30783886455,-5,1116,2991,30
30788033555,30788033553,-2,1083,1820,30
30788285450,30788285446,-4,1053,3350,30
30793419557,30793419553,-4,975,2206,30
30795568778,30795568774,-4,1024,3019,30
30797968594,30797968590,-4,1192,3879,30
30801144376,30801144373,-3,1156,3210,30
30801907150,30801907146,-4,750,2663,30
30803031545,30803031539,-6,1388,6096,30
30807054403,30807054397,-6,1107,4246,30
30807148503,30807148498,-5,1183,2486,30
30814152306,30814152299,-7,744,2222,30
30817835201,30817835197,-4,1230,3548,30
30819917147,30819917144,-3,934,2665,30
30826092409,30826092416,7,2276,1119,30
30827237969,30827237964,-5,1420,2707,30
30827569577,30827569562,-15,1124,2799,30
30828433747,30828433726,-21,216,1259,30
30833008879,30833008874,-5,1244,2553,30
30837363716,30837363711,-5,1266,2953,30
30841434237,30841434234,-3,1723,4400,30
30842472425,30842472423,-2,831,1299,30
30844998918,30844998914,-4,814,2704,30
30847145618,30847145612,-6,841,3092,30
30853236973,30853236968,-5,560,1067,30
30856637881,30856637878,-3,1098,2133,30
30864258949,30864258953,4,2220,1178,30
30866072549,30866072542,-7,482,1642,30
30873416427,30873416423,-4,949,2555,30
30873653507,30873653501,-6,1090,3373,30
30874450218,30874450214,-4,1072,3413,30
30882491304,30882491301,-3,1112,3438,30
30891026095,30891026090,-5,1307,2819,30
30897785392,30897785386,-6,809,2767,30
30899494495,30899494490,-5,611,1854,30
30901504834,30901504830,-4,929,2762,30
30904297057,30904297054,-3,1177,3913,30
30905099631,30905099624,-7,928,3398,30
30908580497,30908580490,-7,1019,2766,30
30908705610,30908705611,1,940,1475,30
30909377729,30909377749,20,764,2955,30
30937368918,30937368911,-7,751,2395,30
30951859251,30951859248,-3,818,2995,30
30954020658,30954020654,-4,1340,2942,30
30967656694,30967656707,13,12270,32490,30
30968328227,30968328223,-4,869,3007,30
30968503546,30968503537,-9,251,1703,30
30969285990,30969285985,-5,1692,5461,30
30970998246,30970998241,-5,1102,3430,30
30972158458,30972158452,-6,359,832,30
30972360790,30972360785,-5,1093,3880,30
30974633510,30974633506,-4,967,3135,30
30975744435,30975744433,-2,1013,2539,30
30978070086,30978070082,-4,1054,2814,30
30980923129,30980923122,-7,1049,2264,30
30984909958,30984909955,-3,703,2627,30
30986478460,30986478457,-3,566,1757,30
30986649804,30986649812,8,15792,30674,30
30988123836,30988123831,-5,1026,1976,30
30991200526,30991200522,-4,1221,2985,30
30991568262,30991568261,-1,1087,802,30
30992453958,30992453963,5,1956,1208,30
30996122002,30996121998,-4,863,1661,30
30997834853,30997834848,-5,1154,2053,30
31002236000,31002235998,-2,1761,2435,30
31011251303,31011251299,-4,846,1760,30
31011596703,31011596696,-7,1207,3591,30
31011631620,31011631616,-4,1205,3020,30
31013011870,31013011867,-3,1021,3196,30
31017086331,31017086329,-2,1057,1932,30
31025341373,31025341377,4,3695,2699,30
31033540470,31033540466,-4,1079,2502,30
31033815770,31033815789,19,646,2573,30
31037470914,31037470910,-4,1475,3001,30
31047882898,31047882897,-1,1393,2565,30
31055636813,31055636809,-4,670,2406,30
31058009080,31058009073,-7,1394,3772,30
31064765215,31064765210,-5,829,2637,30
31065041379,31065041378,-1,1087,598,30
31066498117,31066498113,-4,830,2604,30
31068210669,31068210663,-6,999,2495,30
31069606915,31069606902,-13,231,1232,30
31078717015,31078717011,-4,1137,2583,30
31085309509,31085309504,-5,1605,2923,30
31085927194,31085927181,-13,251,1087,30
31086462277,31086462273,-4,1217,4372,30
31095088493,31095088490,-3,888,2331,30
31101814514,31101814510,-4,1225,2720,30
31102717363,31102717369,6,5258,2095,30
31103441102,31103441097,-5,1302,3378,30
31103802627,31103802621,-6,953,3572,30
31112848612,31112848606,-6,1250,3228,30
31114970717,31114970712,-5,941,2368,30
31118864007,31118864014,7,26493,59509,30
31121128710,31121128707,-3,839,3196,30
31122150042,31122150039,-3,923,3052,30
31127311646,31127311641,-5,845,2640,30
31128770386,31128770401,15,305,831,30
31132558079,31132558077,-2,760,1574,30
31133249045,31133249041,-4,887,1753,30
31139857086,31139857090,4,2447,1072,30
31139914926,31139914931,5,844,664,30
31141212866,31141212873,7,3559,1432,30
31141657925,31141657918,-7,1429,4804,30
31148454669,31148454666,-3,1998,4764,30
31149256682,31149256674,-8,1057,2309,30
31149954096,31149954092,-4,1475,3121,30
31150566062,31150566056,-6,1092,2844,30
31161080399,31161080397,-2,844,2977,30
31161724242,31161724221,-21,1047,2885,30
31163156699,31163156694,-5,1112,2984,30
31164806686,31164806679,-7,1101,3162,30
31170594331,31170594326,-5,1513,3307,30
31174668565,31174668562,-3,1130,2788,30
31175576651,31175576650,-1,1160,1410,30
31180821710,31180821706,-4,1250,2898,30
31183787498,31183787490,-8,942,5027,30
31185149413,31185149406,-7,1070,2046,30
31186302186,31186302190,4,1889,1195,30
31188796905,31188796901,-4,701,1862,30
31196106693,31196106687,-6,827,3346,30
31196701831,31196701824,-7,861,4838,30
31198674310,31198674308,-2,1011,2183,30
31198746117,31198746110,-7,1076,3055,30
31205570813,31205570809,-4,1129,2404,30
31212023918,31212023913,-5,775,2025,30
31212923183,31212923177,-6,820,2018,30
31214625582,31214625577,-5,624,2044,30
31219917463,31219917458,-5,1214,2533,30
31224931297,31224931301,4,3410,3053,30
31230624543,31230624539,-4,814,2343,30
31230791889,31230791911,22,447,2894,30
31231499951,31231499944,-7,570,2245,30
31250921835,31250921830,-5,921,2673,30
31254702856,31254702858,2,1619,1592,30
31263943410,31263943406,-4,1400,2402,30
31264893683,31264893680,-3,1172,3396,30
31269238278,31269238274,-4,994,3121,30
31272253891,31272253894,3,1574,1293,30
31272964118,31272964114,-4,861,2435,30
31275116675,31275116673,-2,1646,3160,30
31279287997,31279287992,-5,1025,2724,30
31289080739,31289080734,-5,1187,2384,30
31292439413,31292439409,-4,688,2897,30
31295797182,31295797177,-5,1039,3243,30
31296908207,31296908202,-5,1176,1820,30
31307134267,31307134262,-5,1315,3081,30
31310227899,31310227894,-5,1163,3422,30
31310363665,31310363650,-15,309,1092,30
31313920292,31313920287,-5,1423,3084,30
31320211945,31320211944,-1,1967,2588,30
31321585973,31321585970,-3,1150,2755,30
31341818413,31341818417,4,3744,2325,30
31343002521,31343002517,-4,663,1769,30
31343293846,31343293841,-5,925,3003,30
31344119602,31344119598,-4,1133,2575,30
31347469271,31347469268,-3,975,2069,30
31347769624,31347769641,17,355,1261,30
31360507001,31360506998,-3,957,1245,30
31366346002,31366345998,-4,867,2566,30
31367531940,31367531935,-5,1395,3623,30
31367804364,31367804377,13,393,1057,30
31370584590,31370584589,-1,826,2340,30
31372267843,31372267839,-4,1003,3904,30
31374224520,31374224516,-4,939,3048,30
31375693211,31375693206,-5,1362,2898,30
31382917437,31382917434,-3,3695,4101,30
31384410819,31384410814,-5,1066,3903,30
31384701665,31384701658,-7,1097,4225,30
31386156793,31386156787,-6,1094,3292,30
31388186960,31388186957,-3,1103,3258,30
31397848650,31397848646,-4,843,2173,30
31397883782,31397883776,-6,930,2455,30
31407593690,31407593686,-4,1087,4493,30
31416215570,31416215583,13,16589,24736,30
31417529159,31417529154,-5,1857,7507,30
31417932074,31417932069,-5,1704,4213,30
31424331053,31424331051,-2,1316,1856,30
31427784702,31427784696,-6,1117,2362,30
31427859058,31427859054,-4,996,2938,30
31434773511,31434773509,-2,1218,2547,30
31435296821,31435296817,-4,1065,3241,30
31435782390,31435782389,-1,1381,1418,30
31439282723,31439282718,-5,1249,3376,30
31440193390,31440193390,0,3852,17798,30
31443695617,31443695613,-4,1003,2535,30
31443770956,31443770970,14,1538,3130,30
31444087235,31444087231,-4,739,2925,30
31447550933,31447550930,-3,1149,1965,30
31451279371,31451279366,-5,1267,3006,30
31453069875,31453069887,12,700,3183,30
31462422769,31462422766,-3,1005,1402,30
31464395946,31464395944,-2,1189,2518,30
31465020026,31465020030,4,2286,1066,30
31467204739,31467204737,-2,2207,4257,30
31474038415,31474038409,-6,1003,2028,30
31476645649,31476645647,-2,1281,1556,30
31477976643,31477976621,-22,1765,721,30
31479216185,31479216180,-5,1187,2839,30
31482114450,31482114446,-4,970,2483,30
31485531919,31485531914,-5,1084,2981,30
31487356262,31487356257,-5,1084,2912,30
31487547416,31487547414,-2,42,841,30
31490085884,31490085879,-5,1172,2511,30
31490396950,31490396946,-4,586,1796,30
31498136712,31498136709,-3,1007,3441,30
31499647626,31499647623,-3,1199,3947,30
31502490517,31502490517,0,3050,3643,30
31509626218,31509626214,-4,1108,3438,30
31510690669,31510690662,-7,1216,3635,30
31513635273,31513635270,-3,1003,2509,30
31516027139,31516027134,-5,1155,2215,30
31517512499,31517512495,-4,1058,3715,30
31518599386,31518599397,11,78,885,30
31523448526,31523448523,-3,949,2228,30
31525439944,31525439939,-5,1223,2593,30
31527174847,31527174842,-5,716,2284,30
31535519246,31535519241,-5,929,2317,30
31538470956,31538470952,-4,1325,4285,30
31540469403,31540469398,-5,990,2996,30
31543113575,31543113570,-5,761,2352,30
31544199950,31544199946,-4,1189,3222,30
31546311419,31546311413,-6,1542,3470,30
31547077306,31547077302,-4,1014,3170,30
31552667118,31552667118,0,698,1485,30
31559465529,31559465522,-7,1458,5034,30
31566786792,31566786788,-4,1144,3125,30
31566850610,31566850626,16,518,1849,30
31568531278,31568531276,-2,1078,2914,30
31568703547,31568703542,-5,676,2040,30
31575706771,31575706767,-4,891,2479,30
31581675057,31581675052,-5,936,4114,30
31582391292,31582391309,17,1000,2496,30
31588787004,31588786999,-5,1095,2408,30
31589328945,31589328945,0,66,1032,30
31592891085,31592891082,-3,20498,13662,30
31595668066,31595668073,7,2717,1433,30
31596570895,31596570892,-3,922,3514,30
31605403548,31605403543,-5,1257,2975,30
31606436539,31606436534,-5,1290,3504,30
31610035539,31610035533,-6,715,2538,30
31611874405,31611874400,-5,1024,1838,30
31611925821,31611925819,-2,1564,3179,30
31614600083,31614600078,-5,1153,2497,30
31617078176,31617078171,-5,1027,3339,30
31624172310,31624172306,-4,1633,4515,30
31625220519,31625220516,-3,1077,2818,30
31628502705,31628502701,-4,1344,3734,30
31629556122,31629556118,-4,1432,3957,30
31630395844,31630395840,-4,936,2351,30
31630979610,31630979606,-4,817,1580,30
31632466073,31632466066,-7,1163,3157,30
31639000563,31639000557,-6,1188,2338,30
31640121221,31640121217,-4,689,2454,30
31641520249,31641520244,-5,116,955,30
31643652711,31643652706,-5,1097,2012,30
31644489554,31644489550,-4,1093,2320,30
31649576291,31649576286,-5,637,2406,30
31649946407,31649946404,-3,1082,2861,30
31651153549,31651153546,-3,1028,3267,30
31651258173,31651258167,-6,1070,2507,30
31651782544,31651782544,0,2561,2497,30
31662781831,31662781823,-8,708,3661,30
31665748254,31665748251,-3,1283,3023,30
31668433151,31668433147,-4,831,2506,30
31672021770,31672021766,-4,1120,2464,30
31672931111,31672931106,-5,1030,2850,30
31672971209,31672971212,3,193,577,30
31673254061,31673254055,-6,1421,4325,30
31674638743,31674638737,-6,2077,5643,30
31685340074,31685340068,-6,1289,3102,30
31687045285,31687045293,8,2517,1095,30
31691530303,31691530298,-5,990,3884,30
31693068604,31693068601,-3,1235,2549,30
31696567315,31696567311,-4,1023,2589,30
31696968281,31696968276,-5,813,2639,30
31697184450,31697184466,16,282,755,30
31702215943,31702215939,-4,1427,3661,30
31705156480,31705156476,-4,1386,3016,30
31708613545,31708613542,-3,1619,2724,30
31713924906,31713924899,-7,1656,3657,30
31716234891,31716234887,-4,1093,2643,30
31716842223,31716842221,-2,1002,1429,30
31720238774,31720238787,13,14819,43007,30
31729625722,31729625721,-1,1137,2098,30
31732004875,31732004869,-6,1195,3476,30
31733970195,31733970192,-3,1531,2281,30
31743922568,31743922571,3,1769,1072,30
31746684093,31746684088,-5,2649,6619,30
31747347729,31747347727,-2,720,4027,30
31748749332,31748749331,-1,1876,3882,30
31750357367,31750357362,-5,1011,2342,30
31755311415,31755311411,-4,1132,2859,30
31755562188,31755562203,15,416,2029,30
31757247711,31757247707,-4,1140,3343,30
31766049010,31766049006,-4,1357,4525,30
31771724304,31771724322,18,613,1869,30
31772246314,31772246334,20,1613,1302,30
31776952342,31776952337,-5,1031,3262,30
31783640160,31783640155,-5,1516,3084,30
31784387123,31784387118,-5,1274,3398,30
31790062858,31790062854,-4,1017,3765,30
31790302075,31790302073,-2,869,1833,30
31799052127,31799052145,18,164,1078,30
31800879934,31800879929,-5,1189,4106,30
31801037537,31801037537,0,1263,1448,30
31801078364,31801078379,15,243,637,30
31804068474,31804068472,-2,435,1763,30
31809037493,31809037493,0,1097,1398,30
31813166855,31813166851,-4,830,2800,30
31814791393,31814791386,-7,890,3539,30
31816941891,31816941886,-5,748,2396,30
31817778714,31817778709,-5,1044,3551,30
31818035176,31818035173,-3,1397,3797,30
31821153693,31821153687,-6,1248,3387,30
31828685071,31828685067,-4,1479,3031,30
31829575230,31829575227,-3,940,1934,30
31830232170,31830232165,-5,1540,3737,30
31834038460,31834038457,-3,1736,4715,30
31844879421,31844879417,-4,1402,2744,30
31845988402,31845988395,-7,859,2758,30
31846588393,31846588390,-3,858,2595,30
31849213282,31849213277,-5,1101,3141,30
31851866566,31851866575,9,8797,1090,30
31852550142,31852550137,-5,1101,2334,30
31858377242,31858377240,-2,860,1998,30
31862380220,31862380225,5,24986,28689,30
31864668875,31864668870,-5,1133,2612,30
31869051828,31869051823,-5,1516,3541,30
31870937721,31870937743,22,619,2601,30
31872757178,31872757178,0,936,1425,30
31874526507,31874526503,-4,1009,1974,30
31874834354,31874834350,-4,109,836,30
31874958384,31874958366,-18,243,998,30
31875605809,31875605804,-5,1138,3913,30
31876814283,31876814289,6,3033,1671,30
31882966402,31882966397,-5,1080,2087,30
31883022477,31883022481,4,2951,1805,30
31886942898,31886942894,-4,1326,3126,30
31887110924,31887110939,15,183,1263,30
31889139800,31889139794,-6,1440,4326,30
31891207543,31891207538,-5,1314,2091,30
31894509710,31894509702,-8,1241,4730,30
31900655010,31900655007,-3,1282,3076,30
31902495080,31902495073,-7,1108,2447,30
31904856586,31904856579,-7,770,1768,30
31906638741,31906638740,-1,23448,19345,30
31908172003,31908172000,-3,1091,1306,30
31909941100,31909941090,-10,1009,2852,30
31915605674,31915605669,-5,744,2562,30
31915745763,31915745743,-20,1258,3430,30
31917797122,31917797117,-5,952,3395,30
31918114336,31918114334,-2,1181,2812,30
31918468409,31918468397,-12,258,7738,30
31923348025,31923348021,-4,935,3165,30
31924702942,31924702945,3,1847,1478,30
31927711048,31927711058,10,186,803,30
31929714191,31929714185,-6,1405,2857,30
31934758357,31934758351,-6,1415,4372,30
31937711366,31937711359,-7,1022,2778,30
31945342117,31945342111,-6,575,1604,30
31946614792,31946614780,-12,40312,98942,30
31947294610,31947294605,-5,1276,3686,30
31952087643,31952087638,-5,1220,3322,30
31955147727,31955147722,-5,676,1885,30
31959251591,31959251586,-5,740,2750,30
31965461001,31965460998,-3,1224,2492,30
31966373509,31966373506,-3,985,2679,30
31966753977,31966753998,21,981,3038,30
31967810852,31967810848,-4,729,2015,30
31970788763,31970788757,-6,703,3337,30
31970973632,31970973646,14,431,1992,30
31985993515,31985993510,-5,1112,2055,30
31987175353,31987175347,-6,1025,3379,30
31990008138,31990008134,-4,1046,3083,30
31990068041,31990068034,-7,1710,7012,30
31990160178,31990160179,1,277,1339,30
31993128854,31993128850,-4,1066,2983,30
31998293142,31998293136,-6,626,1751,30
32000271281,32000271268,-13,2700,1430,30
32001322274,32001322270,-4,507,1953,30
32003109823,32003109818,-5,720,1792,30
32004019434,32004019428,-6,754,3191,30
32006193538,32006193540,2,2986,3033,30
32009069320,32009069313,-7,738,2424,30
32009500235,32009500229,-6,795,2602,30
32012750505,32012750511,6,7613,3206,30
32017582845,32017582850,5,2186,1318,30
32019122039,32019122034,-5,848,4024,30
32023207206,32023207211,5,6345,2481,30
32026371408,32026371402,-6,792,2326,30
32027218397,32027218393,-4,942,2186,30
32027387138,32027387136,-2,1079,1910,30
32030938206,32030938202,-4,1472,4941,30
32036604446,32036604441,-5,739,2885,30
32036630961,32036630961,0,1466,1560,30
32041322272,32041322270,-2,868,2380,30
32057601631,32057601627,-4,816,1586,30
32057891021,32057891026,5,2921,1504,30
32062174557,32062174559,2,1363,1519,30
32064982803,32064982798,-5,602,2746,30
32066436267,32066436250,-17,21,875,30
32067018734,32067018734,0,1432,1520,30
32069039855,32069039850,-5,1066,2430,30
32071248932,32071248936,4,4492,2708,30
32074371178,32074371174,-4,895,1987,30
32077575806,32077575801,-5,1549,3242,30
32085702464,32085702458,-6,1022,2452,30
32094944609,32094944615,6,7499,19427,30
32096125367,32096125361,-6,982,2562,30
32098626980,32098626976,-4,1092,2664,30
32102032715,32102032718,3,2921,2492,30
32108020396,32108020391,-5,1100,2580,30
32110202563,32110202550,-13,41530,4734,30
32110283250,32110283246,-4,989,2294,30
32111363016,32111363012,-4,1111,3581,30
32111794707,32111794702,-5,1153,2368,30
32116662614,32116662610,-4,1112,2439,30
32118557624,32118557643,19,137,1270,30
32123187170,32123187166,-4,780,2893,30
32129147790,32129147786,-4,1053,2516,30
32130295299,32130295315,16,257,1020,30
32133273816,32133273816,0,2563,2522,30
32134442881,32134442875,-6,816,2371,30
32137183371,32137183385,14,1060,2412,30
32140051252,32140051246,-6,1157,2304,30
32140336778,32140336799,21,443,1546,30
32142335231,32142335225,-6,1070,2761,30
32143629910,32143629905,-5,1280,2529,30
32144450407,32144450402,-5,831,2897,30
32152320907,32152320910,3,3551,1981,30
32154292194,32154292202,8,14530,4820,30
32154464723,32154464719,-4,661,1917,30
32155600495,32155600490,-5,1032,2836,30
32157234394,32157234390,-4,1003,3437,30
32159994499,32159994496,-3,1063,3083,30
32163601901,32163601896,-5,1008,2791,30
32163999904,32163999908,4,2156,1368,30
32164848023,32164848015,-8,21492,13417,30
32174593255,32174593251,-4,797,2233,30
32176413249,32176413246,-3,1095,2434,30
32185229966,32185229962,-4,1406,3600,30
32185610446,32185610443,-3,1036,2081,30
32193483290,32193483285,-5,869,3670,30
32194609762,32194609758,-4,1167,2452,30
32195875098,32195875093,-5,962,2666,30
32196660451,32196660447,-4,946,3982,30
32197148014,32197148008,-6,750,3720,30
32205543755,32205543748,-7,591,2270,30
32209331489,32209331485,-4,825,1873,30
32210213973,32210213983,10,16868,54526,30
32213087975,32213087972,-3,1426,3820,30
32213427931,32213427925,-6,1159,2841,30
32213857487,32213857483,-4,840,1953,30
32215169351,32215169348,-3,987,2052,30
32226455502,32226455500,-2,959,3100,30
32227942774,32227942772,-2,1130,1905,30
32237439113,32237439109,-4,1496,2566,30
32240486651,32240486645,-6,939,2712,30
32241796038,32241796035,-3,1062,4509,30
32243836098,32243836093,-5,1023,2886,30
32243868266,32243868258,-8,1045,2900,30
32243932323,32243932336,13,837,2207,30
32248331207,32248331202,-5,678,1905,30
32249391486,32249391481,-5,561,2095,30
32249523409,32249523399,-10,685,3935,30
32249915690,32249915711,21,270,931,30
32251151103,32251151096,-7,1007,2167,30
32256029061,32256029056,-5,1107,2169,30
32261760658,32261760653,-5,1307,3243,30
32264632603,32264632597,-6,6403,4197,30
32271428490,32271428484,-6,1670,3909,30
32271974814,32271974808,-6,1145,2814,30
32272140529,32272140542,13,310,786,30
32273382586,32273382582,-4,1169,3319,30
32280465722,32280465717,-5,1255,3321,30
32284015479,32284015477,-2,971,1882,30
32284573112,32284573107,-5,156,1319,30
32284905251,32284905229,-22,1157,2427,30
32290141851,32290141850,-1,2830,4304,30
32290437452,32290437458,6,1814,1199,30
32291328589,32291328585,-4,831,2166,30
32298556750,32298556748,-2,1017,2032,30
32299575658,32299575650,-8,795,5195,30
32299609329,32299609346,17,952,2797,30
32302891049,32302891044,-5,1123,3697,30
32305778383,32305778379,-4,926,2887,30
32317194191,32317194186,-5,786,2861,30
32324736959,32324736958,-1,648,1562,30
32328738410,32328738405,-5,1004,3655,30
32330470611,32330470609,-2,1045,2252,30
32336377324,32336377318,-6,898,1934,30
32337819893,32337819888,-5,1146,3113,30
32342071162,32342071157,-5,1098,2651,30
32343053344,32343053339,-5,1182,2734,30
32345804730,32345804730,0,1750,2152,30
32350128222,32350128217,-5,1322,3679,30
32355847975,32355847972,-3,920,2729,30
32358069067,32358069062,-5,881,1901,30
32360557274,32360557270,-4,804,2122,30
32364973583,32364973580,-3,1104,2419,30
32366405153,32366405150,-3,1209,2721,30
32370566159,32370566143,-16,118,1391,30
32371853212,32371853208,-4,1065,4009,30
32376143755,32376143749,-6,1027,2797,30
32376625649,32376625638,-11,931,2743,30
32379334330,32379334326,-4,1022,3235,30
32383041558,32383041555,-3,676,3464,30
32383236600,32383236623,23,1500,2679,30
32385229983,32385229977,-6,1215,3088,30
32385413609,32385413605,-4,1138,2540,30
32386998371,32386998366,-5,1197,2685,30
32395884855,32395884851,-4,919,2527,30
32396066755,32396066749,-6,1196,3126,30
32399065072,32399065069,-3,985,2144,30
32400691350,32400691354,4,2075,1909,30
32403360501,32403360496,-5,941,2109,30
32404773454,32404773449,-5,1132,2966,30
32405003494,32405003490,-4,738,3534,30
32407027149,32407027144,-5,656,2797,30
32407298608,32407298631,23,837,3212,30
32412263323,32412263320,-3,1239,3519,30
32416909598,32416909593,-5,1117,3540,30
32421880035,32421880031,-4,897,2092,30
32424987633,32424987633,0,765,2248,30
32425948363,32425948357,-6,845,2635,30
32429632304,32429632312,8,86450,103739,30
32431018192,32431018186,-6,1688,3762,30
32431773462,32431773467,5,4019,1820,30
32433106489,32433106484,-5,1040,2760,30
32438053243,32438053238,-5,848,2251,30
32442579474,32442579476,2,1190,1220,30
32443671334,32443671330,-4,1089,2358,30
32443915722,32443915715,-7,545,1464,30
32447538702,32447538709,7,3244,1697,30
32463271635,32463271632,-3,809,2742,30
32465850861,32465850856,-5,1177,3046,30
32471299329,32471299325,-4,1172,2614,30
32473603447,32473603443,-4,1024,3033,30
32473657085,32473657082,-3,1131,3029,30
32476693675,32476693671,-4,1299,3545,30
32477160551,32477160547,-4,1049,3637,30
32478415475,32478415467,-8,764,3097,30
32478974703,32478974698,-5,1384,2358,30
32484620194,32484620189,-5,1053,2441,30
32485128831,32485128826,-5,1092,2306,30
32486123547,32486123552,5,1328,691,30
32486859773,32486859765,-8,779,1506,30
32492160515,32492160515,0,1770,1359,30
32495049683,32495049680,-3,967,2639,30
32498533401,32498533397,-4,1209,2967,30
32499604534,32499604531,-3,644,1959,30
32507198572,32507198565,-7,1830,4529,30
32508908355,32508908350,-5,998,2978,30
32517103386,32517103382,-4,907,2403,30
32517593102,32517593098,-4,970,3253,30
32519802689,32519802684,-5,1115,2699,30
32521843729,32521843726,-3,1220,2307,30
32526218299,32526218296,-3,1306,2683,30
32535014163,32535014161,-2,485,1463,30
32536288215,32536288211,-4,673,1773,30
32547708489,32547708483,-6,1193,2612,30
32561518415,32561518410,-5,725,2948,30
32563945477,32563945469,-8,1376,3404,30
32564205813,32564205807,-6,860,3036,30
32564317481,32564317502,21,651,1905,30
32569502779,32569502783,4,3657,2986,30
32569912622,32569912617,-5,1007,2690,30
32578252906,32578252901,-5,1022,3235,30
32581981378,32581981373,-5,839,2573,30
32582806640,32582806637,-3,645,1881,30
32582840168,32582840189,21,1163,2870,30
32583478771,32583478769,-2,1254,2697,30
32587112894,32587112890,-4,1053,2965,30
32588564611,32588564603,-8,643,2321,30
32589518061,32589518056,-5,1195,2806,30
32589577315,32589577335,20,612,2253,30
32589799441,32589799437,-4,1317,2239,30
32590878106,32590878112,6,3125,1237,30
32594610785,32594610787,2,1420,1239,30
32607436070,32607436065,-5,1213,3157,30
32608966677,32608966674,-3,822,1224,30
32609377470,32609377465,-5,756,2500,30
32609560498,32609560494,-4,1133,3474,30
32609618178,32609618171,-7,923,2720,30
32611785450,32611785455,5,1423,29435,30
32612260450,32612260449,-1,1651,2233,30
32615977530,32615977523,-7,1071,3958,30
32620979693,32620979686,-7,1016,6090,30
32624274290,32624274283,-7,841,3755,30
32626027401,32626027395,-6,744,2170,30
32630133102,32630133111,9,236,763,30
32634220110,32634220106,-4,429,1826,30
32635966676,32635966670,-6,1114,3598,30
32636375574,32636375569,-5,950,3594,30
32641422798,32641422793,-5,1086,1817,30
32642707777,32642707762,-15,284,1293,30
32646406442,32646406437,-5,535,2008,30
32647792644,32647792639,-5,1224,3058,30
32648863306,32648863302,-4,1057,2415,30
32650108155,32650108153,-2,802,2137,30
32650975296,32650975314,18,431,848,30
32655997515,32655997510,-5,1319,3039,30
32658157208,32658157205,-3,1699,2325,30
32659548849,32659548844,-5,1592,2514,30
32668434673,32668434668,-5,750,2304,30
32673138714,32673138710,-4,885,3497,30
32677138543,32677138537,-6,1200,4535,30
32677477452,32677477446,-6,1339,3172,30
32683858885,32683858898,13,16545,21841,30
32691570282,32691570278,-4,1051,3131,30
32692800880,32692800877,-3,1021,2735,30
32697836794,32697836790,-4,1310,4898,30
32700136475,32700136474,-1,920,1513,30
32701370492,32701370487,-5,1608,3940,30
32702086936,32702086950,14,835,2000,30
32703467629,32703467624,-5,580,2534,30
32710671658,32710671658,0,1521,1275,30
32714483513,32714483508,-5,981,4189,30
32715403022,32715403018,-4,748,3744,30
32716082309,32716082302,-7,1034,2980,30
32716935990,32716935991,1,9469,9182,30
32717625938,32717625933,-5,1153,3401,30
32717811583,32717811583,0,1583,1900,30
32719481116,32719481113,-3,1214,2262,30
32729892972,32729892968,-4,1045,3029,30
32730197651,32730197646,-5,1132,2250,30
32732411522,32732411518,-4,1233,1658,30
32740821748,32740821743,-5,708,1921,30
32742897526,32742897533,7,4356,1562,30
32744198975,32744198970,-5,538,3313,30
32747684672,32747684667,-5,1160,2985,30
32753947588,32753947585,-3,1178,3443,30
32754238537,32754238559,22,1538,3056,30
32754822834,32754822854,20,1446,4242,30
32755158567,32755158563,-4,983,3318,30
32755231495,32755231493,-2,1251,2732,30
32771595803,32771595798,-5,1319,2798,30
32775093171,32775093165,-6,770,3044,30
32775960171,32775960154,-17,220,1326,30
32776882005,32776882000,-5,957,2176,30
32777042587,32777042598,11,608,2361,30
32781257738,32781257732,-6,1106,2670,30
32783735726,32783735721,-5,1540,5002,30
32786528431,32786528426,-5,1033,2458,30
32788406114,32788406110,-4,986,2429,30
32788942934,32788942928,-6,999,3654,30
32800383871,32800383866,-5,1217,3160,30
32802015491,32802015474,-17,128,1078,30
32807647351,32807647349,-2,989,2230,30
32816713318,32816713314,-4,867,2422,30
32817130076,32817130061,-15,155,823,30
32819104962,32819104942,-20,255,920,30
32820739629,32820739623,-6,730,1731,30
32821981245,32821981238,-7,942,7814,30
32828959598,32828959594,-4,1467,3108,30
32829772590,32829772590,0,1199,1777,30
32830787636,32830787630,-6,1683,4352,30
32831229550,32831229545,-5,745,5305,30
32834528180,32834528174,-6,856,2498,30
32843070323,32843070324,1,163,1333,30
32843889327,32843889322,-5,1341,4521,30
32844051019,32844051014,-5,681,2035,30
32844504642,32844504650,8,15847,19798,30
32849138747,32849138746,-1,1312,2064,30
32851296551,32851296546,-5,1314,4562,30
32853031249,32853031244,-5,1069,2954,30
32857299939,32857299934,-5,1197,3216,30
32861589165,32861589159,-6,897,2312,30
32861687539,32861687545,6,413,1849,30
32861999426,32861999437,11,129,940,30
32874906609,32874906607,-2,1038,2920,30
32876572233,32876572220,-13,241,1844,30
32880890010,32880890006,-4,873,2094,30
32881084394,32881084389,-5,776,2879,30
32882163266,32882163262,-4,871,3012,30
32882833590,32882833586,-4,955,2961,30
32883894842,32883894859,17,1099,2647,30
32888063469,32888063462,-7,809,2812,30
32889487182,32889487182,0,1319,2366,30
32901607786,32901607780,-6,1288,3030,30
32904458138,32904458134,-4,952,3745,30
32906217135,32906217129,-6,740,2516,30
32908220581,32908220582,1,1717,1971,30
32911189462,32911189458,-4,698,1976,30
32920409032,32920409027,-5,1161,2472,30
32930525609,32930525607,-2,972,2453,30
32930860385,32930860391,6,1646,584,30
32937074260,32937074254,-6,1083,3487,30
32940463301,32940463297,-4,1381,3433,30
32941176578,32941176573,-5,1011,2199,30
32948400749,32948400749,0,1474,2253,30
32950140894,32950140890,-4,1090,3374,30
32950216018,32950216014,-4,779,1358,30
32950464450,32950464466,16,1427,4651,30
32950781205,32950781201,-4,812,2606,30
32958803010,32958803007,-3,873,2598,30
32959494739,32959494733,-6,1051,2892,30
32963396249,32963396245,-4,875,2369,30
32968439261,32968439255,-6,1538,6297,30
32976960977,32976960972,-5,1060,4462,30
32977606926,32977606933,7,5829,1210,30
32983987979,32983987985,6,2272,1169,30
32985317083,32985317078,-5,693,1889,30
32986610046,32986610043,-3,841,2616,30
32993009233,32993009229,-4,908,3157,30
32993464502,32993464499,-3,966,2886,30
32995046793,32995046815,22,1119,2931,30
32998330240,32998330233,-7,450,1876,30
32999418114,32999418109,-5,1011,2321,30
33002518990,33002518987,-3,984,3487,30
33003804806,33003804801,-5,1339,4416,30
33009704467,33009704458,-9,914,2208,30
33011400018,33011400015,-3,518,2458,30
33015418355,33015418350,-5,1248,2786,30
33019435352,33019435346,-6,1179,2333,30
33024651693,33024651690,-3,1071,3774,30
33029311849,33029311845,-4,1196,2724,30
33034629397,33034629392,-5,1484,3749,30
33038911306,33038911305,-1,1258,2583,30
33040863028,33040863026,-2,1579,2001,30
33045671047,33045671043,-4,876,1961,30
33046876746,33046876743,-3,823,2678,30
33047182578,33047182577,-1,1050,2268,30
33051963647,33051963644,-3,1323,2674,30
33052859029,33052859024,-5,941,2951,30
33057459430,33057459435,5,937,1732,30
33089956800,33089956795,-5,1519,3663,30
33093597529,33093597525,-4,710,2005,30
33094772590,33094772585,-5,1217,2734,30
33098999721,33098999726,5,5831,3001,30
33101234813,33101234806,-7,718,1874,30
33101727345,33101727339,-6,1201,2630,30
33101934707,33101934703,-4,1238,2567,30
33105108235,33105108241,6,2351,1361,30
33107098452,33107098446,-6,1333,3344,30
33110845505,33110845514,9,13826,36051,30
33111596306,33111596302,-4,1133,3256,30
33115371821,33115371815,-6,1230,3211,30
33115816766,33115816759,-7,836,3070,30
33116242833,33116242849,16,915,2501,30
33116559615,33116559611,-4,936,3430,30
33117509575,33117509570,-5,767,1802,30
33119795930,33119795933,3,1716,1204,30
33125151148,33125151145,-3,29445,12106,30
33127874490,33127874486,-4,1163,2902,30
33128525958,33128525963,5,13847,8596,30
33133742679,33133742674,-5,1524,2702,30
33134271186,33134271182,-4,1239,3163,30
33136247621,33136247619,-2,2129,3737,30
33141329400,33141329395,-5,913,3167,30
33141525409,33141525411,2,292,817,30
33145175951,33145175946,-5,797,2479,30
33154404239,33154404236,-3,1590,3736,30
33155240950,33155240947,-3,1346,2609,30
33157022183,33157022181,-2,1110,2098,30
33157870182,33157870173,-9,949,2340,30
33167881823,33167881818,-5,1123,2434,30
33175009915,33175009910,-5,893,2018,30
33187042673,33187042668,-5,1434,4762,30
33192794140,33192794137,-3,1140,2861,30
33198043239,33198043234,-5,1233,2571,30
33198217367,33198217364,-3,698,2487,30
33198761947,33198761950,3,346,1024,30
33199281328,33199281344,16,67,900,30
33206195008,33206195004,-4,1090,2146,30
33206968791,33206968786,-5,931,3469,30
33208579983,33208579981,-2,665,1123,30
33211511335,33211511332,-3,1038,2657,30
33211889498,33211889495,-3,885,2449,30
33220475538,33220475534,-4,898,2626,30
33221077641,33221077635,-6,2214,7686,30
33221963645,33221963640,-5,1199,4034,30
33222860570,33222860564,-6,1313,3306,30
33223491844,33223491861,17,1147,2753,30
33225392097,33225392090,-7,1282,4485,30
33225924298,33225924278,-20,96,607,30
33226293541,33226293546,5,1617,1115,30
33229222279,33229222275,-4,815,2182,30
33230383030,33230383025,-5,1309,3434,30
33234365379,33234365373,-6,1473,4856,30
33236929563,33236929559,-4,1160,3476,30
33240410134,33240410131,-3,411,1173,30
33247385270,33247385273,3,1230,1083,30
33250468700,33250468694,-6,939,3341,30
33253429469,33253429465,-4,797,2430,30
33253473363,33253473367,4,2,491,30
33255630121,33255630116,-5,1130,2567,30
33258460739,33258460738,-1,979,2095,30
33260098937,33260098942,5,10933,5011,30
33265049267,33265049263,-4,945,3209,30
33267571843,33267571838,-5,925,3604,30
33267878489,33267878485,-4,1142,4021,30
33270183329,33270183323,-6,857,2724,30
33272557898,33272557894,-4,620,1179,30
33291143294,33291143301,7,4244,1257,30
33294676857,33294676854,-3,1336,2345,30
33296531120,33296531134,14,117,934,30
33296761479,33296761473,-6,735,1541,30
33298664977,33298664971,-6,1206,4580,30
33300903917,33300903912,-5,1087,2901,30
33304896243,33304896237,-6,970,2613,30
33306360153,33306360148,-5,899,2636,30
33313122930,33313122926,-4,785,2840,30
33314276438,33314276435,-3,1087,2804,30
33315120150,33315120146,-4,980,2344,30
33316355671,33316355665,-6,871,2795,30
33316961342,33316961338,-4,1405,3416,30
33322994618,33322994625,7,2219,1319,30
33326698895,33326698892,-3,879,2471,30
33330504754,33330504749,-5,1234,2495,30
33330587100,33330587117,17,1517,3731,30
33334567087,33334567082,-5,1803,6233,30
33339534863,33339534867,4,2144,1182,30
33353782598,33353782595,-3,1096,2773,30
33357466203,33357466200,-3,1429,3487,30
33361122987,33361122985,-2,1450,1984,30
33361796638,33361796633,-5,949,2506,30
33366021868,33366021863,-5,978,3161,30
33366572954,33366572949,-5,941,2736,30
33366657422,33366657422,0,1344,2329,30
33369647920,33369647913,-7,819,1523,30
33370209161,33370209181,20,1067,2997,30
33370391615,33370391609,-6,1315,3006,30
33374032262,33374032262,0,2015,2456,30
33381195562,33381195559,-3,866,2048,30
33384391494,33384391491,-3,1006,2383,30
33387853082,33387853087,5,1725,1183,30
33392251503,33392251500,-3,1257,2648,30
33393599130,33393599125,-5,1151,3451,30
33396667330,33396667326,-4,1230,2075,30
33398532276,33398532273,-3,1132,3378,30
33401402663,33401402660,-3,1528,2899,30
33401845714,33401845710,-4,1102,2455,30
33402873175,33402873170,-5,1035,3995,30
33410384536,33410384530,-6,674,3407,30
33410963168,33410963163,-5,1150,2459,30
33413431519,33413431513,-6,1111,3626,30
33416184854,33416184854,0,933,1463,30
33418761102,33418761097,-5,1121,2875,30
33420595009,33420595006,-3,973,2072,30
33422757307,33422757302,-5,1092,2375,30
33423244577,33423244598,21,705,1942,30
33425920586,33425920582,-4,867,2795,30
33427840891,33427840888,-3,715,1539,30
33437616945,33437616939,-6,970,3664,30
33438262954,33438262941,-13,1051,2883,30
33443309231,33443309225,-6,1122,2752,30
33444148241,33444148228,-13,1013,2366,30
33446043566,33446043563,-3,555,1751,30
33455412050,33455412044,-6,1029,2075,30
33456033576,33456033595,19,459,938,30
33460642300,33460642297,-3,893,2508,30
33461683372,33461683368,-4,753,1948,30
33465631695,33465631690,-5,1356,3121,30
33470196718,33470196721,3,8,727,30
33471235487,33471235482,-5,910,2666,30
33471389584,33471389576,-8,64,1545,30
33471966232,33471966243,11,57,706,30
33476218739,33476218738,-1,20179,8885,30
33485531639,33485531634,-5,810,2430,30
33490858495,33490858491,-4,639,2446,30
33491069239,33491069231,-8,1359,4610,30
33498209799,33498209795,-4,902,1920,30
33498309032,33498309053,21,395,998,30
33503822998,33503822991,-7,1051,3692,30
33504301001,33504300991,-10,569,1124,30
33507844085,33507844081,-4,1096,2057,30
33510259825,33510259825,0,4873,7100,30
33510773870,33510773867,-3,787,1071,30
33511524041,33511524038,-3,1227,3577,30
33512846687,33512846681,-6,780,1609,30
33523739297,33523739293,-4,1076,2941,30
33524344026,33524344041,15,843,2401,30
33525262006,33525262002,-4,802,2471,30
33525462626,33525462627,1,1731,1573,30
33526050731,33526050726,-5,575,2115,30
33527371155,33527371150,-5,792,3372,30
33530454449,33530454445,-4,1059,2666,30
33531809945,33531809925,-20,1043,2208,30
33532372786,33532372787,1,733,1015,30
33532494298,33532494309,11,302,1124,30
33532923762,33532923758,-4,1407,4186,30
33533484185,33533484166,-19,290,779,30
33535928327,33535928323,-4,1004,3262,30
33536489699,33536489701,2,1439,1562,30
33539341196,33539341190,-6,1110,2392,30
33542304240,33542304237,-3,1289,2304,30
33542983568,33542983563,-5,1209,3041,30
33546528456,33546528453,-3,927,2222,30
33546595586,33546595601,15,338,939,30
33551082385,33551082381,-4,1123,3237,30
33561875159,33561875154,-5,1051,3369,30
33566797486,33566797482,-4,1060,2843,30
33569736662,33569736673,11,208,711,30
33573310140,33573310134,-6,789,3318,30
33575266215,33575266212,-3,1163,1426,30
33576756863,33576756858,-5,1017,2955,30
33576793994,33576793999,5,2094,1620,30
33579350180,33579350177,-3,1039,2316,30
33580341613,33580341606,-7,1174,2901,30
33581383475,33581383494,19,180,1295,30
33584283674,33584283669,-5,946,3645,30
33586386759,33586386754,-5,624,2335,30
33587710332,33587710328,-4,747,1969,30
33590659084,33590659080,-4,733,2168,30
33593889965,33593889958,-7,1150,2916,30
33593946659,33593946654,-5,1049,2930,30
33597815534,33597815529,-5,1198,3065,30
33597954272,33597954295,23,1541,3414,30
33599805690,33599805687,-3,805,2669,30
33608399540,33608399545,5,1695,1207,30
33612874739,33612874732,-7,1128,5154,30
33618938211,33618938208,-3,889,1490,30
33619208474,33619208470,-4,877,2615,30
33619917937,33619917957,20,1069,2336,30
33620454804,33620454800,-4,1157,2450,30
33620494474,33620494471,-3,703,1008,30
33621974134,33621974131,-3,1300,2583,30
33631933970,33631933967,-3,1994,4034,30
33632127640,33632127634,-6,800,2312,30
33632743728,33632743734,6,1735,882,30
33634532642,33634532637,-5,758,1873,30
33634579514,33634579535,21,617,1545,30
33636360695,33636360691,-4,961,2861,30
33638962879,33638962874,-5,798,2256,30
33640291389,33640291390,1,115,1003,30
33640858235,33640858231,-4,1221,3253,30
33641261273,33641261268,-5,808,3015,30
33647906644,33647906638,-6,1058,2328,30
33649240396,33649240407,11,67,870,30
33650728221,33650728216,-5,903,2408,30
33651641728,33651641711,-17,1128,2652,30
33655379354,33655379350,-4,858,1960,30
33657013918,33657013916,-2,1236,2676,30
33657654400,33657654391,-9,305,952,30
33658110090,33658110081,-9,754,4054,30
33660703651,33660703647,-4,692,2175,30
33661800759,33661800754,-5,1216,2793,30
33663934827,33663934825,-2,1099,2560,30
33670580977,33670580969,-8,1440,7172,30
33674022146,33674022141,-5,1011,2183,30
33674762953,33674762970,17,316,1073,30
33677325650,33677325649,-1,1916,2901,30
33684021829,33684021824,-5,933,3191,30
33693055426,33693055422,-4,1059,3753,30
33693301003,33693301001,-2,1126,2506,30
33695538798,33695538794,-4,801,1520,30
33695665874,33695665854,-20,190,625,30
33698792134,33698792130,-4,752,2357,30
33702262131,33702262145,14,685,2098,30
33703226238,33703226233,-5,809,1910,30
33703401697,33703401695,-2,88,880,30
33705437211,33705437205,-6,995,2856,30
33711006317,33711006313,-4,1201,2176,30
33711785357,33711785353,-4,1486,4193,30
33712732458,33712732453,-5,2145,6254,30
33717923783,33717923780,-3,1191,2957,30
33719532106,33719532101,-5,912,2541,30
33722441603,33722441599,-4,1338,2236,30
33730400835,33730400832,-3,1106,2816,30
33733844226,33733844225,-1,969,1530,30
33734630715,33734630710,-5,836,2697,30
33737898307,33737898301,-6,813,1996,30
33738762978,33738762974,-4,969,3013,30
33738871434,33738871429,-5,195,1183,30
33740073260,33740073255,-5,1326,3888,30
33740279731,33740279721,-10,1447,2956,30
33743400997,33743400999,2,1459,1190,30
33750017075,33750017073,-2,909,2067,30
33754716484,33754716478,-6,1835,3412,30
33760012564,33760012559,-5,1436,3893,30
33762137242,33762137248,6,4380,1913,30
33763251091,33763251094,3,3238,2309,30
33766820125,33766820121,-4,1289,3416,30
33772716571,33772716565,-6,1107,4451,30
33773440240,33773440221,-19,1170,2826,30
33777280393,33777280390,-3,462,1711,30
33778243396,33778243394,-2,31568,15068,30
33778686621,33778686617,-4,975,1910,30
33780338197,33780338193,-4,1377,2914,30
33782651435,33782651430,-5,1414,3771,30
33782849107,33782849104,-3,1077,2681,30
33784513595,33784513592,-3,1403,2970,30
33784905834,33784905830,-4,1425,3990,30
33785048768,33785048765,-3,798,2939,30
33785465442,33785465441,-1,1015,1856,30
33788915400,33788915396,-4,732,3038,30
33798467522,33798467518,-4,1196,2992,30
33806021588,33806021582,-6,31539,14997,30
33815702889,33815702882,-7,1021,3255,30
33817659884,33817659877,-7,1688,8988,30
33827173296,33827173291,-5,877,2790,30
33829239919,33829239916,-3,907,3222,30
33829436239,33829436236,-3,998,2020,30
33831870894,33831870897,3,1733,2603,30
33833250530,33833250526,-4,1024,2560,30
33835017090,33835017086,-4,1024,2763,30
33841688534,33841688529,-5,963,2943,30
33844093114,33844093110,-4,1052,2852,30
33845718201,33845718195,-6,928,3540,30
33847137227,33847137215,-12,1203,609,30
33851141592,33851141586,-6,143,1087,30
33855229170,33855229168,-2,741,2516,30
33857962102,33857962099,-3,621,2913,30
33866197276,33866197270,-6,747,1905,30
33866303857,33866303876,19,1386,4129,30
33867744383,33867744383,0,954,1090,30
33869744139,33869744135,-4,1037,2788,30
33870024434,33870024451,17,1138,5118,30
33871439641,33871439637,-4,921,1431,30
33873232131,33873232150,19,1292,3229,30
33873899050,33873899045,-5,1010,3321,30
33880449193,33880449190,-3,1125,1975,30
33883986153,33883986147,-6,1259,3237,30
33891119181,33891119187,6,2981,1454,30
33896562203,33896562198,-5,1014,1908,30
33897415342,33897415342,0,732,1028,30
33903166497,33903166493,-4,882,3021,30
33911951498,33911951499,1,878,1708,30
33917948362,33917948358,-4,986,2187,30
33919652132,33919652128,-4,860,2944,30
33926080711,33926080707,-4,575,1348,30
33927266013,33927266010,-3,1340,3297,30
33935942810,33935942809,-1,692,1693,30
33936500646,33936500641,-5,1048,3139,30
33943393878,33943393878,0,1325,2054,30
33948079276,33948079273,-3,910,2067,30
33949488851,33949488846,-5,849,2970,30
33950713687,33950713681,-6,1129,3481,30
33962722950,33962722946,-4,666,1035,30
33964066926,33964066915,-11,129,769,30
33965990383,33965990379,-4,819,1840,30
33968420797,33968420803,6,2453,1477,30
33972969718,33972969714,-4,736,1995,30
33982278982,33982278978,-4,1242,3937,30
33983880156,33983880152,-4,171,899,30
33988516978,33988516976,-2,778,1673,30
33994077187,33994077186,-1,957,1914,30
33997476613,33997476608,-5,391,1396,30
33997601051,33997601041,-10,164,1791,30
33998257475,33998257470,-5,726,2763,30
33999379474,33999379473,-1,628,950,30
34000119261,34000119261,0,4874,5864,30
34000373602,34000373598,-4,1151,2972,30
34006463810,34006463806,-4,865,2557,30
34012758634,34012758630,-4,1038,2263,30
34015792519,34015792525,6,2353,1252,30
34016517503,34016517497,-6,908,3575,30
34017439957,34017439956,-1,1171,965,30
34029361960,34029361957,-3,1302,2525,30
34033085874,34033085870,-4,934,2469,30
34034396827,34034396823,-4,870,2585,30
34035190812,34035190806,-6,1050,2736,30
34039142018,34039142013,-5,1457,4140,30
34039842599,34039842595,-4,970,2423,30
34045012655,34045012650,-5,1366,2815,30
34045228367,34045228363,-4,910,1925,30
34048307282,34048307278,-4,834,2638,30
34049992812,34049992806,-6,1061,3469,30
34050921442,34050921439,-3,1129,3311,30
34051524791,34051524790,-1,814,1325,30
34052991399,34052991396,-3,913,2792,30
34057338978,34057338973,-5,838,2483,30
34058892262,34058892254,-8,1277,3647,30
34062139495,34062139488,-7,914,3570,30
34062237722,34062237728,6,48,449,30
34066482002,34066482013,11,296,692,30
34068047169,34068047167,-2,1028,2096,30
34073375853,34073375850,-3,1062,2621,30
34077073117,34077073113,-4,1161,3720,30
34077487106,34077487098,-8,1406,4896,30
34077919375,34077919369,-6,1068,3908,30
34084239826,34084239821,-5,1123,2917,30
34084616731,34084616725,-6,836,2204,30
34092447261,34092447254,-7,1402,2826,30
34092595398,34092595394,-4,1402,4003,30
34096884859,34096884867,8,6332,2886,30
34097595021,34097595014,-7,915,2684,30
34105439017,34105439014,-3,1360,2601,30
34105522225,34105522246,21,640,2824,30
34105611367,34105611368,1,1009,1231,30
34108293645,34108293643,-2,1450,3690,30
34112674178,34112674173,-5,956,2314,30
34115426395,34115426389,-6,940,2380,30
34122659799,34122659795,-4,1395,3445,30
34123326441,34123326459,18,590,2255,30
34130815398,34130815397,-1,1259,2939,30
34131742419,34131742413,-6,1345,3159,30
34132644086,34132644081,-5,772,1811,30
34133018265,34133018277,12,502,1017,30
34136973411,34136973407,-4,981,2744,30
34137724219,34137724215,-4,1225,2713,30
34138203829,34138203823,-6,548,2726,30
34150881773,34150881768,-5,1415,3864,30
34151357315,34151357309,-6,1151,3360,30
34155730839,34155730834,-5,1108,2681,30
34156385435,34156385451,16,325,1355,30
34157714091,34157714086,-5,1719,5896,30
34163163495,34163163492,-3,1027,2850,30
34164105855,34164105851,-4,1175,2520,30
34168010033,34168010028,-5,1156,2703,30
34168126258,34168126254,-4,1411,3179,30
34169926518,34169926513,-5,974,2613,30
34173681026,34173681022,-4,937,1640,30
34173848295,34173848293,-2,907,2236,30
34175934518,34175934514,-4,1093,2977,30
34185293089,34185293085,-4,1252,3707,30
34186730332,34186730327,-5,1144,3384,30
34188963178,34188963173,-5,1469,3098,30
34189560678,34189560673,-5,1166,3950,30
34191861628,34191861624,-4,1738,3903,30
34192963002,34192962998,-4,1009,3523,30
34199587066,34199587060,-6,1168,2974,30
34202429316,34202429309,-7,999,3204,30
34207136364,34207136380,16,1748,606,30
34212924036,34212924030,-6,996,2625,30
34212960633,34212960625,-8,1091,2930,30
34215103310,34215103304,-6,1055,3011,30
34216938669,34216938674,5,928,1165,30
34222175150,34222175144,-6,856,4174,30
34223808755,34223808751,-4,1238,2607,30
34224451896,34224451889,-7,690,3488,30
34236694018,34236694013,-5,1146,3592,30
34238227233,34238227230,-3,931,2461,30
34239591599,34239591607,8,4832,1217,30
34240183922,34240183917,-5,986,2849,30
34240404593,34240404595,2,983,858,30
34241977411,34241977429,18,991,1985,30
34245405616,34245405611,-5,1057,2753,30
34249197282,34249197278,-4,1275,3251,30
34250877099,34250877094,-5,990,2030,30
34250929056,34250929078,22,1219,2258,30
34251772911,34251772907,-4,797,2186,30
34252977873,34252977866,-7,221,1254,30
34260005388,34260005384,-4,1287,2873,30
34262379129,34262379123,-6,1020,2517,30
34268969132,34268969135,3,2253,1807,30
34274045575,34274045574,-1,1302,2399,30
34275069136,34275069133,-3,1513,2788,30
34276380089,34276380085,-4,169,815,30
34277274282,34277274278,-4,893,3324,30
34282317399,34282317394,-5,1318,3346,30
34282517242,34282517262,20,526,1471,30
34294533843,34294533837,-6,766,1738,30
34296342239,34296342246,7,5088,1728,30
34302365088,34302365084,-4,820,1801,30
34306459011,34306459008,-3,1029,1973,30
34306915899,34306915916,17,639,1144,30
34317782987,34317782984,-3,1296,2956,30
34322321999,34322321996,-3,697,1755,30
34323469843,34323469854,11,485,1188,30
34324799022,34324799019,-3,1070,2254,30
34330794054,34330794050,-4,985,2638,30
34331113379,34331113374,-5,1252,3106,30
34332230783,34332230780,-3,1033,2271,30
34332964934,34332964937,3,1550,2007,30
34334349790,34334349785,-5,1775,5581,30
34335637967,34335637963,-4,1152,3219,30
34337478875,34337478872,-3,998,3077,30
34340589207,34340589202,-5,1039,3621,30
34346647858,34346647854,-4,1147,3567,30
34349543282,34349543277,-5,1294,3373,30
34353525986,34353525982,-4,1364,3182,30
34358753918,34358753915,-3,1111,1572,30
34360507751,34360507749,-2,2359,5091,30
34363276246,34363276242,-4,892,2006,30
34366615341,34366615336,-5,1014,3289,30
34369410886,34369410881,-5,1164,2307,30
34370052467,34370052465,-2,868,2430,30
34374025764,34374025760,-4,1383,3310,30
34380127640,34380127639,-1,38499,20606,30
34383820062,34383820057,-5,828,2563,30
34386027118,34386027111,-7,718,3550,30
34390446541,34390446537,-4,1121,3110,30
34391487259,34391487253,-6,1024,4362,30
34394547361,34394547358,-3,954,2868,30
34396247463,34396247458,-5,804,2820,30
34401819406,34401819402,-4,1571,2440,30
34405193226,34405193222,-4,1505,3574,30
34412959078,34412959074,-4,1064,1656,30
34422655206,34422655203,-3,1265,2978,30
34427520304,34427520298,-6,1465,2958,30
34427742332,34427742351,19,1037,2867,30
34428150599,34428150595,-4,1022,3012,30
34439619002,34439619006,4,20855,22324,30
34439906965,34439906967,2,3666,1909,30
34440712367,34440712362,-5,1148,3269,30
34443744452,34443744450,-2,1439,1884,30
34452578603,34452578598,-5,1327,2317,30
34458722551,34458722547,-4,1144,3173,30
34463861594,34463861598,4,1642,1326,30
34469740896,34469740893,-3,956,1706,30
34472463509,34472463505,-4,1196,2801,30
34473291550,34473291557,7,2830,1274,30
34482913452,34482913450,-2,609,2113,30
34485440942,34485440942,0,2866,4300,30
34485958390,34485958386,-4,827,2700,30
34486585626,34486585635,9,817,13554,30
34492439422,34492439416,-6,981,2493,30
34492635186,34492635186,0,952,1330,30
34494580458,34494580453,-5,1065,3199,30
34494796289,34494796282,-7,1226,2987,30
34499184889,34499184886,-3,1381,2950,30
34504106091,34504106092,1,784,1264,30
34505993511,34505993505,-6,1153,3266,30
34506216162,34506216156,-6,682,2293,30
34506591546,34506591542,-4,275,991,30
34507684110,34507684113,3,2065,1583,30
34513795278,34513795257,-21,271,726,30
34519478982,34519478978,-4,1339,3081,30
34523673101,34523673097,-4,1099,3846,30
34523965584,34523965595,11,273,1109,30
34528242526,34528242521,-5,661,2344,30
34531228031,34531228026,-5,1317,4489,30
34531904431,34531904426,-5,803,2081,30
34535434471,34535434469,-2,820,2320,30
34541676505,34541676499,-6,1020,3645,30
34543181835,34543181830,-5,1059,2730,30
34549834722,34549834717,-5,901,3444,30
34551611271,34551611272,1,1428,1622,30
34553195962,34553195957,-5,1045,3492,30
34555420250,34555420245,-5,752,1918,30
34557245087,34557245085,-2,1405,1788,30
34564216231,34564216227,-4,1608,4214,30
34564545499,34564545496,-3,1280,3340,30
34566288490,34566288488,-2,1128,2200,30
34576013897,34576013892,-5,910,3423,30
34576381785,34576381789,4,35930,21065,30
34578287452,34578287446,-6,942,3321,30
34579614393,34579614389,-4,1409,3049,30
34586334929,34586334922,-7,1096,1615,30
34594317499,34594317494,-5,959,3512,30
34598625794,34598625791,-3,1289,2274,30
34599472773,34599472769,-4,884,2752,30
34599991545,34599991561,16,836,2157,30
34607981867,34607981861,-6,896,2866,30
34618236939,34618236933,-6,1076,3139,30
34618783365,34618783361,-4,1340,3370,30
34625238666,34625238662,-4,957,2683,30
34625697850,34625697847,-3,706,2750,30
34633971121,34633971119,-2,1061,2499,30
34635122463,34635122458,-5,1422,3450,30
34635890597,34635890605,8,3275,1519,30
34642163759,34642163753,-6,1281,2926,30
34644096839,34644096834,-5,963,2809,30
34644253097,34644253115,18,1400,2795,30
34654559343,34654559337,-6,995,2459,30
34657379794,34657379790,-4,1637,3516,30
34660305537,34660305533,-4,1167,2889,30
34662339369,34662339365,-4,893,3247,30
34667778413,34667778408,-5,908,2242,30
34676449767,34676449762,-5,1081,2681,30
34676899847,34676899842,-5,791,3126,30
34685296109,34685296111,2,1680,1823,30
34685463491,34685463491,0,1332,1537,30
34686530167,34686530162,-5,1418,3109,30
34687657003,34687656998,-5,1065,4103,30
34688483732,34688483750,18,242,1221,30
34689650202,34689650200,-2,789,2516,30
34690093337,34690093333,-4,1100,2362,30
34697140175,34697140171,-4,1199,2462,30
34703896821,34703896817,-4,1015,2191,30
34703951242,34703951236,-6,1133,3741,30
34704880028,34704880025,-3,1249,2142,30
34704974803,34704974807,4,201,1021,30
34707763563,34707763566,3,1658,1616,30
34711955003,34711954996,-7,663,4990,30
34713495694,34713495691,-3,851,2572,30
34717451931,34717451930,-1,1313,1551,30
34728606764,34728606761,-3,1234,3332,30
34729717123,34729717103,-20,1065,3485,30
34733816338,34733816334,-4,1396,3196,30
34741799450,34741799445,-5,780,3046,30
34744444085,34744444087,2,1566,1330,30
34749306593,34749306588,-5,1119,2825,30
34749781161,34749781158,-3,1511,3673,30
34751202810,34751202808,-2,954,2865,30
34751400483,34751400478,-5,847,3446,30
34752760028,34752760026,-2,768,2283,30
34760203021,34760203013,-8,898,3276,30
34761849035,34761849029,-6,1257,4400,30
34765497090,34765497073,-17,627,1693,30
34765885144,34765885166,22,444,2529,30
34771494221,34771494217,-4,1009,1971,30
34772469169,34772469190,21,382,767,30
34772907422,34772907420,-2,755,2916,30
34772968609,34772968602,-7,1172,4701,30
34773934518,34773934514,-4,986,2787,30
34778878024,34778878019,-5,1279,3538,30
34782173668,34782173665,-3,1257,2769,30
34783038633,34783038629,-4,816,2080,30
34784714616,34784714611,-5,748,3232,30
34786285186,34786285181,-5,946,2443,30
34791423806,34791423802,-4,1071,2853,30
34794425584,34794425578,-6,1086,3040,30
34797570150,34797570148,-2,900,2104,30
34806146220,34806146215,-5,952,3951,30
34812992694,34812992687,-7,1100,2574,30
34814811263,34814811257,-6,1025,3347,30
34817903919,34817903914,-5,1119,3032,30
34819478657,34819478654,-3,1055,2683,30
34832794357,34832794357,0,3057,3603,30
34839074368,34839074364,-4,1003,3658,30
34839240551,34839240546,-5,1526,3625,30
34840246505,34840246525,20,479,1061,30
34840360098,34840360094,-4,815,1818,30
34844036103,34844036098,-5,737,2125,30
34844805694,34844805690,-4,1138,2486,30
34849262431,34849262428,-3,1108,1178,30
34851394383,34851394375,-8,1205,3807,30
34853459398,34853459403,5,1829,878,30
34854377004,34854376999,-5,990,2324,30
34856603651,34856603641,-10,969,2792,30
34856701786,34856701806,20,360,1197,30
34856875459,34856875457,-2,900,2646,30
34857059670,34857059665,-5,1039,3090,30
34857789182,34857789178,-4,802,2231,30
34858543809,34858543829,20,1037,2290,30
34859627290,34859627283,-7,1215,3885,30
34860160280,34860160279,-1,1025,1718,30
34863658051,34863658060,9,2215,1167,30
34863856261,34863856257,-4,1186,2465,30
34864860850,34864860842,-8,1500,5482,30
34864924521,34864924501,-20,996,2020,30
34867609308,34867609305,-3,1512,2792,30
34868136585,34868136578,-7,2811,9747,30
34869134166,34869134162,-4,1368,3356,30
34871517394,34871517390,-4,802,2495,30
34872073074,34872073071,-3,664,1611,30
34873744558,34873744555,-3,2136,4423,30
34874060158,34874060162,4,1480,1242,30
34875234723,34875234719,-4,1147,4025,30
34883938764,34883938759,-5,705,1570,30
34883983329,34883983325,-4,910,3221,30
34884543656,34884543654,-2,187,1130,30
34885788957,34885788963,6,1803,701,30
34887501030,34887501026,-4,762,2611,30
34891027766,34891027762,-4,981,2813,30
34892706999,34892706993,-6,810,2500,30
34893242122,34893242126,4,199,914,30
34894142641,34894142638,-3,1094,1925,30
34899808936,34899808930,-6,913,2278,30
34900217533,34900217527,-6,1218,3412,30
34903144991,34903144988,-3,1012,1470,30
34905704207,34905704202,-5,813,2346,30
34908286859,34908286858,-1,1157,1678,30
34911274053,34911274048,-5,936,2663,30
34916764287,34916764283,-4,1003,1980,30
34917339054,34917339048,-6,660,7044,30
34917789168,34917789154,-14,861,1859,30
34917971787,34917971765,-22,296,1020,30
34918586264,34918586261,-3,1272,2399,30
34921088112,34921088107,-5,1016,4536,30
34923563776,34923563772,-4,1443,2075,30
34924212194,34924212189,-5,843,3256,30
34927013262,34927013258,-4,1067,2468,30
34928541506,34928541490,-16,335,1252,30
34931860387,34931860385,-2,1129,2269,30
34933309931,34933309927,-4,1068,3316,30
34933521490,34933521490,0,1112,1455,30
34933762904,34933762886,-18,372,976,30
34935867358,34935867354,-4,816,2998,30
34938190609,34938190602,-7,950,2431,30
34940167641,34940167654,13,1167,1295,30
34940587055,34940587051,-4,1039,2281,30
34942758832,34942758826,-6,935,3729,30
34943517403,34943517403,0,127,810,30
34946237471,34946237470,-1,1155,1975,30
34946339462,34946339465,3,2325,1599,30
34947876365,34947876358,-7,1059,3913,30
34949711403,34949711398,-5,1166,2945,30
34951769692,34951769687,-5,918,2973,30
34952081664,34952081648,-16,829,2570,30
34952803095,34952803089,-6,2603,6695,30
34958011396,34958011390,-6,1040,3145,30
34958601080,34958601077,-3,778,1957,30
34964592537,34964592533,-4,1394,4152,30
34965650056,34965650050,-6,867,2713,30
34969873482,34969873478,-4,1106,3641,30
34974884587,34974884582,-5,799,2299,30
34981067729,34981067726,-3,690,2787,30
34982024793,34982024795,2,1410,1250,30
34984759638,34984759633,-5,855,2270,30
34995671665,34995671661,-4,2209,5821,30
34998730961,34998730967,6,4270,1586,30
35009943578,35009943574,-4,941,3081,30
35014477643,35014477637,-6,860,3204,30
35016170295,35016170290,-5,641,1741,30
35018403806,35018403800,-6,1047,2751,30
35018587281,35018587298,17,818,3092,30
35019742635,35019742631,-4,3265,7414,30
35022272373,35022272369,-4,1129,2079,30
35023872957,35023872959,2,1412,1278,30
35040998575,35040998570,-5,1199,2670,30
35044293675,35044293666,-9,804,3572,30
35047880330,35047880328,-2,638,2258,30
35056676331,35056676348,17,154,983,30
35060568470,35060568465,-5,1200,3706,30
35061762590,35061762595,5,2127,1287,30
35074524874,35074524870,-4,1068,4620,30
35075625884,35075625881,-3,735,1721,30
35075773795,35075773781,-14,65,744,30
35076308270,35076308265,-5,1303,3669,30
35084735794,35084735789,-5,1646,3528,30
35086226700,35086226717,17,1186,2527,30
35089921049,35089921042,-7,762,4050,30
35091368340,35091368342,2,2063,2112,30
35092120279,35092120275,-4,1075,2121,30
35094849760,35094849757,-3,951,4044,30
35095046010,35095046027,17,993,2333,30
35097441338,35097441332,-6,662,2935,30
35097684897,35097684893,-4,1792,4491,30
35100919378,35100919374,-4,1192,2253,30
35103571922,35103571918,-4,1115,2247,30
35103621867,35103621845,-22,47,661,30
35107016295,35107016292,-3,925,2861,30
35108648247,35108648241,-6,1040,3434,30
35113970496,35113970492,-4,1059,3008,30
35114865302,35114865298,-4,943,2847,30
35115474927,35115474922,-5,1265,2370,30
35115834529,35115834526,-3,657,1946,30
35116008849,35116008842,-7,860,2877,30
35116964871,35116964852,-19,2377,1711,30
35121208376,35121208374,-2,1697,3318,30
35124258606,35124258612,6,1976,1055,30
35125547722,35125547718,-4,978,2081,30
35148451862,35148451858,-4,1370,3898,30
35149626332,35149626319,-13,893,3531,30
35149993314,35149993330,16,876,2113,30
35151111487,35151111482,-5,1675,3503,30
35151723822,35151723817,-5,1360,2717,30
35158014945,35158014947,2,1650,2022,30
35158547456,35158547451,-5,1523,2546,30
35158649146,35158649139,-7,269,731,30
35160953706,35160953699,-7,948,2183,30
35161869386,35161869381,-5,1388,3175,30
35164160879,35164160876,-3,1028,2455,30
35166091229,35166091222,-7,1212,3416,30
35170260623,35170260623,0,1340,963,30
35171222751,35171222750,-1,1177,2081,30
35171814264,35171814261,-3,722,2280,30
35173872734,35173872729,-5,961,3563,30
35179432065,35179432062,-3,657,1519,30
35179692065,35179692058,-7,1178,3758,30
35180037457,35180037462,5,4373,1729,30
35186704434,35186704433,-1,1303,1937,30
35194647283,35194647278,-5,1062,2855,30
35197720626,35197720621,-5,1163,3245,30
35197906315,35197906312,-3,881,1643,30
35199273326,35199273322,-4,905,3028,30
35199850065,35199850081,16,932,2649,30
35202625222,35202625219,-3,808,1836,30
35210234436,35210234432,-4,1086,2592,30
35216404783,35216404777,-6,1512,3359,30
35216909006,35216909019,13,249,1415,30
35217662518,35217662515,-3,954,1700,30
35221562514,35221562510,-4,811,2563,30
35222277917,35222277911,-6,781,3021,30
35225449898,35225449897,-1,1163,1759,30
35226708145,35226708165,20,401,1239,30
35227014967,35227014962,-5,906,2243,30
35227511787,35227511789,2,184,1375,30
35229475954,35229475945,-9,1321,8599,30
35230939820,35230939814,-6,851,3145,30
35232513578,35232513574,-4,1108,2724,30
35233751193,35233751189,-4,862,2358,30
35240260583,35240260578,-5,645,2362,30
35240576227,35240576229,2,1323,1239,30
35244700794,35244700794,0,4583,5213,30
35247616658,35247616656,-2,856,1625,30
35249754633,35249754613,-20,606,1538,30
35250222739,35250222735,-4,941,2695,30
35251844974,35251844968,-6,1017,2594,30
35252314826,35252314823,-3,705,2465,30
35260466455,35260466448,-7,22283,12678,30
35269391554,35269391557,3,2303,1720,30
35271198500,35271198496,-4,1198,2273,30
35273745310,35273745305,-5,1088,3010,30
35276031144,35276031140,-4,1074,3253,30
35279732930,35279732925,-5,1202,3669,30
35285166003,35285166001,-2,1231,2781,30
35285643302,35285643297,-5,1157,2666,30
35289847886,35289847881,-5,945,3232,30
35293495251,35293495244,-7,916,4922,30
35295090217,35295090234,17,648,2235,30
35304446544,35304446548,4,2382,1941,30
35305878149,35305878146,-3,857,2776,30
35306426956,35306426973,17,1196,3608,30
35308231018,35308231014,-4,1073,2811,30
35313215769,35313215772,3,1363,1641,30
35313830018,35313830016,-2,1225,2805,30
35316608740,35316608737,-3,1032,1952,30
35316924315,35316924329,14,935,3280,30
35323058933,35323058928,-5,1056,2598,30
35323257386,35323257382,-4,872,2444,30
35324168825,35324168821,-4,868,2807,30
35324543584,35324543594,10,176,950,30
35325409745,35325409739,-6,708,2761,30
35329179522,35329179518,-4,689,2267,30
35330502862,35330502857,-5,1347,3188,30
35331410909,35331410904,-5,1368,6826,30
35332503366,35332503370,4,12833,19324,30
35335147991,35335147986,-5,974,2819,30
35340565291,35340565288,-3,661,2725,30
35343011434,35343011429,-5,1266,2314,30
35345412951,35345412946,-5,1176,2265,30
35345844298,35345844296,-2,2239,3287,30
35352946365,35352946370,5,1660,1435,30
35364648315,35364648309,-6,870,1659,30
35385625195,35385625190,-5,920,2732,30
35386048017,35386048018,1,34021,42177,30
35391908981,35391908976,-5,806,3145,30
35394200430,35394200428,-2,1142,2630,30
35395095054,35395095048,-6,994,2646,30
35395269315,35395269307,-8,231,1048,30
35397303822,35397303825,3,6034,23850,30
35397877486,35397877483,-3,1116,3527,30
35398277248,35398277266,18,837,1989,30
35399213082,35399213077,-5,927,2073,30
35401512870,35401512866,-4,633,2045,30
35404689443,35404689435,-8,992,3916,30
35419525043,35419525035,-8,1059,3578,30
35420820302,35420820283,-19,337,1336,30
35421140146,35421140160,14,55,601,30
35422887566,35422887571,5,2806,1617,30
35428379022,35428379017,-5,959,3121,30
35430622018,35430622037,19,425,1622,30
35431069497,35431069493,-4,529,1387,30
35431440658,35431440636,-22,44,2977,30
35434089459,35434089455,-4,813,2469,30
35435791898,35435791894,-4,929,3394,30
35438475262,35438475257,-5,954,1796,30
35438619953,35438619938,-15,193,1046,30
35439929342,35439929337,-5,755,2714,30
35441640891,35441640889,-2,1718,3145,30
35442736817,35442736813,-4,1583,3858,30
35449077061,35449077078,17,305,1348,30
35462605701,35462605719,18,168,1163,30
35465429934,35465429930,-4,811,3671,30
35466696839,35466696834,-5,1062,3494,30
35468148418,35468148414,-4,993,2730,30
35468938043,35468938031,-12,130,905,30
35469782396,35469782390,-6,1318,3160,30
35470189892,35470189909,17,843,1898,30
35472021879,35472021873,-6,827,3023,30
35472331978,35472331974,-4,999,2697,30
35482077916,35482077911,-5,963,4343,30
35483270408,35483270402,-6,1380,2936,30
35483598274,35483598271,-3,813,2501,30
35488806523,35488806518,-5,1313,2826,30
35497238499,35497238494,-5,1340,3397,30
35498428797,35498428793,-4,1138,3434,30
35499609918,35499609913,-5,774,2519,30
35500416962,35500416980,18,705,3117,30
35501267089,35501267086,-3,911,2046,30
35502966995,35502966990,-5,1117,3084,30
35506884571,35506884562,-9,179,825,30
35508006451,35508006446,-5,798,1902,30
35515150125,35515150120,-5,1214,3975,30
35516650062,35516650055,-7,716,2590,30
35522806154,35522806150,-4,1079,2250,30
35524421367,35524421362,-5,792,2274,30
35525144984,35525144978,-6,1538,3130,30
35525763868,35525763873,5,44587,119908,30
35526887970,35526887965,-5,1520,3269,30
35527460865,35527460861,-4,1576,2797,30
35528711258,35528711253,-5,1021,3098,30
35532437590,35532437587,-3,964,2661,30
35540544033,35540544029,-4,1310,3281,30
35548199075,35548199069,-6,807,2794,30
35552335474,35552335470,-4,1016,2399,30
35555368813,35555368808,-5,985,3248,30
35555721764,35555721764,0,1158,1428,30
35557791038,35557791033,-5,1358,2823,30
35560420279,35560420274,-5,1140,3416,30
35560941115,35560941112,-3,1206,2971,30
35568291409,35568291403,-6,2084,3331,30
35570471967,35570471961,-6,1484,3482,30
35577498249,35577498244,-5,1066,3043,30
35584121926,35584121918,-8,1099,2581,30
35585715174,35585715170,-4,1467,3384,30
35586296384,35586296382,-2,1420,2273,30
35588800638,35588800634,-4,1366,2931,30
35589267899,35589267894,-5,1017,3690,30
35589706576,35589706582,6,3147,791,30
35594816503,35594816499,-4,709,3026,30
35596610581,35596610577,-4,1763,5446,30
35596947129,35596947127,-2,1456,2410,30
35597278515,35597278501,-14,1137,2018,30
35598369642,35598369640,-2,1161,1883,30
35598431367,35598431362,-5,834,2254,30
35602481866,35602481867,1,1267,1054,30
35609149905,35609149902,-3,1069,3083,30
35610069771,35610069767,-4,1098,2906,30
35614327478,35614327474,-4,807,2618,30
35615719545,35615719551,6,3761,1728,30
35619269100,35619269098,-2,3151,4900,30
35622131618,35622131616,-2,834,2651,30
35623049313,35623049319,6,2847,1216,30
35624945060,35624945051,-9,1208,2235,30
35626899175,35626899171,-4,793,2088,30
35629936528,35629936518,-10,100,591,30
35634287790,35634287792,2,1880,1864,30
35635349958,35635349952,-6,660,2162,30
35638166331,35638166334,3,1113,894,30
35643578876,35643578870,-6,1097,4035,30
35643984450,35643984470,20,539,1047,30
35647078145,35647078141,-4,762,2093,30
35648033706,35648033714,8,332,1038,30
35648740329,35648740324,-5,1154,2621,30
35652029684,35652029682,-2,1129,3004,30
35654966803,35654966798,-5,1119,2023,30
35656410286,35656410286,0,1288,1652,30
35656752759,35656752755,-4,1185,2643,30
35659354778,35659354773,-5,1037,2985,30
35659870467,35659870455,-12,132,642,30
35661431826,35661431822,-4,1131,2600,30
35663347682,35663347676,-6,1095,2826,30
35668295245,35668295242,-3,1347,3864,30
35670227396,35670227392,-4,896,2682,30
35670763627,35670763615,-12,773,302,30
35672614662,35672614670,8,3971,2003,30
35673958245,35673958252,7,4911,1610,30
35680879461,35680879470,9,12715,23009,30
35686060639,35686060633,-6,1072,3046,30
35689430306,35689430302,-4,944,2924,30
35692115967,35692115963,-4,1287,2930,30
35695557060,35695557056,-4,1215,2277,30
35697304914,35697304910,-4,2329,4973,30
35699945043,35699945038,-5,1394,3750,30
35703883294,35703883288,-6,901,2399,30
35708178007,35708178003,-4,890,2633,30
35711314959,35711314953,-6,1065,3128,30
35718185570,35718185566,-4,967,3311,30
35718418106,35718418115,9,294,935,30
35725486213,35725486209,-4,939,2476,30
35728677985,35728677982,-3,1150,2261,30
35728826186,35728826199,13,244,554,30
35729679681,35729679677,-4,1297,3503,30
35730021852,35730021866,14,389,885,30
35730726744,35730726738,-6,1164,3597,30
35732895809,35732895803,-6,1263,3016,30
35733227203,35733227200,-3,1316,3302,30
35737088243,35737088237,-6,751,2862,30
35749745103,35749745098,-5,1421,3883,30
35757588070,35757588067,-3,1075,2796,30
35759515448,35759515444,-4,935,2489,30
35761772931,35761772927,-4,893,1594,30
35763401108,35763401114,6,1729,1100,30
35763977699,35763977693,-6,1028,3805,30
35770816479,35770816476,-3,1274,3726,30
35772785941,35772785934,-7,1109,2609,30
35775293682,35775293677,-5,879,3160,30
35784176087,35784176083,-4,1163,2905,30
35786648597,35786648600,3,992,1264,30
35787040170,35787040163,-7,836,3108,30
35787181939,35787181933,-6,1171,3427,30
35788332673,35788332666,-7,1065,3088,30
35789593455,35789593450,-5,627,2860,30
35789763251,35789763230,-21,648,1750,30
35789813433,35789813452,19,462,1654,30
35793219608,35793219604,-4,1034,2436,30
35795024727,35795024720,-7,1387,2325,30
35795941385,35795941381,-4,29292,12068,30
35802110295,35802110291,-4,820,3325,30
35802969129,35802969151,22,217,1030,30
35803899837,35803899830,-7,1094,5066,30
35809840470,35809840470,0,877,1675,30
35812178299,35812178295,-4,606,1731,30
35815556484,35815556482,-2,1008,2351,30
35817293735,35817293730,-5,1019,3584,30
35823322699,35823322695,-4,789,2379,30
35825794620,35825794616,-4,993,1769,30
35826277857,35826277851,-6,1022,2672,30
35829680938,35829680933,-5,1124,4253,30
35830281093,35830281090,-3,1537,2807,30
35833158511,35833158515,4,2211,1909,30
35833490537,35833490529,-8,719,2349,30
35841099803,35841099797,-6,1183,3556,30
35843505006,35843505006,0,1523,2044,30
35843657965,35843657963,-2,1672,1414,30
35848784268,35848784263,-5,1506,3794,30
35854999175,35854999171,-4,603,2287,30
35856523547,35856523541,-6,1108,2634,30
35857855670,35857855666,-4,1584,2867,30
35860563195,35860563190,-5,1037,2175,30
35861743393,35861743376,-17,215,1088,30
35864813622,35864813620,-2,790,1249,30
35879632178,35879632175,-3,774,2161,30
35882178727,35882178724,-3,643,2450,30
35882283336,35882283358,22,519,1004,30
35884016709,35884016705,-4,1140,2541,30
35885126314,35885126310,-4,727,1366,30
35886673431,35886673425,-6,966,3538,30
35886765515,35886765531,16,81,779,30
35888235511,35888235506,-5,879,3106,30
35889914214,35889914209,-5,1535,3273,30
35892181710,35892181708,-2,1447,4140,30
35895801283,35895801279,-4,1895,4725,30
35899519005,35899518999,-6,1107,2624,30
35899687908,35899687905,-3,1804,2934,30
35903386794,35903386788,-6,602,2428,30
35906495732,35906495726,-6,1145,3886,30
35906646568,35906646555,-13,604,2099,30
35907341828,35907341847,19,221,678,30
35910220318,35910220313,-5,1041,2494,30
35911024643,35911024639,-4,1128,3516,30
35912468994,35912468988,-6,2057,7538,30
35915204167,35915204162,-5,941,2312,30
35915746876,35915746890,14,854,2584,30
35919092271,35919092267,-4,856,2723,30
35919210083,35919210102,19,81,764,30
35919940523,35919940508,-15,860,346,30
35923277282,35923277277,-5,826,3217,30
35924842808,35924842805,-3,21046,16425,30
35927366907,35927366902,-5,1082,2834,30
35928081436,35928081431,-5,809,3377,30
35928185150,35928185143,-7,1832,9090,30
35932362089,35932362084,-5,710,3297,30
35932891941,35932891937,-4,938,2332,30
35941188076,35941188071,-5,1225,3984,30
35941508690,35941508684,-6,1024,2859,30
35950441821,35950441837,16,1044,2708,30
35950681046,35950681059,13,1565,1315,30
35952845875,35952845869,-6,792,3016,30
35958025598,35958025595,-3,1112,3249,30
35959659257,35959659253,-4,1394,2988,30
35962863190,35962863185,-5,814,3113,30
35967172558,35967172555,-3,1013,1899,30
35977483920,35977483916,-4,917,3853,30
35980922430,35980922426,-4,1137,2392,30
35981771039,35981771035,-4,1222,2508,30
35984198319,35984198313,-6,914,2869,30
35988035211,35988035205,-6,1014,2590,30
36004685386,36004685380,-6,1047,2576,30
36005439450,36005439447,-3,975,1964,30
36006020947,36006020966,19,1217,3163,30
36006320889,36006320910,21,597,2944,30
36007050227,36007050222,-5,1425,2939,30
36007773614,36007773618,4,1911,959,30
36020884035,36020884029,-6,1312,2911,30
36022783832,36022783838,6,22907,31012,30
36024994411,36024994407,-4,641,2241,30
36031097202,36031097195,-7,568,1241,30
36031736567,36031736563,-4,1139,2982,30
36033186915,36033186911,-4,798,3020,30
36035568270,36035568263,-7,934,3341,30
36035604529,36035604521,-8,887,1686,30
36036457180,36036457193,13,1324,2892,30
36036940877,36036940874,-3,1119,1790,30
36038247362,36038247374,12,380,1073,30
36040138543,36040138540,-3,979,3147,30
36042557907,36042557901,-6,950,2002,30
36043882325,36043882323,-2,899,1267,30
36045360086,36045360082,-4,1114,2537,30
36060500482,36060500477,-5,1189,3417,30
36060930833,36060930829,-4,818,3083,30
36064983092,36064983087,-5,1163,3939,30
36065131483,36065131490,7,189,952,30
36068480911,36068480906,-5,860,2866,30
36075278995,36075278989,-6,1189,3103,30
36077109181,36077109183,2,1705,2424,30
36083267019,36083267018,-1,1092,2157,30
36083933341,36083933337,-4,944,2935,30
36084192466,36084192481,15,821,2381,30
36095570175,36095570181,6,2082,1711,30
36099019254,36099019249,-5,911,1921,30
36101134378,36101134374,-4,1296,3247,30
36101746006,36101746002,-4,739,2794,30
36107607995,36107607995,0,2396,3787,30
36109388251,36109388249,-2,1108,3162,30
36109983621,36109983617,-4,1175,3029,30
36110672968,36110672987,19,898,2647,30
36111646538,36111646535,-3,1534,3068,30
36112406975,36112406971,-4,1123,2334,30
36117639028,36117639033,5,3066,1443,30
36132070877,36132070872,-5,900,3235,30
36134619399,36134619393,-6,878,2753,30
36145496562,36145496558,-4,1015,3747,30
36147192382,36147192386,4,4336,2671,30
36150390225,36150390219,-6,895,2416,30
36154544675,36154544672,-3,986,2937,30
36159590750,36159590745,-5,635,1632,30
36159845266,36159845253,-13,966,2859,30
36159955596,36159955575,-21,176,1555,30
36160188948,36160188962,14,259,1208,30
36164555803,36164555797,-6,890,1879,30
36167612170,36167612165,-5,1196,3566,30
36167909554,36167909542,-12,1025,2690,30
36171025578,36171025573,-5,1203,2679,30
36173026219,36173026213,-6,844,2191,30
36177131773,36177131767,-6,1233,3965,30
36178910975,36178910971,-4,955,2401,30
36182597798,36182597792,-6,1506,2843,30
36186605458,36186605466,8,4068,1528,30
36189201766,36189201761,-5,107,654,30
36193326590,36193326594,4,2962,1752,30
36196845239,36196845234,-5,705,1887,30
36199574103,36199574101,-2,731,1809,30
36205928541,36205928542,1,1243,1741,30
36213377322,36213377318,-4,980,2386,30
36215144675,36215144674,-1,829,1251,30
36215553382,36215553389,7,4113,1302,30
36216317327,36216317322,-5,971,2980,30
36220805657,36220805654,-3,828,2606,30
36229455176,36229455173,-3,1380,3189,30
36229766775,36229766769,-6,844,2183,30
36232951599,36232951594,-5,756,3388,30
36236787441,36236787436,-5,1271,3660,30
36241081718,36241081713,-5,835,2956,30
36242611634,36242611629,-5,1023,3413,30
36243127769,36243127766,-3,960,2163,30
36244434081,36244434081,0,2921,5003,30
36247716391,36247716397,6,2255,1509,30
36249635527,36249635522,-5,1301,3666,30
36259344202,36259344205,3,2692,2833,30
36262596437,36262596433,-4,991,3306,30
36265246514,36265246509,-5,870,1877,30
36276495674,36276495670,-4,1185,3515,30
36277443367,36277443362,-5,1006,4132,30
36278664293,36278664287,-6,1242,5619,30
36283412739,36283412735,-4,987,2679,30
36290591146,36290591145,-1,22196,2300,30
36292423340,36292423337,-3,1018,2557,30
36300233613,36300233610,-3,138,1170,30
36303478899,36303478898,-1,1794,3796,30
36305308256,36305308250,-6,1032,2669,30
36310161967,36310161962,-5,845,2525,30
36314484831,36314484825,-6,1136,4043,30
36316199024,36316199018,-6,1178,3200,30
36318618009,36318618031,22,936,3212,30
36318867197,36318867196,-1,1210,2269,30
36320963310,36320963306,-4,1681,3311,30
36322096682,36322096676,-6,663,2007,30
36322867104,36322867122,18,202,770,30
36323382529,36323382525,-4,1157,2727,30
36327295726,36327295723,-3,764,1932,30
36327390451,36327390465,14,252,803,30
36327640327,36327640323,-4,1024,2582,30
36331391495,36331391490,-5,1015,1837,30
36331850761,36331850758,-3,713,2371,30
36338350847,36338350852,5,3493,1902,30
36340997819,36340997816,-3,1237,3511,30
36341412886,36341412883,-3,935,3006,30
36344314281,36344314282,1,1788,2103,30
36346737834,36346737830,-4,1417,4031,30
36351520894,36351520890,-4,1272,2077,30
36356624214,36356624209,-5,914,3169,30
36364579271,36364579269,-2,774,1789,30
36372993793,36372993789,-4,826,2985,30
36376354283,36376354279,-4,1061,2570,30
36376543665,36376543686,21,762,2304,30
36379420674,36379420670,-4,1350,2052,30
36381887018,36381887013,-5,820,2876,30
36392865838,36392865833,-5,1205,3951,30
36395991717,36395991702,-15,948,838,30
36405742638,36405742636,-2,839,2330,30
36408051910,36408051914,4,3544,1678,30
36408801711,36408801706,-5,769,1730,30
36408857122,36408857140,18,311,1791,30
36409184769,36409184763,-6,1331,3389,30
36414309255,36414309253,-2,1109,2355,30
36420186074,36420186069,-5,1463,2506,30
36422860299,36422860294,-5,679,2513,30
36423824074,36423824072,-2,1392,2298,30
36435707747,36435707744,-3,1362,2329,30
36436954571,36436954578,7,189,888,30
36439124057,36439124050,-7,1223,4473,30
36441992815,36441992810,-5,1716,4777,30
36449007350,36449007344,-6,1262,4045,30
36452959357,36452959351,-6,1262,2810,30
36457338813,36457338810,-3,316,2388,30
36462133325,36462133321,-4,1222,3020,30
36463335865,36463335862,-3,54,785,30
36464252410,36464252405,-5,1110,2527,30
36467662274,36467662270,-4,715,2383,30
36470831863,36470831859,-4,1275,2695,30
36470923439,36470923436,-3,1255,2477,30
36473149769,36473149764,-5,1252,3527,30
36480119803,36480119799,-4,843,2889,30
36481359058,36481359054,-4,22354,64829,30
36484317528,36484317524,-4,719,3511,30
36484812196,36484812202,6,2779,1322,30
36484917799,36484917794,-5,1174,2679,30
36486867767,36486867762,-5,1649,3055,30
36510581628,36510581624,-4,1164,3283,30
36512503018,36512503015,-3,1036,3510,30
36514081149,36514081144,-5,1057,2610,30
36515521244,36515521241,-3,949,2752,30
36517194692,36517194698,6,1903,1185,30
36517295331,36517295325,-6,1095,3134,30
36525446870,36525446865,-5,999,3321,30
36528517627,36528517623,-4,1366,2798,30
36535236114,36535236106,-8,1003,2636,30
36535490922,36535490941,19,605,1074,30
36537307278,36537307274,-4,1231,3202,30
36538106450,36538106437,-13,1359,4334,30
36538641785,36538641781,-4,1099,1848,30
36539633019,36539633014,-5,914,2085,30
36539667553,36539667557,4,202,872,30
36541530108,36541530109,1,1839,2310,30
36549392487,36549392483,-4,1106,2875,30
36550844205,36550844201,-4,723,1707,30
36556743114,36556743112,-2,1042,1609,30
36556929664,36556929645,-19,836,2047,30
36557474134,36557474136,2,5804,20579,30
36560326669,36560326665,-4,763,1916,30
36561009799,36561009794,-5,1289,2719,30
36561161296,36561161291,-5,873,2788,30
36561738082,36561738101,19,346,1167,30
36565477866,36565477864,-2,1116,2838,30
36569767927,36569767930,3,2829,1828,30
36571406018,36571406015,-3,1112,2399,30
36583405978,36583405972,-6,1446,3466,30
36587282971,36587282968,-3,861,2449,30
36589123930,36589123936,6,3726,1677,30
36593469257,36593469253,-4,934,2231,30
36594987941,36594987934,-7,1242,2764,30
36596154418,36596154414,-4,1013,3208,30
36598353514,36598353509,-5,954,2323,30
36602675894,36602675889,-5,1169,2558,30
36604656326,36604656326,0,1644,1403,30
36615700743,36615700738,-5,662,2213,30
36618362080,36618362074,-6,2750,5516,30
36621498031,36621498027,-4,1630,3239,30
36627792715,36627792709,-6,823,1580,30
36630026094,36630026096,2,2401,2205,30
36631926797,36631926793,-4,966,2910,30
36632857906,36632857901,-5,1404,3360,30
36638975857,36638975858,1,3591,3182,30
36640327998,36640327995,-3,974,2390,30
36640970356,36640970370,14,263,1215,30
36642097962,36642097958,-4,903,3270,30
36644176539,36644176536,-3,1039,2429,30
36648308170,36648308167,-3,895,1751,30
36650999667,36650999666,-1,1592,2252,30
36651936455,36651936452,-3,819,2466,30
36652582649,36652582629,-20,1315,3674,30
36655374519,36655374513,-6,1092,2819,30
36655418077,36655418071,-6,1333,4734,30
36656488315,36656488311,-4,817,3312,30
36657444333,36657444327,-6,1088,2550,30
36659775370,36659775366,-4,1159,2209,30
36669236824,36669236818,-6,893,3229,30
36671976970,36671976962,-8,1183,4151,30
36677315983,36677315977,-6,795,2315,30
36681714926,36681714923,-3,881,1947,30
36682320317,36682320311,-6,623,2203,30
36683486133,36683486129,-4,682,2474,30
36684579502,36684579506,4,1885,1029,30
36690311785,36690311782,-3,1036,1865,30
36692374387,36692374383,-4,784,1918,30
36692564202,36692564217,15,570,2436,30
36694405629,36694405626,-3,696,1869,30
36694491040,36694491020,-20,856,2064,30
36697040589,36697040584,-5,1343,2574,30
36703414267,36703414262,-5,883,2022,30
36705031731,36705031729,-2,1465,2460,30
36708200351,36708200346,-5,982,2752,30
36708418437,36708418433,-4,1282,3292,30
36718436831,36718436826,-5,696,2373,30
36718583265,36718583262,-3,1025,3215,30
36726543505,36726543507,2,1453,1206,30
36728081471,36728081469,-2,1308,2849,30
36730097951,36730097946,-5,824,2771,30
36731832630,36731832626,-4,926,3116,30
36732153819,36732153833,14,825,2576,30
36735519434,36735519429,-5,1118,2873,30
36738344950,36738344944,-6,978,2874,30
36739971833,36739971838,5,38232,19763,30
36741368144,36741368138,-6,520,1879,30
36753906750,36753906747,-3,888,3615,30
36756849123,36756849129,6,1686,2163,30
36758293814,36758293815,1,1056,1247,30
36761122226,36761122222,-4,1112,2969,30
36762046391,36762046389,-2,976,2198,30
36770491710,36770491708,-2,609,2127,30
36777548746,36777548742,-4,683,1820,30
36778743157,36778743153,-4,1228,2842,30
36795885326,36795885334,8,1702,1212,30
36800058834,36800058830,-4,979,2653,30
36802305978,36802305973,-5,942,1839,30
36807588308,36807588303,-5,942,2446,30
36810432806,36810432802,-4,1170,3206,30
36811063807,36811063799,-8,894,2254,30
36811766674,36811766669,-5,515,1628,30
36815850805,36815850801,-4,1178,3548,30
36816907902,36816907896,-6,1377,3346,30
36818290034,36818290029,-5,1242,2933,30
36818533890,36818533885,-5,912,2187,30
36827409746,36827409749,3,2257,1386,30
36834894443,36834894441,-2,1126,2802,30
36836331611,36836331605,-6,774,2136,30
36842136490,36842136486,-4,1245,3525,30
36849247331,36849247327,-4,1087,4303,30
36851173534,36851173530,-4,1333,2917,30
36854183828,36854183841,13,616,2276,30
36869437787,36869437787,0,1950,1707,30
36878016471,36878016466,-5,953,2626,30
36881661184,36881661191,7,1428,1008,30
36882293545,36882293538,-7,1132,3835,30
36884604469,36884604465,-4,1077,2370,30
36884889246,36884889244,-2,1643,2610,30
36886085821,36886085816,-5,1115,3813,30
36887013763,36887013758,-5,1151,3969,30
36891519336,36891519354,18,729,1939,30
36893863526,36893863521,-5,1240,2946,30
36895014546,36895014541,-5,1054,2449,30
36899042457,36899042454,-3,1454,3092,30
36900130237,36900130233,-4,1178,2615,30
36900387210,36900387205,-5,852,2772,30
36901690549,36901690554,5,6171,2004,30
36908131574,36908131572,-2,1184,2785,30
36909797017,36909797013,-4,633,2116,30
36914460285,36914460290,5,2353,882,30
36916776030,36916776044,14,1049,1977,30
36920721883,36920721881,-2,788,1906,30
36922351326,36922351322,-4,954,2992,30
36925439624,36925439619,-5,1177,3260,30
36929164038,36929164035,-3,1610,3273,30
36931232486,36931232481,-5,1033,2347,30
36931843103,36931843098,-5,1025,2492,30
36932113794,36932113789,-5,640,2024,30
36932821100,36932821118,18,360,663,30
36933493292,36933493286,-6,32123,14963,30
36935684105,36935684100,-5,809,2792,30
36940272366,36940272361,-5,1001,3142,30
36941719278,36941719274,-4,1520,2954,30
36942615753,36942615747,-6,1393,4020,30
36945972230,36945972225,-5,628,2005,30
36947451615,36947451611,-4,1158,3413,30
36949216414,36949216410,-4,1496,3687,30
36949479905,36949479897,-8,373,1288,30
36958616387,36958616379,-8,1218,3532,30
36961565219,36961565214,-5,877,1449,30
36963050702,36963050697,-5,1138,2776,30
36963468707,36963468714,7,313,1245,30
36964394228,36964394224,-4,1408,2594,30
36968072900,36968072895,-5,1340,3711,30
36972650386,36972650386,0,1252,1355,30
36972983174,36972983170,-4,939,2697,30
36974063303,36974063298,-5,1158,2380,30
36974366558,36974366554,-4,687,2510,30
36975320451,36975320444,-7,991,3448,30
36980775791,36980775785,-6,814,4148,30
36981239104,36981239097,-7,1225,3879,30
36994040539,36994040534,-5,1430,3537,30
37000200802,37000200802,0,797,1795,30
37006069752,37006069746,-6,1302,3774,30
37007585877,37007585877,0,17539,17765,30
37010125093,37010125088,-5,717,3175,30
37014021489,37014021494,5,5325,3053,30
37016537398,37016537395,-3,710,2689,30
37027611701,37027611698,-3,1257,1204,30
37028355111,37028355113,2,3297,3286,30
37028424587,37028424582,-5,681,3793,30
37029830863,37029830858,-5,820,3468,30
37033294123,37033294119,-4,883,1660,30
37034136854,37034136851,-3,1824,3091,30
37034247667,37034247662,-5,1174,2214,30
37035427738,37035427734,-4,1124,3273,30
37039597082,37039597078,-4,854,2385,30
37041431494,37041431489,-5,856,2551,30
37043272713,37043272707,-6,1085,3996,30
37044696577,37044696573,-4,1099,3480,30
37044757275,37044757266,-9,930,2515,30
37064146535,37064146530,-5,1124,2399,30
37069939116,37069939112,-4,975,2593,30
37073069482,37073069479,-3,1190,3392,30
37075176036,37075176034,-2,1389,3476,30
37075940851,37075940846,-5,600,1682,30
37077291525,37077291521,-4,1209,2552,30
37078085810,37078085805,-5,913,2385,30
37079954197,37079954192,-5,921,2450,30
37089214017,37089214001,-16,127,1258,30
37092901084,37092901078,-6,1030,2608,30
37093725635,37093725633,-2,1104,2899,30
37095043962,37095043958,-4,1390,3494,30
37096630999,37096630994,-5,926,2487,30
37104205122,37104205120,-2,916,1822,30
37104385148,37104385151,3,179,1916,30
37104732978,37104732990,12,310,1177,30
37106579803,37106579797,-6,866,4552,30
37108479375,37108479371,-4,1111,3120,30
37111845837,37111845833,-4,1297,4049,30
37119267963,37119267958,-5,706,3165,30
37119527810,37119527826,16,397,1296,30
37122030487,37122030484,-3,889,2415,30
37122499658,37122499657,-1,6279,9338,30
37123169994,37123169992,-2,1086,2666,30
37123202799,37123202806,7,2994,1260,30
37131011379,37131011374,-5,929,2164,30
37138380666,37138380661,-5,2182,6415,30
37147076221,37147076216,-5,670,1691,30
37148249506,37148249525,19,404,1129,30
37163571253,37163571250,-3,1383,4107,30
37169002631,37169002628,-3,1446,3290,30
37169052359,37169052354,-5,1127,2393,30
37170068926,37170068923,-3,1302,3638,30
37172869761,37172869757,-4,1113,3016,30
37177055520,37177055517,-3,1656,3917,30
37178978538,37178978534,-4,861,2638,30
37183732576,37183732572,-4,1461,3924,30
37184248914,37184248910,-4,803,2756,30
37184802331,37184802323,-8,1016,2538,30
37187173943,37187173938,-5,886,3387,30
37187335782,37187335777,-5,803,2664,30
37188265262,37188265259,-3,839,2078,30
37191291655,37191291650,-5,1164,2491,30
37198626654,37198626655,1,1209,1675,30
37203237939,37203237934,-5,984,2299,30
37203466826,37203466846,20,184,908,30
37207044295,37207044298,3,1681,1716,30
37208463190,37208463186,-4,1386,2050,30
37218334967,37218334968,1,1268,1822,30
37235668664,37235668668,4,4821,2263,30
37236154346,37236154341,-5,982,2865,30
37236304560,37236304578,18,122,1309,30
37236351690,37236351708,18,949,3096,30
37237444163,37237444176,13,401,1105,30
37240620744,37240620743,-1,386,1345,30
37243074038,37243074034,-4,983,3059,30
37246639347,37246639342,-5,1319,4691,30
37249327318,37249327312,-6,1022,2802,30
37255039993,37255039993,0,1330,2765,30
37256285881,37256285877,-4,1406,3499,30
37261241346,37261241341,-5,825,2270,30
37261732892,37261732889,-3,1038,1785,30
37265424319,37265424314,-5,686,2023,30
37268410214,37268410210,-4,1559,3822,30
37269115691,37269115682,-9,994,2884,30
37269185458,37269185451,-7,288,1640,30
37273703376,37273703382,6,4421,2021,30
37284428259,37284428256,-3,879,2704,30
37289782777,37289782774,-3,1005,2686,30
37290636274,37290636282,8,2810,1176,30
37296365983,37296365976,-7,496,918,30
37297032081,37297032079,-2,1071,3393,30
37298292550,37298292546,-4,985,3855,30
37305170179,37305170176,-3,707,1972,30
37308430307,37308430302,-5,916,2679,30
37309887286,37309887283,-3,1151,3099,30
37310391975,37310391970,-5,570,1603,30
37310769513,37310769534,21,693,3906,30
37311455395,37311455392,-3,786,1678,30
37311669986,37311669981,-5,644,2665,30
37314945691,37314945688,-3,879,2788,30
37317074605,37317074596,-9,1098,2894,30
37322529748,37322529749,1,18330,10185,30
37325911669,37325911663,-6,1153,4501,30
37334733678,37334733674,-4,1021,3227,30
37335764057,37335764053,-4,637,3353,30
37339233481,37339233476,-5,1192,2553,30
37344193803,37344193798,-5,886,3696,30
37344281377,37344281358,-19,681,2154,30
37345131305,37345131299,-6,1737,3875,30
37352853032,37352853027,-5,786,1846,30
37354770423,37354770422,-1,1327,1998,30
37359529261,37359529255,-6,793,2950,30
37361107073,37361107081,8,10347,36118,30
37363667583,37363667577,-6,1383,4825,30
37364925670,37364925665,-5,829,2185,30
37367867090,37367867085,-5,1219,3270,30
37369795984,37369795980,-4,995,3420,30
37369898802,37369898797,-5,1112,2606,30
37370089432,37370089417,-15,1205,4068,30
37378681518,37378681513,-5,885,2993,30
37378707216,37378707234,18,406,2014,30
37384947517,37384947514,-3,974,3970,30
37385850562,37385850557,-5,1291,2640,30
37386661505,37386661502,-3,1530,2473,30
37389515602,37389515598,-4,939,2801,30
37390425975,37390425972,-3,1498,4019,30
37390706167,37390706162,-5,1517,4116,30
37393181312,37393181319,7,3362,987,30
37398297242,37398297239,-3,698,1543,30
37400566125,37400566125,0,1321,2114,30
37402888949,37402888945,-4,935,2296,30
37405180489,37405180483,-6,842,2408,30
37409132755,37409132737,-18,984,2687,30
37409535210,37409535226,16,854,2444,30
37409667975,37409667970,-5,1139,2345,30
37410864045,37410864043,-2,1329,2626,30
37414314463,37414314458,-5,1372,3347,30
37415799231,37415799226,-5,971,2421,30
37426466974,37426466983,9,2437,978,30
37427345692,37427345690,-2,1789,3139,30
37427372833,37427372850,17,1063,3137,30
37430415846,37430415843,-3,902,2498,30
37432501989,37432502003,14,134,981,30
37434459147,37434459141,-6,464,1277,30
37434758798,37434758793,-5,1240,2529,30
37437080204,37437080198,-6,413,700,30
37437478290,37437478306,16,314,1213,30
37439621999,37439622002,3,1707,1357,30
37448310321,37448310317,-4,665,2322,30
37452399590,37452399585,-5,1217,3133,30
37453019807,37453019802,-5,1110,2383,30
37455397649,37455397642,-7,2865,14317,30
37457395033,37457395035,2,1454,1197,30
37458826287,37458826287,0,1428,1783,30
37466437590,37466437587,-3,785,2353,30
37468685758,37468685754,-4,1026,3024,30
37469500586,37469500582,-4,704,3241,30
37469883459,37469883445,-14,707,2298,30
37472211914,37472211906,-8,668,3159,30
37472905678,37472905673,-5,885,3145,30
37474300513,37474300508,-5,1145,3134,30
37490992816,37490992822,6,77,1046,30
37493427622,37493427642,20,555,1414,30
37493664790,37493664790,0,31311,19469,30
37497382334,37497382341,7,4686,1852,30
37497893750,37497893745,-5,758,1460,30
37501325537,37501325533,-4,1215,2311,30
37505079517,37505079502,-15,1500,989,30
37505310617,37505310613,-4,51256,25731,30
37507082244,37507082239,-5,1319,3196,30
37514752383,37514752380,-3,1299,2774,30
37523343715,37523343710,-5,951,3194,30
37527954955,37527954950,-5,1008,3274,30
37537087343,37537087353,10,148,858,30
37537363139,37537363146,7,2140,1150,30
37540326766,37540326762,-4,1224,2968,30
37540606916,37540606920,4,330,1268,30
37545915818,37545915814,-4,756,3074,30
37549722044,37549722039,-5,1406,3639,30
37550287613,37550287617,4,2911,1393,30
37551629652,37551629647,-5,1329,3574,30
37556393720,37556393725,5,12487,20788,30
37557104498,37557104494,-4,1251,2996,30
37558266434,37558266430,-4,1938,6895,30
37559777160,37559777153,-7,818,1765,30
37561807345,37561807342,-3,1605,3498,30
37562732732,37562732729,-3,765,2025,30
37562861153,37562861169,16,60,840,30
37579849226,37579849222,-4,1000,1921,30
37581907754,37581907751,-3,1148,2873,30
37583326723,37583326717,-6,611,2152,30
37584462198,37584462187,-11,927,1455,30
37585054202,37585054214,12,86,997,30
37590284171,37590284167,-4,920,3920,30
37592547859,37592547864,5,13702,28581,30
37593358882,37593358890,8,3862,1033,30
37598125525,37598125520,-5,962,1861,30
37599928079,37599928075,-4,1240,2419,30
37600640682,37600640681,-1,918,2358,30
37605723058,37605723055,-3,936,2431,30
37607181865,37607181859,-6,769,2984,30
37620360377,37620360389,12,12231,51394,30
37623888421,37623888418,-3,857,2777,30
37624164923,37624164925,2,1036,1485,30
37630724193,37630724194,1,3420,3471,30
37630816233,37630816226,-7,839,4314,30
37631156560,37631156566,6,2891,1529,30
37634918184,37634918180,-4,1389,2966,30
37640671997,37640671993,-4,1172,3263,30
37642862314,37642862310,-4,1302,2865,30
37643036474,37643036471,-3,560,2125,30
37643846633,37643846637,4,2075,1801,30
37644393599,37644393594,-5,864,2960,30
37645004035,37645004051,16,28371,28647,30
37650017223,37650017219,-4,643,3861,30
37653664576,37653664573,-3,792,2500,30
37653812441,37653812457,16,1332,2579,30
37659383449,37659383445,-4,1475,3783,30
37665138391,37665138386,-5,1232,2492,30
37667797118,37667797115,-3,1191,2096,30
37673604542,37673604537,-5,1185,2627,30
37674392144,37674392136,-8,161,878,30
37675598239,37675598234,-5,806,2469,30
37677471027,37677471022,-5,1354,3078,30
37684692865,37684692861,-4,975,3050,30
37697996411,37697996408,-3,1074,3042,30
37698132804,37698132811,7,116,842,30
37700343145,37700343141,-4,968,3180,30
37704508879,37704508874,-5,866,2705,30
37706159893,37706159890,-3,1239,1836,30
37707517314,37707517329,15,2504,1319,30
37708047636,37708047640,4,4636,2840,30
37710978474,37710978470,-4,1278,1758,30
37711641426,37711641427,1,200,1178,30
37715272845,37715272849,4,1660,1263,30
37716862993,37716862989,-4,1393,2775,30
37717871300,37717871298,-2,1308,2639,30
37717922584,37717922575,-9,96,825,30
37721497758,37721497753,-5,1091,2943,30
37722576334,37722576330,-4,1322,2535,30
37723495102,37723495099,-3,747,1694,30
37729249704,37729249723,19,79,1051,30
37734353043,37734353038,-5,1110,2750,30
37735596747,37735596764,17,549,1849,30
37741435408,37741435406,-2,1194,3224,30
37747333074,37747333069,-5,1329,1511,30
37757804103,37757804095,-8,850,2305,30
37758769537,37758769531,-6,2018,3645,30
37762527784,37762527778,-6,768,2387,30
37770010271,37770010267,-4,591,1064,30
37773810788,37773810784,-4,1005,2360,30
37774051531,37774051551,20,774,2967,30
37776155062,37776155056,-6,1165,3767,30
37777351865,37777351858,-7,1198,2578,30
37779724546,37779724540,-6,1149,4211,30
37790059844,37790059850,6,10322,22000,30
37791039648,37791039642,-6,970,3494,30
37794983538,37794983533,-5,1165,2955,30
37795232154,37795232169,15,843,2830,30
37797581634,37797581629,-5,1254,3095,30
37799088239,37799088234,-5,684,2148,30
37800652206,37800652201,-5,888,2687,30
37809242573,37809242570,-3,784,2107,30
37811493823,37811493821,-2,1241,2291,30
37812989132,37812989127,-5,1055,2399,30
37815078575,37815078569,-6,950,2243,30
37815152710,37815152705,-5,756,2226,30
37817158174,37817158168,-6,1436,3737,30
37817357732,37817357725,-7,1121,2679,30
37818072007,37818072003,-4,926,1400,30
37819954717,37819954713,-4,799,1926,30
37820045793,37820045798,5,357,780,30
37822855701,37822855696,-5,1307,2542,30
37823568665,37823568661,-4,1000,2624,30
37824080712,37824080706,-6,783,2402,30
37827533562,37827533556,-6,1414,3756,30
37829132186,37829132179,-7,677,2468,30
37830853698,37830853693,-5,1252,3720,30
37832289690,37832289685,-5,1005,2067,30
37832501395,37832501395,0,246,1660,30
37838287731,37838287711,-20,1868,843,30
37847214089,37847214089,0,1810,2774,30
37853213325,37853213321,-4,959,2928,30
37859189409,37859189405,-4,1028,2167,30
37868506825,37868506832,7,2761,1860,30
37868983858,37868983854,-4,859,2089,30
37869432970,37869432986,16,701,2378,30
37874487802,37874487798,-4,677,3071,30
37879438239,37879438234,-5,566,1953,30
37882688866,37882688866,0,2307,2958,30
37883669140,37883669134,-6,1101,2249,30
37885458969,37885458964,-5,526,2870,30
37888704011,37888704008,-3,1266,3829,30
37888974416,37888974401,-15,997,3179,30
37891324567,37891324569,2,1913,1761,30
37893465794,37893465790,-4,749,2474,30
37894141591,37894141585,-6,1117,3368,30
37894959054,37894959057,3,3106,2864,30
37897933237,37897933233,-4,894,2562,30
37899163130,37899163126,-4,1398,2238,30
37900162663,37900162658,-5,1369,3288,30
37903812461,37903812455,-6,923,2775,30
37908378479,37908378477,-2,599,2260,30
37908698704,37908698700,-4,53,1056,30
37912923338,37912923334,-4,906,1613,30
37921587819,37921587815,-4,1236,2484,30
37922066730,37922066726,-4,1066,2795,30
37924066823,37924066819,-4,1046,2512,30
37924792948,37924792942,-6,1092,3536,30
37927906267,37927906261,-6,1121,2816,30
37928253826,37928253822,-4,1299,2883,30
37928977756,37928977752,-4,811,2751,30
37929874551,37929874550,-1,1096,2341,30
37931374769,37931374762,-7,1125,2576,30
37935276682,37935276683,1,1175,1368,30
37936095908,37936095906,-2,1190,2206,30
37941912291,37941912286,-5,1092,2457,30
37942444920,37942444905,-15,526,1110,30
37943092211,37943092208,-3,873,2535,30
37944936223,37944936218,-5,524,1292,30
37950864521,37950864514,-7,1156,2915,30
37953786479,37953786476,-3,884,2255,30
37953927571,37953927570,-1,951,828,30
37955413430,37955413426,-4,982,1964,30
37955638955,37955638936,-19,993,2113,30
37956206867,37956206878,11,506,1830,30
37958707947,37958707942,-5,1423,4908,30
37960273450,37960273448,-2,1360,2571,30
37962265417,37962265413,-4,987,2552,30
37970701230,37970701227,-3,1265,2233,30
37972857166,37972857157,-9,508,2478,30
37973061148,37973061142,-6,1183,3156,30
37975621906,37975621902,-4,1310,2466,30
37979026126,37979026127,1,1197,1620,30
37979818823,37979818817,-6,830,3011,30
37981063910,37981063906,-4,1270,3349,30
37982722626,37982722628,2,2442,3207,30
37984553338,37984553333,-5,1600,3863,30
37989744119,37989744129,10,322,1004,30
37991872789,37991872782,-7,1200,3014,30
38000919298,38000919294,-4,1161,3046,30
38001014475,38001014470,-5,1069,2758,30
38001886861,38001886857,-4,1394,3391,30
38003914719,38003914714,-5,1048,3038,30
38006008366,38006008361,-5,696,2486,30
38010499352,38010499348,-4,1211,2895,30
38011970528,38011970524,-4,920,2452,30
38012922252,38012922269,17,697,3107,30
38013635771,38013635767,-4,1000,2471,30
38023866739,38023866736,-3,867,1762,30
38024763563,38024763560,-3,1294,3268,30
38027960051,38027960047,-4,1012,3613,30
38028739933,38028739927,-6,1103,3736,30
38031625902,38031625897,-5,1331,3368,30
38033504466,38033504458,-8,653,2973,30
38034711038,38034711046,8,3450,1334,30
38039114763,38039114765,2,1403,1014,30
38040648968,38040648961,-7,1226,3624,30
38041309703,38041309699,-4,1013,3147,30
38041527786,38041527778,-8,146,1419,30
38042080340,38042080354,14,339,637,30
38047715242,38047715240,-2,1065,1798,30
38049856786,38049856785,-1,1302,2328,30
38050404555,38050404549,-6,1192,6090,30
38051673661,38051673657,-4,646,2214,30
38052070834,38052070823,-11,200,1103,30
38066069523,38066069519,-4,761,2557,30
38066222959,38066222960,1,17757,21108,30
38069314915,38069314910,-5,819,2182,30
38075546978,38075546974,-4,1139,2658,30
38078028770,38078028765,-5,1133,2752,30
38101262020,38101262015,-5,1455,4093,30
38102161658,38102161679,21,1105,2355,30
38103795619,38103795616,-3,933,2239,30
38104377163,38104377174,11,216,724,30
38113406463,38113406456,-7,971,3163,30
38115441173,38115441168,-5,1093,3845,30
38119608162,38119608157,-5,922,4367,30
38123528582,38123528574,-8,963,3769,30
38134033979,38134033975,-4,1364,3087,30
38138980706,38138980700,-6,997,2237,30
38140668594,38140668589,-5,1221,3491,30
38143843397,38143843393,-4,972,1804,30
38144548539,38144548539,0,150,852,30
38147168275,38147168271,-4,1157,2732,30
38148114851,38148114846,-5,1118,3603,30
38148953337,38148953346,9,201,841,30
38152585993,38152585991,-2,940,2237,30
38155278763,38155278760,-3,938,2211,30
38158132639,38158132634,-5,820,2833,30
38164793055,38164793050,-5,1151,3136,30
38171173790,38171173784,-6,1055,2991,30
38180777294,38180777288,-6,1156,3031,30
38185293606,38185293600,-6,1027,4263,30
38187275051,38187275046,-5,889,2704,30
38189138859,38189138856,-3,933,2292,30
38189249095,38189249092,-3,1254,3304,30
38191014292,38191014286,-6,1021,2976,30
38194019450,38194019466,16,1089,2281,30
38199104067,38199104064,-3,1065,3363,30
38199445907,38199445902,-5,802,2547,30
38208815864,38208815860,-4,1324,2230,30
38213314594,38213314590,-4,851,2767,30
38214908213,38214908209,-4,1007,2231,30
38217383018,38217383014,-4,1071,3082,30
38218775795,38218775792,-3,918,2051,30
38232714163,38232714158,-5,658,2242,30
38235254686,38235254679,-7,1201,4374,30
38236099724,38236099725,1,2803,3640,30
38236235607,38236235601,-6,944,2677,30
38239748633,38239748632,-1,1462,3134,30
38241579483,38241579480,-3,1392,3370,30
38242015778,38242015794,16,712,3058,30
38242410739,38242410734,-5,1352,3066,30
38243901530,38243901526,-4,1054,2705,30
38243953635,38243953637,2,150,1131,30
38244664759,38244664756,-3,1217,2118,30
38247714283,38247714276,-7,885,3440,30
38248966964,38248966974,10,195,1023,30
38252130729,38252130729,0,1599,2609,30
38255436086,38255436083,-3,1068,2729,30
38255657334,38255657330,-4,536,1865,30
38259258834,38259258828,-6,726,2347,30
38262861638,38262861636,-2,31192,16623,30
38264912214,38264912210,-4,1302,2752,30
38266742194,38266742196,2,1867,1096,30
38272000203,38272000198,-5,849,2436,30
38283132307,38283132305,-2,1093,1880,30
38283771531,38283771509,-22,322,515,30
38294116733,38294116729,-4,790,3135,30
38294416568,38294416562,-6,890,3330,30
38294478368,38294478390,22,1064,3622,30
38298852118,38298852115,-3,1264,2279,30
38308641546,38308641543,-3,995,2425,30
38311326008,38311326006,-2,888,3053,30
38311523460,38311523475,15,753,1541,30
38312205723,38312205726,3,6615,29046,30
38313219022,38313219018,-4,1091,3277,30
38316721734,38316721730,-4,1201,2344,30
38320861826,38320861821,-5,1480,4490,30
38321397436,38321397454,18,539,1270,30
38328168743,38328168737,-6,814,2590,30
38328761979,38328761974,-5,1292,3192,30
38329375032,38329375028,-4,1018,2103,30
38331184101,38331184095,-6,844,2229,30
38332559804,38332559818,14,310,1265,30
38335257963,38335257958,-5,917,2695,30
38346187566,38346187573,7,4340,1439,30
38349813621,38349813617,-4,1072,2876,30
38354104142,38354104142,0,1535,1540,30
38354587588,38354587581,-7,730,1530,30
38356556181,38356556177,-4,1104,3008,30
38356621384,38356621407,23,487,1014,30
38357051134,38357051133,-1,1212,2203,30
38361998474,38361998470,-4,854,2171,30
38362457101,38362457097,-4,1192,2564,30
38362619841,38362619861,20,389,1800,30
38365298767,38365298762,-5,910,1944,30
38365769379,38365769359,-20,1236,2266,30
38366870993,38366870998,5,3585,1181,30
38368320318,38368320314,-4,2093,5077,30
38369921975,38369921969,-6,1176,3266,30
38372027179,38372027174,-5,860,2595,30
38374600122,38374600118,-4,1176,2688,30
38374697539,38374697550,11,372,1367,30
38375343690,38375343691,1,1361,2155,30
38376266546,38376266546,0,864,1588,30
38376895750,38376895747,-3,1450,2035,30
38377827213,38377827216,3,29649,17293,30
38378555826,38378555821,-5,997,2909,30
38385345191,38385345186,-5,1391,3339,30
38394681623,38394681639,16,345,1094,30
38397871486,38397871491,5,1574,1000,30
38400439727,38400439723,-4,881,2741,30
38400472963,38400472965,2,145,1028,30
38409154598,38409154595,-3,1271,3150,30
38409388529,38409388523,-6,956,3547,30
38414455824,38414455819,-5,1103,2597,30
38414958118,38414958112,-6,1443,3198,30
38416066550,38416066545,-5,885,2068,30
38418265335,38418265328,-7,970,2539,30
38421181582,38421181578,-4,610,2096,30
38422860739,38422860733,-6,961,2322,30
38423304097,38423304093,-4,1185,3048,30
38429721010,38429721005,-5,821,1875,30
38435730054,38435730049,-5,1528,2997,30
38439387508,38439387504,-4,1167,2640,30
38442283270,38442283267,-3,980,2197,30
38445282583,38445282581,-2,617,2565,30
38445951195,38445951211,16,247,822,30
38458367119,38458367134,15,13002,46014,30
38459040798,38459040793,-5,989,2148,30
38459295674,38459295672,-2,1329,2923,30
38463476270,38463476264,-6,808,3306,30
38466968099,38466968090,-9,902,3275,30
38470553306,38470553301,-5,1129,4575,30
38471980460,38471980454,-6,763,2604,30
38474106806,38474106803,-3,1080,2688,30
38480278106,38480278102,-4,984,3188,30
38484690786,38484690782,-4,1242,2789,30
38484943520,38484943515,-5,1361,3250,30
38485988919,38485988916,-3,1166,2983,30
38489678978,38489678976,-2,1296,2542,30
38491615859,38491615855,-4,1138,3359,30
38492072067,38492072067,0,1611,1764,30
38494640518,38494640513,-5,879,2736,30
38498520830,38498520824,-6,1297,4788,30
38499650091,38499650085,-6,636,2046,30
38499877009,38499876994,-15,871,3378,30
38499944043,38499944057,14,421,1708,30
38500295542,38500295537,-5,1053,3254,30
38502249498,38502249492,-6,318,1351,30
38504474667,38504474662,-5,1041,2973,30
38507650766,38507650762,-4,1661,3564,30
38507842190,38507842187,-3,1025,1775,30
38507958341,38507958341,0,1974,2992,30
38509658798,38509658797,-1,2242,2288,30
38512904270,38512904266,-4,1001,1531,30
38514202288,38514202280,-8,1024,2283,30
38517228867,38517228863,-4,1181,3561,30
38520988102,38520988099,-3,968,2705,30
38528204253,38528204249,-4,1444,3942,30
38533656719,38533656712,-7,796,4855,30
38534555777,38534555767,-10,1077,2670,30
38535674755,38535674752,-3,778,3338,30
38540299742,38540299737,-5,1296,2842,30
38540472133,38540472131,-2,2560,4327,30
38542870386,38542870381,-5,876,2097,30
38543647743,38543647741,-2,1147,2086,30
38544162815,38544162812,-3,1074,2840,30
38546896847,38546896843,-4,14442,18606,30
38548190335,38548190332,-3,1399,2774,30
38551729441,38551729435,-6,787,3780,30
38555785156,38555785155,-1,1556,2111,30
38556333979,38556333974,-5,1066,2087,30
38557320842,38557320828,-14,428,7237,30
38566202133,38566202128,-5,1029,3188,30
38566343418,38566343439,21,371,1182,30
38568944326,38568944322,-4,1159,2110,30
38569303385,38569303402,17,393,1000,30
38572798534,38572798550,16,919,2182,30
38574492899,38574492911,12,837,4224,30
38577662078,38577662073,-5,975,3677,30
38577702177,38577702196,19,555,1647,30
38584857639,38584857637,-2,1165,2562,30
38585519627,38585519622,-5,954,3338,30
38587525803,38587525798,-5,999,1274,30
38587743755,38587743759,4,1523,1203,30
38588818698,38588818693,-5,1498,6400,30
38598256325,38598256319,-6,1180,4688,30
38598395833,38598395854,21,801,1484,30
38598423376,38598423368,-8,1011,1980,30
38598693115,38598693097,-18,44,501,30
38600110382,38600110376,-6,1335,2757,30
38603660167,38603660156,-11,38388,15690,30
38603721914,38603721909,-5,1147,3212,30
38606904974,38606904972,-2,1343,2418,30
38612392874,38612392870,-4,1243,3831,30
38613624927,38613624921,-6,1292,3431,30
38614093614,38614093609,-5,805,3654,30
38616490048,38616490044,-4,1266,3353,30
38617631003,38617630998,-5,960,3489,30
38632670242,38632670238,-4,1199,3108,30
38633735954,38633735950,-4,1335,3069,30
38637389138,38637389133,-5,721,2338,30
38637436444,38637436439,-5,1050,3155,30
38643836230,38643836227,-3,1045,2807,30
38644370602,38644370599,-3,1184,1925,30
38644591877,38644591873,-4,661,2241,30
38649012454,38649012451,-3,881,2200,30
38649458729,38649458751,22,832,2554,30
38649977266,38649977255,-11,1207,2510,30
38650991982,38650991980,-2,1607,2344,30
38652263093,38652263090,-3,1068,2464,30
38653304905,38653304919,14,509,848,30
38658160711,38658160707,-4,766,2228,30
38658393830,38658393827,-3,1562,3625,30
38662050395,38662050390,-5,840,2872,30
38663875799,38663875794,-5,990,3050,30
38666571433,38666571430,-3,1212,3237,30
38669665943,38669665940,-3,1270,1912,30
38670177397,38670177390,-7,988,2286,30
38671472598,38671472592,-6,861,2995,30
38671937257,38671937279,22,148,395,30
38673283465,38673283468,3,3769,2422,30
38674661365,38674661362,-3,1326,2819,30
38676648623,38676648630,7,4622,2496,30
38677094383,38677094377,-6,1179,3790,30
38677484643,38677484646,3,228,894,30
38680274922,38680274924,2,941,803,30
38682327533,38682327527,-6,1595,2623,30
38688429354,38688429358,4,3583,1049,30
38689561446,38689561441,-5,1008,2384,30
38693137194,38693137189,-5,1098,2924,30
38696420842,38696420838,-4,1290,3492,30
38699580282,38699580278,-4,1222,3091,30
38705024302,38705024298,-4,1096,2765,30
38711008545,38711008540,-5,728,2410,30
38712100550,38712100547,-3,1048,2927,30
38717133661,38717133653,-8,893,2469,30
38728749341,38728749334,-7,942,3207,30
38733521050,38733521045,-5,1053,2498,30
38735104846,38735104842,-4,1046,3064,30
38737263894,38737263890,-4,1109,2850,30
38737988731,38737988725,-6,972,4084,30
38740485527,38740485523,-4,1095,2994,30
38746287597,38746287603,6,2024,1254,30
38749215194,38749215189,-5,1282,3037,30
38749313910,38749313906,-4,1396,2537,30
38749672204,38749672210,6,4404,1539,30
38750642513,38750642510,-3,1103,3548,30
38751532073,38751532068,-5,1130,3674,30
38752193009,38752193015,6,1663,491,30
38753705307,38753705302,-5,1134,3269,30
38754115296,38754115318,22,512,1404,30
38754791162,38754791173,11,15349,9882,30
38769089199,38769089195,-4,855,1536,30
38772314651,38772314647,-4,593,3322,30
38772413459,38772413466,7,161,1491,30
38773633353,38773633353,0,2434,2344,30
38774536750,38774536744,-6,969,2683,30
38774750704,38774750701,-3,1297,3136,30
38775239015,38775239010,-5,1622,3124,30
38776187945,38776187964,19,974,3274,30
38792519161,38792519159,-2,1140,1854,30
38794659778,38794659772,-6,1167,3317,30
38795323218,38795323214,-4,1331,2527,30
38803844382,38803844377,-5,1193,2249,30
38809249699,38809249694,-5,1058,3736,30
38809540422,38809540418,-4,1175,2835,30
38809674620,38809674624,4,5201,2867,30
38810805359,38810805355,-4,773,2086,30
38810868235,38810868215,-20,29588,26090,30
38812725502,38812725502,0,2594,3896,30
38818030141,38818030138,-3,738,2785,30
38820564758,38820564753,-5,1321,4004,30
38821628126,38821628121,-5,946,3856,30
38828278194,38828278190,-4,978,2358,30
38828918491,38828918482,-9,215,942,30
38830937667,38830937664,-3,973,2546,30
38831090754,38831090750,-4,725,2319,30
38836021784,38836021782,-2,1218,2891,30
38836151733,38836151730,-3,1603,2929,30
38836473270,38836473266,-4,1442,3027,30
38836683989,38836683983,-6,1261,3537,30
38838283947,38838283943,-4,1048,3632,30
38844927358,38844927353,-5,1313,2749,30
38845713951,38845713946,-5,887,3365,30
38851102185,38851102190,5,930,761,30
38854627878,38854627875,-3,921,2073,30
38856642173,38856642180,7,4400,1762,30
38858135598,38858135595,-3,1189,3356,30
38858516018,38858516007,-11,991,2987,30
38859044428,38859044442,14,907,3225,30
38859549218,38859549213,-5,707,2519,30
38860252602,38860252595,-7,1001,2258,30
38865388196,38865388193,-3,728,1699,30
38868359803,38868359798,-5,1110,3210,30
38871022227,38871022226,-1,922,1159,30
38876511542,38876511538,-4,1124,2482,30
38878940201,38878940196,-5,883,1938,30
38879365338,38879365326,-12,173,776,30
38879519466,38879519467,1,36,651,30
38880591610,38880591607,-3,927,1861,30
38880983985,38880984005,20,1396,2333,30
38883405739,38883405734,-5,616,2460,30
38883461537,38883461554,17,935,1890,30
38883853054,38883853050,-4,1091,3099,30
38884566678,38884566671,-7,1502,3237,30
38887275923,38887275918,-5,823,3200,30
38887921206,38887921201,-5,1116,3196,30
38891816797,38891816793,-4,1095,3500,30
38893261254,38893261249,-5,1141,2486,30
38899847526,38899847517,-9,1358,7017,30
38900552530,38900552525,-5,1165,2928,30
38902643719,38902643719,0,1525,1873,30
38903733843,38903733841,-2,984,2843,30
38908953167,38908953165,-2,1374,2647,30
38914578515,38914578513,-2,947,1989,30
38915001198,38915001191,-7,1066,2986,30
38915907314,38915907310,-4,1497,2735,30
38922969303,38922969299,-4,1061,2208,30
38928530411,38928530408,-3,646,3156,30
38930077772,38930077768,-4,1328,3096,30
38931121830,38931121826,-4,832,2446,30
38931178874,38931178888,14,240,889,30
38933284385,38933284381,-4,1070,2423,30
38934080087,38934080082,-5,876,2318,30
38934586670,38934586665,-5,903,2815,30
38935514926,38935514938,12,15549,6000,30
38936310654,38936310650,-4,793,2871,30
38936480839,38936480833,-6,1033,3137,30
38937669106,38937669101,-5,761,1979,30
38938923314,38938923317,3,1290,1109,30
38939107818,38939107815,-3,905,3399,30
38939740003,38939740019,16,781,3324,30
38940969099,38940969094,-5,713,2631,30
38942697419,38942697413,-6,782,2462,30
38942776258,38942776237,-21,1064,3144,30
38944022604,38944022615,11,936,2025,30
38945650188,38945650180,-8,877,2814,30
38945919119,38945919114,-5,1223,2494,30
38948143502,38948143501,-1,6247,12913,30
38948368295,38948368291,-4,874,2024,30
38949210219,38949210213,-6,843,2626,30
38953100665,38953100670,5,1813,1057,30
38955109895,38955109889,-6,1089,2222,30
38955424315,38955424333,18,159,1055,30
38960073191,38960073186,-5,921,2854,30
38960451114,38960451110,-4,1033,4309,30
38965151959,38965151953,-6,796,3392,30
38966276902,38966276898,-4,579,2049,30
38969103962,38969103959,-3,1367,3104,30
38970552611,38970552610,-1,1043,1621,30
38972063054,38972063050,-4,1046,3161,30
38977543331,38977543332,1,1738,2585,30
38979723409,38979723402,-7,900,2478,30
38981485900,38981485909,9,142,836,30
38982905018,38982905022,4,1775,1512,30
38984530194,38984530189,-5,1004,2818,30
38986605448,38986605444,-4,1318,3686,30
38992132950,38992132943,-7,1093,3411,30
38997236682,38997236677,-5,828,2228,30
38997791142,38997791138,-4,1088,2644,30
39001100193,39001100189,-4,1724,3223,30
39012371710,39012371709,-1,905,1454,30
39014564315,39014564310,-5,1226,3655,30
39015298184,39015298181,-3,1536,2238,30
39016473123,39016473119,-4,1177,2414,30
39017273692,39017273709,17,453,3023,30
39017488881,39017488876,-5,1714,3108,30
39018489845,39018489842,-3,1168,3164,30
39018584522,39018584538,16,681,1587,30
39020625966,39020625961,-5,1037,3287,30
39023230181,39023230177,-4,922,2984,30
39023914430,39023914447,17,232,1040,30
39024906810,39024906805,-5,869,2976,30
39025754176,39025754166,-10,595,2017,30
39031056655,39031056652,-3,22774,6585,30
39031498669,39031498665,-4,1311,3209,30
39033333195,39033333189,-6,907,3216,30
39033959077,39033959081,4,3468,1869,30
39048381662,39048381656,-6,1096,4223,30
39048687392,39048687414,22,346,1020,30
39049709235,39049709212,-23,1359,2395,30
39052162042,39052162038,-4,1180,2785,30
39061658362,39061658359,-3,1360,2948,30
39066355685,39066355681,-4,1356,2314,30
39077158426,39077158431,5,1666,947,30
39077952290,39077952296,6,1649,1100,30
39078250086,39078250093,7,10252,39514,30
39088891307,39088891302,-5,933,2463,30
39089047870,39089047865,-5,837,3103,30
39089444659,39089444679,20,62,1332,30
39091052847,39091052843,-4,1087,2119,30
39095119570,39095119570,0,1112,1762,30
39100561445,39100561441,-4,1184,3288,30
39100848697,39100848716,19,834,3182,30
39101060825,39101060822,-3,1104,3289,30
39104577336,39104577332,-4,597,2278,30
39104770128,39104770133,5,219,1758,30
39105464172,39105464177,5,4316,2470,30
39105751735,39105751734,-1,767,1688,30
39109190086,39109190080,-6,966,2061,30
39110928975,39110928974,-1,873,1003,30
39113114662,39113114663,1,2851,2598,30
39113348926,39113348921,-5,1024,1515,30
39115969489,39115969485,-4,640,2355,30
39118997324,39118997321,-3,1322,2390,30
39126034455,39126034449,-6,1060,3199,30
39130912393,39130912387,-6,1810,10585,30
39131039627,39131039624,-3,1025,2823,30
39131267930,39131267930,0,1464,1646,30
39133135653,39133135648,-5,927,2877,30
39133607067,39133607063,-4,1130,3633,30
39145819702,39145819698,-4,817,2622,30
39149477186,39149477180,-6,828,2827,30
39152828739,39152828735,-4,931,2614,30
39153250575,39153250570,-5,876,2718,30
39163333712,39163333722,10,56,684,30
39165434302,39165434296,-6,1004,2459,30
39167201722,39167201717,-5,1595,4452,30
39171433150,39171433146,-4,1001,2506,30
39174077378,39174077373,-5,898,3688,30
39174231290,39174231306,16,518,1976,30
39179709663,39179709659,-4,498,2072,30
39183971346,39183971350,4,2839,1749,30
39186015302,39186015297,-5,1071,2514,30
39188912386,39188912381,-5,830,1688,30
39189398879,39189398874,-5,1352,3242,30
39189680464,39189680445,-19,908,2508,30
39190010200,39190010199,-1,170,951,30
39195051258,39195051254,-4,1035,3106,30
39195306661,39195306665,4,2140,2070,30
39195543766,39195543787,21,17426,45331,30
39202762132,39202762125,-7,1126,3827,30
39203764300,39203764313,13,1011,2494,30
39206286218,39206286215,-3,535,1103,30
39207136586,39207136582,-4,1091,2964,30
39207401523,39207401525,2,340,1029,30
39213258662,39213258660,-2,1012,1659,30
39220295220,39220295215,-5,917,3127,30
39224521126,39224521121,-5,1094,3265,30
39225783313,39225783319,6,33261,37937,30
39226677092,39226677097,5,7866,24061,30
39235988255,39235988250,-5,864,2968,30
39236427774,39236427770,-4,693,1951,30
39241496310,39241496305,-5,1499,3674,30
39243587499,39243587478,-21,1049,2606,30
39260137611,39260137604,-7,391,1862,30
39263787090,39263787089,-1,905,1806,30
39264075866,39264075861,-5,775,1800,30
39269451727,39269451722,-5,913,2650,30
39273481857,39273481860,3,2360,1095,30
39279795771,39279795766,-5,1383,3201,30
39280695234,39280695250,16,426,1435,30
39281465705,39281465712,7,4043,2611,30
39283427618,39283427621,3,1381,1287,30
39283606026,39283606012,-14,3807,2105,30
39294857186,39294857182,-4,1113,2807,30
39296402425,39296402425,0,3344,3741,30
39317364546,39317364545,-1,1350,2489,30
39317527785,39317527780,-5,1367,3238,30
39320156676,39320156698,22,1031,1786,30
39322675762,39322675756,-6,1189,3696,30
39324105919,39324105925,6,2810,1855,30
39326728512,39326728506,-6,1197,2912,30
39328634946,39328634946,0,730,1714,30
39332421342,39332421342,0,1067,1415,30
39336335061,39336335056,-5,1379,3294,30
39340484323,39340484314,-9,589,5386,30
39341541398,39341541417,19,5629,1476,30
39343006342,39343006340,-2,919,2288,30
39347144890,39347144887,-3,1005,2959,30
39348785759,39348785759,0,980,1190,30
39349482354,39349482355,1,4298,17057,30
39351195902,39351195897,-5,835,2379,30
39352357638,39352357632,-6,1098,2945,30
39355706275,39355706279,4,2894,1760,30
39357009725,39357009721,-4,1531,3553,30
39362273286,39362273281,-5,1283,3491,30
39365539538,39365539518,-20,805,1949,30
39365856375,39365856370,-5,1029,3353,30
39367823314,39367823309,-5,1171,2319,30
39368161208,39368161229,21,201,1634,30
39376269965,39376269961,-4,1215,2656,30
39377900704,39377900705,1,1757,1467,30
39379292523,39379292518,-5,1050,2770,30
39380011963,39380011957,-6,1048,2791,30
39382133870,39382133861,-9,908,2954,30
39384096655,39384096651,-4,1130,3343,30
39394734211,39394734206,-5,1148,2875,30
39397106198,39397106192,-6,2121,5758,30
39399408543,39399408538,-5,873,2902,30
39399690033,39399690027,-6,1436,3412,30
39403713456,39403713450,-6,1156,3657,30
39404298075,39404298093,18,330,1967,30
39404821571,39404821570,-1,2824,3965,30
39412052762,39412052759,-3,1120,3343,30
39412377275,39412377272,-3,1159,3287,30
39413296710,39413296702,-8,656,5604,30
39413791996,39413792012,16,1078,4150,30
39416290110,39416290110,0,1507,2151,30
39421091062,39421091062,0,1196,1830,30
39422258098,39422258093,-5,1118,2382,30
39423153850,39423153845,-5,1258,3941,30
39429673455,39429673461,6,3453,1249,30
39432340486,39432340478,-8,1434,3710,30
39442120632,39442120627,-5,1039,3897,30
39447722466,39447722461,-5,1531,6214,30
39447888895,39447888889,-6,900,3211,30
39454620717,39454620721,4,1692,1759,30
39455342913,39455342909,-4,1066,2823,30
39455653906,39455653903,-3,1112,2994,30
39462279613,39462279609,-4,1227,2654,30
39462689506,39462689502,-4,1233,3410,30
39466576602,39466576596,-6,1083,3265,30
39476152595,39476152590,-5,947,3594,30
39477434761,39477434757,-4,1075,3148,30
39477595926,39477595920,-6,1191,2418,30
39477793663,39477793660,-3,1077,2325,30
39480425316,39480425309,-7,729,2367,30
39481186232,39481186254,22,566,4447,30
39482036474,39482036469,-5,1359,3756,30
39485682064,39485682058,-6,794,2677,30
39500391027,39500391022,-5,815,2888,30
39500939929,39500939922,-7,95,817,30
39511184533,39511184526,-7,991,5029,30
39515860174,39515860171,-3,1188,2541,30
39516428800,39516428782,-18,657,1545,30
39517123793,39517123788,-5,1309,2849,30
39527163651,39527163647,-4,1253,4184,30
39527403291,39527403306,15,624,2336,30
39528344771,39528344765,-6,1220,3770,30
39529105273,39529105269,-4,980,2615,30
39529348450,39529348445,-5,1038,4501,30
39531118784,39531118778,-6,1088,3774,30
39532711057,39532711050,-7,917,2290,30
39538820298,39538820293,-5,1250,3324,30
39544710771,39544710765,-6,1042,2383,30
39545947514,39545947534,20,633,3342,30
39547116650,39547116647,-3,853,2772,30
39557672122,39557672117,-5,1349,3071,30
39563905274,39563905277,3,2124,2191,30
39564369371,39564369366,-5,992,3667,30
39565893670,39565893665,-5,1172,3494,30
39568817394,39568817389,-5,1167,2889,30
39573725083,39573725078,-5,1143,3184,30
39575045282,39575045278,-4,1703,2253,30
39580277194,39580277188,-6,1041,5123,30
39582477698,39582477693,-5,851,2306,30
39584566154,39584566150,-4,967,2771,30
39585471914,39585471918,4,2461,2041,30
39591915203,39591915202,-1,1438,3580,30
39591998553,39591998574,21,467,1242,30
39592344960,39592344956,-4,1279,3699,30
39596736107,39596736116,9,11573,28175,30
39606508757,39606508753,-4,975,2451,30
39606866089,39606866109,20,644,1903,30
39614684858,39614684850,-8,1274,3185,30
39616990670,39616990668,-2,1020,2538,30
39619971110,39619971107,-3,1206,3023,30
39623537063,39623537059,-4,876,1643,30
39634164302,39634164307,5,2618,1222,30
39641099607,39641099603,-4,786,1970,30
39641615939,39641615935,-4,1072,2373,30
39645426950,39645426938,-12,1860,594,30
39648196343,39648196338,-5,834,2123,30
39648407897,39648407918,21,225,1246,30
39653166625,39653166621,-4,1107,3311,30
39658020138,39658020150,12,10531,43883,30
39661384073,39661384066,-7,1339,4114,30
39662718321,39662718322,1,1623,1300,30
39666178822,39666178817,-5,965,3024,30
39668513225,39668513223,-2,1932,3180,30
39672795815,39672795810,-5,1340,3086,30
39674548314,39674548310,-4,1134,3291,30
39676036084,39676036079,-5,1151,2004,30
39679500434,39679500428,-6,1319,3891,30
39683631798,39683631793,-5,1175,2849,30
39685232428,39685232440,12,139,989,30
39685684509,39685684507,-2,1123,1732,30
39695620150,39695620151,1,1371,1407,30
39695723273,39695723289,16,27,858,30
39696141403,39696141399,-4,593,2623,30
39703889072,39703889078,6,2212,1604,30
39706326065,39706326061,-4,939,2094,30
39706688866,39706688863,-3,676,3143,30
39711410989,39711410983,-6,804,3189,30
39716813397,39716813393,-4,931,1984,30
39723088199,39723088193,-6,1408,4834,30
39724051633,39724051633,0,909,984,30
39726264710,39726264707,-3,807,2478,30
39727814510,39727814506,-4,1048,2548,30
39729971062,39729971058,-4,1519,3513,30
39732243646,39732243645,-1,1582,2910,30
39737678107,39737678101,-6,1262,4451,30
39739952016,39739952020,4,1269,601,30
39740632409,39740632405,-4,1035,3704,30
39741600566,39741600561,-5,1198,3805,30
39753122513,39753122507,-6,1222,2222,30
39756268007,39756268005,-2,908,1794,30
39757755799,39757755794,-5,1632,3191,30
39764147446,39764147442,-4,1055,2612,30
39768434969,39768434964,-5,1253,3093,30
39771538802,39771538799,-3,1345,2254,30
39772829715,39772829710,-5,599,2391,30
39776322209,39776322203,-6,1068,2846,30
39781119149,39781119141,-8,927,6696,30
39781355760,39781355778,18,167,712,30
39783900339,39783900334,-5,907,1941,30
39784901880,39784901887,7,30,970,30
39791335258,39791335253,-5,703,1855,30
39791877587,39791877606,19,4839,7573,30
39793917278,39793917272,-6,1448,6808,30
39794297598,39794297602,4,1849,1568,30
39796087146,39796087142,-4,452,2127,30
39797223222,39797223219,-3,920,2236,30
39797696045,39797696041,-4,699,1787,30
39798504222,39798504218,-4,1136,2549,30
39805165240,39805165234,-6,1412,3879,30
39813494858,39813494854,-4,800,1724,30
39820285269,39820285273,4,3267,2178,30
39821683189,39821683209,20,309,953,30
39825302253,39825302249,-4,1238,3913,30
39827688217,39827688212,-5,1012,3149,30
39828007778,39828007791,13,1,581,30
39832923947,39832923944,-3,1202,2207,30
39834723561,39834723560,-1,1160,2067,30
39834834434,39834834427,-7,1046,5198,30
39839086135,39839086130,-5,937,2544,30
39845648971,39845648966,-5,1177,3389,30
39850569935,39850569931,-4,906,2414,30
39854687751,39854687747,-4,1067,2041,30
39856829743,39856829737,-6,1040,2656,30
39869750415,39869750411,-4,2654,6249,30
39870620970,39870620965,-5,1130,2204,30
39870706336,39870706353,17,695,2350,30
39884839215,39884839214,-1,2188,3666,30
39891493594,39891493589,-5,555,2277,30
39893033633,39893033629,-4,886,2465,30
39894737266,39894737261,-5,1000,1944,30
39895582975,39895582974,-1,795,1863,30
39895877201,39895877198,-3,861,2182,30
39899274234,39899274230,-4,966,1844,30
39900910164,39900910159,-5,1129,3273,30
39901868690,39901868686,-4,1173,2888,30
39905352755,39905352752,-3,1254,2706,30
39905864871,39905864866,-5,855,2733,30
39910624419,39910624415,-4,1174,3065,30
39916394125,39916394121,-4,1007,2704,30
39917710166,39917710162,-4,530,2117,30
39917806185,39917806202,17,1095,2527,30
39920990012,39920990006,-6,913,3129,30
39924693978,39924693974,-4,1350,2978,30
39925053510,39925053505,-5,1159,4159,30
39925263305,39925263311,6,22636,32666,30
39928918555,39928918558,3,2773,1600,30
39929915561,39929915555,-6,1638,3725,30
39929943594,39929943585,-9,11032,84503,30
39930616161,39930616157,-4,630,2071,30
39932287546,39932287566,20,1540,1036,30
39932764639,39932764637,-2,1485,2460,30
39937207291,39937207286,-5,34871,21680,30
39940055397,39940055390,-7,810,3576,30
39945649367,39945649361,-6,647,7394,30
39946335870,39946335866,-4,1388,2848,30
39949926642,39949926637,-5,1014,2729,30
39954858796,39954858792,-4,1274,2553,30
39957892417,39957892410,-7,819,2208,30
39958183756,39958183774,18,171,1082,30
39959988327,39959988329,2,1566,2064,30
39966063144,39966063137,-7,1263,2907,30
39973989330,39973989335,5,2562,1425,30
39974329028,39974329036,8,3466,1536,30
39975896195,39975896189,-6,1362,3854,30
39976640530,39976640528,-2,890,2327,30
39982267881,39982267877,-4,1159,3198,30
39982382865,39982382861,-4,221,1302,30
39988717541,39988717537,-4,1295,3104,30
39989179106,39989179101,-5,1079,2854,30
39990287849,39990287854,5,2069,1136,30
39995300702,39995300700,-2,1139,2139,30
39996035362,39996035362,0,112,836,30
39998174602,39998174598,-4,1108,2522,30
40001516426,40001516423,-3,1110,2582,30
40008751843,40008751846,3,2674,2505,30
40009556535,40009556532,-3,1240,2946,30
40012361762,40012361757,-5,829,2133,30
40014515421,40014515421,0,1422,2237,30
40016378039,40016378034,-5,1042,2759,30
40017188960,40017188962,2,1611,1235,30
40018644395,40018644391,-4,946,2380,30
40018695806,40018695802,-4,1076,1794,30
40019343211,40019343207,-4,1333,2773,30
40019623674,40019623670,-4,1420,3233,30
40022651894,40022651889,-5,991,2796,30
40026640834,40026640838,4,4614,2967,30
40029651235,40029651232,-3,1057,2524,30
40030122062,40030122058,-4,1003,1768,30
40032288762,40032288763,1,1967,1857,30
40035307170,40035307187,17,11652,48719,30
40043711384,40043711378,-6,607,2123,30
40049950241,40049950247,6,2820,1341,30
40054024242,40054024236,-6,1157,2620,30
40054184065,40054184062,-3,1188,2481,30
40054280681,40054280674,-7,904,1726,30
40056993291,40056993287,-4,1134,3711,30
40057887295,40057887291,-4,1200,3912,30
40058382170,40058382166,-4,691,2632,30
40071386471,40071386465,-6,1094,2787,30
40071660680,40071660673,-7,1094,6294,30
40072986464,40072986463,-1,323,1065,30
40078827014,40078827020,6,1795,1189,30
40081721162,40081721157,-5,1035,3136,30
40085102105,40085102107,2,2087,1834,30
40085571367,40085571362,-5,1308,3127,30
40088356506,40088356501,-5,1004,2892,30
40088895644,40088895647,3,2565,1187,30
40090641282,40090641278,-4,1044,2361,30
40092934950,40092934966,16,408,1563,30
40098621730,40098621724,-6,1500,2993,30
40098827392,40098827399,7,3372,1099,30
40104338376,40104338370,-6,1200,3605,30
40105345545,40105345539,-6,1255,3157,30
40106392541,40106392548,7,5543,2163,30
40109442418,40109442413,-5,686,3332,30
40110232044,40110232054,10,384,1433,30
40111423345,40111423340,-5,912,2438,30
40111927977,40111927973,-4,605,2827,30
40113971865,40113971861,-4,1135,3102,30
40122651247,40122651241,-6,1096,2550,30
40123098675,40123098694,19,1468,4000,30
40123197210,40123197230,20,1202,3213,30
40127683258,40127683256,-2,818,1602,30
40132273243,40132273238,-5,1334,2335,30
40137386547,40137386544,-3,980,2299,30
40137500091,40137500082,-9,715,2521,30
40141118814,40141118809,-5,837,3887,30
40141314913,40141314934,21,766,2951,30
40142334039,40142334032,-7,1234,5048,30
40145190671,40145190666,-5,1013,2269,30
40145662001,40145662022,21,589,1470,30
40150812175,40150812170,-5,1029,2650,30
40151324123,40151324122,-1,1165,1530,30
40153221159,40153221163,4,20317,21765,30
40157419703,40157419699,-4,850,1816,30
40167012475,40167012474,-1,812,2054,30
40170270285,40170270284,-1,1436,1964,30
40171472626,40171472621,-5,1029,3378,30
40171532279,40171532274,-5,950,3031,30
40172035674,40172035694,20,25,1041,30
40175021358,40175021358,0,1104,2591,30
40175519900,40175519905,5,4564,3188,30
40175612483,40175612477,-6,1134,3498,30
40176049593,40176049578,-15,1354,4616,30
40189599915,40189599908,-7,1148,4129,30
40195169745,40195169740,-5,932,1945,30
40195976643,40195976640,-3,849,2235,30
40212559789,40212559783,-6,1101,2501,30
40214436503,40214436498,-5,708,1687,30
40214580535,40214580532,-3,1342,3813,30
40216749972,40216749972,0,1527,1912,30
40217984414,40217984409,-5,1269,4045,30
40220334150,40220334146,-4,1208,2415,30
40223308736,40223308718,-18,830,2088,30
40224918390,40224918385,-5,1006,2672,30
40230827677,40230827695,18,1046,1256,30
40236367122,40236367119,-3,889,2291,30
40242343636,40242343630,-6,266,790,30
40243866810,40243866805,-5,657,1420,30
40245715620,40245715619,-1,198,5157,30
40246938494,40246938490,-4,750,2387,30
40246997188,40246997191,3,2235,1837,30
40248266536,40248266534,-2,1049,2991,30
40249790331,40249790329,-2,1095,2094,30
40255298119,40255298113,-6,604,2981,30
40259994831,40259994829,-2,1274,2525,30
40262961123,40262961119,-4,1061,2842,30
40265090047,40265090042,-5,910,2373,30
40268109198,40268109194,-4,1180,3437,30
40268377379,40268377374,-5,1127,2690,30
40278380426,40278380419,-7,880,3693,30
40278511684,40278511697,13,1367,4133,30
40283809573,40283809567,-6,1097,3147,30
40283928777,40283928797,20,257,967,30
40290854635,40290854629,-6,993,2557,30
40294033933,40294033938,5,4367,2035,30
40294088375,40294088369,-6,1194,3254,30
40299449033,40299449026,-7,993,2499,30
40302464634,40302464633,-1,1027,2148,30
40305855033,40305855029,-4,863,2747,30
40306006688,40306006682,-6,366,688,30
40310124359,40310124355,-4,885,2199,30
40311001066,40311001066,0,690,1162,30
40316200096,40316200091,-5,1170,3442,30
40319323158,40319323154,-4,884,1210,30
40319864246,40319864242,-4,1045,1679,30
40320061233,40320061234,1,175,910,30
40321678770,40321678773,3,3281,2331,30
40322122862,40322122863,1,1090,1096,30
40323114869,40323114866,-3,798,2276,30
40324571997,40324571992,-5,1081,3774,30
40332317865,40332317865,0,2265,3518,30
40334015500,40334015496,-4,2199,5308,30
40335419366,40335419361,-5,792,2434,30
40336106049,40336106047,-2,546,1488,30
40338390672,40338390668,-4,1200,2202,30
40344029309,40344029305,-4,1132,2854,30
40351173103,40351173098,-5,1391,3880,30
40354086030,40354086026,-4,1040,3056,30
40354328577,40354328572,-5,1555,2813,30
40354520189,40354520185,-4,1277,2687,30
40358763059,40358763054,-5,1020,3312,30
40360252243,40360252238,-5,1374,3654,30
40360303979,40360303977,-2,2246,3886,30
40362854647,40362854642,-5,1065,3175,30
40362990936,40362990919,-17,1387,3170,30
40363674866,40363674866,0,3049,3461,30
40363830234,40363830230,-4,818,3768,30
40364676812,40364676809,-3,1019,3087,30
40366041243,40366041238,-5,976,2578,30
40366260768,40366260784,16,683,2807,30
40381113215,40381113209,-6,664,3208,30
40381384145,40381384157,12,155,861,30
40382651538,40382651534,-4,950,2813,30
40389120976,40389120974,-2,1279,3291,30
40389729868,40389729862,-6,657,1050,30
40390262482,40390262489,7,6280,2520,30
40392384622,40392384617,-5,1025,2931,30
40396841025,40396841026,1,2144,1673,30
40401098582,40401098578,-4,597,2243,30
40403248146,40403248146,0,1633,2097,30
40408805995,40408805990,-5,800,2093,30
40409437650,40409437633,-17,926,2822,30
40409979795,40409979790,-5,1067,2523,30
40412393181,40412393184,3,1116,1209,30
40414171697,40414171713,16,317,938,30
40418688000,40418687994,-6,783,2519,30
40426410937,40426410933,-4,879,2191,30
40434027830,40434027826,-4,1256,3322,30
40437689466,40437689462,-4,1263,3603,30
40438039562,40438039562,0,192,993,30
40438302594,40438302589,-5,865,2515,30
40440967670,40440967668,-2,932,3358,30
40441975827,40441975834,7,2218,1080,30
40463758941,40463758938,-3,1044,3347,30
40464285042,40464285043,1,1288,1716,30
40466411430,40466411425,-5,1489,4093,30
40468608146,40468608143,-3,819,2206,30
40476334395,40476334390,-5,509,2151,30
40491612881,40491612878,-3,1141,3088,30
40491674592,40491674586,-6,1130,2790,30
40491972374,40491972370,-4,1315,3266,30
40497636246,40497636246,0,1514,1807,30
40503142775,40503142771,-4,999,2806,30
40503880171,40503880156,-15,965,2892,30
40504504819,40504504818,-1,238,1190,30
40515439339,40515439334,-5,878,3042,30
40516951503,40516951501,-2,763,1799,30
40518424733,40518424728,-5,934,3123,30
40518509568,40518509591,23,606,1683,30
40518623170,40518623166,-4,854,1873,30
40520388258,40520388259,1,2035,2246,30
40522178784,40522178786,2,1964,1828,30
40532352918,40532352923,5,1727,961,30
40534394225,40534394220,-5,1212,3110,30
40535878337,40535878332,-5,1225,1830,30
40538899203,40538899191,-12,25938,16878,30
40541665130,40541665124,-6,1511,3267,30
40542247375,40542247370,-5,923,3037,30
40545194118,40545194118,0,1498,2112,30
40548028782,40548028778,-4,1355,2471,30
40548154709,40548154708,-1,788,1895,30
40548427707,40548427726,19,49,951,30
40549086582,40549086577,-5,676,3087,30
40553977349,40553977345,-4,722,2600,30
40560895734,40560895731,-3,686,3297,30
40568097595,40568097594,-1,1313,2422,30
40570566713,40570566707,-6,849,2414,30
40573013693,40573013688,-5,1537,3009,30
40578297082,40578297077,-5,1161,2787,30
40588887922,40588887918,-4,1021,3160,30
40595895155,40595895153,-2,990,3147,30
40596436811,40596436802,-9,968,3947,30
40596831801,40596831794,-7,1554,4745,30
40603366626,40603366622,-4,959,3583,30
40605562453,40605562447,-6,1286,3494,30
40607902235,40607902230,-5,861,2288,30
40618631473,40618631476,3,1325,1575,30
40621739462,40621739457,-5,866,2893,30
40622480026,40622480041,15,483,1152,30
40631748590,40631748586,-4,1088,3266,30
40633008658,40633008664,6,15849,7141,30
40640477261,40640477241,-20,755,1625,30
40642004071,40642004067,-4,1358,2574,30
40642083064,40642083071,7,2257,1213,30
40646692846,40646692842,-4,833,1969,30
40648112278,40648112275,-3,1272,2693,30
40657137194,40657137190,-4,1226,4309,30
40658172975,40658172970,-5,895,2106,30
40661430954,40661430950,-4,1271,2160,30
40668795370,40668795364,-6,1111,2619,30
40670434172,40670434167,-5,1046,2223,30
40672418080,40672418084,4,1984,1709,30
40674346539,40674346539,0,1186,1996,30
40676484055,40676484054,-1,997,2152,30
40677158793,40677158787,-6,1127,3529,30
40684173002,40684173006,4,1907,1162,30
40684750049,40684750044,-5,698,2589,30
40687625261,40687625255,-6,957,3510,30
40691924385,40691924382,-3,886,3555,30
40694874163,40694874160,-3,1104,3617,30
40698141817,40698141811,-6,1019,3380,30
40698970148,40698970141,-7,961,2557,30
40699399834,40699399829,-5,663,3003,30
40700930503,40700930501,-2,903,2229,30
40702256281,40702256275,-6,1020,2370,30
40702396245,40702396240,-5,1376,5240,30
40707265510,40707265507,-3,1103,2239,30
40711967197,40711967192,-5,1117,2762,30
40712987583,40712987578,-5,941,3867,30
40714024085,40714024080,-5,1377,3972,30
40717436416,40717436418,2,32566,23739,30
40718702205,40718702201,-4,983,1834,30
40720803895,40720803890,-5,1043,3369,30
40720944573,40720944574,1,1474,1125,30
40722323833,40722323826,-7,933,2874,30
40723946315,40723946310,-5,1161,3025,30
40725838501,40725838495,-6,1096,4358,30
40731059558,40731059565,7,2401,1415,30
40732076067,40732076067,0,1163,1301,30
40735467502,40735467497,-5,1068,2367,30
40739527580,40739527574,-6,1088,3211,30
40744312477,40744312472,-5,1421,3507,30
40752677429,40752677426,-3,1238,3086,30
40759473015,40759473009,-6,1212,2898,30
40761771842,40761771842,0,1669,2057,30
40761963408,40761963402,-6,1182,3163,30
40765339403,40765339403,0,1164,1111,30
40767383150,40767383145,-5,743,1898,30
40772532980,40772532975,-5,1531,2849,30
40779690649,40779690644,-5,1080,2470,30
40781767679,40781767675,-4,935,2524,30
40785891294,40785891291,-3,1011,2626,30
40788214994,40788214994,0,1029,1344,30
40790111267,40790111270,3,2263,1426,30
40793076409,40793076405,-4,1315,3389,30
40795479044,40795479040,-4,1007,3497,30
40798361539,40798361533,-6,39893,28540,30
40799556870,40799556874,4,2765,2028,30
40803798459,40803798453,-6,732,2883,30
40803825855,40803825851,-4,1155,2597,30
40804661554,40804661550,-4,1604,3492,30
40815898444,40815898451,7,3273,1360,30
40820321691,40820321691,0,1607,2560,30
40821348082,40821348079,-3,765,1807,30
40823404378,40823404374,-4,1050,2398,30
40825454871,40825454866,-5,1061,3040,30
40826255205,40826255209,4,35485,23839,30
40828911102,40828911100,-2,840,2184,30
40829640621,40829640617,-4,1321,3021,30
40830027664,40830027658,-6,141,1090,30
40830513840,40830513835,-5,709,1774,30
40833477199,40833477193,-6,677,1616,30
40833733540,40833733558,18,809,1791,30
40834561986,40834561983,-3,783,2646,30
40837432381,40837432386,5,4429,3014,30
40838713353,40838713350,-3,557,1662,30
40841103746,40841103762,16,313,1153,30
40850058387,40850058382,-5,933,2233,30
40850345115,40850345119,4,262,875,30
40853075502,40853075498,-4,1616,2557,30
40854563424,40854563417,-7,2278,9618,30
40868301906,40868301914,8,3017,1021,30
40870929008,40870929006,-2,1040,2132,30
40872083854,40872083850,-4,1167,2968,30
40888039502,40888039497,-5,743,2389,30
40891603974,40891603970,-4,762,2600,30
40902963950,40902963946,-4,723,2671,30
40907680909,40907680903,-6,1353,3641,30
40911000721,40911000718,-3,997,2583,30
40915285414,40915285410,-4,913,2712,30
40917377231,40917377225,-6,827,2999,30
40917695537,40917695534,-3,987,2666,30
40921527414,40921527406,-8,845,3232,30
40926295502,40926295496,-6,915,1643,30
40926867977,40926867972,-5,876,2550,30
40927380779,40927380775,-4,1175,3111,30
40927470900,40927470898,-2,469,1336,30
40927864994,40927864991,-3,656,1428,30
40930939557,40930939556,-1,1040,2217,30
40931282441,40931282455,14,328,1110,30
40932822910,40932822905,-5,859,2689,30
40938689478,40938689473,-5,832,1624,30
40939326186,40939326181,-5,1247,3642,30
40949020943,40949020943,0,1110,1540,30
40949582259,40949582254,-5,1165,3064,30
40952360131,40952360128,-3,808,2335,30
40952554172,40952554189,17,656,2803,30
40955492993,40955492987,-6,1257,2833,30
40961737293,40961737314,21,16581,31534,30
40962181383,40962181378,-5,1350,3077,30
40962333314,40962333311,-3,3122,4511,30
40963564059,40963564062,3,1072,1303,30
40969165531,40969165527,-4,776,2202,30
40972730324,40972730319,-5,731,2503,30
40974365918,40974365913,-5,1039,2662,30
40978883139,40978883132,-7,1451,3725,30
40992548758,40992548757,-1,1180,2149,30
40993336121,40993336118,-3,1209,3125,30
40995378146,40995378125,-21,1236,1565,30
41001470648,41001470669,21,523,1286,30
41001930772,41001930770,-2,1061,2250,30
41004275428,41004275426,-2,893,2302,30
41004894686,41004894686,0,1992,2113,30
41009891078,41009891074,-4,906,2827,30
41012429334,41012429330,-4,1160,3853,30
41015469115,41015469126,11,15213,31927,30
41016033408,41016033405,-3,1078,3201,30
41019492007,41019492003,-4,1004,4737,30
41020217666,41020217676,10,144,975,30
41024089914,41024089910,-4,1207,4240,30
41024787091,41024787068,-23,730,2289,30
41026195625,41026195621,-4,1283,2345,30
41026510662,41026510657,-5,929,2538,30
41027184191,41027184185,-6,2603,9632,30
41028118543,41028118539,-4,977,3212,30
41028161953,41028161950,-3,1177,2172,30
41031425571,41031425566,-5,1335,2940,30
41032686311,41032686305,-6,812,3064,30
41033150875,41033150865,-10,103,1125,30
41034288079,41034288062,-17,309,910,30
41035123252,41035123269,17,811,1641,30
41035674202,41035674198,-4,925,2524,30
41040909814,41040909810,-4,1150,2855,30
41045125675,41045125683,8,2923,1383,30
41049269118,41049269113,-5,1121,2844,30
41049429744,41049429726,-18,1100,3043,30
41050830576,41050830572,-4,1176,2323,30
41053647351,41053647345,-6,978,1978,30
41056802170,41056802169,-1,3225,3916,30
41057935731,41057935727,-4,867,1978,30
41063283407,41063283404,-3,754,1809,30
41074881282,41074881278,-4,899,1908,30
41076302318,41076302314,-4,905,2439,30
41077130499,41077130496,-3,746,2530,30
41081297234,41081297229,-5,1122,2620,30
41087664698,41087664691,-7,1175,2576,30
41088370323,41088370302,-21,1023,4533,30
41092081887,41092081882,-5,1181,3731,30
41092412240,41092412220,-20,891,2180,30
41094628701,41094628695,-6,1121,3540,30
41099024677,41099024673,-4,1077,2188,30
41101783609,41101783605,-4,1012,3093,30
41103580862,41103580859,-3,1360,3117,30
41106649130,41106649126,-4,1003,2477,30
41110049535,41110049526,-9,1066,4055,30
41110675426,41110675443,17,1344,2909,30
41115761980,41115761974,-6,1300,3438,30
41125868002,41125867998,-4,1123,3586,30
41127465887,41127465883,-4,951,1670,30
41131604048,41131604042,-6,860,2413,30
41131819318,41131819314,-4,5712,13824,30
41133883051,41133883046,-5,941,2880,30
41136548399,41136548386,-13,10384,38472,30
41140109799,41140109796,-3,982,2759,30
41140646435,41140646430,-5,1221,3258,30
41141762758,41141762757,-1,1276,2425,30
41146326930,41146326929,-1,1821,2853,30
41149833471,41149833465,-6,1246,3735,30
41153522959,41153522955,-4,632,1784,30
41165953518,41165953515,-3,580,1421,30
41167687983,41167687979,-4,818,1938,30
41169732561,41169732559,-2,955,3616,30
41172215034,41172215031,-3,1760,3824,30
41185824411,41185824421,10,2506,1033,30
41188162171,41188162166,-5,1408,3026,30
41193459698,41193459694,-4,904,1997,30
41203553220,41203553216,-4,770,1921,30
41205723306,41205723302,-4,885,2490,30
41209243708,41209243701,-7,995,2358,30
41211715307,41211715303,-4,1105,3476,30
41213010701,41213010703,2,48382,29608,30
41213129056,41213129052,-4,1205,3028,30
41213418122,41213418126,4,1356,2682,30
41217595364,41217595362,-2,1536,2529,30
41220666783,41220666785,2,1039,1118,30
41222028569,41222028565,-4,1061,3134,30
41224487050,41224487046,-4,850,2066,30
41224780690,41224780709,19,527,1209,30
41226285901,41226285897,-4,1130,3317,30
41228867061,41228867057,-4,662,1361,30
41229339931,41229339912,-19,1005,3996,30
41237184030,41237184036,6,4572,2514,30
41238117629,41238117623,-6,1268,3363,30
41238884308,41238884319,11,313,1399,30
41239840493,41239840490,-3,662,1720,30
41240462830,41240462826,-4,687,1945,30
41243037097,41243037092,-5,1257,3689,30
41244606331,41244606327,-4,916,3677,30
41247406247,41247406242,-5,1331,3046,30
41247708332,41247708348,16,713,2766,30
41251697581,41251697574,-7,1043,3218,30
41252104833,41252104828,-5,1040,3588,30
41257243467,41257243456,-11,803,2617,30
41262789815,41262789810,-5,1143,2816,30
41263583942,41263583939,-3,519,1926,30
41264090135,41264090130,-5,1267,2300,30
41264349476,41264349473,-3,998,1842,30
41274930910,41274930914,4,1485,1858,30
41276575511,41276575507,-4,702,2036,30
41277011945,41277011936,-9,397,994,30
41280306428,41280306423,-5,712,2515,30
41284521604,41284521600,-4,1045,2567,30
41285633521,41285633521,0,2166,1958,30
41291405766,41291405760,-6,1152,2676,30
41293140378,41293140377,-1,1184,2525,30
41293772401,41293772396,-5,1541,3669,30
41298027300,41298027306,6,3031,1286,30
41303356199,41303356194,-5,1209,3400,30
41304326441,41304326426,-15,881,2890,30
41306580515,41306580510,-5,924,2144,30
41306980589,41306980583,-6,1210,3024,30
41309793138,41309793135,-3,811,2430,30
41312162223,41312162220,-3,1275,2574,30
41313018805,41313018801,-4,726,3207,30
41315111098,41315111095,-3,1195,3216,30
41315615676,41315615671,-5,1190,2928,30
41315713424,41315713405,-19,743,2262,30
41319485071,41319485067,-4,1187,1687,30
41323658379,41323658374,-5,858,2203,30
41323825785,41323825789,4,2000,1272,30
41332078773,41332078770,-3,1599,4161,30
41333412995,41333412991,-4,1656,3299,30
41341051323,41341051316,-7,1452,2890,30
41343901182,41343901178,-4,1095,2456,30
41345648051,41345648047,-4,1155,2781,30
41348254293,41348254289,-4,1231,3090,30
41349032319,41349032313,-6,874,2406,30
41350567070,41350567065,-5,1135,2963,30
41350929422,41350929418,-4,950,2229,30
41351090614,41351090610,-4,915,4176,30
41352932242,41352932240,-2,702,1823,30
41356539733,41356539730,-3,1260,2399,30
41358546123,41358546116,-7,884,3255,30
41358866401,41358866389,-12,1008,3618,30
41368782226,41368782223,-3,1107,2563,30
41370723670,41370723666,-4,1078,2273,30
41372732949,41372732946,-3,1177,2926,30
41381100698,41381100694,-4,938,2146,30
41381443444,41381443449,5,26,806,30
41383446048,41383446041,-7,729,1205,30
41386995387,41386995381,-6,761,3806,30
41392365150,41392365147,-3,669,1949,30
41392956499,41392956494,-5,880,1946,30
41393696857,41393696855,-2,894,2138,30
41396440530,41396440525,-5,1104,3757,30
41399006635,41399006632,-3,761,1723,30
41401483129,41401483123,-6,954,3075,30
41401572960,41401572983,23,859,1796,30
41401764233,41401764226,-7,1489,9440,30
41405033990,41405033984,-6,991,3019,30
41407276854,41407276850,-4,1139,3103,30
41408298631,41408298628,-3,959,3149,30
41412708766,41412708773,7,2906,1605,30
41415854630,41415854626,-4,1203,3270,30
41418203901,41418203897,-4,427,1239,30
41419460090,41419460095,5,3504,1486,30
41419609498,41419609495,-3,1372,4022,30
41431681875,41431681871,-4,901,2775,30
41436392966,41436392961,-5,18368,66071,30
41439362326,41439362320,-6,1460,3146,30
41444385875,41444385871,-4,1362,3059,30
41451416096,41451416093,-3,1554,3110,30
41463608886,41463608891,5,1397,942,30
41464052673,41464052653,-20,383,1655,30
41464666154,41464666151,-3,1021,2873,30
41466527685,41466527679,-6,997,3490,30
41466626038,41466626033,-5,1267,3222,30
41467569197,41467569193,-4,902,3186,30
41469502317,41469502312,-5,1316,3090,30
41472948382,41472948378,-4,1149,2743,30
41475418437,41475418430,-7,1272,2517,30
41479636479,41479636477,-2,1378,2975,30
41479925504,41479925493,-11,839,3472,30
41480495490,41480495486,-4,1136,2571,30
41480708248,41480708245,-3,95,987,30
41481412289,41481412303,14,694,2728,30
41481738511,41481738515,4,2792,993,30
41486614261,41486614257,-4,1097,3307,30
41491693283,41491693277,-6,1028,2572,30
41496709022,41496709042,20,594,1457,30
41497574615,41497574609,-6,1029,3833,30
41505571422,41505571415,-7,1262,2426,30
41505676179,41505676195,16,1102,3533,30
41510891341,41510891345,4,1649,1314,30
41516978054,41516978050,-4,1117,2793,30
41518962055,41518962048,-7,1122,3533,30
41525773883,41525773882,-1,1482,2156,30
41528665088,41528665082,-6,1298,3225,30
41531509782,41531509778,-4,879,2375,30
41532501726,41532501728,2,1352,1322,30
41537283330,41537283326,-4,1122,2944,30
41538437740,41538437736,-4,789,2260,30
41541846307,41541846302,-5,1230,3392,30
41544748385,41544748380,-5,797,1474,30
41545804632,41545804629,-3,1138,2541,30
41546768111,41546768107,-4,1295,2968,30
41551869364,41551869358,-6,1155,3089,30
41552408560,41552408556,-4,1339,2127,30
41553502937,41553502934,-3,538,2255,30
41555504062,41555504066,4,21924,25572,30
41558119075,41558119070,-5,557,2421,30
41570123179,41570123172,-7,668,3248,30
41572037059,41572037055,-4,1095,2949,30
41572405335,41572405331,-4,1229,3197,30
41575623639,41575623634,-5,911,3690,30
41579006081,41579006074,-7,736,2067,30
41581431935,41581431935,0,2483,2532,30
41581670405,41581670402,-3,887,3077,30
41587373915,41587373910,-5,1191,3026,30
41588391819,41588391812,-7,1304,2862,30
41588506419,41588506438,19,36,984,30
41596683216,41596683211,-5,1283,3018,30
41598825473,41598825471,-2,23298,10704,30
41607275505,41607275523,18,300,1622,30
41613049470,41613049467,-3,721,1681,30
41613561648,41613561631,-17,985,3494,30
41613781468,41613781449,-19,9,948,30
41614656019,41614656015,-4,1317,4259,30
41615431197,41615431195,-2,2351,3966,30
41617635080,41617635081,1,2492,2077,30
41622135770,41622135766,-4,1143,3059,30
41623491733,41623491729,-4,1469,2602,30
41627416687,41627416682,-5,933,3069,30
41633347871,41633347867,-4,927,2410,30
41636378144,41636378141,-3,1345,2106,30
41637636204,41637636220,16,1001,3102,30
41647659707,41647659709,2,1204,938,30
41649688852,41649688861,9,175,641,30
41650594674,41650594670,-4,1152,2835,30
41658978350,41658978348,-2,529,2402,30
41666226770,41666226766,-4,1149,3667,30
41666382072,41666382079,7,199,812,30
41671269127,41671269126,-1,1083,2956,30
41674707337,41674707330,-7,1717,5203,30
41677349775,41677349771,-4,1409,2443,30
41684000093,41684000090,-3,794,2107,30
41685005845,41685005855,10,783,1126,30
41685176084,41685176103,19,249,612,30
41688451402,41688451398,-4,1475,3886,30
41691065259,41691065254,-5,1208,4032,30
41699690449,41699690454,5,2618,1462,30
41706946930,41706946925,-5,1229,3866,30
41709059229,41709059225,-4,841,2332,30
41710526714,41710526715,1,1173,1626,30
41712242785,41712242782,-3,778,1370,30
41712430311,41712430306,-5,3181,7980,30
41713583707,41713583701,-6,898,1869,30
41723450089,41723450088,-1,1416,2766,30
41724006302,41724006306,4,3164,1497,30
41727572785,41727572779,-6,972,2750,30
41737152375,41737152370,-5,1032,3999,30
41738499544,41738499538,-6,973,2704,30
41746459443,41746459442,-1,2186,2290,30
41747052820,41747052817,-3,1200,1902,30
41750642759,41750642759,0,507,1056,30
41750870693,41750870696,3,1751,1294,30
41752216936,41752216931,-5,997,3316,30
41758847697,41758847692,-5,920,3236,30
41760967029,41760967025,-4,804,2526,30
41761186499,41761186495,-4,635,2385,30
41761717276,41761717270,-6,1223,2984,30
41765119010,41765119005,-5,1901,5183,30
41768502427,41768502423,-4,964,3066,30
41769298764,41769298756,-8,1033,3191,30
41770282827,41770282834,7,86467,35815,30
41771516138,41771516134,-4,1303,2351,30
41771806124,41771806117,-7,1318,2500,30
41772345682,41772345678,-4,1357,4034,30
41773226955,41773226957,2,1999,1964,30
41781817138,41781817134,-4,1297,2640,30
41782968575,41782968570,-5,1110,4101,30
41783422864,41783422849,-15,183,1205,30
41786240222,41786240217,-5,1154,2406,30
41787834859,41787834855,-4,1008,3392,30
41791594965,41791594962,-3,1381,3285,30
41797994548,41797994545,-3,816,2677,30
41801350640,41801350635,-5,801,2187,30
41804941975,41804941973,-2,1370,1573,30
41807778018,41807778018,0,2092,2341,30
41820739854,41820739849,-5,1001,2639,30
41821418649,41821418645,-4,828,2443,30
41826108121,41826108114,-7,1023,2427,30
41826402772,41826402788,16,253,1169,30
41829996588,41829996583,-5,791,2830,30
41836918212,41836918207,-5,1349,3334,30
41839169070,41839169065,-5,532,2795,30
41839556786,41839556803,17,434,1547,30
41847896986,41847896982,-4,710,2659,30
41851060082,41851060078,-4,651,2434,30
41851608082,41851608077,-5,923,3798,30
41854318859,41854318853,-6,767,2467,30
41855089962,41855089958,-4,1220,3522,30
41855310689,41855310702,13,340,1117,30
41856738029,41856738033,4,5204,2368,30
41858164903,41858164901,-2,16780,32030,30
41859173091,41859173095,4,1399,786,30
41860358741,41860358735,-6,1184,3069,30
41861801116,41861801130,14,411,1815,30
41864428574,41864428572,-2,1229,1885,30
41865440359,41865440355,-4,1441,2598,30
41865487501,41865487507,6,4441,1432,30
41867030658,41867030654,-4,973,2176,30
41867551974,41867551971,-3,1056,1278,30
41868662146,41868662142,-4,1173,3155,30
41870899950,41870899946,-4,1051,2676,30
41872684026,41872684023,-3,1067,2450,30
41882998834,41882998831,-3,1305,3464,30
41884200224,41884200221,-3,1231,2870,30
41884608681,41884608702,21,798,2757,30
41885163552,41885163543,-9,163,1527,30
41886494018,41886494016,-2,1123,2181,30
41892159036,41892159031,-5,880,2446,30
41901041690,41901041685,-5,629,2159,30
41902474899,41902474892,-7,362,1297,30
41908379575,41908379570,-5,962,2533,30
41913013890,41913013885,-5,652,3555,30
41914064855,41914064857,2,1582,1672,30
41920085627,41920085621,-6,761,2797,30
41921551770,41921551765,-5,1003,2829,30
41926407242,41926407237,-5,1299,4198,30
41927772426,41927772425,-1,2652,3804,30
41931346286,41931346281,-5,905,2662,30
41933195595,41933195591,-4,1087,3923,30
41933887490,41933887487,-3,1297,2525,30
41934859386,41934859382,-4,989,2882,30
41935662823,41935662818,-5,900,2883,30
41944800059,41944800054,-5,606,1307,30
41947740207,41947740196,-11,641,2953,30
41947845540,41947845557,17,629,1803,30
41951183869,41951183866,-3,1087,2705,30
41952253486,41952253482,-4,1032,3085,30
41952638924,41952638920,-4,1190,2514,30
41952685895,41952685893,-2,929,3251,30
41957282414,41957282409,-5,793,2775,30
41959029091,41959029075,-16,253,1148,30
41964280311,41964280303,-8,1255,4527,30
41966597772,41966597767,-5,1076,2606,30
41973845363,41973845360,-3,1000,2111,30
41976222769,41976222765,-4,1290,2175,30
41998659333,41998659327,-6,975,2658,30
42000731046,42000731051,5,2041,1491,30
42003357357,42003357351,-6,1048,3334,30
42004774762,42004774758,-4,1286,3065,30
42005152174,42005152170,-4,1115,2240,30
42005526362,42005526357,-5,1601,3270,30
42006608262,42006608258,-4,1041,3476,30
42008465459,42008465454,-5,1032,3573,30
42009706466,42009706462,-4,933,3022,30
42010047346,42010047342,-4,1404,3389,30
42013213566,42013213563,-3,872,2174,30
42014619823,42014619818,-5,949,3440,30
42015389960,42015389958,-2,2330,5304,30
42017961197,42017961194,-3,1143,2287,30
42018488306,42018488321,15,681,1049,30
42018591422,42018591419,-3,785,2320,30
42018759104,42018759106,2,35847,89174,30
42020293854,42020293850,-4,982,2955,30
42020850209,42020850207,-2,1057,2323,30
42021347216,42021347210,-6,989,3028,30
42026696545,42026696542,-3,901,2799,30
42031758950,42031758946,-4,1374,2924,30
42038434869,42038434863,-6,953,2510,30
42038953006,42038953002,-4,1060,2602,30
42039656255,42039656250,-5,976,2844,30
42046863481,42046863471,-10,415,1588,30
42051137326,42051137323,-3,1164,2353,30
42055231932,42055231927,-5,1092,2865,30
42055601614,42055601610,-4,1024,2887,30
42057682639,42057682633,-6,967,3343,30
42061666447,42061666445,-2,828,1656,30
42068819594,42068819598,4,4563,2979,30
42069558496,42069558494,-2,848,2592,30
42071131350,42071131350,0,996,1374,30
42076931346,42076931342,-4,737,1775,30
42081172872,42081172878,6,23355,20219,30
42083639535,42083639533,-2,1003,2440,30
42083755473,42083755469,-4,1121,2821,30
42085000301,42085000295,-6,734,1661,30
42089945589,42089945583,-6,974,3406,30
42099226053,42099226048,-5,852,2587,30
42099933688,42099933690,2,205,1034,30
42105454054,42105454069,15,529,1261,30
42106436410,42106436405,-5,1034,2463,30
42112745169,42112745163,-6,1340,4065,30
42113340830,42113340826,-4,1403,3335,30
42114840746,42114840746,0,1516,3206,30
42115593182,42115593177,-5,1498,2909,30
42117132395,42117132390,-5,740,2764,30
42120443270,42120443264,-6,650,2235,30
42120785002,42120785010,8,155,740,30
42121105457,42121105472,15,616,2369,30
42122659567,42122659564,-3,809,2290,30
42122743172,42122743166,-6,1112,2310,30
42123093002,42123092997,-5,658,1863,30
42126243275,42126243282,7,4286,846,30
42135429285,42135429280,-5,1175,4511,30
42136409404,42136409405,1,151,797,30
42136517427,42136517410,-17,244,671,30
42137805391,42137805386,-5,630,1704,30
42138229202,42138229206,4,4132,2404,30
42141346293,42141346288,-5,1182,4471,30
42144619082,42144619077,-5,1316,3079,30
42145461698,42145461693,-5,719,1597,30
42145602478,42145602474,-4,981,3103,30
42147431022,42147431018,-4,729,2494,30
42154037507,42154037504,-3,2243,3670,30
42156215134,42156215131,-3,1061,1705,30
42156815636,42156815649,13,611,1963,30
42157111353,42157111373,20,163,1202,30
42160224010,42160224009,-1,1221,2410,30
42161778755,42161778751,-4,864,2538,30
42165754174,42165754170,-4,992,3075,30
42166299633,42166299627,-6,700,2199,30
42169311353,42169311349,-4,663,1747,30
42170518190,42170518186,-4,884,2272,30
42172779524,42172779519,-5,930,3510,30
42173907019,42173907034,15,826,2714,30
42175979229,42175979231,2,1896,1789,30
42176413037,42176413038,1,3694,3288,30
42179812607,42179812602,-5,1845,7136,30
42184116803,42184116798,-5,744,2217,30
42184455851,42184455864,13,498,1587,30
42186777761,42186777759,-2,1158,2103,30
42187963291,42187963285,-6,676,2072,30
42209611143,42209611137,-6,1188,3554,30
42211896327,42211896321,-6,915,3494,30
42212927475,42212927477,2,8555,8208,30
42214098904,42214098897,-7,1795,7016,30
42225168530,42225168524,-6,1000,3997,30
42225585384,42225585391,7,103,843,30
42242169334,42242169329,-5,29694,19633,30
42244102365,42244102359,-6,1015,2401,30
42248510678,42248510678,0,1727,2693,30
42252764110,42252764117,7,13973,21779,30
42260882325,42260882322,-3,1298,2864,30
42261185755,42261185749,-6,211,1203,30
42263953861,42263953857,-4,2244,6003,30
42265540578,42265540575,-3,1260,2612,30
42268716529,42268716550,21,899,3946,30
42271625946,42271625943,-3,893,1910,30
42275508993,42275508990,-3,797,2650,30
42275951388,42275951404,16,806,2247,30
42279352174,42279352169,-5,970,2580,30
42281608897,42281608895,-2,1143,1962,30
42283129772,42283129766,-6,1236,2682,30
42291765501,42291765494,-7,771,3696,30
42292145092,42292145088,-4,1066,2537,30
42292690374,42292690369,-5,939,4632,30
42297714895,42297714893,-2,1951,2657,30
42300747611,42300747606,-5,1167,3056,30
42310313020,42310313016,-4,1086,3216,30
42312991219,42312991214,-5,1115,2679,30
42316271178,42316271183,5,1595,828,30
42321161170,42321161165,-5,1007,2392,30
42325970666,42325970663,-3,842,3180,30
42332148897,42332148892,-5,1258,2841,30
42332208107,42332208103,-4,366,1017,30
42333684894,42333684889,-5,590,1124,30
42336301499,42336301494,-5,1081,2779,30
42337391535,42337391529,-6,1224,3794,30
42337869780,42337869799,19,118,1205,30
42339631523,42339631521,-2,1140,2553,30
42350744885,42350744881,-4,1059,3002,30
42350925289,42350925311,22,155,746,30
42351046004,42351046021,17,673,1363,30
42351471603,42351471598,-5,977,3072,30
42358944132,42358944126,-6,1161,2413,30
42360950149,42360950129,-20,5034,1918,30
42362709402,42362709398,-4,1702,3953,30
42363970457,42363970452,-5,1145,2658,30
42365269483,42365269479,-4,1084,3944,30
42369007671,42369007667,-4,1206,3296,30
42369573795,42369573791,-4,1063,4106,30
42373380903,42373380897,-6,943,3358,30
42377008942,42377008940,-2,1015,2352,30
42378049274,42378049269,-5,1590,3840,30
42378281683,42378281678,-5,613,2388,30
42378619529,42378619526,-3,152,955,30
42381183866,42381183861,-5,1033,2491,30
42381959859,42381959854,-5,1278,2524,30
42383105148,42383105142,-6,1904,5745,30
42386581771,42386581765,-6,906,3491,30
42391346919,42391346915,-4,1403,3476,30
42398508175,42398508169,-6,907,3020,30
42399003841,42399003857,16,740,2060,30
42399066189,42399066184,-5,924,2992,30
42400784441,42400784435,-6,1326,3357,30
42401101121,42401101118,-3,49,965,30
42401202760,42401202778,18,540,1663,30
42409749398,42409749395,-3,706,3027,30
42417384270,42417384267,-3,1096,1468,30
42417688685,42417688690,5,8627,22243,30
42418932985,42418932979,-6,1163,2274,30
42420097529,42420097526,-3,914,2952,30
42424172290,42424172297,7,4588,1006,30
42427043765,42427043761,-4,693,1254,30
42427525032,42427525041,9,346,1116,30
42429073718,42429073714,-4,1190,3015,30
42442977051,42442977052,1,1179,2441,30
42443185127,42443185122,-5,1261,2639,30
42445435193,42445435187,-6,1015,3221,30
42448613011,42448613006,-5,928,2366,30
42453718587,42453718582,-5,1173,2858,30
42454690272,42454690260,-12,1334,2753,30
42457090734,42457090729,-5,1595,4975,30
42458389640,42458389637,-3,1353,1947,30
42458867121,42458867141,20,303,851,30
42460994195,42460994189,-6,802,2169,30
42466390478,42466390472,-6,990,3043,30
42471627250,42471627253,3,1956,1637,30
42472825823,42472825820,-3,963,2577,30
42474382385,42474382381,-4,729,2087,30
42474726570,42474726553,-17,199,789,30
42477185351,42477185348,-3,1302,3223,30
42479563266,42479563266,0,1273,2004,30
42481737070,42481737069,-1,1130,2294,30
42482211157,42482211151,-6,810,1641,30
42482260138,42482260154,16,281,1191,30
42484545356,42484545353,-3,1062,2875,30
42487972115,42487972111,-4,888,2811,30
42501019959,42501019953,-6,758,3068,30
42501532651,42501532647,-4,1428,3356,30
42501718530,42501718551,21,796,2755,30
42511822179,42511822177,-2,1909,4350,30
42513515816,42513515809,-7,1215,4727,30
42517004273,42517004279,6,4744,975,30
42522652535,42522652529,-6,836,3422,30
42527559354,42527559347,-7,1159,2345,30
42529551478,42529551474,-4,1138,2937,30
42533179548,42533179541,-7,1155,4149,30
42533557802,42533557796,-6,1094,3478,30
42537159147,42537159143,-4,1678,2627,30
42537473920,42537473916,-4,1331,2029,30
42537739971,42537739966,-5,991,4136,30
42539599239,42539599235,-4,667,2443,30
42539887703,42539887697,-6,850,3323,30
42540234953,42540234974,21,399,892,30
42542025077,42542025071,-6,1087,5184,30
42550823363,42550823357,-6,1060,2364,30
42550951163,42550951179,16,509,1770,30
42551604346,42551604340,-6,2118,7738,30
42552265113,42552265108,-5,998,3208,30
42552543345,42552543332,-13,142,1195,30
42552981036,42552981042,6,142,557,30
42554639563,42554639560,-3,269,1517,30
42555408093,42555408089,-4,736,1980,30
42555444697,42555444696,-1,32794,56656,30
42556034126,42556034121,-5,975,3367,30
42556371630,42556371626,-4,950,2325,30
42559601218,42559601215,-3,1054,2707,30
42573294267,42573294262,-5,1017,3279,30
42574468173,42574468168,-5,1083,3017,30
42574694467,42574694462,-5,1434,3300,30
42576582929,42576582923,-6,1476,3972,30
42581051939,42581051933,-6,855,2042,30
42582688286,42582688282,-4,936,3369,30
42583500302,42583500298,-4,1137,2468,30
42587551090,42587551082,-8,612,3131,30
42587691322,42587691330,8,319,841,30
42591860265,42591860270,5,2586,1581,30
42613800822,42613800817,-5,943,2970,30
42615141573,42615141568,-5,1108,2795,30
42627932586,42627932581,-5,828,2762,30
42630007063,42630007061,-2,1212,1635,30
42630687786,42630687782,-4,780,3151,30
42631744077,42631744071,-6,1079,2602,30
42633233003,42633232998,-5,1276,3326,30
42634808594,42634808600,6,3456,1142,30
42635562718,42635562714,-4,1151,3151,30
42635729777,42635729791,14,257,900,30
42639225839,42639225835,-4,989,2910,30
42639429138,42639429152,14,446,1360,30
42640111736,42640111732,-4,1059,3167,30
42644195623,42644195618,-5,1001,3108,30
42649411494,42649411499,5,1737,1072,30
42649990074,42649990084,10,15836,39912,30
42652629873,42652629880,7,2955,1451,30
42652847619,42652847614,-5,985,2116,30
42658901066,42658901061,-5,1048,3345,30
42661590283,42661590279,-4,1407,3074,30
42667973186,42667973190,4,1709,1167,30
42671338780,42671338775,-5,1388,3002,30
42674108618,42674108616,-2,2077,4914,30
42678225723,42678225718,-5,917,2194,30
42682095137,42682095136,-1,2348,4385,30
42686446213,42686446210,-3,1205,2320,30
42698827136,42698827133,-3,1331,1945,30
42700430044,42700430038,-6,826,2169,30
42703466099,42703466095,-4,725,1603,30
42704700108,42704700126,18,304,1077,30
42710000374,42710000369,-5,794,2033,30
42713247082,42713247076,-6,848,3601,30
42714471315,42714471314,-1,1181,2596,30
42714740727,42714740722,-5,1196,3410,30
42720693086,42720693083,-3,1661,3328,30
42731724204,42731724217,13,1032,2927,30
42738245503,42738245495,-8,919,1933,30
42747229749,42747229754,5,1535,944,30
42755902946,42755902942,-4,1135,3176,30
42756400598,42756400594,-4,1132,2223,30
42760424931,42760424927,-4,1122,2968,30
42761496162,42761496167,5,2157,1591,30
42761666825,42761666824,-1,1474,2021,30
42766401128,42766401123,-5,1482,4080,30
42770208395,42770208391,-4,342,884,30
42771348312,42771348318,6,731,119,30
42771663362,42771663354,-8,766,1734,30
42772248176,42772248170,-6,1163,3748,30
42772285352,42772285373,21,425,1750,30
42776483625,42776483622,-3,1077,3032,30
42781839947,42781839941,-6,1022,2396,30
42783419157,42783419153,-4,1840,5035,30
42784060403,42784060399,-4,224,930,30
42789877251,42789877247,-4,1471,3332,30
42802309615,42802309611,-4,1294,2825,30
42809965999,42809965993,-6,1064,4058,30
42817882690,42817882692,2,3174,4247,30
42821443505,42821443501,-4,1291,2528,30
42828552668,42828552661,-7,864,4176,30
42828860852,42828860864,12,335,1264,30
42834389658,42834389654,-4,955,2618,30
42834650945,42834650933,-12,839,1502,30
42836484241,42836484237,-4,1432,2852,30
42837381455,42837381450,-5,853,2461,30
42842262732,42842262729,-3,917,1397,30
42844019694,42844019699,5,2321,1827,30
42845425789,42845425783,-6,1271,4095,30
42846247274,42846247279,5,3629,1939,30
42846787781,42846787774,-7,1118,3234,30
42848259315,42848259310,-5,1054,3028,30
42850412194,42850412213,19,350,813,30
42852952555,42852952547,-8,1191,3464,30
42854636477,42854636472,-5,1176,2701,30
42855315229,42855315225,-4,1123,2680,30
42859445382,42859445382,0,1060,1949,30
42861840102,42861840109,7,3274,1409,30
42863673269,42863673265,-4,826,2429,30
42869612902,42869612898,-4,891,2382,30
42872982246,42872982242,-4,1449,3451,30
42884201491,42884201484,-7,1689,5224,30
42885683196,42885683192,-4,1085,3232,30
42886740779,42886740773,-6,1060,3249,30
42887009410,42887009403,-7,1108,2667,30
42887755126,42887755121,-5,781,2332,30
42890212698,42890212693,-5,1031,2228,30
42893010950,42893010947,-3,1189,3550,30
42895873788,42895873785,-3,722,1976,30
42897849205,42897849200,-5,973,2697,30
42898730797,42898730791,-6,518,2146,30
42899750892,42899750890,-2,1375,1635,30
42901945105,42901945100,-5,1082,3209,30
42904120193,42904120186,-7,1456,4691,30
42931455710,42931455712,2,2943,2887,30
42931727738,42931727733,-5,1271,2732,30
42932197523,42932197521,-2,1391,3101,30
42933084241,42933084236,-5,1112,2155,30
42937713360,42937713342,-18,1413,3942,30
42937986841,42937986862,21,444,1844,30
42939248711,42939248707,-4,1974,4484,30
42942136813,42942136805,-8,926,2837,30
42943504498,42943504484,-14,127,2454,30
42944611888,42944611883,-5,1169,3332,30
42953135563,42953135559,-4,942,2627,30
42954635805,42954635802,-3,865,2053,30
42957244924,42957244921,-3,1326,2949,30
42962124105,42962124101,-4,939,2747,30
42968286126,42968286124,-2,1316,2210,30
42970666133,42970666129,-4,968,2831,30
42974063711,42974063707,-4,1725,3701,30
42981617011,42981617009,-2,1208,3195,30
42981878077,42981878073,-4,973,1702,30
42985959374,42985959369,-5,1115,1827,30
42992385852,42992385845,-7,933,3079,30
43003948686,43003948685,-1,1948,2067,30
43004494311,43004494306,-5,861,1662,30
43010470091,43010470090,-1,1793,2622,30
43012290482,43012290478,-4,1204,3821,30
43012607549,43012607545,-4,326,782,30
43015427006,43015427002,-4,1139,2995,30
43018200913,43018200907,-6,943,3764,30
43023808299,43023808293,-6,949,3360,30
43024760290,43024760293,3,1630,914,30
43026079605,43026079600,-5,844,3713,30
43031022563,43031022569,6,5405,2954,30
43033456057,43033456053,-4,851,1808,30
43033654560,43033654582,22,326,1268,30
43035994283,43035994280,-3,1381,2478,30
43038286069,43038286066,-3,1047,2125,30
43039550130,43039550122,-8,1055,4346,30
43041777121,43041777116,-5,1582,4138,30
43042545090,43042545084,-6,1530,5697,30
43050012430,43050012440,10,16366,41706,30
43051233374,43051233370,-4,822,1467,30
43056134781,43056134778,-3,804,3186,30
43056965945,43056965939,-6,842,2789,30
43060458208,43060458203,-5,1224,2546,30
43061204699,43061204694,-5,1042,2878,30
43061580514,43061580495,-19,319,1603,30
43061721228,43061721241,13,451,1020,30
43065539121,43065539119,-2,1417,3359,30
43067495033,43067495029,-4,991,2682,30
43068481841,43068481821,-20,1168,2914,30
43078881700,43078881696,-4,786,1839,30
43079279883,43079279902,19,1366,2140,30
43081029825,43081029822,-3,1164,2756,30
43083103598,43083103593,-5,1030,2542,30
43083178546,43083178561,15,282,741,30
43084071882,43084071886,4,7358,2224,30
43092887651,43092887654,3,1010,1591,30
43092944134,43092944129,-5,773,2174,30
43093517367,43093517361,-6,461,728,30
43095421854,43095421849,-5,1497,3829,30
43095797495,43095797504,9,12171,30461,30
43098610269,43098610265,-4,1653,3104,30
43099068150,43099068147,-3,1162,2907,30
43101274339,43101274332,-7,1074,3141,30
43103277411,43103277406,-5,1309,5220,30
43106113284,43106113278,-6,1417,3308,30
43114313766,43114313762,-4,612,1900,30
43120739150,43120739146,-4,981,3219,30
43121205051,43121205046,-5,1138,2851,30
43121868816,43121868832,16,1070,2227,30
43122641616,43122641611,-5,1128,2885,30
43123237419,43123237437,18,730,2740,30
43124889543,43124889535,-8,984,4594,30
43125645774,43125645774,0,1070,1942,30
43133853783,43133853776,-7,775,4195,30
43136244632,43136244629,-3,30966,9922,30
43137784915,43137784912,-3,1278,3279,30
43145424415,43145424413,-2,919,2615,30
43146018898,43146018894,-4,978,3038,30
43149845273,43149845270,-3,791,2219,30
43152668501,43152668495,-6,1655,3779,30
43162302602,43162302598,-4,734,2164,30
43165782406,43165782423,17,691,2254,30
43167654190,43167654186,-4,948,3878,30
43169662278,43169662274,-4,1156,3502,30
43170558504,43170558518,14,599,1777,30
43184140751,43184140746,-5,1146,3281,30
43186586070,43186586064,-6,953,2578,30
43186754524,43186754541,17,911,2837,30
43189714393,43189714389,-4,1593,3647,30
43189792907,43189792902,-5,707,2952,30
43193554291,43193554285,-6,825,3648,30
43195409430,43195409432,2,1719,1987,30
43197389491,43197389473,-18,187,527,30
43198854841,43198854838,-3,1119,1827,30
43204022436,43204022430,-6,1034,3389,30
43207594990,43207594983,-7,1246,4591,30
43207723360,43207723371,11,257,1062,30
43208736603,43208736594,-9,139,684,30
43209616545,43209616541,-4,594,2647,30
43211307490,43211307485,-5,1027,3376,30
43212385498,43212385493,-5,881,3487,30
43212745429,43212745425,-4,23402,13409,30
43232222125,43232222127,2,2839,2176,30
43233906819,43233906814,-5,936,3039,30
43235111327,43235111323,-4,989,2268,30
43238436787,43238436783,-4,548,2241,30
43248429087,43248429074,-13,9687,40089,30
43256648978,43256648974,-4,907,1780,30
43258195485,43258195480,-5,882,4247,30
43258780642,43258780636,-6,898,2657,30
43260508489,43260508485,-4,805,2800,30
43265474831,43265474827,-4,1037,2687,30
43265889287,43265889284,-3,1143,2100,30
43266421666,43266421663,-3,1258,2480,30
43267263129,43267263123,-6,949,2651,30
43268992539,43268992534,-5,951,2902,30
43273934335,43273934330,-5,1242,3544,30
43273976990,43273976987,-3,575,1052,30
43280864805,43280864800,-5,1192,2904,30
43284915940,43284915957,17,122,770,30
43286110747,43286110744,-3,877,2830,30
43286879597,43286879593,-4,994,3714,30
43290716163,43290716157,-6,1524,2193,30
43293615041,43293615037,-4,749,2560,30
43293959418,43293959438,20,1347,2802,30
43296709649,43296709645,-4,1234,2872,30
43312980951,43312980946,-5,1204,3181,30
43314666750,43314666745,-5,772,2014,30
43317486835,43317486832,-3,1309,2457,30
43319411963,43319411958,-5,787,2860,30
43319661156,43319661174,18,502,934,30
43320851188,43320851184,-4,1299,3202,30
43334487135,43334487132,-3,1277,2760,30
43341187577,43341187573,-4,789,2068,30
43342270144,43342270137,-7,696,2139,30
43342479112,43342479095,-17,1052,2819,30
43344211810,43344211805,-5,745,3263,30
43346275269,43346275262,-7,896,3382,30
43358367734,43358367727,-7,986,4549,30
43359576611,43359576608,-3,831,1825,30
43361940718,43361940718,0,1353,2295,30
43364740040,43364740047,7,3596,1233,30
43366502857,43366502854,-3,1289,2772,30
43368539457,43368539467,10,13356,18919,30
43374488212,43374488209,-3,1314,1901,30
43380850824,43380850819,-5,737,2635,30
43382333487,43382333483,-4,1072,3757,30
43384795833,43384795827,-6,1124,2851,30
43387505436,43387505431,-5,343,1332,30
43387657594,43387657611,17,555,1225,30
43390132067,43390132062,-5,1045,4023,30
43391892117,43391892110,-7,1057,2907,30
43401583314,43401583309,-5,936,3028,30
43405429695,43405429692,-3,586,2332,30
43406982689,43406982685,-4,1109,2995,30
43411199310,43411199305,-5,1401,3605,30
43411272049,43411272070,21,1366,2824,30
43413781263,43413781258,-5,819,2619,30
43413913617,43413913633,16,1134,2687,30
43414089224,43414089218,-6,844,3213,30
43415818686,43415818691,5,6536,18206,30
43418778140,43418778134,-6,2196,7372,30
43419105723,43419105715,-8,1180,5745,30
43428043730,43428043719,-11,378,801,30
43438211863,43438211858,-5,861,3825,30
43438248210,43438248229,19,24951,101868,30
43440995155,43440995172,17,27530,23942,30
43452451497,43452451492,-5,1554,3238,30
43453681608,43453681603,-5,1109,2313,30
43455775406,43455775404,-2,1097,3070,30
43461216006,43461216006,0,1328,1927,30
43465460835,43465460831,-4,1055,2695,30
43479161965,43479161959,-6,1375,3064,30
43479488051,43479488030,-21,221,896,30
43480084954,43480084953,-1,39,1074,30
43490442155,43490442150,-5,1048,2928,30
43490668865,43490668858,-7,611,1453,30
43491329899,43491329919,20,1373,3780,30
43493333641,43493333636,-5,942,2425,30
43493422131,43493422139,8,140,1061,30
43495605603,43495605599,-4,977,4126,30
43505047190,43505047185,-5,3129,5873,30
43508281050,43508281042,-8,1400,5319,30
43518294869,43518294866,-3,815,2619,30
43519030281,43519030281,0,1774,1610,30
43523449083,43523449079,-4,419,1009,30
43524537607,43524537599,-8,574,2863,30
43529319327,43529319320,-7,1819,7717,30
43530972742,43530972737,-5,862,2592,30
43535670379,43535670375,-4,1067,3112,30
43536122563,43536122554,-9,1185,2049,30
43537715966,43537715973,7,376,1090,30
43537962858,43537962853,-5,1122,3226,30
43538294369,43538294382,13,419,2171,30
43542675263,43542675258,-5,823,3031,30
43543110034,43543110030,-4,859,2169,30
43545389614,43545389609,-5,1494,3656,30
43549529477,43549529472,-5,765,2048,30
43550558339,43550558332,-7,1294,3476,30
43551422140,43551422136,-4,773,2458,30
43551603094,43551603090,-4,876,4546,30
43557031734,43557031730,-4,883,3058,30
43558066605,43558066600,-5,1238,2481,30
43558625489,43558625470,-19,169,901,30
43563788850,43563788846,-4,1021,2962,30
43564593620,43564593626,6,3657,1392,30
43565806365,43565806363,-2,1469,1786,30
43570187506,43570187500,-6,636,2148,30
43570593673,43570593668,-5,52433,23776,30
43572048591,43572048589,-2,619,2385,30
43574545469,43574545465,-4,1615,4223,30
43577945229,43577945225,-4,1047,3081,30
43579584203,43579584198,-5,1056,3417,30
43582195569,43582195564,-5,937,3052,30
43582262889,43582262904,15,574,1695,30
43587175394,43587175399,5,3734,2465,30
43588370890,43588370885,-5,807,1111,30
43594235618,43594235617,-1,839,3071,30
43594807693,43594807689,-4,1174,3284,30
43596332672,43596332666,-6,1263,3457,30
43597007097,43597007092,-5,887,2738,30
43597191113,43597191109,-4,935,3849,30
43597249940,43597249957,17,1060,2886,30
43601059141,43601059138,-3,860,2871,30
43602331586,43602331583,-3,1450,2034,30
43603800185,43603800181,-4,992,3005,30
43606849686,43606849682,-4,1186,2939,30
43612651963,43612651958,-5,1158,2629,30
43613891728,43613891719,-9,179,1528,30
43614991625,43614991618,-7,1245,3657,30
43617455863,43617455858,-5,2256,8161,30
43618346663,43618346659,-4,1094,2400,30
43620410946,43620410952,6,3189,1762,30
43621082679,43621082674,-5,1170,3493,30
43630985293,43630985288,-5,928,2875,30
43631410594,43631410590,-4,329,1669,30
43633977026,43633977023,-3,1088,2480,30
43634303800,43634303794,-6,1105,3107,30
43634938230,43634938225,-5,1456,3683,30
43635006673,43635006667,-6,1093,2436,30
43635336795,43635336813,18,129,929,30
43636517229,43636517224,-5,996,3518,30
43639152633,43639152637,4,20746,15023,30
43641533818,43641533814,-4,1542,3006,30
43646061827,43646061823,-4,1313,3230,30
43650886233,43650886226,-7,810,1750,30
43651157589,43651157585,-4,1197,3099,30
43653228810,43653228806,-4,976,3542,30
43654024003,43654023986,-17,567,1571,30
43654544681,43654544677,-4,1189,3127,30
43656157199,43656157193,-6,988,3113,30
43663033279,43663033261,-18,1081,2452,30
43668080958,43668080953,-5,849,3385,30
43670492495,43670492489,-6,1280,3054,30
43670808359,43670808353,-6,1017,2673,30
43671871048,43671871046,-2,1319,2186,30
43672553714,43672553712,-2,791,2124,30
43672955354,43672955335,-19,1006,4277,30
43674120149,43674120144,-5,1360,3112,30
43675116014,43675116010,-4,1171,2059,30
43679620230,43679620228,-2,1023,1972,30
43681859886,43681859895,9,3331,706,30
43684833847,43684833842,-5,948,3074,30
43685720766,43685720760,-6,883,3529,30
43689231239,43689231234,-5,965,2521,30
43689952087,43689952082,-5,1032,3273,30
43690579514,43690579510,-4,167,969,30
43695209785,43695209780,-5,1119,1828,30
43698474717,43698474713,-4,751,2650,30
43707532543,43707532539,-4,658,2929,30
43709802281,43709802278,-3,1149,2521,30
43711368759,43711368754,-5,1078,2172,30
43711926129,43711926124,-5,1282,3290,30
43714489436,43714489433,-3,1191,2268,30
43716990787,43716990784,-3,877,2322,30
43719626845,43719626841,-4,1096,2984,30
43722016839,43722016836,-3,762,1938,30
43723441762,43723441757,-5,994,2267,30
43726117652,43726117649,-3,1124,2591,30
43729293080,43729293095,15,839,2450,30
43730838734,43730838729,-5,1504,3383,30
43732229419,43732229413,-6,1179,3718,30
43737051230,43737051238,8,2764,1147,30
43738119740,43738119735,-5,991,3209,30
43745238225,43745238222,-3,1290,2650,30
43748815795,43748815791,-4,804,3344,30
43749701343,43749701337,-6,720,2036,30
43750388243,43750388241,-2,739,2319,30
43750831462,43750831458,-4,806,2533,30
43760526508,43760526515,7,8801,3408,30
43761810426,43761810421,-5,1415,4109,30
43762039771,43762039766,-5,873,3320,30
43770175510,43770175505,-5,906,3030,30
43776283198,43776283194,-4,836,2385,30
43778776134,43778776129,-5,549,2823,30
43778845754,43778845761,7,262,1455,30
43779474450,43779474429,-21,905,2820,30
43782003935,43782003932,-3,1143,2695,30
43783432582,43783432577,-5,1204,3193,30
43787906304,43787906299,-5,1230,2766,30
43789818566,43789818563,-3,1596,1906,30
43790989165,43790989161,-4,1467,3744,30
43791797449,43791797446,-3,1376,3669,30
43792668882,43792668877,-5,993,3024,30
43797701815,43797701812,-3,1076,2946,30
43799310467,43799310462,-5,702,2674,30
43801522034,43801522030,-4,1337,3653,30
43803816081,43803816075,-6,1155,3510,30
43806915592,43806915598,6,5442,2789,30
43812352974,43812352969,-5,810,2173,30
43825421971,43825421966,-5,894,3097,30
43828196877,43828196869,-8,501,2033,30
43830688084,43830688091,7,6187,2698,30
43833689255,43833689253,-2,833,1975,30
43838800931,43838800925,-6,986,3080,30
43839523306,43839523302,-4,568,2382,30
43843058094,43843058091,-3,1066,3920,30
43845631876,43845631874,-2,894,2068,30
43852164393,43852164389,-4,903,3773,30
43853772055,43853772037,-18,2689,1274,30
43853814515,43853814509,-6,597,1266,30
43855258650,43855258644,-6,803,3185,30
43857760922,43857760917,-5,903,2397,30
43857990402,43857990397,-5,868,3031,30
43858522647,43858522649,2,1733,1056,30
43860393573,43860393569,-4,1190,3552,30
43867530457,43867530453,-4,1071,3510,30
43869670846,43869670841,-5,1155,2095,30
43869985267,43869985264,-3,1362,2164,30
43872842350,43872842354,4,1809,1651,30
43876612133,43876612129,-4,1179,2719,30
43877939373,43877939368,-5,1805,3814,30
43879594319,43879594314,-5,1124,2298,30
43887227375,43887227370,-5,1103,2844,30
43887424690,43887424686,-4,855,2609,30
43888288094,43888288089,-5,875,2682,30
43895736403,43895736397,-6,838,2172,30
43899114978,43899114973,-5,999,3334,30
43912043597,43912043593,-4,1722,3358,30
43917124713,43917124707,-6,711,1777,30
43919435465,43919435472,7,4417,1476,30
43924788546,43924788541,-5,770,2668,30
43924966073,43924966093,20,289,1093,30
43927611666,43927611664,-2,948,2526,30
43930233763,43930233758,-5,1203,3082,30
43936281271,43936281250,-21,1474,967,30
43950797133,43950797129,-4,781,1952,30
43951328053,43951328050,-3,1299,1917,30
43959193947,43959193939,-8,654,2838,30
43961069098,43961069094,-4,994,3419,30
43963317778,43963317774,-4,859,2738,30
43963808568,43963808564,-4,1329,2139,30
43965724577,43965724571,-6,1580,8404,30
43967858885,43967858881,-4,850,2416,30
43967885643,43967885647,4,218,1235,30
43968817465,43968817446,-19,103,1290,30
43970426137,43970426132,-5,1054,3476,30
43971361370,43971361365,-5,1255,3353,30
43972626464,43972626458,-6,1123,2688,30
43972797468,43972797483,15,122,857,30
43973665646,43973665649,3,1163,1605,30
43975580219,43975580214,-5,1304,3532,30
43975848815,43975848814,-1,6175,9479,30
43983391702,43983391694,-8,908,2688,30
43986971393,43986971389,-4,479,2692,30
43987740427,43987740406,-21,873,3022,30
43988604258,43988604273,15,131,1061,30
43989660488,43989660506,18,870,2608,30
43990223543,43990223535,-8,1249,2945,30
43992230361,43992230358,-3,833,2601,30
43993704946,43993704942,-4,935,3334,30
43997562778,43997562774,-4,740,2154,30
44000603010,44000603007,-3,601,1192,30
44000630490,44000630471,-19,880,1447,30
44012994648,44012994643,-5,1197,3070,30
44013945989,44013945991,2,1128,1529,30
44027314449,44027314445,-4,1035,2628,30
44031837869,44031837862,-7,679,2491,30
44032051270,44032051266,-4,810,2541,30
44032717794,44032717809,15,976,3292,30
44037239498,44037239495,-3,1272,3168,30
44048492885,44048492878,-7,781,5245,30
44057871281,44057871275,-6,1518,3407,30
44065052454,44065052450,-4,796,1961,30
44065129126,44065129124,-2,845,1768,30
44065284712,44065284711,-1,77,555,30
44070229775,44070229769,-6,1217,4577,30
44071625320,44071625315,-5,1307,3188,30
44075076307,44075076303,-4,1049,3829,30
44076153407,44076153405,-2,1275,2781,30
44080603221,44080603217,-4,1251,3422,30
44082545383,44082545378,-5,709,2818,30
44094616991,44094616987,-4,855,2159,30
44096694144,44096694141,-3,2165,3466,30
44097441434,44097441442,8,54,1202,30
44098652442,44098652437,-5,1047,2174,30
44101984128,44101984124,-4,1463,2245,30
44102544370,44102544368,-2,1038,3085,30
44116511981,44116511978,-3,855,2367,30
44116657734,44116657730,-4,1234,2699,30
44118741006,44118741001,-5,1128,3715,30
44118975002,44118974998,-4,1152,2207,30
44120040459,44120040458,-1,978,2697,30
44120942101,44120942097,-4,1044,2168,30
44125174189,44125174184,-5,1158,2834,30
44135403133,44135403129,-4,1182,3539,30
44138367836,44138367830,-6,914,2767,30
44139442318,44139442315,-3,1133,2524,30
44141592854,44141592849,-5,590,2014,30
44141958968,44141958989,21,1729,2989,30
44141990882,44141990878,-4,1220,2757,30
44144823614,44144823610,-4,1166,3110,30
44151963945,44151963950,5,3390,1899,30
44153816677,44153816675,-2,1414,2846,30
44158226438,44158226431,-7,1177,4018,30
44161967666,44161967661,-5,1023,2939,30
44162359993,44162360013,20,677,1849,30
44167854163,44167854158,-5,1218,2984,30
44170787142,44170787147,5,2513,1265,30
44171364226,44171364222,-4,765,2809,30
44172456920,44172456941,21,334,1064,30
44175448317,44175448314,-3,1266,3978,30
44179303411,44179303412,1,1904,1329,30
44179671414,44179671409,-5,1124,3750,30
44188336267,44188336261,-6,782,2869,30
44189293031,44189293025,-6,1088,3133,30
44189629771,44189629755,-16,136,1255,30
44195066364,44195066360,-4,1076,3102,30
44203060054,44203060049,-5,1093,3355,30
44208019793,44208019793,0,1562,1663,30
44209288505,44209288497,-8,1096,1946,30
44214252336,44214252330,-6,1051,2390,30
44214846697,44214846678,-19,811,3157,30
44216098194,44216098190,-4,1010,2558,30
44223121975,44223121972,-3,1100,2651,30
44224489928,44224489928,0,2626,3892,30
44225367345,44225367341,-4,1248,3981,30
44226650974,44226650970,-4,719,2942,30
44230372437,44230372432,-5,1139,4630,30
44241193455,44241193453,-2,1043,2540,30
44243481743,44243481738,-5,955,3360,30
44245663071,44245663066,-5,896,2766,30
44247416597,44247416594,-3,1240,3553,30
44247589132,44247589148,16,1038,2474,30
44249562323,44249562319,-4,740,2462,30
44249766496,44249766490,-6,1211,3066,30
44250332354,44250332349,-5,1343,2684,30
44251559367,44251559362,-5,1203,2291,30
44252508441,44252508430,-11,1059,3545,30
44267054018,44267054017,-1,816,1436,30
44268141861,44268141855,-6,949,1962,30
44269064776,44269064788,12,83,2624,30
44270339766,44270339762,-4,963,3807,30
44274755763,44274755758,-5,1192,3475,30
44275081624,44275081621,-3,942,3778,30
44276989770,44276989775,5,4243,2056,30
44277839565,44277839561,-4,1354,3365,30
44280564455,44280564454,-1,970,1740,30
44283092401,44283092396,-5,1029,3334,30
44284740521,44284740516,-5,1170,2710,30
44285922449,44285922470,21,357,1307,30
44286144935,44286144931,-4,1244,2913,30
44292276075,44292276078,3,1573,1280,30
44299657889,44299657884,-5,938,2035,30
44300685120,44300685122,2,2503,3760,30
44305078631,44305078625,-6,989,3080,30
44305556758,44305556760,2,1029,746,30
44307578377,44307578393,16,725,2927,30
44314017792,44314017811,19,1211,2667,30
44314255214,44314255210,-4,1279,3278,30
44314949796,44314949814,18,842,2676,30
44315728936,44315728930,-6,1063,2144,30
44316470639,44316470634,-5,751,3716,30
44324626054,44324626049,-5,736,2795,30
44328124044,44328124040,-4,1486,2605,30
44331370478,44331370477,-1,18576,8759,30
44337023411,44337023406,-5,879,2670,30
44338225413,44338225406,-7,919,3316,30
44340301729,44340301725,-4,1139,2681,30
44344549951,44344549946,-5,1200,2471,30
44346871645,44346871641,-4,944,3323,30
44346923508,44346923525,17,391,993,30
44347258476,44347258469,-7,1042,3249,30
44352492826,44352492822,-4,1022,3080,30
44357111731,44357111726,-5,1330,3682,30
44357261465,44357261467,2,219,1329,30
44359207301,44359207297,-4,720,2221,30
44364321706,44364321702,-4,877,2055,30
44366495927,44366495923,-4,934,2433,30
44369066674,44369066670,-4,1195,3485,30
44375516851,44375516850,-1,1712,2806,30
44378443190,44378443197,7,3440,1181,30
44378769066,44378769062,-4,1418,3530,30
44382778542,44382778538,-4,906,2351,30
44386190401,44386190397,-4,1240,2548,30
44400948743,44400948738,-5,1166,3253,30
44401951083,44401951078,-5,1168,2947,30
44413476964,44413476959,-5,1284,3193,30
44436776393,44436776388,-5,1174,3588,30
44437979452,44437979447,-5,1092,2461,30
44440128158,44440128162,4,1207,1357,30
44442843915,44442843912,-3,1118,3041,30
44443161479,44443161474,-5,1043,3487,30
44445878503,44445878499,-4,1218,3000,30
44446130198,44446130195,-3,1440,3328,30
44448514455,44448514451,-4,1335,2024,30
44450894857,44450894852,-5,1378,4311,30
44455163090,44455163087,-3,534,1268,30
44465425247,44465425245,-2,849,1627,30
44466177882,44466177872,-10,1180,3087,30
44478510253,44478510248,-5,943,2847,30
44479602492,44479602490,-2,1159,2456,30
44480312303,44480312301,-2,1299,2016,30
44480393250,44480393271,21,282,1118,30
44480780226,44480780225,-1,1882,3266,30
44483427826,44483427822,-4,937,2139,30
44492519094,44492519089,-5,715,2768,30
44495033391,44495033385,-6,786,3322,30
44496584281,44496584277,-4,1013,2890,30
44499652986,44499652981,-5,1246,2622,30
44513939080,44513939073,-7,1787,8633,30
44519852568,44519852575,7,2440,1233,30
44528990994,44528990990,-4,973,2763,30
44529758046,44529758040,-6,1328,4707,30
44530120271,44530120273,2,1171,1376,30
44532015046,44532015039,-7,783,2180,30
44532556028,44532556041,13,571,1061,30
44533650638,44533650641,3,3043,2262,30
44534420287,44534420282,-5,1054,2823,30
44540618256,44540618250,-6,1499,3546,30
44541265177,44541265193,16,871,2335,30
44542996586,44542996582,-4,789,2753,30
44547189481,44547189477,-4,1438,3449,30
44551131913,44551131909,-4,1082,1791,30
44558768090,44558768083,-7,456,1203,30
44561127483,44561127478,-5,1074,2513,30
44563541267,44563541264,-3,1265,2350,30
44565153187,44565153182,-5,1150,3510,30
44569388449,44569388453,4,1645,1353,30
44570093211,44570093206,-5,1235,2556,30
44573802725,44573802729,4,3155,1212,30
44574309558,44574309554,-4,667,1488,30
44576830065,44576830059,-6,570,1687,30
44582691192,44582691191,-1,1198,1610,30
44586491945,44586491941,-4,805,2348,30
44586776914,44586776911,-3,615,1867,30
44587150395,44587150393,-2,1236,2875,30
44588048209,44588048205,-4,953,2534,30
44592082573,44592082567,-6,1128,3657,30
44592872043,44592872037,-6,529,1423,30
44593296721,44593296742,21,634,2494,30
44595165024,44595165019,-5,1363,3220,30
44598209674,44598209669,-5,765,2978,30
44600353550,44600353546,-4,740,3164,30
44600519650,44600519643,-7,181,1119,30
44601681285,44601681289,4,3125,1504,30
44601879649,44601879645,-4,1058,3158,30
44602310907,44602310897,-10,562,927,30
44605072621,44605072618,-3,1357,1211,30
44608119474,44608119470,-4,1234,2949,30
44611157986,44611157982,-4,1237,3901,30
44612086639,44612086635,-4,845,1742,30
44613601926,44613601921,-5,1151,3067,30
44614848306,44614848302,-4,1182,3890,30
44615923000,44615922999,-1,1373,2744,30
44620646433,44620646428,-5,929,2539,30
44622118709,44622118706,-3,939,2427,30
44623532805,44623532802,-3,1317,2338,30
44629423732,44629423729,-3,1315,3423,30
44633830811,44633830806,-5,767,2232,30
44635399909,44635399905,-4,1372,5555,30
44641293551,44641293546,-5,1109,3001,30
44644399602,44644399599,-3,719,1641,30
44644524281,44644524277,-4,91,1195,30
44647997614,44647997612,-2,1020,2432,30
44648225489,44648225510,21,294,900,30
44653266319,44653266315,-4,1071,2398,30
44659808570,44659808567,-3,880,2729,30
44661314981,44661314983,2,11522,9343,30
44662469157,44662469152,-5,935,2449,30
44663429242,44663429238,-4,1188,2396,30
44667902926,44667902939,13,17316,28768,30
44678176915,44678176910,-5,1091,2212,30
44678388667,44678388648,-19,806,1747,30
44683632619,44683632614,-5,1670,3513,30
44684356427,44684356422,-5,920,2878,30
44692224221,44692224215,-6,1338,4011,30
44698880710,44698880707,-3,862,1900,30
44699193254,44699193246,-8,792,4507,30
44701931095,44701931093,-2,1186,1961,30
44703849768,44703849779,11,473,1065,30
44704933409,44704933406,-3,1300,2224,30
44712623137,44712623130,-7,1248,3861,30
44713269289,44713269306,17,135,695,30
44722428906,44722428902,-4,874,2259,30
44722808524,44722808519,-5,1278,2267,30
44723498374,44723498369,-5,1443,4124,30
44724091003,44724090999,-4,881,2391,30
44724207390,44724207389,-1,1311,3883,30
44727600269,44727600265,-4,1060,2433,30
44729491314,44729491308,-6,795,3158,30
44731987308,44731987302,-6,942,2326,30
44732311441,44732311438,-3,1315,2081,30
44732707658,44732707665,7,10289,2361,30
44736720405,44736720401,-4,865,3145,30
44738212986,44738212981,-5,787,2065,30
44742690894,44742690893,-1,1339,2095,30
44743070807,44743070803,-4,1286,3822,30
44744337393,44744337388,-5,926,3073,30
44746271891,44746271886,-5,1411,3623,30
44747822615,44747822611,-4,906,2404,30
44749865978,44749865976,-2,1079,1714,30
44750197011,44750197022,11,456,2681,30
44750686247,44750686242,-5,1684,4266,30
44752898934,44752898930,-4,720,1447,30
44761335205,44761335199,-6,1165,2511,30
44772528667,44772528664,-3,1083,2670,30
44774013231,44774013228,-3,1074,2695,30
44774913898,44774913900,2,1628,1993,30
44776680863,44776680858,-5,1368,2161,30
44776839042,44776839057,15,795,2929,30
44780032011,44780032006,-5,816,2272,30
44784003889,44784003886,-3,2912,5656,30
44789664329,44789664328,-1,2441,4270,30
44790713214,44790713209,-5,1141,2429,30
44793139294,44793139291,-3,1064,2497,30
44798385102,44798385099,-3,936,2724,30
44804296187,44804296183,-4,795,2839,30
44806901791,44806901787,-4,952,3765,30
44808055634,44808055629,-5,1022,2347,30
44808626923,44808626921,-2,1416,4528,30
44808975923,44808975918,-5,956,2808,30
44810988595,44810988588,-7,933,3243,30
44812559270,44812559266,-4,1289,3536,30
44813658222,44813658219,-3,1075,1794,30
44814114484,44814114501,17,454,1666,30
44814159113,44814159115,2,1082,1030,30
44814854201,44814854181,-20,946,2767,30
44819134040,44819134042,2,2615,1206,30
44820516943,44820516939,-4,1425,3523,30
44822557199,44822557203,4,1844,1689,30
44823870450,44823870445,-5,936,2600,30
44825013444,44825013438,-6,1200,3218,30
44826172047,44826172042,-5,1298,3470,30
44829247929,44829247934,5,3519,1542,30
44830223271,44830223269,-2,2280,3555,30
44831262367,44831262362,-5,896,3193,30
44831439381,44831439377,-4,756,1723,30
44832560778,44832560792,14,1378,1234,30
44832673203,44832673198,-5,1340,3782,30
44834506489,44834506485,-4,857,2720,30
44842919795,44842919791,-4,1236,4203,30
44848427241,44848427235,-6,1234,3132,30
44850988796,44850988791,-5,1267,1974,30
44856010869,44856010865,-4,838,2901,30
44856113803,44856113822,19,716,2281,30
44856735421,44856735420,-1,1908,2142,30
44860425558,44860425555,-3,1152,3230,30
44867614882,44867614890,8,301,1054,30
44868731429,44868731430,1,1200,1386,30
44874319198,44874319196,-2,1078,2618,30
44875518225,44875518222,-3,1083,2250,30
44880668268,44880668265,-3,1226,1946,30
44881625554,44881625550,-4,1462,2909,30
44882108218,44882108238,20,831,3280,30
44883166566,44883166563,-3,1133,2737,30
44883599899,44883599895,-4,606,2361,30
44885324758,44885324752,-6,1557,3584,30
44885578195,44885578191,-4,967,2525,30
44885950938,44885950942,4,249,833,30
44891651738,44891651746,8,4126,1418,30
44894552430,44894552425,-5,1159,5378,30
44894715985,44894715975,-10,204,615,30
44895805490,44895805500,10,247,1230,30
44896953392,44896953394,2,228,940,30
44898768739,44898768734,-5,825,2415,30
44900797231,44900797226,-5,1195,2790,30
44902362050,44902362028,-22,36,2350,30
44904883900,44904883894,-6,1293,3392,30
44909817995,44909817995,0,977,1482,30
44915904198,44915904194,-4,870,2060,30
44917293131,44917293127,-4,1122,3075,30
44930316401,44930316394,-7,1257,3246,30
44930840062,44930840058,-4,906,2372,30
44933441030,44933441026,-4,662,3423,30
44934181731,44934181730,-1,1932,2099,30
44934550133,44934550130,-3,1048,2298,30
44938312159,44938312156,-3,952,2763,30
44941670153,44941670148,-5,753,2103,30
44945076814,44945076809,-5,1043,3145,30
44945122628,44945122646,18,541,2419,30
44947810410,44947810404,-6,1038,3128,30
44949312363,44949312358,-5,1062,2852,30
44949490709,44949490702,-7,1195,3055,30
44962191317,44962191315,-2,1323,2172,30
44962514831,44962514825,-6,778,1764,30
44964471294,44964471289,-5,772,2551,30
44964752931,44964752939,8,85,672,30
44966443194,44966443190,-4,1329,3556,30
44970499755,44970499750,-5,821,2096,30
44973723391,44973723387,-4,956,2444,30
44976163782,44976163778,-4,890,3360,30
44981698125,44981698119,-6,1172,2778,30
44984127642,44984127638,-4,1041,2746,30
44985361509,44985361505,-4,660,2685,30
44988938041,44988938041,0,1135,1576,30
44990867739,44990867746,7,5577,1704,30
44994050100,44994050094,-6,768,3836,30
44994133836,44994133817,-19,120,722,30
44995990287,44995990283,-4,1331,2962,30
45000189386,45000189385,-1,2025,2437,30
45001971148,45001971149,1,1225,2071,30
45007949002,45007948998,-4,829,1934,30
45019648007,45019648005,-2,890,2083,30
45021595571,45021595565,-6,1645,5221,30
45024968703,45024968704,1,19237,27214,30
45025212313,45025212307,-6,937,2865,30
45025503010,45025503005,-5,1009,2188,30
45026318888,45026318891,3,1243,954,30
45036502019,45036502014,-5,1099,4154,30
45039807378,45039807374,-4,508,2122,30
45041436066,45041436061,-5,857,3158,30
45042273793,45042273788,-5,736,1700,30
45044781255,45044781251,-4,1686,3075,30
45046812370,45046812366,-4,1188,2510,30
45052104568,45052104565,-3,1319,3137,30
45057703933,45057703930,-3,1072,2267,30
45064070543,45064070537,-6,1294,3738,30
45089486123,45089486118,-5,941,2255,30
45089691267,45089691263,-4,790,3249,30
45090983117,45090983113,-4,1026,3496,30
45092715135,45092715131,-4,1019,3120,30
45094731082,45094731078,-4,975,2578,30
45094966114,45094966119,5,2540,1251,30
45099171058,45099171053,-5,1022,2813,30
45100497825,45100497810,-15,1087,3408,30
45102507590,45102507586,-4,839,2794,30
45107412482,45107412478,-4,1294,1949,30
45112572704,45112572705,1,1460,1487,30
45113258727,45113258722,-5,995,2570,30
45115420804,45115420799,-5,1013,2036,30
45119542929,45119542927,-2,1665,2529,30
45120244795,45120244793,-2,1399,2849,30
45121905509,45121905502,-7,809,4377,30
45123041983,45123041982,-1,2306,3236,30
45123471599,45123471601,2,1470,1263,30
45124031169,45124031166,-3,936,1898,30
45126728407,45126728403,-4,725,2471,30
45131917360,45131917355,-5,1455,4297,30
45132695659,45132695679,20,47,691,30
45133273023,45133273019,-4,665,1981,30
45135437763,45135437757,-6,1133,3181,30
45143619085,45143619082,-3,1106,3541,30
45144417697,45144417703,6,5446,2486,30
45152516872,45152516869,-3,1183,2530,30
45152563996,45152563994,-2,1152,1609,30
45154539682,45154539678,-4,854,1650,30
45156581342,45156581340,-2,1742,2148,30
45162676886,45162676881,-5,1015,3411,30
45163167562,45163167546,-16,188,1335,30
45164193143,45164193138,-5,728,2168,30
45171536522,45171536516,-6,1019,2897,30
45173995170,45173995178,8,9532,22581,30
45180919835,45180919830,-5,873,1629,30
45185381874,45185381869,-5,1117,2803,30
45187468950,45187468946,-4,1075,2167,30
45194199431,45194199451,20,202,1038,30
45195850377,45195850375,-2,1552,2121,30
45197759132,45197759128,-4,834,3088,30
45209390262,45209390259,-3,887,2098,30
45210962953,45210962935,-18,229,930,30
45212878820,45212878835,15,256,934,30
45213065833,45213065829,-4,1323,2610,30
45219122769,45219122765,-4,1020,3481,30
45219928954,45219928963,9,9543,27907,30
45230678089,45230678089,0,1312,1823,30
45232170274,45232170269,-5,1359,3221,30
45232923148,45232923144,-4,832,1914,30
45234461204,45234461211,7,4972,1694,30
45236854298,45236854291,-7,1483,3526,30
45239001893,45239001889,-4,1279,2796,30
45241163282,45241163278,-4,1420,2953,30
45241570191,45241570188,-3,1492,3160,30
45244904837,45244904834,-3,1375,3697,30
45245448459,45245448474,15,816,2572,30
45255250265,45255250266,1,2690,3753,30
45255479892,45255479888,-4,1297,1931,30
45263049216,45263049214,-2,1071,2983,30
45263767231,45263767226,-5,1042,2264,30
45265195536,45265195530,-6,996,4276,30
45265281533,45265281531,-2,1039,2504,30
45271838740,45271838737,-3,1123,1730,30
45272102185,45272102174,-11,240,769,30
45272827259,45272827254,-5,984,3195,30
45273518134,45273518129,-5,1094,2887,30
45273925723,45273925742,19,346,1150,30
45280803547,45280803542,-5,1015,2493,30
45284435650,45284435646,-4,940,2472,30
45284460959,45284460958,-1,1151,2531,30
45292555648,45292555645,-3,1076,2083,30
45298099319,45298099315,-4,855,3115,30
45299652443,45299652441,-2,1527,2871,30
45301559985,45301559979,-6,981,3025,30
45301624430,45301624425,-5,1120,4167,30
45304917643,45304917637,-6,517,1607,30
45306628256,45306628254,-2,1366,3147,30
45308692836,45308692834,-2,1652,2241,30
45323177085,45323177081,-4,1711,3295,30
45326137330,45326137328,-2,593,1618,30
45330136237,45330136233,-4,892,2359,30
45332669178,45332669172,-6,1203,4077,30
45334743062,45334743067,5,13470,11421,30
45335489053,45335489048,-5,1336,2372,30
45336780602,45336780607,5,2587,1384,30
45341569619,45341569615,-4,951,2466,30
45341989909,45341989903,-6,873,3775,30
45342812122,45342812107,-15,879,3172,30
45343265218,45343265230,12,25,869,30
45355442545,45355442541,-4,973,2539,30
45362166429,45362166426,-3,888,2430,30
45363431942,45363431929,-13,827,1583,30
45366334450,45366334446,-4,953,1942,30
45370357937,45370357934,-3,1350,2272,30
45372721443,45372721439,-4,1081,3230,30
45373278431,45373278429,-2,1207,2028,30
45375617990,45375617985,-5,1065,3298,30
45377242995,45377242993,-2,775,1731,30
45378037937,45378037937,0,1517,1745,30
45378366642,45378366638,-4,802,2133,30
45378874697,45378874677,-20,1120,2876,30
45381430503,45381430509,6,3106,1650,30
45382888612,45382888605,-7,1371,3245,30
45384627758,45384627754,-4,956,2670,30
45385706578,45385706575,-3,903,2674,30
45385789115,45385789098,-17,1023,2262,30
45387744025,45387744019,-6,1531,2828,30
45389666205,45389666198,-7,849,3882,30
45392463797,45392463792,-5,959,2659,30
45393993258,45393993252,-6,1022,2511,30
45394221713,45394221718,5,2963,1333,30
45396374994,45396374991,-3,1009,2540,30
45396450041,45396450061,20,1443,2601,30
45398791621,45398791617,-4,1632,2330,30
45400375874,45400375869,-5,1343,2912,30
45401189646,45401189642,-4,1006,3051,30
45403974720,45403974716,-4,1239,2695,30
45405784779,45405784774,-5,986,3354,30
45407189901,45407189896,-5,965,2407,30
45408473111,45408473107,-4,871,2619,30
45422945988,45422945986,-2,853,1984,30
45422999531,45422999527,-4,1477,3943,30
45425353455,45425353451,-4,867,2386,30
45430912421,45430912418,-3,1228,3195,30
45431137043,45431137039,-4,917,2395,30
45434903497,45434903494,-3,859,1946,30
45437613004,45437613001,-3,1042,2098,30
45443249176,45443249170,-6,875,2631,30
45446875470,45446875466,-4,1402,3991,30
45447796165,45447796161,-4,572,2236,30
45452626530,45452626526,-4,1086,2879,30
45455872766,45455872762,-4,2446,6387,30
45463895147,45463895146,-1,831,2378,30
45466572752,45466572745,-7,1380,3491,30
45468043097,45468043093,-4,1118,1634,30
45468760530,45468760525,-5,1081,2868,30
45470518342,45470518338,-4,861,2417,30
45476384126,45476384123,-3,896,1853,30
45477305394,45477305375,-19,1238,605,30
45484162966,45484162963,-3,950,3000,30
45484489357,45484489353,-4,1375,4611,30
45501393265,45501393258,-7,1338,2496,30
45506632447,45506632445,-2,2366,4578,30
45518482806,45518482801,-5,1456,4203,30
45527390702,45527390696,-6,899,3572,30
45532546482,45532546491,9,3139,1237,30
45538562609,45538562605,-4,1146,2609,30
45540082067,45540082061,-6,1168,3106,30
45540577257,45540577258,1,1556,1873,30
45547771070,45547771065,-5,1274,3169,30
45557784103,45557784100,-3,982,2506,30
45557979770,45557979758,-12,134,1116,30
45560648335,45560648329,-6,1048,2598,30
45561421060,45561421078,18,792,2485,30
45567078307,45567078302,-5,805,3120,30
45568866150,45568866145,-5,879,2375,30
45571296886,45571296882,-4,679,2161,30
45573545203,45573545198,-5,1516,5959,30
45578095274,45578095269,-5,863,3383,30
45578267857,45578267876,19,272,1228,30
45579448861,45579448854,-7,1094,2129,30
45581076287,45581076282,-5,1011,2198,30
45583195728,45583195724,-4,2611,6279,30
45585753216,45585753212,-4,1374,2658,30
45585857979,45585857994,15,439,1205,30
45590655766,45590655762,-4,1161,2663,30
45594536034,45594536030,-4,860,2208,30
45596402891,45596402889,-2,1824,2598,30
45600218021,45600218017,-4,1293,2995,30
45603422760,45603422756,-4,1282,4004,30
45607305578,45607305594,16,96,1660,30
45609085355,45609085351,-4,1085,2388,30
45613674966,45613674962,-4,846,2036,30
45617668027,45617668024,-3,736,3032,30
45620323209,45620323212,3,1232,914,30
45626888091,45626888087,-4,705,2202,30
45631803647,45631803654,7,17947,15871,30
45634596953,45634596939,-14,7704,26262,30
45638002546,45638002540,-6,942,2554,30
45642689910,45642689906,-4,630,1788,30
45643986250,45643986257,7,1448,1083,30
45644613207,45644613202,-5,901,1429,30
45650618735,45650618731,-4,1080,2223,30
45654698026,45654698018,-8,1104,2992,30
45655943559,45655943555,-4,943,3472,30
45656705301,45656705308,7,4121,1225,30
45658232715,45658232723,8,21376,41150,30
45664964133,45664964129,-4,1027,2590,30
45665363313,45665363310,-3,1126,2210,30
45668436474,45668436467,-7,33308,11558,30
45671379907,45671379905,-2,698,2932,30
45672828087,45672828083,-4,655,1701,30
45677297074,45677297071,-3,841,2267,30
45677794201,45677794197,-4,836,3269,30
45684024575,45684024571,-4,1028,3139,30
45685672258,45685672253,-5,1003,2165,30
45686264507,45686264514,7,185,1084,30
45686493228,45686493222,-6,777,2004,30
45687160039,45687160034,-5,1134,2362,30
45688667454,45688667449,-5,1856,8839,30
45694623435,45694623430,-5,820,2191,30
45695947154,45695947134,-20,985,2394,30
45707674590,45707674586,-4,1283,3850,30
45712776121,45712776117,-4,884,3479,30
45718970999,45718970995,-4,1170,2640,30
45720484250,45720484245,-5,788,3647,30
45723149778,45723149777,-1,958,2426,30
45723699733,45723699731,-2,1111,1717,30
45726355673,45726355667,-6,1338,4106,30
45733242499,45733242495,-4,689,1922,30
45734580471,45734580473,2,1072,1459,30
45738167733,45738167728,-5,1032,2325,30
45739732157,45739732154,-3,811,2887,30
45739832979,45739832972,-7,38,685,30
45741767745,45741767741,-4,610,2267,30
45741849128,45741849138,10,327,1151,30
45744523105,45744523099,-6,2049,8389,30
45745107711,45745107710,-1,1112,2351,30
45751341368,45751341363,-5,862,2205,30
45753016172,45753016167,-5,686,1302,30
45757464438,45757464435,-3,959,1762,30
45759673734,45759673742,8,287,1506,30
45765780702,45765780697,-5,1183,2751,30
45771679235,45771679230,-5,1325,3548,30
45773037018,45773037013,-5,1038,3329,30
45774999741,45774999738,-3,719,4075,30
45777039155,45777039150,-5,1205,3024,30
45782284233,45782284229,-4,1333,3141,30
45782464751,45782464749,-2,685,2160,30
45783970000,45783969995,-5,81,930,30
45785313021,45785313017,-4,19883,16133,30
45787980473,45787980467,-6,899,3349,30
45791345036,45791345033,-3,771,2566,30
45791886980,45791886957,-23,887,2929,30
45792076456,45792076472,16,776,3415,30
45792667848,45792667842,-6,1263,4280,30
45794367287,45794367285,-2,1020,2318,30
45796019422,45796019416,-6,1044,2329,30
45800998639,45800998633,-6,1140,2593,30
45802104779,45802104756,-23,947,2188,30
45803110490,45803110482,-8,1317,3702,30
45803895059,45803895058,-1,1327,2504,30
45804457033,45804457029,-4,864,2960,30
45805113266,45805113278,12,326,1559,30
45805989366,45805989362,-4,1142,2470,30
45811558093,45811558086,-7,863,2136,30
45815154970,45815154966,-4,1111,3266,30
45815197713,45815197729,16,944,2203,30
45816451459,45816451463,4,1526,1041,30
45817850986,45817850981,-5,1203,2303,30
45818721331,45818721328,-3,906,3808,30
45821057044,45821057038,-6,1213,3617,30
45823267384,45823267380,-4,1853,4771,30
45832732990,45832732987,-3,745,2367,30
45837491103,45837491098,-5,809,2463,30
45838317780,45838317794,14,1114,3388,30
45839361187,45839361193,6,4746,2232,30
45841518025,45841518018,-7,1270,3132,30
45841624818,45841624810,-8,1286,4311,30
45841731688,45841731703,15,568,2094,30
45847781371,45847781378,7,4471,1377,30
45852433034,45852433029,-5,834,3118,30
45857565214,45857565210,-4,1549,2387,30
45857723165,45857723166,1,21793,22432,30
45859132659,45859132653,-6,813,2874,30
45859584504,45859584523,19,456,690,30
45863095241,45863095237,-4,751,2217,30
45864839434,45864839429,-5,981,2322,30
45869978765,45869978761,-4,942,2588,30
45873543150,45873543146,-4,783,2085,30
45876163154,45876163149,-5,1026,3121,30
45887253033,45887253030,-3,1112,3075,30
45888648254,45888648248,-6,998,3404,30
45889695913,45889695914,1,1638,1789,30
45894822146,45894822142,-4,1202,3067,30
45895695728,45895695722,-6,1211,3078,30
45896427426,45896427421,-5,1123,3978,30
45897397967,45897397963,-4,1618,3910,30
45899646185,45899646185,0,1029,1740,30
45901429070,45901429066,-4,976,2244,30
45906690434,45906690429,-5,952,2788,30
45915291902,45915291895,-7,1970,9786,30
45915892236,45915892237,1,1446,1676,30
45916275026,45916275032,6,11191,22638,30
45920172755,45920172750,-5,1192,3253,30
45921953562,45921953558,-4,1575,3726,30
45924297939,45924297935,-4,840,2595,30
45927298372,45927298367,-5,1331,2647,30
45928194088,45928194084,-4,979,2385,30
45930559618,45930559613,-5,930,3145,30
45942094730,45942094722,-8,928,2426,30
45943943378,45943943375,-3,957,2217,30
45944459625,45944459632,7,63941,20294,30
45946016643,45946016637,-6,1162,2924,30
45946878707,45946878702,-5,1071,3386,30
45965448619,45965448614,-5,576,1497,30
45965567778,45965567795,17,415,1163,30
45966495946,45966495950,4,4431,2942,30
45968711178,45968711173,-5,1029,2619,30
45969331715,45969331710,-5,1291,2492,30
45971295568,45971295590,22,550,2177,30
45977604374,45977604369,-5,871,2149,30
45980555158,45980555154,-4,881,3547,30
45981849281,45981849285,4,14027,9076,30
45984834667,45984834669,2,1014,1460,30
45992239360,45992239364,4,11451,23242,30
45993454311,45993454305,-6,832,1700,30
45995276059,45995276054,-5,1484,3055,30
45997537814,45997537811,-3,1002,2563,30
45997960546,45997960539,-7,1198,2931,30
45998085033,45998085049,16,690,2755,30
45998394062,45998394058,-4,2029,5202,30
46001100154,46001100150,-4,1130,2502,30
46006123851,46006123847,-4,1033,2525,30
46007807206,46007807201,-5,1187,3096,30
46008762590,46008762584,-6,928,3339,30
46010615246,46010615242,-4,864,3125,30
46015959635,46015959632,-3,1026,2630,30
46023582150,46023582144,-6,1207,4308,30
46025284054,46025284050,-4,879,2481,30
46025362649,46025362670,21,6,867,30
46026603174,46026603170,-4,1197,2268,30
46029016146,46029016143,-3,1232,2515,30
46032345996,46032346010,14,616,2051,30
46035061279,46035061274,-5,886,2349,30
46036663685,46036663682,-3,1195,3305,30
46038071739,46038071753,14,537,2150,30
46038886900,46038886896,-4,1161,1844,30
46041448943,46041448939,-4,472,1683,30
46044504986,46044504982,-4,885,3091,30
46059317737,46059317733,-4,1363,2789,30
46059836729,46059836722,-7,756,3033,30
46063430041,46063430037,-4,1358,3489,30
46067458680,46067458665,-15,113,866,30
46072017937,46072017930,-7,599,2251,30
46073599301,46073599298,-3,1113,2269,30
46074177241,46074177237,-4,167,550,30
46074927146,46074927142,-4,1039,2383,30
46075367510,46075367505,-5,850,3507,30
46075688990,46075688994,4,3124,1381,30
46077004267,46077004264,-3,1595,2958,30
46085714113,46085714110,-3,610,1816,30
46088329183,46088329178,-5,1137,2145,30
46091275243,46091275237,-6,797,2900,30
46092012157,46092012154,-3,1235,2310,30
46095056479,46095056477,-2,1029,2875,30
46095522602,46095522601,-1,1166,1990,30
46104909262,46104909257,-5,1024,3745,30
46108493352,46108493357,5,3724,1680,30
46112930757,46112930755,-2,1322,2289,30
46113962459,46113962456,-3,1117,2661,30
46114488033,46114488031,-2,277,1135,30
46115107355,46115107366,11,205,1166,30
46127227983,46127227980,-3,1067,2412,30
46129919699,46129919694,-5,1438,4026,30
46134948751,46134948747,-4,736,2993,30
46153694482,46153694478,-4,866,2937,30
46154377434,46154377432,-2,717,2593,30
46158810751,46158810745,-6,976,3020,30
46159221985,46159221978,-7,1040,2256,30
46159272757,46159272753,-4,1224,3071,30
46159681067,46159681071,4,287,1611,30
46160702554,46160702570,16,406,1698,30
46161782827,46161782823,-4,959,2107,30
46163798625,46163798631,6,2032,950,30
46164127167,46164127163,-4,1698,3050,30
46169052981,46169052971,-10,18519,17263,30
46174029687,46174029686,-1,1920,1783,30
46178876784,46178876779,-5,1771,4293,30
46181527046,46181527048,2,3297,4005,30
46185070794,46185070788,-6,1034,2742,30
46188402575,46188402570,-5,1203,2633,30
46192396338,46192396333,-5,882,3811,30
46194672001,46194671998,-3,1155,3139,30
46194807436,46194807437,1,171,1267,30
46200534454,46200534449,-5,1135,3466,30
46201077305,46201077286,-19,177,1662,30
46210868186,46210868186,0,2760,4104,30
46214116803,46214116806,3,1928,1739,30
46216767994,46216767989,-5,1001,3468,30
46217265850,46217265845,-5,1212,3380,30
46219705191,46219705189,-2,594,2805,30
46224254318,46224254313,-5,855,2616,30
46230503847,46230503844,-3,1057,1936,30
46230641386,46230641402,16,234,987,30
46238780315,46238780312,-3,789,2387,30
46240562448,46240562445,-3,1236,2796,30
46252023236,46252023233,-3,718,1618,30
46259591881,46259591875,-6,505,2951,30
46261985047,46261985042,-5,1234,3197,30
46273611570,46273611565,-5,1034,2673,30
46273935735,46273935731,-4,1303,3162,30
46276889541,46276889537,-4,864,2918,30
46278803926,46278803927,1,1092,1356,30
46284313857,46284313853,-4,1464,3453,30
46287834449,46287834453,4,1742,756,30
46287965113,46287965109,-4,635,1442,30
46292789051,46292789046,-5,625,2039,30
46296053913,46296053910,-3,1065,3068,30
46302655523,46302655518,-5,1180,2913,30
46303088706,46303088701,-5,1083,3249,30
46308840284,46308840281,-3,1113,2718,30
46321338688,46321338684,-4,837,1769,30
46323983722,46323983718,-4,1141,2878,30
46326208227,46326208223,-4,1029,2722,30
46334460622,46334460618,-4,657,2602,30
46336784257,46336784262,5,3270,1515,30
46339029694,46339029690,-4,1185,2774,30
46344248238,46344248233,-5,1313,3126,30
46354616982,46354616978,-4,1157,2754,30
46355193789,46355193789,0,1675,1699,30
46366104526,46366104519,-7,1016,3355,30
46366303216,46366303209,-7,1307,3733,30
46372857793,46372857789,-4,1183,2595,30
46386583315,46386583311,-4,1166,3138,30
46389632589,46389632585,-4,1134,2921,30
46394104938,46394104934,-4,932,3429,30
46398340325,46398340326,1,3445,2898,30
46399831271,46399831267,-4,1233,2549,30
46401129058,46401129054,-4,997,2304,30
46401164362,46401164351,-11,257,1002,30
46412455898,46412455893,-5,1017,3707,30
46413509090,46413509085,-5,218,1427,30
46422510833,46422510829,-4,1108,1812,30
46424810217,46424810213,-4,1507,3221,30
46427424761,46427424758,-3,1052,3705,30
46428340188,46428340190,2,3071,2564,30
46436478681,46436478677,-4,1049,2513,30
46437070019,46437070015,-4,588,892,30
46442962951,46442962948,-3,758,1410,30
46445245399,46445245401,2,1585,1674,30
46446781600,46446781597,-3,1013,2119,30
46447484250,46447484267,17,586,826,30
46447949453,46447949453,0,2132,2304,30
46448831110,46448831107,-3,978,2538,30
46449319181,46449319176,-5,825,2616,30
46452161476,46452161473,-3,1288,3150,30
46453241951,46453241947,-4,881,2904,30
46453518923,46453518931,8,3151,1206,30
46454439178,46454439179,1,1618,1721,30
46454506778,46454506773,-5,1106,2513,30
46454920801,46454920818,17,1264,2202,30
46456474963,46456474959,-4,760,2114,30
46456827305,46456827326,21,751,2307,30
46462029547,46462029541,-6,684,2561,30
46462912318,46462912314,-4,696,1982,30
46463088164,46463088181,17,1099,1922,30
46465649183,46465649178,-5,967,2599,30
46469565289,46469565286,-3,1410,2951,30
46469881119,46469881115,-4,1095,3023,30
46470160168,46470160166,-2,1172,2338,30
46473619215,46473619215,0,247,565,30
46480089903,46480089899,-4,819,3075,30
46484430407,46484430402,-5,1091,3449,30
46485003149,46485003143,-6,1111,3993,30
46488032590,46488032586,-4,772,3156,30
46491453427,46491453423,-4,1174,3012,30
46491690514,46491690509,-5,1151,2680,30
46491754955,46491754949,-6,219,1311,30
46495004809,46495004805,-4,986,2780,30
46496781710,46496781706,-4,671,2666,30
46498285620,46498285626,6,87,481,30
46505807674,46505807670,-4,930,2343,30
46506982902,46506982898,-4,1019,2307,30
46512315807,46512315801,-6,2071,7022,30
46513257637,46513257630,-7,971,2592,30
46517738167,46517738163,-4,1285,3189,30
46518318127,46518318122,-5,794,1864,30
46518903169,46518903190,21,206,911,30
46521716690,46521716689,-1,1452,2984,30
46522661897,46522661894,-3,800,3092,30
46523069115,46523069111,-4,917,2851,30
46525218930,46525218925,-5,805,1951,30
46525728238,46525728233,-5,983,2809,30
46534956411,46534956406,-5,1173,2727,30
46535544787,46535544786,-1,1439,2235,30
46543909217,46543909212,-5,1466,3180,30
46548612810,46548612802,-8,2170,7742,30
46558178056,46558178053,-3,1157,2450,30
46568293675,46568293666,-9,1115,2897,30
46569882162,46569882152,-10,1038,2594,30
46570862052,46570862047,-5,872,3614,30
46572485551,46572485546,-5,1349,3219,30
46576573751,46576573747,-4,1164,4263,30
46587580094,46587580090,-4,1255,2561,30
46589078829,46589078825,-4,1439,2748,30
46595821830,46595821827,-3,1140,2315,30
46606731354,46606731355,1,1267,2191,30
46608226334,46608226328,-6,595,1763,30
46610467206,46610467203,-3,841,3466,30
46614177002,46614176997,-5,1241,3096,30
46614668649,46614668645,-4,1200,3410,30
46618577737,46618577733,-4,950,2481,30
46619327821,46619327818,-3,831,2817,30
46623439187,46623439185,-2,790,1482,30
46623766377,46623766367,-10,1270,3986,30
46629149062,46629149059,-3,1218,3171,30
46629195977,46629195986,9,253,591,30
46635836782,46635836777,-5,1019,3770,30
46639703458,46639703453,-5,880,3377,30
46640292250,46640292270,20,1432,4149,30
46645025354,46645025359,5,4263,1898,30
46650061118,46650061117,-1,903,1671,30
46650959852,46650959847,-5,909,3355,30
46654114954,46654114958,4,5188,3278,30
46657751989,46657751988,-1,725,1382,30
46662073739,46662073734,-5,967,2726,30
46663430462,46663430458,-4,934,2690,30
46673414328,46673414335,7,4846,1868,30
46673928285,46673928282,-3,625,1963,30
46677803744,46677803739,-5,1017,3941,30
46681005919,46681005915,-4,570,1708,30
46682289315,46682289307,-8,493,2096,30
46688444683,46688444675,-8,489,2049,30
46697544218,46697544223,5,4545,2657,30
46700204170,46700204166,-4,1114,2159,30
46700872934,46700872930,-4,1071,3555,30
46706725074,46706725069,-5,918,2913,30
46707543170,46707543164,-6,682,2995,30
46714633775,46714633770,-5,997,2788,30
46716470902,46716470898,-4,737,2783,30
46718066075,46718066070,-5,1175,3574,30
46723020177,46723020173,-4,1645,4004,30
46723963739,46723963735,-4,1,805,30
46733625573,46733625569,-4,1184,4276,30
46739757999,46739757997,-2,1018,2209,30
46741793806,46741793803,-3,1396,1732,30
46744477678,46744477672,-6,1000,3219,30
46746034538,46746034531,-7,901,3067,30
46753823142,46753823136,-6,1118,2962,30
46754762851,46754762848,-3,1062,2359,30
46755000425,46755000408,-17,1124,3419,30
46757214319,46757214314,-5,1110,2713,30
46760990923,46760990902,-21,1104,3742,30
46763064230,46763064227,-3,1625,2002,30
46765039883,46765039889,6,182,952,30
46766341373,46766341369,-4,1445,2974,30
46767857092,46767857089,-3,1512,2559,30
46774132123,46774132117,-6,1322,3400,30
46774784406,46774784401,-5,858,2782,30
46776335878,46776335873,-5,860,2814,30
46779364470,46779364468,-2,1182,3391,30
46782847787,46782847781,-6,190,1983,30
46782947028,46782947026,-2,308,896,30
46783709866,46783709858,-8,279,566,30
46783951978,46783951970,-8,433,1896,30
46792920781,46792920776,-5,721,1147,30
46793276073,46793276089,16,807,2283,30
46794402626,46794402622,-4,895,2634,30
46796185231,46796185230,-1,906,2003,30
46799632493,46799632488,-5,1186,2578,30
46801553370,46801553366,-4,592,2421,30
46804344083,46804344077,-6,4251,13744,30
46804739017,46804739016,-1,20399,23838,30
46809243103,46809243088,-15,978,3172,30
46809507697,46809507680,-17,1142,2513,30
46811983727,46811983721,-6,637,1990,30
46815876155,46815876156,1,1717,2223,30
46821800194,46821800190,-4,894,2377,30
46822212207,46822212202,-5,1189,3173,30
46823790625,46823790622,-3,909,2598,30
46825630482,46825630481,-1,1796,1725,30
46831119484,46831119480,-4,1522,2007,30
46833664255,46833664250,-5,955,2978,30
46840619823,46840619806,-17,1468,674,30
46848205083,46848205081,-2,581,1900,30
46849363642,46849363635,-7,1149,2846,30
46851143635,46851143630,-5,1033,1899,30
46855143151,46855143145,-6,1096,2299,30
46855762642,46855762646,4,2138,1459,30
46855896886,46855896883,-3,1016,3189,30
46860090847,46860090843,-4,2070,4578,30
46866157439,46866157433,-6,1066,3095,30
46869152087,46869152083,-4,1011,1874,30
46870084001,46870083997,-4,941,2929,30
46870232444,46870232463,19,872,2038,30
46874652585,46874652582,-3,1270,2251,30
46876293834,46876293838,4,2052,1544,30
46877332494,46877332489,-5,785,2733,30
46879797395,46879797392,-3,887,2158,30
46881261995,46881261989,-6,894,2650,30
46884023955,46884023949,-6,1149,3696,30
46887055028,46887055022,-6,1072,2839,30
46900081146,46900081142,-4,965,2047,30
46903222186,46903222181,-5,852,3055,30
46904149111,46904149106,-5,769,2344,30
46904705690,46904705711,21,846,3104,30
46908868656,46908868651,-5,1251,2820,30
46910147265,46910147261,-4,947,2441,30
46916160637,46916160632,-5,1078,2646,30
46924687347,46924687343,-4,1275,2955,30
46929678685,46929678698,13,595,1944,30
46932402097,46932402098,1,1077,1654,30
46932892877,46932892884,7,11184,2374,30
46934491158,46934491155,-3,924,2478,30
46938198510,46938198518,8,3495,1643,30
46939605505,46939605502,-3,1142,3053,30
46940659734,46940659730,-4,997,2444,30
46940729946,46940729941,-5,866,1785,30
46942401639,46942401635,-4,1021,3014,30
46943518135,46943518131,-4,828,2961,30
46944329163,46944329158,-5,1148,3520,30
46944473655,46944473651,-4,756,1845,30
46944546289,46944546285,-4,1094,1885,30
46945750249,46945750246,-3,1102,2713,30
46946016866,46946016853,-13,291,970,30
46949568265,46949568260,-5,1559,2560,30
46957388892,46957388897,5,4699,2633,30
46958638980,46958638983,3,7657,22174,30
46959594930,46959594931,1,938,1469,30
46960951474,46960951469,-5,1014,3494,30
46962394715,46962394712,-3,1143,2758,30
46962730401,46962730423,22,932,3972,30
46968058559,46968058555,-4,832,2913,30
46971178479,46971178476,-3,595,2012,30
46971333296,46971333279,-17,264,872,30
46974213178,46974213173,-5,1829,5018,30
46977886082,46977886076,-6,1083,3953,30
46978119050,46978119038,-12,896,2186,30
46978473506,46978473505,-1,303,858,30
46984035298,46984035301,3,2907,2115,30
46984985743,46984985738,-5,845,3523,30
46987147978,46987147974,-4,1093,2495,30
46988218163,46988218142,-21,1053,4032,30
46989522125,46989522121,-4,744,1777,30
46991701497,46991701494,-3,1525,2794,30
46992029615,46992029610,-5,935,3413,30
46997361610,46997361606,-4,756,2443,30
46999998382,46999998377,-5,1021,1856,30
47003765683,47003765682,-1,884,1122,30
47004747545,47004747567,22,651,2809,30
47009621017,47009621025,8,2196,1434,30
47013734359,47013734360,1,2937,4059,30
47014859425,47014859421,-4,1238,2256,30
47018540095,47018540091,-4,1108,3616,30
47019999255,47019999250,-5,936,3344,30
47023040935,47023040930,-5,807,2560,30
47023571258,47023571277,19,1065,2542,30
47026635327,47026635321,-6,777,2693,30
47027997630,47027997626,-4,862,2349,30
47030049425,47030049420,-5,1228,3037,30
47030208235,47030208253,18,1578,5118,30
47036491249,47036491267,18,1196,3119,30
47039034279,47039034275,-4,1006,3211,30
47039686970,47039686966,-4,996,2779,30
47043207981,47043207977,-4,960,2459,30
47049767657,47049767651,-6,891,3449,30
47049793795,47049793797,2,129,651,30
47053227712,47053227709,-3,709,2242,30
47053818201,47053818201,0,1402,1838,30
47054128743,47054128739,-4,1136,2236,30
47058092967,47058092963,-4,766,1930,30
47067586360,47067586355,-5,1397,3235,30
47071055546,47071055541,-5,1119,2683,30
47073712720,47073712718,-2,1138,3578,30
47079086753,47079086748,-5,1138,3551,30
47079423163,47079423182,19,1011,2528,30
47082472837,47082472834,-3,1217,2555,30
47085948061,47085948066,5,1076,506,30
47088169670,47088169666,-4,1010,2945,30
47095594443,47095594439,-4,674,1731,30
47096143633,47096143648,15,627,2190,30
47100033010,47100033006,-4,1064,1956,30
47100074363,47100074382,19,951,3890,30
47102461318,47102461314,-4,944,2862,30
47107581545,47107581541,-4,770,2018,30
47108167169,47108167166,-3,227,1193,30
47109426386,47109426397,11,12222,49589,30
47111263264,47111263266,2,2100,2152,30
47112601231,47112601226,-5,1529,3199,30
47116522912,47116522906,-6,771,2342,30
47128767973,47128767976,3,2158,1253,30
47130621667,47130621659,-8,930,3107,30
47135704969,47135704965,-4,1004,3123,30
47139889751,47139889747,-4,1492,2435,30
47140610410,47140610405,-5,1062,2336,30
47140821011,47140821024,13,739,2216,30
47142025183,47142025189,6,5310,2072,30
47146432606,47146432603,-3,1243,2620,30
47147704230,47147704226,-4,670,3762,30
47150969777,47150969773,-4,1057,2857,30
47151899015,47151899010,-5,1030,3591,30
47158676710,47158676702,-8,1184,4300,30
47165215609,47165215606,-3,1486,3274,30
47165983565,47165983567,2,1878,1614,30
47169153298,47169153294,-4,983,2255,30
47169554027,47169554047,20,574,2102,30
47175402144,47175402139,-5,1435,2838,30
47175481081,47175481082,1,187,1053,30
47177397896,47177397891,-5,1123,2669,30
47182190314,47182190309,-5,937,3165,30
47184088682,47184088676,-6,923,2011,30
47186209863,47186209858,-5,709,2573,30
47198325374,47198325369,-5,994,2596,30
47201520954,47201520937,-17,1203,848,30
47204013438,47204013436,-2,746,1170,30
47204457480,47204457499,19,442,1268,30
47216394232,47216394226,-6,1037,3378,30
47222491835,47222491831,-4,899,2449,30
47223165019,47223165014,-5,826,2277,30
47227556874,47227556870,-4,1106,3418,30
47232480927,47232480922,-5,675,1934,30
47233353780,47233353798,18,1023,3766,30
47235644386,47235644382,-4,903,2292,30
47236329103,47236329100,-3,782,1925,30
47237219971,47237219968,-3,1196,3585,30
47241556555,47241556550,-5,989,3461,30
47241701170,47241701165,-5,924,1822,30
47246824622,47246824614,-8,941,1679,30
47249075460,47249075466,6,2133,1208,30
47256352894,47256352889,-5,1251,3213,30
47260346937,47260346933,-4,1095,2513,30
47263941632,47263941626,-6,1279,2808,30
47264014586,47264014582,-4,727,1625,30
47267384305,47267384301,-4,1186,3609,30
47270750689,47270750684,-5,1307,3116,30
47272619097,47272619089,-8,729,2875,30
47273471195,47273471190,-5,788,2715,30
47276507491,47276507485,-6,796,3312,30
47278954158,47278954154,-4,1395,3582,30
47287618518,47287618514,-4,864,2377,30
47288964022,47288964018,-4,1241,2802,30
47290264669,47290264664,-5,830,3410,30
47292147269,47292147265,-4,1412,2369,30
47293471195,47293471190,-5,1138,2640,30
47293790857,47293790852,-5,733,2683,30
47294505875,47294505870,-5,960,2921,30
47299948338,47299948334,-4,1425,2500,30
47300042794,47300042793,-1,1377,1640,30
47304605774,47304605769,-5,885,2968,30
47310995131,47310995134,3,152,1144,30
47318025104,47318025097,-7,1407,3964,30
47319970088,47319970083,-5,10,839,30
47329848510,47329848505,-5,1523,3821,30
47330013476,47330013478,2,1389,1950,30
47330210633,47330210654,21,336,1290,30
47332463007,47332463002,-5,942,1974,30
47340444919,47340444915,-4,606,1062,30
47354200615,47354200609,-6,1123,2798,30
47355593321,47355593316,-5,1133,2859,30
47356311139,47356311134,-5,1054,3144,30
47357371595,47357371590,-5,1070,2846,30
47361061243,47361061237,-6,1231,3062,30
47362217199,47362217198,-1,4346,8556,30
47363974763,47363974761,-2,1453,3102,30
47367541982,47367541978,-4,816,2118,30
47368510136,47368510132,-4,1462,3712,30
47369669429,47369669423,-6,967,1936,30
47371735286,47371735284,-2,1317,2369,30
47373258789,47373258796,7,2493,1553,30
47379813304,47379813315,11,1,533,30
47383108242,47383108249,7,6679,2606,30
47386470093,47386470089,-4,999,2938,30
47402929472,47402929469,-3,1389,3709,30
47408663903,47408663894,-9,643,2738,30
47408736211,47408736210,-1,1141,2260,30
47410262368,47410262365,-3,1431,1947,30
47410808706,47410808701,-5,989,2348,30
47411439633,47411439626,-7,867,2286,30
47416669263,47416669260,-3,1225,2335,30
47417458642,47417458625,-17,1087,2366,30
47420990875,47420990869,-6,1302,3348,30
47422171195,47422171191,-4,961,2916,30
47423395176,47423395170,-6,1107,3147,30
47423765089,47423765111,22,1068,7435,30
47424452410,47424452407,-3,1051,2885,30
47440284390,47440284385,-5,767,2602,30
47440537802,47440537823,21,285,851,30
47443757943,47443757930,-13,23272,17379,30
47444514117,47444514120,3,3188,1871,30
47448187743,47448187738,-5,1107,3030,30
47449501199,47449501195,-4,800,3141,30
47450059397,47450059391,-6,1121,4491,30
47450105654,47450105649,-5,1023,2935,30
47450765243,47450765237,-6,993,2636,30
47454280656,47454280650,-6,1392,2638,30
47460818154,47460818149,-5,919,2425,30
47466422680,47466422679,-1,8001,12382,30
47476268990,47476268987,-3,1707,2349,30
47477782155,47477782149,-6,733,2989,30
47485797686,47485797681,-5,851,2978,30
47497193455,47497193450,-5,803,3127,30
47497424209,47497424226,17,389,1425,30
47499766862,47499766858,-4,1306,3500,30
47502215358,47502215343,-15,1732,314,30
47502779864,47502779861,-3,1355,2005,30
47506448831,47506448831,0,1267,1884,30
47509167886,47509167882,-4,773,2883,30
47514223875,47514223870,-5,865,2547,30
47514576619,47514576618,-1,1119,1866,30
47514802557,47514802554,-3,1224,2660,30
47515882552,47515882550,-2,1054,2053,30
47524946110,47524946109,-1,1596,2241,30
47525850225,47525850227,2,1988,1342,30
47527563218,47527563228,10,2546,1159,30
47530371358,47530371353,-5,1091,4517,30
47532169418,47532169418,0,1476,1646,30
47532306341,47532306336,-5,2384,9289,30
47532946179,47532946173,-6,857,2820,30
47539860611,47539860606,-5,1033,4173,30
47539961980,47539961973,-7,1470,5264,30
47542002651,47542002653,2,3447,4302,30
47544674022,47544674018,-4,1031,3201,30
47544700297,47544700279,-18,937,2456,30
47552908090,47552908098,8,4637,1321,30
47553027714,47553027710,-4,918,3133,30
47556925742,47556925737,-5,1277,2479,30
47558349754,47558349749,-5,1103,3214,30
47562383814,47562383808,-6,426,1748,30
47563778950,47563778946,-4,1218,3635,30
47565063442,47565063439,-3,1094,2233,30
47571141867,47571141861,-6,772,3097,30
47571748951,47571748949,-2,939,3050,30
47572901990,47572901986,-4,1394,3011,30
47573424324,47573424317,-7,1668,8566,30
47576248814,47576248810,-4,1038,1602,30
47580131381,47580131374,-7,1092,4889,30
47582245450,47582245448,-2,2112,4139,30
47582523033,47582523029,-4,1518,3762,30
47584572326,47584572322,-4,872,2415,30
47584742713,47584742708,-5,1251,2391,30
47589315966,47589315961,-5,930,2836,30
47593188544,47593188541,-3,1238,2597,30
47593381157,47593381152,-5,1254,3351,30
47597771762,47597771760,-2,1068,2247,30
47599158661,47599158656,-5,1208,4673,30
47605478499,47605478495,-4,822,2980,30
47606796480,47606796476,-4,1092,2727,30
47607441195,47607441197,2,263,881,30
47617395873,47617395869,-4,1118,2547,30
47622108255,47622108253,-2,588,2177,30
47622796954,47622796950,-4,936,3839,30
47622993587,47622993601,14,32,876,30
47626170185,47626170186,1,1754,1822,30
47629999975,47629999971,-4,861,2571,30
47630035906,47630035902,-4,1060,2639,30
47635454987,47635454982,-5,883,3099,30
47638124879,47638124873,-6,940,2112,30
47642221023,47642221030,7,1400,874,30
47642630993,47642630987,-6,1160,3112,30
47650469676,47650469672,-4,1031,3241,30
47652050868,47652050881,13,1085,3537,30
47655353632,47655353647,15,13465,45578,30
47661323240,47661323235,-5,1082,2481,30
47662184003,47662183987,-16,72,884,30
47662911336,47662911330,-6,1115,3736,30
47664751457,47664751455,-2,933,1847,30
47665865944,47665865940,-4,1099,2805,30
47679224354,47679224351,-3,845,2006,30
47681909238,47681909235,-3,840,2776,30
47683290259,47683290256,-3,1051,2794,30
47684100237,47684100231,-6,2231,7258,30
47684635974,47684635972,-2,1362,2388,30
47690275025,47690275022,-3,822,1918,30
47690555610,47690555630,20,923,2202,30
47700043695,47700043689,-6,889,2276,30
47702177811,47702177805,-6,1083,2933,30
47704301039,47704301034,-5,1576,3367,30
47707987761,47707987762,1,1442,1485,30
47712818201,47712818198,-3,818,1441,30
47713907125,47713907130,5,3063,1725,30
47716604204,47716604201,-3,630,2977,30
47721535215,47721535210,-5,1057,3010,30
47727448991,47727448989,-2,772,2646,30
47728488019,47728488014,-5,207,948,30
47730925818,47730925814,-4,973,2273,30
47731685542,47731685537,-5,1060,2864,30
47731986002,47731985998,-4,946,2995,30
47732872155,47732872151,-4,942,2495,30
47733411447,47733411442,-5,1049,2671,30
47736855003,47736855000,-3,1047,2306,30
47740067519,47740067514,-5,1469,3443,30
47742357503,47742357499,-4,900,3133,30
47742593827,47742593830,3,228,961,30
47745809137,47745809134,-3,857,2244,30
47747359822,47747359818,-4,1296,3192,30
47750031742,47750031737,-5,1064,3428,30
47751555731,47751555725,-6,1302,2836,30
47752948645,47752948641,-4,1100,2786,30
47758786709,47758786705,-4,1099,2252,30
47763282377,47763282371,-6,922,4068,30
47763457265,47763457281,16,407,1607,30
47765295578,47765295571,-7,1008,3038,30
47768694036,47768694042,6,8621,1375,30
47770288983,47770288977,-6,515,2276,30
47777432531,47777432527,-4,1096,2886,30
47778873569,47778873563,-6,834,4771,30
47781626959,47781626957,-2,1078,2593,30
47786960822,47786960815,-7,897,1539,30
47787406583,47787406579,-4,1132,3649,30
47787917734,47787917729,-5,717,3505,30
47788620762,47788620741,-21,172,1191,30
47790217863,47790217860,-3,1163,3072,30
47795771530,47795771525,-5,984,2620,30
47801699235,47801699232,-3,747,4263,30
47806453062,47806453079,17,15650,50467,30
47808744622,47808744616,-6,1466,4072,30
47808908035,47808908050,15,340,2300,30
47809490289,47809490309,20,673,1778,30
47810039280,47810039277,-3,1239,2439,30
47810574405,47810574403,-2,890,2357,30
47811838771,47811838763,-8,1354,3444,30
47818482770,47818482770,0,1210,1537,30
47825056319,47825056313,-6,1188,3124,30
47829998964,47829998961,-3,1344,3199,30
47831270615,47831270611,-4,852,1510,30
47840922219,47840922213,-6,739,2726,30
47847730966,47847730968,2,1756,1807,30
47861178702,47861178699,-3,1129,2316,30
47861534708,47861534703,-5,1200,1750,30
47862577114,47862577112,-2,995,2172,30
47867454745,47867454741,-4,758,2127,30
47867754720,47867754736,16,405,1243,30
47868327255,47868327249,-6,1304,3231,30
47871569014,47871569010,-4,1066,2569,30
47871697818,47871697837,19,104,713,30
47877286030,47877286026,-4,750,2674,30
47880735048,47880735042,-6,1113,2958,30
47881661537,47881661533,-4,1371,2876,30
47885076752,47885076749,-3,1107,2691,30
47885501293,47885501297,4,2619,1971,30
47889334487,47889334484,-3,783,3024,30
47889981982,47889981978,-4,1148,2387,30
47893895837,47893895837,0,1673,1985,30
47899649012,47899648995,-17,273,1788,30
47904031784,47904031779,-5,1201,3512,30
47904534370,47904534382,12,521,1696,30
47904961221,47904961217,-4,882,2540,30
47906300518,47906300514,-4,708,2479,30
47907594635,47907594634,-1,1354,2210,30
47910737235,47910737231,-4,1356,3067,30
47910864391,47910864386,-5,1381,2935,30
47917645454,47917645456,2,1199,1714,30
47919360630,47919360624,-6,989,3340,30
47926653738,47926653733,-5,883,2184,30
47930565954,47930565959,5,3069,761,30
47931788059,47931788056,-3,826,2423,30
47939877566,47939877570,4,1165,1259,30
47941824091,47941824087,-4,1022,2830,30
47944543445,47944543446,1,2092,1911,30
47946928274,47946928269,-5,1460,3562,30
47948734657,47948734654,-3,1400,2359,30
47949753194,47949753185,-9,1556,2828,30
47950623004,47950623006,2,1534,1456,30
47963879974,47963879970,-4,802,2927,30
47964113832,47964113842,10,393,729,30
47966018679,47966018673,-6,805,3675,30
47968250097,47968250093,-4,1084,2616,30
47976038961,47976038957,-4,1452,3270,30
47982186861,47982186854,-7,1384,2488,30
47982582374,47982582369,-5,1089,3213,30
47992612151,47992612145,-6,1165,4034,30
47993989057,47993989050,-7,1175,3107,30
47995291920,47995291916,-4,970,2894,30
48003901338,48003901335,-3,974,2630,30
48010543393,48010543389,-4,1081,2354,30
48010886845,48010886839,-6,1197,3452,30
48012835358,48012835357,-1,1163,1656,30
48014649403,48014649400,-3,1105,2333,30
48015009186,48015009183,-3,246,1020,30
48017798434,48017798429,-5,767,1738,30
48017850489,48017850485,-4,530,2195,30
48024529702,48024529697,-5,665,2742,30
48039560181,48039560175,-6,584,1967,30
48042212575,48042212570,-5,792,2662,30
48052592944,48052592938,-6,1182,3832,30
48053175191,48053175186,-5,663,1884,30
48054050805,48054050805,0,1382,1357,30
48055347283,48055347276,-7,138,792,30
48057818098,48057818094,-4,1017,2786,30
48058924498,48058924493,-5,1431,3728,30
48061457482,48061457477,-5,1072,2204,30
48062347465,48062347463,-2,1480,2473,30
48063854950,48063854946,-4,2030,4807,30
48074680819,48074680818,-1,1415,1910,30
48077065819,48077065821,2,1178,1080,30
48077579294,48077579290,-4,1128,2906,30
48077973893,48077973889,-4,1293,2478,30
48079853222,48079853217,-5,747,2572,30
48080254973,48080254968,-5,1198,4297,30
48083036605,48083036601,-4,1531,2932,30
48089764073,48089764067,-6,1274,3601,30
48091837675,48091837670,-5,1142,2481,30
48093519416,48093519413,-3,909,3326,30
48094113230,48094113226,-4,1205,2970,30
48097777021,48097777022,1,1167,1273,30
48101992046,48101992051,5,4309,2282,30
48107369570,48107369566,-4,923,2438,30
48107696570,48107696585,15,761,2920,30
48109175635,48109175626,-9,619,2059,30
48109440666,48109440685,19,1006,3594,30
48109553843,48109553843,0,212,987,30
48111512110,48111512106,-4,1079,2370,30
48112673398,48112673393,-5,1186,2966,30
48118764670,48118764667,-3,1126,2684,30
48120351363,48120351359,-4,1095,2526,30
48123881931,48123881938,7,2968,1175,30
48129170578,48129170573,-5,795,1811,30
48132233035,48132233031,-4,797,2332,30
48135672609,48135672607,-2,804,1652,30
48140528890,48140528886,-4,1027,3092,30
48140559635,48140559650,15,622,2480,30
48141831264,48141831259,-5,1237,2673,30
48143695078,48143695073,-5,814,2251,30
48145429402,48145429407,5,3738,1771,30
48146290834,48146290830,-4,1239,2110,30
48147994093,48147994090,-3,755,2520,30
48148479180,48148479176,-4,1255,2465,30
48149438904,48149438900,-4,290,860,30
48149630949,48149630945,-4,848,2870,30
48155600687,48155600680,-7,1095,5183,30
48157512234,48157512229,-5,757,2068,30
48164263003,48164262999,-4,869,2824,30
48165767554,48165767552,-2,916,2738,30
48169075097,48169075092,-5,1068,2785,30
48169497346,48169497341,-5,1222,3780,30
48178967335,48178967330,-5,1087,2678,30
48181228833,48181228829,-4,855,2668,30
48181478217,48181478235,18,187,884,30
48184052553,48184052550,-3,1123,2176,30
48187252242,48187252238,-4,979,3134,30
48187554530,48187554527,-3,1018,1888,30
48189609681,48189609678,-3,808,1841,30
48190768526,48190768522,-4,930,2980,30
48193205930,48193205926,-4,1479,3977,30
48198514365,48198514360,-5,1202,3025,30
48203093120,48203093120,0,1296,2834,30
48203785161,48203785142,-19,250,741,30
48204552525,48204552521,-4,1453,2927,30
48206446020,48206446004,-16,1997,13688,30
48207205348,48207205348,0,1264,1273,30
48218813457,48218813453,-4,1144,3540,30
48220628637,48220628634,-3,1022,2221,30
48224668850,48224668847,-3,956,2404,30
48226338623,48226338620,-3,904,2613,30
48227495855,48227495850,-5,756,3396,30
48228631006,48228631002,-4,1626,3070,30
48237128154,48237128151,-3,1101,2760,30
48239349190,48239349198,8,5849,1350,30
48247967899,48247967894,-5,1171,2521,30
48255525159,48255525153,-6,1043,2821,30
48257465314,48257465307,-7,1048,4279,30
48258028808,48258028790,-18,401,900,30
48264512781,48264512777,-4,1181,4218,30
48264823796,48264823784,-12,1391,3890,30
48270325753,48270325761,8,13664,23957,30
48271305729,48271305732,3,4144,3240,30
48271728302,48271728297,-5,1109,2734,30
48271989719,48271989714,-5,1058,3206,30
48279095155,48279095158,3,1742,1654,30
48279788843,48279788837,-6,1112,1860,30
48281300350,48281300345,-5,966,2463,30
48293187298,48293187293,-5,875,2332,30
48293782286,48293782282,-4,1339,2577,30
48300508176,48300508173,-3,1170,2798,30
48301225182,48301225178,-4,835,2471,30
48312005750,48312005757,7,2022,1077,30
48314578318,48314578314,-4,1008,2913,30
48316938701,48316938697,-4,832,3974,30
48317914309,48317914306,-3,1160,2514,30
48320181467,48320181461,-6,1172,4329,30
48323160155,48323160157,2,1040,1366,30
48323713059,48323713066,7,8472,2946,30
48326509127,48326509123,-4,1707,3954,30
48326809973,48326809971,-2,1128,3149,30
48329319462,48329319456,-6,1432,3617,30
48329984346,48329984346,0,2104,3209,30
48340090512,48340090505,-7,1108,4160,30
48344321585,48344321587,2,1380,1511,30
48349650093,48349650088,-5,1096,2253,30
48350934975,48350934972,-3,1227,2736,30
48354561004,48354561009,5,2256,1030,30
48360267928,48360267922,-6,1011,3049,30
48361284994,48361284990,-4,1119,2348,30
48364435823,48364435818,-5,734,3261,30
48367064269,48367064265,-4,991,3372,30
48367170900,48367170918,18,427,1155,30
48367250098,48367250093,-5,32264,13680,30
48372904257,48372904250,-7,1166,3330,30
48373387928,48373387919,-9,281,765,30
48378341450,48378341448,-2,844,2192,30
48378693074,48378693090,16,194,1058,30
48379395522,48379395517,-5,790,2674,30
48379513959,48379513957,-2,1170,2266,30
48379726949,48379726946,-3,1162,2305,30
48381603127,48381603122,-5,1030,3301,30
48384992635,48384992631,-4,1278,3324,30
48389396429,48389396423,-6,1065,3362,30
48393916622,48393916618,-4,1372,4019,30
48398031211,48398031217,6,1428,713,30
48402851355,48402851350,-5,1027,3527,30
48403832580,48403832576,-4,1108,2645,30
48404300115,48404300112,-3,1069,3155,30
48404584345,48404584337,-8,975,2081,30
48407477971,48407477958,-13,122,1068,30
48410182017,48410182013,-4,1049,2607,30
48419149338,48419149343,5,1991,1066,30
48421116333,48421116330,-3,694,2131,30
48429112482,48429112477,-5,691,1405,30
48434466677,48434466672,-5,865,2894,30
48441138783,48441138777,-6,1257,3300,30
48441240180,48441240166,-14,738,3264,30
48441941672,48441941666,-6,871,2809,30
48443451490,48443451486,-4,1142,2715,30
48444733499,48444733498,-1,929,2115,30
48449004041,48449004037,-4,1342,3073,30
48450805814,48450805809,-5,1590,2703,30
48451318418,48451318414,-4,761,2059,30
48455049262,48455049259,-3,1143,1692,30
48461825057,48461825067,10,256,1043,30
48461955170,48461955169,-1,492,1421,30
48462922626,48462922626,0,1333,749,30
48465972922,48465972917,-5,1041,2566,30
48466079361,48466079376,15,746,4379,30
48466302662,48466302657,-5,1134,2304,30
48469679087,48469679082,-5,1426,2332,30
48473123735,48473123730,-5,1336,3234,30
48474952641,48474952637,-4,1258,2796,30
48475431417,48475431438,21,985,3220,30
48477622655,48477622650,-5,585,2817,30
48480969129,48480969125,-4,1248,3155,30
48481008658,48481008654,-4,1106,2525,30
48481620475,48481620470,-5,1806,8204,30
48488600722,48488600718,-4,970,3292,30
48498561802,48498561796,-6,1050,3154,30
48500434549,48500434543,-6,520,1677,30
48504808329,48504808324,-5,1047,2932,30
48511015063,48511015058,-5,1411,3564,30
48513263894,48513263889,-5,1456,2670,30
48515796434,48515796429,-5,1006,3135,30
48516726505,48516726495,-10,844,1673,30
48521943563,48521943561,-2,912,2256,30
48525040532,48525040528,-4,5636,13702,30
48543606497,48543606494,-3,871,3302,30
48544800233,48544800229,-4,1003,3180,30
48549637096,48549637091,-5,983,2855,30
48552120218,48552120215,-3,918,2496,30
48556714187,48556714182,-5,970,3044,30
48565738197,48565738190,-7,1359,3513,30
48570394066,48570394062,-4,978,4407,30
48571262603,48571262585,-18,100,1371,30
48576529856,48576529850,-6,1062,3677,30
48584170839,48584170835,-4,847,2744,30
48585380355,48585380350,-5,853,2725,30
48586047436,48586047440,4,202,976,30
48587189210,48587189204,-6,1471,3192,30
48589156053,48589156049,-4,1158,3913,30
48594908290,48594908290,0,1905,2190,30
48596986447,48596986442,-5,790,2180,30
48602476535,48602476530,-5,1175,2896,30
48608183830,48608183831,1,1614,1750,30
48608322970,48608322981,11,12722,46623,30
48609383221,48609383215,-6,1692,3093,30
48612651626,48612651623,-3,1187,2391,30
48616836013,48616836009,-4,824,2031,30
48617458736,48617458758,22,1309,2735,30
48617562604,48617562601,-3,565,2182,30
48627959076,48627959085,9,20943,45343,30
48629705735,48629705731,-4,976,2496,30
48629845720,48629845718,-2,241,1444,30
48630903747,48630903741,-6,1143,3300,30
48631146135,48631146132,-3,797,2687,30
48631235386,48631235370,-16,770,2690,30
48648622257,48648622262,5,7115,2423,30
48649968656,48649968650,-6,1335,3410,30
48651494925,48651494921,-4,1234,2896,30
48653986838,48653986833,-5,1614,4029,30
48654651665,48654651661,-4,1242,4269,30
48657509911,48657509905,-6,987,2623,30
48658639350,48658639344,-6,1066,3055,30
48660241400,48660241398,-2,1141,1660,30
48663226137,48663226133,-4,1223,2362,30
48665406010,48665406006,-4,961,3298,30
48669164739,48669164734,-5,1371,2827,30
48673700708,48673700706,-2,1759,2362,30
48681374761,48681374754,-7,1467,3579,30
48684621631,48684621626,-5,1313,3851,30
48690423977,48690423972,-5,1357,4133,30
48696603855,48696603849,-6,1179,3009,30
48703273352,48703273349,-3,1024,1502,30
48703755396,48703755413,17,517,1796,30
48707112972,48707112970,-2,1263,2858,30
48708018596,48708018578,-18,1006,3160,30
48711943326,48711943322,-4,1269,2905,30
48713383435,48713383430,-5,918,2971,30
48714203778,48714203784,6,160,773,30
48714762105,48714762102,-3,511,1131,30
48715377825,48715377825,0,190,1499,30
48717026451,48717026448,-3,1587,3181,30
48718047350,48718047346,-4,1161,2691,30
48718427504,48718427504,0,1504,2632,30
48720451759,48720451753,-6,1247,4086,30
48721938566,48721938572,6,3239,953,30
48722136550,48722136541,-9,1429,30110,30
48722769754,48722769749,-5,1205,2685,30
48723777578,48723777574,-4,1126,2569,30
48727823703,48727823699,-4,1163,2637,30
48730166926,48730166918,-8,930,3115,30
48742146913,48742146920,7,13206,26717,30
48742897529,48742897525,-4,793,2294,30
48745627886,48745627881,-5,1434,3308,30
48753130213,48753130209,-4,847,2568,30
48753541160,48753541178,18,938,2596,30
48760484866,48760484861,-5,875,3333,30
48768027618,48768027611,-7,960,4013,30
48768129030,48768129026,-4,962,3032,30
48772349115,48772349111,-4,1283,2967,30
48773890930,48773890937,7,3299,1258,30
48776569279,48776569274,-5,980,3038,30
48782887926,48782887923,-3,919,2710,30
48784258768,48784258764,-4,1314,2144,30
48784490731,48784490748,17,330,2092,30
48791250937,48791250932,-5,914,2886,30
48793952330,48793952325,-5,1178,3188,30
48794821478,48794821482,4,2468,1283,30
48795788162,48795788157,-5,1294,3159,30
48798946249,48798946257,8,7336,2066,30
48808224382,48808224378,-4,764,3128,30
48808388801,48808388819,18,986,3017,30
48809604542,48809604538,-4,1123,4067,30
48812658166,48812658160,-6,971,3836,30
48814739821,48814739816,-5,820,2938,30
48815230640,48815230654,14,179,1100,30
48819072738,48819072732,-6,1018,2963,30
48834933426,48834933421,-5,699,1278,30
48835130022,48835130025,3,1752,1238,30
48840857529,48840857523,-6,791,2676,30
48843915685,48843915681,-4,1328,2769,30
48867820079,48867820077,-2,7054,14792,30
48872398547,48872398541,-6,1077,1547,30
48872501644,48872501638,-6,763,3144,30
48874023510,48874023501,-9,747,3564,30
48875326841,48875326837,-4,945,2490,30
48881986539,48881986536,-3,1002,2741,30
48882863279,48882863273,-6,1254,4309,30
48892525499,48892525493,-6,753,2818,30
48895981301,48895981297,-4,1160,3539,30
48897504685,48897504686,1,2351,2425,30
48905861386,48905861382,-4,27547,7897,30
48906959874,48906959870,-4,979,2880,30
48907146139,48907146119,-20,138,989,30
48912655302,48912655299,-3,1125,2850,30
48917641211,48917641205,-6,510,2235,30
48917706033,48917706053,20,467,1236,30
48919526057,48919526063,6,3362,2330,30
48920419700,48920419696,-4,1441,3815,30
48923472164,48923472158,-6,1047,3287,30
48924225403,48924225406,3,36,796,30
48925593472,48925593456,-16,1225,2552,30
48925622684,48925622697,13,254,1224,30
48932596373,48932596369,-4,965,3568,30
48937137063,48937137058,-5,1301,2915,30
48937520481,48937520485,4,3484,3443,30
48940764254,48940764250,-4,1367,3303,30
48941048454,48941048450,-4,1060,3448,30
48941278056,48941278077,21,387,1450,30
48946802558,48946802553,-5,1284,3727,30
48948486767,48948486763,-4,1078,3232,30
48953503275,48953503269,-6,964,3583,30
48953558318,48953558330,12,10732,48679,30
48955395267,48955395262,-5,1289,4110,30
48956207410,48956207405,-5,898,3180,30
48958685324,48958685318,-6,1406,2886,30
48966901684,48966901678,-6,1113,2747,30
48967463079,48967463075,-4,718,3372,30
48970323614,48970323609,-5,804,1872,30
48975285483,48975285478,-5,566,1929,30
48981014289,48981014285,-4,895,2376,30
48983416406,48983416403,-3,787,2540,30
48984846071,48984846070,-1,1185,1906,30
48984998968,48984998950,-18,1120,3364,30
48986040189,48986040184,-5,741,4217,30
48986215361,48986215351,-10,936,3283,30
48986442571,48986442590,19,1090,3521,30
48988571481,48988571477,-4,927,2145,30
48990258603,48990258602,-1,1112,2021,30
48999391398,48999391389,-9,994,2943,30
49002629527,49002629523,-4,819,2750,30
49002669195,49002669215,20,577,2860,30
49002990219,49002990214,-5,897,3319,30
49003196451,49003196446,-5,1169,2544,30
49005245267,49005245262,-5,1247,2688,30
49008173124,49008173119,-5,963,2859,30
49023007138,49023007135,-3,986,2465,30
49028750178,49028750174,-4,749,2075,30
49038262177,49038262174,-3,855,1872,30
49039093429,49039093423,-6,999,2272,30
49039902929,49039902922,-7,876,2797,30
49041282115,49041282110,-5,983,3310,30
49044573484,49044573481,-3,968,3173,30
49050014839,49050014834,-5,1072,2903,30
49052120130,49052120145,15,669,2852,30
49054049376,49054049372,-4,1456,3304,30
49058684551,49058684554,3,1683,1620,30
49060375247,49060375247,0,1421,2187,30
49062560878,49062560873,-5,1365,3204,30
49067412984,49067412981,-3,1549,2975,30
49068522294,49068522288,-6,1015,2576,30
49068708363,49068708353,-10,210,706,30
49079827919,49079827916,-3,960,3442,30
49085379506,49085379502,-4,741,3092,30
49088475994,49088475990,-4,976,2520,30
49088562190,49088562190,0,763,1302,30
49090299931,49090299927,-4,1201,3395,30
49091053222,49091053218,-4,834,3728,30
49092890924,49092890918,-6,1056,3312,30
49098876015,49098876009,-6,950,2379,30
49099327378,49099327373,-5,1241,2953,30
49102446798,49102446791,-7,1336,6334,30
49103254751,49103254745,-6,919,2814,30
49103314291,49103314285,-6,1136,3386,30
49105597719,49105597714,-5,1005,2469,30
49112492166,49112492162,-4,883,2790,30
49124461575,49124461573,-2,1006,2440,30
49129706749,49129706745,-4,613,1917,30
49130153746,49130153765,19,932,2164,30
49130223875,49130223870,-5,1548,3385,30
49132995197,49132995184,-13,2151,1128,30
49136653081,49136653077,-4,1572,2905,30
49136896034,49136896043,9,68,546,30
49139385815,49139385810,-5,825,1978,30
49143670587,49143670583,-4,1290,3869,30
49144115089,49144115103,14,386,1407,30
49147782594,49147782581,-13,1347,460,30
49155831532,49155831527,-5,1188,3093,30
49155923858,49155923858,0,192,1209,30
49156284696,49156284681,-15,262,876,30
49157747474,49157747470,-4,122,912,30
49161121886,49161121883,-3,974,3378,30
49161180618,49161180614,-4,854,2263,30
49167036585,49167036581,-4,1058,3046,30
49169522412,49169522409,-3,950,2600,30
49171766851,49171766846,-5,612,2123,30
49175419983,49175419978,-5,583,1627,30
49175859059,49175859061,2,50,913,30
49177349167,49177349163,-4,786,2861,30
49188162734,49188162729,-5,923,3158,30
49193435825,49193435821,-4,741,3338,30
49200265743,49200265743,0,1708,1613,30
49211530227,49211530224,-3,1162,2444,30
49213210021,49213210021,0,1297,1673,30
49215089286,49215089282,-4,1167,3033,30
49218387323,49218387318,-5,1005,3475,30
49225057966,49225057960,-6,1275,2735,30
49227658107,49227658102,-5,647,1414,30
49228125650,49228125638,-12,269,1127,30
49238736593,49238736588,-5,1103,3008,30
49251326679,49251326676,-3,1076,2434,30
49252122934,49252122931,-3,956,2777,30
49261238503,49261238498,-5,920,2435,30
49263302181,49263302186,5,3548,1768,30
49265422807,49265422803,-4,1352,3175,30
49269816210,49269816206,-4,1013,2442,30
49271226164,49271226158,-6,1234,3627,30
49271448904,49271448886,-18,340,1192,30
49273257860,49273257875,15,735,1086,30
49274134019,49274134014,-5,1142,3676,30
49275104458,49275104455,-3,1236,3350,30
49276162547,49276162554,7,271,925,30
49276770858,49276770875,17,752,2356,30
49277895935,49277895934,-1,1821,2800,30
49278626292,49278626285,-7,1238,4784,30
49281223118,49281223112,-6,1161,4526,30
49281334260,49281334268,8,139,974,30
49303636326,49303636323,-3,1742,2925,30
49307947909,49307947906,-3,1200,3470,30
49319990295,49319990290,-5,880,3283,30
49320181403,49320181422,19,481,2465,30
49322176687,49322176683,-4,1168,1513,30
49324296174,49324296169,-5,934,2616,30
49328329693,49328329691,-2,1359,1900,30
49330351810,49330351805,-5,1344,2712,30
49331731764,49331731759,-5,873,2972,30
49335098714,49335098710,-4,1213,2815,30
49337624133,49337624129,-4,1389,3585,30
49340688611,49340688608,-3,1441,2442,30
49350816900,49350816896,-4,1111,2651,30
49352434045,49352434048,3,1816,1758,30
49353419208,49353419204,-4,996,3020,30
49356657782,49356657778,-4,664,2565,30
49376294426,49376294421,-5,1078,2416,30
49376862023,49376862021,-2,1372,2692,30
49377655030,49377655026,-4,1493,4263,30
49378076827,49378076834,7,3091,1507,30
49383358864,49383358859,-5,1191,3242,30
49391622330,49391622326,-4,1074,2685,30
49391841044,49391841058,14,1416,2902,30
49392215148,49392215165,17,913,2271,30
49394952272,49394952279,7,1619,455,30
49396863737,49396863733,-4,984,3251,30
49398965687,49398965682,-5,1111,2972,30
49400149830,49400149825,-5,1563,3671,30
49400441013,49400441014,1,784,945,30
49404529985,49404529984,-1,6738,22189,30
49405069675,49405069694,19,877,2789,30
49408139584,49408139581,-3,929,2380,30
49414348246,49414348241,-5,1567,5625,30
49415681395,49415681391,-4,1170,2449,30
49421947642,49421947637,-5,832,3075,30
49422368816,49422368807,-9,211,1181,30
49427309488,49427309485,-3,1274,2981,30
49432107317,49432107322,5,3646,26905,30
49439663487,49439663495,8,10223,31376,30
49441932811,49441932805,-6,852,2883,30
49443765145,49443765141,-4,1160,3262,30
49444336995,49444337010,15,813,1453,30
49445109749,49445109746,-3,944,2035,30
49445150778,49445150773,-5,1337,3312,30
49445213403,49445213398,-5,902,3301,30
49445545872,49445545894,22,917,1852,30
49447157355,49447157350,-5,823,2530,30
49448217910,49448217905,-5,1004,3818,30
49448637691,49448637710,19,408,2357,30
49451676595,49451676591,-4,761,1870,30
49459089587,49459089581,-6,790,3974,30
49459175874,49459175871,-3,1239,1804,30
49474064105,49474064110,5,14880,17770,30
49481988458,49481988453,-5,699,2833,30
49483713506,49483713504,-2,111,1520,30
49484048178,49484048174,-4,1021,3663,30
49485363262,49485363258,-4,1047,2354,30
49485811578,49485811571,-7,945,3538,30
49487582791,49487582787,-4,905,1983,30
49490081566,49490081561,-5,1408,3624,30
49490334190,49490334187,-3,1162,3217,30
49492309126,49492309119,-7,1009,2811,30
49493030874,49493030859,-15,48,1291,30
49493983043,49493983039,-4,708,743,30
49494122892,49494122870,-22,257,1109,30
49498651984,49498651990,6,5384,2471,30
49502026255,49502026250,-5,1144,2590,30
49502123044,49502123058,14,484,2427,30
49506052550,49506052550,0,1122,1148,30
49506872892,49506872889,-3,1001,3068,30
49507020706,49507020706,0,1638,1593,30
49515788499,49515788493,-6,907,2697,30
49516518366,49516518362,-4,859,3164,30
49516963835,49516963830,-5,823,3509,30
49517919116,49517919111,-5,1031,2346,30
49519599539,49519599535,-4,649,1614,30
49522195550,49522195547,-3,815,3211,30
49529350895,49529350891,-4,1019,3363,30
49530509952,49530509949,-3,1077,2783,30
49531050846,49531050841,-5,1412,4401,30
49531600079,49531600071,-8,1068,5020,30
49541444901,49541444893,-8,918,2531,30
49546024299,49546024294,-5,1081,2742,30
49546158926,49546158922,-4,1242,3024,30
49554649807,49554649805,-2,1206,2613,30
49555470736,49555470729,-7,855,2899,30
49555910251,49555910255,4,252,1211,30
49559354187,49559354193,6,1445,1090,30
49564140081,49564140075,-6,928,3409,30
49565974555,49565974549,-6,573,2097,30
49567932095,49567932089,-6,902,2796,30
49572859411,49572859407,-4,1296,3125,30
49573310375,49573310370,-5,986,2959,30
49577493758,49577493752,-6,1404,3763,30
49580636651,49580636648,-3,928,1897,30
49581095760,49581095755,-5,1039,3694,30
49581551688,49581551669,-19,861,2299,30
49581600864,49581600887,23,294,821,30
49587250875,49587250870,-5,674,2373,30
49587477542,49587477538,-4,1153,2850,30
49587731529,49587731530,1,81,1084,30
49594978143,49594978151,8,10938,28735,30
49597023980,49597023980,0,1717,2739,30
49598324458,49598324454,-4,672,1702,30
49607717801,49607717808,7,6498,2550,30
49609038917,49609038912,-5,937,3060,30
49610226070,49610226066,-4,567,2093,30
49610844524,49610844519,-5,1317,2608,30
49624390390,49624390385,-5,1252,3453,30
49624711008,49624711002,-6,775,2738,30
49631078982,49631078977,-5,1070,2438,30
49643033470,49643033473,3,17458,18312,30
49644453936,49644453930,-6,986,2429,30
49648070927,49648070922,-5,944,3453,30
49655655200,49655655194,-6,1041,2030,30
49657496666,49657496662,-4,1165,2852,30
49665007427,49665007433,6,1404,954,30
49669613721,49669613717,-4,1242,3118,30
49676061992,49676061988,-4,1255,2764,30
49676988923,49676988918,-5,1355,3173,30
49695593674,49695593669,-5,1033,2964,30
49706255906,49706255890,-16,1332,437,30
49707644945,49707644938,-7,1023,3156,30
49707678963,49707678961,-2,1446,3914,30
49708319958,49708319961,3,3508,1815,30
49711546038,49711546033,-5,1416,4517,30
49717764910,49717764894,-16,703,1732,30
49722767508,49722767502,-6,1138,3414,30
49727262793,49727262787,-6,1101,4711,30
49727324991,49727324989,-2,1597,3132,30
49733738463,49733738458,-5,1029,2177,30
49738672803,49738672796,-7,731,2351,30
49746373234,49746373230,-4,999,2157,30
49748716053,49748716058,5,1372,971,30
49749010570,49749010565,-5,858,2581,30
49749124740,49749124751,11,211,1313,30
49752125858,49752125852,-6,976,3865,30
49756587854,49756587849,-5,1104,3509,30
49757641387,49757641382,-5,1999,9729,30
49758924567,49758924566,-1,847,1666,30
49766523256,49766523259,3,2132,1774,30
49778553783,49778553779,-4,1317,3381,30
49778695833,49778695855,22,232,815,30
49780700903,49780700899,-4,757,1846,30
49791871589,49791871602,13,780,1513,30
49793867842,49793867838,-4,821,2760,30
49804241980,49804241977,-3,1509,3511,30
49814476845,49814476838,-7,1381,2975,30
49820685827,49820685822,-5,759,2507,30
49822787078,49822787074,-4,1118,2643,30
49827062473,49827062469,-4,984,2330,30
49827929866,49827929861,-5,1257,2852,30
49830541654,49830541650,-4,1001,2600,30
49830980145,49830980139,-6,1090,2326,30
49832085710,49832085707,-3,1098,2051,30
49834870309,49834870306,-3,931,2524,30
49839087037,49839087030,-7,1084,2270,30
49841909087,49841909082,-5,1262,3133,30
49842671361,49842671358,-3,866,2554,30
49843470701,49843470699,-2,1508,3306,30
49858536946,49858536942,-4,1451,4402,30
49862154361,49862154357,-4,1392,3156,30
49864014514,49864014519,5,2237,1066,30
49864236411,49864236407,-4,935,2746,30
49866403373,49866403368,-5,1123,2699,30
49866767077,49866767073,-4,904,2919,30
49870459926,49870459921,-5,962,4153,30
49874383305,49874383301,-4,842,1829,30
49878950246,49878950240,-6,980,2572,30
49881405348,49881405353,5,18,1118,30
49882628250,49882628234,-16,131,1083,30
49884713480,49884713487,7,74718,22940,30
49889841719,49889841722,3,2656,1613,30
49900978107,49900978105,-2,871,2809,30
49903755027,49903755022,-5,648,2661,30
49905395839,49905395834,-5,797,3177,30
49906791278,49906791274,-4,1080,4017,30
49910493168,49910493161,-7,1162,4105,30
49914825786,49914825782,-4,1797,4020,30
49920253563,49920253560,-3,860,1984,30
49921680363,49921680360,-3,1426,2562,30
49926125899,49926125898,-1,1402,2467,30
49929094448,49929094445,-3,1459,3881,30
49929485839,49929485833,-6,1060,3070,30
49931132950,49931132946,-4,1095,2817,30
49931490858,49931490879,21,236,1332,30
49935989447,49935989442,-5,2135,6574,30
49943146334,49943146329,-5,805,2579,30
49943371299,49943371294,-5,1656,4323,30
49944857449,49944857445,-4,1171,3654,30
49949010190,49949010185,-5,939,3664,30
49952626843,49952626862,19,599,1560,30
49954453185,49954453179,-6,854,2569,30
49955616411,49955616405,-6,878,3471,30
49956254784,49956254799,15,207,2798,30
49956304042,49956304037,-5,985,2448,30
49956371554,49956371539,-15,70,654,30
49963331919,49963331914,-5,1038,3558,30
49964846578,49964846570,-8,23,848,30
49966523398,49966523395,-3,702,2042,30
49966709658,49966709679,21,383,1586,30
49967310295,49967310291,-4,1353,2967,30
49967954690,49967954689,-1,1658,215,30
49968529144,49968529139,-5,680,2673,30
49969443474,49969443453,-21,738,2600,30
49971707235,49971707230,-5,597,3447,30
49974597527,49974597522,-5,991,2839,30
49976423941,49976423937,-4,930,2363,30
49976963144,49976963135,-9,574,1983,30
49977090135,49977090129,-6,979,3747,30
49983106182,49983106178,-4,48850,26979,30
49983378203,49983378198,-5,1845,6682,30
49995182587,49995182584,-3,1031,2847,30
49995867007,49995867001,-6,913,2287,30
49998735791,49998735784,-7,855,1294,30
50006147599,50006147594,-5,971,2188,30
50006184194,50006184214,20,215,859,30
50007472339,50007472341,2,1388,1335,30
50009894103,50009894097,-6,699,2306,30
50011891746,50011891742,-4,862,2266,30
50013623801,50013623795,-6,1022,3058,30
50016212752,50016212750,-2,765,2385,30
50016300680,50016300676,-4,1380,4076,30
50031532141,50031532134,-7,1357,6381,30
50034555668,50034555673,5,1934,1146,30
50040286431,50040286426,-5,1298,3309,30
50040725870,50040725862,-8,935,2663,30
50046284345,50046284341,-4,997,2603,30
50052464815,50052464821,6,12226,26798,30
50055493741,50055493737,-4,1490,3777,30
50058046354,50058046350,-4,900,1806,30
50060669459,50060669457,-2,921,2732,30
50062186163,50062186158,-5,1199,3785,30
50071552543,50071552539,-4,946,2610,30
50071795297,50071795314,17,283,1409,30
50072412139,50072412135,-4,650,1652,30
50072466788,50072466783,-5,810,2716,30
50072905432,50072905451,19,606,2993,30
50074444759,50074444750,-9,652,3728,30
50077574982,50077574978,-4,1129,3962,30
50084429675,50084429670,-5,1975,4445,30
50084998126,50084998124,-2,576,1829,30
50089520758,50089520753,-5,1652,3314,30
50090737520,50090737517,-3,1559,2890,30
50090895746,50090895740,-6,1063,2481,30
50092022414,50092022409,-5,897,3267,30
50093351698,50093351689,-9,1192,2410,30
50100330167,50100330159,-8,1137,3789,30
50104356339,50104356338,-1,1946,1868,30
50112417657,50112417661,4,1241,915,30
50115543237,50115543233,-4,1270,2903,30
50117725834,50117725835,1,1688,2260,30
50122263259,50122263263,4,2448,1679,30
50140619490,50140619486,-4,1394,2388,30
50142448337,50142448334,-3,1231,2485,30
50147913077,50147913073,-4,830,1833,30
50156368753,50156368749,-4,1195,3410,30
50158534395,50158534390,-5,1257,3056,30
50160538819,50160538814,-5,1167,4362,30
50161441719,50161441722,3,41558,97755,30
50163857835,50163857831,-4,1281,3273,30
50164326443,50164326450,7,2770,1373,30
50165989694,50165989674,-20,1117,1564,30
50169125839,50169125834,-5,930,2207,30
50171430245,50171430246,1,1670,2357,30
50171913906,50171913902,-4,1259,3472,30
50171968412,50171968407,-5,117,1035,30
50174881937,50174881934,-3,1225,3260,30
50177540506,50177540503,-3,1219,2412,30
50179111354,50179111352,-2,863,1735,30
50183821625,50183821621,-4,1574,2753,30
50190545797,50190545797,0,10734,13953,30
50191879378,50191879373,-5,1080,3736,30
50191946988,50191947005,17,852,3086,30
50193099357,50193099353,-4,940,3187,30
50197399274,50197399270,-4,1123,2204,30
50202697054,50202697055,1,1206,1106,30
50204149759,50204149754,-5,763,2124,30
50211649249,50211649245,-4,1440,2813,30
50212464395,50212464391,-4,789,2283,30
50218350421,50218350417,-4,575,1578,30
50222785301,50222785306,5,1300,1261,30
50222990514,50222990509,-5,1257,3153,30
50223620219,50223620215,-4,710,2347,30
50225247106,50225247122,16,660,1695,30
50226127670,50226127667,-3,780,3314,30
50232905465,50232905461,-4,1976,4727,30
50233479850,50233479845,-5,1175,3452,30
50233920649,50233920645,-4,1335,3881,30
50235357822,50235357817,-5,802,1021,30
50236284280,50236284274,-6,1213,3533,30
50242070127,50242070122,-5,948,3702,30
50250405737,50250405734,-3,994,1805,30
50250501236,50250501222,-14,84,1045,30
50263368602,50263368597,-5,1236,2867,30
50264320806,50264320802,-4,980,2624,30
50265937287,50265937282,-5,1231,2921,30
50270226975,50270226973,-2,1079,3023,30
50271857242,50271857238,-4,1120,2939,30
50274507411,50274507406,-5,1031,2677,30
50284991387,50284991386,-1,2146,2910,30
50286180179,50286180176,-3,810,3076,30
50291248981,50291248974,-7,1011,3331,30
50297588275,50297588276,1,2316,1794,30
50300597854,50300597850,-4,1214,2249,30
50301225012,50301225024,12,10681,48127,30
50303100285,50303100280,-5,1439,3451,30
50303410051,50303410041,-10,118,787,30
50307928085,50307928083,-2,764,2735,30
50308799955,50308799953,-2,1629,2600,30
50314578889,50314578888,-1,1646,2667,30
50314966279,50314966275,-4,1119,2322,30
50317458051,50317458049,-2,940,2113,30
50318900498,50318900493,-5,1399,3429,30
50319784234,50319784231,-3,1050,2778,30
50321793753,50321793748,-5,1238,4465,30
50325988434,50325988430,-4,780,1354,30
50329462511,50329462507,-4,874,2816,30
50336583315,50336583318,3,2788,2332,30
50338231414,50338231408,-6,1162,3013,30
50338538347,50338538347,0,282,820,30
50339686917,50339686910,-7,1260,3464,30
50344862241,50344862237,-4,1120,3174,30
50345700436,50345700431,-5,1523,4474,30
50348866241,50348866245,4,1951,1659,30
50349106402,50349106406,4,1214,769,30
50352523718,50352523714,-4,860,3018,30
50358278746,50358278746,0,1027,1536,30
50358534074,50358534070,-4,870,4087,30
50362195282,50362195279,-3,831,1829,30
50362375065,50362375085,20,464,2268,30
50365910199,50365910196,-3,1240,2473,30
50367964195,50367964189,-6,855,2588,30
50368332667,50368332681,14,337,1594,30
50375872605,50375872600,-5,1133,4030,30
50376198001,50376197998,-3,950,2672,30
50379357082,50379357078,-4,1241,4051,30
50384911228,50384911223,-5,1281,2418,30
50385939622,50385939618,-4,1595,2834,30
50386418239,50386418234,-5,829,2527,30
50386830819,50386830814,-5,1186,2467,30
50389645110,50389645105,-5,1581,4002,30
50395276073,50395276070,-3,753,1626,30
50398517795,50398517792,-3,797,1222,30
50407645311,50407645308,-3,725,2370,30
50411384759,50411384755,-4,1095,2998,30
50421089130,50421089125,-5,997,2966,30
50421732047,50421732053,6,3064,1769,30
50426424222,50426424217,-5,627,2037,30
50441830881,50441830877,-4,859,2792,30
50442812766,50442812771,5,5706,2247,30
50443025933,50443025928,-5,912,1925,30
50443718778,50443718777,-1,1141,2095,30
50445032150,50445032146,-4,1126,2854,30
50456875925,50456875921,-4,887,2658,30
50456974444,50456974462,18,901,2974,30
50457466856,50457466858,2,1388,1340,30
50462478267,50462478263,-4,852,3209,30
50466652326,50466652326,0,1236,1934,30
50472262094,50472262089,-5,1117,2482,30
50476999553,50476999548,-5,975,3438,30
50478331507,50478331502,-5,1003,2371,30
50484287834,50484287830,-4,1148,2475,30
50489249060,50489249057,-3,860,1983,30
50497006862,50497006869,7,1865,935,30
50497329199,50497329190,-9,1076,1573,30
50498008210,50498008205,-5,845,4534,30
50499510031,50499510026,-5,1328,3279,30
50503511241,50503511243,2,1019,1086,30
50507059377,50507059373,-4,1083,3032,30
50517178697,50517178694,-3,733,1579,30
50517568529,50517568543,14,772,3646,30
50520850821,50520850815,-6,245,1435,30
50521188280,50521188297,17,220,2409,30
50522839999,50522839993,-6,1035,3679,30
50525435378,50525435375,-3,988,2758,30
50536549434,50536549433,-1,1286,2219,30
50539230683,50539230677,-6,902,1457,30
50542085525,50542085518,-7,1377,3776,30
50544794913,50544794909,-4,1299,3184,30
50545023230,50545023225,-5,723,2594,30
50545165090,50545165110,20,610,2730,30
50545758206,50545758202,-4,1120,2315,30
50551166358,50551166344,-14,29091,14867,30
50560783024,50560783022,-2,1284,1864,30
50563899605,50563899599,-6,1017,2894,30
50564875376,50564875372,-4,1389,3168,30
50567265495,50567265493,-2,1038,2398,30
50570170819,50570170814,-5,1016,2619,30
50571422890,50571422885,-5,954,3341,30
50571728865,50571728845,-20,147,1004,30
50572096042,50572096021,-21,1057,3308,30
50579804089,50579804084,-5,1325,3152,30
50580671639,50580671639,0,1107,2029,30
50583503274,50583503269,-5,1071,3025,30
50587479472,50587479468,-4,1252,2538,30
50588081583,50588081578,-5,1063,2727,30
50594747687,50594747682,-5,974,2636,30
50600898532,50600898526,-6,1329,2547,30
50610209690,50610209685,-5,1077,3399,30
50611764885,50611764880,-5,651,2275,30
50613540030,50613540019,-11,17720,15023,30
50621354792,50621354786,-6,813,1735,30
50621720052,50621720069,17,847,2664,30
50623973482,50623973487,5,4272,2291,30
50626573133,50626573133,0,1331,1574,30
50632876165,50632876160,-5,807,1814,30
50635565211,50635565209,-2,974,2252,30
50636739159,50636739154,-5,1029,2083,30
50642541102,50642541097,-5,1123,2841,30
50643331043,50643331038,-5,1185,2520,30
50645542530,50645542529,-1,1202,3320,30
50646636742,50646636738,-4,1176,3320,30
50646758254,50646758256,2,906,1443,30
50650212205,50650212203,-2,1311,1928,30
50653622210,50653622204,-6,707,2037,30
50653938026,50653938021,-5,999,3452,30
50657424950,50657424947,-3,1014,2752,30
50657486027,50657486044,17,200,4380,30
50658275750,50658275745,-5,858,2553,30
50658569494,50658569489,-5,847,2398,30
50666225099,50666225096,-3,944,1749,30
50674826607,50674826605,-2,897,2624,30
50676080191,50676080186,-5,1062,4388,30
50676166081,50676166074,-7,150,1209,30
50678054774,50678054771,-3,1117,3120,30
50678863991,50678863997,6,4142,2260,30
50680449285,50680449287,2,2260,1526,30
50682650646,50682650642,-4,1559,3372,30
50683380664,50683380650,-14,180,1319,30
50686200453,50686200453,0,5761,6485,30
50686233226,50686233222,-4,1392,3329,30
50687120912,50687120923,11,12923,28268,30
50687944999,50687944996,-3,1036,2357,30
50688103955,50688103951,-4,772,2876,30
50697067277,50697067278,1,1113,1843,30
50698651543,50698651539,-4,1084,2200,30
50701395030,50701395026,-4,855,2459,30
50702621700,50702621694,-6,1279,2892,30
50705713402,50705713395,-7,1645,4525,30
50705911457,50705911451,-6,862,3064,30
50706172562,50706172559,-3,1066,2952,30
50710373593,50710373591,-2,1160,2854,30
50713398869,50713398863,-6,1060,3060,30
50715056479,50715056486,7,3581,1470,30
50719129149,50719129146,-3,964,2939,30
50722584279,50722584275,-4,1220,2936,30
50722855788,50722855802,14,1647,3589,30
50725800850,50725800846,-4,1172,2623,30
50730215163,50730215157,-6,1067,2640,30
50734660325,50734660315,-10,1037,2360,30
50735118936,50735118926,-10,166,1238,30
50737049258,50737049254,-4,1015,1821,30
50739228624,50739228647,23,823,3503,30
50739620264,50739620261,-3,867,2024,30
50740335923,50740335922,-1,401,796,30
50752087011,50752087005,-6,937,2688,30
50757954778,50757954772,-6,1189,3579,30
50758575606,50758575603,-3,1247,3265,30
50762651709,50762651703,-6,1039,3056,30
50762698081,50762698085,4,7047,19755,30
50765695829,50765695825,-4,1069,3013,30
50769631093,50769631096,3,2297,2091,30
50776821379,50776821374,-5,1010,3301,30
50788117368,50788117364,-4,1604,3728,30
50790065354,50790065349,-5,980,2956,30
50793884661,50793884657,-4,858,2701,30
50794201194,50794201209,15,1551,2272,30
50794349365,50794349359,-6,912,2385,30
50807860420,50807860417,-3,2174,3861,30
50812253777,50812253773,-4,944,2566,30
50814583342,50814583338,-4,1103,2769,30
50820571305,50820571302,-3,1176,2299,30
50830739147,50830739143,-4,2024,4203,30
50843833198,50843833194,-4,1547,4140,30
50847105701,50847105702,1,2088,1883,30
50848676245,50848676238,-7,1199,2644,30
50861423345,50861423342,-3,811,2195,30
50862082059,50862082043,-16,1201,337,30
50863921147,50863921145,-2,1446,2775,30
50864755963,50864755965,2,1425,1385,30
50865499186,50865499182,-4,1421,3977,30
50868205969,50868205963,-6,948,2775,30
50868278041,50868278047,6,48,915,30
50871844539,50871844534,-5,1235,3120,30
50872187137,50872187159,22,302,992,30
50872972457,50872972477,20,1090,4079,30
50874337331,50874337329,-2,1003,1023,30
50877734007,50877734007,0,838,1298,30
50884836385,50884836389,4,1790,839,30
50905274915,50905274909,-6,849,3548,30
50905524012,50905524031,19,1107,2755,30
50906804724,50906804709,-15,1575,603,30
50909200453,50909200461,8,6138,2044,30
50910401425,50910401421,-4,1272,2111,30
50912617869,50912617874,5,1585,1109,30
50913399874,50913399871,-3,876,2918,30
50917368819,50917368814,-5,1109,2735,30
50917466890,50917466887,-3,1289,2550,30
50924310068,50924310062,-6,749,2406,30
50925045209,50925045225,16,305,762,30
50928373222,50928373214,-8,640,2285,30
50929835509,50929835514,5,1068,529,30
50938498202,50938498198,-4,868,2696,30
50941371335,50941371329,-6,1063,3551,30
50943256093,50943256085,-8,1037,3430,30
50945361071,50945361065,-6,833,2240,30
50960781475,50960781478,3,1895,1640,30
50970734467,50970734463,-4,950,2595,30
50981873130,50981873126,-4,1329,3540,30
50986010726,50986010722,-4,788,2921,30
50987112395,50987112394,-1,1636,1731,30
50988427390,50988427385,-5,930,2902,30
50991372348,50991372344,-4,1504,3946,30
50998851451,50998851446,-5,999,3107,30
50999354850,50999354870,20,990,2920,30
51002894762,51002894758,-4,507,2511,30
51005832941,51005832939,-2,1700,2071,30
51007617055,51007617051,-4,1113,2426,30
51011083927,51011083924,-3,1093,2274,30
51012201371,51012201366,-5,864,2573,30
51013089196,51013089192,-4,1283,3065,30
51013175713,51013175706,-7,144,1019,30
51021543494,51021543490,-4,1234,2881,30
51021937353,51021937344,-9,857,2357,30
51023085933,51023085930,-3,987,3171,30
51023905028,51023905038,10,289,1002,30
51024406975,51024406982,7,141,1095,30
51026984256,51026984251,-5,1481,3931,30
51027070441,51027070430,-11,1015,2791,30
51027951943,51027951962,19,1613,1145,30
51031934485,51031934485,0,1356,1648,30
51033367711,51033367709,-2,543,2800,30
51043370499,51043370495,-4,1224,3064,30
51044731254,51044731250,-4,925,3070,30
51044826131,51044826135,4,1652,864,30
51047259605,51047259598,-7,1373,3952,30
51048709482,51048709478,-4,1317,2333,30
51054810999,51054810994,-5,1348,3602,30
51055190888,51055190882,-6,985,2396,30
51055614178,51055614197,19,108,931,30
51061951637,51061951632,-5,1054,2771,30
51066483268,51066483250,-18,2291,1895,30
51067666063,51067666058,-5,1271,2787,30
51067791986,51067791969,-17,226,1138,30
51068383730,51068383747,17,47,909,30
51078256036,51078256031,-5,783,1455,30
51078652872,51078652894,22,305,815,30
51080832261,51080832259,-2,913,2007,30
51082513066,51082513062,-4,1027,2835,30
51086863776,51086863771,-5,880,3312,30
51094598514,51094598510,-4,1263,3672,30
51094758786,51094758781,-5,1321,3698,30
51097751950,51097751946,-4,1114,2297,30
51110151631,51110151626,-5,754,4079,30
51116333327,51116333322,-5,1273,2519,30
51117747057,51117747054,-3,1191,2329,30
51118659224,51118659231,7,87,982,30
51118970219,51118970215,-4,914,2251,30
51122560775,51122560769,-6,1698,7485,30
51124259363,51124259358,-5,985,2913,30
51128139769,51128139766,-3,1382,3795,30
51128636003,51128636001,-2,602,2394,30
51129539282,51129539276,-6,757,3058,30
51129893884,51129893894,10,266,1166,30
51131798641,51131798643,2,2542,3705,30
51139970845,51139970839,-6,1237,3947,30
51141698679,51141698675,-4,1138,2502,30
51141994325,51141994320,-5,2082,4831,30
51143053856,51143053862,6,2011,697,30
51146505466,51146505461,-5,981,3495,30
51148789706,51148789702,-4,665,2567,30
51152478891,51152478890,-1,1166,2141,30
51152584177,51152584197,20,319,1692,30
51161377938,51161377933,-5,949,3040,30
51162047335,51162047329,-6,1347,4212,30
51162123691,51162123686,-5,1088,3460,30
51167533127,51167533123,-4,1092,2481,30
51168164921,51168164938,17,415,2525,30
51168665222,51168665218,-4,1016,2875,30
51182360011,51182360007,-4,1553,2918,30
51189334839,51189334838,-1,2618,4409,30
51190437408,51190437415,7,29479,34412,30
51193661710,51193661704,-6,1133,2691,30
51196618487,51196618482,-5,763,2388,30
51202554031,51202554027,-4,1202,2276,30
51209640236,51209640218,-18,1162,2850,30
51216147086,51216147081,-5,956,2175,30
51229871791,51229871785,-6,869,2253,30
51236982570,51236982564,-6,1078,2370,30
51237555243,51237555238,-5,1198,2109,30
51241522028,51241522024,-4,1190,3658,30
51245627943,51245627939,-4,1035,3242,30
51246973299,51246973294,-5,1327,3651,30
51249373193,51249373187,-6,1099,3818,30
51251633830,51251633834,4,7439,3814,30
51253041207,51253041202,-5,1112,3627,30
51255525567,51255525563,-4,1162,2391,30
51260718810,51260718807,-3,626,1399,30
51265152781,51265152775,-6,1013,3449,30
51265748385,51265748403,18,371,1615,30
51269011222,51269011222,0,1520,1685,30
51274425288,51274425285,-3,999,1954,30
51280148877,51280148874,-3,1493,3336,30
51288121886,51288121882,-4,1301,3387,30
51290516995,51290516990,-5,984,4078,30
51299100350,51299100355,5,3289,1534,30
51310073854,51310073849,-5,578,2424,30
51311206658,51311206655,-3,736,2358,30
51314859529,51314859526,-3,985,2932,30
51322574354,51322574349,-5,1360,3069,30
51322825095,51322825092,-3,1243,2382,30
51323134654,51323134651,-3,1070,3056,30
51329302607,51329302603,-4,1145,1462,30
51330478341,51330478337,-4,1033,3072,30
51334380329,51334380326,-3,904,3107,30
51337413957,51337413953,-4,1349,3498,30
51337799517,51337799513,-4,1017,2495,30
51346398405,51346398410,5,1398,615,30
51347015176,51347015175,-1,1178,2236,30
51347674561,51347674558,-3,915,3073,30
51352920307,51352920302,-5,802,2174,30
51355810953,51355810947,-6,1525,3925,30
51357434837,51357434830,-7,1318,3056,30
51359478971,51359478967,-4,1098,2206,30
51360048131,51360048126,-5,1549,5153,30
51361653242,51361653238,-4,1110,1845,30
51368132102,51368132098,-4,653,1947,30
51370939129,51370939123,-6,1029,2789,30
51374309350,51374309345,-5,1066,3026,30
51387173334,51387173338,4,2032,1212,30
51388132959,51388132954,-5,757,2429,30
51388606643,51388606642,-1,325,1511,30
51390202703,51390202698,-5,1086,2447,30
51393028101,51393028096,-5,803,2814,30
51397444098,51397444093,-5,1004,2797,30
51401669707,51401669703,-4,834,3195,30
51401936854,51401936851,-3,837,2294,30
51402554107,51402554098,-9,126,1406,30
51403619278,51403619273,-5,984,3073,30
51404118042,51404118037,-5,1274,3201,30
51413617152,51413617146,-6,1217,3582,30
51415497347,51415497341,-6,837,2103,30
51424636788,51424636784,-4,1012,2862,30
51425858421,51425858418,-3,1026,2237,30
51426290492,51426290498,6,80,1767,30
51429450704,51429450686,-18,181,1104,30
51430356427,51430356419,-8,1165,3490,30
51433292498,51433292493,-5,1078,3467,30
51433349498,51433349518,20,1487,4008,30
51434212414,51434212410,-4,971,2116,30
51439348404,51439348400,-4,847,1810,30
51443000637,51443000632,-5,1166,3211,30
51447771177,51447771173,-4,1236,2997,30
51447927107,51447927094,-13,1219,3312,30
51449569675,51449569673,-2,584,1371,30
51450101215,51450101211,-4,1162,2214,30
51452324184,51452324188,4,15037,3821,30
51457235200,51457235196,-4,1027,2834,30
51460887861,51460887857,-4,895,2561,30
51461482631,51461482625,-6,507,1609,30
51465045219,51465045214,-5,941,2362,30
51466279001,51466278997,-4,1289,4232,30
51467157352,51467157348,-4,961,3014,30
51467468801,51467468806,5,189,917,30
51468412987,51468412983,-4,575,1260,30
51470539275,51470539271,-4,1090,3126,30
51479510927,51479510933,6,5654,1853,30
51487154219,51487154218,-1,1100,2198,30
51487627143,51487627139,-4,819,2563,30
51496602963,51496602957,-6,1151,2544,30
51497371246,51497371242,-4,998,3397,30
51497486513,51497486535,22,368,829,30
51497816302,51497816298,-4,1112,3908,30
51498015035,51498015053,18,772,3970,30
51501274216,51501274210,-6,1041,2864,30
51502188666,51502188662,-4,985,2338,30
51505626602,51505626600,-2,868,1630,30
51505930046,51505930041,-5,729,2936,30
51508910954,51508910949,-5,1458,2705,30
51510104222,51510104218,-4,1166,3430,30
51514794578,51514794574,-4,1254,4020,30
51515580137,51515580134,-3,1250,1961,30
51516762652,51516762648,-4,1261,3349,30
51517738226,51517738231,5,209,650,30
51521181178,51521181174,-4,901,2558,30
51531628698,51531628694,-4,1363,3486,30
51532297078,51532297074,-4,1101,3115,30
51535322924,51535322929,5,3067,1467,30
51538474581,51538474577,-4,895,3013,30
51540567419,51540567414,-5,1165,3642,30
51540700211,51540700205,-6,13,696,30
51542223982,51542223976,-6,669,2465,30
51551241702,51551241699,-3,1201,3041,30
51551699227,51551699223,-4,1011,2709,30
51554369873,51554369861,-12,32609,14487,30
51555970477,51555970473,-4,780,2800,30
51558666256,51558666251,-5,797,2324,30
51558867971,51558867967,-4,870,2329,30
51565660493,51565660493,0,1717,2512,30
51570975170,51570975167,-3,1331,296,30
51578959583,51578959578,-5,680,1945,30
51581632357,51581632350,-7,1147,3112,30
51583341432,51583341422,-10,1073,2831,30
51588675224,51588675214,-10,910,2374,30
51588795732,51588795747,15,1165,3101,30
51591930919,51591930921,2,3229,15887,30
51598079712,51598079707,-5,1244,3761,30
51599805910,51599805903,-7,1343,3366,30
51600721622,51600721618,-4,1028,2839,30
51602445087,51602445083,-4,1123,2660,30
51607239714,51607239710,-4,1030,2466,30
51607532193,51607532195,2,1788,933,30
51607776385,51607776381,-4,1233,1793,30
51608803899,51608803887,-12,975,1800,30
51609060480,51609060497,17,933,2222,30
51613176863,51613176861,-2,504,2581,30
51621230267,51621230264,-3,920,2290,30
51624489094,51624489089,-5,740,2348,30
51624529242,51624529242,0,243,981,30
51629347350,51629347351,1,12014,14492,30
51632999283,51632999280,-3,1373,2722,30
51633414055,51633414051,-4,1063,2680,30
51635285057,51635285056,-1,1142,1601,30
51636613269,51636613267,-2,702,2244,30
51636646650,51636646631,-19,834,2359,30
51637365763,51637365782,19,469,2339,30
51640356366,51640356361,-5,685,1631,30
51651958606,51651958600,-6,1803,5793,30
51661332264,51661332260,-4,1216,3717,30
51661514031,51661514028,-3,1238,2062,30
51665585964,51665585962,-2,1127,2015,30
51667262071,51667262071,0,3385,3380,30
51672185343,51672185338,-5,958,3459,30
51674431194,51674431186,-8,893,1903,30
51676674042,51676674035,-7,1212,4758,30
51683157152,51683157147,-5,966,2446,30
51683411340,51683411325,-15,988,2879,30
51690010947,51690010942,-5,1153,3801,30
51691572722,51691572717,-5,1221,3385,30
51691892476,51691892492,16,933,2845,30
51694076749,51694076744,-5,772,1402,30
51696305031,51696305026,-5,1030,3608,30
51703349454,51703349450,-4,1049,1713,30
51705253994,51705253989,-5,1501,4077,30
51705885298,51705885306,8,4302,1472,30
51710041738,51710041734,-4,750,1498,30
51712422016,51712422014,-2,1209,2038,30
51712953401,51712953383,-18,1000,1142,30
51716383244,51716383238,-6,1255,2949,30
51716575411,51716575397,-14,890,1646,30
51716867534,51716867549,15,12991,53010,30
51717339763,51717339759,-4,1109,2940,30
51717693617,51717693623,6,2454,1797,30
51725288202,51725288202,0,2139,2704,30
51726534342,51726534337,-5,1638,3959,30
51726990514,51726990508,-6,846,3798,30
51732608969,51732608964,-5,1214,3294,30
51734151565,51734151561,-4,1354,3212,30
51739427695,51739427689,-6,638,1206,30
51747921315,51747921313,-2,1170,2233,30
51749925308,51749925302,-6,1039,2416,30
51760141007,51760141002,-5,1160,3610,30
51764422128,51764422121,-7,795,2497,30
51767162819,51767162818,-1,927,2661,30
51767690583,51767690580,-3,1189,2515,30
51771747617,51771747612,-5,759,4374,30
51774247110,51774247106,-4,1503,3120,30
51776065918,51776065913,-5,1228,2817,30
51776367104,51776367099,-5,1415,3116,30
51777734222,51777734221,-1,978,2575,30
51778806282,51778806281,-1,36369,21399,30
51778874055,51778874049,-6,925,4650,30
51779046601,51779046597,-4,36766,21391,30
51782031334,51782031330,-4,981,3185,30
51783130792,51783130814,22,219,1565,30
51787510718,51787510713,-5,975,3193,30
51806664796,51806664793,-3,1346,3610,30
51807640515,51807640511,-4,929,1637,30
51810739277,51810739285,8,6420,2395,30
51816665066,51816665061,-5,1331,2545,30
51819065737,51819065726,-11,2200,5144,30
51829715324,51829715323,-1,859,1298,30
51830261002,51830260999,-3,809,1884,30
51830485058,51830485053,-5,869,2493,30
51835009166,51835009162,-4,1271,3585,30
51842368034,51842368030,-4,828,2283,30
51844777939,51844777934,-5,600,2189,30
51846657438,51846657436,-2,869,2846,30
51847067620,51847067634,14,928,2842,30
51853261930,51853261926,-4,808,2392,30
51853513776,51853513770,-6,1263,3704,30
51856048065,51856048062,-3,738,2743,30
51856305224,51856305221,-3,140,1155,30
51860076180,51860076176,-4,623,2429,30
51860260860,51860260875,15,886,3655,30
51860303944,51860303939,-5,1236,2639,30
51860540850,51860540828,-22,1185,2753,30
51863634640,51863634633,-7,1039,2796,30
51871093019,51871093014,-5,3040,10407,30
51871623543,51871623539,-4,1346,2682,30
51871677086,51871677093,7,7273,2427,30
51876223374,51876223369,-5,912,2598,30
51876495072,51876495091,19,1091,3696,30
51878664947,51878664944,-3,1319,2467,30
51885352649,51885352645,-4,785,1806,30
51890146954,51890146951,-3,1188,2711,30
51893508899,51893508893,-6,1071,2126,30
51907067695,51907067690,-5,1056,2876,30
51908796391,51908796386,-5,1155,3198,30
51909696890,51909696887,-3,426,805,30
51911785045,51911785040,-5,1425,3714,30
51915836150,51915836150,0,1791,2837,30
51915961770,51915961765,-5,924,2957,30
51917840045,51917840040,-5,1092,3395,30
51922300169,51922300162,-7,761,3667,30
51929161279,51929161277,-2,1222,3057,30
51933463942,51933463940,-2,3735,7121,30
51935141282,51935141276,-6,772,3494,30
51935256234,51935256231,-3,1048,2385,30
51938502426,51938502422,-4,1045,2032,30
51938798674,51938798681,7,5945,2818,30
51939198955,51939198951,-4,1023,2871,30
51940047570,51940047565,-5,1207,3348,30
51942608787,51942608781,-6,962,2373,30
51945893762,51945893754,-8,1027,3393,30
51947552759,51947552756,-3,1068,2896,30
51951540073,51951540071,-2,1216,1973,30
51961789519,51961789514,-5,1148,2999,30
51965841270,51965841266,-4,821,2284,30
51965874890,51965874905,15,789,4530,30
51971035354,51971035350,-4,761,1912,30
51973641512,51973641509,-3,1629,3013,30
51974027999,51974027994,-5,1123,4810,30
51975894883,51975894878,-5,1324,3603,30
51977218520,51977218518,-2,1400,2621,30
51980699767,51980699763,-4,1068,2355,30
51984183818,51984183822,4,4146,1640,30
51985294575,51985294569,-6,981,3390,30
51985374756,51985374774,18,712,2680,30
51986542098,51986542094,-4,1034,2360,30
51986590607,51986590617,10,12169,34183,30
51987291042,51987291034,-8,684,2298,30
51998244674,51998244670,-4,1471,2359,30
52000884865,52000884860,-5,800,3189,30
52007379559,52007379555,-4,1028,2883,30
52010222130,52010222125,-5,970,3140,30
52016083584,52016083581,-3,1316,3110,30
52016562746,52016562752,6,6684,2552,30
52019315938,52019315935,-3,779,2355,30
52032722670,52032722665,-5,1221,3979,30
52033484641,52033484654,13,176,979,30
52039477833,52039477827,-6,1085,3477,30
52040016852,52040016854,2,1242,1342,30
52045619691,52045619685,-6,1153,2037,30
52053635866,52053635862,-4,1034,3682,30
52056595410,52056595415,5,4572,1565,30
52061581654,52061581657,3,2210,1834,30
52068802649,52068802647,-2,1066,3617,30
52069092355,52069092350,-5,1346,4102,30
52078640517,52078640512,-5,1323,3620,30
52079087102,52079087097,-5,997,2266,30
52080125841,52080125830,-11,982,2373,30
52084470067,52084470063,-4,1055,2369,30
52088013861,52088013857,-4,1382,3706,30
52088533135,52088533130,-5,1196,3284,30
52089270160,52089270154,-6,1088,2274,30
52089652804,52089652800,-4,1225,4412,30
52096489450,52096489448,-2,2180,3343,30
52100270767,52100270762,-5,1074,2461,30
52110839530,52110839525,-5,925,3322,30
52113336709,52113336705,-4,1277,1947,30
52118813924,52118813921,-3,1383,3943,30
52119658907,52119658902,-5,1221,1787,30
52122893434,52122893429,-5,999,2751,30
52123334062,52123334066,4,1990,1371,30
52124385319,52124385314,-5,517,2376,30
52125467066,52125467058,-8,1437,2386,30
52127102134,52127102129,-5,1293,4288,30
52127344891,52127344885,-6,873,3215,30
52138211927,52138211924,-3,1099,2469,30
52138425420,52138425419,-1,1020,1124,30
52144815897,52144815894,-3,1106,3441,30
52160253953,52160253959,6,2901,1854,30
52162857666,52162857662,-4,1128,2189,30
52162986046,52162986041,-5,968,4249,30
52172171835,52172171839,4,2253,976,30
52174774322,52174774314,-8,829,2917,30
52175162971,52175162969,-2,1292,2667,30
52176878162,52176878159,-3,1246,3448,30
52179258181,52179258177,-4,1367,3909,30
52179713822,52179713817,-5,1082,3001,30
52179846218,52179846214,-4,1117,2800,30
52182742503,52182742504,1,1482,2468,30
52183629074,52183629079,5,1654,1101,30
52189754267,52189754264,-3,1046,3475,30
52193694822,52193694817,-5,1326,2657,30
52193937168,52193937164,-4,21823,16073,30
52194054765,52194054760,-5,1072,2814,30
52197500250,52197500243,-7,733,2965,30
52201962390,52201962387,-3,452,2721,30
52202209485,52202209487,2,3323,1617,30
52202468322,52202468311,-11,3717,14783,30
52211183003,52211182998,-5,1329,3433,30
52211498627,52211498633,6,193,1821,30
52212881365,52212881367,2,2980,2619,30
52217619656,52217619650,-6,1098,3262,30
52221521057,52221521053,-4,1151,2637,30
52224976694,52224976691,-3,1597,2687,30
52232320410,52232320406,-4,892,3100,30
52234710662,52234710657,-5,759,3265,30
52234950296,52234950317,21,996,3231,30
52252830159,52252830153,-6,769,2529,30
52255641126,52255641122,-4,1000,2758,30
52261453918,52261453914,-4,1065,3361,30
52265550663,52265550658,-5,1971,4616,30
52268801302,52268801298,-4,1149,2118,30
52269916938,52269916955,17,495,1443,30
52272352947,52272352946,-1,763,1930,30
52274895790,52274895785,-5,1135,2470,30
52282695357,52282695353,-4,815,2258,30
52282961355,52282961350,-5,1306,3512,30
52284461373,52284461368,-5,835,3055,30
52284715312,52284715297,-15,954,1687,30
52285807768,52285807789,21,340,975,30
52290021116,52290021111,-5,781,2368,30
52292174174,52292174169,-5,1352,3964,30
52293113413,52293113407,-6,1111,3959,30
52296588487,52296588481,-6,940,2493,30
52297338234,52297338229,-5,1437,3698,30
52298532335,52298532333,-2,847,1781,30
52302155727,52302155738,11,12936,42026,30
52302576809,52302576806,-3,1433,3242,30
52308082588,52308082583,-5,868,3852,30
52310089223,52310089217,-6,979,2213,30
52318202086,52318202081,-5,886,2701,30
52319250017,52319250013,-4,1174,2409,30
52320877921,52320877918,-3,1243,3326,30
52321081966,52321081959,-7,1642,3026,30
52331205230,52331205226,-4,1033,2552,30
52342744258,52342744252,-6,1134,2694,30
52345227876,52345227871,-5,28163,11789,30
52346697034,52346697030,-4,1011,2315,30
52348283573,52348283570,-3,668,2794,30
52353507004,52353507014,10,227,1312,30
52353817954,52353817958,4,2047,1971,30
52354698470,52354698461,-9,929,2486,30
52358485756,52358485752,-4,1155,2821,30
52362764274,52362764268,-6,1080,3002,30
52363693914,52363693906,-8,96,1270,30
52368004623,52368004617,-6,1155,2331,30
52370239715,52370239710,-5,604,1969,30
52373370510,52373370506,-4,1192,3428,30
52378215753,52378215750,-3,1146,1994,30
52378649483,52378649477,-6,1115,2643,30
52386480755,52386480751,-4,729,1805,30
52388423118,52388423114,-4,824,2142,30
52391164738,52391164734,-4,1037,3152,30
52399384680,52399384675,-5,1216,4592,30
52399930005,52399930001,-4,1063,2468,30
52399970635,52399970648,13,406,1234,30
52401023376,52401023369,-7,1157,2777,30
52401596424,52401596446,22,764,1510,30
52407948462,52407948458,-4,991,2415,30
52409210208,52409210202,-6,1222,3986,30
52411157331,52411157325,-6,1327,2701,30
52417595059,52417595054,-5,923,3154,30
52419509115,52419509113,-2,1041,2175,30
52419955156,52419955171,15,121,875,30
52420848250,52420848246,-4,1352,3058,30
52422220101,52422220097,-4,931,2374,30
52422389337,52422389338,1,2387,2614,30
52423321306,52423321303,-3,1412,3263,30
52427386585,52427386581,-4,1563,3320,30
52428005320,52428005315,-5,1272,2260,30
52428501107,52428501105,-2,1168,2576,30
52429224155,52429224170,15,544,2025,30
52431324035,52431324033,-2,573,1362,30
52432321109,52432321106,-3,1425,3712,30
52435211259,52435211256,-3,1100,3554,30
52438321217,52438321214,-3,1595,4693,30
52440890980,52440890998,18,892,2830,30
52443581841,52443581846,5,2402,1262,30
52445307294,52445307288,-6,1356,3190,30
52457655462,52457655467,5,652,2060,30
52457804083,52457804077,-6,801,2813,30
52466889350,52466889346,-4,1102,2710,30
52466983413,52466983410,-3,806,2379,30
52467453657,52467453653,-4,1149,2447,30
52468583602,52468583622,20,760,2239,30
52468993231,52468993227,-4,877,3023,30
52474318340,52474318337,-3,1002,2847,30
52474644479,52474644478,-1,708,1548,30
52475122529,52475122515,-14,143,765,30
52481497073,52481497068,-5,864,3442,30
52485590133,52485590128,-5,1055,2983,30
52486755941,52486755938,-3,743,1979,30
52490543957,52490543954,-3,1228,2786,30
52492591317,52492591324,7,6355,3106,30
52497927995,52497927991,-4,1190,2928,30
52502220711,52502220706,-5,1395,3651,30
52503663873,52503663870,-3,1488,2942,30
52503692253,52503692250,-3,844,3044,30
52505253206,52505253201,-5,1498,2227,30
52507848881,52507848878,-3,1177,3083,30
52512196176,52512196186,10,89,1123,30
52514684308,52514684305,-3,1177,2144,30
52517414318,52517414317,-1,1085,2007,30
52518151442,52518151444,2,1205,863,30
52520065399,52520065397,-2,908,2353,30
52521682530,52521682526,-4,1003,2217,30
52522348671,52522348665,-6,1312,3052,30
52524040663,52524040657,-6,427,3076,30
52525426252,52525426265,13,272,1097,30
52526676202,52526676197,-5,515,1560,30
52544809271,52544809271,0,24975,25246,30
52546935623,52546935630,7,11911,23147,30
52547070484,52547070502,18,1066,2453,30
52552893031,52552893029,-2,841,2137,30
52554552282,52554552280,-2,554,2184,30
52555791769,52555791765,-4,1067,3113,30
52558289647,52558289643,-4,1231,2797,30
52563172311,52563172318,7,4256,1442,30
52563209825,52563209821,-4,852,2128,30
52563359177,52563359168,-9,239,1360,30
52569207964,52569207959,-5,1683,4973,30
52569602045,52569602042,-3,1363,2293,30
52577064971,52577064965,-6,914,2179,30
52577116500,52577116505,5,169,1420,30
52578236087,52578236082,-5,757,2020,30
52580074731,52580074734,3,10645,8242,30
52582685802,52582685798,-4,535,1780,30
52588368746,52588368741,-5,1710,4239,30
52595410209,52595410203,-6,1115,3072,30
52598867586,52598867580,-6,1315,3029,30
52601101235,52601101230,-5,952,4257,30
52603362478,52603362475,-3,821,2820,30
52605087705,52605087704,-1,1517,2076,30
52606964181,52606964175,-6,1490,4327,30
52609409956,52609409957,1,1615,2121,30
52610525506,52610525501,-5,1233,3874,30
52611952407,52611952403,-4,949,2085,30
52614711494,52614711490,-4,673,2090,30
52623383802,52623383798,-4,1169,2530,30
52627558592,52627558588,-4,1430,1917,30
52631931741,52631931734,-7,1120,4345,30
52632929329,52632929334,5,1929,1424,30
52636134320,52636134317,-3,1260,2931,30
52636233161,52636233158,-3,1179,4111,30
52638505563,52638505559,-4,610,1011,30
52639285418,52639285437,19,781,2390,30
52640382162,52640382157,-5,1584,4161,30
52642003454,52642003450,-4,797,2605,30
52643007404,52643007393,-11,21548,16899,30
52644589497,52644589494,-3,1350,2464,30
52645267859,52645267859,0,55,726,30
52646243385,52646243381,-4,1450,3458,30
52648344642,52648344636,-6,1258,2919,30
52650857274,52650857269,-5,1444,3809,30
52652402223,52652402217,-6,903,8553,30
52653288986,52653288981,-5,1034,2972,30
52654771786,52654771781,-5,940,3367,30
52660899839,52660899836,-3,711,2228,30
52661663213,52661663210,-3,1099,2364,30
52663346011,52663346003,-8,372,1853,30
52664756142,52664756137,-5,1261,7082,30
52665036844,52665036841,-3,1232,2238,30
52668463889,52668463889,0,34458,20957,30
52671654627,52671654622,-5,1460,2693,30
52672582107,52672582102,-5,1042,1762,30
52673814577,52673814597,20,721,3237,30
52675269228,52675269222,-6,1022,3326,30
52675828160,52675828177,17,985,2786,30
52676741090,52676741085,-5,1080,3069,30
52677837854,52677837849,-5,1125,3274,30
52680333662,52680333657,-5,741,3180,30
52684862843,52684862838,-5,973,3139,30
52686418895,52686418889,-6,928,2119,30
52690966782,52690966782,0,1593,1805,30
52696716762,52696716760,-2,1370,2092,30
52697142763,52697142758,-5,1202,3010,30
52697836924,52697836917,-7,632,4650,30
52699721750,52699721748,-2,1429,2554,30
52700127884,52700127877,-7,22583,16985,30
52702064770,52702064768,-2,1410,2809,30
52702200567,52702200562,-5,1101,3127,30
52704689247,52704689243,-4,919,2263,30
52706019571,52706019566,-5,917,3016,30
52708870041,52708870037,-4,1290,2437,30
52712222375,52712222371,-4,1096,2309,30
52712958714,52712958722,8,205,1172,30
52717550577,52717550572,-5,1281,3594,30
52717866677,52717866673,-4,1202,3095,30
52719530834,52719530829,-5,1059,3359,30
52722918315,52722918311,-4,978,2877,30
52724390480,52724390478,-2,606,1843,30
52724907656,52724907674,18,308,1089,30
52727091377,52727091377,0,1535,1539,30
52729352427,52729352421,-6,895,2357,30
52729576163,52729576157,-6,1002,2914,30
52730217274,52730217270,-4,1342,3290,30
52735112554,52735112550,-4,984,4009,30
52737371262,52737371258,-4,1088,2831,30
52737396338,52737396321,-17,1206,2480,30
52737871181,52737871177,-4,835,2835,30
52737978818,52737978802,-16,81,1025,30
52740504562,52740504557,-5,913,2226,30
52743228891,52743228889,-2,1704,3165,30
52743649861,52743649857,-4,994,2836,30
52747193107,52747193112,5,2067,1747,30
52749482994,52749482989,-5,733,3234,30
52752739092,52752739087,-5,1130,3270,30
52759810618,52759810613,-5,1011,3594,30
52760312701,52760312701,0,24569,16339,30
52768916478,52768916474,-4,979,3152,30
52770813486,52770813484,-2,1214,3811,30
52771489550,52771489544,-6,1066,2891,30
52788770506,52788770505,-1,1485,3402,30
52790653962,52790653955,-7,1087,4965,30
52792449646,52792449641,-5,1242,2500,30
52793485506,52793485501,-5,1204,4052,30
52797100406,52797100404,-2,713,2177,30
52798464110,52798464105,-5,1257,3251,30
52815932318,52815932315,-3,1226,2401,30
52817275698,52817275692,-6,1095,2526,30
52822329349,52822329354,5,3015,1473,30
52822439067,52822439063,-4,1137,3032,30
52824222845,52824222840,-5,1434,3751,30
52828128698,52828128685,-13,781,318,30
52828533638,52828533630,-8,746,2980,30
52843027302,52843027298,-4,1019,2846,30
52848020439,52848020433,-6,804,2325,30
52849970202,52849970196,-6,978,2299,30
52858755246,52858755243,-3,856,2168,30
52863257267,52863257262,-5,940,2351,30
52867483290,52867483285,-5,827,2628,30
52869721623,52869721617,-6,1248,2361,30
52870522221,52870522216,-5,1119,3016,30
52872372337,52872372333,-4,793,2112,30
52872794233,52872794222,-11,990,2548,30
52874516611,52874516612,1,46085,4052,30
52875819091,52875819086,-5,1032,3266,30
52876401068,52876401082,14,246,1074,30
52878849863,52878849861,-2,881,2458,30
52879599249,52879599245,-4,1436,3350,30
52883360107,52883360103,-4,828,4547,30
52886361205,52886361201,-4,1016,2511,30
52886407039,52886407035,-4,1256,2918,30
52887450861,52887450857,-4,1097,2198,30
52889170959,52889170958,-1,1148,1438,30
52890581319,52890581312,-7,741,3812,30
52892207450,52892207447,-3,580,1076,30
52903268779,52903268775,-4,973,2850,30
52909789521,52909789527,6,2735,1308,30
52911159876,52911159878,2,1548,1924,30
52912742114,52912742112,-2,942,3282,30
52915316889,52915316885,-4,776,2691,30
52918820865,52918820860,-5,1139,3466,30
52928575048,52928575054,6,35,1062,30
52931976855,52931976851,-4,1138,3410,30
52932495734,52932495728,-6,992,2848,30
52932757788,52932757806,18,340,853,30
52936416286,52936416289,3,1543,953,30
52938220143,52938220139,-4,798,3106,30
52938344595,52938344594,-1,2433,3654,30
52939140915,52939140912,-3,1209,3678,30
52942289142,52942289145,3,3194,2968,30
52943454217,52943454213,-4,1312,2186,30
52945738857,52945738879,22,886,2000,30
52948228412,52948228412,0,1463,2717,30
52963547863,52963547858,-5,849,3082,30
52965226519,52965226515,-4,996,2662,30
52966844120,52966844114,-6,1093,2696,30
52969000502,52969000499,-3,1258,2903,30
52972296270,52972296267,-3,1208,3275,30
52974851923,52974851919,-4,1356,2954,30
52978061841,52978061835,-6,1468,3333,30
52979472440,52979472463,23,845,1485,30
52980865266,52980865262,-4,693,2336,30
52985235112,52985235106,-6,1185,2596,30
52990060069,52990060065,-4,702,2429,30
52990241913,52990241930,17,605,2048,30
52992609134,52992609138,4,1950,1364,30
52992743789,52992743790,1,2183,1896,30
52993355962,52993355966,4,6560,5443,30
52994708797,52994708793,-4,1350,4101,30
52994781442,52994781437,-5,1560,3266,30
52996947062,52996947058,-4,1050,2436,30
52997644127,52997644123,-4,937,3248,30
52999431879,52999431875,-4,1210,3767,30
53005697966,53005697962,-4,1201,3761,30
53006140112,53006140101,-11,96,669,30
53014504648,53014504643,-5,1215,4276,30
53014805923,53014805943,20,830,3088,30
53020292675,53020292673,-2,759,1898,30
53020939570,53020939571,1,991,1458,30
53021796555,53021796548,-7,21386,11221,30
53024199245,53024199242,-3,1050,1872,30
53044961857,53044961857,0,1528,2293,30
53046326110,53046326106,-4,724,1833,30
53048317991,53048317987,-4,998,2511,30
53053200606,53053200599,-7,786,2503,30
53066502345,53066502342,-3,921,3234,30
53068393022,53068393018,-4,956,2870,30
53070966242,53070966239,-3,1192,2095,30
53082754414,53082754410,-4,1110,3149,30
53087723958,53087723953,-5,383,2621,30
53088429482,53088429502,20,415,1626,30
53088514482,53088514480,-2,28063,51734,30
53096759893,53096759889,-4,840,2325,30
53100846050,53100846045,-5,800,2781,30
53102057499,53102057495,-4,742,2705,30
53104960318,53104960314,-4,6241,15292,30
53106192306,53106192303,-3,571,1555,30
53109197867,53109197864,-3,379,1398,30
53112189414,53112189410,-4,1419,3866,30
53115980789,53115980786,-3,904,2227,30
53116262523,53116262513,-10,406,1115,30
53132496836,53132496854,18,1244,3572,30
53132686136,53132686137,1,270,887,30
53132941796,53132941791,-5,714,1774,30
53132978248,53132978241,-7,947,3615,30
53134257763,53134257757,-6,522,1392,30
53136031797,53136031796,-1,887,2531,30
53137232265,53137232262,-3,1150,2066,30
53138703730,53138703726,-4,944,2409,30
53146020867,53146020865,-2,822,2235,30
53147285153,53147285146,-7,720,2259,30
53147369515,53147369494,-21,96,429,30
53165134838,53165134835,-3,1167,3416,30
53166100086,53166100087,1,1151,1237,30
53175353022,53175353030,8,5569,1778,30
53175714742,53175714738,-4,1291,2612,30
53180001934,53180001927,-7,908,3506,30
53182361594,53182361591,-3,1032,2997,30
53185588783,53185588777,-6,904,3258,30
53186061081,53186061077,-4,1130,2342,30
53199041379,53199041377,-2,1568,3453,30
53205857939,53205857934,-5,1139,3763,30
53207296270,53207296267,-3,733,1614,30
53208216377,53208216370,-7,1314,2685,30
53208602519,53208602516,-3,610,2001,30
53209297226,53209297223,-3,935,2655,30
53209403601,53209403595,-6,1123,3566,30
53210534966,53210534962,-4,1020,4409,30
53211803587,53211803582,-5,1373,3251,30
53226037661,53226037657,-4,705,2185,30
53227868934,53227868931,-3,1040,1950,30
53228713608,53228713594,-14,1064,1841,30
53229489578,53229489573,-5,669,1443,30
53233325335,53233325331,-4,1060,3041,30
53233843563,53233843569,6,166,899,30
53234678472,53234678469,-3,1529,3701,30
53234888066,53234888061,-5,754,3048,30
53236131292,53236131310,18,345,1542,30
53236323299,53236323294,-5,760,1832,30
53236628506,53236628524,18,1057,2463,30
53237126140,53237126134,-6,836,1594,30
53238342511,53238342506,-5,1163,4044,30
53243023241,53243023244,3,1574,1090,30
53244723694,53244723690,-4,952,2468,30
53266667073,53266667069,-4,1060,2534,30
53267609590,53267609586,-4,1050,3451,30
53267658055,53267658052,-3,841,3016,30
53268410815,53268410811,-4,1022,4349,30
53269762823,53269762818,-5,963,4113,30
53271425886,53271425880,-6,805,2615,30
53273357091,53273357087,-4,1280,2507,30
53281068021,53281068015,-6,1108,3028,30
53281131401,53281131421,20,977,3144,30
53286138527,53286138523,-4,1190,3706,30
53288541978,53288541974,-4,1659,3341,30
53289906987,53289906983,-4,999,2663,30
53290708731,53290708725,-6,998,4052,30
53290945554,53290945549,-5,1401,3439,30
53304283458,53304283454,-4,1031,3305,30
53307168562,53307168558,-4,1369,3521,30
53308902811,53308902807,-4,685,2948,30
53314081841,53314081833,-8,1334,5757,30
53319789571,53319789571,0,1438,1827,30
53321211838,53321211833,-5,875,2921,30
53322092800,53322092822,22,638,2398,30
53327328658,53327328653,-5,786,3290,30
53334871623,53334871617,-6,795,3655,30
53336082147,53336082143,-4,819,2368,30
53336485622,53336485622,0,751,1249,30
53340631955,53340631961,6,2397,950,30
53341222639,53341222633,-6,1253,1742,30
53342100130,53342100129,-1,1195,1897,30
53347918970,53347918965,-5,1131,2521,30
53352054621,53352054627,6,1399,1205,30
53352756558,53352756554,-4,828,2802,30
53353034736,53353034754,18,261,1383,30
53353504390,53353504397,7,4032,1457,30
53354616762,53354616759,-3,1190,3109,30
53360065834,53360065830,-4,580,2973,30
53363037260,53363037265,5,12623,8022,30
53363139013,53363139008,-5,968,2809,30
53372377370,53372377367,-3,865,2311,30
53372410753,53372410771,18,808,2158,30
53372976254,53372976249,-5,27111,15340,30
53373369000,53373368994,-6,1013,2883,30
53374377446,53374377446,0,2130,1929,30
53382944882,53382944877,-5,775,3144,30
53390732518,53390732520,2,2768,2710,30
53391102185,53391102180,-5,1062,3428,30
53395733481,53395733479,-2,1121,2472,30
53401919779,53401919774,-5,1174,3062,30
53404442411,53404442406,-5,957,2064,30
53405133565,53405133562,-3,1058,2173,30
53406355015,53406355015,0,820,932,30
53412472842,53412472838,-4,793,1816,30
53418384729,53418384751,22,662,3034,30
53419854092,53419854085,-7,1164,4090,30
53419882531,53419882540,9,166,1753,30
53426023945,53426023941,-4,935,2450,30
53426595783,53426595778,-5,867,1765,30
53426931272,53426931291,19,925,2537,30
53427453014,53427453012,-2,1199,3881,30
53442894922,53442894917,-5,862,3997,30
53444348158,53444348153,-5,1237,2804,30
53449215215,53449215211,-4,1134,2154,30
53449548414,53449548411,-3,1193,1347,30
53455228677,53455228694,17,1164,2845,30
53455748466,53455748462,-4,852,2727,30
53456874070,53456874077,7,3787,1475,30
53464310787,53464310785,-2,1393,3115,30
53467670491,53467670485,-6,1049,3099,30
53470496236,53470496238,2,1194,1658,30
53472392050,53472392046,-4,828,2007,30
53472727402,53472727396,-6,1181,2820,30
53477190213,53477190207,-6,1123,3254,30
53485361775,53485361770,-5,1099,3258,30
53488200171,53488200167,-4,930,2470,30
53488922929,53488922909,-20,5,901,30
53494688567,53494688568,1,1314,1871,30
53497733251,53497733248,-3,993,2067,30
53513275781,53513275777,-4,1088,3362,30
53513513485,53513513480,-5,1052,3136,30
53514025826,53514025822,-4,1183,2411,30
53518277320,53518277316,-4,996,2349,30
53520736727,53520736723,-4,976,2923,30
53521046764,53521046760,-4,1544,3186,30
53521753602,53521753598,-4,806,2746,30
53527934527,53527934522,-5,1424,3155,30
53528160346,53528160343,-3,1357,2153,30
53528370231,53528370227,-4,835,2359,30
53531425839,53531425834,-5,1075,3115,30
53532202170,53532202165,-5,944,2608,30
53534652418,53534652413,-5,1220,2642,30
53535845337,53535845359,22,1531,1548,30
53537734966,53537734961,-5,1175,2716,30
53538161619,53538161620,1,2020,1380,30
53538636161,53538636156,-5,1047,2934,30
53539242569,53539242550,-19,179,936,30
53546589442,53546589438,-4,1500,4179,30
53547097353,53547097349,-4,150,982,30
53549186699,53549186695,-4,1046,2474,30
53549441362,53549441369,7,17903,26160,30
53552083566,53552083580,14,1252,1545,30
53554079492,53554079486,-6,1170,3375,30
53555670051,53555670046,-5,900,2036,30
53556078554,53556078550,-4,957,3759,30
53563030381,53563030378,-3,1014,2191,30
53564134994,53564134990,-4,1405,3762,30
53569477834,53569477829,-5,1102,2601,30
53569587252,53569587257,5,239,806,30
53575230693,53575230687,-6,994,3682,30
53576083370,53576083364,-6,1240,4452,30
53576946363,53576946358,-5,1020,2993,30
53577307821,53577307828,7,10407,32242,30
53582460534,53582460531,-3,1411,2885,30
53586476409,53586476404,-5,1407,2815,30
53590282300,53590282300,0,1934,2898,30
53590929074,53590929062,-12,785,2295,30
53591996227,53591996223,-4,1125,3053,30
53592517467,53592517462,-5,998,2925,30
53593301547,53593301544,-3,1297,3213,30
53595617361,53595617363,2,958,1153,30
53597450755,53597450748,-7,800,2895,30
53599004502,53599004498,-4,1056,2926,30
53601176817,53601176812,-5,1090,3463,30
53601719520,53601719518,-2,1109,2174,30
53603734080,53603734076,-4,1133,2482,30
53604031131,53604031150,19,1670,3411,30
53605595333,53605595327,-6,1033,3919,30
53607048281,53607048274,-7,1483,3265,30
53609609691,53609609687,-4,749,2189,30
53611917397,53611917382,-15,405,1795,30
53612683133,53612683129,-4,708,2027,30
53616985670,53616985661,-9,1172,2992,30
53618341265,53618341261,-4,851,3367,30
53620731766,53620731761,-5,1330,3259,30
53621535763,53621535760,-3,1094,3097,30
53625647057,53625647052,-5,1303,2724,30
53629094914,53629094911,-3,1130,2668,30
53629950143,53629950137,-6,1164,4947,30
53633764865,53633764861,-4,1391,3297,30
53635322455,53635322450,-5,1169,3253,30
53637264274,53637264270,-4,1154,2562,30
53637383675,53637383680,5,175,1048,30
53643680650,53643680646,-4,1125,3500,30
53646481779,53646481775,-4,1125,2529,30
53665972945,53665972942,-3,1249,3987,30
53670061809,53670061803,-6,985,2182,30
53673382050,53673382046,-4,1269,2552,30
53673812986,53673812983,-3,705,1663,30
53675508612,53675508609,-3,1193,2595,30
53676340161,53676340156,-5,1004,2425,30
53676637206,53676637202,-4,1145,2498,30
53677774379,53677774374,-5,1085,2479,30
53682918042,53682918037,-5,862,2955,30
53683181301,53683181297,-4,851,2962,30
53683510313,53683510330,17,708,1409,30
53684835543,53684835538,-5,1387,2731,30
53689400493,53689400493,0,19115,38286,30
53690137590,53690137586,-4,488,1881,30
53690721483,53690721478,-5,1179,3093,30
53691382340,53691382337,-3,1084,3328,30
53693453054,53693453050,-4,1118,2924,30
53695961044,53695961036,-8,2133,8651,30
53696236394,53696236389,-5,1160,4004,30
53697042633,53697042644,11,10572,45140,30
53706752991,53706752986,-5,1050,2695,30
53714397646,53714397664,18,621,1857,30
53723388289,53723388283,-6,1130,2642,30
53732781071,53732781067,-4,1090,3191,30
53736015249,53736015254,5,1312,1257,30
53736942786,53736942782,-4,1259,2830,30
53738710619,53738710616,-3,1148,3098,30
53741317491,53741317487,-4,1094,2880,30
53741583922,53741583918,-4,1227,2526,30
53748178448,53748178450,2,41184,34169,30
53748811710,53748811703,-7,1092,3487,30
53752400367,53752400361,-6,752,4244,30
53752681428,53752681424,-4,38904,17563,30
53757147113,53757147107,-6,1166,2384,30
53757697683,53757697681,-2,1401,2212,30
53760189756,53760189750,-6,1081,3282,30
53766464610,53766464604,-6,1359,2802,30
53787184690,53787184686,-4,1127,2468,30
53790264526,53790264521,-5,1390,3796,30
53797739674,53797739669,-5,1189,2422,30
53802079482,53802079489,7,5251,1701,30
53806840530,53806840525,-5,1345,3317,30
53806900634,53806900629,-5,1317,1779,30
53807005112,53807005107,-5,601,1827,30
53808197025,53808197013,-12,142,1041,30
53808929380,53808929374,-6,1012,3728,30
53810482916,53810482909,-7,1121,2693,30
53811362010,53811362006,-4,682,2141,30
53811472580,53811472595,15,768,3132,30
53814474473,53814474465,-8,1046,3041,30
53814756018,53814756012,-6,129,950,30
53822599106,53822599110,4,1469,839,30
53824702130,53824702125,-5,1183,3198,30
53828540599,53828540595,-4,1228,2280,30
53841796737,53841796735,-2,1053,3426,30
53849371972,53849371968,-4,1390,3016,30
53849707358,53849707364,6,3592,2130,30
53850217939,53850217935,-4,910,2544,30
53851813649,53851813655,6,7458,3013,30
53852689735,53852689731,-4,999,2956,30
53853565929,53853565926,-3,1280,2656,30
53855413345,53855413338,-7,804,2357,30
53855682649,53855682671,22,742,1317,30
53855721510,53855721506,-4,1309,3953,30
53856463326,53856463320,-6,1767,3601,30
53864129010,53864129023,13,716,2385,30
53865638577,53865638574,-3,1333,2295,30
53869279385,53869279382,-3,1255,2671,30
53870476837,53870476834,-3,1682,2763,30
53885249250,53885249249,-1,849,2650,30
53887243291,53887243285,-6,501,2267,30
53888388585,53888388580,-5,1097,2762,30
53890550662,53890550658,-4,1074,2064,30
53893384199,53893384194,-5,809,2474,30
53895744361,53895744355,-6,1685,2667,30
53896969639,53896969632,-7,808,2382,30
53898534947,53898534942,-5,927,2980,30
53901977050,53901977047,-3,1269,1874,30
53902452185,53902452179,-6,754,2373,30
53915981319,53915981314,-5,1110,2330,30
53918647649,53918647653,4,3392,2765,30
53921256092,53921256093,1,1614,1898,30
53921763886,53921763906,20,663,2678,30
53923311071,53923311068,-3,1034,2276,30
53923612480,53923612471,-9,132,689,30
53923919803,53923919798,-5,1274,4075,30
53924792368,53924792387,19,413,1104,30
53927533163,53927533158,-5,1698,3649,30
53929060458,53929060453,-5,1178,2902,30
53932753591,53932753585,-6,1034,2695,30
53938271441,53938271436,-5,1084,3160,30
53938433992,53938434012,20,618,2441,30
53939308331,53939308326,-5,1247,2813,30
53945048551,53945048548,-3,1163,3315,30
53949507801,53949507814,13,403,990,30
53953072609,53953072602,-7,945,4027,30
53956594802,53956594794,-8,1255,3708,30
53956668854,53956668851,-3,1018,2553,30
53959564394,53959564390,-4,1212,2696,30
53959892210,53959892206,-4,1261,2957,30
53963471712,53963471722,10,9614,37356,30
53975811849,53975811853,4,2728,2023,30
53978196423,53978196419,-4,735,2525,30
53979169193,53979169190,-3,1419,3296,30
53983566543,53983566538,-5,1307,3376,30
53985554429,53985554430,1,1873,2120,30
53987636237,53987636242,5,2761,1545,30
53992007184,53992007182,-2,4270,7302,30
53993213341,53993213337,-4,924,3089,30
53994745871,53994745865,-6,1160,2775,30
53995439623,53995439618,-5,1116,2299,30
53998690237,53998690231,-6,1338,2820,30
54000554054,54000554050,-4,1316,2598,30
54011946725,54011946719,-6,1051,3052,30
54013280191,54013280186,-5,997,2564,30
54022895058,54022895054,-4,1031,3442,30
54023566889,54023566909,20,256,670,30
54026800787,54026800781,-6,1870,6872,30
54027441639,54027441659,20,14332,45086,30
54028440574,54028440569,-5,814,2835,30
54035582330,54035582326,-4,1034,1492,30
54038671863,54038671857,-6,1167,3136,30
54039831109,54039831107,-2,1793,3472,30
54040175726,54040175730,4,10546,55448,30
54042811544,54042811541,-3,508,2341,30
54044509166,54044509161,-5,1067,2605,30
54045110883,54045110879,-4,795,2155,30
54045282459,54045282474,15,660,2058,30
54047522547,54047522542,-5,1083,2853,30
54047771984,54047771979,-5,1761,5736,30
54051986964,54051986962,-2,1154,2649,30
54056248173,54056248167,-6,1170,3114,30
54057150019,54057150014,-5,1085,3315,30
54058114219,54058114205,-14,1005,3476,30
54058365041,54058365061,20,538,2295,30
54058428505,54058428505,0,2844,3686,30
54060865685,54060865680,-5,1209,3729,30
54061336190,54061336186,-4,1044,3548,30
54062140755,54062140749,-6,1066,3444,30
54066274846,54066274842,-4,1152,3030,30
54068789103,54068789102,-1,635,1145,30
54068960487,54068960482,-5,1033,3176,30
54071858267,54071858263,-4,453,895,30
54072740248,54072740245,-3,999,2312,30
54074053987,54074053987,0,33327,55532,30
54076669082,54076669078,-4,833,2676,30
54077760390,54077760386,-4,1080,2829,30
54079783147,54079783145,-2,981,1958,30
54083904057,54083904051,-6,1198,4282,30
54084931969,54084931965,-4,785,1546,30
54086992807,54086992803,-4,1053,2623,30
54088623470,54088623466,-4,1209,4548,30
54088792070,54088792071,1,1061,835,30
54089148500,54089148497,-3,760,1821,30
54093721543,54093721539,-4,875,2016,30
54097040366,54097040371,5,1768,998,30
54098397106,54098397102,-4,968,3399,30
54099981377,54099981374,-3,655,1480,30
54100939457,54100939454,-3,995,2278,30
54103159500,54103159500,0,1344,1674,30
54104802838,54104802835,-3,939,2884,30
54106157101,54106157107,6,2219,1419,30
54116980612,54116980610,-2,1580,2396,30
54118777415,54118777411,-4,950,2490,30
54121476858,54121476854,-4,1491,3583,30
54122030563,54122030558,-5,1385,3629,30
54134965531,54134965524,-7,737,5564,30
54137471235,54137471230,-5,1138,2702,30
54143128878,54143128873,-5,1514,4091,30
54143368193,54143368189,-4,872,1856,30
54145827778,54145827773,-5,1304,3450,30
54147251806,54147251801,-5,1249,3595,30
54149670121,54149670125,4,2098,1323,30
54151329878,54151329873,-5,1068,2989,30
54161105331,54161105335,4,1394,1159,30
54161713036,54161713042,6,2620,1417,30
54163579323,54163579321,-2,822,2467,30
54170955139,54170955134,-5,834,1884,30
54177022910,54177022905,-5,888,2375,30
54184729698,54184729717,19,1,1826,30
54187132570,54187132568,-2,978,2352,30
54187198882,54187198891,9,305,1566,30
54187383371,54187383366,-5,1135,3297,30
54188439942,54188439947,5,18557,29591,30
54189701388,54189701384,-4,1080,3062,30
54191361664,54191361660,-4,1263,2756,30
54199761033,54199761030,-3,677,1358,30
54199825952,54199825970,18,384,589,30
54200275353,54200275347,-6,1115,1917,30
54201366504,54201366522,18,1041,2575,30
54208802058,54208802054,-4,1199,2493,30
54209035434,54209035430,-4,965,2758,30
54213819507,54213819506,-1,2897,5285,30
54217173233,54217173249,16,1082,3049,30
54221936009,54221936004,-5,1090,4510,30
54224592078,54224592073,-5,1343,2740,30
54231196271,54231196267,-4,1238,3043,30
54233767239,54233767235,-4,678,3163,30
54240697652,54240697647,-5,1078,2983,30
54245578407,54245578402,-5,1426,2902,30
54252376135,54252376131,-4,1143,3423,30
54255492306,54255492299,-7,1035,2843,30
54255900611,54255900608,-3,1161,2084,30
54257703049,54257703044,-5,1091,2501,30
54258786874,54258786867,-7,1014,3495,30
54259396931,54259396927,-4,1167,3085,30
54263264217,54263264214,-3,1416,4248,30
54265892530,54265892536,6,3698,1796,30
54266558580,54266558577,-3,842,1732,30
54266768700,54266768706,6,168,1249,30
54281332216,54281332217,1,1406,1930,30
54290879665,54290879662,-3,1005,2879,30
54294194175,54294194169,-6,1075,3109,30
54297906567,54297906562,-5,1504,3944,30
54298603501,54298603496,-5,1118,3160,30
54300222255,54300222250,-5,903,3274,30
54302143066,54302143061,-5,1174,3156,30
54302448244,54302448238,-6,1111,3820,30
54302728787,54302728781,-6,984,2139,30
54305289420,54305289414,-6,1016,3638,30
54307378191,54307378185,-6,975,3144,30
54310095540,54310095554,14,454,1735,30
54318057051,54318057044,-7,610,2080,30
54319881397,54319881393,-4,1227,2750,30
54320596566,54320596562,-4,816,2208,30
54322037714,54322037708,-6,1296,4155,30
54323484109,54323484117,8,305,816,30
54327776641,54327776636,-5,1166,3791,30
54328834479,54328834473,-6,1411,3677,30
54330310211,54330310211,0,2776,3461,30
54330670681,54330670674,-7,1111,5663,30
54331666678,54331666674,-4,538,1459,30
54333801702,54333801703,1,1369,1776,30
54341992750,54341992746,-4,1243,3132,30
54344285239,54344285235,-4,1281,3750,30
54348577685,54348577679,-6,602,1836,30
54350616430,54350616429,-1,884,345,30
54355270944,54355270939,-5,898,2582,30
54360694612,54360694606,-6,1117,2737,30
54361804116,54361804114,-2,1132,3097,30
54367991322,54367991317,-5,1129,2181,30
54376650259,54376650254,-5,1471,4258,30
54378878160,54378878155,-5,1260,2638,30
54379186681,54379186698,17,351,1632,30
54379923682,54379923677,-5,1327,3712,30
54383457028,54383457026,-2,981,2350,30
54387832015,54387832010,-5,1289,3011,30
54389239242,54389239238,-4,853,2708,30
54390179921,54390179938,17,462,865,30
54392290812,54392290810,-2,1719,3519,30
54396774723,54396774719,-4,914,2392,30
54397972664,54397972657,-7,1174,2766,30
54399663913,54399663908,-5,1491,3447,30
54401007254,54401007250,-4,1222,3796,30
54408989762,54408989757,-5,999,1622,30
54414047561,54414047557,-4,806,1474,30
54416172451,54416172448,-3,945,2451,30
54417339877,54417339887,10,228,713,30
54421915432,54421915429,-3,1345,2886,30
54428248362,54428248357,-5,1371,3469,30
54430335577,54430335582,5,4258,2268,30
54431284799,54431284795,-4,997,2519,30
54431734914,54431734906,-8,257,1184,30
54432168385,54432168382,-3,983,2316,30
54433319565,54433319561,-4,992,3039,30
54434209494,54434209490,-4,770,2033,30
54435199875,54435199892,17,795,1806,30
54437474322,54437474317,-5,753,2807,30
54440415883,54440415879,-4,740,2480,30
54440937687,54440937689,2,1276,1708,30
54441223073,54441223069,-4,195,756,30
54443307232,54443307227,-5,981,3144,30
54449155751,54449155746,-5,815,3368,30
54454541575,54454541570,-5,975,2820,30
54455068871,54455068866,-5,1529,3862,30
54455469337,54455469332,-5,721,1823,30
54460701960,54460701953,-7,23088,15820,30
54461429424,54461429419,-5,799,2341,30
54468295946,54468295944,-2,1234,2894,30
54469234848,54469234871,23,449,1035,30
54469435215,54469435194,-21,4106,1634,30
54473479132,54473479134,2,1435,1869,30
54474800427,54474800422,-5,685,2605,30
54475251124,54475251101,-23,244,890,30
54475454959,54475454956,-3,1452,3610,30
54480127606,54480127601,-5,1068,2446,30
54484776407,54484776402,-5,793,2493,30
54487240992,54487240985,-7,1106,3330,30
54487271452,54487271465,13,124,752,30
54487772793,54487772788,-5,1398,3450,30
54490736658,54490736654,-4,1088,3014,30
54494788631,54494788628,-3,720,1560,30
54495552315,54495552311,-4,900,2437,30
54498529079,54498529077,-2,1017,2762,30
54499960049,54499960042,-7,833,1914,30
54500050888,54500050880,-8,868,2159,30
54507600254,54507600251,-3,814,2810,30
54510737622,54510737624,2,907,1317,30
54512060118,54512060113,-5,1081,3084,30
54515990325,54515990327,2,2335,1441,30
54516953027,54516953023,-4,1010,2088,30
54519599449,54519599446,-3,891,2244,30
54522983306,54522983307,1,1425,601,30
54524428897,54524428894,-3,1033,3006,30
54525133130,54525133143,13,800,3550,30
54526100506,54526100502,-4,1279,2672,30
54527753043,54527753039,-4,667,947,30
54531438883,54531438879,-4,1255,4345,30
54532740219,54532740214,-5,946,2948,30
54534460830,54534460826,-4,1068,2805,30
54539990448,54539990442,-6,1233,3217,30
54542061186,54542061181,-5,1677,4766,30
54544150342,54544150339,-3,896,1084,30
54546037951,54546037947,-4,941,2228,30
54546979477,54546979487,10,14632,20323,30
54552172526,54552172524,-2,1006,2626,30
54555613785,54555613781,-4,781,2582,30
54557033570,54557033567,-3,1116,2539,30
54557059129,54557059117,-12,923,2478,30
54559003071,54559003066,-5,1347,4269,30
54564609382,54564609382,0,2798,2677,30
54565346620,54565346602,-18,880,3611,30
54565739956,54565739969,13,930,2210,30
54567069279,54567069275,-4,1040,2374,30
54567338243,54567338260,17,573,1283,30
54567587877,54567587874,-3,780,2186,30
54573576458,54573576451,-7,734,3483,30
54574275362,54574275357,-5,924,2934,30
54574560507,54574560523,16,363,1135,30
54577001507,54577001502,-5,777,2105,30
54577195258,54577195245,-13,1150,2888,30
54577719954,54577719957,3,1313,776,30
54579645097,54579645092,-5,1024,2250,30
54581471771,54581471769,-2,767,1824,30
54585417366,54585417359,-7,1588,3437,30
54585691694,54585691693,-1,1193,1961,30
54585805674,54585805671,-3,1185,3561,30
54600750517,54600750513,-4,1161,3252,30
54602528151,54602528146,-5,682,2635,30
54603315570,54603315566,-4,2118,4750,30
54603416198,54603416193,-5,1614,3768,30
54604595089,54604595082,-7,1648,4244,30
54612583575,54612583569,-6,1145,2655,30
54621830691,54621830684,-7,1513,3609,30
54628486826,54628486819,-7,827,2931,30
54630835689,54630835685,-4,1125,3170,30
54630960578,54630960574,-4,1072,3229,30
54631662542,54631662538,-4,1514,2665,30
54633891681,54633891675,-6,645,1774,30
54633975609,54633975630,21,720,2668,30
54638743597,54638743590,-7,602,2341,30
54640301505,54640301500,-5,1003,2904,30
54644210318,54644210322,4,4582,2357,30
54649560499,54649560495,-4,634,1556,30
54658246654,54658246649,-5,892,2967,30
54659915826,54659915822,-4,1260,2379,30
54663230686,54663230681,-5,935,2637,30
54669810640,54669810644,4,3977,3504,30
54670053067,54670053062,-5,694,2067,30
54679338773,54679338776,3,1808,1293,30
54679826867,54679826879,12,15148,24707,30
54679915346,54679915353,7,3212,1522,30
54684138630,54684138622,-8,839,3564,30
54684165723,54684165703,-20,364,2302,30
54684647955,54684647971,16,658,1894,30
54684817576,54684817599,23,783,2113,30
54685707028,54685707022,-6,1024,2798,30
54689612914,54689612909,-5,1514,3914,30
54692882758,54692882754,-4,690,2664,30
54700208495,54700208491,-4,931,1994,30
54707710941,54707710936,-5,1264,2834,30
54709009783,54709009777,-6,712,1280,30
54710229626,54710229626,0,185,632,30
54711055704,54711055710,6,2447,1533,30
54712264084,54712264078,-6,850,2650,30
54713850494,54713850490,-4,824,1789,30
54715544885,54715544881,-4,1250,2195,30
54715884651,54715884636,-15,1128,2403,30
54716980234,54716980254,20,339,872,30
54722995115,54722995112,-3,793,1576,30
54724068872,54724068873,1,1192,1226,30
54729297429,54729297425,-4,1165,2620,30
54731486237,54731486233,-4,722,1582,30
54735012235,54735012230,-5,965,3598,30
54735228114,54735228109,-5,1254,2408,30
54742867406,54742867401,-5,1116,2664,30
54742989335,54742989333,-2,1029,1993,30
54745844546,54745844542,-4,554,1962,30
54747155577,54747155573,-4,1197,3905,30
54747288656,54747288643,-13,50,1099,30
54748873139,54748873135,-4,842,1769,30
54750979159,54750979155,-4,667,2979,30
54753561411,54753561407,-4,972,2327,30
54754070953,54754070973,20,521,3069,30
54759641153,54759641149,-4,1291,3956,30
54760643177,54760643194,17,905,3687,30
54760744066,54760744082,16,701,2874,30
54761128063,54761128058,-5,1029,2849,30
54762645386,54762645382,-4,771,2621,30
54765314159,54765314154,-5,1054,2544,30
54770844050,54770844059,9,1063,1604,30
54772631055,54772631051,-4,1356,2702,30
54774136117,54774136113,-4,1147,2337,30
54779816510,54779816505,-5,1291,2506,30
54796285243,54796285238,-5,872,2630,30
54796709994,54796709990,-4,1003,2255,30
54797798054,54797798050,-4,1417,2807,30
54797996121,54797996117,-4,968,2350,30
54801592074,54801592077,3,1689,1453,30
54802260826,54802260822,-4,1201,2665,30
54808794165,54808794164,-1,1259,2536,30
54810599144,54810599150,6,2792,1423,30
54813852654,54813852648,-6,803,2443,30
54814627655,54814627650,-5,834,2967,30
54815150153,54815150138,-15,1080,2277,30
54820513378,54820513374,-4,1166,1614,30
54820842344,54820842360,16,781,2995,30
54827104174,54827104172,-2,915,2573,30
54828155619,54828155615,-4,995,2237,30
54832035381,54832035378,-3,1288,3462,30
54834217415,54834217417,2,18995,35495,30
54837651595,54837651592,-3,745,1714,30
54838648052,54838648066,14,151,930,30
54841211353,54841211339,-14,19629,30532,30
54842265237,54842265233,-4,1066,2255,30
54847104321,54847104317,-4,873,2907,30
54849042265,54849042261,-4,1068,2811,30
54849529170,54849529167,-3,1293,2603,30
54863015451,54863015449,-2,853,3104,30
54863610599,54863610594,-5,277,1990,30
54867758586,54867758581,-5,1378,5401,30
54872060663,54872060658,-5,863,2255,30
54872499431,54872499426,-5,1150,2234,30
54873291387,54873291383,-4,857,2749,30
54877978621,54877978620,-1,1187,2052,30
54880336206,54880336202,-4,1157,2950,30
54884931376,54884931370,-6,1184,3611,30
54887939717,54887939713,-4,1427,3542,30
54896080670,54896080666,-4,978,2366,30
54896164260,54896164270,10,344,901,30
54896354025,54896354033,8,2311,1824,30
54896890443,54896890438,-5,1302,3767,30
54897452978,54897452973,-5,1011,3177,30
54897807675,54897807671,-4,1164,3915,30
54902030279,54902030275,-4,913,2464,30
54903884986,54903885003,17,854,1941,30
54906803125,54906803121,-4,958,3085,30
54907143439,54907143440,1,33131,35023,30
54911132417,54911132412,-5,1283,2863,30
54915289169,54915289166,-3,1298,2921,30
54915956574,54915956571,-3,1251,2811,30
54921265634,54921265649,15,695,1939,30
54924928629,54924928627,-2,768,2238,30
54927889910,54927889905,-5,731,2956,30
54928252520,54928252510,-10,297,1418,30
54928400320,54928400314,-6,1445,3190,30
54935306175,54935306172,-3,916,3052,30
54954969215,54954969210,-5,1117,3810,30
54957556318,54957556313,-5,773,1934,30
54961695211,54961695206,-5,1017,3010,30
54961744214,54961744209,-5,1086,2800,30
54962106586,54962106582,-4,1867,3758,30
54962183852,54962183847,-5,1440,3645,30
54962327586,54962327606,20,176,1131,30
54962366555,54962366574,19,319,1330,30
54963067050,54963067045,-5,1206,2948,30
54964425254,54964425251,-3,1049,3080,30
54969444158,54969444153,-5,1029,2372,30
54972652195,54972652189,-6,1076,3527,30
54980473731,54980473728,-3,1413,2970,30
54980501198,54980501195,-3,745,2648,30
54999957138,54999957135,-3,2243,4058,30
55001577146,55001577142,-4,1138,3177,30
55007381512,55007381510,-2,1521,2600,30
55007642095,55007642090,-5,942,2139,30
55009898162,55009898153,-9,249,693,30
55012075299,55012075305,6,3435,1242,30
55013946207,55013946204,-3,990,2283,30
55014927387,55014927381,-6,1384,2593,30
55018422514,55018422513,-1,1127,2504,30
55018463554,55018463556,2,2889,2870,30
55018882910,55018882905,-5,960,3030,30
55027822051,55027822048,-3,1182,3237,30
55030255120,55030255119,-1,1649,2024,30
55035724669,55035724664,-5,1468,4013,30
55041908925,55041908919,-6,962,3255,30
55042237062,55042237058,-4,656,2574,30
55042356843,55042356857,14,497,4490,30
55045305418,55045305416,-2,789,2381,30
55046620761,55046620758,-3,1207,1499,30
55049358086,55049358082,-4,1082,2632,30
55054507198,55054507193,-5,1165,2556,30
55055148193,55055148189,-4,1176,3310,30
55060566557,55060566552,-5,1338,2798,30
55060832601,55060832608,7,7972,35739,30
55066530408,55066530402,-6,702,2974,30
55066943239,55066943245,6,4474,2463,30
55067468729,55067468724,-5,1563,3615,30
55070058526,55070058523,-3,1596,3862,30
55070293710,55070293704,-6,1296,3264,30
55071557761,55071557749,-12,803,2869,30
55072702138,55072702134,-4,927,2338,30
55075296207,55075296205,-2,985,2211,30
55076178562,55076178553,-9,1406,3549,30
55078506137,55078506130,-7,1008,3690,30
55083733459,55083733455,-4,1338,4044,30
55085740547,55085740549,2,1567,1549,30
55093692494,55093692490,-4,1173,3580,30
55094140018,55094140014,-4,1008,2370,30
55098523400,55098523397,-3,1227,2713,30
55098711004,55098711008,4,6858,21178,30
55099219206,55099219203,-3,1028,2330,30
55099941528,55099941530,2,1501,2258,30
55103297929,55103297924,-5,864,3351,30
55104466540,55104466541,1,32793,36019,30
55110814627,55110814622,-5,480,1174,30
55115990622,55115990621,-1,1108,1257,30
55116528485,55116528478,-7,1193,3296,30
55119303630,55119303628,-2,1500,3686,30
55119648172,55119648167,-5,868,1157,30
55119771246,55119771239,-7,981,3811,30
55123019224,55123019221,-3,1533,2243,30
55125199974,55125199983,9,17907,49228,30
55134087955,55134087950,-5,1021,2307,30
55135413356,55135413373,17,476,1996,30
55136183375,55136183371,-4,906,2323,30
55136918737,55136918730,-7,1351,2514,30
55140100835,55140100831,-4,1134,3186,30
55145509128,55145509126,-2,776,2344,30
55148371470,55148371466,-4,1112,3135,30
55148974754,55148974751,-3,1093,2764,30
55157895170,55157895167,-3,731,2629,30
55160286613,55160286607,-6,1320,3671,30
55163635227,55163635229,2,1466,1664,30
55165634138,55165634134,-4,976,2328,30
55167784531,55167784526,-5,932,1645,30
55172557461,55172557458,-3,911,3384,30
55176095038,55176095033,-5,1383,3645,30
55176376510,55176376505,-5,1415,3997,30
55179580102,55179580099,-3,967,2758,30
55187489457,55187489451,-6,1017,1650,30
55190461158,55190461154,-4,1728,3192,30
55195405925,55195405918,-7,1100,3269,30
55199575258,55199575252,-6,863,3205,30
55200675585,55200675581,-4,1367,3988,30
55205790561,55205790562,1,3697,3162,30
55208052130,55208052126,-4,1052,2882,30
55210429287,55210429294,7,6456,2923,30
55211976461,55211976458,-3,973,3201,30
55217678045,55217678040,-5,1094,3369,30
55218586874,55218586870,-4,914,2125,30
55220572079,55220572076,-3,1181,1704,30
55222557795,55222557790,-5,634,2108,30
55223758818,55223758814,-4,1082,2682,30
55224590057,55224590076,19,1202,3283,30
55224731073,55224731089,16,397,2517,30
55226337212,55226337226,14,17447,56297,30
55238224723,55238224718,-5,1251,2332,30
55241673619,55241673614,-5,1050,4701,30
55242740999,55242741005,6,3101,1520,30
55246040510,55246040506,-4,1419,3470,30
55248592978,55248592974,-4,1007,2709,30
55248796741,55248796737,-4,662,2469,30
55252473114,55252473114,0,1660,2191,30
55254672927,55254672923,-4,1048,2608,30
55265165930,55265165926,-4,979,3066,30
55267115223,55267115218,-5,1190,4581,30
55271906382,55271906377,-5,1269,3386,30
55272310896,55272310906,10,388,962,30
55278389450,55278389445,-5,838,2136,30
55282147905,55282147910,5,2504,1514,30
55283274272,55283274266,-6,1008,2373,30
55284922590,55284922587,-3,884,2252,30
55289940330,55289940330,0,1472,1505,30
55291579350,55291579345,-5,1310,2504,30
55299547996,55299548014,18,839,2343,30
55311530715,55311530710,-5,1306,2817,30
55314177753,55314177747,-6,1041,3683,30
55315270156,55315270154,-2,1236,1081,30
55316403311,55316403306,-5,1051,2970,30
55317626992,55317626991,-1,202,939,30
55324584241,55324584237,-4,1177,2669,30
55329886575,55329886557,-18,885,3313,30
55330329011,55330328993,-18,629,1405,30
55334978478,55334978473,-5,1306,3177,30
55336535986,55336535982,-4,891,2697,30
55336611084,55336611094,10,323,1758,30
55345648878,55345648874,-4,987,2219,30
55348505294,55348505290,-4,876,3432,30
55351238007,55351238003,-4,1059,3642,30
55354702538,55354702537,-1,2109,2892,30
55358219067,55358219065,-2,848,3233,30
55361919890,55361919882,-8,1118,4281,30
55362024938,55362024930,-8,664,3426,30
55362147182,55362147182,0,1497,1496,30
55367740714,55367740710,-4,1110,2631,30
55373618395,55373618390,-5,909,4400,30
55379735057,55379735054,-3,754,2472,30
55380383894,55380383902,8,4960,2568,30
55380419074,55380419070,-4,1329,3114,30
55381694294,55381694290,-4,1054,3000,30
55383549007,55383549014,7,2494,1553,30
55387315245,55387315241,-4,1268,3318,30
55387500740,55387500754,14,529,1283,30
55388636855,55388636849,-6,594,3286,30
55388706090,55388706106,16,626,1718,30
55388946770,55388946768,-2,714,1103,30
55393274218,55393274223,5,4507,2401,30
55398642666,55398642662,-4,1126,2490,30
55401087713,55401087709,-4,1073,2550,30
55404612527,55404612522,-5,1510,3189,30
55407154568,55407154562,-6,927,2983,30
55407396372,55407396389,17,700,1845,30
55410832997,55410832993,-4,1358,2772,30
55414726422,55414726419,-3,1055,2422,30
55417666218,55417666212,-6,1035,4155,30
55418935754,55418935753,-1,1447,1719,30
55419148586,55419148581,-5,1246,3379,30
55419195847,55419195843,-4,1267,3743,30
55419452500,55419452494,-6,976,2772,30
55423825431,55423825425,-6,1284,4257,30
55432907445,55432907442,-3,987,3079,30
55433747617,55433747613,-4,1048,3159,30
55433785513,55433785535,22,1007,2730,30
55444219001,55444218997,-4,949,2680,30
55444980641,55444980622,-19,210,1013,30
55446957849,55446957845,-4,1191,2482,30
55447498869,55447498865,-4,815,2548,30
55449903312,55449903309,-3,901,2447,30
55457607255,55457607249,-6,1039,3669,30
55460042218,55460042225,7,4635,1526,30
55463202182,55463202162,-20,1022,1827,30
55473866141,55473866135,-6,1267,3165,30
55474117063,55474117060,-3,872,1899,30
55475167438,55475167441,3,2063,1594,30
55478760934,55478760927,-7,1072,3724,30
55481239707,55481239702,-5,1345,4418,30
55485504578,55485504573,-5,1097,3662,30
55486164700,55486164717,17,810,3396,30
55486272389,55486272391,2,948,927,30
55491488291,55491488286,-5,810,2881,30
55491779635,55491779639,4,3913,1757,30
55499735665,55499735666,1,4337,2882,30
55503049326,55503049322,-4,727,2129,30
55503298395,55503298391,-4,877,2332,30
55503460628,55503460623,-5,862,1542,30
55509662175,55509662178,3,3301,3046,30
55516413417,55516413414,-3,943,2148,30
55516554178,55516554190,12,434,970,30
55520702297,55520702299,2,1259,1528,30
55533616382,55533616382,0,2048,2934,30
55534064344,55534064346,2,2917,2174,30
55539339987,55539339982,-5,1226,4008,30
55544783842,55544783837,-5,1167,2393,30
55545715983,55545715978,-5,958,2739,30
55545991760,55545991754,-6,193,1676,30
55547530283,55547530279,-4,1006,2822,30
55550304926,55550304922,-4,1416,2745,30
55554595197,55554595195,-2,899,1075,30
55564060142,55564060139,-3,1124,3034,30
55564503825,55564503846,21,546,1490,30
55564677270,55564677265,-5,830,2267,30
55564897274,55564897255,-19,134,562,30
55567543466,55567543462,-4,877,3411,30
55568043354,55568043353,-1,1016,3167,30
55575452998,55575452996,-2,17882,32296,30
55582072500,55582072496,-4,1119,2710,30
55582305611,55582305594,-17,273,987,30
55586829229,55586829247,18,769,2725,30
55589446566,55589446559,-7,1322,3259,30
55605065184,55605065181,-3,994,2120,30
55619671143,55619671140,-3,1365,2445,30
55622710523,55622710518,-5,915,2301,30
55624596636,55624596634,-2,18336,14130,30
55625441582,55625441578,-4,1251,3028,30
55625579939,55625579958,19,826,1606,30
55627715407,55627715402,-5,855,2740,30
55630016279,55630016274,-5,1049,3282,30
55631478923,55631478918,-5,674,2468,30
55631904239,55631904235,-4,1245,2144,30
55633345939,55633345939,0,953,1230,30
55636446963,55636446958,-5,1347,3047,30
55637809179,55637809173,-6,1250,2868,30
55637854611,55637854631,20,271,661,30
55640926107,55640926111,4,4900,3112,30
55643510765,55643510759,-6,1320,2734,30
55644829105,55644829100,-5,1084,2980,30
55646922633,55646922630,-3,1303,2535,30
55648451366,55648451358,-8,1038,3643,30
55658780474,55658780469,-5,1116,3605,30
55659436868,55659436861,-7,1030,2886,30
55670459200,55670459196,-4,1657,3897,30
55671796150,55671796145,-5,1043,4496,30
55674125071,55674125066,-5,1203,2462,30
55675874804,55675874798,-6,932,3077,30
55677811205,55677811201,-4,1538,2931,30
55688337129,55688337123,-6,1095,3817,30
55696666729,55696666722,-7,809,2900,30
55697797167,55697797162,-5,1490,2516,30
55703187138,55703187133,-5,735,3003,30
55703316779,55703316774,-5,993,2265,30
55707880119,55707880114,-5,1348,4058,30
55708841145,55708841143,-2,1132,1815,30
55714829610,55714829606,-4,1058,2213,30
55718478383,55718478379,-4,1152,3424,30
55719968721,55719968720,-1,1327,1774,30
55721336355,55721336350,-5,1018,2899,30
55724280162,55724280156,-6,1021,3250,30
55728621098,55728621092,-6,523,894,30
55729938922,55729938917,-5,1059,2144,30
55730708891,55730708891,0,706,903,30
55736263794,55736263790,-4,736,2261,30
55737253434,55737253450,16,344,1348,30
55739658037,55739658030,-7,614,1654,30
55747512170,55747512168,-2,1174,1934,30
55755160558,55755160553,-5,1158,3143,30
55758654140,55758654139,-1,1294,1374,30
55762519496,55762519496,0,1555,1659,30
55765395081,55765395077,-4,1312,3584,30
55766470419,55766470413,-6,1362,3372,30
55767601355,55767601349,-6,879,2845,30
55768047251,55768047270,19,1050,2566,30
55769906103,55769906099,-4,1223,2851,30
55771409754,55771409749,-5,999,2777,30
55773515511,55773515506,-5,708,1386,30
55780419831,55780419826,-5,1273,3956,30
55783134137,55783134130,-7,887,2439,30
55787431763,55787431759,-4,807,1790,30
55790293831,55790293826,-5,1558,3118,30
55791063993,55791063989,-4,967,1982,30
55794227415,55794227412,-3,1112,2112,30
55806801200,55806801206,6,2569,1358,30
55807659502,55807659507,5,67,710,30
55823286299,55823286294,-5,1335,2642,30
55824346959,55824346955,-4,925,2247,30
55825561183,55825561177,-6,1606,4004,30
55828603793,55828603789,-4,1263,3623,30
55841602218,55841602213,-5,849,3677,30
55844810145,55844810144,-1,1158,2273,30
55847474745,55847474741,-4,1282,2575,30
55849996899,55849996894,-5,778,2050,30
55859333441,55859333438,-3,971,2665,30
55859581240,55859581229,-11,1019,3035,30
55867279671,55867279667,-4,885,2381,30
55870798242,55870798243,1,8560,9078,30
55880578681,55880578670,-11,46,1451,30
55884800426,55884800418,-8,1314,3728,30
55889338305,55889338305,0,2523,2673,30
55891912640,55891912634,-6,25278,15668,30
55893337267,55893337269,2,1438,1834,30
55903175006,55903175003,-3,905,2867,30
55903283323,55903283318,-5,951,2570,30
55911905981,55911905977,-4,1152,3660,30
55916087209,55916087215,6,3513,1276,30
55920582527,55920582521,-6,871,2416,30
55920795329,55920795325,-4,1308,3991,30
55921979249,55921979231,-18,188,1195,30
55922289695,55922289691,-4,1321,2752,30
55928660124,55928660120,-4,1482,3629,30
55931075219,55931075213,-6,623,1175,30
55934195799,55934195806,7,2170,679,30
55937072263,55937072259,-4,1212,2925,30
55937114712,55937114704,-8,1194,3461,30
55942630013,55942630006,-7,1031,4389,30
55943931113,55943931108,-5,1028,2671,30
55944323442,55944323438,-4,775,2263,30
55945250395,55945250394,-1,142,844,30
55945626471,55945626465,-6,735,2415,30
55950824777,55950824773,-4,1111,3636,30
55954635443,55954635438,-5,923,2542,30
55955355899,55955355877,-22,688,2552,30
55960513233,55960513228,-5,1075,3051,30
55961768497,55961768493,-4,868,3415,30
55964118119,55964118113,-6,1145,2940,30
55974212351,55974212353,2,1729,1122,30
55978672701,55978672701,0,1523,2105,30
55981032993,55981032988,-5,1073,2782,30
55982534766,55982534761,-5,1701,7525,30
55984116351,55984116345,-6,1015,3045,30
55985163058,55985163078,20,584,1935,30
55986082605,55986082602,-3,653,1821,30
55995959157,55995959153,-4,903,2643,30
56005105165,56005105170,5,3568,1357,30
56006302386,56006302390,4,1672,1552,30
56006559816,56006559809,-7,896,3611,30
56006723520,56006723537,17,1063,2821,30
56007618739,56007618736,-3,1062,3911,30
56011714114,56011714109,-5,956,2700,30
56019136559,56019136554,-5,1717,2469,30
56027471245,56027471241,-4,1013,4384,30
56028148910,56028148911,1,1765,1728,30
56034229257,56034229254,-3,867,2220,30
56047042483,56047042487,4,2291,1246,30
56049922795,56049922798,3,2477,2680,30
56060319766,56060319760,-6,852,2550,30
56060455434,56060455434,0,113,927,30
56060619334,56060619329,-5,1140,3344,30
56064410045,56064410039,-6,1446,4999,30
56066662795,56066662787,-8,940,2838,30
56068785118,56068785114,-4,1456,3364,30
56071319825,56071319821,-4,818,3065,30
56084356418,56084356412,-6,1035,3308,30
56085559500,56085559497,-3,691,2328,30
56089406978,56089406974,-4,893,2681,30
56089901016,56089901032,16,481,2220,30
56097011295,56097011290,-5,1229,2685,30
56097318950,56097318946,-4,1288,2269,30
56100473565,56100473557,-8,1043,3152,30
56108644906,56108644901,-5,1050,2621,30
56116522242,56116522238,-4,774,2594,30
56118150407,56118150411,4,4786,2700,30
56123679204,56123679198,-6,977,2914,30
56125309121,56125309114,-7,1859,6579,30
56129719545,56129719542,-3,1210,3062,30
56132147455,56132147452,-3,1131,2934,30
56135409327,56135409323,-4,1172,3960,30
56136100882,56136100901,19,214,1209,30
56137263103,56137263098,-5,1056,2196,30
56140636609,56140636614,5,2269,1085,30
56149626470,56149626466,-4,1105,3858,30
56150522238,56150522234,-4,1458,2620,30
56150672499,56150672508,9,14172,27228,30
56151086939,56151086933,-6,1107,3216,30
56154485519,56154485514,-5,820,1484,30
56157477574,56157477570,-4,864,2879,30
56159164589,56159164581,-8,875,2020,30
56159532387,56159532407,20,1079,3283,30
56164197306,56164197301,-5,1185,2960,30
56167025917,56167025913,-4,1411,3370,30
56167788447,56167788442,-5,802,2929,30
56171259154,56171259150,-4,1019,2399,30
56176205054,56176205056,2,1332,642,30
56178058939,56178058936,-3,974,3095,30
56178162210,56178162229,19,171,901,30
56180429510,56180429505,-5,951,2574,30
56182237494,56182237490,-4,398,867,30
56183968564,56183968577,13,14891,9842,30
56184605014,56184605009,-5,670,2153,30
56186507234,56186507230,-4,1135,3479,30
56187678766,56187678762,-4,1189,2997,30
56188165369,56188165365,-4,1301,2804,30
56196008935,56196008932,-3,910,3077,30
56196391068,56196391064,-4,784,3183,30
56199475522,56199475519,-3,1315,2627,30
56206462166,56206462183,17,144,1047,30
56208946158,56208946152,-6,1297,3103,30
56209087540,56209087558,18,1132,3345,30
56209458257,56209458253,-4,1058,3880,30
56211137584,56211137578,-6,1093,2526,30
56211213210,56211213190,-20,1298,3614,30
56211650898,56211650917,19,1041,2091,30
56214204442,56214204439,-3,898,2799,30
56214306387,56214306383,-4,863,2433,30
56220271826,56220271823,-3,736,2634,30
56220457753,56220457739,-14,801,3889,30
56220706948,56220706930,-18,52,470,30
56222857526,56222857521,-5,1212,3929,30
56223506534,56223506531,-3,1317,2951,30
56223789091,56223789086,-5,891,2687,30
56226370768,56226370761,-7,730,3364,30
56228563577,56228563579,2,79,817,30
56229573574,56229573570,-4,1130,2506,30
56229742079,56229742075,-4,1649,3911,30
56230765425,56230765422,-3,798,2879,30
56237497424,56237497446,22,642,2353,30
56239758200,56239758198,-2,1648,3188,30
56243282172,56243282175,3,2410,1812,30
56244430343,56244430344,1,23950,17580,30
56256863808,56256863805,-3,1246,2365,30
56258325741,56258325738,-3,794,2806,30
56258692062,56258692062,0,868,1971,30
56259526033,56259526026,-7,707,1717,30
56271905858,56271905853,-5,930,3443,30
56277444885,56277444878,-7,911,3085,30
56277585642,56277585657,15,333,1116,30
56277730892,56277730885,-7,982,2171,30
56280258163,56280258169,6,1773,1126,30
56282810582,56282810578,-4,2889,8814,30
56284629039,56284629037,-2,23927,19658,30
56285731318,56285731314,-4,600,1774,30
56285786105,56285786101,-4,1458,4376,30
56289468038,56289468034,-4,1015,3306,30
56290101103,56290101101,-2,22823,26744,30
56293487394,56293487389,-5,363,1160,30
56298294603,56298294621,18,1047,1972,30
56300489573,56300489569,-4,1461,2748,30
56305402622,56305402619,-3,1843,3682,30
56309054029,56309054025,-4,954,2384,30
56309993523,56309993523,0,44446,28979,30
56310022211,56310022206,-5,807,2655,30
56310983522,56310983521,-1,2756,5041,30
56313173242,56313173237,-5,2226,6116,30
56314836261,56314836257,-4,1195,2910,30
56315016154,56315016149,-5,890,2658,30
56316382570,56316382565,-5,1182,3353,30
56317765462,56317765456,-6,674,2022,30
56318787718,56318787712,-6,1190,3620,30
56320418351,56320418349,-2,818,2561,30
56326455890,56326455885,-5,940,3326,30
56328057008,56328057005,-3,1264,4270,30
56329032853,56329032850,-3,955,2332,30
56329241049,56329241038,-11,1041,3122,30
56332998163,56332998157,-6,942,3740,30
56333145592,56333145610,18,963,2000,30
56339458574,56339458570,-4,799,2661,30
56341393553,56341393556,3,1459,1279,30
56345278081,56345278077,-4,629,928,30
56347598718,56347598714,-4,1176,4145,30
56354968999,56354968993,-6,810,2304,30
56355444027,56355444026,-1,208,1296,30
56357285458,56357285454,-4,1237,3759,30
56357783423,56357783419,-4,1113,2508,30
56369512484,56369512486,2,3156,2763,30
56370023810,56370023814,4,1745,1262,30
56376629494,56376629489,-5,1296,3173,30
56378695414,56378695410,-4,1009,3175,30
56380288871,56380288865,-6,1119,2752,30
56381716920,56381716914,-6,799,1572,30
56382411895,56382411890,-5,723,1545,30
56382483481,56382483502,21,825,2392,30
56385992419,56385992415,-4,1320,2022,30
56387446821,56387446817,-4,1151,3059,30
56389957788,56389957785,-3,1516,4138,30
56393783815,56393783818,3,1142,875,30
56394742250,56394742245,-5,1256,3005,30
56395168532,56395168526,-6,1069,2525,30
56397050198,56397050194,-4,743,2828,30
56397828993,56397828987,-6,1184,3064,30
56400488514,56400488510,-4,823,2243,30
56407999427,56407999422,-5,1304,3173,30
56411822241,56411822236,-5,1227,4067,30
56411948986,56411949006,20,1006,2673,30
56412012529,56412012530,1,297,1267,30
56412365403,56412365382,-21,1052,2462,30
56414952782,56414952778,-4,1084,2964,30
56415248401,56415248398,-3,1193,2617,30
56416442859,56416442879,20,224,1444,30
56417597683,56417597678,-5,1373,2350,30
56420992322,56420992316,-6,1389,4798,30
56423793854,56423793848,-6,708,2492,30
56425006640,56425006636,-4,1586,2632,30
56429872245,56429872241,-4,948,3086,30
56433940469,56433940465,-4,979,2416,30
56435216286,56435216282,-4,1032,2664,30
56435808770,56435808772,2,245,1036,30
56437649509,56437649509,0,1318,2062,30
56438469714,56438469709,-5,1155,3089,30
56440713411,56440713407,-4,1071,3780,30
56440875879,56440875875,-4,1020,2372,30
56441162909,56441162903,-6,2081,8675,30
56452301614,56452301608,-6,1265,4220,30
56458022189,56458022184,-5,1071,2342,30
56462149963,56462149958,-5,1157,2554,30
56471980311,56471980307,-4,549,1794,30
56476891479,56476891474,-5,641,2633,30
56481699075,56481699072,-3,1104,2884,30
56481810236,56481810233,-3,1022,2625,30
56484138059,56484138054,-5,1341,2991,30
56488404088,56488404081,-7,1109,4406,30
56488542882,56488542870,-12,319,923,30
56492003319,56492003315,-4,675,2832,30
56503461656,56503461654,-2,1211,2221,30
56504207365,56504207350,-15,14,1150,30
56507386621,56507386623,2,2148,1616,30
56512018293,56512018290,-3,868,4053,30
56518851207,56518851203,-4,784,1869,30
56523063067,56523063062,-5,1399,2392,30
56524601895,56524601898,3,4045,3837,30
56527330941,56527330937,-4,1585,3395,30
56531019846,56531019842,-4,830,2877,30
56536278775,56536278771,-4,1331,3426,30
56537043738,56537043734,-4,802,2231,30
56537362192,56537362213,21,439,2081,30
56542696439,56542696437,-2,1014,2794,30
56544249943,56544249949,6,22,868,30
56549943978,56549943980,2,7007,21239,30
56553743211,56553743206,-5,1105,2331,30
56554545723,56554545721,-2,970,2727,30
56554828753,56554828773,20,303,1610,30
56557129847,56557129842,-5,1216,4343,30
56557961900,56557961894,-6,759,3097,30
56558451568,56558451578,10,105,1376,30
56571248399,56571248399,0,2151,1876,30
56577777922,56577777915,-7,1095,3474,30
56578782749,56578782745,-4,1371,3665,30
56582538225,56582538220,-5,955,2981,30
56582921242,56582921233,-9,1184,2372,30
56586942639,56586942634,-5,1144,3259,30
56591235834,56591235830,-4,1112,1578,30
56601450597,56601450593,-4,1302,2803,30
56608571231,56608571226,-5,887,3197,30
56609500910,56609500906,-4,984,2275,30
56610043066,56610043063,-3,1366,2796,30
56612010354,56612010350,-4,1177,2601,30
56612329383,56612329378,-5,1055,2886,30
56617678238,56617678233,-5,1126,2258,30
56619235484,56619235480,-4,1051,2384,30
56620429978,56620429976,-2,832,1308,30
56620969856,56620969877,21,1243,3819,30
56623443803,56623443799,-4,1362,2834,30
56624596819,56624596813,-6,1304,2029,30
56624746650,56624746665,15,189,744,30
56626170925,56626170922,-3,668,2434,30
56630289850,56630289844,-6,834,3602,30
56635596419,56635596414,-5,889,2429,30
56636916161,56636916154,-7,1073,2458,30
56639038472,56639038466,-6,1360,3729,30
56644798124,56644798118,-6,1329,4241,30
56647663067,56647663062,-5,1522,3707,30
56647774682,56647774679,-3,1319,2559,30
56651224929,56651224934,5,2476,1356,30
56657146601,56657146599,-2,983,3150,30
56657207014,56657207012,-2,1152,2360,30
56663665294,56663665313,19,494,1221,30
56664181876,56664181875,-1,1097,1759,30
56672667559,56672667554,-5,947,3276,30
56672968383,56672968377,-6,871,2088,30
56674676423,56674676420,-3,810,2439,30
56680701823,56680701818,-5,1363,2176,30
56683112914,56683112915,1,3031,3581,30
56683483055,56683483050,-5,739,2113,30
56684140912,56684140922,10,278,900,30
56689909372,56689909367,-5,1080,2810,30
56690344038,56690344033,-5,1129,2693,30
56690394203,56690394199,-4,1165,4000,30
56692450547,56692450543,-4,1275,3373,30
56695297807,56695297801,-6,913,3429,30
56696280781,56696280774,-7,1018,3100,30
56696532513,56696532506,-7,937,3973,30
56698795359,56698795354,-5,326,1923,30
56699345026,56699345033,7,285,1050,30
56704675186,56704675184,-2,945,2310,30
56705461302,56705461299,-3,804,2609,30
56713758710,56713758705,-5,904,2865,30
56715728354,56715728351,-3,890,2728,30
56715947737,56715947738,1,246,1128,30
56720098785,56720098780,-5,1021,2157,30
56721810639,56721810637,-2,1128,3131,30
56723792434,56723792430,-4,1095,2966,30
56724895658,56724895656,-2,1027,3407,30
56725948850,56725948846,-4,1213,2701,30
56726099617,56726099613,-4,1087,3447,30
56726689987,56726689983,-4,936,2008,30
56730232990,56730232985,-5,854,2517,30
56731821762,56731821758,-4,1480,4766,30
56732870778,56732870795,17,718,2016,30
56735061812,56735061807,-5,1001,3437,30
56737449079,56737449074,-5,888,3905,30
56738416999,56738416995,-4,1034,2337,30
56739055802,56739055797,-5,1090,2853,30
56739366981,56739366976,-5,1224,3676,30
56741352458,56741352454,-4,1209,2504,30
56744072337,56744072333,-4,1407,2171,30
56747637422,56747637416,-6,1150,3586,30
56749286922,56749286915,-7,1179,3167,30
56753873976,56753873979,3,1545,1131,30
56756130086,56756130082,-4,1217,3237,30
56756451850,56756451846,-4,658,1888,30
56758504127,56758504125,-2,838,2493,30
56761543908,56761543911,3,1827,1539,30
56766854388,56766854384,-4,1703,3373,30
56767434863,56767434859,-4,796,2834,30
56767492814,56767492810,-4,1137,2373,30
56767855233,56767855219,-14,553,2682,30
56770835182,56770835178,-4,1181,1854,30
56784089631,56784089622,-9,1298,9642,30
56784733447,56784733450,3,2505,1760,30
56785662959,56785662954,-5,936,3375,30
56788098695,56788098690,-5,1335,3222,30
56788868510,56788868504,-6,1060,4833,30
56790871281,56790871278,-3,909,2052,30
56797972499,56797972496,-3,1098,2531,30
56798292003,56798292001,-2,879,3469,30
56798775630,56798775628,-2,956,3056,30
56800958095,56800958090,-5,1251,3758,30
56804224879,56804224876,-3,1072,2705,30
56805066572,56805066567,-5,1249,2849,30
56815360361,56815360354,-7,1114,2707,30
56816926529,56816926533,4,2253,1511,30
56831541914,56831541915,1,1791,1657,30
56833168029,56833168030,1,1563,1880,30
56834917062,56834917065,3,1938,1420,30
56835073791,56835073786,-5,1348,3883,30
56840295462,56840295457,-5,1104,3438,30
56841233362,56841233358,-4,1202,2265,30
56854206309,56854206305,-4,1291,2679,30
56855603440,56855603438,-2,1232,1759,30
56865540755,56865540749,-6,899,2852,30
56866351658,56866351636,-22,1234,3604,30
56867022947,56867022942,-5,1249,2600,30
56870742554,56870742550,-4,1213,3595,30
56877660459,56877660456,-3,1141,3727,30
56878655615,56878655612,-3,1066,2374,30
56883858866,56883858862,-4,1098,2284,30
56892309250,56892309247,-3,706,2077,30
56899607120,56899607114,-6,1224,2526,30
56910228563,56910228565,2,1444,1201,30
56915623150,56915623143,-7,1023,2599,30
56923861131,56923861126,-5,1300,2630,30
56929244965,56929244961,-4,1197,3757,30
56931602301,56931602296,-5,943,2518,30
56938567057,56938567055,-2,719,908,30
56941144375,56941144380,5,2632,1096,30
56943077594,56943077598,4,2361,2072,30
56943177934,56943177928,-6,989,2025,30
56949093031,56949093025,-6,960,3631,30
56949501566,56949501567,1,1480,1109,30
56958735156,56958735153,-3,1262,2766,30
56960250232,56960250226,-6,944,2587,30
56962072213,56962072208,-5,1261,2721,30
56963344879,56963344875,-4,788,3065,30
56967446262,56967446257,-5,825,3075,30
56969362981,56969362976,-5,818,2841,30
56971603569,56971603573,4,8439,34917,30
56972168438,56972168437,-1,912,1741,30
56972620066,56972620050,-16,155,717,30
56974339090,56974339084,-6,1055,2719,30
56974405641,56974405621,-20,1207,2696,30
56979538981,56979538975,-6,822,3024,30
56979810063,56979810058,-5,1303,3786,30
56983483297,56983483296,-1,1553,1850,30
56985308021,56985308017,-4,579,1280,30
56990972530,56990972530,0,1452,1754,30
56993150290,56993150289,-1,1574,2159,30
56995774450,56995774445,-5,1190,2713,30
56996050713,56996050695,-18,227,1022,30
56996285555,56996285568,13,260,1712,30
56996828434,56996828439,5,2003,811,30
57003645398,57003645394,-4,2517,5659,30
57010221875,57010221869,-6,927,3910,30
57012159159,57012159153,-6,743,2798,30
57020197999,57020197997,-2,1286,2776,30
57020544449,57020544446,-3,818,2165,30
57022794483,57022794477,-6,676,4254,30
57024252324,57024252319,-5,1476,3046,30
57024518663,57024518660,-3,866,2583,30
57024714827,57024714821,-6,1111,2806,30
57025159426,57025159445,19,634,2345,30
57029169066,57029169062,-4,891,2923,30
57031082609,57031082601,-8,648,2428,30
57035677863,57035677883,20,747,2045,30
57038029210,57038029205,-5,892,2887,30
57040875566,57040875565,-1,1175,1797,30
57044840254,57044840249,-5,798,2043,30
57046011952,57046011941,-11,191,1199,30
57046788018,57046788013,-5,940,3117,30
57051285326,57051285320,-6,1490,2896,30
57056001483,57056001478,-5,1251,3069,30
57060988097,57060988092,-5,1005,3784,30
57062954918,57062954915,-3,1319,2349,30
57065165553,57065165548,-5,985,3839,30
57065579817,57065579802,-15,1077,3558,30
57066789762,57066789758,-4,1143,3537,30
57068289094,57068289090,-4,1268,3487,30
57069366928,57069366932,4,4439,2568,30
57074069418,57074069412,-6,1077,3493,30
57075747607,57075747606,-1,1389,2482,30
57079571093,57079571098,5,2243,1103,30
57080524286,57080524302,16,756,1900,30
57089121294,57089121290,-4,1186,3078,30
57094735806,57094735802,-4,1113,3029,30
57097451972,57097451974,2,1830,1430,30
57097557583,57097557581,-2,1153,2422,30
57107462794,57107462790,-4,1312,2073,30
57110916050,57110916057,7,1485,874,30
57111383165,57111383161,-4,861,2088,30
57115890763,57115890758,-5,922,3072,30
57116937506,57116937502,-4,1004,3808,30
57121085831,57121085827,-4,884,2929,30
57121399431,57121399428,-3,1378,2982,30
57123723153,57123723149,-4,772,2415,30
57124087420,57124087414,-6,842,2281,30
57128301278,57128301274,-4,1244,3656,30
57129931287,57129931289,2,1170,831,30
57130277662,57130277682,20,962,766,30
57132523843,57132523838,-5,473,3012,30
57150595971,57150595967,-4,383,2098,30
57154705928,57154705925,-3,954,1522,30
57154877482,57154877479,-3,1405,2188,30
57159697371,57159697366,-5,1482,3448,30
57162368630,57162368624,-6,834,3484,30
57168196595,57168196589,-6,1150,2852,30
57172462658,57172462657,-1,1689,2236,30
57180455322,57180455318,-4,1202,2754,30
57184731390,57184731387,-3,1087,1986,30
57186654069,57186654062,-7,1357,3149,30
57187656851,57187656847,-4,1045,3148,30
57190817802,57190817798,-4,1044,2956,30
57191524820,57191524833,13,526,1160,30
57193807564,57193807559,-5,971,3568,30
57200603603,57200603601,-2,1077,2340,30
57201908391,57201908385,-6,926,4861,30
57212065039,57212065034,-5,838,3078,30
57213248154,57213248150,-4,1250,3607,30
57215298923,57215298917,-6,1215,3900,30
57215559162,57215559161,-1,831,2076,30
57216937279,57216937275,-4,1176,2325,30
57220526394,57220526387,-7,1249,5332,30
57220575025,57220575021,-4,1162,2746,30
57228178045,57228178040,-5,829,2898,30
57233890473,57233890467,-6,1077,2877,30
57233981170,57233981165,-5,1161,4365,30
57234022376,57234022398,22,707,3379,30
57237847694,57237847700,6,15326,23575,30
57239643942,57239643938,-4,1237,2841,30
57240658585,57240658568,-17,993,2747,30
57258206646,57258206643,-3,1584,2920,30
57258257017,57258257028,11,209,979,30
57261374855,57261374849,-6,2415,5740,30
57261676742,57261676738,-4,1136,3241,30
57268360586,57268360581,-5,917,3307,30
57269229036,57269229039,3,1353,887,30
57276324461,57276324456,-5,1046,2512,30
57279536782,57279536778,-4,967,3752,30
57280638368,57280638365,-3,1242,3495,30
57280740464,57280740463,-1,48041,16352,30
57282447906,57282447901,-5,1106,2996,30
57286073553,57286073549,-4,1116,3567,30
57286521409,57286521404,-5,956,4353,30
57290910960,57290910956,-4,1051,3065,30
57291145332,57291145330,-2,1032,2995,30
57292845857,57292845853,-4,1390,4322,30
57297018566,57297018562,-4,822,2346,30
57299976958,57299976954,-4,872,2100,30
57301164784,57301164778,-6,56,902,30
57301530596,57301530608,12,877,2273,30
57302619774,57302619770,-4,1047,2536,30
57303135190,57303135197,7,6798,2405,30
57303204243,57303204229,-14,23272,17872,30
57304664767,57304664762,-5,1179,3380,30
57308193255,57308193253,-2,1206,2560,30
57315069274,57315069271,-3,907,2125,30
57316652839,57316652834,-5,1482,3668,30
57320780721,57320780718,-3,674,3609,30
57322454141,57322454137,-4,1150,3123,30
57325190670,57325190666,-4,1102,2742,30
57326094918,57326094916,-2,755,2121,30
57326830370,57326830370,0,1922,2597,30
57327487031,57327487027,-4,1761,2825,30
57330232323,57330232320,-3,887,1870,30
57332168851,57332168848,-3,22395,24186,30
57332248677,57332248673,-4,966,2251,30
57332375953,57332375949,-4,1361,3276,30
57342283962,57342283961,-1,1201,2372,30
57342572723,57342572718,-5,997,2567,30
57345836265,57345836261,-4,980,2904,30
57347923231,57347923226,-5,1306,2570,30
57351348422,57351348418,-4,1251,3147,30
57351584891,57351584886,-5,615,1720,30
57352967141,57352967135,-6,1118,2398,30
57355321538,57355321539,1,20373,95187,30
57355391043,57355391039,-4,664,782,30
57356369400,57356369395,-5,1253,2821,30
57362143459,57362143454,-5,665,1912,30
57362663944,57362663939,-5,1190,2676,30
57371349602,57371349597,-5,1146,2407,30
57376183719,57376183714,-5,1063,4456,30
57382431658,57382431651,-7,933,4499,30
57383530449,57383530445,-4,1233,3472,30
57385008000,57385007997,-3,1142,3006,30
57392027292,57392027287,-5,1073,3834,30
57395827862,57395827861,-1,1095,2351,30
57395984275,57395984270,-5,771,1058,30
57398072759,57398072754,-5,1160,3252,30
57399108883,57399108879,-4,857,3361,30
57399140445,57399140440,-5,794,3726,30
57399386610,57399386628,18,777,2215,30
57409960545,57409960540,-5,1211,2526,30
57411937357,57411937350,-7,32082,12861,30
57423111119,57423111115,-4,723,2512,30
57423471042,57423471037,-5,1050,2569,30
57423588763,57423588762,-1,108,918,30
57425919583,57425919578,-5,1123,3726,30
57432348246,57432348244,-2,785,2127,30
57432876509,57432876506,-3,942,2651,30
57435538377,57435538390,13,211,1280,30
57436728129,57436728125,-4,845,1719,30
57440164152,57440164133,-19,1284,750,30
57447206177,57447206174,-3,1175,2935,30
57447851726,57447851720,-6,843,3939,30
57448500439,57448500447,8,634,1099,30
57452569495,57452569490,-5,957,2486,30
57457003569,57457003564,-5,1199,2798,30
57457270472,57457270466,-6,1442,3202,30
57457352988,57457352986,-2,3123,3284,30
57459516751,57459516747,-4,663,2693,30
57461949091,57461949086,-5,1188,3159,30
57463666075,57463666072,-3,1099,3690,30
57463996988,57463996984,-4,954,1941,30
57464260221,57464260219,-2,1714,2878,30
57464940372,57464940370,-2,1065,1169,30
57468261462,57468261458,-4,1164,2815,30
57483623825,57483623823,-2,2085,2114,30
57485860650,57485860642,-8,1067,3975,30
57487404928,57487404914,-14,580,1470,30
57489185154,57489185150,-4,926,3076,30
57492520338,57492520336,-2,1175,2252,30
57495771054,57495771050,-4,1090,2834,30
57496080854,57496080853,-1,2573,4230,30
57497966691,57497966687,-4,1060,2456,30
57498837494,57498837489,-5,916,3932,30
57505045392,57505045388,-4,377,2841,30
57505576360,57505576356,-4,922,2917,30
57507641375,57507641370,-5,1052,3370,30
57509369749,57509369744,-5,1087,3293,30
57511020857,57511020853,-4,1257,2801,30
57521979199,57521979194,-5,1133,4045,30
57525951603,57525951602,-1,1204,2372,30
57529322586,57529322581,-5,1060,3067,30
57530799325,57530799321,-4,1054,3383,30
57534896941,57534896938,-3,1264,2460,30
57536153657,57536153650,-7,917,3427,30
57536609286,57536609281,-5,1148,3330,30
57538221243,57538221238,-5,929,2983,30
57538513531,57538513525,-6,1140,2919,30
57541723655,57541723650,-5,958,3205,30
57542446075,57542446094,19,217,1615,30
57543493451,57543493445,-6,942,3070,30
57546157180,57546157176,-4,1326,3226,30
57548562809,57548562807,-2,1224,2284,30
57555528198,57555528202,4,2804,1441,30
57558516831,57558516826,-5,1077,3714,30
57560832169,57560832163,-6,1383,4841,30
57561075522,57561075518,-4,828,2897,30
57566231874,57566231874,0,975,1742,30
57570393711,57570393706,-5,1244,2880,30
57574073038,57574073035,-3,843,2638,30
57578253981,57578253977,-4,1274,2437,30
57581388626,57581388630,4,2529,1940,30
57582988666,57582988661,-5,938,3697,30
57583786427,57583786421,-6,726,3574,30
57584034966,57584034962,-4,723,2226,30
57586187845,57586187867,22,2034,1438,30
57586567363,57586567358,-5,1083,2020,30
57588956236,57588956230,-6,956,3261,30
57589304161,57589304183,22,602,2395,30
57590541651,57590541646,-5,1059,3623,30
57597636541,57597636537,-4,1015,2631,30
57597902603,57597902597,-6,1324,3332,30
57598950530,57598950523,-7,852,2704,30
57602179477,57602179471,-6,836,3616,30
57607661564,57607661570,6,4060,1203,30
57608509190,57608509185,-5,940,2793,30
57608765661,57608765658,-3,738,1807,30
57615566586,57615566581,-5,1199,4584,30
57617234998,57617234994,-4,1399,3213,30
57624248798,57624248794,-4,1054,2741,30
57631175761,57631175757,-4,1254,3597,30
57631371795,57631371790,-5,1360,3152,30
57639289414,57639289418,4,2420,1681,30
57640186354,57640186358,4,4550,2506,30
57640495793,57640495789,-4,1599,3517,30
57644939218,57644939213,-5,1067,3192,30
57650294374,57650294367,-7,1134,2628,30
57651250453,57651250448,-5,946,2849,30
57657739801,57657739796,-5,1078,2408,30
57658111252,57658111234,-18,265,821,30
57659632486,57659632481,-5,924,3163,30
57661954147,57661954143,-4,877,2833,30
57664468683,57664468677,-6,960,2566,30
57666167879,57666167875,-4,760,2281,30
57668884974,57668884969,-5,1168,3462,30
57681355546,57681355542,-4,1125,2141,30
57681612679,57681612686,7,1770,730,30
57685862083,57685862078,-5,715,3173,30
57689547707,57689547702,-5,913,3194,30
57697808986,57697808982,-4,412,1906,30
57698644873,57698644870,-3,1174,3255,30
57699624925,57699624921,-4,1046,3370,30
57700450116,57700450120,4,2265,1716,30
57700752021,57700752021,0,1823,1604,30
57703672539,57703672539,0,1180,2212,30
57708745708,57708745716,8,16101,21976,30
57710991416,57710991413,-3,816,2408,30
57715182938,57715182938,0,1697,2168,30
57723158824,57723158818,-6,1091,3211,30
57723715155,57723715151,-4,934,3469,30
57725100261,57725100265,4,1309,1639,30
57725206386,57725206382,-4,1298,2886,30
57725586810,57725586805,-5,689,2781,30
57726012642,57726012657,15,400,2623,30
57726274940,57726274937,-3,1490,2167,30
57726591544,57726591542,-2,482,1661,30
57727107426,57727107422,-4,1212,2560,30
57729669101,57729669097,-4,947,2618,30
57732932498,57732932493,-5,843,2393,30
57739620493,57739620489,-4,1122,2786,30
57741667275,57741667282,7,6433,2590,30
57752777190,57752777195,5,2390,1446,30
57757299004,57757299001,-3,1025,2186,30
57768701111,57768701106,-5,982,3216,30
57781259982,57781259976,-6,816,3100,30
57783030063,57783030057,-6,720,2314,30
57784181206,57784181201,-5,698,2022,30
57785244203,57785244206,3,1208,1081,30
57787688250,57787688247,-3,1130,1823,30
57792159002,57792159006,4,3369,2878,30
57793703674,57793703670,-4,1070,1253,30
57794134298,57794134293,-5,1522,3329,30
57801336426,57801336419,-7,844,3293,30
57804246007,57804246001,-6,843,2587,30
57806909639,57806909636,-3,1006,3174,30
57809648118,57809648114,-4,1121,3136,30
57809924520,57809924523,3,380,1267,30
57811526495,57811526502,7,3323,906,30
57813415786,57813415781,-5,561,1751,30
57813802942,57813802938,-4,866,3844,30
57817755179,57817755186,7,3154,1525,30
57821930489,57821930484,-5,459,1664,30
57823566392,57823566387,-5,1166,3644,30
57823741373,57823741370,-3,537,1791,30
57825217539,57825217517,-22,356,852,30
57826678776,57826678756,-20,1160,2185,30
57840024631,57840024625,-6,776,2479,30
57845351702,57845351697,-5,1377,3952,30
57848162835,57848162831,-4,1053,2189,30
57852730603,57852730598,-5,1428,3716,30
57858189386,57858189382,-4,756,2686,30
57858648290,57858648283,-7,1375,2692,30
57860745013,57860745017,4,2088,1312,30
57867256926,57867256921,-5,1094,3008,30
57872081300,57872081294,-6,880,2442,30
57876653560,57876653555,-5,722,3039,30
57876912498,57876912517,19,332,1030,30
57877547014,57877547008,-6,704,1241,30
57883077698,57883077694,-4,979,2826,30
57883356840,57883356857,17,1103,2641,30
57886056212,57886056219,7,10105,34799,30
57887692923,57887692918,-5,1826,4329,30
57893406410,57893406406,-4,1002,2699,30
57893641729,57893641726,-3,164,1053,30
57896826079,57896826072,-7,1520,3811,30
57897917188,57897917183,-5,767,2641,30
57898409161,57898409178,17,383,1067,30
57899874367,57899874363,-4,937,1867,30
57906338433,57906338426,-7,1114,2692,30
57908113034,57908113031,-3,2451,5659,30
57920083066,57920083059,-7,513,2291,30
57925165350,57925165346,-4,1000,3093,30
57925431970,57925431965,-5,2040,5381,30
57928274879,57928274874,-5,936,2666,30
57928457442,57928457439,-3,66,898,30
57929798367,57929798361,-6,1011,3090,30
57933861442,57933861438,-4,1036,1726,30
57935072762,57935072765,3,4367,3765,30
57935659360,57935659354,-6,1128,3139,30
57938793629,57938793625,-4,861,4084,30
57941107126,57941107121,-5,1806,3520,30
57941626210,57941626209,-1,958,1789,30
57941857246,57941857239,-7,35,2103,30
57943622816,57943622814,-2,7180,13738,30
57947141164,57947141171,7,2043,1325,30
57953366203,57953366198,-5,1543,3287,30
57954190997,57954190990,-7,1040,3175,30
57957552800,57957552798,-2,2323,2849,30
57958633074,57958633071,-3,799,2712,30
57963581707,57963581710,3,3640,2963,30
57964328477,57964328474,-3,856,2784,30
57965429689,57965429702,13,4987,42694,30
57971030087,57971030082,-5,1368,3123,30
57972207697,57972207693,-4,480,1922,30
57973258301,57973258296,-5,1153,2561,30
57977385747,57977385742,-5,895,2208,30
57978356679,57978356673,-6,1048,3166,30
57982444646,57982444642,-4,821,2080,30
57982581609,57982581603,-6,1169,3229,30
57983911721,57983911717,-4,912,3091,30
57985785906,57985785894,-12,1004,2565,30
57989025234,57989025230,-4,931,2994,30
57989092358,57989092356,-2,987,2806,30
57991364144,57991364146,2,3010,3175,30
57993705826,57993705822,-4,926,2483,30
57997100152,57997100148,-4,1018,2789,30
57998408866,57998408861,-5,1103,2104,30
58003600959,58003600953,-6,1485,3190,30
58007179455,58007179450,-5,835,2790,30
58011681857,58011681853,-4,898,2463,30
58013998098,58013998094,-4,729,1829,30
58016278578,58016278587,9,3054,705,30
58018150043,58018150038,-5,1023,2352,30
58018900257,58018900252,-5,1136,2926,30
58024070583,58024070578,-5,585,1413,30
58024541771,58024541767,-4,530,2034,30
58025649690,58025649686,-4,890,3331,30
58025761074,58025761070,-4,189,894,30
58026240209,58026240225,16,822,3747,30
58029834281,58029834278,-3,1059,2404,30
58035247518,58035247515,-3,1390,2882,30
58037449638,58037449635,-3,859,1431,30
58038459062,58038459062,0,3441,3331,30
58040800843,58040800846,3,1653,1264,30
58040973485,58040973478,-7,1038,3181,30
58048296393,58048296390,-3,966,2837,30
58049804496,58049804491,-5,1124,3377,30
58053118828,58053118823,-5,1251,3909,30
58056344214,58056344209,-5,1179,3141,30
58059713629,58059713624,-5,961,2813,30
58065225017,58065225013,-4,689,3821,30
58068233867,58068233863,-4,525,1671,30
58069043418,58069043414,-4,952,3048,30
58071291130,58071291134,4,10903,6651,30
58073243039,58073243033,-6,918,4679,30
58073524770,58073524782,12,898,3192,30
58074148646,58074148642,-4,925,2554,30
58074462874,58074462883,9,341,1026,30
58075362241,58075362237,-4,1306,2575,30
58078446179,58078446173,-6,871,3192,30
58083978342,58083978338,-4,1305,3223,30
58094964477,58094964471,-6,1396,2728,30
58095897534,58095897530,-4,967,2162,30
58096956895,58096956890,-5,838,2233,30
58098129107,58098129104,-3,866,1677,30
58102542192,58102542191,-1,1127,1994,30
58102845290,58102845301,11,419,1320,30
58103376049,58103376043,-6,950,3050,30
58104163381,58104163378,-3,1380,3878,30
58104432537,58104432530,-7,700,1368,30
58108158386,58108158378,-8,859,2829,30
58108860939,58108860955,16,800,2109,30
58110149526,58110149522,-4,1163,3649,30
58114364015,58114364009,-6,1018,1923,30
58118293766,58118293764,-2,24095,75192,30
58122936911,58122936909,-2,1847,3772,30
58123238756,58123238773,17,884,2418,30
58127717224,58127717221,-3,1057,2957,30
58132025279,58132025273,-6,946,4134,30
58133632288,58133632282,-6,1235,2904,30
58134665487,58134665484,-3,1382,3036,30
58137143021,58137143043,22,810,2276,30
58137639087,58137639082,-5,1255,3823,30
58140673853,58140673851,-2,1146,1870,30
58149904894,58149904889,-5,1916,4713,30
58153081094,58153081090,-4,1067,3110,30
58153223466,58153223461,-5,988,3064,30
58155312339,58155312333,-6,1166,2649,30
58162576858,58162576853,-5,923,3060,30
58164807522,58164807517,-5,997,3334,30
58169676626,58169676631,5,3722,1552,30
58176384406,58176384401,-5,1184,2489,30
58176659660,58176659677,17,697,1077,30
58181229010,58181229009,-1,1325,1656,30
58183947581,58183947576,-5,788,2291,30
58191701891,58191701894,3,1927,1080,30
58204030227,58204030222,-5,707,1789,30
58204755916,58204755934,18,426,1062,30
58205207945,58205207945,0,1022,1360,30
58206094399,58206094397,-2,1422,2850,30
58206196263,58206196257,-6,1097,4004,30
58211414390,58211414386,-4,1014,3144,30
58211842874,58211842869,-5,979,3144,30
58214460478,58214460474,-4,976,2579,30
58215535106,58215535103,-3,1136,2556,30
58216047220,58216047214,-6,1154,2711,30
58218140370,58218140366,-4,714,2527,30
58219517636,58219517633,-3,1306,2738,30
58221679434,58221679430,-4,756,1324,30
58222608546,58222608537,-9,1108,2881,30
58227468755,58227468751,-4,3822,10706,30
58228546303,58228546300,-3,650,1450,30
58230089731,58230089730,-1,1173,1496,30
58231895920,58231895914,-6,900,2421,30
58235056876,58235056873,-3,831,3024,30
58241218551,58241218544,-7,1068,2706,30
58242331827,58242331825,-2,847,3098,30
58244827197,58244827197,0,1843,2746,30
58245482455,58245482451,-4,1948,6305,30
58246668013,58246668009,-4,579,2117,30
58247312816,58247312808,-8,886,3884,30
58248767055,58248767049,-6,1351,3765,30
58253267186,58253267187,1,1439,2231,30
58262707709,58262707701,-8,1461,8499,30
58262916539,58262916534,-5,1109,2840,30
58263307342,58263307337,-5,851,2110,30
58268185914,58268185910,-4,944,1394,30
58277688159,58277688155,-4,1187,2972,30
58279077358,58279077342,-16,1640,1121,30
58280851107,58280851103,-4,524,1197,30
58283962167,58283962165,-2,1118,3161,30
58284822682,58284822698,16,778,2266,30
58285407467,58285407464,-3,1238,1778,30
58286128389,58286128384,-5,806,2222,30
58288196986,58288196979,-7,825,3395,30
58290681153,58290681148,-5,909,2669,30
58292773459,58292773461,2,1254,1286,30
58295840970,58295840965,-5,603,2947,30
58298766139,58298766134,-5,953,3074,30
58299400099,58299400099,0,161,1041,30
58300592257,58300592255,-2,1198,2988,30
58304667245,58304667241,-4,1229,2799,30
58305010859,58305010854,-5,708,2896,30
58306225988,58306225984,-4,1187,3470,30
58309167372,58309167368,-4,1234,4308,30
58309366418,58309366413,-5,1384,4288,30
58310276382,58310276381,-1,1115,2476,30
58319825001,58319825006,5,3178,1658,30
58321061235,58321061230,-5,1340,2639,30
58322608642,58322608637,-5,667,2120,30
58327379051,58327379046,-5,751,2099,30
58328190154,58328190149,-5,973,3593,30
58330541838,58330541834,-4,1184,3028,30
58335408242,58335408238,-4,1011,3193,30
58335725353,58335725370,17,612,2490,30
58342984252,58342984246,-6,1459,3935,30
58345100471,58345100465,-6,1012,2996,30
58346037146,58346037142,-4,951,3166,30
58347790741,58347790734,-7,969,3623,30
58348002586,58348002571,-15,35,802,30
58349609416,58349609400,-16,1101,531,30
58349692722,58349692710,-12,6,871,30
58352923321,58352923339,18,1258,793,30
58361252266,58361252262,-4,1110,2885,30
58365354122,58365354120,-2,1930,3943,30
58368184843,58368184840,-3,938,3037,30
58371620387,58371620382,-5,690,2098,30
58374997765,58374997767,2,1076,1537,30
58376570468,58376570463,-5,1444,4276,30
58381967173,58381967167,-6,1191,3812,30
58382355326,58382355319,-7,1036,2615,30
58382842290,58382842285,-5,1081,3345,30
58388470415,58388470410,-5,1156,3223,30
58390818314,58390818307,-7,977,3507,30
58392804131,58392804134,3,7287,8435,30
58396752486,58396752481,-5,1069,2960,30
58398181097,58398181092,-5,1142,1897,30
58399449987,58399449980,-7,948,2405,30
58403097966,58403097961,-5,834,3123,30
58406516138,58406516132,-6,853,2791,30
58410166142,58410166138,-4,1065,3670,30
58418676071,58418676067,-4,1221,2312,30
58423864725,58423864719,-6,767,3137,30
58430246193,58430246188,-5,865,2496,30
58430812881,58430812886,5,3347,1680,30
58432002573,58432002569,-4,1339,2400,30
58436897701,58436897696,-5,1197,3455,30
58437613351,58437613349,-2,1018,2626,30
58443361248,58443361243,-5,2331,5848,30
58446208074,58446208079,5,2637,1571,30
58449475848,58449475871,23,1127,1282,30
58450672255,58450672250,-5,991,2690,30
58452946356,58452946363,7,3652,1367,30
58453938598,58453938593,-5,707,2652,30
58456665118,58456665113,-5,854,1960,30
58456712027,58456712021,-6,1302,2660,30
58461510977,58461510973,-4,1231,2569,30
58463265653,58463265649,-4,962,2704,30
58466361691,58466361685,-6,754,3544,30
58469853054,58469853047,-7,1218,4907,30
58471754810,58471754807,-3,608,1560,30
58474444714,58474444710,-4,954,2323,30
58476395446,58476395439,-7,724,4071,30
58476875486,58476875481,-5,1055,2595,30
58480961151,58480961147,-4,2343,7110,30
58485892105,58485892100,-5,835,3080,30
58486571966,58486571964,-2,1447,2650,30
58492348054,58492348051,-3,1110,3630,30
58497247745,58497247736,-9,618,2032,30
58499482474,58499482473,-1,1382,2511,30
58499651971,58499651966,-5,1100,3696,30
58503270807,58503270802,-5,646,4284,30
58511767562,58511767557,-5,1120,3205,30
58518497485,58518497478,-7,942,3245,30
58520320371,58520320366,-5,1037,2959,30
58521495395,58521495391,-4,538,1303,30
58521866474,58521866468,-6,1249,3211,30
58524571251,58524571249,-2,1165,3014,30
58528327613,58528327609,-4,1187,2588,30
58532215594,58532215590,-4,1044,2777,30
58546148211,58546148208,-3,814,3137,30
58546352257,58546352252,-5,1030,2421,30
58550387726,58550387722,-4,1024,2704,30
58550484418,58550484426,8,229,2556,30
58557976362,58557976356,-6,1289,4211,30
58559984359,58559984353,-6,1037,2821,30
58561236122,58561236102,-20,804,2691,30
58566955450,58566955446,-4,1085,2591,30
58575533778,58575533771,-7,1245,2608,30
58581385220,58581385217,-3,773,2591,30
58582750807,58582750802,-5,1012,3119,30
58583960397,58583960394,-3,1106,2429,30
58584311631,58584311630,-1,1170,2577,30
58585669526,58585669521,-5,1449,3187,30
58586433076,58586433071,-5,1003,3288,30
58589299965,58589299961,-4,1013,2183,30
58590186481,58590186478,-3,871,2457,30
58591502462,58591502454,-8,1465,13184,30
58595703762,58595703757,-5,660,1784,30
58597242347,58597242343,-4,569,1179,30
58600651400,58600651397,-3,1075,2904,30
58601737751,58601737746,-5,1064,3061,30
58603691810,58603691805,-5,1112,3245,30
58605606043,58605606038,-5,920,2253,30
58609730119,58609730116,-3,780,2824,30
58611439054,58611439048,-6,938,2960,30
58614367998,58614367994,-4,1185,4703,30
58616537914,58616537911,-3,1147,2232,30
58617919157,58617919156,-1,1564,2974,30
58625590685,58625590679,-6,1156,3816,30
58627500346,58627500343,-3,946,1966,30
58632132966,58632132962,-4,1087,2502,30
58636652090,58636652086,-4,1134,2876,30
58637618065,58637618061,-4,1347,3416,30
58639352786,58639352787,1,1232,1535,30
58645355702,58645355698,-4,1277,3914,30
58652550097,58652550092,-5,999,3230,30
58656345394,58656345389,-5,2020,8230,30
58665796374,58665796370,-4,1082,4096,30
58666163930,58666163914,-16,1005,2141,30
58667532806,58667532802,-4,968,2453,30
58668862732,58668862728,-4,1175,2968,30
58670276574,58670276569,-5,1632,2974,30
58670483634,58670483630,-4,1264,3007,30
58676991693,58676991688,-5,1573,4049,30
58682926674,58682926676,2,3123,2578,30
58687181878,58687181884,6,1852,1193,30
58691765505,58691765498,-7,1014,3040,30
58696838609,58696838601,-8,1078,3776,30
58697816337,58697816355,18,2634,1050,30
58698226765,58698226759,-6,1795,3744,30
58703382190,58703382186,-4,864,3009,30
58706327338,58706327334,-4,1575,3612,30
58711242905,58711242899,-6,1086,2664,30
58713350489,58713350486,-3,879,1847,30
58717454646,58717454640,-6,913,4203,30
58718069352,58718069341,-11,1251,3811,30
58719758773,58719758769,-4,1272,3352,30
58720534040,58720534035,-5,217,861,30
58725850772,58725850776,4,11491,33683,30
58727785080,58727785074,-6,1446,3023,30
58733798059,58733798054,-5,862,1948,30
58736922162,58736922160,-2,778,1982,30
58737863323,58737863300,-23,1034,2516,30
58748115103,58748115109,6,6415,2930,30
58752179127,58752179123,-4,853,2849,30
58758348899,58758348893,-6,969,2591,30
58762389357,58762389351,-6,1392,3588,30
58762622834,58762622830,-4,1339,3866,30
58767220239,58767220234,-5,978,3344,30
58767853135,58767853130,-5,1114,3102,30
58769601062,58769601058,-4,858,3030,30
58772330200,58772330194,-6,1282,2341,30
58772494386,58772494402,16,846,2489,30
58774680090,58774680086,-4,977,2901,30
58775084751,58775084747,-4,1089,2303,30
58784219498,58784219498,0,1301,2699,30
58788014352,58788014346,-6,1286,3505,30
58788041928,58788041928,0,134,920,30
58789598625,58789598622,-3,820,2219,30
58796452614,58796452613,-1,1444,3160,30
58797979780,58797979773,-7,1181,2824,30
58798264081,58798264077,-4,1388,3754,30
58800438406,58800438399,-7,1762,11649,30
58803659417,58803659417,0,1148,2135,30
58807022335,58807022330,-5,1053,2309,30
58813563082,58813563077,-5,1224,3417,30
58817512402,58817512396,-6,1469,4997,30
58819197771,58819197765,-6,602,2162,30
58822932014,58822932009,-5,1062,2380,30
58824695573,58824695571,-2,2252,2397,30
58825237582,58825237577,-5,1254,2624,30
58826700905,58826700902,-3,1177,2396,30
58838431482,58838431480,-2,713,1769,30
58838603074,58838603069,-5,912,3512,30
58840358388,58840358385,-3,1304,2022,30
58842114571,58842114566,-5,1101,2720,30
58856729739,58856729735,-4,923,2260,30
58858363183,58858363178,-5,505,1217,30
58858645677,58858645682,5,2353,1336,30
58858856556,58858856553,-3,1525,3458,30
58859903294,58859903291,-3,1383,3082,30
58870481577,58870481580,3,2319,1388,30
58870600830,58870600826,-4,818,3744,30
58873390525,58873390520,-5,1303,3559,30
58873955450,58873955446,-4,899,2239,30
58874412960,58874412982,22,172,437,30
58875299148,58875299143,-5,1296,2814,30
58880047045,58880047041,-4,1281,3032,30
58880704714,58880704729,15,537,1825,30
58882227653,58882227649,-4,1084,3598,30
58882598651,58882598649,-2,1291,2309,30
58882759573,58882759568,-5,785,2818,30
58884897515,58884897510,-5,825,3708,30
58885335979,58885335976,-3,1114,2812,30
58886051402,58886051402,0,1411,1928,30
58888388669,58888388671,2,1943,1747,30
58897638262,58897638258,-4,494,1798,30
58897809882,58897809881,-1,1945,3628,30
58901788505,58901788510,5,2145,1482,30
58902935975,58902935970,-5,1050,3420,30
58904844326,58904844323,-3,1133,2150,30
58905829715,58905829711,-4,823,2946,30
58907628206,58907628211,5,3429,1489,30
58909997293,58909997288,-5,855,2204,30
58911510312,58911510306,-6,1126,3249,30
58923232352,58923232347,-5,1367,3011,30
58923367883,58923367898,15,446,2093,30
58925435884,58925435886,2,147,959,30
58929887593,58929887589,-4,2292,5352,30
58930378090,58930378086,-4,931,1834,30
58934555954,58934555949,-5,806,2872,30
58935873203,58935873205,2,22078,42331,30
58937799550,58937799545,-5,889,2298,30
58940725229,58940725224,-5,570,3077,30
58954112301,58954112298,-3,1979,2656,30
58955099674,58955099670,-4,917,3182,30
58955436656,58955436676,20,814,2182,30
58958053766,58958053761,-5,686,2824,30
58959936637,58959936633,-4,1227,3882,30
58962016725,58962016731,6,2926,1693,30
58964868611,58964868606,-5,717,2987,30
58968552050,58968552051,1,2766,3158,30
58978165441,58978165436,-5,925,2836,30
58978762794,58978762790,-4,765,2655,30
58980816199,58980816196,-3,761,1857,30
58981791183,58981791177,-6,1156,4009,30
58985766541,58985766545,4,1225,2373,30
58986037323,58986037318,-5,1031,2928,30
58988270429,58988270425,-4,1028,2564,30
58994145843,58994145842,-1,1217,2027,30
58995703075,58995703071,-4,841,2494,30
58996674318,58996674314,-4,819,3474,30
59012018318,59012018315,-3,778,2981,30
59016645476,59016645482,6,2527,1046,30
59020680785,59020680782,-3,1639,3626,30
59021974983,59021974981,-2,787,2261,30
59025248817,59025248812,-5,1303,3285,30
59025413001,59025412990,-11,903,2705,30
59029865379,59029865384,5,2112,1921,30
59040736411,59040736408,-3,1341,2578,30
59041634515,59041634510,-5,1262,2050,30
59041773803,59041773807,4,2692,1954,30
59043106722,59043106718,-4,1112,3210,30
59055051852,59055051845,-7,1167,3581,30
59055598795,59055598798,3,1700,1015,30
59061510082,59061510080,-2,844,1398,30
59065913786,59065913786,0,995,1091,30
59069607343,59069607337,-6,1079,4044,30
59071153588,59071153603,15,605,1673,30
59076074764,59076074758,-6,970,2889,30
59076166608,59076166608,0,225,1200,30
59089634815,59089634815,0,1521,1667,30
59091522782,59091522787,5,2345,986,30
59092341295,59092341302,7,3623,1186,30
59092758307,59092758301,-6,1124,4418,30
59093221340,59093221354,14,446,973,30
59102633073,59102633068,-5,1149,3163,30
59104935053,59104935046,-7,1255,3005,30
59106727755,59106727750,-5,824,2264,30
59107725428,59107725423,-5,1107,2877,30
59113106154,59113106151,-3,1610,2277,30
59116700548,59116700545,-3,802,1966,30
59118942390,59118942386,-4,1006,2895,30
59122349923,59122349923,0,1164,1447,30
59133371197,59133371182,-15,296,1166,30
59134089515,59134089510,-5,830,3464,30
59137929175,59137929171,-4,1246,2355,30
59138341500,59138341506,6,2867,1920,30
59138540680,59138540678,-2,1270,3307,30
59140935486,59140935481,-5,1756,4552,30
59143059477,59143059473,-4,677,2343,30
59143473691,59143473687,-4,803,3108,30
59144510994,59144510980,-14,204,4011,30
59145352745,59145352726,-19,920,3486,30
59145625097,59145625105,8,1688,1271,30
59146011664,59146011659,-5,1172,3023,30
59146279405,59146279399,-6,1480,4447,30
59147529437,59147529444,7,5587,1794,30
59152732778,59152732782,4,2473,1865,30
59155651566,59155651559,-7,1561,3350,30
59160038204,59160038200,-4,1047,3397,30
59160207328,59160207343,15,185,691,30
59164479929,59164479924,-5,688,1360,30
59169614993,59169614990,-3,1204,3300,30
59169772556,59169772569,13,925,3407,30
59170514422,59170514418,-4,1248,3050,30
59170852117,59170852112,-5,739,3060,30
59175893740,59175893734,-6,965,4200,30
59176032435,59176032454,19,665,2297,30
59176254520,59176254543,23,316,1420,30
59176453667,59176453653,-14,290,1223,30
59178145979,59178145971,-8,1279,4038,30
59186352920,59186352914,-6,1176,3192,30
59186665773,59186665769,-4,1029,3427,30
59188482677,59188482672,-5,1088,2389,30
59190639595,59190639591,-4,963,2949,30
59195269144,59195269147,3,942,802,30
59199360339,59199360337,-2,835,1746,30
59207058411,59207058418,7,2600,1533,30
59209356891,59209356886,-5,789,3232,30
59234584331,59234584326,-5,511,2077,30
59242677129,59242677123,-6,1074,3241,30
59244332471,59244332469,-2,419,962,30
59245706807,59245706805,-2,1478,2431,30
59248910123,59248910118,-5,823,2213,30
59256399840,59256399822,-18,154,1594,30
59261937484,59261937481,-3,947,2714,30
59262913043,59262913038,-5,538,2207,30
59264109131,59264109127,-4,1068,2623,30
59265289860,59265289854,-6,797,2942,30
59267094968,59267094963,-5,1058,3961,30
59268332325,59268332321,-4,864,2253,30
59274074774,59274074770,-4,1003,2126,30
59276399287,59276399286,-1,1213,1652,30
59287668381,59287668376,-5,1406,4294,30
59287752786,59287752782,-4,951,3057,30
59292150533,59292150529,-4,1018,3013,30
59295332359,59295332354,-5,1078,2906,30
59296429803,59296429818,15,1674,2801,30
59301762601,59301762597,-4,960,2685,30
59306542074,59306542070,-4,1052,1914,30
59308391233,59308391240,7,4618,1923,30
59310969431,59310969425,-6,988,3742,30
59311705421,59311705424,3,2388,2713,30
59313743086,59313743081,-5,935,3164,30
59316879919,59316879914,-5,1193,2900,30
59318396627,59318396622,-5,875,3157,30
59320266174,59320266181,7,2502,1041,30
59322727165,59322727158,-7,823,2043,30
59325936297,59325936290,-7,1089,3030,30
59333461443,59333461438,-5,5670,14155,30
59340369814,59340369810,-4,897,2749,30
59346910619,59346910626,7,3471,1190,30
59350534350,59350534354,4,2800,739,30
59352898711,59352898718,7,10916,2312,30
59354510823,59354510817,-6,798,2339,30
59356778183,59356778183,0,1516,2198,30
59356905232,59356905232,0,1488,2164,30
59363403450,59363403442,-8,423,2987,30
59371324776,59371324769,-7,1791,5701,30
59371393970,59371393990,20,1261,4832,30
59373295099,59373295093,-6,970,3497,30
59373678640,59373678635,-5,55,339,30
59376304691,59376304688,-3,797,2233,30
59379226521,59379226541,20,882,2131,30
59379377668,59379377683,15,697,2412,30
59382373363,59382373359,-4,1215,3152,30
59389429803,59389429798,-5,895,3378,30
59392757510,59392757506,-4,1119,2091,30
59395928499,59395928494,-5,725,1914,30
59396981584,59396981578,-6,1143,2188,30
59403045478,59403045474,-4,1255,2862,30
59406011168,59406011159,-9,17415,27031,30
59410774578,59410774573,-5,988,2728,30
59415524803,59415524798,-5,890,2085,30
59417938040,59417938035,-5,797,2176,30
59418107777,59418107774,-3,983,3101,30
59423333083,59423333078,-5,1333,3188,30
59424915186,59424915181,-5,1046,2843,30
59427902977,59427902986,9,102,825,30
59430311637,59430311639,2,1415,1924,30
59431730833,59431730828,-5,1398,3058,30
59435640409,59435640428,19,569,1836,30
59438090354,59438090350,-4,1099,3173,30
59440272591,59440272586,-5,829,2985,30
59448456247,59448456250,3,2129,1593,30
59452072626,59452072621,-5,836,2372,30
59452473736,59452473755,19,721,1476,30
59462836948,59462836943,-5,800,2378,30
59466397613,59466397609,-4,1274,3075,30
59468202623,59468202618,-5,949,2954,30
59478006727,59478006722,-5,947,3182,30
59482124629,59482124625,-4,909,2669,30
59482268391,59482268387,-4,994,2499,30
59484658711,59484658704,-7,781,2767,30
59485129614,59485129610,-4,917,2177,30
59486260855,59486260856,1,1303,1423,30
59491172301,59491172299,-2,1445,2440,30
59493084418,59493084413,-5,840,2146,30
59493521371,59493521370,-1,24637,2419,30
59495514819,59495514814,-5,985,2703,30
59496814025,59496814020,-5,1098,2867,30
59499747990,59499747985,-5,1180,2522,30
59501079300,59501079294,-6,812,2245,30
59502842564,59502842560,-4,751,2763,30
59503666122,59503666142,20,1100,3444,30
59504810434,59504810430,-4,1297,2035,30
59505230070,59505230066,-4,1072,3181,30
59507736854,59507736855,1,1244,1047,30
59513435725,59513435722,-3,1004,2511,30
59515425069,59515425066,-3,1065,3026,30
59515527194,59515527189,-5,1178,2615,30
59515710001,59515710002,1,249,1188,30
59516191719,59516191714,-5,1168,3323,30
59516838084,59516838078,-6,1359,3409,30
59518904996,59518904994,-2,1226,2298,30
59520963592,59520963577,-15,869,3232,30
59521510514,59521510520,6,62441,30133,30
59525314296,59525314300,4,1137,994,30
59529825181,59529825178,-3,1995,7340,30
59530069015,59530069011,-4,1125,2556,30
59532604782,59532604774,-8,1281,3021,30
59532897409,59532897412,3,172,940,30
59534088658,59534088653,-5,819,3122,30
59537302573,59537302569,-4,849,1401,30
59537876214,59537876210,-4,1496,4058,30
59542576449,59542576442,-7,1030,2890,30
59544604113,59544604109,-4,1128,1738,30
59548826645,59548826640,-5,1322,3493,30
59549755775,59549755770,-5,1010,3053,30
59550646805,59550646802,-3,868,2072,30
59550936985,59550937001,16,720,1881,30
59556754757,59556754754,-3,2725,5315,30
59567129041,59567129037,-4,1221,2715,30
59567270518,59567270524,6,2565,1375,30
59572437739,59572437742,3,1801,1617,30
59578604426,59578604423,-3,1201,2359,30
59579319148,59579319142,-6,1300,4057,30
59581570367,59581570354,-13,208,1074,30
59582131987,59582132007,20,386,1358,30
59586091662,59586091659,-3,1089,2732,30
59587526477,59587526472,-5,1218,3787,30
59594594337,59594594344,7,15308,17569,30
59597372128,59597372122,-6,952,2417,30
59601717259,59601717260,1,11423,12962,30
59610903801,59610903802,1,1174,1385,30
59623469674,59623469670,-4,938,2021,30
59627496794,59627496790,-4,1398,2546,30
59635286458,59635286454,-4,925,2351,30
59637247638,59637247637,-1,40370,33019,30
59638104947,59638104942,-5,1165,4442,30
59639427839,59639427834,-5,984,2314,30
59641348450,59641348451,1,1313,1564,30
59641926897,59641926893,-4,951,3208,30
59646895755,59646895750,-5,995,3379,30
59649847981,59649847978,-3,1368,2049,30
59650818333,59650818336,3,1658,1996,30
59651272491,59651272509,18,524,1383,30
59652859766,59652859761,-5,1133,2572,30
59654809137,59654809133,-4,1552,2790,30
59655841898,59655841894,-4,1428,3112,30
59657599115,59657599113,-2,1325,2530,30
59660447826,59660447821,-5,864,2926,30
59660963651,59660963649,-2,1198,2632,30
59666076867,59666076863,-4,1001,3276,30
59670108089,59670108085,-4,1089,4004,30
59674805700,59674805696,-4,934,2641,30
59676160146,59676160142,-4,919,2543,30
59678759706,59678759702,-4,798,3044,30
59679911734,59679911731,-3,1234,2207,30
59681791618,59681791625,7,4519,1839,30
59688461195,59688461192,-3,1106,2830,30
59689262226,59689262221,-5,1040,2753,30
59693447118,59693447114,-4,880,2342,30
59696173433,59696173428,-5,1031,2348,30
59697743631,59697743626,-5,727,2239,30
59700165202,59700165198,-4,784,1686,30
59700210842,59700210834,-8,841,3326,30
59701740670,59701740666,-4,954,2762,30
59708618243,59708618249,6,4945,1643,30
59711134400,59711134394,-6,865,3094,30
59713494831,59713494829,-2,891,2382,30
59713811747,59713811750,3,269,837,30
59714779706,59714779702,-4,1387,3052,30
59715800689,59715800672,-17,71,1023,30
59716874426,59716874444,18,941,3060,30
59719538853,59719538846,-7,1002,2941,30
59721437578,59721437573,-5,1269,3553,30
59723745576,59723745570,-6,2466,9816,30
59738156076,59738156073,-3,1418,2958,30
59746212950,59746212945,-5,1111,3925,30
59746963162,59746963157,-5,1080,3174,30
59749950951,59749950954,3,1183,1054,30
59754740346,59754740340,-6,1074,2787,30
59757842029,59757842025,-4,1030,2779,30
59758308944,59758308966,22,333,1730,30
59762803496,59762803492,-4,1317,2786,30
59771069122,59771069119,-3,705,2806,30
59771161495,59771161489,-6,884,2236,30
59779605521,59779605517,-4,828,2486,30
59780511766,59780511761,-5,543,1705,30
59781661857,59781661853,-4,1371,1979,30
59785850831,59785850828,-3,1227,2714,30
59788617794,59788617798,4,3561,1615,30
59790305231,59790305226,-5,804,2097,30
59792260048,59792260071,23,222,1060,30
59799273614,59799273613,-1,6305,11357,30
59799596699,59799596696,-3,1055,2276,30
59800123281,59800123297,16,1043,3309,30
59800691355,59800691346,-9,774,3138,30
59801409507,59801409494,-13,1177,2145,30
59804144970,59804144966,-4,1062,2416,30
59805780266,59805780258,-8,804,1438,30
59806834467,59806834451,-16,314,1255,30
59815653058,59815653053,-5,1310,3310,30
59817669893,59817669888,-5,1117,3353,30
59824973889,59824973886,-3,767,2313,30
59825235190,59825235186,-4,1177,2594,30
59827017529,59827017528,-1,756,1488,30
59829384104,59829384100,-4,1175,2903,30
59830876555,59830876556,1,134,880,30
59837357714,59837357709,-5,661,2449,30
59837804232,59837804219,-13,187,1090,30
59838999546,59838999542,-4,1614,3160,30
59839805572,59839805579,7,3348,1840,30
59839912290,59839912289,-1,2016,3964,30
59840459817,59840459812,-5,1663,3740,30
59840829215,59840829210,-5,943,3750,30
59851080317,59851080313,-4,1441,2389,30
59852512707,59852512721,14,758,1950,30
59853449699,59853449693,-6,1171,3033,30
59855360861,59855360857,-4,848,3042,30
59863471414,59863471409,-5,1007,2711,30
59866697722,59866697725,3,2314,3835,30
59869259051,59869259046,-5,750,2735,30
59875069119,59875069115,-4,1539,3915,30
59875453342,59875453338,-4,1215,2716,30
59876638030,59876638031,1,1228,1613,30
59881469870,59881469867,-3,815,2545,30
59881543811,59881543805,-6,691,1748,30
59885061933,59885061930,-3,1139,2920,30
59888011442,59888011442,0,1235,1605,30
59888970167,59888970162,-5,820,2740,30
59890916438,59890916445,7,2367,1603,30
59894543410,59894543405,-5,822,2646,30
59897586824,59897586820,-4,844,3184,30
59900746958,59900746954,-4,1032,2656,30
59901347987,59901347985,-2,309,1178,30
59902668962,59902668958,-4,1126,3059,30
59902865602,59902865597,-5,992,3310,30
59902972858,59902972850,-8,151,1171,30
59909124667,59909124665,-2,1903,2264,30
59909592258,59909592261,3,4622,3881,30
59911934142,59911934138,-4,948,3704,30
59912161874,59912161892,18,539,2402,30
59917919658,59917919669,11,213,1248,30
59929803158,59929803154,-4,1290,2938,30
59931249186,59931249192,6,3565,1425,30
59933469930,59933469924,-6,1495,4032,30
59937240326,59937240341,15,734,1908,30
59938076775,59938076770,-5,634,2871,30
59940388881,59940388878,-3,1196,2533,30
59940642252,59940642247,-5,1037,2922,30
59943372898,59943372894,-4,898,2315,30
59943512449,59943512447,-2,1140,3036,30
59949077002,59949076998,-4,1244,3341,30
59953315535,59953315529,-6,1060,3187,30
59956646219,59956646215,-4,1215,3640,30
59964483053,59964483048,-5,1326,2935,30
59972279733,59972279729,-4,1382,2575,30
59973481171,59973481166,-5,770,2606,30
59974201099,59974201097,-2,914,2735,30
59974915718,59974915713,-5,1469,1719,30
59975180327,59975180325,-2,1050,2755,30
59979652185,59979652181,-4,1298,2644,30
59982263730,59982263726,-4,1197,2475,30
59982741981,59982741974,-7,1228,4530,30
59984888770,59984888765,-5,1145,2409,30
59989781069,59989781063,-6,1297,4878,30
59992587980,59992587976,-4,1350,2969,30
59994830871,59994830865,-6,743,2873,30
59995822435,59995822430,-5,827,2565,30
59997914398,59997914393,-5,970,2853,30
60000963157,60000963151,-6,624,2378,30
60005937583,60005937579,-4,1046,2849,30
60006281047,60006281042,-5,1119,3378,30
60008275340,60008275335,-5,1962,5709,30
60010834330,60010834326,-4,734,1943,30
60013142163,60013142157,-6,895,2157,30
60013237516,60013237531,15,199,650,30
60016449529,60016449524,-5,1190,2723,30
60018157583,60018157580,-3,879,2610,30
60019307719,60019307714,-5,1443,3541,30
60022942935,60022942930,-5,1026,3406,30
60028229362,60028229359,-3,828,2941,30
60029069720,60029069722,2,321,1215,30
60031162123,60031162121,-2,648,2159,30
60033641054,60033641049,-5,910,3199,30
60033754470,60033754478,8,6925,2630,30
60042913197,60042913193,-4,1183,3468,30
60044765973,60044765968,-5,1469,4508,30
60045679867,60045679863,-4,284,1028,30
60047317677,60047317673,-4,970,2895,30
60048276622,60048276617,-5,549,1989,30
60049507346,60049507361,15,283,1455,30
60051127429,60051127425,-4,1197,2625,30
60056303295,60056303291,-4,849,2379,30
60056419188,60056419202,14,879,2696,30
60062779595,60062779590,-5,1274,2588,30
60063053617,60063053613,-4,1226,2950,30
60063513694,60063513688,-6,1209,2987,30
60072660486,60072660481,-5,1170,3296,30
60073455422,60073455419,-3,1326,2330,30
60083392295,60083392289,-6,871,2169,30
60084323620,60084323621,1,1395,1915,30
60091350423,60091350418,-5,923,3275,30
60091873039,60091873035,-4,1379,2781,30
60091986963,60091986950,-13,1268,2674,30
60097996079,60097996074,-5,722,2492,30
60099513762,60099513777,15,213,816,30
60103659902,60103659897,-5,1154,2505,30
60104768779,60104768775,-4,1509,3631,30
60106869344,60106869342,-2,1131,1951,30
60108319563,60108319558,-5,838,3060,30
60109548707,60109548703,-4,765,3636,30
60116703235,60116703230,-5,1005,2577,30
60117377830,60117377822,-8,973,2893,30
60127691065,60127691060,-5,1274,3575,30
60131617258,60131617252,-6,699,2626,30
60132177551,60132177543,-8,961,3426,30
60132415958,60132415952,-6,1024,3087,30
60135485427,60135485423,-4,1381,3798,30
60137123314,60137123314,0,1281,2400,30
60141158392,60141158386,-6,621,1632,30
60142881626,60142881622,-4,1594,2875,30
60143466913,60143466910,-3,1003,2047,30
60147344470,60147344465,-5,932,3136,30
60150683289,60150683286,-3,809,3017,30
60151551389,60151551382,-7,610,2291,30
60153947714,60153947707,-7,916,2792,30
60155533495,60155533491,-4,1336,1946,30
60156241046,60156241043,-3,1080,2546,30
60158995160,60158995157,-3,1008,3046,30
60159030910,60159030905,-5,872,2456,30
60165593351,60165593347,-4,1463,3664,30
60168656686,60168656681,-5,707,1990,30
60169604165,60169604160,-5,1301,3248,30
60174087908,60174087905,-3,1447,3100,30
60175955215,60175955214,-1,916,2212,30
60176731978,60176731972,-6,1155,2921,30
60179207978,60179207974,-4,536,2383,30
60179436097,60179436078,-19,841,3343,30
60182409314,60182409309,-5,792,2903,30
60182977501,60182977504,3,1417,922,30
60183491009,60183491002,-7,1485,5953,30
60188948542,60188948537,-5,711,2010,30
60198231239,60198231236,-3,785,2066,30
60198555017,60198555020,3,2078,1834,30
60200618202,60200618207,5,2973,2250,30
60204197786,60204197781,-5,975,2236,30
60205433925,60205433923,-2,901,2413,30
60215204866,60215204864,-2,745,1829,30
60220628114,60220628109,-5,859,2856,30
60222185066,60222185045,-21,107,759,30
60225384022,60225384018,-4,1148,2469,30
60225480136,60225480154,18,984,1747,30
60227135078,60227135074,-4,1066,3289,30
60229034799,60229034797,-2,940,1574,30
60233352437,60233352433,-4,721,1845,30
60233567834,60233567823,-11,1151,3899,30
60234785365,60234785361,-4,931,2029,30
60235186187,60235186205,18,1081,3569,30
60236700875,60236700870,-5,946,3586,30
60239445098,60239445093,-5,1138,3173,30
60241164967,60241164962,-5,1289,2756,30
60244761665,60244761673,8,5920,1440,30
60247869943,60247869939,-4,877,2465,30
60251641193,60251641189,-4,898,2766,30
60254586549,60254586546,-3,1023,2099,30
60258933528,60258933522,-6,1008,3728,30
60258967204,60258967222,18,1272,2216,30
60259124982,60259124981,-1,696,2155,30
60265718754,60265718757,3,7796,26549,30
60266186348,60266186328,-20,770,3687,30
60268243964,60268243967,3,1073,1480,30
60271625676,60271625673,-3,1100,2204,30
60272112149,60272112146,-3,973,3052,30
60272303963,60272303961,-2,1003,2825,30
60280477103,60280477098,-5,1201,2908,30
60280647282,60280647301,19,704,3348,30
60283878987,60283878981,-6,858,2144,30
60287467355,60287467352,-3,659,1889,30
60290063537,60290063534,-3,856,3043,30
60294293683,60294293679,-4,1198,2544,30
60294431419,60294431433,14,211,1022,30
60307534270,60307534263,-7,1555,9277,30
60310155355,60310155350,-5,663,3716,30
60310567987,60310567964,-23,213,1322,30
60325022550,60325022545,-5,4661,10592,30
60327311503,60327311503,0,1622,1406,30
60328137867,60328137862,-5,1194,2905,30
60333297723,60333297719,-4,685,1752,30
60338148234,60338148230,-4,1008,3923,30
60342200643,60342200646,3,2119,1191,30
60343745218,60343745214,-4,698,2225,30
60348263849,60348263843,-6,1149,2805,30
60349925978,60349925974,-4,1164,1936,30
60354302395,60354302392,-3,883,2728,30
60355844167,60355844164,-3,605,2662,30
60357644427,60357644426,-1,1256,2664,30
60360532188,60360532184,-4,1025,3016,30
60361572870,60361572865,-5,1495,4347,30
60361650886,60361650882,-4,1700,3069,30
60362195269,60362195270,1,1148,1923,30
60362999313,60362999307,-6,1102,4252,30
60363321130,60363321151,21,772,2812,30
60372169054,60372169058,4,2323,1389,30
60375632486,60375632482,-4,1265,4173,30
60376399523,60376399519,-4,1235,3105,30
60377370906,60377370902,-4,990,2808,30
60380251444,60380251440,-4,1372,2374,30
60393444501,60393444509,8,2888,1327,30
60393513618,60393513613,-5,835,2421,30
60398122775,60398122771,-4,529,1671,30
60398781499,60398781489,-10,361,1717,30
60398925730,60398925739,9,7253,37376,30
60400479600,60400479594,-6,937,3550,30
60401224583,60401224579,-4,639,2322,30
60402115939,60402115933,-6,1150,3302,30
60404103338,60404103337,-1,997,2132,30
60410275154,60410275149,-5,1284,2605,30
60410521994,60410522011,17,429,1187,30
60410731270,60410731267,-3,1034,2844,30
60412568441,60412568437,-4,1129,3389,30
60413380866,60413380881,15,383,1026,30
60415433846,60415433855,9,774,2193,30
60415679019,60415679014,-5,1105,3514,30
60416040498,60416040494,-4,1280,3147,30
60416606711,60416606706,-5,912,2339,30
60418000228,60418000226,-2,2656,4448,30
60419848202,60419848196,-6,977,3453,30
60423081132,60423081124,-8,827,2335,30
60431966986,60431966985,-1,775,2672,30
60432820475,60432820471,-4,938,3020,30
60434529822,60434529817,-5,1086,2534,30
60439663975,60439663969,-6,796,3314,30
60443343191,60443343187,-4,1207,2793,30
60447341523,60447341519,-4,1471,3997,30
60447664562,60447664561,-1,962,1689,30
60452032043,60452032038,-5,1019,2925,30
60459139085,60459139079,-6,1069,2622,30
60459227316,60459227311,-5,1088,2889,30
60459651213,60459651208,-5,824,3975,30
60459747581,60459747577,-4,886,2652,30
60462255319,60462255315,-4,1304,3136,30
60463338305,60463338302,-3,963,2653,30
60463796884,60463796879,-5,1475,3379,30
60464686298,60464686293,-5,697,3143,30
60467402966,60467402962,-4,949,3112,30
60467429003,60467428986,-17,868,4394,30
60468949713,60468949714,1,325,1239,30
60469023084,60469023097,13,641,2173,30
60469684604,60469684622,18,478,1579,30
60474197478,60474197473,-5,1440,3759,30
60475488643,60475488637,-6,935,2618,30
60476085222,60476085219,-3,1444,3603,30
60477175888,60477175884,-4,1455,4031,30
60482536951,60482536944,-7,757,2528,30
60483083163,60483083157,-6,216,1042,30
60483547370,60483547362,-8,151,2030,30
60486438658,60486438654,-4,1169,2971,30
60491295138,60491295132,-6,1215,3329,30
60493246595,60493246590,-5,1336,3330,30
60494734438,60494734432,-6,1333,2494,30
60497020582,60497020587,5,3474,1935,30
60497223377,60497223373,-4,1046,4737,30
60498450767,60498450763,-4,876,2313,30
60498607827,60498607821,-6,881,3894,30
60502659482,60502659478,-4,956,2090,30
60504656939,60504656933,-6,921,2153,30
60505493318,60505493316,-2,7141,11966,30
60506330740,60506330735,-5,1402,3357,30
60516176582,60516176576,-6,1369,4668,30
60518881188,60518881190,2,1324,959,30
60525357509,60525357504,-5,1288,3042,30
60528170847,60528170842,-5,738,3007,30
60543245487,60543245481,-6,1184,2977,30
60544030259,60544030255,-4,1062,3004,30
60548937382,60548937378,-4,1441,3294,30
60551711870,60551711864,-6,1393,3749,30
60553874769,60553874785,16,935,2506,30
60554900951,60554900945,-6,1191,2646,30
60555883647,60555883643,-4,1468,2722,30
60556844294,60556844289,-5,1178,4140,30
60564388863,60564388858,-5,1017,3553,30
60568196993,60568196989,-4,1215,2899,30
60569070103,60569070099,-4,910,2981,30
60569239822,60569239832,10,14602,35848,30
60571767085,60571767080,-5,1143,2592,30
60573318035,60573318033,-2,1213,2349,30
60576500109,60576500102,-7,821,2819,30
60577441182,60577441189,7,69959,26075,30
60579443455,60579443451,-4,1143,4318,30
60581332170,60581332167,-3,834,2555,30
60582971169,60582971164,-5,1197,3426,30
60589465039,60589465034,-5,1366,2679,30
60592550723,60592550718,-5,924,3379,30
60593733226,60593733239,13,246,1840,30
60593810392,60593810410,18,1269,3256,30
60594632871,60594632866,-5,575,3484,30
60596743583,60596743583,0,2174,2257,30
60600825023,60600825021,-2,850,1772,30
60619399090,60619399084,-6,931,4206,30
60634738654,60634738649,-5,1057,3768,30
60638292565,60638292585,20,697,2805,30
60639933136,60639933136,0,988,894,30
60645400730,60645400726,-4,952,3203,30
60648946442,60648946438,-4,877,2672,30
60650548022,60650548018,-4,986,3487,30
60652315604,60652315611,7,545,1319,30
60655046719,60655046718,-1,1460,1985,30
60656281822,60656281822,0,1247,1599,30
60656982554,60656982557,3,1841,1644,30
60660714791,60660714786,-5,1098,2575,30
60661901529,60661901524,-5,1507,3315,30
60670656266,60670656262,-4,740,1181,30
60671522212,60671522231,19,1285,2603,30
60672131823,60672131819,-4,927,2442,30
60672939062,60672939058,-4,1125,3454,30
60674579868,60674579863,-5,1223,2730,30
60679314567,60679314565,-2,1152,1522,30
60679614442,60679614457,15,488,1546,30
60679644682,60679644689,7,5370,2018,30
60686800530,60686800530,0,1561,1881,30
60687235410,60687235406,-4,876,2231,30
60690032825,60690032821,-4,1512,3723,30
60690129959,60690129954,-5,1064,3059,30
60696749314,60696749314,0,1093,1519,30
60697543452,60697543466,14,1045,2278,30
60698091305,60698091302,-3,1138,3699,30
60699654426,60699654421,-5,767,2464,30
60703531418,60703531414,-4,593,2479,30
60705315649,60705315642,-7,1397,10696,30
60710133858,60710133854,-4,1007,2664,30
60715144214,60715144209,-5,1334,3190,30
60715490629,60715490634,5,3607,2189,30
60716262174,60716262178,4,2618,1084,30
60717872214,60717872210,-4,797,2908,30
60717937275,60717937269,-6,582,1090,30
60719754627,60719754622,-5,1117,2577,30
60732738933,60732738926,-7,28387,11642,30
60734545142,60734545138,-4,956,2344,30
60734709324,60734709342,18,625,2366,30
60735494995,60735494992,-3,278,1136,30
60737751398,60737751394,-4,1075,2801,30
60742587041,60742587037,-4,1087,2409,30
60743656681,60743656685,4,1423,1248,30
60744875203,60744875198,-5,885,2414,30
60746671195,60746671187,-8,984,3196,30
60747465453,60747465449,-4,1329,3466,30
60751192649,60751192656,7,5099,1070,30
60757260159,60757260154,-5,1220,3684,30
60757492565,60757492561,-4,1277,2976,30
60774023505,60774023500,-5,1119,3698,30
60778321782,60778321790,8,3598,1100,30
60788579338,60788579337,-1,1248,950,30
60790021211,60790021205,-6,1540,3129,30
60791947330,60791947325,-5,1138,3213,30
60792022523,60792022526,3,203,1078,30
60793744352,60793744349,-3,1025,2629,30
60795042550,60795042545,-5,1346,3996,30
60795859593,60795859589,-4,1001,2043,30
60796004469,60796004462,-7,1262,5116,30
60797899656,60797899651,-5,814,2464,30
60805885690,60805885683,-7,989,3932,30
60809365025,60809365022,-3,880,1665,30
60810232389,60810232385,-4,889,3073,30
60813309895,60813309890,-5,1354,2707,30
60814016806,60814016809,3,7326,28069,30
60814487862,60814487858,-4,1299,3001,30
60820509842,60820509837,-5,768,2214,30
60825398122,60825398116,-6,1336,2686,30
60826111715,60826111692,-23,863,2841,30
60836972738,60836972734,-4,1108,3099,30
60839572737,60839572734,-3,1149,2529,30
60839816471,60839816468,-3,741,2201,30
60846536819,60846536813,-6,920,3439,30
60846992665,60846992662,-3,794,3141,30
60847194953,60847194949,-4,1462,3780,30
60849282860,60849282855,-5,1138,1773,30
60849356562,60849356553,-9,1189,2845,30
60850917221,60850917214,-7,744,4110,30
60851133722,60851133705,-17,1141,2283,30
60851168736,60851168747,11,45,1476,30
60852757822,60852757817,-5,1351,3775,30
60853047875,60853047871,-4,1078,3132,30
60853231306,60853231303,-3,1284,3353,30
60854292802,60854292822,20,754,2368,30
60855070109,60855070103,-6,827,3110,30
60855498101,60855498094,-7,1314,2672,30
60864714167,60864714162,-5,1112,3387,30
60869054646,60869054639,-7,1198,3342,30
60869204811,60869204831,20,978,2727,30
60873556692,60873556686,-6,1104,2682,30
60881285225,60881285219,-6,1029,2665,30
60882650621,60882650626,5,2750,1723,30
60887337915,60887337910,-5,1188,2743,30
60888547914,60888547909,-5,1076,2780,30
60890527626,60890527619,-7,1232,3369,30
60890964834,60890964824,-10,1117,3043,30
60894436105,60894436100,-5,1196,3598,30
60902875669,60902875674,5,2465,1410,30
60904543477,60904543478,1,2157,2182,30
60907107254,60907107250,-4,737,1937,30
60910082789,60910082782,-7,1138,2950,30
60910369318,60910369321,3,2567,1428,30
60910835750,60910835746,-4,1212,2930,30
60914264743,60914264741,-2,679,2025,30
60925145995,60925145991,-4,1047,2317,30
60927940419,60927940416,-3,1179,2492,30
60928550106,60928550106,0,998,2250,30
60936847482,60936847481,-1,1052,2426,30
60937394204,60937394201,-3,827,2148,30
60938181063,60938181059,-4,758,2347,30
60951103324,60951103320,-4,37550,29922,30
60951928207,60951928208,1,2157,3039,30
60952514695,60952514690,-5,970,3575,30
60952809098,60952809117,19,505,1454,30
60953624558,60953624565,7,7532,3286,30
60954805457,60954805453,-4,877,2666,30
60969215235,60969215230,-5,1525,3050,30
60973801079,60973801075,-4,1405,2939,30
60975679234,60975679230,-4,1107,2780,30
60985449690,60985449687,-3,863,2419,30
60992471218,60992471214,-4,1020,3045,30
60997770441,60997770448,7,22174,21397,30
60997878947,60997878943,-4,1350,3323,30
60999086813,60999086809,-4,1063,3033,30
60999782883,60999782870,-13,340,742,30
61000588290,61000588294,4,2159,1832,30
61005327303,61005327300,-3,1272,2552,30
61007120847,61007120841,-6,888,3712,30
61008218371,61008218366,-5,1237,2686,30
61009364709,61009364702,-7,1177,3445,30
61009917066,61009917085,19,621,1762,30
61012071897,61012071891,-6,1162,3462,30
61012386242,61012386237,-5,940,2424,30
61015607994,61015607992,-2,1150,2884,30
61017462418,61017462413,-5,1071,2770,30
61020650907,61020650903,-4,1541,2768,30
61021283413,61021283406,-7,1242,3452,30
61023336135,61023336129,-6,1110,2782,30
61025909827,61025909824,-3,1496,3708,30
61026970463,61026970467,4,1696,1326,30
61028707623,61028707616,-7,969,2745,30
61029238826,61029238821,-5,1121,2757,30
61036581233,61036581229,-4,797,2757,30
61036879879,61036879874,-5,1247,2826,30
61040549583,61040549580,-3,660,1960,30
61046198150,61046198171,21,382,1358,30
61046674389,61046674386,-3,1322,2956,30
61049307719,61049307714,-5,693,3088,30
61051033062,61051033057,-5,911,1821,30
61051691483,61051691478,-5,1232,3126,30
61056552865,61056552861,-4,1484,3565,30
61056632408,61056632401,-7,1054,1828,30
61064847320,61064847327,7,3338,1322,30
61064895620,61064895614,-6,938,2814,30
61065725253,61065725250,-3,1327,3337,30
61067602675,61067602672,-3,694,2289,30
61068425323,61068425342,19,370,1470,30
61071668307,61071668302,-5,841,3229,30
61073173390,61073173393,3,1682,1684,30
61073736120,61073736116,-4,906,2741,30
61075814819,61075814814,-5,793,3218,30
61080262110,61080262105,-5,1327,3090,30
61083116978,61083116973,-5,667,2766,30
61091798671,61091798668,-3,19120,18308,30
61092684682,61092684677,-5,1436,3089,30
61098802146,61098802154,8,1820,1261,30
61099295561,61099295557,-4,1211,3071,30
61101347767,61101347766,-1,44905,38165,30
61101752846,61101752842,-4,796,2216,30
61105820780,61105820775,-5,1079,2751,30
61107060305,61107060302,-3,1066,2502,30
61108937158,61108937155,-3,2146,3484,30
61110442650,61110442643,-7,1091,3002,30
61120094431,61120094425,-6,1572,4434,30
61120524433,61120524413,-20,1014,2390,30
61126179462,61126179458,-4,1109,2761,30
61130990346,61130990341,-5,894,2499,30
61136300603,61136300597,-6,1422,3276,30
61137789670,61137789668,-2,731,2600,30
61140084917,61140084912,-5,1075,2857,30
61140648552,61140648571,19,232,1313,30
61141808420,61141808417,-3,627,2116,30
61149462333,61149462329,-4,1231,3766,30
61153107866,61153107868,2,3011,2380,30
61154660943,61154660938,-5,1188,3815,30
61156781138,61156781134,-4,1128,2747,30
61168958522,61168958517,-5,1208,3387,30
61170106639,61170106635,-4,1333,3544,30
61172011915,61172011910,-5,840,2452,30
61172098203,61172098200,-3,1341,2834,30
61172941682,61172941697,15,748,2886,30
61188104374,61188104370,-4,1037,2522,30
61189936119,61189936138,19,27840,19859,30
61190963198,61190963198,0,1723,1474,30
61191592809,61191592804,-5,1100,2830,30
61194030352,61194030346,-6,988,3659,30
61194497550,61194497546,-4,1238,2575,30
61194646381,61194646398,17,2245,1483,30
61201247891,61201247885,-6,1095,3390,30
61210864704,61210864700,-4,1605,2750,30
61219070451,61219070447,-4,960,2158,30
61219732250,61219732243,-7,1181,3288,30
61231313135,61231313132,-3,941,2191,30
61240760830,61240760828,-2,817,1989,30
61243657331,61243657326,-5,485,1285,30
61245406247,61245406245,-2,913,1841,30
61246023097,61246023098,1,1699,1634,30
61254264184,61254264179,-5,930,3869,30
61256949598,61256949595,-3,1280,2801,30
61257928026,61257928020,-6,590,1780,30
61259358689,61259358711,22,1288,2526,30
61260436230,61260436224,-6,1078,3451,30
61262358659,61262358656,-3,861,1879,30
61262756560,61262756567,7,2651,1464,30
61275866881,61275866875,-6,1231,2939,30
61277209428,61277209425,-3,907,1941,30
61277802011,61277802005,-6,728,2957,30
61278329602,61278329621,19,956,3385,30
61279867294,61279867289,-5,717,2047,30
61282068595,61282068576,-19,1031,3285,30
61282943416,61282943398,-18,676,2077,30
61287346667,61287346662,-5,1033,4126,30
61288014538,61288014533,-5,22385,13060,30
61294319332,61294319331,-1,1341,2750,30
61297118201,61297118196,-5,1137,2577,30
61298177790,61298177785,-5,880,4288,30
61301570704,61301570698,-6,847,3483,30
61302455006,61302455011,5,7337,18562,30
61304989012,61304989008,-4,1193,2399,30
61310357453,61310357475,22,664,3230,30
61310750302,61310750297,-5,1079,2945,30
61317145882,61317145875,-7,1030,3154,30
61317292235,61317292231,-4,806,3011,30
61320047537,61320047534,-3,1222,3991,30
61320353419,61320353412,-7,484,1519,30
61321085350,61321085345,-5,1323,2635,30
61323187682,61323187677,-5,1097,2235,30
61325211973,61325211966,-7,361,1217,30
61325883274,61325883270,-4,879,2681,30
61327761644,61327761638,-6,575,1430,30
61328719843,61328719862,19,449,1102,30
61329565047,61329565043,-4,962,2367,30
61332179990,61332179985,-5,1163,2386,30
61333969853,61333969851,-2,978,3469,30
61335920271,61335920269,-2,964,2238,30
61339587183,61339587178,-5,690,1770,30
61342309828,61342309830,2,1473,1423,30
61346551521,61346551540,19,3100,178,30
61350384258,61350384274,16,219,742,30
61351754649,61351754639,-10,206,948,30
61355088395,61355088390,-5,1223,3076,30
61370253014,61370253010,-4,854,2507,30
61371245194,61371245194,0,769,981,30
61372572674,61372572668,-6,1250,3730,30
61373001960,61373001978,18,268,1018,30
61373629422,61373629417,-5,914,2730,30
61378672398,61378672394,-4,865,2667,30
61381368093,61381368089,-4,1456,3290,30
61382900665,61382900659,-6,1210,10230,30
61383609507,61383609501,-6,914,3148,30
61384228363,61384228358,-5,1047,2844,30
61388739179,61388739171,-8,1090,3473,30
61388924870,61388924871,1,1289,2095,30
61389209820,61389209834,14,305,846,30
61396360715,61396360713,-2,998,2809,30
61398899766,61398899772,6,2272,1389,30
61401377293,61401377292,-1,1099,1497,30
61402887367,61402887361,-6,1190,2431,30
61404414458,61404414472,14,273,678,30
61416673377,61416673374,-3,1195,2748,30
61416717034,61416717014,-20,816,2397,30
61416897008,61416897029,21,551,1589,30
61418356730,61418356725,-5,1211,2492,30
61419454886,61419454882,-4,1255,3692,30
61422933522,61422933518,-4,826,2492,30
61425395718,61425395714,-4,1145,4237,30
61432149569,61432149567,-2,913,2764,30
61432234219,61432234238,19,217,2105,30
61433659846,61433659842,-4,1253,3360,30
61433900879,61433900873,-6,1092,2367,30
61435246074,61435246074,0,1357,2255,30
61435383619,61435383622,3,16,808,30
61444653026,61444653020,-6,1123,2476,30
61455904726,61455904723,-3,787,1618,30
61458905290,61458905286,-4,1197,3083,30
61459401674,61459401670,-4,1132,2931,30
61459531462,61459531461,-1,1737,2281,30
61460143054,61460143059,5,3246,1959,30
61466503283,61466503279,-4,1182,3571,30
61467262908,61467262925,17,692,2159,30
61474773120,61474773118,-2,1206,1609,30
61478806841,61478806836,-5,1232,4511,30
61485879203,61485879208,5,1698,1042,30
61488132886,61488132882,-4,926,3041,30
61493286419,61493286413,-6,1033,2536,30
61494922222,61494922217,-5,883,2409,30
61495498628,61495498639,11,265,1253,30
61501102462,61501102458,-4,1043,2571,30
61503244223,61503244218,-5,515,2394,30
61508202474,61508202470,-4,1102,2698,30
61508611674,61508611670,-4,1286,3118,30
61515642406,61515642402,-4,981,3030,30
61516818281,61516818297,16,925,2221,30
61518107870,61518107869,-1,28713,69372,30
61523625377,61523625375,-2,653,1682,30
61526292429,61526292426,-3,859,2485,30
61527123475,61527123493,18,621,2227,30
61527220324,61527220321,-3,1043,2395,30
61533409618,61533409621,3,37075,31301,30
61534779234,61534779237,3,1607,1471,30
61535360149,61535360145,-4,1332,3198,30
61536428250,61536428254,4,2845,1850,30
61537984186,61537984165,-21,872,3717,30
61538289347,61538289350,3,371,1378,30
61538607705,61538607701,-4,1201,1674,30
61539759460,61539759463,3,3882,3768,30
61541094048,61541094043,-5,1235,3196,30
61543074054,61543074050,-4,1091,2338,30
61547147710,61547147705,-5,869,2306,30
61548255356,61548255354,-2,1404,3412,30
61548957954,61548957933,-21,40,1364,30
61552324843,61552324837,-6,970,3208,30
61554684763,61554684760,-3,575,2410,30
61562087790,61562087786,-4,869,1787,30
61563093639,61563093634,-5,1328,4092,30
61566650073,61566650068,-5,1004,3195,30
61568110201,61568110198,-3,1342,3510,30
61568170177,61568170156,-21,491,818,30
61574030241,61574030246,5,2237,1421,30
61574903874,61574903869,-5,1166,2556,30
61575223532,61575223547,15,790,3176,30
61579340842,61579340842,0,1380,1950,30
61582405438,61582405443,5,2379,1096,30
61586234218,61586234223,5,3159,1145,30
61591795966,61591795961,-5,1543,4262,30
61593028710,61593028711,1,2586,2996,30
61593334774,61593334767,-7,931,2663,30
61595938742,61595938737,-5,1055,3073,30
61599939863,61599939858,-5,1400,3124,30
61606565751,61606565746,-5,668,1664,30
61607903702,61607903703,1,1778,2448,30
61615269558,61615269554,-4,731,2816,30
61615661644,61615661657,13,1044,3501,30
61619202258,61619202251,-7,1164,2507,30
61619471620,61619471617,-3,1001,2845,30
61620030456,61620030445,-11,179,546,30
61620176356,61620176353,-3,1393,2201,30
61626249815,61626249812,-3,576,2515,30
61629273590,61629273585,-5,736,2026,30
61630536601,61630536596,-5,1292,4043,30
61638030801,61638030800,-1,2310,2521,30
61647560084,61647560079,-5,1932,2915,30
61652492598,61652492593,-5,604,2502,30
61657975786,61657975806,20,454,1185,30
61658391754,61658391748,-6,1009,3083,30
61660342266,61660342261,-5,1510,2556,30
61661388115,61661388123,8,2630,2015,30
61664941151,61664941153,2,1752,1300,30
61672258003,61672258005,2,1477,1735,30
61672381737,61672381734,-3,1087,2571,30
61676181290,61676181290,0,990,1714,30
61682748224,61682748219,-5,593,2481,30
61684640426,61684640419,-7,908,3004,30
61691760623,61691760619,-4,1254,2921,30
61694416566,61694416562,-4,1495,3862,30
61701747933,61701747928,-5,749,2540,30
61708016917,61708016914,-3,1191,1689,30
61714179710,61714179706,-4,958,2719,30
61717560861,61717560857,-4,1240,3232,30
61726394990,61726394985,-5,1117,3345,30
61727611283,61727611299,16,397,913,30
61733938886,61733938882,-4,1174,2590,30
61737475978,61737475973,-5,1080,2424,30
61748660666,61748660662,-4,1133,3197,30
61748757600,61748757594,-6,1006,3250,30
61750249744,61750249738,-6,1349,3966,30
61753194680,61753194682,2,1110,1082,30
61753365802,61753365799,-3,797,1949,30
61753567597,61753567593,-4,830,3115,30
61754427273,61754427267,-6,1245,1856,30
61755045498,61755045508,10,12597,50945,30
61757681634,61757681629,-5,829,2626,30
61758440297,61758440313,16,1000,2718,30
61768227407,61768227401,-6,1214,4478,30
61768722160,61768722141,-19,69,1012,30
61771155327,61771155325,-2,1662,2873,30
61771539545,61771539540,-5,1338,3763,30
61779850214,61779850220,6,14271,21721,30
61784336914,61784336909,-5,1268,4256,30
61785673782,61785673779,-3,841,3105,30
61790842170,61790842167,-3,1182,1659,30
61792116215,61792116211,-4,1106,3505,30
61792974521,61792974519,-2,1456,4106,30
61798933430,61798933434,4,1557,1586,30
61805552298,61805552293,-5,1478,2728,30
61821015744,61821015740,-4,929,1716,30
61823127710,61823127706,-4,1071,2348,30
61829221023,61829221017,-6,1019,2856,30
61830864562,61830864558,-4,1079,2581,30
61833952086,61833952082,-4,1016,2226,30
61835813423,61835813418,-5,1207,4502,30
61839106629,61839106624,-5,723,1865,30
61841250894,61841250890,-4,1128,2467,30
61848494670,61848494654,-16,1011,2977,30
61852478474,61852478471,-3,974,3227,30
61854204660,61854204677,17,413,778,30
61855973599,61855973597,-2,1164,2921,30
61856769759,61856769754,-5,882,3806,30
61867776264,61867776267,3,2137,1498,30
61868216711,61868216707,-4,795,1723,30
61869134966,61869134960,-6,710,3423,30
61869553262,61869553256,-6,1752,4540,30
61869816001,61869815997,-4,783,3008,30
61877480411,61877480406,-5,1308,2576,30
61885166765,61885166760,-5,1113,2872,30
61894999740,61894999734,-6,1624,7875,30
61896100606,61896100602,-4,1110,2142,30
61899379618,61899379625,7,3039,1030,30
61899726941,61899726936,-5,946,2883,30
61900018310,61900018307,-3,654,1787,30
61910345809,61910345814,5,2083,1483,30
61918440498,61918440494,-4,1224,2543,30
61921055291,61921055285,-6,1038,2669,30
61927327262,61927327258,-4,827,1655,30
61929243347,61929243342,-5,1018,3357,30
61932189031,61932189025,-6,977,2413,30
61933872838,61933872832,-6,906,2730,30
61936492957,61936492951,-6,1224,3559,30
61944172174,61944172170,-4,1472,3201,30
61953093284,61953093279,-5,1623,2975,30
61956105577,61956105578,1,915,1246,30
61958075132,61958075126,-6,567,1315,30
61958846228,61958846222,-6,890,2682,30
61962117701,61962117698,-3,946,3145,30
61963744885,61963744879,-6,1461,3659,30
61965205237,61965205237,0,3196,4088,30
61968305726,61968305721,-5,1017,4376,30
61969095506,61969095502,-4,1028,3005,30
61969986555,61969986538,-17,239,975,30
61970621978,61970621975,-3,1069,2148,30
61971067278,61971067273,-5,1310,3513,30
61971598571,61971598568,-3,1025,2082,30
61971862929,61971862938,9,300,2149,30
61973487879,61973487874,-5,665,3006,30
61975093102,61975093101,-1,842,2075,30
61976187594,61976187590,-4,1264,3492,30
61978204665,61978204658,-7,2247,8712,30
61985977918,61985977914,-4,1135,4543,30
61990942225,61990942222,-3,660,2277,30
61994933175,61994933171,-4,672,1433,30
61996568323,61996568318,-5,1011,2462,30
61997549353,61997549350,-3,1197,1535,30
62001129303,62001129298,-5,1197,2830,30
62004507687,62004507682,-5,874,2220,30
62005532408,62005532415,7,6352,1120,30
62007408195,62007408188,-7,706,4320,30
62011863869,62011863866,-3,1334,2571,30
62020441302,62020441298,-4,866,4196,30
62023299607,62023299600,-7,1354,2698,30
62023701945,62023701938,-7,1080,2905,30
62025593120,62025593122,2,28,771,30
62027725353,62027725350,-3,1263,2899,30
62032090300,62032090312,12,9993,47060,30
62035621012,62035621008,-4,911,2341,30
62036972290,62036972285,-5,1083,2251,30
62043424093,62043424089,-4,881,1859,30
62053701283,62053701277,-6,1413,2589,30
62053742011,62053742014,3,315,1670,30
62055073793,62055073789,-4,479,2695,30
62058326691,62058326688,-3,791,3797,30
62058886108,62058886106,-2,626,1282,30
62064139775,62064139772,-3,874,1884,30
62068055882,62068055875,-7,722,3345,30
62068870450,62068870445,-5,719,3607,30
62073662774,62073662770,-4,1040,3565,30
62073720058,62073720041,-17,91,945,30
62084513359,62084513354,-5,943,2638,30
62085196555,62085196549,-6,1231,3421,30
62085401772,62085401769,-3,1416,3249,30
62086083610,62086083605,-5,777,2519,30
62086725296,62086725282,-14,1920,1142,30
62087756825,62087756818,-7,1007,4076,30
62091291283,62091291279,-4,1384,3579,30
62096615499,62096615494,-5,1171,3101,30
62097602579,62097602576,-3,650,1681,30
62102077503,62102077499,-4,1226,3038,30
62103028733,62103028728,-5,1234,6132,30
62105765311,62105765305,-6,888,2650,30
62112210945,62112210941,-4,720,2855,30
62116498689,62116498685,-4,1177,2594,30
62117686093,62117686086,-7,1169,2463,30
62119670916,62119670911,-5,549,1853,30
62121306574,62121306571,-3,720,2215,30
62127666666,62127666663,-3,794,2465,30
62132113738,62132113733,-5,1446,2766,30
62135250550,62135250545,-5,1298,2828,30
62139852086,62139852082,-4,869,2343,30
62142884342,62142884334,-8,1308,3875,30
62147909399,62147909394,-5,1274,3918,30
62149768533,62149768534,1,15788,17230,30
62154495135,62154495130,-5,952,2820,30
62158573071,62158573062,-9,1107,2166,30
62167175078,62167175073,-5,958,3716,30
62169011254,62169011258,4,1923,1442,30
62170967319,62170967317,-2,1444,3808,30
62171457802,62171457797,-5,1575,2268,30
62174813507,62174813497,-10,36866,12779,30
62176207485,62176207485,0,1304,1780,30
62176771782,62176771778,-4,1017,3623,30
62177572138,62177572133,-5,1086,1667,30
62178915511,62178915508,-3,712,3416,30
62179993287,62179993283,-4,1230,3401,30
62180845046,62180845039,-7,1088,2601,30
62187442733,62187442730,-3,1644,3368,30
62188594050,62188594046,-4,1177,2387,30
62192135486,62192135480,-6,1008,2842,30
62192659379,62192659395,16,233,763,30
62197677889,62197677884,-5,1213,2208,30
62199340878,62199340874,-4,1130,3032,30
62203679957,62203679953,-4,1279,2970,30
62204640364,62204640382,18,719,2630,30
62208185891,62208185886,-5,812,3108,30
62213132339,62213132334,-5,536,1408,30
62213921362,62213921361,-1,232,906,30
62215174471,62215174469,-2,762,2583,30
62216679698,62216679695,-3,874,2636,30
62217306114,62217306117,3,1450,1407,30
62218990260,62218990261,1,1011,1242,30
62219581020,62219581017,-3,29,1232,30
62221654382,62221654374,-8,1136,3280,30
62227671958,62227671954,-4,1081,2290,30
62232159990,62232159988,-2,1296,2495,30
62232870710,62232870706,-4,1236,3335,30
62232923866,62232923862,-4,1138,2576,30
62236176702,62236176699,-3,1282,2436,30
62236868571,62236868566,-5,1013,2824,30
62244689621,62244689617,-4,887,2604,30
62245979170,62245979166,-4,784,2310,30
62252294207,62252294226,19,1828,600,30
62258559250,62258559246,-4,1153,2329,30
62260340431,62260340426,-5,1033,3111,30
62263518038,62263518033,-5,1184,3270,30
62265918236,62265918231,-5,1093,2473,30
62267921167,62267921162,-5,1135,2698,30
62274882697,62274882694,-3,633,2054,30
62287324866,62287324862,-4,1267,3694,30
62287734714,62287734712,-2,871,2276,30
62294754819,62294754808,-11,1396,2027,30
62298599872,62298599868,-4,1045,2790,30
62302913351,62302913346,-5,1195,3160,30
62303240042,62303240038,-4,561,1820,30
62303332763,62303332751,-12,11733,42202,30
62310374939,62310374934,-5,746,2497,30
62312556649,62312556649,0,1108,2310,30
62312985746,62312985739,-7,230,708,30
62314393307,62314393303,-4,1127,3067,30
62315206922,62315206921,-1,519,2572,30
62316530691,62316530674,-17,235,844,30
62318392071,62318392067,-4,1121,3747,30
62320559053,62320559047,-6,1519,3656,30
62321887403,62321887397,-6,725,3022,30
62330255194,62330255191,-3,843,2345,30
62333958922,62333958923,1,1144,1372,30
62341972451,62341972445,-6,764,3317,30
62342070491,62342070509,18,531,1457,30
62343627106,62343627102,-4,1011,3120,30
62343697889,62343697894,5,5408,2383,30
62346078886,62346078882,-4,817,1173,30
62349983335,62349983330,-5,1463,4135,30
62353576837,62353576839,2,831,1373,30
62354104043,62354104034,-9,1093,2929,30
62355475377,62355475369,-8,663,2133,30
62359669287,62359669282,-5,1098,3020,30
62366027489,62366027485,-4,1137,3369,30
62372173975,62372173969,-6,864,3276,30
62372415809,62372415814,5,2860,1526,30
62372674553,62372674555,2,1702,1191,30
62372810047,62372810041,-6,1156,3995,30
62377149255,62377149250,-5,735,2622,30
62387175907,62387175902,-5,1038,2127,30
62387900708,62387900702,-6,1212,3022,30
62388821418,62388821439,21,575,2744,30
62389430612,62389430609,-3,1157,3538,30
62390987125,62390987122,-3,1548,3164,30
62391809291,62391809309,18,700,1966,30
62397759755,62397759751,-4,1317,3500,30
62397822402,62397822397,-5,1248,2145,30
62400362416,62400362411,-5,1096,2793,30
62405205484,62405205485,1,344,20,30
62406076625,62406076621,-4,926,2625,30
62410161839,62410161834,-5,1011,3149,30
62413187041,62413187034,-7,810,2041,30
62421200034,62421200050,16,1061,2504,30
62423654255,62423654252,-3,1177,3922,30
62426017950,62426017948,-2,1149,1185,30
62426606817,62426606815,-2,1226,1225,30
62433989727,62433989722,-5,1303,2842,30
62435298851,62435298846,-5,1396,4172,30
62436001789,62436001789,0,1141,2008,30
62443141002,62443140997,-5,1274,2645,30
62443320348,62443320344,-4,1198,2368,30
62450742500,62450742496,-4,1189,3025,30
62457144250,62457144246,-4,773,2149,30
62459166330,62459166326,-4,790,1353,30
62459371660,62459371656,-4,1097,3217,30
62462704644,62462704645,1,995,1206,30
62465480573,62465480568,-5,718,2735,30
62466657504,62466657484,-20,1036,3453,30
62473558111,62473558109,-2,2108,5355,30
62479037724,62479037722,-2,1534,2506,30
62480586719,62480586713,-6,849,2162,30
62481142484,62481142502,18,455,1387,30
62481749419,62481749417,-2,1246,3354,30
62483212241,62483212245,4,1202,1278,30
62485532393,62485532388,-5,999,3606,30
62485648962,62485648971,9,111,1060,30
62491386949,62491386943,-6,645,2345,30
62492563069,62492563065,-4,1431,3677,30
62492770326,62492770322,-4,1052,2449,30
62493647594,62493647582,-12,314,835,30
62496378415,62496378410,-5,932,2391,30
62507001602,62507001597,-5,1059,2159,30
62507880035,62507880031,-4,852,2435,30
62510040254,62510040249,-5,1134,2534,30
62512366709,62512366705,-4,861,1696,30
62512647672,62512647656,-16,185,537,30
62522713790,62522713785,-5,1030,2805,30
62525206984,62525206981,-3,925,3139,30
62530190919,62530190914,-5,809,2522,30
62530856074,62530856069,-5,1178,2496,30
62534222789,62534222784,-5,1102,2833,30
62536818901,62536818895,-6,874,3326,30
62540798848,62540798841,-7,1029,3979,30
62541022411,62541022403,-8,1295,2794,30
62541195905,62541195916,11,95,978,30
62544815837,62544815830,-7,1296,3573,30
62545237646,62545237642,-4,1000,2708,30
62549021241,62549021254,13,15307,5230,30
62549582997,62549583001,4,17189,10913,30
62552628637,62552628634,-3,1052,4168,30
62552692934,62552692926,-8,713,2502,30
62555189662,62555189657,-5,835,2257,30
62555267018,62555267013,-5,1225,2585,30
62555982868,62555982864,-4,1113,3365,30
62557739792,62557739786,-6,1044,2958,30
62559166582,62559166578,-4,955,2212,30
62561547322,62561547327,5,2096,1132,30
62565124614,62565124608,-6,1683,7421,30
62566314013,62566314006,-7,686,2066,30
62567014113,62567014115,2,289,1122,30
62578272707,62578272701,-6,1049,2880,30
62579609178,62579609174,-4,1601,3630,30
62580474413,62580474408,-5,1479,3470,30
62582928366,62582928362,-4,1116,2703,30
62583479000,62583478996,-4,1130,3200,30
62583565712,62583565733,21,307,1182,30
62585083291,62585083288,-3,1097,3679,30
62591277860,62591277859,-1,1510,2147,30
62602280298,62602280318,20,885,2222,30
62605821759,62605821755,-4,935,2485,30
62611953559,62611953554,-5,1201,2755,30
62614793165,62614793160,-5,977,3880,30
62622792294,62622792289,-5,843,2842,30
62622932824,62622932819,-5,975,3118,30
62632680523,62632680518,-5,687,1749,30
62634004339,62634004322,-17,1025,2591,30
62634896527,62634896526,-1,517,1442,30
62638367997,62638367992,-5,1323,4330,30
62644003102,62644003091,-11,3641,13411,30
62649669903,62649669900,-3,1206,3269,30
62649990324,62649990311,-13,217,1134,30
62651108835,62651108832,-3,728,1177,30
62652372651,62652372643,-8,717,2579,30
62661870780,62661870774,-6,2148,7347,30
62668827806,62668827813,7,3876,1594,30
62669085323,62669085319,-4,520,1713,30
62669698924,62669698913,-11,824,2471,30
62670601242,62670601249,7,1830,1083,30
62672654559,62672654554,-5,648,2823,30
62678929257,62678929254,-3,1780,3866,30
62679467309,62679467303,-6,566,1393,30
62680328086,62680328082,-4,1119,2421,30
62680393624,62680393643,19,322,1033,30
62687379163,62687379158,-5,845,2190,30
62689597970,62689597962,-8,849,3672,30
62692735871,62692735874,3,1264,1685,30
62694795017,62694795012,-5,887,3231,30
62696950971,62696950966,-5,926,2349,30
62699050702,62699050696,-6,694,2117,30
62706951243,62706951239,-4,1069,2993,30
62709408551,62709408547,-4,1148,3114,30
62711448198,62711448194,-4,1249,3082,30
62717608233,62717608230,-3,686,1243,30
62720422486,62720422482,-4,757,3328,30
62720838618,62720838639,21,451,2947,30
62721371626,62721371622,-4,879,2225,30
62722031326,62722031322,-4,1045,2800,30
62722639470,62722639466,-4,2112,5225,30
62724497427,62724497422,-5,934,2945,30
62726055765,62726055762,-3,1269,3128,30
62726876153,62726876170,17,749,3206,30
62733234324,62733234319,-5,1736,4241,30
62733588249,62733588247,-2,98,999,30
62737939532,62737939527,-5,1412,2515,30
62738146482,62738146477,-5,984,3767,30
62739909423,62739909423,0,1375,1697,30
62744489889,62744489885,-4,820,2397,30
62744588556,62744588566,10,29,807,30
62745169192,62745169184,-8,1221,4048,30
62747368894,62747368890,-4,1179,2376,30
62748461800,62748461806,6,3389,1406,30
62757084401,62757084396,-5,1053,2123,30
62757277794,62757277789,-5,786,1808,30
62761247858,62761247855,-3,879,2414,30
62761894470,62761894469,-1,2157,3881,30
62763963538,62763963533,-5,974,3104,30
62764725605,62764725601,-4,962,3419,30
62765320395,62765320389,-6,89,1112,30
62770008318,62770008314,-4,1334,3025,30
62772527230,62772527226,-4,727,2606,30
62773122749,62773122747,-2,1192,2059,30
62774789422,62774789417,-5,857,2160,30
62778079731,62778079726,-5,1295,2189,30
62780303387,62780303381,-6,616,2320,30
62786885539,62786885535,-4,1080,2462,30
62788043451,62788043454,3,2379,2140,30
62791799075,62791799072,-3,1055,3651,30
62798371281,62798371277,-4,889,2717,30
62798419402,62798419390,-12,214,1039,30
62805419491,62805419486,-5,1178,3126,30
62806376338,62806376334,-4,1334,2773,30
62817082490,62817082494,4,1633,1410,30
62819994750,62819994750,0,1899,1439,30
62823220707,62823220706,-1,1187,1654,30
62825892181,62825892174,-7,1120,2419,30
62826350602,62826350622,20,831,1590,30
62838478387,62838478383,-4,919,2751,30
62841237121,62841237113,-8,199,767,30
62850790977,62850790974,-3,1097,3082,30
62850854950,62850854945,-5,629,2807,30
62851904739,62851904737,-2,1026,2240,30
62853682631,62853682625,-6,1408,5297,30
62857493476,62857493471,-5,1700,3498,30
62863436675,62863436668,-7,1307,4910,30
62864374455,62864374450,-5,514,2533,30
62865507137,62865507143,6,4023,1471,30
62874313795,62874313792,-3,790,2386,30
62876033230,62876033225,-5,1150,2771,30
62885398710,62885398705,-5,1251,3068,30
62892594822,62892594818,-4,1251,2701,30
62894236462,62894236457,-5,972,2408,30
62894593571,62894593569,-2,1102,1522,30
62896058626,62896058625,-1,1115,2477,30
62902451986,62902451983,-3,1229,2115,30
62910086334,62910086330,-4,920,2344,30
62912431191,62912431186,-5,845,1703,30
62926853948,62926853944,-4,997,2484,30
62932728643,62932728639,-4,1188,3374,30
62935843134,62935843129,-5,1027,3184,30
62944469786,62944469782,-4,1252,1989,30
62953510408,62953510402,-6,744,2918,30
62956714759,62956714757,-2,889,2623,30
62964422863,62964422858,-5,1181,2807,30
62969614123,62969614121,-2,876,2195,30
62971104774,62971104774,0,1458,2090,30
62971484762,62971484762,0,1246,1897,30
62972412866,62972412881,15,509,1828,30
62974827450,62974827456,6,3099,1677,30
62978716723,62978716717,-6,1380,4570,30
62980914605,62980914601,-4,777,2385,30
62981646484,62981646503,19,33,799,30
62982342541,62982342535,-6,1057,3046,30
62982941402,62982941383,-19,24847,30540,30
62985068143,62985068138,-5,1557,2321,30
62994057138,62994057136,-2,875,3307,30
62998019833,62998019826,-7,890,2489,30
62998078610,62998078605,-5,278,1319,30
62998416314,62998416313,-1,121,1706,30
63002812753,63002812746,-7,1219,3306,30
63008133111,63008133110,-1,1552,1729,30
63008712854,63008712851,-3,990,2380,30
63011595195,63011595192,-3,492,1696,30
63027974842,63027974838,-4,1659,3931,30
63033180182,63033180177,-5,1271,4126,30
63033334013,63033334009,-4,1191,3101,30
63033802080,63033802061,-19,48,729,30
63034245033,63034245027,-6,1207,4256,30
63038021648,63038021643,-5,901,4714,30
63038571560,63038571549,-11,978,1698,30
63044380230,63044380237,7,7855,3355,30
63049749903,63049749898,-5,609,2141,30
63059753631,63059753630,-1,1205,2185,30
63060484872,63060484866,-6,1199,3243,30
63061046113,63061046113,0,96,912,30
63063035374,63063035371,-3,989,2938,30
63064271894,63064271890,-4,1077,2234,30
63067199033,63067199034,1,1200,1519,30
63069559101,63069559098,-3,1002,3911,30
63069654053,63069654048,-5,1246,2840,30
63072210079,63072210074,-5,842,3097,30
63073290259,63073290254,-5,745,2197,30
63073991553,63073991549,-4,1454,3081,30
63084900409,63084900407,-2,934,1870,30
63086662789,63086662791,2,2009,1461,30
63086746192,63086746187,-5,1190,3030,30
63095714164,63095714168,4,2224,1313,30
63100784618,63100784613,-5,1159,3293,30
63101377406,63101377402,-4,900,3135,30
63105841151,63105841148,-3,1167,1774,30
63115353641,63115353636,-5,1101,4323,30
63118267803,63118267798,-5,1237,2435,30
63119038176,63119038197,21,784,2844,30
63121184349,63121184343,-6,1017,3109,30
63122256127,63122256122,-5,1347,3016,30
63123360711,63123360712,1,1120,2362,30
63133887052,63133887046,-6,1147,3380,30
63134769919,63134769914,-5,1172,2893,30
63137661131,63137661128,-3,958,2859,30
63138243107,63138243116,9,298,824,30
63138853974,63138853972,-2,913,2197,30
63140154273,63140154266,-7,1044,3673,30
63147068054,63147068049,-5,637,1213,30
63152047089,63152047086,-3,946,2521,30
63153461782,63153461781,-1,1333,3298,30
63155255414,63155255411,-3,1229,2092,30
63158622646,63158622644,-2,1358,2089,30
63165321246,63165321245,-1,940,1953,30
63165652726,63165652721,-5,763,3046,30
63165974159,63165974154,-5,1674,3349,30
63166759789,63166759785,-4,837,2709,30
63168246360,63168246377,17,726,1787,30
63176009159,63176009157,-2,635,2429,30
63178292741,63178292735,-6,1633,3431,30
63182604895,63182604890,-5,1445,2671,30
63183990256,63183990250,-6,1421,2899,30
63190130610,63190130610,0,3435,4297,30
63192253907,63192253903,-4,886,2699,30
63195357326,63195357322,-4,1140,4268,30
63200413039,63200413034,-5,1076,2079,30
63209174003,63209173998,-5,720,2555,30
63211954390,63211954396,6,3320,1730,30
63213530839,63213530834,-5,390,2659,30
63217032749,63217032751,2,1969,767,30
63217134071,63217134066,-5,925,3003,30
63217520005,63217520005,0,1824,1931,30
63220077854,63220077850,-4,870,2505,30
63227397180,63227397182,2,1398,1009,30
63227505127,63227505122,-5,1126,3217,30
63227801131,63227801129,-2,1204,2413,30
63229222457,63229222453,-4,1171,2809,30
63230529589,63230529585,-4,511,1217,30
63231272243,63231272247,4,280,714,30
63232952510,63232952506,-4,822,2362,30
63233418990,63233418985,-5,900,3275,30
63235761858,63235761853,-5,713,1649,30
63237086293,63237086298,5,5389,2452,30
63237498904,63237498899,-5,1088,3672,30
63238274544,63238274538,-6,1014,3149,30
63242901802,63242901806,4,5504,2990,30
63244621417,63244621413,-4,1092,2588,30
63245044632,63245044641,9,9986,42987,30
63247126298,63247126294,-4,1350,2047,30
63250960866,63250960861,-5,909,2864,30
63261049206,63261049222,16,599,2930,30
63265691545,63265691541,-4,973,2449,30
63267567794,63267567795,1,1240,1507,30
63270187922,63270187919,-3,1676,2157,30
63271676499,63271676495,-4,1206,3294,30
63271985084,63271985078,-6,1182,3482,30
63273931527,63273931525,-2,1278,2696,30
63274006785,63274006778,-7,1631,6076,30
63279992562,63279992557,-5,1192,2353,30
63280970636,63280970650,14,1060,1930,30
63284314417,63284314413,-4,1359,3831,30
63287763542,63287763547,5,3082,1448,30
63293302309,63293302307,-2,1463,3074,30
63297923434,63297923427,-7,1282,4558,30
63309947002,63309946982,-20,60,1025,30
63311263943,63311263938,-5,677,1805,30
63312995490,63312995486,-4,1031,2429,30
63313063338,63313063326,-12,78,639,30
63316410622,63316410618,-4,1219,3291,30
63329592716,63329592713,-3,1215,2355,30
63331777054,63331777052,-2,816,2958,30
63331869858,63331869844,-14,350,870,30
63332647870,63332647866,-4,688,2384,30
63332771218,63332771219,1,1769,2204,30
63334019654,63334019649,-5,996,2695,30
63337481601,63337481602,1,2016,2160,30
63344369407,63344369401,-6,1180,4086,30
63344469412,63344469422,10,553,2389,30
63348310699,63348310695,-4,1007,2441,30
63350649613,63350649613,0,12709,17278,30
63352910848,63352910845,-3,1221,1711,30
63357816254,63357816251,-3,799,1719,30
63358111836,63358111838,2,1553,1094,30
63358942026,63358942023,-3,843,2558,30
63359154066,63359154087,21,891,2397,30
63361058785,63361058787,2,1242,1473,30
63361619902,63361619898,-4,1148,2004,30
63364408058,63364408054,-4,1014,3414,30
63370147139,63370147136,-3,1223,3200,30
63370261526,63370261533,7,2852,1514,30
63373134214,63373134208,-6,1086,3346,30
63376692106,63376692101,-5,794,1293,30
63378196053,63378196033,-20,10,1944,30
63381201069,63381201063,-6,810,2682,30
63388472710,63388472705,-5,1251,3353,30
63389246740,63389246734,-6,1274,3190,30
63391675067,63391675066,-1,608,1493,30
63407524162,63407524158,-4,1420,3497,30
63407990620,63407990616,-4,867,2539,30
63410954612,63410954606,-6,913,3197,30
63411684567,63411684562,-5,1057,1996,30
63413445259,63413445254,-5,721,1927,30
63415870316,63415870317,1,1522,2046,30
63417178067,63417178064,-3,2084,6630,30
63417286285,63417286281,-4,883,3488,30
63418336151,63418336146,-5,1096,3918,30
63422887599,63422887596,-3,1232,2293,30
63423932100,63423932099,-1,2760,3670,30
63425467915,63425467911,-4,1178,2947,30
63429123384,63429123381,-3,661,1266,30
63430035123,63430035118,-5,1075,4693,30
63430292530,63430292526,-4,788,2386,30
63431671082,63431671078,-4,970,1830,30
63434799917,63434799915,-2,829,1851,30
63435228967,63435228964,-3,1034,2297,30
63435337802,63435337783,-19,189,1085,30
63441319958,63441319954,-4,1255,3310,30
63448800481,63448800476,-5,860,2315,30
63451331321,63451331315,-6,827,2426,30
63451625205,63451625204,-1,2716,3950,30
63451840065,63451840065,0,2756,2776,30
63455780768,63455780762,-6,895,2347,30
63459544305,63459544312,7,3779,933,30
63462304298,63462304305,7,4285,2559,30
63465978412,63465978409,-3,995,2727,30
63471090394,63471090394,0,1002,955,30
63479086731,63479086726,-5,1220,2523,30
63480383187,63480383183,-4,896,3502,30
63491025138,63491025138,0,1794,1424,30
63491885258,63491885254,-4,923,2965,30
63492966674,63492966670,-4,1206,3448,30
63494870697,63494870698,1,1889,1814,30
63503652686,63503652681,-5,1144,2960,30
63514788941,63514788945,4,2224,1001,30
63519575971,63519575966,-5,1163,3175,30
63534597997,63534598001,4,3143,3264,30
63535027520,63535027517,-3,1059,2348,30
63538380786,63538380782,-4,837,2922,30
63543292346,63543292354,8,2710,1475,30
63545362645,63545362639,-6,646,2387,30
63547783878,63547783873,-5,1380,3189,30
63549891624,63549891610,-14,654,3228,30
63550127457,63550127466,9,8715,2356,30
63553065727,63553065722,-5,610,1845,30
63559736778,63559736778,0,985,1097,30
63566245879,63566245878,-1,1298,3044,30
63566615274,63566615270,-4,1354,3875,30
63567068658,63567068679,21,949,2605,30
63569304322,63569304314,-8,1742,4951,30
63578224706,63578224705,-1,1467,2848,30
63584638690,63584638685,-5,814,2214,30
63589616909,63589616907,-2,1082,2682,30
63592046036,63592046030,-6,1056,3077,30
63612568018,63612568013,-5,1248,3636,30
63612672537,63612672557,20,435,1192,30
63613997049,63613997045,-4,958,3731,30
63616290912,63616290907,-5,1209,2447,30
63618344357,63618344358,1,3957,26037,30
63622097253,63622097248,-5,1179,3030,30
63623591576,63623591582,6,1579,995,30
63627523170,63627523167,-3,1410,2797,30
63632267339,63632267334,-5,716,3236,30
63635662590,63635662586,-4,869,2188,30
63638480638,63638480634,-4,967,3107,30
63643968075,63643968073,-2,801,2101,30
63648699619,63648699615,-4,1459,2668,30
63650380993,63650380989,-4,708,2862,30
63652659650,63652659647,-3,1200,1746,30
63656958747,63656958742,-5,1228,2641,30
63659455975,63659455973,-2,515,1767,30
63660891913,63660891896,-17,519,2235,30
63661725793,63661725814,21,809,1080,30
63667090818,63667090812,-6,649,2490,30
63667149787,63667149787,0,224,1649,30
63667943206,63667943204,-2,1153,2213,30
63673328999,63673328993,-6,713,3884,30
63673679226,63673679214,-12,1399,3810,30
63677010935,63677010931,-4,1169,2729,30
63677054202,63677054218,16,1127,3358,30
63681790835,63681790830,-5,699,1730,30
63681964378,63681964394,16,987,2227,30
63683491654,63683491650,-4,925,1657,30
63684673555,63684673548,-7,808,2788,30
63687592984,63687592981,-3,1026,2626,30
63690177325,63690177322,-3,1024,2568,30
63690203217,63690203210,-7,1044,1458,30
63694445510,63694445504,-6,1369,4555,30
63699469673,63699469667,-6,1388,4315,30
63703698555,63703698549,-6,789,3152,30
63703755381,63703755381,0,1774,1502,30
63706829942,63706829946,4,313,879,30
63710849823,63710849821,-2,808,2507,30
63713065302,63713065298,-4,883,1991,30
63713262651,63713262670,19,636,1143,30
63722290396,63722290391,-5,1314,3336,30
63724776871,63724776865,-6,1244,4010,30
63730643674,63730643669,-5,1075,3389,30
63733470837,63733470833,-4,1138,3624,30
63733707677,63733707679,2,1401,1763,30
63733933527,63733933522,-5,746,2775,30
63738290267,63738290286,19,76,1348,30
63744388946,63744388942,-4,894,2016,30
63751490490,63751490485,-5,1036,2444,30
63754209276,63754209283,7,3620,1079,30
63759531644,63759531640,-4,876,2200,30
63760044242,63760044244,2,2158,1999,30
63761299343,63761299337,-6,1060,3380,30
63765207523,63765207529,6,1793,1560,30
63766983276,63766983276,0,1378,1647,30
63771220367,63771220363,-4,781,1871,30
63775742452,63775742457,5,2484,1532,30
63790346698,63790346694,-4,826,3069,30
63791620686,63791620690,4,1270,1392,30
63803901951,63803901946,-5,643,2863,30
63806703979,63806703974,-5,1496,7835,30
63811003229,63811003224,-5,1386,3563,30
63813640514,63813640510,-4,738,1863,30
63814950831,63814950825,-6,1072,2366,30
63818102002,63818101998,-4,526,1064,30
63820736560,63820736554,-6,1073,2707,30
63825282406,63825282402,-4,648,1938,30
63825633665,63825633687,22,619,1216,30
63832038866,63832038861,-5,1309,2440,30
63836330428,63836330422,-6,1103,3127,30
63836656325,63836656322,-3,3660,6594,30
63838226383,63838226383,0,1399,1444,30
63839775795,63839775791,-4,787,2681,30
63840758667,63840758687,20,384,1106,30
63843744507,63843744502,-5,1224,3044,30
63847845865,63847845858,-7,1596,3172,30
63848737151,63848737149,-2,1079,2110,30
63852105378,63852105386,8,5379,1709,30
63856544137,63856544133,-4,825,1785,30
63858424993,63858424990,-3,1357,2701,30
63859782025,63859782019,-6,818,3372,30
63865198773,63865198769,-4,1128,2671,30
63865340537,63865340520,-17,1094,3269,30
63868421799,63868421793,-6,1161,3343,30
63868702569,63868702584,15,501,2605,30
63875546375,63875546372,-3,698,2904,30
63883638657,63883638654,-3,951,2241,30
63883686684,63883686701,17,865,1741,30
63886272230,63886272225,-5,1372,4031,30
63890272594,63890272598,4,1651,996,30
63891022062,63891022058,-4,695,3154,30
63893553162,63893553155,-7,966,4764,30
63896141718,63896141719,1,1999,1419,30
63900371689,63900371686,-3,564,1855,30
63906460598,63906460602,4,2263,1503,30
63908812466,63908812465,-1,2922,6091,30
63912758675,63912758670,-5,1307,3183,30
63915448950,63915448946,-4,974,3790,30
63915728475,63915728457,-18,100,1087,30
63922535482,63922535478,-4,629,2154,30
63924030070,63924030065,-5,1566,3528,30
63926154884,63926154878,-6,900,2801,30
63937749002,63937748994,-8,920,3667,30
63938972418,63938972413,-5,1207,2771,30
63939212011,63939212011,0,16,883,30
63945997500,63945997495,-5,999,2770,30
63949874399,63949874394,-5,965,3563,30
63962445399,63962445394,-5,945,3559,30
63967180094,63967180090,-4,2014,5067,30
63971703851,63971703854,3,1778,1446,30
63973403619,63973403614,-5,1162,3288,30
63986254498,63986254496,-2,1107,2149,30
63986727412,63986727406,-6,1113,4336,30
63987156122,63987156101,-21,751,2263,30
63988894852,63988894867,15,135,992,30
63990263949,63990263946,-3,1288,2602,30
63990884193,63990884190,-3,811,2557,30
63991581051,63991581049,-2,822,1422,30
63995856134,63995856130,-4,1012,3322,30
64000236086,64000236100,14,1021,257,30
64000891566,64000891560,-6,1009,3564,30
64003104151,64003104147,-4,1264,2350,30
64004462847,64004462842,-5,1312,3562,30
64008895862,64008895879,17,1194,1919,30
64009429987,64009430005,18,746,2722,30
64012871962,64012871957,-5,1177,3087,30
64013601046,64013601043,-3,977,2268,30
64013851769,64013851771,2,197,842,30
64014745926,64014745926,0,1409,2160,30
64016471355,64016471350,-5,850,2803,30
64017457827,64017457821,-6,161,913,30
64021963873,64021963867,-6,929,2441,30
64027251806,64027251801,-5,1395,2348,30
64027521826,64027521843,17,309,962,30
64031751842,64031751838,-4,846,2876,30
64032170669,64032170665,-4,821,1603,30
64037036974,64037036967,-7,1090,3620,30
64052985505,64052985505,0,917,2359,30
64053426890,64053426885,-5,976,2936,30
64057353236,64057353240,4,46871,25101,30
64058488722,64058488717,-5,1807,5265,30
64069519330,64069519326,-4,975,2232,30
64078779345,64078779341,-4,970,2981,30
64080084837,64080084834,-3,994,2619,30
64080126722,64080126727,5,2036,1544,30
64082957109,64082957109,0,2506,3042,30
64083063753,64083063758,5,2899,729,30
64084079410,64084079406,-4,870,2374,30
64084484162,64084484157,-5,767,2960,30
64089031474,64089031470,-4,604,2673,30
64099807182,64099807179,-3,1370,3599,30
64100238773,64100238772,-1,826,2469,30
64102646991,64102646987,-4,756,2014,30
64103512695,64103512690,-5,922,2756,30
64114227238,64114227242,4,2042,1240,30
64121632254,64121632251,-3,949,1913,30
64125112659,64125112655,-4,673,1609,30
64135089928,64135089921,-7,1396,5037,30
64147730881,64147730887,6,1974,1191,30
64149493579,64149493574,-5,1117,3523,30
64152185220,64152185216,-4,1479,3173,30
64155558010,64155558005,-5,904,2306,30
64158735682,64158735675,-7,1528,5299,30
64166329765,64166329761,-4,1115,2568,30
64167549606,64167549600,-6,1239,2236,30
64170616689,64170616697,8,2313,1123,30
64171666671,64171666666,-5,982,3063,30
64173903289,64173903286,-3,761,2642,30
64184503580,64184503574,-6,903,3953,30
64186044161,64186044158,-3,1015,2822,30
64186978955,64186978938,-17,1209,537,30
64188208739,64188208746,7,8360,3056,30
64189378850,64189378846,-4,613,2602,30
64191268609,64191268614,5,2870,1697,30
64200251749,64200251745,-4,1116,2546,30
64204342777,64204342770,-7,1632,3344,30
64205670730,64205670724,-6,1650,3362,30
64207333358,64207333366,8,6253,2148,30
64209614788,64209614783,-5,1183,3126,30
64211468399,64211468392,-7,1028,2527,30
64216077119,64216077123,4,1143,849,30
64234249483,64234249479,-4,1016,2859,30
64236069848,64236069842,-6,916,2963,30
64237017682,64237017675,-7,172,940,30
64238993612,64238993613,1,1817,1399,30
64239385158,64239385154,-4,1123,2463,30
64242585186,64242585180,-6,662,1612,30
64245575410,64245575407,-3,644,882,30
64252688753,64252688758,5,2290,1592,30
64256052373,64256052379,6,6425,2285,30
64261185949,64261185945,-4,1608,3772,30
64277468644,64277468638,-6,658,2052,30
64279303718,64279303714,-4,1207,3753,30
64282879837,64282879834,-3,852,2234,30
64285097235,64285097233,-2,723,2590,30
64290429550,64290429545,-5,1033,3199,30
64296389081,64296389083,2,1120,591,30
64298666722,64298666719,-3,1163,2604,30
64301241151,64301241145,-6,824,1899,30
64303776036,64303776030,-6,867,2061,30
64309237983,64309237979,-4,1096,2884,30
64320366169,64320366165,-4,1391,2760,30
64323055199,64323055194,-5,895,1706,30
64324224765,64324224762,-3,2405,4713,30
64324904303,64324904302,-1,1325,1629,30
64332493667,64332493665,-2,1484,1753,30
64334482594,64334482591,-3,959,2171,30
64340188059,64340188056,-3,540,3209,30
64340468836,64340468855,19,163,809,30
64342062139,64342062136,-3,1109,3412,30
64348473578,64348473574,-4,858,3360,30
64353913921,64353913917,-4,682,2692,30
64354997260,64354997254,-6,1047,3276,30
64363966718,64363966722,4,3313,2167,30
64369686127,64369686122,-5,710,3327,30
64370548330,64370548328,-2,1048,1873,30
64373681780,64373681777,-3,1067,3365,30
64374024142,64374024138,-4,1209,2563,30
64374840635,64374840630,-5,883,2178,30
64383358026,64383358027,1,1949,1977,30
64384306905,64384306900,-5,1247,3085,30
64384596752,64384596746,-6,1174,2652,30
64388851964,64388851959,-5,1007,2749,30
64398908714,64398908710,-4,902,2596,30
64402704619,64402704615,-4,1219,3556,30
64407157454,64407157451,-3,871,1722,30
64410534789,64410534786,-3,987,2752,30
64417645582,64417645578,-4,1040,2587,30
64419045891,64419045891,0,802,1373,30
64424212211,64424212207,-4,1054,2341,30
64426960139,64426960134,-5,947,2480,30
64427831639,64427831634,-5,2830,9840,30
64430498743,64430498740,-3,1054,2937,30
64432497282,64432497275,-7,1128,3200,30
64438148295,64438148293,-2,762,2612,30
64450770458,64450770453,-5,1274,2982,30
64453357834,64453357839,5,1750,1861,30
64459521557,64459521553,-4,749,1802,30
64460431354,64460431351,-3,1153,2948,30
64461330799,64461330793,-6,1011,3844,30
64461478320,64461478338,18,82,596,30
64463844707,64463844701,-6,1192,3623,30
64465284038,64465284034,-4,1058,3029,30
64473402811,64473402804,-7,576,2223,30
64473580099,64473580082,-17,57,1125,30
64474657068,64474657075,7,1891,1219,30
64474826284,64474826280,-4,1136,3316,30
64477804623,64477804634,11,283,835,30
64479009590,64479009586,-4,919,1950,30
64479848725,64479848721,-4,885,2069,30
64482100595,64482100589,-6,786,3006,30
64482571936,64482571938,2,1245,1129,30
64488653170,64488653166,-4,1486,3517,30
64490927723,64490927719,-4,1067,2480,30
64493014726,64493014722,-4,1020,2691,30
64493178136,64493178158,22,264,1318,30
64494215385,64494215382,-3,687,2673,30
64494296895,64494296891,-4,1083,2784,30
64500737270,64500737265,-5,698,2103,30
64502233375,64502233371,-4,856,2590,30
64505547009,64505547015,6,3417,1309,30
64506803119,64506803116,-3,596,1781,30
64509516117,64509516119,2,2790,1620,30
64515244213,64515244209,-4,1696,5939,30
64517275639,64517275642,3,7671,6421,30
64522810614,64522810609,-5,1308,3500,30
64529970652,64529970646,-6,705,2295,30
64532447341,64532447336,-5,908,1762,30
64539142503,64539142498,-5,641,2338,30
64540680608,64540680604,-4,1130,3630,30
64542520313,64542520309,-4,930,3183,30
64548632494,64548632490,-4,1045,3473,30
64553939974,64553939971,-3,1220,2779,30
64555236134,64555236151,17,915,2738,30
64555597390,64555597386,-4,1056,2650,30
64563666675,64563666671,-4,869,3050,30
64565082810,64565082828,18,1263,1115,30
64565357946,64565357946,0,1070,2352,30
64569534590,64569534584,-6,1351,3416,30
64572143355,64572143354,-1,1223,1625,30
64576573109,64576573104,-5,1557,4294,30
64576738394,64576738406,12,312,1606,30
64585746987,64585746983,-4,1249,2612,30
64593467972,64593467969,-3,1301,2694,30
64595315648,64595315658,10,375,1516,30
64602656290,64602656286,-4,1715,3094,30
64603940805,64603940800,-5,1321,2646,30
64605818310,64605818306,-4,1393,3986,30
64608024628,64608024621,-7,1011,4277,30
64610017723,64610017717,-6,1439,2707,30
64614101806,64614101798,-8,1236,3289,30
64616232996,64616232990,-6,933,3001,30
64617658769,64617658767,-2,2534,5125,30
64619576876,64619576871,-5,817,2184,30
64626669754,64626669750,-4,908,2355,30
64627350666,64627350662,-4,1289,3042,30
64629911162,64629911158,-4,1005,3384,30
64641351601,64641351595,-6,1193,2766,30
64647665981,64647665977,-4,785,2396,30
64649613649,64649613641,-8,1338,9452,30
64650305067,64650305051,-16,1096,2388,30
64651312946,64651312942,-4,742,2898,30
64651902747,64651902765,18,827,2386,30
64656235973,64656235969,-4,1168,2694,30
64662619503,64662619497,-6,1142,4357,30
64664985503,64664985498,-5,1095,2945,30
64665180448,64665180466,18,257,922,30
64674880081,64674880077,-4,1026,2645,30
64677235226,64677235221,-5,507,2562,30
64678072177,64678072199,22,416,1353,30
64683743672,64683743669,-3,993,3024,30
64686627555,64686627550,-5,1119,2710,30
64688106503,64688106501,-2,942,2385,30
64688715771,64688715766,-5,937,3439,30
64692500023,64692500019,-4,1135,2746,30
64693251879,64693251874,-5,966,1870,30
64695282304,64695282300,-4,1381,2725,30
64695768236,64695768242,6,84,591,30
64703661141,64703661137,-4,1193,2669,30
64710570223,64710570219,-4,928,3399,30
64710680738,64710680722,-16,1861,3693,30
64712069649,64712069653,4,1160,707,30
64712983118,64712983113,-5,1071,3656,30
64713985614,64713985609,-5,1139,4284,30
64714401707,64714401711,4,2735,2133,30
64714670588,64714670582,-6,1250,3109,30
64722142155,64722142150,-5,1031,3022,30
64739051943,64739051939,-4,853,2330,30
64741349246,64741349242,-4,966,2579,30
64741928764,64741928763,-1,2637,3206,30
64743011873,64743011869,-4,1252,2469,30
64747685967,64747685962,-5,1586,2994,30
64751722767,64751722761,-6,1231,3115,30
64756831975,64756831972,-3,865,1897,30
64762408098,64762408094,-4,685,1773,30
64763777612,64763777605,-7,1148,3055,30
64764462750,64764462769,19,708,1326,30
64764696044,64764696040,-4,820,2257,30
64764798162,64764798163,1,808,1216,30
64765575354,64765575370,16,301,1218,30
64767127521,64767127515,-6,1216,2377,30
64782248507,64782248501,-6,900,4846,30
64784269510,64784269507,-3,1177,2697,30
64784752595,64784752590,-5,1157,4105,30
64785582244,64785582239,-5,1128,2938,30
64785630698,64785630716,18,318,1084,30
64791707200,64791707197,-3,1614,1959,30
64795156286,64795156282,-4,760,3396,30
64804257587,64804257584,-3,994,2662,30
64804503647,64804503642,-5,1369,3341,30
64805579454,64805579449,-5,1525,3013,30
64806222491,64806222487,-4,2498,7436,30
64809399814,64809399810,-4,1254,3815,30
64813053629,64813053625,-4,720,2827,30
64820565622,64820565617,-5,1152,2084,30
64823112281,64823112265,-16,994,3122,30
64825391390,64825391384,-6,1104,3295,30
64825833969,64825833984,15,711,1803,30
64826706395,64826706390,-5,702,2193,30
64841870037,64841870034,-3,1427,1946,30
64850194393,64850194385,-8,969,1667,30
64852196658,64852196658,0,1271,1499,30
64858424723,64858424718,-5,737,3369,30
64859145350,64859145344,-6,1765,8469,30
64860452552,64860452548,-4,1443,3445,30
64860779886,64860779882,-4,937,4104,30
64865285371,64865285369,-2,1166,2677,30
64867255241,64867255234,-7,1184,2848,30
64867631350,64867631345,-5,949,2434,30
64871016205,64871016201,-4,608,1507,30
64873238273,64873238269,-4,1140,3139,30
64874328748,64874328742,-6,1253,2224,30
64879634522,64879634518,-4,786,2142,30
64879903101,64879903096,-5,1217,2890,30
64880210996,64880211008,12,234,1649,30
64883539865,64883539863,-2,1145,1949,30
64883839841,64883839839,-2,1280,1783,30
64892802218,64892802214,-4,1199,2965,30
64898700665,64898700657,-8,1310,5822,30
64903757269,64903757265,-4,2199,6726,30
64904029230,64904029228,-2,1394,2617,30
64904961526,64904961526,0,1370,1816,30
64905086971,64905086991,20,258,761,30
64907780194,64907780190,-4,816,2234,30
64908428334,64908428329,-5,1069,2898,30
64909007982,64909007978,-4,1021,2637,30
64909170246,64909170239,-7,839,2082,30
64912246826,64912246822,-4,1035,2461,30
64913049214,64913049210,-4,1074,2407,30
64915814405,64915814402,-3,952,1923,30
64915873434,64915873430,-4,700,1696,30
64916005843,64916005858,15,235,1074,30
64917476748,64917476746,-2,1137,1450,30
64918410624,64918410630,6,4084,979,30
64924458678,64924458674,-4,1321,3163,30
64925380203,64925380182,-21,58,1028,30
64930083087,64930083081,-6,2011,9326,30
64930174085,64930174086,1,934,1076,30
64931603811,64931603808,-3,1117,1924,30
64932886850,64932886846,-4,743,2801,30
64935840440,64935840434,-6,1116,3018,30
64944021266,64944021261,-5,1282,3226,30
64944438066,64944438062,-4,859,3863,30
64946097238,64946097235,-3,931,2845,30
64946148432,64946148429,-3,2249,5718,30
64946336842,64946336838,-4,1061,1798,30
64947734644,64947734639,-5,920,2089,30
64948775664,64948775685,21,574,940,30
64949379692,64949379689,-3,1093,2885,30
64949880401,64949880405,4,2102,2267,30
64950268995,64950268988,-7,743,1608,30
64955866258,64955866263,5,13536,8745,30
64958438535,64958438535,0,1159,1935,30
64969838099,64969838095,-4,689,2737,30
64983716231,64983716227,-4,817,2688,30
64984940923,64984940917,-6,827,2925,30
64987080240,64987080235,-5,1547,3439,30
64990549474,64990549469,-5,1033,2211,30
64991617596,64991617612,16,737,1479,30
64992718395,64992718394,-1,1745,2202,30
64993923684,64993923697,13,196,1171,30
64996416782,64996416777,-5,770,3885,30
64998381348,64998381357,9,224,848,30
64998830267,64998830261,-6,4000,16061,30
64998934904,64998934899,-5,1212,3260,30
64999913555,64999913550,-5,280,1627,30
65002755455,65002755455,0,629,1210,30
65007044623,65007044619,-4,932,1915,30
65007867319,65007867314,-5,1081,1779,30
65007992952,65007992951,-1,1596,2336,30
65009068206,65009068202,-4,637,1688,30
65015172407,65015172403,-4,1157,1917,30
65017809469,65017809473,4,4735,2538,30
65018105246,65018105238,-8,1070,3208,30
65020906026,65020906023,-3,26208,5188,30
65022079804,65022079800,-4,1315,3534,30
65022584190,65022584184,-6,915,3004,30
65025143359,65025143355,-4,2055,3158,30
65025935602,65025935597,-5,961,3135,30
65028699831,65028699833,2,1494,735,30
65033395203,65033395198,-5,1096,3082,30
65033754086,65033754082,-4,2560,6636,30
65040203761,65040203767,6,2267,1566,30
65043401919,65043401914,-5,1366,2317,30
65043580029,65043580027,-2,1060,2610,30
65052942398,65052942393,-5,1344,3379,30
65055899627,65055899623,-4,908,2377,30
65056043508,65056043523,15,523,1782,30
65058281872,65058281868,-4,1130,3012,30
65061801989,65061801987,-2,1079,2004,30
65063001431,65063001427,-4,1088,2740,30
65065613978,65065613975,-3,1469,1994,30
65068314105,65068314098,-7,1187,2283,30
65070339812,65070339814,2,2278,1650,30
65077696791,65077696789,-2,1095,2054,30
65080310409,65080310406,-3,859,2836,30
65083118753,65083118772,19,582,1636,30
65088047492,65088047495,3,2127,1013,30
65092594423,65092594424,1,2816,3864,30
65092947616,65092947611,-5,1126,3587,30
65093010618,65093010633,15,767,2508,30
65097410377,65097410379,2,1703,1585,30
65098102322,65098102317,-5,618,2000,30
65100462513,65100462507,-6,991,3072,30
65103304507,65103304501,-6,1098,2682,30
65112850008,65112850001,-7,1177,2379,30
65113687843,65113687837,-6,1190,4109,30
65113713834,65113713850,16,628,1260,30
65125573832,65125573826,-6,774,2925,30
65127201627,65127201618,-9,951,2637,30
65127668209,65127668228,19,1071,3683,30
65128045442,65128045436,-6,1273,3910,30
65130733777,65130733772,-5,1358,3352,30
65138607596,65138607592,-4,1327,2832,30
65141314167,65141314162,-5,1073,2653,30
65144868234,65144868239,5,1012,1182,30
65147068317,65147068315,-2,1161,1926,30
65147554243,65147554226,-17,1007,2353,30
65149205824,65149205817,-7,1784,5318,30
65151194801,65151194796,-5,809,3551,30
65152932791,65152932793,2,1888,2293,30
65155013489,65155013485,-4,1181,3190,30
65156388018,65156388016,-2,1002,1785,30
65156626489,65156626505,16,1353,1959,30
65158533753,65158533746,-7,1083,2535,30
65161229518,65161229516,-2,862,2542,30
65174319226,65174319223,-3,987,2486,30
65175277034,65175277030,-4,1175,3267,30
65180388486,65180388495,9,270,1082,30
65184551898,65184551894,-4,924,1966,30
65188001802,65188001799,-3,1151,1621,30
65196297510,65196297513,3,2860,2370,30
65200572075,65200572070,-5,751,3023,30
65202576546,65202576543,-3,1232,3013,30
65205330970,65205330969,-1,2242,4438,30
65210139538,65210139534,-4,1667,5530,30
65210366632,65210366628,-4,1187,2666,30
65212222105,65212222102,-3,950,2295,30
65214486806,65214486803,-3,1157,2473,30
65216797563,65216797559,-4,807,2853,30
65224552690,65224552686,-4,1087,2345,30
65224652606,65224652602,-4,1072,2212,30
65226615005,65226615001,-4,1329,2716,30
65230429506,65230429501,-5,1102,2746,30
65231479621,65231479614,-7,1079,2984,30
65232968891,65232968887,-4,1048,2126,30
65235282878,65235282875,-3,873,1245,30
65240660097,65240660094,-3,645,2505,30
65241800663,65241800658,-5,605,2327,30
65244264495,65244264491,-4,875,2593,30
65247320983,65247320978,-5,1101,3535,30
65247766219,65247766214,-5,1157,2924,30
65250097035,65250097030,-5,1722,5112,30
65254600882,65254600874,-8,960,2684,30
65254762658,65254762652,-6,1078,2819,30
65256906281,65256906274,-7,967,2854,30
65257614070,65257614065,-5,1212,2630,30
65261345183,65261345179,-4,998,3146,30
65264189262,65264189258,-4,1066,3310,30
65266102666,65266102662,-4,756,2573,30
65267333212,65267333218,6,5627,3048,30
65271974024,65271974021,-3,872,1611,30
65273798430,65273798427,-3,979,1908,30
65274779086,65274779082,-4,783,3195,30
65290254332,65290254334,2,1502,1324,30
65291190886,65291190879,-7,1326,4326,30
65304157663,65304157659,-4,979,2807,30
65304712420,65304712439,19,631,1599,30
65308558598,65308558591,-7,1725,7309,30
65315336041,65315336037,-4,792,1397,30
65315553298,65315553297,-1,2206,2949,30
65316124766,65316124763,-3,1122,2195,30
65316347025,65316347018,-7,1361,4553,30
65321171361,65321171378,17,469,632,30
65330676841,65330676840,-1,1378,1975,30
65331345543,65331345539,-4,765,3419,30
65332515254,65332515255,1,1503,1487,30
65333147964,65333147970,6,6048,2723,30
65340285527,65340285522,-5,896,3715,30
65341114927,65341114922,-5,859,4140,30
65347762786,65347762782,-4,1309,3148,30
65348583789,65348583785,-4,882,3390,30
65349149579,65349149566,-13,40463,15800,30
65349506017,65349506024,7,7528,2500,30
65350148530,65350148526,-4,1105,2406,30
65354577373,65354577370,-3,1291,2201,30
65356931549,65356931545,-4,1622,3420,30
65358694407,65358694402,-5,1436,2930,30
65361531602,65361531591,-11,1136,1665,30
65361972130,65361972126,-4,711,1736,30
65365753277,65365753275,-2,857,1962,30
65368013403,65368013398,-5,1090,3919,30
65379145031,65379145029,-2,1766,2236,30
65388662113,65388662119,6,4382,1833,30
65388834714,65388834713,-1,1573,2491,30
65390414703,65390414698,-5,1030,2664,30
65391349789,65391349789,0,2261,2467,30
65391520454,65391520453,-1,1174,1553,30
65392466079,65392466077,-2,924,2043,30
65394990218,65394990213,-5,1331,4321,30
65409569225,65409569230,5,2932,1725,30
65412062733,65412062732,-1,1369,1081,30
65414494235,65414494229,-6,943,3844,30
65416241982,65416241980,-2,1218,2985,30
65423719159,65423719154,-5,1023,3217,30
65426823737,65426823734,-3,710,1959,30
65429938001,65429937997,-4,887,3346,30
65433900923,65433900919,-4,1201,3299,30
65433980249,65433980244,-5,706,2825,30
65434206975,65434206971,-4,705,2144,30
65438169414,65438169411,-3,1397,3611,30
65441039606,65441039602,-4,864,2531,30
65445515120,65445515114,-6,1200,3644,30
65446340664,65446340659,-5,1538,3687,30
65447361857,65447361843,-14,927,2947,30
65449059980,65449059998,18,290,1192,30
65449807231,65449807226,-5,1408,3446,30
65464512999,65464513016,17,643,1719,30
65465970703,65465970698,-5,1209,3366,30
65466266031,65466266027,-4,571,2535,30
65467481783,65467481774,-9,1667,3396,30
65468599955,65468599950,-5,1371,3727,30
65472033348,65472033343,-5,968,2687,30
65476013705,65476013701,-4,825,2702,30
65476693594,65476693601,7,5366,1735,30
65482302597,65482302592,-5,940,2786,30
65487055884,65487055882,-2,900,1393,30
65488758815,65488758809,-6,984,1840,30
65490244731,65490244728,-3,957,3735,30
65499812181,65499812175,-6,1141,3853,30
65503332598,65503332593,-5,1106,4444,30
65505455189,65505455182,-7,1036,3089,30
65508170163,65508170156,-7,910,2673,30
65510008079,65510008074,-5,924,2678,30
65516870306,65516870307,1,2343,3082,30
65517448974,65517448968,-6,1181,3285,30
65520039019,65520039015,-4,984,2809,30
65523220210,65523220206,-4,687,2130,30
65523451519,65523451513,-6,938,1983,30
65523928224,65523928234,10,189,997,30
65528720923,65528720918,-5,1722,4367,30
65529396566,65529396561,-5,733,1564,30
65538903984,65538903981,-3,1041,2716,30
65539810888,65539810884,-4,1030,2722,30
65540247785,65540247778,-7,975,2360,30
65552982563,65552982556,-7,1075,3472,30
65553834285,65553834280,-5,1000,2760,30
65563023481,65563023477,-4,1086,2183,30
65565485496,65565485497,1,18066,6864,30
65578848523,65578848520,-3,913,2953,30
65584155791,65584155785,-6,1282,3325,30
65588126280,65588126274,-6,1042,2924,30
65588160657,65588160652,-5,1427,3774,30
65597088774,65597088770,-4,788,3042,30
65597428282,65597428282,0,1679,2508,30
65603787484,65603787478,-6,1189,2952,30
65606815592,65606815587,-5,1191,2108,30
65607675116,65607675112,-4,1496,3806,30
65610340842,65610340838,-4,571,612,30
65626051277,65626051273,-4,1517,3253,30
65626496683,65626496679,-4,1138,3313,30
65626599426,65626599446,20,90,815,30
65628024132,65628024125,-7,1013,2618,30
65628055546,65628055539,-7,290,973,30
65629644309,65629644304,-5,978,3996,30
65632735435,65632735429,-6,1079,1771,30
65633072755,65633072741,-14,731,14135,30
65634242632,65634242625,-7,36368,13514,30
65643636378,65643636372,-6,831,3091,30
65643715798,65643715794,-4,1097,3186,30
65651767847,65651767841,-6,1012,3556,30
65652984014,65652984010,-4,890,2987,30
65659164462,65659164459,-3,1458,3163,30
65666654953,65666654949,-4,1071,3760,30
65668173046,65668173043,-3,1350,2953,30
65669074331,65669074326,-5,1081,3714,30
65674057561,65674057557,-4,1068,2282,30
65676313299,65676313294,-5,1293,2511,30
65679677882,65679677879,-3,792,2459,30
65683704076,65683704070,-6,1179,3370,30
65684337504,65684337498,-6,1146,2890,30
65686101674,65686101670,-4,6,592,30
65686568643,65686568649,6,4667,2613,30
65690417902,65690417903,1,1197,1508,30
65692440809,65692440804,-5,818,2517,30
65700636327,65700636322,-5,1076,4072,30
65711343494,65711343491,-3,887,2253,30
65715424104,65715424110,6,2012,1343,30
65719090430,65719090425,-5,925,3167,30
65722191671,65722191666,-5,1153,4118,30
65725327159,65725327154,-5,1019,3082,30
65725625419,65725625414,-5,854,2050,30
65728003938,65728003933,-5,1289,2992,30
65730347514,65730347512,-2,785,2509,30
65741839043,65741839042,-1,1326,1981,30
65742329439,65742329434,-5,902,2350,30
65742616048,65742616046,-2,1521,3901,30
65747755362,65747755364,2,3597,3109,30
65755310913,65755310892,-21,1108,502,30
65755730239,65755730235,-4,1025,2929,30
65763990614,65763990608,-6,1160,2641,30
65766747707,65766747706,-1,1265,1482,30
65769774726,65769774722,-4,857,2964,30
65770162152,65770162134,-18,280,568,30
65770941976,65770941972,-4,838,2274,30
65771851529,65771851524,-5,1305,2879,30
65773571434,65773571438,4,2991,2018,30
65773807301,65773807315,14,323,1610,30
65781709138,65781709134,-4,1139,3674,30
65786416333,65786416333,0,905,1449,30
65788735150,65788735147,-3,1060,2263,30
65789848179,65789848174,-5,1373,10237,30
65797684930,65797684928,-2,1128,2615,30
65803924469,65803924462,-7,1118,2579,30
65808381486,65808381481,-5,1158,3112,30
65813853545,65813853551,6,1867,776,30
65814752857,65814752853,-4,1048,2046,30
65815066849,65815066842,-7,119,926,30
65815788721,65815788742,21,325,1831,30
65818175367,65818175375,8,3866,1391,30
65819234690,65819234687,-3,940,1417,30
65820332863,65820332858,-5,1281,2491,30
65820416593,65820416599,6,338,2436,30
65820771866,65820771886,20,694,1773,30
65821728905,65821728902,-3,973,2780,30
65822898466,65822898461,-5,1427,2523,30
65827772390,65827772384,-6,989,3607,30
65830673634,65830673627,-7,1017,3297,30
65830825964,65830825974,10,35,523,30
65833464408,65833464401,-7,550,1946,30
65837759484,65837759478,-6,1350,3694,30
65840361048,65840361041,-7,1090,3691,30
65840799331,65840799332,1,3050,3228,30
65854822047,65854822039,-8,812,3904,30
65857641683,65857641684,1,1626,1962,30
65858858249,65858858243,-6,1113,3589,30
65862688710,65862688708,-2,1047,2069,30
65867928717,65867928712,-5,1091,2809,30
65871201985,65871201982,-3,1244,2460,30
65886577023,65886577019,-4,813,1856,30
65887444758,65887444755,-3,1712,2884,30
65887671828,65887671839,11,247,1028,30
65892650640,65892650637,-3,902,2761,30
65893128570,65893128565,-5,1460,3680,30
65896982327,65896982324,-3,892,3101,30
65908398774,65908398772,-2,1516,3668,30
65911723233,65911723229,-4,498,2522,30
65914991159,65914991161,2,1781,1951,30
65917405682,65917405689,7,2927,1194,30
65919870650,65919870646,-4,1098,2502,30
65922304174,65922304173,-1,933,2496,30
65930293663,65930293658,-5,942,3450,30
65936875715,65936875709,-6,1113,4236,30
65936939001,65936938999,-2,111,695,30
65940030387,65940030385,-2,1312,1980,30
65940389759,65940389753,-6,1274,3336,30
65942448794,65942448798,4,5074,19843,30
65944274759,65944274755,-4,1389,3694,30
65957226334,65957226328,-6,857,3156,30
65960036649,65960036644,-5,1142,2469,30
65962440535,65962440529,-6,781,2100,30
65963556888,65963556885,-3,71,1055,30
65968681138,65968681134,-4,1376,2597,30
65970976254,65970976256,2,2604,2172,30
65971069383,65971069380,-3,1122,2711,30
65971659193,65971659189,-4,891,2941,30
65977958271,65977958277,6,1675,1284,30
65981858880,65981858878,-2,1208,2294,30
65982232682,65982232670,-12,895,3525,30
65991472082,65991472077,-5,1094,2806,30
65992217466,65992217462,-4,734,1982,30
65993178452,65993178469,17,1027,3044,30
65993482071,65993482070,-1,1236,2203,30
65996648566,65996648561,-5,1194,3182,30
65997307397,65997307403,6,6746,2860,30
65999565459,65999565454,-5,838,2677,30
66000112305,66000112300,-5,1049,2515,30
66000179663,66000179659,-4,1167,3387,30
66007430854,66007430851,-3,1272,2534,30
66009048171,66009048165,-6,828,1735,30
66010927301,66010927305,4,3428,1913,30
66015498528,66015498521,-7,1136,2350,30
66015744748,66015744766,18,328,1086,30
66015942496,66015942518,22,512,1925,30
66024426705,66024426701,-4,986,2405,30
66024666462,66024666456,-6,1436,4071,30
66029017247,66029017242,-5,865,3184,30
66031947281,66031947277,-4,947,2364,30
66039277762,66039277759,-3,961,2388,30
66040516350,66040516346,-4,754,2444,30
66042677538,66042677533,-5,1050,3058,30
66042831307,66042831295,-12,177,1179,30
66046617570,66046617567,-3,1085,2454,30
66057253523,66057253517,-6,722,2783,30
66059452690,66059452687,-3,790,2721,30
66060365386,66060365382,-4,1336,3534,30
66061533482,66061533482,0,2929,3547,30
66063081606,66063081601,-5,871,3136,30
66063405321,66063405304,-17,985,3098,30
66069472158,66069472154,-4,1006,2429,30
66074517066,66074517061,-5,919,2135,30
66075966898,66075966894,-4,1169,2927,30
66079635681,66079635686,5,2209,1351,30
66082842259,66082842256,-3,806,2574,30
66087962542,66087962538,-4,733,1841,30
66088114112,66088114121,9,1436,1709,30
66101065390,66101065383,-7,1348,3996,30
66103437742,66103437741,-1,749,2153,30
66105179358,66105179359,1,1284,1443,30
66109160502,66109160501,-1,831,2604,30
66111257794,66111257789,-5,955,3350,30
66114716569,66114716564,-5,952,3682,30
66116451025,66116451015,-10,167,4751,30
66118678580,66118678575,-5,1643,3826,30
66121794801,66121794797,-4,840,2916,30
66121902632,66121902653,21,402,1219,30
66124400200,66124400206,6,2603,1719,30
66129879430,66129879425,-5,1232,2792,30
66140089018,66140089015,-3,903,2623,30
66140254294,66140254289,-5,927,3392,30
66140387848,66140387865,17,525,1361,30
66141255031,66141255028,-3,681,1644,30
66145039383,66145039376,-7,1121,4190,30
66145584537,66145584555,18,680,2211,30
66148418246,66148418241,-5,940,3474,30
66151077119,66151077118,-1,1902,2528,30
66162098494,66162098487,-7,1423,2515,30
66164866870,66164866862,-8,1066,3364,30
66171669970,66171669967,-3,888,1803,30
66172309635,66172309631,-4,1231,3921,30
66173853223,66173853222,-1,1544,1922,30
66175882874,66175882869,-5,712,2206,30
66178960458,66178960457,-1,1363,1776,30
66180802234,66180802229,-5,977,2458,30
66180890339,66180890358,19,887,2118,30
66183776488,66183776483,-5,1453,2940,30
66185017921,66185017917,-4,732,2628,30
66185936954,66185936950,-4,586,2522,30
66186316035,66186316021,-14,1139,2580,30
66187599492,66187599488,-4,1108,3406,30
66192355075,66192355073,-2,1223,2703,30
66193389487,66193389481,-6,731,2356,30
66197296945,66197296941,-4,889,2839,30
66202136654,66202136649,-5,754,2799,30
66202420546,66202420563,17,139,774,30
66202694436,66202694433,-3,735,2695,30
66203198402,66203198398,-4,1541,3546,30
66206614150,66206614145,-5,794,2787,30
66208264891,66208264885,-6,922,3416,30
66211468667,66211468671,4,1209,957,30
66212874810,66212874806,-4,961,2962,30
66217060717,66217060712,-5,1633,2531,30
66225610598,66225610593,-5,1210,3140,30
66226796098,66226796094,-4,597,1738,30
66228322138,66228322134,-4,1060,3373,30
66229078018,66229078013,-5,1171,2454,30
66234193771,66234193770,-1,1510,1842,30
66234426739,66234426753,14,940,2332,30
66237892833,66237892829,-4,1650,4022,30
66241790802,66241790798,-4,668,2495,30
66242346207,66242346202,-5,1388,2822,30
66243931373,66243931373,0,1689,2171,30
66245774683,66245774680,-3,1280,3080,30
66247571230,66247571226,-4,1044,2604,30
66248121968,66248121966,-2,1508,3679,30
66248512874,66248512869,-5,897,2644,30
66248768448,66248768469,21,753,2514,30
66257160569,66257160565,-4,872,2366,30
66260585385,66260585406,21,47,723,30
66269068254,66269068253,-1,1607,3041,30
66271031779,66271031775,-4,740,1793,30
66271971384,66271971378,-6,1286,3284,30
66276161650,66276161646,-4,955,1989,30
66277902661,66277902657,-4,963,1949,30
66278823329,66278823323,-6,953,3181,30
66285608083,66285608078,-5,783,2890,30
66286766585,66286766604,19,370,1215,30
66287208103,66287208098,-5,1047,2326,30
66289329353,66289329350,-3,963,2507,30
66292305442,66292305438,-4,856,2238,30
66292579478,66292579474,-4,1015,2995,30
66295592463,66295592459,-4,768,2365,30
66298067234,66298067228,-6,1439,5512,30
66301572913,66301572911,-2,1932,3206,30
66303576915,66303576911,-4,1122,3021,30
66303840479,66303840479,0,1134,1553,30
66306971027,66306971022,-5,963,4382,30
66309871201,66309871197,-4,1337,3544,30
66310703498,66310703486,-12,846,1297,30
66312925921,66312925927,6,5553,2546,30
66313178459,66313178458,-1,967,1420,30
66313827444,66313827463,19,48,1366,30
66317333151,66317333147,-4,958,3371,30
66319835031,66319835026,-5,1090,2674,30
66327871351,66327871347,-4,887,1509,30
66328386555,66328386575,20,276,992,30
66332469702,66332469695,-7,449,1394,30
66334296017,66334296010,-7,1015,2961,30
66334863421,66334863416,-5,736,1239,30
66338031720,66338031715,-5,1587,3389,30
66338390881,66338390897,16,428,1329,30
66344865085,66344865081,-4,1040,3144,30
66345072610,66345072630,20,781,1755,30
66345872143,66345872139,-4,946,2285,30
66346583402,66346583398,-4,1437,2365,30
66350376006,66350376002,-4,1124,2541,30
66363251429,66363251425,-4,838,2493,30
66381211998,66381211993,-5,1400,4388,30
66383351745,66383351740,-5,1398,3175,30
66383403292,66383403288,-4,1074,1939,30
66386048945,66386048941,-4,918,2587,30
66391052800,66391052790,-10,36084,14966,30
66394520952,66394520946,-6,948,4515,30
66395389476,66395389470,-6,891,1881,30
66397095851,66397095864,13,129,752,30
66397177662,66397177657,-5,1341,3168,30
66399415578,66399415573,-5,1968,3290,30
66407032847,66407032842,-5,1186,2882,30
66410531996,66410531993,-3,1066,2029,30
66414085100,66414085095,-5,1651,4394,30
66419173055,66419173050,-5,1147,2243,30
66419911210,66419911224,14,890,1402,30
66425837367,66425837362,-5,1178,2954,30
66432980413,66432980407,-6,1343,3442,30
66438027581,66438027577,-4,1073,3675,30
66438168148,66438168145,-3,488,2092,30
66445625039,66445625034,-5,1039,3249,30
66446688587,66446688581,-6,1360,3491,30
66450092033,66450092029,-4,779,2434,30
66457393527,66457393523,-4,888,2391,30
66459434892,66459434871,-21,373,1603,30
66460849926,66460849921,-5,904,2953,30
66461007242,66461007238,-4,138,599,30
66462036486,66462036489,3,1287,799,30
66462456388,66462456382,-6,1967,8608,30
66466023828,66466023824,-4,947,2584,30
66472183749,66472183744,-5,935,2643,30
66472654023,66472654018,-5,885,2533,30
66479916357,66479916341,-16,575,2599,30
66489608373,66489608368,-5,952,3834,30
66498528971,66498528965,-6,1114,2667,30
66502813555,66502813550,-5,1550,3201,30
66504232904,66504232900,-4,781,2011,30
66505851755,66505851746,-9,834,2920,30
66511432914,66511432914,0,1436,1107,30
66515542355,66515542349,-6,584,1839,30
66518223338,66518223334,-4,1168,2787,30
66523792523,66523792518,-5,543,2414,30
66524523617,66524523614,-3,747,1948,30
66525437705,66525437704,-1,450,1882,30
66528470538,66528470532,-6,669,2369,30
66532515184,66532515181,-3,1305,2719,30
66533247884,66533247903,19,497,982,30
66535123611,66535123606,-5,973,2626,30
66539434375,66539434372,-3,983,3064,30
66539952709,66539952715,6,128790,57201,30
66548158608,66548158603,-5,1245,3090,30
66548781625,66548781640,15,1092,2867,30
66555575963,66555575961,-2,1318,3174,30
66557446003,66557445999,-4,839,2855,30
66564276391,66564276387,-4,1248,4304,30
66565549094,66565549089,-5,745,3743,30
66567348227,66567348222,-5,807,2081,30
66572487469,66572487466,-3,673,1184,30
66581027490,66581027485,-5,993,1962,30
66581313690,66581313711,21,292,1229,30
66582192104,66582192126,22,426,1103,30
66582795919,66582795914,-5,1062,2693,30
66583336370,66583336367,-3,1535,4212,30
66584150674,66584150670,-4,1092,3260,30
66588193494,66588193494,0,1362,1738,30
66589379382,66589379385,3,2460,2468,30
66592197778,66592197784,6,1002,533,30
66593252214,66593252209,-5,996,3154,30
66593283337,66593283334,-3,1265,3634,30
66593346912,66593346918,6,449,1526,30
66601107195,66601107189,-6,886,2343,30
66602150220,66602150217,-3,1004,3366,30
66602342514,66602342508,-6,962,3312,30
66602973884,66602973894,10,606,2771,30
66604083947,66604083941,-6,1371,4518,30
66605533366,66605533362,-4,998,3327,30
66609859794,66609859801,7,2026,818,30
66615051653,66615051646,-7,954,3164,30
66617583794,66617583789,-5,875,3012,30
66619921898,66619921892,-6,957,2930,30
66623210243,66623210239,-4,1107,2526,30
66634884487,66634884502,15,300,730,30
66638591990,66638591984,-6,816,2144,30
66638982255,66638982247,-8,895,5306,30
66639416433,66639416418,-15,217,1194,30
66641051166,66641051161,-5,734,2222,30
66641399570,66641399553,-17,301,9484,30
66642207200,66642207209,9,11019,36694,30
66649014938,66649014933,-5,1319,3856,30
66649072130,66649072144,14,672,3701,30
66653073859,66653073852,-7,1049,3952,30
66655526818,66655526798,-20,949,1303,30
66659981401,66659981397,-4,896,3214,30
66670707942,66670707936,-6,1111,4044,30
66672978185,66672978181,-4,1152,2278,30
66673118369,66673118359,-10,869,3176,30
66673487081,66673487082,1,100,1391,30
66678484671,66678484667,-4,949,2182,30
66680842103,66680842121,18,274,1092,30
66684461114,66684461112,-2,686,2582,30
66687047718,66687047715,-3,1212,2337,30
66688422603,66688422598,-5,808,3020,30
66690501435,66690501433,-2,1136,4083,30
66692857639,66692857634,-5,738,1864,30
66693701071,66693701068,-3,1120,3844,30
66704971014,66704971014,0,947,1657,30
66706375349,66706375353,4,1905,1335,30
66713827621,66713827617,-4,939,3578,30
66714533194,66714533212,18,734,2329,30
66716668030,66716668026,-4,1305,2900,30
66720964388,66720964380,-8,51694,23982,30
66731381710,66731381690,-20,1189,2919,30
66733495418,66733495413,-5,1002,2804,30
66734396913,66734396909,-4,1336,3128,30
66739255382,66739255385,3,2206,1140,30
66742829353,66742829349,-4,1235,4177,30
66745822860,66745822857,-3,1387,2942,30
66749193349,66749193345,-4,18422,15334,30
66750708343,66750708337,-6,625,2277,30
66765555261,66765555257,-4,919,2761,30
66771256419,66771256414,-5,800,2155,30
66774255131,66774255125,-6,2013,7939,30
66778066182,66778066179,-3,1270,3368,30
66778390354,66778390366,12,246,1370,30
66782932534,66782932532,-2,2503,5179,30
66783314506,66783314503,-3,1239,3164,30
66791377583,66791377579,-4,924,2572,30
66792239019,66792239017,-2,660,1653,30
66799757169,66799757154,-15,2372,988,30
66805106714,66805106709,-5,723,2984,30
66805480278,66805480273,-5,1469,2596,30
66807719980,66807719976,-4,947,2279,30
66808355834,66808355847,13,10528,39437,30
66815571567,66815571581,14,3979,15632,30
66820460453,66820460448,-5,807,2061,30
66824360499,66824360502,3,325,1167,30
66824410313,66824410309,-4,1045,2729,30
66825466483,66825466476,-7,1097,2361,30
66825520313,66825520334,21,1064,2859,30
66833786990,66833786985,-5,1217,2967,30
66836311107,66836311108,1,1898,1791,30
66842712962,66842712958,-4,1154,3191,30
66844876443,66844876441,-2,1128,3019,30
66849724893,66849724889,-4,1040,3281,30
66851047694,66851047690,-4,1386,2682,30
66853720405,66853720402,-3,842,1717,30
66855460440,66855460437,-3,1424,3336,30
66862241549,66862241545,-4,1047,2832,30
66868331923,66868331919,-4,826,3346,30
66875209826,66875209838,12,381,1733,30
66877719225,66877719226,1,1592,1571,30
66882480458,66882480453,-5,1096,2146,30
66883265857,66883265878,21,764,2702,30
66883378029,66883378036,7,3077,1256,30
66885100794,66885100793,-1,830,2117,30
66885565726,66885565722,-4,589,2464,30
66887316565,66887316561,-4,929,2098,30
66891381690,66891381684,-6,571,2745,30
66892540288,66892540278,-10,599,1268,30
66893043523,66893043519,-4,586,2065,30
66894929434,66894929428,-6,958,4135,30
66895114785,66895114773,-12,112,1339,30
66895626494,66895626489,-5,1181,2329,30
66900346883,66900346879,-4,2986,10251,30
66910675383,66910675374,-9,1119,1956,30
66910764441,66910764424,-17,1192,2607,30
66910852746,66910852742,-4,1349,3058,30
66920714581,66920714577,-4,1332,3076,30
66922272002,66922272002,0,741,1250,30
66922692387,66922692382,-5,1013,3208,30
66925203641,66925203638,-3,1017,2957,30
66926090049,66926090044,-5,1138,2650,30
66926168508,66926168527,19,1091,3420,30
66930701257,66930701261,4,1281,1092,30
66932246426,66932246421,-5,1299,3370,30
66932281783,66932281779,-4,988,2597,30
66935983138,66935983134,-4,1037,2810,30
66936087036,66936087053,17,867,2106,30
66936641411,66936641406,-5,1108,3069,30
66938103633,66938103633,0,16382,13343,30
66939648842,66939648837,-5,614,2969,30
66939981366,66939981362,-4,1215,2891,30
66941204138,66941204133,-5,844,2819,30
66941729617,66941729639,22,737,1950,30
66943255707,66943255702,-5,990,3999,30
66943402058,66943402054,-4,1493,2761,30
66946738349,66946738344,-5,1004,2176,30
66948780313,66948780309,-4,722,1876,30
66949152257,66949152257,0,14210,15194,30
66950177231,66950177228,-3,615,2392,30
66952854036,66952854030,-6,886,2819,30
66952900715,66952900702,-13,1147,4195,30
66953568513,66953568507,-6,179,1001,30
66955816835,66955816829,-6,2020,5001,30
66956825393,66956825390,-3,966,1874,30
66957486444,66957486438,-6,1771,5840,30
66959024310,66959024312,2,1717,1327,30
66960717144,66960717139,-5,1218,2624,30
66963729155,66963729151,-4,824,2636,30
66964931419,66964931422,3,5025,4441,30
66972328482,66972328478,-4,1025,2758,30
66973663465,66973663461,-4,1312,2917,30
66974136358,66974136351,-7,772,2961,30
66977295141,66977295137,-4,1513,3763,30
66978949582,66978949577,-5,946,3010,30
66987740262,66987740258,-4,990,2419,30
66990940200,66990940214,14,141,936,30
66993676606,66993676601,-5,977,2839,30
66994757759,66994757753,-6,1069,3353,30
67002461856,67002461851,-5,1205,3362,30
67004459186,67004459183,-3,1079,2632,30
67012056644,67012056641,-3,1096,2475,30
67012207405,67012207400,-5,1628,2879,30
67012721579,67012721567,-12,29300,16921,30
67016205699,67016205695,-4,665,1990,30
67016987114,67016987118,4,188,1139,30
67019920579,67019920573,-6,794,3239,30
67020410979,67020410978,-1,1034,1401,30
67026805191,67026805191,0,1481,2389,30
67034941005,67034941002,-3,1052,3044,30
67036200078,67036200073,-5,503,2275,30
67037270429,67037270425,-4,1161,3114,30
67049409462,67049409460,-2,1198,2829,30
67051633589,67051633595,6,12795,21928,30
67053069325,67053069322,-3,575,2093,30
67067542997,67067543006,9,9956,43101,30
67070446503,67070446496,-7,788,1895,30
67074899071,67074899067,-4,1131,2332,30
67076606483,67076606477,-6,840,2557,30
67079846846,67079846842,-4,1194,3218,30
67083690062,67083690055,-7,807,2553,30
67085805774,67085805769,-5,837,2108,30
67091104022,67091104020,-2,598,1441,30
67091710995,67091710988,-7,874,3123,30
67094055115,67094055110,-5,993,2886,30
67094215174,67094215170,-4,1077,2821,30
67095815976,67095815970,-6,1235,4236,30
67096798922,67096798915,-7,1012,2317,30
67099203998,67099203994,-4,1037,2881,30
67099966451,67099966441,-10,1104,3761,30
67103893662,67103893658,-4,1147,2786,30
67103964241,67103964222,-19,1098,2770,30
67108083039,67108083033,-6,1089,2981,30
67108124864,67108124883,19,144,663,30
67121771457,67121771453,-4,1352,3311,30
67128707955,67128707950,-5,878,2117,30
67129911109,67129911103,-6,1136,3883,30
67131971116,67131971113,-3,1284,2975,30
67138291678,67138291673,-5,558,2599,30
67143531565,67143531561,-4,1196,3081,30
67145703426,67145703421,-5,1180,3217,30
67146172882,67146172878,-4,692,3509,30
67147115796,67147115790,-6,932,2936,30
67152471605,67152471599,-6,1300,3555,30
67154185127,67154185135,8,27789,57978,30
67160429815,67160429810,-5,1335,2520,30
67168919551,67168919547,-4,952,2233,30
67170991262,67170991257,-5,1112,3328,30
67173862987,67173862982,-5,995,2694,30
67179167552,67179167547,-5,1146,2387,30
67179746218,67179746238,20,779,5310,30
67182117697,67182117692,-5,1115,4288,30
67183620443,67183620438,-5,1298,3802,30
67185811430,67185811438,8,2368,1514,30
67188601284,67188601281,-3,1263,3951,30
67188907449,67188907467,18,950,2736,30
67193405539,67193405534,-5,977,2580,30
67193727208,67193727214,6,105,1408,30
67198120137,67198120131,-6,877,2626,30
67200418115,67200418110,-5,842,2536,30
67200939270,67200939271,1,2549,2197,30
67204816674,67204816670,-4,657,1887,30
67206740238,67206740233,-5,1351,2606,30
67206786494,67206786491,-3,927,3135,30
67209417221,67209417223,2,1385,1072,30
67218077010,67218077016,6,2681,1216,30
67220162740,67220162739,-1,1142,1962,30
67226562999,67226562994,-5,1024,2773,30
67233558303,67233558297,-6,1453,3976,30
67233791736,67233791731,-5,1020,2946,30
67234046787,67234046782,-5,1005,2804,30
67234746438,67234746434,-4,1041,2874,30
67241497883,67241497878,-5,871,2235,30
67241713124,67241713123,-1,1401,2012,30
67243029186,67243029179,-7,984,2482,30
67245457245,67245457241,-4,1335,3396,30
67246156823,67246156817,-6,722,2879,30
67248067677,67248067683,6,1545,1300,30
67250772335,67250772333,-2,1028,2907,30
67253257127,67253257121,-6,1567,5396,30
67256252652,67256252645,-7,825,3705,30
67261908750,67261908745,-5,1135,2925,30
67262270499,67262270491,-8,100,701,30
67267452603,67267452599,-4,644,2113,30
67269189117,67269189111,-6,1234,3321,30
67270397015,67270397011,-4,1149,3323,30
67270953289,67270953286,-3,1619,2995,30
67271960372,67271960368,-4,1125,2706,30
67275721196,67275721191,-5,1414,2557,30
67275805037,67275805031,-6,1105,2544,30
67276024532,67276024529,-3,787,2388,30
67279673953,67279673949,-4,1093,1687,30
67283306623,67283306617,-6,1083,3720,30
67285538250,67285538245,-5,1116,3693,30
67292750813,67292750806,-7,1002,2751,30
67294715131,67294715125,-6,1041,2220,30
67295483741,67295483734,-7,950,3142,30
67301031488,67301031482,-6,962,3118,30
67304412206,67304412212,6,1631,34431,30
67315316447,67315316441,-6,1198,2635,30
67315715686,67315715686,0,1207,1590,30
67317945990,67317945985,-5,977,2751,30
67318455022,67318455018,-4,1016,2816,30
67318790289,67318790286,-3,644,2223,30
67322188144,67322188141,-3,1131,2439,30
67323214334,67323214330,-4,740,2663,30
67325730754,67325730751,-3,1168,2701,30
67332105607,67332105602,-5,995,2205,30
67340111795,67340111790,-5,948,2428,30
67342968831,67342968829,-2,797,2168,30
67343101788,67343101781,-7,1033,3247,30
67343518739,67343518755,16,954,4081,30
67347783385,67347783388,3,1076,1879,30
67348379524,67348379538,14,876,1902,30
67356623807,67356623802,-5,1014,2787,30
67357604772,67357604766,-6,1177,2964,30
67358991355,67358991352,-3,906,2488,30
67359303829,67359303825,-4,1161,2791,30
67367927649,67367927645,-4,1177,2295,30
67370515856,67370515850,-6,702,2854,30
67373442350,67373442343,-7,1226,3061,30
67373748896,67373748878,-18,888,3561,30
67374446936,67374446936,0,1168,922,30
67377046343,67377046347,4,2897,1327,30
67387406200,67387406195,-5,1405,3945,30
67391772059,67391772054,-5,705,2019,30
67392231972,67392231968,-4,1010,1898,30
67393001394,67393001390,-4,884,3199,30
67393560493,67393560493,0,1251,2414,30
67400679011,67400679006,-5,1527,3614,30
67403739769,67403739765,-4,889,3120,30
67404342987,67404342985,-2,1000,2933,30
67412982986,67412982994,8,4190,1871,30
67419487586,67419487581,-5,1205,4576,30
67427972218,67427972215,-3,1078,2657,30
67429790927,67429790923,-4,964,2362,30
67429858498,67429858496,-2,972,3854,30
67431080690,67431080694,4,3394,2986,30
67431390121,67431390118,-3,1125,3667,30
67434731175,67434731170,-5,954,3636,30
67435432755,67435432754,-1,1296,2233,30
67439247687,67439247681,-6,1035,3392,30
67440216498,67440216493,-5,1227,2573,30
67440559818,67440559807,-11,245,1306,30
67442517244,67442517245,1,877,1284,30
67443135810,67443135805,-5,1104,2163,30
67446402340,67446402334,-6,927,2816,30
67448029789,67448029784,-5,721,2937,30
67448164450,67448164470,20,1396,3286,30
67450225162,67450225158,-4,1370,4028,30
67453018288,67453018285,-3,840,3011,30
67459221074,67459221069,-5,1086,2690,30
67460024421,67460024417,-4,1286,2688,30
67469948949,67469948942,-7,1309,3860,30
67472390548,67472390547,-1,1403,1506,30
67474740836,67474740838,2,2080,1631,30
67474819272,67474819267,-5,1007,4148,30
67475216691,67475216711,20,1050,2490,30
67475944449,67475944445,-4,987,2688,30
67485189983,67485189988,5,4677,2531,30
67485969424,67485969419,-5,970,2980,30
67495253359,67495253355,-4,1174,3405,30
67499836322,67499836318,-4,781,2704,30
67500394751,67500394745,-6,786,4340,30
67502992326,67502992322,-4,993,2728,30
67505313859,67505313855,-4,697,1028,30
67509326956,67509326954,-2,1309,2054,30
67510943439,67510943434,-5,1253,2722,30
67515020418,67515020413,-5,729,2821,30
67521386256,67521386253,-3,1287,2299,30
67527309562,67527309558,-4,1378,3264,30
67527480002,67527479994,-8,745,3642,30
67528619576,67528619589,13,804,2692,30
67536909550,67536909546,-4,1356,4596,30
67537987470,67537987466,-4,725,2278,30
67538825603,67538825602,-1,1611,2156,30
67542681908,67542681905,-3,1249,2566,30
67547115791,67547115785,-6,1045,2804,30
67547181956,67547181975,19,1155,2678,30
67548688119,67548688115,-4,646,1723,30
67549448334,67549448330,-4,691,1604,30
67551263002,67551262998,-4,1065,3247,30
67551341408,67551341388,-20,139,1203,30
67554914989,67554914984,-5,1163,3557,30
67555605226,67555605222,-4,1084,2634,30
67558913718,67558913705,-13,1033,3192,30
67562935519,67562935517,-2,1246,1699,30
67565085879,67565085873,-6,1440,3459,30
67577691966,67577691962,-4,616,2234,30
67579142785,67579142803,18,1206,2998,30
67584450209,67584450206,-3,978,2555,30
67584641459,67584641454,-5,1575,5007,30
67587496023,67587496018,-5,1367,4112,30
67588345082,67588345079,-3,874,3106,30
67594053589,67594053585,-4,809,2095,30
67600419226,67600419220,-6,1207,1679,30
67601480684,67601480681,-3,813,2778,30
67605104119,67605104114,-5,1119,2060,30
67609634114,67609634109,-5,1244,2343,30
67613742012,67613742018,6,2957,1399,30
67617368754,67617368751,-3,920,2068,30
67617783466,67617783462,-4,500,2145,30
67620858255,67620858255,0,1299,1401,30
67622557586,67622557582,-4,1020,1601,30
67624346628,67624346625,-3,1108,2766,30
67627084557,67627084551,-6,944,2831,30
67627182347,67627182341,-6,1094,3639,30
67629853511,67629853505,-6,1324,2860,30
67630752921,67630752914,-7,1004,2993,30
67632539100,67632539117,17,421,5593,30
67633506514,67633506511,-3,1230,2998,30
67635827330,67635827326,-4,1105,2904,30
67641763857,67641763851,-6,785,2526,30
67643835610,67643835608,-2,1281,2811,30
67645298300,67645298297,-3,887,1774,30
67647098901,67647098895,-6,1302,2936,30
67650479751,67650479745,-6,1597,6020,30
67651348143,67651348142,-1,1948,1926,30
67654581251,67654581247,-4,761,1762,30
67655617931,67655617945,14,36,1182,30
67662817110,67662817107,-3,684,1425,30
67663177072,67663177066,-6,925,2932,30
67674519130,67674519125,-5,1346,4917,30
67676339520,67676339515,-5,722,2335,30
67678663466,67678663460,-6,1426,2958,30
67679820930,67679820926,-4,597,1813,30
67687413126,67687413120,-6,1631,2974,30
67687600146,67687600145,-1,1120,2075,30
67689108118,67689108129,11,12186,43057,30
67689374601,67689374595,-6,735,1938,30
67696250262,67696250257,-5,1148,3322,30
67696904967,67696904966,-1,988,1953,30
67699113889,67699113885,-4,1059,2161,30
67700330026,67700330021,-5,871,1978,30
67702325197,67702325192,-5,1436,3440,30
67709246571,67709246577,6,2636,723,30
67712063462,67712063463,1,1389,2046,30
67712123627,67712123606,-21,1206,2341,30
67713828329,67713828330,1,1498,1436,30
67718759207,67718759202,-5,1271,2856,30
67720302559,67720302566,7,2827,1096,30
67731484182,67731484177,-5,1309,2176,30
67732409545,67732409541,-4,1328,3727,30
67735815464,67735815459,-5,1412,2613,30
67738574403,67738574398,-5,980,3566,30
67740418982,67740418976,-6,904,2382,30
67748940902,67748940898,-4,1112,2725,30
67751784191,67751784188,-3,844,3618,30
67752385969,67752385967,-2,859,2144,30
67753544799,67753544807,8,9634,16108,30
67754193010,67754193006,-4,1102,2086,30
67755924503,67755924499,-4,1286,3255,30
67759833302,67759833298,-4,1076,2445,30
67761452168,67761452165,-3,852,2888,30
67768866114,67768866109,-5,1402,3338,30
67775967509,67775967510,1,2250,1925,30
67781606599,67781606592,-7,1088,4468,30
67783670903,67783670898,-5,1166,2370,30
67785776137,67785776134,-3,1063,2757,30
67786651491,67786651483,-8,1417,4185,30
67792458730,67792458725,-5,1309,2929,30
67794010986,67794010983,-3,1302,3100,30
67798669994,67798669990,-4,873,2982,30
67799593810,67799593808,-2,902,2172,30
67801308247,67801308254,7,2672,1082,30
67802519210,67802519206,-4,1293,2448,30
67802691747,67802691743,-4,1020,2152,30
67803539010,67803539005,-5,1078,4331,30
67812485221,67812485217,-4,731,2793,30
67814713994,67814713989,-5,980,2529,30
67815486097,67815486110,13,574,2834,30
67818050615,67818050612,-3,1019,2869,30
67821606994,67821606991,-3,1130,2027,30
67826379375,67826379371,-4,526,1397,30
67829881270,67829881266,-4,542,1830,30
67835442577,67835442571,-6,852,3593,30
67835965227,67835965215,-12,910,2802,30
67837158666,67837158669,3,1853,1018,30
67839133732,67839133726,-6,1008,5612,30
67839541066,67839541061,-5,742,2721,30
67841592934,67841592929,-5,1177,4051,30
67843538582,67843538578,-4,804,3450,30
67846411560,67846411557,-3,765,1912,30
67847669530,67847669525,-5,811,1757,30
67852141872,67852141867,-5,992,3758,30
67861874494,67861874489,-5,931,2826,30
67863319923,67863319918,-5,967,2857,30
67865277169,67865277165,-4,959,2990,30
67868638261,67868638255,-6,1443,3462,30
67873019061,67873019057,-4,1174,2082,30
67873746869,67873746853,-16,990,1967,30
67876978749,67876978743,-6,853,2407,30
67877252526,67877252521,-5,979,2990,30
67878061797,67878061793,-4,1192,3577,30
67891731111,67891731106,-5,884,2696,30
67892495231,67892495225,-6,703,1888,30
67893816873,67893816868,-5,1387,2673,30
67895340043,67895340037,-6,880,2832,30
67896902199,67896902194,-5,980,2626,30
67898072378,67898072374,-4,740,1540,30
67905092994,67905092990,-4,742,3023,30
67905212747,67905212742,-5,1252,2648,30
67909062644,67909062637,-7,1045,5115,30
67909901298,67909901294,-4,1267,2925,30
67912324986,67912324978,-8,1039,4449,30
67914506381,67914506377,-4,1029,2574,30
67916725028,67916725024,-4,1234,2131,30
67922237155,67922237152,-3,1444,3595,30
67922698547,67922698541,-6,837,3257,30
67922749833,67922749831,-2,1298,2843,30
67925677979,67925677975,-4,1006,2116,30
67929034166,67929034162,-4,998,3226,30
67941589662,67941589657,-5,1283,3785,30
67941648880,67941648874,-6,1170,3644,30
67942538078,67942538074,-4,1396,2673,30
67942598478,67942598471,-7,1343,6910,30
67946759246,67946759242,-4,793,3252,30
67950173810,67950173806,-4,1125,2017,30
67963923418,67963923417,-1,992,1873,30
67972196628,67972196622,-6,1004,3153,30
67977387815,67977387810,-5,668,2246,30
67980966246,67980966241,-5,1496,4163,30
67982865156,67982865149,-7,1714,5909,30
67983454762,67983454781,19,364,2035,30
67984097754,67984097752,-2,2461,4973,30
67988939311,67988939310,-1,1454,1466,30
67991796974,67991796971,-3,875,1869,30
67998523497,67998523489,-8,1173,3697,30
68003602187,68003602182,-5,730,2104,30
68005413767,68005413762,-5,881,2431,30
68006026750,68006026747,-3,1085,3429,30
68006856861,68006856858,-3,813,1870,30
68007141010,68007141004,-6,1102,2115,30
68008840389,68008840386,-3,856,3012,30
68009132824,68009132821,-3,989,2073,30
68010290080,68010290098,18,833,2536,30
68011555593,68011555589,-4,964,2975,30
68015835710,68015835705,-5,660,2524,30
68016927776,68016927762,-14,2559,4150,30
68017355043,68017355046,3,1481,1112,30
68021885502,68021885498,-4,1264,2633,30
68037805284,68037805279,-5,1010,2834,30
68039833334,68039833322,-12,160,710,30
68041776921,68041776915,-6,890,2597,30
68063946215,68063946211,-4,697,3280,30
68064250746,68064250742,-4,1315,3016,30
68065255662,68065255658,-4,762,3014,30
68070661458,68070661462,4,1494,1467,30
68072859002,68072858998,-4,1055,2551,30
68075247478,68075247473,-5,778,2664,30
68075483485,68075483479,-6,804,2578,30
68076781747,68076781745,-2,895,1761,30
68078663503,68078663500,-3,1267,2980,30
68080131078,68080131075,-3,984,2225,30
68083730359,68083730355,-4,1240,2027,30
68083995253,68083995249,-4,1016,2807,30
68084979714,68084979710,-4,1078,2732,30
68091625823,68091625818,-5,788,3944,30
68092138962,68092138978,16,343,2169,30
68102323454,68102323451,-3,718,2788,30
68102375939,68102375953,14,187,1376,30
68102990438,68102990433,-5,1030,2325,30
68105946183,68105946190,7,4638,2547,30
68106203018,68106203015,-3,937,2492,30
68112194091,68112194086,-5,650,2229,30
68115814950,68115814946,-4,1077,3264,30
68117808990,68117808984,-6,522,2637,30
68127170708,68127170703,-5,34493,12237,30
68127200397,68127200391,-6,990,4648,30
68134370898,68134370894,-4,762,3287,30
68135465005,68135464999,-6,1533,3808,30
68135558432,68135558450,18,707,3094,30
68138884844,68138884835,-9,16453,27573,30
68142438249,68142438242,-7,892,3458,30
68146661538,68146661534,-4,910,2331,30
68148008271,68148008266,-5,906,3939,30
68152767638,68152767633,-5,1256,2203,30
68156412428,68156412418,-10,79,860,30
68163562920,68163562917,-3,1100,2055,30
68165491042,68165491039,-3,1442,3663,30
68166991349,68166991344,-5,926,3166,30
68168180943,68168180938,-5,1222,2925,30
68168857136,68168857154,18,485,1774,30
68178533681,68178533687,6,3067,1047,30
68179514719,68179514713,-6,965,2266,30
68181638983,68181638978,-5,811,3240,30
68182588814,68182588809,-5,1159,4128,30
68184848369,68184848364,-5,1416,3942,30
68188812001,68188812007,6,2689,1407,30
68190763919,68190763912,-7,977,2732,30
68201274566,68201274559,-7,817,3656,30
68204137042,68204137036,-6,1142,3125,30
68205351276,68205351285,9,380,10020,30
68207398410,68207398406,-4,1107,3066,30
68210174437,68210174445,8,13542,27339,30
68213133631,68213133626,-5,1241,2493,30
68216266722,68216266729,7,6169,2422,30
68216456479,68216456475,-4,424,3176,30
68217199392,68217199387,-5,549,2653,30
68223285406,68223285402,-4,1149,1811,30
68224193619,68224193614,-5,899,2468,30
68224224914,68224224912,-2,943,1264,30
68226966734,68226966729,-5,968,2595,30
68231216234,68231216234,0,1247,2288,30
68233308803,68233308798,-5,21499,16371,30
68236195398,68236195390,-8,924,2983,30
68236325019,68236325014,-5,591,2751,30
68236375729,68236375750,21,634,2147,30
68240713805,68240713810,5,2057,1723,30
68242733309,68242733303,-6,1728,4976,30
68248162426,68248162426,0,1743,1624,30
68254422796,68254422793,-3,52,429,30
68254868446,68254868444,-2,689,1935,30
68256609210,68256609207,-3,1176,2558,30
68259896752,68259896747,-5,1185,2964,30
68262834580,68262834575,-5,1251,3399,30
68269222245,68269222241,-4,817,2084,30
68271921536,68271921529,-7,1102,2551,30
68274856217,68274856213,-4,888,1902,30
68277098827,68277098818,-9,744,177,30
68281582234,68281582226,-8,878,2671,30
68281978802,68281978809,7,5346,2332,30
68287580483,68287580481,-2,825,2386,30
68292204188,68292204184,-4,1073,3334,30
68297370933,68297370928,-5,1597,4017,30
68298207507,68298207503,-4,759,2502,30
68298244731,68298244743,12,328,1256,30
68306479926,68306479923,-3,1026,2504,30
68307497937,68307497930,-7,1187,3728,30
68307608055,68307608049,-6,948,3148,30
68308291019,68308291019,0,3418,3862,30
68308620158,68308620153,-5,1352,4361,30
68309055394,68309055409,15,569,2476,30
68312116190,68312116185,-5,1036,2984,30
68312767403,68312767401,-2,889,2041,30
68313969730,68313969723,-7,1644,5571,30
68314345674,68314345679,5,3108,1556,30
68317085694,68317085689,-5,918,2820,30
68318620691,68318620690,-1,1279,1653,30
68318848767,68318848762,-5,986,2178,30
68319205546,68319205542,-4,1044,3516,30
68325118385,68325118382,-3,903,2464,30
68333458474,68333458471,-3,637,2345,30
68340252542,68340252540,-2,1382,1947,30
68343408205,68343408200,-5,1322,2880,30
68343792130,68343792119,-11,117,1026,30
68344618818,68344618813,-5,594,3877,30
68345730696,68345730693,-3,1474,1945,30
68346355903,68346355899,-4,1355,2375,30
68347501427,68347501422,-5,1060,2642,30
68347563739,68347563734,-5,1177,3427,30
68348131696,68348131714,18,368,1615,30
68349198628,68349198647,19,119,1133,30
68353700030,68353700022,-8,672,3417,30
68358260415,68358260410,-5,1048,2804,30
68358522133,68358522126,-7,1724,7538,30
68361947487,68361947482,-5,1496,3737,30
68363069695,68363069690,-5,1076,3154,30
68365553164,68365553158,-6,823,3256,30
68366429667,68366429660,-7,78,584,30
68368408526,68368408522,-4,1192,3785,30
68372699788,68372699783,-5,930,2352,30
68373166667,68373166663,-4,823,3050,30
68373278794,68373278790,-4,1081,3065,30
68376332002,68376331999,-3,1399,2695,30
68376929536,68376929535,-1,1767,2243,30
68379610397,68379610398,1,2345,1458,30
68381135236,68381135237,1,22998,20330,30
68385894443,68385894437,-6,935,3093,30
68385954369,68385954390,21,847,2608,30
68388772063,68388772056,-7,781,2825,30
68392771970,68392771965,-5,1055,3261,30
68397247488,68397247484,-4,1310,2958,30
68398057026,68398057022,-4,792,2888,30
68398123144,68398123160,16,467,2229,30
68401343495,68401343490,-5,1000,2147,30
68402195494,68402195500,6,60533,106202,30
68403193995,68403193990,-5,1438,3070,30
68403830453,68403830449,-4,1068,3155,30
68414316238,68414316234,-4,873,2603,30
68415567264,68415567263,-1,1301,1483,30
68415857409,68415857404,-5,827,3057,30
68421344949,68421344953,4,2558,1569,30
68423132064,68423132060,-4,962,2422,30
68423733625,68423733638,13,169,1155,30
68424839861,68424839862,1,5563,6267,30
68426938451,68426938446,-5,1047,3233,30
68429216267,68429216261,-6,1307,2747,30
68439028316,68439028313,-3,1691,3756,30
68440430186,68440430183,-3,1005,2350,30
68443600141,68443600145,4,3491,1864,30
68450657541,68450657537,-4,683,3245,30
68453689224,68453689225,1,1224,2858,30
68455079825,68455079820,-5,1092,3643,30
68456648713,68456648709,-4,727,2668,30
68459575795,68459575790,-5,808,1968,30
68460937194,68460937177,-17,932,2481,30
68462994950,68462994946,-4,681,1330,30
68463248905,68463248902,-3,821,2505,30
68463968461,68463968453,-8,1070,8732,30
68464151986,68464151970,-16,1190,3708,30
68464340218,68464340198,-20,936,3272,30
68471698651,68471698647,-4,839,2746,30
68476555704,68476555699,-5,1253,2617,30
68482916452,68482916447,-5,1201,2192,30
68489216952,68489216950,-2,1248,3421,30
68491013642,68491013639,-3,712,1453,30
68492683473,68492683470,-3,1293,3892,30
68495410375,68495410371,-4,611,3458,30
68496094463,68496094458,-5,704,2950,30
68496434755,68496434773,18,1298,2652,30
68497971171,68497971169,-2,1118,2924,30
68498088500,68498088495,-5,1036,3412,30
68501661938,68501661935,-3,888,2216,30
68505464900,68505464905,5,2515,1303,30
68507278503,68507278497,-6,1786,8000,30
68513579851,68513579846,-5,816,4078,30
68514721090,68514721095,5,1923,913,30
68517794651,68517794649,-2,748,1823,30
68518941194,68518941203,9,13352,23138,30
68519653783,68519653778,-5,759,2233,30
68524248759,68524248751,-8,569,2129,30
68529034805,68529034801,-4,845,1841,30
68531150450,68531150443,-7,939,3219,30
68531713897,68531713882,-15,316,1107,30
68533535506,68533535500,-6,1171,3284,30
68534056149,68534056143,-6,1258,3554,30
68535117401,68535117421,20,844,2509,30
68535918834,68535918829,-5,1307,3990,30
68536193142,68536193137,-5,660,1577,30
68536606306,68536606303,-3,1623,3328,30
68539869230,68539869225,-5,1551,3540,30
68540145824,68540145847,23,57,591,30
68548885719,68548885714,-5,907,2449,30
68548980252,68548980264,12,770,4231,30
68551701964,68551701958,-6,1224,2594,30
68556316950,68556316945,-5,940,1996,30
68561244069,68561244068,-1,1310,2511,30
68561828997,68561828994,-3,1104,3135,30
68565229076,68565229071,-5,1275,4540,30
68565890006,68565890002,-4,1144,3264,30
68566064130,68566064125,-5,1521,4062,30
68567545436,68567545434,-2,1551,3266,30
68568295036,68568295036,0,24018,12075,30
68573592789,68573592785,-4,592,2136,30
68574821442,68574821437,-5,18303,15849,30
68575300684,68575300682,-2,949,2326,30
68576503227,68576503234,7,2491,1099,30
68577997906,68577997903,-3,1083,1887,30
68584589675,68584589671,-4,1037,3022,30
68594425738,68594425733,-5,1018,2563,30
68594468289,68594468273,-16,236,507,30
68596537693,68596537691,-2,1126,2682,30
68599238994,68599238989,-5,1163,3354,30
68599446572,68599446565,-7,30771,15161,30
68602531994,68602531997,3,2525,3017,30
68603409510,68603409506,-4,991,3233,30
68605399564,68605399558,-6,1192,2127,30
68610917264,68610917260,-4,957,2346,30
68612680364,68612680362,-2,874,1949,30
68618334835,68618334830,-5,1288,4467,30
68621319799,68621319795,-4,1052,3467,30
68622444259,68622444253,-6,889,2406,30
68624070609,68624070607,-2,1069,1568,30
68625409155,68625409150,-5,1187,2667,30
68625883998,68625884004,6,3001,1375,30
68629113093,68629113092,-1,2753,4245,30
68630518183,68630518179,-4,780,2149,30
68630622778,68630622775,-3,1003,1865,30
68631120959,68631120957,-2,1146,1539,30
68631735733,68631735738,5,3198,1272,30
68633553033,68633553026,-7,2003,7839,30
68634314971,68634314966,-5,1796,3823,30
68638315148,68638315146,-2,2350,4317,30
68638517243,68638517239,-4,1215,4741,30
68646492939,68646492939,0,1052,1225,30
68646848929,68646848926,-3,754,2444,30
68648245308,68648245302,-6,875,2989,30
68648707130,68648707127,-3,1244,3091,30
68649730110,68649730118,8,91291,39160,30
68651787116,68651787120,4,5539,3619,30
68652163674,68652163669,-5,713,2047,30
68653225039,68653225032,-7,736,3445,30
68653322861,68653322857,-4,1330,2168,30
68659334185,68659334184,-1,25709,6605,30
68663168974,68663168972,-2,1020,2783,30
68663299843,68663299838,-5,1617,3367,30
68667127678,68667127674,-4,1222,3663,30
68667989142,68667989146,4,43461,35747,30
68676177402,68676177401,-1,1239,1163,30
68686948871,68686948866,-5,523,2777,30
68691890067,68691890062,-5,992,2637,30
68695694641,68695694640,-1,1319,2336,30
68695770329,68695770327,-2,1234,3414,30
68696822549,68696822554,5,2311,1678,30
68720174720,68720174720,0,3428,3867,30
68729449017,68729449011,-6,938,3001,30
68731776018,68731775997,-21,998,467,30
68736474072,68736474068,-4,950,2149,30
68737399681,68737399667,-14,94,1027,30
68738523544,68738523539,-5,1274,3923,30
68741273851,68741273848,-3,678,1760,30
68742560370,68742560373,3,3417,2549,30
68744263425,68744263422,-3,672,1900,30
68748609035,68748609034,-1,779,62,30
68752514509,68752514506,-3,1324,3918,30
68754623152,68754623147,-5,973,2791,30
68759770203,68759770201,-2,788,2642,30
68765297413,68765297414,1,1964,2057,30
68776724656,68776724650,-6,1195,3376,30
68779751645,68779751644,-1,671,1694,30
68780196015,68780196009,-6,1186,3236,30
68794933295,68794933290,-5,1058,3042,30
68797759757,68797759753,-4,1153,2545,30
68799617016,68799617011,-5,1506,2616,30
68804158558,68804158553,-5,813,1994,30
68805433937,68805433930,-7,1016,2651,30
68806410422,68806410417,-5,1069,2286,30
68806554921,68806554908,-13,832,2721,30
68807097834,68807097829,-5,692,2679,30
68808210663,68808210659,-4,1001,2944,30
68814820275,68814820269,-6,977,1740,30
68815546202,68815546197,-5,1277,3480,30
68818677723,68818677718,-5,1053,3483,30
68820114134,68820114129,-5,1064,2769,30
68821806045,68821806041,-4,1334,3374,30
68823208897,68823208892,-5,1095,4021,30
68830947090,68830947083,-7,1538,4720,30
68831671681,68831671678,-3,836,2022,30
68841682563,68841682558,-5,869,3383,30
68841993701,68841993698,-3,1204,2178,30
68843282966,68843282961,-5,982,2820,30
68850935148,68850935155,7,1830,1125,30
68852776739,68852776734,-5,955,1943,30
68855942014,68855942009,-5,1209,3045,30
68867297090,68867297082,-8,1127,3420,30
68867985339,68867985357,18,879,2898,30
68873374308,68873374303,-5,1074,3580,30
68873531690,68873531685,-5,1333,3341,30
68874248589,68874248586,-3,993,3383,30
68874319169,68874319162,-7,364,1760,30
68878506285,68878506278,-7,2227,7364,30
68879100716,68879100711,-5,1197,4029,30
68879153539,68879153557,18,719,3766,30
68884273494,68884273499,5,3027,2321,30
68891290245,68891290238,-7,1206,3223,30
68891569577,68891569599,22,341,1052,30
68892598786,68892598780,-6,1267,3974,30
68892797914,68892797898,-16,977,2665,30
68899577874,68899577870,-4,1242,3805,30
68902032436,68902032445,9,99,1122,30
68912288188,68912288184,-4,891,3562,30
68913861238,68913861232,-6,1338,2935,30
68919544666,68919544670,4,3554,1873,30
68920544275,68920544269,-6,1766,3999,30
68921461782,68921461777,-5,1327,2947,30
68924506482,68924506487,5,3014,1726,30
68925793867,68925793861,-6,1175,3159,30
68934622283,68934622278,-5,1157,3420,30
68944844771,68944844768,-3,758,3121,30
68959249547,68959249538,-9,1113,4330,30
68964257934,68964257930,-4,1321,3479,30
68964955969,68964955950,-19,870,2258,30
68968459216,68968459213,-3,526,1509,30
68968665593,68968665610,17,807,3259,30
68971120296,68971120298,2,1549,931,30
68975040497,68975040494,-3,899,2954,30
68977564046,68977564043,-3,552,1492,30
68977961986,68977961965,-21,984,3033,30
68978834939,68978834958,19,569,1741,30
68984297913,68984297918,5,1863,872,30
68986834719,68986834722,3,1804,1538,30
68987097735,68987097730,-5,971,2393,30
68988612761,68988612757,-4,1161,2675,30
68992270953,68992270950,-3,1033,3713,30
68992464894,68992464886,-8,736,2465,30
68999038615,68999038611,-4,742,2282,30
68999696808,68999696827,19,377,1435,30
69002499565,69002499562,-3,1220,2758,30
69004619773,69004619770,-3,2236,2412,30
69005395353,69005395349,-4,1145,3270,30
69007292705,69007292698,-7,1230,2988,30
69009525591,69009525589,-2,1180,2565,30
69009694746,69009694741,-5,1148,3382,30
69010873782,69010873782,0,1728,1781,30
69012505920,69012505915,-5,851,2625,30
69012926761,69012926756,-5,1442,3001,30
69022182391,69022182389,-2,1065,1886,30
69028567150,69028567146,-4,951,2029,30
69029760447,69029760441,-6,1016,3184,30
69032354636,69032354641,5,769,1313,30
69033932499,69033932493,-6,837,3464,30
69034127365,69034127361,-4,1233,2885,30
69034191177,69034191172,-5,963,3043,30
69035781227,69035781222,-5,859,2761,30
69036345754,69036345758,4,3072,2501,30
69037374191,69037374184,-7,1012,3144,30
69038013984,69038013983,-1,1205,2105,30
69041463554,69041463550,-4,1224,4098,30
69043618888,69043618882,-6,1090,4362,30
69052740284,69052740280,-4,930,2891,30
69053464346,69053464341,-5,965,2889,30
69056702865,69056702861,-4,901,2978,30
69057136147,69057136142,-5,945,3154,30
69057209558,69057209553,-5,1011,1808,30
69061906553,69061906551,-2,1104,1437,30
69062372040,69062372035,-5,1123,3739,30
69062711478,69062711481,3,1355,20129,30
69064782774,69064782766,-8,608,1410,30
69065883165,69065883163,-2,972,1541,30
69066224515,69066224531,16,990,1631,30
69066407000,69066406989,-11,1068,4241,30
69068025599,69068025592,-7,1361,3539,30
69071697613,69071697607,-6,765,1935,30
69074493106,69074493114,8,2768,1168,30
69076503187,69076503182,-5,917,2551,30
69081529350,69081529349,-1,904,1140,30
69087160793,69087160795,2,1510,1339,30
69088631969,69088631965,-4,846,2458,30
69089193933,69089193929,-4,1630,3757,30
69090909834,69090909829,-5,1136,2733,30
69091286131,69091286146,15,704,3599,30
69093161704,69093161699,-5,1509,4266,30
69094380735,69094380730,-5,1275,2639,30
69096077325,69096077321,-4,846,2531,30
69097460050,69097460054,4,2290,1805,30
69099114605,69099114601,-4,1001,2992,30
69101991822,69101991820,-2,1070,1992,30
69103784298,69103784294,-4,720,2575,30
69112295459,69112295453,-6,1345,3455,30
69129941070,69129941066,-4,1094,2896,30
69130246224,69130246247,23,271,1132,30
69130587211,69130587206,-5,1044,2853,30
69133967835,69133967828,-7,835,2895,30
69139174155,69139174150,-5,967,2598,30
69139996754,69139996751,-3,191,1129,30
69144962771,69144962767,-4,1190,2728,30
69152376138,69152376132,-6,2009,6122,30
69154222598,69154222594,-4,1251,3266,30
69163362167,69163362161,-6,908,2841,30
69163593165,69163593159,-6,1113,3115,30
69169479344,69169479341,-3,1253,2607,30
69169731578,69169731573,-5,850,2702,30
69170067507,69170067498,-9,827,2635,30
69170822666,69170822681,15,1234,3021,30
69171491870,69171491868,-2,643,2020,30
69172637347,69172637341,-6,754,2391,30
69173286482,69173286478,-4,1081,2068,30
69173647214,69173647209,-5,837,1906,30
69174439398,69174439395,-3,1179,3232,30
69175470547,69175470542,-5,744,2385,30
69175609627,69175609615,-12,1037,3467,30
69182013561,69182013557,-4,1211,2847,30
69184921683,69184921679,-4,1271,3681,30
69187395741,69187395738,-3,1023,2660,30
69187685475,69187685472,-3,962,2201,30
69189255811,69189255807,-4,1011,2820,30
69192089327,69192089326,-1,1407,1902,30
69197570250,69197570246,-4,928,1788,30
69198211047,69198211042,-5,1261,3207,30
69216143490,69216143486,-4,1311,3280,30
69218081962,69218081958,-4,1062,3424,30
69218964615,69218964610,-5,1175,2594,30
69220878933,69220878930,-3,932,2605,30
69226952066,69226952058,-8,669,2865,30
69227370076,69227370054,-22,275,1824,30
69228418142,69228418138,-4,1227,3118,30
69228605418,69228605414,-4,1269,3308,30
69232634701,69232634697,-4,955,2093,30
69235548126,69235548121,-5,1267,2477,30
69241548406,69241548412,6,3276,1442,30
69242545721,69242545717,-4,977,2890,30
69252620664,69252620659,-5,1201,2490,30
69252779283,69252779262,-21,117,1202,30
69256723455,69256723450,-5,1168,2882,30
69260180090,69260180090,0,1409,2464,30
69260649074,69260649072,-2,1052,2231,30
69266162919,69266162914,-5,1244,3407,30
69273845579,69273845572,-7,1064,2498,30
69277760839,69277760834,-5,1092,3581,30
69280451229,69280451230,1,1445,2050,30
69293573697,69293573691,-6,1342,3142,30
69294747083,69294747078,-5,996,3554,30
69294872532,69294872551,19,157,991,30
69302741586,69302741582,-4,869,2585,30
69305813187,69305813184,-3,1105,2387,30
69306437891,69306437888,-3,1155,2356,30
69307144270,69307144274,4,1800,1345,30
69308979599,69308979594,-5,1297,4279,30
69310630236,69310630230,-6,858,2249,30
69312103221,69312103213,-8,1243,3389,30
69322594618,69322594611,-7,703,2214,30
69324791498,69324791492,-6,998,2099,30
69325073561,69325073557,-4,1038,2701,30
69327022335,69327022331,-4,820,2149,30
69334951767,69334951762,-5,1133,2379,30
69336477705,69336477701,-4,1286,3025,30
69338745762,69338745758,-4,1087,2831,30
69347257547,69347257544,-3,1224,3867,30
69348737142,69348737142,0,966,1128,30
69349699467,69349699456,-11,662,2166,30
69350127985,69350128007,22,96,1226,30
69351868219,69351868221,2,1273,1876,30
69353584581,69353584577,-4,945,2890,30
69353844377,69353844395,18,159,816,30
69360943454,69360943449,-5,1280,2732,30
69361618162,69361618156,-6,1035,3569,30
69364482358,69364482349,-9,1352,4758,30
69368611906,69368611901,-5,1322,2634,30
69374982595,69374982591,-4,1314,2816,30
69389936956,69389936962,6,2776,1557,30
69391772585,69391772581,-4,579,2451,30
69392235330,69392235323,-7,1669,8894,30
69396664635,69396664629,-6,987,2897,30
69401500633,69401500629,-4,1104,2655,30
69401794166,69401794166,0,1106,1893,30
69407682278,69407682277,-1,604,2237,30
69408131153,69408131146,-7,939,2129,30
69409106010,69409106025,15,417,1105,30
69409250362,69409250357,-5,937,2636,30
69418079049,69418079041,-8,1374,4140,30
69418575059,69418575056,-3,1222,2582,30
69432829274,69432829270,-4,1085,3363,30
69433611485,69433611479,-6,960,3861,30
69434590350,69434590344,-6,1072,5555,30
69442353864,69442353858,-6,1168,2933,30
69444726549,69444726552,3,13256,20634,30
69457824075,69457824070,-5,930,2234,30
69461528356,69461528362,6,2934,1297,30
69463509655,69463509657,2,1002,1516,30
69468314698,69468314694,-4,891,1913,30
69469931915,69469931910,-5,780,2708,30
69471444286,69471444282,-4,1125,2991,30
69472845571,69472845590,19,810,2039,30
69475944559,69475944555,-4,1046,3308,30
69481148679,69481148677,-2,1591,3519,30
69484438412,69484438417,5,2529,1546,30
69490744582,69490744577,-5,1213,2741,30
69491837994,69491837989,-5,711,3689,30
69493850872,69493850869,-3,1258,2701,30
69494580095,69494580093,-2,1062,2323,30
69497167390,69497167386,-4,1425,2407,30
69498091914,69498091908,-6,1008,3441,30
69506108922,69506108917,-5,963,2442,30
69507848839,69507848834,-5,1524,3559,30
69508876303,69508876301,-2,706,988,30
69520557137,69520557134,-3,1114,3174,30
69522250187,69522250181,-6,1571,2950,30
69533178923,69533178918,-5,1057,2125,30
69542172198,69542172194,-4,1090,3107,30
69549923862,69549923861,-1,1047,2712,30
69550682174,69550682170,-4,1154,3258,30
69552918386,69552918384,-2,1410,2515,30
69559264152,69559264148,-4,1135,2843,30
69559495538,69559495554,16,773,2550,30
69560462010,69560462004,-6,941,4615,30
69561665886,69561665882,-4,856,3439,30
69562514926,69562514921,-5,1068,2241,30
69567585191,69567585189,-2,970,2514,30
69571073349,69571073344,-5,1035,2633,30
69571555000,69571554985,-15,768,2821,30
69571934561,69571934553,-8,21,1118,30
69575942697,69575942692,-5,1000,2730,30
69581069679,69581069675,-4,773,3252,30
69585528991,69585528987,-4,823,1804,30
69588991546,69588991540,-6,1562,4798,30
69591181498,69591181494,-4,1321,2395,30
69591530001,69591529987,-14,203,639,30
69609165078,69609165073,-5,928,2242,30
69618462326,69618462321,-5,822,2693,30
69619999354,69619999367,13,573,1923,30
69634448011,69634448010,-1,742,2505,30
69634811233,69634811229,-4,887,1977,30
69637584072,69637584067,-5,1248,4593,30
69650410967,69650410971,4,1888,1317,30
69652101167,69652101163,-4,861,2202,30
69652383329,69652383338,9,73,872,30
69657592089,69657592082,-7,1109,2815,30
69659189174,69659189180,6,2094,1140,30
69662453081,69662453074,-7,920,3753,30
69664473101,69664473102,1,1032,1321,30
69666337186,69666337182,-4,1005,3206,30
69667276223,69667276218,-5,1050,2024,30
69668272050,69668272054,4,2571,2530,30
69670683181,69670683176,-5,1143,3517,30
69672419421,69672419415,-6,1059,4167,30
69672784533,69672784528,-5,1005,4537,30
69672855404,69672855417,13,798,3273,30
69682963976,69682963973,-3,1186,2480,30
69685406754,69685406743,-11,1133,3294,30
69690449591,69690449611,20,812,2031,30
69693788995,69693788992,-3,1117,1794,30
69694126167,69694126162,-5,854,3107,30
69706339647,69706339651,4,300,1080,30
69708601254,69708601250,-4,1272,2662,30
69709908412,69709908430,18,417,792,30
69714196083,69714196079,-4,1158,3054,30
69715116411,69715116427,16,464,808,30
69723514454,69723514454,0,2938,3489,30
69725979862,69725979857,-5,794,2500,30
69728907727,69728907723,-4,1177,2725,30
69730282177,69730282172,-5,1177,3190,30
69730333186,69730333181,-5,971,3374,30
69736192061,69736192057,-4,1124,2758,30
69738780474,69738780482,8,2110,1278,30
69739951945,69739951939,-6,1084,3541,30
69745498311,69745498307,-4,1409,3721,30
69747094586,69747094585,-1,2176,2735,30
69747938182,69747938178,-4,976,1733,30
69749054991,69749054986,-5,1340,4069,30
69751372022,69751372021,-1,1929,2304,30
69757170999,69757171002,3,1346,1039,30
69757613230,69757613231,1,1068,1109,30
69763053305,69763053302,-3,905,2844,30
69764133937,69764133930,-7,1183,6190,30
69768911029,69768911026,-3,1904,4721,30
69787294451,69787294446,-5,1163,2636,30
69787395706,69787395726,20,733,2253,30
69795521203,69795521198,-5,718,2051,30
69798000354,69798000359,5,1501,1203,30
69802598525,69802598525,0,1558,2683,30
69802706160,69802706156,-4,1101,3140,30
69803333682,69803333678,-4,782,2842,30
69804197128,69804197143,15,133,1290,30
69804536530,69804536534,4,5224,2226,30
69807771413,69807771420,7,5002,2215,30
69812108554,69812108551,-3,1110,3419,30
69813394071,69813394065,-6,617,2237,30
69818657170,69818657166,-4,1100,3523,30
69820712119,69820712119,0,1152,1673,30
69821563660,69821563670,10,114,550,30
69825669641,69825669637,-4,841,1821,30
69826253598,69826253596,-2,1119,2311,30
69830711542,69830711536,-6,1314,2827,30
69830942203,69830942218,15,855,2470,30
69835649044,69835649038,-6,944,2922,30
69837063283,69837063278,-5,1175,3519,30
69837986582,69837986581,-1,1020,1812,30
69838169291,69838169306,15,865,2938,30
69840086623,69840086622,-1,1191,1843,30
69847641112,69847641107,-5,115,929,30
69850582005,69850581997,-8,976,4799,30
69850963634,69850963628,-6,1614,2890,30
69851767434,69851767430,-4,825,2849,30
69852289072,69852289078,6,4771,2459,30
69856615143,69856615140,-3,800,2530,30
69859170607,69859170602,-5,728,2403,30
69862270707,69862270705,-2,1411,2651,30
69862411629,69862411624,-5,869,3802,30
69862835305,69862835306,1,1530,1958,30
69864163054,69864163049,-5,1051,3839,30
69865867484,69865867481,-3,1072,2886,30
69866105827,69866105844,17,271,743,30
69868152446,69868152444,-2,1163,1977,30
69868318971,69868318966,-5,1228,3558,30
69879389187,69879389183,-4,1378,3230,30
69882610581,69882610574,-7,1152,4005,30
69886771086,69886771081,-5,1279,3808,30
69887299631,69887299629,-2,1122,2111,30
69891751939,69891751934,-5,1032,2073,30
69894414151,69894414145,-6,1046,3495,30
69895328952,69895328975,23,296,1028,30
69900690355,69900690349,-6,845,3145,30
69900740563,69900740558,-5,1245,2968,30
69900914346,69900914365,19,722,2499,30
69904448710,69904448705,-5,953,2557,30
69913890175,69913890170,-5,1023,2827,30
69913922979,69913922993,14,681,3703,30
69921641970,69921641966,-4,1617,3089,30
69932103237,69932103233,-4,1220,2701,30
69933711839,69933711834,-5,675,1858,30
69936614776,69936614771,-5,1066,3372,30
69936850579,69936850596,17,1070,3560,30
69937905225,69937905206,-19,134,1181,30
69943923990,69943923990,0,1505,1577,30
69946769494,69946769482,-12,1509,4477,30
69952237650,69952237649,-1,966,2251,30
69952307533,69952307532,-1,954,2212,30
69956217723,69956217729,6,4192,2226,30
69958440033,69958440028,-5,1074,3060,30
69961506242,69961506234,-8,32371,12248,30
69964433106,69964433101,-5,1082,2387,30
69965155277,69965155274,-3,853,2943,30
69967641914,69967641913,-1,1013,2165,30
69968587394,69968587411,17,762,3408,30
69971462915,69971462910,-5,969,3075,30
69972313766,69972313770,4,2498,1119,30
69974157582,69974157578,-4,1266,1848,30
69984111239,69984111235,-4,1230,2263,30
69992340329,69992340326,-3,786,2433,30
69993246592,69993246578,-14,1265,3194,30
69993817289,69993817299,10,158,855,30
69999611852,69999611845,-7,708,2706,30
70002892823,70002892828,5,2511,1294,30
70012439437,70012439432,-5,903,2613,30
70016312220,70016312219,-1,1050,2739,30
70020428566,70020428562,-4,1308,3140,30
70023586015,70023586010,-5,947,1944,30
70025329702,70025329698,-4,870,3237,30
70032303117,70032303112,-5,894,1659,30
70035287771,70035287772,1,1684,2479,30
70051773425,70051773420,-5,920,2838,30
70054055481,70054055482,1,1096,881,30
70055761088,70055761105,17,758,2569,30
70070717122,70070717116,-6,1063,2884,30
70077075898,70077075894,-4,1044,2674,30
70080418517,70080418512,-5,833,3066,30
70080652602,70080652597,-5,1245,2265,30
70082253021,70082253015,-6,1490,4354,30
70083225198,70083225196,-2,18183,15252,30
70087858914,70087858909,-5,1098,3079,30
70096777143,70096777138,-5,914,2568,30
70098411233,70098411226,-7,1196,2656,30
70098646046,70098646042,-4,914,3231,30
70100275807,70100275801,-6,1499,2677,30
70105759311,70105759309,-2,1125,1536,30
70109814327,70109814326,-1,1416,1853,30
70112372698,70112372715,17,2322,179,30
70117066363,70117066358,-5,1106,2661,30
70128848658,70128848652,-6,536,3001,30
70129672639,70129672633,-6,1010,3256,30
70130040971,70130040969,-2,1545,2210,30
70130709629,70130709633,4,1687,1011,30
70135190147,70135190145,-2,1162,2645,30
70136659109,70136659103,-6,1278,4118,30
70137193131,70137193127,-4,784,2101,30
70137522421,70137522416,-5,909,2545,30
70138680847,70138680843,-4,707,2063,30
70139045522,70139045543,21,769,3289,30
70142917831,70142917823,-8,614,2443,30
70144221049,70144221046,-3,980,1962,30
70144463954,70144463949,-5,353,873,30
70146946569,70146946563,-6,917,2816,30
70148010176,70148010159,-17,812,2724,30
70148310314,70148310310,-4,1327,3432,30
70149150566,70149150560,-6,815,2808,30
70152402707,70152402719,12,177,975,30
70155400033,70155400030,-3,977,2474,30
70157339443,70157339438,-5,1176,2678,30
70157668581,70157668577,-4,918,2921,30
70159551938,70159551933,-5,1177,2568,30
70165981368,70165981365,-3,999,2082,30
70168784095,70168784090,-5,810,1294,30
70170243682,70170243677,-5,1232,2493,30
70176684052,70176684049,-3,1105,3895,30
70178793980,70178793974,-6,959,3065,30
70180976135,70180976130,-5,1185,3511,30
70189248703,70189248700,-3,961,1490,30
70199084855,70199084850,-5,1123,3444,30
70202036114,70202036112,-2,1041,2672,30
70207577791,70207577787,-4,728,2684,30
70207714564,70207714546,-18,26,570,30
70210022714,70210022708,-6,1131,4253,30
70210887888,70210887909,21,273,771,30
70214593562,70214593561,-1,748,1672,30
70216571683,70216571678,-5,1381,3133,30
70216744499,70216744492,-7,818,2949,30
70219337036,70219337032,-4,1612,3353,30
70219401522,70219401518,-4,1107,3678,30
70230051564,70230051569,5,2206,1812,30
70230196562,70230196556,-6,812,2442,30
70235193824,70235193826,2,1540,2212,30
70245775200,70245775197,-3,1008,2408,30
70246284854,70246284851,-3,847,2717,30
70255261774,70255261769,-5,1205,2577,30
70258845540,70258845521,-19,1434,1352,30
70261193998,70261193994,-4,959,2696,30
70265434253,70265434250,-3,1506,2565,30
70265772737,70265772734,-3,926,2520,30
70269579851,70269579844,-7,828,1639,30
70273010079,70273010074,-5,1203,3379,30
70277453081,70277453087,6,10507,3998,30
70282620903,70282620900,-3,1206,2733,30
70282699657,70282699665,8,4700,1698,30
70285608406,70285608402,-4,451,975,30
70288835466,70288835462,-4,1361,3250,30
70290778645,70290778641,-4,1303,2812,30
70291100997,70291100993,-4,944,2365,30
70298281427,70298281422,-5,755,2408,30
70300216152,70300216145,-7,1306,3876,30
70301422354,70301422352,-2,1094,2173,30
70302835117,70302835113,-4,840,1904,30
70304712948,70304712958,10,299,1791,30
70312957678,70312957676,-2,1021,2771,30
70313054608,70313054589,-19,1153,2274,30
70313472859,70313472846,-13,137,1118,30
70316351308,70316351303,-5,1103,3425,30
70316477668,70316477686,18,67,860,30
70320063134,70320063114,-20,298,883,30
70323046214,70323046211,-3,1804,5526,30
70325865494,70325865491,-3,985,2436,30
70326264344,70326264359,15,182,1194,30
70327997503,70327997499,-4,1263,4672,30
70339561571,70339561565,-6,1174,3630,30
70340580648,70340580643,-5,1014,2757,30
70340802598,70340802592,-6,941,2672,30
70342517566,70342517562,-4,847,2104,30
70342691251,70342691259,8,137,909,30
70348764491,70348764486,-5,1241,5661,30
70352377157,70352377163,6,2256,1195,30
70359185298,70359185293,-5,937,3467,30
70359296970,70359296974,4,2204,1262,30
70364405916,70364405910,-6,1235,4151,30
70365401510,70365401503,-7,1285,3373,30
70365753848,70365753829,-19,175,980,30
70367144181,70367144176,-5,974,3363,30
70370017769,70370017765,-4,882,2095,30
70374254394,70374254391,-3,805,2261,30
70376517858,70376517855,-3,1091,3133,30
70377260469,70377260462,-7,1284,4306,30
70379532902,70379532898,-4,761,2167,30
70379981399,70379981397,-2,2783,3569,30
70380867675,70380867670,-5,1314,2444,30
70381956762,70381956757,-5,1114,3079,30
70382419792,70382419810,18,783,2783,30
70385779222,70385779217,-5,1107,2762,30
70394010063,70394010062,-1,1036,1742,30
70396678431,70396678426,-5,1041,3969,30
70397383835,70397383829,-6,1496,3599,30
70401062081,70401062076,-5,1004,2291,30
70404177638,70404177634,-4,998,2594,30
70405955529,70405955538,9,384,854,30
70409712902,70409712899,-3,822,2576,30
70409837411,70409837406,-5,957,3018,30
70414614778,70414614775,-3,1075,2760,30
70414964555,70414964550,-5,525,1943,30
70415324421,70415324417,-4,1027,2792,30
70417924348,70417924341,-7,1618,5433,30
70418715169,70418715189,20,1139,3346,30
70418836558,70418836554,-4,1053,2131,30
70419059008,70419059026,18,842,3196,30
70423540363,70423540358,-5,781,1945,30
70424542907,70424542902,-5,891,2795,30
70424673120,70424673115,-5,1175,3342,30
70429407783,70429407778,-5,1201,2556,30
70429761205,70429761202,-3,414,2192,30
70431284477,70431284474,-3,982,2506,30
70432209555,70432209538,-17,801,2770,30
70443395224,70443395219,-5,1280,4090,30
70449495607,70449495602,-5,1241,2936,30
70451464189,70451464182,-7,1736,4757,30
70456014126,70456014122,-4,1066,2547,30
70457723920,70457723916,-4,721,2366,30
70458730026,70458730012,-14,1034,3245,30
70459544063,70459544059,-4,326,935,30
70462082716,70462082714,-2,949,2555,30
70462929571,70462929568,-3,1031,1823,30
70463802206,70463802201,-5,1195,2983,30
70463987618,70463987616,-2,1056,2377,30
70467955743,70467955738,-5,766,3086,30
70468808482,70468808474,-8,197,1058,30
70470432827,70470432821,-6,855,2659,30
70472219555,70472219550,-5,1115,2801,30
70472525202,70472525195,-7,824,2688,30
70477831426,70477831422,-4,983,3039,30
70481762682,70481762677,-5,941,3899,30
70485054555,70485054550,-5,822,1683,30
70487231229,70487231225,-4,1205,3818,30
70488417355,70488417349,-6,1242,2982,30
70489414511,70489414506,-5,913,2922,30
70491733014,70491733011,-3,1282,2916,30
70491765384,70491765376,-8,1125,2263,30
70492227847,70492227843,-4,1182,3198,30
70492521384,70492521404,20,823,1062,30
70494351871,70494351868,-3,954,1945,30
70496605342,70496605338,-4,546,2533,30
70502815854,70502815851,-3,931,2945,30
70503109970,70503109982,12,308,1038,30
70509254150,70509254146,-4,627,2117,30
70509826356,70509826355,-1,1385,2467,30
70511604470,70511604469,-1,16741,4650,30
70518861178,70518861174,-4,910,2757,30
70520456671,70520456666,-5,973,1765,30
70520691367,70520691366,-1,1419,2247,30
70521030679,70521030677,-2,937,1575,30
70527025461,70527025455,-6,930,2613,30
70529716366,70529716362,-4,937,3722,30
70529803741,70529803744,3,1425,1740,30
70532036198,70532036194,-4,1149,4214,30
70536266944,70536266939,-5,617,2373,30
70537813801,70537813796,-5,644,1748,30
70541007331,70541007328,-3,642,2559,30
70544243930,70544243925,-5,884,3267,30
70550036771,70550036766,-5,1097,3480,30
70550697081,70550697102,21,1014,2011,30
70552301329,70552301331,2,3727,3364,30
70559787349,70559787358,9,16152,24436,30
70560224142,70560224137,-5,1050,2470,30
70561556342,70561556338,-4,1010,2706,30
70570141826,70570141821,-5,871,2803,30
70575658670,70575658664,-6,1178,3006,30
70575989890,70575989885,-5,734,1460,30
70576308297,70576308287,-10,62,849,30
70578359121,70578359116,-5,1207,3296,30
70578712188,70578712205,17,881,2899,30
70580745714,70580745710,-4,676,2185,30
70581293080,70581293071,-9,910,2524,30
70581840371,70581840366,-5,1126,3612,30
70582073717,70582073712,-5,929,2357,30
70586839935,70586839930,-5,1956,4976,30
70593639170,70593639164,-6,1009,3504,30
70596669555,70596669553,-2,829,2566,30
70598704062,70598704057,-5,1230,2881,30
70599506918,70599506914,-4,761,2742,30
70600330131,70600330127,-4,1157,3486,30
70603829945,70603829940,-5,1408,3697,30
70604864530,70604864526,-4,647,3249,30
70606356815,70606356816,1,935,1529,30
70611186078,70611186075,-3,954,2661,30
70613852137,70613852139,2,1308,1621,30
70613964388,70613964382,-6,1708,4070,30
70618041060,70618041056,-4,4133,11885,30
70618886146,70618886145,-1,1036,1423,30
70620752465,70620752461,-4,1021,2481,30
70620909977,70620909958,-19,162,1026,30
70622724566,70622724562,-4,1249,3053,30
70629489810,70629489807,-3,942,2503,30
70632492708,70632492713,5,2091,893,30
70633264151,70633264147,-4,616,1552,30
70634375395,70634375390,-5,1597,2531,30
70637333442,70637333437,-5,966,3313,30
70638336702,70638336699,-3,1347,2319,30
70641841398,70641841393,-5,874,2737,30
70643931715,70643931710,-5,634,1962,30
70644045659,70644045650,-9,1001,3503,30
70645186689,70645186672,-17,4,2554,30
70645988266,70645988279,13,160,824,30
70649661166,70649661162,-4,836,2055,30
70650238736,70650238730,-6,1021,2723,30
70654578073,70654578066,-7,1017,2016,30
70655007843,70655007839,-4,1418,3340,30
70657913401,70657913402,1,3102,3475,30
70659130326,70659130325,-1,867,1973,30
70661018193,70661018189,-4,1054,3273,30
70664604049,70664604042,-7,751,2318,30
70667249394,70667249393,-1,1162,1920,30
70670093227,70670093227,0,1304,2126,30
70673874337,70673874337,0,1263,1301,30
70681793164,70681793158,-6,933,3564,30
70682986826,70682986820,-6,1495,4478,30
70684649547,70684649542,-5,1010,3725,30
70690016291,70690016285,-6,1129,3199,30
70691451783,70691451778,-5,943,3222,30
70691719353,70691719371,18,408,3058,30
70695650438,70695650433,-5,1169,3481,30
70696830493,70696830489,-4,814,2513,30
70698831713,70698831710,-3,809,2017,30
70699266016,70699266012,-4,1005,3032,30
70704741623,70704741627,4,708,1021,30
70705420021,70705420016,-5,1067,2117,30
70705894089,70705894069,-20,348,1062,30
70709905903,70709905899,-4,701,1752,30
70714989398,70714989393,-5,888,2724,30
70716478589,70716478584,-5,996,2789,30
70720765793,70720765790,-3,1162,2604,30
70722815764,70722815767,3,5201,2837,30
70723345117,70723345122,5,9328,5047,30
70728106454,70728106449,-5,1114,3202,30
70731929924,70731929920,-4,956,2352,30
70733038105,70733038104,-1,1184,1928,30
70733541148,70733541142,-6,1158,3740,30
70733680097,70733680093,-4,1324,2903,30
70738503007,70738503001,-6,981,2216,30
70740043179,70740043175,-4,719,1681,30
70740310178,70740310190,12,909,2444,30
70741141071,70741141065,-6,1122,2374,30
70741768110,70741768106,-4,1501,3876,30
70746782996,70746782991,-5,1745,2147,30
70750012679,70750012675,-4,1170,3021,30
70750671450,70750671470,20,1215,2400,30
70753392319,70753392314,-5,1063,2643,30
70756089463,70756089459,-4,773,2988,30
70758042230,70758042225,-5,1268,2758,30
70760559701,70760559698,-3,966,3037,30
70760968059,70760968078,19,236,1792,30
70761469457,70761469450,-7,143,797,30
70763781206,70763781199,-7,906,2409,30
70765590176,70765590171,-5,1079,2246,30
70779640058,70779640055,-3,944,1589,30
70779670225,70779670210,-15,2026,1093,30
70787648071,70787648066,-5,1315,3294,30
70794082041,70794082036,-5,1192,3230,30
70799954772,70799954775,3,2505,1318,30
70800156870,70800156866,-4,962,2851,30
70800664463,70800664460,-3,965,2234,30
70808073030,70808073026,-4,786,2648,30
70812148093,70812148087,-6,1232,3640,30
70816238216,70816238210,-6,1165,3209,30
70819671884,70819671878,-6,977,3443,30
70823151087,70823151082,-5,1215,2681,30
70825912818,70825912816,-2,897,2205,30
70834262929,70834262925,-4,537,1313,30
70836264731,70836264726,-5,1337,3376,30
70838132675,70838132658,-17,4379,2988,30
70858768641,70858768637,-4,1399,2685,30
70863303815,70863303813,-2,1338,2661,30
70865285663,70865285656,-7,23100,15002,30
70873390293,70873390290,-3,1250,2215,30
70876509471,70876509465,-6,1067,3315,30
70876751393,70876751387,-6,1245,3295,30
70880302668,70880302662,-6,1434,2405,30
70880447698,70880447714,16,594,4578,30
70881544059,70881544054,-5,1031,3058,30
70888025688,70888025682,-6,1034,3017,30
70891273894,70891273897,3,3372,3484,30
70893187826,70893187821,-5,1159,3171,30
70893480057,70893480059,2,1293,1342,30
70895606499,70895606494,-5,324,1346,30
70897718881,70897718878,-3,1199,2678,30
70898400889,70898400906,17,889,2995,30
70900736083,70900736078,-5,918,3533,30
70903347981,70903347976,-5,1263,2581,30
70913394404,70913394399,-5,1015,3219,30
70915230338,70915230334,-4,816,3491,30
70915623904,70915623901,-3,1080,2441,30
70915900887,70915900882,-5,707,3473,30
70920110332,70920110327,-5,1369,3568,30
70922547622,70922547617,-5,1310,3371,30
70922826148,70922826147,-1,2744,4655,30
70923041343,70923041338,-5,759,2014,30
70924100401,70924100406,5,2913,1557,30
70924984945,70924984942,-3,688,1938,30
70927046294,70927046293,-1,2355,4427,30
70931426779,70931426775,-4,926,2910,30
70933065909,70933065905,-4,1526,4301,30
70933092281,70933092300,19,713,1896,30
70937379830,70937379825,-5,1243,4257,30
70938888246,70938888241,-5,1463,3488,30
70943657299,70943657294,-5,1110,3328,30
70949092925,70949092919,-6,964,3402,30
70951547930,70951547925,-5,1324,2784,30
70951734818,70951734833,15,701,2525,30
70952353929,70952353925,-4,863,2956,30
70955418879,70955418874,-5,1579,4464,30
70955625914,70955625910,-4,853,2166,30
70956981045,70956981039,-6,1516,3895,30
70960892086,70960892081,-5,1198,3366,30
70966303148,70966303143,-5,922,2703,30
70968659587,70968659585,-2,704,1536,30
70968839224,70968839217,-7,1091,2460,30
70969006153,70969006151,-2,1159,2477,30
70971757797,70971757798,1,1490,2328,30
70984865948,70984865944,-4,1019,2849,30
70984987696,70984987677,-19,95,1041,30
70987992917,70987992911,-6,973,3135,30
70989240954,70989240951,-3,590,3009,30
70989565329,70989565324,-5,979,3028,30
70994699767,70994699762,-5,1019,3208,30
70995905014,70995905012,-2,1237,2581,30
70996099383,70996099377,-6,1211,2529,30
70997291969,70997291962,-7,861,2589,30
71000019398,71000019395,-3,708,2271,30
71001262857,71001262870,13,222,1029,30
71004000308,71004000305,-3,931,1292,30
71007121674,71007121671,-3,550,1838,30
71007666778,71007666774,-4,736,2859,30
71020082655,71020082651,-4,1183,3382,30
71020812712,71020812709,-3,1320,2384,30
71022346798,71022346794,-4,884,2019,30
71024760298,71024760293,-5,899,2211,30
71033353141,71033353135,-6,837,2962,30
71033637166,71033637162,-4,1213,3331,30
71035370562,71035370583,21,1086,2554,30
71042061500,71042061494,-6,980,2529,30
71044768120,71044768114,-6,1092,3871,30
71047714057,71047714055,-2,1348,2735,30
71051327051,71051327039,-12,36274,29833,30
71052142134,71052142126,-8,881,2724,30
71055656417,71055656417,0,1181,2713,30
71058343113,71058343107,-6,818,3425,30
71062486209,71062486205,-4,1116,2974,30
71065913584,71065913581,-3,1177,2936,30
71068018659,71068018654,-5,1050,3927,30
71068371481,71068371477,-4,1196,3467,30
71072405401,71072405397,-4,942,3510,30
71073111507,71073111524,17,214,2075,30
71075139582,71075139576,-6,1051,2986,30
71077238258,71077238254,-4,1269,3447,30
71079719923,71079719921,-2,1261,3478,30
71087844012,71087844009,-3,1041,2758,30
71094331518,71094331518,0,3275,3962,30
71097479966,71097479962,-4,778,2259,30
71100223791,71100223786,-5,868,1984,30
71101865943,71101865938,-5,919,3035,30
71101986491,71101986487,-4,1188,2630,30
71106538213,71106538226,13,2445,1957,30
71108848534,71108848530,-4,638,3024,30
71115506511,71115506506,-5,901,3146,30
71116595583,71116595578,-5,775,2684,30
71117058638,71117058633,-5,1177,2957,30
71117834577,71117834571,-6,1199,2527,30
71117982874,71117982887,13,300,1081,30
71118730447,71118730443,-4,1188,1962,30
71118985053,71118985047,-6,1530,2789,30
71119238891,71119238887,-4,1177,2825,30
71120263350,71120263347,-3,762,2267,30
71120632055,71120632050,-5,1771,4068,30
71120841735,71120841729,-6,802,1913,30
71121583514,71121583509,-5,1062,3003,30
71125411609,71125411603,-6,1049,3040,30
71134497717,71134497713,-4,986,2655,30
71134942202,71134942197,-5,1034,2760,30
71137043865,71137043858,-7,973,2295,30
71140551246,71140551243,-3,1031,2795,30
71141435990,71141435986,-4,842,2292,30
71142470172,71142470186,14,613,1732,30
71143737346,71143737341,-5,859,3897,30
71146657836,71146657830,-6,1268,3753,30
71147177508,71147177522,14,1113,3823,30
71148494770,71148494762,-8,988,3544,30
71150216163,71150216157,-6,1237,2781,30
71160223021,71160223002,-19,761,1189,30
71164019936,71164019934,-2,752,1976,30
71169109465,71169109463,-2,1066,2508,30
71173867990,71173867986,-4,1063,3405,30
71175474046,71175474040,-6,23900,10094,30
71176301766,71176301761,-5,1455,2225,30
71178956819,71178956817,-2,1128,3375,30
71179423590,71179423586,-4,1044,2505,30
71181072519,71181072513,-6,1120,2489,30
71184232587,71184232582,-5,1010,3287,30
71184936621,71184936617,-4,1145,2684,30
71186962810,71186962807,-3,1000,2264,30
71188229245,71188229242,-3,1219,3181,30
71191663126,71191663121,-5,766,2010,30
71203262616,71203262610,-6,910,3395,30
71203591058,71203591039,-19,26,901,30
71214059148,71214059142,-6,1782,3939,30
71215066467,71215066465,-2,792,1984,30
71218703453,71218703449,-4,928,3435,30
71219741262,71219741257,-5,932,1629,30
71221405109,71221405104,-5,983,4040,30
71221951898,71221951915,17,469,1975,30
71227292754,71227292749,-5,847,1460,30
71235835563,71235835562,-1,1168,2803,30
71241064131,71241064126,-5,741,2047,30
71246966233,71246966227,-6,769,3655,30
71247275731,71247275729,-2,1028,2926,30
71256460621,71256460625,4,1201,1108,30
71259781310,71259781306,-4,844,2344,30
71262386171,71262386167,-4,1175,3854,30
71263827656,71263827651,-5,1084,3205,30
71263955936,71263955930,-6,1188,1392,30
71267483145,71267483148,3,993,1155,30
71267878092,71267878106,14,182,1698,30
71269264261,71269264264,3,2959,1963,30
71275423009,71275423004,-5,1204,4047,30
71276991271,71276991266,-5,883,2762,30
71277746666,71277746662,-4,656,1996,30
71278695697,71278695717,20,1032,2277,30
71279569784,71279569779,-5,906,3354,30
71281902654,71281902649,-5,809,2804,30
71282463908,71282463904,-4,1441,3488,30
71288047419,71288047417,-2,879,2080,30
71292365890,71292365886,-4,901,1595,30
71294858049,71294858042,-7,1425,3386,30
71297583464,71297583468,4,4834,22451,30
71304352878,71304352875,-3,755,2064,30
71306439215,71306439209,-6,961,2873,30
71311761575,71311761571,-4,1442,1983,30
71317360831,71317360825,-6,1061,3078,30
71317517190,71317517185,-5,1289,3484,30
71320271337,71320271323,-14,352,1456,30
71321915519,71321915514,-5,834,1320,30
71324565386,71324565382,-4,1314,3624,30
71324881825,71324881840,15,640,1460,30
71330274903,71330274899,-4,967,2739,30
71330606597,71330606593,-4,1265,3657,30
71334907417,71334907423,6,4944,2302,30
71337124750,71337124746,-4,817,3246,30
71343840910,71343840907,-3,891,2763,30
71347973663,71347973658,-5,1021,1724,30
71357093761,71357093757,-4,984,2681,30
71361425935,71361425930,-5,439,945,30
71371780537,71371780537,0,997,1334,30
71372588771,71372588768,-3,901,2064,30
71373162593,71373162589,-4,984,3466,30
71376708857,71376708852,-5,1140,3323,30
71389358802,71389358797,-5,929,3364,30
71396031173,71396031170,-3,22211,4834,30
71406271461,71406271457,-4,1541,4076,30
71407374330,71407374334,4,49307,32328,30
71410209427,71410209422,-5,968,2776,30
71414980480,71414980480,0,1460,3314,30
71416961897,71416961893,-4,562,1566,30
71417826554,71417826547,-7,1012,3039,30
71421444681,71421444678,-3,488,2319,30
71423849227,71423849223,-4,855,2398,30
71424465767,71424465768,1,1668,2325,30
71426085825,71426085818,-7,1177,2657,30
71428210713,71428210708,-5,863,3373,30
71429918525,71429918521,-4,996,2309,30
71429949793,71429949782,-11,173,1018,30
71433980818,71433980814,-4,664,1894,30
71439184919,71439184912,-7,1359,3240,30
71441485758,71441485738,-20,2078,597,30
71446040403,71446040398,-5,1316,2984,30
71450337941,71450337937,-4,1104,2602,30
71450532075,71450532093,18,999,5343,30
71452144582,71452144577,-5,1174,3919,30
71458303734,71458303731,-3,1002,2485,30
71459637290,71459637286,-4,1588,3471,30
71460707153,71460707150,-3,717,1527,30
71463546763,71463546757,-6,1101,3371,30
71465975366,71465975364,-2,996,1698,30
71469140545,71469140542,-3,1067,1790,30
71472328595,71472328589,-6,950,2784,30
71473733624,71473733642,18,1292,2118,30
71474127762,71474127759,-3,913,2227,30
71476915450,71476915445,-5,1070,3918,30
71480130067,71480130067,0,7016,7772,30
71484354390,71484354391,1,1547,1701,30
71489333653,71489333649,-4,1036,2949,30
71490272555,71490272568,13,695,2241,30
71492511469,71492511463,-6,1032,2877,30
71493278698,71493278694,-4,1586,2567,30
71494416277,71494416273,-4,1120,2916,30
71496500803,71496500799,-4,1184,2530,30
71496792280,71496792270,-10,1084,2393,30
71499832289,71499832285,-4,859,2464,30
71503713023,71503713030,7,2364,1304,30
71505567698,71505567693,-5,947,1597,30
71510917285,71510917280,-5,814,2692,30
71511115595,71511115593,-2,1129,1714,30
71511694881,71511694898,17,536,1497,30
71513401364,71513401358,-6,931,2917,30
71518405510,71518405504,-6,1171,3614,30
71521076975,71521076969,-6,1096,2997,30
71522368820,71522368817,-3,1022,2750,30
71522767820,71522767810,-10,803,2741,30
71524818134,71524818129,-5,965,2826,30
71525432794,71525432780,-14,968,3923,30
71526164249,71526164246,-3,1032,2859,30
71526708164,71526708182,18,591,2410,30
71528476453,71528476449,-4,1318,2389,30
71528872041,71528872037,-4,126,924,30
71531605424,71531605422,-2,1175,2038,30
71537028666,71537028661,-5,1123,1724,30
71537837215,71537837210,-5,1251,3059,30
71541261653,71541261649,-4,701,1566,30
71544656750,71544656730,-20,1347,620,30
71545310181,71545310179,-2,49134,21382,30
71547399868,71547399863,-5,2251,5114,30
71553939738,71553939734,-4,1047,3100,30
71556935021,71556935021,0,958,1395,30
71557173050,71557173042,-8,177,1267,30
71559275642,71559275637,-5,996,2232,30
71559936388,71559936383,-5,885,1707,30
71572157191,71572157187,-4,1177,2073,30
71581165106,71581165109,3,2096,1787,30
71581851442,71581851437,-5,1098,2744,30
71584871785,71584871786,1,1524,2629,30
71587195034,71587195030,-4,1608,3118,30
71591104092,71591104088,-4,1619,3242,30
71592552623,71592552617,-6,1323,4122,30
71595306463,71595306457,-6,1305,3294,30
71595414914,71595414927,13,487,1745,30
71595591743,71595591742,-1,1644,2773,30
71597949474,71597949471,-3,770,2300,30
71602083933,71602083928,-5,1179,2264,30
71605597333,71605597329,-4,1233,2630,30
71611216719,71611216714,-5,1229,3321,30
71611245393,71611245395,2,119,947,30
71613867548,71613867541,-7,922,2912,30
71618733082,71618733078,-4,1049,3421,30
71622777594,71622777590,-4,832,2301,30
71624819993,71624819997,4,4636,2766,30
71628679051,71628679046,-5,1304,3249,30
71629253882,71629253879,-3,892,2686,30
71640238858,71640238855,-3,988,2488,30
71640701366,71640701374,8,2888,1267,30
71641827831,71641827821,-10,1000,3066,30
71643151951,71643151946,-5,719,1797,30
71644376286,71644376280,-6,1260,4499,30
71647510914,71647510910,-4,951,2710,30
71648596793,71648596792,-1,1188,2530,30
71656190005,71656190004,-1,1110,2493,30
71656872682,71656872703,21,382,1186,30
71658696975,71658696973,-2,1461,2277,30
71660012358,71660012354,-4,1083,3592,30
71663049019,71663049014,-5,1120,2375,30
71668885743,71668885740,-3,1388,2310,30
71668962570,71668962566,-4,1458,3853,30
71672301833,71672301834,1,1739,1211,30
71672775046,71672775042,-4,1318,2585,30
71678461097,71678461090,-7,1162,6074,30
71680511458,71680511461,3,2718,3333,30
71688395345,71688395340,-5,960,2342,30
71693694586,71693694580,-6,1084,3017,30
71696322255,71696322250,-5,1416,2815,30
71703931015,71703931013,-2,1127,2367,30
71704525708,71704525726,18,164,913,30
71706026589,71706026585,-4,1367,3021,30
71719175563,71719175560,-3,854,2834,30
71720371457,71720371451,-6,1174,2918,30
71720423833,71720423828,-5,1252,3598,30
71722083398,71722083395,-3,27138,11643,30
71729543655,71729543661,6,2318,1525,30
71737232068,71737232067,-1,1658,2917,30
71749067246,71749067239,-7,781,3851,30
71751627642,71751627646,4,9797,7262,30
71753644537,71753644538,1,1390,1584,30
71753977766,71753977762,-4,1093,2801,30
71754745114,71754745095,-19,16,920,30
71756543241,71756543238,-3,2652,5341,30
71766079552,71766079546,-6,1499,4059,30
71767458622,71767458621,-1,1177,2402,30
71767757008,71767757005,-3,230,1540,30
71776911287,71776911282,-5,1218,3364,30
71790610402,71790610397,-5,1248,3440,30
71795908629,71795908627,-2,1352,3787,30
71798996689,71798996683,-6,781,3026,30
71799342634,71799342630,-4,1083,3096,30
71804666663,71804666661,-2,1256,2373,30
71808826111,71808826107,-4,914,2247,30
71813790365,71813790359,-6,1183,1990,30
71814457394,71814457389,-5,1020,1891,30
71819797514,71819797522,8,3002,1204,30
71824392417,71824392412,-5,879,2164,30
71825137322,71825137317,-5,1044,2749,30
71828228323,71828228319,-4,1001,4043,30
71828726684,71828726702,18,733,3223,30
71836518113,71836518107,-6,996,4277,30
71838961990,71838961983,-7,522,3206,30
71842924372,71842924365,-7,533,1702,30
71843978953,71843978949,-4,713,2287,30
71844838787,71844838782,-5,1774,4077,30
71846697471,71846697478,7,4804,1137,30
71848238437,71848238432,-5,1128,3031,30
71851415599,71851415594,-5,874,3297,30
71851658888,71851658883,-5,1040,3789,30
71851723877,71851723875,-2,1606,2216,30
71853641492,71853641489,-3,1432,3556,30
71854933446,71854933442,-4,1293,2585,30
71855950259,71855950254,-5,1278,1997,30
71859171963,71859171958,-5,826,2502,30
71865744729,71865744726,-3,947,1612,30
71867066401,71867066399,-2,1661,2952,30
71870487206,71870487202,-4,1084,3541,30
71885943267,71885943263,-4,638,1106,30
71890600262,71890600257,-5,1165,3665,30
71891839593,71891839576,-17,1319,3294,30
71893886282,71893886281,-1,1359,3009,30
71896727026,71896727029,3,1620,1307,30
71898028567,71898028564,-3,1250,2810,30
71901285567,71901285561,-6,378,1246,30
71904583177,71904583177,0,1657,1458,30
71907062709,71907062704,-5,764,3007,30
71907726328,71907726350,22,995,3380,30
71911749154,71911749155,1,1209,1976,30
71912427063,71912427068,5,8396,4915,30
71912900318,71912900322,4,1841,665,30
71916419516,71916419509,-7,1473,2748,30
71923494091,71923494087,-4,2087,3467,30
71928094662,71928094658,-4,1199,3591,30
71929128589,71929128584,-5,646,2035,30
71933243434,71933243442,8,7927,1909,30
71933951226,71933951213,-13,168,960,30
71936789435,71936789438,3,22784,46267,30
71940013794,71940013790,-4,789,3157,30
71943829711,71943829705,-6,961,3250,30
71945247934,71945247929,-5,1336,2007,30
71946326830,71946326819,-11,818,174,30
71947176766,71947176762,-4,1091,2832,30
71948105766,71948105759,-7,1628,6283,30
71949987467,71949987461,-6,1010,2337,30
71951032606,71951032606,0,34872,18715,30
71952750115,71952750110,-5,630,2503,30
71953691485,71953691481,-4,1262,4067,30
71959082738,71959082733,-5,946,2152,30
71964257510,71964257504,-6,1443,2346,30
71965262007,71965262005,-2,1420,2563,30
71965584444,71965584458,14,1029,3071,30
71968447232,71968447226,-6,1133,3283,30
71975273308,71975273298,-10,1062,2234,30
71975988420,71975988415,-5,1467,3690,30
71989673138,71989673133,-5,917,3642,30
71998051266,71998051261,-5,794,2173,30
72001322314,72001322309,-5,1060,2651,30
72002975231,72002975226,-5,1625,2578,30
72005456926,72005456921,-5,1378,2666,30
72008102926,72008102922,-4,909,2432,30
72017969369,72017969366,-3,849,1618,30
72020842823,72020842819,-4,956,2605,30
72024529482,72024529482,0,1142,2055,30
72025611375,72025611371,-4,1175,2730,30
72031096496,72031096491,-5,1095,2772,30
72033785371,72033785378,7,4588,2000,30
72038943874,72038943874,0,1071,1819,30
72044050186,72044050183,-3,1161,2338,30
72044698299,72044698294,-5,919,2583,30
72047528342,72047528338,-4,1234,2679,30
72048098360,72048098364,4,450,1492,30
72048454713,72048454730,17,807,2587,30
72049951462,72049951458,-4,1206,2999,30
72050541103,72050541098,-5,966,2698,30
72054478839,72054478834,-5,1046,2172,30
72055543594,72055543610,16,379,1115,30
72056418818,72056418812,-6,622,3463,30
72057141738,72057141734,-4,1095,4193,30
72057245191,72057245186,-5,1230,3236,30
72063805377,72063805372,-5,1355,2933,30
72069782846,72069782841,-5,1102,2912,30
72071981750,72071981743,-7,719,3542,30
72078676640,72078676634,-6,1404,2862,30
72080596233,72080596235,2,1592,1683,30
72086669702,72086669699,-3,910,2705,30
72088639193,72088639189,-4,755,2957,30
72089578921,72089578939,18,467,1923,30
72092873147,72092873143,-4,1238,3369,30
72093394058,72093394054,-4,979,3054,30
72096581045,72096581038,-7,1261,3368,30
72100200130,72100200127,-3,1027,3016,30
72103192531,72103192514,-17,177,1222,30
72103585885,72103585881,-4,1517,3118,30
72105088586,72105088581,-5,808,2509,30
72105240877,72105240870,-7,1608,4713,30
72116363848,72116363831,-17,931,2231,30
72118006330,72118006334,4,3270,1964,30
72121511778,72121511776,-2,1151,2510,30
72125351686,72125351682,-4,906,3349,30
72125617243,72125617235,-8,601,14428,30
72129866332,72129866327,-5,982,2500,30
72131598381,72131598375,-6,1593,3732,30
72138521690,72138521686,-4,1013,2974,30
72142393933,72142393929,-4,828,2003,30
72151813736,72151813733,-3,1268,3950,30
72153015969,72153015986,17,895,3029,30
72158646206,72158646202,-4,851,1318,30
72167157690,72167157684,-6,1181,3581,30
72171396413,72171396409,-4,630,2287,30
72175588874,72175588869,-5,1042,3184,30
72178716641,72178716637,-4,1557,3060,30
72178755449,72178755464,15,441,1733,30
72181033626,72181033626,0,1320,2061,30
72181472007,72181472005,-2,1243,1690,30
72182150906,72182150901,-5,887,2827,30
72188727865,72188727859,-6,1378,2769,30
72195588350,72195588346,-4,1137,3104,30
72195708227,72195708219,-8,1002,3132,30
72197586604,72197586598,-6,778,3049,30
72198580685,72198580681,-4,1044,2403,30
72199457701,72199457697,-4,1693,3871,30
72200390122,72200390118,-4,118,1985,30
72202266240,72202266237,-3,1016,2253,30
72209561916,72209561913,-3,1135,2659,30
72212753514,72212753510,-4,801,1733,30
72214502759,72214502754,-5,744,2458,30
72216313627,72216313643,16,306,880,30
72222199246,72222199243,-3,1135,3256,30
72224299631,72224299626,-5,979,2891,30
72231204549,72231204542,-7,1141,2960,30
72239117299,72239117295,-4,1053,2566,30
72240276908,72240276919,11,15986,23689,30
72242322135,72242322131,-4,1051,2306,30
72245704781,72245704784,3,977,2137,30
72248489059,72248489054,-5,1285,2895,30
72249211746,72249211743,-3,725,2641,30
72249261016,72249261009,-7,210,1108,30
72249572617,72249572614,-3,1582,3141,30
72258828526,72258828522,-4,1019,3061,30
72264104143,72264104138,-5,1063,1772,30
72265095229,72265095225,-4,1643,3529,30
72265727085,72265727081,-4,1334,2345,30
72267135159,72267135157,-2,1559,2743,30
72267728447,72267728442,-5,930,2176,30
72278877643,72278877635,-8,989,2234,30
72279201104,72279201101,-3,1844,2559,30
72280659798,72280659794,-4,988,3134,30
72284861530,72284861526,-4,1294,3051,30
72285574925,72285574919,-6,735,1685,30
72289587637,72289587634,-3,447,1920,30
72290293305,72290293307,2,198,722,30
72292796753,72292796751,-2,513,2058,30
72296020151,72296020151,0,1318,1934,30
72298131072,72298131071,-1,826,1877,30
72300018795,72300018790,-5,1281,2059,30
72309610745,72309610740,-5,828,2832,30
72311077607,72311077602,-5,1312,4178,30
72313730195,72313730190,-5,980,3035,30
72329931732,72329931727,-5,905,3511,30
72338105509,72338105503,-6,1097,3712,30
72343029094,72343029091,-3,1664,2903,30
72346376892,72346376887,-5,953,2655,30
72354130294,72354130288,-6,319,1016,30
72359107357,72359107353,-4,898,2831,30
72359644600,72359644596,-4,1030,2229,30
72363534447,72363534445,-2,1137,2573,30
72365123145,72365123141,-4,894,2228,30
72367811846,72367811842,-4,5275,14816,30
72368148952,72368148945,-7,785,2471,30
72369902066,72369902063,-3,1099,2578,30
72373444509,72373444506,-3,1368,2296,30
72373674435,72373674435,0,1350,2235,30
72375415155,72375415149,-6,351,1642,30
72382230335,72382230348,13,672,2019,30
72383584595,72383584591,-4,1261,2969,30
72384456296,72384456315,19,799,2010,30
72385888660,72385888655,-5,1135,2976,30
72389482999,72389482997,-2,999,1954,30
72389823409,72389823410,1,1699,1825,30
72392043822,72392043814,-8,1244,3810,30
72394687618,72394687614,-4,1250,3684,30
72394779946,72394779941,-5,905,4730,30
72408700597,72408700593,-4,1285,2644,30
72410335146,72410335141,-5,1048,2685,30
72410533938,72410533926,-12,127,1257,30
72410579946,72410579937,-9,871,3192,30
72413347229,72413347225,-4,1312,2756,30
72429296595,72429296590,-5,1222,4017,30
72432281451,72432281445,-6,869,2057,30
72432450101,72432450097,-4,859,2849,30
72432484352,72432484349,-3,1623,3538,30
72434672226,72434672225,-1,661,1308,30
72435046861,72435046857,-4,1225,2808,30
72439962373,72439962367,-6,1117,4095,30
72443506692,72443506687,-5,1544,3338,30
72445167794,72445167789,-5,894,3292,30
72446024572,72446024574,2,2717,2646,30
72446943005,72446943000,-5,1301,3519,30
72447834435,72447834423,-12,167,661,30
72449166323,72449166318,-5,740,2530,30
72449968667,72449968677,10,468,2075,30
72454079659,72454079653,-6,970,3353,30
72467263289,72467263285,-4,1493,4187,30
72470752254,72470752253,-1,1352,1830,30
72472570209,72472570203,-6,1224,3267,30
72478414865,72478414865,0,1271,918,30
72479082328,72479082350,22,751,3072,30
72481544126,72481544120,-6,960,4144,30
72485304485,72485304481,-4,915,2548,30
72485531928,72485531910,-18,670,3645,30
72489244168,72489244165,-3,711,2384,30
72489618992,72489618989,-3,1438,2600,30
72490293893,72490293888,-5,1227,3336,30
72493400413,72493400410,-3,27859,16354,30
72493562314,72493562309,-5,813,3104,30
72497749195,72497749192,-3,1166,2886,30
72497855680,72497855702,22,307,1299,30
72502184668,72502184662,-6,1155,1914,30
72503566296,72503566292,-4,1889,3611,30
72509504591,72509504587,-4,1082,2378,30
72513041722,72513041718,-4,976,3155,30
72522893579,72522893576,-3,991,2416,30
72525226103,72525226100,-3,1061,2435,30
72525933005,72525933003,-2,1220,1011,30
72526006875,72526006870,-5,657,1689,30
72526102564,72526102580,16,893,2479,30
72530485893,72530485890,-3,1040,2032,30
72530829539,72530829534,-5,1143,2125,30
72533181187,72533181182,-5,1253,3652,30
72535724196,72535724201,5,4641,2924,30
72543458671,72543458676,5,4162,1188,30
72548332503,72548332497,-6,1016,2909,30
72553614727,72553614722,-5,1008,3540,30
72557185190,72557185187,-3,1070,2846,30
72557333002,72557332986,-16,845,2144,30
72561007291,72561007287,-4,1172,2613,30
72561072499,72561072518,19,396,2142,30
72563093203,72563093201,-2,964,2018,30
72563754043,72563754034,-9,710,1753,30
72565068036,72565068035,-1,472,1270,30
72569066933,72569066930,-3,1117,2074,30
72571331378,72571331372,-6,891,1678,30
72571585320,72571585302,-18,1054,4081,30
72573459030,72573459025,-5,877,2479,30
72573611499,72573611479,-20,127,1448,30
72574130124,72574130120,-4,1023,2663,30
72575984690,72575984687,-3,840,2063,30
72578748718,72578748714,-4,872,2085,30
72578793328,72578793335,7,151,798,30
72582729278,72582729274,-4,1216,3512,30
72583825745,72583825741,-4,1144,3027,30
72586394448,72586394445,-3,1636,3628,30
72590972982,72590972982,0,1530,1593,30
72592074799,72592074799,0,1715,2836,30
72594269330,72594269327,-3,607,1163,30
72597374622,72597374627,5,2240,1210,30
72601527598,72601527606,8,4256,1458,30
72607659059,72607659055,-4,1030,3208,30
72608191978,72608191997,19,202,1173,30
72609370176,72609370162,-14,211,750,30
72610192497,72610192495,-2,944,1587,30
72613502486,72613502480,-6,1255,4814,30
72619844347,72619844346,-1,1170,2273,30
72626289903,72626289908,5,698,469,30
72632480175,72632480172,-3,987,2057,30
72640428233,72640428228,-5,942,3175,30
72642783158,72642783154,-4,610,2668,30
72645945927,72645945921,-6,873,2310,30
72650677078,72650677075,-3,926,3108,30
72660036475,72660036482,7,1285,845,30
72672372476,72672372478,2,3039,2612,30
72672423526,72672423522,-4,937,2956,30
72673216665,72673216660,-5,1596,3961,30
72674182659,72674182655,-4,1215,3401,30
72674226626,72674226623,-3,620,1190,30
72676960249,72676960250,1,474,1281,30
72677944635,72677944618,-17,1306,3154,30
72684189990,72684189985,-5,750,2548,30
72688358378,72688358374,-4,1281,3868,30
72688472499,72688472518,19,783,2972,30
72689460173,72689460169,-4,701,1669,30
72697549146,72697549143,-3,994,2466,30
72703227376,72703227372,-4,1301,2698,30
72705236162,72705236158,-4,1154,2588,30
72721693777,72721693772,-5,1469,3551,30
72722904940,72722904955,15,380,1364,30
72725404423,72725404418,-5,994,2276,30
72726019707,72726019704,-3,1041,2400,30
72726117312,72726117299,-13,375,1398,30
72727456500,72727456497,-3,1138,2944,30
72731924594,72731924599,5,2375,1331,30
72746761710,72746761709,-1,1168,2433,30
72751180485,72751180482,-3,1600,1697,30
72756296995,72756296992,-3,1014,1826,30
72757810228,72757810224,-4,948,2259,30
72758937328,72758937320,-8,1201,2786,30
72762618866,72762618859,-7,824,3858,30
72763320889,72763320870,-19,1079,3681,30
72763590433,72763590426,-7,1395,3290,30
72763701528,72763701510,-18,899,2933,30
72768994589,72768994584,-5,1527,3889,30
72769986937,72769986935,-2,1162,1077,30
72772180937,72772180930,-7,1015,3120,30
72774037579,72774037577,-2,886,2515,30
72774541130,72774541133,3,6554,4776,30
72787609684,72787609702,18,266,918,30
72788286304,72788286301,-3,1281,2845,30
72788438555,72788438551,-4,1033,3248,30
72789830333,72789830335,2,1653,1123,30
72790352222,72790352217,-5,1323,3003,30
72791915839,72791915835,-4,994,2753,30
72792140087,72792140083,-4,1026,2342,30
72793268179,72793268198,19,171,1518,30
72797717849,72797717842,-7,751,2234,30
72808412990,72808412985,-5,1007,3186,30
72810221126,72810221119,-7,672,2814,30
72813975461,72813975454,-7,1090,4221,30
72818515963,72818515958,-5,679,2361,30
72824522427,72824522419,-8,817,2377,30
72833550829,72833550827,-2,1182,1898,30
72834554831,72834554825,-6,756,2159,30
72835870382,72835870376,-6,1018,3056,30
72836170826,72836170822,-4,1257,3797,30
72836777091,72836777082,-9,247,1285,30
72838851123,72838851117,-6,937,3731,30
72841281620,72841281614,-6,1201,3120,30
72841337850,72841337869,19,1024,2380,30
72844850121,72844850117,-4,679,1855,30
72845971621,72845971616,-5,1045,2510,30
72846642997,72846642991,-6,1034,2240,30
72858255127,72858255124,-3,929,2525,30
72858717191,72858717186,-5,889,2977,30
72862854437,72862854430,-7,1308,3301,30
72862890796,72862890804,8,187,837,30
72875819526,72875819523,-3,1065,3000,30
72875929465,72875929487,22,225,780,30
72882800832,72882800840,8,2654,1572,30
72885921708,72885921702,-6,1277,3073,30
72889034133,72889034129,-4,810,2944,30
72889309627,72889309606,-21,1065,2602,30
72897301652,72897301650,-2,1768,2883,30
72900862988,72900862996,8,7422,2530,30
72901753628,72901753625,-3,816,2140,30
72905386354,72905386348,-6,789,2713,30
72910353344,72910353339,-5,1059,2371,30
72910939209,72910939225,16,1039,3811,30
72911176772,72911176768,-4,1177,1969,30
72911329723,72911329730,7,3711,1425,30
72912139394,72912139391,-3,1049,2827,30
72914116966,72914116961,-5,1070,2938,30
72920954171,72920954171,0,1097,1143,30
72921444724,72921444719,-5,630,2529,30
72922279567,72922279563,-4,830,2414,30
72925366527,72925366523,-4,1088,3255,30
72928034823,72928034818,-5,1137,2534,30
72933571319,72933571314,-5,1097,2772,30
72938618717,72938618718,1,2063,2367,30
72949268286,72949268289,3,1116,789,30
72950970345,72950970339,-6,908,2427,30
72957989942,72957989937,-5,854,2364,30
72959619470,72959619470,0,2732,3272,30
72960070336,72960070331,-5,836,2492,30
72962965194,72962965183,-11,967,1318,30
72968087831,72968087842,11,330,1611,30
72970002300,72970002295,-5,1464,3237,30
72973260551,72973260546,-5,449,1737,30
72975394042,72975394038,-4,1209,3059,30
72975455885,72975455875,-10,1073,3392,30
72985025018,72985025013,-5,747,2634,30
72985483632,72985483654,22,455,1378,30
72986956354,72986956349,-5,706,3222,30
72986995502,72986995498,-4,757,2497,30
72987179850,72987179845,-5,594,1978,30
73000055925,73000055918,-7,889,3230,30
73001223138,73001223134,-4,1360,3245,30
73002057887,73002057881,-6,1743,2699,30
73005818866,73005818864,-2,688,1568,30
73013572662,73013572667,5,3652,2837,30
73024337062,73024337057,-5,828,3214,30
73024827260,73024827274,14,772,3371,30
73025461970,73025461966,-4,632,2374,30
73026269256,73026269239,-17,920,2529,30
73031542961,73031542957,-4,713,3380,30
73032150088,73032150074,-14,270,659,30
73035067158,73035067153,-5,912,1638,30
73035835778,73035835775,-3,634,1090,30
73037441691,73037441685,-6,799,2278,30
73037518802,73037518804,2,13,1147,30
73039831170,73039831167,-3,1702,4174,30
73040105758,73040105765,7,3858,1888,30
73042993005,73042993001,-4,1127,2782,30
73047784216,73047784211,-5,1294,3044,30
73052070191,73052070194,3,1288,1276,30
73057071297,73057071297,0,1023,1886,30
73061436646,73061436642,-4,1189,4123,30
73061621330,73061621327,-3,1360,2142,30
73063585288,73063585284,-4,1027,3107,30
73065994284,73065994290,6,4480,2331,30
73074718024,73074718021,-3,1083,2408,30
73075796601,73075796597,-4,1550,4505,30
73088167872,73088167870,-2,1115,1756,30
73090446470,73090446466,-4,1197,3188,30
73098654382,73098654377,-5,1385,3797,30
73099969532,73099969527,-5,1110,5509,30
73106169122,73106169117,-5,1243,3004,30
73112521998,73112521991,-7,1078,3456,30
73114586978,73114586975,-3,1072,3409,30
73115337628,73115337646,18,321,1179,30
73120971206,73120971202,-4,1073,3314,30
73122644715,73122644710,-5,1005,2659,30
73123471831,73123471825,-6,522,2929,30
73133148474,73133148470,-4,1090,4070,30
73136457451,73136457449,-2,1361,2584,30
73137314025,73137314021,-4,1337,4386,30
73143824443,73143824439,-4,725,2238,30
73144040167,73144040162,-5,1527,2668,30
73144135128,73144135145,17,171,1294,30
73146611504,73146611500,-4,1156,2668,30
73148327082,73148327077,-5,1448,2470,30
73148901486,73148901482,-4,1188,2947,30
73149164593,73149164613,20,1105,2635,30
73149791610,73149791630,20,277,816,30
73154312349,73154312350,1,1136,2126,30
73154884014,73154884009,-5,939,2517,30
73161056949,73161056944,-5,1321,3084,30
73163648878,73163648871,-7,1095,3574,30
73169959707,73169959705,-2,1191,1694,30
73174900856,73174900843,-13,20973,16957,30
73181023182,73181023177,-5,1157,3021,30
73181319934,73181319928,-6,780,3189,30
73182461414,73182461409,-5,959,2556,30
73182623434,73182623449,15,873,2837,30
73184728523,73184728526,3,1352,1179,30
73186775684,73186775679,-5,1361,2987,30
73188649486,73188649481,-5,1073,3572,30
73188691408,73188691427,19,258,984,30
73192712591,73192712585,-6,714,3510,30
73197418289,73197418284,-5,949,2676,30
73198501195,73198501209,14,631,2906,30
73200509782,73200509777,-5,1159,2859,30
73203434191,73203434189,-2,1126,2451,30
73216018299,73216018298,-1,1153,2118,30
73216055570,73216055566,-4,899,2250,30
73217468035,73217468030,-5,1247,3397,30
73219264262,73219264258,-4,1352,3327,30
73220265994,73220265991,-3,798,2651,30
73223309741,73223309736,-5,1147,2185,30
73228924579,73228924574,-5,892,2835,30
73238281154,73238281154,0,1247,2543,30
73239522388,73239522403,15,19490,45336,30
73241621758,73241621754,-4,919,2635,30
73242293158,73242293154,-4,1142,2114,30
73243320234,73243320254,20,1133,2513,30
73245571903,73245571895,-8,1177,4284,30
73249886271,73249886267,-4,697,1739,30
73251179707,73251179711,4,2792,1558,30
73251453243,73251453244,1,1803,1890,30
73255377574,73255377569,-5,781,2677,30
73255486940,73255486958,18,866,3250,30
73256341449,73256341445,-4,1211,2464,30
73263087972,73263087980,8,1744,1381,30
73263915098,73263915097,-1,2462,2962,30
73268122263,73268122257,-6,920,2963,30
73268500906,73268500907,1,20,1068,30
73269805334,73269805329,-5,1407,3362,30
73270972665,73270972661,-4,1160,2444,30
73288910436,73288910454,18,991,1632,30
73293862426,73293862423,-3,879,2255,30
73295458808,73295458803,-5,1146,2840,30
73297739896,73297739893,-3,957,2080,30
73301617958,73301617959,1,1241,1004,30
73302171250,73302171245,-5,973,2954,30
73303511295,73303511292,-3,1030,2796,30
73303927946,73303927941,-5,1017,2972,30
73304871769,73304871770,1,3630,3175,30
73314925019,73314925014,-5,895,2596,30
73317248543,73317248538,-5,974,2831,30
73318278769,73318278763,-6,1367,4498,30
73318580760,73318580757,-3,80,1041,30
73319250173,73319250168,-5,823,3598,30
73321765521,73321765516,-5,1639,3227,30
73324064325,73324064320,-5,692,2173,30
73324893163,73324893169,6,148,1020,30
73329750790,73329750791,1,1385,1681,30
73333692198,73333692193,-5,1030,2764,30
73337222285,73337222279,-6,1649,3667,30
73340749857,73340749852,-5,770,2905,30
73345499298,73345499293,-5,1127,2453,30
73348524911,73348524907,-4,753,2573,30
73352239738,73352239735,-3,630,2012,30
73353389491,73353389486,-5,1126,3250,30
73358355124,73358355118,-6,1251,3662,30
73363266819,73363266822,3,177,1091,30
73363852982,73363852978,-4,1207,3801,30
73364943978,73364943976,-2,1437,1797,30
73365906188,73365906186,-2,1040,2450,30
73366321566,73366321561,-5,885,4245,30
73369822708,73369822729,21,508,1115,30
73371449173,73371449170,-3,1442,2376,30
73378624699,73378624696,-3,1008,2091,30
73379510403,73379510398,-5,1293,3080,30
73386097143,73386097141,-2,88,907,30
73388796779,73388796773,-6,772,2776,30
73389648225,73389648223,-2,225,1120,30
73390261754,73390261749,-5,1190,2788,30
73391366008,73391366003,-5,783,2595,30
73392233527,73392233521,-6,968,4383,30
73393526498,73393526493,-5,1152,3139,30
73393850232,73393850226,-6,1752,1585,30
73396069750,73396069749,-1,1167,2068,30
73396121658,73396121670,12,203,1061,30
73398559437,73398559433,-4,934,4265,30
73404083545,73404083540,-5,1012,2318,30
73404286129,73404286134,5,24246,127431,30
73404429989,73404429986,-3,944,3224,30
73405153994,73405154015,21,1140,3672,30
73405553141,73405553135,-6,871,3495,30
73408717947,73408717944,-3,672,2864,30
73410925608,73410925603,-5,838,3017,30
73412088242,73412088235,-7,1070,3320,30
73412362262,73412362257,-5,1238,3275,30
73412417768,73412417790,22,624,1961,30
73417258179,73417258177,-2,1091,2449,30
73426508525,73426508522,-3,1281,2366,30
73430290058,73430290057,-1,1314,1924,30
73436828927,73436828929,2,1107,1592,30
73444690938,73444690932,-6,1058,4374,30
73445137138,73445137133,-5,1270,4155,30
73445612139,73445612137,-2,1168,2306,30
73447055927,73447055923,-4,1267,3018,30
73450515998,73450515993,-5,810,1463,30
73456529406,73456529418,12,639,1804,30
73458838825,73458838820,-5,947,2305,30
73459554045,73459554039,-6,1161,2490,30
73462945571,73462945571,0,1126,2034,30
73469870725,73469870721,-4,785,2219,30
73472644365,73472644360,-5,1143,2817,30
73476431959,73476431963,4,6295,20525,30
73481032429,73481032414,-15,551,1084,30
73486616187,73486616182,-5,1027,4182,30
73494485817,73494485814,-3,733,3398,30
73496902694,73496902690,-4,1237,2308,30
73497795573,73497795569,-4,1258,3585,30
73502025896,73502025892,-4,1049,3442,30
73504627771,73504627766,-5,828,3180,30
73508684555,73508684550,-5,709,2895,30
73509429154,73509429175,21,669,2268,30
73510194099,73510194094,-5,1145,2880,30
73512274009,73512274002,-7,1426,3521,30
73513910043,73513910040,-3,1601,3537,30
73523954786,73523954781,-5,1197,3094,30
73526585788,73526585789,1,1244,2015,30
73528835316,73528835308,-8,843,2040,30
73535288782,73535288777,-5,1429,3702,30
73539277052,73539277047,-5,861,1253,30
73544539965,73544539960,-5,1055,3126,30
73544735982,73544735977,-5,1495,3460,30
73544903722,73544903718,-4,996,2099,30
73548898645,73548898640,-5,788,2242,30
73548953666,73548953670,4,35352,93377,30
73550858581,73550858575,-6,795,3692,30
73551119962,73551119978,16,925,2091,30
73553022018,73553022013,-5,1573,3980,30
73558780575,73558780570,-5,1069,2914,30
73569233539,73569233537,-2,1194,2346,30
73569357085,73569357078,-7,998,2395,30
73578158940,73578158937,-3,1234,2857,30
73579210305,73579210285,-20,748,2142,30
73579772873,73579772868,-5,902,2138,30
73580815753,73580815748,-5,848,2959,30
73588572134,73588572132,-2,904,2463,30
73588809295,73588809289,-6,803,2905,30
73588901906,73588901923,17,196,1029,30
73591683020,73591683024,4,31347,49256,30
73594227886,73594227881,-5,823,2259,30
73594765840,73594765827,-13,1019,2966,30
73595444110,73595444105,-5,982,2842,30
73595755363,73595755349,-14,960,2665,30
73603457150,73603457147,-3,4117,8561,30
73603657387,73603657382,-5,5169,11091,30
73605820191,73605820186,-5,742,1867,30
73616007061,73616007053,-8,1031,4327,30
73616596659,73616596665,6,12458,20610,30
73618618182,73618618177,-5,1219,4077,30
73620365054,73620365050,-4,1205,3606,30
73622600182,73622600178,-4,1142,2947,30
73628959354,73628959350,-4,885,4093,30
73629227546,73629227543,-3,1026,2463,30
73631427182,73631427180,-2,1082,3463,30
73651144322,73651144319,-3,795,1947,30
73663053237,73663053233,-4,939,3130,30
73664301283,73664301275,-8,1074,3427,30
73670179711,73670179707,-4,805,3322,30
73670283364,73670283380,16,747,2356,30
73671495305,73671495306,1,1395,1458,30
73675196047,73675196044,-3,971,3265,30
73675608978,73675608978,0,1434,2437,30
73677130371,73677130369,-2,1393,2650,30
73679525250,73679525246,-4,738,2261,30
73679854076,73679854089,13,400,1430,30
73680549335,73680549329,-6,1021,2399,30
73681233155,73681233161,6,3740,2270,30
73681999266,73681999262,-4,1043,3184,30
73683326634,73683326653,19,672,1982,30
73685879867,73685879861,-6,922,3503,30
73690077108,73690077103,-5,883,2385,30
73693133842,73693133839,-3,1926,3019,30
73698173138,73698173119,-19,231,869,30
73699593432,73699593428,-4,987,2364,30
73704641508,73704641505,-3,1139,3083,30
73707144431,73707144427,-4,1172,2734,30
73712718750,73712718745,-5,1398,3311,30
73714172548,73714172566,18,713,1806,30
73715031706,73715031705,-1,1130,1542,30
73721386927,73721386921,-6,1134,2551,30
73722383162,73722383159,-3,925,3387,30
73731222998,73731222991,-7,1077,2584,30
73737343758,73737343753,-5,1129,2497,30
73738347507,73738347502,-5,1141,3046,30
73738652133,73738652128,-5,1202,2798,30
73738871284,73738871280,-4,1468,2804,30
73741666081,73741666077,-4,1631,3041,30
73750970229,73750970245,16,928,2076,30
73754258257,73754258253,-4,1163,3059,30
73770205905,73770205926,21,606,2281,30
73770264843,73770264843,0,986,2281,30
73770322466,73770322477,11,399,851,30
73772432873,73772432870,-3,1721,2021,30
73773352325,73773352320,-5,765,2490,30
73773685183,73773685180,-3,653,3121,30
73784501644,73784501640,-4,1142,2687,30
73784734322,73784734331,9,180,713,30
73787944033,73787944026,-7,1097,3993,30
73791484976,73791484972,-4,1097,3194,30
73796920054,73796920049,-5,1112,3034,30
73800533671,73800533670,-1,2085,1692,30
73804418526,73804418522,-4,1390,2787,30
73811231000,73811230994,-6,1493,3824,30
73813714836,73813714830,-6,880,2660,30
73813853926,73813853922,-4,1325,3489,30
73814386446,73814386442,-4,757,3103,30
73814813665,73814813686,21,920,3074,30
73818996078,73818996075,-3,982,1396,30
73819212646,73819212642,-4,682,2321,30
73820060740,73820060735,-5,1640,4659,30
73823946227,73823946222,-5,1132,3366,30
73828847418,73828847414,-4,798,2448,30
73834708979,73834708974,-5,1307,3311,30
73839078879,73839078872,-7,833,2941,30
73842115846,73842115843,-3,1069,3003,30
73846868701,73846868696,-5,843,2847,30
73858016730,73858016725,-5,764,2919,30
73862727203,73862727201,-2,1299,2245,30
73863849505,73863849501,-4,2621,6134,30
73866750914,73866750909,-5,1257,3445,30
73866875596,73866875610,14,827,2477,30
73866992127,73866992124,-3,1021,1802,30
73867714101,73867714101,0,1832,1792,30
73875476270,73875476275,5,18717,17052,30
73876202426,73876202426,0,2140,3133,30
73885282405,73885282426,21,632,1756,30
73890381099,73890381094,-5,639,2459,30
73893138322,73893138315,-7,1617,3923,30
73893508808,73893508789,-19,871,2567,30
73893742979,73893742956,-23,386,558,30
73901572518,73901572513,-5,823,3151,30
73901821767,73901821763,-4,573,1284,30
73905334201,73905334205,4,43694,52056,30
73912634536,73912634532,-4,1067,2700,30
73916400858,73916400855,-3,783,3761,30
73917815223,73917815217,-6,1235,4293,30
73928125175,73928125173,-2,1714,2885,30
73931434571,73931434566,-5,1028,1859,30
73935211972,73935211967,-5,919,2592,30
73939117173,73939117169,-4,1238,2903,30
73939246700,73939246676,-24,978,6756,30
73940018935,73940018932,-3,1323,2567,30
73946879257,73946879250,-7,927,2481,30
73953274441,73953274434,-7,1269,2640,30
73955102679,73955102675,-4,1260,2592,30
73963837597,73963837591,-6,860,3002,30
73964147025,73964147005,-20,886,3714,30
73965534149,73965534143,-6,1067,4065,30
73966821202,73966821197,-5,1549,2598,30
73971431542,73971431549,7,5926,2071,30
73979409837,73979409833,-4,989,2939,30
73984216652,73984216650,-2,2014,2479,30
73984440626,73984440617,-9,955,1457,30
73986276185,73986276178,-7,1429,4906,30
73987994977,73987994980,3,2561,1474,30
73988544892,73988544905,13,300,1073,30
74003546931,74003546925,-6,1036,3484,30
74007642558,74007642557,-1,785,1282,30
74008109812,74008109808,-4,927,2700,30
74010222133,74010222133,0,1754,2801,30
74011274739,74011274735,-4,1181,2320,30
74013273670,74013273653,-17,308,1232,30
74021300258,74021300255,-3,1064,3357,30
74021563416,74021563411,-5,1098,2427,30
74021889264,74021889254,-10,1070,2634,30
74022678335,74022678332,-3,1347,2500,30
74023688914,74023688908,-6,745,1640,30
74024446331,74024446325,-6,913,3401,30
74032009243,74032009238,-5,783,2209,30
74036221706,74036221702,-4,1136,3254,30
74037499299,74037499306,7,114,1053,30
74040034397,74040034403,6,3300,934,30
74043558354,74043558349,-5,1017,3110,30
74046838458,74046838445,-13,945,2199,30
74049892591,74049892586,-5,1249,3978,30
74052604670,74052604665,-5,918,2584,30
74054823646,74054823641,-5,835,2286,30
74055225139,74055225129,-10,1464,1727,30
74055368927,74055368922,-5,968,3187,30
74062939818,74062939813,-5,1177,2753,30
74066816086,74066816079,-7,633,3956,30
74070771658,74070771661,3,1489,1467,30
74075134850,74075134847,-3,1457,3992,30
74081512738,74081512736,-2,928,3261,30
74090277604,74090277607,3,2941,2152,30
74109962918,74109962915,-3,1463,2730,30
74117058640,74117058642,2,2811,2009,30
74120729215,74120729209,-6,983,4658,30
74121964802,74121964819,17,932,2460,30
74125409087,74125409089,2,2709,2178,30
74128343918,74128343913,-5,1305,3920,30
74131575466,74131575462,-4,491,2013,30
74132075235,74132075230,-5,1347,4380,30
74132142978,74132142973,-5,1120,4303,30
74136252191,74136252186,-5,773,1624,30
74136878274,74136878290,16,1092,2751,30
74138652273,74138652270,-3,823,2509,30
74139319257,74139319245,-12,1071,2614,30
74142317226,74142317221,-5,1001,3657,30
74142833441,74142833444,3,134,2604,30
74143137257,74143137253,-4,1313,3009,30
74149383913,74149383932,19,512,1857,30
74157399803,74157399798,-5,1053,2859,30
74166706415,74166706411,-4,732,1538,30
74171311745,74171311739,-6,1370,2819,30
74173373199,74173373193,-6,1259,3033,30
74175397077,74175397076,-1,1935,2188,30
74175987247,74175987241,-6,1247,3845,30
74182301265,74182301261,-4,1527,1685,30
74184723417,74184723411,-6,1273,3732,30
74184832064,74184832055,-9,937,2116,30
74185791946,74185791941,-5,718,2497,30
74187032866,74187032861,-5,1220,2388,30
74188584588,74188584581,-7,571,1817,30
74189395324,74189395345,21,771,2245,30
74190175970,74190175966,-4,1181,2909,30
74197606278,74197606273,-5,927,2593,30
74201444179,74201444175,-4,1097,3513,30
74206340987,74206340984,-3,676,2109,30
74207533347,74207533343,-4,975,2566,30
74215163166,74215163161,-5,1232,2972,30
74216861735,74216861729,-6,772,3096,30
74226196311,74226196307,-4,1540,3137,30
74228600655,74228600652,-3,1274,2283,30
74231308958,74231308956,-2,1484,1889,30
74236029870,74236029866,-4,1449,2852,30
74241194413,74241194409,-4,1017,3021,30
74251026149,74251026154,5,3346,1437,30
74254398558,74254398562,4,4441,3495,30
74258185298,74258185294,-4,553,2726,30
74260040774,74260040770,-4,604,2159,30
74265898553,74265898548,-5,1728,3358,30
74271514474,74271514471,-3,915,2149,30
74272668091,74272668085,-6,1251,3859,30
74273882278,74273882282,4,4277,24478,30
74286355927,74286355928,1,1000,1369,30
74287661075,74287661070,-5,1017,2904,30
74288332262,74288332258,-4,1162,4213,30
74289558169,74289558164,-5,888,2443,30
74290042029,74290042024,-5,992,2125,30
74290163828,74290163834,6,120,1316,30
74292207531,74292207530,-1,1691,3106,30
74311359998,74311359994,-4,631,1788,30
74312859218,74312859219,1,3527,3055,30
74316040336,74316040331,-5,1069,2869,30
74319831180,74319831175,-5,834,2479,30
74332142933,74332142930,-3,1189,3517,30
74333122816,74333122838,22,920,1685,30
74333362813,74333362809,-4,1298,3542,30
74338294059,74338294054,-5,1019,2000,30
74342039055,74342039050,-5,1224,2672,30
74342097491,74342097470,-21,1689,2066,30
74342661281,74342661277,-4,1428,3035,30
74345405779,74345405772,-7,1152,7677,30
74348496062,74348496062,0,1864,1828,30
74359780904,74359780898,-6,1110,2879,30
74361070555,74361070550,-5,1214,2659,30
74364035115,74364035110,-5,880,2247,30
74365284382,74365284377,-5,1053,4350,30
74367658493,74367658486,-7,1418,3850,30
74368180998,74368180994,-4,904,2227,30
74368242438,74368242433,-5,825,3628,30
74374274245,74374274249,4,32927,24915,30
74374364834,74374364830,-4,1170,3249,30
74378144239,74378144235,-4,774,2520,30
74381120319,74381120320,1,2136,1976,30
74387830096,74387830103,7,2343,1205,30
74388972178,74388972174,-4,817,2540,30
74389608155,74389608142,-13,254,930,30
74390902135,74390902129,-6,816,2173,30
74391438360,74391438371,11,591,3163,30
74394228212,74394228207,-5,1253,3538,30
74394652568,74394652563,-5,1450,3466,30
74400253351,74400253342,-9,371,3237,30
74402196050,74402196047,-3,907,1879,30
74408004862,74408004857,-5,777,2339,30
74408292400,74408292403,3,216,1021,30
74416091495,74416091497,2,1081,1406,30
74416759465,74416759461,-4,915,2465,30
74417547754,74417547750,-4,771,2545,30
74417787735,74417787729,-6,784,3554,30
74422538990,74422538986,-4,864,2487,30
74423194401,74423194401,0,13988,18413,30
74427147629,74427147624,-5,1401,5626,30
74429010292,74429010286,-6,1205,2681,30
74429199870,74429199866,-4,896,3031,30
74443478491,74443478486,-5,1558,3696,30
74443744288,74443744269,-19,183,1377,30
74445917645,74445917642,-3,1083,2492,30
74447690613,74447690609,-4,1101,2324,30
74452428850,74452428846,-4,1336,3914,30
74458740206,74458740201,-5,853,4302,30
74459258785,74459258781,-4,933,3091,30
74459902351,74459902346,-5,499,1385,30
74462459469,74462459466,-3,915,2643,30
74462966759,74462966755,-4,836,2649,30
74474574976,74474574973,-3,764,1280,30
74475374614,74475374608,-6,1303,3957,30
74476315187,74476315186,-1,1141,1977,30
74478972223,74478972223,0,1444,1713,30
74479250534,74479250529,-5,922,2651,30
74483607189,74483607184,-5,1009,2836,30
74485215069,74485215066,-3,716,2606,30
74489263242,74489263235,-7,1058,5461,30
74490831613,74490831609,-4,1098,2501,30
74491103604,74491103622,18,45,1028,30
74492856255,74492856252,-3,1122,2605,30
74497425447,74497425442,-5,1038,2337,30
74504706190,74504706186,-4,1316,4242,30
74505030066,74505030082,16,881,2433,30
74509054304,74509054301,-3,24920,14855,30
74512396725,74512396715,-10,167,741,30
74516646914,74516646917,3,2817,3179,30
74517077427,74517077425,-2,1744,2969,30
74519559026,74519559031,5,2686,979,30
74520871484,74520871481,-3,1154,1628,30
74529803923,74529803918,-5,521,2236,30
74531190356,74531190350,-6,937,2922,30
74534148962,74534148957,-5,669,3215,30
74545406615,74545406611,-4,861,2004,30
74547450285,74547450282,-3,1117,2246,30
74549355094,74549355089,-5,1641,3722,30
74550085715,74550085711,-4,1134,4456,30
74562651418,74562651417,-1,1280,2217,30
74567272466,74567272462,-4,707,2393,30
74568607155,74568607172,17,627,2896,30
74571994215,74571994207,-8,1007,2634,30
74572750572,74572750587,15,660,2379,30
74572999959,74572999957,-2,1025,2579,30
74581978220,74581978214,-6,1019,2467,30
74582175186,74582175191,5,227,867,30
74586968264,74586968259,-5,1135,2475,30
74587064195,74587064209,14,201,872,30
74591091254,74591091248,-6,846,1987,30
74591984551,74591984546,-5,1284,3418,30
74592647918,74592647914,-4,1417,2472,30
74610718871,74610718867,-4,836,3124,30
74611068050,74611068046,-4,1043,3109,30
74612719273,74612719269,-4,536,2041,30
74619712690,74619712686,-4,955,3160,30
74621662322,74621662318,-4,1436,2248,30
74625105774,74625105792,18,1513,2394,30
74627336050,74627336056,6,2049,957,30
74628637670,74628637670,0,1135,1877,30
74630342171,74630342168,-3,1127,4064,30
74632538019,74632538014,-5,1094,2555,30
74633711250,74633711248,-2,1004,2066,30
74640399679,74640399675,-4,845,2784,30
74641946097,74641946102,5,15676,8453,30
74644975528,74644975525,-3,1300,3452,30
74645224970,74645224966,-4,1255,3560,30
74648183823,74648183820,-3,849,3462,30
74648762580,74648762594,14,374,2518,30
74650881572,74650881566,-6,1126,3539,30
74652525158,74652525154,-4,1387,2711,30
74653037014,74653037013,-1,2239,17406,30
74653552558,74653552554,-4,1223,4450,30
74655318605,74655318602,-3,1270,2110,30
74656087702,74656087703,1,2153,1760,30
74660492197,74660492193,-4,1309,3815,30
74661081608,74661081630,22,411,1570,30
74662740724,74662740722,-2,907,1572,30
74664464817,74664464814,-3,1022,2053,30
74666052027,74666052022,-5,823,3695,30
74667804645,74667804646,1,1353,1668,30
74671575353,74671575358,5,8367,25368,30
74675788310,74675788306,-4,1237,2038,30
74679143801,74679143807,6,6292,31311,30
74683597914,74683597914,0,949,1845,30
74685308636,74685308631,-5,1515,2642,30
74687615986,74687615981,-5,1032,3597,30
74691732789,74691732785,-4,1352,3179,30
74695019950,74695019947,-3,919,2891,30
74702240558,74702240558,0,1862,1891,30
74704748267,74704748263,-4,1223,2395,30
74709025542,74709025537,-5,1070,3505,30
74709635074,74709635070,-4,704,1707,30
74709894011,74709894030,19,634,1740,30
74724720889,74724720887,-2,1099,1984,30
74729895671,74729895666,-5,647,2243,30
74730691919,74730691913,-6,799,3137,30
74736509178,74736509178,0,1471,645,30
74738325527,74738325522,-5,1117,3802,30
74739790162,74739790157,-5,661,2387,30
74740678781,74740678778,-3,863,2178,30
74744505343,74744505332,-11,2230,461,30
74746209700,74746209699,-1,1301,2804,30
74749205824,74749205818,-6,1433,3648,30
74749408504,74749408525,21,587,2483,30
74750209213,74750209209,-4,1436,4063,30
74751189766,74751189763,-3,1085,2345,30
74757095810,74757095811,1,988,1077,30
74757875299,74757875296,-3,1396,3095,30
74761524227,74761524222,-5,1369,5218,30
74761571903,74761571902,-1,1357,2182,30
74761685804,74761685802,-2,1048,2205,30
74762374083,74762374078,-5,911,2460,30
74765207296,74765207291,-5,1103,2966,30
74769691075,74769691070,-5,1442,4550,30
74769972376,74769972396,20,680,3428,30
74774843230,74774843225,-5,908,2151,30
74775681086,74775681081,-5,1146,3051,30
74784246741,74784246735,-6,797,3322,30
74784378933,74784378929,-4,751,3007,30
74790900150,74790900143,-7,833,3448,30
74795216677,74795216685,8,1748,1064,30
74796135534,74796135530,-4,1981,5622,30
74797116091,74797116087,-4,561,1718,30
74797624262,74797624257,-5,898,3071,30
74804196485,74804196483,-2,1192,1791,30
74804480665,74804480681,16,833,1609,30
74810713519,74810713514,-5,934,2976,30
74817419273,74817419268,-5,959,3574,30
74819219892,74819219887,-5,1327,2409,30
74819336753,74819336749,-4,1262,2698,30
74821221616,74821221610,-6,1016,2767,30
74825430562,74825430559,-3,787,2280,30
74830608218,74830608224,6,4511,2965,30
74834565110,74834565105,-5,1157,3355,30
74837940555,74837940558,3,1267,767,30
74838774538,74838774534,-4,343,964,30
74840258461,74840258457,-4,1224,3662,30
74840407572,74840407591,19,338,1042,30
74842923589,74842923583,-6,840,2761,30
74852360706,74852360700,-6,679,2502,30
74855126884,74855126879,-5,1077,2748,30
74857434986,74857434983,-3,978,3392,30
74859635089,74859635101,12,469,1152,30
74862422280,74862422281,1,698,1514,30
74865477802,74865477802,0,1927,2164,30
74869001067,74869001067,0,692,964,30
74869348471,74869348465,-6,928,2705,30
74869704364,74869704366,2,7,893,30
74870838654,74870838650,-4,777,2042,30
74871490082,74871490078,-4,1126,3092,30
74875271558,74875271554,-4,995,3164,30
74882500872,74882500868,-4,1123,3008,30
74883515535,74883515530,-5,939,2689,30
74884741651,74884741647,-4,1197,2400,30
74887658029,74887658025,-4,708,1641,30
74888436361,74888436377,16,330,1844,30
74889176471,74889176465,-6,593,2521,30
74890645770,74890645787,17,302,1234,30
74892782270,74892782266,-4,1027,2469,30
74897915581,74897915577,-4,956,3652,30
74898349404,74898349399,-5,1027,3225,30
74906055750,74906055745,-5,804,2308,30
74908094015,74908094010,-5,1541,3992,30
74909114958,74909114953,-5,1008,3526,30
74912151156,74912151161,5,4601,2595,30
74912568497,74912568491,-6,1108,3932,30
74912854618,74912854614,-4,3471,8781,30
74918462970,74918462965,-5,1048,3669,30
74919525205,74919525209,4,1639,1594,30
74919655949,74919655946,-3,1468,2441,30
74926473607,74926473602,-5,1450,3625,30
74927297824,74927297820,-4,1180,2372,30
74927343930,74927343909,-21,248,1135,30
74929230552,74929230566,14,574,1754,30
74930083462,74930083458,-4,1160,2855,30
74930142668,74930142674,6,167,1483,30
74933229790,74933229787,-3,959,3157,30
74934339322,74934339318,-4,882,3315,30
74934583040,74934583030,-10,201,1526,30
74946340149,74946340146,-3,1181,3667,30
74946428201,74946428218,17,652,1679,30
74961692531,74961692526,-5,899,2610,30
74961720249,74961720242,-7,105,914,30
74966277754,74966277747,-7,729,7560,30
74966823334,74966823327,-7,1177,2975,30
74969693811,74969693806,-5,1371,3426,30
74970486126,74970486123,-3,1190,2045,30
74970920689,74970920685,-4,730,2207,30
74971152314,74971152298,-16,69,502,30
74971386063,74971386058,-5,1377,3286,30
74975666161,74975666156,-5,1102,2836,30
74976708973,74976708971,-2,768,2287,30
74977283123,74977283109,-14,97,1295,30
74978227429,74978227423,-6,1164,3192,30
74985169303,74985169300,-3,1247,3209,30
74985932058,74985932057,-1,1342,1954,30
74987782759,74987782757,-2,2069,2463,30
74989867714,74989867734,20,372,1387,30
74994900712,74994900730,18,840,2867,30
74996567546,74996567542,-4,877,1861,30
74998539421,74998539414,-7,1113,2072,30
74999608964,74999608965,1,6542,8178,30
75000073899,75000073894,-5,1295,3164,30
75001495689,75001495685,-4,1043,2798,30
75005994934,75005994929,-5,1064,2942,30
75006293726,75006293729,3,2881,1600,30
75009193487,75009193482,-5,861,2881,30
75012852875,75012852871,-4,829,2274,30
75013127983,75013127976,-7,983,2820,30
75014902181,75014902176,-5,1255,3797,30
75026455842,75026455838,-4,902,3267,30
75026943811,75026943806,-5,1242,3059,30
75027784978,75027784973,-5,1575,2794,30
75031199303,75031199297,-6,1181,3889,30
75032904413,75032904409,-4,20752,16003,30
75033360645,75033360639,-6,1454,3642,30
75035742889,75035742885,-4,888,3336,30
75036115539,75036115542,3,134,855,30
75038458295,75038458291,-4,854,3145,30
75042267444,75042267440,-4,770,1793,30
75050321215,75050321209,-6,873,2905,30
75053743574,75053743574,0,1643,1410,30
75058799421,75058799418,-3,1216,2771,30
75058833858,75058833877,19,674,2035,30
75063658396,75063658403,7,3980,2046,30
75073442010,75073442003,-7,944,3714,30
75076967012,75076967005,-7,1505,7070,30
75084860654,75084860650,-4,1159,2372,30
75085159808,75085159827,19,1044,3813,30
75086589501,75086589496,-5,1406,3658,30
75088225013,75088225009,-4,1047,1931,30
75088876022,75088876018,-4,1185,2638,30
75090746353,75090746349,-4,1292,2657,30
75091915915,75091915911,-4,1009,2500,30
75103149917,75103149916,-1,1362,2294,30
75108845647,75108845643,-4,1100,2319,30
75110325531,75110325528,-3,793,3276,30
75110476755,75110476750,-5,848,2725,30
75112523283,75112523278,-5,1073,3075,30
75113010267,75113010287,20,1100,2287,30
75114038504,75114038501,-3,687,1479,30
75116196198,75116196197,-1,502,1445,30
75120304262,75120304278,16,532,1817,30
75121863122,75121863121,-1,989,2041,30
75123847578,75123847570,-8,845,5234,30
75124117810,75124117806,-4,831,1931,30
75128805842,75128805841,-1,861,1723,30
75136560042,75136560039,-3,1096,2398,30
75137281966,75137281962,-4,1227,3260,30
75138204986,75138204980,-6,1139,3006,30
75140441533,75140441529,-4,1526,4789,30
75150709655,75150709650,-5,677,2780,30
75152086458,75152086461,3,1547,1287,30
75153479270,75153479265,-5,1069,2872,30
75157044990,75157044986,-4,1016,2736,30
75168998038,75168998033,-5,1298,2800,30
75172862695,75172862681,-14,1025,2548,30
75174002843,75174002834,-9,33324,12492,30
75180162462,75180162457,-5,982,3092,30
75181631870,75181631865,-5,796,2733,30
75183678547,75183678542,-5,1085,2168,30
75184967015,75184967010,-5,1144,3072,30
75185082489,75185082494,5,13007,6667,30
75189908262,75189908254,-8,1151,5715,30
75195281838,75195281832,-6,981,2429,30
75198010157,75198010155,-2,1285,2568,30
75198427807,75198427802,-5,756,2807,30
75199796903,75199796900,-3,849,2663,30
75205142449,75205142445,-4,762,2028,30
75207449128,75207449123,-5,1081,2882,30
75209500642,75209500624,-18,1006,3164,30
75210176624,75210176630,6,5631,2317,30
75211226406,75211226403,-3,393,1788,30
75215876898,75215876893,-5,1500,3512,30
75216064026,75216064010,-16,251,676,30
75216747890,75216747886,-4,1639,4221,30
75217247340,75217247322,-18,893,2427,30
75219572290,75219572286,-4,1066,2862,30
75221360041,75221360035,-6,1255,3664,30
75221989769,75221989764,-5,1098,2685,30
75223867213,75223867210,-3,1179,1557,30
75225887681,75225887683,2,1532,2187,30
75226697010,75226697006,-4,1017,2784,30
75228744193,75228744212,19,959,3636,30
75228819905,75228819907,2,4038,17420,30
75230284757,75230284754,-3,951,2347,30
75234175644,75234175638,-6,902,4605,30
75237861349,75237861344,-5,820,1492,30
75238819215,75238819210,-5,1111,2870,30
75239929230,75239929225,-5,795,3465,30
75244408941,75244408937,-4,689,1803,30
75244481779,75244481774,-5,1497,3344,30
75244512678,75244512681,3,1520,1315,30
75250842245,75250842240,-5,844,2809,30
75260049701,75260049694,-7,1094,3564,30
75265057587,75265057583,-4,837,2457,30
75265635147,75265635167,20,247,2300,30
75267960053,75267960056,3,1518,935,30
75271026199,75271026195,-4,986,2302,30
75274433958,75274433955,-3,1118,2673,30
75278030193,75278030187,-6,1150,2866,30
75278682805,75278682803,-2,1025,2435,30
75278985996,75278986010,14,443,848,30
75279343833,75279343829,-4,941,1576,30
75281609997,75281609993,-4,956,2336,30
75282175619,75282175614,-5,1618,2798,30
75286521535,75286521529,-6,1019,2524,30
75286555491,75286555506,15,1082,2804,30
75287615589,75287615594,5,3566,1446,30
75293915162,75293915155,-7,1231,2918,30
75298991638,75298991634,-4,1458,2555,30
75299101943,75299101938,-5,711,3129,30
75309926010,75309926006,-4,1147,3328,30
75319550201,75319550194,-7,1506,4351,30
75326973930,75326973924,-6,1344,2733,30
75333352106,75333352101,-5,1043,2090,30
75333440112,75333440122,10,164,1135,30
75335330772,75335330769,-3,934,2887,30
75336040148,75336040142,-6,1483,5423,30
75336163580,75336163595,15,166,922,30
75337333342,75337333339,-3,704,3099,30
75337655675,75337655672,-3,962,3169,30
75339924009,75339924004,-5,948,2397,30
75342043958,75342043962,4,1569,1253,30
75351280494,75351280488,-6,879,3521,30
75362897925,75362897921,-4,948,2445,30
75363414234,75363414248,14,272,597,30
75370193722,75370193722,0,6453,10582,30
75372978326,75372978321,-5,1059,2758,30
75373164267,75373164262,-5,1262,3048,30
75375216525,75375216519,-6,1135,3514,30
75381763175,75381763170,-5,1024,2339,30
75382440214,75382440209,-5,1014,2554,30
75388018159,75388018157,-2,844,1959,30
75388489773,75388489771,-2,1967,2908,30
75392882335,75392882332,-3,1307,3087,30
75392966850,75392966853,3,3023,2897,30
75394921295,75394921296,1,1125,2001,30
75404173443,75404173437,-6,1051,2650,30
75405891407,75405891402,-5,1152,2340,30
75410736699,75410736695,-4,1268,3373,30
75410795889,75410795884,-5,1463,4225,30
75414441707,75414441703,-4,1670,3806,30
75420550976,75420550973,-3,959,2441,30
75426228578,75426228574,-4,1387,3659,30
75427141430,75427141425,-5,907,2832,30
75432591629,75432591625,-4,983,2557,30
75432638979,75432638997,18,708,1014,30
75436491580,75436491579,-1,1380,1694,30
75436783801,75436783798,-3,1020,2031,30
75438231662,75438231659,-3,702,2682,30
75438281937,75438281957,20,743,2197,30
75439275442,75439275431,-11,12763,38003,30
75439596554,75439596550,-4,1544,4952,30
75443084859,75443084854,-5,768,1988,30
75448103842,75448103839,-3,933,4049,30
75449518391,75449518387,-4,1076,2907,30
75449917591,75449917588,-3,872,1856,30
75452847559,75452847554,-5,1054,2790,30
75456564617,75456564611,-6,1046,2329,30
75460378401,75460378396,-5,1158,3648,30
75464340490,75464340484,-6,737,2364,30
75464489891,75464489880,-11,967,2516,30
75464887750,75464887745,-5,1041,2702,30
75465201468,75465201470,2,2490,1344,30
75474014195,75474014190,-5,518,1326,30
75474885539,75474885536,-3,1822,2494,30
75475407298,75475407290,-8,941,3215,30
75481623391,75481623386,-5,1519,4036,30
75485628900,75485628901,1,1809,2315,30
75487559183,75487559179,-4,1136,3442,30
75488386017,75488386012,-5,880,5120,30
75488961247,75488961243,-4,1004,2719,30
75492061574,75492061572,-2,918,2785,30
75496291537,75496291535,-2,3251,5366,30
75500162394,75500162393,-1,1103,1872,30
75500304811,75500304807,-4,1172,3080,30
75505860617,75505860613,-4,1085,2800,30
75507006605,75507006601,-4,1329,2958,30
75507965394,75507965389,-5,1027,4005,30
75508331731,75508331727,-4,869,2458,30
75508631036,75508631052,16,920,2299,30
75510125354,75510125359,5,9485,4679,30
75511546375,75511546370,-5,1100,2717,30
75511698139,75511698135,-4,1339,4237,30
75512546655,75512546653,-2,1117,2623,30
75513203528,75513203522,-6,843,3601,30
75514901786,75514901802,16,952,2666,30
75520718660,75520718654,-6,1019,1999,30
75520795337,75520795351,14,358,1381,30
75520972622,75520972618,-4,769,1742,30
75521136560,75521136557,-3,1102,1491,30
75531387111,75531387107,-4,1129,3540,30
75565521692,75565521686,-6,1010,1990,30
75573256786,75573256785,-1,817,2972,30
75578241899,75578241895,-4,817,2381,30
75583031121,75583031134,13,3199,1277,30
75584887639,75584887637,-2,19152,9402,30
75586300263,75586300254,-9,827,2881,30
75586494968,75586494980,12,47,899,30
75587186491,75587186497,6,189,844,30
75589112355,75589112343,-12,1022,2425,30
75604802880,75604802874,-6,1172,3302,30
75606330666,75606330670,4,3112,1869,30
75611609467,75611609461,-6,860,3654,30
75611652736,75611652757,21,219,727,30
75614907533,75614907529,-4,885,2835,30
75619874387,75619874386,-1,2096,2596,30
75623395641,75623395629,-12,186,1207,30
75623902595,75623902609,14,40,1212,30
75629443102,75629443098,-4,1513,3294,30
75630654975,75630654972,-3,904,2304,30
75631527963,75631527958,-5,1004,3044,30
75631839343,75631839337,-6,1060,2669,30
75637381982,75637381981,-1,1079,2765,30
75646440867,75646440862,-5,957,2207,30
75646723801,75646723794,-7,264,814,30
75647642514,75647642509,-5,957,3089,30
75653667611,75653667606,-5,822,2661,30
75666549328,75666549322,-6,1149,4481,30
75667675433,75667675428,-5,958,3786,30
75667875475,75667875470,-5,1250,3494,30
75668758446,75668758442,-4,880,3054,30
75672723155,75672723149,-6,1026,1621,30
75680713111,75680713109,-2,905,2100,30
75684655343,75684655341,-2,1016,2300,30
75684770660,75684770646,-14,70,448,30
75684867663,75684867657,-6,1434,4488,30
75691053458,75691053452,-6,469,2986,30
75691292331,75691292318,-13,1062,2847,30
75693958605,75693958604,-1,1688,2490,30
75701728598,75701728593,-5,865,1649,30
75706418642,75706418637,-5,524,2349,30
75707149606,75707149602,-4,1370,2886,30
75707498346,75707498363,17,1081,2510,30
75711508179,75711508183,4,2586,1441,30
75716505157,75716505152,-5,574,2604,30
75718737677,75718737674,-3,1077,2015,30
75720006697,75720006693,-4,914,3156,30
75730991985,75730991986,1,3837,3914,30
75732916175,75732916168,-7,665,1472,30
75735497450,75735497448,-2,1324,2079,30
75744236451,75744236446,-5,1480,2954,30
75745828932,75745828924,-8,1245,2936,30
75746045484,75746045491,7,460,2668,30
75749379102,75749379098,-4,1454,2340,30
75751946156,75751946150,-6,1017,2803,30
75752701405,75752701401,-4,837,1894,30
75756007619,75756007615,-4,1250,3126,30
75756034423,75756034428,5,10951,3811,30
75757065773,75757065767,-6,924,2225,30
75765437363,75765437358,-5,1052,2303,30
75770740601,75770740597,-4,1254,3510,30
75774119279,75774119274,-5,1016,3969,30
75778194522,75778194520,-2,1104,2268,30
75780774747,75780774741,-6,641,3029,30
75782845953,75782845947,-6,1232,3534,30
75784123463,75784123479,16,506,2212,30
75784155924,75784155922,-2,1550,1730,30
75784274438,75784274435,-3,849,2581,30
75789580649,75789580644,-5,1003,2673,30
75796399499,75796399498,-1,1133,1698,30
75797343842,75797343838,-4,1074,2855,30
75802125366,75802125359,-7,1578,5135,30
75802743824,75802743824,0,23771,18010,30
75807750527,75807750523,-4,735,2463,30
75808678722,75808678718,-4,961,3467,30
75812752580,75812752580,0,1189,2019,30
75819618566,75819618561,-5,1172,2480,30
75819950314,75819950333,19,107,1172,30
75823805540,75823805539,-1,1216,1380,30
75824622022,75824622015,-7,427,1361,30
75825547090,75825547088,-2,1092,2687,30
75827082269,75827082265,-4,953,1988,30
75833933888,75833933884,-4,983,2893,30
75840737031,75840737027,-4,1012,2781,30
75841879010,75841879005,-5,1023,2977,30
75846891494,75846891489,-5,1273,3813,30
75850842999,75850842997,-2,984,2310,30
75853153912,75853153906,-6,1197,2870,30
75853819915,75853819911,-4,645,2688,30
75860577509,75860577505,-4,693,1931,30
75868431746,75868431746,0,1517,1591,30
75869633883,75869633886,3,1134,1341,30
75871770490,75871770486,-4,1133,2911,30
75872180580,75872180592,12,353,5256,30
75874053376,75874053379,3,1660,2099,30
75874212347,75874212342,-5,898,2732,30
75877040334,75877040327,-7,1112,3887,30
75877275618,75877275607,-11,11927,27162,30
75877336969,75877336964,-5,1444,2880,30
75879129846,75879129841,-5,559,1682,30
75880418418,75880418419,1,1370,1906,30
75892693924,75892693915,-9,967,2048,30
75897770323,75897770320,-3,958,3389,30
75900194330,75900194326,-4,1414,3305,30
75902242527,75902242523,-4,793,2844,30
75905103466,75905103483,17,3245,1488,30
75907996608,75907996607,-1,1483,2101,30
75908552883,75908552878,-5,1137,2700,30
75913905038,75913905039,1,3050,3298,30
75917963417,75917963413,-4,858,3261,30
75918756190,75918756186,-4,1153,3423,30
75922711778,75922711773,-5,992,2071,30
75922772288,75922772284,-4,809,2292,30
75926616742,75926616738,-4,1275,3396,30
75927206661,75927206657,-4,1024,3597,30
75928062226,75928062224,-2,1156,2464,30
75938106297,75938106290,-7,96,856,30
75948923361,75948923357,-4,1010,2469,30
75952090245,75952090238,-7,1485,3154,30
75952889448,75952889444,-4,913,2530,30
75954131991,75954131986,-5,1380,3234,30
75955663938,75955663957,19,149,855,30
75958387751,75958387744,-7,964,5057,30
75966174206,75966174202,-4,1035,2262,30
75968192515,75968192495,-20,2004,1672,30
75968850187,75968850187,0,1455,3278,30
75969003169,75969003163,-6,997,2752,30
75971740549,75971740545,-4,889,1557,30
75975706942,75975706937,-5,1294,3542,30
75976742955,75976742954,-1,618,1841,30
75977780035,75977780030,-5,917,3612,30
75980030346,75980030341,-5,1127,2474,30
75980747344,75980747340,-4,1285,2593,30
75982138722,75982138727,5,5887,2574,30
75990640091,75990640086,-5,1112,3813,30
75992988739,75992988758,19,1078,2529,30
75994434493,75994434489,-4,798,2422,30
75999197742,75999197737,-5,1411,4706,30
75999363890,75999363906,16,387,1230,30
75999986722,75999986721,-1,2717,16036,30
76000670235,76000670230,-5,501,1935,30
76001360593,76001360588,-5,1187,2755,30
76006013423,76006013418,-5,1347,3805,30
76006523553,76006523547,-6,940,2225,30
76008334187,76008334183,-4,647,2474,30
76010666436,76010666433,-3,273,1764,30
76011186527,76011186522,-5,1062,3217,30
76011305878,76011305874,-4,1060,3581,30
76017981178,76017981175,-3,1057,2490,30
76028284759,76028284756,-3,1160,2266,30
76031219234,76031219238,4,3386,2173,30
76031782881,76031782876,-5,1517,2706,30
76035652088,76035652084,-4,1568,2463,30
76036612731,76036612726,-5,848,2543,30
76040433305,76040433306,1,1064,2314,30
76048881666,76048881662,-4,1134,2932,30
76055521007,76055521004,-3,898,2037,30
76055664306,76055664285,-21,9,1399,30
76056967881,76056967883,2,1768,1493,30
76057715501,76057715496,-5,954,2581,30
76064014235,76064014231,-4,867,3255,30
76071336048,76071336051,3,3142,2525,30
76072000823,76072000818,-5,1032,2261,30
76074043151,76074043146,-5,909,2164,30
76080061810,76080061807,-3,1070,2571,30
76080678827,76080678833,6,430,8516,30
76082215815,76082215812,-3,1457,2497,30
76082535857,76082535852,-5,1320,3471,30
76087874287,76087874283,-4,1571,4254,30
76088968268,76088968264,-4,1601,2825,30
76091825891,76091825894,3,1396,984,30
76095215753,76095215749,-4,1236,3086,30
76095410224,76095410237,13,414,1613,30
76095570579,76095570569,-10,103,1163,30
76097417754,76097417750,-4,936,2632,30
76103161824,76103161821,-3,1038,2624,30
76105099350,76105099346,-4,1522,3377,30
76115720930,76115720926,-4,627,2470,30
76135349386,76135349385,-1,1337,2482,30
76138357340,76138357335,-5,1268,3570,30
76148030535,76148030531,-4,1079,2398,30
76149182390,76149182390,0,1297,1345,30
76149868893,76149868889,-4,1115,2408,30
76154294070,76154294066,-4,1046,2980,30
76155027255,76155027251,-4,451,783,30
76157178511,76157178506,-5,1419,3361,30
76159059024,76159059019,-5,1079,2626,30
76159225182,76159225178,-4,1223,2811,30
76162880721,76162880717,-4,616,1545,30
76163201070,76163201067,-3,725,2588,30
76163639043,76163639051,8,461,1278,30
76165096464,76165096468,4,2538,1134,30
76166388296,76166388293,-3,1357,2155,30
76167690466,76167690462,-4,594,1938,30
76169086953,76169086934,-19,1101,2529,30
76171706577,76171706571,-6,1096,2627,30
76173063627,76173063623,-4,743,1703,30
76175556885,76175556881,-4,754,2796,30
76175860536,76175860530,-6,41903,15564,30
76177876555,76177876551,-4,1116,2179,30
76179514871,76179514865,-6,1158,2975,30
76180675931,76180675929,-2,968,1928,30
76182472757,76182472752,-5,35951,19156,30
76184765247,76184765243,-4,1047,3108,30
76185299505,76185299527,22,694,1207,30
76202211138,76202211137,-1,1471,1814,30
76203639338,76203639334,-4,637,2102,30
76203794882,76203794901,19,1175,3076,30
76214155297,76214155293,-4,956,2381,30
76217824730,76217824725,-5,892,2884,30
76219890899,76219890897,-2,830,2477,30
76220829224,76220829210,-14,86,1429,30
76220968304,76220968303,-1,163,952,30
76221872421,76221872417,-4,1051,3716,30
76226128879,76226128875,-4,1509,3595,30
76230436232,76230436238,6,2323,1426,30
76231093701,76231093708,7,2736,1282,30
76232192855,76232192850,-5,1352,2058,30
76233939290,76233939286,-4,1010,1825,30
76236119469,76236119466,-3,887,2817,30
76236688964,76236688981,17,723,2919,30
76237053375,76237053370,-5,1340,2711,30
76238852181,76238852178,-3,502,1801,30
76239031769,76239031758,-11,174,1197,30
76240680841,76240680837,-4,1384,2147,30
76242189776,76242189772,-4,942,2780,30
76242701521,76242701518,-3,17700,48414,30
76246221906,76246221902,-4,1501,4001,30
76246346339,76246346330,-9,1106,3483,30
76248001542,76248001539,-3,820,2570,30
76248463002,76248462994,-8,1000,3154,30
76249313677,76249313674,-3,665,1723,30
76250034180,76250034190,10,196,1233,30
76251767167,76251767163,-4,947,1857,30
76252382019,76252382036,17,987,2411,30
76257064171,76257064164,-7,1549,7127,30
76258037680,76258037678,-2,701,1656,30
76260198872,76260198871,-1,1150,2721,30
76266077179,76266077174,-5,1160,2996,30
76267785597,76267785591,-6,884,3141,30
76268803771,76268803767,-4,1384,3197,30
76269106646,76269106642,-4,1746,3920,30
76277068717,76277068712,-5,807,2294,30
76277505634,76277505629,-5,1654,3328,30
76278648995,76278648990,-5,1214,2685,30
76278694808,76278694823,15,437,1007,30
76280720811,76280720809,-2,1069,2289,30
76286354098,76286354094,-4,1014,3308,30
76286522999,76286522994,-5,1226,4840,30
76289034074,76289034071,-3,807,2614,30
76294568355,76294568353,-2,1028,2290,30
76295274846,76295274838,-8,942,3932,30
76296538061,76296538055,-6,744,2027,30
76296901056,76296901072,16,795,2321,30
76299045625,76299045621,-4,951,2659,30
76299843604,76299843602,-2,1001,1652,30
76301040323,76301040319,-4,626,3083,30
76301174027,76301174014,-13,1160,3986,30
76301221539,76301221537,-2,1009,2001,30
76303579669,76303579666,-3,1249,2892,30
76309924119,76309924118,-1,617,1055,30
76316399221,76316399218,-3,1077,3495,30
76316982924,76316982937,13,518,2419,30
76318324703,76318324699,-4,598,1535,30
76321383217,76321383213,-4,1139,3257,30
76326898639,76326898635,-4,970,2818,30
76328165058,76328165053,-5,862,2239,30
76344663049,76344663046,-3,1300,2785,30
76351498169,76351498173,4,1968,1908,30
76355638642,76355638638,-4,843,3102,30
76356655855,76356655849,-6,1127,3374,30
76357956931,76357956927,-4,1152,2681,30
76365765374,76365765370,-4,1248,2421,30
76368554092,76368554093,1,1857,1465,30
76368948771,76368948766,-5,959,1689,30
76374810175,76374810170,-5,1067,1911,30
76375471850,76375471848,-2,895,2042,30
76377864002,76377864004,2,617,1115,30
76382034911,76382034908,-3,849,2754,30
76383344657,76383344653,-4,958,2509,30
76394867092,76394867100,8,12594,44829,30
76397942415,76397942410,-5,1325,2489,30
76400268314,76400268309,-5,658,2233,30
76404538826,76404538821,-5,1268,3380,30
76410186625,76410186631,6,2823,1378,30
76411001967,76411001962,-5,1068,2552,30
76411515830,76411515826,-4,746,2717,30
76416041359,76416041355,-4,991,3162,30
76420346662,76420346658,-4,1082,2156,30
76423163862,76423163860,-2,913,2968,30
76432293035,76432293031,-4,823,2640,30
76440089413,76440089418,5,3011,1340,30
76440127726,76440127722,-4,1182,2644,30
76442317151,76442317146,-5,1840,4406,30
76443486190,76443486186,-4,823,2594,30
76446434655,76446434650,-5,1352,3835,30
76448664026,76448664021,-5,981,1568,30
76454525586,76454525581,-5,807,2848,30
76455562027,76455562011,-16,330,770,30
76456545283,76456545280,-3,1024,2387,30
76457201439,76457201434,-5,878,3031,30
76459280397,76459280399,2,1685,1798,30
76462945634,76462945629,-5,1261,2976,30
76465110803,76465110798,-5,940,3044,30
76466282408,76466282431,23,915,3162,30
76466439945,76466439942,-3,1210,2623,30
76473377293,76473377290,-3,1125,2104,30
76478198751,76478198748,-3,803,2252,30
76479621042,76479621038,-4,775,2697,30
76480168126,76480168126,0,1049,3071,30
76482572810,76482572805,-5,910,2225,30
76483009300,76483009295,-5,1119,2633,30
76485008512,76485008512,0,20655,18124,30
76485982490,76485982486,-4,721,2517,30
76487108507,76487108523,16,382,1485,30
76487874049,76487874042,-7,189,883,30
76500128198,76500128194,-4,1227,2780,30
76501728582,76501728586,4,3649,1953,30
76506230542,76506230546,4,2735,1776,30
76506761924,76506761920,-4,1359,2596,30
76507496634,76507496617,-17,769,1793,30
76508133258,76508133279,21,132,1062,30
76509972579,76509972574,-5,1261,4170,30
76512010111,76512010107,-4,1163,2637,30
76519438758,76519438751,-7,974,4555,30
76524115786,76524115779,-7,1375,4374,30
76524152626,76524152604,-22,711,1850,30
76527109822,76527109818,-4,1232,1959,30
76528418946,76528418958,12,207,557,30
76532217782,76532217778,-4,1094,2868,30
76541276093,76541276087,-6,1047,4085,30
76541858209,76541858200,-9,1011,3160,30
76542472970,76542472991,21,320,785,30
76545629759,76545629752,-7,2261,10898,30
76546988138,76546988134,-4,1387,4350,30
76550816479,76550816473,-6,949,2788,30
76554959811,76554959805,-6,867,2513,30
76568615249,76568615246,-3,1379,3352,30
76569074938,76569074933,-5,873,2609,30
76571938790,76571938782,-8,1147,3303,30
76573052128,76573052122,-6,1039,2505,30
76574546108,76574546103,-5,987,2993,30
76575980772,76575980775,3,22261,20731,30
76581100379,76581100375,-4,1411,4257,30
76582103047,76582103046,-1,970,1589,30
76582977868,76582977886,18,998,2894,30
76583724787,76583724783,-4,872,1865,30
76586254465,76586254464,-1,712,1983,30
76591750598,76591750612,14,516,1104,30
76593641254,76593641255,1,1313,1253,30
76597366810,76597366811,1,1458,1691,30
76601057711,76601057708,-3,1391,3601,30
76603341014,76603341010,-4,904,3299,30
76604701131,76604701126,-5,869,2708,30
76608913866,76608913862,-4,1035,2407,30
76611011693,76611011689,-4,1053,3086,30
76611830826,76611830821,-5,926,2747,30
76612538799,76612538795,-4,1047,3171,30
76612826982,76612826987,5,95,3021,30
76613052610,76613052590,-20,160,834,30
76613794212,76613794221,9,135,1089,30
76620058289,76620058284,-5,620,2688,30
76626606295,76626606290,-5,1037,2740,30
76626758859,76626758869,10,106,1064,30
76629235922,76629235941,19,1109,1068,30
76629816908,76629816904,-4,1660,3182,30
76631517514,76631517513,-1,3746,5112,30
76636871458,76636871453,-5,1105,3319,30
76636935129,76636935145,16,1047,2253,30
76639611845,76639611840,-5,989,2974,30
76645121470,76645121466,-4,1233,2494,30
76646488130,76646488133,3,1139,1447,30
76648130600,76648130597,-3,838,2866,30
76648453579,76648453574,-5,1365,3656,30
76655207389,76655207385,-4,1144,3093,30
76657398403,76657398398,-5,851,2185,30
76661114101,76661114097,-4,987,1838,30
76662360757,76662360753,-4,760,3479,30
76663059992,76663060014,22,1251,3466,30
76667708735,76667708730,-5,662,2376,30
76667799380,76667799398,18,199,909,30
76671592108,76671592103,-5,1192,3742,30
76671888385,76671888403,18,567,1323,30
76673184380,76673184382,2,1740,1921,30
76674161950,76674161944,-6,1499,4288,30
76683787480,76683787477,-3,754,1305,30
76685054718,76685054710,-8,916,2834,30
76686627462,76686627456,-6,1272,2216,30
76686985368,76686985386,18,1610,5040,30
76700612176,76700612171,-5,978,3551,30
76701316507,76701316522,15,547,2405,30
76711113301,76711113308,7,2846,1349,30
76725877890,76725877885,-5,1034,2828,30
76728861058,76728861058,0,17961,6557,30
76729670618,76729670611,-7,1266,2753,30
76730188803,76730188790,-13,139,865,30
76730350467,76730350461,-6,758,2103,30
76730469978,76730469976,-2,983,2339,30
76738474469,76738474469,0,1647,1958,30
76741104745,76741104739,-6,873,3299,30
76742606530,76742606525,-5,1096,3236,30
76743190004,76743190001,-3,788,2870,30
76744168293,76744168290,-3,1180,3114,30
76744295896,76744295913,17,593,1160,30
76752122721,76752122717,-4,1379,3323,30
76757944142,76757944139,-3,751,2032,30
76758168785,76758168792,7,13821,32363,30
76761228178,76761228174,-4,1394,2251,30
76763033319,76763033315,-4,992,2904,30
76763625946,76763625955,9,378,939,30
76779663858,76779663852,-6,1225,3156,30
76780098893,76780098890,-3,1141,2696,30
76787454066,76787454061,-5,1247,2732,30
76790048659,76790048653,-6,902,1703,30
76796667198,76796667193,-5,860,2875,30
76797837120,76797837138,18,631,1890,30
76798409079,76798409074,-5,1103,3503,30
76804528699,76804528694,-5,1180,2661,30
76804562490,76804562484,-6,1147,3163,30
76810262610,76810262607,-3,927,3391,30
76814220617,76814220613,-4,1217,3561,30
76820699075,76820699069,-6,1077,3297,30
76822119909,76822119906,-3,1594,3244,30
76822718726,76822718721,-5,971,2460,30
76829582610,76829582617,7,2795,1899,30
76833065882,76833065877,-5,1140,2502,30
76839910355,76839910344,-11,831,165,30
76840571228,76840571226,-2,1174,2402,30
76845451491,76845451485,-6,2123,5256,30
76850884129,76850884125,-4,1237,3062,30
76851629333,76851629329,-4,694,3448,30
76851872474,76851872483,9,330,943,30
76859116858,76859116854,-4,1200,2697,30
76859504678,76859504674,-4,369,1095,30
76868395383,76868395379,-4,790,1210,30
76869698298,76869698294,-4,1043,2851,30
76869938993,76869939007,14,736,2715,30
76873205550,76873205545,-5,762,2029,30
76876394561,76876394557,-4,950,2785,30
76884665313,76884665315,2,3169,2988,30
76888855071,76888855065,-6,866,2308,30
76889051378,76889051376,-2,1155,3060,30
76889816140,76889816151,11,501,1515,30
76891351773,76891351773,0,1642,2036,30
76895394546,76895394549,3,1585,1192,30
76897298181,76897298175,-6,1028,2781,30
76901814458,76901814465,7,3191,1568,30
76903424903,76903424898,-5,1276,2195,30
76907053492,76907053496,4,2471,1833,30
76908694558,76908694553,-5,876,2680,30
76909732578,76909732592,14,643,4212,30
76912046170,76912046174,4,4167,2661,30
76913337200,76913337197,-3,975,2465,30
76917885958,76917885956,-2,2236,4601,30
76918608911,76918608909,-2,1353,3210,30
76923070385,76923070380,-5,1400,3828,30
76923595950,76923595957,7,14865,25589,30
76931987338,76931987334,-4,1051,2981,30
76932405199,76932405197,-2,1183,3194,30
76934458647,76934458642,-5,784,3280,30
76935772951,76935772946,-5,1058,2540,30
76941986052,76941986045,-7,1210,2806,30
76948801149,76948801145,-4,991,2781,30
76949438515,76949438516,1,223,1699,30
76952219578,76952219573,-5,1306,3363,30
76953488754,76953488749,-5,392,1255,30
76957839763,76957839760,-3,839,1937,30
76963512853,76963512850,-3,1505,3482,30
76964679564,76964679556,-8,1035,3378,30
76974052334,76974052329,-5,678,2014,30
76976487315,76976487310,-5,1303,2758,30
76979210266,76979210266,0,1443,1836,30
76982086973,76982086967,-6,1027,2860,30
76982230875,76982230870,-5,1150,2881,30
76983626741,76983626736,-5,847,1636,30
76984944362,76984944357,-5,1337,3309,30
76985627477,76985627482,5,3360,1968,30
76986592670,76986592665,-5,1104,2520,30
76987264841,76987264836,-5,1236,2161,30
76991563876,76991563869,-7,1214,5142,30
76999333486,76999333482,-4,864,3026,30
77000326494,77000326489,-5,1162,3014,30
77006253930,77006253925,-5,1731,3624,30
77008048037,77008048032,-5,1027,3618,30
77009057962,77009057955,-7,1328,3196,30
77009339648,77009339640,-8,932,2683,30
77020192035,77020192031,-4,1222,2221,30
77023854587,77023854584,-3,1312,2592,30
77024765055,77024765050,-5,794,1913,30
77026348667,77026348663,-4,1039,2682,30
77027302544,77027302562,18,383,1241,30
77035934766,77035934772,6,2952,1278,30
77037610430,77037610423,-7,723,2439,30
77041179098,77041179082,-16,141,1059,30
77044366705,77044366701,-4,1121,2389,30
77046575791,77046575788,-3,1015,2625,30
77054055785,77054055778,-7,1106,3017,30
77054959574,77054959578,4,1224,1057,30
77056011980,77056011977,-3,561,2011,30
77056225975,77056225970,-5,764,1985,30
77056710535,77056710535,0,1496,1579,30
77057316497,77057316490,-7,1604,3474,30
77057803252,77057803245,-7,765,5050,30
77058089791,77058089785,-6,908,2227,30
77058602015,77058602010,-5,841,1993,30
77059036401,77059036395,-6,867,2715,30
77059861290,77059861285,-5,937,1877,30
77061080608,77061080604,-4,1038,2305,30
77066145533,77066145529,-4,1249,2754,30
77075360090,77075360086,-4,1014,2632,30
77081494472,77081494468,-4,1310,2900,30
77088460875,77088460869,-6,1037,2443,30
77097168058,77097168050,-8,989,4413,30
77097418065,77097418085,20,268,895,30
77103633777,77103633776,-1,810,2221,30
77108099527,77108099531,4,1532,1353,30
77109097061,77109097062,1,1484,1283,30
77112354750,77112354747,-3,1214,3164,30
77117035022,77117035015,-7,1144,2802,30
77127654542,77127654536,-6,1492,5297,30
77128193367,77128193362,-5,1401,3606,30
77133650638,77133650635,-3,1138,2787,30
77143216810,77143216808,-2,1149,2567,30
77147500586,77147500589,3,979,1111,30
77149621303,77149621297,-6,1013,2776,30
77150578412,77150578409,-3,1533,3302,30
77151727348,77151727343,-5,1157,3227,30
77155765467,77155765467,0,2426,5048,30
77156476842,77156476838,-4,919,2227,30
77161157059,77161157054,-5,652,2515,30
77161691080,77161691103,23,63,1002,30
77169853707,77169853710,3,1566,880,30
77171048346,77171048343,-3,941,2866,30
77171203055,77171203050,-5,1058,3397,30
77171885698,77171885696,-2,747,1714,30
77176594334,77176594329,-5,1344,3258,30
77187730562,77187730556,-6,944,3038,30
77187816993,77187816992,-1,6957,9103,30
77189035367,77189035373,6,2443,791,30
77203262018,77203262013,-5,1294,3038,30
77205486414,77205486410,-4,969,2231,30
77209038683,77209038678,-5,889,3431,30
77209372198,77209372194,-4,1355,2945,30
77211941542,77211941538,-4,1255,3044,30
77214323658,77214323653,-5,1067,2577,30
77214900264,77214900261,-3,1203,2223,30
77219098830,77219098831,1,978,1532,30
77222504818,77222504815,-3,397,695,30
77225912902,77225912898,-4,1142,2413,30
77231399854,77231399848,-6,714,1257,30
77232325314,77232325310,-4,798,1923,30
77232524972,77232524981,9,149,2415,30
77241816418,77241816414,-4,1378,3672,30
77243732581,77243732576,-5,1088,2984,30
77244021047,77244021043,-4,1148,3869,30
77245027340,77245027356,16,138,1165,30
77248999286,77248999287,1,1856,1988,30
77249468292,77249468289,-3,909,1664,30
77251119156,77251119169,13,730,1802,30
77254042651,77254042647,-4,1701,2434,30
77257265192,77257265187,-5,761,2856,30
77263250194,77263250199,5,2027,1048,30
77263986226,77263986222,-4,1335,3687,30
77275310953,77275310950,-3,1104,2104,30
77279828144,77279828146,2,1460,1513,30
77281569890,77281569898,8,1696,1005,30
77283892641,77283892638,-3,843,1764,30
77286293890,77286293889,-1,1471,3274,30
77287081701,77287081693,-8,544,1856,30
77292076514,77292076518,4,2133,1307,30
77293224095,77293224090,-5,1235,2583,30
77293389455,77293389450,-5,950,3600,30
77297425975,77297425971,-4,820,3182,30
77297662873,77297662893,20,612,2370,30
77303164691,77303164686,-5,708,1899,30
77303851137,77303851133,-4,520,3086,30
77304234920,77304234910,-10,1117,2009,30
77306088799,77306088794,-5,705,2339,30
77310751562,77310751555,-7,1221,2576,30
77313500950,77313500949,-1,1504,2023,30
77317636283,77317636278,-5,1323,2259,30
77320825538,77320825531,-7,658,3065,30
77323923228,77323923226,-2,1137,2546,30
77332937656,77332937653,-3,1325,4143,30
77340339490,77340339486,-4,1122,3307,30
77343324194,77343324190,-4,1230,2747,30
77345496443,77345496438,-5,1116,3216,30
77347260555,77347260550,-5,839,1658,30
77347765490,77347765484,-6,829,3495,30
77351110957,77351110952,-5,747,2499,30
77351616122,77351616103,-19,23,3979,30
77366641011,77366641008,-3,930,2217,30
77370010260,77370010255,-5,887,3002,30
77372759945,77372759946,1,1056,1049,30
77380324991,77380324986,-5,772,1439,30
77383553162,77383553157,-5,996,2697,30
77383857315,77383857301,-14,270,1379,30
77384096426,77384096442,16,495,1067,30
77389222980,77389222973,-7,906,3961,30
77393065370,77393065373,3,194,839,30
77393999755,77393999750,-5,1063,3151,30
77397998164,77397998162,-2,902,1963,30
77398305388,77398305367,-21,166,1317,30
77398585619,77398585614,-5,1444,3311,30
77401240119,77401240114,-5,1025,1493,30
77404775119,77404775125,6,3427,2586,30
77412188412,77412188418,6,289,1526,30
77415079693,77415079691,-2,843,3256,30
77420426513,77420426510,-3,927,2993,30
77421232831,77421232829,-2,1094,3107,30
77444650042,77444650038,-4,1169,2009,30
77445179666,77445179662,-4,1025,3454,30
77445250184,77445250173,-11,259,1343,30
77451579875,77451579870,-5,1257,2938,30
77457565547,77457565542,-5,986,3143,30
77465705065,77465705061,-4,911,2544,30
77465917505,77465917498,-7,1437,3372,30
77466783147,77466783142,-5,1314,4064,30
77467602531,77467602526,-5,1025,2702,30
77468351621,77468351617,-4,1038,3060,30
77471436178,77471436173,-5,1511,3492,30
77473505338,77473505359,21,351,972,30
77473616743,77473616741,-2,1318,2173,30
77478818754,77478818749,-5,1475,4047,30
77482125610,77482125605,-5,20065,11556,30
77484755975,77484755973,-2,2417,3665,30
77487431171,77487431169,-2,644,2895,30
77492517114,77492517110,-4,711,2555,30
77496506632,77496506629,-3,1321,2545,30
77503065847,77503065845,-2,1054,2880,30
77504443323,77504443338,15,3,1037,30
77507148469,77507148471,2,2279,2081,30
77523976546,77523976542,-4,969,2275,30
77524075061,77524075062,1,1634,1072,30
77525379578,77525379574,-4,977,2044,30
77531807282,77531807278,-4,1345,2645,30
77539992060,77539992056,-4,1123,3142,30
77540955681,77540955700,19,261,1194,30
77546612150,77546612147,-3,1630,1816,30
77548508902,77548508898,-4,1160,2549,30
77551517742,77551517738,-4,772,1850,30
77560603248,77560603244,-4,1342,3475,30
77566671084,77566671079,-5,1137,3185,30
77567157261,77567157254,-7,838,4346,30
77567884859,77567884854,-5,874,2907,30
77572439049,77572439045,-4,1457,3733,30
77573406110,77573406110,0,1243,2082,30
77574700149,77574700145,-4,1108,3814,30
77576077858,77576077860,2,3175,2745,30
77578742727,77578742737,10,10882,36550,30
77579585725,77579585727,2,1664,1609,30
77584688317,77584688313,-4,653,1891,30
77592102194,77592102190,-4,1442,2703,30
77593562711,77593562706,-5,955,2486,30
77597348315,77597348309,-6,785,3655,30
77599039481,77599039478,-3,1108,2265,30
77600270005,77600270003,-2,2179,3874,30
77601178454,77601178453,-1,1459,2900,30
77601564407,77601564406,-1,758,1668,30
77604937789,77604937783,-6,1014,3694,30
77608993231,77608993226,-5,890,3275,30
77611285415,77611285412,-3,738,1455,30
77612510046,77612510040,-6,894,2860,30
77616901734,77616901729,-5,1096,2438,30
77617540769,77617540762,-7,886,3731,30
77621099022,77621099016,-6,1190,3561,30
77625612522,77625612518,-4,1159,3932,30
77626401328,77626401311,-17,215,1190,30
77628508496,77628508492,-4,1310,3777,30
77629928855,77629928851,-4,1015,3673,30
77630387754,77630387751,-3,1244,3201,30
77631759159,77631759164,5,2064,776,30
77633757715,77633757712,-3,1292,2662,30
77643265274,77643265270,-4,1343,3384,30
77650613545,77650613538,-7,1445,4049,30
77651117970,77651117966,-4,1156,2586,30
77658570938,77658570938,0,1657,1706,30
77668310778,77668310792,14,14465,51361,30
77671148746,77671148741,-5,1141,4220,30
77672544132,77672544128,-4,1641,2568,30
77681136495,77681136493,-2,1107,2920,30
77682357374,77682357367,-7,1062,6608,30
77682942371,77682942366,-5,953,2415,30
77683726894,77683726891,-3,991,2603,30
77689361315,77689361311,-4,1331,3327,30
77691929134,77691929130,-4,922,2658,30
77697676582,77697676576,-6,1079,3196,30
77703270635,77703270631,-4,997,2323,30
77703426370,77703426384,14,495,4506,30
77704156880,77704156876,-4,899,1798,30
77707563521,77707563517,-4,848,1471,30
77711151482,77711151476,-6,1151,4118,30
77724789319,77724789314,-5,977,3225,30
77725624206,77725624204,-2,1553,2912,30
77727790546,77727790541,-5,787,2509,30
77731316867,77731316862,-5,1031,3624,30
77731458166,77731458162,-4,799,2887,30
77733046291,77733046287,-4,1075,2867,30
77733303017,77733303009,-8,128,789,30
77735068570,77735068568,-2,699,1807,30
77739908326,77739908322,-4,1195,3305,30
77746006636,77746006642,6,1884,1139,30
77746943453,77746943448,-5,1731,3569,30
77747484039,77747484035,-4,725,1358,30
77747827160,77747827157,-3,40135,1870,30
77748324791,77748324789,-2,1135,2255,30
77754347143,77754347140,-3,871,2796,30
77756046218,77756046211,-7,1056,3278,30
77756107011,77756106998,-13,113,1245,30
77757740119,77757740113,-6,942,2790,30
77762550853,77762550872,19,429,1612,30
77770713239,77770713235,-4,994,1990,30
77772951511,77772951506,-5,1037,3687,30
77781347246,77781347242,-4,950,2401,30
77782001984,77782001977,-7,112,1058,30
77782865686,77782865685,-1,1243,2726,30
77783544487,77783544482,-5,857,1514,30
77788093970,77788093967,-3,2030,3276,30
77790874575,77790874571,-4,1090,2730,30
77792709513,77792709510,-3,1150,2612,30
77793031483,77793031481,-2,695,2595,30
77794245262,77794245261,-1,1448,2232,30
77795566467,77795566462,-5,1059,2129,30
77796154385,77796154382,-3,962,2284,30
77797171243,77797171245,2,289,1080,30
77800056469,77800056465,-4,719,1258,30
77800351931,77800351926,-5,969,2640,30
77802419897,77802419895,-2,690,1269,30
77808942705,77808942701,-4,1433,3812,30
77810387043,77810387038,-5,955,2037,30
77811495481,77811495498,17,178,550,30
77811587581,77811587589,8,1256,946,30
77812563595,77812563591,-4,1354,2895,30
77818983273,77818983279,6,5241,2367,30
77823944779,77823944774,-5,1281,3291,30
77829652984,77829652980,-4,686,2493,30
77835722471,77835722466,-5,1032,3671,30
77836022977,77836022972,-5,1226,2910,30
77836248264,77836248245,-19,962,2257,30
77846672309,77846672305,-4,1016,3295,30
77848589787,77848589779,-8,838,4551,30
77850233670,77850233648,-22,748,395,30
77850495170,77850495161,-9,1157,1887,30
77853783542,77853783539,-3,710,1412,30
77854963441,77854963437,-4,1106,3399,30
77856644055,77856644051,-4,1084,2912,30
77856827435,77856827431,-4,763,2639,30
77858052841,77858052835,-6,904,2846,30
77858551530,77858551536,6,10382,36132,30
77858698011,77858698024,13,531,1700,30
77864407092,77864407086,-6,1381,3496,30
77868931010,77868931004,-6,1135,3186,30
77870043846,77870043842,-4,881,3370,30
77870619100,77870619113,13,776,2324,30
77876142163,77876142158,-5,1066,3672,30
77878755488,77878755482,-6,1109,3394,30
77879177662,77879177656,-6,1017,2208,30
77883079771,77883079766,-5,743,2481,30
77887428914,77887428929,15,412,1790,30
77889678407,77889678405,-2,434,1072,30
77890575021,77890575027,6,4027,985,30
77891897863,77891897855,-8,481,4604,30
77892463134,77892463131,-3,1029,2783,30
77895963406,77895963401,-5,1113,3174,30
77896350691,77896350687,-4,734,2641,30
77902117243,77902117238,-5,1302,3759,30
77907114474,77907114468,-6,1056,3037,30
77911579329,77911579326,-3,1334,2397,30
77913473084,77913473077,-7,1169,3524,30
77914038691,77914038709,18,516,1970,30
77920521213,77920521207,-6,1116,4062,30
77920547968,77920547950,-18,188,928,30
77922155797,77922155793,-4,1203,2386,30
77927061042,77927061040,-2,1893,2888,30
77931135426,77931135422,-4,1428,3803,30
77934275811,77934275807,-4,997,3770,30
77935703128,77935703119,-9,625,1593,30
77935921122,77935921117,-5,863,3485,30
77937719723,77937719721,-2,655,849,30
77941889198,77941889193,-5,920,2963,30
77944047305,77944047301,-4,745,2618,30
77945286474,77945286474,0,1328,2195,30
77955526537,77955526534,-3,866,2373,30
77955902403,77955902392,-11,1049,2984,30
77957589022,77957589019,-3,828,2654,30
77959215823,77959215816,-7,1086,3781,30
77971181957,77971181964,7,2386,1266,30
77972674309,77972674305,-4,1303,3466,30
77976272699,77976272693,-6,1235,3133,30
77976885350,77976885354,4,1626,1071,30
77982918962,77982918958,-4,822,2768,30
77983128989,77983128985,-4,1108,2738,30
77983424163,77983424143,-20,1085,2861,30
77985384491,77985384489,-2,1263,2296,30
77985480934,77985480930,-4,3624,7734,30
77986132548,77986132554,6,3855,1475,30
77986414537,77986414534,-3,1022,2999,30
77987941858,77987941854,-4,994,2817,30
77991334326,77991334318,-8,2088,12153,30
77992070243,77992070234,-9,655,2827,30
77995138770,77995138770,0,1900,2404,30
78000232379,78000232374,-5,616,2104,30
78006127364,78006127357,-7,1371,3758,30
78008833730,78008833729,-1,1046,3010,30
78012748243,78012748238,-5,1006,2406,30
78013427730,78013427728,-2,1131,2599,30
78015852539,78015852534,-5,1036,3856,30
78019290474,78019290468,-6,978,5194,30
78019492004,78019492020,16,941,2396,30
78033534254,78033534249,-5,933,2301,30
78033691716,78033691731,15,937,2494,30
78035710120,78035710114,-6,1232,3575,30
78039277409,78039277403,-6,1342,4792,30
78039679021,78039679021,0,2034,2521,30
78040027509,78040027505,-4,790,2051,30
78045100381,78045100375,-6,399,1307,30
78053490714,78053490712,-2,1137,2299,30
78056058567,78056058565,-2,900,2291,30
78059440621,78059440627,6,20717,24345,30
78065898639,78065898635,-4,1122,2266,30
78068790089,78068790083,-6,681,2908,30
78069485549,78069485541,-8,812,2172,30
78071401017,78071401037,20,524,2381,30
78072538482,78072538479,-3,1519,2948,30
78072937967,78072937964,-3,803,2760,30
78072991366,78072991362,-4,775,2186,30
78076403490,78076403492,2,23270,31116,30
78085252914,78085252910,-4,1027,2997,30
78092043463,78092043460,-3,1204,1653,30
78092612028,78092612035,7,4079,1309,30
78096861112,78096861109,-3,1778,4190,30
78098528455,78098528451,-4,760,3045,30
78105427393,78105427389,-4,959,3198,30
78105510507,78105510518,11,210,643,30
78106476895,78106476889,-6,720,3334,30
78108312578,78108312593,15,511,1606,30
78111038206,78111038202,-4,696,2437,30
78115726786,78115726781,-5,897,3391,30
78118681783,78118681779,-4,558,1705,30
78123851006,78123851003,-3,1630,2783,30
78124877467,78124877463,-4,1301,3531,30
78126413843,78126413839,-4,995,3219,30
78130447079,78130447078,-1,1308,3064,30
78132828054,78132828049,-5,1063,3082,30
78138011390,78138011387,-3,809,2094,30
78139483397,78139483393,-4,1022,3074,30
78141170771,78141170766,-5,1156,2778,30
78142160008,78142160004,-4,936,2250,30
78147232521,78147232516,-5,1292,3076,30
78147302196,78147302215,19,519,2236,30
78152577206,78152577201,-5,756,2948,30
78153698939,78153698957,18,260,714,30
78157696399,78157696393,-6,768,3756,30
78159354724,78159354742,18,379,1044,30
78160158269,78160158275,6,19749,23139,30
78160216725,78160216726,1,1856,1410,30
78160683570,78160683562,-8,208,847,30
78162091683,78162091678,-5,565,3366,30
78163582202,78163582197,-5,967,3427,30
78167155459,78167155453,-6,904,4116,30
78169821170,78169821180,10,18099,42137,30
78169900265,78169900258,-7,1094,2975,30
78171994994,78171995001,7,6025,2234,30
78175912515,78175912510,-5,1085,3264,30
78184144448,78184144444,-4,1038,2874,30
78195001526,78195001510,-16,1919,314,30
78195401785,78195401781,-4,1544,3683,30
78206976038,78206976033,-5,1180,3130,30
78207021179,78207021198,19,260,1077,30
78208966022,78208966018,-4,1048,3049,30
78210958253,78210958248,-5,715,2303,30
78212344450,78212344445,-5,829,2799,30
78220316474,78220316470,-4,1112,2570,30
78221044208,78221044202,-6,1192,2843,30
78221880601,78221880596,-5,921,2868,30
78223478798,78223478795,-3,252,1081,30
78239941161,78239941154,-7,750,2459,30
78242854900,78242854893,-7,1053,2982,30
78246167566,78246167563,-3,1195,3416,30
78256507839,78256507836,-3,727,2051,30
78261850959,78261850954,-5,697,2194,30
78265550502,78265550500,-2,1066,2419,30
78266245654,78266245650,-4,1116,1398,30
78276133503,78276133500,-3,648,2895,30
78277672698,78277672695,-3,1084,2476,30
78279075714,78279075710,-4,1346,3059,30
78281379092,78281379086,-6,1063,3128,30
78286829093,78286829093,0,1154,1629,30
78288798644,78288798647,3,631,11300,30
78291063811,78291063806,-5,964,2025,30
78296800378,78296800375,-3,1053,1622,30
78300041478,78300041482,4,14156,8382,30
78302698931,78302698931,0,10895,13996,30
78306508978,78306508972,-6,931,2470,30
78307062538,78307062558,20,207,804,30
78307684617,78307684612,-5,1251,3459,30
78309498562,78309498558,-4,766,2223,30
78309880111,78309880105,-6,1355,3206,30
78316117345,78316117344,-1,1346,1959,30
78318817378,78318817375,-3,796,2105,30
78321103010,78321103006,-4,1669,3315,30
78321224130,78321224127,-3,760,2268,30
78328455324,78328455317,-7,1540,2817,30
78330791758,78330791752,-6,889,2724,30
78331989799,78331989792,-7,1009,2798,30
78332948369,78332948365,-4,1863,4205,30
78335901616,78335901611,-5,1505,3466,30
78341770171,78341770169,-2,1115,4276,30
78346080192,78346080189,-3,927,1900,30
78346329736,78346329731,-5,933,2302,30
78347809367,78347809362,-5,1287,3235,30
78355746862,78355746865,3,1149,1353,30
78356841870,78356841865,-5,912,3619,30
78360640476,78360640473,-3,1203,2378,30
78362586402,78362586398,-4,1091,3152,30
78363017798,78363017793,-5,970,3311,30
78363067610,78363067606,-4,796,2285,30
78365772058,78365772054,-4,1002,3295,30
78366997237,78366997232,-5,1016,3767,30
78368895411,78368895406,-5,1084,2194,30
78370744223,78370744218,-5,1058,2215,30
78373454476,78373454470,-6,2017,7987,30
78375073127,78375073124,-3,1424,2572,30
78377080058,78377080051,-7,1357,3434,30
78383335525,78383335519,-6,949,2745,30
78384485087,78384485082,-5,1061,2569,30
78387155380,78387155376,-4,626,2235,30
78402949022,78402949018,-4,963,2868,30
78403018979,78403018967,-12,275,769,30
78407623382,78407623399,17,492,1350,30
78411737339,78411737340,1,1914,2593,30
78414505262,78414505269,7,5748,2573,30
78415069381,78415069376,-5,1052,3812,30
78418485187,78418485182,-5,744,2575,30
78422968166,78422968162,-4,1473,4259,30
78423646766,78423646772,6,2400,1088,30
78424022366,78424022366,0,1195,1428,30
78424404320,78424404338,18,1285,3107,30
78427227963,78427227961,-2,1000,2468,30
78427647374,78427647371,-3,1581,3827,30
78428663998,78428663992,-6,651,2903,30
78430029053,78430029049,-4,995,2836,30
78430437603,78430437621,18,255,1127,30
78433269498,78433269495,-3,1757,3918,30
78437151231,78437151248,17,576,2212,30
78437881474,78437881470,-4,1140,2462,30
78442483827,78442483825,-2,1110,1929,30
78442787353,78442787372,19,1162,2796,30
78452149093,78452149098,5,3372,1770,30
78453815050,78453815045,-5,844,3958,30
78454718801,78454718797,-4,1094,2437,30
78454783050,78454783068,18,948,3660,30
78457665654,78457665650,-4,1061,1740,30
78459614930,78459614922,-8,876,3417,30
78459706825,78459706829,4,91,955,30
78460267574,78460267570,-4,789,1673,30
78461606885,78461606885,0,1432,1142,30
78463496841,78463496835,-6,1389,3466,30
78467492059,78467492053,-6,2251,5503,30
78472774218,78472774214,-4,862,3056,30
78473867442,78473867463,21,454,936,30
78475590031,78475590027,-4,1347,3127,30
78477761535,78477761530,-5,721,1457,30
78478990690,78478990687,-3,1024,1313,30
78479198747,78479198765,18,1067,4605,30
78483251217,78483251221,4,27336,33342,30
78486626894,78486626893,-1,1442,1971,30
78486836819,78486836835,16,783,1972,30
78491709071,78491709066,-5,874,3360,30
78494080089,78494080084,-5,1471,2730,30
78506259579,78506259575,-4,838,1927,30
78508941163,78508941156,-7,586,3287,30
78515150963,78515150956,-7,956,2335,30
78526752458,78526752466,8,8839,2912,30
78527145754,78527145750,-4,1146,2880,30
78527217874,78527217894,20,892,2965,30
78529099404,78529099398,-6,1097,3108,30
78529975464,78529975459,-5,1466,2922,30
78532477520,78532477524,4,2159,1352,30
78533579710,78533579704,-6,1298,3607,30
78533961587,78533961584,-3,1471,3075,30
78535863133,78535863129,-4,1086,3157,30
78541388750,78541388744,-6,1067,2172,30
78554106786,78554106778,-8,672,2079,30
78554995796,78554995790,-6,1679,5666,30
78558385881,78558385876,-5,977,2583,30
78560954933,78560954930,-3,729,1428,30
78562415454,78562415450,-4,3931,11641,30
78583285627,78583285622,-5,1539,3388,30
78584990594,78584990589,-5,601,1918,30
78587828238,78587828234,-4,1145,3890,30
78592040539,78592040534,-5,990,2503,30
78592103492,78592103489,-3,837,2917,30
78593478045,78593478041,-4,1099,2420,30
78598034921,78598034926,5,2206,1076,30
78599850075,78599850070,-5,1091,2029,30
78600204465,78600204459,-6,670,3200,30
78601904754,78601904749,-5,922,2875,30
78603324168,78603324169,1,1689,1940,30
78607510763,78607510758,-5,1042,3575,30
78609469274,78609469270,-4,1151,2402,30
78612004707,78612004716,9,13017,42230,30
78616461567,78616461562,-5,1015,2601,30
78617191234,78617191251,17,261,568,30
78623055951,78623055946,-5,566,1325,30
78623376590,78623376585,-5,1041,3365,30
78625104443,78625104438,-5,565,3168,30
78634763516,78634763518,2,1651,1631,30
78637702002,78637701995,-7,1424,5596,30
78638363103,78638363098,-5,688,2452,30
78644133250,78644133246,-4,926,3992,30
78645745958,78645745954,-4,976,2685,30
78646595481,78646595478,-3,1165,1864,30
78646848083,78646848082,-1,19,716,30
78649966514,78649966509,-5,1414,2760,30
78651154146,78651154141,-5,1470,4223,30
78651916640,78651916635,-5,1023,2302,30
78661540241,78661540237,-4,1282,2865,30
78661995148,78661995129,-19,1462,8692,30
78667326062,78667326058,-4,1122,3620,30
78672928795,78672928791,-4,1318,2945,30
78673435248,78673435254,6,25936,15541,30
78674351511,78674351511,0,1310,1769,30
78677067549,78677067544,-5,915,3468,30
78682306321,78682306315,-6,1252,2217,30
78684877767,78684877762,-5,962,3788,30
78693034541,78693034536,-5,709,3395,30
78694979462,78694979457,-5,1438,3820,30
78695285737,78695285734,-3,776,1722,30
78698075101,78698075095,-6,955,2019,30
78698894337,78698894359,22,150,937,30
78699937987,78699937983,-4,1163,3031,30
78704077481,78704077474,-7,696,6220,30
78706090834,78706090830,-4,974,3282,30
78708296694,78708296699,5,4143,2063,30
78710025996,78710025990,-6,1188,3160,30
78713858933,78713858929,-4,1330,4794,30
78719217158,78719217154,-4,1016,1724,30
78722848463,78722848457,-6,1156,3385,30
78724187943,78724187937,-6,500,1981,30
78731015835,78731015833,-2,703,2287,30
78731512704,78731512698,-6,1297,2551,30
78732544056,78732544041,-15,945,2193,30
78733246347,78733246342,-5,1216,2745,30
78736879313,78736879310,-3,759,2911,30
78737310767,78737310764,-3,1391,3545,30
78737664738,78737664733,-5,706,1935,30
78738087835,78738087853,18,93,684,30
78740066539,78740066536,-3,1178,2324,30
78753252690,78753252685,-5,1034,1982,30
78754865322,78754865322,0,1237,2247,30
78755246463,78755246458,-5,993,3140,30
78762837694,78762837692,-2,1897,2360,30
78763511536,78763511553,17,441,1182,30
78766450626,78766450622,-4,969,1562,30
78768883323,78768883316,-7,827,3686,30
78772971504,78772971503,-1,1436,2345,30
78777020800,78777020797,-3,911,2970,30
78780870129,78780870122,-7,1118,4632,30
78781968341,78781968336,-5,1152,2627,30
78782403610,78782403603,-7,1425,3567,30
78784556853,78784556848,-5,1039,3103,30
78784941513,78784941508,-5,1383,3061,30
78806239001,78806238996,-5,1044,2459,30
78806449026,78806449042,16,384,1194,30
78807764432,78807764429,-3,1199,2949,30
78807828729,78807828747,18,499,1875,30
78808621566,78808621565,-1,633,1338,30
78809485170,78809485165,-5,1052,2759,30
78810470153,78810470150,-3,142,740,30
78813993052,78813993058,6,2697,1351,30
78814029630,78814029626,-4,862,3070,30
78815347019,78815347016,-3,1000,2584,30
78829698364,78829698361,-3,893,2370,30
78831413480,78831413475,-5,996,2710,30
78832443922,78832443918,-4,876,2823,30
78833144475,78833144471,-4,950,2306,30
78835098421,78835098417,-4,1119,3595,30
78840414433,78840414428,-5,913,3226,30
78840981480,78840981501,21,565,2391,30
78841260267,78841260262,-5,846,3880,30
78843015952,78843015946,-6,1370,3404,30
78851171867,78851171861,-6,1079,3955,30
78855539047,78855539043,-4,569,1518,30
78857836150,78857836162,12,11887,37921,30
78858488551,78858488546,-5,946,3368,30
78863632822,78863632817,-5,1107,2493,30
78869883615,78869883616,1,1081,2029,30
78870349425,78870349418,-7,843,3296,30
78871716720,78871716724,4,1961,1316,30
78876926289,78876926282,-7,1173,5324,30
78877407109,78877407105,-4,1446,2477,30
78880579141,78880579136,-5,1042,2599,30
78892931842,78892931837,-5,890,3886,30
78897029886,78897029885,-1,11388,19415,30
78899363082,78899363077,-5,602,3160,30
78905146091,78905146089,-2,944,2647,30
78908334669,78908334666,-3,777,2137,30
78908374436,78908374446,10,208,831,30
78914077657,78914077653,-4,948,1571,30
78919697683,78919697679,-4,869,2347,30
78920385452,78920385466,14,365,769,30
78924255363,78924255366,3,5746,20700,30
78925296105,78925296098,-7,1516,3375,30
78926349876,78926349894,18,174,914,30
78930365079,78930365073,-6,894,2518,30
78932033000,78932032996,-4,1038,3323,30
78935103578,78935103570,-8,1576,4963,30
78935330561,78935330555,-6,1010,2683,30
78936352758,78936352754,-4,1248,3161,30
78940749894,78940749889,-5,964,2623,30
78947288910,78947288908,-2,1163,2619,30
78948401818,78948401813,-5,1051,2325,30
78949592241,78949592238,-3,897,2667,30
78966915746,78966915741,-5,938,3570,30
78968081785,78968081777,-8,1077,4710,30
78968312016,78968312038,22,668,2254,30
78974252451,78974252445,-6,521,1385,30
78982242053,78982242048,-5,988,2845,30
78988385306,78988385302,-4,1555,4318,30
79000004402,79000004397,-5,1507,3652,30
79006601171,79006601164,-7,755,3147,30
79006847633,79006847627,-6,906,2925,30
79012815843,79012815841,-2,1041,2762,30
79015170203,79015170201,-2,1124,1818,30
79023573829,79023573825,-4,1083,3251,30
79024395099,79024395103,4,1329,1036,30
79028016442,79028016440,-2,1302,2697,30
79028519373,79028519368,-5,1378,2938,30
79029943725,79029943719,-6,985,3031,30
79030241518,79030241518,0,893,1399,30
79030466467,79030466478,11,403,770,30
79032300582,79032300577,-5,1486,4940,30
79037985885,79037985879,-6,967,2946,30
79038126306,79038126297,-9,161,1070,30
79044659734,79044659730,-4,1064,2932,30
79048202794,79048202789,-5,772,2063,30
79048695058,79048695043,-15,251,928,30
79053774616,79053774612,-4,958,3745,30
79055744610,79055744605,-5,706,1532,30
79057610828,79057610846,18,935,2916,30
79063297938,79063297931,-7,681,2865,30
79065822040,79065822034,-6,1558,3349,30
79072483041,79072483038,-3,685,2674,30
79075638214,79075638209,-5,1055,2935,30
79078065562,79078065555,-7,1098,4222,30
79081882441,79081882438,-3,1285,2739,30
79081935739,79081935745,6,1906,1190,30
79083446122,79083446118,-4,1025,2441,30
79083949821,79083949818,-3,1244,2900,30
79087740498,79087740496,-2,709,2784,30
79088866360,79088866355,-5,672,1184,30
79088968456,79088968470,14,157,920,30
79089403822,79089403818,-4,1329,2856,30
79093418977,79093418980,3,3640,3891,30
79094114668,79094114673,5,4139,2086,30
79095780883,79095780879,-4,1109,2919,30
79096182542,79096182538,-4,1129,3698,30
79098412429,79098412425,-4,1063,2823,30
79098841564,79098841566,2,2052,1359,30
79099583233,79099583227,-6,864,3910,30
79110245713,79110245708,-5,1086,3573,30
79111459522,79111459520,-2,1467,3552,30
79111743682,79111743679,-3,736,2171,30
79114059717,79114059723,6,4207,1435,30
79122354739,79122354744,5,8317,33359,30
79125804240,79125804244,4,1392,1110,30
79128060770,79128060766,-4,1144,2520,30
79137110962,79137110954,-8,1182,3357,30
79137688962,79137688956,-6,1063,2304,30
79138175468,79138175482,14,75,971,30
79139946362,79139946365,3,1951,1202,30
79140292340,79140292344,4,1612,887,30
79146177677,79146177682,5,1372,989,30
79150269966,79150269972,6,2007,1360,30
79150589165,79150589159,-6,1318,4613,30
79156893442,79156893438,-4,933,3150,30
79159030934,79159030929,-5,1206,3201,30
79160129825,79160129825,0,1290,1693,30
79168603756,79168603750,-6,1158,3040,30
79169724909,79169724917,8,3622,1528,30
79171787115,79171787109,-6,1326,2519,30
79174620154,79174620150,-4,1164,2876,30
79177602410,79177602415,5,1397,513,30
79178929499,79178929494,-5,746,4691,30
79179493856,79179493854,-2,132,1038,30
79183866917,79183866910,-7,1244,4313,30
79186354569,79186354563,-6,907,2828,30
79186546114,79186546110,-4,297,1546,30
79187457630,79187457631,1,1319,1688,30
79187599241,79187599238,-3,1147,2677,30
79188008921,79188008917,-4,1308,3252,30
79188392518,79188392514,-4,1613,3240,30
79188561353,79188561370,17,407,1654,30
79189015735,79189015737,2,1302,1317,30
79189384633,79189384629,-4,745,2236,30
79192819884,79192819879,-5,928,2613,30
79196212209,79196212215,6,1390,1396,30
79197456433,79197456430,-3,615,2448,30
79198113577,79198113571,-6,1135,4148,30
79198761459,79198761478,19,478,1154,30
79199719780,79199719774,-6,893,1516,30
79201009018,79201009013,-5,797,2182,30
79202091249,79202091268,19,319,1410,30
79213275234,79213275230,-4,863,2742,30
79214805854,79214805849,-5,989,2019,30
79221586670,79221586665,-5,889,2951,30
79223290098,79223290093,-5,1129,2577,30
79231397878,79231397874,-4,1533,4199,30
79232560590,79232560586,-4,835,2539,30
79237063302,79237063296,-6,1193,2796,30
79242026561,79242026557,-4,1463,3288,30
79243367349,79243367345,-4,1267,2891,30
79250280827,79250280822,-5,1048,3056,30
79260550165,79260550175,10,5740,715,30
79266494386,79266494381,-5,931,2025,30
79268778080,79268778085,5,2372,1545,30
79269714679,79269714674,-5,1334,3119,30
79270045302,79270045298,-4,1409,3290,30
79275156345,79275156343,-2,1092,3156,30
79278314386,79278314381,-5,783,2923,30
79278341867,79278341853,-14,300,767,30
79279055461,79279055465,4,3278,2699,30
79280593372,79280593367,-5,1245,3076,30
79285959403,79285959402,-1,1639,2638,30
79286099718,79286099722,4,1235,1320,30
79289208624,79289208621,-3,932,2961,30
79290337294,79290337310,16,587,1607,30
79298534450,79298534445,-5,1257,2891,30
79299764051,79299764046,-5,1055,2239,30
79300205513,79300205506,-7,1237,3559,30
79300454679,79300454673,-6,904,3779,30
79302431859,79302431855,-4,991,3839,30
79302546679,79302546674,-5,1001,3274,30
79305843401,79305843398,-3,1580,2298,30
79308528972,79308528967,-5,1375,3993,30
79313101752,79313101758,6,3084,1299,30
79316541763,79316541763,0,1561,1914,30
79319510543,79319510538,-5,604,2233,30
79332428413,79332428410,-3,1140,2137,30
79332734073,79332734073,0,933,1501,30
79335057361,79335057356,-5,1104,2573,30
79342612294,79342612289,-5,1162,2245,30
79344195505,79344195500,-5,1173,3223,30
79350555049,79350555044,-5,1535,3183,30
79351534157,79351534150,-7,657,3187,30
79353030642,79353030637,-5,1641,3625,30
79356795845,79356795841,-4,1815,4299,30
79358953125,79358953122,-3,596,2579,30
79361788939,79361788933,-6,848,2565,30
79363841275,79363841272,-3,889,2386,30
79367124571,79367124566,-5,1316,3499,30
79367822824,79367822818,-6,1279,3029,30
79370772154,79370772150,-4,1110,2637,30
79371886415,79371886410,-5,1080,3165,30
79373599899,79373599894,-5,821,2589,30
79373996212,79373996228,16,520,1332,30
79375032317,79375032315,-2,1130,3089,30
79376746868,79376746864,-4,792,3420,30
79384514555,79384514550,-5,907,2364,30
79388684448,79388684445,-3,758,2544,30
79389357593,79389357587,-6,1016,3122,30
79389465236,79389465253,17,780,2887,30
79392384965,79392384962,-3,990,3148,30
79400423832,79400423830,-2,952,1880,30
79402640876,79402640871,-5,1348,2202,30
79409899926,79409899922,-4,1034,2881,30
79410080474,79410080458,-16,710,2315,30
79413208858,79413208854,-4,1067,1996,30
79420455505,79420455502,-3,798,1185,30
79421389730,79421389736,6,316,1189,30
79423030291,79423030287,-4,1231,2884,30
79427411192,79427411193,1,1510,1434,30
79427968887,79427968883,-4,925,2549,30
79430071963,79430071958,-5,1003,3386,30
79433978135,79433978131,-4,772,2494,30
79443616851,79443616846,-5,1457,3048,30
79444932473,79444932466,-7,1042,2450,30
79447886734,79447886730,-4,801,3158,30
79448697285,79448697284,-1,1242,1842,30
79455011647,79455011642,-5,1114,1801,30
79458176142,79458176139,-3,1228,2577,30
79460178498,79460178491,-7,1345,2250,30
79460614938,79460614927,-11,282,968,30
79464915427,79464915424,-3,520,1500,30
79467670022,79467670020,-2,1045,2720,30
79470676633,79470676629,-4,1301,2204,30
79472674215,79472674210,-5,937,2554,30
79474008687,79474008682,-5,956,3764,30
79484466402,79484466397,-5,995,2720,30
79492446539,79492446534,-5,1152,3540,30
79494184501,79494184505,4,861,1084,30
79496996683,79496996679,-4,975,3177,30
79504920130,79504920125,-5,781,2153,30
79510898736,79510898731,-5,1302,2034,30
79526459829,79526459826,-3,796,2731,30
79527204147,79527204143,-4,1403,3941,30
79530233747,79530233745,-2,1166,2770,30
79530305436,79530305451,15,517,1920,30
79533838127,79533838122,-5,710,2353,30
79535044989,79535044985,-4,1170,2490,30
79535735392,79535735385,-7,208,816,30
79539016198,79539016191,-7,902,4258,30
79539904362,79539904341,-21,276,1020,30
79552291718,79552291720,2,8261,18043,30
79555453977,79555453974,-3,1018,2390,30
79559679054,79559679050,-4,999,3637,30
79567886054,79567886048,-6,969,2303,30
79569620004,79569620002,-2,815,2508,30
79570759754,79570759749,-5,1492,2567,30
79572739217,79572739210,-7,924,1670,30
79577693485,79577693483,-2,810,2225,30
79579132411,79579132406,-5,1250,3053,30
79580534420,79580534414,-6,1067,3655,30
79583148391,79583148389,-2,1038,3235,30
79584959882,79584959870,-12,855,2786,30
79585909363,79585909361,-2,1335,1865,30
79587652054,79587652051,-3,1216,4221,30
79587720282,79587720273,-9,1258,4170,30
79587821827,79587821823,-4,185,719,30
79588347403,79588347422,19,315,936,30
79589894235,79589894231,-4,1019,2263,30
79592328294,79592328287,-7,918,5451,30
79602219981,79602219976,-5,1110,2634,30
79618931015,79618931011,-4,1270,3023,30
79619682641,79619682642,1,918,707,30
79622532226,79622532223,-3,1444,3222,30
79622890070,79622890066,-4,828,1571,30
79622978608,79622978614,6,2048,1188,30
79623384821,79623384819,-2,1209,2089,30
79624040055,79624040052,-3,1304,2113,30
79629328499,79629328497,-2,1858,3109,30
79629954123,79629954117,-6,1062,3550,30
79639187191,79639187182,-9,831,3793,30
79639720934,79639720930,-4,1064,4052,30
79641233999,79641234004,5,4698,2442,30
79643374960,79643374954,-6,1153,3379,30
79644145477,79644145472,-5,1338,2716,30
79645716153,79645716153,0,1482,1905,30
79647097058,79647097054,-4,1199,2955,30
79650425146,79650425142,-4,981,2533,30
79656106529,79656106523,-6,1046,3175,30
79656968583,79656968577,-6,701,2009,30
79659501238,79659501233,-5,1289,2879,30
79661131144,79661131140,-4,1379,3502,30
79661609534,79661609529,-5,1170,3249,30
79661762147,79661762161,14,961,3189,30
79664004653,79664004648,-5,1235,3758,30
79664788987,79664788981,-6,912,3416,30
79666039878,79666039874,-4,776,3062,30
79666259497,79666259487,-10,877,3338,30
79666497466,79666497461,-5,917,2743,30
79669601013,79669601009,-4,1309,4609,30
79671700834,79671700830,-4,1051,2979,30
79672336378,79672336398,20,168,1477,30
79680585832,79680585826,-6,919,1713,30
79680976720,79680976709,-11,1025,2236,30
79683914678,79683914696,18,314,1617,30
79691698494,79691698491,-3,1341,2194,30
79693417622,79693417616,-6,1015,2977,30
79703160033,79703160028,-5,1387,3852,30
79703282412,79703282410,-2,965,1978,30
79704477585,79704477589,4,21491,43597,30
79705947679,79705947674,-5,728,2696,30
79706000543,79706000538,-5,771,2988,30
79707135783,79707135779,-4,908,2465,30
79707264875,79707264878,3,226,924,30
79725198942,79725198944,2,23998,24629,30
79726967853,79726967850,-3,1378,2962,30
79731894348,79731894348,0,1613,1772,30
79732804114,79732804109,-5,924,2638,30
79733564738,79733564736,-2,948,2540,30
79737391105,79737391101,-4,797,3201,30
79750388993,79750388988,-5,1316,3484,30
79753395141,79753395137,-4,1203,2430,30
79759490926,79759490929,3,40037,27616,30
79760099366,79760099362,-4,1518,3227,30
79760721579,79760721574,-5,920,1891,30
79761477542,79761477538,-4,1543,3646,30
79761838566,79761838561,-5,682,2136,30
79762006928,79762006926,-2,1071,2104,30
79762377560,79762377565,5,233,962,30
79765254985,79765254986,1,2071,1415,30
79770908025,79770908020,-5,1306,6780,30
79772466864,79772466860,-4,1285,3306,30
79772946145,79772946141,-4,1117,3428,30
79775230648,79775230645,-3,1374,2977,30
79776034167,79776034162,-5,798,2787,30
79779207830,79779207827,-3,1060,2473,30
79785308154,79785308149,-5,961,1917,30
79785844912,79785844926,14,454,2079,30
79786204204,79786204200,-4,1417,3078,30
79788807712,79788807706,-6,1080,5290,30
79799608490,79799608491,1,2551,2794,30
79800721961,79800721958,-3,1076,1960,30
79801356370,79801356365,-5,637,2065,30
79801732390,79801732396,6,6421,2742,30
79803536913,79803536905,-8,2189,4592,30
79805277224,79805277242,18,857,2777,30
79806157035,79806157031,-4,1467,3660,30
79811513330,79811513326,-4,993,3434,30
79813277022,79813277018,-4,818,2169,30
79813560195,79813560174,-21,55,936,30
79814142937,79814142927,-10,146,910,30
79815573648,79815573659,11,242,1051,30
79823819950,79823819945,-5,1410,4141,30
79825431038,79825431049,11,363,1011,30
79830038854,79830038850,-4,3357,14291,30
79830285907,79830285904,-3,716,2307,30
79830858502,79830858499,-3,1359,2694,30
79831515110,79831515106,-4,956,2858,30
79834165034,79834165042,8,1694,515,30
79834954731,79834954734,3,1399,887,30
79835457190,79835457184,-6,1165,3928,30
79835601689,79835601702,13,61,733,30
79836922362,79836922357,-5,961,2798,30
79840136290,79840136294,4,1809,1508,30
79845917302,79845917297,-5,860,3178,30
79847166610,79847166608,-2,1136,2366,30
79851309671,79851309666,-5,583,1714,30
79852722765,79852722771,6,1918,1466,30
79855326631,79855326629,-2,1227,1764,30
79856418762,79856418761,-1,2611,3836,30
79857451130,79857451126,-4,827,2204,30
79860392269,79860392264,-5,795,1919,30
79863100693,79863100689,-4,1181,3775,30
79865174889,79865174886,-3,1196,2234,30
79865277587,79865277565,-22,112,1122,30
79866982978,79866982974,-4,1107,2762,30
79870329901,79870329897,-4,1026,3764,30
79872185362,79872185364,2,1892,1875,30
79873250281,79873250282,1,2610,3791,30
79874851237,79874851231,-6,1420,3048,30
79891605786,79891605782,-4,735,3474,30
79894108442,79894108463,21,127,909,30
79895608307,79895608302,-5,1119,2170,30
79904258269,79904258275,6,1787,1290,30
79905291970,79905291967,-3,1087,2296,30
79906039209,79906039206,-3,1334,2610,30
79910737742,79910737738,-4,1925,3077,30
79910833510,79910833504,-6,1169,2281,30
79913403935,79913403932,-3,1173,1957,30
79916653698,79916653694,-4,1473,2554,30
79920287146,79920287139,-7,1018,4368,30
79923102930,79923102928,-2,702,1392,30
79927069734,79927069731,-3,849,2663,30
79927875195,79927875174,-21,149,1043,30
79928960319,79928960313,-6,1080,3811,30
79934548648,79934548643,-5,872,1915,30
79938451363,79938451359,-4,971,2747,30
79942911654,79942911649,-5,1232,2507,30
79944090843,79944090846,3,2816,1995,30
79944530597,79944530593,-4,1041,2853,30
79944613957,79944613953,-4,1292,3077,30
79944898318,79944898315,-3,983,1996,30
79945318579,79945318598,19,641,2624,30
79948354479,79948354475,-4,930,2890,30
79949295198,79949295193,-5,887,2195,30
79951009287,79951009278,-9,842,4412,30
79952323625,79952323618,-7,816,2936,30
79956099543,79956099539,-4,946,3059,30
79956488361,79956488355,-6,709,3182,30
79959449592,79959449588,-4,1014,2412,30
79960075189,79960075185,-4,1152,3186,30
79961007898,79961007893,-5,1156,3386,30
79964951989,79964951986,-3,1366,2486,30
79966041366,79966041361,-5,950,3327,30
79974836558,79974836554,-4,1059,3389,30
79975381809,79975381804,-5,259,1124,30
79980968396,79980968390,-6,1095,2711,30
79991454386,79991454381,-5,751,3601,30
79994669558,79994669561,3,3718,3579,30
79996563442,79996563441,-1,6951,10898,30
79998434194,79998434190,-4,1036,2749,30
80000570586,80000570594,8,9168,2284,30
80003185897,80003185893,-4,1511,2413,30
80007704875,80007704871,-4,1113,2264,30
80009858150,80009858157,7,3074,1455,30
80010067851,80010067857,6,3582,1444,30
80014367577,80014367570,-7,935,3626,30
80017551733,80017551729,-4,1187,2898,30
80018459739,80018459734,-5,931,3048,30
80024500663,80024500658,-5,963,3108,30
80026052720,80026052717,-3,903,2350,30
80030753586,80030753585,-1,1272,2706,30
80032081315,80032081312,-3,847,1871,30
80033375152,80033375133,-19,770,1857,30
80034734074,80034734070,-4,775,3334,30
80039757530,80039757528,-2,1349,2272,30
80041389714,80041389721,7,1279,870,30
80045582626,80045582622,-4,1018,3474,30
80050382972,80050382978,6,3078,1002,30
80053593623,80053593618,-5,1112,2851,30
80054906664,80054906660,-4,1221,3516,30
80058421314,80058421318,4,6407,25529,30
80059675990,80059675984,-6,896,3008,30
80064503876,80064503870,-6,1320,4260,30
80065308387,80065308389,2,3269,3073,30
80065622228,80065622224,-4,1226,3230,30
80068330499,80068330501,2,39068,83203,30
80070957075,80070957070,-5,1262,2843,30
80073407848,80073407855,7,3349,1474,30
80076622594,80076622589,-5,1028,3221,30
80076913595,80076913603,8,281,882,30
80078977978,80078977984,6,56120,111859,30
80091311515,80091311511,-4,893,2207,30
80096768515,80096768510,-5,1107,3504,30
80099402959,80099402954,-5,2031,7156,30
80099553752,80099553747,-5,501,1382,30
80105166603,80105166606,3,1384,1459,30
80107544238,80107544234,-4,784,2791,30
80109785705,80109785698,-7,998,3511,30
80111910355,80111910352,-3,641,1193,30
80112670858,80112670858,0,690,996,30
80116541846,80116541842,-4,1172,2710,30
80119433851,80119433846,-5,734,1569,30
80120426727,80120426722,-5,1273,3786,30
80121374519,80121374513,-6,646,1826,30
80121409532,80121409551,19,740,2331,30
80125271157,80125271153,-4,1123,3427,30
80129688237,80129688233,-4,919,3137,30
80130348889,80130348891,2,2252,1619,30
80132337857,80132337853,-4,1061,3129,30
80134829221,80134829216,-5,748,2349,30
80147733604,80147733601,-3,1371,4243,30
80148918719,80148918713,-6,1572,3307,30
80151348119,80151348116,-3,712,2463,30
80152187563,80152187582,19,779,1650,30
80156932114,80156932110,-4,2468,5018,30
80158813003,80158812999,-4,1064,3185,30
80161415134,80161415134,0,1313,2343,30
80162732173,80162732173,0,1508,1483,30
80163133641,80163133658,17,438,2713,30
80164435422,80164435417,-5,900,3572,30
80164764667,80164764661,-6,1055,4685,30
80171419343,80171419339,-4,1168,2919,30
80177191682,80177191678,-4,981,2664,30
80190261962,80190261958,-4,681,2824,30
80192831185,80192831203,18,1236,2149,30
80203976148,80203976143,-5,1591,2694,30
80204941414,80204941409,-5,914,1470,30
80208517507,80208517503,-4,1784,2632,30
80209350709,80209350705,-4,882,1595,30
80216102202,80216102197,-5,1107,2864,30
80216235812,80216235829,17,767,3659,30
80216635917,80216635913,-4,1282,3159,30
80220631919,80220631913,-6,1089,2728,30
80222792029,80222792023,-6,1396,2786,30
80226582897,80226582894,-3,756,1875,30
80226738008,80226738031,23,351,1136,30
80227349177,80227349182,5,2007,1542,30
80230776205,80230776208,3,1459,1511,30
80244016087,80244016084,-3,1213,2834,30
80245879622,80245879617,-5,957,2770,30
80250129520,80250129514,-6,1381,2947,30
80264759711,80264759706,-5,872,2829,30
80265522259,80265522271,12,622,1575,30
80267735458,80267735464,6,3149,1422,30
80269282532,80269282530,-2,743,2221,30
80269909734,80269909728,-6,1078,4054,30
80272332510,80272332507,-3,1021,2727,30
80273013342,80273013341,-1,1119,1980,30
80278303684,80278303681,-3,1370,3354,30
80286264327,80286264330,3,1854,1624,30
80287884983,80287884978,-5,829,2010,30
80289797330,80289797324,-6,765,1936,30
80290311740,80290311744,4,1973,1698,30
80294028482,80294028476,-6,892,3681,30
80294177401,80294177413,12,78,847,30
80296362006,80296362010,4,4389,2545,30
80298338311,80298338313,2,1602,2082,30
80302821802,80302821794,-8,817,2250,30
80307899469,80307899463,-6,899,2472,30
80308825736,80308825732,-4,1319,2200,30
80315504830,80315504826,-4,1166,4097,30
80315548162,80315548170,8,2869,1511,30
80320743558,80320743555,-3,1375,3712,30
80323188169,80323188165,-4,993,2766,30
80326497891,80326497884,-7,1030,3392,30
80330633213,80330633208,-5,1038,2559,30
80333546708,80333546703,-5,1185,2680,30
80337947373,80337947369,-4,713,1866,30
80338648871,80338648865,-6,644,2697,30
80341236809,80341236805,-4,733,2698,30
80341938518,80341938516,-2,714,2466,30
80355170994,80355170989,-5,1073,3785,30
80361694783,80361694776,-7,924,3537,30
80366993796,80366993793,-3,659,1970,30
80377641499,80377641499,0,1050,1664,30
80377995148,80377995144,-4,859,2328,30
80379384058,80379384066,8,9249,3053,30
80379641105,80379641099,-6,1376,3573,30
80380504773,80380504769,-4,1218,2656,30
80383166639,80383166635,-4,1744,3207,30
80384415700,80384415698,-2,3018,4663,30
80386193586,80386193587,1,2117,2530,30
80386877830,80386877826,-4,946,3246,30
80389649286,80389649281,-5,1342,3273,30
80394765028,80394765023,-5,1183,2124,30
80394831096,80394831116,20,660,2689,30
80405723514,80405723509,-5,1239,3391,30
80409822805,80409822799,-6,920,2164,30
80417526862,80417526858,-4,1269,3638,30
80423482574,80423482570,-4,763,2064,30
80426055779,80426055774,-5,975,2384,30
80428294460,80428294456,-4,1023,2689,30
80436461542,80436461543,1,1495,2683,30
80437870878,80437870873,-5,1194,3654,30
80444361244,80444361238,-6,967,2109,30
80449430078,80449430082,4,1482,1401,30
80452820938,80452820940,2,3036,3532,30
80454923571,80454923565,-6,931,3445,30
80456403653,80456403656,3,11897,8761,30
80462877445,80462877441,-4,1427,4170,30
80463332723,80463332718,-5,1343,3290,30
80463539380,80463539375,-5,1216,3123,30
80464211449,80464211465,16,694,2796,30
80466464429,80466464429,0,3377,3985,30
80467166445,80467166441,-4,960,2365,30
80473227954,80473227952,-2,713,1813,30
80475657558,80475657555,-3,1118,2608,30
80479009567,80479009568,1,5504,21038,30
80479864841,80479864835,-6,1466,3529,30
80480980958,80480980953,-5,1062,2864,30
80483737022,80483737019,-3,1436,2849,30
80487015984,80487015988,4,2306,1956,30
80489212565,80489212559,-6,1121,2490,30
80491839901,80491839894,-7,812,2119,30
80494452145,80494452144,-1,760,1436,30
80498215111,80498215106,-5,889,2314,30
80498798761,80498798750,-11,238,1734,30
80500924422,80500924420,-2,1056,2800,30
80508257861,80508257860,-1,1619,2591,30
80510927729,80510927723,-6,995,3224,30
80515780002,80515779999,-3,1355,3126,30
80516588799,80516588793,-6,1276,3824,30
80516721793,80516721788,-5,1588,3641,30
80518675164,80518675159,-5,797,3281,30
80520091421,80520091410,-11,29,911,30
80522816927,80522816924,-3,1233,2773,30
80526248922,80526248918,-4,2006,4257,30
80528666077,80528666071,-6,848,1847,30
80530236850,80530236846,-4,806,2566,30
80530766264,80530766258,-6,136,1084,30
80531933870,80531933866,-4,1242,2980,30
80532204860,80532204857,-3,859,1657,30
80536680780,80536680787,7,2637,1241,30
80537721997,80537721995,-2,1050,1414,30
80542174879,80542174872,-7,1669,3316,30
80545956684,80545956685,1,3320,3553,30
80547925574,80547925575,1,1798,2115,30
80553853648,80553853645,-3,1119,2718,30
80554442394,80554442401,7,172,1495,30
80556905125,80556905121,-4,1273,2875,30
80557332873,80557332894,21,1059,2731,30
80558728464,80558728459,-5,717,1561,30
80570962018,80570962015,-3,685,1416,30
80578809115,80578809109,-6,1305,2121,30
80580744368,80580744363,-5,943,2471,30
80582527234,80582527229,-5,1397,3956,30
80583783785,80583783782,-3,846,2373,30
80585440438,80585440434,-4,1198,3140,30
80587132938,80587132934,-4,1275,2759,30
80590472535,80590472530,-5,1242,2851,30
80597178609,80597178602,-7,1465,4004,30
80604029830,80604029824,-6,962,1934,30
80605009196,80605009214,18,872,2978,30
80610184454,80610184447,-7,683,2548,30
80611150678,80611150675,-3,963,2255,30
80611452475,80611452468,-7,491,3134,30
80611634195,80611634189,-6,748,2237,30
80612122330,80612122333,3,1762,2334,30
80613002842,80613002837,-5,984,2662,30
80615471484,80615471481,-3,1446,2683,30
80617126227,80617126222,-5,1008,2475,30
80621149275,80621149268,-7,1193,2528,30
80624919388,80624919383,-5,1309,3361,30
80638021576,80638021569,-7,978,3345,30
80639363873,80639363894,21,262,2620,30
80643673973,80643673967,-6,1548,2907,30
80649633309,80649633305,-4,1235,3153,30
80654677848,80654677849,1,2388,1473,30
80661939500,80661939494,-6,1129,3530,30
80678305974,80678305970,-4,1350,3594,30
80683735845,80683735842,-3,1086,1941,30
80684796714,80684796705,-9,1272,1894,30
80687984361,80687984358,-3,1071,2638,30
80688048225,80688048242,17,1105,2736,30
80689719534,80689719531,-3,1147,2242,30
80690102736,80690102732,-4,763,2339,30
80690727583,80690727580,-3,1005,2795,30
80694597651,80694597656,5,2374,1382,30
80697507010,80697507006,-4,1126,3627,30
80699077387,80699077384,-3,1400,2587,30
80700471334,80700471330,-4,984,2394,30
80705828142,80705828138,-4,1163,3279,30
80706454340,80706454334,-6,1399,2594,30
80707700738,80707700732,-6,880,2439,30
80711632191,80711632186,-5,1161,3010,30
80712430935,80712430930,-5,996,2721,30
80712978382,80712978378,-4,830,1213,30
80731369015,80731369009,-6,1520,3115,30
80732705279,80732705273,-6,755,2520,30
80732761842,80732761861,19,714,2029,30
80734310727,80734310724,-3,1893,5198,30
80742070264,80742070257,-7,1008,3124,30
80742546492,80742546511,19,115,652,30
80743529481,80743529477,-4,1600,3470,30
80743730102,80743730098,-4,1247,4015,30
80749434762,80749434761,-1,1125,1669,30
80753643546,80753643542,-4,1067,2400,30
80753780215,80753780216,1,857,1346,30
80755634856,80755634850,-6,1486,3800,30
80759588406,80759588402,-4,1323,3908,30
80760690986,80760690969,-17,281,600,30
80762154423,80762154418,-5,763,3450,30
80765118298,80765118294,-4,677,2395,30
80765299712,80765299698,-14,1440,4081,30
80769754178,80769754174,-4,1061,2672,30
80772598578,80772598578,0,2296,2685,30
80783047149,80783047147,-2,1362,1587,30
80792667503,80792667499,-4,904,2670,30
80793165115,80793165111,-4,1585,2520,30
80795579021,80795579014,-7,1422,3315,30
80803946829,80803946826,-3,1315,2867,30
80805461262,80805461262,0,2966,4445,30
80806878735,80806878729,-6,1198,3120,30
80807341962,80807341960,-2,1320,2384,30
80809582247,80809582243,-4,1112,2790,30
80810491378,80810491374,-4,1067,3568,30
80810871176,80810871159,-17,80,1214,30
80812802643,80812802646,3,2165,1154,30
80814248212,80814248206,-6,1211,2834,30
80814361897,80814361917,20,773,3293,30
80815655570,80815655567,-3,791,2642,30
80818960410,80818960404,-6,1067,3656,30
80824247127,80824247123,-4,1226,3795,30
80829098717,80829098712,-5,789,3955,30
80832324986,80832324982,-4,1176,3485,30
80839724487,80839724478,-9,780,1673,30
80842755197,80842755191,-6,1335,3714,30
80842851458,80842851459,1,1237,1512,30
80845043233,80845043229,-4,665,2281,30
80846644017,80846644012,-5,1056,2844,30
80848171643,80848171637,-6,731,3598,30
80854794419,80854794415,-4,1317,3252,30
80860489219,80860489215,-4,809,2209,30
80862221580,80862221574,-6,915,3316,30
80865008457,80865008453,-4,1138,4391,30
80869385652,80869385646,-6,1027,4141,30
80870868682,80870868677,-5,1012,5814,30
80871349810,80871349829,19,1141,2867,30
80873490139,80873490137,-2,866,2884,30
80875997518,80875997514,-4,651,2719,30
80878134029,80878134024,-5,1068,2037,30
80878420018,80878420013,-5,1056,2588,30
80879905022,80879905022,0,3365,3440,30
80880253295,80880253287,-8,1170,5958,30
80880302755,80880302741,-14,1071,2264,30
80881809873,80881809868,-5,1072,3480,30
80883930059,80883930062,3,1938,2170,30
80886003967,80886003962,-5,1122,2817,30
80887205360,80887205355,-5,1293,3460,30
80887481529,80887481530,1,220,980,30
80890995469,80890995465,-4,1270,2533,30
80895734970,80895734969,-1,1976,3134,30
80897697565,80897697562,-3,1065,2538,30
80899146387,80899146395,8,12012,24493,30
80900631077,80900631073,-4,1381,2131,30
80904799243,80904799239,-4,874,2016,30
80905342578,80905342595,17,927,3166,30
80921148419,80921148418,-1,939,1498,30
80922202779,80922202773,-6,490,2789,30
80928729561,80928729554,-7,1189,2838,30
80928855570,80928855566,-4,789,2412,30
80930489878,80930489873,-5,1482,4172,30
80932115017,80932115018,1,1851,2110,30
80935664372,80935664368,-4,1157,2138,30
80936239001,80936239022,21,442,1181,30
80945625402,80945625423,21,504,2315,30
80949580148,80949580144,-4,948,3536,30
80951360362,80951360357,-5,923,2176,30
80951863299,80951863297,-2,1468,3065,30
80953347842,80953347838,-4,1088,3571,30
80956647201,80956647193,-8,1089,4303,30
80957540074,80957540090,16,703,2605,30
80968735344,80968735340,-4,992,2792,30
80970427078,80970427073,-5,1311,4177,30
80970849928,80970849950,22,373,1578,30
80971964017,80971964011,-6,807,2365,30
80972851069,80972851090,21,1195,1995,30
80974349825,80974349821,-4,1098,4181,30
80977487071,80977487070,-1,776,998,30
80978184290,80978184310,20,388,1366,30
80982847068,80982847066,-2,1307,2158,30
80983647480,80983647474,-6,853,1517,30
80985009391,80985009387,-4,1093,2359,30
80986784730,80986784723,-7,1852,4935,30
80987027217,80987027210,-7,1298,3734,30
80987959646,80987959642,-4,1463,3739,30
80998192635,80998192630,-5,1041,2494,30
80999713392,80999713387,-5,933,3577,30
81006824950,81006824945,-5,992,1838,30
81007210449,81007210444,-5,1083,2957,30
81007644590,81007644587,-3,844,3104,30
81008320829,81008320825,-4,1316,3372,30
81011152547,81011152542,-5,614,1800,30
81019369374,81019369369,-5,1074,2274,30
81020978486,81020978479,-7,1169,2722,30
81025915412,81025915407,-5,788,2474,30
81026002361,81026002351,-10,209,666,30
81034244454,81034244451,-3,932,2096,30
81040895990,81040895970,-20,3023,1393,30
81042021027,81042021021,-6,806,2862,30
81043402857,81043402852,-5,739,2932,30
81044026131,81044026125,-6,850,2734,30
81047667505,81047667502,-3,732,1751,30
81048129241,81048129242,1,568,1667,30
81049966106,81049966101,-5,763,2043,30
81062931283,81062931280,-3,1060,3114,30
81066680089,81066680095,6,2170,856,30
81070550446,81070550443,-3,851,2416,30
81071059087,81071059081,-6,782,2872,30
81074567703,81074567698,-5,1063,3259,30
81074974664,81074974671,7,109,857,30
81092817073,81092817067,-6,1068,2837,30
81093151468,81093151482,14,158,964,30
81094709405,81094709402,-3,1226,1947,30
81094898689,81094898711,22,723,2288,30
81097279635,81097279629,-6,1347,2765,30
81099932211,81099932207,-4,1249,2545,30
81100508278,81100508282,4,1204,1310,30
81101472459,81101472456,-3,856,2229,30
81101978702,81101978694,-8,1537,9910,30
81102410492,81102410489,-3,1176,3105,30
81115193813,81115193810,-3,871,2054,30
81119417439,81119417434,-5,1004,2925,30
81123751155,81123751150,-5,1252,2743,30
81125455189,81125455186,-3,1518,2495,30
81126130188,81126130198,10,392,879,30
81128746945,81128746940,-5,1241,2650,30
81132099750,81132099749,-1,1052,2555,30
81134817667,81134817662,-5,843,2563,30
81136742581,81136742583,2,3083,1806,30
81139028474,81139028469,-5,907,3212,30
81140319026,81140319045,19,335,1004,30
81142615422,81142615425,3,4566,21591,30
81143655675,81143655670,-5,1108,3222,30
81147674311,81147674306,-5,925,3055,30
81155725126,81155725121,-5,883,3293,30
81158705638,81158705634,-4,1000,2982,30
81159182442,81159182439,-3,650,2287,30
81159684510,81159684505,-5,1085,4037,30
81161463426,81161463422,-4,572,2078,30
81165049871,81165049867,-4,598,1926,30
81166446665,81166446660,-5,894,3132,30
81166550435,81166550431,-4,965,2424,30
81175750973,81175750969,-4,1193,3153,30
81179193979,81179193977,-2,803,1219,30
81179226068,81179226085,17,881,2525,30
81182648678,81182648674,-4,985,2019,30
81188293111,81188293104,-7,870,2803,30
81193464017,81193464013,-4,793,2798,30
81194482684,81194482684,0,635,1362,30
81197047711,81197047705,-6,585,2070,30
81204620590,81204620588,-2,1475,3199,30
81205628459,81205628455,-4,823,2396,30
81209908415,81209908410,-5,689,2489,30
81217253466,81217253462,-4,829,2185,30
81217332114,81217332109,-5,1127,3245,30
81222775046,81222775042,-4,925,2918,30
81225602726,81225602723,-3,902,2091,30
81240157990,81240157986,-4,889,2373,30
81248315455,81248315450,-5,1824,4749,30
81248445799,81248445791,-8,729,2933,30
81252617145,81252617141,-4,1059,2916,30
81257802809,81257802807,-2,1004,2997,30
81262019108,81262019127,19,185,660,30
81265007190,81265007187,-3,1084,2993,30
81272152009,81272152004,-5,943,2685,30
81272432400,81272432418,18,874,2229,30
81272567104,81272567101,-3,863,2903,30
81290938064,81290938058,-6,1368,3148,30
81293228305,81293228302,-3,1101,3273,30
81294556863,81294556861,-2,874,2257,30
81295050526,81295050521,-5,1119,3187,30
81296728497,81296728493,-4,682,1549,30
81300519906,81300519913,7,4239,1673,30
81316796559,81316796554,-5,882,2703,30
81321173938,81321173934,-4,1039,3453,30
81326212194,81326212189,-5,588,1753,30
81331446230,81331446227,-3,1029,2304,30
81336883631,81336883627,-4,685,2282,30
81337589506,81337589515,9,1359,1131,30
81340391713,81340391710,-3,931,2378,30
81340604899,81340604893,-6,690,2129,30
81351562370,81351562366,-4,1116,2851,30
81351990267,81351990261,-6,1227,3899,30
81358244145,81358244138,-7,945,3151,30
81363898859,81363898853,-6,1189,2496,30
81365729851,81365729847,-4,1309,3395,30
81366309433,81366309453,20,238,999,30
81368130016,81368130037,21,800,3184,30
81371932415,81371932409,-6,1080,3534,30
81379554954,81379554950,-4,1026,2645,30
81387394045,81387394047,2,1196,1363,30
81393327706,81393327702,-4,972,3524,30
81394033283,81394033289,6,242,1226,30
81394205598,81394205594,-4,847,2121,30
81394469280,81394469286,6,225,1357,30
81394778713,81394778735,22,576,1928,30
81394950019,81394950014,-5,1059,2649,30
81395314842,81395314837,-5,943,3058,30
81395686818,81395686838,20,805,2219,30
81396140035,81396140033,-2,1176,2676,30
81399450567,81399450565,-2,1295,1631,30
81401643322,81401643317,-5,984,2663,30
81402958368,81402958365,-3,1057,1598,30
81403253211,81403253222,11,455,640,30
81405763405,81405763401,-4,1538,3381,30
81409372629,81409372622,-7,1492,5523,30
81410746879,81410746873,-6,1007,2574,30
81411027172,81411027154,-18,272,1226,30
81412572731,81412572726,-5,1330,3277,30
81424789551,81424789547,-4,919,3227,30
81425307251,81425307271,20,768,1413,30
81430010522,81430010518,-4,796,2814,30
81430287699,81430287694,-5,1248,4294,30
81431073569,81431073564,-5,777,3109,30
81432891998,81432891983,-15,3463,771,30
81434890209,81434890206,-3,2227,4591,30
81440228587,81440228579,-8,855,3563,30
81441615947,81441615945,-2,967,2300,30
81441915635,81441915634,-1,762,2094,30
81442234063,81442234057,-6,1095,3092,30
81442621442,81442621432,-10,1128,2733,30
81442908276,81442908271,-5,1272,3388,30
81443215571,81443215567,-4,1164,2891,30
81447883638,81447883633,-5,1491,3148,30
81448529462,81448529466,4,2865,1501,30
81449266002,81449265999,-3,775,1562,30
81464566943,81464566939,-4,865,2747,30
81468889813,81468889809,-4,847,2211,30
81472246847,81472246845,-2,745,2167,30
81473281977,81473281974,-3,975,3349,30
81473455552,81473455549,-3,1502,2819,30
81475264168,81475264162,-6,1079,2705,30
81476340806,81476340802,-4,987,3343,30
81477895474,81477895470,-4,1349,3016,30
81477934953,81477934949,-4,1084,3134,30
81481410518,81481410514,-4,1273,2886,30
81486887726,81486887721,-5,928,3629,30
81486999779,81486999798,19,900,2812,30
81488924938,81488924934,-4,1151,1970,30
81494585005,81494585001,-4,1094,2745,30
81495113910,81495113906,-4,899,3929,30
81496054166,81496054161,-5,1250,2505,30
81496367496,81496367490,-6,695,2089,30
81500013141,81500013135,-6,877,2372,30
81507827783,81507827777,-6,1040,2487,30
81510487054,81510487050,-4,925,2697,30
81515091506,81515091502,-4,1197,3415,30
81517818693,81517818690,-3,776,1969,30
81523798659,81523798646,-13,902,3204,30
81528709601,81528709597,-4,987,2458,30
81528960871,81528960865,-6,1012,3210,30
81531939603,81531939597,-6,1385,2865,30
81537767942,81537767939,-3,1204,2964,30
81540219391,81540219390,-1,1048,1586,30
81540681365,81540681361,-4,1361,4092,30
81541174041,81541174046,5,6184,2840,30
81541769298,81541769290,-8,1294,3816,30
81543019675,81543019654,-21,275,859,30
81543854817,81543854813,-4,1288,2594,30
81544859960,81544859980,20,1159,5430,30
81546003134,81546003130,-4,1179,3716,30
81550381470,81550381466,-4,1505,3102,30
81560132071,81560132068,-3,1077,2536,30
81560448076,81560448089,13,1081,2533,30
81565269639,81565269635,-4,1442,3164,30
81568405326,81568405325,-1,1227,2380,30
81570606755,81570606750,-5,1220,2951,30
81573623010,81573623006,-4,1009,1551,30
81575130062,81575130059,-3,861,2521,30
81575879361,81575879359,-2,18,633,30
81581401973,81581401976,3,9888,26551,30
81582511486,81582511481,-5,818,2244,30
81583463736,81583463729,-7,919,2471,30
81586384347,81586384335,-12,514,371,30
81590388778,81590388775,-3,771,2101,30
81592447539,81592447535,-4,971,2510,30
81595845193,81595845195,2,3082,3020,30
81600953632,81600953629,-3,1379,3921,30
81602510237,81602510231,-6,1212,3598,30
81603069458,81603069472,14,36,849,30
81604779765,81604779769,4,2374,1881,30
81606213457,81606213453,-4,859,2436,30
81609336933,81609336936,3,1574,1023,30
81611557842,81611557846,4,3306,2030,30
81612432633,81612432639,6,2234,1119,30
81619848143,81619848137,-6,1408,1173,30
81620301758,81620301757,-1,1118,2365,30
81621404658,81621404643,-15,5084,1481,30
81623777795,81623777789,-6,1022,3700,30
81624799469,81624799471,2,1618,1445,30
81627332267,81627332263,-4,633,1279,30
81628288689,81628288679,-10,164,612,30
81633200689,81633200686,-3,642,2856,30
81644035799,81644035795,-4,502,1728,30
81644322041,81644322063,22,502,2329,30
81644447231,81644447226,-5,1161,2026,30
81647207470,81647207466,-4,1236,3590,30
81648562483,81648562483,0,1438,2122,30
81650866274,81650866269,-5,1021,2675,30
81652656080,81652656075,-5,1513,3720,30
81657150002,81657149995,-7,854,3424,30
81658144078,81658144066,-12,36039,13633,30
81663415742,81663415737,-5,1460,3678,30
81664953748,81664953745,-3,1000,2990,30
81668142834,81668142829,-5,960,2195,30
81668560811,81668560809,-2,1257,2012,30
81672857086,81672857079,-7,1150,4675,30
81673833694,81673833690,-4,768,2134,30
81674026482,81674026495,13,734,2222,30
81675700329,81675700329,0,1471,2484,30
81681585633,81681585629,-4,1600,3503,30
81682231583,81682231578,-5,901,2277,30
81682341283,81682341293,10,286,1775,30
81686351315,81686351314,-1,1293,2165,30
81691950074,81691950070,-4,924,2529,30
81696716998,81696716994,-4,1541,3670,30
81701050286,81701050282,-4,1158,2917,30
81703318474,81703318470,-4,1645,3756,30
81705165016,81705165011,-5,1200,3528,30
81705660703,81705660698,-5,915,3240,30
81707266879,81707266876,-3,1010,3346,30
81714199462,81714199459,-3,1091,2245,30
81719974069,81719974069,0,2528,3869,30
81722115948,81722115941,-7,1335,3280,30
81724608328,81724608323,-5,1130,2503,30
81731091420,81731091414,-6,20652,14224,30
81732361377,81732361373,-4,1487,3351,30
81741747478,81741747475,-3,756,1661,30
81741933551,81741933547,-4,849,2587,30
81743430459,81743430457,-2,1051,2407,30
81745777158,81745777156,-2,1006,1511,30
81755504828,81755504822,-6,1262,5553,30
81757709165,81757709161,-4,799,2457,30
81763184231,81763184226,-5,1307,2712,30
81763422170,81763422165,-5,812,7212,30
81771370751,81771370751,0,1179,1023,30
81772369257,81772369252,-5,1046,3477,30
81776825953,81776825933,-20,1216,2029,30
81780638649,81780638642,-7,791,2794,30
81782280406,81782280400,-6,643,2418,30
81793128537,81793128534,-3,1016,2743,30
81795120807,81795120805,-2,954,2088,30
81795402102,81795402106,4,1271,1210,30
81795995885,81795995888,3,2734,1740,30
81798412528,81798412523,-5,1594,3245,30
81799662578,81799662574,-4,1357,3142,30
81804787374,81804787370,-4,1093,2819,30
81810049236,81810049232,-4,835,2264,30
81825163309,81825163306,-3,984,2920,30
81829901939,81829901934,-5,1684,4136,30
81829952767,81829952762,-5,956,2892,30
81831384890,81831384885,-5,984,2536,30
81835157593,81835157589,-4,1343,3149,30
81835288250,81835288247,-3,1145,2891,30
81837100955,81837100950,-5,1148,3259,30
81838731214,81838731212,-2,1217,3897,30
81842726830,81842726827,-3,1014,2055,30
81845418210,81845418210,0,2276,2598,30
81850304446,81850304441,-5,1180,3445,30
81854568484,81854568498,14,3,1215,30
81859383467,81859383461,-6,1397,3167,30
81863517843,81863517841,-2,47406,43680,30
81868472355,81868472351,-4,585,2579,30
81869057276,81869057270,-6,698,1985,30
81870842397,81870842393,-4,932,2527,30
81870921428,81870921439,11,265,1047,30
81871549204,81871549199,-5,961,3571,30
81881740230,81881740233,3,1540,1603,30
81882872587,81882872583,-4,929,2293,30
81883722878,81883722874,-4,1308,2690,30
81886344486,81886344481,-5,1381,2979,30
81889455958,81889455953,-5,1024,3032,30
81889801041,81889801049,8,4095,1312,30
81890004659,81890004654,-5,1357,2972,30
81892444735,81892444729,-6,1274,2465,30
81892591083,81892591079,-4,831,2275,30
81896448117,81896448113,-4,1223,2646,30
81902256027,81902256021,-6,615,2416,30
81904210255,81904210251,-4,1239,3553,30
81906386686,81906386681,-5,949,2856,30
81906486834,81906486854,20,801,2570,30
81907185095,81907185092,-3,1214,2443,30
81912884795,81912884790,-5,936,2623,30
81913543078,81913543073,-5,1500,2749,30
81914340470,81914340466,-4,1080,3113,30
81919314416,81919314411,-5,524,3365,30
81931143107,81931143104,-3,1074,3456,30
81934583836,81934583839,3,2903,1857,30
81942938573,81942938566,-7,1159,3747,30
81943520739,81943520755,16,317,1004,30
81955877803,81955877801,-2,535,2658,30
81958519982,81958519964,-18,3849,1699,30
81963953695,81963953690,-5,1018,1897,30
81968501976,81968501972,-4,1036,2789,30
81969472139,81969472136,-3,1438,2663,30
81972520057,81972520052,-5,1284,2523,30
81979109919,81979109914,-5,1184,2899,30
81989032999,81989032993,-6,1004,2651,30
81989883810,81989883816,6,5871,2996,30
81990226693,81990226688,-5,1039,2713,30
81994825684,81994825680,-4,1162,2644,30
81996154475,81996154469,-6,893,2624,30
81999134558,81999134555,-3,939,2508,30
82006619314,82006619309,-5,1133,2937,30
82008807143,82008807137,-6,941,2622,30
82008888223,82008888218,-5,977,3114,30
82009270286,82009270282,-4,918,2654,30
82015086103,82015086099,-4,756,2387,30
82018488651,82018488647,-4,1099,3313,30
82020615590,82020615585,-5,875,3574,30
82021950938,82021950933,-5,1199,4840,30
82023669290,82023669287,-3,1418,4200,30
82025602734,82025602731,-3,1625,3717,30
82031296089,82031296085,-4,1266,2807,30
82032868599,82032868594,-5,698,1965,30
82034956108,82034956102,-6,791,2768,30
82037571211,82037571217,6,4467,2752,30
82049582992,82049582986,-6,1027,2620,30
82056229900,82056229896,-4,1447,3436,30
82057024132,82057024150,18,1217,2745,30
82058235938,82058235934,-4,853,1611,30
82063066096,82063066097,1,2756,3752,30
82064337071,82064337065,-6,743,3275,30
82065582450,82065582465,15,840,4118,30
82071457969,82071457965,-4,1274,3291,30
82075221255,82075221250,-5,726,1727,30
82079333549,82079333544,-5,1356,3875,30
82084457867,82084457863,-4,1374,2350,30
82088239160,82088239156,-4,796,2743,30
82091661686,82091661682,-4,763,3464,30
82091704904,82091704922,18,849,2544,30
82098836446,82098836441,-5,828,3786,30
82099631894,82099631890,-4,1007,2376,30
82103364543,82103364538,-5,1282,3640,30
82103549523,82103549518,-5,774,2733,30
82103937246,82103937241,-5,1190,3740,30
82104521730,82104521734,4,3365,1469,30
82106839146,82106839141,-5,868,2922,30
82107976189,82107976184,-5,931,2916,30
82108076526,82108076525,-1,1291,1576,30
82110321520,82110321513,-7,903,3465,30
82111013992,82111013975,-17,217,1584,30
82113653990,82113653986,-4,1187,2703,30
82117290454,82117290451,-3,803,2146,30
82119757027,82119757031,4,1259,1303,30
82121575120,82121575115,-5,762,3160,30
82124706065,82124706060,-5,1231,3212,30
82126243973,82126243963,-10,37637,15428,30
82127079090,82127079087,-3,854,2415,30
82128109397,82128109394,-3,925,3072,30
82132640730,82132640724,-6,992,2899,30
82135014134,82135014127,-7,1147,3456,30
82135653481,82135653477,-4,1468,3363,30
82136482370,82136482348,-22,1269,2261,30
82136749467,82136749454,-13,768,3109,30
82137836199,82137836196,-3,1146,2930,30
82140351850,82140351846,-4,1109,2600,30
82140405251,82140405235,-16,833,2669,30
82141005706,82141005698,-8,313,1323,30
82141465142,82141465137,-5,1188,3645,30
82149179894,82149179889,-5,1134,3930,30
82152710411,82152710409,-2,1054,3434,30
82153559403,82153559399,-4,911,1968,30
82153781569,82153781588,19,291,1553,30
82153980729,82153980726,-3,1361,3987,30
82154509850,82154509844,-6,1085,3400,30
82154933480,82154933477,-3,840,2153,30
82156096938,82156096957,19,742,1999,30
82157699393,82157699388,-5,825,2732,30
82161521898,82161521893,-5,907,3021,30
82164009518,82164009513,-5,1128,5992,30
82167160241,82167160235,-6,1319,2138,30
82171461228,82171461221,-7,1147,3075,30
82174711441,82174711443,2,1063,1244,30
82175502871,82175502865,-6,1016,3231,30
82181176605,82181176601,-4,1275,2829,30
82182455154,82182455153,-1,1243,1980,30
82191395585,82191395581,-4,1362,3966,30
82192344334,82192344333,-1,1203,1868,30
82199107942,82199107940,-2,812,2527,30
82202065410,82202065409,-1,1029,1430,30
82204262118,82204262114,-4,861,3220,30
82204641445,82204641441,-4,1411,2654,30
82207825998,82207825994,-4,885,2143,30
82208284012,82208284006,-6,1032,2952,30
82213679331,82213679327,-4,947,2522,30
82215389680,82215389687,7,5307,2831,30
82215795494,82215795490,-4,1223,3078,30
82218057863,82218057863,0,1474,1957,30
82219957790,82219957785,-5,1133,2682,30
82237909034,82237909029,-5,871,2739,30
82243853175,82243853170,-5,893,2907,30
82247509871,82247509867,-4,1001,3111,30
82252578398,82252578394,-4,1332,2682,30
82253939868,82253939865,-3,1228,3086,30
82254948059,82254948063,4,2138,1327,30
82256159209,82256159202,-7,1107,3626,30
82260247353,82260247348,-5,803,2300,30
82263088336,82263088331,-5,1396,3200,30
82263566107,82263566101,-6,1134,2120,30
82272259444,82272259449,5,2829,1452,30
82285210527,82285210533,6,2245,1247,30
82286840815,82286840811,-4,1715,4217,30
82291011301,82291011294,-7,2380,11028,30
82291892267,82291892262,-5,1162,3265,30
82293343177,82293343174,-3,1314,3274,30
82295360051,82295360051,0,1594,1480,30
82304581767,82304581763,-4,1182,3241,30
82306500108,82306500103,-5,1187,2983,30
82309733017,82309733019,2,1563,1670,30
82313763210,82313763206,-4,812,1982,30
82319093920,82319093917,-3,581,1865,30
82322407977,82322407971,-6,1157,4306,30
82328662629,82328662624,-5,758,2625,30
82329525845,82329525841,-4,1202,2740,30
82331867902,82331867899,-3,888,2640,30
82334757714,82334757709,-5,1038,3933,30
82343251938,82343251935,-3,1024,2126,30
82350710583,82350710578,-5,1260,2396,30
82358805607,82358805604,-3,729,2093,30
82361187761,82361187759,-2,1196,1903,30
82363922169,82363922165,-4,1053,2759,30
82368083574,82368083570,-4,984,2565,30
82369980638,82369980633,-5,695,2444,30
82372650368,82372650374,6,2576,1160,30
82374847702,82374847697,-5,1273,3827,30
82375812475,82375812492,17,885,2757,30
82376242500,82376242516,16,1505,3241,30
82379430030,82379430026,-4,1478,2620,30
82380989375,82380989371,-4,886,2190,30
82381197329,82381197316,-13,758,2000,30
82384764303,82384764298,-5,1401,2301,30
82386620162,82386620151,-11,922,1151,30
82389396011,82389396005,-6,910,3353,30
82398578145,82398578140,-5,1376,3472,30
82399424103,82399424098,-5,1262,3762,30
82399468331,82399468350,19,886,1156,30
82401435760,82401435755,-5,894,2465,30
82408786454,82408786449,-5,1100,3516,30
82411032927,82411032925,-2,538,1791,30
82411509283,82411509287,4,3696,2750,30
82411948846,82411948841,-5,1244,2521,30
82414923028,82414923025,-3,1143,3192,30
82415438719,82415438717,-2,965,2713,30
82418730286,82418730281,-5,1202,2773,30
82427214224,82427214220,-4,1265,2604,30
82428438643,82428438640,-3,1194,3005,30
82428491038,82428491033,-5,860,2480,30
82428577361,82428577375,14,233,1092,30
82429864614,82429864611,-3,1504,3800,30
82431373110,82431373106,-4,754,1434,30
82435665881,82435665878,-3,2128,2459,30
82436145511,82436145506,-5,1084,2548,30
82436293851,82436293828,-23,1035,2398,30
82437143058,82437143053,-5,1100,3738,30
82439033666,82439033661,-5,823,3356,30
82440321062,82440321057,-5,1003,2547,30
82445060257,82445060252,-5,1063,2221,30
82445481427,82445481423,-4,1009,3309,30
82450612340,82450612334,-6,1328,3918,30
82453660099,82453660092,-7,898,2306,30
82456140438,82456140433,-5,1065,2294,30
82456321705,82456321723,18,281,1360,30
82456844914,82456844919,5,2590,829,30
82461299358,82461299353,-5,1314,4699,30
82463117713,82463117731,18,897,2455,30
82463630920,82463630915,-5,1182,1901,30
82467754512,82467754509,-3,1115,2219,30
82470811151,82470811149,-2,918,1599,30
82473237845,82473237839,-6,1095,2771,30
82474871286,82474871281,-5,1083,2863,30
82481382686,82481382678,-8,900,3200,30
82482072450,82482072455,5,13247,8236,30
82483265161,82483265157,-4,981,2878,30
82485435488,82485435482,-6,1250,3356,30
82485570202,82485570190,-12,970,2738,30
82485664692,82485664706,14,730,1751,30
82493214833,82493214829,-4,955,2211,30
82493794479,82493794473,-6,1302,3363,30
82507514527,82507514523,-4,1191,3472,30
82508563990,82508563986,-4,952,2773,30
82508600249,82508600267,18,145,580,30
82510124438,82510124432,-6,939,2446,30
82510321345,82510321340,-5,873,2450,30
82510778839,82510778846,7,746,1611,30
82513365310,82513365309,-1,1285,1276,30
82517730511,82517730507,-4,1187,2671,30
82518596955,82518596951,-4,967,2261,30
82519302914,82519302922,8,80,895,30
82530484805,82530484802,-3,1535,3582,30
82530925258,82530925238,-20,877,2100,30
82532313341,82532313337,-4,731,1623,30
82533632748,82533632743,-5,1018,2656,30
82535786044,82535786039,-5,1107,2668,30
82536633607,82536633600,-7,825,1856,30
82544024766,82544024773,7,3129,1015,30
82549928874,82549928870,-4,1025,3352,30
82550607991,82550607986,-5,1413,3087,30
82553509742,82553509738,-4,764,2201,30
82554859259,82554859254,-5,908,2619,30
82562252835,82562252837,2,994,1463,30
82562873402,82562873397,-5,570,1026,30
82564773920,82564773920,0,2701,3061,30
82567585323,82567585318,-5,1046,2411,30
82572979398,82572979395,-3,1003,2475,30
82581024683,82581024675,-8,1059,4802,30
82583067133,82583067129,-4,3026,11268,30
82585956659,82585956664,5,2473,1378,30
82588556103,82588556098,-5,1158,2827,30
82590983959,82590983957,-2,2507,4948,30
82591416018,82591416014,-4,855,2643,30
82592851793,82592851787,-6,1281,3231,30
82595101452,82595101446,-6,1232,4242,30
82595796849,82595796846,-3,1119,3224,30
82596068986,82596068980,-6,1191,2938,30
82596224655,82596224651,-4,826,2863,30
82596338340,82596338349,9,262,868,30
82601411387,82601411388,1,4929,25254,30
82606610645,82606610650,5,4658,2533,30
82609973900,82609973894,-6,981,2600,30
82618168614,82618168610,-4,851,3196,30
82619877182,82619877178,-4,1030,2795,30
82627230656,82627230653,-3,644,1636,30
82631769440,82631769436,-4,1202,2373,30
82635382103,82635382097,-6,597,2452,30
82635521715,82635521711,-4,976,2274,30
82639983279,82639983276,-3,821,2326,30
82645658049,82645658044,-5,877,3162,30
82646336600,82646336582,-18,121,598,30
82656169555,82656169550,-5,1275,2323,30
82663039235,82663039234,-1,1315,2263,30
82673378799,82673378797,-2,801,2142,30
82677357523,82677357517,-6,1438,3338,30
82679702032,82679702029,-3,956,2603,30
82680592794,82680592789,-5,911,2827,30
82681596083,82681596080,-3,1108,2353,30
82682469924,82682469932,8,888,2309,30
82683739785,82683739781,-4,1142,2890,30
82684366294,82684366290,-4,1444,3205,30
82687344262,82687344258,-4,1307,3240,30
82696461841,82696461837,-4,969,2294,30
82699018772,82699018769,-3,1296,2387,30
82700217647,82700217642,-5,872,2727,30
82700914817,82700914832,15,650,2748,30
82700989779,82700989774,-5,1036,3247,30
82701809906,82701809910,4,2018,1711,30
82705251469,82705251466,-3,807,2233,30
82707049698,82707049694,-4,1011,2495,30
82707814615,82707814611,-4,862,1785,30
82714146139,82714146133,-6,1199,3345,30
82714235331,82714235326,-5,1490,3110,30
82723541135,82723541130,-5,907,3624,30
82723976665,82723976661,-4,1143,3980,30
82724478162,82724478165,3,1323,1668,30
82732904578,82732904574,-4,849,2543,30
82735909253,82735909249,-4,657,2616,30
82748228154,82748228153,-1,1756,2095,30
82757608578,82757608558,-20,197,1191,30
82758290266,82758290260,-6,1301,3069,30
82758564753,82758564775,22,410,900,30
82764361151,82764361146,-5,967,2885,30
82774409334,82774409330,-4,1084,3153,30
82775393899,82775393894,-5,1332,3767,30
82777889261,82777889258,-3,1466,4261,30
82787060942,82787060935,-7,976,2442,30
82788660410,82788660406,-4,1028,3648,30
82789069589,82789069582,-7,1028,4960,30
82790773050,82790773046,-4,1639,2983,30
82793117774,82793117770,-4,950,2457,30
82794237494,82794237489,-5,999,2862,30
82796311757,82796311757,0,45864,22826,30
82801370338,82801370344,6,1974,1187,30
82810022686,82810022684,-2,773,3214,30
82810062881,82810062902,21,250,998,30
82811656800,82811656794,-6,1190,2463,30
82814312287,82814312282,-5,920,1616,30
82814528430,82814528426,-4,1250,2361,30
82814680055,82814680053,-2,798,2364,30
82816997567,82816997565,-2,576,1890,30
82820795784,82820795783,-1,2552,2970,30
82823909238,82823909234,-4,1298,2572,30
82827184085,82827184078,-7,1325,3334,30
82836111914,82836111910,-4,993,2607,30
82840236401,82840236396,-5,1265,4925,30
82847384349,82847384344,-5,957,2125,30
82851561294,82851561290,-4,709,2042,30
82852776402,82852776398,-4,1160,3124,30
82855941538,82855941533,-5,795,3000,30
82857308847,82857308841,-6,979,3577,30
82858435858,82858435874,16,704,2004,30
82859833285,82859833267,-18,145,446,30
82864882067,82864882065,-2,1089,2965,30
82866020218,82866020213,-5,813,2148,30
82867372066,82867372066,0,981,1513,30
82869624060,82869624051,-9,2304,10174,30
82873236326,82873236321,-5,731,1302,30
82873809383,82873809381,-2,1684,1937,30
82875024447,82875024441,-6,608,4598,30
82875101603,82875101606,3,73,1049,30
82878044574,82878044569,-5,1049,3410,30
82887419757,82887419754,-3,1080,3738,30
82888045666,82888045661,-5,844,2397,30
82890475634,82890475631,-3,1287,2354,30
82897124399,82897124395,-4,1232,2712,30
82897767768,82897767771,3,7241,5306,30
82897941334,82897941333,-1,1658,2774,30
82898060105,82898060101,-4,1244,2598,30
82901318715,82901318710,-5,847,1659,30
82903282062,82903282058,-4,694,2201,30
82904509598,82904509594,-4,995,2683,30
82904779446,82904779442,-4,913,2434,30
82905512778,82905512773,-5,631,2471,30
82906297217,82906297230,13,698,2868,30
82906794686,82906794681,-5,1201,3428,30
82907269393,82907269394,1,2045,1737,30
82919181673,82919181667,-6,1321,3163,30
82920460679,82920460674,-5,996,3578,30
82925753194,82925753191,-3,1435,2470,30
82926167636,82926167657,21,673,2517,30
82926477198,82926477195,-3,879,2212,30
82928167911,82928167931,20,224,686,30
82929760445,82929760464,19,339,1449,30
82930043064,82930043082,18,1005,2486,30
82933559834,82933559829,-5,964,2432,30
82938746103,82938746106,3,2507,1232,30
82940536372,82940536378,6,2823,1569,30
82942809319,82942809313,-6,1143,3293,30
82944100969,82944100955,-14,159,1392,30
82956800070,82956800065,-5,815,1912,30
82956855434,82956855450,16,314,1020,30
82958634139,82958634134,-5,1130,3426,30
82958927059,82958927062,3,2178,1746,30
82962125843,82962125850,7,1391,1132,30
82967930898,82967930895,-3,842,1762,30
82970574183,82970574181,-2,730,2846,30
82972108677,82972108672,-5,865,2941,30
82978508338,82978508335,-3,1314,3295,30
82980423866,82980423862,-4,1046,2939,30
82982963747,82982963742,-5,939,2906,30
82983423771,82983423766,-5,1108,3390,30
82987703925,82987703921,-4,1086,3101,30
82987848620,82987848639,19,1,802,30
82993975042,82993975037,-5,780,2179,30
82996756014,82996756009,-5,590,1292,30
82997466226,82997466221,-5,1291,2937,30
82998611827,82998611821,-6,1100,3573,30
82999493178,82999493174,-4,392,1621,30
83000684215,83000684213,-2,916,2851,30
83001896162,83001896159,-3,755,2715,30
83003666235,83003666222,-13,685,2026,30
83012106875,83012106878,3,4362,3685,30
83012181071,83012181066,-5,788,4136,30
83013132450,83013132447,-3,687,2415,30
83016938734,83016938730,-4,1552,3323,30
83018255947,83018255944,-3,1116,1716,30
83020473194,83020473191,-3,1209,3580,30
83020787233,83020787254,21,221,1153,30
83028328002,83028328007,5,1308,845,30
83031530263,83031530257,-6,1099,4059,30
83033281394,83033281391,-3,643,1174,30
83037790199,83037790190,-9,1141,4581,30
83038050122,83038050118,-4,855,2393,30
83043532789,83043532785,-4,1017,3108,30
83049475084,83049475101,17,510,2869,30
83057664169,83057664165,-4,780,2187,30
83060706627,83060706623,-4,935,3195,30
83061483011,83061483006,-5,483,2017,30
83061759658,83061759679,21,916,2531,30
83065351103,83065351100,-3,1381,2728,30
83065801172,83065801191,19,602,1997,30
83069493030,83069493026,-4,740,1624,30
83074771376,83074771371,-5,964,2184,30
83076339681,83076339676,-5,1257,3227,30
83080464398,83080464393,-5,956,3692,30
83091956289,83091956285,-4,846,2429,30
83104082977,83104082978,1,1760,1974,30
83105485831,83105485826,-5,900,2720,30
83110428827,83110428821,-6,922,1737,30
83112079890,83112079886,-4,1000,3773,30
83112230442,83112230438,-4,1058,3130,30
83112665321,83112665315,-6,767,1990,30
83121003637,83121003634,-3,861,2690,30
83123714200,83123714203,3,3798,3128,30
83124394376,83124394371,-5,1065,2351,30
83127817292,83127817288,-4,941,4007,30
83133374367,83133374362,-5,1399,3029,30
83140531634,83140531629,-5,869,3612,30
83141922507,83141922523,16,502,1710,30
83141962986,83141962986,0,1285,2775,30
83142528297,83142528291,-6,1112,3265,30
83149353667,83149353665,-2,614,1621,30
83157410579,83157410581,2,1745,1671,30
83159336443,83159336438,-5,907,2368,30
83159809555,83159809542,-13,1422,2159,30
83164391397,83164391391,-6,1080,3225,30
83166037877,83166037871,-6,1057,3758,30
83171695838,83171695833,-5,1116,3370,30
83171743632,83171743625,-7,970,2812,30
83173695991,83173695994,3,1389,1448,30
83175644655,83175644648,-7,833,2574,30
83176989909,83176989903,-6,1054,2311,30
83179120591,83179120586,-5,926,2225,30
83180577602,83180577599,-3,723,2202,30
83181125123,83181125119,-4,1156,2946,30
83189963720,83189963714,-6,1482,4005,30
83191145955,83191145957,2,33697,33524,30
83195688558,83195688556,-2,1067,1994,30
83197038323,83197038318,-5,773,1942,30
83198201102,83198201098,-4,835,2442,30
83202502808,83202502803,-5,725,2847,30
83206700602,83206700597,-5,1045,2145,30
83209782946,83209782942,-4,1031,2030,30
83217197541,83217197537,-4,1076,3165,30
83218057317,83218057313,-4,1181,3140,30
83219779798,83219779795,-3,1259,3355,30
83223230894,83223230890,-4,1482,2655,30
83224702449,83224702455,6,2922,1123,30
83226397487,83226397481,-6,1195,5478,30
83226559569,83226559564,-5,1332,3376,30
83228464145,83228464141,-4,1021,2991,30
83229206158,83229206154,-4,1012,2303,30
83230682569,83230682565,-4,778,2634,30
83231499340,83231499337,-3,958,3048,30
83240401735,83240401730,-5,849,2044,30
83243909261,83243909256,-5,1344,4171,30
83245596481,83245596475,-6,726,2403,30
83246228200,83246228195,-5,917,2812,30
83246394786,83246394777,-9,279,1060,30
83247546742,83247546737,-5,1921,3678,30
83250607347,83250607345,-2,1371,1779,30
83250838454,83250838450,-4,1324,3081,30
83251773449,83251773446,-3,1132,2204,30
83255935666,83255935659,-7,807,4699,30
83258042247,83258042247,0,1357,1499,30
83261563280,83261563267,-13,940,3345,30
83262677151,83262677145,-6,812,2751,30
83264147986,83264147980,-6,647,2150,30
83266111271,83266111266,-5,1313,2715,30
83266548644,83266548641,-3,821,1877,30
83266613419,83266613410,-9,325,951,30
83268672101,83268672095,-6,883,3436,30
83274061842,83274061838,-4,1144,3224,30
83274753012,83274753005,-7,1117,3454,30
83283102029,83283102023,-6,990,1729,30
83283507604,83283507614,10,555,1211,30
83285643601,83285643598,-3,1060,2381,30
83285810859,83285810838,-21,737,1714,30
83285857634,83285857655,21,311,1305,30
83286471144,83286471138,-6,1066,3193,30
83293980889,83293980884,-5,1452,2730,30
83294270497,83294270514,17,708,1903,30
83298510311,83298510305,-6,489,1741,30
83300472330,83300472323,-7,1004,3767,30
83301315546,83301315542,-4,1045,2222,30
83302718187,83302718182,-5,1128,3000,30
83304782995,83304782989,-6,1014,2454,30
83305706105,83305706121,16,141,621,30
83306605827,83306605825,-2,582,2402,30
83308934518,83308934513,-5,1168,2955,30
83317167541,83317167536,-5,1245,2676,30
83317306427,83317306422,-5,1131,3614,30
83321006909,83321006904,-5,901,2744,30
83321194037,83321194033,-4,1215,3145,30
83328083200,83328083195,-5,1208,4017,30
83328616457,83328616436,-21,297,1632,30
83329533625,83329533621,-4,1330,2824,30
83330004679,83330004674,-5,571,1927,30
83332987753,83332987749,-4,959,3089,30
83341290213,83341290221,8,11516,4893,30
83347288235,83347288229,-6,1086,3712,30
83350358426,83350358431,5,4213,2199,30
83358619732,83358619726,-6,682,2627,30
83366957090,83366957085,-5,633,2472,30
83368949309,83368949305,-4,952,2863,30
83369002945,83369002933,-12,723,1258,30
83369499530,83369499517,-13,265,868,30
83369830848,83369830855,7,257,1093,30
83369858664,83369858686,22,482,2565,30
83378317887,83378317888,1,889,2578,30
83383993343,83383993339,-4,1031,3291,30
83386382074,83386382068,-6,1121,2628,30
83387530719,83387530716,-3,1386,3494,30
83389939548,83389939562,14,832,2973,30
83392151939,83392151942,3,1297,1352,30
83399344614,83399344606,-8,524,1723,30
83401046623,83401046620,-3,922,2617,30
83401455589,83401455590,1,1804,1463,30
83405405659,83405405656,-3,1066,2989,30
83408918299,83408918292,-7,940,2884,30
83412970494,83412970487,-7,640,2929,30
83416392355,83416392351,-4,830,2163,30
83422151853,83422151847,-6,540,883,30
83423325568,83423325591,23,201,1611,30
83423484297,83423484286,-11,234,828,30
83426071804,83426071805,1,2412,2524,30
83428094971,83428094979,8,3003,1346,30
83432613404,83432613398,-6,989,3225,30
83440316776,83440316772,-4,1239,3790,30
83443939376,83443939381,5,3177,1855,30
83445261810,83445261806,-4,1046,3197,30
83447815721,83447815715,-6,938,1833,30
83448503760,83448503758,-2,993,3397,30
83449394714,83449394711,-3,797,2002,30
83453225599,83453225593,-6,1360,2896,30
83453259553,83453259550,-3,244,1029,30
83456192398,83456192393,-5,922,2346,30
83456322706,83456322706,0,986,1349,30
83456373371,83456373391,20,606,2423,30
83456827683,83456827701,18,1224,2601,30
83457818669,83457818669,0,3538,2718,30
83458761506,83458761499,-7,1296,4811,30
83465783110,83465783106,-4,584,1515,30
83466064604,83466064615,11,489,1185,30
83466560756,83466560753,-3,860,2499,30
83475650167,83475650163,-4,926,2405,30
83479820579,83479820574,-5,1744,2811,30
83480757108,83480757102,-6,1327,3082,30
83491657091,83491657087,-4,1037,1730,30
83492584873,83492584874,1,1164,1113,30
83493328012,83493328007,-5,1382,2542,30
83497681502,83497681504,2,14850,11387,30
83502680687,83502680682,-5,699,2115,30
83502892241,83502892257,16,652,918,30
83504268910,83504268918,8,3565,1451,30
83510275954,83510275949,-5,1121,2355,30
83511585725,83511585721,-4,1054,2571,30
83512853934,83512853931,-3,1076,2782,30
83513329107,83513329121,14,1037,4045,30
83513667739,83513667759,20,806,3343,30
83517128790,83517128788,-2,949,3236,30
83517284186,83517284183,-3,132,731,30
83518250506,83518250503,-3,1017,2879,30
83521233403,83521233400,-3,940,2694,30
83522451503,83522451501,-2,1445,2451,30
83524849026,83524849023,-3,815,3515,30
83526451466,83526451461,-5,1331,3405,30
83526927955,83526927952,-3,1059,3106,30
83531828808,83531828802,-6,927,2406,30
83537315157,83537315151,-6,1187,4516,30
83538497626,83538497621,-5,1477,3503,30
83538773539,83538773533,-6,1141,3127,30
83539646018,83539646013,-5,805,2550,30
83539697641,83539697633,-8,412,1000,30
83552696714,83552696709,-5,590,1509,30
83553041995,83553041992,-3,1147,2511,30
83553091695,83553091690,-5,1405,3136,30
83554953611,83554953605,-6,1112,4654,30
83557106127,83557106128,1,752,1448,30
83560406655,83560406649,-6,1126,3881,30
83562479103,83562479101,-2,964,1705,30
83563549911,83563549921,10,1465,1306,30
83564258112,83564258118,6,1863,819,30
83565369593,83565369599,6,3286,1602,30
83566920707,83566920702,-5,832,3049,30
83568817581,83568817577,-4,1540,4942,30
83574027559,83574027554,-5,889,2934,30
83577715739,83577715734,-5,1052,2358,30
83583438393,83583438389,-4,983,2998,30
83583606275,83583606269,-6,1245,2706,30
83583871452,83583871470,18,792,2984,30
83584291837,83584291832,-5,1281,2816,30
83595951585,83595951581,-4,993,3032,30
83606013885,83606013881,-4,1082,3595,30
83606809553,83606809555,2,107,1331,30
83613372743,83613372740,-3,922,2151,30
83613879739,83613879724,-15,1075,3504,30
83614057763,83614057763,0,1239,1415,30
83614128834,83614128829,-5,713,2250,30
83616370108,83616370101,-7,1372,2788,30
83616983617,83616983598,-19,874,2778,30
83627297976,83627297973,-3,819,1922,30
83637628438,83637628433,-5,901,2558,30
83640140590,83640140587,-3,1065,3076,30
83642191810,83642191796,-14,585,2254,30
83642476869,83642476865,-4,1268,3424,30
83649003854,83649003855,1,1951,1621,30
83652536105,83652536101,-4,1106,3296,30
83653271585,83653271566,-19,877,1343,30
83655829772,83655829768,-4,913,3032,30
83659053832,83659053837,5,5034,2621,30
83662876338,83662876334,-4,1120,3219,30
83664499876,83664499871,-5,1156,3299,30
83665296651,83665296655,4,149,849,30
83668396658,83668396659,1,31756,18830,30
83673830146,83673830165,19,1262,2329,30
83673921450,83673921447,-3,1081,2734,30
83675054004,83675054006,2,2273,1864,30
83679054055,83679054050,-5,1772,3294,30
83682557096,83682557091,-5,1395,3075,30
83682996608,83682996611,3,43,1073,30
83683232011,83683232006,-5,1114,3346,30
83684661509,83684661505,-4,769,2004,30
83687013466,83687013460,-6,815,2671,30
83689100534,83689100529,-5,639,2295,30
83689855931,83689855933,2,211,974,30
83695529203,83695529201,-2,52850,29153,30
83697437185,83697437182,-3,1072,3104,30
83698583867,83698583862,-5,1002,2367,30
83698725437,83698725431,-6,876,3370,30
83699260420,83699260433,13,542,857,30
83707393843,83707393837,-6,969,3177,30
83709678818,83709678812,-6,732,2206,30
83709852225,83709852222,-3,835,2252,30
83711960608,83711960605,-3,817,1496,30
83712420831,83712420826,-5,962,2757,30
83712717499,83712717493,-6,898,3338,30
83714055725,83714055726,1,2230,3016,30
83724420670,83724420667,-3,1145,2412,30
83739126570,83739126566,-4,1082,2264,30
83741177745,83741177739,-6,1881,3944,30
83744409850,83744409846,-4,1340,2886,30
83746365134,83746365130,-4,956,1700,30
83746831872,83746831853,-19,100376,52749,30
83747263186,83747263185,-1,19622,21104,30
83758162494,83758162490,-4,1146,1587,30
83762760108,83762760105,-3,994,2651,30
83767483391,83767483386,-5,910,3779,30
83775668163,83775668157,-6,1348,4263,30
83777397647,83777397664,17,15258,52147,30
83781889971,83781889970,-1,1482,3132,30
83782813042,83782813037,-5,659,2318,30
83787890818,83787890835,17,268,983,30
83787969430,83787969425,-5,1041,2928,30
83791587902,83791587908,6,49752,22407,30
83793478702,83793478697,-5,675,3024,30
83794249642,83794249640,-2,788,1705,30
83797432832,83797432827,-5,983,3392,30
83797600425,83797600421,-4,1246,3919,30
83798647313,83798647314,1,1308,1218,30
83804113164,83804113158,-6,1047,3290,30
83804335715,83804335695,-20,765,3203,30
83804868750,83804868761,11,12710,35042,30
83805716134,83805716128,-6,1124,3382,30
83807375454,83807375450,-4,1190,3331,30
83808608133,83808608131,-2,1240,2676,30
83810983715,83810983710,-5,1428,3357,30
83811888998,83811888994,-4,1083,2367,30
83812783346,83812783341,-5,1226,3446,30
83816790945,83816790942,-3,847,2207,30
83818990066,83818990061,-5,948,3024,30
83820723363,83820723358,-5,1340,4506,30
83823146211,83823146208,-3,936,2821,30
83823883974,83823883970,-4,883,2216,30
83838900022,83838900018,-4,1115,4160,30
83840195422,83840195422,0,807,1359,30
83845208751,83845208746,-5,1086,2584,30
83846956883,83846956902,19,708,3180,30
83851754713,83851754706,-7,1088,2618,30
83861408402,83861408398,-4,709,1643,30
83867813574,83867813570,-4,815,2674,30
83868696865,83868696861,-4,816,3137,30
83870374678,83870374673,-5,1334,3198,30
83873324758,83873324755,-3,1600,2817,30
83876359314,83876359309,-5,1015,2658,30
83887351418,83887351416,-2,579,1720,30
83888873962,83888873958,-4,952,1973,30
83891114216,83891114214,-2,1026,3207,30
83891670051,83891670045,-6,909,1263,30
83892518900,83892518904,4,4077,2714,30
83893878067,83893878063,-4,1081,2462,30
83894499839,83894499837,-2,1529,2388,30
83899552595,83899552590,-5,708,2634,30
83904044103,83904044107,4,1079,1109,30
83906779931,83906779926,-5,883,2502,30
83914550926,83914550923,-3,841,2873,30
83915991993,83915991989,-4,1506,2947,30
83919477251,83919477246,-5,954,2434,30
83920875190,83920875186,-4,778,2507,30
83921371642,83921371638,-4,1240,2952,30
83922591559,83922591556,-3,665,2120,30
83923753082,83923753094,12,276,1399,30
83925333966,83925333964,-2,1046,3179,30
83931357037,83931357030,-7,1019,2663,30
83933007731,83933007710,-21,1160,1177,30
83936776412,83936776408,-4,1141,2834,30
83937166135,83937166131,-4,1206,2932,30
83940530118,83940530113,-5,1434,3810,30
83950950453,83950950460,7,3719,1386,30
83954957863,83954957859,-4,560,2019,30
83956414653,83956414654,1,2188,1565,30
83957349280,83957349274,-6,1088,3345,30
83957785959,83957785957,-2,1116,2949,30
83958880021,83958880033,12,1302,961,30
83962416554,83962416552,-2,1058,3513,30
83965562544,83965562527,-17,126,1199,30
83966637868,83966637881,13,324,1142,30
83968897641,83968897636,-5,852,2547,30
83972643198,83972643195,-3,865,2820,30
83973338906,83973338908,2,2210,2003,30
83983885303,83983885297,-6,1052,2586,30
83985218965,83985218969,4,1065,1666,30
83986958115,83986958110,-5,956,3096,30
83988468725,83988468720,-5,1003,2647,30
83988866463,83988866459,-4,915,2056,30
83989391953,83989391949,-4,859,3255,30
83989952474,83989952454,-20,654,2422,30
83992037264,83992037258,-6,908,4019,30
83992069881,83992069863,-18,187,807,30
84002311662,84002311658,-4,1193,3522,30
84002681093,84002681088,-5,975,3222,30
84004000919,84004000914,-5,1159,2925,30
84006799523,84006799517,-6,888,3710,30
84011954133,84011954129,-4,1086,2824,30
84019872898,84019872893,-5,1031,3597,30
84023559713,84023559707,-6,1082,3275,30
84024274029,84024274023,-6,1058,3229,30
84024437169,84024437165,-4,1131,2913,30
84025355690,84025355683,-7,1611,5383,30
84025421739,84025421733,-6,944,2520,30
84030781534,84030781529,-5,1120,3349,30
84031925229,84031925225,-4,743,2346,30
84032343147,84032343144,-3,1007,2399,30
84033672375,84033672371,-4,1145,3674,30
84035760410,84035760405,-5,901,3597,30
84039261647,84039261641,-6,1149,2882,30
84039728944,84039728940,-4,159,5300,30
84039825738,84039825757,19,832,2425,30
84042591367,84042591363,-4,693,1403,30
84043503493,84043503497,4,1909,1198,30
84046916084,84046916086,2,2414,1454,30
84049059616,84049059611,-5,867,2418,30
84052123347,84052123350,3,1656,1383,30
84052335698,84052335694,-4,1016,3247,30
84058786427,84058786426,-1,1220,3057,30
84059059779,84059059777,-2,907,1733,30
84063724486,84063724482,-4,914,2517,30
84064664260,84064664256,-4,1223,4083,30
84069302240,84069302233,-7,1168,3668,30
84079018022,84079018017,-5,1114,3451,30
84079205477,84079205470,-7,941,2664,30
84079272793,84079272780,-13,1138,3739,30
84081596922,84081596917,-5,782,1752,30
84082547512,84082547514,2,1027,928,30
84084267951,84084267946,-5,1030,3911,30
84085397610,84085397609,-1,1189,1401,30
84086854262,84086854255,-7,696,3266,30
84097206995,84097206996,1,86281,20213,30
84103553750,84103553745,-5,928,2470,30
84103981121,84103981115,-6,961,2376,30
84104341349,84104341346,-3,842,1724,30
84106407690,84106407683,-7,572,1378,30
84107211066,84107211050,-16,1150,2365,30
84108041394,84108041406,12,108,684,30
84110211374,84110211381,7,8208,2912,30
84126027825,84126027817,-8,803,3510,30
84126219899,84126219883,-16,101,897,30
84127636566,84127636564,-2,833,2841,30
84130536570,84130536569,-1,1128,2166,30
84130628255,84130628253,-2,1405,3086,30
84131271030,84131271026,-4,1046,3143,30
84132577059,84132577055,-4,841,2562,30
84138026974,84138026969,-5,1413,2897,30
84139790686,84139790683,-3,1139,1699,30
84141914656,84141914650,-6,1079,4458,30
84142200184,84142200170,-14,187,912,30
84142383784,84142383801,17,779,3397,30
84143808822,84143808819,-3,1112,2510,30
84149485488,84149485494,6,8240,37237,30
84156582215,84156582211,-4,1218,1850,30
84160880909,84160880905,-4,1017,2118,30
84164240157,84164240152,-5,1131,2962,30
84172240210,84172240206,-4,779,2839,30
84172541674,84172541667,-7,1289,2291,30
84172990458,84172990454,-4,1263,3570,30
84175068355,84175068350,-5,912,3077,30
84180127111,84180127106,-5,421,2149,30
84181490712,84181490703,-9,121,767,30
84184143111,84184143129,18,709,2233,30
84191219025,84191219028,3,2430,2653,30
84192673889,84192673884,-5,1126,2348,30
84193573038,84193573033,-5,949,2077,30
84194768487,84194768491,4,3653,2282,30
84195011234,84195011229,-5,1257,2832,30
84196518771,84196518766,-5,1580,3329,30
84196612732,84196612717,-15,8,793,30
84199186815,84199186815,0,1256,1291,30
84199799744,84199799728,-16,120,860,30
84201267674,84201267670,-4,1132,2539,30
84201384336,84201384354,18,203,1030,30
84205471105,84205471098,-7,953,3270,30
84209742037,84209742033,-4,1202,2964,30
84212394998,84212394995,-3,679,2332,30
84212423100,84212423119,19,1066,2655,30
84215311707,84215311712,5,118,659,30
84223356801,84223356807,6,2698,1092,30
84224977725,84224977721,-4,859,2664,30
84225509062,84225509067,5,2248,1988,30
84234993089,84234993085,-4,1466,4070,30
84236043610,84236043608,-2,999,2480,30
84240888102,84240888097,-5,1115,3471,30
84242126592,84242126606,14,386,1743,30
84242577899,84242577897,-2,1333,1926,30
84242745423,84242745418,-5,1284,2784,30
84243152682,84243152678,-4,1280,2676,30
84243836001,84243835997,-4,1062,3165,30
84244494502,84244494499,-3,1178,3278,30
84249475924,84249475918,-6,1144,3509,30
84253665653,84253665648,-5,719,1749,30
84257748858,84257748855,-3,958,1953,30
84259035842,84259035841,-1,2206,2936,30
84266228707,84266228702,-5,959,2691,30
84266488146,84266488141,-5,794,2415,30
84272468978,84272468978,0,1261,2016,30
84276242057,84276242053,-4,1002,2557,30
84277866279,84277866274,-5,1256,3695,30
84278496702,84278496698,-4,695,1874,30
84280375960,84280375966,6,3768,1668,30
84282363968,84282363963,-5,1080,3416,30
84285588251,84285588246,-5,807,2453,30
84292138406,84292138401,-5,1112,2739,30
84292623756,84292623769,13,798,1808,30
84293408368,84293408364,-4,996,3323,30
84296642294,84296642290,-4,996,2475,30
84297786115,84297786110,-5,1314,3029,30
84299834995,84299834990,-5,1298,3054,30
84300036779,84300036777,-2,1942,2404,30
84301840028,84301840022,-6,975,2658,30
84303874814,84303874809,-5,1457,2058,30
84305491927,84305491921,-6,1322,3181,30
84307983222,84307983217,-5,828,1683,30
84311517666,84311517666,0,2129,2965,30
84311608168,84311608163,-5,960,2820,30
84312209350,84312209346,-4,929,2816,30
84323731147,84323731142,-5,840,2656,30
84323908627,84323908644,17,861,2654,30
84327297836,84327297831,-5,1366,3686,30
84330633492,84330633489,-3,1006,2995,30
84330877018,84330877003,-15,273,954,30
84333805571,84333805562,-9,924,2078,30
84338817066,84338817067,1,1679,1851,30
84341871734,84341871732,-2,792,1388,30
84345532315,84345532315,0,1490,1892,30
84346388822,84346388817,-5,971,3137,30
84346487770,84346487791,21,180,928,30
84358184287,84358184282,-5,1140,3156,30
84358515718,84358515713,-5,1691,3299,30
84360307290,84360307283,-7,934,2402,30
84362108260,84362108276,16,1005,3335,30
84362495365,84362495358,-7,1015,3075,30
84362993685,84362993681,-4,1269,2220,30
84364109612,84364109631,19,463,1840,30
84364435222,84364435217,-5,1076,2451,30
84369261798,84369261802,4,1765,868,30
84370783496,84370783491,-5,879,1697,30
84372819647,84372819642,-5,426,1491,30
84376245327,84376245322,-5,1168,2593,30
84376800179,84376800173,-6,986,3287,30
84377520954,84377520948,-6,1334,3379,30
84380712253,84380712248,-5,1104,3988,30
84382640286,84382640289,3,1923,1436,30
84383577967,84383577963,-4,998,2771,30
84395395283,84395395278,-5,1077,3282,30
84396155294,84396155290,-4,1337,3815,30
84398927563,84398927557,-6,952,3454,30
84401001298,84401001302,4,938,1490,30
84405703605,84405703601,-4,1081,2977,30
84410590083,84410590081,-2,1152,1166,30
84411801491,84411801488,-3,808,1907,30
84412428395,84412428381,-14,319,957,30
84416189693,84416189688,-5,1097,3529,30
84417192177,84417192173,-4,1125,3247,30
84421276233,84421276215,-18,1634,789,30
84423883478,84423883474,-4,925,2144,30
84424762519,84424762515,-4,1617,2897,30
84433200397,84433200392,-5,927,2992,30
84435221794,84435221791,-3,1275,2431,30
84436019673,84436019666,-7,1087,1682,30
84437314618,84437314613,-5,624,1410,30
84439620664,84439620662,-2,2355,4802,30
84442188752,84442188747,-5,1271,4225,30
84450406244,84450406241,-3,1096,2173,30
84458269101,84458269097,-4,666,2873,30
84458786280,84458786276,-4,1304,2657,30
84458873051,84458873048,-3,728,1601,30
84460218375,84460218368,-7,967,2780,30
84462601175,84462601171,-4,1023,3203,30
84467201078,84467201060,-18,1741,1398,30
84471406562,84471406556,-6,660,3176,30
84471501345,84471501343,-2,918,1928,30
84472665992,84472665987,-5,986,3444,30
84474233707,84474233703,-4,909,2678,30
84478320261,84478320257,-4,1155,3820,30
84478451129,84478451128,-1,202,1075,30
84479520664,84479520645,-19,37,972,30
84479898266,84479898263,-3,1235,2893,30
84480139562,84480139558,-4,1032,1758,30
84480166805,84480166801,-4,1241,2500,30
84480383884,84480383902,18,1063,2850,30
84482189386,84482189382,-4,2469,4811,30
84486148526,84486148522,-4,1123,3415,30
84494489101,84494489099,-2,642,2266,30
84495146184,84495146178,-6,1309,4117,30
84497226679,84497226674,-5,3621,9711,30
84499258394,84499258390,-4,1057,2798,30
84499821508,84499821508,0,32,1961,30
84501955419,84501955414,-5,819,2642,30
84513494801,84513494797,-4,1273,2955,30
84515164994,84515164989,-5,1187,3342,30
84518207502,84518207498,-4,1312,2193,30
84520100979,84520100977,-2,893,2309,30
84521915720,84521915716,-4,1097,2544,30
84522534899,84522534896,-3,1274,2804,30
84529451634,84529451632,-2,1195,1508,30
84532579305,84532579299,-6,851,3147,30
84533610364,84533610359,-5,1029,1978,30
84533908273,84533908294,21,963,3603,30
84538828185,84538828181,-4,1231,4074,30
84539070246,84539070243,-3,1046,3191,30
84539660015,84539660010,-5,1247,2242,30
84545711619,84545711615,-4,1370,3394,30
84546185616,84546185612,-4,1363,2699,30
84546578573,84546578574,1,989,20990,30
84549020727,84549020722,-5,881,2446,30
84553348182,84553348176,-6,1066,2202,30
84553889066,84553889066,0,210,1146,30
84565061162,84565061157,-5,1131,4005,30
84567821026,84567821022,-4,1234,2125,30
84574322950,84574322946,-4,794,2684,30
84574382218,84574382214,-4,723,2919,30
84575695524,84575695518,-6,1405,4372,30
84577285276,84577285270,-6,896,2625,30
84583532539,84583532534,-5,680,2713,30
84585131859,84585131855,-4,1338,4230,30
84587386001,84587385996,-5,1170,2525,30
84589154072,84589154067,-5,1023,2978,30
84590709959,84590709956,-3,925,1913,30
84592214794,84592214790,-4,776,2774,30
84600988123,84600988118,-5,1310,3621,30
84603271942,84603271937,-5,33333,9528,30
84603649926,84603649923,-3,1175,2087,30
84606601207,84606601203,-4,1023,2137,30
84608760713,84608760706,-7,837,3018,30
84610053022,84610053023,1,1688,1898,30
84614409949,84614409945,-4,782,3011,30
84615067138,84615067135,-3,180,1412,30
84618582319,84618582314,-5,820,2224,30
84621345196,84621345193,-3,741,2069,30
84623530788,84623530784,-4,1644,3668,30
84625481711,84625481706,-5,1111,4254,30
84630240123,84630240118,-5,1209,2999,30
84632727541,84632727535,-6,696,2122,30
84633629351,84633629346,-5,1149,3961,30
84640411035,84640411030,-5,1416,3137,30
84641483457,84641483474,17,554,1294,30
84644549110,84644549103,-7,961,3662,30
84644885355,84644885348,-7,1266,10236,30
84647221142,84647221138,-4,772,2574,30
84648344610,84648344605,-5,801,2911,30
84654300203,84654300198,-5,950,3125,30
84666188143,84666188138,-5,953,2842,30
84666863149,84666863147,-2,1286,1829,30
84667786237,84667786233,-4,825,2652,30
84670004359,84670004367,8,268,775,30
84684736843,84684736838,-5,1018,3051,30
84686091953,84686091942,-11,178,994,30
84689745733,84689745726,-7,1253,4253,30
84692158506,84692158503,-3,1213,2999,30
84692315888,84692315882,-6,840,2970,30
84693316809,84693316827,18,251,924,30
84694189762,84694189756,-6,987,2689,30
84695136540,84695136553,13,363,911,30
84699176467,84699176463,-4,1022,2515,30
84703807873,84703807868,-5,1215,2751,30
84703896938,84703896922,-16,235,885,30
84713422606,84713422602,-4,1446,4691,30
84713576441,84713576436,-5,1137,2134,30
84714837941,84714837937,-4,958,2667,30
84715069080,84715069068,-12,741,2930,30
84723418497,84723418501,4,1228,679,30
84723497913,84723497908,-5,1223,3334,30
84730578399,84730578397,-2,909,1763,30
84731140785,84731140800,15,240,1003,30
84736021192,84736021188,-4,1250,3515,30
84747940119,84747940124,5,44634,30515,30
84753751926,84753751921,-5,1245,4648,30
84760481136,84760481133,-3,1512,2122,30
84768742790,84768742786,-4,1544,3621,30
84768913282,84768913278,-4,1085,3575,30
84770449350,84770449347,-3,964,1663,30
84772739931,84772739928,-3,944,1663,30
84776106661,84776106656,-5,1177,2716,30
84776265468,84776265482,14,830,2256,30
84784600629,84784600626,-3,1091,3821,30
84788515419,84788515415,-4,1019,1558,30
84795983680,84795983675,-5,526,1463,30
84797067273,84797067286,13,13970,50455,30
84803073178,84803073174,-4,1077,2222,30
84803701978,84803701977,-1,1526,2227,30
84806683477,84806683471,-6,658,2016,30
84807004234,84807004217,-17,806,3554,30
84809124786,84809124782,-4,642,2413,30
84811884818,84811884814,-4,822,2488,30
84818159099,84818159095,-4,1269,2516,30
84819343602,84819343598,-4,1030,3252,30
84822632698,84822632695,-3,997,3585,30
84824319762,84824319755,-7,637,1637,30
84824654250,84824654253,3,2420,1714,30
84824935812,84824935807,-5,933,1855,30
84825904122,84825904118,-4,907,2615,30
84827651460,84827651463,3,41570,23735,30
84829220554,84829220553,-1,1116,1761,30
84829454001,84829454008,7,471,3781,30
84830463315,84830463311,-4,938,2098,30
84830817960,84830817955,-5,860,2495,30
84832334215,84832334212,-3,902,2617,30
84838452935,84838452934,-1,1566,2041,30
84839825258,84839825254,-4,738,1783,30
84842951232,84842951228,-4,1013,2847,30
84845007582,84845007579,-3,767,2344,30
84845291002,84845290998,-4,1198,1717,30
84847335954,84847335950,-4,1166,2991,30
84847757888,84847757880,-8,959,1940,30
84852962802,84852962797,-5,1229,3063,30
84853074426,84853074420,-6,1068,3004,30
84854239489,84854239484,-5,1228,4066,30
84854292744,84854292739,-5,1030,2547,30
84856922805,84856922799,-6,1404,2610,30
84856958855,84856958849,-6,753,3258,30
84858247758,84858247754,-4,931,2590,30
84859180586,84859180576,-10,43120,2683,30
84860978283,84860978281,-2,663,1703,30
84863851634,84863851629,-5,1107,3118,30
84866018690,84866018686,-4,1250,3209,30
84871807494,84871807490,-4,951,3026,30
84885492302,84885492297,-5,889,2268,30
84886510339,84886510337,-2,874,1836,30
84888025503,84888025500,-3,1359,3026,30
84890230734,84890230732,-2,777,2221,30
84891696466,84891696462,-4,1202,3143,30
84894299029,84894299024,-5,1172,4178,30
84896096946,84896096954,8,2528,1198,30
84897233213,84897233209,-4,1192,3227,30
84898505165,84898505167,2,2153,1355,30
84899687650,84899687645,-5,940,2192,30
84902629375,84902629375,0,1640,2220,30
84902835846,84902835842,-4,897,2285,30
84904275577,84904275593,16,516,2155,30
84908198065,84908198062,-3,867,3679,30
84909273866,84909273875,9,85,814,30
84910577877,84910577870,-7,1077,3879,30
84910621723,84910621741,18,94,890,30
84921420486,84921420481,-5,1152,2972,30
84925282700,84925282696,-4,744,2462,30
84930195546,84930195542,-4,1110,3448,30
84946303267,84946303261,-6,1128,5964,30
84952501220,84952501216,-4,1255,2986,30
84953016846,84953016842,-4,1124,3670,30
84954134798,84954134794,-4,1055,3376,30
84961161978,84961161974,-4,905,1712,30
84964710830,84964710826,-4,838,2791,30
84965158017,84965158017,0,1485,1202,30
84972570014,84972570009,-5,815,2651,30
84974528654,84974528651,-3,1356,2438,30
84976929304,84976929305,1,1288,1207,30
84979233338,84979233343,5,2060,1167,30
84985233920,84985233919,-1,850,1713,30
84985469823,84985469821,-2,1336,2200,30
84985905753,84985905749,-4,1106,3054,30
84986061983,84986061978,-5,1064,2530,30
84986470739,84986470734,-5,1203,3914,30
84990231329,84990231325,-4,1904,3168,30
84991278570,84991278565,-5,1321,2915,30
84995187400,84995187401,1,2004,1448,30
84997269018,84997269014,-4,1548,2739,30
85001330453,85001330450,-3,746,2367,30
85007232722,85007232718,-4,2349,6083,30
85008934966,85008934961,-5,1238,2034,30
85009127515,85009127530,15,843,2517,30
85011865393,85011865386,-7,947,3724,30
85012219897,85012219918,21,481,2092,30
85016117150,85016117163,13,174,1371,30
85019715527,85019715524,-3,1107,2917,30
85024340233,85024340229,-4,1237,3224,30
85025123331,85025123326,-5,871,2630,30
85036629575,85036629581,6,4883,3110,30
85046408043,85046408037,-6,932,2953,30
85046537809,85046537825,16,828,2569,30
85047464790,85047464786,-4,913,2736,30
85053486789,85053486793,4,1281,1047,30
85054219595,85054219588,-7,842,2387,30
85059342339,85059342336,-3,988,2942,30
85062267314,85062267310,-4,1060,2011,30
85063137169,85063137166,-3,768,1509,30
85070947286,85070947280,-6,1083,2494,30
85072031435,85072031414,-21,905,2339,30
85073051028,85073051025,-3,1020,2742,30
85075385492,85075385486,-6,1205,2934,30
85083924858,85083924854,-4,1192,2242,30
85084224771,85084224771,0,1551,1439,30
85088259638,85088259640,2,36315,29571,30
85094342514,85094342509,-5,1050,5627,30
85095118797,85095118802,5,940,1263,30
85102231415,85102231410,-5,1147,1487,30
85103643189,85103643182,-7,459,675,30
85109269572,85109269577,5,1796,1084,30
85110629630,85110629632,2,1683,1014,30
85112936989,85112936984,-5,929,2751,30
85116066753,85116066770,17,151,1261,30
85118365419,85118365414,-5,1035,2458,30
85123092071,85123092070,-1,976,2581,30
85124700711,85124700709,-2,768,1601,30
85129993928,85129993925,-3,1146,2663,30
85142887010,85142887004,-6,876,1753,30
85145188654,85145188649,-5,1191,3634,30
85149507180,85149507177,-3,1059,1997,30
85150062563,85150062542,-21,60,1333,30
85159208501,85159208495,-6,1335,3452,30
85163570358,85163570338,-20,1651,810,30
85164337944,85164337933,-11,865,2865,30
85167893023,85167893021,-2,1435,1814,30
85173239315,85173239310,-5,1068,2688,30
85177098765,85177098762,-3,800,2682,30
85182465318,85182465313,-5,1232,2620,30
85184202405,85184202401,-4,596,1695,30
85185156232,85185156227,-5,23713,12390,30
85185530569,85185530566,-3,1118,2419,30
85186143516,85186143509,-7,874,2944,30
85188793161,85188793156,-5,1229,2804,30
85192594827,85192594823,-4,1281,1952,30
85194733754,85194733751,-3,1025,2666,30
85198277929,85198277923,-6,1264,3117,30
85198718443,85198718441,-2,1349,2744,30
85199722973,85199722968,-5,829,1991,30
85200565202,85200565219,17,816,2115,30
85205763606,85205763609,3,1072,1189,30
85207563087,85207563080,-7,1571,4046,30
85208267162,85208267158,-4,1268,3026,30
85209235643,85209235640,-3,1088,2577,30
85219691473,85219691472,-1,1029,2215,30
85223595589,85223595586,-3,1370,1929,30
85224549935,85224549932,-3,1096,1971,30
85225008271,85225008267,-4,1290,2719,30
85227202913,85227202907,-6,1004,3133,30
85228479381,85228479377,-4,840,1781,30
85235386108,85235386121,13,619,1828,30
85240056482,85240056477,-5,999,2580,30
85244644792,85244644789,-3,1094,2595,30
85258940978,85258940974,-4,872,2501,30
85265388458,85265388453,-5,1128,2852,30
85265675558,85265675557,-1,984,2084,30
85267174129,85267174124,-5,1403,2552,30
85267393373,85267393374,1,3120,3196,30
85269189730,85269189726,-4,855,3232,30
85271422986,85271422982,-4,813,2828,30
85271945802,85271945807,5,19843,50436,30
85276076571,85276076573,2,1118,1256,30
85278077750,85278077746,-4,825,4672,30
85281417834,85281417828,-6,1204,3236,30
85286861205,85286861206,1,155,935,30
85296378069,85296378066,-3,1096,2048,30
85296900698,85296900693,-5,707,2045,30
85298165369,85298165366,-3,1027,2911,30
85303211138,85303211134,-4,1160,3054,30
85304463596,85304463591,-5,1528,3491,30
85306537596,85306537604,8,11485,45537,30
85308391369,85308391370,1,3379,3984,30
85311344995,85311344993,-2,1087,2461,30
85315195626,85315195623,-3,801,1673,30
85318535982,85318535975,-7,1131,2872,30
85321835082,85321835078,-4,813,1953,30
85328325854,85328325849,-5,1440,2622,30
85330672763,85330672761,-2,1131,1832,30
85335108672,85335108659,-13,717,1355,30
85336197167,85336197164,-3,1217,2790,30
85339268267,85339268263,-4,1046,2392,30
85343838390,85343838383,-7,938,3710,30
85350200297,85350200293,-4,911,3201,30
85351811174,85351811170,-4,1488,2855,30
85356518303,85356518298,-5,766,2682,30
85359390612,85359390611,-1,1353,2924,30
85359641338,85359641353,15,402,817,30
85363740963,85363740957,-6,948,2099,30
85370845046,85370845042,-4,1330,4379,30
85371173235,85371173230,-5,1428,3221,30
85380166446,85380166440,-6,1029,1352,30
85382898479,85382898475,-4,1108,2728,30
85383114746,85383114742,-4,1119,3314,30
85388427658,85388427654,-4,1014,2781,30
85389611258,85389611254,-4,896,2762,30
85393960547,85393960546,-1,1407,2501,30
85394151223,85394151221,-2,1049,2439,30
85395617307,85395617301,-6,1150,4731,30
85399403566,85399403558,-8,1014,3198,30
85401239417,85401239415,-2,1256,2080,30
85404420779,85404420776,-3,862,2710,30
85406879168,85406879162,-6,1197,3988,30
85412825615,85412825607,-8,808,4996,30
85419960701,85419960694,-7,1206,3899,30
85420727523,85420727518,-5,1356,3783,30
85420891704,85420891693,-11,135,1056,30
85424758977,85424758974,-3,890,3129,30
85424996313,85424996313,0,28471,42012,30
85425869139,85425869137,-2,1230,2841,30
85426643467,85426643464,-3,1369,1794,30
85427074146,85427074149,3,91,951,30
85429500974,85429500969,-5,1009,3153,30
85430581577,85430581573,-4,1362,2229,30
85431454821,85431454822,1,2077,2099,30
85432327547,85432327542,-5,935,3297,30
85432960001,85432959998,-3,1093,2179,30
85433489804,85433489785,-19,1109,3081,30
85438821073,85438821066,-7,1286,3529,30
85440755486,85440755482,-4,621,1708,30
85442690125,85442690130,5,4224,2471,30
85445388486,85445388482,-4,1033,2412,30
85448521246,85448521241,-5,1076,2844,30
85448560583,85448560578,-5,548,1646,30
85449255161,85449255155,-6,250,1174,30
85450227523,85450227537,14,599,1954,30
85453741125,85453741122,-3,1037,2852,30
85460456219,85460456215,-4,1178,3345,30
85464531295,85464531291,-4,890,2899,30
85466080421,85466080418,-3,1145,2812,30
85466811387,85466811385,-2,1266,2298,30
85476901746,85476901728,-18,1556,1048,30
85479636797,85479636793,-4,1408,3195,30
85481010671,85481010670,-1,170,1126,30
85481444180,85481444193,13,739,3324,30
85483996175,85483996171,-4,986,2190,30
85489012976,85489012970,-6,908,2542,30
85492504209,85492504205,-4,1084,2538,30
85499797974,85499797968,-6,1310,2900,30
85499831931,85499831911,-20,1033,662,30
85500598355,85500598350,-5,1172,4412,30
85504174687,85504174683,-4,867,2323,30
85504594723,85504594721,-2,1084,2354,30
85508850095,85508850090,-5,1502,3161,30
85510021217,85510021214,-3,957,2179,30
85512105094,85512105090,-4,952,3036,30
85515139630,85515139626,-4,1037,1887,30
85524238017,85524238011,-6,901,2896,30
85525944509,85525944530,21,8,947,30
85526894909,85526894904,-5,1967,8242,30
85528358375,85528358372,-3,1087,3161,30
85528408744,85528408755,11,6,578,30
85531838335,85531838331,-4,871,2639,30
85533606323,85533606318,-5,1049,2646,30
85535696983,85535696979,-4,1261,4112,30
85537762819,85537762836,17,694,2069,30
85544571414,85544571407,-7,1258,3676,30
85549340860,85549340856,-4,1187,2072,30
85554996256,85554996251,-5,1212,2083,30
85555629076,85555629072,-4,1310,3297,30
85565807094,85565807089,-5,1134,2743,30
85568104111,85568104107,-4,906,3236,30
85572334926,85572334921,-5,1133,3910,30
85572859823,85572859818,-5,1478,2769,30
85573295921,85573295917,-4,946,2442,30
85574302030,85574302028,-2,1339,2482,30
85582338434,85582338430,-4,883,3410,30
85585649854,85585649851,-3,871,2834,30
85587892531,85587892525,-6,1495,3625,30
85590000861,85590000854,-7,1265,4052,30
85591225405,85591225400,-5,887,3368,30
85592196458,85592196453,-5,944,2493,30
85599588653,85599588650,-3,896,1669,30
85601427211,85601427207,-4,1163,3497,30
85603463222,85603463222,0,2603,2462,30
85603852069,85603852064,-5,998,2593,30
85614702445,85614702441,-4,927,2780,30
85615827227,85615827222,-5,1284,3987,30
85617580269,85617580263,-6,934,3710,30
85619625969,85619625973,4,1616,945,30
85620606626,85620606630,4,1831,1558,30
85620796846,85620796841,-5,626,2796,30
85621449526,85621449521,-5,1076,2045,30
85626441080,85626441077,-3,1066,3177,30
85629294927,85629294921,-6,1542,2427,30
85634573154,85634573150,-4,951,2947,30
85636498083,85636498078,-5,1084,3979,30
85644110106,85644110102,-4,939,1914,30
85654416438,85654416436,-2,983,2399,30
85655767958,85655767953,-5,1076,2563,30
85661000230,85661000228,-2,1307,2681,30
85661558952,85661558946,-6,552,3328,30
85661655842,85661655831,-11,19,1716,30
85665454019,85665454014,-5,873,2150,30
85669885426,85669885422,-4,1150,2755,30
85672087170,85672087165,-5,931,3168,30
85675350408,85675350406,-2,1657,3217,30
85676545850,85676545846,-4,1243,2172,30
85682710723,85682710717,-6,631,1661,30
85687557943,85687557939,-4,879,2555,30
85694434250,85694434246,-4,890,3445,30
85696933081,85696933074,-7,1348,3195,30
85703342794,85703342789,-5,1392,3207,30
85706915574,85706915580,6,7594,29288,30
85708110255,85708110251,-4,1354,3402,30
85711014638,85711014635,-3,1583,3323,30
85713742624,85713742621,-3,1240,3127,30
85718904386,85718904381,-5,959,2743,30
85720190924,85720190917,-7,965,2210,30
85720684831,85720684827,-4,1143,3134,30
85726624026,85726624033,7,3029,1984,30
85730351302,85730351298,-4,873,2716,30
85730966930,85730966927,-3,849,1639,30
85731732406,85731732401,-5,1032,2852,30
85732056925,85732056921,-4,1516,3989,30
85732455162,85732455158,-4,1444,2862,30
85745057134,85745057130,-4,749,2237,30
85748085842,85748085839,-3,1165,2720,30
85752024986,85752024982,-4,1276,3630,30
85756761139,85756761134,-5,1182,2594,30
85762497734,85762497729,-5,1450,4045,30
85763484934,85763484929,-5,1386,3397,30
85765356631,85765356626,-5,1417,2729,30
85766570387,85766570384,-3,1052,2889,30
85769524522,85769524525,3,1748,1557,30
85770438111,85770438107,-4,956,3177,30
85773006257,85773006253,-4,1017,2989,30
85773174856,85773174846,-10,870,2026,30
85777452942,85777452946,4,2610,2119,30
85783594258,85783594254,-4,1045,2449,30
85792598594,85792598591,-3,1119,1867,30
85796673443,85796673438,-5,1054,3048,30
85796714173,85796714168,-5,1133,3044,30
85799049898,85799049895,-3,740,1717,30
85799079827,85799079846,19,1347,3835,30
85799387151,85799387148,-3,1084,2481,30
85802133154,85802133151,-3,1253,2443,30
85802545446,85802545449,3,19436,26328,30
85806453583,85806453578,-5,956,3314,30
85807093249,85807093271,22,743,2799,30
85812152902,85812152901,-1,1991,2458,30
85817560010,85817560011,1,1115,22568,30
85817594259,85817594252,-7,1171,2908,30
85820190262,85820190257,-5,1075,2745,30
85822290894,85822290889,-5,1059,3279,30
85827062716,85827062712,-4,1205,2798,30
85827799495,85827799492,-3,730,2380,30
85827847715,85827847710,-5,899,2624,30
85828129566,85828129562,-4,1152,2538,30
85831297634,85831297629,-5,891,3174,30
85831984970,85831984973,3,138,942,30
85835752949,85835752944,-5,585,2734,30
85843917654,85843917658,4,1887,1041,30
85844577826,85844577822,-4,757,2773,30
85852600172,85852600169,-3,18160,19720,30
85852932399,85852932393,-6,1207,2811,30
85853283011,85853282998,-13,228,1242,30
85860519633,85860519630,-3,1061,3950,30
85860763835,85860763847,12,327,924,30
85874368815,85874368809,-6,1221,1978,30
85878204743,85878204738,-5,1248,2836,30
85885620819,85885620813,-6,936,2874,30
85891236074,85891236068,-6,974,2220,30
85891342803,85891342823,20,428,2021,30
85894248814,85894248810,-4,1324,3376,30
85896651631,85896651626,-5,1031,3261,30
85898586724,85898586727,3,3444,2032,30
85905625647,85905625640,-7,2858,8727,30
85907513237,85907513233,-4,911,1630,30
85909822859,85909822853,-6,753,2015,30
85912363339,85912363337,-2,1573,2311,30
85914878870,85914878865,-5,998,1993,30
85915708233,85915708227,-6,974,2476,30
85919327664,85919327659,-5,983,3554,30
85919902440,85919902431,-9,932,1663,30
85921520726,85921520733,7,2159,1147,30
85925941145,85925941147,2,980,940,30
85927712555,85927712549,-6,1120,2711,30
85937797429,85937797426,-3,1000,2630,30
85940918437,85940918432,-5,900,2237,30
85941342557,85941342554,-3,637,2622,30
85941604220,85941604216,-4,1251,3830,30
85942062500,85942062503,3,34,740,30
85942541765,85942541762,-3,1200,2225,30
85943979682,85943979677,-5,910,3370,30
85946032193,85946032186,-7,673,2059,30
85949673543,85949673540,-3,1256,2621,30
85952010195,85952010191,-4,1335,3027,30
85962197823,85962197817,-6,1249,3090,30
85966091115,85966091110,-5,995,3559,30
85968314442,85968314438,-4,929,2915,30
85972699626,85972699623,-3,1083,4151,30
85977011563,85977011557,-6,684,2895,30
85986942287,85986942282,-5,1019,2083,30
85987610561,85987610582,21,51,471,30
85992268602,85992268602,0,194,896,30
85998146918,85998146914,-4,913,3828,30
86001812486,86001812482,-4,936,2119,30
86002014489,86002014506,17,1339,3143,30
86002055612,86002055607,-5,1459,3402,30
86002483266,86002483250,-16,103,885,30
86004681257,86004681253,-4,1123,2391,30
86004927719,86004927713,-6,1116,2842,30
86008150586,86008150582,-4,1179,2500,30
86008485142,86008485139,-3,1126,3113,30
86010751518,86010751515,-3,1054,2961,30
86011841376,86011841378,2,2536,2549,30
86011934163,86011934160,-3,1139,2680,30
86014185078,86014185075,-3,1718,3264,30
86014520787,86014520786,-1,1166,2124,30
86014828613,86014828626,13,133,651,30
86017448617,86017448610,-7,1800,8847,30
86020364350,86020364345,-5,727,1700,30
86020708459,86020708457,-2,1707,2597,30
86023391778,86023391773,-5,839,2397,30
86027704575,86027704573,-2,1117,2713,30
86027909171,86027909190,19,646,1309,30
86028227075,86028227071,-4,1166,3192,30
86029616814,86029616810,-4,1008,1399,30
86031037446,86031037442,-4,922,2988,30
86032413507,86032413502,-5,1601,2991,30
86032519272,86032519289,17,747,1413,30
86039531853,86039531858,5,2171,1236,30
86046143326,86046143320,-6,1195,4077,30
86048347654,86048347649,-5,990,3829,30
86054540390,86054540393,3,3451,2242,30
86055702313,86055702309,-4,1704,3193,30
86058163291,86058163286,-5,1232,2227,30
86059879365,86059879362,-3,877,1460,30
86060732562,86060732558,-4,965,3650,30
86067155833,86067155834,1,2952,3441,30
86068135946,86068135964,18,409,1674,30
86074638128,86074638124,-4,1014,2331,30
86083753490,86083753486,-4,1361,3637,30
86087870514,86087870513,-1,848,2309,30
86088811235,86088811231,-4,912,2611,30
86106632269,86106632264,-5,962,2321,30
86109224728,86109224722,-6,1536,3193,30
86111723105,86111723099,-6,1073,4052,30
86111920073,86111920089,16,298,938,30
86113806614,86113806611,-3,644,1885,30
86116821382,86116821378,-4,1129,3486,30
86118150751,86118150746,-5,845,3466,30
86118979045,86118979041,-4,828,2610,30
86119090679,86119090674,-5,828,3214,30
86119604681,86119604699,18,1829,9037,30
86119910498,86119910494,-4,976,2684,30
86126054502,86126054509,7,3438,1576,30
86133374982,86133374977,-5,1156,3004,30
86144650898,86144650901,3,1504,2252,30
86149365936,86149365932,-4,759,1877,30
86149875290,86149875285,-5,280,1257,30
86150990656,86150990650,-6,1004,3349,30
86159286041,86159286037,-4,1538,2815,30
86163877630,86163877634,4,2121,1340,30
86167415925,86167415919,-6,1497,4443,30
86175824078,86175824075,-3,1223,3529,30
86180726262,86180726257,-5,1256,2813,30
86183761330,86183761325,-5,1022,3691,30
86184008126,86184008122,-4,1125,2734,30
86184801821,86184801816,-5,1152,1769,30
86194188450,86194188459,9,2022,1109,30
86196428704,86196428700,-4,1207,2185,30
86199582185,86199582180,-5,1107,2396,30
86202779468,86202779471,3,2293,2071,30
86205384983,86205384981,-2,998,3211,30
86207326341,86207326336,-5,664,1557,30
86209999675,86209999671,-4,1162,3826,30
86214465523,86214465517,-6,1161,2764,30
86215468886,86215468881,-5,1437,3829,30
86216599515,86216599513,-2,970,2872,30
86220549582,86220549577,-5,909,2136,30
86222095348,86222095365,17,655,2809,30
86223602546,86223602542,-4,806,2042,30
86224710326,86224710322,-4,831,2961,30
86226798850,86226798845,-5,915,2617,30
86227039406,86227039402,-4,1197,2978,30
86227224753,86227224749,-4,767,1710,30
86231289853,86231289849,-4,807,2640,30
86234577072,86234577068,-4,1222,2722,30
86235103575,86235103573,-2,1019,2052,30
86238173989,86238173985,-4,1143,3768,30
86242264810,86242264806,-4,1425,3249,30
86246110386,86246110381,-5,800,3808,30
86256257468,86256257463,-5,759,2189,30
86266454234,86266454226,-8,2309,9148,30
86279790586,86279790586,0,630,1520,30
86281215346,86281215338,-8,183,1142,30
86282661584,86282661591,7,3169,1270,30
86288105951,86288105958,7,4038,1450,30
86291319471,86291319471,0,537,1144,30
86312035365,86312035362,-3,928,2491,30
86312156296,86312156289,-7,1252,2390,30
86314294021,86314294017,-4,793,3253,30
86315134934,86315134930,-4,926,3089,30
86316031940,86316031934,-6,1250,2979,30
86321450330,86321450326,-4,1372,2836,30
86323023771,86323023767,-4,638,1884,30
86325079935,86325079930,-5,1133,3864,30
86328086174,86328086167,-7,30177,10044,30
86328522184,86328522179,-5,1182,1876,30
86351746569,86351746562,-7,827,2839,30
86359820270,86359820265,-5,1106,4164,30
86360366626,86360366613,-13,686,2808,30
86365032158,86365032154,-4,67,829,30
86366475440,86366475462,22,456,1333,30
86366893273,86366893269,-4,1394,2933,30
86374899760,86374899757,-3,1376,2642,30
86376458993,86376458994,1,2376,2156,30
86377729786,86377729786,0,1497,1632,30
86378454647,86378454651,4,20981,24676,30
86382146990,86382146988,-2,726,1935,30
86386061974,86386061970,-4,1149,3486,30
86405343571,86405343569,-2,706,2502,30
86407140649,86407140656,7,17526,22475,30
86407920709,86407920705,-4,478,1863,30
86413137942,86413137937,-5,937,3012,30
86413423273,86413423291,18,780,3346,30
86422213306,86422213301,-5,1062,2752,30
86427513234,86427513230,-4,1508,3354,30
86434329659,86434329656,-3,1210,2443,30
86437124458,86437124453,-5,1011,3293,30
86439899222,86439899221,-1,1119,1497,30
86443791070,86443791066,-4,974,3333,30
86444063394,86444063373,-21,834,2520,30
86447687089,86447687086,-3,890,1817,30
86451511326,86451511322,-4,519,1660,30
86452455251,86452455248,-3,938,1695,30
86453179332,86453179328,-4,1050,3066,30
86457374163,86457374159,-4,905,1461,30
86457411209,86457411203,-6,783,2854,30
86459153481,86459153477,-4,969,2714,30
86462337231,86462337240,9,12534,42942,30
86465719142,86465719137,-5,661,3478,30
86466525627,86466525621,-6,403,1126,30
86480691364,86480691358,-6,1285,4039,30
86480840449,86480840445,-4,1269,2349,30
86485942830,86485942831,1,13861,17298,30
86487400819,86487400814,-5,1137,2853,30
86492990874,86492990870,-4,930,2477,30
86494283784,86494283780,-4,1273,3462,30
86495257553,86495257552,-1,1118,1982,30
86497904015,86497904009,-6,1101,3091,30
86498241965,86498241970,5,2817,1162,30
86503803401,86503803401,0,1258,1903,30
86504368370,86504368366,-4,1363,3434,30
86510183113,86510183108,-5,1084,2295,30
86510485707,86510485701,-6,995,3028,30
86515130311,86515130307,-4,1389,3284,30
86515498390,86515498386,-4,1100,2878,30
86516975518,86516975521,3,1788,1649,30
86521621162,86521621170,8,23203,49957,30
86522526337,86522526331,-6,1019,1876,30
86528655290,86528655297,7,6003,2210,30
86530562089,86530562085,-4,650,3675,30
86530744753,86530744741,-12,320,1224,30
86530905991,86530905985,-6,1056,4139,30
86537550876,86537550872,-4,1048,2848,30
86538610346,86538610342,-4,1026,3093,30
86539436873,86539436868,-5,870,2255,30
86545897786,86545897783,-3,1021,3129,30
86549446352,86549446349,-3,1254,3146,30
86552070649,86552070644,-5,1391,3374,30
86553998074,86553998071,-3,1101,3392,30
86555531542,86555531538,-4,1454,3276,30
86556404358,86556404345,-13,807,2502,30
86558439247,86558439251,4,2916,1473,30
86559513087,86559513086,-1,1506,1696,30
86560604086,86560604081,-5,1076,3908,30
86565662751,86565662746,-5,657,2117,30
86571578235,86571578230,-5,406,1485,30
86580015692,86580015691,-1,25953,50256,30
86583067321,86583067318,-3,1044,1769,30
86588173708,86588173704,-4,1444,2108,30
86592190075,86592190071,-4,1209,3185,30
86595220995,86595220990,-5,1031,2754,30
86599173526,86599173522,-4,1057,2334,30
86601015891,86601015886,-5,1322,3262,30
86602827491,86602827487,-4,936,2901,30
86603339772,86603339789,17,754,1784,30
86605690791,86605690787,-4,870,2879,30
86605847977,86605847971,-6,1685,3286,30
86619156606,86619156601,-5,1140,2831,30
86624252039,86624252038,-1,1022,1855,30
86624939377,86624939374,-3,1096,2573,30
86625824595,86625824593,-2,949,2675,30
86636159824,86636159820,-4,813,2891,30
86636633223,86636633225,2,839,561,30
86640842843,86640842839,-4,845,2625,30
86640903491,86640903505,14,229,929,30
86643401806,86643401802,-4,1006,2328,30
86650858621,86650858615,-6,694,3367,30
86650913314,86650913307,-7,163,1186,30
86655062443,86655062439,-4,1218,2901,30
86655235070,86655235071,1,1720,2326,30
86662639723,86662639719,-4,837,2526,30
86669740489,86669740482,-7,1200,2201,30
86676991169,86676991166,-3,1319,3605,30
86679567261,86679567257,-4,1361,3381,30
86679754731,86679754729,-2,2873,4785,30
86683502399,86683502394,-5,1052,2755,30
86697991961,86697991962,1,954,1313,30
86701018865,86701018861,-4,998,1922,30
86701242474,86701242489,15,353,979,30
86704009991,86704009988,-3,877,2506,30
86707959159,86707959156,-3,1260,3347,30
86708552314,86708552323,9,97,835,30
86709120808,86709120804,-4,1090,2476,30
86709336029,86709336027,-2,23246,12587,30
86713804590,86713804585,-5,980,2718,30
86714527394,86714527373,-21,1018,3689,30
86715546412,86715546418,6,4613,1846,30
86716173575,86716173570,-5,1058,2982,30
86717282536,86717282558,22,595,2635,30
86720477411,86720477426,15,873,2676,30
86721242808,86721242798,-10,447,1136,30
86722961701,86722961694,-7,1243,2717,30
86729311931,86729311926,-5,1232,3652,30
86731297132,86731297126,-6,1006,3261,30
86732208853,86732208849,-4,470,1937,30
86733770677,86733770674,-3,1190,2401,30
86739862887,86739862881,-6,1220,4012,30
86739954056,86739954059,3,212,1319,30
86744964475,86744964486,11,199,961,30
86745887568,86745887587,19,328,1101,30
86746012217,86746012211,-6,414,795,30
86746178322,86746178321,-1,237,859,30
86751048362,86751048360,-2,1085,2861,30
86758847899,86758847896,-3,821,2019,30
86759953867,86759953859,-8,1325,3772,30
86760087760,86760087780,20,869,2602,30
86767204215,86767204209,-6,2062,10586,30
86767568257,86767568251,-6,1209,2441,30
86768423126,86768423131,5,2502,1049,30
86775922263,86775922259,-4,945,3031,30
86776505559,86776505556,-3,1378,3961,30
86777114946,86777114943,-3,1069,3635,30
86779673404,86779673401,-3,821,2508,30
86783305442,86783305438,-4,893,3379,30
86797739654,86797739658,4,1347,1247,30
86798446219,86798446214,-5,1027,2378,30
86800480983,86800480985,2,1403,1120,30
86801318614,86801318611,-3,1517,314,30
86801840995,86801840974,-21,216,810,30
86803278966,86803278961,-5,1180,3633,30
86805069655,86805069648,-7,1309,3251,30
86806032167,86806032163,-4,789,2600,30
86807318874,86807318890,16,667,2478,30
86814851355,86814851354,-1,1102,2456,30
86826246530,86826246526,-4,1033,2149,30
86827518955,86827518950,-5,1524,3785,30
86831140641,86831140635,-6,694,3016,30
86841530351,86841530348,-3,678,1923,30
86842880275,86842880272,-3,1331,2901,30
86845973059,86845973054,-5,946,3049,30
86847932373,86847932367,-6,885,3146,30
86850703957,86850703957,0,19894,19313,30
86852570648,86852570643,-5,1058,3406,30
86854916071,86854916068,-3,700,2533,30
86855052234,86855052239,5,2513,1712,30
86855354125,86855354121,-4,1224,2971,30
86859655233,86859655228,-5,1078,3171,30
86859842052,86859842049,-3,1153,2632,30
86864982466,86864982462,-4,1433,2148,30
86866519164,86866519161,-3,1197,2443,30
86867076882,86867076878,-4,1320,3012,30
86872906862,86872906877,15,550,1616,30
86875196815,86875196811,-4,662,2141,30
86876059209,86876059202,-7,1813,6485,30
86881023383,86881023380,-3,825,2775,30
86882961937,86882961934,-3,1199,3057,30
86885644126,86885644121,-5,792,2133,30
86886767055,86886767050,-5,1354,4363,30
86887130867,86887130860,-7,900,6670,30
86895427278,86895427272,-6,808,2884,30
86899622358,86899622355,-3,789,1885,30
86900476543,86900476538,-5,937,3033,30
86901444827,86901444823,-4,1273,3650,30
86903262385,86903262386,1,34857,45570,30
86909487249,86909487246,-3,1432,3135,30
86911108842,86911108850,8,283,1069,30
86911879703,86911879702,-1,2048,977,30
86915221601,86915221602,1,2105,2476,30
86918166480,86918166475,-5,1047,3281,30
86919456545,86919456542,-3,1421,2251,30
86919613290,86919613295,5,175,921,30
86925673131,86925673126,-5,1155,2688,30
86926052592,86926052587,-5,605,1222,30
86926539528,86926539546,18,523,3102,30
86934390689,86934390694,5,4073,2552,30
86936969851,86936969858,7,5701,2667,30
86942010503,86942010499,-4,1104,2459,30
86944732101,86944732098,-3,1081,3106,30
86946256273,86946256269,-4,987,3101,30
86951542514,86951542509,-5,970,2323,30
86953424031,86953424026,-5,905,3118,30
86955746881,86955746883,2,1249,1248,30
86957066235,86957066231,-4,1206,2578,30
86960936021,86960936016,-5,975,1998,30
86962239557,86962239553,-4,1320,3408,30
86962267803,86962267822,19,848,3241,30
86967231723,86967231719,-4,1485,4774,30
86969880908,86969880907,-1,1119,1861,30
86970432331,86970432325,-6,967,1759,30
86971710443,86971710439,-4,1158,3037,30
86974087933,86974087928,-5,1170,2640,30
86976563277,86976563277,0,1653,2344,30
86980283970,86980283966,-4,982,2692,30
86980636152,86980636148,-4,942,2906,30
86986296557,86986296554,-3,1233,3555,30
86992245542,86992245549,7,5644,1719,30
86992374631,86992374626,-5,1136,2604,30
86993767214,86993767211,-3,754,1878,30
86993899136,86993899127,-9,691,3568,30
86994508706,86994508701,-5,681,1549,30
86995509617,86995509613,-4,969,3172,30
86996519766,86996519762,-4,1152,2166,30
87003827578,87003827573,-5,1084,3339,30
87011348163,87011348161,-2,763,1876,30
87014847641,87014847635,-6,1137,3161,30
87019386482,87019386476,-6,987,2669,30
87024330767,87024330766,-1,1199,1776,30
87028696278,87028696275,-3,833,1649,30
87029770296,87029770317,21,604,1288,30
87032150701,87032150698,-3,1003,2484,30
87034742489,87034742485,-4,949,3772,30
87036084360,87036084358,-2,963,1671,30
87037142502,87037142498,-4,922,2298,30
87037469941,87037469933,-8,846,2306,30
87038580353,87038580351,-2,1372,2349,30
87045347573,87045347569,-4,1299,3112,30
87050533325,87050533321,-4,927,3163,30
87051902990,87051902986,-4,928,3225,30
87054471710,87054471704,-6,1074,3206,30
87056525727,87056525722,-5,1259,2987,30
87058764412,87058764409,-3,737,1823,30
87059450345,87059450341,-4,1279,2795,30
87060666181,87060666179,-2,2185,2865,30
87061508698,87061508694,-4,364,2018,30
87066746477,87066746471,-6,821,2585,30
87067302241,87067302236,-5,1172,4064,30
87067785878,87067785881,3,1701,1528,30
87070294195,87070294190,-5,513,919,30
87076021846,87076021838,-8,1216,3156,30
87087485148,87087485144,-4,1218,2341,30
87090232903,87090232898,-5,1310,3964,30
87092230107,87092230102,-5,947,3312,30
87096608019,87096608016,-3,1282,4293,30
87098514112,87098514107,-5,1175,2674,30
87101494256,87101494253,-3,1018,2344,30
87103279291,87103279287,-4,1121,2484,30
87103736358,87103736354,-4,690,1613,30
87105532375,87105532370,-5,1678,4256,30
87107198291,87107198286,-5,1275,2958,30
87116380598,87116380595,-3,967,2882,30
87118086522,87118086513,-9,1388,2749,30
87118327519,87118327514,-5,1089,3818,30
87121852942,87121852935,-7,952,2645,30
87122167936,87122167946,10,254,920,30
87126253927,87126253922,-5,925,2248,30
87126953880,87126953901,21,1021,2454,30
87128120573,87128120569,-4,1277,4082,30
87130419985,87130419981,-4,1066,3218,30
87136046311,87136046305,-6,846,3957,30
87138641821,87138641827,6,4001,2420,30
87141484526,87141484523,-3,945,1994,30
87143472131,87143472125,-6,897,3500,30
87144847061,87144847061,0,1171,2287,30
87148661857,87148661854,-3,738,2509,30
87149391385,87149391405,20,577,3181,30
87149896959,87149896956,-3,906,2987,30
87152372475,87152372482,7,2760,946,30
87160653378,87160653377,-1,1583,2656,30
87162217268,87162217261,-7,1253,3291,30
87164420071,87164420066,-5,809,2507,30
87167296322,87167296317,-5,758,1546,30
87171459987,87171459979,-8,935,2004,30
87174821294,87174821290,-4,1180,2664,30
87175271495,87175271491,-4,1046,3933,30
87184394839,87184394837,-2,494,1641,30
87185131390,87185131394,4,26928,35904,30
87192838147,87192838142,-5,847,3180,30
87199961626,87199961621,-5,1299,2823,30
87201918351,87201918346,-5,746,2019,30
87202704869,87202704862,-7,981,2769,30
87207204149,87207204147,-2,1002,3327,30
87207632051,87207632049,-2,910,2748,30
87209101027,87209101022,-5,678,3563,30
87210575099,87210575093,-6,728,1877,30
87211283328,87211283326,-2,851,2008,30
87215507049,87215507044,-5,1143,3247,30
87224795851,87224795848,-3,979,2496,30
87225395312,87225395307,-5,1138,3592,30
87225510290,87225510285,-5,1422,3430,30
87228417998,87228417991,-7,1405,6395,30
87229007092,87229007086,-6,1341,3411,30
87240332234,87240332234,0,1927,3040,30
87246532162,87246532159,-3,1533,3067,30
87252485125,87252485129,4,7259,6056,30
87259346476,87259346473,-3,741,2319,30
87260880775,87260880769,-6,1325,3649,30
87262667988,87262667984,-4,1324,3597,30
87263089019,87263089036,17,889,1434,30
87266518371,87266518366,-5,940,2089,30
87267149163,87267149154,-9,778,3046,30
87268087222,87268087217,-5,952,4214,30
87270543241,87270543236,-5,1110,4128,30
87270691798,87270691793,-5,789,4378,30
87272021471,87272021470,-1,1341,3811,30
87272498859,87272498836,-23,1384,2005,30
87273911727,87273911718,-9,911,2600,30
87273939359,87273939354,-5,1119,4015,30
87274439511,87274439506,-5,841,2263,30
87275758700,87275758697,-3,1341,2900,30
87279635247,87279635242,-5,944,2467,30
87280256817,87280256839,22,824,2394,30
87280954940,87280954934,-6,667,1326,30
87282399184,87282399179,-5,1012,1977,30
87286745732,87286745737,5,1253,1324,30
87286906322,87286906317,-5,858,2634,30
87294184567,87294184560,-7,797,3822,30
87294459929,87294459925,-4,1352,3577,30
87296418890,87296418886,-4,656,2005,30
87304564418,87304564415,-3,861,1861,30
87312743157,87312743154,-3,778,1438,30
87318475693,87318475688,-5,985,3625,30
87324348219,87324348238,19,2709,1269,30
87332361462,87332361468,6,13548,27071,30
87333334511,87333334506,-5,858,3580,30
87334478181,87334478177,-4,844,1593,30
87335520520,87335520537,17,972,1873,30
87347568382,87347568377,-5,1460,4407,30
87351077463,87351077458,-5,1460,3986,30
87351695677,87351695681,4,3816,2513,30
87355625781,87355625786,5,2658,1263,30
87360946237,87360946233,-4,1100,1579,30
87361580217,87361580213,-4,812,2774,30
87361729329,87361729334,5,951,548,30
87362227959,87362227957,-2,704,2662,30
87363211997,87363211993,-4,1185,2782,30
87363679182,87363679175,-7,1044,3386,30
87364133376,87364133399,23,913,2557,30
87364866743,87364866737,-6,854,3144,30
87367800903,87367800898,-5,1085,4253,30
87379015022,87379015018,-4,1095,3039,30
87381208338,87381208333,-5,979,1931,30
87383730502,87383730497,-5,913,4055,30
87388046887,87388046881,-6,968,2652,30
87388314889,87388314878,-11,719,2612,30
87388910786,87388910770,-16,730,1986,30
87390119717,87390119719,2,1279,1841,30
87390898121,87390898116,-5,934,3463,30
87398198454,87398198450,-4,904,2530,30
87403588681,87403588674,-7,1028,2670,30
87405220023,87405220018,-5,1169,4162,30
87409002198,87409002193,-5,1238,2336,30
87412770078,87412770072,-6,853,2480,30
87419485350,87419485344,-6,970,3057,30
87421786967,87421786962,-5,746,2464,30
87435354166,87435354162,-4,2115,7160,30
87437742110,87437742106,-4,671,2207,30
87439886818,87439886812,-6,1341,3970,30
87440760598,87440760593,-5,959,3377,30
87441079625,87441079641,16,171,835,30
87447079885,87447079883,-2,1277,3062,30
87452622308,87452622305,-3,34814,11684,30
87454748404,87454748400,-4,828,2136,30
87454938310,87454938305,-5,843,2339,30
87455581964,87455581980,16,1107,3682,30
87457320421,87457320418,-3,1398,2743,30
87460169794,87460169792,-2,646,1060,30
87461474625,87461474621,-4,778,1864,30
87463123004,87463123001,-3,908,2523,30
87468832799,87468832794,-5,1025,3641,30
87469341359,87469341355,-4,814,1642,30
87471883466,87471883467,1,1374,1446,30
87472830545,87472830541,-4,1620,3998,30
87479024402,87479024401,-1,1915,2707,30
87479368772,87479368768,-4,1329,2635,30
87481527381,87481527376,-5,1203,4220,30
87481938792,87481938785,-7,849,2137,30
87482637980,87482637994,14,152,1277,30
87491983782,87491983776,-6,908,2619,30
87492549902,87492549897,-5,839,2760,30
87496280710,87496280706,-4,1226,2987,30
87498476926,87498476922,-4,1513,2693,30
87509180534,87509180531,-3,999,3297,30
87514230890,87514230886,-4,866,1849,30
87514662818,87514662810,-8,217,1065,30
87518369091,87518369087,-4,1012,2120,30
87519688109,87519688105,-4,717,2692,30
87519730465,87519730465,0,353,1070,30
87520143912,87520143933,21,587,2052,30
87526730557,87526730553,-4,883,2472,30
87528847485,87528847484,-1,1432,1436,30
87533672674,87533672670,-4,383,1112,30
87534739714,87534739709,-5,1004,3280,30
87535262649,87535262666,17,900,2338,30
87535344666,87535344660,-6,1107,2504,30
87540290610,87540290616,6,3872,1974,30
87549800446,87549800442,-4,668,3104,30
87550537808,87550537803,-5,851,2524,30
87551538089,87551538085,-4,818,3827,30
87551589233,87551589245,12,691,2173,30
87551944388,87551944382,-6,1213,3434,30
87552127774,87552127769,-5,1193,2634,30
87553233047,87553233042,-5,772,1979,30
87553335594,87553335614,20,135,1155,30
87554606122,87554606122,0,1578,3287,30
87558133601,87558133596,-5,858,2063,30
87559683242,87559683242,0,1381,1844,30
87571657273,87571657279,6,1574,767,30
87575711715,87575711710,-5,1133,4203,30
87576119076,87576119070,-6,1200,3153,30
87578661943,87578661940,-3,1232,4031,30
87580803650,87580803654,4,1864,1453,30
87585983263,87585983257,-6,1109,3685,30
87586676732,87586676726,-6,1038,2823,30
87587008641,87587008627,-14,4408,37971,30
87590417102,87590417095,-7,803,1527,30
87591814793,87591814790,-3,660,2555,30
87592091900,87592091903,3,2140,1540,30
87592774711,87592774705,-6,945,2704,30
87594409534,87594409529,-5,892,2582,30
87596549862,87596549862,0,1217,1456,30
87618582269,87618582265,-4,753,2045,30
87619890576,87619890592,16,374,1181,30
87620491570,87620491566,-4,1265,2383,30
87622696041,87622696035,-6,905,1877,30
87626449465,87626449486,21,758,2522,30
87627457895,87627457890,-5,1070,3522,30
87637595030,87637595029,-1,2320,3121,30
87639302937,87639302933,-4,1266,2444,30
87646400891,87646400886,-5,1184,4484,30
87648048206,87648048201,-5,1254,2637,30
87651435526,87651435526,0,1117,1990,30
87652709917,87652709914,-3,917,3213,30
87653990817,87653990833,16,843,1931,30
87664688946,87664688942,-4,560,2899,30
87666001244,87666001249,5,3021,1724,30
87669447397,87669447394,-3,1170,3204,30
87671003121,87671003115,-6,917,2338,30
87671177089,87671177083,-6,1067,3129,30
87672116376,87672116375,-1,221,921,30
87678787531,87678787527,-4,890,1665,30
87679430276,87679430289,13,263,871,30
87683254655,87683254651,-4,953,1861,30
87683811664,87683811686,22,669,1583,30
87684337519,87684337517,-2,1137,1575,30
87689954385,87689954379,-6,545,2769,30
87690008072,87690008089,17,475,2042,30
87691580186,87691580181,-5,1161,3371,30
87697636102,87697636122,20,475,1322,30
87703280823,87703280818,-5,436,2478,30
87706207006,87706207013,7,2721,1274,30
87707492026,87707492022,-4,721,2359,30
87713409091,87713409086,-5,927,3362,30
87714096791,87714096789,-2,1067,2999,30
87714275748,87714275748,0,2919,2521,30
87715207418,87715207413,-5,1017,2748,30
87726890598,87726890598,0,1163,1749,30
87728291418,87728291413,-5,854,3279,30
87730337273,87730337267,-6,752,3826,30
87734025582,87734025577,-5,1336,2793,30
87736388666,87736388660,-6,917,2072,30
87740972594,87740972590,-4,933,3117,30
87745625658,87745625650,-8,848,4291,30
87747182518,87747182513,-5,982,2199,30
87747337933,87747337930,-3,1317,2463,30
87751236518,87751236514,-4,1349,3400,30
87752262018,87752262012,-6,1147,2989,30
87752360205,87752360199,-6,970,4081,30
87753295590,87753295586,-4,1222,3520,30
87753706876,87753706874,-2,156,616,30
87753962114,87753962133,19,781,2331,30
87754369874,87754369870,-4,1441,3649,30
87760957132,87760957127,-5,1120,3387,30
87768841202,87768841206,4,2147,1305,30
87771525478,87771525472,-6,1011,2744,30
87775341075,87775341069,-6,1299,2312,30
87775709642,87775709659,17,175,747,30
87782888410,87782888406,-4,1190,2948,30
87783051154,87783051154,0,69,605,30
87793976599,87793976595,-4,862,2991,30
87795377770,87795377765,-5,837,2483,30
87795620337,87795620353,16,176,931,30
87802614474,87802614474,0,1793,1872,30
87809917956,87809917974,18,1153,2696,30
87812269673,87812269666,-7,876,2904,30
87813979727,87813979723,-4,928,3031,30
87814080803,87814080799,-4,845,4750,30
87818249230,87818249226,-4,1046,2575,30
87818673737,87818673744,7,2501,1833,30
87819914281,87819914277,-4,1154,2784,30
87827252661,87827252660,-1,1308,1980,30
87828329931,87828329926,-5,1265,3160,30
87833697736,87833697730,-6,999,2300,30
87837620734,87837620749,15,953,4719,30
87838835043,87838835049,6,940,2123,30
87846687348,87846687343,-5,740,1361,30
87848764355,87848764349,-6,763,2451,30
87851456937,87851456918,-19,911,3018,30
87853756920,87853756914,-6,1221,3873,30
87855545355,87855545355,0,944,1205,30
87857354462,87857354455,-7,1129,2285,30
87858217901,87858217896,-5,1278,3420,30
87859010566,87859010562,-4,1287,2212,30
87861502671,87861502668,-3,962,2587,30
87864163531,87864163527,-4,1067,2293,30
87866703829,87866703824,-5,699,2830,30
87866938787,87866938782,-5,1051,3906,30
87870257926,87870257922,-4,925,3668,30
87876816106,87876816103,-3,760,2065,30
87877654705,87877654701,-4,1193,2572,30
87882472180,87882472173,-7,1483,3823,30
87896990837,87896990833,-4,1061,3824,30
87903574358,87903574359,1,27589,29359,30
87904725719,87904725718,-1,790,1614,30
87905280724,87905280726,2,47229,43322,30
87908454810,87908454806,-4,1105,1288,30
87911133115,87911133109,-6,881,3231,30
87914159139,87914159137,-2,1269,3077,30
87922735844,87922735841,-3,715,2797,30
87923151259,87923151276,17,1009,2398,30
87926179310,87926179306,-4,596,2122,30
87926595131,87926595127,-4,978,2606,30
87946718523,87946718518,-5,1301,3036,30
87948240139,87948240132,-7,1161,2839,30
87949177273,87949177271,-2,1017,2091,30
87950295173,87950295166,-7,1033,3877,30
87953512567,87953512562,-5,839,2321,30
87954544796,87954544790,-6,1171,3308,30
87955224368,87955224363,-5,1185,2170,30
87955532634,87955532629,-5,435,2313,30
87955787778,87955787773,-5,128,3150,30
87959231530,87959231525,-5,1117,2652,30
87959675161,87959675166,5,4182,2951,30
87962320550,87962320547,-3,1269,2899,30
87969782370,87969782361,-9,643,2471,30
87970561749,87970561746,-3,1066,3425,30
87973952278,87973952273,-5,1051,2074,30
87976114950,87976114946,-4,1079,2917,30
87979970941,87979970938,-3,759,1782,30
87980356790,87980356794,4,2489,1206,30
87983130650,87983130645,-5,992,2303,30
87983683634,87983683629,-5,866,2681,30
87984517765,87984517767,2,2631,1314,30
87984722710,87984722705,-5,1005,2763,30
87987892875,87987892870,-5,617,1639,30
87989323528,87989323534,6,3255,1167,30
87991161788,87991161790,2,2780,2715,30
87994442350,87994442345,-5,647,2274,30
87996542662,87996542658,-4,628,2512,30
87997227404,87997227417,13,789,2472,30
87998662749,87998662742,-7,1476,9077,30
88002048333,88002048329,-4,1080,2773,30
88003842838,88003842834,-4,987,2879,30
88005635218,88005635211,-7,1024,2815,30
88013011186,88013011182,-4,922,2889,30
88013075916,88013075934,18,1101,2766,30
88013357957,88013357952,-5,1072,1463,30
88016823411,88016823408,-3,779,2268,30
88017042264,88017042244,-20,586,2232,30
88017396569,88017396566,-3,1045,2486,30
88026340843,88026340841,-2,1298,2626,30
88030233385,88030233379,-6,1447,3577,30
88032643089,88032643085,-4,1410,2612,30
88033162740,88033162732,-8,1663,4191,30
88037470850,88037470848,-2,1251,2803,30
88038688230,88038688250,20,561,2285,30
88044711246,88044711249,3,1937,1614,30
88052473393,88052473385,-8,828,4827,30
88053262813,88053262810,-3,1010,2925,30
88054215053,88054215049,-4,1337,2958,30
88058306363,88058306357,-6,1008,3226,30
88058477456,88058477474,18,580,2335,30
88062742069,88062742062,-7,1099,2361,30
88065857242,88065857239,-3,1127,2518,30
88070289639,88070289636,-3,1121,2220,30
88070403417,88070403420,3,5983,22903,30
88075602711,88075602706,-5,744,3951,30
88077846406,88077846402,-4,1337,3053,30
88079953080,88079953077,-3,2523,4658,30
88081999772,88081999769,-3,938,3159,30
88092686359,88092686353,-6,719,2208,30
88092901705,88092901720,15,693,2219,30
88100587722,88100587704,-18,1027,500,30
88103519813,88103519808,-5,1288,3085,30
88105351389,88105351385,-4,1481,4008,30
88109373481,88109373474,-7,878,3662,30
88113745867,88113745862,-5,997,2887,30
88114013927,88114013925,-2,844,2696,30
88114322563,88114322558,-5,720,2275,30
88114945801,88114945799,-2,1337,1828,30
88120209525,88120209521,-4,1132,2868,30
88127860747,88127860742,-5,1253,3966,30
88133243719,88133243717,-2,752,1616,30
88137412754,88137412752,-2,1301,2253,30
88137832192,88137832192,0,2720,4167,30
88139310347,88139310354,7,1963,777,30
88140348278,88140348273,-5,823,1591,30
88141446293,88141446289,-4,1140,2912,30
88143299923,88143299917,-6,807,2693,30
88148428705,88148428699,-6,1448,4669,30
88148478822,88148478816,-6,1026,2424,30
88149155062,88149155058,-4,1220,2717,30
88150540875,88150540870,-5,930,3378,30
88151926708,88151926722,14,414,1144,30
88152531616,88152531611,-5,1035,2958,30
88166641917,88166641920,3,2481,1497,30
88169090697,88169090693,-4,972,3074,30
88171360947,88171360953,6,2137,1575,30
88171713855,88171713850,-5,516,932,30
88175806569,88175806591,22,598,1900,30
88176843570,88176843565,-5,1143,2931,30
88179916789,88179916784,-5,1343,2963,30
88181010496,88181010492,-4,776,2936,30
88182864058,88182864053,-5,1167,2545,30
88183541996,88183542009,13,689,1913,30
88186291999,88186291997,-2,1138,1767,30
88186483012,88186483031,19,888,3357,30
88189056527,88189056522,-5,552,2109,30
88193189985,88193189980,-5,1253,3396,30
88193683758,88193683750,-8,35065,17056,30
88193727738,88193727730,-8,970,3458,30
88200209562,88200209561,-1,1093,1518,30
88210562072,88210562069,-3,1037,2829,30
88210971827,88210971820,-7,888,2975,30
88211068330,88211068351,21,577,1009,30
88211350132,88211350135,3,1806,1574,30
88213940405,88213940401,-4,957,2813,30
88214081233,88214081250,17,754,2419,30
88215608923,88215608924,1,1579,2229,30
88216024122,88216024120,-2,2182,4647,30
88220606382,88220606386,4,4567,4351,30
88226052406,88226052401,-5,1035,3389,30
88231940462,88231940457,-5,1213,3000,30
88233861499,88233861501,2,1031,1672,30
88234084675,88234084669,-6,988,3683,30
88234898214,88234898209,-5,1245,2802,30
88241631135,88241631129,-6,1669,4327,30
88243122974,88243122969,-5,1382,4654,30
88243374922,88243374918,-4,1287,3312,30
88243600835,88243600846,11,279,1071,30
88245552550,88245552546,-4,1504,3020,30
88248193618,88248193613,-5,888,2688,30
88250478570,88250478566,-4,731,1733,30
88252104487,88252104483,-4,1359,2974,30
88254254570,88254254569,-1,1086,1754,30
88256758849,88256758846,-3,733,2395,30
88261135729,88261135725,-4,770,2441,30
88261174633,88261174634,1,6,1415,30
88263105073,88263105070,-3,1293,3101,30
88265545043,88265545038,-5,1049,2430,30
88268677045,88268677044,-1,944,2252,30
88275070702,88275070698,-4,1267,3205,30
88275899775,88275899771,-4,1098,3055,30
88276599186,88276599179,-7,989,3469,30
88280217430,88280217426,-4,1116,2888,30
88288375923,88288375918,-5,840,3310,30
88290003849,88290003846,-3,774,1548,30
88290436513,88290436508,-5,1251,3513,30
88291612318,88291612314,-4,1097,2936,30
88293225480,88293225475,-5,1140,2962,30
88297407334,88297407339,5,1857,1395,30
88300639983,88300639979,-4,1098,3794,30
88301421365,88301421362,-3,732,1751,30
88306913918,88306913918,0,1281,2914,30
88309176754,88309176750,-4,1167,2152,30
88309415912,88309415929,17,497,1500,30
88316176273,88316176268,-5,1030,2929,30
88316630570,88316630557,-13,107,2003,30
88320519229,88320519225,-4,2235,8477,30
88325312252,88325312249,-3,962,4072,30
88325807094,88325807092,-2,1183,2773,30
88326205559,88326205554,-5,613,2695,30
88327374997,88327374993,-4,1094,2813,30
88329057737,88329057739,2,332,1051,30
88338080511,88338080505,-6,312,1343,30
88339823751,88339823745,-6,1101,2226,30
88346637691,88346637686,-5,1435,3131,30
88348572317,88348572314,-3,985,2982,30
88349330015,88349330010,-5,1246,2765,30
88350788847,88350788844,-3,476,1898,30
88352389376,88352389368,-8,1629,3985,30
88355866126,88355866123,-3,666,3458,30
88358987762,88358987759,-3,747,1583,30
88365224686,88365224682,-4,844,2604,30
88366767930,88366767926,-4,996,2359,30
88367938703,88367938697,-6,724,1705,30
88368947249,88368947245,-4,1251,2599,30
88369093289,88369093311,22,977,1302,30
88370314058,88370314054,-4,663,1425,30
88371952106,88371952095,-11,864,2172,30
88372071602,88372071621,19,854,2681,30
88372900750,88372900747,-3,756,2743,30
88373219694,88373219698,4,1340,1488,30
88378276250,88378276243,-7,977,2281,30
88380624122,88380624129,7,8495,2620,30
88381250450,88381250453,3,435,1019,30
88382236870,88382236875,5,1574,358,30
88384743482,88384743489,7,2745,1323,30
88384786385,88384786387,2,1757,1978,30
88388283584,88388283581,-3,1152,1588,30
88396034456,88396034451,-5,1214,2420,30
88397607289,88397607286,-3,1331,3134,30
88398080160,88398080183,23,278,1062,30
88401071364,88401071359,-5,1371,2761,30
88401608360,88401608382,22,659,3464,30
88406759033,88406759031,-2,168,1292,30
88407108356,88407108369,13,1113,4574,30
88408116206,88408116204,-2,1167,2192,30
88411354717,88411354712,-5,1024,3602,30
88412961251,88412961249,-2,736,1962,30
88415878065,88415878060,-5,912,2198,30
88418678827,88418678826,-1,1312,1510,30
88424323260,88424323257,-3,986,3446,30
88426356719,88426356714,-5,873,2596,30
88435218725,88435218730,5,5164,2590,30
88436182639,88436182633,-6,917,2369,30
88445896334,88445896329,-5,1174,3613,30
88447260897,88447260916,19,182,1641,30
88454596003,88454595998,-5,792,1500,30
88457271087,88457271084,-3,1646,2581,30
88462653491,88462653486,-5,1124,3715,30
88466197969,88466197965,-4,925,2013,30
88466845202,88466845197,-5,952,2498,30
88468918542,88468918550,8,4175,1219,30
88470884092,88470884088,-4,1095,3328,30
88472284749,88472284746,-3,801,2315,30
88473909257,88473909253,-4,1029,3796,30
88476039893,88476039890,-3,1110,3087,30
88479886008,88479886005,-3,1150,3153,30
88490432095,88490432089,-6,698,3077,30
88490613124,88490613136,12,952,3192,30
88496110514,88496110506,-8,986,3883,30
88497340510,88497340524,14,510,1394,30
88497387955,88497387949,-6,1318,3511,30
88497946883,88497946883,0,1314,1709,30
88505072793,88505072788,-5,1223,3179,30
88508861055,88508861050,-5,1269,3487,30
88508908307,88508908296,-11,1399,5307,30
88509999822,88509999817,-5,814,2176,30
88510845030,88510845025,-5,1054,2397,30
88514716135,88514716130,-5,867,3479,30
88515096850,88515096845,-5,799,2426,30
88515491303,88515491301,-2,1136,1187,30
88519098424,88519098418,-6,820,2355,30
88520282561,88520282568,7,17736,55692,30
88524546652,88524546653,1,1319,1563,30
88527355742,88527355741,-1,1140,2091,30
88529464118,88529464121,3,1747,1370,30
88531283586,88531283578,-8,1258,3478,30
88533571180,88533571178,-2,912,1928,30
88535792275,88535792269,-6,649,1633,30
88536397490,88536397486,-4,705,2444,30
88540038753,88540038749,-4,1022,3745,30
88541542236,88541542247,11,237,1094,30
88543512846,88543512842,-4,951,1012,30
88544257467,88544257461,-6,1612,4097,30
88544854710,88544854706,-4,570,2032,30
88545261144,88545261167,23,1067,2856,30
88547893613,88547893610,-3,1665,3172,30
88548563233,88548563228,-5,855,3322,30
88555122053,88555122049,-4,814,2982,30
88564380030,88564380028,-2,799,2014,30
88566966701,88566966693,-8,1248,3092,30
88570026921,88570026914,-7,1461,4078,30
88573555205,88573555200,-5,1349,3027,30
88573677913,88573677928,15,673,2190,30
88574909087,88574909088,1,23162,36006,30
88580944837,88580944834,-3,1442,2034,30
88581736333,88581736329,-4,1473,4450,30
88590295706,88590295702,-4,919,2656,30
88593237119,88593237114,-5,1021,2203,30
88603734614,88603734609,-5,1035,3015,30
88614345409,88614345405,-4,1023,2976,30
88617005346,88617005340,-6,1240,3909,30
88617330137,88617330150,13,602,1553,30
88617491257,88617491250,-7,1041,2317,30
88617542883,88617542874,-9,187,1568,30
88622746069,88622746066,-3,1009,2317,30
88624323119,88624323118,-1,1351,1618,30
88625778596,88625778593,-3,1738,2881,30
88626779161,88626779162,1,2066,1975,30
88631897314,88631897313,-1,828,3094,30
88635511971,88635511966,-5,770,3076,30
88638890844,88638890842,-2,1161,2192,30
88640620651,88640620646,-5,927,2197,30
88641432724,88641432721,-3,1208,2966,30
88644766220,88644766213,-7,728,5383,30
88645406562,88645406554,-8,1087,3306,30
88646925445,88646925445,0,1556,1936,30
88648529689,88648529686,-3,695,2957,30
88653109796,88653109789,-7,696,2677,30
88659421853,88659421848,-5,1202,2535,30
88664330638,88664330633,-5,710,2577,30
88665950765,88665950761,-4,969,2278,30
88674219568,88674219564,-4,1205,3534,30
88674828863,88674828859,-4,1438,3334,30
88683320431,88683320429,-2,776,2245,30
88685109540,88685109537,-3,981,2600,30
88685905162,88685905154,-8,671,2931,30
88690404956,88690404974,18,653,2429,30
88691512161,88691512157,-4,1095,2041,30
88692067929,88692067938,9,39,1019,30
88692331471,88692331471,0,21166,86580,30
88692690444,88692690441,-3,899,2016,30
88701340614,88701340606,-8,1315,5476,30
88704439277,88704439282,5,2554,1512,30
88705135354,88705135345,-9,38,870,30
88707853313,88707853306,-7,1007,3786,30
88708487803,88708487799,-4,876,1829,30
88709877389,88709877383,-6,1036,4094,30
88714043555,88714043550,-5,1032,1969,30
88717581138,88717581138,0,1257,2154,30
88730385713,88730385709,-4,1174,2867,30
88731935302,88731935308,6,2694,1082,30
88733173525,88733173528,3,4082,2984,30
88736167146,88736167141,-5,611,1714,30
88737724866,88737724881,15,653,1660,30
88739684529,88739684522,-7,649,1414,30
88743040269,88743040264,-5,916,3794,30
88748599562,88748599557,-5,940,3543,30
88749675086,88749675085,-1,824,2099,30
88750791818,88750791814,-4,856,2558,30
88756162988,88756162986,-2,1328,1441,30
88762124748,88762124750,2,3464,3499,30
88763926536,88763926541,5,3352,1492,30
88765067626,88765067620,-6,1092,2627,30
88767612554,88767612548,-6,947,2894,30
88768272050,88768272066,16,1467,3147,30
88781244631,88781244628,-3,1545,3646,30
88784740921,88784740904,-17,258,1092,30
88784879043,88784879030,-13,183,1245,30
88786096698,88786096694,-4,819,2522,30
88802047595,88802047590,-5,936,3417,30
88802591391,88802591385,-6,813,3537,30
88807070690,88807070688,-2,935,2243,30
88808058583,88808058581,-2,621,2284,30
88815633644,88815633651,7,5386,2246,30
88815784643,88815784640,-3,1105,2937,30
88816275946,88816275942,-4,1322,3460,30
88820579520,88820579513,-7,1020,3234,30
88820667195,88820667211,16,416,1541,30
88826994287,88826994286,-1,1746,1496,30
88828105727,88828105721,-6,796,2964,30
88828940711,88828940709,-2,1202,2540,30
88830882520,88830882523,3,6456,5615,30
88833104042,88833104037,-5,1011,2636,30
88834213795,88834213790,-5,1050,1908,30
88838119369,88838119366,-3,1365,3204,30
88838228833,88838228847,14,171,788,30
88841288557,88841288558,1,1954,1985,30
88844287320,88844287321,1,1601,1984,30
88844827953,88844827947,-6,1175,2799,30
88846426362,88846426364,2,1062,1172,30
88855082020,88855082014,-6,1291,2664,30
88857955317,88857955314,-3,1049,3086,30
88862968330,88862968327,-3,872,3187,30
88871601503,88871601503,0,1416,2096,30
88872952143,88872952138,-5,1253,1968,30
88875066273,88875066287,14,236,566,30
88875773082,88875773069,-13,209,1129,30
88875917560,88875917554,-6,1548,2348,30
88880653385,88880653378,-7,553,1543,30
88881695751,88881695747,-4,1178,2602,30
88881914811,88881914806,-5,1255,2881,30
88884709952,88884709946,-6,1130,3144,30
88885044586,88885044573,-13,982,3218,30
88885692230,88885692227,-3,1123,2077,30
88885791800,88885791817,17,807,3084,30
88892809660,88892809659,-1,1016,2569,30
88896236026,88896236022,-4,668,2754,30
88896327597,88896327591,-6,882,2930,30
88897833103,88897833110,7,3765,1527,30
88901113774,88901113769,-5,1682,3092,30
88904181884,88904181888,4,57099,55736,30
88908294033,88908294029,-4,835,2128,30
88908319211,88908319214,3,131,963,30
88909070605,88909070599,-6,1353,4141,30
88909567635,88909567630,-5,940,1994,30
88918205959,88918205960,1,1335,1366,30
88919020030,88919020045,15,901,2187,30
88922935687,88922935682,-5,1282,4537,30
88923740166,88923740162,-4,1100,2430,30
88926305267,88926305264,-3,1347,2579,30
88928375233,88928375228,-5,1463,2740,30
88932411406,88932411402,-4,1021,2984,30
88932926263,88932926258,-5,828,2655,30
88937951031,88937951027,-4,1199,3140,30
88939236038,88939236033,-5,631,2122,30
88940892203,88940892199,-4,1263,2919,30
88948410891,88948410898,7,3919,1829,30
88961686311,88961686306,-5,864,3761,30
88966525827,88966525821,-6,806,2382,30
88969562940,88969562937,-3,2624,4799,30
88971301066,88971301061,-5,1107,2793,30
88975776295,88975776290,-5,734,2881,30
88976171794,88976171790,-4,851,2660,30
88988414406,88988414403,-3,790,2594,30
88991751808,88991751803,-5,852,2234,30
88991919182,88991919177,-5,940,4220,30
88992667521,88992667505,-16,880,2922,30
88994052806,88994052810,4,3553,2976,30
88997528288,88997528289,1,1085,1274,30
89003041341,89003041347,6,2614,1415,30
89004488543,89004488539,-4,908,3311,30
89005791895,89005791892,-3,996,2220,30
89006468043,89006468039,-4,1109,2685,30
89009673441,89009673435,-6,1539,3074,30
89009810462,89009810457,-5,1376,2875,30
89011288721,89011288720,-1,1053,2258,30
89013489859,89013489853,-6,1890,3139,30
89024722265,89024722265,0,2296,2895,30
89031239779,89031239774,-5,1046,2469,30
89033679127,89033679123,-4,1418,2168,30
89035235697,89035235694,-3,1213,3137,30
89039707555,89039707551,-4,1292,3346,30
89039954427,89039954423,-4,1198,2868,30
89040774735,89040774730,-5,612,3076,30
89041171092,89041171105,13,253,575,30
89042222175,89042222173,-2,799,1810,30
89043556928,89043556917,-11,876,2849,30
89048587746,89048587742,-4,1500,3878,30
89054316831,89054316825,-6,777,3584,30
89055816371,89055816366,-5,1446,3601,30
89057909355,89057909351,-4,1069,4151,30
89058676919,89058676917,-2,1213,3070,30
89060043066,89060043085,19,328,1550,30
89060120793,89060120790,-3,1382,3358,30
89061221174,89061221171,-3,789,2483,30
89061966345,89061966360,15,239,921,30
89063625258,89063625258,0,1178,1595,30
89065652171,89065652168,-3,963,1632,30
89065998080,89065998080,0,1583,2746,30
89073029547,89073029540,-7,1003,3525,30
89073506654,89073506650,-4,1131,3910,30
89074075571,89074075585,14,734,2853,30
89074767507,89074767501,-6,1140,3824,30
89075199859,89075199836,-23,1165,1040,30
89078526004,89078526002,-2,1392,2884,30
89078907239,89078907236,-3,981,2260,30
89079454264,89079454269,5,92,1348,30
89083812859,89083812855,-4,618,1262,30
89088215495,89088215490,-5,999,2357,30
89090086635,89090086630,-5,1246,3628,30
89091556538,89091556537,-1,1068,1837,30
89093641717,89093641712,-5,1170,3998,30
89099951529,89099951524,-5,1263,3054,30
89103298788,89103298790,2,3032,2719,30
89103341966,89103341961,-5,993,2564,30
89104933737,89104933732,-5,950,2691,30
89105290401,89105290422,21,404,6684,30
89109663037,89109663031,-6,936,3189,30
89111598050,89111598051,1,1454,1300,30
89112838867,89112838862,-5,704,2135,30
89115657779,89115657777,-2,1051,1971,30
89116859894,89116859890,-4,1224,3762,30
89118312166,89118312146,-20,566,1360,30
89120178825,89120178824,-1,998,1537,30
89128415529,89128415524,-5,839,2554,30
89129244273,89129244294,21,203,1244,30
89131562061,89131562057,-4,1248,4121,30
89131910162,89131910157,-5,1165,3080,30
89133898044,89133898040,-4,1447,3132,30
89139801697,89139801695,-2,902,1863,30
89139919321,89139919341,20,181,1321,30
89140158617,89140158610,-7,157,1187,30
89152964195,89152964191,-4,1510,4138,30
89153142345,89153142365,20,1413,4976,30
89155427845,89155427841,-4,904,2188,30
89157498784,89157498777,-7,699,2691,30
89159213118,89159213126,8,6247,2273,30
89160313243,89160313238,-5,787,3148,30
89160640289,89160640305,16,629,1932,30
89165759781,89165759776,-5,1702,3856,30
89173407187,89173407182,-5,1007,3348,30
89174018828,89174018843,15,404,1549,30
89174063649,89174063663,14,182,1341,30
89181255941,89181255936,-5,1355,2775,30
89181688442,89181688435,-7,295,752,30
89188937615,89188937609,-6,874,2902,30
89198941947,89198941941,-6,1192,3449,30
89202246066,89202246063,-3,979,2093,30
89203297806,89203297802,-4,1140,2933,30
89204089802,89204089798,-4,1036,2893,30
89206187213,89206187213,0,22367,83009,30
89209563247,89209563243,-4,1371,3826,30
89217876031,89217876026,-5,1204,2286,30
89218487462,89218487460,-2,1164,3137,30
89222341402,89222341406,4,2664,1590,30
89225957593,89225957589,-4,1060,3326,30
89226919579,89226919589,10,12151,28019,30
89227520013,89227520009,-4,1286,3128,30
89232083155,89232083150,-5,1280,3025,30
89233519882,89233519879,-3,922,2351,30
89238306058,89238306055,-3,1407,2410,30
89242455814,89242455810,-4,1048,1948,30
89242537676,89242537689,13,401,1782,30
89249064714,89249064709,-5,1308,3086,30
89250203790,89250203785,-5,1022,3160,30
89251272690,89251272686,-4,990,2676,30
89253711143,89253711139,-4,823,2345,30
89261164739,89261164738,-1,998,1754,30
89268201677,89268201672,-5,1072,3219,30
89277774153,89277774147,-6,1050,3393,30
89280834197,89280834190,-7,2382,9397,30
89285701943,89285701940,-3,1116,2338,30
89286441481,89286441479,-2,545,1425,30
89289593556,89289593552,-4,1449,2519,30
89291551522,89291551519,-3,1174,2473,30
89292484235,89292484214,-21,769,2673,30
89293059258,89293059261,3,2030,1565,30
89294893826,89294893821,-5,1539,4461,30
89295553774,89295553778,4,1793,1328,30
89297563774,89297563770,-4,822,2891,30
89306972250,89306972247,-3,1250,3161,30
89311559994,89311559990,-4,892,1496,30
89314297766,89314297763,-3,1289,2360,30
89315250801,89315250805,4,2619,1438,30
89316768176,89316768174,-2,543,321,30
89319915569,89319915565,-4,1112,3366,30
89323676622,89323676618,-4,1157,2750,30
89323789346,89323789324,-22,828,2538,30
89325507997,89325507994,-3,1609,4092,30
89328022369,89328022363,-6,732,4028,30
89328326473,89328326490,17,224,773,30
89329580487,89329580483,-4,1034,2881,30
89331114889,89331114883,-6,1258,3284,30
89331612267,89331612262,-5,967,2741,30
89332835377,89332835395,18,1846,1588,30
89334870644,89334870638,-6,1206,2502,30
89336250422,89336250416,-6,936,2967,30
89338046759,89338046754,-5,1165,2618,30
89338094826,89338094817,-9,660,2824,30
89343202230,89343202225,-5,989,3351,30
89346901747,89346901745,-2,1049,981,30
89349371682,89349371676,-6,1333,3810,30
89350639416,89350639410,-6,933,3244,30
89356721291,89356721285,-6,1075,2181,30
89360273543,89360273539,-4,964,2183,30
89360476753,89360476749,-4,1051,2583,30
89360843025,89360843020,-5,957,2195,30
89361949976,89361949993,17,856,4296,30
89362016188,89362016184,-4,1031,2851,30
89366074571,89366074566,-5,1079,2908,30
89369122747,89369122746,-1,1743,2148,30
89376632509,89376632506,-3,992,2892,30
89379171793,89379171793,0,1669,1632,30
89381573884,89381573900,16,383,1722,30
89382262895,89382262889,-6,1373,2888,30
89385286070,89385286066,-4,856,2841,30
89389178936,89389178931,-5,1165,3106,30
89392502090,89392502090,0,1324,1504,30
89393494742,89393494744,2,1845,1893,30
89400982923,89400982918,-5,1136,3615,30
89401261776,89401261762,-14,32,1235,30
89406190480,89406190478,-2,8827,15609,30
89410164331,89410164327,-4,1490,2432,30
89412229418,89412229414,-4,1012,2651,30
89417350273,89417350270,-3,1082,3277,30
89424191583,89424191577,-6,1043,2687,30
89424289666,89424289685,19,1260,3218,30
89425964658,89425964665,7,2707,1116,30
89427483622,89427483617,-5,964,2691,30
89433557454,89433557454,0,1165,1568,30
89434211856,89434211879,23,1180,2163,30
89435222971,89435222967,-4,167,686,30
89435809449,89435809446,-3,1097,2189,30
89436192689,89436192682,-7,1095,4486,30
89447515851,89447515847,-4,268,1672,30
89453547909,89453547905,-4,1014,2735,30
89460518865,89460518866,1,2013,2645,30
89461726010,89461726006,-4,1066,3266,30
89465837438,89465837436,-2,985,2786,30
89468368334,89468368328,-6,1240,2819,30
89470665803,89470665806,3,1905,774,30
89472055074,89472055068,-6,217,1059,30
89475382466,89475382462,-4,945,2264,30
89478457053,89478457047,-6,786,1525,30
89486010549,89486010545,-4,1099,3441,30
89488552122,89488552118,-4,1704,4701,30
89489781448,89489781443,-5,782,3163,30
89489874067,89489874087,20,882,3067,30
89490285224,89490285227,3,2155,1508,30
89492684876,89492684871,-5,1267,2962,30
89501332666,89501332661,-5,1365,4096,30
89502711310,89502711306,-4,1262,3534,30
89502813472,89502813466,-6,894,1114,30
89504375696,89504375690,-6,857,2616,30
89504789675,89504789654,-21,233,979,30
89509122771,89509122765,-6,1073,2838,30
89514185910,89514185909,-1,1709,2707,30
89515976042,89515976037,-5,1043,4049,30
89521448182,89521448175,-7,1332,2742,30
89521793369,89521793373,4,1254,1190,30
89522770040,89522770037,-3,1242,3459,30
89523402611,89523402592,-19,1033,3776,30
89530319930,89530319926,-4,1080,2177,30
89531700886,89531700882,-4,910,2846,30
89537043812,89537043806,-6,1358,3605,30
89537795563,89537795558,-5,1089,3522,30
89538223746,89538223741,-5,852,2244,30
89538444890,89538444886,-4,973,2025,30
89542374587,89542374582,-5,1033,2931,30
89544940999,89544940994,-5,947,1977,30
89545447625,89545447622,-3,995,2620,30
89547033096,89547033098,2,1579,1616,30
89548382903,89548382898,-5,873,2794,30
89550191083,89550191078,-5,701,2911,30
89552610720,89552610716,-4,1100,1798,30
89552902539,89552902518,-21,1100,3609,30
89554973624,89554973620,-4,2313,6354,30
89557996046,89557996042,-4,1096,2349,30
89558140401,89558140420,19,701,2386,30
89561000723,89561000719,-4,902,2416,30
89561101035,89561101039,4,5378,24876,30
89563169598,89563169606,8,2672,1291,30
89566235104,89566235100,-4,498,2175,30
89567325480,89567325475,-5,1266,3573,30
89569438965,89569438958,-7,933,2995,30
89571015064,89571015063,-1,1408,2714,30
89573212741,89573212736,-5,1050,3179,30
89574893542,89574893538,-4,1265,2224,30
89578452238,89578452239,1,1889,1661,30
89581307891,89581307887,-4,895,2154,30
89582989793,89582989789,-4,1173,3193,30
89583391974,89583391970,-4,1293,3052,30
89583675535,89583675530,-5,859,1965,30
89586671047,89586671041,-6,1219,4239,30
89588600121,89588600117,-4,742,2480,30
89595328307,89595328304,-3,637,2636,30
89596243737,89596243757,20,628,1975,30
89602142922,89602142916,-6,718,1803,30
89603182243,89603182238,-5,1118,3176,30
89603265659,89603265654,-5,1417,4081,30
89606487486,89606487480,-6,805,1858,30
89606778715,89606778711,-4,1088,3220,30
89609003715,89609003709,-6,801,2006,30
89611767935,89611767930,-5,715,1978,30
89613303046,89613303051,5,920,1294,30
89618451286,89618451282,-4,1062,2443,30
89618808187,89618808206,19,897,2121,30
89619572782,89619572779,-3,1234,2477,30
89620503683,89620503679,-4,961,3188,30
89620743753,89620743746,-7,120,954,30
89625739763,89625739761,-2,1487,3250,30
89630262553,89630262546,-7,1227,4645,30
89632826829,89632826824,-5,1110,2543,30
89640768288,89640768281,-7,1255,2285,30
89643627455,89643627451,-4,501,2216,30
89646120606,89646120604,-2,1505,2907,30
89646577973,89646577970,-3,913,2609,30
89649194388,89649194395,7,2470,1443,30
89650779325,89650779323,-2,987,2242,30
89656191535,89656191530,-5,1074,2969,30
89666807111,89666807106,-5,848,2430,30
89667005563,89667005546,-17,365,1070,30
89672549857,89672549853,-4,1306,3844,30
89676858183,89676858182,-1,1274,2141,30
89683784162,89683784160,-2,1552,2081,30
89685702710,89685702704,-6,1397,3437,30
89702578877,89702578872,-5,1045,2807,30
89707022442,89707022437,-5,1335,3147,30
89707076996,89707077001,5,339,2279,30
89708092229,89708092225,-4,776,1924,30
89708278777,89708278798,21,356,961,30
89709174746,89709174742,-4,1102,3405,30
89711814489,89711814486,-3,843,2567,30
89717225210,89717225207,-3,1060,2188,30
89717277364,89717277378,14,38,728,30
89718805684,89718805680,-4,934,2420,30
89719209450,89719209442,-8,1107,4714,30
89721592558,89721592554,-4,1191,2724,30
89722397258,89722397253,-5,731,2686,30
89726917355,89726917350,-5,628,1830,30
89730294622,89730294618,-4,845,3132,30
89736467289,89736467303,14,256,756,30
89737086099,89737086094,-5,1214,3172,30
89739157270,89739157265,-5,1125,3390,30
89746007127,89746007123,-4,1440,3362,30
89746085680,89746085683,3,2965,1937,30
89746573780,89746573776,-4,1093,2576,30
89748070786,89748070786,0,1807,2266,30
89748152767,89748152764,-3,1241,3171,30
89748533687,89748533682,-5,1300,3276,30
89749652165,89749652159,-6,920,2567,30
89751333256,89751333254,-2,1129,2615,30
89753799679,89753799674,-5,1277,3120,30
89755505122,89755505129,7,2289,868,30
89767508122,89767508137,15,1007,3775,30
89768569258,89768569254,-4,918,2543,30
89775009983,89775009978,-5,929,3314,30
89775279233,89775279249,16,283,806,30
89780857489,89780857494,5,16315,20409,30
89786734616,89786734610,-6,1215,2950,30
89789695373,89789695369,-4,978,3573,30
89792544581,89792544582,1,2766,3185,30
89794608941,89794608939,-2,1047,2207,30
89796319303,89796319299,-4,975,1861,30
89797247170,89797247167,-3,730,2733,30
89801450895,89801450891,-4,1201,2118,30
89801544707,89801544714,7,190,1229,30
89802226531,89802226526,-5,846,3113,30
89805142165,89805142159,-6,1440,1536,30
89805189339,89805189340,1,1084,1230,30
89807095783,89807095780,-3,1334,1740,30
89810372986,89810372982,-4,835,2159,30
89811775842,89811775842,0,2149,3577,30
89815300073,89815300068,-5,1203,2979,30
89824269890,89824269884,-6,858,2763,30
89824383387,89824383375,-12,11,872,30
89824849836,89824849831,-5,1272,3418,30
89826615954,89826615949,-5,1171,3100,30
89830776274,89830776270,-4,868,1875,30
89830831930,89830831951,21,723,1757,30
89833586241,89833586235,-6,1234,2981,30
89836954451,89836954448,-3,1040,2379,30
89838321486,89838321482,-4,835,1973,30
89838563955,89838563954,-1,187,1006,30
89839565342,89839565338,-4,1136,2446,30
89840723247,89840723242,-5,756,2579,30
89843238246,89843238241,-5,1029,3755,30
89844683018,89844683014,-4,966,3060,30
89848186394,89848186389,-5,417,1372,30
89849083515,89849083533,18,1206,2893,30
89851957578,89851957575,-3,1610,3917,30
89856269121,89856269121,0,2116,1569,30
89862483506,89862483501,-5,801,2436,30
89863695033,89863695029,-4,1114,1787,30
89871502427,89871502423,-4,1302,3941,30
89889707017,89889707014,-3,1018,2003,30
89892316852,89892316846,-6,1247,2591,30
89893751215,89893751209,-6,1198,3244,30
89894434731,89894434725,-6,966,3279,30
89894751841,89894751825,-16,1084,2857,30
89904804919,89904804914,-5,1418,4589,30
89906294859,89906294842,-17,210,1033,30
89906764586,89906764573,-13,1581,957,30
89908184760,89908184754,-6,756,3645,30
89908611411,89908611430,19,756,2201,30
89913098506,89913098502,-4,952,2751,30
89914012587,89914012582,-5,1380,3544,30
89921374857,89921374850,-7,1364,6746,30
89922175528,89922175530,2,1263,1437,30
89924955623,89924955620,-3,1227,2419,30
89926011398,89926011397,-1,329,2654,30
89929089914,89929089906,-8,910,2871,30
89933939737,89933939734,-3,1338,3781,30
89934133347,89934133355,8,517,1543,30
89937975355,89937975350,-5,883,3413,30
89939837498,89939837493,-5,1040,2557,30
89940697054,89940697053,-1,1816,1805,30
89948249642,89948249646,4,2259,1393,30
89952234698,89952234694,-4,1364,3311,30
89953153422,89953153417,-5,1660,5255,30
89953771234,89953771235,1,1297,1790,30
89957802011,89957802006,-5,23043,11469,30
89963932138,89963932134,-4,735,1829,30
89964449233,89964449227,-6,950,2887,30
89976249482,89976249481,-1,1154,2495,30
89995102366,89995102362,-4,906,2864,30
89995321792,89995321815,23,257,911,30
89995655623,89995655640,17,1270,3651,30
89998154001,89998153998,-3,752,3836,30
90003568157,90003568153,-4,1042,1879,30
90004124069,90004124066,-3,907,2312,30
90011295719,90011295719,0,1416,1604,30
90014525247,90014525240,-7,959,2842,30
90016255551,90016255544,-7,1362,4532,30
90017864475,90017864473,-2,1286,2533,30
90020455973,90020455967,-6,1239,4272,30
90024382151,90024382146,-5,1764,4537,30
90024729707,90024729707,0,1717,2215,30
90031567543,90031567538,-5,1476,3465,30
90032155483,90032155479,-4,1585,4107,30
90032402920,90032402927,7,2393,983,30
90037840942,90037840939,-3,867,2764,30
90040849927,90040849922,-5,714,1193,30
90044853629,90044853626,-3,986,2481,30
90047325918,90047325915,-3,1140,1771,30
90047597713,90047597708,-5,1167,3525,30
90047894569,90047894585,16,134,1205,30
90060920375,90060920371,-4,1360,3012,30
90061446974,90061446970,-4,910,2321,30
90061749158,90061749154,-4,942,3073,30
90062440994,90062440990,-4,1032,1656,30
90072352589,90072352585,-4,519,1991,30
90074505635,90074505631,-4,1071,2453,30
90074763225,90074763239,14,617,1368,30
90086738481,90086738476,-5,1456,3712,30
90094301918,90094301935,17,714,2357,30
90101367967,90101367962,-5,734,2961,30
90102748646,90102748641,-5,1088,2140,30
90104747711,90104747707,-4,1123,3929,30
90108750279,90108750276,-3,1270,2923,30
90110856277,90110856298,21,1932,1245,30
90113767583,90113767578,-5,620,1884,30
90114139740,90114139736,-4,990,3067,30
90114544999,90114544994,-5,1025,3553,30
90117956176,90117956173,-3,1112,2491,30
90124115510,90124115506,-4,1514,3578,30
90127005229,90127005230,1,832,1021,30
90132087766,90132087766,0,1237,1959,30
90137786503,90137786496,-7,829,3287,30
90137828137,90137828134,-3,261,2758,30
90142030242,90142030238,-4,1121,3525,30
90157941467,90157941464,-3,1174,3182,30
90158673190,90158673186,-4,1031,3425,30
90158848025,90158848018,-7,739,2684,30
90160363126,90160363122,-4,1190,3364,30
90160439341,90160439337,-4,1189,3572,30
90163159378,90163159357,-21,855,3047,30
90165442658,90165442652,-6,1040,2870,30
90170126066,90170126059,-7,1255,4859,30
90179824215,90179824209,-6,835,3719,30
90189235089,90189235083,-6,956,2900,30
90189661689,90189661677,-12,909,2101,30
90190030833,90190030820,-13,1170,3098,30
90191331584,90191331578,-6,715,3060,30
90191554520,90191554520,0,1239,1967,30
90191884017,90191884035,18,1096,2410,30
90194757529,90194757546,17,856,3901,30
90194922305,90194922326,21,149,1136,30
90216933510,90216933523,13,460,1217,30
90218682980,90218682974,-6,771,2001,30
90218855274,90218855289,15,591,1332,30
90224419602,90224419598,-4,1088,2937,30
90232862546,90232862542,-4,919,2939,30
90233055257,90233055258,1,3225,4955,30
90234524862,90234524858,-4,1239,3358,30
90235379443,90235379439,-4,1255,2293,30
90239751179,90239751185,6,2938,1456,30
90242586752,90242586746,-6,970,2097,30
90247659923,90247659921,-2,854,2489,30
90248157031,90248157027,-4,1316,2942,30
90249183199,90249183195,-4,711,1523,30
90250635069,90250635085,16,1692,751,30
90251453631,90251453629,-2,917,1990,30
90252072807,90252072801,-6,974,2790,30
90253406410,90253406406,-4,917,3102,30
90253828467,90253828462,-5,1146,2625,30
90260625447,90260625443,-4,853,2566,30
90261149535,90261149530,-5,830,3935,30
90261661910,90261661910,0,945,993,30
90265134523,90265134521,-2,508,1513,30
90275216490,90275216486,-4,1650,3097,30
90276912986,90276912979,-7,1269,3883,30
90277182021,90277182017,-4,1060,2501,30
90278521444,90278521438,-6,1411,4372,30
90279230267,90279230264,-3,1119,2003,30
90280451400,90280451397,-3,1230,2567,30
90285923650,90285923646,-4,846,2110,30
90285985545,90285985564,19,1486,2990,30
90291354698,90291354694,-4,1773,3358,30
90292856877,90292856873,-4,1396,2951,30
90297543430,90297543426,-4,858,2706,30
90298236760,90298236758,-2,906,1709,30
90298748890,90298748910,20,483,1410,30
90301327029,90301327025,-4,1070,2625,30
90302003128,90302003130,2,164,870,30
90306186329,90306186334,5,2407,1210,30
90307687446,90307687442,-4,847,3100,30
90308530967,90308530958,-9,1006,3207,30
90308603559,90308603555,-4,11175,15397,30
90312629621,90312629601,-20,935,1081,30
90313598089,90313598091,2,1847,1264,30
90316378891,90316378886,-5,1046,3883,30
90316682131,90316682122,-9,780,3208,30
90320722435,90320722431,-4,877,2487,30
90325809939,90325809931,-8,192,1364,30
90328954874,90328954870,-4,887,1865,30
90334749965,90334749971,6,2718,1045,30
90338241299,90338241294,-5,1265,4481,30
90338929883,90338929902,19,1245,3724,30
90341876146,90341876143,-3,1137,3629,30
90346475219,90346475215,-4,946,3036,30
90347823275,90347823270,-5,1078,3103,30
90349034822,90349034818,-4,867,2353,30
90355261385,90355261390,5,1419,719,30
90363126105,90363126101,-4,1570,4258,30
90364978993,90364978989,-4,1134,2351,30
90370245876,90370245870,-6,1199,2748,30
90373823686,90373823680,-6,1108,3528,30
90376236922,90376236918,-4,1046,2879,30
90386105097,90386105094,-3,1039,2512,30
90388844333,90388844332,-1,1083,2259,30
90391090563,90391090559,-4,1508,2936,30
90395214746,90395214741,-5,1098,2370,30
90395329306,90395329302,-4,1034,2462,30
90398762023,90398762021,-2,705,1284,30
90398990475,90398990452,-23,138,1140,30
90401092943,90401092941,-2,2146,5552,30
90401398230,90401398225,-5,756,1443,30
90404259007,90404259004,-3,858,2611,30
90404465001,90404464998,-3,1039,2510,30
90404675171,90404675167,-4,20,1450,30
90405370985,90405370979,-6,1790,3163,30
90411595033,90411595029,-4,1733,3446,30
90412061447,90412061445,-2,1447,3352,30
90414473183,90414473179,-4,1344,3947,30
90421744464,90421744459,-5,1066,3196,30
90422977132,90422977150,18,307,1845,30
90424352367,90424352363,-4,845,2368,30
90431387302,90431387296,-6,1235,3630,30
90431979880,90431979877,-3,1736,3025,30
90436068382,90436068376,-6,809,3090,30
90437978102,90437978095,-7,1140,3496,30
90438211322,90438211316,-6,745,1569,30
90439278991,90439278987,-4,1227,2653,30
90439519201,90439519198,-3,1047,2379,30
90440437863,90440437859,-4,1164,2999,30
90445916994,90445916989,-5,1264,3006,30
90451050499,90451050496,-3,1118,2053,30
90456963310,90456963310,0,1890,1509,30
90469336018,90469336020,2,5107,4671,30
90471120054,90471120051,-3,984,2062,30
90474471475,90474471470,-5,1117,2600,30
90477053614,90477053609,-5,1166,3693,30
90486300239,90486300231,-8,999,3032,30
90494930643,90494930658,15,355,960,30
90496413826,90496413829,3,1634,1229,30
90501267910,90501267904,-6,1160,2958,30
90501318749,90501318743,-6,1736,3642,30
90507737002,90507736998,-4,1200,3141,30
90513105695,90513105689,-6,772,2086,30
90517113391,90517113375,-16,159,985,30
90518199828,90518199825,-3,1342,2117,30
90522323995,90522323989,-6,746,3792,30
90523712106,90523712111,5,2135,823,30
90525399825,90525399821,-4,1026,3478,30
90526044876,90526044894,18,82,838,30
90527633923,90527633920,-3,1016,3272,30
90527743625,90527743647,22,1041,3000,30
90542009891,90542009894,3,1917,1558,30
90543285661,90543285656,-5,957,3448,30
90543459925,90543459922,-3,952,2146,30
90555565158,90555565155,-3,1418,3216,30
90558702777,90558702771,-6,778,1587,30
90563918703,90563918698,-5,1056,2344,30
90567940469,90567940466,-3,220,991,30
90570917791,90570917789,-2,1015,1752,30
90574450716,90574450714,-2,1148,1574,30
90576973103,90576973089,-14,1446,490,30
90594778630,90594778624,-6,933,3009,30
90599345339,90599345334,-5,1160,2303,30
90601435978,90601435973,-5,849,3409,30
90602507413,90602507409,-4,1167,2273,30
90604502441,90604502437,-4,1004,3492,30
90608706818,90608706820,2,3143,3190,30
90618882805,90618882803,-2,1179,2640,30
90628546767,90628546762,-5,872,2987,30
90630608973,90630608969,-4,1104,2510,30
90637301418,90637301414,-4,923,2170,30
90637435361,90637435355,-6,128,770,30
90638847324,90638847317,-7,987,2690,30
90638999315,90638999309,-6,930,3031,30
90639340698,90639340695,-3,1694,2813,30
90640586600,90640586594,-6,1211,4237,30
90642775894,90642775890,-4,5596,16100,30
90650893174,90650893169,-5,1529,3018,30
90654890199,90654890195,-4,1016,2042,30
90658837675,90658837672,-3,812,2254,30
90662372530,90662372526,-4,1235,3339,30
90667293939,90667293936,-3,953,2992,30
90669713131,90669713128,-3,988,1562,30
90671207150,90671207150,0,2373,2975,30
90675242758,90675242753,-5,1105,2896,30
90676780743,90676780738,-5,641,2845,30
90676817550,90676817547,-3,934,1991,30
90684594226,90684594211,-15,5105,25965,30
90689083178,90689083157,-21,1257,1525,30
90689390814,90689390810,-4,727,2528,30
90691046142,90691046137,-5,1305,3388,30
90691551520,90691551517,-3,1292,3860,30
90692526679,90692526674,-5,1031,2848,30
90700079278,90700079273,-5,1007,2676,30
90700973155,90700973149,-6,1277,2834,30
90708148429,90708148421,-8,447,1720,30
90709254315,90709254311,-4,856,2233,30
90709826804,90709826798,-6,1065,3161,30
90710210727,90710210722,-5,1101,3981,30
90712063762,90712063759,-3,839,3263,30
90716885125,90716885118,-7,1917,4645,30
90717023965,90717023961,-4,1154,3561,30
90720175073,90720175069,-4,1545,2776,30
90722283530,90722283526,-4,1177,3162,30
90729926167,90729926162,-5,1148,2903,30
90730269039,90730269058,19,624,2722,30
90733984095,90733984093,-2,930,2251,30
90735725095,90735725092,-3,1104,2152,30
90738557091,90738557087,-4,634,2335,30
90739449785,90739449781,-4,1001,2186,30
90740969598,90740969593,-5,748,2854,30
90742386639,90742386634,-5,1006,1760,30
90754605113,90754605109,-4,910,2514,30
90775305411,90775305421,10,13135,39821,30
90775778129,90775778123,-6,1170,2570,30
90775964683,90775964676,-7,1085,3136,30
90777202481,90777202474,-7,626,2187,30
90780106735,90780106731,-4,626,3111,30
90780569654,90780569660,6,10077,34487,30
90781605675,90781605669,-6,798,4675,30
90781671855,90781671851,-4,1243,2716,30
90782676866,90782676870,4,1831,1458,30
90785237577,90785237572,-5,1298,2825,30
90792531814,90792531808,-6,1160,3851,30
90792870910,90792870903,-7,577,2835,30
90794751721,90794751716,-5,1275,2506,30
90799045190,90799045185,-5,941,2494,30
90800230197,90800230202,5,22209,40266,30
90807089877,90807089873,-4,1477,2692,30
90807697029,90807697025,-4,976,2434,30
90807969161,90807969159,-2,1216,2884,30
90809665460,90809665474,14,429,1056,30
90810985126,90810985144,18,1028,2197,30
90811223490,90811223509,19,1166,3470,30
90819007443,90819007438,-5,1067,3070,30
90820714170,90820714166,-4,937,3215,30
90826360616,90826360611,-5,683,2383,30
90828208799,90828208793,-6,1070,2249,30
90828518944,90828518935,-9,1284,2933,30
90830587150,90830587145,-5,930,3107,30
90834988421,90834988415,-6,1134,3490,30
90835015128,90835015150,22,781,3239,30
90839248949,90839248942,-7,873,2606,30
90839439635,90839439630,-5,699,2062,30
90843014662,90843014659,-3,1235,1772,30
90843157026,90843157026,0,1271,2915,30
90843607752,90843607745,-7,852,2420,30
90847959839,90847959837,-2,1054,3034,30
90850776101,90850776097,-4,1104,3351,30
90851226600,90851226591,-9,203,756,30
90852030314,90852030309,-5,1377,3506,30
90855748080,90855748076,-4,1147,2927,30
90859622798,90859622795,-3,1035,2717,30
90860392115,90860392129,14,800,3021,30
90860771778,90860771774,-4,724,2654,30
90863524902,90863524897,-5,888,1782,30
90866103638,90866103634,-4,1034,3261,30
90870861666,90870861663,-3,765,2818,30
90877394981,90877394976,-5,669,2791,30
90880158482,90880158478,-4,743,2957,30
90883788930,90883788926,-4,1094,2775,30
90888423582,90888423593,11,16572,44871,30
90900569037,90900569033,-4,1106,3161,30
90901585523,90901585519,-4,1053,2580,30
90901796459,90901796473,14,179,1092,30
90901987478,90901987473,-5,1131,3156,30
90905381987,90905381983,-4,1012,2736,30
90909190401,90909190398,-3,832,2635,30
90912179051,90912179047,-4,1212,3247,30
90913638806,90913638801,-5,713,3669,30
90913933951,90913933946,-5,1234,3818,30
90914736623,90914736618,-5,512,1908,30
90914773410,90914773429,19,1018,2666,30
90916319655,90916319650,-5,815,1811,30
90919688678,90919688677,-1,1610,2943,30
90922031118,90922031114,-4,923,2683,30
90923368854,90923368849,-5,1323,3513,30
90924363575,90924363570,-5,940,2807,30
90925971333,90925971333,0,1252,2377,30
90928902814,90928902810,-4,1070,2779,30
90934654502,90934654498,-4,974,2168,30
90943437082,90943437078,-4,920,2749,30
90950001245,90950001251,6,1878,1280,30
90957685144,90957685141,-3,956,2030,30
90959642350,90959642346,-4,693,3153,30
90962669727,90962669721,-6,483,2700,30
90963048927,90963048928,1,1826,1728,30
90964936494,90964936489,-5,2052,5664,30
90967977151,90967977147,-4,1461,3200,30
90968313852,90968313846,-6,1115,3425,30
90968341713,90968341735,22,1656,1707,30
90968627314,90968627310,-4,699,2139,30
90973449295,90973449290,-5,748,2761,30
90973979127,90973979125,-2,1324,2198,30
90978567166,90978567165,-1,668,1729,30
90981684878,90981684874,-4,1127,2790,30
90983708276,90983708273,-3,1756,3264,30
90989205189,90989205186,-3,653,1638,30
90993857281,90993857278,-3,808,1204,30
90994698000,90994698000,0,1331,1678,30
90995779058,90995779061,3,2517,2469,30
90997538577,90997538573,-4,1323,2944,30
90998665385,90998665387,2,1903,1631,30
91000331351,91000331345,-6,1570,5830,30
91002296520,91002296515,-5,1150,2712,30
91003154403,91003154421,18,1053,3170,30
91003892902,91003892899,-3,1305,2057,30
91013090058,91013090054,-4,1249,3495,30
91018192215,91018192209,-6,1030,3177,30
91033844676,91033844673,-3,1448,3002,30
91035007670,91035007666,-4,1421,4281,30
91043389999,91043390002,3,904,1352,30
91044086024,91044086009,-15,45,1112,30
91047023144,91047023138,-6,1797,4537,30
91048684065,91048684048,-17,539,1476,30
91054775598,91054775594,-4,936,2820,30
91055003953,91055003972,19,897,2411,30
91059083653,91059083648,-5,1177,2326,30
91061565354,91061565349,-5,1088,2732,30
91066229614,91066229618,4,1867,1235,30
91067719572,91067719568,-4,1296,3865,30
91068625880,91068625864,-16,155,4918,30
91073387521,91073387513,-8,487,3414,30
91077336273,91077336270,-3,597,2170,30
91078681861,91078681852,-9,832,2785,30
91078914392,91078914411,19,920,2952,30
91085549973,91085549979,6,1972,1267,30
91087743218,91087743215,-3,886,3147,30
91092669698,91092669678,-20,967,1054,30
91100545775,91100545770,-5,1227,2957,30
91101964063,91101964058,-5,1048,2842,30
91113022790,91113022785,-5,921,1884,30
91113589371,91113589368,-3,1048,3241,30
91115080044,91115080042,-2,1549,3081,30
91120425550,91120425544,-6,993,2777,30
91120561171,91120561158,-13,579,1911,30
91128608533,91128608529,-4,1077,3040,30
91130162022,91130162020,-2,870,1919,30
91142550562,91142550559,-3,719,3376,30
91144855246,91144855240,-6,745,4929,30
91146800723,91146800718,-5,1234,4382,30
91149075571,91149075567,-4,1068,3326,30
91151955564,91151955568,4,2779,2082,30
91152022042,91152022037,-5,1588,2847,30
91153375574,91153375578,4,2704,1221,30
91157121678,91157121674,-4,1395,2797,30
91165059238,91165059234,-4,848,2531,30
91168913003,91168912998,-5,820,3078,30
91170064404,91170064421,17,1121,3272,30
91175779942,91175779948,6,2171,1440,30
91177435257,91177435253,-4,950,3082,30
91178319194,91178319190,-4,1032,2547,30
91179413350,91179413346,-4,1002,3769,30
91186484835,91186484829,-6,1362,4471,30
91188973294,91188973290,-4,1703,3607,30
91189215358,91189215354,-4,843,3070,30
91189890917,91189890912,-5,1103,2966,30
91196561046,91196561041,-5,1091,1611,30
91198931622,91198931603,-19,1099,1388,30
91200125238,91200125234,-4,941,2142,30
91204194358,91204194358,0,1678,2305,30
91204584037,91204584034,-3,1020,3420,30
91210731810,91210731805,-5,598,3105,30
91213674499,91213674495,-4,950,2294,30
91214772374,91214772370,-4,3735,10952,30
91216366326,91216366322,-4,674,1840,30
91217923216,91217923209,-7,1415,3382,30
91219409318,91219409314,-4,844,3032,30
91220286702,91220286697,-5,895,2639,30
91220349312,91220349302,-10,771,1425,30
91220820891,91220820882,-9,1193,2850,30
91221830834,91221830830,-4,636,2747,30
91223251709,91223251703,-6,1089,3376,30
91225370386,91225370385,-1,1483,2023,30
91227112955,91227112950,-5,1156,3558,30
91230606101,91230606098,-3,1294,2738,30
91231718986,91231718981,-5,1237,2760,30
91235558887,91235558884,-3,785,1847,30
91237297222,91237297219,-3,976,2964,30
91238672082,91238672077,-5,1332,2365,30
91244986857,91244986851,-6,849,3883,30
91249011876,91249011871,-5,2937,9317,30
91250216823,91250216818,-5,1053,2824,30
91251075184,91251075187,3,1804,1202,30
91253142772,91253142766,-6,987,2745,30
91254333886,91254333881,-5,817,2102,30
91254777617,91254777633,16,550,1333,30
91258352816,91258352811,-5,1091,4048,30
91259547931,91259547925,-6,1017,4196,30
91262413309,91262413304,-5,756,2261,30
91263540362,91263540358,-4,1267,3706,30
91263913105,91263913125,20,193,1439,30
91265811094,91265811089,-5,966,2891,30
91272017427,91272017428,1,2938,3041,30
91272504745,91272504739,-6,950,3150,30
91272922320,91272922302,-18,583,9319,30
91273227610,91273227606,-4,1043,2556,30
91273724436,91273724454,18,320,1078,30
91273969992,91273969973,-19,740,2245,30
91274915620,91274915633,13,287,552,30
91281252126,91281252123,-3,669,2240,30
91290774878,91290774877,-1,1438,2722,30
91292137554,91292137549,-5,1459,3987,30
91292224650,91292224634,-16,1052,2046,30
91294700677,91294700674,-3,1046,2981,30
91295159003,91295158999,-4,1133,2269,30
91296482461,91296482457,-4,1326,3663,30
91315314233,91315314230,-3,1441,1663,30
91315835491,91315835511,20,572,1632,30
91330935166,91330935162,-4,1037,4031,30
91331650628,91331650644,16,519,1831,30
91333214310,91333214305,-5,805,2114,30
91335497913,91335497906,-7,975,2548,30
91339761194,91339761190,-4,768,1896,30
91347080985,91347080979,-6,925,4380,30
91347360179,91347360182,3,968,1063,30
91354733820,91354733816,-4,1240,3427,30
91355068450,91355068446,-4,1089,3150,30
91357512298,91357512294,-4,1308,3245,30
91373197819,91373197816,-3,876,1853,30
91374350994,91374350993,-1,1004,1565,30
91376174999,91376174994,-5,889,2460,30
91380778927,91380778922,-5,702,1238,30
91383593063,91383593058,-5,1151,2884,30
91384712635,91384712650,15,997,1596,30
91386141803,91386141797,-6,722,2694,30
91390324206,91390324200,-6,1052,2394,30
91390611985,91390612006,21,21,1600,30
91390932521,91390932529,8,106,800,30
91392442495,91392442490,-5,1063,2284,30
91397498086,91397498082,-4,760,2698,30
91397724682,91397724678,-4,1170,2490,30
91400824829,91400824825,-4,1100,2177,30
91406626573,91406626567,-6,1258,3309,30
91409345979,91409345982,3,3120,3526,30
91409854248,91409854253,5,7720,5373,30
91413099805,91413099808,3,1541,1639,30
91416834572,91416834584,12,2043,1228,30
91424068449,91424068445,-4,1080,2225,30
91425405713,91425405709,-4,1195,2464,30
91428255106,91428255101,-5,1215,3396,30
91429904271,91429904267,-4,792,2915,30
91430457157,91430457155,-2,574,1338,30
91430688204,91430688218,14,194,1792,30
91431155092,91431155104,12,812,2375,30
91431216929,91431216925,-4,601,2534,30
91435138544,91435138540,-4,1337,3467,30
91437861117,91437861112,-5,1012,3177,30
91438459830,91438459822,-8,1014,4709,30
91440056135,91440056130,-5,798,2709,30
91450356782,91450356777,-5,803,2977,30
91450393284,91450393298,14,202,2371,30
91463304583,91463304578,-5,708,1796,30
91463728007,91463728002,-5,1034,2433,30
91466381717,91466381710,-7,1361,3508,30
91466607733,91466607727,-6,1332,3372,30
91467772010,91467772021,11,613,1341,30
91468150235,91468150228,-7,958,2182,30
91488458041,91488458047,6,2155,969,30
91493104854,91493104850,-4,776,2018,30
91496614317,91496614313,-4,995,1732,30
91500212557,91500212552,-5,1335,3012,30
91501627719,91501627719,0,577,1305,30
91509801028,91509801021,-7,1634,6471,30
91510137960,91510137963,3,3,800,30
91511831583,91511831579,-4,1098,2091,30
91513140047,91513140042,-5,1084,2560,30
91515559670,91515559665,-5,881,2893,30
91520504398,91520504395,-3,973,2282,30
91522095395,91522095392,-3,1056,2500,30
91526362523,91526362518,-5,701,1945,30
91528004355,91528004353,-2,1183,2247,30
91529142757,91529142753,-4,903,3325,30
91536206734,91536206729,-5,1169,2497,30
91536878226,91536878215,-11,1090,1970,30
91537956569,91537956590,21,874,2037,30
91544789745,91544789738,-7,1055,3756,30
91546096226,91546096220,-6,1160,3557,30
91551479707,91551479703,-4,1406,4228,30
91551615357,91551615364,7,3331,1958,30
91558029140,91558029135,-5,798,1802,30
91559781063,91559781058,-5,1052,2903,30
91560114920,91560114903,-17,227,818,30
91560574161,91560574146,-15,142,826,30
91563457207,91563457202,-5,926,3021,30
91567507353,91567507349,-4,687,2047,30
91569035217,91569035231,14,206,897,30
91585490557,91585490554,-3,1163,2532,30
91586254248,91586254250,2,1359,1213,30
91586508481,91586508499,18,358,758,30
91587587119,91587587115,-4,1209,3451,30
91593291790,91593291785,-5,1373,3091,30
91594732267,91594732263,-4,1144,2621,30
91596619802,91596619795,-7,1862,6428,30
91598280870,91598280864,-6,1248,3140,30
91611236122,91611236118,-4,1461,2855,30
91613191134,91613191131,-3,1501,2235,30
91615039873,91615039866,-7,2476,13105,30
91616250777,91616250771,-6,1053,4013,30
91618111411,91618111406,-5,785,2655,30
91622187310,91622187306,-4,1780,3384,30
91623249874,91623249870,-4,915,3306,30
91627107571,91627107566,-5,693,1591,30
91629510138,91629510134,-4,1019,2647,30
91634578912,91634578905,-7,765,3053,30
91636937358,91636937355,-3,829,3077,30
91638056783,91638056777,-6,888,3613,30
91639086714,91639086709,-5,1155,3125,30
91640783241,91640783235,-6,1649,3716,30
91640900329,91640900325,-4,1189,3548,30
91641143874,91641143870,-4,921,2802,30
91644067161,91644067158,-3,764,1864,30
91650023978,91650023976,-2,967,2286,30
91650228293,91650228288,-5,849,2985,30
91650311846,91650311850,4,2227,1379,30
91651934246,91651934240,-6,1116,2569,30
91654630678,91654630683,5,1147,71,30
91655463035,91655463034,-1,1177,1528,30
91656402667,91656402664,-3,746,1839,30
91657352966,91657352962,-4,1480,3232,30
91657485174,91657485171,-3,1393,2325,30
91661555672,91661555667,-5,1303,2601,30
91662359347,91662359343,-4,974,2276,30
91663527333,91663527328,-5,901,2750,30
91667775475,91667775494,19,692,1143,30
91667999342,91667999338,-4,861,2052,30
91676577364,91676577361,-3,1052,2122,30
91676627039,91676627035,-4,1011,2188,30
91683573409,91683573406,-3,1048,2120,30
91690673856,91690673852,-4,1252,2744,30
91691555297,91691555298,1,1526,1838,30
91691683108,91691683102,-6,1117,3260,30
91698434110,91698434106,-4,1283,2625,30
91699227330,91699227334,4,2785,1672,30
91703903445,91703903441,-4,741,2483,30
91715727788,91715727794,6,13007,6555,30
91719131038,91719131041,3,1519,1081,30
91719467662,91719467657,-5,1367,4015,30
91719537714,91719537731,17,115,1085,30
91724184072,91724184068,-4,884,2500,30
91731504109,91731504106,-3,921,2490,30
91732743537,91732743529,-8,1049,3107,30
91736620786,91736620783,-3,1347,1508,30
91738309389,91738309386,-3,1046,2913,30
91743864010,91743864013,3,2231,1390,30
91744111455,91744111450,-5,561,1880,30
91744481435,91744481430,-5,300,1692,30
91747164535,91747164530,-5,952,2491,30
91749456330,91749456325,-5,959,2722,30
91749540641,91749540638,-3,220,1155,30
91753132425,91753132422,-3,995,2443,30
91753183858,91753183849,-9,422,1049,30
91764932551,91764932548,-3,1312,2539,30
91766461479,91766461473,-6,1040,4300,30
91769105682,91769105679,-3,1108,2325,30
91776092789,91776092785,-4,713,2556,30
91776241756,91776241767,11,722,2246,30
91777809000,91777808990,-10,1098,3333,30
91778099247,91778099242,-5,886,2387,30
91780473027,91780473022,-5,1530,3235,30
91780745719,91780745714,-5,1274,2979,30
91781989962,91781989962,0,963,2136,30
91784157391,91784157383,-8,992,2930,30
91786455822,91786455819,-3,1254,1583,30
91787411525,91787411521,-4,1023,3201,30
91795899089,91795899090,1,1670,1852,30
91797258355,91797258350,-5,803,1775,30
91799156485,91799156478,-7,1159,3345,30
91804603582,91804603578,-4,505,3030,30
91804640898,91804640914,16,1501,3645,30
91814054453,91814054450,-3,1049,2847,30
91816539340,91816539341,1,1454,1705,30
91818499094,91818499091,-3,1126,2800,30
91818743676,91818743693,17,1015,3231,30
91825362905,91825362902,-3,2609,5815,30
91827545691,91827545687,-4,952,1826,30
91828858945,91828858939,-6,1094,3010,30
91829077223,91829077217,-6,764,2738,30
91833569252,91833569247,-5,1015,2978,30
91834811981,91834811975,-6,968,2314,30
91843410942,91843410955,13,11838,38046,30
91846030106,91846030103,-3,1050,2619,30
91847868366,91847868363,-3,1090,3261,30
91848473810,91848473827,17,9,452,30
91852773515,91852773510,-5,966,2681,30
91853088373,91853088369,-4,1051,2149,30
91853390121,91853390141,20,315,1860,30
91858110105,91858110093,-12,1126,3176,30
91861651791,91861651786,-5,900,3161,30
91862622217,91862622213,-4,1016,2705,30
91863850773,91863850767,-6,900,2284,30
91869799635,91869799630,-5,758,3249,30
91880085051,91880085046,-5,1550,3292,30
91883131846,91883131853,7,1727,1233,30
91888275878,91888275873,-5,1171,3363,30
91891598187,91891598182,-5,1187,4194,30
91895372223,91895372219,-4,1081,2453,30
91897365400,91897365394,-6,906,3248,30
91900836410,91900836405,-5,675,2501,30
91903178718,91903178714,-4,1002,3623,30
91911479999,91911479994,-5,943,2611,30
91914656843,91914656838,-5,1061,3678,30
91914852179,91914852193,14,305,1583,30
91916823719,91916823715,-4,742,2149,30
91917025002,91917024993,-9,64,1272,30
91927908782,91927908777,-5,816,1878,30
91930016680,91930016661,-19,129,935,30
91933799132,91933799133,1,3655,3668,30
91938294547,91938294542,-5,990,2262,30
91938916655,91938916650,-5,1709,3141,30
91942489531,91942489526,-5,1074,3401,30
91943669584,91943669575,-9,947,3044,30
91944067631,91944067623,-8,1152,2444,30
91951894941,91951894937,-4,903,2805,30
91955099383,91955099378,-5,907,2984,30
91955396187,91955396181,-6,1233,2305,30
91960383875,91960383875,0,1721,1411,30
91964739893,91964739888,-5,999,3340,30
91965287162,91965287143,-19,1026,3694,30
91965364322,91965364343,21,626,2633,30
91967310621,91967310617,-4,831,1852,30
91968003662,91968003658,-4,1158,2543,30
91970151922,91970151923,1,1059,1145,30
91972918318,91972918314,-4,1040,2146,30
91974518561,91974518557,-4,1460,2557,30
91981905370,91981905366,-4,947,2383,30
91984364738,91984364737,-1,857,1892,30
91987166490,91987166486,-4,1381,3864,30
91999190815,91999190806,-9,490,3133,30
92003464918,92003464914,-4,882,2790,30
92016553243,92016553238,-5,742,2499,30
92016836526,92016836522,-4,1145,2603,30
92020906099,92020906094,-5,1274,2102,30
92021369648,92021369644,-4,979,3221,30
92023240106,92023240103,-3,1239,2979,30
92025300897,92025300896,-1,2009,3068,30
92030471396,92030471393,-3,1333,3698,30
92030966738,92030966732,-6,997,3107,30
92041947585,92041947581,-4,884,2702,30
92044804786,92044804782,-4,1521,2810,30
92047786704,92047786699,-5,2073,6813,30
92048879471,92048879467,-4,916,3725,30
92049252114,92049252110,-4,445,721,30
92054117281,92054117275,-6,854,2014,30
92064998206,92064998198,-8,1031,3591,30
92065969392,92065969388,-4,985,2615,30
92069439346,92069439329,-17,2152,1211,30
92069501213,92069501207,-6,1616,2819,30
92071728078,92071728074,-4,1095,2463,30
92073400031,92073400028,-3,703,2395,30
92077806241,92077806236,-5,1460,3425,30
92079220905,92079220925,20,826,2341,30
92079410270,92079410264,-6,918,4263,30
92083318014,92083318011,-3,950,2447,30
92087148867,92087148864,-3,857,2614,30
92094164902,92094164896,-6,1814,6085,30
92098922767,92098922762,-5,870,2110,30
92102676793,92102676787,-6,1157,3788,30
92104093183,92104093178,-5,817,2738,30
92104187634,92104187632,-2,1026,2310,30
92116648042,92116648041,-1,1532,1865,30
92118714930,92118714922,-8,1158,3480,30
92120975350,92120975345,-5,1539,2868,30
92126795961,92126795955,-6,1225,4001,30
92128457331,92128457326,-5,1041,2293,30
92130690891,92130690885,-6,910,1433,30
92136913926,92136913921,-5,1304,3256,30
92140143050,92140143046,-4,1336,2148,30
92144942150,92144942154,4,1790,1700,30
92145155139,92145155136,-3,1051,3764,30
92147296159,92147296155,-4,858,2292,30
92147393954,92147393969,15,745,3490,30
92154827054,92154827047,-7,1456,5239,30
92160063355,92160063350,-5,1292,3320,30
92162897825,92162897822,-3,1509,3276,30
92169267419,92169267414,-5,1001,2688,30
92174844846,92174844842,-4,1506,4100,30
92175260865,92175260869,4,2637,1250,30
92175354991,92175354985,-6,820,1627,30
92176625186,92176625182,-4,1238,2806,30
92176740149,92176740144,-5,695,2598,30
92182307606,92182307602,-4,852,2940,30
92183971835,92183971840,5,214,915,30
92184352201,92184352195,-6,1348,3263,30
92187778696,92187778703,7,4148,1417,30
92197453262,92197453258,-4,835,1906,30
92198123497,92198123491,-6,976,4288,30
92198649602,92198649612,10,200,1316,30
92199683170,92199683154,-16,1086,2209,30
92201510700,92201510713,13,266,812,30
92202764939,92202764935,-4,989,2773,30
92203081000,92203080994,-6,1606,3810,30
92205369139,92205369140,1,1738,2210,30
92209321233,92209321230,-3,873,1976,30
92209824581,92209824576,-5,969,2508,30
92210184096,92210184091,-5,981,3517,30
92214272030,92214272025,-5,965,3716,30
92218992985,92218992981,-4,1257,4547,30
92221277431,92221277425,-6,1131,3931,30
92222526229,92222526224,-5,829,2908,30
92225575657,92225575653,-4,1465,3365,30
92226669639,92226669636,-3,898,1839,30
92229245678,92229245674,-4,1913,5204,30
92229822927,92229822926,-1,2544,3039,30
92232706150,92232706145,-5,1319,3590,30
92232800732,92232800741,9,30,634,30
92234620366,92234620362,-4,931,3157,30
92243899998,92243899994,-4,1161,2367,30
92245159381,92245159375,-6,1435,2544,30
92245981360,92245981356,-4,1254,2927,30
92248113357,92248113353,-4,943,2735,30
92255096366,92255096363,-3,967,2866,30
92259577592,92259577595,3,1469,976,30
92259886550,92259886555,5,2591,1647,30
92260077722,92260077717,-5,988,2581,30
92265142150,92265142147,-3,920,3336,30
92271657654,92271657650,-4,792,2019,30
92275102511,92275102505,-6,1299,2554,30
92279938527,92279938523,-4,811,2595,30
92284388243,92284388243,0,1724,2513,30
92284881369,92284881364,-5,1107,3398,30
92286235965,92286235966,1,779,1268,30
92289472507,92289472504,-3,878,2489,30
92290327747,92290327741,-6,757,3810,30
92294812882,92294812878,-4,3392,8349,30
92305478972,92305478966,-6,1322,3429,30
92307731909,92307731906,-3,1144,2532,30
92308732071,92308732066,-5,954,3243,30
92310244218,92310244214,-4,1309,2913,30
92311540674,92311540678,4,1360,1174,30
92311727656,92311727653,-3,1202,1848,30
92312546908,92312546905,-3,845,2431,30
92316535222,92316535219,-3,1080,3091,30
92320533041,92320533037,-4,1155,3198,30
92326062904,92326062907,3,54001,38733,30
92331265031,92331265028,-3,1204,1851,30
92334246579,92334246574,-5,744,2426,30
92334872166,92334872161,-5,1411,3498,30
92336730226,92336730221,-5,835,3386,30
92338784920,92338784916,-4,1359,3455,30
92343753870,92343753866,-4,1246,2972,30
92344267826,92344267846,20,76,785,30
92355153863,92355153859,-4,1452,3550,30
92356696320,92356696316,-4,1138,2648,30
92357959375,92357959371,-4,891,1771,30
92359456491,92359456487,-4,885,1903,30
92370345118,92370345121,3,1836,1588,30
92373711701,92373711696,-5,1058,3247,30
92374671895,92374671889,-6,969,2289,30
92375409774,92375409773,-1,941,2327,30
92378528797,92378528794,-3,1014,2432,30
92382087137,92382087133,-4,1053,2259,30
92385926975,92385926971,-4,961,1845,30
92387354650,92387354669,19,1424,1792,30
92396487499,92396487496,-3,670,1274,30
92398025225,92398025246,21,609,2820,30
92398152806,92398152801,-5,749,3456,30
92398859479,92398859474,-5,1220,3160,30
92403006934,92403006930,-4,1142,3242,30
92404739267,92404739262,-5,992,4082,30
92404989960,92404989953,-7,1217,3879,30
92411746095,92411746089,-6,1446,3592,30
92411900530,92411900547,17,783,1174,30
92417446449,92417446445,-4,954,1927,30
92432169957,92432169959,2,2226,1764,30
92439787083,92439787078,-5,1246,2767,30
92440027058,92440027061,3,55,920,30
92442445359,92442445354,-5,1365,2830,30
92442935087,92442935092,5,1732,1646,30
92444890961,92444890959,-2,778,3109,30
92446603737,92446603734,-3,1030,2743,30
92446791056,92446791049,-7,153,1084,30
92447421659,92447421646,-13,126,902,30
92449407735,92449407738,3,1683,1130,30
92452028294,92452028287,-7,735,3242,30
92454738286,92454738283,-3,1085,3289,30
92459283380,92459283377,-3,718,2215,30
92462259446,92462259444,-2,630,1366,30
92464602823,92464602822,-1,1220,3095,30
92464843992,92464843998,6,309,1140,30
92465779090,92465779085,-5,817,2901,30
92469876631,92469876629,-2,819,2587,30
92477266834,92477266833,-1,1094,2007,30
92477548051,92477548046,-5,923,3421,30
92480261716,92480261722,6,2106,1413,30
92482492323,92482492321,-2,1116,2551,30
92486281505,92486281518,13,1933,1458,30
92487078426,92487078420,-6,1574,3906,30
92487889968,92487889962,-6,1308,2818,30
92489487326,92489487322,-4,1070,2124,30
92489843985,92489844001,16,634,2478,30
92501930240,92501930235,-5,1075,1964,30
92502092315,92502092299,-16,134,946,30
92502491889,92502491885,-4,1060,2235,30
92503937802,92503937797,-5,882,2124,30
92506885526,92506885521,-5,1391,2281,30
92506988230,92506988226,-4,797,1629,30
92508721001,92508720998,-3,968,1897,30
92515882343,92515882338,-5,1541,5197,30
92517961665,92517961659,-6,1190,2606,30
92518607435,92518607454,19,395,1122,30
92523308687,92523308680,-7,1057,2881,30
92523401249,92523401265,16,1175,3584,30
92526147527,92526147523,-4,618,3402,30
92530980721,92530980718,-3,873,2937,30
92539565295,92539565290,-5,1444,3137,30
92540601110,92540601108,-2,1182,2759,30
92542130169,92542130149,-20,819,2784,30
92542361747,92542361766,19,463,855,30
92545116277,92545116270,-7,924,3155,30
92547905511,92547905507,-4,1008,2796,30
92550211343,92550211337,-6,1192,3609,30
92553328902,92553328896,-6,1319,3727,30
92557428733,92557428730,-3,1347,2362,30
92558365337,92558365332,-5,1204,3701,30
92564784187,92564784183,-4,898,2192,30
92571581054,92571581053,-1,37208,22680,30
92571823216,92571823212,-4,875,3159,30
92572169514,92572169510,-4,972,2573,30
92573862181,92573862178,-3,970,2148,30
92576511207,92576511205,-2,955,2635,30
92576819913,92576819906,-7,1010,3126,30
92580415233,92580415229,-4,884,1849,30
92581381422,92581381417,-5,1263,3665,30
92588826171,92588826175,4,2064,1505,30
92594008243,92594008238,-5,815,2869,30
92594286042,92594286025,-17,1402,3456,30
92596828753,92596828749,-4,1185,3516,30
92598064348,92598064343,-5,971,2639,30
92599325243,92599325237,-6,1417,4385,30
92601681414,92601681410,-4,854,2752,30
92601794620,92601794638,18,979,2920,30
92602731170,92602731167,-3,1465,3380,30
92603866890,92603866885,-5,901,2843,30
92604031457,92604031441,-16,131,504,30
92605903459,92605903455,-4,31851,2144,30
92607957523,92607957520,-3,1402,2158,30
92615611897,92615611893,-4,1010,4075,30
92617524673,92617524670,-3,7041,13194,30
92618381198,92618381206,8,5986,1887,30
92621788865,92621788861,-4,1084,2008,30
92623752110,92623752108,-2,1109,3132,30
92626101862,92626101857,-5,1115,2872,30
92629504536,92629504533,-3,1046,2399,30
92630159667,92630159679,12,646,3096,30
92634213607,92634213602,-5,638,2551,30
92634680163,92634680158,-5,1234,2282,30
92635931931,92635931927,-4,575,1851,30
92636471985,92636471977,-8,825,4300,30
92636847322,92636847311,-11,969,2679,30
92643297535,92643297530,-5,963,2825,30
92647364766,92647364759,-7,826,3234,30
92648780906,92648780901,-5,1125,2903,30
92649158893,92649158887,-6,651,2086,30
92652661982,92652661978,-4,1043,3565,30
92655100132,92655100126,-6,486,3161,30
92659142839,92659142842,3,1215,937,30
92663213797,92663213802,5,5185,1846,30
92670689331,92670689326,-5,960,2650,30
92672801070,92672801067,-3,621,1241,30
92673312443,92673312439,-4,1153,3558,30
92673670103,92673670097,-6,1244,4311,30
92674047644,92674047663,19,130,1233,30
92684504056,92684504061,5,3210,1249,30
92685559081,92685559078,-3,1116,2371,30
92686739505,92686739522,17,969,2665,30
92687747389,92687747387,-2,346,1017,30
92688719721,92688719737,16,924,1862,30
92693363410,92693363406,-4,739,2568,30
92700559921,92700559922,1,1963,1797,30
92700687652,92700687647,-5,984,2700,30
92708458202,92708458199,-3,1563,3718,30
92713667813,92713667806,-7,964,3096,30
92718416163,92718416167,4,2944,1299,30
92719267075,92719267071,-4,692,2546,30
92719298586,92719298605,19,872,1787,30
92719494002,92719493998,-4,749,2923,30
92721260005,92721260002,-3,789,2178,30
92725874043,92725874039,-4,705,2118,30
92729318119,92729318113,-6,1075,2510,30
92731469054,92731469062,8,5520,1945,30
92731720595,92731720594,-1,1075,1710,30
92732439375,92732439369,-6,652,1226,30
92734086779,92734086774,-5,905,2743,30
92735178998,92735178994,-4,960,2440,30
92737315311,92737315306,-5,926,2540,30
92737454628,92737454642,14,203,778,30
92742276463,92742276457,-6,1370,3094,30
92742540916,92742540925,9,78,589,30
92743401451,92743401445,-6,1102,4760,30
92753292346,92753292341,-5,1327,2859,30
92754375394,92754375383,-11,174,1035,30
92754653484,92754653498,14,913,2177,30
92758683527,92758683521,-6,872,2535,30
92758970217,92758970212,-5,1109,3506,30
92764325889,92764325868,-21,850,1514,30
92767772294,92767772295,1,1403,943,30
92774794530,92774794524,-6,842,2191,30
92774919882,92774919891,9,310,1141,30
92781908342,92781908337,-5,1236,3191,30
92784341509,92784341502,-7,796,2736,30
92784632043,92784632038,-5,1285,2976,30
92787854749,92787854755,6,1491,1527,30
92789065154,92789065149,-5,757,2031,30
92794638614,92794638610,-4,1054,2549,30
92798986429,92798986425,-4,1347,2719,30
92799045682,92799045667,-15,1042,3363,30
92800092267,92800092269,2,2115,2015,30
92810588102,92810588098,-4,994,2745,30
92810744762,92810744756,-6,1311,3633,30
92816959282,92816959278,-4,746,3135,30
92817700811,92817700799,-12,1290,3005,30
92818736386,92818736398,12,93,1208,30
92819740817,92819740810,-7,306,930,30
92821830738,92821830736,-2,825,2613,30
92822403811,92822403807,-4,2332,5244,30
92824594794,92824594790,-4,1045,3709,30
92829472195,92829472190,-5,1158,1925,30
92829629848,92829629869,21,1006,2796,30
92829684993,92829684990,-3,1328,3216,30
92829751005,92829750999,-6,791,2384,30
92829826339,92829826353,14,118,1399,30
92832479637,92832479632,-5,1137,2543,30
92833139177,92833139186,9,136,467,30
92834574883,92834574876,-7,1107,2783,30
92834662312,92834662301,-11,159,1100,30
92836032701,92836032695,-6,834,2581,30
92839060258,92839060254,-4,1011,2560,30
92845286447,92845286443,-4,1037,2688,30
92845625909,92845625906,-3,2315,5465,30
92849703655,92849703650,-5,571,1793,30
92853881102,92853881110,8,14796,1419,30
92857529168,92857529173,5,10870,32043,30
92868508842,92868508837,-5,1047,4047,30
92869899475,92869899483,8,2539,1224,30
92874440218,92874440218,0,1036,1048,30
92875386250,92875386254,4,1399,1346,30
92882166175,92882166170,-5,1237,3936,30
92882793314,92882793317,3,145,1042,30
92886662530,92886662534,4,4375,2445,30
92887743842,92887743835,-7,1351,2605,30
92887993834,92887993831,-3,1142,2697,30
92888192211,92888192209,-2,1300,2010,30
92888453414,92888453407,-7,1344,2788,30
92889358490,92889358486,-4,752,2574,30
92890234275,92890234254,-21,985,3836,30
92906521740,92906521734,-6,1215,3641,30
92906572738,92906572734,-4,236,1175,30
92910167701,92910167716,15,751,2042,30
92910453689,92910453690,1,1162,746,30
92921486901,92921486897,-4,1068,2878,30
92925382582,92925382576,-6,1078,3086,30
92926023858,92926023853,-5,1195,3686,30
92928267415,92928267410,-5,1097,2795,30
92929189897,92929189914,17,206,712,30
92931030688,92931030686,-2,833,2056,30
92935131166,92935131162,-4,985,3424,30
92937465987,92937465982,-5,333,2474,30
92946121739,92946121735,-4,839,2451,30
92946337661,92946337656,-5,1219,2847,30
92952121388,92952121395,7,2800,39194,30
92952397283,92952397278,-5,638,3061,30
92952762843,92952762838,-5,991,2378,30
92960918275,92960918272,-3,1022,2116,30
92962739814,92962739814,0,2301,3733,30
92974024152,92974024149,-3,1647,3437,30
92976765278,92976765274,-4,624,2627,30
92977080035,92977080034,-1,653,1762,30
92978720454,92978720450,-4,1442,3051,30
92981121775,92981121770,-5,703,2727,30
92984806330,92984806325,-5,927,2873,30
92988623509,92988623506,-3,421,2548,30
92989450043,92989450037,-6,162,1211,30
92995256875,92995256871,-4,1127,2275,30
92997211150,92997211148,-2,1171,3475,30
93002239587,93002239586,-1,627,1688,30
93006500494,93006500490,-4,702,1948,30
93007571246,93007571239,-7,881,1881,30
93011310133,93011310129,-4,1327,3251,30
93024201879,93024201874,-5,974,3313,30
93026056641,93026056647,6,1797,1146,30
93026659479,93026659474,-5,1061,3462,30
93030620697,93030620702,5,8939,5080,30
93032328391,93032328385,-6,695,1641,30
93036252326,93036252327,1,1016,1423,30
93036442860,93036442854,-6,1286,3420,30
93038653905,93038653901,-4,859,2436,30
93041440539,93041440536,-3,1114,3690,30
93043187304,93043187305,1,25625,20093,30
93053303658,93053303654,-4,979,1561,30
93062015422,93062015404,-18,855,463,30
93062898400,93062898392,-8,1391,3316,30
93065148710,93065148705,-5,1450,3583,30
93067836869,93067836864,-5,1098,3098,30
93070840919,93070840914,-5,1258,2818,30
93077005551,93077005546,-5,1106,3249,30
93081102138,93081102134,-4,781,3000,30
93084511441,93084511438,-3,946,3170,30
93091019121,93091019127,6,2641,1356,30
93094014623,93094014618,-5,1661,4178,30
93100792817,93100792814,-3,1233,2583,30
93102440830,93102440825,-5,683,2676,30
93111813109,93111813103,-6,991,2285,30
93116691107,93116691101,-6,501,1488,30
93119749806,93119749802,-4,1279,3037,30
93119911107,93119911125,18,1014,4697,30
93125225531,93125225527,-4,1120,2547,30
93128573833,93128573827,-6,1282,3658,30
93135816978,93135816967,-11,1940,846,30
93147456367,93147456363,-4,1150,2756,30
93149847479,93149847475,-4,1077,2285,30
93154091971,93154091966,-5,1058,2500,30
93160205410,93160205405,-5,971,3080,30
93160977907,93160977902,-5,876,2286,30
93162407422,93162407417,-5,623,1684,30
93163353860,93163353857,-3,28216,16939,30
93163522114,93163522109,-5,1107,3641,30
93166213722,93166213718,-4,1304,2854,30
93171581361,93171581357,-4,1122,2928,30
93179812278,93179812275,-3,1514,3386,30
93180581831,93180581826,-5,917,2795,30
93189199715,93189199708,-7,1358,7321,30
93192456805,93192456801,-4,832,1662,30
93194079269,93194079266,-3,1808,3698,30
93195140060,93195140054,-6,1362,2431,30
93199099977,93199099981,4,3581,2459,30
93200732853,93200732850,-3,1109,3054,30
93202059162,93202059150,-12,759,1627,30
93208281327,93208281322,-5,1259,3121,30
93208723636,93208723632,-4,1207,2661,30
93212796415,93212796412,-3,844,2985,30
93216807694,93216807689,-5,871,3069,30
93219132959,93219132953,-6,937,2625,30
93219277747,93219277730,-17,935,3063,30
93219441835,93219441852,17,292,870,30
93221287622,93221287619,-3,964,2744,30
93223035314,93223035310,-4,1407,3250,30
93226464796,93226464789,-7,863,5997,30
93228876831,93228876824,-7,786,2373,30
93231396934,93231396930,-4,1051,3191,30
93232153470,93232153466,-4,993,2344,30
93238502979,93238502977,-2,1013,2437,30
93257446449,93257446443,-6,895,2549,30
93258906055,93258906051,-4,707,2540,30
93267413882,93267413878,-4,1259,2709,30
93272876925,93272876921,-4,1428,3608,30
93278362250,93278362247,-3,1023,3031,30
93278591331,93278591350,19,321,1296,30
93281941697,93281941689,-8,1228,3318,30
93282822759,93282822758,-1,932,1316,30
93284909570,93284909567,-3,1110,2800,30
93287611882,93287611887,5,2114,1033,30
93298153059,93298153057,-2,493,2059,30
93303601773,93303601768,-5,1101,2038,30
93306202018,93306202011,-7,966,3181,30
93319191990,93319191986,-4,687,1977,30
93328739559,93328739557,-2,1164,2419,30
93334124009,93334124005,-4,1197,2743,30
93335327489,93335327484,-5,949,3074,30
93338903757,93338903753,-4,775,1386,30
93339399348,93339399343,-5,1066,2742,30
93345463479,93345463472,-7,910,3146,30
93347328372,93347328378,6,4831,1753,30
93348458481,93348458481,0,1141,1909,30
93348546139,93348546128,-11,19391,19938,30
93350108599,93350108594,-5,622,3217,30
93351258454,93351258449,-5,824,3304,30
93351803011,93351803005,-6,1028,2755,30
93352681931,93352681938,7,6016,2779,30
93355024442,93355024438,-4,1250,3421,30
93356295802,93356295798,-4,1323,2718,30
93356469459,93356469456,-3,1600,3863,30
93357715702,93357715700,-2,1005,1720,30
93357832077,93357832073,-4,1242,3228,30
93370597003,93370596999,-4,1159,1670,30
93371426131,93371426124,-7,905,5622,30
93377386193,93377386190,-3,1191,2069,30
93377698111,93377698107,-4,906,2035,30
93378684213,93378684215,2,2106,1437,30
93381341814,93381341810,-4,589,1551,30
93382852502,93382852497,-5,1345,3211,30
93387638844,93387638845,1,4613,6633,30
93390250302,93390250298,-4,980,3028,30
93391079789,93391079795,6,3074,1322,30
93391264650,93391264647,-3,1385,3532,30
93399421515,93399421510,-5,916,2254,30
93399675218,93399675201,-17,856,2144,30
93400793082,93400793079,-3,1252,2910,30
93401547668,93401547686,18,544,1727,30
93407112635,93407112633,-2,1760,2781,30
93420420402,93420420403,1,1086,1022,30
93422392325,93422392321,-4,1202,3625,30
93424650502,93424650498,-4,1684,3484,30
93424869470,93424869466,-4,876,1890,30
93425932478,93425932474,-4,1308,3132,30
93429131789,93429131785,-4,922,1958,30
93433013148,93433013144,-4,1568,4725,30
93446511150,93446511147,-3,1396,2731,30
93452354784,93452354779,-5,1429,3293,30
93453021193,93453021185,-8,1088,2709,30
93466346270,93466346273,3,1395,1854,30
93467036729,93467036722,-7,791,2185,30
93468363545,93468363540,-5,987,2112,30
93476418750,93476418745,-5,793,2387,30
93482062425,93482062418,-7,531,1853,30
93485175849,93485175844,-5,1268,3902,30
93487411630,93487411627,-3,1474,2423,30
93488691211,93488691206,-5,1184,3013,30
93494465850,93494465846,-4,1398,3512,30
93498795041,93498795037,-4,1031,3582,30
93499414532,93499414550,18,311,1917,30
93502555881,93502555878,-3,1232,3411,30
93513213909,93513213902,-7,1071,3424,30
93518292509,93518292505,-4,1200,2933,30
93519700597,93519700592,-5,1321,3435,30
93519985881,93519985897,16,389,1264,30
93522882118,93522882113,-5,1077,3161,30
93524184853,93524184849,-4,1162,3012,30
93524448779,93524448758,-21,1263,3944,30
93530468614,93530468609,-5,1181,3480,30
93530548025,93530548044,19,327,980,30
93531009873,93531009853,-20,159,1253,30
93532168871,93532168865,-6,887,2558,30
93535216713,93535216710,-3,1128,2758,30
93540160534,93540160528,-6,793,3006,30
93543327923,93543327921,-2,1266,2835,30
93546769260,93546769255,-5,1201,2302,30
93553303921,93553303921,0,1846,1206,30
93559164878,93559164874,-4,1001,3008,30
93563667346,93563667353,7,3681,1320,30
93566307035,93566307033,-2,814,1613,30
93567477776,93567477779,3,145,655,30
93569220438,93569220431,-7,1137,3006,30
93572488847,93572488847,0,1158,1523,30
93579225671,93579225669,-2,893,3245,30
93579423018,93579423026,8,147,1332,30
93582364369,93582364366,-3,1203,3235,30
93583513860,93583513878,18,458,1721,30
93587669290,93587669284,-6,758,1987,30
93587802905,93587802907,2,1588,1677,30
93591005251,93591005247,-4,1437,3309,30
93603404589,93603404602,13,6963,46841,30
93604085341,93604085339,-2,1551,1357,30
93605488104,93605488114,10,13434,30778,30
93606485335,93606485313,-22,1447,1711,30
93612710279,93612710278,-1,765,1271,30
93613129834,93613129834,0,960,2030,30
93614404419,93614404416,-3,969,2718,30
93619345537,93619345533,-4,1838,4267,30
93619796249,93619796244,-5,905,2871,30
93622483549,93622483545,-4,1307,2874,30
93623228909,93623228905,-4,882,3178,30
93633975426,93633975424,-2,1046,2218,30
93638562872,93638562869,-3,792,2381,30
93650501046,93650501042,-4,959,2083,30
93658244099,93658244095,-4,1259,2910,30
93661906550,93661906546,-4,1340,2930,30
93665920875,93665920870,-5,1164,2701,30
93667217210,93667217203,-7,1320,2935,30
93668526097,93668526093,-4,1558,2945,30
93668563199,93668563192,-7,803,2484,30
93670269444,93670269440,-4,921,1937,30
93670653403,93670653400,-3,978,2031,30
93670866116,93670866132,16,197,1231,30
93671859801,93671859818,17,94,598,30
93678652151,93678652148,-3,945,2469,30
93681620053,93681620049,-4,856,2215,30
93687231896,93687231892,-4,722,3037,30
93688188623,93688188617,-6,666,2641,30
93688730676,93688730670,-6,795,2157,30
93690799614,93690799612,-2,886,2298,30
93692455422,93692455417,-5,748,2794,30
93692507905,93692507917,12,193,966,30
93707094592,93707094587,-5,914,3628,30
93712608547,93712608535,-12,29759,15383,30
93715148741,93715148742,1,35597,37005,30
93723432177,93723432160,-17,752,378,30
93732750743,93732750749,6,3451,1320,30
93739517139,93739517134,-5,1163,3590,30
93740398628,93740398622,-6,1019,3109,30
93745113985,93745113981,-4,918,3319,30
93746754882,93746754877,-5,914,2728,30
93746823304,93746823317,13,156,912,30
93749381891,93749381886,-5,817,2281,30
93757396637,93757396634,-3,1218,3325,30
93759647640,93759647635,-5,1436,3925,30
93762212441,93762212437,-4,1958,3891,30
93772726657,93772726652,-5,993,2201,30
93777975662,93777975658,-4,926,3449,30
93782712966,93782712962,-4,1033,2415,30
93783563142,93783563137,-5,1197,2906,30
93788503639,93788503632,-7,623,3824,30
93790497326,93790497320,-6,1542,4209,30
93791676367,93791676364,-3,1223,2615,30
93791844162,93791844158,-4,848,2340,30
93792125656,93792125679,23,288,910,30
93798974250,93798974246,-4,1257,3247,30
93801944118,93801944113,-5,981,1975,30
93804849480,93804849474,-6,1193,3147,30
93807656483,93807656478,-5,1507,4585,30
93808051039,93808051034,-5,630,2036,30
93810135782,93810135776,-6,1391,4245,30
93816738538,93816738539,1,12018,14675,30
93822877466,93822877462,-4,934,2159,30
93835061672,93835061670,-2,975,2465,30
93837657594,93837657591,-3,1349,3172,30
93842390218,93842390216,-2,860,1933,30
93843625309,93843625305,-4,1474,3204,30
93847983645,93847983640,-5,1244,3525,30
93849743018,93849743014,-4,993,2015,30
93854686101,93854686100,-1,1066,1997,30
93856172872,93856172889,17,660,2467,30
93856448576,93856448557,-19,394,1395,30
93856484313,93856484322,9,183,1152,30
93863061594,93863061599,5,2125,1025,30
93863503875,93863503871,-4,1682,3570,30
93864662444,93864662438,-6,861,2567,30
93868071135,93868071131,-4,754,2163,30
93868721791,93868721786,-5,1019,2234,30
93869853439,93869853434,-5,979,2204,30
93872106142,93872106134,-8,1186,3760,30
93880887418,93880887414,-4,1265,2670,30
93883075921,93883075917,-4,1015,2782,30
93884758278,93884758275,-3,549,1169,30
93887313760,93887313754,-6,1195,3095,30
93888082130,93888082125,-5,1272,3259,30
93889583018,93889583014,-4,1055,2422,30
93890732783,93890732777,-6,887,3009,30
93893684567,93893684558,-9,32511,15604,30
93893873884,93893873880,-4,895,2306,30
93894185043,93894185022,-21,1148,1835,30
93894714412,93894714409,-3,294,697,30
93896507413,93896507407,-6,1045,2291,30
93899956687,93899956682,-5,675,2631,30
93899990149,93899990145,-4,1301,3170,30
93900257626,93900257621,-5,1201,4231,30
93900313634,93900313630,-4,1127,3886,30
93905217767,93905217762,-5,1740,3179,30
93913628615,93913628611,-4,969,4155,30
93922634230,93922634225,-5,404,1476,30
93923108055,93923108052,-3,1081,3213,30
93925044203,93925044198,-5,673,2374,30
93926196015,93926196010,-5,789,1176,30
93927725537,93927725533,-4,1140,3737,30
93930684391,93930684387,-4,927,3184,30
93930795434,93930795451,17,166,689,30
93931124803,93931124806,3,4057,3539,30
93931562415,93931562409,-6,987,3401,30
93933195854,93933195852,-2,898,2439,30
93933232647,93933232643,-4,1111,2764,30
93934377807,93934377802,-5,619,2126,30
93934649464,93934649460,-4,1516,3382,30
93935543402,93935543399,-3,1021,2974,30
93940418721,93940418714,-7,1006,3127,30
93940745481,93940745494,13,99,902,30
93941398169,93941398150,-19,1378,2362,30
93948929228,93948929232,4,3214,1508,30
93949248514,93949248510,-4,1032,2928,30
93954149602,93954149601,-1,633,1148,30
93955394475,93955394470,-5,1076,2731,30
93956728459,93956728454,-5,1226,2558,30
93957325734,93957325731,-3,758,1876,30
93957919451,93957919446,-5,1312,3078,30
93958159331,93958159337,6,169,870,30
93958316348,93958316363,15,325,1360,30
93958552306,93958552304,-2,1099,3379,30
93960029135,93960029129,-6,1195,2978,30
93962378757,93962378752,-5,863,3304,30
93973595891,93973595886,-5,1340,3852,30
93976988443,93976988446,3,1768,1770,30
93977520918,93977520913,-5,817,3319,30
93988446582,93988446587,5,9686,5878,30
93988524658,93988524675,17,361,2133,30
94002036094,94002036093,-1,1261,1981,30
94002089821,94002089817,-4,1140,2176,30
94005068973,94005068967,-6,1132,2840,30
94008660162,94008660158,-4,925,2019,30
94008807066,94008807055,-11,1255,3400,30
94010434291,94010434287,-4,785,2616,30
94010847195,94010847190,-5,801,1949,30
94011344592,94011344573,-19,689,2186,30
94014962154,94014962159,5,1661,1497,30
94019264744,94019264741,-3,1054,2446,30
94021149935,94021149928,-7,618,2008,30
94034717418,94034717415,-3,1595,3187,30
94034876791,94034876788,-3,797,2628,30
94040145005,94040145002,-3,1242,2500,30
94040265557,94040265553,-4,1364,4248,30
94041005650,94041005645,-5,751,3428,30
94043275946,94043275943,-3,579,1372,30
94044857419,94044857421,2,1955,1369,30
94050345462,94050345458,-4,1190,2627,30
94052760536,94052760533,-3,1410,3066,30
94053483139,94053483133,-6,1367,2800,30
94053528485,94053528486,1,1323,1288,30
94056123582,94056123579,-3,843,1705,30
94069260415,94069260411,-4,1183,2185,30
94069618994,94069618976,-18,183,784,30
94073668632,94073668629,-3,1353,3083,30
94075191957,94075191953,-4,687,3200,30
94075384426,94075384424,-2,685,2004,30
94079400664,94079400661,-3,1090,3507,30
94080764417,94080764438,21,826,2308,30
94081675074,94081675069,-5,1492,3347,30
94082108589,94082108583,-6,942,3772,30
94083102515,94083102511,-4,947,3147,30
94084410490,94084410486,-4,72,1041,30
94089284451,94089284445,-6,1005,2237,30
94090218366,94090218361,-5,1057,3613,30
94090352400,94090352419,19,224,1090,30
94095014085,94095014081,-4,1536,2578,30
94095593275,94095593288,13,749,2642,30
94101146803,94101146796,-7,1140,2236,30
94101591744,94101591739,-5,1334,4131,30
94101942314,94101942306,-8,807,3274,30
94103576026,94103576023,-3,1149,3184,30
94103961686,94103961682,-4,1363,3254,30
94107658993,94107658989,-4,1133,2417,30
94112421155,94112421151,-4,718,2577,30
94113730093,94113730088,-5,747,2040,30
94119693019,94119693014,-5,999,3011,30
94122374905,94122374900,-5,1370,4010,30
94123755839,94123755833,-6,710,2023,30
94124232308,94124232322,14,717,2451,30
94125693991,94125693985,-6,816,3052,30
94126604135,94126604130,-5,976,3129,30
94126930168,94126930185,17,293,1234,30
94128306554,94128306549,-5,1022,2267,30
94129903038,94129903040,2,1635,1530,30
94130990752,94130990746,-6,1250,3206,30
94131023769,94131023762,-7,1359,3967,30
94136278048,94136278042,-6,1035,2944,30
94136725034,94136725030,-4,1347,2577,30
94142356257,94142356253,-4,1304,2366,30
94142413644,94142413639,-5,1147,3698,30
94144465050,94144465045,-5,1036,4573,30
94145186170,94145186166,-4,1315,2492,30
94146623288,94146623282,-6,1098,2564,30
94148485431,94148485436,5,2107,1755,30
94150689796,94150689791,-5,1303,3093,30
94151114666,94151114653,-13,866,3232,30
94153219126,94153219121,-5,1034,2433,30
94153678191,94153678186,-5,951,2145,30
94155245741,94155245736,-5,899,3462,30
94157898579,94157898579,0,2329,3060,30
94169129807,94169129803,-4,804,3115,30
94173891097,94173891093,-4,1198,2549,30
94176495078,94176495081,3,32811,31925,30
94176969271,94176969266,-5,1192,1736,30
94180450962,94180450958,-4,1142,2567,30
94180986370,94180986365,-5,1063,3142,30
94181156985,94181157003,18,508,1167,30
94188704571,94188704569,-2,860,3038,30
94194083089,94194083089,0,1440,1722,30
94197572267,94197572261,-6,1236,3109,30
94197971947,94197971953,6,4134,1999,30
94203199389,94203199386,-3,1432,3353,30
94208628641,94208628641,0,2186,2590,30
94209173614,94209173610,-4,1339,2855,30
94212463800,94212463794,-6,1102,3104,30
94215620319,94215620316,-3,953,2599,30
94217895986,94217895986,0,14608,17245,30
94219895333,94219895327,-6,1392,2775,30
94222871261,94222871255,-6,1075,3370,30
94224798103,94224798110,7,2191,771,30
94224916606,94224916605,-1,720,1892,30
94230877613,94230877610,-3,1120,1955,30
94231578391,94231578389,-2,925,3169,30
94236189142,94236189137,-5,998,2644,30
94237388008,94237388002,-6,1035,2574,30
94237445410,94237445405,-5,1361,3170,30
94238333670,94238333665,-5,1016,1807,30
94258323615,94258323618,3,1455,1210,30
94259774351,94259774346,-5,1337,3817,30
94270221342,94270221334,-8,700,5223,30
94270810033,94270810021,-12,885,2100,30
94272051752,94272051747,-5,926,2644,30
94272779840,94272779826,-14,106,685,30
94273171880,94273171875,-5,1054,3690,30
94277157657,94277157652,-5,989,3906,30
94279063348,94279063343,-5,1318,2131,30
94289509816,94289509811,-5,1334,3718,30
94297746854,94297746850,-4,654,1893,30
94298598922,94298598938,16,268,1262,30
94300098123,94300098122,-1,948,2343,30
94304636937,94304636944,7,2095,1173,30
94307778601,94307778597,-4,1515,3232,30
94307933473,94307933470,-3,910,3639,30
94309463160,94309463144,-16,103,1286,30
94311846543,94311846539,-4,908,2492,30
94315080282,94315080279,-3,726,2824,30
94315334417,94315334411,-6,1287,3483,30
94318806385,94318806381,-4,969,2023,30
94321436894,94321436890,-4,1370,3921,30
94321769567,94321769561,-6,2019,4575,30
94325069499,94325069497,-2,1144,2042,30
94326754565,94326754571,6,1901,1313,30
94327965058,94327965054,-4,1451,3049,30
94332598726,94332598722,-4,1364,3515,30
94334390153,94334390149,-4,990,2715,30
94338857857,94338857853,-4,1051,2536,30
94343509782,94343509798,16,1207,2664,30
94344552524,94344552518,-6,995,3282,30
94345061334,94345061332,-2,1058,2254,30
94348389399,94348389395,-4,1321,2256,30
94348637030,94348637027,-3,941,2268,30
94351274516,94351274513,-3,845,2402,30
94352273627,94352273623,-4,719,2422,30
94354299547,94354299542,-5,735,3697,30
94355577223,94355577217,-6,1091,2625,30
94356734897,94356734890,-7,1170,3040,30
94358856582,94358856578,-4,907,2056,30
94361743047,94361743042,-5,775,2701,30
94364576029,94364576012,-17,1474,865,30
94369552112,94369552113,1,1841,1874,30
94369958884,94369958890,6,782,251,30
94372787587,94372787582,-5,772,2220,30
94379026032,94379026051,19,395,812,30
94381477639,94381477634,-5,922,2562,30
94383428604,94383428600,-4,890,2628,30
94388245339,94388245334,-5,1248,3353,30
94394402395,94394402390,-5,1415,3243,30
94405336165,94405336160,-5,916,2070,30
94406258206,94406258202,-4,1129,4000,30
94408567695,94408567689,-6,1246,2980,30
94408939482,94408939487,5,1777,1214,30
94410718227,94410718222,-5,1198,3851,30
94413000933,94413000930,-3,1175,3687,30
94413359573,94413359579,6,5866,1766,30
94417869973,94417869969,-4,1109,2651,30
94420890707,94420890704,-3,1375,2607,30
94424299446,94424299442,-4,817,2257,30
94430545367,94430545363,-4,923,2583,30
94431868566,94431868559,-7,711,1877,30
94436017900,94436017895,-5,794,1570,30
94436265721,94436265727,6,6003,3373,30
94438053931,94438053935,4,3956,3070,30
94438623347,94438623344,-3,856,2561,30
94439147558,94439147553,-5,1250,2784,30
94440039829,94440039825,-4,863,2246,30
94444099038,94444099033,-5,1064,3357,30
94444750807,94444750803,-4,940,2474,30
94446107211,94446107227,16,263,657,30
94449920915,94449920915,0,923,1125,30
94452531621,94452531617,-4,443,1514,30
94453216887,94453216891,4,31302,29124,30
94458076050,94458076045,-5,773,3248,30
94460633040,94460633033,-7,1058,8158,30
94461599968,94461599965,-3,1228,2120,30
94461894485,94461894481,-4,1117,1722,30
94465257986,94465257983,-3,912,3090,30
94470552206,94470552203,-3,618,1009,30
94471147438,94471147433,-5,675,3043,30
94471247586,94471247606,20,734,3275,30
94473274807,94473274802,-5,1452,3881,30
94485049518,94485049513,-5,1391,3136,30
94486744174,94486744168,-6,972,2927,30
94487228371,94487228350,-21,90,569,30
94489208015,94489208012,-3,1032,3737,30
94491206431,94491206427,-4,788,2970,30
94494050899,94494050894,-5,1048,3887,30
94495432274,94495432266,-8,1277,3522,30
94514889456,94514889452,-4,925,3382,30
94519083537,94519083536,-1,1275,2716,30
94521708635,94521708630,-5,764,2640,30
94526418026,94526418020,-6,2205,5748,30
94528268302,94528268296,-6,1210,3164,30
94538707330,94538707326,-4,1117,2743,30
94541728377,94541728395,18,17498,23578,30
94543653255,94543653253,-2,1707,2851,30
94547957798,94547957793,-5,876,3047,30
94548434921,94548434918,-3,733,2246,30
94549652629,94549652627,-2,1227,2113,30
94557065976,94557065966,-10,833,4038,30
94566488097,94566488091,-6,977,3760,30
94566933786,94566933783,-3,889,2358,30
94576000074,94576000069,-5,1293,2978,30
94581325829,94581325826,-3,919,3449,30
94585629708,94585629706,-2,817,1802,30
94586706824,94586706838,14,206,900,30
94588047093,94588047090,-3,854,2736,30
94602497651,94602497646,-5,1322,2220,30
94612863246,94612863247,1,693,1589,30
94616851195,94616851190,-5,685,2142,30
94618991386,94618991381,-5,903,2177,30
94621846959,94621846956,-3,843,2325,30
94625526787,94625526786,-1,1501,2023,30
94626148126,94626148122,-4,1183,2831,30
94626207495,94626207489,-6,1135,2901,30
94626238879,94626238875,-4,1227,3699,30
94628623479,94628623474,-5,1662,3126,30
94644804951,94644804945,-6,640,3417,30
94644915226,94644915241,15,719,2201,30
94648043599,94648043593,-6,1201,2900,30
94650820135,94650820133,-2,1033,1787,30
94653494134,94653494129,-5,1091,2658,30
94654619903,94654619897,-6,1054,2943,30
94655842291,94655842285,-6,968,2789,30
94660593034,94660593015,-19,1461,1715,30
94661638967,94661638962,-5,1004,2655,30
94661682762,94661682746,-16,948,2582,30
94664936862,94664936857,-5,1133,3213,30
94665825070,94665825066,-4,453,1236,30
94667037421,94667037417,-4,5310,12485,30
94667918293,94667918289,-4,768,2569,30
94671775766,94671775761,-5,1624,3032,30
94674215383,94674215383,0,1716,2337,30
94676822933,94676822930,-3,1394,3009,30
94679304797,94679304792,-5,1009,2693,30
94679379547,94679379543,-4,1400,2925,30
94681601452,94681601446,-6,79,824,30
94684183666,94684183667,1,3069,3803,30
94685371962,94685371959,-3,788,2812,30
94690138045,94690138041,-4,1412,3290,30
94695464427,94695464422,-5,885,2009,30
94696068681,94696068679,-2,1230,1865,30
94698373692,94698373689,-3,1084,2903,30
94706483600,94706483593,-7,1204,3494,30
94712301107,94712301103,-4,1474,2729,30
94716568965,94716568965,0,3106,4021,30
94718758663,94718758658,-5,1283,4905,30
94719890879,94719890873,-6,1368,2970,30
94721314261,94721314257,-4,1075,2188,30
94721568534,94721568530,-4,933,2840,30
94725498218,94725498213,-5,804,1977,30
94725772368,94725772355,-13,1085,3546,30
94726350121,94726350116,-5,1195,3486,30
94736832751,94736832746,-5,999,3169,30
94742457201,94742457197,-4,1096,2927,30
94744571002,94744570998,-4,742,2842,30
94747653876,94747653870,-6,982,4153,30
94750239476,94750239471,-5,1749,5795,30
94751952086,94751952081,-5,1185,3422,30
94757816899,94757816895,-4,1549,3957,30
94759315999,94759315994,-5,984,2853,30
94759909633,94759909617,-16,159,1295,30
94760152137,94760152131,-6,1173,3840,30
94760926035,94760926037,2,20945,37772,30
94762040113,94762040109,-4,1366,3995,30
94762446315,94762446330,15,1167,3152,30
94762634145,94762634141,-4,976,3571,30
94763102466,94763102462,-4,1053,3140,30
94763445370,94763445366,-4,1162,3473,30
94764420697,94764420705,8,1115,488,30
94766075235,94766075215,-20,14,743,30
94773584769,94773584764,-5,1024,2488,30
94776753157,94776753153,-4,1239,5444,30
94778631185,94778631181,-4,863,2397,30
94782652972,94782652989,17,1334,3426,30
94786465050,94786465043,-7,1188,2195,30
94787551379,94787551374,-5,704,2378,30
94788998412,94788998409,-3,866,2140,30
94789028916,94789028932,16,371,1658,30
94795589679,94795589675,-4,781,3014,30
94797205802,94797205807,5,2058,1138,30
94797319018,94797319013,-5,805,2344,30
94800265431,94800265426,-5,1624,3866,30
94800587670,94800587666,-4,818,2038,30
94801345564,94801345583,19,1770,4180,30
94808060960,94808060958,-2,2444,4591,30
94809963294,94809963289,-5,956,2952,30
94814984096,94814984091,-5,1110,3751,30
94817758746,94817758742,-4,1404,3455,30
94827747666,94827747664,-2,1253,3040,30
94829064886,94829064882,-4,1013,2963,30
94829412953,94829412951,-2,83,882,30
94830964467,94830964459,-8,973,3756,30
94833375506,94833375501,-5,882,3284,30
94836366306,94836366299,-7,656,2250,30
94839281233,94839281229,-4,1113,2459,30
94840297355,94840297349,-6,795,3238,30
94841638367,94841638361,-6,1030,2441,30
94847187028,94847187023,-5,586,2507,30
94848696911,94848696906,-5,974,2616,30
94852490745,94852490740,-5,1035,2474,30
94859092265,94859092261,-4,1084,2302,30
94860468077,94860468073,-4,1055,2005,30
94865002002,94865001997,-5,999,2282,30
94865418330,94865418350,20,1099,3537,30
94867576934,94867576931,-3,931,2228,30
94869282234,94869282229,-5,720,2295,30
94869921857,94869921837,-20,167,1200,30
94872835930,94872835926,-4,1893,3936,30
94883074067,94883074065,-2,1109,3150,30
94884477254,94884477255,1,3159,2283,30
94887734596,94887734592,-4,1443,3376,30
94888409734,94888409729,-5,934,2873,30
94888689277,94888689273,-4,1274,2831,30
94891300371,94891300365,-6,831,2849,30
94892094839,94892094834,-5,473,1939,30
94892182938,94892182954,16,211,573,30
94892724096,94892724101,5,2236,1195,30
94895969621,94895969616,-5,672,1293,30
94897970497,94897970514,17,946,2631,30
94898499788,94898499782,-6,1254,3122,30
94902851381,94902851377,-4,1182,3011,30
94907519371,94907519367,-4,705,3925,30
94908315474,94908315454,-20,257,1912,30
94912086579,94912086578,-1,1025,1254,30
94912558362,94912558357,-5,935,2954,30
94913152178,94913152174,-4,1085,2751,30
94916345545,94916345540,-5,1021,2855,30
94921910907,94921910902,-5,296,1674,30
94926596102,94926596102,0,900,1664,30
94930287700,94930287694,-6,798,2755,30
94931900709,94931900715,6,14865,7612,30
94936779651,94936779658,7,150,1115,30
94938315779,94938315794,15,725,2419,30
94943457282,94943457290,8,1482,716,30
94945464150,94945464145,-5,1375,4975,30
94945583819,94945583813,-6,687,2286,30
94945874625,94945874611,-14,1309,2519,30
94946313082,94946313081,-1,732,3169,30
94946507748,94946507760,12,591,1427,30
94950613912,94950613903,-9,731,2874,30
94951008260,94951008275,15,111,1146,30
94951075450,94951075469,19,348,2004,30
94955504571,94955504576,5,2651,2077,30
94960059521,94960059526,5,3514,1524,30
94963396863,94963396859,-4,1167,2599,30
94965609202,94965609194,-8,1453,3091,30
94965645238,94965645238,0,1170,1842,30
94967672078,94967672071,-7,873,2444,30
94974544870,94974544865,-5,917,3576,30
94976845051,94976845048,-3,1322,3277,30
94977421830,94977421826,-4,753,3274,30
94980401646,94980401637,-9,1346,3426,30
94981293609,94981293611,2,5015,18652,30
94986228555,94986228550,-5,891,2795,30
94988111559,94988111554,-5,1173,3229,30
94988366019,94988366010,-9,1037,3041,30
94989883784,94989883778,-6,1387,4222,30
94993648578,94993648574,-4,982,3119,30
94997824994,94997824989,-5,700,2028,30
94999919400,94999919397,-3,1468,2362,30
95001619414,95001619409,-5,1518,4087,30
95007563402,95007563396,-6,1011,2766,30
95007727756,95007727753,-3,1053,2571,30
95011663502,95011663495,-7,1362,4123,30
95012518770,95012518767,-3,1064,1911,30
95015914899,95015914894,-5,1181,2048,30
95016978283,95016978279,-4,876,3344,30
95022182095,95022182093,-2,689,2191,30
95023019280,95023019296,16,676,2978,30
95023968546,95023968541,-5,1076,2703,30
95024651130,95024651126,-4,68,1088,30
95027362077,95027362074,-3,133,635,30
95027881360,95027881359,-1,170,1047,30
95029957733,95029957727,-6,1344,3426,30
95030654106,95030654104,-2,1066,1962,30
95033645846,95033645842,-4,875,2875,30
95034191226,95034191229,3,1437,1432,30
95038057662,95038057658,-4,1342,3096,30
95039626599,95039626592,-7,1027,3308,30
95044148274,95044148270,-4,1160,2936,30
95044968926,95044968921,-5,972,3342,30
95045084624,95045084613,-11,810,2559,30
95047736894,95047736894,0,1334,2188,30
95050442723,95050442720,-3,1095,2783,30
95053130151,95053130146,-5,340,2799,30
95053564082,95053564080,-2,1176,3233,30
95055726885,95055726881,-4,822,2364,30
95056224197,95056224202,5,4559,3457,30
95058427173,95058427167,-6,934,2102,30
95064485501,95064485499,-2,1428,3489,30
95068279591,95068279587,-4,1122,3970,30
95069559198,95069559193,-5,1597,3258,30
95072398735,95072398732,-3,1009,2701,30
95072685699,95072685713,14,208,2598,30
95075985116,95075985110,-6,1390,3411,30
95080161442,95080161437,-5,1311,3493,30
95081945685,95081945692,7,10234,32191,30
95082154017,95082154012,-5,948,2184,30
95083661994,95083661992,-2,919,2412,30
95084015610,95084015605,-5,939,3988,30
95084104770,95084104766,-4,1078,2666,30
95085509250,95085509245,-5,1131,2530,30
95085914745,95085914740,-5,717,3328,30
95088251321,95088251318,-3,1151,2504,30
95089058383,95089058378,-5,1402,2547,30
95098149308,95098149301,-7,1114,3071,30
95099503101,95099503104,3,2265,1650,30
95099978050,95099978054,4,2490,2368,30
95102170206,95102170202,-4,1088,2643,30
95103953450,95103953444,-6,1267,3280,30
95114540651,95114540646,-5,1317,3509,30
95117371345,95117371339,-6,906,3092,30
95117917642,95117917637,-5,1331,3706,30
95119736921,95119736918,-3,1594,4065,30
95131997110,95131997107,-3,1370,3132,30
95134133010,95134133004,-6,672,4501,30
95141751537,95141751533,-4,1300,2074,30
95143410138,95143410133,-5,707,2376,30
95145781230,95145781225,-5,1104,1802,30
95148594112,95148594110,-2,1225,2891,30
95153024290,95153024283,-7,802,2354,30
95157442463,95157442457,-6,1269,3133,30
95165591975,95165591970,-5,801,3406,30
95166406504,95166406498,-6,168,1053,30
95172964875,95172964872,-3,1098,1939,30
95173446853,95173446850,-3,1470,2425,30
95174385499,95174385493,-6,686,2467,30
95180311991,95180311987,-4,773,2589,30
95194141521,95194141515,-6,1293,3141,30
95195313734,95195313729,-5,782,2811,30
95197132136,95197132154,18,1100,2702,30
95204914812,95204914808,-4,1059,3018,30
95205316129,95205316122,-7,1254,2824,30
95209076822,95209076824,2,1281,1312,30
95213573429,95213573440,11,732,1038,30
95216462481,95216462475,-6,988,3344,30
95216777497,95216777493,-4,663,1734,30
95218518497,95218518489,-8,1271,4801,30
95219877089,95219877085,-4,1521,2273,30
95226773875,95226773875,0,967,932,30
95230404980,95230404975,-5,992,3490,30
95233107198,95233107193,-5,1367,3712,30
95233252800,95233252799,-1,119,1053,30
95233859935,95233859935,0,1381,2300,30
95235262806,95235262803,-3,1428,3137,30
95235747218,95235747212,-6,1644,6774,30
95237399495,95237399489,-6,1014,2937,30
95238774477,95238774473,-4,1203,2613,30
95240455249,95240455245,-4,734,2476,30
95240632651,95240632646,-5,843,2276,30
95259714882,95259714879,-3,867,1561,30
95262378390,95262378397,7,4461,1804,30
95274603454,95274603450,-4,978,2163,30
95279017614,95279017613,-1,1069,1373,30
95282699710,95282699705,-5,993,3309,30
95287140614,95287140608,-6,1169,2728,30
95288053075,95288053067,-8,881,3750,30
95288658618,95288658636,18,549,1552,30
95289318422,95289318419,-3,957,2941,30
95289986842,95289986836,-6,78,1028,30
95294622180,95294622177,-3,1328,3138,30
95294816648,95294816632,-16,21,1071,30
95300578778,95300578771,-7,1146,3437,30
95306051715,95306051709,-6,1156,1609,30
95312787299,95312787294,-5,1127,2724,30
95318134942,95318134937,-5,762,2102,30
95322142430,95322142424,-6,1014,2999,30
95322513586,95322513607,21,736,2454,30
95323541815,95323541815,0,1212,2429,30
95326545535,95326545535,0,928,1019,30
95326971739,95326971742,3,25341,125314,30
95333476315,95333476319,4,770,865,30
95337713083,95337713082,-1,1807,2510,30
95338372015,95338372009,-6,1157,2726,30
95350177228,95350177222,-6,960,1957,30
95354336299,95354336295,-4,1122,1710,30
95354740090,95354740097,7,4435,1399,30
95356510474,95356510474,0,4062,4009,30
95360385882,95360385878,-4,1237,4028,30
95363680998,95363680996,-2,1294,4086,30
95363983914,95363983907,-7,1194,3111,30
95364277410,95364277396,-14,1089,2573,30
95367516043,95367516039,-4,1415,3231,30
95369061098,95369061093,-5,1207,2942,30
95370527298,95370527296,-2,1192,3532,30
95371666645,95371666642,-3,1290,4627,30
95372408264,95372408261,-3,362,1168,30
95378052186,95378052181,-5,1047,2348,30
95380933747,95380933742,-5,727,2300,30
95382370314,95382370309,-5,1233,3135,30
95384743801,95384743798,-3,1223,2149,30
95391214578,95391214574,-4,962,1975,30
95395125810,95395125804,-6,1241,3669,30
95396097882,95396097860,-22,65,813,30
95397274524,95397274521,-3,1620,2666,30
95398077019,95398077014,-5,913,3417,30
95404655319,95404655314,-5,719,3005,30
95407427586,95407427582,-4,929,2793,30
95408472235,95408472229,-6,1009,2741,30
95408968307,95408968300,-7,1060,3827,30
95409129326,95409129321,-5,1182,2780,30
95411739243,95411739255,12,457,3514,30
95412832233,95412832226,-7,1406,4555,30
95415531979,95415531974,-5,1385,3156,30
95416507597,95416507593,-4,1438,2746,30
95417224297,95417224294,-3,1022,1702,30
95420112774,95420112770,-4,738,1506,30
95421510594,95421510588,-6,1227,2558,30
95422391538,95422391534,-4,688,1914,30
95423039253,95423039249,-4,1348,4827,30
95423818024,95423818046,22,710,2729,30
95430506998,95430506995,-3,1115,1685,30
95432368681,95432368676,-5,1512,3111,30
95433253997,95433253997,0,1416,2362,30
95438498790,95438498786,-4,1649,3413,30
95439058862,95439058856,-6,760,2718,30
95441017817,95441017815,-2,1208,2377,30
95441955169,95441955165,-4,1020,3014,30
95444352377,95444352370,-7,973,3644,30
95448982661,95448982656,-5,1298,2525,30
95456279146,95456279142,-4,1164,3346,30
95458535546,95458535542,-4,1098,2901,30
95467043759,95467043756,-3,570,1822,30
95469016179,95469016180,1,1790,2370,30
95470366184,95470366178,-6,1311,3053,30
95471360818,95471360822,4,6556,5133,30
95473609867,95473609861,-6,648,3031,30
95478156130,95478156127,-3,1187,2434,30
95479506419,95479506422,3,3826,3536,30
95481080345,95481080341,-4,780,2435,30
95485525526,95485525520,-6,1009,2902,30
95486607092,95486607089,-3,1062,2243,30
95488466807,95488466802,-5,1327,3849,30
95489611002,95489611000,-2,1493,1990,30
95498324322,95498324329,7,5181,2727,30
95500669130,95500669127,-3,788,1973,30
95502300019,95502300017,-2,1167,2936,30
95503877372,95503877367,-5,930,1952,30
95509143351,95509143354,3,1319,1335,30
95510225552,95510225554,2,172,1091,30
95512584094,95512584098,4,2876,1884,30
95512838358,95512838366,8,5779,2123,30
95524000811,95524000806,-5,1278,2297,30
95530645732,95530645730,-2,1236,3107,30
95535364237,95535364231,-6,770,2444,30
95545432894,95545432890,-4,715,2062,30
95546823467,95546823465,-2,721,2482,30
95548851493,95548851488,-5,1272,3772,30
95549055370,95549055383,13,161,1041,30
95557203226,95557203223,-3,1242,3068,30
95561389922,95561389918,-4,2670,5771,30
95562928187,95562928182,-5,528,3125,30
95566351738,95566351741,3,1481,1214,30
95574017927,95574017923,-4,1229,3936,30
95575053810,95575053809,-1,1088,2177,30
95578748058,95578748058,0,947,2136,30
95579518575,95579518571,-4,1083,2307,30
95579813562,95579813557,-5,936,4371,30
95579899073,95579899074,1,277,1089,30
95581991534,95581991533,-1,830,1665,30
95582954018,95582954013,-5,928,2074,30
95585144860,95585144877,17,1321,2743,30
95586758923,95586758921,-2,897,2371,30
95587104031,95587104033,2,2726,1698,30
95589414720,95589414718,-2,1230,3469,30
95591819388,95591819382,-6,1102,2640,30
95592957549,95592957546,-3,1057,2555,30
95601807361,95601807355,-6,1386,2966,30
95602358185,95602358166,-19,258,772,30
95604841462,95604841458,-4,1104,3720,30
95608229991,95608229986,-5,1134,3650,30
95610961130,95610961129,-1,1075,2131,30
95612774511,95612774517,6,974,810,30
95613059714,95613059710,-4,953,2876,30
95622494173,95622494176,3,1495,1482,30
95627699046,95627699041,-5,916,3080,30
95628359113,95628359110,-3,2423,5504,30
95628725570,95628725567,-3,139,1178,30
95630188274,95630188265,-9,950,1724,30
95634736095,95634736092,-3,883,2403,30
95637559849,95637559844,-5,1298,3385,30
95638710413,95638710410,-3,1151,2436,30
95642881539,95642881534,-5,1076,3385,30
95650022667,95650022662,-5,1161,2649,30
95650066274,95650066287,13,236,1452,30
95660648909,95660648905,-4,1552,1659,30
95661350907,95661350905,-2,1808,2913,30
95665196540,95665196530,-10,49151,14424,30
95672102983,95672102979,-4,1095,3385,30
95680390583,95680390579,-4,1137,3031,30
95686917567,95686917564,-3,1060,2205,30
95687932297,95687932292,-5,1682,3683,30
95690395818,95690395812,-6,1240,3529,30
95691876238,95691876234,-4,1281,2596,30
95693896435,95693896432,-3,1088,2056,30
95693981856,95693981850,-6,744,2686,30
95705530886,95705530881,-5,987,2374,30
95710511929,95710511925,-4,1237,4113,30
95712074007,95712074002,-5,1086,2973,30
95714361889,95714361885,-4,2810,4571,30
95716697219,95716697211,-8,552,1063,30
95718241836,95718241852,16,944,3467,30
95718511011,95718511008,-3,970,2410,30
95719975458,95719975462,4,1435,1757,30
95721158131,95721158126,-5,1465,4047,30
95722236734,95722236734,0,2256,3103,30
95724152135,95724152130,-5,757,2934,30
95724233950,95724233946,-4,1025,2714,30
95725936854,95725936850,-4,963,2707,30
95728666073,95728666068,-5,1012,2578,30
95733311350,95733311353,3,1662,1504,30
95735894825,95735894821,-4,1178,3385,30
95737332929,95737332951,22,204,1318,30
95737776082,95737776078,-4,912,3239,30
95742308609,95742308604,-5,1098,3295,30
95743347210,95743347203,-7,1332,5431,30
95744006150,95744006144,-6,715,1741,30
95745133962,95745133958,-4,852,3167,30
95751090172,95751090169,-3,779,1681,30
95756754963,95756754958,-5,845,2172,30
95759017990,95759017988,-2,1065,2128,30
95762934347,95762934342,-5,1134,3439,30
95763446050,95763446066,16,809,2833,30
95767019854,95767019849,-5,1069,3135,30
95767539953,95767539937,-16,480,2120,30
95767956664,95767956651,-13,1089,3366,30
95768455217,95768455238,21,575,2953,30
95770052534,95770052528,-6,922,3498,30
95770136652,95770136658,6,368,1062,30
95772654154,95772654150,-4,836,2839,30
95781881143,95781881140,-3,894,2255,30
95782426238,95782426243,5,2828,1308,30
95782663750,95782663749,-1,1215,2010,30
95792613090,95792613085,-5,1187,3241,30
95793372142,95793372143,1,1089,1669,30
95795922111,95795922108,-3,848,2200,30
95798068134,95798068128,-6,814,4756,30
95798567987,95798567984,-3,1039,2477,30
95799425964,95799425973,9,2733,1063,30
95809782010,95809782009,-1,958,1973,30
95826343367,95826343362,-5,845,2489,30
95828544801,95828544796,-5,1100,2801,30
95828785930,95828785945,15,288,1375,30
95832224059,95832224054,-5,844,2973,30
95842228174,95842228169,-5,893,1790,30
95842843274,95842843266,-8,1001,3168,30
95856373298,95856373294,-4,870,4417,30
95857353049,95857353070,21,614,1423,30
95860761337,95860761330,-7,6576,14670,30
95873195508,95873195505,-3,1077,2437,30
95882464027,95882464023,-4,965,1744,30
95882839340,95882839359,19,897,4446,30
95896599658,95896599652,-6,1000,3112,30
95898546570,95898546574,4,2051,1543,30
95899977069,95899977075,6,2948,937,30
95903821314,95903821310,-4,919,2993,30
95909122475,95909122472,-3,1237,3539,30
95910493517,95910493509,-8,607,2213,30
95911638440,95911638434,-6,1544,2146,30
95913741275,95913741291,16,858,2291,30
95916425590,95916425587,-3,1392,3367,30
95921782646,95921782639,-7,839,2388,30
95922894871,95922894867,-4,893,2776,30
95927299791,95927299784,-7,734,2513,30
95930936952,95930936947,-5,807,2995,30
95933160954,95933160950,-4,685,2977,30
95935377971,95935377966,-5,979,2485,30
95939124120,95939124115,-5,1231,2764,30
95944171899,95944171894,-5,1089,2736,30
95945086487,95945086483,-4,1350,3116,30
95946593569,95946593562,-7,1348,3637,30
95948120125,95948120120,-5,942,2803,30
95948162676,95948162695,19,615,3434,30
95948746274,95948746270,-4,842,2781,30
95952853289,95952853283,-6,1511,4471,30
95953005136,95953005118,-18,220,1250,30
95953232155,95953232144,-11,1318,3376,30
95958174564,95958174559,-5,1283,3404,30
95967918082,95967918077,-5,1146,3212,30
95976990317,95976990313,-4,1192,3406,30
95977895942,95977895941,-1,1012,1646,30
95979459958,95979459954,-4,1187,2262,30
95981724439,95981724434,-5,1233,2826,30
95983172610,95983172606,-4,872,2332,30
95986575912,95986575908,-4,1247,2916,30
95987203669,95987203662,-7,1069,2789,30
95990247435,95990247434,-1,6022,9393,30
95991036730,95991036735,5,3309,2077,30
95992195807,95992195803,-4,1067,2799,30
95993661206,95993661205,-1,710,1353,30
95994665006,95994665001,-5,678,1739,30
95995253861,95995253856,-5,849,2464,30
96005645326,96005645322,-4,728,2539,30
96006798243,96006798237,-6,912,2898,30
96021194889,96021194885,-4,1314,3872,30
96032087451,96032087445,-6,1194,2626,30
96033742110,96033742105,-5,1053,2488,30
96034828261,96034828255,-6,1082,5486,30
96035250777,96035250771,-6,1420,5351,30
96040551456,96040551466,10,12551,34756,30
96044597513,96044597507,-6,1046,4073,30
96044986913,96044986897,-16,1003,3284,30
96047325570,96047325567,-3,1048,2529,30
96062305470,96062305466,-4,1145,3244,30
96063979288,96063979285,-3,746,2878,30
96072037267,96072037263,-4,1006,3446,30
96073979954,96073979950,-4,1225,2164,30
96074402324,96074402322,-2,919,1544,30
96074670017,96074670013,-4,1032,3084,30
96076218217,96076218231,14,422,843,30
96077498020,96077498014,-6,935,3783,30
96079859874,96079859870,-4,1048,2398,30
96085238838,96085238839,1,1260,2175,30
96088810471,96088810466,-5,699,1944,30
96098882899,96098882895,-4,1169,2704,30
96099447293,96099447292,-1,890,2176,30
96100044358,96100044354,-4,1260,2587,30
96100748248,96100748270,22,1285,4366,30
96109127185,96109127181,-4,1099,1692,30
96109583639,96109583634,-5,959,2889,30
96113112090,96113112099,9,4761,2588,30
96117347415,96117347411,-4,1196,2536,30
96121075122,96121075119,-3,1192,2241,30
96122585330,96122585323,-7,1211,4629,30
96125602037,96125602034,-3,1898,3556,30
96128219243,96128219240,-3,691,2369,30
96128805957,96128805953,-4,1063,3430,30
96128907003,96128907001,-2,1013,2169,30
96128975042,96128975020,-22,970,2860,30
96129357624,96129357607,-17,1444,3924,30
96130793771,96130793765,-6,1324,3708,30
96131363468,96131363468,0,1173,2009,30
96138479240,96138479234,-6,1453,3467,30
96141854789,96141854785,-4,967,1669,30
96145541635,96145541636,1,1270,1358,30
96147491455,96147491452,-3,955,2077,30
96147530787,96147530782,-5,187,769,30
96147857068,96147857065,-3,1297,2121,30
96152626803,96152626798,-5,1410,3421,30
96155290028,96155290022,-6,1016,2364,30
96156026785,96156026783,-2,1692,2607,30
96163795533,96163795530,-3,581,1604,30
96171964129,96171964122,-7,1277,3009,30
96176364794,96176364793,-1,665,1180,30
96182055616,96182055615,-1,452,1038,30
96183378371,96183378379,8,157,750,30
96186723114,96186723109,-5,911,3238,30
96187171255,96187171250,-5,917,3584,30
96191854095,96191854093,-2,823,1698,30
96196952403,96196952399,-4,881,2807,30
96206463774,96206463778,4,1465,1241,30
96206558759,96206558754,-5,901,3823,30
96208841791,96208841788,-3,948,2261,30
96210911226,96210911221,-5,1102,2862,30
96211413847,96211413842,-5,866,2914,30
96213666965,96213666958,-7,898,3235,30
96216191512,96216191513,1,1795,1623,30
96217886101,96217886096,-5,803,3423,30
96219059978,96219059974,-4,1057,2223,30
96220282115,96220282110,-5,1074,2729,30
96236201745,96236201748,3,2410,2207,30
96239017191,96239017187,-4,857,2876,30
96250097497,96250097495,-2,992,2757,30
96250894764,96250894765,1,2468,2560,30
96253966594,96253966590,-4,987,2441,30
96254204699,96254204680,-19,1201,12086,30
96258761698,96258761697,-1,3491,4805,30
96264890607,96264890601,-6,1341,2872,30
96267256631,96267256626,-5,1001,2514,30
96271899068,96271899063,-5,1300,3594,30
96279171140,96279171136,-4,1386,3413,30
96283676761,96283676762,1,1469,2477,30
96285297023,96285297018,-5,896,2956,30
96287732771,96287732766,-5,1141,1964,30
96295374312,96295374305,-7,1323,3431,30
96295674847,96295674845,-2,1466,1870,30
96295775581,96295775577,-4,1422,3191,30
96298948255,96298948252,-3,627,2618,30
96313277404,96313277399,-5,1303,3096,30
96316466935,96316466928,-7,850,4154,30
96316656360,96316656350,-10,1148,2778,30
96321326473,96321326469,-4,925,3169,30
96323803215,96323803211,-4,1329,2736,30
96329138939,96329138934,-5,1039,3280,30
96329922321,96329922342,21,920,2795,30
96331162983,96331162978,-5,969,3054,30
96333441535,96333441531,-4,1216,3037,30
96337189758,96337189756,-2,1283,1518,30
96338495136,96338495153,17,969,3803,30
96338702458,96338702450,-8,925,2698,30
96341661858,96341661854,-4,1246,3376,30
96345605838,96345605831,-7,1052,2397,30
96345776595,96345776615,20,1261,3108,30
96346681613,96346681606,-7,692,1671,30
96346835236,96346835237,1,1149,1567,30
96353361982,96353361979,-3,1092,2685,30
96353701123,96353701119,-4,117,795,30
96358353869,96358353865,-4,981,2022,30
96363816011,96363816006,-5,1076,1660,30
96364441705,96364441699,-6,988,2277,30
96365161419,96365161414,-5,928,3547,30
96370615138,96370615134,-4,307,2204,30
96371102237,96371102233,-4,1057,4645,30
96378475434,96378475428,-6,1214,3926,30
96383361921,96383361917,-4,935,3025,30
96384361567,96384361564,-3,806,2181,30
96386301976,96386301978,2,1716,1353,30
96389887032,96389887025,-7,1337,3960,30
96392768470,96392768462,-8,978,2387,30
96393057804,96393057798,-6,1137,4190,30
96396592676,96396592670,-6,729,2338,30
96398165543,96398165537,-6,874,3068,30
96401605705,96401605702,-3,980,2137,30
96404253406,96404253402,-4,1055,3260,30
96405025195,96405025190,-5,946,2883,30
96406220082,96406220078,-4,924,2468,30
96406470184,96406470171,-13,207,783,30
96416912933,96416912935,2,1401,1405,30
96419566149,96419566146,-3,809,2532,30
96421794965,96421794965,0,2124,2069,30
96428029625,96428029627,2,1302,1247,30
96429120747,96429120741,-6,995,3810,30
96430526150,96430526149,-1,18768,18981,30
96435580962,96435580958,-4,809,2619,30
96436249139,96436249135,-4,1159,1862,30
96436474713,96436474705,-8,772,3347,30
96438006519,96438006510,-9,168,1073,30
96439483738,96439483735,-3,878,2524,30
96445084432,96445084427,-5,1487,3929,30
96447170652,96447170667,15,18848,42032,30
96447730641,96447730661,20,23,887,30
96448152646,96448152642,-4,868,2572,30
96449835619,96449835615,-4,1474,2521,30
96451416749,96451416744,-5,1134,3028,30
96451489403,96451489396,-7,1038,2391,30
96453497085,96453497081,-4,1067,2485,30
96454103009,96454103006,-3,1060,2689,30
96458267433,96458267428,-5,1322,2890,30
96460865294,96460865289,-5,902,1977,30
96462698486,96462698481,-5,1258,2313,30
96463637254,96463637253,-1,1130,1798,30
96469489606,96469489602,-4,1162,2229,30
96471506349,96471506362,13,10730,45718,30
96472357522,96472357521,-1,1456,1615,30
96473871762,96473871754,-8,1218,2334,30
96479454109,96479454111,2,2158,1618,30
96479873494,96479873505,11,605,1156,30
96481189533,96481189526,-7,988,3051,30
96484337570,96484337568,-2,1794,2691,30
96498249113,96498249111,-2,1198,1655,30
96498638356,96498638350,-6,1269,3506,30
96499395505,96499395498,-7,1086,2862,30
96500624658,96500624654,-4,1449,2727,30
96507466162,96507466163,1,1306,2496,30
96507789125,96507789122,-3,1491,1902,30
96513569620,96513569617,-3,1381,4172,30
96513921158,96513921155,-3,1105,1396,30
96514758765,96514758760,-5,823,1732,30
96515572857,96515572853,-4,1293,2936,30
96518384935,96518384931,-4,1342,2966,30
96527376200,96527376198,-2,267,800,30
96536057532,96536057528,-4,1170,4051,30
96537284422,96537284426,4,2018,1664,30
96542529517,96542529512,-5,1075,4681,30
96546037515,96546037510,-5,757,3033,30
96552477069,96552477063,-6,702,2916,30
96553960503,96553960498,-5,965,2337,30
96557340006,96557340002,-4,1062,2660,30
96560672526,96560672521,-5,995,4176,30
96565117453,96565117446,-7,845,3574,30
96567868282,96567868276,-6,688,1475,30
96568591154,96568591150,-4,810,2213,30
96570080871,96570080889,18,478,926,30
96570675071,96570675063,-8,2321,35959,30
96572270872,96572270877,5,4793,2335,30
96573502314,96573502310,-4,994,2145,30
96578058091,96578058086,-5,1069,1883,30
96578261162,96578261158,-4,543,1174,30
96579054378,96579054374,-4,1445,2496,30
96579639311,96579639306,-5,1237,2548,30
96580112221,96580112217,-4,1593,3187,30
96582897751,96582897747,-4,998,3444,30
96583897322,96583897338,16,377,853,30
96587833314,96587833309,-5,937,2560,30
96588080105,96588080108,3,16,1262,30
96588748018,96588748013,-5,1053,2789,30
96589437519,96589437514,-5,1298,3210,30
96591738548,96591738543,-5,1072,2522,30
96593918040,96593918034,-6,1088,4953,30
96603447326,96603447323,-3,1746,3307,30
96604400542,96604400538,-4,1091,2830,30
96606206564,96606206559,-5,1152,3657,30
96610295029,96610295035,6,6098,1629,30
96610728977,96610728974,-3,1089,2521,30
96617004055,96617004050,-5,1034,2043,30
96617308611,96617308612,1,1003,1887,30
96621018051,96621018046,-5,921,4117,30
96634537329,96634537335,6,3155,1283,30
96640062518,96640062519,1,2131,1860,30
96640915063,96640915057,-6,831,3357,30
96641836522,96641836518,-4,1092,3059,30
96644409345,96644409339,-6,629,2764,30
96655562890,96655562886,-4,1375,3533,30
96655969859,96655969873,14,387,2696,30
96665003911,96665003906,-5,1037,2907,30
96671013399,96671013401,2,1041,2041,30
96672725294,96672725299,5,3693,1553,30
96672810278,96672810281,3,2512,2939,30
96677630154,96677630149,-5,1175,1699,30
96679643133,96679643129,-4,1200,2493,30
96682632723,96682632719,-4,860,2051,30
96685168055,96685168051,-4,967,1534,30
96688891573,96688891570,-3,939,2146,30
96689519698,96689519692,-6,1147,2332,30
96690770650,96690770646,-4,968,4946,30
96695201002,96695201006,4,3845,2310,30
96696010300,96696010302,2,2807,2538,30
96702118755,96702118750,-5,921,2187,30
96704622468,96704622463,-5,1278,4107,30
96707209505,96707209501,-4,1004,1845,30
96707958638,96707958639,1,1319,1576,30
96709832245,96709832239,-6,832,3835,30
96714177475,96714177470,-5,1586,2425,30
96717672907,96717672903,-4,975,2818,30
96718523780,96718523766,-14,216,1248,30
96719075237,96719075234,-3,1221,2956,30
96720563946,96720563939,-7,967,2714,30
96721151632,96721151638,6,327,1007,30
96723012655,96723012651,-4,1124,2300,30
96723050990,96723050985,-5,654,1433,30
96726234234,96726234234,0,954,2164,30
96733317384,96733317381,-3,33019,14096,30
96735057534,96735057529,-5,811,2110,30
96745736662,96745736658,-4,1236,3346,30
96746604598,96746604595,-3,963,3780,30
96747976617,96747976615,-2,1452,2647,30
96750493001,96750492995,-6,1423,5756,30
96751691339,96751691336,-3,1190,2265,30
96752394851,96752394845,-6,877,2177,30
96761043350,96761043346,-4,1136,2491,30
96761321816,96761321817,1,178,973,30
96763287224,96763287233,9,289,815,30
96766851144,96766851146,2,2157,2280,30
96767931970,96767931967,-3,998,2829,30
96768729307,96768729303,-4,878,1922,30
96775606158,96775606157,-1,1290,2268,30
96777745631,96777745626,-5,837,1495,30
96781237377,96781237371,-6,1303,3675,30
96784395324,96784395319,-5,1399,3358,30
96787665967,96787665960,-7,711,3599,30
96787710387,96787710406,19,834,2418,30
96789356129,96789356122,-7,870,4289,30
96792633808,96792633804,-4,1180,2664,30
96792874642,96792874638,-4,883,2437,30
96793355126,96793355122,-4,896,2369,30
96797745034,96797745034,0,1480,1857,30
96804780857,96804780851,-6,1313,3147,30
96806499861,96806499857,-4,920,2638,30
96817723705,96817723702,-3,1270,2201,30
96820470167,96820470163,-4,850,2268,30
96823811411,96823811406,-5,1113,3138,30
96829598151,96829598147,-4,1129,2952,30
96833475059,96833475055,-4,1103,4048,30
96841801710,96841801710,0,40243,70777,30
96846869055,96846869055,0,1526,1472,30
96851896289,96851896287,-2,850,1798,30
96852401287,96852401284,-3,1067,2864,30
96852512202,96852512209,7,3280,1124,30
96853198795,96853198799,4,3311,1647,30
96853296508,96853296504,-4,795,2447,30
96854172241,96854172250,9,581,1671,30
96856325142,96856325134,-8,1069,3869,30
96859565874,96859565870,-4,840,2469,30
96859838899,96859838893,-6,895,3953,30
96864475243,96864475237,-6,917,2485,30
96864864113,96864864134,21,234,1339,30
96868217483,96868217478,-5,1391,4085,30
96875050544,96875050546,2,1559,1681,30
96879414579,96879414577,-2,937,2172,30
96887908708,96887908705,-3,1080,2674,30
96888680131,96888680129,-2,795,2015,30
96892296475,96892296472,-3,1084,2065,30
96892382418,96892382413,-5,1008,2261,30
96895983303,96895983297,-6,1144,2398,30
96898860643,96898860637,-6,1413,3125,30
96898938282,96898938277,-5,881,2919,30
96903042063,96903042058,-5,1013,2511,30
96903639047,96903639050,3,837,1224,30
96907637643,96907637637,-6,1175,2885,30
96919741444,96919741446,2,957,719,30
96927488046,96927488042,-4,1073,3437,30
96927875851,96927875846,-5,628,2780,30
96930924697,96930924693,-4,1687,3340,30
96931593331,96931593326,-5,1358,3595,30
96934310359,96934310354,-5,1131,3344,30
96936821398,96936821394,-4,1162,3207,30
96938836412,96938836417,5,3335,1904,30
96942417575,96942417567,-8,950,3499,30
96944325355,96944325349,-6,1040,3281,30
96945545681,96945545675,-6,819,3310,30
96949640370,96949640365,-5,1456,3526,30
96950029766,96950029762,-4,1167,2683,30
96951326065,96951326071,6,1869,943,30
96955692915,96955692909,-6,1146,3343,30
96959070102,96959070097,-5,1002,3529,30
96961732230,96961732228,-2,765,1889,30
96965531584,96965531581,-3,1034,2903,30
96969148755,96969148751,-4,1471,3199,30
96974002767,96974002765,-2,713,1331,30
96977438643,96977438637,-6,1691,3418,30
96978478378,96978478373,-5,1126,3936,30
96980258927,96980258922,-5,1405,2026,30
96980966166,96980966162,-4,1114,2988,30
96988672695,96988672691,-4,934,2719,30
96995967785,96995967782,-3,832,2895,30
96996824282,96996824278,-4,1124,2441,30
96999344243,96999344238,-5,1144,3773,30
97003179944,97003179941,-3,1182,2407,30
97003796674,97003796686,12,332,1122,30
97008264238,97008264233,-5,401,2743,30
97009839925,97009839923,-2,878,2354,30
97010721986,97010721982,-4,1209,3272,30
97017865209,97017865205,-4,829,2523,30
97020723606,97020723619,13,247,836,30
97022078089,97022078085,-4,771,3225,30
97027482922,97027482918,-4,822,2152,30
97029141442,97029141459,17,790,2637,30
97029380522,97029380502,-20,262,1050,30
97033384810,97033384806,-4,951,2967,30
97036060769,97036060766,-3,1304,3427,30
97037538351,97037538348,-3,982,1814,30
97039233702,97039233698,-4,865,2255,30
97041216087,97041216081,-6,760,2358,30
97042874583,97042874581,-2,854,1955,30
97050990502,97050990498,-4,1195,3871,30
97054383419,97054383415,-4,828,2224,30
97057578146,97057578139,-7,1917,5336,30
97064837510,97064837519,9,16688,55802,30
97067691022,97067691018,-4,1090,2129,30
97069740433,97069740429,-4,582,1995,30
97069869545,97069869541,-4,1588,3602,30
97077086221,97077086218,-3,669,2225,30
97078246951,97078246957,6,37135,18941,30
97084635812,97084635807,-5,629,2113,30
97088928086,97088928079,-7,823,1851,30
97097253734,97097253730,-4,1334,3321,30
97097639763,97097639759,-4,880,2625,30
97098580945,97098580942,-3,744,2052,30
97104351952,97104351946,-6,785,3164,30
97106146254,97106146251,-3,802,2191,30
97107091442,97107091443,1,168,528,30
97107686667,97107686687,20,249,1089,30
97109239842,97109239838,-4,1031,2237,30
97110036773,97110036770,-3,1148,2639,30
97111049157,97111049150,-7,1190,2893,30
97112503597,97112503594,-3,1146,2360,30
97113007790,97113007786,-4,1272,3558,30
97113999730,97113999725,-5,1001,2065,30
97114331099,97114331118,19,1032,2872,30
97121580239,97121580237,-2,547,2244,30
97122408356,97122408375,19,338,1648,30
97128806037,97128806030,-7,1010,5794,30
97130570090,97130570091,1,975,1500,30
97131676890,97131676886,-4,1132,2236,30
97131832709,97131832707,-2,996,3116,30
97134688203,97134688217,14,839,2606,30
97141579970,97141579984,14,674,2574,30
97142633152,97142633151,-1,1127,3095,30
97153241389,97153241383,-6,1035,2253,30
97158241059,97158241054,-5,919,2012,30
97158501639,97158501638,-1,1114,2010,30
97161747942,97161747939,-3,744,2429,30
97162048978,97162048978,0,1353,2164,30
97163599393,97163599388,-5,930,2345,30
97176836545,97176836541,-4,1193,3572,30
97178265774,97178265769,-5,1403,3856,30
97187656687,97187656691,4,1697,1260,30
97192115911,97192115928,17,1092,2580,30
97192817825,97192817820,-5,1050,2903,30
97199304771,97199304766,-5,1035,2434,30
97200818763,97200818758,-5,843,4660,30
97200869043,97200869062,19,607,4236,30
97202676433,97202676428,-5,983,2642,30
97202908635,97202908650,15,1099,2785,30
97203523889,97203523875,-14,255,1146,30
97204732883,97204732879,-4,1052,2372,30
97207933270,97207933263,-7,1804,4902,30
97208721450,97208721462,12,351,922,30
97216920584,97216920587,3,943,333,30
97218640390,97218640389,-1,1572,2154,30
97221577009,97221577006,-3,1068,3037,30
97222274005,97222274001,-4,1288,3410,30
97223427425,97223427421,-4,732,2363,30
97225389391,97225389387,-4,949,2505,30
97225639870,97225639872,2,1915,1563,30
97226034805,97226034806,1,1632,2518,30
97231048782,97231048778,-4,937,2862,30
97238567050,97238567045,-5,1148,3461,30
97242119146,97242119141,-5,1393,3262,30
97243099394,97243099390,-4,1129,2457,30
97243851000,97243850997,-3,1017,2326,30
97244785538,97244785530,-8,1165,1008,30
97245047946,97245047943,-3,1000,2149,30
97251367710,97251367707,-3,738,2132,30
97252449214,97252449211,-3,869,2668,30
97253051154,97253051151,-3,912,2072,30
97254587313,97254587314,1,3391,2862,30
97256211226,97256211221,-5,782,2795,30
97259138021,97259138023,2,1675,1487,30
97259257032,97259257051,19,824,2944,30
97259453415,97259453422,7,4012,1474,30
97260388633,97260388626,-7,1171,2625,30
97260772623,97260772618,-5,880,1596,30
97264414907,97264414906,-1,1339,1831,30
97269049148,97269049142,-6,1239,3377,30
97271186193,97271186187,-6,1403,3098,30
97271735110,97271735105,-5,1103,3324,30
97273619719,97273619713,-6,1142,3060,30
97276316783,97276316780,-3,931,2296,30
97279796022,97279796018,-4,1317,2383,30
97280086226,97280086222,-4,1112,2743,30
97281694324,97281694319,-5,1071,1880,30
97285254664,97285254662,-2,1506,2698,30
97286996390,97286996384,-6,1613,7219,30
97287987647,97287987642,-5,698,1904,30
97293396928,97293396922,-6,916,3181,30
97294659107,97294659103,-4,1192,3287,30
97301303919,97301303916,-3,789,2593,30
97307771697,97307771698,1,1242,2034,30
97315056122,97315056119,-3,799,1584,30
97316649489,97316649489,0,13748,16984,30
97319044736,97319044730,-6,1153,3313,30
97322052942,97322052934,-8,786,2257,30
97323880627,97323880623,-4,866,2413,30
97324142433,97324142429,-4,1884,4718,30
97327710508,97327710531,23,256,752,30
97333982272,97333982266,-6,1226,2261,30
97336323767,97336323762,-5,1017,2487,30
97341112165,97341112161,-4,909,2312,30
97348830082,97348830078,-4,661,1936,30
97349706159,97349706155,-4,1214,3638,30
97351770114,97351770114,0,1652,2506,30
97356133189,97356133184,-5,1320,4205,30
97356940567,97356940562,-5,939,2746,30
97360901880,97360901860,-20,989,3063,30
97364519026,97364519021,-5,885,1843,30
97365189996,97365190010,14,450,1294,30
97365670195,97365670191,-4,1151,3821,30
97368933254,97368933249,-5,1321,2543,30
97369021027,97369021023,-4,571,2712,30
97369176683,97369176677,-6,883,3306,30
97371885767,97371885761,-6,992,3133,30
97373914523,97373914519,-4,1571,3106,30
97374033585,97374033578,-7,1137,2961,30
97375990953,97375990948,-5,771,2517,30
97385510208,97385510200,-8,1509,4180,30
97385931531,97385931522,-9,1039,2601,30
97387854862,97387854857,-5,1367,2127,30
97388538910,97388538902,-8,841,3111,30
97397817306,97397817302,-4,1129,2522,30
97398222021,97398222020,-1,769,1818,30
97401500519,97401500513,-6,744,2471,30
97404400712,97404400708,-4,1542,4096,30
97410756941,97410756937,-4,1459,3560,30
97411308105,97411308102,-3,910,2656,30
97413233717,97413233713,-4,982,2540,30
97413759775,97413759769,-6,1040,2685,30
97415528068,97415528064,-4,841,2544,30
97419316375,97419316369,-6,1485,4320,30
97424157971,97424157965,-6,935,3292,30
97424300457,97424300471,14,494,753,30
97439305842,97439305837,-5,1635,2800,30
97442219993,97442219990,-3,1066,1558,30
97442870758,97442870758,0,1336,2007,30
97449893993,97449893990,-3,830,2460,30
97450799534,97450799531,-3,1148,1837,30
97453629102,97453629098,-4,682,2552,30
97455340650,97455340652,2,7183,6959,30
97458834960,97458834978,18,256,758,30
97459481290,97459481285,-5,1203,2510,30
97459743687,97459743682,-5,941,1652,30
97461613389,97461613382,-7,1565,4237,30
97465835312,97465835314,2,2310,1259,30
97467312687,97467312682,-5,655,4005,30
97467634469,97467634462,-7,1047,2341,30
97467730685,97467730678,-7,1278,2146,30
97470892890,97470892884,-6,848,4541,30
97476848977,97476848972,-5,889,2692,30
97477536363,97477536353,-10,978,2309,30
97482853242,97482853237,-5,1389,2227,30
97484577397,97484577395,-2,1110,2942,30
97486538406,97486538407,1,1257,2186,30
97496273129,97496273126,-3,1590,3141,30
97505442431,97505442425,-6,822,5003,30
97510656702,97510656698,-4,1416,2577,30
97513104885,97513104879,-6,1034,2176,30
97519160425,97519160420,-5,1760,3394,30
97523072215,97523072210,-5,1023,3987,30
97529897981,97529897977,-4,762,2780,30
97531334166,97531334162,-4,1343,4304,30
97532403038,97532403034,-4,853,2619,30
97540110306,97540110307,1,1363,2072,30
97546110370,97546110367,-3,706,1999,30
97555268364,97555268360,-4,1506,2131,30
97556290602,97556290598,-4,1043,2957,30
97558379782,97558379786,4,2038,1610,30
97558508802,97558508798,-4,1076,3279,30
97558616876,97558616889,13,887,2021,30
97561606533,97561606551,18,6,951,30
97562467096,97562467093,-3,952,3462,30
97566163631,97566163625,-6,1816,10018,30
97567417947,97567417944,-3,1280,4190,30
97569400892,97569400886,-6,1317,3040,30
97580791558,97580791560,2,2279,2077,30
97581057515,97581057513,-2,1293,2803,30
97582131962,97582131979,17,985,1459,30
97586722891,97586722885,-6,762,2278,30
97597944579,97597944573,-6,584,2563,30
97598509789,97598509785,-4,943,1856,30
97601061113,97601061108,-5,1567,3295,30
97601222432,97601222427,-5,1174,3415,30
97601707406,97601707408,2,1779,1762,30
97602700986,97602700987,1,1784,2179,30
97602899631,97602899626,-5,1024,2754,30
97606347898,97606347896,-2,670,2726,30
97606899826,97606899819,-7,836,4475,30
97613601375,97613601370,-5,1300,2993,30
97615636738,97615636734,-4,1226,3066,30
97621310638,97621310633,-5,860,1900,30
97624114563,97624114558,-5,467,1406,30
97629790567,97629790563,-4,1034,2253,30
97633154783,97633154779,-4,1275,2069,30
97634127542,97634127543,1,1476,1687,30
97637349050,97637349045,-5,594,1465,30
97646279280,97646279275,-5,1248,3749,30
97655551151,97655551146,-5,1103,2932,30
97665269175,97665269170,-5,1666,3470,30
97665321934,97665321929,-5,1021,1981,30
97670469465,97670469463,-2,850,1145,30
97676883311,97676883306,-5,1298,2442,30
97679374559,97679374557,-2,1266,2846,30
97681063333,97681063332,-1,968,1998,30
97681356465,97681356487,22,987,2065,30
97683514618,97683514614,-4,1226,3711,30
97685993850,97685993845,-5,992,2251,30
97689233324,97689233321,-3,1557,3726,30
97691152947,97691152949,2,10994,11474,30
97693622708,97693622703,-5,1262,3925,30
97697293931,97697293929,-2,1406,1994,30
97700208619,97700208617,-2,836,2645,30
97700996657,97700996666,9,378,1616,30
97701394352,97701394349,-3,878,2669,30
97704666171,97704666166,-5,1263,3398,30
97705813735,97705813732,-3,1026,2186,30
97706334817,97706334813,-4,986,2873,30
97711807967,97711807963,-4,881,2850,30
97714529917,97714529913,-4,599,3665,30
97717882046,97717882047,1,3523,3797,30
97719111600,97719111593,-7,986,2941,30
97720711878,97720711875,-3,784,2415,30
97722112218,97722112223,5,14605,8132,30
97722490416,97722490412,-4,768,2552,30
97723032171,97723032162,-9,766,1933,30
97725099930,97725099927,-3,769,2057,30
97729285107,97729285104,-3,1346,2902,30
97737139234,97737139230,-4,967,3325,30
97737284752,97737284745,-7,1047,3101,30
97738363254,97738363249,-5,1187,3130,30
97740623911,97740623906,-5,857,2289,30
97744321606,97744321599,-7,1084,2290,30
97745426347,97745426342,-5,961,2986,30
97749339721,97749339714,-7,1262,3218,30
97749433299,97749433294,-5,973,3481,30
97750350211,97750350209,-2,969,2942,30
97753840675,97753840669,-6,993,3228,30
97753969063,97753969059,-4,826,2203,30
97760726314,97760726321,7,3052,1412,30
97761448415,97761448410,-5,1186,2649,30
97762606929,97762606925,-4,783,1930,30
97778214486,97778214464,-22,1444,712,30
97784103183,97784103178,-5,815,3527,30
97784869713,97784869734,21,869,2825,30
97786471880,97786471874,-6,1556,3427,30
97788315378,97788315381,3,3490,2201,30
97794325163,97794325159,-4,884,3858,30
97801018316,97801018311,-5,597,2637,30
97809770995,97809770990,-5,1010,2022,30
97810654746,97810654730,-16,146,1094,30
97816122697,97816122715,18,829,1890,30
97821631538,97821631533,-5,1240,3504,30
97831194851,97831194848,-3,821,2643,30
97836362245,97836362239,-6,1114,3064,30
97837352905,97837352901,-4,1257,1945,30
97838954508,97838954502,-6,1240,2405,30
97839720370,97839720357,-13,1241,3534,30
97853698959,97853698953,-6,897,2699,30
97855076206,97855076202,-4,1040,2974,30
97855611609,97855611605,-4,1064,3402,30
97856306364,97856306361,-3,367,1969,30
97857097010,97857097006,-4,1454,2909,30
97859836960,97859836954,-6,964,2407,30
97861051995,97861051994,-1,3666,6554,30
97866909535,97866909531,-4,740,2169,30
97874056207,97874056203,-4,744,2379,30
97878017026,97878017020,-6,1009,3102,30
97879594372,97879594367,-5,990,2223,30
97884348112,97884348107,-5,1710,3615,30
97884458731,97884458726,-5,1167,4276,30
97885604389,97885604384,-5,1375,2651,30
97886446114,97886446109,-5,1019,3618,30
97888758747,97888758741,-6,905,3495,30
97888884675,97888884691,16,446,2509,30
97889469347,97889469343,-4,1296,3668,30
97891312470,97891312466,-4,658,1922,30
97898592534,97898592535,1,1606,1369,30
97901836759,97901836754,-5,1032,2564,30
97902881019,97902881002,-17,897,2128,30
97903347503,97903347501,-2,23350,19660,30
97903565383,97903565382,-1,1041,2176,30
97903705481,97903705477,-4,784,2111,30
97905010871,97905010868,-3,1394,2703,30
97906477081,97906477076,-5,1376,4432,30
97906864257,97906864253,-4,715,2880,30
97907269875,97907269870,-5,1040,2669,30
97908011103,97908011098,-5,891,2255,30
97910794727,97910794722,-5,746,3328,30
97913166428,97913166424,-4,1170,3037,30
97914256798,97914256794,-4,1118,3180,30
97916055000,97916054997,-3,750,2330,30
97917219843,97917219861,18,745,2294,30
97920545241,97920545240,-1,1264,2340,30
97923922970,97923922973,3,1673,1283,30
97925716142,97925716138,-4,1035,3000,30
97925949458,97925949456,-2,3203,12280,30
97935307570,97935307566,-4,1093,3849,30
97938587363,97938587358,-5,1109,2869,30
97941599014,97941599009,-5,726,2946,30
97942214015,97942214013,-2,1328,3903,30
97942679396,97942679410,14,416,1251,30
97950292270,97950292265,-5,1071,3210,30
97951751547,97951751542,-5,767,1673,30
97954259230,97954259226,-4,1162,2118,30
97959732816,97959732819,3,2477,1450,30
97974251482,97974251478,-4,1068,2669,30
97974649306,97974649298,-8,1035,2433,30
97975340768,97975340772,4,219,891,30
97991028897,97991028899,2,1632,1564,30
97999281916,97999281913,-3,1108,2272,30
98001311218,98001311213,-5,274,1033,30
98008950518,98008950514,-4,1318,3432,30
98014224175,98014224169,-6,678,3623,30
98016253871,98016253881,10,10331,37545,30
98022018886,98022018881,-5,1446,2558,30
98030909355,98030909350,-5,656,2768,30
98033131714,98033131710,-4,1344,3400,30
98034239010,98034239008,-2,1039,2442,30
98035843247,98035843241,-6,820,3044,30
98037182363,98037182361,-2,816,2724,30
98039597443,98039597438,-5,1338,1649,30
98049347551,98049347547,-4,961,2173,30
98049443619,98049443615,-4,784,1926,30
98049868728,98049868750,22,319,1997,30
98050293781,98050293777,-4,1115,3323,30
98053020955,98053020949,-6,1064,2750,30
98054496151,98054496145,-6,693,2379,30
98058216451,98058216447,-4,787,1785,30
98067491033,98067491026,-7,776,2449,30
98068516291,98068516293,2,3724,3260,30
98075875702,98075875697,-5,847,2939,30
98079779692,98079779698,6,3676,1240,30
98084755351,98084755346,-5,755,2586,30
98089261495,98089261490,-5,1408,4549,30
98099247459,98099247454,-5,1292,3485,30
98101875359,98101875354,-5,889,2651,30
98102488576,98102488557,-19,178,1119,30
98110736909,98110736903,-6,916,4002,30
98110858179,98110858166,-13,1149,2902,30
98116351326,98116351322,-4,1503,3577,30
98117030306,98117030302,-4,1242,2821,30
98121841030,98121841024,-6,1166,2981,30
98123596511,98123596506,-5,998,3195,30
98125770139,98125770135,-4,1028,2684,30
98125948049,98125948029,-20,77,624,30
98128143211,98128143209,-2,973,1936,30
98130032993,98130032988,-5,795,2465,30
98131940734,98131940729,-5,1065,2799,30
98134125446,98134125445,-1,1155,1342,30
98134885359,98134885353,-6,952,3349,30
98141807903,98141807900,-3,961,3383,30
98142229214,98142229211,-3,665,1232,30
98143367238,98143367234,-4,1133,3376,30
98143460857,98143460849,-8,104,705,30
98144689012,98144689027,15,714,1378,30
98145463631,98145463626,-5,951,3099,30
98147162283,98147162278,-5,1181,3463,30
98150217274,98150217269,-5,1199,2786,30
98157653807,98157653801,-6,778,2000,30
98159050217,98159050213,-4,943,2916,30
98160018106,98160018101,-5,1394,3261,30
98161142275,98161142269,-6,1223,3413,30
98163692739,98163692734,-5,1042,2636,30
98164154374,98164154369,-5,695,2041,30
98167338210,98167338207,-3,1020,2193,30
98169499933,98169499926,-7,807,2101,30
98173014396,98173014417,21,135,762,30
98184924167,98184924163,-4,1135,4183,30
98185465150,98185465143,-7,1024,7132,30
98188340037,98188340032,-5,869,2246,30
98194094782,98194094778,-4,940,2874,30
98199300683,98199300678,-5,703,3036,30
98199436741,98199436735,-6,859,3764,30
98201821315,98201821311,-4,1285,2776,30
98202651894,98202651894,0,966,1910,30
98204935530,98204935526,-4,948,2667,30
98205298386,98205298370,-16,511,2073,30
98210001275,98210001270,-5,719,2084,30
98211822297,98211822302,5,1387,1288,30
98212826069,98212826062,-7,860,2406,30
98214437108,98214437102,-6,755,2954,30
98215829142,98215829138,-4,1173,2496,30
98223279640,98223279635,-5,1066,2585,30
98223530453,98223530449,-4,1393,3240,30
98227920466,98227920461,-5,1068,2372,30
98228994881,98228994889,8,13302,39130,30
98235616819,98235616815,-4,788,1829,30
98245164440,98245164439,-1,28081,7966,30
98255166754,98255166752,-2,1222,1556,30
98255744814,98255744809,-5,1370,3230,30
98258737125,98258737126,1,373,932,30
98260060595,98260060590,-5,1119,2796,30
98260566578,98260566573,-5,1203,2984,30
98267058766,98267058762,-4,1354,3745,30
98271343469,98271343459,-10,48728,9008,30
98272503539,98272503535,-4,1028,2747,30
98274103646,98274103645,-1,822,2035,30
98285599009,98285599003,-6,878,2436,30
98285692010,98285691997,-13,713,2710,30
98287251307,98287251301,-6,994,3905,30
98297841263,98297841258,-5,634,1684,30
98299089950,98299089944,-6,886,3984,30
98300671113,98300671109,-4,1027,2331,30
98307221606,98307221602,-4,1367,3997,30
98315490920,98315490934,14,531,851,30
98318204023,98318204021,-2,777,2098,30
98318385004,98318385013,9,386,2035,30
98328427592,98328427588,-4,1115,2875,30
98333814635,98333814632,-3,1626,3918,30
98343746805,98343746800,-5,1113,1793,30
98344834929,98344834930,1,1352,1535,30
98346765717,98346765713,-4,1336,2619,30
98347125070,98347125066,-4,1334,3350,30
98347222673,98347222694,21,643,1908,30
98348068582,98348068577,-5,1088,2950,30
98348572841,98348572827,-14,1310,3529,30
98350278259,98350278254,-5,1162,2748,30
98352436488,98352436482,-6,1288,3468,30
98354657265,98354657264,-1,1489,1501,30
98354752219,98354752214,-5,1031,3213,30
98362444506,98362444506,0,965,2422,30
98364232788,98364232783,-5,1078,2558,30
98365055100,98365055119,19,628,2243,30
98365820747,98365820741,-6,846,2720,30
98366708270,98366708266,-4,898,2930,30
98366947249,98366947249,0,1924,2066,30
98372365534,98372365529,-5,1270,3041,30
98382979111,98382979106,-5,1622,4126,30
98385172214,98385172208,-6,965,2315,30
98395065074,98395065070,-4,1168,3338,30
98396867182,98396867174,-8,1094,4568,30
98402991998,98402992004,6,5705,2842,30
98403945570,98403945570,0,1231,1321,30
98409125019,98409125021,2,1871,1904,30
98409692626,98409692622,-4,982,2763,30
98409961834,98409961855,21,1030,2169,30
98412690190,98412690191,1,1835,1933,30
98420047031,98420047027,-4,1072,2738,30
98421899304,98421899297,-7,1281,3884,30
98423144067,98423144083,16,1154,2253,30
98427310054,98427310048,-6,975,3067,30
98429057713,98429057718,5,2008,1196,30
98439268230,98439268225,-5,797,2276,30
98441666738,98441666734,-4,1336,3619,30
98446653031,98446653026,-5,1181,3180,30
98452317210,98452317206,-4,1062,4140,30
98454234002,98454233998,-4,870,1905,30
98457196830,98457196837,7,3361,2197,30
98458321615,98458321615,0,846,2038,30
98459079602,98459079597,-5,685,2299,30
98462212081,98462212075,-6,1198,2302,30
98462366330,98462366349,19,766,2288,30
98464630195,98464630192,-3,619,2030,30
98466509339,98466509331,-8,831,3252,30
98470494879,98470494882,3,2056,1829,30
98472120201,98472120196,-5,1309,3045,30
98474095287,98474095282,-5,854,3632,30
98479647461,98479647457,-4,1178,2990,30
98479678588,98479678606,18,772,2307,30
98482929206,98482929218,12,1085,1623,30
98484971909,98484971911,2,1373,1764,30
98485584552,98485584574,22,963,1600,30
98486141633,98486141615,-18,216,1173,30
98488997589,98488997585,-4,830,1922,30
98490715061,98490715056,-5,1129,4066,30
98490890822,98490890815,-7,1183,2732,30
98492039287,98492039287,0,2547,3485,30
98507365917,98507365913,-4,826,3020,30
98507840937,98507840934,-3,1166,2860,30
98508255346,98508255336,-10,5587,14722,30
98508751541,98508751540,-1,1281,2368,30
98509809222,98509809217,-5,710,1068,30
98510643593,98510643588,-5,916,3690,30
98513676343,98513676338,-5,1061,3601,30
98516834905,98516834900,-5,1149,3838,30
98516960210,98516960206,-4,1494,2562,30
98520339198,98520339194,-4,1016,2934,30
98521269713,98521269719,6,2455,1246,30
98523401131,98523401128,-3,866,2568,30
98527366249,98527366244,-5,783,2418,30
98527788435,98527788418,-17,1234,2118,30
98528639400,98528639388,-12,950,3926,30
98531541070,98531541066,-4,1363,3025,30
98534392163,98534392158,-5,1265,5341,30
98534747648,98534747644,-4,1493,3250,30
98535036961,98535036957,-4,1080,3427,30
98535321127,98535321122,-5,872,2234,30
98537657907,98537657901,-6,883,3194,30
98538963682,98538963678,-4,600,1252,30
98539850469,98539850466,-3,1046,2401,30
98544434741,98544434737,-4,1001,2458,30
98544737883,98544737866,-17,978,2991,30
98545223914,98545223909,-5,827,3192,30
98551970130,98551970127,-3,937,1969,30
98552320888,98552320888,0,221,1376,30
98556446322,98556446321,-1,1183,2167,30
98560128784,98560128779,-5,1089,2599,30
98560721069,98560721064,-5,869,3042,30
98568816130,98568816126,-4,1164,2789,30
98572026938,98572026935,-3,1060,2501,30
98577529938,98577529943,5,3545,1805,30
98583299442,98583299438,-4,1037,3353,30
98583442889,98583442904,15,751,2407,30
98598299653,98598299649,-4,647,1634,30
98599685106,98599685102,-4,1098,2549,30
98603491030,98603491016,-14,1095,76,30
98605372059,98605372055,-4,1376,3394,30
98608489115,98608489111,-4,1221,2944,30
98612792893,98612792889,-4,904,2118,30
98613304263,98613304258,-5,712,1615,30
98619992510,98619992505,-5,1082,2325,30
98622980411,98622980419,8,2722,2716,30
98634813463,98634813458,-5,1399,2635,30
98636066664,98636066644,-20,964,2527,30
98637204793,98637204788,-5,1315,2943,30
98638780714,98638780710,-4,1047,2721,30
98641313371,98641313367,-4,1258,3719,30
98643284384,98643284379,-5,1475,3265,30
98646475386,98646475381,-5,1159,3710,30
98647290160,98647290153,-7,201,945,30
98648265209,98648265199,-10,703,1798,30
98651755543,98651755542,-1,1147,3671,30
98652248421,98652248415,-6,668,1817,30
98652858870,98652858872,2,1658,1705,30
98664967386,98664967381,-5,1042,2982,30
98665299043,98665299058,15,312,1876,30
98669153805,98669153802,-3,1119,2952,30
98670033954,98670033938,-16,133,904,30
98678528422,98678528418,-4,1365,2010,30
98682667077,98682667072,-5,937,2036,30
98685332522,98685332517,-5,878,2662,30
98688953525,98688953522,-3,1409,3275,30
98691004744,98691004739,-5,639,3100,30
98691121506,98691121486,-20,1182,3597,30
98691561402,98691561396,-6,309,2218,30
98694828710,98694828707,-3,905,2079,30
98706344325,98706344319,-6,939,3129,30
98706993798,98706993794,-4,1222,3904,30
98707424819,98707424817,-2,2624,5297,30
98710124681,98710124702,21,1581,3407,30
98710977312,98710977310,-2,1032,1944,30
98725133565,98725133562,-3,826,2777,30
98730632596,98730632593,-3,920,2595,30
98733537750,98733537742,-8,294,2104,30
98736421444,98736421441,-3,979,2962,30
98742178394,98742178388,-6,25222,17664,30
98742536110,98742536107,-3,386,1335,30
98746228746,98746228743,-3,1728,4361,30
98748649833,98748649821,-12,319,7376,30
98749845730,98749845712,-18,1066,3254,30
98750680385,98750680381,-4,1082,2882,30
98757853413,98757853426,13,13428,40743,30
98758220451,98758220453,2,231,1156,30
98760560166,98760560162,-4,1158,4272,30
98762959405,98762959401,-4,484,960,30
98765710147,98765710143,-4,1072,2540,30
98768423273,98768423269,-4,837,2540,30
98769751366,98769751361,-5,677,2368,30
98769907723,98769907741,18,1154,3442,30
98771098355,98771098353,-2,1003,2927,30
98783190547,98783190554,7,4976,2003,30
98789053951,98789053948,-3,784,2312,30
98789094962,98789094981,19,309,987,30
98791592098,98791592093,-5,952,2946,30
98792700267,98792700263,-4,1109,3080,30
98793121698,98793121694,-4,870,2363,30
98795020699,98795020694,-5,779,4231,30
98795067713,98795067727,14,368,1129,30
98802123506,98802123511,5,2854,1629,30
98805587391,98805587387,-4,493,2960,30
98809402483,98809402478,-5,887,3162,30
98813613702,98813613698,-4,1106,3789,30
98820314695,98820314692,-3,486,1143,30
98824746281,98824746274,-7,658,2741,30
98829851336,98829851337,1,737,1909,30
98830939901,98830939886,-15,3166,958,30
98832543109,98832543106,-3,752,2222,30
98833712601,98833712615,14,249,1185,30
98834326745,98834326731,-14,1019,2538,30
98835430060,98835430055,-5,4219,10976,30
98835758622,98835758634,12,13805,36326,30
98836288590,98836288586,-4,813,2323,30
98840712308,98840712304,-4,1492,3769,30
98842421062,98842421055,-7,1513,4514,30
98848931714,98848931710,-4,1478,3632,30
98849187135,98849187132,-3,892,2160,30
98850726462,98850726459,-3,1297,2555,30
98854355014,98854355008,-6,1170,3901,30
98860188169,98860188164,-5,748,1691,30
98861853716,98861853711,-5,1232,2941,30
98863573059,98863573054,-5,991,2569,30
98866676594,98866676590,-4,1131,3076,30
98867439470,98867439466,-4,993,3452,30
98867894507,98867894502,-5,1353,3306,30
98869516357,98869516354,-3,1113,3749,30
98869781580,98869781581,1,2049,1803,30
98875990446,98875990442,-4,1144,3307,30
98877293712,98877293727,15,884,2942,30
98877508898,98877508893,-5,1304,3514,30
98882572751,98882572747,-4,1148,2815,30
98882611940,98882611957,17,331,1352,30
98883996607,98883996605,-2,1097,2333,30
98884099758,98884099750,-8,883,2798,30
98884948241,98884948240,-1,1225,1533,30
98890403155,98890403150,-5,1053,2743,30
98890428282,98890428296,14,582,1783,30
98891789908,98891789905,-3,973,2949,30
98893864389,98893864386,-3,642,1881,30
98894688266,98894688260,-6,2006,7849,30
98899704932,98899704927,-5,1047,3606,30
98905764283,98905764279,-4,889,2597,30
98906715694,98906715689,-5,825,3370,30
98913898494,98913898488,-6,1215,3327,30
98921548870,98921548866,-4,1017,2774,30
98927725493,98927725488,-5,1112,3731,30
98930463357,98930463359,2,1655,1845,30
98932522047,98932522041,-6,1021,2971,30
98935074546,98935074545,-1,1288,2685,30
98940363964,98940363962,-2,901,1239,30
98943823362,98943823358,-4,1063,2794,30
98948691711,98948691710,-1,1804,2594,30
98949301692,98949301695,3,1678,1397,30
98950176177,98950176199,22,364,1233,30
98951092390,98951092377,-13,704,3400,30
98956223720,98956223717,-3,1198,2285,30
98961676263,98961676259,-4,1506,3788,30
98962249409,98962249407,-2,925,1634,30
98976887125,98976887122,-3,1728,3238,30
98986399173,98986399169,-4,992,2053,30
98988139345,98988139339,-6,891,3324,30
98988298779,98988298769,-10,1174,1144,30
98998237017,98998237013,-4,991,2937,30
99002248502,99002248496,-6,1242,3021,30
99002733178,99002733177,-1,1126,1973,30
99003475136,99003475146,10,191,877,30
99004245561,99004245556,-5,1263,3590,30
99008110548,99008110557,9,1740,2053,30
99016170899,99016170895,-4,1085,2553,30
99019223352,99019223347,-5,1128,2838,30
99023088945,99023088954,9,2023,1138,30
99024749859,99024749857,-2,2070,4531,30
99025777938,99025777934,-4,1092,3700,30
99025889514,99025889526,12,225,1293,30
99031047817,99031047813,-4,1336,3879,30
99031099647,99031099642,-5,1474,2932,30
99032156690,99032156686,-4,1269,3108,30
99032979210,99032979207,-3,1022,3521,30
99033757908,99033757903,-5,667,2705,30
99041769744,99041769741,-3,1168,2295,30
99043427011,99043427006,-5,1214,3508,30
99044412619,99044412614,-5,806,3014,30
99054734431,99054734450,19,1122,2750,30
99055104754,99055104753,-1,1090,2735,30
99055631235,99055631229,-6,1329,3411,30
99055887273,99055887270,-3,1278,2106,30
99060379142,99060379138,-4,1277,4031,30
99063452979,99063452972,-7,1305,3406,30
99064397612,99064397609,-3,957,3152,30
99065350145,99065350166,21,742,1867,30
99067141205,99067141198,-7,918,1800,30
99068226205,99068226198,-7,1175,1963,30
99068405984,99068405966,-18,278,1744,30
99070303834,99070303830,-4,1264,4254,30
99071025686,99071025681,-5,750,3063,30
99072635024,99072635018,-6,1087,2673,30
99076155654,99076155650,-4,2074,3608,30
99078136966,99078136961,-5,744,2011,30
99078699165,99078699163,-2,1165,2499,30
99081052530,99081052526,-4,705,2673,30
99087222491,99087222486,-5,1074,3895,30
99091155150,99091155154,4,3535,1777,30
99096277054,99096277051,-3,1157,3121,30
99096569260,99096569255,-5,1242,3349,30
99096886654,99096886648,-6,1074,3561,30
99103264144,99103264142,-2,1109,1302,30
99109608347,99109608342,-5,1050,3084,30
99110539572,99110539587,15,774,2224,30
99116184390,99116184384,-6,1010,5121,30
99116372827,99116372822,-5,951,1965,30
99116460640,99116460625,-15,182,604,30
99119419511,99119419506,-5,706,1341,30
99120379209,99120379202,-7,654,1958,30
99125827515,99125827511,-4,506,2209,30
99130966433,99130966428,-5,1512,3685,30
99132561255,99132561251,-4,1297,2768,30
99139867743,99139867738,-5,1033,2997,30
99141180619,99141180614,-5,1003,2355,30
99141859130,99141859134,4,1298,835,30
99144025828,99144025824,-4,829,2672,30
99145417475,99145417470,-5,949,2615,30
99150549611,99150549608,-3,935,3828,30
99152875666,99152875662,-4,1354,2889,30
99156250142,99156250135,-7,964,3040,30
99156280356,99156280367,11,356,1098,30
99157126434,99157126434,0,908,1153,30
99159604540,99159604558,18,1010,3696,30
99160826657,99160826653,-4,1164,2808,30
99160887496,99160887511,15,558,2202,30
99170535862,99170535857,-5,1165,3106,30
99171170825,99171170838,13,357,5218,30
99173359609,99173359627,18,660,3162,30
99175298655,99175298650,-5,1018,2303,30
99180520546,99180520540,-6,1466,3494,30
99181575249,99181575246,-3,689,3051,30
99183506847,99183506842,-5,679,1578,30
99185551683,99185551679,-4,1260,3629,30
99188065599,99188065592,-7,1089,2611,30
99188201410,99188201426,16,770,2311,30
99189873062,99189873066,4,3963,2886,30
99193084345,99193084341,-4,1407,3123,30
99199929131,99199929128,-3,1093,3063,30
99206364370,99206364371,1,2474,2151,30
99214209402,99214209398,-4,1322,3789,30
99216151262,99216151257,-5,941,2325,30
99216654754,99216654774,20,501,820,30
99216966675,99216966670,-5,910,2905,30
99218636450,99218636447,-3,819,1854,30
99218912986,99218912985,-1,1275,2041,30
99223091467,99223091462,-5,849,2761,30
99230320891,99230320886,-5,5459,16972,30
99231964821,99231964817,-4,1017,3373,30
99234956809,99234956816,7,3580,1886,30
99238764777,99238764770,-7,1073,2716,30
99238875693,99238875688,-5,1184,2632,30
99239960690,99239960685,-5,1312,2863,30
99240681003,99240680999,-4,306,655,30
99243540271,99243540267,-4,997,3624,30
99246632671,99246632667,-4,1523,3556,30
99252024325,99252024322,-3,668,1595,30
99255863609,99255863615,6,2670,1272,30
99255934002,99255934018,16,1145,3202,30
99256930847,99256930845,-2,1432,2440,30
99259521747,99259521742,-5,1177,2560,30
99268116065,99268116059,-6,1258,3132,30
99268242787,99268242787,0,1463,1780,30
99268270369,99268270363,-6,691,3037,30
99269274028,99269274046,18,1116,2608,30
99271928507,99271928502,-5,940,4349,30
99272353137,99272353153,16,681,1800,30
99274284173,99274284169,-4,1230,3609,30
99274432874,99274432868,-6,1089,3277,30
99278198811,99278198806,-5,1079,2350,30
99280774566,99280774562,-4,1398,4226,30
99281541299,99281541293,-6,1013,2807,30
99281892839,99281892831,-8,901,2761,30
99282011321,99282011331,10,223,1574,30
99293632691,99293632685,-6,903,3956,30
99295444396,99295444393,-3,1934,4175,30
99298546257,99298546252,-5,1194,3012,30
99299451043,99299451039,-4,1303,2688,30
99303147587,99303147585,-2,1031,2544,30
99305802044,99305802038,-6,1376,2954,30
99311455831,99311455829,-2,716,2453,30
99317494683,99317494669,-14,346,1052,30
99319135059,99319135070,11,509,2183,30
99319678778,99319678774,-4,962,2710,30
99322596554,99322596550,-4,1116,3509,30
99323534874,99323534869,-5,867,1802,30
99336125060,99336125047,-13,177,1362,30
99336661538,99336661534,-4,1008,3105,30
99336704383,99336704377,-6,1575,3500,30
99340476920,99340476917,-3,1020,1982,30
99345489473,99345489467,-6,1362,2731,30
99348970215,99348970209,-6,1292,3929,30
99355774385,99355774381,-4,827,2610,30
99361668783,99361668778,-5,1370,2950,30
99361703220,99361703206,-14,198,1011,30
99362348430,99362348427,-3,600,1865,30
99367679678,99367679677,-1,711,2411,30
99374920808,99374920812,4,5282,2559,30
99394373730,99394373726,-4,1114,2875,30
99396049775,99396049770,-5,1625,5942,30
99405273021,99405273015,-6,992,2953,30
99405987305,99405987301,-4,1097,2782,30
99414673593,99414673590,-3,912,2306,30
99415008516,99415008531,15,203,1012,30
99425909204,99425909196,-8,1810,8905,30
99438882645,99438882641,-4,407,1310,30
99440972869,99440972874,5,2818,1303,30
99441482874,99441482870,-4,1468,4076,30
99444065108,99444065101,-7,1085,2838,30
99450257685,99450257693,8,3147,1803,30
99450880794,99450880788,-6,980,1943,30
99451102913,99451102932,19,622,2202,30
99451531298,99451531293,-5,1249,2683,30
99451931347,99451931346,-1,1269,2284,30
99453830887,99453830879,-8,979,3798,30
99455457014,99455457008,-6,1086,2975,30
99457382954,99457382951,-3,939,2848,30
99457468876,99457468871,-5,703,3856,30
99458225467,99458225463,-4,1064,2840,30
99459452595,99459452593,-2,1201,3142,30
99464945695,99464945690,-5,962,2250,30
99468950438,99468950435,-3,1061,2010,30
99475917334,99475917331,-3,618,2146,30
99476834542,99476834537,-5,1392,3745,30
99491902538,99491902543,5,1872,1303,30
99497912702,99497912696,-6,816,3219,30
99500320266,99500320260,-6,833,3208,30
99510548351,99510548348,-3,1163,2896,30
99511269886,99511269882,-4,1154,3049,30
99512159882,99512159883,1,1277,1830,30
99513821534,99513821528,-6,1008,3326,30
99514331521,99514331503,-18,1218,606,30
99515500939,99515500933,-6,1426,3343,30
99515812771,99515812786,15,1174,2849,30
99516100091,99516100068,-23,706,2409,30
99516431692,99516431688,-4,1062,1796,30
99516671749,99516671746,-3,1332,2623,30
99516798478,99516798474,-4,1127,2843,30
99516824993,99516824978,-15,155,1538,30
99522120006,99522120004,-2,1093,2170,30
99526615495,99526615491,-4,1245,3625,30
99528184557,99528184557,0,1762,2189,30
99528828923,99528828917,-6,859,2165,30
99529456065,99529456054,-11,293,1071,30
99529936522,99529936503,-19,979,1585,30
99531432171,99531432165,-6,1472,3020,30
99532182361,99532182369,8,1401,1641,30
99534251978,99534251974,-4,1413,2731,30
99535370133,99535370126,-7,1292,2839,30
99535525002,99535524991,-11,194,691,30
99555094995,99555094992,-3,918,1906,30
99561131807,99561131810,3,402,1174,30
99564533265,99564533262,-3,684,2170,30
99575943350,99575943347,-3,857,2908,30
99577259240,99577259261,21,168,870,30
99579463899,99579463898,-1,1170,1712,30
99580330189,99580330185,-4,1145,3251,30
99584276779,99584276771,-8,1280,4229,30
99586775974,99586775979,5,2102,760,30
99591077554,99591077553,-1,1058,2649,30
99593453710,99593453705,-5,1282,2600,30
99594845889,99594845885,-4,894,2900,30
99602569105,99602569101,-4,946,1841,30
99607439082,99607439080,-2,1575,3226,30
99607959958,99607959962,4,2074,928,30
99608341910,99608341903,-7,902,2963,30
99611530414,99611530410,-4,971,3922,30
99615925105,99615925101,-4,805,2008,30
99620108110,99620108106,-4,1245,2897,30
99621381825,99621381817,-8,1081,3033,30
99621584217,99621584232,15,643,1568,30
99628948518,99628948514,-4,1254,3260,30
99634447902,99634447902,0,690,1607,30
99638495132,99638495113,-19,2816,1672,30
99640747091,99640747095,4,1400,821,30
99646942325,99646942326,1,1304,1531,30
99652091734,99652091728,-6,1483,6639,30
99657208190,99657208189,-1,998,1157,30
99662724858,99662724856,-2,740,2424,30
99668992175,99668992170,-5,998,2564,30
99676989855,99676989851,-4,808,2605,30
99677190995,99677190973,-22,971,3943,30
99681375641,99681375637,-4,1042,3564,30
99682921315,99682921309,-6,826,2490,30
99696433783,99696433778,-5,700,2787,30
99699050367,99699050365,-2,985,3654,30
99708731975,99708731971,-4,965,2236,30
99708792671,99708792671,0,518,948,30
99709840722,99709840700,-22,198,1001,30
99711335372,99711335366,-6,1350,3774,30
99712698757,99712698754,-3,1489,2111,30
99715580057,99715580050,-7,996,3226,30
99722348187,99722348180,-7,1040,4664,30
99722670491,99722670486,-5,1167,4127,30
99726217309,99726217315,6,2361,1600,30
99726906977,99726906973,-4,739,2455,30
99732042215,99732042210,-5,852,2984,30
99733458974,99733458969,-5,876,3486,30
99735264918,99735264914,-4,731,2791,30
99735295802,99735295815,13,208,965,30
99735510008,99735510031,23,100,825,30
99740492591,99740492588,-3,961,2694,30
99742082327,99742082322,-5,1076,2936,30
99745164522,99745164517,-5,1102,3173,30
99761463107,99761463105,-2,670,1525,30
99765251625,99765251622,-3,856,84,30
99765918752,99765918746,-6,980,2488,30
99767493234,99767493232,-2,800,1632,30
99768051558,99768051563,5,3340,1701,30
99770767030,99770767024,-6,828,2772,30
99774440447,99774440445,-2,646,1178,30
99779278873,99779278865,-8,1205,4533,30
99782008643,99782008638,-5,1193,2587,30
99783824758,99783824750,-8,832,4419,30
99784830302,99784830298,-4,1180,2239,30
99785041622,99785041617,-5,1268,3210,30
99785145610,99785145626,16,412,2020,30
99792121676,99792121673,-3,955,2017,30
99796141218,99796141211,-7,817,2175,30
99799764895,99799764890,-5,1282,4150,30
99799813352,99799813347,-5,862,1662,30
99802398422,99802398418,-4,1320,2308,30
99806541567,99806541563,-4,881,2786,30
99808925995,99808925990,-5,979,3381,30
99810140626,99810140622,-4,1113,2402,30
99810310054,99810310050,-4,1094,2507,30
99823344346,99823344341,-5,1171,2830,30
99827615059,99827615056,-3,889,2598,30
99832050311,99832050306,-5,1110,2282,30
99839139046,99839139045,-1,214,756,30
99840107225,99840107247,22,1215,2358,30
99844728653,99844728649,-4,1066,2638,30
99848368899,99848368895,-4,1393,2837,30
99853893552,99853893552,0,809,1357,30
99855809711,99855809715,4,11378,8217,30
99857405487,99857405479,-8,914,2079,30
99860118598,99860118595,-3,1122,2585,30
99860392027,99860392023,-4,1479,3285,30
99860682666,99860682662,-4,1126,2919,30
99862951467,99862951465,-2,629,3037,30
99865063025,99865063017,-8,1023,4449,30
99868290830,99868290825,-5,1231,2528,30
99872154629,99872154621,-8,907,1727,30
99872471548,99872471565,17,134,1112,30
99874755486,99874755481,-5,937,2329,30
99875937637,99875937632,-5,1257,2865,30
99877498918,99877498913,-5,910,1992,30
99878463740,99878463754,14,356,2106,30
99881405578,99881405585,7,16411,20110,30
99887833458,99887833451,-7,1362,4380,30
99892843105,99892843103,-2,941,3137,30
99898551566,99898551561,-5,988,2852,30
99909931118,99909931115,-3,1152,3114,30
99911437709,99911437705,-4,1212,2360,30
99913421818,99913421813,-5,809,2524,30
99914024762,99914024758,-4,965,2806,30
99915851379,99915851373,-6,1220,3811,30
99918302725,99918302720,-5,1137,5232,30
99919530118,99919530114,-4,948,3305,30
99924594442,99924594437,-5,1091,3568,30
99924971565,99924971561,-4,1430,3498,30
99926771933,99926771929,-4,1134,3635,30
99927340275,99927340273,-2,123,929,30
99930472302,99930472298,-4,531,2033,30
99932096401,99932096421,20,668,1166,30
99939116550,99939116544,-6,978,3557,30
99940485922,99940485917,-5,1050,3457,30
99945314896,99945314891,-5,1149,3329,30
99951038366,99951038361,-5,723,2758,30
99953860532,99953860527,-5,1340,2581,30
99954393404,99954393423,19,301,1318,30
99958475403,99958475400,-3,1207,3281,30
99967196587,99967196582,-5,1219,3058,30
99967411602,99967411598,-4,733,1839,30
99974959959,99974959953,-6,733,1853,30
99986094214,99986094210,-4,1330,3181,30
99990664552,99990664552,0,1672,2522,30
99995141358,99995141354,-4,1062,2431,30
99995381618,99995381637,19,1211,2272,30
99997118734,99997118732,-2,885,2260,30
99999049470,99999049465,-5,883,2721,30
99999683043,99999683027,-16,201,623,30
100001732670,100001732665,-5,1158,3591,30
100004453975,100004453969,-6,900,2775,30
100006320728,100006320723,-5,1037,3087,30
100009960716,100009960711,-5,960,3025,30
100011596931,100011596928,-3,963,2878,30
100013285670,100013285667,-3,908,2272,30
100015626878,100015626876,-2,1319,2547,30
100016571922,100016571900,-22,1142,3264,30
100016836330,100016836322,-8,297,1242,30
100017776226,100017776221,-5,1248,3175,30
100020858446,100020858441,-5,1098,3543,30
100023690421,100023690416,-5,507,1509,30
100025179497,100025179494,-3,852,1485,30
100026523507,100026523503,-4,1049,2360,30
100032201274,100032201272,-2,772,2997,30
100032606747,100032606743,-4,788,2962,30
100032860941,100032860935,-6,1390,3206,30
100033336498,100033336519,21,168,1400,30
100034709411,100034709407,-4,712,2247,30
100041301670,100041301656,-14,1077,3952,30
100042669694,100042669689,-5,1054,3289,30
100044516366,100044516362,-4,1090,2016,30
100045977186,100045977181,-5,910,3567,30
100048020529,100048020525,-4,1131,2951,30
100050431194,100050431193,-1,1810,3414,30
100053133374,100053133370,-4,1176,2567,30
100056178542,100056178538,-4,787,2632,30
100057737319,100057737317,-2,930,2969,30
100063320473,100063320467,-6,851,2171,30
100063806118,100063806115,-3,1124,3456,30
100069550775,100069550769,-6,790,2314,30
100071367773,100071367769,-4,1052,1512,30
100074021778,100074021774,-4,750,1499,30
100076377231,100076377228,-3,888,2388,30
100078583050,100078583059,9,10113,30027,30
100083419354,100083419345,-9,575,258,30
100085991267,100085991262,-5,937,2601,30
100087161559,100087161556,-3,1074,3229,30
100091999569,100091999562,-7,1021,3094,30
100092475659,100092475655,-4,285,1276,30
100093317251,100093317252,1,1382,2090,30
100096340441,100096340439,-2,928,1480,30
100099736086,100099736093,7,4799,1812,30
100100408574,100100408595,21,706,1193,30
100101820340,100101820334,-6,959,2878,30
100103455497,100103455491,-6,933,2842,30
100111845747,100111845727,-20,1635,2967,30
100116236906,100116236901,-5,990,3925,30
100117963961,100117963958,-3,1245,4011,30
100119424883,100119424878,-5,1012,2644,30
100121652621,100121652618,-3,672,2311,30
100122980838,100122980840,2,6383,7481,30
100124283586,100124283582,-4,1159,3833,30
100127070542,100127070537,-5,1012,4210,30
100127868496,100127868492,-4,1164,3762,30
100128554934,100128554930,-4,986,3513,30
100134252598,100134252594,-4,803,3913,30
100136248598,100136248593,-5,1463,3479,30
100137210562,100137210555,-7,1733,4703,30
100144017425,100144017419,-6,1232,3093,30
100144703800,100144703796,-4,199,1194,30
100145830491,100145830486,-5,972,3144,30
100147150061,100147150054,-7,832,3079,30
100149477560,100149477554,-6,1123,3068,30
100150758393,100150758388,-5,807,2472,30
100157724740,100157724735,-5,509,1226,30
100160011483,100160011479,-4,810,2370,30
100161051665,100161051660,-5,1042,2023,30
100161303658,100161303654,-4,941,2692,30
100162961745,100162961740,-5,1132,2998,30
100164988667,100164988665,-2,1176,3320,30
100167391311,100167391306,-5,963,2623,30
100172712733,100172712729,-4,1206,3486,30
100179572998,100179572990,-8,1858,10250,30
100182198014,100182198018,4,1588,1424,30
100186835966,100186835962,-4,1035,2864,30
100195433542,100195433543,1,1529,1956,30
100196240827,100196240822,-5,839,2998,30
100196903761,100196903757,-4,957,2793,30
100197346025,100197346019,-6,910,3161,30
100200995327,100200995324,-3,802,2206,30
100201617668,100201617663,-5,751,1651,30
100202660208,100202660203,-5,1070,2975,30
100203334738,100203334734,-4,1180,2774,30
100204188344,100204188367,23,435,2561,30
100205818817,100205818810,-7,873,3079,30
100205915371,100205915357,-14,173,861,30
100206281985,100206281978,-7,920,2720,30
100208719637,100208719633,-4,1481,3707,30
100211892941,100211892945,4,57992,36468,30
100214323749,100214323745,-4,1014,2134,30
100225956942,100225956946,4,2133,997,30
100226195020,100226195017,-3,1203,3039,30
100226294401,100226294389,-12,931,4580,30
100226985227,100226985222,-5,813,2930,30
100228257178,100228257174,-4,1345,2822,30
100228487843,100228487857,14,519,2459,30
100229734936,100229734930,-6,1384,3418,30
100230801103,100230801099,-4,1069,2933,30
100231288597,100231288592,-5,1130,2806,30
100231526359,100231526353,-6,732,3679,30
100231715258,100231715263,5,273,1169,30
100233955666,100233955663,-3,1689,3943,30
100234303432,100234303423,-9,661,3182,30
100236252200,100236252196,-4,1252,4837,30
100237267819,100237267814,-5,597,1957,30
100240359333,100240359329,-4,1226,3646,30
100240727611,100240727630,19,380,1772,30
100241870338,100241870333,-5,1143,4013,30
100242805316,100242805313,-3,1002,3405,30
100243984707,100243984702,-5,768,2576,30
100255504545,100255504542,-3,1903,2945,30
100257451208,100257451204,-4,1432,3256,30
100258575316,100258575311,-5,2581,5703,30
100261289819,100261289814,-5,658,2665,30
100261344513,100261344529,16,244,878,30
100262169966,100262169966,0,1918,1453,30
100266652383,100266652387,4,2546,1536,30
100267438846,100267438843,-3,874,1315,30
100271909377,100271909373,-4,769,2778,30
100273308699,100273308702,3,254,790,30
100276818464,100276818485,21,653,1890,30
100283634794,100283634790,-4,885,1829,30
100283775121,100283775141,20,1172,2794,30
100286530775,100286530771,-4,1220,2426,30
100288177507,100288177510,3,1596,1981,30
100290631798,100290631795,-3,1064,2714,30
100301099198,100301099194,-4,861,3363,30
100307630677,100307630671,-6,1177,2936,30
100308193546,100308193566,20,761,2127,30
100314060000,100314059995,-5,1071,2873,30
100321248305,100321248301,-4,1241,2441,30
100323586720,100323586718,-2,1329,3169,30
100323698978,100323698977,-1,1678,3564,30
100330246070,100330246067,-3,1048,2822,30
100332129083,100332129085,2,2416,2677,30
100332988783,100332988778,-5,940,3143,30
100334722046,100334722042,-4,593,833,30
100342461591,100342461588,-3,787,1481,30
100343622486,100343622483,-3,1236,3395,30
100343784187,100343784185,-2,1432,2394,30
100350913844,100350913835,-9,1141,4270,30
100359772803,100359772798,-5,1325,3336,30
100361339368,100361339370,2,1712,1532,30
100377057664,100377057660,-4,1216,4124,30
100379400693,100379400690,-3,893,2950,30
100380542143,100380542138,-5,1514,3770,30
100390164123,100390164120,-3,1187,2486,30
100391491971,100391491991,20,1425,3826,30
100395098446,100395098440,-6,1069,2326,30
100396218668,100396218662,-6,749,2258,30
100402060588,100402060583,-5,1177,4136,30
100402555265,100402555267,2,1980,1622,30
100402652503,100402652498,-5,1090,3213,30
100403220664,100403220663,-1,3671,6011,30
100406457437,100406457433,-4,1150,3379,30
100408221411,100408221406,-5,831,2386,30
100422098095,100422098098,3,1235,1403,30
100422738383,100422738381,-2,626,2269,30
100422936360,100422936363,3,8282,5170,30
100430486075,100430486067,-8,934,2723,30
100431134723,100431134735,12,628,2225,30
100443373575,100443373570,-5,585,1994,30
100448923361,100448923359,-2,1319,2848,30
100455705643,100455705639,-4,869,1609,30
100458196554,100458196549,-5,1208,2247,30
100458261370,100458261366,-4,1014,2672,30
100463355610,100463355605,-5,1471,3181,30
100467805242,100467805239,-3,970,3085,30
100468234385,100468234383,-2,238,1580,30
100468811275,100468811269,-6,488,1879,30
100470381109,100470381103,-6,1537,2460,30
100470708853,100470708849,-4,1037,2188,30
100470757641,100470757661,20,789,1312,30
100473662098,100473662093,-5,917,1948,30
100476809665,100476809659,-6,1076,2650,30
100479143266,100479143268,2,6203,28176,30
100480431784,100480431784,0,8340,22625,30
100484372269,100484372266,-3,840,2506,30
100485711752,100485711747,-5,1369,2656,30
100485843639,100485843634,-5,1405,3336,30
100488710503,100488710495,-8,1076,2179,30
100489180777,100489180765,-12,924,2729,30
100490840478,100490840474,-4,697,2203,30
100491437403,100491437399,-4,1274,2533,30
100493712872,100493712885,13,376,1032,30
100494763696,100494763691,-5,1375,2783,30
100495813816,100495813807,-9,170,1133,30
100497493506,100497493513,7,1808,989,30
100498287106,100498287101,-5,980,2470,30
100498443834,100498443830,-4,908,2191,30
100498506546,100498506547,1,144,1116,30
100505422833,100505422828,-5,1051,2665,30
100507597933,100507597926,-7,1669,7020,30
100513930046,100513930041,-5,914,3546,30
100518848477,100518848473,-4,830,2058,30
100519269913,100519269911,-2,1341,2601,30
100519893888,100519893907,19,214,924,30
100528568807,100528568801,-6,535,2546,30
100529526414,100529526410,-4,1373,2504,30
100530273343,100530273321,-22,552,250,30
100530967934,100530967930,-4,1312,2757,30
100534744330,100534744322,-8,1214,2918,30
100547566911,100547566906,-5,1166,3105,30
100552936139,100552936132,-7,839,2538,30
100557061826,100557061822,-4,1023,1816,30
100558941509,100558941514,5,3047,1363,30
100565000054,100565000049,-5,546,2088,30
100565301418,100565301418,0,176,1210,30
100569120983,100569120978,-5,890,2814,30
100572300462,100572300459,-3,763,2527,30
100572476162,100572476140,-22,783,2541,30
100575818577,100575818575,-2,584,1559,30
100582658542,100582658539,-3,835,2419,30
100583035391,100583035386,-5,1222,2852,30
100589435427,100589435422,-5,990,2903,30
100596487202,100596487199,-3,606,1582,30
100598349910,100598349906,-4,1268,2822,30
100598599302,100598599296,-6,912,3129,30
100598764248,100598764234,-14,245,911,30
100601262684,100601262680,-4,1096,3284,30
100604852038,100604852033,-5,1360,2959,30
100606665744,100606665738,-6,1166,3074,30
100607382801,100607382799,-2,1174,2605,30
100610690059,100610690055,-4,719,2122,30
100611303586,100611303582,-4,1218,3137,30
100611469862,100611469863,1,973,1557,30
100618009639,100618009634,-5,695,3037,30
100618416919,100618416916,-3,755,1601,30
100620132190,100620132182,-8,1181,3582,30
100620288356,100620288366,10,438,923,30
100620914346,100620914341,-5,911,3254,30
100626946442,100626946438,-4,900,2004,30
100627681623,100627681618,-5,859,2817,30
100629842742,100629842737,-5,873,1923,30
100633786194,100633786187,-7,735,2339,30
100637273834,100637273830,-4,1185,3419,30
100644675606,100644675602,-4,1460,3039,30
100647297770,100647297765,-5,845,1856,30
100648079114,100648079111,-3,1380,2447,30
100651860311,100651860307,-4,1125,3133,30
100652718438,100652718434,-4,939,2391,30
100655083317,100655083311,-6,1064,2499,30
100657821430,100657821425,-5,1061,2719,30
100661103973,100661103967,-6,1672,3375,30
100662531619,100662531614,-5,1206,2300,30
100663267723,100663267719,-4,728,2582,30
100666003814,100666003809,-5,1285,3200,30
100672455539,100672455535,-4,930,3008,30
100672731756,100672731758,2,1324,1049,30
100672771909,100672771905,-4,902,2351,30
100673275818,100673275814,-4,1249,3559,30
100673341265,100673341287,22,343,2693,30
100680105622,100680105617,-5,1145,2865,30
100685118016,100685118012,-4,1558,2857,30
100685933307,100685933304,-3,1357,2750,30
100687113001,100687112997,-4,1187,3851,30
100689550963,100689550962,-1,1253,2470,30
100702477127,100702477122,-5,891,2564,30
100703055414,100703055411,-3,1028,3442,30
100704482864,100704482858,-6,1265,3771,30
100707259477,100707259473,-4,1193,3286,30
100710635735,100710635734,-1,992,2453,30
100712810210,100712810206,-4,753,2212,30
100713402698,100713402714,16,1248,2038,30
100720258382,100720258377,-5,1131,3088,30
100721278107,100721278102,-5,990,3127,30
100721507379,100721507397,18,1079,2277,30
100723368970,100723368966,-4,1230,2783,30
100723973460,100723973479,19,483,2563,30
100727610290,100727610286,-4,1286,3199,30
100727745101,100727745097,-4,1014,2108,30
100729617245,100729617241,-4,1168,2207,30
100730740603,100730740601,-2,1114,2401,30
100732604783,100732604777,-6,1079,3609,30
100732859830,100732859830,0,1274,2291,30
100734425763,100734425759,-4,941,2409,30
100734701688,100734701669,-19,196,1231,30
100736236027,100736236023,-4,910,2633,30
100737120401,100737120412,11,184,1462,30
100738431363,100738431358,-5,1134,3740,30
100738882968,100738882961,-7,872,2713,30
100739023358,100739023354,-4,1091,3542,30
100740247753,100740247748,-5,868,2663,30
100741385505,100741385500,-5,1046,3007,30
100746663558,100746663558,0,1813,1723,30
100750160344,100750160339,-5,1139,3294,30
100750472226,100750472210,-16,243,1246,30
100753773823,100753773819,-4,655,1494,30
100755433668,100755433663,-5,1097,4176,30
100755765947,100755765963,16,74,889,30
100760651895,100760651890,-5,1214,2568,30
100765177516,100765177522,6,3072,1629,30
100765690890,100765690888,-2,723,2683,30
100766301951,100766301949,-2,999,1677,30
100767401794,100767401790,-4,1140,3281,30
100768649371,100768649364,-7,1025,2867,30
100770278431,100770278426,-5,828,2539,30
100770553459,100770553461,2,1852,1688,30
100772124091,100772124085,-6,824,2875,30
100773884937,100773884934,-3,907,1180,30
100776947742,100776947734,-8,1316,6073,30
100777916959,100777916956,-3,921,2733,30
100781456191,100781456186,-5,789,3088,30
100782229736,100782229730,-6,1299,4513,30
100782718943,100782718937,-6,1293,2740,30
100788183261,100788183257,-4,1089,3002,30
100794533658,100794533655,-3,1421,2411,30
100794980743,100794980740,-3,1026,3238,30
100799997955,100799997949,-6,640,1525,30
100807297334,100807297329,-5,993,3622,30
100807867231,100807867230,-1,853,2155,30
100815146750,100815146745,-5,1268,2936,30
100818876900,100818876895,-5,1451,3150,30
100820373898,100820373894,-4,1434,3236,30
100821782945,100821782943,-2,781,1515,30
100822582849,100822582843,-6,911,2542,30
100823588222,100823588218,-4,2116,5361,30
100830473736,100830473730,-6,844,2301,30
100831482627,100831482637,10,257,1003,30
100834150217,100834150210,-7,914,3640,30
100835351256,100835351262,6,3177,1467,30
100837307124,100837307132,8,40056,2993,30
100837422096,100837422093,-3,800,3022,30
100839077843,100839077863,20,2575,1047,30
100839321695,100839321690,-5,1214,3040,30
100840081429,100840081425,-4,1057,3012,30
100841232154,100841232149,-5,1468,3368,30
100841344644,100841344663,19,315,1256,30
100841401136,100841401130,-6,1178,3073,30
100847257406,100847257403,-3,787,2981,30
100850027164,100850027170,6,4344,1294,30
100858380001,100858380007,6,4034,1219,30
100864443067,100864443062,-5,850,2448,30
100866207953,100866207947,-6,987,2191,30
100868020605,100868020600,-5,1132,2772,30
100869097302,100869097301,-1,1604,2157,30
100874235427,100874235422,-5,1157,3648,30
100875997404,100875997418,14,15327,7248,30
100881336539,100881336534,-5,1116,2748,30
100884358331,100884358326,-5,1282,2402,30
100885747579,100885747573,-6,1163,2906,30
100904499185,100904499178,-7,1274,4003,30
100909277755,100909277752,-3,1400,3488,30
100915593977,100915593974,-3,822,2627,30
100919350578,100919350574,-4,1596,3694,30
100922602599,100922602596,-3,1385,2985,30
100925471064,100925471062,-2,1699,3565,30
100926938020,100926938013,-7,2149,8647,30
100927171818,100927171814,-4,965,2425,30
100930542510,100930542505,-5,1609,3129,30
100934549249,100934549245,-4,835,2265,30
100937751606,100937751602,-4,823,3100,30
100940268099,100940268094,-5,1552,2627,30
100943176362,100943176354,-8,1178,3091,30
100947664238,100947664233,-5,1601,3950,30
100949185659,100949185653,-6,936,3357,30
100953268511,100953268507,-4,1091,2926,30
100955104282,100955104284,2,17268,35540,30
100955261378,100955261374,-4,917,2087,30
100962894282,100962894277,-5,793,1963,30
100963736114,100963736115,1,893,1250,30
100964263229,100964263237,8,4036,1634,30
100971254393,100971254408,15,62,1086,30
100978829107,100978829102,-5,1081,2369,30
100979042401,100979042396,-5,714,1812,30
100980539445,100980539441,-4,1152,4021,30
100986315277,100986315269,-8,1015,4030,30
100989009587,100989009593,6,3937,1421,30
100993101737,100993101733,-4,1234,2434,30
100995980958,100995980956,-2,819,2504,30
100996341869,100996341863,-6,1066,3698,30
100996498129,100996498126,-3,248,905,30
101002129793,101002129810,17,711,2893,30
101006249965,101006249959,-6,1384,4056,30
101008209547,101008209553,6,1329,1120,30
101013801334,101013801330,-4,1245,3281,30
101014541442,101014541435,-7,723,1056,30
101018258593,101018258589,-4,888,3337,30
101020986847,101020986844,-3,898,2936,30
101022716207,101022716209,2,1517,1565,30
101024222174,101024222170,-4,1014,2082,30
101024577946,101024577965,19,79,756,30
101024906475,101024906469,-6,1272,6135,30
101028993625,101028993621,-4,893,2424,30
101029935492,101029935515,23,1378,2417,30
101032473391,101032473388,-3,1257,2576,30
101055681550,101055681545,-5,979,2921,30
101056318835,101056318830,-5,1049,2653,30
101057055058,101057055057,-1,2389,3255,30
101060294327,101060294325,-2,1149,2239,30
101062326373,101062326368,-5,816,1914,30
101076839579,101076839574,-5,1133,2522,30
101079242663,101079242658,-5,1016,2302,30
101082575782,101082575778,-4,1094,3577,30
101082631169,101082631166,-3,936,3163,30
101085602681,101085602675,-6,1077,3409,30
101087712751,101087712758,7,3327,1340,30
101092148581,101092148583,2,1993,1193,30
101093022225,101093022218,-7,1019,2808,30
101094521327,101094521323,-4,824,2240,30
101095151878,101095151873,-5,939,2987,30
101097233359,101097233354,-5,48168,18664,30
101099948141,101099948135,-6,1109,3645,30
101100181487,101100181488,1,3131,3104,30
101100227983,101100227979,-4,880,2000,30
101102993843,101102993840,-3,1382,2833,30
101107586554,101107586555,1,1294,1250,30
101117959402,101117959399,-3,893,3128,30
101118095409,101118095427,18,554,1048,30
101119077987,101119077983,-4,943,2533,30
101123905282,101123905276,-6,1089,3074,30
101124681131,101124681109,-22,1142,4798,30
101125249146,101125249142,-4,1339,2031,30
101125698870,101125698866,-4,998,2666,30
101126709901,101126709897,-4,837,3086,30
101129095329,101129095322,-7,1201,1990,30
101129885914,101129885930,16,175,1390,30
101130709920,101130709918,-2,1900,1958,30
101131048873,101131048895,22,400,1044,30
101136420247,101136420240,-7,1204,2595,30
101137980719,101137980719,0,840,1801,30
101138388645,101138388646,1,1422,1418,30
101150630398,101150630394,-4,1073,3032,30
101150932191,101150932199,8,67064,112777,30
101156387494,101156387489,-5,1060,2511,30
101159222632,101159222629,-3,1593,3353,30
101159462528,101159462524,-4,862,3193,30
101162923143,101162923139,-4,1305,3412,30
101164773443,101164773438,-5,672,2119,30
101181400216,101181400210,-6,1144,3330,30
101184340642,101184340638,-4,740,1877,30
101186611494,101186611489,-5,1046,3603,30
101187347134,101187347130,-4,1394,3720,30
101192331174,101192331172,-2,854,2714,30
101192409436,101192409454,18,810,2559,30
101193916962,101193916957,-5,976,2853,30
101195184454,101195184450,-4,1416,3172,30
101195320890,101195320883,-7,1602,5257,30
101195924165,101195924159,-6,2030,6869,30
101197314449,101197314444,-5,1572,4285,30
101204144133,101204144136,3,6056,30159,30
101209638400,101209638407,7,3964,1323,30
101211531421,101211531414,-7,1160,3873,30
101221087535,101221087531,-4,1330,3100,30
101222925258,101222925253,-5,854,3056,30
101222995315,101222995317,2,156,1095,30
101228778269,101228778265,-4,1131,4185,30
101228867521,101228867539,18,666,3282,30
101231660811,101231660807,-4,1324,3778,30
101234347374,101234347373,-1,1892,2351,30
101236062794,101236062789,-5,1123,2496,30
101242664209,101242664215,6,3179,1386,30
101245428089,101245428086,-3,910,2670,30
101247161703,101247161698,-5,1119,3552,30
101248485657,101248485650,-7,120,535,30
101251716746,101251716754,8,2652,932,30
101253228726,101253228722,-4,1110,2016,30
101258678275,101258678270,-5,934,2614,30
101260313833,101260313829,-4,999,2992,30
101262692382,101262692378,-4,647,1353,30
101262869890,101262869886,-4,968,2749,30
101264737630,101264737626,-4,1530,3824,30
101267855887,101267855883,-4,1180,2548,30
101269006110,101269006105,-5,1261,5961,30
101270244022,101270244018,-4,1172,2855,30
101273171791,101273171787,-4,1296,3038,30
101278547557,101278547553,-4,588,1434,30
101285650697,101285650703,6,10583,5772,30
101291904702,101291904700,-2,881,2308,30
101293979733,101293979731,-2,1074,2495,30
101294046378,101294046393,15,639,2386,30
101302099066,101302099061,-5,1120,3061,30
101304978116,101304978112,-4,851,2380,30
101306951023,101306951019,-4,1002,3339,30
101307775010,101307775031,21,903,2784,30
101308526088,101308526100,12,9929,44985,30
101309374200,101309374203,3,2188,1378,30
101312357269,101312357271,2,1912,1873,30
101313388140,101313388154,14,465,1737,30
101318189867,101318189863,-4,777,2338,30
101318715551,101318715545,-6,1143,2012,30
101319681822,101319681817,-5,923,2038,30
101321376517,101321376513,-4,1139,3919,30
101322126451,101322126447,-4,1162,2327,30
101326222475,101326222471,-4,1469,3207,30
101327069695,101327069698,3,1521,692,30
101332482449,101332482451,2,6111,17292,30
101332524653,101332524647,-6,1711,2762,30
101335158017,101335158010,-7,1086,2342,30
101335437835,101335437818,-17,1099,3582,30
101337645099,101337645094,-5,1051,2530,30
101339198002,101339197998,-4,1098,4084,30
101344893870,101344893868,-2,1376,1803,30
101351417799,101351417796,-3,1008,2670,30
101354861230,101354861227,-3,809,1712,30
101356003154,101356003147,-7,575,1598,30
101356147513,101356147532,19,859,2345,30
101362423933,101362423930,-3,749,2175,30
101369469405,101369469418,13,11969,44460,30
101371813060,101371813079,19,426,1791,30
101372368725,101372368721,-4,1407,2752,30
101381152114,101381152109,-5,868,3369,30
101386617794,101386617789,-5,1096,3021,30
101388920047,101388920042,-5,796,3193,30
101393779435,101393779431,-4,1231,3134,30
101395109069,101395109074,5,2557,1556,30
101401649827,101401649822,-5,934,2571,30
101407229606,101407229601,-5,31159,20819,30
101408079887,101408079882,-5,1352,3828,30
101411814665,101411814661,-4,1291,2336,30
101413319062,101413319059,-3,851,2095,30
101414569282,101414569282,0,1204,2144,30
101415662693,101415662690,-3,1347,3540,30
101419070280,101419070280,0,1266,1857,30
101424646223,101424646219,-4,1041,2044,30
101434116243,101434116238,-5,810,1580,30
101442339471,101442339467,-4,1020,2263,30
101445970166,101445970162,-4,990,1716,30
101446493482,101446493477,-5,921,2437,30
101452357551,101452357547,-4,1014,2036,30
101454336443,101454336438,-5,1298,2333,30
101456690791,101456690786,-5,1025,3607,30
101461104402,101461104397,-5,870,1900,30
101461221404,101461221417,13,1240,3403,30
101463092655,101463092652,-3,835,1950,30
101466435244,101466435241,-3,975,2940,30
101471195579,101471195575,-4,760,3051,30
101479965720,101479965717,-3,1178,2381,30
101480511135,101480511130,-5,1131,4506,30
101483553252,101483553250,-2,1129,2083,30
101486090051,101486090048,-3,1898,3986,30
101488963517,101488963513,-4,656,1228,30
101493659857,101493659853,-4,1173,2907,30
101496539450,101496539448,-2,727,1578,30
101498276884,101498276878,-6,31935,14180,30
101503916728,101503916732,4,4706,2949,30
101518132370,101518132366,-4,997,3305,30
101518266816,101518266827,11,11486,31498,30
101518292129,101518292125,-4,1906,3593,30
101518502106,101518502103,-3,1171,3545,30
101521024278,101521024274,-4,1492,3521,30
101526571538,101526571536,-2,1261,2851,30
101528402098,101528402103,5,12253,6167,30
101539138328,101539138322,-6,1107,2919,30
101541721754,101541721746,-8,1022,3219,30
101544819063,101544819061,-2,1152,2827,30
101551298521,101551298517,-4,1004,3090,30
101554774039,101554774043,4,1830,1262,30
101556869374,101556869375,1,1934,2220,30
101559150193,101559150189,-4,1326,2854,30
101569858764,101569858759,-5,1067,2331,30
101570939149,101570939147,-2,1311,2465,30
101580985033,101580985027,-6,1085,2986,30
101581189686,101581189683,-3,694,2716,30
101581391738,101581391727,-11,947,1604,30
101582591862,101582591858,-4,695,2023,30
101584023897,101584023892,-5,1309,2588,30
101587735150,101587735145,-5,1120,3800,30
101596618855,101596618850,-5,1262,4323,30
101600247129,101600247122,-7,1113,2927,30
101602127035,101602127032,-3,656,2355,30
101603886068,101603886062,-6,1219,3299,30
101606812621,101606812615,-6,907,2939,30
101607680194,101607680206,12,10016,44478,30
101608868386,101608868380,-6,1109,3630,30
101610573179,101610573174,-5,588,2531,30
101611826241,101611826235,-6,1082,2087,30
101611970890,101611970883,-7,1001,3153,30
101615055855,101615055852,-3,1038,3064,30
101616112415,101616112411,-4,756,1231,30
101617092380,101617092375,-5,1005,2142,30
101617635761,101617635752,-9,1238,3635,30
101617671882,101617671902,20,828,1556,30
101622314530,101622314526,-4,1092,3445,30
101625901349,101625901342,-7,333,3388,30
101626006924,101626006942,18,1106,2622,30
101626079526,101626079522,-4,1057,3925,30
101629049223,101629049220,-3,1413,3700,30
101634565537,101634565533,-4,1383,3040,30
101637010539,101637010533,-6,1012,3451,30
101637286369,101637286363,-6,1460,3376,30
101638056314,101638056327,13,303,1112,30
101639090866,101639090863,-3,1084,2920,30
101643621651,101643621663,12,316,1030,30
101651307050,101651307051,1,1083,1221,30
101652357080,101652357088,8,3954,1657,30
101657994333,101657994331,-2,1554,2916,30
101658300513,101658300508,-5,1098,2583,30
101661933297,101661933318,21,320,1916,30
101665434471,101665434470,-1,38936,38977,30
101665767374,101665767369,-5,1158,2456,30
101670136313,101670136309,-4,1047,3610,30
101672165079,101672165083,4,2997,1715,30
101681632098,101681632093,-5,1425,3747,30
101682362959,101682362946,-13,10623,40863,30
101684780823,101684780818,-5,1289,3636,30
101692494006,101692494011,5,2387,1225,30
101693533354,101693533349,-5,1083,2788,30
101695854262,101695854257,-5,1142,1927,30
101699808743,101699808738,-5,1198,2768,30
101702433874,101702433870,-4,1010,2449,30
101709776100,101709776104,4,1793,1089,30
101710460811,101710460807,-4,1218,2652,30
101710731605,101710731606,1,2741,2980,30
101712278965,101712278971,6,2248,1367,30
101712800974,101712800992,18,515,2543,30
101721494852,101721494845,-7,1516,4610,30
101727512241,101727512234,-7,1554,7706,30
101728649578,101728649575,-3,705,1729,30
101729937553,101729937547,-6,581,1327,30
101733699807,101733699826,19,778,1807,30
101738925226,101738925222,-4,1053,2748,30
101743270392,101743270389,-3,1195,2822,30
101744492356,101744492369,13,8,612,30
101747314567,101747314563,-4,1027,2327,30
101747468283,101747468280,-3,838,2462,30
101747981026,101747981021,-5,1175,3338,30
101753359634,101753359630,-4,1258,2246,30
101753488675,101753488674,-1,1141,1441,30
101753582748,101753582744,-4,851,1946,30
101754212963,101754212983,20,702,2863,30
101757109791,101757109787,-4,1028,4065,30
101757455014,101757455021,7,84167,34665,30
101761311058,101761311050,-8,1005,2858,30
101762352916,101762352911,-5,934,2259,30
101767439445,101767439438,-7,1402,3283,30
101769333815,101769333818,3,1444,1464,30
101773960039,101773960034,-5,979,2558,30
101775471778,101775471773,-5,1668,7054,30
101778803429,101778803424,-5,804,2585,30
101778864187,101778864182,-5,861,3363,30
101779903511,101779903507,-4,1062,2633,30
101782784879,101782784873,-6,1989,3716,30
101795347815,101795347811,-4,1180,2778,30
101797201773,101797201768,-5,1315,3526,30
101799613043,101799613039,-4,1074,3295,30
101801533966,101801533961,-5,1036,3157,30
101805117805,101805117798,-7,1201,4067,30
101805731758,101805731754,-4,1286,5270,30
101805873719,101805873714,-5,901,3151,30
101805935896,101805935918,22,715,2969,30
101815250854,101815250850,-4,917,1406,30
101831032768,101831032763,-5,1107,3224,30
101834236190,101834236186,-4,874,3330,30
101836053106,101836053100,-6,1369,3558,30
101838383595,101838383590,-5,1575,4026,30
101839307815,101839307809,-6,2095,7429,30
101841210989,101841210985,-4,828,2160,30
101844550409,101844550402,-7,1334,3184,30
101856107426,101856107426,0,1434,2938,30
101863757455,101863757451,-4,803,2726,30
101865519526,101865519522,-4,1046,2954,30
101868869677,101868869673,-4,1082,3591,30
101869298941,101869298937,-4,1032,3537,30
101869844971,101869844969,-2,822,1111,30
101870316363,101870316358,-5,595,2626,30
101871429195,101871429190,-5,1048,2815,30
101874040573,101874040568,-5,783,3877,30
101874239700,101874239710,10,364,1375,30
101874845046,101874845041,-5,938,3487,30
101876441031,101876441026,-5,2085,2899,30
101884467891,101884467885,-6,845,3084,30
101884894970,101884894990,20,845,1820,30
101887620910,101887620903,-7,985,4000,30
101888404810,101888404802,-8,1199,2480,30
101891578196,101891578190,-6,786,1706,30
101892181627,101892181625,-2,615,2356,30
101892765940,101892765934,-6,1312,3678,30
101894130827,101894130822,-5,649,2627,30
101902330023,101902330018,-5,1247,3519,30
101904264792,101904264785,-7,1150,3285,30
101905464002,101905463999,-3,1062,1803,30
101905740882,101905740879,-3,1514,2068,30
101906659499,101906659506,7,10113,35406,30
101906835402,101906835401,-1,181,1057,30
101907229928,101907229923,-5,1187,3018,30
101907669203,101907669198,-5,1038,3583,30
101911425438,101911425433,-5,854,2033,30
101912522086,101912522081,-5,1304,2771,30
101912558934,101912558928,-6,1270,5405,30
101916201641,101916201642,1,900,1259,30
101920193465,101920193461,-4,1075,2794,30
101920244877,101920244874,-3,961,3071,30
101920352898,101920352879,-19,75,1033,30
101925946414,101925946409,-5,986,4074,30
101929911118,101929911114,-4,1069,2559,30
101935898234,101935898226,-8,1026,4368,30
101936015571,101936015563,-8,147,1031,30
101942276851,101942276847,-4,1302,3315,30
101943640232,101943640227,-5,1577,3045,30
101945780150,101945780150,0,1153,1911,30
101953583785,101953583781,-4,1344,2084,30
101959763074,101959763070,-4,874,1954,30
101963132509,101963132510,1,1513,1302,30
101974328870,101974328877,7,12327,33400,30
101974545199,101974545197,-2,683,1863,30
101980597607,101980597603,-4,1078,3544,30
101984919675,101984919670,-5,1047,3324,30
101988129106,101988129101,-5,1175,3539,30
101988731250,101988731246,-4,748,2004,30
101988940810,101988940802,-8,1409,5990,30
101991344987,101991344985,-2,848,2147,30
101992087839,101992087834,-5,956,2758,30
101992331600,101992331593,-7,1262,4877,30
101995522979,101995522975,-4,718,1695,30
101996150616,101996150610,-6,1015,3401,30
101997224643,101997224625,-18,1471,2262,30
101999779123,101999779116,-7,1301,2521,30
102007260606,102007260600,-6,876,3060,30
102007390993,102007390974,-19,213,1307,30
102008652904,102008652909,5,3074,2066,30
102010005145,102010005139,-6,1030,2925,30
102013405049,102013405043,-6,1947,8062,30
102017210363,102017210357,-6,1000,2604,30
102022307723,102022307721,-2,1004,3015,30
102023616399,102023616394,-5,1063,2608,30
102027239883,102027239881,-2,1156,2873,30
102027687289,102027687286,-3,906,2578,30
102028040275,102028040272,-3,1021,1517,30
102028216888,102028216885,-3,808,3289,30
102035912772,102035912765,-7,1000,2386,30
102036051512,102036051506,-6,922,2558,30
102037376145,102037376142,-3,825,2555,30
102040270433,102040270426,-7,960,2888,30
102044095041,102044095045,4,3903,3013,30
102046105282,102046105278,-4,1203,3726,30
102055185066,102055185063,-3,1743,3455,30
102057978318,102057978313,-5,965,2493,30
102066447631,102066447625,-6,1049,2825,30
102068513802,102068513798,-4,964,2103,30
102068785889,102068785880,-9,686,2924,30
102069000718,102069000714,-4,947,2109,30
102071143618,102071143614,-4,1500,3743,30
102075464798,102075464794,-4,1715,3382,30
102077792708,102077792701,-7,1212,4047,30
102078620758,102078620754,-4,1117,3452,30
102079542524,102079542521,-3,1063,2282,30
102080242927,102080242921,-6,1141,3805,30
102088736639,102088736634,-5,734,2154,30
102100991560,102100991555,-5,1223,3298,30
102102634487,102102634483,-4,704,2925,30
102105760666,102105760668,2,20876,29140,30
102109576163,102109576162,-1,756,1748,30
102112251310,102112251314,4,2669,1066,30
102114087158,102114087166,8,206,1106,30
102116089539,102116089542,3,1520,1289,30
102118374507,102118374503,-4,1329,2617,30
102120211439,102120211434,-5,1053,2692,30
102122037973,102122037969,-4,582,1597,30
102130393531,102130393525,-6,1438,3196,30
102131125216,102131125211,-5,281,1130,30
102131468874,102131468892,18,693,2178,30
102132220614,102132220616,2,5253,24017,30
102135789854,102135789851,-3,1193,2289,30
102135975108,102135975126,18,674,1532,30
102136317831,102136317823,-8,1201,4808,30
102138277539,102138277534,-5,1285,3166,30
102140561025,102140561019,-6,1033,1603,30
102144967267,102144967270,3,2163,1711,30
102150255762,102150255757,-5,1131,2751,30
102150375260,102150375272,12,383,1478,30
102158281850,102158281845,-5,1244,2610,30
102160818879,102160818877,-2,920,2072,30
102161715506,102161715502,-4,902,2810,30
102162462022,102162462018,-4,1303,2525,30
102167157513,102167157509,-4,991,2265,30
102168503858,102168503859,1,2611,3616,30
102169238194,102169238190,-4,1039,3760,30
102175132880,102175132875,-5,788,2886,30
102175432737,102175432732,-5,1177,1813,30
102179231657,102179231652,-5,837,3027,30
102180681970,102180681970,0,1709,2734,30
102181524896,102181524895,-1,1246,1314,30
102186325048,102186325046,-2,1233,1842,30
102191595973,102191595967,-6,941,3006,30
102193377998,102193378001,3,2576,2291,30
102196492278,102196492271,-7,730,2984,30
102207854249,102207854247,-2,2640,4510,30
102212265769,102212265766,-3,1100,1608,30
102217849613,102217849609,-4,1051,2674,30
102219124615,102219124614,-1,1077,1327,30
102221354389,102221354384,-5,1261,3063,30
102221669388,102221669402,14,898,2201,30
102224622678,102224622679,1,1908,1794,30
102226909162,102226909158,-4,437,2320,30
102229866560,102229866554,-6,1311,3606,30
102233888926,102233888923,-3,850,2314,30
102237025522,102237025516,-6,731,2490,30
102240953916,102240953913,-3,899,2954,30
102242435459,102242435473,14,531,2301,30
102244653386,102244653381,-5,806,3619,30
102247825386,102247825381,-5,748,2337,30
102251933663,102251933659,-4,885,2935,30
102252872409,102252872404,-5,1096,3549,30
102253106052,102253106066,14,465,1786,30
102256111366,102256111363,-3,1173,2663,30
102257601985,102257601982,-3,1414,3697,30
102262000139,102262000146,7,2217,1339,30
102263570607,102263570602,-5,1300,3017,30
102265419407,102265419402,-5,1217,3136,30
102265906345,102265906341,-4,766,2632,30
102266607794,102266607814,20,799,2590,30
102269360583,102269360579,-4,1284,3644,30
102272862540,102272862535,-5,1770,3704,30
102275025637,102275025634,-3,1261,2949,30
102279816224,102279816218,-6,1011,2176,30
102280534428,102280534426,-2,1164,1761,30
102285941923,102285941918,-5,1242,2733,30
102291940691,102291940686,-5,1162,3557,30
102294773899,102294773901,2,1056,1735,30
102296130472,102296130475,3,287,1218,30
102307759247,102307759253,6,2924,1333,30
102311308221,102311308214,-7,1117,4071,30
102326499083,102326499078,-5,1224,2843,30
102328711574,102328711570,-4,745,2494,30
102330590128,102330590122,-6,1267,4103,30
102333020648,102333020646,-2,1087,2546,30
102333295377,102333295360,-17,97,1337,30
102335061657,102335061653,-4,1285,3039,30
102337863136,102337863133,-3,960,2128,30
102344823522,102344823510,-12,1062,2962,30
102345152863,102345152859,-4,660,1420,30
102349783638,102349783630,-8,842,3449,30
102357206492,102357206486,-6,921,3452,30
102358257619,102358257639,20,593,2569,30
102361502602,102361502598,-4,583,1377,30
102364807503,102364807497,-6,1463,3231,30
102364880166,102364880161,-5,1038,3814,30
102364915718,102364915716,-2,1019,3237,30
102365183135,102365183129,-6,859,1988,30
102365348371,102365348365,-6,42,881,30
102366186725,102366186722,-3,660,1590,30
102366877636,102366877634,-2,3094,4303,30
102367970375,102367970371,-4,602,2716,30
102368210886,102368210884,-2,673,1826,30
102368479898,102368479894,-4,1083,2366,30
102370597278,102370597275,-3,1300,2219,30
102377113776,102377113772,-4,1395,3614,30
102378220150,102378220149,-1,1151,1855,30
102385897956,102385897958,2,10462,8573,30
102391222902,102391222898,-4,1114,1528,30
102399487527,102399487523,-4,923,2425,30
102399812264,102399812282,18,1113,3587,30
102404105746,102404105745,-1,1007,1880,30
102406749611,102406749607,-4,1207,3043,30
102407381408,102407381418,10,267,1423,30
102413302635,102413302630,-5,1317,2153,30
102418501127,102418501127,0,779,1131,30
102430225895,102430225889,-6,869,2798,30
102430628410,102430628405,-5,773,1680,30
102434628082,102434628078,-4,650,1815,30
102435579659,102435579653,-6,833,2159,30
102436634482,102436634479,-3,821,3375,30
102439481224,102439481219,-5,1234,2574,30
102440551426,102440551428,2,1449,1591,30
102444318402,102444318401,-1,1521,1185,30
102448391447,102448391444,-3,1020,2847,30
102458205410,102458205408,-2,1208,3171,30
102461735597,102461735595,-2,1393,2805,30
102463157138,102463157133,-5,633,1891,30
102471633818,102471633813,-5,817,2062,30
102473926302,102473926296,-6,498,1711,30
102479264346,102479264341,-5,1901,10135,30
102479342934,102479342929,-5,723,2762,30
102479853576,102479853597,21,641,2638,30
102480814843,102480814843,0,1566,2475,30
102489963546,102489963541,-5,1228,2525,30
102493562606,102493562602,-4,1073,3287,30
102496046640,102496046637,-3,691,2074,30
102502409313,102502409307,-6,963,2891,30
102502613055,102502613054,-1,1032,2435,30
102507283501,102507283486,-15,1497,890,30
102519945393,102519945389,-4,981,2219,30
102524437537,102524437538,1,4155,17947,30
102528193138,102528193134,-4,1173,2794,30
102529643636,102529643631,-5,983,2701,30
102529726282,102529726278,-4,1034,3240,30
102538033807,102538033801,-6,973,2794,30
102542529335,102542529329,-6,1209,3906,30
102547815294,102547815307,13,12299,50394,30
102556892618,102556892616,-2,895,2684,30
102557787720,102557787714,-6,1139,3873,30
102557965247,102557965244,-3,1253,2944,30
102560304037,102560304039,2,1279,1321,30
102564318307,102564318303,-4,1146,2716,30
102567996816,102567996812,-4,1468,2960,30
102568813305,102568813301,-4,920,2862,30
102576008518,102576008514,-4,1312,2614,30
102576566594,102576566586,-8,1408,4493,30
102588388476,102588388471,-5,1139,2660,30
102601093402,102601093397,-5,1119,3605,30
102601703515,102601703509,-6,1069,2448,30
102607838821,102607838817,-4,1274,2638,30
102611479110,102611479107,-3,1225,2981,30
102612052230,102612052230,0,1350,1592,30
102621107321,102621107319,-2,1223,3538,30
102621636215,102621636213,-2,1066,1413,30
102626074915,102626074907,-8,1059,3873,30
102628099443,102628099438,-5,969,3392,30
102628783382,102628783377,-5,1214,3892,30
102629377978,102629377975,-3,994,2274,30
102633292270,102633292265,-5,1844,3477,30
102641470408,102641470405,-3,810,2587,30
102641864074,102641864070,-4,1356,2667,30
102646991929,102646991927,-2,691,1729,30
102647766550,102647766545,-5,883,2375,30
102660088066,102660088061,-5,712,2960,30
102660760955,102660760942,-13,821,1912,30
102662130162,102662130158,-4,1391,3660,30
102664550187,102664550182,-5,767,2729,30
102665099187,102665099169,-18,772,2635,30
102666177022,102666177019,-3,822,2378,30
102667279954,102667279949,-5,1171,3564,30
102674409999,102674409993,-6,1112,2914,30
102677658807,102677658804,-3,1127,2418,30
102683304658,102683304654,-4,1385,3480,30
102683582598,102683582594,-4,854,2456,30
102684400010,102684400006,-4,1077,2378,30
102685958554,102685958550,-4,1366,2377,30
102698073554,102698073549,-5,1065,2492,30
102698687953,102698687948,-5,1362,4404,30
102702027906,102702027902,-4,938,2208,30
102704507490,102704507486,-4,1027,1556,30
102706752278,102706752273,-5,1134,3756,30
102710646823,102710646821,-2,1140,2102,30
102716726139,102716726134,-5,560,1690,30
102720103825,102720103822,-3,1056,2318,30
102721531583,102721531584,1,3010,1723,30
102730539030,102730539025,-5,1168,2844,30
102733569357,102733569358,1,633,1005,30
102733655843,102733655842,-1,1054,2275,30
102735259188,102735259183,-5,1524,2555,30
102740355651,102740355646,-5,1030,2951,30
102744670983,102744670981,-2,936,2933,30
102744781452,102744781471,19,602,951,30
102747636733,102747636729,-4,903,2127,30
102747791411,102747791425,14,776,2041,30
102749015707,102749015707,0,946,2133,30
102753641383,102753641378,-5,1128,3755,30
102755317856,102755317851,-5,863,1858,30
102756799555,102756799553,-2,1132,2343,30
102758560152,102758560146,-6,1034,3402,30
102758608032,102758608018,-14,199,806,30
102765404760,102765404756,-4,1287,2635,30
102767207537,102767207533,-4,715,2680,30
102767753251,102767753245,-6,941,2355,30
102768121338,102768121359,21,597,1594,30
102771306939,102771306937,-2,1281,1148,30
102775540045,102775540041,-4,1297,3172,30
102779637628,102779637633,5,1181,1120,30
102781558461,102781558462,1,724,1626,30
102783502171,102783502165,-6,1506,2414,30
102786439273,102786439270,-3,645,2141,30
102794871221,102794871216,-5,1620,5540,30
102799811667,102799811666,-1,1989,4194,30
102801852881,102801852877,-4,1104,2660,30
102802016299,102802016293,-6,775,1910,30
102803743401,102803743397,-4,1175,3097,30
102813078733,102813078728,-5,1378,4009,30
102817746945,102817746941,-4,1442,3073,30
102819104601,102819104607,6,3663,2043,30
102825052515,102825052521,6,6954,3004,30
102825597389,102825597385,-4,1282,3552,30
102829156133,102829156126,-7,965,3637,30
102829345610,102829345603,-7,1172,3131,30
102832253735,102832253729,-6,939,2248,30
102832595106,102832595101,-5,1003,2910,30
102836699883,102836699880,-3,853,1958,30
102838054928,102838054924,-4,978,2891,30
102838729075,102838729072,-3,498,1346,30
102843399662,102843399658,-4,1169,3045,30
102844163413,102844163409,-4,1180,2988,30
102844232676,102844232674,-2,1213,2610,30
102847897423,102847897419,-4,971,2894,30
102848658755,102848658750,-5,883,2628,30
102852016483,102852016482,-1,856,1234,30
102852105974,102852105969,-5,1085,2707,30
102854166373,102854166370,-3,1498,2847,30
102856401803,102856401798,-5,1109,2309,30
102859215835,102859215830,-5,1109,2653,30
102859672050,102859672042,-8,286,959,30
102860933023,102860933018,-5,1075,3225,30
102863712411,102863712407,-4,1520,3174,30
102864339244,102864339241,-3,705,2241,30
102864578689,102864578707,18,1076,2502,30
102864730026,102864730041,15,509,1141,30
102865609046,102865609047,1,1501,1634,30
102870694159,102870694154,-5,1587,3450,30
102872673769,102872673763,-6,1076,2238,30
102876100376,102876100370,-6,884,2617,30
102880653480,102880653478,-2,1121,2892,30
102884583667,102884583662,-5,1108,2614,30
102892646842,102892646838,-4,1428,2908,30
102893658446,102893658441,-5,1421,3039,30
102894142631,102894142626,-5,968,2996,30
102897911909,102897911904,-5,1991,2535,30
102899729162,102899729183,21,267,1292,30
102904634052,102904634049,-3,1101,3813,30
102906039818,102906039815,-3,813,2457,30
102911520354,102911520349,-5,25080,14925,30
102913906692,102913906686,-6,767,2044,30
102914686810,102914686828,18,576,1507,30
102915314346,102915314341,-5,1351,2269,30
102915575499,102915575493,-6,807,2927,30
102916967629,102916967624,-5,1619,4500,30
102920260986,102920260981,-5,892,2382,30
102921677678,102921677674,-4,735,2300,30
102921809855,102921809849,-6,1244,3370,30
102926837031,102926837030,-1,1471,3221,30
102929605524,102929605518,-6,1141,4226,30
102935008173,102935008167,-6,912,4076,30
102935195261,102935195257,-4,1102,3104,30
102935299632,102935299621,-11,1257,3780,30
102937290153,102937290146,-7,869,4848,30
102943622742,102943622736,-6,991,3170,30
102944761257,102944761254,-3,1571,4244,30
102956398522,102956398518,-4,1106,2282,30
102968981942,102968981948,6,2922,1215,30
102970731579,102970731574,-5,883,3082,30
102972024938,102972024933,-5,1094,2642,30
102974600445,102974600438,-7,1222,3875,30
102976985809,102976985802,-7,1121,2573,30
102981060748,102981060745,-3,1211,2893,30
102988173802,102988173798,-4,1016,3852,30
102995209809,102995209805,-4,1326,2535,30
102996436158,102996436153,-5,880,2062,30
103003482450,103003482446,-4,998,2545,30
103004459283,103004459278,-5,1042,3037,30
103005179884,103005179886,2,243,1193,30
103005817894,103005817889,-5,1605,3087,30
103005923993,103005924014,21,1085,2531,30
103006240547,103006240525,-22,320,964,30
103006693703,103006693709,6,7571,35782,30
103018533824,103018533819,-5,839,2991,30
103034181909,103034181904,-5,695,1615,30
103036001362,103036001357,-5,1010,3048,30
103039124982,103039124978,-4,855,2832,30
103041531288,103041531286,-2,2022,4263,30
103042741568,103042741564,-4,1079,2329,30
103044766639,103044766634,-5,916,2683,30
103046571777,103046571773,-4,1209,3598,30
103046833331,103046833326,-5,1092,2636,30
103047445893,103047445889,-4,614,1227,30
103048276895,103048276890,-5,1306,4735,30
103057827908,103057827902,-6,986,3871,30
103058974223,103058974218,-5,1160,4218,30
103060793111,103060793105,-6,926,2945,30
103062844671,103062844666,-5,1071,3115,30
103062985838,103062985833,-5,1345,3421,30
103063126882,103063126902,20,802,3187,30
103067682634,103067682629,-5,1029,2785,30
103068221543,103068221540,-3,1129,3902,30
103069121929,103069121926,-3,1100,3093,30
103069225252,103069225269,17,766,1714,30
103073421306,103073421304,-2,1253,2883,30
103077112737,103077112730,-7,490,969,30
103083491739,103083491735,-4,1014,3251,30
103084096763,103084096758,-5,662,3081,30
103085973958,103085973953,-5,1117,1597,30
103086450584,103086450582,-2,1182,2923,30
103087531210,103087531211,1,925,855,30
103094100038,103094100032,-6,1390,3288,30
103094685767,103094685761,-6,1043,3333,30
103099979173,103099979167,-6,864,2739,30
103101490459,103101490455,-4,1027,2441,30
103101614033,103101614030,-3,130,1097,30
103105332958,103105332954,-4,1115,2163,30
103110153631,103110153633,2,2271,2758,30
103112371722,103112371717,-5,942,3770,30
103123393457,103123393450,-7,1218,3737,30
103123604251,103123604271,20,548,1283,30
103127058536,103127058532,-4,1049,3115,30
103128988823,103128988817,-6,1042,4390,30
103129297574,103129297569,-5,711,2531,30
103130754478,103130754472,-6,662,2757,30
103131255665,103131255685,20,1036,2832,30
103136095874,103136095870,-4,954,2453,30
103144219135,103144219130,-5,772,2969,30
103146891966,103146891970,4,4045,2491,30
103149739491,103149739484,-7,883,2994,30
103151719338,103151719332,-6,1346,3686,30
103154512558,103154512555,-3,844,1228,30
103162466234,103162466229,-5,1206,2223,30
103166690731,103166690724,-7,1053,2794,30
103173513157,103173513154,-3,1128,2244,30
103175929997,103175929994,-3,904,2925,30
103176149571,103176149586,15,631,2998,30
103177414613,103177414610,-3,1133,2859,30
103179136499,103179136494,-5,862,2413,30
103179337978,103179337960,-18,1089,2938,30
103180496530,103180496515,-15,884,3669,30
103180950779,103180950797,18,713,1776,30
103181122101,103181122081,-20,2193,1382,30
103183178814,103183178810,-4,1045,2654,30
103184658497,103184658494,-3,1174,2714,30
103190104966,103190104982,16,1791,1387,30
103192121024,103192121019,-5,1099,3422,30
103196653959,103196653954,-5,1484,4075,30
103199206853,103199206850,-3,1124,2977,30
103200626279,103200626276,-3,926,2472,30
103203098603,103203098601,-2,874,2343,30
103206550781,103206550778,-3,931,2465,30
103208967830,103208967825,-5,708,3394,30
103209137773,103209137770,-3,1059,2572,30
103211389774,103211389769,-5,776,2650,30
103229752560,103229752554,-6,1164,4347,30
103230920806,103230920804,-2,235,1183,30
103231556238,103231556234,-4,794,2812,30
103247572797,103247572794,-3,1557,2632,30
103249443239,103249443231,-8,616,3830,30
103255329832,103255329828,-4,909,3978,30
103257316882,103257316876,-6,1040,2970,30
103257555975,103257555970,-5,1142,2577,30
103258443612,103258443631,19,596,2493,30
103261361211,103261361205,-6,845,1774,30
103262062129,103262062132,3,1928,952,30
103268620129,103268620125,-4,1185,2273,30
103271829663,103271829661,-2,1087,2266,30
103275530611,103275530613,2,3914,3305,30
103275739559,103275739554,-5,849,3244,30
103281845189,103281845190,1,947,1268,30
103282934424,103282934418,-6,1050,3159,30
103285755755,103285755752,-3,1129,3163,30
103292659535,103292659530,-5,668,1572,30
103292750177,103292750191,14,586,1624,30
103294445072,103294445066,-6,2454,5037,30
103302070534,103302070529,-5,592,2571,30
103307722381,103307722397,16,607,2342,30
103310656639,103310656634,-5,1141,2672,30
103312087231,103312087227,-4,1506,3344,30
103317166531,103317166526,-5,902,2192,30
103320177218,103320177226,8,5446,1893,30
103320533945,103320533941,-4,1161,2712,30
103321782725,103321782720,-5,778,1265,30
103323173874,103323173878,4,2091,876,30
103329013402,103329013399,-3,1172,1838,30
103329510503,103329510498,-5,1276,2934,30
103332700503,103332700497,-6,905,1684,30
103335095857,103335095855,-2,574,1619,30
103335164046,103335164045,-1,1772,1904,30
103337372762,103337372757,-5,881,1919,30
103340835457,103340835451,-6,919,2540,30
103342165281,103342165276,-5,1036,2465,30
103343133704,103343133700,-4,1365,2671,30
103343817290,103343817284,-6,862,2383,30
103345596313,103345596308,-5,1145,2762,30
103347016954,103347016949,-5,1091,2838,30
103347557362,103347557346,-16,243,795,30
103349008238,103349008233,-5,1612,3395,30
103351108935,103351108930,-5,957,2755,30
103351166513,103351166508,-5,1220,4013,30
103353319686,103353319681,-5,1033,3046,30
103353616947,103353616941,-6,1169,3033,30
103355950121,103355950120,-1,1375,1723,30
103356269118,103356269113,-5,1168,3760,30
103357001667,103357001663,-4,1002,4078,30
103362621147,103362621143,-4,838,2508,30
103362860523,103362860520,-3,1206,2345,30
103364107129,103364107125,-4,1597,3064,30
103364310777,103364310773,-4,1084,2792,30
103365339107,103365339101,-6,61,1148,30
103369383807,103369383804,-3,1039,2099,30
103370158459,103370158454,-5,1392,3022,30
103375039218,103375039213,-5,1045,2659,30
103389349338,103389349334,-4,995,2941,30
103396627474,103396627467,-7,1203,2931,30
103396690041,103396690063,22,766,2611,30
103396774731,103396774726,-5,1017,3446,30
103399098954,103399098949,-5,868,3285,30
103400095356,103400095350,-6,1002,3487,30
103407369736,103407369735,-1,1874,3251,30
103409805391,103409805387,-4,693,1904,30
103410593146,103410593140,-6,1198,4278,30
103411798978,103411798979,1,176,1618,30
103413070319,103413070318,-1,1966,2641,30
103416613345,103416613340,-5,948,3505,30
103417977235,103417977231,-4,671,2816,30
103419363439,103419363435,-4,813,2078,30
103422974406,103422974407,1,1834,1906,30
103426061367,103426061369,2,1420,1350,30
103427172687,103427172682,-5,1129,2626,30
103428725951,103428725946,-5,891,3216,30
103429393379,103429393377,-2,774,1332,30
103433055791,103433055788,-3,1329,3316,30
103434254906,103434254906,0,828,1488,30
103435945579,103435945575,-4,1169,2669,30
103436530832,103436530829,-3,1437,3668,30
103440624565,103440624570,5,10403,20769,30
103442091130,103442091127,-3,791,2319,30
103442562324,103442562337,13,212,985,30
103451543223,103451543218,-5,795,2580,30
103453182666,103453182667,1,1664,1215,30
103453572917,103453572923,6,2438,1023,30
103462955664,103462955645,-19,1434,847,30
103468878350,103468878346,-4,758,1090,30
103473938112,103473938110,-2,1356,2646,30
103475854109,103475854102,-7,915,3106,30
103477674902,103477674897,-5,1061,2429,30
103480423369,103480423363,-6,1502,3949,30
103483782686,103483782684,-2,1143,2936,30
103483956723,103483956719,-4,1174,2913,30
103484866199,103484866197,-2,667,1780,30
103493627529,103493627525,-4,1007,2887,30
103497166578,103497166574,-4,682,1831,30
103498639863,103498639858,-5,774,2637,30
103499042124,103499042138,14,1073,2730,30
103499144087,103499144081,-6,998,2988,30
103499442953,103499442948,-5,20,753,30
103500393532,103500393538,6,3102,1449,30
103502034214,103502034210,-4,1333,2325,30
103503350779,103503350778,-1,134,1001,30
103505711009,103505711015,6,2836,1101,30
103515989524,103515989520,-4,922,2844,30
103517333190,103517333187,-3,830,1888,30
103517572825,103517572814,-11,1091,2909,30
103519339588,103519339604,16,981,3054,30
103520554198,103520554193,-5,1054,2897,30
103523163559,103523163554,-5,1032,3909,30
103537486131,103537486130,-1,3575,4443,30
103538265833,103538265829,-4,1002,2718,30
103539194031,103539194027,-4,1439,2889,30
103549222359,103549222355,-4,929,2067,30
103549801199,103549801196,-3,871,1812,30
103551018039,103551018038,-1,939,2136,30
103556237969,103556237964,-5,1035,2324,30
103556299557,103556299553,-4,952,1110,30
103558477274,103558477270,-4,861,2385,30
103563319883,103563319878,-5,1108,3062,30
103565366607,103565366602,-5,1069,2914,30
103575729819,103575729814,-5,995,3274,30
103575871255,103575871250,-5,1198,2380,30
103576635960,103576635982,22,829,2472,30
103581425281,103581425275,-6,1089,4318,30
103590682978,103590682972,-6,1364,3436,30
103592707817,103592707811,-6,2671,7250,30
103594639962,103594639961,-1,2300,3458,30
103602992513,103602992510,-3,775,2828,30
103603578330,103603578331,1,10065,10616,30
103616752525,103616752518,-7,1364,2990,30
103617948849,103617948870,21,1093,3568,30
103618032808,103618032804,-4,1005,3078,30
103620169707,103620169704,-3,1181,2125,30
103624042087,103624042083,-4,1186,3013,30
103626923306,103626923302,-4,1997,2827,30
103633439127,103633439124,-3,860,2231,30
103641361226,103641361226,0,829,1573,30
103641790370,103641790369,-1,63,1161,30
103642393153,103642393143,-10,170,852,30
103642815969,103642815965,-4,25677,10415,30
103648760867,103648760858,-9,1071,3278,30
103651198641,103651198638,-3,1232,2659,30
103661488940,103661488942,2,7271,6418,30
103665284684,103665284670,-14,126,1393,30
103668006706,103668006702,-4,1255,2670,30
103669326726,103669326720,-6,1315,3244,30
103669395864,103669395874,10,134,1004,30
103670855481,103670855499,18,1172,3335,30
103671249746,103671249742,-4,840,2066,30
103675389875,103675389869,-6,1090,2734,30
103678733793,103678733790,-3,992,2210,30
103680376804,103680376801,-3,1490,3226,30
103683338991,103683338986,-5,737,2779,30
103684274148,103684274143,-5,1278,3904,30
103684366955,103684366967,12,533,1589,30
103685643898,103685643905,7,1109,745,30
103688979193,103688979188,-5,779,3572,30
103689614017,103689614001,-16,1070,2952,30
103691506249,103691506264,15,1116,2835,30
103693250766,103693250761,-5,1572,4026,30
103695510518,103695510513,-5,672,1305,30
103696220678,103696220673,-5,1353,3428,30
103696376998,103696376993,-5,990,2971,30
103708463076,103708463070,-6,822,2261,30
103710603319,103710603314,-5,1350,4121,30
103712315808,103712315805,-3,1404,2921,30
103720434600,103720434594,-6,969,2411,30
103720462944,103720462967,23,201,1147,30
103723806590,103723806586,-4,969,3370,30
103727108766,103727108775,9,2871,1478,30
103727683638,103727683635,-3,1061,2704,30
103729759741,103729759741,0,1536,2328,30
103731333229,103731333228,-1,1331,1620,30
103733990101,103733990096,-5,1055,2660,30
103743806554,103743806550,-4,918,3132,30
103748631050,103748631046,-4,1207,3789,30
103752180305,103752180311,6,2805,1850,30
103754789069,103754789065,-4,352,1742,30
103766104007,103766104002,-5,847,2478,30
103766547500,103766547510,10,320,1060,30
103768595806,103768595799,-7,1161,2954,30
103773227261,103773227255,-6,1490,3874,30
103775544703,103775544698,-5,744,2561,30
103778148460,103778148457,-3,739,2387,30
103782390426,103782390422,-4,1124,2028,30
103782661824,103782661818,-6,909,4182,30
103787577927,103787577934,7,4118,1311,30
103792767906,103792767902,-4,1239,2599,30
103794849470,103794849466,-4,921,2346,30
103797048471,103797048469,-2,1010,1878,30
103797954377,103797954370,-7,1185,2754,30
103808307945,103808307938,-7,1298,4173,30
103810707491,103810707486,-5,994,2914,30
103811108267,103811108259,-8,193,782,30
103811584425,103811584404,-21,1010,2730,30
103819396300,103819396286,-14,1094,2699,30
103819652899,103819652905,6,6301,2787,30
103821290233,103821290230,-3,1451,2072,30
103822235272,103822235268,-4,1404,3285,30
103822556793,103822556790,-3,944,2773,30
103827875302,103827875298,-4,966,4153,30
103830805530,103830805525,-5,1378,4262,30
103831576019,103831576023,4,2060,1570,30
103834333057,103834333053,-4,1066,3166,30
103836771710,103836771704,-6,981,3233,30
103838826346,103838826341,-5,1030,2823,30
103845338773,103845338769,-4,1602,3539,30
103853655950,103853655945,-5,1172,3163,30
103856712771,103856712769,-2,1105,2377,30
103870643826,103870643822,-4,1085,3381,30
103872998899,103872998906,7,1606,728,30
103874277188,103874277186,-2,1572,2469,30
103876861469,103876861465,-4,1048,1798,30
103877841274,103877841269,-5,910,3316,30
103886736582,103886736578,-4,1057,2297,30
103890387435,103890387428,-7,1082,1829,30
103891047725,103891047723,-2,1282,1747,30
103892487832,103892487826,-6,1653,2849,30
103897765377,103897765369,-8,1251,3092,30
103897990485,103897990485,0,1051,1931,30
103900088566,103900088562,-4,1082,2700,30
103902368463,103902368458,-5,1039,3039,30
103902467849,103902467854,5,2698,1230,30
103905488170,103905488164,-6,807,2721,30
103907838850,103907838845,-5,918,3375,30
103917663111,103917663106,-5,878,2483,30
103922528862,103922528867,5,3914,2665,30
103924624600,103924624595,-5,1358,3483,30
103927018090,103927018086,-4,775,2168,30
103929210220,103929210227,7,2862,1663,30
103929280061,103929280042,-19,2917,759,30
103929333418,103929333414,-4,1387,4022,30
103929863159,103929863154,-5,1188,2834,30
103929944009,103929944004,-5,72,714,30
103933318558,103933318558,0,1098,2985,30
103938644679,103938644677,-2,1214,2291,30
103940449486,103940449482,-4,1057,3848,30
103941317689,103941317684,-5,765,2144,30
103947175798,103947175793,-5,652,2844,30
103948100113,103948100109,-4,932,3527,30
103948976412,103948976408,-4,937,2650,30
103955095506,103955095501,-5,987,2488,30
103958723112,103958723107,-5,1332,3841,30
103958861480,103958861477,-3,950,2060,30
103960086656,103960086651,-5,1322,2835,30
103960517124,103960517120,-4,1761,3388,30
103960562069,103960562065,-4,670,2172,30
103960815350,103960815346,-4,1720,2773,30
103962661281,103962661278,-3,1263,2568,30
103965961718,103965961713,-5,1194,3576,30
103966512267,103966512269,2,1825,1218,30
103972216357,103972216351,-6,1189,2811,30
103972250024,103972250038,14,424,1876,30
103974928894,103974928891,-3,892,2986,30
103979615977,103979615970,-7,1009,3246,30
103983883542,103983883538,-4,797,1942,30
103985737200,103985737194,-6,835,2618,30
103986621730,103986621725,-5,983,6071,30
103987630306,103987630303,-3,1117,2980,30
103989209747,103989209741,-6,731,2290,30
103990483890,103990483886,-4,1030,3573,30
103996339318,103996339313,-5,930,3124,30
103998942836,103998942833,-3,1346,2656,30
104001314989,104001314985,-4,807,1675,30
104002030689,104002030685,-4,1319,3381,30
104004508454,104004508449,-5,710,1824,30
104007144859,104007144854,-5,1054,3560,30
104007219090,104007219071,-19,28,1746,30
104008970683,104008970679,-4,954,2114,30
104018227073,104018227074,1,1699,2093,30
104026854399,104026854394,-5,745,2798,30
104027547650,104027547645,-5,1383,3132,30
104028492179,104028492182,3,100,797,30
104028870170,104028870165,-5,713,3745,30
104042628051,104042628045,-6,1657,3874,30
104044070471,104044070467,-4,1094,3140,30
104048971524,104048971529,5,2484,1772,30
104050119555,104050119550,-5,1023,3220,30
104054063152,104054063145,-7,1294,5015,30
104063668187,104063668182,-5,1109,2094,30
104065210692,104065210696,4,2226,1775,30
104066889141,104066889136,-5,1086,2602,30
104070876079,104070876075,-4,1146,3574,30
104076612032,104076612034,2,1752,1883,30
104078069817,104078069813,-4,1097,2703,30
104078410064,104078410050,-14,313,982,30
104086480715,104086480710,-5,1024,2542,30
104086832387,104086832367,-20,576,1799,30
104087727383,104087727378,-5,833,2622,30
104091615807,104091615800,-7,1013,2487,30
104092749891,104092749886,-5,1508,3828,30
104100210167,104100210172,5,944,1283,30
104103633905,104103633901,-4,1373,3954,30
104108302590,104108302586,-4,957,3458,30
104111228039,104111228034,-5,995,3102,30
104112758954,104112758973,19,1409,2879,30
104114931206,104114931203,-3,1811,3323,30
104118171974,104118171971,-3,737,1660,30
104121242973,104121242972,-1,2391,3422,30
104123145164,104123145158,-6,956,2663,30
104125114564,104125114551,-13,184,560,30
104127546586,104127546583,-3,800,1148,30
104128385306,104128385297,-9,1288,2649,30
104135045353,104135045358,5,2536,1525,30
104137199727,104137199723,-4,903,2919,30
104138048790,104138048787,-3,382,1078,30
104141780978,104141780998,20,585,3350,30
104149937072,104149937065,-7,812,2263,30
104151785456,104151785451,-5,1217,2396,30
104156272374,104156272370,-4,614,1542,30
104158777175,104158777173,-2,854,2208,30
104159078729,104159078727,-2,1097,2781,30
104159322061,104159322056,-5,1104,2970,30
104164211884,104164211878,-6,1466,3696,30
104165062513,104165062508,-5,1434,3771,30
104168044480,104168044475,-5,1060,2983,30
104170767423,104170767418,-5,1051,4092,30
104172609596,104172609602,6,5954,26629,30
104180899581,104180899579,-2,782,2934,30
104182705572,104182705567,-5,892,1823,30
104182796168,104182796186,18,61,934,30
104185113540,104185113534,-6,825,2228,30
104190953795,104190953793,-2,962,2150,30
104192163107,104192163103,-4,1189,2980,30
104200681894,104200681890,-4,1120,2383,30
104201291566,104201291561,-5,1314,2773,30
104209178277,104209178270,-7,1253,3908,30
104210585214,104210585213,-1,962,1980,30
104211462730,104211462735,5,1835,1138,30
104214402556,104214402549,-7,1829,8055,30
104216512641,104216512646,5,2736,1161,30
104218355141,104218355145,4,2039,1696,30
104219732490,104219732485,-5,1206,2518,30
104222095377,104222095371,-6,1501,3106,30
104226622698,104226622697,-1,1009,1568,30
104229611902,104229611897,-5,1019,2691,30
104230211844,104230211848,4,2296,1535,30
104231144832,104231144826,-6,1369,3977,30
104231272555,104231272550,-5,1001,2816,30
104233588126,104233588124,-2,1455,2876,30
104237135661,104237135662,1,3459,13917,30
104237232793,104237232787,-6,1112,3201,30
104240120987,104240120985,-2,1864,3506,30
104242478885,104242478878,-7,1215,3139,30
104243518141,104243518137,-4,1044,2467,30
104243699949,104243699944,-5,1236,3444,30
104244384949,104244384950,1,1121,1385,30
104247988301,104247988297,-4,942,2705,30
104253961786,104253961778,-8,806,2297,30
104256505895,104256505892,-3,890,2633,30
104257335035,104257335030,-5,1168,2620,30
104259580647,104259580642,-5,771,1886,30
104262751689,104262751683,-6,1194,4524,30
104263424783,104263424784,1,966,1664,30
104272127887,104272127882,-5,705,2305,30
104273455800,104273455794,-6,1009,1791,30
104277463911,104277463904,-7,878,2795,30
104278994215,104278994211,-4,1084,3283,30
104281935563,104281935557,-6,863,2816,30
104282483578,104282483574,-4,996,3557,30
104284381659,104284381655,-4,1346,2658,30
104288697441,104288697438,-3,1033,3549,30
104291784117,104291784114,-3,1257,3075,30
104297967678,104297967672,-6,807,3485,30
104299663423,104299663420,-3,1194,3448,30
104301347935,104301347931,-4,1005,2942,30
104305071046,104305071038,-8,1166,3200,30
104307229079,104307229074,-5,1340,4338,30
104307791145,104307791143,-2,999,2253,30
104315115041,104315115037,-4,1357,3570,30
104315426474,104315426475,1,1059,1160,30
104319340954,104319340957,3,3633,2849,30
104319980032,104319980029,-3,1488,3962,30
104324754585,104324754582,-3,1042,3108,30
104326942905,104326942906,1,1483,2020,30
104328604290,104328604286,-4,1280,3470,30
104329166586,104329166590,4,68,1141,30
104330185923,104330185917,-6,1022,2487,30
104335117142,104335117142,0,1302,1820,30
104336356091,104336356090,-1,142,971,30
104360354030,104360354026,-4,1079,3274,30
104360601731,104360601750,19,1342,3727,30
104361065354,104361065374,20,591,1520,30
104361591803,104361591797,-6,892,1995,30
104362155917,104362155913,-4,1049,2861,30
104363637410,104363637405,-5,1286,3361,30
104370196374,104370196370,-4,803,1932,30
104375125467,104375125463,-4,1081,2572,30
104376411178,104376411173,-5,688,2651,30
104378691519,104378691516,-3,1138,2311,30
104379013339,104379013333,-6,839,2727,30
104385691404,104385691400,-4,1289,3430,30
104391838477,104391838471,-6,863,2900,30
104393879190,104393879198,8,2095,889,30
104394958418,104394958414,-4,1139,2212,30
104403582341,104403582337,-4,741,1765,30
104406284033,104406284030,-3,947,2741,30
104407543326,104407543323,-3,753,2633,30
104409249036,104409249031,-5,1223,3832,30
104413366403,104413366398,-5,1251,2364,30
104414586169,104414586165,-4,1212,3910,30
104415011191,104415011194,3,3350,2699,30
104415624157,104415624152,-5,1229,2462,30
104423066764,104423066771,7,9415,30257,30
104423213580,104423213598,18,700,1948,30
104423461627,104423461622,-5,693,2085,30
104425495144,104425495146,2,1513,1816,30
104427003171,104427003168,-3,801,1883,30
104428093274,104428093277,3,875,996,30
104441313955,104441313952,-3,1623,2713,30
104444410502,104444410501,-1,1413,2506,30
104445257717,104445257717,0,1337,1488,30
104445584918,104445584915,-3,698,2063,30
104446652957,104446652959,2,8126,8154,30
104447902502,104447902506,4,1894,1573,30
104459840156,104459840158,2,2345,1834,30
104462188918,104462188913,-5,1099,2056,30
104468080225,104468080225,0,20488,8561,30
104473929726,104473929721,-5,1241,9328,30
104474996690,104474996673,-17,1041,2715,30
104475286250,104475286249,-1,91,1052,30
104476025347,104476025342,-5,655,2236,30
104477636589,104477636586,-3,1090,3012,30
104477909681,104477909677,-4,895,3044,30
104479090649,104479090644,-5,1163,2479,30
104486979089,104486979082,-7,1032,3972,30
104487303266,104487303262,-4,997,2809,30
104494243698,104494243694,-4,917,2662,30
104496074318,104496074314,-4,1242,1579,30
104500860055,104500860051,-4,972,3026,30
104501092872,104501092890,18,1029,2585,30
104507612797,104507612790,-7,715,2751,30
104513458130,104513458126,-4,774,2918,30
104513517127,104513517119,-8,1006,3439,30
104514925435,104514925430,-5,758,2105,30
104520087091,104520087088,-3,1018,2168,30
104520422725,104520422719,-6,1529,3585,30
104532713435,104532713429,-6,714,2035,30
104535227465,104535227462,-3,21884,13588,30
104540262059,104540262053,-6,727,2849,30
104541881570,104541881564,-6,1258,3421,30
104542928187,104542928185,-2,1039,1632,30
104546424267,104546424263,-4,1236,2551,30
104546706242,104546706262,20,956,3816,30
104547131970,104547131968,-2,906,2258,30
104548670689,104548670699,10,9647,42617,30
104551208819,104551208815,-4,1011,1874,30
104553080361,104553080356,-5,1498,2414,30
104556686368,104556686362,-6,1093,3325,30
104557931766,104557931762,-4,926,3133,30
104559158923,104559158920,-3,1249,2672,30
104560327375,104560327373,-2,713,2591,30
104560809742,104560809734,-8,1143,2728,30
104564099800,104564099797,-3,1083,2838,30
104565827880,104565827874,-6,1080,2654,30
104566029315,104566029330,15,229,848,30
104567735559,104567735555,-4,1267,3004,30
104571352794,104571352801,7,1424,860,30
104579910364,104579910370,6,6001,1234,30
104590691774,104590691772,-2,1234,2972,30
104590820565,104590820559,-6,1329,2643,30
104594561595,104594561591,-4,837,1403,30
104596636898,104596636894,-4,738,3185,30
104601695298,104601695293,-5,839,3264,30
104604100503,104604100497,-6,734,3269,30
104607585803,104607585797,-6,256,2116,30
104609202661,104609202658,-3,694,2350,30
104611966354,104611966350,-4,835,3361,30
104624811957,104624811954,-3,857,2634,30
104630581073,104630581070,-3,753,2331,30
104639587614,104639587610,-4,1313,3067,30
104642151025,104642151019,-6,962,3673,30
104642359752,104642359770,18,853,3930,30
104642948094,104642948089,-5,1360,3617,30
104649596075,104649596071,-4,1084,2127,30
104649804562,104649804550,-12,52,483,30
104653788614,104653788609,-5,1214,2611,30
104655407587,104655407582,-5,879,2439,30
104655721147,104655721148,1,2145,1504,30
104655921542,104655921538,-4,1472,2686,30
104656535344,104656535341,-3,908,2827,30
104656572570,104656572573,3,160,1049,30
104662361981,104662361977,-4,1336,3875,30
104669871826,104669871819,-7,904,3049,30
104672193074,104672193079,5,2550,1635,30
104677895225,104677895220,-5,1051,2961,30
104680149097,104680149091,-6,447,1108,30
104683777573,104683777570,-3,1283,1998,30
104684020605,104684020603,-2,496,1303,30
104685182024,104685182020,-4,1282,2797,30
104686153366,104686153363,-3,967,1539,30
104693880750,104693880756,6,2554,1122,30
104694522826,104694522821,-5,179,1406,30
104699101538,104699101541,3,1262,1113,30
104701570670,104701570670,0,2480,4023,30
104705105319,104705105314,-5,866,2531,30
104705262802,104705262795,-7,1057,2803,30
104706406645,104706406641,-4,920,2822,30
104707263190,104707263185,-5,1365,2808,30
104707979847,104707979839,-8,1250,4757,30
104711328999,104711328999,0,1469,2429,30
104714404494,104714404497,3,1588,1544,30
104716098182,104716098178,-4,879,2919,30
104717041542,104717041537,-5,1302,1867,30
104717373744,104717373761,17,1335,4325,30
104724647762,104724647758,-4,1311,4048,30
104724804743,104724804738,-5,688,1837,30
104725942075,104725942095,20,280,1110,30
104726030681,104726030675,-6,1134,2602,30
104734975870,104734975871,1,1049,1236,30
104736850952,104736850949,-3,1296,2072,30
104740206508,104740206508,0,760,1501,30
104741548732,104741548727,-5,1354,2596,30
104748548260,104748548256,-4,1009,3401,30
104749399097,104749399093,-4,1019,3248,30
104750962453,104750962449,-4,838,2902,30
104755830737,104755830735,-2,366,1248,30
104758737517,104758737511,-6,1049,2413,30
104759096578,104759096598,20,581,1661,30
104760356486,104760356487,1,126708,129322,30
104764650533,104764650554,21,314,1031,30
104784213117,104784213113,-4,823,2110,30
104785815474,104785815469,-5,1206,3189,30
104785889658,104785889645,-13,707,2717,30
104787049497,104787049493,-4,1325,3219,30
104789799342,104789799346,4,1825,2078,30
104794417459,104794417455,-4,772,3030,30
104795520707,104795520701,-6,1259,3387,30
104795857411,104795857429,18,307,1087,30
104797172781,104797172782,1,1303,2570,30
104798853890,104798853886,-4,901,2312,30
104798899227,104798899222,-5,702,2089,30
104802762945,104802762942,-3,968,2000,30
104803242123,104803242119,-4,1099,3300,30
104808029019,104808029016,-3,890,2157,30
104812815537,104812815533,-4,985,2748,30
104813704474,104813704460,-14,1062,3556,30
104819352215,104819352211,-4,945,2809,30
104822148046,104822148041,-5,1252,4148,30
104822879999,104822879995,-4,1295,2651,30
104826384614,104826384612,-2,741,1051,30
104828640498,104828640502,4,1748,1530,30
104830099165,104830099167,2,1321,1738,30
104834219709,104834219705,-4,1604,3296,30
104834515401,104834515397,-4,1261,3088,30
104836633846,104836633844,-2,1092,3542,30
104849237663,104849237655,-8,1068,4391,30
104857647583,104857647586,3,2972,2065,30
104861847089,104861847084,-5,1467,4364,30
104863433897,104863433894,-3,794,2774,30
104863689586,104863689581,-5,1068,2719,30
104865060117,104865060115,-2,835,1824,30
104865085721,104865085739,18,195,1126,30
104867182298,104867182295,-3,760,1692,30
104867567619,104867567597,-22,649,3316,30
104879361151,104879361147,-4,848,2780,30
104879394338,104879394359,21,892,2675,30
104885355362,104885355358,-4,868,2414,30
104886414882,104886414882,0,1551,1933,30
104887117607,104887117611,4,1664,819,30
104894081794,104894081790,-4,909,3237,30
104896884298,104896884313,15,889,2613,30
104898534842,104898534858,16,401,1277,30
104907298909,104907298905,-4,1161,4049,30
104907892087,104907892085,-2,1133,1722,30
104912499773,104912499769,-4,882,1370,30
104917671133,104917671129,-4,940,2381,30
104920148247,104920148254,7,2381,799,30
104922183221,104922183215,-6,988,2643,30
104923994153,104923994154,1,1263,1683,30
104924376335,104924376332,-3,1243,2565,30
104925972159,104925972154,-5,1100,3416,30
104928632682,104928632678,-4,1184,3572,30
104939974273,104939974267,-6,902,2761,30
104950346894,104950346889,-5,1042,2982,30
104961812824,104961812818,-6,991,2571,30
104965324247,104965324244,-3,1381,2169,30
104972343865,104972343860,-5,1133,3015,30
104972846888,104972846886,-2,1020,1751,30
104975507559,104975507556,-3,1040,3959,30
104979389654,104979389650,-4,832,4052,30
104986867735,104986867732,-3,822,2288,30
104988722755,104988722762,7,3804,1784,30
104996662107,104996662102,-5,1015,3475,30
105001260919,105001260938,19,989,2018,30
105005302301,105005302302,1,1957,1746,30
105010372943,105010372940,-3,523,1490,30
105011833783,105011833779,-4,962,2881,30
105012165481,105012165497,16,1009,2354,30
105014510889,105014510885,-4,1063,3216,30
105022469066,105022469074,8,3354,1281,30
105024590981,105024590975,-6,1011,3244,30
105028636817,105028636814,-3,1324,2564,30
105038935883,105038935877,-6,819,1715,30
105041185219,105041185226,7,2383,1001,30
105041434049,105041434043,-6,1253,3448,30
105048388423,105048388418,-5,927,2710,30
105051995286,105051995282,-4,1164,3146,30
105054853855,105054853861,6,5104,3293,30
105059249811,105059249807,-4,548,2330,30
105060892625,105060892622,-3,701,1657,30
105061552745,105061552749,4,1272,1002,30
105066515016,105066515018,2,1344,1391,30
105067992804,105067992799,-5,1576,3125,30
105080573257,105080573253,-4,1118,4653,30
105086228190,105086228186,-4,1272,3089,30
105094996995,105094996990,-5,920,2333,30
105102504869,105102504864,-5,1549,3171,30
105106093919,105106093914,-5,1000,3282,30
105108371570,105108371565,-5,1518,2528,30
105118880494,105118880487,-7,941,2541,30
105121725625,105121725622,-3,1216,3139,30
105124772508,105124772503,-5,585,947,30
105125278787,105125278803,16,1251,3584,30
105126183047,105126183045,-2,1607,2671,30
105126392482,105126392478,-4,1065,1970,30
105130141772,105130141767,-5,1227,2142,30
105131623477,105131623482,5,2641,648,30
105134303071,105134303069,-2,1193,3616,30
105134406920,105134406914,-6,1141,2584,30
105135018998,105135018997,-1,4508,7285,30
105136041625,105136041621,-4,769,2457,30
105136650578,105136650574,-4,901,2385,30
105137352549,105137352545,-4,1100,3145,30
105138785793,105138785789,-4,1582,2872,30
105140172358,105140172354,-4,1207,3079,30
105142182383,105142182379,-4,925,2180,30
105144166552,105144166546,-6,1294,2897,30
105144235934,105144235930,-4,1016,3261,30
105150105667,105150105662,-5,865,2487,30
105153407045,105153407041,-4,1040,1684,30
105153957950,105153957945,-5,1172,2886,30
105161660006,105161660016,10,15210,25167,30
105163102836,105163102832,-4,1050,3353,30
105164446568,105164446581,13,353,1823,30
105166153794,105166153790,-4,1226,2994,30
105170527306,105170527304,-2,929,2656,30
105172843773,105172843769,-4,1107,3198,30
105173337809,105173337829,20,1186,2285,30
105174510462,105174510458,-4,1316,2809,30
105186766396,105186766393,-3,930,2948,30
105191215989,105191215985,-4,1518,3654,30
105193525111,105193525107,-4,959,2598,30
105195511446,105195511442,-4,1236,3062,30
105196618389,105196618383,-6,1431,3804,30
105208905073,105208905069,-4,483,2854,30
105211090037,105211090033,-4,1024,3321,30
105211225858,105211225864,6,2367,1457,30
105213390012,105213390010,-2,814,1756,30
105214766099,105214766093,-6,657,2675,30
105216109111,105216109109,-2,510,868,30
105219038194,105219038190,-4,743,2454,30
105225291446,105225291442,-4,703,1803,30
105230407396,105230407391,-5,1273,2981,30
105237058870,105237058865,-5,972,2742,30
105238205276,105238205274,-2,1312,2240,30
105239362943,105239362938,-5,1208,2177,30
105249362847,105249362842,-5,1005,1835,30
105252996253,105252996246,-7,1005,2499,30
105264946381,105264946376,-5,1114,2361,30
105265596229,105265596225,-4,999,1853,30
105268287642,105268287637,-5,727,1619,30
105271555993,105271555987,-6,1054,3762,30
105271939162,105271939158,-4,693,1925,30
105282541556,105282541553,-3,2012,3138,30
105282955647,105282955646,-1,1247,2046,30
105283890589,105283890594,5,4610,2668,30
105284494021,105284494014,-7,2414,8779,30
105285229202,105285229198,-4,1373,2183,30
105291547167,105291547162,-5,479,2115,30
105293708881,105293708877,-4,973,3348,30
105293968266,105293968261,-5,933,2688,30
105297627086,105297627081,-5,1038,2515,30
105298882542,105298882560,18,1100,198,30
105300016631,105300016628,-3,819,2976,30
105302153318,105302153314,-4,1187,3136,30
105303557414,105303557409,-5,1001,3015,30
105305201920,105305201914,-6,1379,3786,30
105307080343,105307080340,-3,786,3146,30
105311133647,105311133641,-6,977,2709,30
105312746326,105312746322,-4,1197,4507,30
105312841576,105312841564,-12,25,1285,30
105316301647,105316301645,-2,1078,2610,30
105318543474,105318543470,-4,762,2810,30
105320750611,105320750605,-6,1103,3600,30
105321249798,105321249796,-2,1445,1992,30
105322239213,105322239209,-4,447,1666,30
105323295679,105323295677,-2,677,1655,30
105324785518,105324785514,-4,1438,2838,30
105334646946,105334646942,-4,2247,6183,30
105337435573,105337435571,-2,927,1790,30
105347282323,105347282315,-8,995,2913,30
105355418832,105355418829,-3,1405,2777,30
105357781321,105357781303,-18,251,904,30
105363837995,105363837990,-5,1172,3844,30
105364218242,105364218238,-4,1150,2579,30
105369092853,105369092848,-5,854,2399,30
105373118969,105373118965,-4,1054,1972,30
105382558309,105382558302,-7,1105,2796,30
105383517122,105383517118,-4,1172,3414,30
105384639672,105384639689,17,707,2801,30
105386037618,105386037615,-3,1115,1979,30
105387363325,105387363321,-4,1012,2404,30
105391243042,105391243038,-4,836,2423,30
105392438983,105392438977,-6,881,2524,30
105395344990,105395344985,-5,1031,2381,30
105397594834,105397594829,-5,1098,3392,30
105397955781,105397955778,-3,1449,4119,30
105400748225,105400748219,-6,1297,3753,30
105404609727,105404609733,6,5281,1804,30
105405637718,105405637713,-5,596,2005,30
105405844472,105405844477,5,95,1147,30
105407046581,105407046577,-4,986,2240,30
105410051253,105410051268,15,338,1888,30
105419362934,105419362927,-7,847,1991,30
105425331691,105425331687,-4,787,3321,30
105429156362,105429156361,-1,141,909,30
105431165407,105431165403,-4,1143,2331,30
105432659581,105432659577,-4,1040,2781,30
105433889175,105433889170,-5,995,3833,30
105434634671,105434634666,-5,802,2883,30
105437400051,105437400048,-3,645,2225,30
105440251638,105440251641,3,3172,3295,30
105440702147,105440702142,-5,1325,3380,30
105444451521,105444451518,-3,1202,3530,30
105445337178,105445337174,-4,1190,1743,30
105449478920,105449478922,2,1297,1101,30
105452581411,105452581408,-3,1373,3397,30
105455863291,105455863286,-5,1370,3357,30
105462654748,105462654742,-6,1273,3001,30
105462969711,105462969706,-5,661,2594,30
105466156806,105466156801,-5,1153,2937,30
105466302873,105466302868,-5,942,1943,30
105467017312,105467017306,-6,1125,2797,30
105470953975,105470953969,-6,1406,2250,30
105472947410,105472947411,1,910,1527,30
105472972826,105472972824,-2,1269,3147,30
105473789415,105473789410,-5,1114,2615,30
105474124918,105474124914,-4,863,1934,30
105477113663,105477113658,-5,1121,2968,30
105478462885,105478462881,-4,1075,3571,30
105478812477,105478812472,-5,1055,3962,30
105478847200,105478847185,-15,260,1308,30
105479825130,105479825124,-6,1350,3064,30
105484117722,105484117717,-5,1389,2968,30
105484207397,105484207393,-4,1092,2056,30
105484562152,105484562146,-6,1250,3546,30
105494998124,105494998118,-6,1422,3532,30
105495855215,105495855213,-2,1255,2866,30
105503725763,105503725758,-5,1414,2928,30
105504957854,105504957851,-3,1430,3860,30
105506591277,105506591273,-4,735,2192,30
105507102098,105507102086,-12,13941,42472,30
105507542279,105507542273,-6,823,3592,30
105508403195,105508403196,1,1308,2114,30
105509022754,105509022750,-4,1149,3066,30
105509386368,105509386366,-2,1783,4180,30
105516990426,105516990422,-4,1508,7548,30
105524566248,105524566243,-5,1102,3016,30
105526993168,105526993164,-4,1379,2864,30
105530620505,105530620491,-14,94,1040,30
105535674218,105535674221,3,7225,19135,30
105538640067,105538640070,3,3076,1570,30
105543378866,105543378862,-4,820,2836,30
105547057731,105547057726,-5,911,2257,30
105550143715,105550143711,-4,1400,2276,30
105551132575,105551132570,-5,995,3039,30
105553881565,105553881566,1,1722,1679,30
105554028757,105554028752,-5,1291,3444,30
105561154193,105561154202,9,3229,1163,30
105563397119,105563397114,-5,1067,2327,30
105564767158,105564767153,-5,1640,3736,30
105565169235,105565169230,-5,941,1824,30
105567597814,105567597808,-6,808,3787,30
105575635419,105575635414,-5,964,2668,30
105576189945,105576189939,-6,1124,2509,30
105577376048,105577376069,21,1101,2849,30
105580597403,105580597397,-6,978,2337,30
105582549642,105582549638,-4,829,2038,30
105585346415,105585346414,-1,213,1168,30
105591739170,105591739167,-3,1104,2699,30
105596645983,105596645978,-5,908,1283,30
105598286709,105598286705,-4,1122,2200,30
105605694430,105605694426,-4,1272,2376,30
105608739982,105608739977,-5,707,2031,30
105615779551,105615779546,-5,1260,2864,30
105619410010,105619410003,-7,937,3105,30
105629666161,105629666167,6,5415,3146,30
105634221035,105634221030,-5,1183,3324,30
105637841454,105637841453,-1,1112,1934,30
105643201803,105643201793,-10,655,3197,30
105644540925,105644540912,-13,1291,349,30
105647730207,105647730208,1,1432,1388,30
105651788134,105651788130,-4,849,3050,30
105654231883,105654231878,-5,1001,2791,30
105655655354,105655655350,-4,1357,3344,30
105658059677,105658059680,3,746,817,30
105662609917,105662609912,-5,1134,3791,30
105663539806,105663539811,5,1379,1171,30
105664143447,105664143442,-5,1344,3619,30
105664811002,105664811006,4,207,925,30
105666668721,105666668718,-3,1139,2019,30
105666768779,105666768797,18,429,1361,30
105670461573,105670461570,-3,814,2534,30
105672924307,105672924302,-5,976,1678,30
105674930723,105674930717,-6,851,2878,30
105678615010,105678614990,-20,2563,1455,30
105683016590,105683016585,-5,998,2564,30
105683410356,105683410371,15,992,3024,30
105687930980,105687930971,-9,1458,3497,30
105692786717,105692786731,14,233,767,30
105693126192,105693126188,-4,1194,3467,30
105705749383,105705749377,-6,985,3176,30
105706327489,105706327484,-5,929,2844,30
105707488634,105707488628,-6,806,2464,30
105709801090,105709801084,-6,1222,3445,30
105710598554,105710598549,-5,860,3233,30
105710674624,105710674619,-5,1146,3694,30
105712819706,105712819702,-4,1140,2701,30
105713365382,105713365384,2,1905,1502,30
105722746942,105722746938,-4,1142,3397,30
105729421267,105729421262,-5,971,2533,30
105730237386,105730237374,-12,956,2734,30
105732231575,105732231570,-5,1200,3657,30
105737594987,105737594982,-5,1155,2934,30
105737662258,105737662254,-4,1332,3355,30
105739456337,105739456334,-3,1073,2883,30
105745356973,105745356970,-3,1047,2082,30
105746280993,105746280993,0,63,1190,30
105748331997,105748331993,-4,1249,3854,30
105748392834,105748392853,19,527,1260,30
105750820416,105750820427,11,689,2161,30
105751789707,105751789702,-5,843,2931,30
105754454098,105754454094,-4,1036,3028,30
105756439391,105756439387,-4,869,2292,30
105757411494,105757411490,-4,1124,2834,30
105759038920,105759038917,-3,6144,13109,30
105760708658,105760708653,-5,1100,3279,30
105763986417,105763986413,-4,989,1978,30
105771307687,105771307686,-1,1894,3063,30
105771580258,105771580252,-6,1237,1831,30
105774882984,105774882978,-6,958,2674,30
105775007764,105775007783,19,1129,2739,30
105777435853,105777435847,-6,1198,2880,30
105778166769,105778166758,-11,206,1715,30
105778240472,105778240495,23,185,1029,30
105779628496,105779628493,-3,1265,3179,30
105781377421,105781377418,-3,1124,2537,30
105782263476,105782263479,3,90,1162,30
105791741693,105791741689,-4,1081,2873,30
105792580513,105792580509,-4,252,1152,30
105796586865,105796586859,-6,1187,3148,30
105802442786,105802442781,-5,1109,2322,30
105805684426,105805684424,-2,1011,2473,30
105807271995,105807271989,-6,1505,4811,30
105808124691,105808124685,-6,941,3172,30
105808871054,105808871057,3,49906,47219,30
105816286178,105816286174,-4,984,2303,30
105817582575,105817582571,-4,1404,4174,30
105822646927,105822646922,-5,1223,2537,30
105824010110,105824010108,-2,1050,2004,30
105824633326,105824633318,-8,782,1778,30
105825578851,105825578870,19,694,2218,30
105826782200,105826782198,-2,903,2280,30
105830857138,105830857136,-2,892,3008,30
105832512763,105832512765,2,2048,2560,30
105837393499,105837393493,-6,1087,3599,30
105837854416,105837854435,19,838,3040,30
105843637301,105843637298,-3,1275,2195,30
105844133614,105844133609,-5,1087,1699,30
105846479742,105846479737,-5,971,3958,30
105847394228,105847394225,-3,766,1403,30
105851424593,105851424586,-7,1164,3828,30
105851744426,105851744422,-4,878,3298,30
105858565091,105858565085,-6,815,2994,30
105866419859,105866419855,-4,1283,3345,30
105870451462,105870451453,-9,834,2169,30
105875982282,105875982278,-4,1077,2575,30
105882549869,105882549863,-6,1351,2580,30
105882804867,105882804883,16,756,1902,30
105885663499,105885663495,-4,931,2909,30
105886875525,105886875521,-4,1309,3036,30
105887743739,105887743737,-2,1996,5420,30
105889435707,105889435703,-4,1021,3012,30
105899833577,105899833573,-4,640,2290,30
105902063715,105902063712,-3,1139,3635,30
105904234403,105904234405,2,2961,1795,30
105904349038,105904349032,-6,1115,2980,30
105905477092,105905477089,-3,1019,2851,30
105906440311,105906440308,-3,688,2202,30
105906748216,105906748231,15,832,1518,30
105906819484,105906819481,-3,1559,2582,30
105911142926,105911142921,-5,742,2070,30
105911544569,105911544565,-4,1431,4265,30
105917515741,105917515733,-8,1095,3920,30
105919156247,105919156245,-2,567,1168,30
105921368452,105921368446,-6,1058,2426,30
105922685819,105922685815,-4,1122,3344,30
105923985778,105923985774,-4,1235,2194,30
105924217043,105924217039,-4,1213,2507,30
105924662998,105924663005,7,42,1268,30
105924910947,105924910926,-21,1402,2990,30
105928633509,105928633505,-4,841,1656,30
105929456743,105929456739,-4,1133,2470,30
105932024611,105932024615,4,3148,2587,30
105932622273,105932622268,-5,1193,4429,30
105938368543,105938368540,-3,602,2018,30
105940219104,105940219125,21,331,1279,30
105943710416,105943710426,10,1282,2493,30
105944449893,105944449888,-5,1047,2781,30
105950306236,105950306233,-3,1042,2791,30
105951668454,105951668450,-4,892,2862,30
105953004601,105953004590,-11,104,469,30
105958988478,105958988473,-5,1314,3199,30
105965201499,105965201495,-4,1044,3177,30
105966230288,105966230284,-4,1172,2992,30
105966598304,105966598318,14,116501,31240,30
105967058179,105967058158,-21,1430,2864,30
105970750115,105970750108,-7,1113,3721,30
105974033652,105974033646,-6,1240,4251,30
105982460867,105982460862,-5,1216,2634,30
105993150514,105993150517,3,1649,1177,30
105996777118,105996777113,-5,719,3810,30
105999073997,105999073991,-6,660,1799,30
106000453977,106000453973,-4,887,2665,30
106002529726,106002529730,4,3944,24475,30
106009808267,106009808262,-5,1039,2434,30
106011177298,106011177316,18,721,3253,30
106011740756,106011740751,-5,927,3371,30
106013666851,106013666847,-4,740,2182,30
106023031454,106023031451,-3,741,2353,30
106032881898,106032881906,8,5267,1290,30
106033563540,106033563535,-5,1009,2742,30
106041906035,106041906030,-5,1267,3249,30
106049501437,106049501431,-6,1400,3638,30
106053809475,106053809470,-5,1069,1870,30
106054564744,106054564738,-6,1354,4414,30
106055734186,106055734182,-4,922,2128,30
106062729222,106062729219,-3,1903,4061,30
106062956479,106062956474,-5,858,2636,30
106063303345,106063303339,-6,1467,2583,30
106064881497,106064881493,-4,1991,4034,30
106065976890,106065976887,-3,1242,3883,30
106071877841,106071877838,-3,1617,3172,30
106072976822,106072976816,-6,917,3739,30
106073991900,106073991917,17,887,2547,30
106074285460,106074285474,14,1142,3242,30
106075168786,106075168781,-5,1138,2914,30
106080569270,106080569266,-4,1212,2276,30
106093617319,106093617313,-6,702,2677,30
106097093987,106097093982,-5,1030,3425,30
106097811514,106097811530,16,140,1129,30
106104640872,106104640868,-4,1526,3310,30
106108299255,106108299250,-5,1101,4429,30
106110249389,106110249385,-4,1121,1713,30
106110573050,106110573046,-4,1020,2559,30
106118022191,106118022187,-4,943,3193,30
106120509203,106120509198,-5,890,2470,30
106121291718,106121291713,-5,1319,3383,30
106129007999,106129007993,-6,1361,2917,30
106132118302,106132118298,-4,1141,2866,30
106136004373,106136004395,22,1273,2501,30
106140543971,106140543966,-5,1008,3564,30
106144392670,106144392666,-4,1317,2864,30
106146274543,106146274541,-2,1091,1993,30
106153701878,106153701874,-4,1291,3357,30
106155515960,106155515942,-18,895,1794,30
106157216690,106157216685,-5,799,2818,30
106157342583,106157342578,-5,771,2194,30
106161970097,106161970093,-4,773,2836,30
106162632763,106162632747,-16,22,743,30
106163172803,106163172798,-5,889,2381,30
106182951045,106182951042,-3,679,1983,30
106184830390,106184830387,-3,1097,1748,30
106186111261,106186111254,-7,1430,3848,30
106191005058,106191005055,-3,886,1832,30
106194756949,106194756943,-6,845,2530,30
106196598067,106196598046,-21,1908,1215,30
106199145890,106199145885,-5,819,3841,30
106199626376,106199626370,-6,1712,6655,30
106204165429,106204165430,1,1664,2298,30
106205304709,106205304690,-19,323,994,30
106206240298,106206240293,-5,1065,2080,30
106207960302,106207960298,-4,948,3935,30
106208687697,106208687692,-5,784,2972,30
106212016435,106212016435,0,1857,1641,30
106215213445,106215213443,-2,925,2044,30
106221852475,106221852470,-5,910,2216,30
106223008305,106223008300,-5,1167,2848,30
106223200136,106223200122,-14,864,3006,30
106223319821,106223319817,-4,1393,2574,30
106227819477,106227819473,-4,1370,3623,30
106228735230,106228735234,4,2603,2236,30
106233715895,106233715890,-5,987,2813,30
106234269500,106234269514,14,689,2953,30
106236940845,106236940838,-7,1202,6031,30
106237409271,106237409266,-5,865,2866,30
106241113698,106241113698,0,1772,1988,30
106241956415,106241956415,0,1657,1774,30
106242217962,106242217957,-5,871,2184,30
106248855958,106248855954,-4,1210,3180,30
106252693986,106252693978,-8,988,2798,30
106253544415,106253544410,-5,1064,3148,30
106254851570,106254851562,-8,1037,2631,30
106255304714,106255304724,10,227,1047,30
106263925723,106263925720,-3,830,2351,30
106266194899,106266194894,-5,1051,2829,30
106267734456,106267734452,-4,1098,3384,30
106267800627,106267800617,-10,1188,2069,30
106267840104,106267840085,-19,98,976,30
106270236478,106270236474,-4,1456,3349,30
106270972865,106270972880,15,1186,4658,30
106274123691,106274123687,-4,645,1924,30
106276401698,106276401699,1,1807,1919,30
106282088665,106282088662,-3,1127,2455,30
106283531358,106283531356,-2,2179,3750,30
106284253355,106284253349,-6,912,3554,30
106284518770,106284518790,20,611,1436,30
106285046482,106285046479,-3,1205,3159,30
106288290222,106288290218,-4,893,3311,30
106289790134,106289790130,-4,968,1372,30
106293799586,106293799579,-7,30251,10801,30
106304166558,106304166573,15,710,2623,30
106306258957,106306258952,-5,1397,2036,30
106310193267,106310193263,-4,856,3313,30
106315494877,106315494873,-4,1195,3182,30
106315534832,106315534814,-18,1254,2856,30
106323140854,106323140850,-4,1186,3021,30
106323986632,106323986637,5,134,754,30
106329536259,106329536253,-6,1214,2357,30
106332227856,106332227851,-5,1024,3745,30
106332591770,106332591764,-6,1365,3419,30
106338636918,106338636920,2,2157,2071,30
106338976915,106338976910,-5,881,4239,30
106340789319,106340789314,-5,1151,2544,30
106341209050,106341209047,-3,1037,2518,30
106342666261,106342666258,-3,1087,3691,30
106346484701,106346484694,-7,1230,4154,30
106347714844,106347714841,-3,1160,2403,30
106348532793,106348532788,-5,752,2204,30
106358003802,106358003797,-5,784,2927,30
106358394067,106358394063,-4,809,2218,30
106359651150,106359651145,-5,1010,3307,30
106360829998,106360829996,-2,1929,4024,30
106363032445,106363032446,1,759,1316,30
106364107960,106364107954,-6,888,2750,30
106365334955,106365334949,-6,3108,9616,30
106372012579,106372012574,-5,1069,6031,30
106373281032,106373281029,-3,1330,3057,30
106385921369,106385921365,-4,1225,3055,30
106386150930,106386150928,-2,257,1475,30
106389233561,106389233558,-3,918,2786,30
106390613655,106390613650,-5,940,2761,30
106391566617,106391566614,-3,1091,2364,30
106392973226,106392973222,-4,2795,6611,30
106393723601,106393723596,-5,874,1889,30
106398428340,106398428342,2,2290,1726,30
106399262205,106399262201,-4,915,1941,30
106404332642,106404332645,3,13081,9260,30
106405099321,106405099316,-5,990,2893,30
106415928786,106415928781,-5,763,2385,30
106419248691,106419248686,-5,1036,2949,30
106426842244,106426842239,-5,805,2930,30
106439290899,106439290894,-5,1130,3661,30
106443568338,106443568332,-6,912,2857,30
106447164384,106447164377,-7,1059,2987,30
106448489496,106448489493,-3,1250,1872,30
106448856065,106448856059,-6,1026,2465,30
106454207937,106454207939,2,1447,1914,30
106454841607,106454841604,-3,1320,3358,30
106455533526,106455533520,-6,1456,4582,30
106464034949,106464034954,5,15205,7599,30
106466023389,106466023385,-4,951,2096,30
106466153963,106466153961,-2,1198,2377,30
106466837029,106466837026,-3,1185,2981,30
106467214483,106467214478,-5,831,3166,30
106469920262,106469920258,-4,747,2457,30
106471168489,106471168485,-4,1205,3715,30
106474794062,106474794057,-5,695,1319,30
106481086927,106481086922,-5,1172,3481,30
106486232261,106486232255,-6,1566,4085,30
106491887659,106491887655,-4,1068,3082,30
106493776070,106493776068,-2,1954,2935,30
106506913474,106506913471,-3,1251,2930,30
106515178379,106515178374,-5,866,2022,30
106516550835,106516550835,0,1610,2152,30
106517485359,106517485355,-4,1425,4170,30
106517543009,106517543010,1,3248,4535,30
106522278143,106522278138,-5,1088,2759,30
106525489860,106525489857,-3,971,2663,30
106528970203,106528970198,-5,1097,3086,30
106529944470,106529944465,-5,1175,4686,30
106534087651,106534087648,-3,1414,2813,30
106537672333,106537672331,-2,1216,1971,30
106542201090,106542201086,-4,794,2035,30
106547228402,106547228398,-4,1234,2357,30
106553260374,106553260373,-1,531,1898,30
106558899287,106558899286,-1,1571,2228,30
106560931637,106560931629,-8,36150,12080,30
106563039851,106563039847,-4,1243,3720,30
106566874769,106566874761,-8,460,1196,30
106569811175,106569811170,-5,1593,2988,30
106585680975,106585680971,-4,908,1920,30
106592850930,106592850926,-4,1107,2602,30
106593869647,106593869641,-6,1261,3232,30
106598865858,106598865856,-2,1114,1805,30
106601460830,106601460826,-4,1443,3045,30
106606047897,106606047902,5,8574,24398,30
106608082407,106608082402,-5,1151,2788,30
106608900681,106608900666,-15,124,904,30
106609839507,106609839501,-6,844,2343,30
106610186681,106610186677,-4,977,2491,30
106610813929,106610813925,-4,1366,4479,30
106611332183,106611332179,-4,1191,3355,30
106615159701,106615159702,1,26918,22044,30
106617343533,106617343530,-3,1574,2602,30
106625489159,106625489159,0,1609,2137,30
106632790974,106632790970,-4,1159,2672,30
106635033726,106635033722,-4,326,1193,30
106636110130,106636110125,-5,1626,3738,30
106639485167,106639485161,-6,1016,4172,30
106650411435,106650411431,-4,866,2429,30
106651670272,106651670265,-7,1275,3634,30
106653518219,106653518219,0,1093,902,30
106659318088,106659318083,-5,1374,3840,30
106660233270,106660233275,5,776,890,30
106662793562,106662793558,-4,1084,4188,30
106662908164,106662908146,-18,753,2044,30
106663293332,106663293325,-7,772,3185,30
106671677499,106671677495,-4,1193,3177,30
106671889867,106671889862,-5,663,2213,30
106672623891,106672623886,-5,1046,2533,30
106673395554,106673395550,-4,1361,4148,30
106677612847,106677612842,-5,837,3008,30
106679025552,106679025540,-12,940,3357,30
106679055207,106679055203,-4,1296,2773,30
106684355825,106684355820,-5,995,2679,30
106689168209,106689168206,-3,875,2836,30
106694645139,106694645134,-5,798,2973,30
106696681037,106696681033,-4,1134,3104,30
106702001674,106702001671,-3,845,2428,30
106703520167,106703520165,-2,1088,3079,30
106704102422,106704102418,-4,2349,7126,30
106709002259,106709002254,-5,1090,3020,30
106709547180,106709547175,-5,1198,2954,30
106721717739,106721717745,6,5795,3533,30
106721795159,106721795156,-3,773,1873,30
106723715214,106723715211,-3,1279,2558,30
106724301435,106724301432,-3,1018,3196,30
106724472108,106724472110,2,1790,2044,30
106726863640,106726863636,-4,1060,3204,30
106731080661,106731080660,-1,1110,1376,30
106733634508,106733634522,14,386,1452,30
106734117350,106734117348,-2,1651,1871,30
106737400566,106737400563,-3,1532,3070,30
106746917450,106746917443,-7,934,4017,30
106757484169,106757484164,-5,1214,2943,30
106760204546,106760204547,1,1415,1735,30
106764122057,106764122051,-6,1257,4410,30
106764909813,106764909806,-7,1196,6280,30
106765094950,106765094945,-5,1335,2716,30
106766473591,106766473585,-6,1141,3605,30
106769249965,106769249962,-3,694,2234,30
106773609327,106773609323,-4,1001,2565,30
106774024067,106774024050,-17,142,739,30
106777019841,106777019837,-4,1178,2796,30
106777090137,106777090152,15,811,1661,30
106785430183,106785430177,-6,1157,3016,30
106790120001,106790119996,-5,907,2876,30
106790762517,106790762513,-4,1365,2644,30
106792931381,106792931382,1,2110,1864,30
106793535842,106793535838,-4,1047,2495,30
106800275294,106800275289,-5,1322,2970,30
106802654315,106802654320,5,1532,948,30
106803736744,106803736742,-2,894,2429,30
106805064642,106805064637,-5,976,2638,30
106810499097,106810499091,-6,1443,3423,30
106818933643,106818933637,-6,1151,4742,30
106822974015,106822974009,-6,865,3121,30
106826469589,106826469591,2,1189,912,30
106841779805,106841779799,-6,1382,3378,30
106841830656,106841830670,14,512,1526,30
106842910850,106842910855,5,3314,1424,30
106846640262,106846640264,2,3079,3219,30
106850685846,106850685841,-5,1140,3012,30
106853842954,106853842950,-4,1272,1963,30
106854326993,106854326988,-5,1056,3959,30
106854511295,106854511290,-5,1210,2961,30
106855033122,106855033141,19,1724,3959,30
106855766473,106855766467,-6,1225,3565,30
106856325601,106856325622,21,282,863,30
106856879920,106856879917,-3,656,2344,30
106857719894,106857719890,-4,620,2219,30
106858628984,106858628978,-6,1031,2914,30
106861359295,106861359290,-5,1391,4431,30
106863881239,106863881234,-5,1313,3091,30
106864004090,106864004081,-9,36,1394,30
106869384254,106869384250,-4,1033,2557,30
106871705287,106871705283,-4,741,1701,30
106873165197,106873165193,-4,1126,3083,30
106874985143,106874985141,-2,6463,14195,30
106875471401,106875471423,22,711,2404,30
106884447735,106884447731,-4,970,2863,30
106885007529,106885007550,21,891,2684,30
106888286914,106888286910,-4,1037,3223,30
106898533911,106898533907,-4,1073,1895,30
106900483351,106900483350,-1,1303,2637,30
106901438978,106901438972,-6,1350,3697,30
106904678315,106904678309,-6,979,2750,30
106910862361,106910862365,4,1357,805,30
106911738674,106911738692,18,798,904,30
106912487121,106912487112,-9,38012,15604,30
106912915729,106912915722,-7,988,3462,30
106915070557,106915070562,5,2598,1976,30
106915903354,106915903350,-4,1078,3041,30
106915998803,106915998793,-10,1039,1873,30
106918089053,106918089049,-4,1031,3223,30
106919057602,106919057598,-4,971,2519,30
106922372210,106922372215,5,3731,1381,30
106933158455,106933158449,-6,1375,2565,30
106933618831,106933618828,-3,630,2309,30
106936161388,106936161382,-6,880,2561,30
106938447459,106938447453,-6,761,2949,30
106939900375,106939900369,-6,841,2381,30
106939946527,106939946522,-5,961,2426,30
106940565672,106940565652,-20,2379,1124,30
106943280724,106943280726,2,1741,1732,30
106945534647,106945534643,-4,1586,2117,30
106952183258,106952183254,-4,678,2688,30
106953451203,106953451208,5,3197,1780,30
106965127029,106965127025,-4,789,1642,30
106965523810,106965523805,-5,1021,2864,30
106966529314,106966529309,-5,655,2728,30
106966810713,106966810734,21,631,2444,30
106966925050,106966925045,-5,947,3241,30
106969680692,106969680688,-4,934,2202,30
106971264818,106971264813,-5,1200,4135,30
106974162046,106974162041,-5,998,2852,30
106975160237,106975160236,-1,869,2203,30
106979488975,106979488988,13,36918,11424,30
106988782870,106988782865,-5,760,2540,30
106990125478,106990125474,-4,1540,3124,30
106991815572,106991815567,-5,1297,3641,30
106992849047,106992849042,-5,832,2279,30
106994776371,106994776367,-4,1159,2354,30
106995286019,106995286018,-1,1335,2480,30
106996372933,106996372925,-8,595,2369,30
106999303813,106999303808,-5,1710,3047,30
107000861454,107000861452,-2,872,1739,30
107001743907,107001743902,-5,912,2595,30
107005456822,107005456818,-4,323,1324,30
107008101430,107008101437,7,5948,2595,30
107009505462,107009505458,-4,823,2706,30
107009671914,107009671907,-7,767,3145,30
107011608306,107011608303,-3,1040,2841,30
107015786192,107015786190,-2,1189,2380,30
107016872410,107016872410,0,11090,46317,30
107018467503,107018467498,-5,978,2541,30
107020743210,107020743206,-4,971,2644,30
107022012360,107022012355,-5,1057,3340,30
107022734690,107022734686,-4,24402,11033,30
107023059305,107023059302,-3,913,2942,30
107027126599,107027126597,-2,884,2864,30
107029555649,107029555644,-5,1290,2477,30
107029953372,107029953368,-4,1075,2717,30
107035464071,107035464067,-4,1407,2936,30
107038414380,107038414401,21,908,2879,30
107049131147,107049131147,0,1268,1370,30
107049425669,107049425672,3,2642,2217,30
107050871986,107050871981,-5,897,3075,30
107055965208,107055965202,-6,1250,4275,30
107059244782,107059244773,-9,97990,35058,30
107061876768,107061876774,6,2000,1560,30
107063906599,107063906596,-3,1318,1647,30
107065127428,107065127422,-6,802,2449,30
107069824234,107069824230,-4,1200,1815,30
107075959682,107075959681,-1,682,1598,30
107076048475,107076048470,-5,921,3057,30
107076701220,107076701220,0,27979,19990,30
107077695998,107077695993,-5,861,2346,30
107078495938,107078495955,17,818,2083,30
107080209139,107080209134,-5,1302,2731,30
107081433662,107081433666,4,1640,1100,30
107084721373,107084721378,5,2037,1242,30
107086087557,107086087563,6,17260,7705,30
107090262549,107090262546,-3,850,2006,30
107092649004,107092649001,-3,1193,3012,30
107095740554,107095740549,-5,799,2951,30
107100490027,107100490022,-5,906,3265,30
107101424003,107101423996,-7,1821,9712,30
107104335573,107104335570,-3,1285,2691,30
107108742954,107108742951,-3,793,3245,30
107113251190,107113251186,-4,1242,2953,30
107118969803,107118969795,-8,2167,8934,30
107123605695,107123605690,-5,643,2233,30
107123914497,107123914485,-12,137,1167,30
107124644100,107124644117,17,273,1249,30
107125451111,107125451107,-4,1078,2547,30
107126869475,107126869470,-5,1078,2194,30
107131251687,107131251682,-5,703,2565,30
107134818733,107134818729,-4,1425,2372,30
107138413620,107138413614,-6,1097,2714,30
107153950925,107153950921,-4,1094,3109,30
107158679174,107158679170,-4,1206,1618,30
107160905859,107160905853,-6,1141,3164,30
107162330154,107162330158,4,2241,1487,30
107169794854,107169794856,2,2123,1172,30
107170443966,107170443986,20,1268,1989,30
107173187563,107173187559,-4,1143,3368,30
107176873769,107176873764,-5,964,2038,30
107179771949,107179771941,-8,776,2965,30
107187368164,107187368162,-2,941,2449,30
107193637830,107193637827,-3,985,2578,30
107195320041,107195320037,-4,1110,2307,30
107196013107,107196013105,-2,1189,1995,30
107197991699,107197991694,-5,991,1774,30
107198231374,107198231371,-3,788,1855,30
107206719653,107206719661,8,3645,1099,30
107208044082,107208044082,0,2003,1985,30
107208721451,107208721448,-3,776,1997,30
107215606991,107215606986,-5,1120,3101,30
107219042944,107219042939,-5,1420,3732,30
107220039385,107220039381,-4,1096,1814,30
107223269857,107223269853,-4,1720,4472,30
107224027735,107224027730,-5,1214,3292,30
107225071874,107225071868,-6,1072,2696,30
107231872118,107231872114,-4,1214,2719,30
107237877199,107237877194,-5,1194,2700,30
107238781005,107238781005,0,1199,2476,30
107242105890,107242105886,-4,1112,3031,30
107244835403,107244835397,-6,736,2195,30
107257906719,107257906714,-5,1442,3822,30
107260724794,107260724790,-4,822,2292,30
107265825866,107265825862,-4,1400,3363,30
107266549116,107266549112,-4,1197,2260,30
107278604841,107278604841,0,1200,1789,30
107278666114,107278666105,-9,683,10009,30
107283104642,107283104620,-22,988,826,30
107285122661,107285122657,-4,891,3054,30
107289170139,107289170134,-5,1505,3624,30
107290394095,107290394091,-4,999,2614,30
107291486421,107291486416,-5,761,2048,30
107292619655,107292619652,-3,1121,2988,30
107294907478,107294907473,-5,916,2607,30
107295416622,107295416617,-5,824,2978,30
107299701398,107299701392,-6,1392,3878,30
107305150407,107305150404,-3,1547,3988,30
107309259320,107309259314,-6,1881,1630,30
107312430773,107312430775,2,1353,861,30
107312641350,107312641346,-4,1389,3204,30
107313675773,107313675766,-7,1220,3004,30
107314831134,107314831128,-6,964,3138,30
107319052617,107319052609,-8,900,1962,30
107319791604,107319791615,11,349,1399,30
107328067458,107328067454,-4,1123,3274,30
107331552389,107331552383,-6,982,2245,30
107332972796,107332972793,-3,1522,3324,30
107333218529,107333218549,20,1538,3662,30
107335008309,107335008305,-4,1184,2978,30
107335872181,107335872187,6,1821,1083,30
107338958287,107338958282,-5,559,1859,30
107339098131,107339098135,4,21915,16975,30
107339885864,107339885861,-3,2693,3995,30
107341109075,107341109072,-3,1036,2652,30
107343465196,107343465192,-4,1025,2902,30
107348116170,107348116166,-4,961,2538,30
107349036053,107349036048,-5,1528,4192,30
107351860991,107351860986,-5,1032,3084,30
107358200250,107358200246,-4,865,1926,30
107364382898,107364382893,-5,844,2745,30
107365791831,107365791828,-3,935,2047,30
107369577067,107369577063,-4,831,2555,30
107370865641,107370865636,-5,878,2866,30
107373389430,107373389426,-4,1329,3341,30
107380491838,107380491834,-4,1066,2711,30
107383810750,107383810747,-3,1212,2845,30
107384627331,107384627326,-5,1291,2704,30
107387790607,107387790603,-4,1475,2761,30
107391641871,107391641868,-3,1351,2610,30
107394652858,107394652851,-7,1017,3106,30
107397263509,107397263506,-3,939,1676,30
107406143694,107406143687,-7,916,2929,30
107411484935,107411484934,-1,1288,2132,30
107412174030,107412174027,-3,859,1999,30
107418518102,107418518096,-6,1012,4230,30
107418946139,107418946158,19,678,2400,30
107419109396,107419109393,-3,22541,8900,30
107421277911,107421277905,-6,911,3486,30
107421728017,107421728023,6,3075,1337,30
107423674618,107423674611,-7,1782,5453,30
107423799441,107423799454,13,14,1487,30
107427062426,107427062420,-6,884,2714,30
107432741957,107432741953,-4,819,2853,30
107441083221,107441083216,-5,1331,2797,30
107441809145,107441809166,21,779,2628,30
107442014962,107442014980,18,878,2628,30
107443424066,107443424061,-5,1393,4330,30
107451748258,107451748254,-4,1379,3330,30
107454243379,107454243376,-3,1140,2368,30
107455959119,107455959119,0,896,1365,30
107462741408,107462741402,-6,766,2507,30
107469815109,107469815104,-5,979,2844,30
107471742962,107471742967,5,2202,1180,30
107476733083,107476733079,-4,748,2776,30
107477337957,107477337954,-3,1015,2586,30
107478287924,107478287919,-5,1038,3035,30
107479719842,107479719839,-3,1049,3036,30
107479802366,107479802362,-4,1153,2808,30
107488929157,107488929168,11,2871,1634,30
107492242615,107492242611,-4,963,3844,30
107494058372,107494058365,-7,792,3302,30
107497718086,107497718082,-4,800,2332,30
107497816505,107497816510,5,2015,1241,30
107498349997,107498349990,-7,2869,12847,30
107498855193,107498855190,-3,688,2039,30
107501686867,107501686862,-5,1518,2740,30
107506238582,107506238578,-4,1104,3136,30
107515885694,107515885691,-3,1313,2188,30
107516186505,107516186501,-4,1137,3094,30
107516371473,107516371455,-18,133,1514,30
107516750459,107516750479,20,217,792,30
107518902423,107518902418,-5,787,2357,30
107519170905,107519170926,21,887,2644,30
107519282734,107519282737,3,928,1235,30
107521262365,107521262361,-4,930,3146,30
107521961169,107521961162,-7,228,1023,30
107530632813,107530632810,-3,789,2478,30
107532281915,107532281912,-3,1049,3627,30
107537232137,107537232133,-4,908,2173,30
107540753230,107540753240,10,892,1277,30
107544594582,107544594586,4,2379,1841,30
107549059898,107549059893,-5,436,2113,30
107549224849,107549224834,-15,103,1113,30
107553051855,107553051859,4,1881,1164,30
107558843663,107558843658,-5,1039,3027,30
107565652374,107565652370,-4,1050,2935,30
107567302071,107567302066,-5,1079,1865,30
107570184347,107570184344,-3,864,2259,30
107570582160,107570582143,-17,72,1064,30
107576357711,107576357706,-5,1064,3009,30
107577822011,107577822018,7,1706,467,30
107578719831,107578719827,-4,1314,3722,30
107581762006,107581762002,-4,1213,3732,30
107582911443,107582911438,-5,755,2713,30
107583683666,107583683662,-4,942,2923,30
107594730922,107594730921,-1,1229,2223,30
107597152838,107597152834,-4,1054,1679,30
107598010723,107598010718,-5,1181,2042,30
107603633133,107603633128,-5,1253,3980,30
107604526597,107604526592,-5,901,2170,30
107605908895,107605908892,-3,860,2410,30
107609948207,107609948205,-2,1096,2138,30
107610976603,107610976599,-4,1795,2672,30
107613117076,107613117070,-6,984,3544,30
107615322489,107615322486,-3,1405,2370,30
107615730602,107615730597,-5,1020,3016,30
107616770946,107616770953,7,3940,1858,30
107624776144,107624776138,-6,1102,3876,30
107625760202,107625760197,-5,1004,3170,30
107626016225,107626016222,-3,1146,2488,30
107626168122,107626168139,17,1291,4109,30
107634260297,107634260294,-3,1036,2381,30
107634634832,107634634851,19,1036,2469,30
107635555805,107635555801,-4,996,2303,30
107635627346,107635627342,-4,1204,3216,30
107636848221,107636848216,-5,1042,2142,30
107637318115,107637318130,15,345,1356,30
107644030062,107644030058,-4,905,2824,30
107645047250,107645047270,20,755,1562,30
107657317843,107657317839,-4,1629,2284,30
107659871246,107659871242,-4,783,1267,30
107678240359,107678240355,-4,1101,3211,30
107686548182,107686548177,-5,1189,3087,30
107689200890,107689200885,-5,1116,3517,30
107690775814,107690775813,-1,2102,3784,30
107698385789,107698385783,-6,1003,2021,30
107699101251,107699101248,-3,874,2235,30
107703030970,107703030967,-3,1175,1849,30
107703277076,107703277082,6,3148,1828,30
107716995367,107716995361,-6,1264,3423,30
107730639090,107730639083,-7,863,3710,30
107735428894,107735428890,-4,1423,3405,30
107736107479,107736107473,-6,1050,3370,30
107744942159,107744942155,-4,1103,2612,30
107745005779,107745005790,11,218,905,30
107748150945,107748150946,1,1817,2121,30
107755580689,107755580690,1,1224,1677,30
107755950748,107755950765,17,733,1619,30
107759259706,107759259701,-5,1059,3210,30
107762501814,107762501812,-2,1343,2414,30
107768081503,107768081498,-5,1047,2829,30
107770093110,107770093106,-4,747,2205,30
107779447994,107779447990,-4,1200,2672,30
107784241746,107784241742,-4,1693,4384,30
107789952136,107789952130,-6,1196,3228,30
107790701942,107790701937,-5,1229,2849,30
107790845117,107790845113,-4,948,1707,30
107794391287,107794391283,-4,964,2202,30
107806118014,107806118010,-4,1163,3050,30
107806478993,107806478976,-17,872,2959,30
107806587880,107806587903,23,300,848,30
107810349309,107810349309,0,889,1692,30
107810710915,107810710933,18,304,1720,30
107817975415,107817975410,-5,936,2468,30
107818428075,107818428070,-5,1290,2898,30
107824908350,107824908343,-7,1286,2700,30
107828691026,107828691032,6,3797,1495,30
107830390962,107830390960,-2,900,2768,30
107834499598,107834499594,-4,985,2662,30
107834765457,107834765451,-6,1123,4959,30
107840384338,107840384345,7,3941,1564,30
107855625946,107855625942,-4,948,2685,30
107855745649,107855745644,-5,1378,4348,30
107856592385,107856592379,-6,1156,2801,30
107861451511,107861451509,-2,1028,2931,30
107861518776,107861518757,-19,878,3383,30
107865490052,107865490068,16,580,3531,30
107871949437,107871949442,5,1219,783,30
107873860269,107873860264,-5,1023,2980,30
107876398956,107876398950,-6,1289,2803,30
107882666966,107882666962,-4,1076,2746,30
107883990802,107883990800,-2,2227,4656,30
107884777679,107884777674,-5,1108,2771,30
107885928122,107885928118,-4,785,2126,30
107886085245,107886085238,-7,1117,3144,30
107886436201,107886436195,-6,1207,2736,30
107887533706,107887533703,-3,851,1544,30
107888356218,107888356213,-5,1080,3343,30
107889953718,107889953723,5,2215,1313,30
107895994412,107895994403,-9,719,2660,30
107904536983,107904536987,4,2334,2280,30
107907385509,107907385504,-5,1254,3262,30
107907855643,107907855630,-13,1256,3882,30
107909863576,107909863570,-6,970,2850,30
107913390085,107913390081,-4,937,3264,30
107913591036,107913591054,18,1590,3338,30
107918099190,107918099188,-2,1009,2437,30
107924253495,107924253489,-6,1216,2215,30
107931784472,107931784466,-6,1170,2386,30
107933909234,107933909230,-4,1108,2628,30
107937048543,107937048538,-5,1023,2960,30
107941407404,107941407398,-6,957,2952,30
107942579993,107942579986,-7,1029,1741,30
107943377127,107943377124,-3,815,1865,30
107944002103,107944002098,-5,1029,2840,30
107946846674,107946846670,-4,759,2722,30
107953610379,107953610382,3,2727,2124,30
107953668546,107953668552,6,4080,2153,30
107955184549,107955184570,21,1336,3990,30
107955270801,107955270818,17,257,1019,30
107956711211,107956711207,-4,1264,4904,30
107957663766,107957663760,-6,961,2772,30
107962370046,107962370040,-6,1175,3529,30
107964834369,107964834362,-7,1004,2712,30
107969984447,107969984442,-5,860,2500,30
107971606149,107971606145,-4,1191,3890,30
107972377178,107972377172,-6,1145,2908,30
107973900538,107973900533,-5,915,3482,30
107974006643,107974006637,-6,1138,3281,30
107978346998,107978346993,-5,1314,2835,30
107978892839,107978892833,-6,1061,3163,30
107983987974,107983987970,-4,1183,2455,30
107989328319,107989328314,-5,1151,3501,30
107994816214,107994816209,-5,1400,3203,30
108002508918,108002508914,-4,1187,3935,30
108003481651,108003481646,-5,989,2214,30
108003538042,108003538037,-5,791,2172,30
108005402755,108005402749,-6,821,3813,30
108011305393,108011305388,-5,1120,4312,30
108012132303,108012132299,-4,960,2351,30
108016401470,108016401465,-5,1078,2366,30
108020271624,108020271620,-4,1210,2767,30
108026742027,108026742022,-5,978,2512,30
108028032530,108028032527,-3,1406,4638,30
108031298229,108031298226,-3,911,1044,30
108034068789,108034068785,-4,960,2771,30
108034279577,108034279587,10,180,947,30
108037028808,108037028803,-5,32995,12184,30
108044156739,108044156732,-7,1740,4146,30
108044739146,108044739143,-3,1156,3147,30
108059346669,108059346671,2,1115,1863,30
108060001334,108060001329,-5,1136,3249,30
108060299848,108060299851,3,2551,1426,30
108062181496,108062181503,7,3111,1220,30
108063193798,108063193796,-2,1144,2136,30
108063490963,108063490940,-23,1148,2362,30
108067181251,108067181247,-4,632,2005,30
108072145401,108072145398,-3,1101,2731,30
108075083074,108075083070,-4,709,1856,30
108075735992,108075736010,18,135,1015,30
108076209850,108076209846,-4,1261,3265,30
108079469990,108079469985,-5,754,2999,30
108082442230,108082442236,6,11122,35993,30
108083096295,108083096290,-5,1029,3305,30
108089519308,108089519305,-3,1086,2571,30
108092720017,108092720013,-4,862,2931,30
108093735769,108093735748,-21,1117,3080,30
108094165587,108094165570,-17,968,1987,30
108097227254,108097227250,-4,1357,2518,30
108099147190,108099147185,-5,1217,3023,30
108101395041,108101395040,-1,819,2598,30
108105212616,108105212622,6,1847,922,30
108108854742,108108854738,-4,999,2907,30
108110267278,108110267259,-19,971,779,30
108114192488,108114192483,-5,1021,2698,30
108114890290,108114890285,-5,912,2064,30
108114974360,108114974369,9,226,870,30
108120312229,108120312226,-3,1187,3136,30
108122986629,108122986624,-5,912,3046,30
108127088250,108127088249,-1,1044,1978,30
108131007647,108131007641,-6,971,3802,30
108134449920,108134449915,-5,1555,3732,30
108143660343,108143660325,-18,127,1071,30
108148679439,108148679441,2,24925,20277,30
108153038705,108153038702,-3,926,2986,30
108155492398,108155492394,-4,1143,2878,30
108157965095,108157965090,-5,1405,3577,30
108158504418,108158504414,-4,838,2514,30
108160139945,108160139962,17,487,1415,30
108160233439,108160233435,-4,980,1770,30
108166013275,108166013270,-5,801,2129,30
108168709991,108168709985,-6,1191,3554,30
108170129423,108170129418,-5,712,2001,30
108178611513,108178611509,-4,1056,3215,30
108182238763,108182238758,-5,1097,2263,30
108182359269,108182359275,6,2552,1367,30
108191163838,108191163833,-5,1403,1891,30
108194792542,108194792537,-5,1528,3127,30
108195138634,108195138630,-4,928,2437,30
108202751247,108202751242,-5,1056,2438,30
108203761088,108203761097,9,224,805,30
108219399171,108219399166,-5,796,3857,30
108221048575,108221048578,3,1988,1351,30
108221261867,108221261862,-5,1206,3824,30
108223068902,108223068907,5,2871,1588,30
108223270653,108223270650,-3,1160,2926,30
108223524208,108223524202,-6,736,2199,30
108238900845,108238900841,-4,999,1957,30
108240179244,108240179241,-3,950,1866,30
108247570321,108247570315,-6,1763,3938,30
108250639971,108250639966,-5,1044,2815,30
108251160322,108251160318,-4,1150,3289,30
108254355689,108254355684,-5,1183,3802,30
108258179063,108258179060,-3,1018,1770,30
108259800242,108259800238,-4,1153,3167,30
108267627006,108267627013,7,4811,1694,30
108268894495,108268894497,2,1581,1822,30
108269123263,108269123261,-2,880,1800,30
108271352813,108271352809,-4,917,2539,30
108272588421,108272588414,-7,936,2294,30
108279265734,108279265728,-6,813,3644,30
108279448584,108279448581,-3,821,2411,30
108281616311,108281616306,-5,744,3306,30
108284322143,108284322138,-5,865,2707,30
108287221743,108287221740,-3,1223,3903,30
108292394774,108292394770,-4,1387,2827,30
108295839160,108295839153,-7,1417,6520,30
108299094788,108299094782,-6,1176,4942,30
108310131598,108310131590,-8,705,2681,30
108315895234,108315895229,-5,1029,2647,30
108317732935,108317732930,-5,1011,2835,30
108318830199,108318830195,-4,1281,3426,30
108324698384,108324698383,-1,1636,2575,30
108326615329,108326615323,-6,1144,2664,30
108329465644,108329465633,-11,1027,3630,30
108329723247,108329723244,-3,892,1725,30
108340878401,108340878398,-3,901,2031,30
108346692139,108346692134,-5,1013,3924,30
108346774630,108346774642,12,26940,46700,30
108347235617,108347235613,-4,1481,2597,30
108347419161,108347419157,-4,989,2703,30
108347450964,108347450982,18,424,1100,30
108350026922,108350026917,-5,1062,2622,30
108351209188,108351209184,-4,743,2536,30
108360381677,108360381671,-6,1424,6661,30
108363278369,108363278363,-6,789,2163,30
108364598108,108364598105,-3,1444,2550,30
108365375879,108365375874,-5,1003,3199,30
108365594778,108365594799,21,487,728,30
108380176855,108380176852,-3,1079,2564,30
108381086002,108381086001,-1,1260,2371,30
108382126126,108382126117,-9,888,3764,30
108382502475,108382502470,-5,1322,2988,30
108386680303,108386680298,-5,714,2761,30
108388174854,108388174849,-5,1161,2663,30
108389319730,108389319725,-5,924,3529,30
108393464390,108393464383,-7,794,2749,30
108393792443,108393792461,18,1315,3078,30
108395613068,108395613066,-2,800,3005,30
108396369425,108396369447,22,925,3754,30
108399028670,108399028665,-5,722,2416,30
108399112354,108399112373,19,684,2568,30
108413815205,108413815201,-4,1266,2745,30
108419314484,108419314479,-5,1022,3012,30
108420189943,108420189939,-4,719,2174,30
108421806574,108421806570,-4,1242,2084,30
108422804278,108422804279,1,839,794,30
108432901591,108432901586,-5,1153,3043,30
108435364863,108435364858,-5,1134,3068,30
108436501499,108436501494,-5,1403,4183,30
108440739868,108440739863,-5,1114,2072,30
108446861709,108446861704,-5,1084,2874,30
108453017742,108453017743,1,1893,1569,30
108453782923,108453782917,-6,1154,3042,30
108467303510,108467303505,-5,1581,2985,30
108471820848,108471820843,-5,951,2636,30
108472246058,108472246053,-5,1283,2340,30
108473594369,108473594367,-2,1291,2596,30
108477642446,108477642461,15,1017,3253,30
108478658463,108478658459,-4,529,2920,30
108479135507,108479135515,8,294,785,30
108480868907,108480868909,2,188,1550,30
108483883563,108483883558,-5,1421,2640,30
108484210326,108484210318,-8,771,4165,30
108485914673,108485914666,-7,2592,10671,30
108488545254,108488545249,-5,1204,2899,30
108495085978,108495085973,-5,972,3508,30
108508833219,108508833214,-5,736,2828,30
108509394090,108509394086,-4,703,2495,30
108515040235,108515040230,-5,755,2734,30
108520744419,108520744414,-5,1209,2745,30
108523552926,108523552922,-4,1025,2967,30
108523962491,108523962488,-3,1099,2185,30
108524676661,108524676656,-5,1067,3548,30
108527794767,108527794761,-6,1199,4085,30
108528246706,108528246702,-4,954,2405,30
108530985495,108530985499,4,2606,1776,30
108531035507,108531035502,-5,1052,2920,30
108534531328,108534531322,-6,1032,1670,30
108535445372,108535445381,9,349,1023,30
108536480646,108536480645,-1,1415,2238,30
108537348507,108537348501,-6,707,2182,30
108538107344,108538107337,-7,1061,2711,30
108541286294,108541286290,-4,1034,2700,30
108552559503,108552559499,-4,800,2520,30
108553464309,108553464302,-7,895,2185,30
108553955269,108553955265,-4,1126,1961,30
108555693891,108555693888,-3,930,2594,30
108555792182,108555792178,-4,1007,2929,30
108560241169,108560241163,-6,953,2911,30
108563121437,108563121435,-2,1430,2160,30
108563860255,108563860250,-5,1283,3008,30
108565169801,108565169796,-5,1012,3747,30
108567338397,108567338394,-3,1282,1877,30
108567445666,108567445660,-6,677,1731,30
108569056280,108569056277,-3,1200,2849,30
108572758569,108572758570,1,3512,3933,30
108575224931,108575224923,-8,1055,5998,30
108576180145,108576180141,-4,1084,2490,30
108581166438,108581166434,-4,988,1649,30
108586056867,108586056862,-5,646,1408,30
108588681500,108588681493,-7,1253,3925,30
108592702995,108592702998,3,2640,1853,30
108600816056,108600816052,-4,972,2805,30
108601061408,108601061390,-18,128,973,30
108601297608,108601297602,-6,1351,3184,30
108609598378,108609598373,-5,956,4510,30
108611326254,108611326250,-4,1504,3998,30
108612901458,108612901454,-4,1110,2640,30
108613880982,108613880977,-5,852,2096,30
108620945443,108620945436,-7,954,4124,30
108622843401,108622843401,0,1055,1990,30
108623450099,108623450115,16,367,1043,30
108626901696,108626901693,-3,794,2749,30
108627208921,108627208938,17,220,880,30
108651186927,108651186924,-3,895,2381,30
108651794882,108651794876,-6,1665,7125,30
108655630676,108655630679,3,2647,1038,30
108655713414,108655713406,-8,870,3360,30
108655971194,108655971175,-19,756,1923,30
108659772568,108659772563,-5,1564,3551,30
108665367644,108665367639,-5,938,2657,30
108671235699,108671235694,-5,727,3121,30
108672168671,108672168665,-6,926,2987,30
108673519937,108673519935,-2,812,3488,30
108678785759,108678785777,18,830,2524,30
108679749506,108679749501,-5,723,2876,30
108680152695,108680152690,-5,795,2034,30
108683411884,108683411878,-6,1095,2548,30
108694512614,108694512609,-5,1109,4337,30
108696010729,108696010724,-5,923,2602,30
108699556950,108699556946,-4,1487,3746,30
108699669962,108699669979,17,441,1147,30
108701847002,108701846997,-5,715,2032,30
108703651279,108703651275,-4,866,2726,30
108704630300,108704630301,1,1497,1263,30
108705221780,108705221799,19,280,1245,30
108705473673,108705473659,-14,191,648,30
108708234459,108708234463,4,2080,1409,30
108711178015,108711178009,-6,684,3369,30
108712329178,108712329177,-1,746,1099,30
108715265381,108715265375,-6,1300,3062,30
108715410169,108715410163,-6,28,744,30
108715666875,108715666890,15,778,2770,30
108717095241,108717095237,-4,1516,2552,30
108717792035,108717792054,19,1240,1390,30
108724751423,108724751417,-6,1031,2782,30
108725716627,108725716622,-5,998,2760,30
108729105175,108729105169,-6,1037,3491,30
108730636074,108730636069,-5,810,2252,30
108734507940,108734507935,-5,882,2439,30
108734611690,108734611670,-20,949,3230,30
108736347389,108736347382,-7,712,2478,30
108736966896,108736966906,10,352,708,30
108742045558,108742045559,1,1449,811,30
108752507631,108752507627,-4,1159,3256,30
108752681409,108752681431,22,930,1450,30
108762246723,108762246719,-4,1017,2916,30
108762654812,108762654806,-6,914,1847,30
108765263258,108765263253,-5,862,2710,30
108766045829,108766045825,-4,879,3372,30
108766307882,108766307899,17,1053,3165,30
108768702071,108768702069,-2,1010,1704,30
108770065220,108770065217,-3,1597,2806,30
108775152710,108775152706,-4,931,2490,30
108775329770,108775329778,8,2767,1137,30
108784475426,108784475419,-7,759,1297,30
108784634071,108784634067,-4,371,2511,30
108788917810,108788917824,14,10305,56913,30
108789290650,108789290645,-5,1326,2868,30
108800407187,108800407183,-4,994,2612,30
108800953464,108800953479,15,35,874,30
108803715406,108803715398,-8,1271,4052,30
108804241987,108804241978,-9,146,880,30
108807986761,108807986757,-4,1218,3081,30
108809868330,108809868341,11,11102,46872,30
108813656492,108813656485,-7,1271,4465,30
108817150051,108817150046,-5,1245,3313,30
108821203527,108821203523,-4,1187,2457,30
108822985983,108822985979,-4,1093,3818,30
108823547747,108823547766,19,288,1415,30
108824835379,108824835377,-2,1008,1896,30
108825549167,108825549164,-3,1112,3025,30
108829813774,108829813781,7,4511,1766,30
108830370436,108830370431,-5,1104,3495,30
108830699979,108830699998,19,967,3054,30
108831334660,108831334656,-4,1071,3951,30
108835819754,108835819749,-5,631,2115,30
108836408690,108836408686,-4,999,2508,30
108837063735,108837063730,-5,960,3118,30
108837100715,108837100703,-12,235,786,30
108839013229,108839013225,-4,945,2260,30
108841950889,108841950884,-5,608,2206,30
108846536969,108846536965,-4,1100,4217,30
108856875586,108856875581,-5,947,4963,30
108856977089,108856977085,-4,1113,2688,30
108859488217,108859488210,-7,838,3482,30
108863715392,108863715385,-7,1047,3924,30
108872436503,108872436498,-5,976,2919,30
108875218983,108875218979,-4,934,2556,30
108889499598,108889499595,-3,1130,3628,30
108893171558,108893171553,-5,913,3013,30
108894272637,108894272633,-4,1373,2878,30
108896489280,108896489274,-6,974,2692,30
108898602582,108898602577,-5,1282,3062,30
108900537413,108900537409,-4,1212,2809,30
108901676360,108901676356,-4,873,2262,30
108905033919,108905033913,-6,1218,4366,30
108908732738,108908732735,-3,723,1937,30
108913169877,108913169873,-4,1152,2418,30
108916621157,108916621155,-2,2610,4696,30
108917266519,108917266518,-1,1587,1480,30
108919066465,108919066461,-4,1706,2535,30
108920095306,108920095327,21,41425,19270,30
108925376095,108925376090,-5,1090,2859,30
108926948090,108926948086,-4,880,2308,30
108927509858,108927509879,21,447,2561,30
108936222377,108936222373,-4,1405,3133,30
108943303407,108943303407,0,2363,1814,30
108945385918,108945385922,4,2011,1401,30
108946329498,108946329493,-5,806,2484,30
108946399150,108946399146,-4,975,2692,30
108953312312,108953312308,-4,1156,2589,30
108953470805,108953470811,6,4613,1722,30
108954793834,108954793835,1,1394,1338,30
108960409285,108960409282,-3,685,2235,30
108960873890,108960873886,-4,861,2801,30
108961019705,108961019702,-3,1009,2608,30
108963713759,108963713753,-6,1089,3143,30
108965301983,108965301981,-2,757,1875,30
108967590014,108967590018,4,1481,1052,30
108968306709,108968306704,-5,954,2344,30
108969458258,108969458254,-4,1332,3079,30
108972141578,108972141574,-4,908,2669,30
108976065990,108976065986,-4,1008,2992,30
108977088318,108977088313,-5,602,1894,30
108978155834,108978155854,20,661,2978,30
108978935000,108978934994,-6,731,2646,30
108979253843,108979253862,19,524,1891,30
108981761658,108981761654,-4,934,2386,30
108982142947,108982142966,19,372,2126,30
108983882578,108983882574,-4,1334,3615,30
108987423476,108987423473,-3,889,1782,30
108996708677,108996708677,0,4518,7006,30
108997150446,108997150441,-5,578,2044,30
109000166478,109000166481,3,2663,2367,30
109001828509,109001828506,-3,1064,2822,30
109002113980,109002113975,-5,1093,3192,30
109003111825,109003111819,-6,1107,2563,30
109003223931,109003223948,17,237,593,30
109003909160,109003909155,-5,1328,5017,30
109006330908,109006330903,-5,1711,3590,30
109006431586,109006431582,-4,895,3158,30
109006583482,109006583495,13,235,825,30
109008800643,109008800639,-4,687,2373,30
109009924014,109009924017,3,1909,1928,30
109011635094,109011635089,-5,1047,2445,30
109017155983,109017155979,-4,956,2297,30
109018445393,109018445401,8,3099,1317,30
109019729183,109019729190,7,4198,2361,30
109019933555,109019933550,-5,935,3394,30
109026925407,109026925401,-6,1185,2734,30
109035137609,109035137605,-4,789,2041,30
109041514487,109041514481,-6,1226,2939,30
109042476671,109042476667,-4,750,2518,30
109053294195,109053294192,-3,1069,2613,30
109064397103,109064397099,-4,609,1418,30
109066625373,109066625367,-6,1165,2801,30
109067363331,109067363326,-5,1084,1699,30
109068202037,109068202030,-7,1482,4395,30
109069425901,109069425897,-4,700,2729,30
109071684823,109071684826,3,2102,1411,30
109072824243,109072824238,-5,665,1757,30
109073935198,109073935198,0,1153,919,30
109076549581,109076549576,-5,1644,4753,30
109077256405,109077256406,1,5505,6116,30
109082077875,109082077871,-4,1069,3039,30
109083164766,109083164764,-2,858,1665,30
109086777671,109086777662,-9,64186,16951,30
109091285022,109091285015,-7,715,2726,30
109091901074,109091901082,8,177,822,30
109092408317,109092408311,-6,1173,3354,30
109093070381,109093070375,-6,1295,3164,30
109094895229,109094895225,-4,847,2876,30
109096857122,109096857141,19,881,5040,30
109101252478,109101252473,-5,1497,2655,30
109107371402,109107371399,-3,911,3065,30
109111138679,109111138676,-3,1599,3902,30
109111915842,109111915838,-4,1060,2448,30
109114832818,109114832814,-4,1134,2562,30
109115277227,109115277247,20,302,1670,30
109117777070,109117777065,-5,951,2254,30
109119393201,109119393198,-3,1396,3537,30
109124084769,109124084767,-2,1245,2835,30
109124971961,109124971957,-4,979,2586,30
109133139843,109133139841,-2,1060,2892,30
109134591777,109134591773,-4,886,2362,30
109134849227,109134849222,-5,297,847,30
109136577233,109136577234,1,2451,2185,30
109136917614,109136917612,-2,1327,1902,30
109138862224,109138862229,5,2616,1217,30
109141183137,109141183137,0,2630,2342,30
109142644343,109142644337,-6,1065,3168,30
109154074673,109154074669,-4,899,2684,30
109158069886,109158069882,-4,730,2677,30
109161094342,109161094323,-19,1033,346,30
109164373214,109164373208,-6,1648,3488,30
109166885543,109166885541,-2,882,1906,30
109171016458,109171016453,-5,1015,3628,30
109182914246,109182914241,-5,1372,3829,30
109183980746,109183980740,-6,677,2768,30
109184408030,109184408026,-4,1058,2064,30
109184515809,109184515830,21,133,335,30
109189167235,109189167237,2,1508,1423,30
109190534655,109190534649,-6,872,1340,30
109190753070,109190753065,-5,2038,5341,30
109194412456,109194412451,-5,1326,2894,30
109195693214,109195693209,-5,1255,3293,30
109198901803,109198901798,-5,1186,2970,30
109199663399,109199663396,-3,1364,2412,30
109203517068,109203517066,-2,1443,1827,30
109205552718,109205552714,-4,1132,2995,30
109207959081,109207959076,-5,1079,2530,30
109211407473,109211407465,-8,973,4673,30
109216769345,109216769341,-4,1136,2371,30
109221923022,109221923007,-15,1067,2507,30
109223140615,109223140611,-4,1013,3647,30
109223572250,109223572240,-10,1079,2860,30
109227404553,109227404549,-4,1517,3971,30
109229016854,109229016852,-2,949,2350,30
109231267397,109231267394,-3,1105,3341,30
109233024558,109233024553,-5,1483,3734,30
109233057991,109233057985,-6,1164,2480,30
109236217878,109236217874,-4,1005,3281,30
109238882561,109238882562,1,1578,1527,30
109239982498,109239982497,-1,1699,3079,30
109240832399,109240832393,-6,1323,3720,30
109242636985,109242636978,-7,854,3534,30
109244418482,109244418490,8,7411,1370,30
109246426003,109246425997,-6,1439,3883,30
109247074054,109247074051,-3,853,1395,30
109248115175,109248115171,-4,1149,3458,30
109248983657,109248983651,-6,1017,2500,30
109251696659,109251696654,-5,614,1963,30
109254957018,109254957014,-4,1636,3336,30
109255603298,109255603301,3,1535,1609,30
109255877309,109255877303,-6,1039,2863,30
109263925714,109263925722,8,324,760,30
109264587120,109264587116,-4,1266,3587,30
109265200683,109265200662,-21,155,858,30
109267186206,109267186202,-4,1069,2045,30
109271413806,109271413802,-4,1219,3011,30
109271823028,109271823028,0,180,894,30
109273380893,109273380886,-7,735,2991,30
109275506113,109275506109,-4,1040,2302,30
109277778827,109277778821,-6,997,3765,30
109282956869,109282956864,-5,963,2692,30
109285647251,109285647249,-2,1286,2792,30
109286158808,109286158810,2,61,565,30
109289118196,109289118192,-4,898,2710,30
109289610216,109289610239,23,377,1160,30
109289804138,109289804135,-3,1203,2427,30
109290916194,109290916199,5,4811,2094,30
109296250684,109296250682,-2,1093,2876,30
109298647212,109298647206,-6,1035,2486,30
109299417822,109299417818,-4,1061,2606,30
109304152869,109304152865,-4,965,2264,30
109308732583,109308732581,-2,815,1789,30
109313664258,109313664263,5,1379,669,30
109320010898,109320010894,-4,1211,3195,30
109322490773,109322490781,8,9417,33103,30
109323532500,109323532496,-4,1031,3684,30
109335705529,109335705530,1,1344,652,30
109342477026,109342477022,-4,582,2199,30
109344251201,109344251198,-3,994,2605,30
109352040713,109352040706,-7,732,1309,30
109354789211,109354789215,4,4167,2897,30
109358509102,109358509098,-4,640,2831,30
109364253514,109364253510,-4,920,2224,30
109364615553,109364615539,-14,882,2285,30
109370760822,109370760818,-4,832,1968,30
109371408145,109371408146,1,2479,3743,30
109374707118,109374707124,6,14150,21867,30
109376293805,109376293799,-6,1577,6078,30
109381485595,109381485590,-5,925,2222,30
109382346160,109382346140,-20,143,748,30
109384783629,109384783626,-3,1459,2656,30
109389183308,109389183306,-2,752,1135,30
109390659955,109390659950,-5,1185,3262,30
109392172151,109392172147,-4,496,1456,30
109393678817,109393678811,-6,1220,3481,30
109396069576,109396069571,-5,751,3413,30
109398421410,109398421407,-3,1184,2078,30
109400199165,109400199159,-6,927,3058,30
109405324725,109405324718,-7,926,2653,30
109408673175,109408673172,-3,878,3004,30
109412903244,109412903240,-4,773,3113,30
109413088694,109413088700,6,1798,787,30
109413717627,109413717623,-4,1386,3227,30
109418583855,109418583850,-5,724,2784,30
109423970397,109423970391,-6,670,3071,30
109426685270,109426685266,-4,1213,3174,30
109427572715,109427572735,20,535,2017,30
109434843887,109434843883,-4,1041,3243,30
109436656345,109436656341,-4,1244,3035,30
109443979922,109443979918,-4,1241,3234,30
109445796502,109445796498,-4,796,2983,30
109446541096,109446541110,14,81,712,30
109447330853,109447330855,2,1377,1243,30
109449707781,109449707786,5,3358,1732,30
109456550871,109456550866,-5,1135,3957,30
109456650874,109456650891,17,1212,3165,30
109457698933,109457698930,-3,1995,3337,30
109458497288,109458497281,-7,1183,1736,30
109461404491,109461404484,-7,1385,4129,30
109461467834,109461467830,-4,887,3549,30
109462628593,109462628587,-6,1033,2336,30
109462654441,109462654421,-20,277,1013,30
109467129174,109467129171,-3,874,2153,30
109467353880,109467353877,-3,939,3112,30
109467677329,109467677350,21,208,2078,30
109471193183,109471193176,-7,947,1758,30
109473574895,109473574890,-5,1494,4458,30
109484953283,109484953278,-5,1091,4240,30
109487778314,109487778310,-4,735,2818,30
109491396299,109491396294,-5,1147,3123,30
109493205152,109493205146,-6,983,1783,30
109493232930,109493232922,-8,933,2993,30
109493519370,109493519360,-10,1081,4049,30
109494611725,109494611727,2,16944,12284,30
109495729635,109495729631,-4,1250,2104,30
109496656046,109496656043,-3,835,2625,30
109502878413,109502878409,-4,1404,3228,30
109516773306,109516773299,-7,814,2900,30
109517705731,109517705727,-4,307,982,30
109519217689,109519217684,-5,1210,2963,30
109521327379,109521327374,-5,1317,3519,30
109521973206,109521973204,-2,1264,2483,30
109524094787,109524094782,-5,957,3225,30
109530992066,109530992061,-5,1110,3290,30
109531391740,109531391757,17,844,2458,30
109531600460,109531600471,11,622,2255,30
109532617161,109532617155,-6,463,1020,30
109534614354,109534614347,-7,811,3587,30
109538080585,109538080579,-6,953,4076,30
109539121732,109539121745,13,262,628,30
109543723206,109543723204,-2,974,1617,30
109544150305,109544150300,-5,997,2853,30
109547166018,109547166015,-3,694,1519,30
109551450099,109551450094,-5,1241,3376,30
109551990163,109551990161,-2,1042,1852,30
109554686155,109554686149,-6,1053,3214,30
109556695421,109556695417,-4,880,2429,30
109557174194,109557174210,16,566,2322,30
109562863593,109562863587,-6,916,1770,30
109571949862,109571949859,-3,1108,3125,30
109572717892,109572717892,0,1738,1841,30
109576367717,109576367713,-4,1052,1701,30
109576675809,109576675812,3,1904,2344,30
109579003959,109579003952,-7,1225,4659,30
109582586809,109582586807,-2,1179,3863,30
109584538559,109584538554,-5,906,1358,30
109587357088,109587357074,-14,64,797,30
109591778323,109591778316,-7,923,2498,30
109591975282,109591975278,-4,912,3005,30
109597964926,109597964925,-1,1200,2755,30
109599553242,109599553247,5,2469,1657,30
109605310287,109605310285,-2,970,3538,30
109607670623,109607670627,4,3932,3369,30
109608977526,109608977523,-3,947,2494,30
109609199267,109609199262,-5,1459,3050,30
109611842961,109611842966,5,2682,1722,30
109615047059,109615047057,-2,1440,2277,30
109617392999,109617392995,-4,678,2253,30
109621561642,109621561637,-5,1057,3076,30
109621794274,109621794293,19,183,881,30
109624484184,109624484178,-6,1043,2850,30
109625355776,109625355772,-4,1448,3341,30
109626674612,109626674631,19,144,576,30
109629997529,109629997523,-6,1642,3308,30
109630832862,109630832857,-5,996,2204,30
109631627869,109631627866,-3,998,2556,30
109632253297,109632253291,-6,830,2412,30
109632716820,109632716816,-4,1290,3194,30
109637199975,109637199972,-3,799,3179,30
109637383977,109637383998,21,1631,2370,30
109640759733,109640759729,-4,851,2715,30
109642220962,109642220955,-7,415,1300,30
109653392389,109653392386,-3,1185,2563,30
109653456494,109653456489,-5,1422,2988,30
109654141055,109654141053,-2,1129,2780,30
109655961057,109655961053,-4,1003,3119,30
109656486518,109656486513,-5,818,3450,30
109659703344,109659703341,-3,1148,1499,30
109666344107,109666344105,-2,1043,1380,30
109669495686,109669495683,-3,1066,2208,30
109670080833,109670080826,-7,994,3039,30
109671881131,109671881126,-5,1406,3755,30
109683748925,109683748921,-4,1458,3622,30
109686134050,109686134046,-4,1102,2426,30
109690415283,109690415278,-5,985,2406,30
109690765753,109690765741,-12,900,2620,30
109694646826,109694646812,-14,4187,15924,30
109706876538,109706876534,-4,957,2330,30
109707069543,109707069538,-5,1047,2407,30
109709676809,109709676805,-4,1240,2258,30
109716711505,109716711488,-17,1198,2732,30
109717728130,109717728126,-4,1101,3072,30
109717858572,109717858588,16,81,1479,30
109721423512,109721423518,6,8609,1914,30
109723117425,109723117419,-6,1316,3484,30
109724461790,109724461810,20,586,1852,30
109731280772,109731280770,-2,1105,2958,30
109733597747,109733597743,-4,749,3548,30
109734210027,109734210024,-3,852,2405,30
109734352295,109734352292,-3,1077,2771,30
109735691962,109735691957,-5,920,2517,30
109735825474,109735825476,2,379,1140,30
109741237281,109741237276,-5,1020,3111,30
109742993882,109742993881,-1,1699,2300,30
109743215559,109743215555,-4,1125,2693,30
109745898279,109745898273,-6,1092,2471,30
109764248681,109764248677,-4,1013,2862,30
109770613792,109770613787,-5,963,3416,30
109771136579,109771136575,-4,1149,3303,30
109772583476,109772583472,-4,927,2061,30
109775394899,109775394896,-3,1206,3078,30
109777419006,109777419001,-5,1120,3760,30
109781277168,109781277162,-6,496,1980,30
109781411318,109781411314,-4,1272,2767,30
109787832765,109787832760,-5,832,2982,30
109790703742,109790703747,5,1670,918,30
109796358394,109796358390,-4,62,818,30
109797639130,109797639127,-3,580,2822,30
109798163183,109798163186,3,2760,1455,30
109800736472,109800736467,-5,1282,3359,30
109802755331,109802755328,-3,3258,7819,30
109807341666,109807341660,-6,820,2037,30
109812216290,109812216291,1,957,1465,30
109812411486,109812411482,-4,1497,3222,30
109812769027,109812769022,-5,1164,2148,30
109815783550,109815783547,-3,751,3219,30
109816425188,109816425204,16,690,1696,30
109818987658,109818987654,-4,1002,2803,30
109822221111,109822221108,-3,997,2226,30
109826336407,109826336402,-5,1131,2588,30
109829390266,109829390270,4,1489,1521,30
109830947546,109830947541,-5,922,4460,30
109831384468,109831384485,17,478,1703,30
109832226957,109832226950,-7,1204,3242,30
109838761214,109838761212,-2,1300,3231,30
109845007506,109845007504,-2,1301,2933,30
109846089906,109846089905,-1,979,1369,30
109858695115,109858695113,-2,943,3619,30
109859497001,109859496997,-4,1179,2884,30
109865070941,109865070937,-4,1030,2651,30
109867845221,109867845214,-7,812,2969,30
109868463818,109868463833,15,164,643,30
109869808818,109869808813,-5,1099,4653,30
109871584235,109871584230,-5,945,2601,30
109874353853,109874353850,-3,1155,2419,30
109876542242,109876542242,0,276,1209,30
109879423026,109879423022,-4,1430,3473,30
109884803672,109884803690,18,14898,29919,30
109889090622,109889090617,-5,821,2100,30
109892913990,109892913985,-5,1060,1448,30
109893917743,109893917740,-3,377,1866,30
109895755517,109895755514,-3,880,2530,30
109895938983,109895938978,-5,896,3021,30
109899794122,109899794118,-4,931,2431,30
109901190263,109901190258,-5,978,3491,30
109901760593,109901760589,-4,831,2025,30
109906387751,109906387746,-5,528,2560,30
109909093609,109909093606,-3,1157,2135,30
109917120618,109917120615,-3,1356,3310,30
109917637919,109917637914,-5,1143,4618,30
109917910470,109917910471,1,1354,1473,30
109919909325,109919909321,-4,981,2053,30
109923367388,109923367395,7,205,1399,30
109924684593,109924684592,-1,1121,1847,30
109926758939,109926758937,-2,1038,2833,30
109926922374,109926922373,-1,832,1046,30
109927900717,109927900712,-5,1493,2521,30
109929049310,109929049307,-3,785,3094,30
109931483594,109931483590,-4,1097,2800,30
109935563561,109935563557,-4,821,3111,30
109937329648,109937329669,21,975,2887,30
109937769563,109937769543,-20,1065,1754,30
109938891785,109938891779,-6,906,2450,30
109939401138,109939401133,-5,1235,4053,30
109939599884,109939599898,14,42,672,30
109950289222,109950289217,-5,915,2273,30
109958240463,109958240462,-1,810,1678,30
109959599570,109959599565,-5,896,3751,30
109961155905,109961155907,2,1755,1752,30
109963559765,109963559762,-3,1125,3311,30
109968178596,109968178598,2,1455,1392,30
109973178716,109973178713,-3,976,2781,30
109978611982,109978611976,-6,569,2469,30
109979503302,109979503300,-2,1082,2848,30
109980529130,109980529125,-5,1009,3058,30
109981331543,109981331547,4,2534,1944,30
109985646177,109985646172,-5,966,2648,30
109985933288,109985933305,17,709,2066,30
109988178855,109988178853,-2,1161,1984,30
109988981100,109988981114,14,557,2183,30
109990066090,109990066086,-4,791,2395,30
109997180462,109997180459,-3,960,2171,30
109998615758,109998615757,-1,1162,1674,30
110001107885,110001107881,-4,1089,2871,30
110002724202,110002724209,7,2767,1380,30
110003855880,110003855876,-4,1109,2503,30
110010906302,110010906297,-5,839,2343,30
110013115866,110013115862,-4,875,2178,30
110015842273,110015842267,-6,1497,4514,30
110017812602,110017812619,17,1041,2963,30
110018891686,110018891681,-5,935,3490,30
110021587573,110021587572,-1,1669,3157,30
110038703746,110038703741,-5,1154,2968,30
110040220442,110040220443,1,1651,1455,30
110047088534,110047088531,-3,871,2808,30
110048644521,110048644542,21,505,2152,30
110062422949,110062422945,-4,618,2813,30
110062504058,110062504053,-5,956,2541,30
110064955330,110064955326,-4,1391,3792,30
110066206741,110066206737,-4,992,2209,30
110076368882,110076368879,-3,852,1574,30
110077450723,110077450719,-4,1107,3549,30
110085924467,110085924462,-5,1213,2373,30
110086185311,110086185307,-4,1120,2613,30
110087618923,110087618918,-5,1468,4252,30
110088995210,110088995211,1,2107,1597,30
110093111146,110093111146,0,1320,2283,30
110099242971,110099242966,-5,2081,7268,30
110100234588,110100234583,-5,953,2494,30
110102604956,110102604954,-2,1124,2624,30
110103338706,110103338711,5,1830,1359,30
110108669742,110108669738,-4,720,1958,30
110114389008,110114389008,0,2077,2280,30
110114668672,110114668670,-2,1391,2605,30
110116996787,110116996783,-4,945,3531,30
110118080063,110118080061,-2,1625,2412,30
110118679843,110118679833,-10,1271,3414,30
110120066104,110120066101,-3,711,1820,30
110121352047,110121352042,-5,1218,3250,30
110122335691,110122335685,-6,1419,2605,30
110123520347,110123520324,-23,1068,1237,30
110124189909,110124189906,-3,1020,3066,30
110128126172,110128126169,-3,1196,2410,30
110128434450,110128434435,-15,151,1233,30
110128626235,110128626232,-3,1039,2754,30
110132416092,110132416090,-2,767,2148,30
110145480967,110145480962,-5,791,2526,30
110145865471,110145865465,-6,1133,3169,30
110146258608,110146258616,8,228,1256,30
110163632119,110163632113,-6,1050,2608,30
110170229385,110170229381,-4,1585,3446,30
110172329962,110172329958,-4,1071,2184,30
110172446459,110172446454,-5,876,3374,30
110175396623,110175396618,-5,1300,3136,30
110179618484,110179618479,-5,1246,3359,30
110183728869,110183728866,-3,1112,4007,30
110186421051,110186421046,-5,1023,2571,30
110187705083,110187705086,3,3074,1662,30
110188092718,110188092714,-4,1669,4231,30
110188210299,110188210294,-5,934,2380,30
110190751835,110190751831,-4,702,1776,30
110190857772,110190857789,17,123,956,30
110191762246,110191762243,-3,833,2660,30
110196069436,110196069432,-4,1613,3639,30
110203546937,110203546933,-4,1014,2647,30
110204569186,110204569183,-3,1055,3143,30
110208006162,110208006157,-5,1046,2326,30
110210178887,110210178884,-3,968,2617,30
110210546809,110210546806,-3,1064,2721,30
110211459061,110211459053,-8,872,4425,30
110212559573,110212559569,-4,1089,3147,30
110212672827,110212672806,-21,1118,3079,30
110213432273,110213432269,-4,1207,2285,30
110215191926,110215191923,-3,1345,3410,30
110217905210,110217905205,-5,909,2601,30
110221357393,110221357399,6,4033,2093,30
110223698942,110223698939,-3,1203,2358,30
110225968678,110225968669,-9,1052,1792,30
110228019739,110228019735,-4,1058,3090,30
110229098611,110229098629,18,432,1122,30
110230307199,110230307195,-4,1084,2447,30
110232665762,110232665761,-1,850,1751,30
110238678110,110238678105,-5,819,1759,30
110239276606,110239276603,-3,1447,3706,30
110242464250,110242464244,-6,1284,3960,30
110244118897,110244118893,-4,650,3574,30
110245512363,110245512357,-6,845,3341,30
110247687038,110247687033,-5,1350,3464,30
110248967233,110248967239,6,1919,683,30
110251759302,110251759307,5,2531,1934,30
110252218968,110252218974,6,4799,1457,30
110256632823,110256632818,-5,1152,2315,30
110259787182,110259787177,-5,1154,3186,30
110262462027,110262462023,-4,1023,1994,30
110263439938,110263439935,-3,1656,4082,30
110271844750,110271844746,-4,847,3075,30
110275922815,110275922810,-5,1126,1810,30
110284413440,110284413434,-6,870,2588,30
110287446371,110287446369,-2,1093,2502,30
110297997579,110297997577,-2,896,3577,30
110299807285,110299807280,-5,1003,2612,30
110301316261,110301316258,-3,1002,2169,30
110301699324,110301699300,-24,871,2231,30
110302769437,110302769449,12,14486,7266,30
110306832861,110306832858,-3,20729,13866,30
110311498978,110311498970,-8,1102,3189,30
110312971210,110312971209,-1,1044,2848,30
110315573558,110315573552,-6,816,2533,30
110316237955,110316237951,-4,1434,3767,30
110317333783,110317333778,-5,1189,3865,30
110317496341,110317496338,-3,924,2286,30
110317923491,110317923493,2,889,1408,30
110322373650,110322373645,-5,1235,3345,30
110323191786,110323191780,-6,277,896,30
110325481058,110325481054,-4,1138,2978,30
110333910251,110333910247,-4,1101,3050,30
110334225562,110334225556,-6,1311,4044,30
110337486354,110337486350,-4,1281,2419,30
110338224802,110338224797,-5,949,1708,30
110338619924,110338619943,19,594,2498,30
110342962358,110342962355,-3,1226,3554,30
110345942770,110345942765,-5,765,2839,30
110347700383,110347700382,-1,778,1223,30
110350628913,110350628910,-3,1084,2425,30
110355248862,110355248845,-17,1282,2120,30
110359666841,110359666838,-3,869,1618,30
110359877522,110359877521,-1,4092,9462,30
110365762640,110365762635,-5,420,2767,30
110366135148,110366135161,13,790,2589,30
110369745938,110369745933,-5,867,2008,30
110371044676,110371044672,-4,536,1802,30
110372195127,110372195122,-5,531,1197,30
110375826758,110375826755,-3,1505,2541,30
110376466786,110376466781,-5,1041,2552,30
110378297598,110378297593,-5,975,2478,30
110382469971,110382469967,-4,686,1809,30
110386407331,110386407326,-5,1125,1818,30
110386443643,110386443649,6,34,2320,30
110391233658,110391233664,6,1515,968,30
110393246942,110393246939,-3,1202,2765,30
110393286397,110393286393,-4,752,2483,30
110396204435,110396204413,-22,1379,4263,30
110396390567,110396390562,-5,1023,2677,30
110397650628,110397650626,-2,1337,2061,30
110401385034,110401385028,-6,834,2473,30
110401910778,110401910774,-4,1095,3220,30
110402525200,110402525215,15,332,1935,30
110408984538,110408984534,-4,1444,3199,30
110419044591,110419044586,-5,1248,3999,30
110423529174,110423529179,5,3560,1787,30
110424883341,110424883335,-6,1278,3210,30
110426403196,110426403190,-6,935,3899,30
110426839826,110426839810,-16,129,973,30
110428833071,110428833066,-5,833,1888,30
110433176768,110433176764,-4,1128,2363,30
110436728482,110436728475,-7,973,3044,30
110445960605,110445960602,-3,1769,5275,30
110447159177,110447159179,2,2668,1128,30
110448184306,110448184301,-5,679,1849,30
110448554422,110448554419,-3,1094,3669,30
110450949982,110450949976,-6,952,2962,30
110452854598,110452854600,2,2010,1508,30
110459495779,110459495777,-2,1083,4008,30
110467655202,110467655198,-4,537,1116,30
110470751830,110470751826,-4,962,3014,30
110471866443,110471866439,-4,721,1707,30
110477934320,110477934321,1,2497,3521,30
110483413051,110483413046,-5,895,2470,30
110487839950,110487839945,-5,1300,3562,30
110496431567,110496431569,2,2418,2697,30
110497040986,110497040979,-7,1023,2906,30
110504155331,110504155323,-8,789,3103,30
110507424667,110507424663,-4,1008,3976,30
110510448733,110510448730,-3,855,2283,30
110514681957,110514681946,-11,1556,3498,30
110516648008,110516648004,-4,717,2748,30
110517562096,110517562080,-16,985,2300,30
110527110402,110527110398,-4,836,3195,30
110527641121,110527641118,-3,915,2872,30
110528865703,110528865698,-5,874,2637,30
110532580063,110532580059,-4,942,2151,30
110550514287,110550514291,4,2842,1984,30
110551770088,110551770083,-5,1228,3645,30
110557631309,110557631302,-7,1490,6213,30
110560022323,110560022329,6,3518,1758,30
110560961983,110560961977,-6,996,2395,30
110562300208,110562300219,11,353,1132,30
110563323293,110563323289,-4,817,2449,30
110565763892,110565763888,-4,620,2616,30
110567062993,110567062986,-7,990,2190,30
110567828984,110567828982,-2,2047,3469,30
110568132642,110568132638,-4,1087,2311,30
110571363163,110571363158,-5,751,2701,30
110573458952,110573458946,-6,1262,3455,30
110578992365,110578992362,-3,1416,2131,30
110584383725,110584383722,-3,1375,2570,30
110584779282,110584779283,1,1341,952,30
110595021962,110595021957,-5,1051,2728,30
110601427195,110601427193,-2,805,1572,30
110601602082,110601602069,-13,1081,2585,30
110605937954,110605937962,8,3644,1252,30
110609678934,110609678941,7,2614,1420,30
110612549620,110612549616,-4,604,3188,30
110613420727,110613420721,-6,1211,3564,30
110615432377,110615432398,21,939,3023,30
110617305906,110617305902,-4,964,3451,30
110620188239,110620188230,-9,374,1870,30
110621057175,110621057172,-3,1240,3227,30
110621230865,110621230860,-5,868,3036,30
110640117236,110640117234,-2,1803,3427,30
110641215642,110641215639,-3,783,2227,30
110641469681,110641469703,22,178,897,30
110644277854,110644277850,-4,1036,2741,30
110644728800,110644728797,-3,1471,2256,30
110649419999,110649419996,-3,1348,3011,30
110657612506,110657612510,4,2416,1355,30
110661376890,110661376890,0,914,1388,30
110664113059,110664113054,-5,1354,3581,30
110667486987,110667486983,-4,874,2944,30
110673348349,110673348370,21,684,1365,30
110676477650,110676477646,-4,664,2293,30
110676824478,110676824474,-4,1184,2163,30
110677368633,110677368627,-6,1020,3435,30
110681253720,110681253716,-4,1275,2831,30
110685821507,110685821505,-2,1104,2652,30
110688377718,110688377717,-1,993,1861,30
110688722474,110688722462,-12,251,1265,30
110689426046,110689426051,5,1820,1336,30
110692676103,110692676099,-4,1035,2521,30
110698334382,110698334375,-7,1371,4689,30
110699920830,110699920826,-4,827,3856,30
110700904164,110700904159,-5,1213,3535,30
110705232371,110705232367,-4,1260,3222,30
110706671002,110706671003,1,1304,2011,30
110708818344,110708818339,-5,1498,3459,30
110715722310,110715722292,-18,442,260,30
110719886832,110719886847,15,189,877,30
110723718658,110723718665,7,3807,1423,30
110724405370,110724405363,-7,652,3707,30
110725663627,110725663624,-3,487,3222,30
110726128913,110726128908,-5,123,901,30
110727317126,110727317122,-4,1456,2812,30
110728571715,110728571709,-6,822,1615,30
110733467213,110733467206,-7,1169,2475,30
110734870079,110734870073,-6,933,2501,30
110738021882,110738021878,-4,1147,2924,30
110741952087,110741952082,-5,1061,3050,30
110743291089,110743291096,7,9590,4498,30
110743329665,110743329681,16,829,3012,30
110746123236,110746123240,4,2094,1298,30
110747470351,110747470346,-5,1096,2670,30
110748874128,110748874147,19,621,2680,30
110757996825,110757996821,-4,900,2596,30
110758553806,110758553802,-4,915,3152,30
110759271567,110759271570,3,2038,1196,30
110763761205,110763761203,-2,542,1244,30
110773899634,110773899630,-4,1013,2688,30
110777861895,110777861891,-4,930,2566,30
110779899327,110779899324,-3,1119,2477,30
110781608482,110781608493,11,256,1177,30
110786993333,110786993338,5,3905,1376,30
110793587057,110793587058,1,2035,1675,30
110803097329,110803097330,1,3952,3149,30
110804570153,110804570150,-3,1257,3277,30
110807837086,110807837081,-5,1285,3446,30
110808207569,110808207583,14,552,1988,30
110809949802,110809949797,-5,864,3020,30
110810132438,110810132431,-7,957,4850,30
110810183962,110810183957,-5,221,1159,30
110812220027,110812220021,-6,1130,3055,30
110815482859,110815482854,-5,841,2626,30
110816324718,110816324713,-5,771,1949,30
110816938638,110816938634,-4,1163,2540,30
110828995882,110828995878,-4,737,2572,30
110831703262,110831703262,0,1026,2014,30
110835390866,110835390862,-4,1287,3711,30
110843075482,110843075478,-4,1289,3444,30
110843197533,110843197536,3,2874,2227,30
110843488562,110843488558,-4,1070,2975,30
110843979207,110843979202,-5,1163,3623,30
110845367035,110845367031,-4,1382,2905,30
110847039769,110847039769,0,2837,3295,30
110854061478,110854061474,-4,758,3139,30
110863023789,110863023784,-5,1010,3582,30
110868468898,110868468894,-4,918,3974,30
110870333271,110870333265,-6,1005,2429,30
110873817084,110873817085,1,1507,1246,30
110879216818,110879216814,-4,1095,2233,30
110881250697,110881250693,-4,1277,2716,30
110883570451,110883570454,3,2237,2131,30
110891989975,110891989968,-7,934,3878,30
110894423970,110894423964,-6,1639,5352,30
110895603509,110895603489,-20,164,801,30
110900075494,110900075492,-2,908,1717,30
110903410699,110903410695,-4,1136,3890,30
110903693168,110903693162,-6,1423,2730,30
110904457543,110904457540,-3,628,1657,30
110908049817,110908049812,-5,1559,4020,30
110915780936,110915780934,-2,1023,2059,30
110917101780,110917101798,18,302,1002,30
110920224190,110920224185,-5,1453,6580,30
110921807718,110921807717,-1,1492,1971,30
110923732199,110923732194,-5,697,2183,30
110930520403,110930520399,-4,950,2231,30
110938717987,110938717983,-4,727,1531,30
110938884713,110938884733,20,487,1326,30
110944354461,110944354453,-8,3964,12564,30
110949802306,110949802313,7,3969,1502,30
110952146623,110952146622,-1,150,1399,30
110953152986,110953152982,-4,1601,2584,30
110961102659,110961102654,-5,1166,2293,30
110967967719,110967967714,-5,731,2795,30
110969023094,110969023089,-5,1476,2309,30
110970542031,110970542025,-6,809,2529,30
110980924923,110980924921,-2,969,2652,30
110981903253,110981903249,-4,1229,2469,30
110987554918,110987554914,-4,883,2767,30
110990260330,110990260323,-7,1005,2622,30
110990437747,110990437742,-5,659,2826,30
110993221890,110993221888,-2,1442,3469,30
110993878037,110993878033,-4,887,2640,30
110993944395,110993944386,-9,125,3384,30
110994226416,110994226439,23,400,824,30
110994422338,110994422333,-5,1439,2715,30
110999508650,110999508646,-4,1086,1972,30
111002041995,111002041991,-4,979,2713,30
111003329677,111003329674,-3,1162,2944,30
111004059778,111004059783,5,1881,1050,30
111005516158,111005516160,2,1560,1361,30
111006219464,111006219462,-2,1417,1746,30
111008487811,111008487807,-4,829,3179,30
111008611549,111008611545,-4,1434,3324,30
111011769982,111011769978,-4,1566,3332,30
111019771421,111019771419,-2,1476,1898,30
111020889611,111020889618,7,3224,1505,30
111020995770,111020995766,-4,595,1884,30
111022555711,111022555716,5,2960,1915,30
111023995338,111023995334,-4,1163,3026,30
111024612010,111024612005,-5,815,2621,30
111031336642,111031336638,-4,1126,2288,30
111034215689,111034215686,-3,1123,1751,30
111035559645,111035559651,6,7059,1021,30
111037525280,111037525276,-4,1012,2905,30
111040765989,111040765986,-3,1718,3311,30
111049986220,111049986215,-5,1091,2899,30
111051375166,111051375161,-5,1481,2943,30
111051463508,111051463526,18,959,2925,30
111057046522,111057046519,-3,1204,2489,30
111066864291,111066864306,15,791,1524,30
111068338377,111068338373,-4,1193,3260,30
111068985362,111068985367,5,1520,1367,30
111076897693,111076897689,-4,608,2801,30
111079972358,111079972353,-5,921,2168,30
111080029980,111080029999,19,1074,2132,30
111081837861,111081837857,-4,1485,3436,30
111084797669,111084797665,-4,1307,2816,30
111091410569,111091410562,-7,828,2235,30
111091969142,111091969137,-5,1243,4542,30
111093233354,111093233351,-3,1194,2307,30
111093280515,111093280533,18,850,1630,30
111094561708,111094561704,-4,1219,2196,30
111096258761,111096258756,-5,1002,2563,30
111098753203,111098753197,-6,473,2518,30
111100540867,111100540861,-6,1450,6353,30
111103735315,111103735319,4,1287,1073,30
111104992831,111104992826,-5,1332,3560,30
111105224395,111105224390,-5,1502,3425,30
111106502547,111106502543,-4,1070,2343,30
111107584267,111107584262,-5,559,1470,30
111111570250,111111570246,-4,917,4247,30
111114185254,111114185250,-4,1199,3352,30
111116665869,111116665864,-5,1391,1923,30
111116705448,111116705442,-6,934,4203,30
111116797638,111116797634,-4,981,2177,30
111119203656,111119203653,-3,924,2157,30
111124197839,111124197835,-4,1428,3280,30
111131005463,111131005458,-5,1145,2952,30
111134405694,111134405689,-5,1562,3378,30
111139465815,111139465809,-6,1022,2956,30
111141317226,111141317221,-5,1077,2991,30
111141408691,111141408707,16,981,2501,30
111143784028,111143784023,-5,1336,2580,30
111147579404,111147579406,2,2255,2368,30
111147990407,111147990402,-5,1126,2953,30
111148805561,111148805554,-7,149,938,30
111149110337,111149110328,-9,264,1004,30
111151020497,111151020498,1,1230,1542,30
111153588041,111153588033,-8,1073,5196,30
111162460859,111162460853,-6,907,2751,30
111165794395,111165794388,-7,1305,3645,30
111168261990,111168261986,-4,997,3509,30
111168824134,111168824128,-6,1272,3550,30
111171836967,111171836963,-4,1465,4470,30
111172848950,111172848946,-4,933,3687,30
111173218739,111173218734,-5,1277,2743,30
111174696682,111174696678,-4,1612,2541,30
111175875429,111175875425,-4,855,2960,30
111179817831,111179817826,-5,1023,3131,30
111185251173,111185251169,-4,1019,4006,30
111185297705,111185297722,17,236,1038,30
111187399431,111187399426,-5,1158,3556,30
111188388038,111188388034,-4,1417,4136,30
111189945671,111189945667,-4,1343,3093,30
111209314843,111209314839,-4,1013,2419,30
111212682751,111212682743,-8,994,3312,30
111222898886,111222898894,8,3794,1411,30
111226792609,111226792607,-2,1425,2460,30
111229985730,111229985725,-5,1135,2869,30
111230449147,111230449126,-21,841,3233,30
111241935833,111241935829,-4,1018,2685,30
111245781913,111245781910,-3,1027,2892,30
111245956033,111245956018,-15,226,1353,30
111247393971,111247393966,-5,1422,2935,30
111254778910,111254778906,-4,1093,2538,30
111266525166,111266525173,7,2269,976,30
111269671373,111269671377,4,2168,1189,30
111270193880,111270193878,-2,872,1231,30
111272881080,111272881077,-3,1354,1760,30
111275128394,111275128404,10,12491,41649,30
111276404184,111276404202,18,1077,2611,30
111280894182,111280894181,-1,1411,2013,30
111283604199,111283604198,-1,654,1726,30
111288021089,111288021084,-5,728,2890,30
111294928711,111294928705,-6,988,4302,30
111295413754,111295413754,0,1313,2235,30
111305666154,111305666151,-3,1039,2313,30
111308866653,111308866646,-7,947,1780,30
111309003426,111309003414,-12,188,973,30
111314226612,111314226609,-3,889,2240,30
111316899807,111316899801,-6,1349,3477,30
111317129126,111317129123,-3,1046,2392,30
111320362115,111320362109,-6,1008,3889,30
111322671535,111322671531,-4,1179,3199,30
111328339898,111328339894,-4,1899,4786,30
111333453774,111333453770,-4,990,2940,30
111335222968,111335222963,-5,1271,2049,30
111340289938,111340289934,-4,1183,2568,30
111343971827,111343971822,-5,676,3825,30
111344447662,111344447658,-4,1526,2517,30
111349498734,111349498748,14,743,2655,30
111351610092,111351610087,-5,978,2599,30
111351995312,111351995297,-15,260,1107,30
111356996001,111356995997,-4,1227,3532,30
111377228420,111377228417,-3,1134,2043,30
111380929610,111380929609,-1,1552,1867,30
111386597018,111386597025,7,2051,1242,30
111387750769,111387750766,-3,1249,3552,30
111388473570,111388473570,0,4916,6124,30
111389206339,111389206340,1,1392,1667,30
111394827789,111394827785,-4,1040,3994,30
111398733845,111398733841,-4,1501,3449,30
111400542712,111400542706,-6,1172,2520,30
111401199223,111401199219,-4,763,2818,30
111405860227,111405860222,-5,1051,3384,30
111412311725,111412311720,-5,1460,3218,30
111414596258,111414596254,-4,876,3508,30
111425290515,111425290510,-5,828,2180,30
111427450087,111427450081,-6,957,3969,30
111428386414,111428386409,-5,1152,4761,30
111431944087,111431944083,-4,2260,5276,30
111436793306,111436793301,-5,1349,3071,30
111436832594,111436832575,-19,65,1062,30
111438047208,111438047230,22,562,1383,30
111448054061,111448054070,9,12488,40230,30
111448596954,111448596950,-4,568,1318,30
111448808761,111448808762,1,1247,2193,30
111452206446,111452206441,-5,1169,2877,30
111452453956,111452453966,10,18780,49180,30
111456198036,111456198031,-5,1072,3076,30
111458915621,111458915622,1,1226,1591,30
111460666723,111460666719,-4,1001,2830,30
111460821594,111460821582,-12,92,967,30
111464546369,111464546371,2,3579,3046,30
111471195351,111471195349,-2,1220,2731,30
111471339033,111471339054,21,303,873,30
111483030918,111483030914,-4,1252,3209,30
111483318366,111483318362,-4,1098,2861,30
111484145297,111484145293,-4,849,2429,30
111484623882,111484623903,21,160,1096,30
111487149610,111487149606,-4,1660,4004,30
111491816389,111491816386,-3,1045,3929,30
111494468371,111494468366,-5,1121,3802,30
111495856571,111495856573,2,1410,1353,30
111496565979,111496565973,-6,1249,2544,30
111498642487,111498642483,-4,1125,2581,30
111501237811,111501237805,-6,1702,6370,30
111502187198,111502187194,-4,786,1947,30
111503232191,111503232186,-5,1187,2772,30
111503961599,111503961595,-4,1145,2552,30
111506095590,111506095588,-2,1539,2348,30
111508957499,111508957514,15,1209,3885,30
111518701135,111518701130,-5,888,2706,30
111532097877,111532097872,-5,1032,3504,30
111533547458,111533547454,-4,936,1900,30
111538887453,111538887446,-7,1010,4156,30
111551781922,111551781916,-6,1186,2220,30
111551894261,111551894266,5,2003,1664,30
111554009350,111554009346,-4,1159,4179,30
111554943127,111554943122,-5,1291,3035,30
111555802159,111555802158,-1,1290,1640,30
111556854287,111556854283,-4,974,2018,30
111564210067,111564210064,-3,1014,3623,30
111564355222,111564355218,-4,1563,2293,30
111564440002,111564439999,-3,1056,3012,30
111570786474,111570786470,-4,885,2969,30
111571762410,111571762402,-8,1065,3202,30
111576169199,111576169189,-10,44206,2518,30
111582773761,111582773756,-5,576,2416,30
111588178620,111588178616,-4,1390,3863,30
111594225375,111594225371,-4,899,3368,30
111599519330,111599519332,2,1097,1894,30
111600813270,111600813266,-4,1565,3766,30
111602407615,111602407609,-6,681,2876,30
111602527008,111602527025,17,50,897,30
111604061405,111604061412,7,2743,1786,30
111608341191,111608341188,-3,1119,2680,30
111610788956,111610788950,-6,1065,3135,30
111611526583,111611526578,-5,814,2378,30
111612630514,111612630509,-5,1051,2569,30
111614187256,111614187249,-7,646,2303,30
111616087840,111616087834,-6,1736,3018,30
111621545557,111621545561,4,13768,18684,30
111628043802,111628043795,-7,1139,11950,30
111636936022,111636936022,0,929,1915,30
111643495850,111643495845,-5,1408,4032,30
111644482229,111644482223,-6,1113,3277,30
111652141836,111652141832,-4,1285,2905,30
111656855561,111656855558,-3,867,2986,30
111662771667,111662771663,-4,958,2694,30
111664644037,111664644033,-4,875,2533,30
111667238654,111667238650,-4,828,2165,30
111673306441,111673306438,-3,665,1245,30
111676397171,111676397169,-2,992,1665,30
111676538892,111676538907,15,614,2054,30
111677431382,111677431387,5,2650,1294,30
111682526819,111682526813,-6,916,3255,30
111683205513,111683205509,-4,1127,3379,30
111689790099,111689790098,-1,967,1724,30
111692956522,111692956529,7,2295,898,30
111699722297,111699722299,2,2248,1742,30
111701929875,111701929870,-5,931,3542,30
111710070618,111710070613,-5,965,2297,30
111712138834,111712138830,-4,1317,2435,30
111712529387,111712529382,-5,1254,3145,30
111713744387,111713744403,16,118,955,30
111717923991,111717923998,7,3628,1178,30
111719933166,111719933163,-3,830,2700,30
111720340859,111720340855,-4,900,2876,30
111720445923,111720445922,-1,3566,5984,30
111722743778,111722743773,-5,1265,3789,30
111723490105,111723490109,4,1832,1600,30
111728078260,111728078255,-5,1333,2844,30
111731607378,111731607372,-6,1106,3160,30
111732534919,111732534914,-5,1036,2532,30
111734661659,111734661654,-5,893,2660,30
111734803906,111734803906,0,319,1085,30
111737062742,111737062736,-6,843,2810,30
111737675480,111737675475,-5,237,990,30
111739255022,111739255018,-4,619,1548,30
111741537692,111741537688,-4,1150,2493,30
111742693338,111742693334,-4,975,2180,30
111743223695,111743223691,-4,1084,2432,30
111746553897,111746553905,8,9110,35812,30
111754411119,111754411114,-5,972,3838,30
111759246893,111759246889,-4,1493,4426,30
111760114556,111760114563,7,4015,1613,30
111761195347,111761195342,-5,1034,2664,30
111770139486,111770139479,-7,1126,4111,30
111771168385,111771168378,-7,1213,2581,30
111776659932,111776659940,8,2367,1749,30
111790045868,111790045863,-5,838,2520,30
111791060674,111791060670,-4,1305,2453,30
111792151474,111792151478,4,2673,1420,30
111797616408,111797616402,-6,1319,3271,30
111803862019,111803862013,-6,1241,3360,30
111807938352,111807938347,-5,1142,2725,30
111813467280,111813467294,14,711,1888,30
111818005169,111818005164,-5,1033,2928,30
111818132922,111818132913,-9,978,2812,30
111819988978,111819988975,-3,1325,3444,30
111820304583,111820304579,-4,1155,2459,30
111826647247,111826647251,4,3192,1378,30
111833587838,111833587833,-5,888,3172,30
111833852291,111833852302,11,668,3194,30
111846427603,111846427601,-2,1030,2433,30
111847154089,111847154085,-4,1406,3875,30
111847313479,111847313474,-5,1370,2955,30
111848459419,111848459413,-6,1288,3159,30
111855556662,111855556658,-4,1226,2776,30
111857371177,111857371173,-4,988,2496,30
111858977443,111858977439,-4,951,1433,30
111859467751,111859467747,-4,921,2505,30
111860076632,111860076626,-6,1261,3065,30
111861620544,111861620538,-6,1069,3897,30
111862180593,111862180594,1,972,1207,30
111865889670,111865889674,4,1667,1492,30
111867648703,111867648701,-2,1547,2925,30
111870203523,111870203517,-6,754,3017,30
111872614154,111872614151,-3,1055,3158,30
111874849181,111874849178,-3,1404,2431,30
111875813815,111875813810,-5,949,1978,30
111884692783,111884692778,-5,738,3150,30
111888836928,111888836924,-4,1185,3959,30
111889597990,111889597985,-5,1219,2196,30
111889974090,111889974110,20,1221,3469,30
111893718179,111893718176,-3,1042,3319,30
111900160030,111900160025,-5,1211,2716,30
111921963578,111921963573,-5,1077,2100,30
111927682171,111927682167,-4,409,2166,30
111928300052,111928300051,-1,91,741,30
111932086166,111932086160,-6,976,2658,30
111934804101,111934804097,-4,1798,3078,30
111936331623,111936331620,-3,978,3129,30
111940764218,111940764214,-4,797,2354,30
111943059435,111943059429,-6,1961,5627,30
111943575630,111943575623,-7,763,1957,30
111946757133,111946757135,2,31021,24928,30
111949119898,111949119893,-5,1346,3561,30
111949673019,111949673015,-4,765,1913,30
111950376435,111950376426,-9,1447,2827,30
111965967016,111965967012,-4,1233,3218,30
111970108139,111970108134,-5,919,3355,30
111970262578,111970262591,13,380,831,30
111970854801,111970854798,-3,1388,2227,30
111973784054,111973784050,-4,783,2692,30
111974919299,111974919294,-5,1272,3098,30
111977954250,111977954246,-4,1056,2144,30
111986048262,111986048257,-5,902,2499,30
111986115912,111986115899,-13,37,817,30
111991696985,111991696979,-6,1060,2431,30
111992170950,111992170945,-5,977,3091,30
111992454506,111992454524,18,686,2195,30
111993770942,111993770936,-6,975,3428,30
111995330656,111995330650,-6,1538,3726,30
111997809949,111997809944,-5,888,3020,30
112002753995,112002753990,-5,1019,3825,30
112003833495,112003833490,-5,852,3180,30
112008401697,112008401697,0,2264,2700,30
112012234754,112012234749,-5,893,3350,30
112012298089,112012298105,16,171,1262,30
112013220126,112013220130,4,1323,1367,30
112014639466,112014639464,-2,1224,2479,30
112015767761,112015767755,-6,1064,3406,30
112016816875,112016816869,-6,1015,2910,30
112018017359,112018017354,-5,962,2147,30
112024850115,112024850112,-3,684,2569,30
112027073531,112027073526,-5,1298,3233,30
112030636478,112030636474,-4,609,4708,30
112030989873,112030989874,1,259,862,30
112037084457,112037084451,-6,23806,13938,30
112038137163,112038137160,-3,969,2319,30
112041174553,112041174546,-7,1270,3867,30
112041276627,112041276610,-17,943,3216,30
112044762540,112044762539,-1,1539,1594,30
112053383635,112053383641,6,2677,1271,30
112054573376,112054573373,-3,1004,2658,30
112055019337,112055019333,-4,911,3069,30
112063265483,112063265478,-5,1026,2146,30
112064693642,112064693636,-6,1328,3923,30
112066506470,112066506465,-5,958,2153,30
112068024589,112068024586,-3,1572,3073,30
112071491354,112071491361,7,3537,871,30
112085157626,112085157625,-1,1168,1120,30
112092080511,112092080506,-5,1107,2167,30
112094028495,112094028490,-5,883,3456,30
112095485718,112095485712,-6,2930,9984,30
112096908110,112096908102,-8,2133,7401,30
112098111062,112098111056,-6,786,3115,30
112098158940,112098158951,11,530,1328,30
112101148353,112101148350,-3,1308,2286,30
112104688785,112104688778,-7,1540,5204,30
112108381666,112108381663,-3,1069,1614,30
112118052646,112118052644,-2,964,2518,30
112118724817,112118724811,-6,839,1839,30
112122205492,112122205489,-3,1011,2631,30
112122563307,112122563325,18,415,1141,30
112125423411,112125423406,-5,794,1530,30
112127176176,112127176172,-4,1593,3857,30
112127815694,112127815691,-3,789,2299,30
112131081231,112131081226,-5,1450,4122,30
112131938248,112131938248,0,1386,2043,30
112133088642,112133088660,18,562,1116,30
112139971377,112139971373,-4,1377,2696,30
112140172233,112140172255,22,417,1141,30
112148266479,112148266474,-5,797,1695,30
112148442136,112148442139,3,2175,1915,30
112169844514,112169844509,-5,914,2996,30
112175487107,112175487104,-3,771,2193,30
112175594971,112175594966,-5,1002,3058,30
112176029794,112176029792,-2,932,2414,30
112177415111,112177415107,-4,873,2720,30
112177613897,112177613907,10,61,572,30
112177809697,112177809716,19,279,1150,30
112178250880,112178250898,18,807,2677,30
112180883658,112180883653,-5,884,2514,30
112180998884,112180998900,16,1118,3214,30
112183828342,112183828340,-2,1457,2568,30
112189106650,112189106646,-4,778,2150,30
112189496277,112189496269,-8,1257,4290,30
112189912841,112189912857,16,728,3075,30
112193930067,112193930062,-5,1165,2908,30
112194791496,112194791481,-15,986,3900,30
112196450836,112196450849,13,336,1134,30
112202248026,112202248022,-4,1125,2751,30
112204596667,112204596662,-5,1263,2465,30
112204746737,112204746757,20,984,2546,30
112206797301,112206797297,-4,633,2520,30
112208740315,112208740332,17,470,699,30
112210313344,112210313349,5,3307,1701,30
112211206342,112211206344,2,1389,898,30
112215559153,112215559151,-2,1379,1890,30
112216890522,112216890518,-4,1376,2963,30
112221112669,112221112666,-3,858,2700,30
112229194562,112229194566,4,4408,2826,30
112230157791,112230157779,-12,9386,27847,30
112234642027,112234642022,-5,1087,3076,30
112239781859,112239781866,7,3407,1635,30
112241909046,112241909065,19,1110,3079,30
112244428494,112244428490,-4,907,3284,30
112247105535,112247105531,-4,930,2216,30
112247239023,112247239020,-3,25905,21234,30
112250305926,112250305925,-1,809,1447,30
112251216022,112251216018,-4,1078,2494,30
112253375590,112253375585,-5,1104,3543,30
112256992459,112256992464,5,1021,529,30
112259291766,112259291762,-4,877,3231,30
112260194407,112260194402,-5,862,2082,30
112260738454,112260738453,-1,968,2953,30
112262307250,112262307249,-1,710,1613,30
112262952776,112262952776,0,1515,1560,30
112263274786,112263274805,19,307,1258,30
112264020477,112264020471,-6,1247,3524,30
112265069594,112265069590,-4,1251,3757,30
112266993926,112266993922,-4,746,1674,30
112268111482,112268111496,14,114,936,30
112274206011,112274206005,-6,870,2533,30
112275087794,112275087793,-1,284,1665,30
112275398522,112275398535,13,633,2298,30
112275702755,112275702752,-3,1044,3402,30
112277276251,112277276249,-2,736,2117,30
112278390914,112278390910,-4,27990,10410,30
112282231885,112282231881,-4,1236,2625,30
112283888519,112283888518,-1,1028,924,30
112287111783,112287111781,-2,1042,3073,30
112291440769,112291440764,-5,968,2570,30
112291645608,112291645628,20,108,1333,30
112297323781,112297323774,-7,1287,2820,30
112301254490,112301254486,-4,1288,3385,30
112302942593,112302942587,-6,1106,2680,30
112312123061,112312123055,-6,853,1706,30
112315963685,112315963677,-8,730,2550,30
112327802221,112327802214,-7,797,2839,30
112329449866,112329449862,-4,871,2580,30
112329521494,112329521490,-4,915,3479,30
112331275560,112331275557,-3,844,3422,30
112332924401,112332924394,-7,1224,3233,30
112332961242,112332961226,-16,953,2391,30
112334337322,112334337321,-1,918,1362,30
112334502007,112334502002,-5,958,3728,30
112337236150,112337236145,-5,1016,3977,30
112337271834,112337271831,-3,1176,2265,30
112353942631,112353942623,-8,1331,2955,30
112357292483,112357292478,-5,1196,2479,30
112359190026,112359190023,-3,895,2081,30
112363330671,112363330669,-2,1179,1722,30
112366577390,112366577390,0,1784,2020,30
112366883334,112366883330,-4,1255,2810,30
112378118566,112378118562,-4,1139,3192,30
112382358132,112382358126,-6,1053,3339,30
112385988661,112385988658,-3,610,1409,30
112386166916,112386166910,-6,1172,2923,30
112389661122,112389661116,-6,1389,3882,30
112390886205,112390886201,-4,1050,3610,30
112393220303,112393220298,-5,2254,6971,30
112400504611,112400504606,-5,1090,3424,30
112401352289,112401352282,-7,784,3934,30
112404892561,112404892558,-3,785,2095,30
112412909018,112412909014,-4,720,2139,30
112413800965,112413800958,-7,637,1697,30
112419580726,112419580721,-5,619,3168,30
112420480876,112420480871,-5,944,3075,30
112422728938,112422728930,-8,774,2150,30
112430768163,112430768159,-4,1179,2744,30
112431417098,112431417094,-4,1059,3543,30
112432817627,112432817623,-4,1463,3136,30
112440988193,112440988188,-5,913,2086,30
112441436413,112441436412,-1,1806,3461,30
112442387718,112442387714,-4,1121,3783,30
112444717468,112444717482,14,346,564,30
112449229490,112449229485,-5,874,2374,30
112449723289,112449723283,-6,153,1000,30
112450932540,112450932538,-2,24235,9527,30
112451174718,112451174715,-3,952,2263,30
112452762874,112452762869,-5,624,2241,30
112453137586,112453137605,19,469,777,30
112453911641,112453911638,-3,989,2553,30
112456790087,112456790083,-4,1081,3226,30
112459557854,112459557849,-5,850,3416,30
112462271053,112462271048,-5,1147,3903,30
112466526306,112466526300,-6,648,2827,30
112468417311,112468417306,-5,886,2956,30
112471303908,112471303903,-5,1366,2562,30
112471528535,112471528523,-12,25006,15161,30
112476132233,112476132228,-5,792,2173,30
112480315805,112480315801,-4,1209,2661,30
112480379912,112480379905,-7,742,2715,30
112484017503,112484017498,-5,927,2804,30
112490850318,112490850312,-6,669,1731,30
112494785629,112494785622,-7,1330,3118,30
112499986643,112499986641,-2,1122,2869,30
112503184122,112503184117,-5,807,2841,30
112511269139,112511269134,-5,615,1982,30
112515187731,112515187731,0,46240,31559,30
112519668961,112519668957,-4,990,1765,30
112526220429,112526220423,-6,1386,4257,30
112532961486,112532961482,-4,750,2677,30
112537090571,112537090565,-6,992,2552,30
112537778490,112537778486,-4,765,2159,30
112546499358,112546499354,-4,1040,3967,30
112548671052,112548671048,-4,926,3116,30
112554647058,112554647054,-4,873,2995,30
112554680491,112554680494,3,207,1248,30
112558050731,112558050727,-4,971,2919,30
112559105508,112559105503,-5,499,1417,30
112563178018,112563178039,21,225,1095,30
112565052062,112565052058,-4,830,2149,30
112565279294,112565279292,-2,1017,2006,30
112568108264,112568108258,-6,1174,2218,30
112571232563,112571232558,-5,892,3373,30
112575950438,112575950439,1,1672,1794,30
112578986873,112578986869,-4,1289,2367,30
112579916052,112579916046,-6,1016,3569,30
112581694903,112581694899,-4,1219,2879,30
112583820350,112583820346,-4,989,3358,30
112592019137,112592019132,-5,1006,2853,30
112593939087,112593939084,-3,913,2203,30
112604824879,112604824873,-6,1103,6072,30
112605519896,112605519891,-5,1200,3285,30
112606838962,112606838960,-2,1326,1900,30
112608458830,112608458825,-5,836,2385,30
112611239166,112611239164,-2,1245,3275,30
112611569428,112611569446,18,516,3120,30
112613795178,112613795173,-5,1122,2802,30
112614109844,112614109846,2,36622,19011,30
112615649445,112615649439,-6,1021,2212,30
112618464525,112618464521,-4,811,1770,30
112620743576,112620743582,6,2563,876,30
112622760599,112622760593,-6,815,3102,30
112623879307,112623879302,-5,1281,2722,30
112624306530,112624306525,-5,766,2665,30
112628474029,112628474022,-7,829,1920,30
112631078194,112631078193,-1,1073,1703,30
112643811762,112643811758,-4,742,2698,30
112649719061,112649719056,-5,839,2680,30
112663361887,112663361883,-4,1158,3320,30
112667590370,112667590370,0,3028,3969,30
112667974332,112667974337,5,5279,4076,30
112669540507,112669540494,-13,1026,2202,30
112669884402,112669884419,17,204,828,30
112671337775,112671337771,-4,905,2773,30
112673051371,112673051367,-4,1321,3247,30
112681600519,112681600514,-5,853,2457,30
112681909071,112681909067,-4,1167,3212,30
112682745686,112682745681,-5,948,2578,30
112682871994,112682871989,-5,908,2577,30
112683178307,112683178293,-14,143,711,30
112685225419,112685225415,-4,1352,2590,30
112687711366,112687711362,-4,758,2288,30
112688147610,112688147606,-4,1392,4122,30
112691377152,112691377147,-5,17432,43370,30
112691816907,112691816904,-3,939,3381,30
112696337354,112696337350,-4,1080,2885,30
112699142393,112699142408,15,814,3130,30
112708602792,112708602787,-5,908,2753,30
112708704979,112708704975,-4,699,2131,30
112712722946,112712722944,-2,1363,1613,30
112713753119,112713753115,-4,1379,2420,30
112719122249,112719122259,10,14726,33424,30
112720173529,112720173527,-2,1145,2765,30
112722389290,112722389289,-1,1342,1537,30
112724744662,112724744671,9,13753,31093,30
112730880167,112730880162,-5,950,2630,30
112731463291,112731463275,-16,217,486,30
112731714427,112731714442,15,623,2298,30
112732882374,112732882370,-4,861,2864,30
112734004026,112734004029,3,1628,2139,30
112738467195,112738467190,-5,694,2768,30
112739745074,112739745069,-5,1181,3078,30
112742922372,112742922366,-6,969,4289,30
112743020602,112743020609,7,130,835,30
112743608636,112743608655,19,736,2519,30
112745213329,112745213335,6,2934,1349,30
112745829739,112745829737,-2,1248,2687,30
112758057381,112758057378,-3,586,1957,30
112763144494,112763144489,-5,1153,2678,30
112770937756,112770937752,-4,1116,1702,30
112773244986,112773244984,-2,1103,3366,30
112774224954,112774224948,-6,1284,3136,30
112774473811,112774473823,12,94,831,30
112777548483,112777548486,3,2894,2422,30
112781700771,112781700765,-6,1238,4506,30
112785809646,112785809644,-2,958,2662,30
112792388209,112792388204,-5,1520,4091,30
112792464196,112792464191,-5,2343,5302,30
112795257294,112795257296,2,1085,1331,30
112796033336,112796033335,-1,100,854,30
112797330555,112797330550,-5,1353,3462,30
112797594450,112797594446,-4,1406,3496,30
112798972687,112798972681,-6,1174,4012,30
112802804326,112802804320,-6,1354,3163,30
112804086301,112804086298,-3,1185,3742,30
112807232960,112807232955,-5,1176,3278,30
112808186831,112808186827,-4,1226,2953,30
112808939586,112808939583,-3,945,2584,30
112810452403,112810452394,-9,549,2241,30
112813421429,112813421427,-2,2441,4194,30
112814310053,112814310048,-5,1403,3658,30
112815262273,112815262269,-4,1306,2930,30
112816421294,112816421289,-5,1398,3613,30
112817979142,112817979137,-5,987,3213,30
112822895267,112822895266,-1,1239,2166,30
112831024217,112831024212,-5,1365,3022,30
112831287625,112831287620,-5,805,2920,30
112835211346,112835211341,-5,1257,2596,30
112835744250,112835744246,-4,640,2077,30
112836405674,112836405673,-1,810,2049,30
112838120214,112838120210,-4,1116,2416,30
112841929050,112841929047,-3,825,1936,30
112843777190,112843777186,-4,1216,3138,30
112843914998,112843914998,0,2551,2578,30
112846231251,112846231246,-5,817,2592,30
112853869482,112853869477,-5,1192,2931,30
112853927745,112853927741,-4,1026,3398,30
112856589492,112856589487,-5,1765,3371,30
112856784177,112856784174,-3,1091,2252,30
112857057220,112857057214,-6,1201,4162,30
112861645841,112861645840,-1,2867,5063,30
112865552514,112865552505,-9,922,6780,30
112874851681,112874851675,-6,641,2831,30
112875034922,112875034906,-16,385,1184,30
112877655514,112877655509,-5,651,2178,30
112881574107,112881574110,3,2016,1128,30
112883940144,112883940140,-4,1710,3126,30
112884517409,112884517402,-7,1009,4285,30
112890325704,112890325699,-5,1104,2813,30
112892244847,112892244842,-5,1034,3031,30
112895618327,112895618323,-4,844,1476,30
112897629974,112897629969,-5,1210,2435,30
112898784359,112898784353,-6,652,4680,30
112902133066,112902133063,-3,1339,2318,30
112904606942,112904606941,-1,1789,2278,30
112909023973,112909023970,-3,1003,2755,30
112909886361,112909886381,20,400,1907,30
112911659373,112911659370,-3,724,1362,30
112915351047,112915351042,-5,1107,2826,30
112919061886,112919061879,-7,1049,3460,30
112919569251,112919569247,-4,984,2292,30
112927868283,112927868278,-5,1250,3533,30
112931734321,112931734318,-3,704,2477,30
112932106489,112932106469,-20,1139,3219,30
112936544843,112936544837,-6,1036,3784,30
112939664436,112939664432,-4,1101,3184,30
112939808458,112939808473,15,978,2205,30
112942842922,112942842919,-3,658,2506,30
112944793311,112944793306,-5,850,1834,30
112949282515,112949282533,18,992,2643,30
112953556639,112953556634,-5,1202,3498,30
112953973396,112953973406,10,225,2460,30
112965286968,112965286965,-3,927,2252,30
112965949561,112965949564,3,2244,1270,30
112969857759,112969857755,-4,683,1933,30
112969907746,112969907762,16,385,1215,30
112970255198,112970255191,-7,1292,3205,30
112975395950,112975395946,-4,1151,2874,30
112977677263,112977677258,-5,869,2926,30
112978120134,112978120130,-4,745,2273,30
112984173513,112984173511,-2,1206,3338,30
112986502662,112986502656,-6,949,2695,30
112989741161,112989741157,-4,1410,3178,30
112993718095,112993718093,-2,1384,2222,30
113004838938,113004838934,-4,1144,3024,30
113011002292,113011002290,-2,1119,3733,30
113014988523,113014988518,-5,1224,2595,30
113027033154,113027033137,-17,2956,1135,30
113027169537,113027169535,-2,718,1633,30
113033729209,113033729202,-7,888,3181,30
113033765778,113033765776,-2,628,1497,30
113039508431,113039508426,-5,1101,2344,30
113046529595,113046529590,-5,905,3287,30
113048226463,113048226457,-6,1396,3357,30
113051179365,113051179362,-3,1132,2953,30
113051335098,113051335117,19,422,1783,30
113054276575,113054276570,-5,1239,3551,30
113055836425,113055836422,-3,636,1270,30
113056385473,113056385462,-11,238,900,30
113060013327,113060013321,-6,906,3339,30
113063555141,113063555140,-1,639,1777,30
113073575617,113073575619,2,969,1310,30
113074512057,113074512053,-4,1212,2586,30
113080440029,113080440033,4,1594,1828,30
113080471595,113080471593,-2,196,1092,30
113083761718,113083761714,-4,1426,4578,30
113086806223,113086806227,4,9455,24519,30
113088032033,113088032029,-4,559,2230,30
113093188965,113093188970,5,1790,1030,30
113094917976,113094917969,-7,573,3033,30
113096930999,113096930994,-5,1112,3332,30
113099840688,113099840697,9,4298,1056,30
113102315722,113102315718,-4,20329,17456,30
113104688591,113104688587,-4,894,2966,30
113108009354,113108009350,-4,1435,3621,30
113108914880,113108914882,2,1078,1643,30
113110389470,113110389469,-1,1382,2157,30
113111600680,113111600676,-4,940,3175,30
113112527214,113112527213,-1,2558,3535,30
113113873362,113113873358,-4,941,1846,30
113117881205,113117881206,1,1421,1612,30
113123678199,113123678194,-5,1290,3560,30
113124313929,113124313922,-7,1200,3170,30
113125442565,113125442561,-4,1381,2078,30
113128027874,113128027870,-4,945,2685,30
113137052568,113137052567,-1,1144,1996,30
113137133905,113137133922,17,38,904,30
113138423534,113138423529,-5,693,1858,30
113139508684,113139508677,-7,945,2768,30
113144977685,113144977691,6,2863,1442,30
113152504820,113152504815,-5,981,3311,30
113153482378,113153482374,-4,1011,3748,30
113154850258,113154850251,-7,195,907,30
113158458126,113158458120,-6,2247,6620,30
113161159707,113161159702,-5,1259,2518,30
113172000097,113172000090,-7,1063,2733,30
113177805678,113177805672,-6,1312,6585,30
113179908535,113179908533,-2,739,2531,30
113180594677,113180594672,-5,1410,3307,30
113182326971,113182326967,-4,942,2441,30
113182897485,113182897478,-7,1522,3795,30
113183046880,113183046902,22,704,3084,30
113184559849,113184559845,-4,1370,3677,30
113186324283,113186324290,7,9688,1804,30
113187398698,113187398686,-12,213,1293,30
113193975201,113193975196,-5,1563,2483,30
113194354667,113194354651,-16,136,1249,30
113195465914,113195465913,-1,2699,5109,30
113200111394,113200111410,16,400,1097,30
113200759479,113200759475,-4,1103,3308,30
113201068917,113201068913,-4,845,2199,30
113201415701,113201415699,-2,1259,2984,30
113205877631,113205877625,-6,663,2406,30
113206984671,113206984667,-4,1099,2533,30
113207229333,113207229329,-4,1539,3697,30
113207924922,113207924941,19,32,809,30
113209268999,113209268994,-5,847,2732,30
113209557738,113209557758,20,293,813,30
113223802670,113223802676,6,5004,2615,30
113225336949,113225336944,-5,872,2476,30
113231000968,113231000963,-5,1240,2473,30
113233114505,113233114501,-4,1193,2327,30
113233984582,113233984577,-5,919,3328,30
113237007422,113237007421,-1,1084,1671,30
113241516891,113241516887,-4,859,1644,30
113243521862,113243521858,-4,1319,3257,30
113246874556,113246874553,-3,1283,3388,30
113249706664,113249706661,-3,1523,2882,30
113252913792,113252913789,-3,863,2400,30
113255595366,113255595362,-4,796,2289,30
113256031657,113256031662,5,431,10236,30
113258353801,113258353806,5,2596,999,30
113259471355,113259471349,-6,871,2543,30
113264642446,113264642441,-5,1150,2590,30
113270169830,113270169826,-4,1539,2748,30
113270485942,113270485938,-4,786,2160,30
113270797194,113270797185,-9,21,964,30
113289084557,113289084547,-10,590,3374,30
113289473917,113289473924,7,6686,1982,30
113297521463,113297521460,-3,1475,3186,30
113298239273,113298239266,-7,1083,6716,30
113298384215,113298384211,-4,895,2793,30
113307789434,113307789429,-5,1226,3545,30
113310753370,113310753371,1,3439,3392,30
113311478964,113311478961,-3,1070,2752,30
113312680901,113312680914,13,14604,49281,30
113316379708,113316379700,-8,956,3410,30
113324520479,113324520484,5,1707,1336,30
113325430190,113325430184,-6,790,2590,30
113333011445,113333011440,-5,980,3136,30
113334441115,113334441110,-5,1032,2332,30
113338800967,113338800963,-4,1139,2611,30
113345228752,113345228748,-4,1138,3379,30
113345452270,113345452270,0,1894,1288,30
113348380244,113348380242,-2,1153,2016,30
113352582570,113352582565,-5,904,1728,30
113354023407,113354023402,-5,733,2482,30
113358460670,113358460666,-4,1060,2143,30
113361624950,113361624944,-6,987,2708,30
113363276897,113363276893,-4,1063,3167,30
113368077141,113368077142,1,1561,1264,30
113371917852,113371917846,-6,1340,2806,30
113375132542,113375132545,3,1701,1457,30
113381766065,113381766062,-3,785,3109,30
113386367097,113386367100,3,3184,2254,30
113387539898,113387539893,-5,1088,2950,30
113387614237,113387614232,-5,1314,3627,30
113390984878,113390984873,-5,1074,2981,30
113391252209,113391252228,19,933,1759,30
113391506410,113391506430,20,651,2723,30
113391968606,113391968602,-4,1147,2571,30
113392166817,113392166835,18,817,3384,30
113394571043,113394571039,-4,1149,3096,30
113396504624,113396504620,-4,1198,2778,30
113402476461,113402476466,5,2235,1215,30
113413573487,113413573482,-5,843,1691,30
113414419813,113414419808,-5,1080,2604,30
113424270248,113424270244,-4,1116,3205,30
113429030333,113429030326,-7,1258,2874,30
113429611074,113429611077,3,2875,1997,30
113430690114,113430690111,-3,835,2628,30
113431570890,113431570874,-16,23,1007,30
113437055414,113437055412,-2,991,2724,30
113437358453,113437358450,-3,1124,2643,30
113438131734,113438131727,-7,1295,2542,30
113439820510,113439820509,-1,916,2228,30
113450427397,113450427394,-3,1374,3681,30
113458009457,113458009452,-5,941,3298,30
113458872136,113458872158,22,1080,2433,30
113458983834,113458983829,-5,985,2889,30
113462614743,113462614738,-5,1070,2626,30
113463554442,113463554437,-5,1083,1818,30
113471420477,113471420472,-5,1131,2925,30
113474908582,113474908578,-4,963,3680,30
113477491399,113477491385,-14,715,2351,30
113478894532,113478894527,-5,777,2790,30
113482820123,113482820117,-6,1000,2557,30
113488746871,113488746866,-5,789,2442,30
113489833163,113489833161,-2,1354,2650,30
113494696742,113494696739,-3,635,1935,30
113497623056,113497623059,3,299,935,30
113498652754,113498652748,-6,1636,3406,30
113500736677,113500736676,-1,1091,2846,30
113510127755,113510127754,-1,1175,2502,30
113514674430,113514674427,-3,477,1804,30
113517417208,113517417201,-7,1128,2090,30
113519925387,113519925383,-4,857,3546,30
113520210435,113520210437,2,2166,1504,30
113532740354,113532740350,-4,868,3030,30
113536241414,113536241409,-5,823,2023,30
113536480952,113536480955,3,274,970,30
113538945422,113538945430,8,4193,1222,30
113540643371,113540643366,-5,804,3404,30
113541581995,113541581998,3,44,671,30
113542910190,113542910192,2,3678,2912,30
113545472543,113545472538,-5,860,3419,30
113548148710,113548148706,-4,1056,3747,30
113548880051,113548880047,-4,1226,3810,30
113552662705,113552662701,-4,630,2267,30
113555996041,113555996037,-4,1429,3920,30
113561629047,113561629050,3,1321,1602,30
113566022898,113566022903,5,2890,2210,30
113568737842,113568737835,-7,912,4543,30
113573160514,113573160509,-5,1087,2180,30
113573866134,113573866129,-5,1372,2457,30
113585334164,113585334171,7,3612,1043,30
113587502144,113587502152,8,1214,1277,30
113590192552,113590192555,3,2271,1434,30
113595983593,113595983589,-4,630,1730,30
113602394813,113602394809,-4,1494,3821,30
113606159146,113606159140,-6,1418,2855,30
113607970197,113607970194,-3,870,3165,30
113608485160,113608485177,17,448,1126,30
113609247845,113609247842,-3,1217,2318,30
113610373018,113610373013,-5,1176,3239,30
113613904987,113613904982,-5,904,3287,30
113614500910,113614500906,-4,1437,3287,30
113619233423,113619233418,-5,936,2308,30
113620130371,113620130389,18,289,789,30
113621690970,113621690965,-5,1137,2821,30
113623099655,113623099653,-2,1195,1948,30
113623970810,113623970805,-5,985,2801,30
113629111669,113629111664,-5,1120,3040,30
113633374769,113633374762,-7,437,2874,30
113634127642,113634127638,-4,778,2664,30
113635277474,113635277470,-4,741,1837,30
113635371817,113635371826,9,48,910,30
113640215285,113640215282,-3,1217,2876,30
113644940694,113644940689,-5,1234,3008,30
113649120389,113649120382,-7,1018,2468,30
113649659834,113649659826,-8,1033,2977,30
113649941724,113649941719,-5,1226,2804,30
113650141137,113650141156,19,447,1818,30
113651920970,113651920962,-8,1821,6689,30
113653368506,113653368506,0,1526,2500,30
113661322581,113661322578,-3,1471,3167,30
113669488034,113669488029,-5,1022,2992,30
113671135678,113671135672,-6,1039,2573,30
113673265446,113673265442,-4,1231,2862,30
113675817454,113675817454,0,1838,2340,30
113681646559,113681646559,0,2067,2311,30
113686785823,113686785818,-5,791,3227,30
113688569361,113688569356,-5,762,2959,30
113690032647,113690032642,-5,516,1676,30
113693282797,113693282793,-4,860,3259,30
113696712183,113696712180,-3,1325,1544,30
113705332006,113705332002,-4,854,3095,30
113710269814,113710269809,-5,1019,1625,30
113713950094,113713950090,-4,848,2284,30
113713976948,113713976965,17,1266,2957,30
113719161927,113719161925,-2,713,2360,30
113723605307,113723605321,14,601,2230,30
113726576646,113726576643,-3,1105,3261,30
113728767452,113728767445,-7,1019,2077,30
113732966533,113732966530,-3,965,3048,30
113733453671,113733453667,-4,1095,2462,30
113735122874,113735122870,-4,731,2624,30
113735487795,113735487790,-5,653,1990,30
113738387991,113738387986,-5,948,3262,30
113746919851,113746919846,-5,1094,2285,30
113753283728,113753283723,-5,859,2400,30
113753882842,113753882836,-6,189,1020,30
113760403450,113760403443,-7,1001,3665,30
113766559710,113766559715,5,1352,790,30
113766843769,113766843765,-4,1243,3335,30
113768111570,113768111566,-4,1214,3115,30
113771007875,113771007870,-5,1287,3985,30
113772752526,113772752520,-6,1203,3898,30
113774429607,113774429603,-4,965,2912,30
113778418373,113778418367,-6,737,2796,30
113780070014,113780070012,-2,1131,3611,30
113780576826,113780576822,-4,1347,3299,30
113780871195,113780871191,-4,1162,2919,30
113782547251,113782547258,7,2469,1225,30
113785597990,113785597986,-4,1063,3056,30
113793321914,113793321910,-4,928,2801,30
113795664577,113795664573,-4,823,2565,30
113795753639,113795753640,1,43562,48136,30
113797501512,113797501527,15,1022,2615,30
113799034998,113799034994,-4,938,2792,30
113800073174,113800073172,-2,924,2572,30
113800118220,113800118215,-5,1106,2689,30
113801576700,113801576702,2,2935,3429,30
113802390190,113802390187,-3,970,2875,30
113804458775,113804458770,-5,781,2551,30
113814818239,113814818255,16,1165,2542,30
113816084666,113816084661,-5,1553,3820,30
113822249535,113822249531,-4,1171,2375,30
113823686774,113823686769,-5,844,2585,30
113825929409,113825929404,-5,1000,1658,30
113831154438,113831154433,-5,940,2764,30
113835085687,113835085685,-2,929,2379,30
113837481099,113837481095,-4,1154,2614,30
113841985710,113841985706,-4,943,3912,30
113843293778,113843293773,-5,324,986,30
113843533971,113843533966,-5,1008,2106,30
113844114219,113844114222,3,1798,1932,30
113848231815,113848231811,-4,1089,3167,30
113860764638,113860764633,-5,1051,2277,30
113862280590,113862280586,-4,1367,3774,30
113864296390,113864296397,7,3116,1548,30
113867413071,113867413078,7,6596,2185,30
113868884290,113868884289,-1,866,1943,30
113874352471,113874352468,-3,920,2477,30
113874870290,113874870286,-4,1276,4256,30
113878415234,113878415229,-5,954,2937,30
113881198413,113881198407,-6,1032,2217,30
113884612209,113884612202,-7,1240,3513,30
113887746297,113887746303,6,20339,20463,30
113888409463,113888409459,-4,975,3208,30
113889360033,113889360028,-5,809,1767,30
113890272283,113890272279,-4,1120,2947,30
113891572204,113891572198,-6,1060,2618,30
113891662609,113891662610,1,69,1203,30
113891778361,113891778342,-19,264,755,30
113899672694,113899672675,-19,1808,2146,30
113904396574,113904396569,-5,911,1980,30
113905418708,113905418722,14,815,2689,30
113916339645,113916339643,-2,1045,1909,30
113917314484,113917314478,-6,1397,4007,30
113922608446,113922608443,-3,1172,2912,30
113929123330,113929123326,-4,1253,3526,30
113933879842,113933879838,-4,1206,2385,30
113933956954,113933956971,17,305,1044,30
113938878229,113938878231,2,20810,29983,30
113941321606,113941321601,-5,749,3110,30
113942843794,113942843790,-4,1408,3975,30
113946514089,113946514085,-4,872,2698,30
113956371054,113956371048,-6,1541,3504,30
113956950627,113956950623,-4,857,2375,30
113959351302,113959351298,-4,629,2488,30
113959640330,113959640343,13,587,1932,30
113961204387,113961204388,1,1585,2495,30
113964332221,113964332221,0,1888,1228,30
113965670954,113965670950,-4,933,1640,30
113970799774,113970799769,-5,1102,2976,30
113981022622,113981022619,-3,1173,1519,30
113987950120,113987950114,-6,1033,3898,30
113990212407,113990212409,2,1088,1443,30
114009903670,114009903666,-4,1274,2162,30
114011197195,114011197191,-4,1062,2442,30
114017880601,114017880596,-5,1013,2946,30
114020116046,114020116039,-7,664,1400,30
114024580357,114024580359,2,1216,1583,30
114027658000,114027657994,-6,1116,3112,30
114028012347,114028012343,-4,1562,2867,30
114029255310,114029255305,-5,1352,2729,30
114034794404,114034794401,-3,1210,2381,30
114035496059,114035496053,-6,618,1882,30
114037158587,114037158607,20,769,2252,30
114038198202,114038198201,-1,1143,1551,30
114044949170,114044949163,-7,1136,4268,30
114045112972,114045112986,14,718,1901,30
114045690791,114045690785,-6,805,2283,30
114052680098,114052680094,-4,852,1409,30
114056587359,114056587355,-4,1347,3116,30
114060078815,114060078807,-8,1270,3108,30
114070404214,114070404209,-5,929,2379,30
114072389658,114072389669,11,298,1286,30
114073718487,114073718482,-5,1406,4873,30
114084334891,114084334888,-3,1235,2274,30
114084546787,114084546801,14,395,1287,30
114086214005,114086214012,7,3515,1849,30
114091984582,114091984579,-3,989,3227,30
114093256524,114093256517,-7,1289,1946,30
114097563124,114097563130,6,17860,24235,30
114099867970,114099867964,-6,1065,2739,30
114104341974,114104341969,-5,246,1162,30
114108961799,114108961794,-5,794,2366,30
114109219531,114109219543,12,240,561,30
114112837776,114112837763,-13,4048,14948,30
114113790077,114113790071,-6,1189,3795,30
114114679634,114114679631,-3,1251,3325,30
114115336647,114115336651,4,2215,1541,30
114116126878,114116126874,-4,1143,2602,30
114119638183,114119638178,-5,1017,3735,30
114126371997,114126371994,-3,822,2297,30
114131301621,114131301615,-6,1165,2865,30
114131634571,114131634579,8,115,788,30
114137363141,114137363138,-3,726,2327,30
114137843355,114137843371,16,801,3924,30
114139235814,114139235812,-2,918,1905,30
114140219823,114140219818,-5,1219,3743,30
114144857019,114144857014,-5,760,2690,30
114147409035,114147409030,-5,661,2036,30
114152637779,114152637773,-6,854,3127,30
114159369034,114159369031,-3,1306,2845,30
114163618402,114163618394,-8,868,4812,30
114164915682,114164915677,-5,673,2689,30
114165817397,114165817394,-3,1043,2915,30
114183186302,114183186299,-3,866,3064,30
114183977987,114183977994,7,234,1022,30
114186070367,114186070362,-5,1288,3836,30
114186121555,114186121568,13,954,2084,30
114188165654,114188165649,-5,651,948,30
114189280841,114189280835,-6,1436,3732,30
114195253571,114195253568,-3,567,1584,30
114200716579,114200716574,-5,1331,3103,30
114201927210,114201927226,16,253,750,30
114202378972,114202378966,-6,1039,3140,30
114203365633,114203365621,-12,266,1525,30
114203771017,114203771010,-7,61,861,30
114210608200,114210608196,-4,1454,3508,30
114216448931,114216448926,-5,1238,2805,30
114217130898,114217130893,-5,1041,1760,30
114223244248,114223244245,-3,947,2729,30
114226318578,114226318574,-4,963,2262,30
114238035377,114238035370,-7,785,1851,30
114238280635,114238280655,20,623,7037,30
114244821858,114244821853,-5,1049,2739,30
114247738296,114247738289,-7,1192,4656,30
114249109122,114249109109,-13,969,4026,30
114256750213,114256750210,-3,1041,1847,30
114259379843,114259379838,-5,910,3194,30
114261077342,114261077339,-3,1479,3709,30
114261323274,114261323266,-8,1113,2815,30
114263160531,114263160526,-5,1184,3193,30
114265524482,114265524478,-4,1243,2201,30
114270069647,114270069642,-5,831,2374,30
114270826551,114270826546,-5,847,2626,30
114271047007,114271047009,2,1785,1210,30
114272154754,114272154752,-2,1567,1784,30
114277102331,114277102326,-5,979,3040,30
114282103474,114282103461,-13,721,2785,30
114285478654,114285478650,-4,1001,2387,30
114289528163,114289528158,-5,857,1942,30
114290701806,114290701802,-4,1456,3857,30
114294914569,114294914565,-4,1227,2583,30
114302076969,114302076962,-7,1100,4019,30
114308083282,114308083281,-1,625,1932,30
114308244837,114308244832,-5,768,2028,30
114309712459,114309712454,-5,2049,6957,30
114313169999,114313169995,-4,1068,2938,30
114313320178,114313320174,-4,1291,3308,30
114316186882,114316186875,-7,996,2937,30
114319511847,114319511842,-5,1037,2438,30
114320241102,114320241095,-7,1124,2979,30
114321208930,114321208922,-8,1017,3372,30
114325144494,114325144500,6,16410,27018,30
114328536979,114328536977,-2,837,1551,30
114329068411,114329068407,-4,1113,1994,30
114333899925,114333899920,-5,1107,2752,30
114336919261,114336919257,-4,1033,2727,30
114341318504,114341318511,7,6822,24468,30
114342125937,114342125933,-4,1275,3071,30
114347922293,114347922290,-3,1330,3389,30
114354278390,114354278385,-5,726,3591,30
114356107858,114356107856,-2,747,2537,30
114359908226,114359908223,-3,1291,1243,30
114361001749,114361001750,1,1419,931,30
114363608988,114363608983,-5,1399,3864,30
114372789104,114372789099,-5,1272,2853,30
114372974459,114372974475,16,1010,2770,30
114373997834,114373997829,-5,1534,2563,30
114383284416,114383284425,9,6560,2764,30
114390515970,114390515966,-4,999,3219,30
114391234961,114391234955,-6,1053,2557,30
114395582633,114395582628,-5,1369,3017,30
114405634316,114405634313,-3,673,2219,30
114408434599,114408434606,7,162,827,30
114409280002,114409280000,-2,214,1050,30
114412493564,114412493558,-6,961,3549,30
114412787971,114412787958,-13,1550,4130,30
114416876442,114416876439,-3,1850,3437,30
114417147139,114417147132,-7,780,2201,30
114419961121,114419961117,-4,1161,2581,30
114420485551,114420485545,-6,1021,2623,30
114427302381,114427302376,-5,1138,3066,30
114430970486,114430970482,-4,1031,2951,30
114437922110,114437922113,3,2224,2117,30
114438432716,114438432711,-5,1091,3095,30
114439025922,114439025925,3,2809,2210,30
114441000286,114441000279,-7,1003,3305,30
114446323865,114446323859,-6,817,3049,30
114455256064,114455256061,-3,1174,2926,30
114456630869,114456630866,-3,709,2406,30
114456929938,114456929935,-3,1087,3621,30
114466411065,114466411061,-4,1099,2742,30
114471312471,114471312471,0,848,1465,30
114471922254,114471922247,-7,1652,4265,30
114480659107,114480659102,-5,831,2594,30
114484002797,114484002791,-6,864,3188,30
114488001548,114488001542,-6,1371,3392,30
114490832741,114490832738,-3,1474,2704,30
114491063548,114491063566,18,850,3243,30
114491137364,114491137382,18,1600,3080,30
114493806451,114493806446,-5,1042,2797,30
114497222625,114497222621,-4,1001,2078,30
114499151474,114499151469,-5,741,2246,30
114499774710,114499774705,-5,513,2582,30
114501343907,114501343898,-9,532,1913,30
114503471945,114503471940,-5,1127,3294,30
114512453154,114512453149,-5,1359,3787,30
114514413717,114514413722,5,3023,1794,30
114524446847,114524446843,-4,1200,2268,30
114525284698,114525284693,-5,828,3621,30
114537143243,114537143234,-9,127,495,30
114537505140,114537505135,-5,775,2807,30
114538851280,114538851276,-4,1411,2452,30
114545527182,114545527177,-5,1009,2594,30
114548336174,114548336170,-4,1151,2863,30
114552333200,114552333195,-5,944,1845,30
114554019846,114554019841,-5,1870,3442,30
114554706461,114554706454,-7,582,2773,30
114554910634,114554910630,-4,928,2421,30
114558422751,114558422746,-5,890,2975,30
114558456420,114558456431,11,430,1068,30
114559001146,114559001141,-5,1214,2903,30
114559358239,114559358234,-5,1432,3082,30
114564841547,114564841541,-6,1118,3909,30
114568607907,114568607902,-5,667,1667,30
114572191350,114572191345,-5,921,2240,30
114573547969,114573547964,-5,1989,5033,30
114573926704,114573926698,-6,482,2742,30
114579019835,114579019830,-5,944,1733,30
114579485867,114579485886,19,901,2960,30
114581002693,114581002688,-5,1370,3440,30
114583141163,114583141166,3,1358,1259,30
114583774882,114583774882,0,1721,1611,30
114587187562,114587187561,-1,924,2141,30
114588847212,114588847209,-3,1300,2621,30
114591253038,114591253033,-5,1192,3820,30
114591705944,114591705937,-7,1157,3881,30
114593022406,114593022401,-5,783,2054,30
114595098432,114595098429,-3,911,1657,30
114599248558,114599248554,-4,1245,3090,30
114599719257,114599719253,-4,1248,3936,30
114605780153,114605780149,-4,1441,3369,30
114612589810,114612589806,-4,1188,2944,30
114615186225,114615186222,-3,1121,1765,30
114616636787,114616636782,-5,1090,3759,30
114619150745,114619150752,7,2509,1024,30
114620767402,114620767396,-6,1322,4865,30
114621539609,114621539602,-7,742,1919,30
114622453501,114622453497,-4,1003,2523,30
114630097651,114630097649,-2,911,2573,30
114634660195,114634660189,-6,961,2692,30
114635710679,114635710674,-5,1358,3362,30
114637275123,114637275118,-5,1430,3565,30
114639526630,114639526626,-4,694,1150,30
114641216545,114641216551,6,2861,1307,30
114646622030,114646622025,-5,1325,2248,30
114647270658,114647270657,-1,2596,3077,30
114647545170,114647545163,-7,940,2514,30
114649326892,114649326886,-6,905,3298,30
114652205953,114652205949,-4,1133,3372,30
114652919692,114652919705,13,210,1097,30
114654819379,114654819373,-6,43,808,30
114656146016,114656146012,-4,814,2519,30
114657871299,114657871294,-5,1258,2403,30
114661972418,114661972417,-1,2660,4414,30
114662591996,114662591990,-6,719,2673,30
114673673291,114673673287,-4,766,2610,30
114673983082,114673983078,-4,799,2571,30
114678325350,114678325348,-2,1283,2560,30
114681394778,114681394776,-2,279,1342,30
114681934614,114681934610,-4,1101,2505,30
114684124636,114684124636,0,869,1269,30
114689378807,114689378805,-2,854,924,30
114694082972,114694082967,-5,952,2956,30
114694587954,114694587971,17,139,446,30
114696035341,114696035345,4,2787,1306,30
114697757038,114697757034,-4,1296,2457,30
114701864943,114701864938,-5,1198,2858,30
114702411039,114702411041,2,866,905,30
114707034203,114707034199,-4,938,1894,30
114707629020,114707629017,-3,1297,3750,30
114708937861,114708937867,6,8847,1305,30
114711113549,114711113548,-1,789,2550,30
114712402482,114712402477,-5,903,2816,30
114717522014,114717522010,-4,655,2497,30
114717712473,114717712470,-3,1012,2687,30
114721765447,114721765442,-5,1111,2620,30
114726013267,114726013261,-6,1213,3372,30
114727130968,114727130971,3,15081,13786,30
114733514999,114733514995,-4,1372,3290,30
114733716968,114733716965,-3,726,2110,30
114733842120,114733842102,-18,456,888,30
114736992459,114736992454,-5,555,2934,30
114737503331,114737503326,-5,1006,2353,30
114748267403,114748267397,-6,1711,3745,30
114749462135,114749462129,-6,611,2843,30
114759168011,114759168005,-6,862,2512,30
114760164873,114760164868,-5,1016,2957,30
114760220817,114760220796,-21,210,1223,30
114772737831,114772737826,-5,1454,3753,30
114773417977,114773417976,-1,992,2491,30
114775370614,114775370609,-5,1193,2331,30
114778607494,114778607491,-3,938,2043,30
114779413099,114779413096,-3,523,2658,30
114787970369,114787970369,0,1577,2310,30
114790021177,114790021173,-4,1127,1830,30
114791305039,114791305034,-5,1379,3592,30
114795851347,114795851342,-5,1034,3148,30
114801373732,114801373728,-4,1440,2433,30
114801953980,114801953975,-5,1189,1880,30
114803437565,114803437561,-4,1272,3507,30
114804676558,114804676551,-7,1096,2972,30
114810117395,114810117391,-4,961,2535,30
114821125655,114821125650,-5,689,3425,30
114821734644,114821734641,-3,1544,3491,30
114823704123,114823704118,-5,920,2421,30
114825256994,114825256985,-9,885,2896,30
114825297432,114825297442,10,174,1397,30
114830263777,114830263770,-7,1449,3506,30
114839254203,114839254199,-4,885,2284,30
114843750546,114843750541,-5,891,2399,30
114849343853,114849343856,3,1587,1463,30
114850663762,114850663758,-4,1277,3319,30
114852338827,114852338824,-3,1061,1838,30
114859048366,114859048362,-4,1164,4584,30
114859452253,114859452246,-7,1187,3840,30
114871008754,114871008750,-4,1242,4418,30
114879621935,114879621931,-4,1172,2807,30
114887920717,114887920722,5,2199,1167,30
114892301305,114892301300,-5,1107,3978,30
114895691636,114895691630,-6,1433,2903,30
114899592003,114899591999,-4,935,2921,30
114900093434,114900093455,21,295,868,30
114902023941,114902023943,2,837,848,30
114903304701,114903304704,3,2480,1835,30
114903621903,114903621901,-2,876,2689,30
114923257086,114923257082,-4,915,2783,30
114926269235,114926269229,-6,672,2656,30
114929112014,114929112013,-1,1842,3201,30
114932946010,114932946005,-5,1033,2625,30
114934893632,114934893654,22,371,1872,30
114939317072,114939317086,14,119,1719,30
114943815521,114943815517,-4,1361,3727,30
114947854078,114947854071,-7,1241,2791,30
114950340258,114950340254,-4,939,2848,30
114950631991,114950631986,-5,785,2021,30
114959389090,114959389089,-1,610,1329,30
114962576823,114962576817,-6,906,3000,30
114962732889,114962732906,17,368,1246,30
114967015393,114967015390,-3,824,2501,30
114968033077,114968033073,-4,1451,2291,30
114969086725,114969086718,-7,1425,4640,30
114969354467,114969354461,-6,894,2561,30
114969978738,114969978733,-5,1135,2072,30
114980890981,114980890979,-2,1310,2242,30
114984294999,114984294995,-4,917,2787,30
114986587685,114986587680,-5,1101,2367,30
114990295342,114990295335,-7,1448,3262,30
114990604879,114990604873,-6,1197,4509,30
114995097306,114995097302,-4,950,2982,30
114996707511,114996707505,-6,1330,4114,30
114998414507,114998414502,-5,1326,3478,30
114999556073,114999556068,-5,624,3592,30
115004146360,115004146359,-1,1281,2243,30
115011820406,115011820403,-3,937,2526,30
115016728399,115016728394,-5,965,2650,30
115019603146,115019603141,-5,687,2176,30
115022949877,115022949874,-3,1163,2776,30
115031278007,115031278004,-3,1195,2201,30
115039437425,115039437421,-4,1051,3691,30
115043780967,115043780964,-3,763,1661,30
115044243831,115044243826,-5,860,2628,30
115045812661,115045812667,6,1889,1268,30
115045969811,115045969807,-4,617,1870,30
115046018649,115046018631,-18,706,2030,30
115050986858,115050986853,-5,1223,3315,30
115051909967,115051909962,-5,763,2014,30
115057316175,115057316172,-3,940,3424,30
115058223729,115058223751,22,403,1625,30
115062346265,115062346260,-5,917,3667,30
115063701078,115063701073,-5,1205,2866,30
115063797769,115063797784,15,1193,5469,30
115067130305,115067130303,-2,1214,1246,30
115067927663,115067927657,-6,1346,2922,30
115070620141,115070620134,-7,1157,3236,30
115073401077,115073401072,-5,598,2046,30
115073936658,115073936652,-6,968,3698,30
115074423689,115074423682,-7,171,643,30
115079903194,115079903189,-5,1832,7138,30
115080126529,115080126526,-3,922,2599,30
115080458425,115080458422,-3,416,720,30
115082366190,115082366208,18,614,2138,30
115088336862,115088336861,-1,1223,2813,30
115089007326,115089007322,-4,1253,2858,30
115090966367,115090966365,-2,912,2684,30
115091209699,115091209701,2,164,518,30
115091450030,115091450026,-4,1299,2407,30
115093102585,115093102582,-3,1005,1967,30
115101955201,115101955204,3,1966,1472,30
115104515449,115104515442,-7,648,3445,30
115111190159,115111190144,-15,229,668,30
115114951261,115114951258,-3,1390,2418,30
115128518929,115128518922,-7,1036,2745,30
115130347946,115130347942,-4,1041,2751,30
115131200386,115131200378,-8,1123,3230,30
115138223277,115138223274,-3,1153,2695,30
115152952989,115152952985,-4,1007,2843,30
115156239908,115156239905,-3,1127,2504,30
115156920376,115156920359,-17,236,936,30
115158391037,115158391038,1,1216,1922,30
115162980719,115162980714,-5,973,3562,30
115164758560,115164758582,22,197,647,30
115165970360,115165970378,18,928,3354,30
115166208626,115166208642,16,843,2194,30
115166911259,115166911253,-6,1085,2702,30
115172093091,115172093087,-4,671,2211,30
115176878830,115176878826,-4,1171,2780,30
115177648495,115177648490,-5,1270,4275,30
115177983415,115177983414,-1,883,1445,30
115181577844,115181577847,3,2315,1402,30
115184411262,115184411260,-2,1116,1585,30
115197161803,115197161797,-6,2472,6188,30
115199043414,115199043408,-6,1025,2964,30
115202796323,115202796319,-4,911,3500,30
115203133065,115203133054,-11,6,743,30
115203802705,115203802706,1,2144,2329,30
115209127242,115209127238,-4,686,2226,30
115211642366,115211642361,-5,1519,7595,30
115217463129,115217463124,-5,1178,2875,30
115218027058,115218027070,12,190,571,30
115219327205,115219327201,-4,1569,3881,30
115231746996,115231746990,-6,1258,2649,30
115233262767,115233262766,-1,1189,1896,30
115238509188,115238509183,-5,977,2823,30
115238995282,115238995277,-5,1047,2100,30
115242011296,115242011291,-5,2561,7311,30
115242595744,115242595740,-4,1274,3302,30
115245502562,115245502557,-5,791,2443,30
115246094760,115246094770,10,203,1089,30
115249912699,115249912695,-4,1113,2739,30
115259666546,115259666551,5,3547,2425,30
115260252654,115260252650,-4,834,2019,30
115264102145,115264102124,-21,1190,3815,30
115266062191,115266062186,-5,1316,3804,30
115271220448,115271220462,14,84,1028,30
115271829265,115271829281,16,697,2786,30
115276789926,115276789933,7,8540,3552,30
115282738899,115282738890,-9,1119,2621,30
115283034028,115283034038,10,368,749,30
115283212860,115283212855,-5,1135,2945,30
115284639617,115284639614,-3,859,3445,30
115287928291,115287928287,-4,992,2413,30
115295225537,115295225533,-4,1523,2122,30
115296820727,115296820723,-4,669,2193,30
115299109868,115299109871,3,1604,1340,30
115299877911,115299877907,-4,1172,3070,30
115301593659,115301593655,-4,1170,2007,30
115302133345,115302133367,22,232,876,30
115304168950,115304168945,-5,1190,2548,30
115305950378,115305950374,-4,1238,3627,30
115306818237,115306818233,-4,881,2352,30
115312944404,115312944398,-6,1162,3249,30
115314065625,115314065631,6,5307,2026,30
115316169791,115316169787,-4,1252,3421,30
115319607626,115319607630,4,2765,1536,30
115323385742,115323385737,-5,965,2723,30
115335174971,115335174969,-2,1237,2182,30
115339432890,115339432887,-3,1061,3325,30
115342317487,115342317482,-5,804,2849,30
115342735719,115342735712,-7,982,3453,30
115343487708,115343487725,17,296,2160,30
115350302985,115350302990,5,2325,1146,30
115355241665,115355241659,-6,1309,3458,30
115361731414,115361731410,-4,912,1744,30
115364836321,115364836318,-3,1186,2712,30
115368208725,115368208722,-3,1086,1794,30
115368417030,115368417030,0,1036,1701,30
115372855130,115372855124,-6,1933,12002,30
115372881267,115372881260,-7,2303,10901,30
115374591806,115374591802,-4,951,1508,30
115379689041,115379689036,-5,1131,3445,30
115382055694,115382055709,15,712,2636,30
115394870650,115394870646,-4,1035,2907,30
115402277183,115402277181,-2,1007,2743,30
115407864819,115407864812,-7,818,2622,30
115409797665,115409797659,-6,1193,2672,30
115411746010,115411746010,0,111,888,30
115412461378,115412461395,17,697,2660,30
115418315635,115418315632,-3,1354,3068,30
115420914513,115420914507,-6,572,2234,30
115421025176,115421025159,-17,39,460,30
115426647471,115426647466,-5,1023,3686,30
115432253017,115432253015,-2,972,1956,30
115442388425,115442388423,-2,914,1591,30
115444174386,115444174364,-22,1170,3258,30
115445216749,115445216751,2,1550,1590,30
115446770154,115446770154,0,973,1027,30
115462199884,115462199885,1,37599,46703,30
115462881007,115462881001,-6,881,2626,30
115467199793,115467199789,-4,1011,3332,30
115472035653,115472035649,-4,779,2716,30
115474062199,115474062200,1,1036,1549,30
115485883180,115485883179,-1,886,1567,30
115486734588,115486734585,-3,868,2359,30
115486972115,115486972110,-5,1155,3962,30
115490891638,115490891630,-8,981,2956,30
115496294410,115496294408,-2,941,1913,30
115498312579,115498312578,-1,1057,1652,30
115498634220,115498634215,-5,1018,2880,30
115505035728,115505035725,-3,1428,2715,30
115506514518,115506514514,-4,959,2841,30
115515319501,115515319506,5,4839,1500,30
115516317180,115516317181,1,2028,1964,30
115517231074,115517231067,-7,1280,7498,30
115517935463,115517935461,-2,872,1514,30
115519714115,115519714110,-5,1035,2617,30
115520188808,115520188794,-14,797,2747,30
115520761627,115520761622,-5,1183,3353,30
115530995747,115530995742,-5,1243,3425,30
115533766986,115533766981,-5,1419,3814,30
115534176406,115534176402,-4,632,1185,30
115536060210,115536060202,-8,703,3181,30
115536474379,115536474390,11,178,892,30
115540389347,115540389342,-5,1200,3420,30
115543955834,115543955829,-5,1132,3181,30
115554137035,115554137032,-3,910,2461,30
115565334575,115565334569,-6,995,3585,30
115566592714,115566592709,-5,979,2165,30
115567827859,115567827855,-4,964,3659,30
115568833715,115568833709,-6,775,3346,30
115573223514,115573223509,-5,1137,3931,30
115577326902,115577326896,-6,991,2492,30
115577560265,115577560262,-3,1112,3234,30
115584037642,115584037637,-5,906,3328,30
115586272395,115586272389,-6,991,2452,30
115587548222,115587548218,-4,1088,2961,30
115588031407,115588031402,-5,829,1878,30
115588877334,115588877330,-4,1403,2567,30
115590036155,115590036151,-4,784,2105,30
115590170386,115590170404,18,392,1595,30
115590802945,115590802940,-5,1111,2234,30
115592236221,115592236216,-5,1442,3189,30
115592771420,115592771415,-5,1311,2662,30
115596325905,115596325899,-6,1012,3112,30
115600596403,115600596405,2,22595,37513,30
115606435147,115606435143,-4,775,1463,30
115608510852,115608510848,-4,1332,4319,30
115611105847,115611105842,-5,1244,3160,30
115612870757,115612870749,-8,184,1160,30
115618305502,115618305497,-5,1053,3079,30
115618563477,115618563472,-5,1155,3235,30
115619866307,115619866310,3,1414,1369,30
115624344890,115624344886,-4,1186,2887,30
115624726466,115624726461,-5,847,2372,30
115625037594,115625037590,-4,923,2817,30
115626549442,115626549439,-3,1317,3657,30
115628441723,115628441718,-5,1198,2680,30
115630444409,115630444409,0,827,1728,30
115639385349,115639385345,-4,1075,3198,30
115641165264,115641165259,-5,1251,4429,30
115647175641,115647175638,-3,1813,2957,30
115649527530,115649527526,-4,1802,2485,30
115651983594,115651983590,-4,1089,3610,30
115657142426,115657142421,-5,825,1934,30
115660033205,115660033209,4,1625,935,30
115664824487,115664824483,-4,1077,2139,30
115669055047,115669055043,-4,1163,2556,30
115688271423,115688271418,-5,930,3341,30
115688310997,115688310992,-5,1109,2872,30
115689609793,115689609790,-3,1607,3705,30
115693675098,115693675094,-4,832,3015,30
115696116455,115696116433,-22,264,1967,30
115696980235,115696980230,-5,732,2771,30
115702530145,115702530141,-4,1252,2406,30
115706229485,115706229478,-7,1112,2217,30
115707914098,115707914097,-1,1353,3102,30
115708590994,115708590990,-4,1063,3005,30
115708666273,115708666275,2,1288,1131,30
115716787206,115716787201,-5,1307,2947,30
115717048643,115717048638,-5,1113,3741,30
115722667038,115722667034,-4,857,2675,30
115726767567,115726767561,-6,1009,2258,30
115730232085,115730232081,-4,1152,2781,30
115730883470,115730883464,-6,1450,3523,30
115731092494,115731092489,-5,1390,3403,30
115731779457,115731779453,-4,865,1695,30
115733063728,115733063723,-5,1061,3288,30
115734164101,115734164095,-6,890,2467,30
115734588286,115734588282,-4,1289,3193,30
115739237611,115739237608,-3,1077,2058,30
115740113919,115740113913,-6,1103,2428,30
115741029610,115741029603,-7,1270,4121,30
115750743645,115750743640,-5,1259,2357,30
115751376718,115751376714,-4,1180,2852,30
115767411849,115767411855,6,1630,27112,30
115770917467,115770917463,-4,738,1506,30
115774551870,115774551865,-5,684,2588,30
115777585358,115777585365,7,3968,1539,30
115777644779,115777644775,-4,849,2331,30
115788386583,115788386582,-1,1251,2825,30
115790202681,115790202681,0,1309,1904,30
115791859067,115791859061,-6,765,2123,30
115793976630,115793976626,-4,1164,2139,30
115794577869,115794577865,-4,1190,3079,30
115796860490,115796860484,-6,1326,3094,30
115797501579,115797501575,-4,660,1211,30
115804586448,115804586455,7,2979,942,30
115804904029,115804904022,-7,958,3277,30
115805754157,115805754160,3,1501,1349,30
115807427365,115807427361,-4,1144,3026,30
115810185363,115810185359,-4,804,1489,30
115813858647,115813858643,-4,825,2118,30
115815964042,115815964044,2,1441,1701,30
115817797334,115817797329,-5,893,2787,30
115824944878,115824944883,5,1870,1235,30
115829066035,115829066031,-4,1126,2595,30
115830014729,115830014725,-4,654,2718,30
115840693481,115840693478,-3,5519,10101,30
115848128493,115848128488,-5,876,1950,30
115853265754,115853265751,-3,1314,2551,30
115853898554,115853898549,-5,1064,2479,30
115855621473,115855621478,5,2139,1316,30
115856821623,115856821619,-4,1238,3996,30
115857618876,115857618882,6,175,1193,30
115862115174,115862115169,-5,834,2794,30
115863326330,115863326330,0,891,1974,30
115867349256,115867349255,-1,157,696,30
115870660638,115870660630,-8,786,2325,30
115874210930,115874210930,0,3195,4401,30
115882210338,115882210334,-4,644,2014,30
115884909258,115884909254,-4,1016,3243,30
115886573688,115886573695,7,9499,2688,30
115889931106,115889931101,-5,1311,3692,30
115894698373,115894698378,5,2861,1579,30
115894839369,115894839365,-4,1159,3021,30
115896598547,115896598543,-4,1687,3228,30
115901248590,115901248586,-4,1074,2305,30
115902265891,115902265870,-21,1242,4291,30
115904670719,115904670715,-4,830,2845,30
115907107009,115907107006,-3,1235,2887,30
115910702177,115910702172,-5,686,2318,30
115913489263,115913489257,-6,680,3201,30
115917941045,115917941047,2,1490,1117,30
115938115740,115938115737,-3,1356,3546,30
115938542118,115938542114,-4,1193,3130,30
115938630220,115938630230,10,168,905,30
115939750497,115939750482,-15,1314,3383,30
115943749025,115943749021,-4,1619,3870,30
115945239133,115945239130,-3,995,2510,30
115950549034,115950549028,-6,1025,2216,30
115955988290,115955988286,-4,1150,2611,30
115960545143,115960545140,-3,1179,2490,30
115965743552,115965743547,-5,1371,3187,30
115971512228,115971512231,3,4059,2583,30
115973280639,115973280635,-4,1014,3051,30
115973758403,115973758422,19,489,1459,30
115976261282,115976261277,-5,1240,3040,30
115979150603,115979150598,-5,1394,3317,30
115983017519,115983017514,-5,1144,3070,30
116000553435,116000553430,-5,1321,3405,30
116002244311,116002244292,-19,800,219,30
116002451931,116002451919,-12,97,1192,30
116004848736,116004848744,8,55,982,30
116010390179,116010390180,1,1222,2172,30
116012761886,116012761884,-2,1143,2175,30
116014415682,116014415679,-3,1480,3152,30
116015611396,116015611391,-5,975,3411,30
116016065659,116016065653,-6,779,4052,30
116018352490,116018352485,-5,1339,2711,30
116023325969,116023325963,-6,1039,2480,30
116023615192,116023615213,21,822,2667,30
116031511722,116031511717,-5,932,3070,30
116032044257,116032044278,21,504,2182,30
116032717871,116032717871,0,2418,1924,30
116035281659,116035281655,-4,1248,3927,30
116035734355,116035734351,-4,1039,3708,30
116041450630,116041450626,-4,899,2267,30
116042202618,116042202634,16,977,2251,30
116043300542,116043300538,-4,1202,3468,30
116044010099,116044010081,-18,750,2023,30
116045278043,116045278039,-4,954,2023,30
116050647318,116050647313,-5,1202,3719,30
116052540701,116052540697,-4,1198,3757,30
116055918796,116055918799,3,1324,943,30
116057079283,116057079278,-5,931,2208,30
116069390403,116069390399,-4,1167,2752,30
116069794971,116069794989,18,1255,2224,30
116070326326,116070326322,-4,980,2658,30
116074779739,116074779734,-5,972,2297,30
116075381444,116075381456,12,493,1252,30
116076589260,116076589255,-5,927,3637,30
116078990429,116078990427,-2,1213,3494,30
116079770387,116079770383,-4,677,2678,30
116080528331,116080528346,15,967,2214,30
116082916655,116082916653,-2,915,1389,30
116085668243,116085668238,-5,1413,3000,30
116088875427,116088875426,-1,919,1691,30
116092302891,116092302886,-5,708,1643,30
116094268605,116094268601,-4,714,1993,30
116094337785,116094337774,-11,2587,10636,30
116101201653,116101201646,-7,1345,4376,30
116101698878,116101698872,-6,1069,2314,30
116103610249,116103610247,-2,1531,1862,30
116108446427,116108446422,-5,1420,3582,30
116111887021,116111887017,-4,1061,3252,30
116112495709,116112495704,-5,1096,3397,30
116113440911,116113440907,-4,1263,3380,30
116120032413,116120032409,-4,1074,3039,30
116121369335,116121369330,-5,745,3054,30
116124241891,116124241884,-7,789,2187,30
116124601098,116124601085,-13,1025,3116,30
116130703090,116130703095,5,1259,1243,30
116135697786,116135697782,-4,1047,2501,30
116141186677,116141186679,2,1876,2150,30
116149293490,116149293494,4,6189,4235,30
116149353873,116149353873,0,714,1646,30
116150316683,116150316679,-4,1186,3789,30
116156099873,116156099884,11,840,1941,30
116156875770,116156875765,-5,1130,3211,30
116158614854,116158614851,-3,1509,2033,30
116159370395,116159370380,-15,101,860,30
116160208963,116160208959,-4,1053,2002,30
116165061700,116165061691,-9,1023,4170,30
116167847286,116167847281,-5,1409,3546,30
116177331776,116177331769,-7,952,3327,30
116177550201,116177550201,0,167,668,30
116178238838,116178238832,-6,1088,2206,30
116180251213,116180251209,-4,937,2625,30
116180983750,116180983746,-4,1048,3027,30
116185836823,116185836818,-5,1113,2581,30
116188104853,116188104852,-1,786,2667,30
116190523800,116190523823,23,698,1041,30
116190760511,116190760506,-5,828,2490,30
116200196831,116200196826,-5,915,2930,30
116201895362,116201895357,-5,877,2199,30
116204486495,116204486489,-6,554,870,30
116205383381,116205383377,-4,948,3044,30
116206047306,116206047301,-5,1240,3360,30
116208573832,116208573838,6,3409,1147,30
116211264977,116211264974,-3,966,2638,30
116211967803,116211967797,-6,1162,2972,30
116216204276,116216204273,-3,1433,2396,30
116223510271,116223510266,-5,942,2725,30
116224036102,116224036097,-5,876,2517,30
116227535749,116227535745,-4,1171,3641,30
116228988555,116228988551,-4,1408,3161,30
116229184306,116229184305,-1,2972,4250,30
116234140749,116234140742,-7,855,2082,30
116235729430,116235729425,-5,797,2733,30
116235897400,116235897423,23,235,843,30
116236189832,116236189817,-15,1307,3860,30
116236468039,116236468038,-1,1199,2402,30
116244859350,116244859346,-4,833,3471,30
116246372338,116246372334,-4,969,2853,30
116249734435,116249734431,-4,1183,3487,30
116253172891,116253172881,-10,23211,15403,30
116253922435,116253922430,-5,926,2911,30
116256109702,116256109697,-5,1256,2836,30
116256747545,116256747547,2,214,922,30
116259270308,116259270305,-3,949,2463,30
116259848010,116259848015,5,208,798,30
116265498786,116265498786,0,709,854,30
116266615173,116266615168,-5,905,2994,30
116268211075,116268211078,3,1441,813,30
116268809293,116268809286,-7,1178,2575,30
116269050897,116269050902,5,4,1173,30
116269375427,116269375445,18,885,2638,30
116269707197,116269707193,-4,1181,2358,30
116270539025,116270539026,1,7173,6774,30
116277845379,116277845372,-7,1045,4005,30
116280294582,116280294578,-4,1400,2437,30
116289472801,116289472796,-5,1009,1895,30
116290540606,116290540602,-4,870,3368,30
116292057415,116292057413,-2,739,1623,30
116292286111,116292286105,-6,1076,2280,30
116295073109,116295073105,-4,1070,3839,30
116295780399,116295780394,-5,852,2958,30
116301258621,116301258616,-5,1054,2725,30
116303214211,116303214205,-6,972,2228,30
116304293704,116304293717,13,311,1295,30
116305847060,116305847054,-6,1126,4606,30
116307670792,116307670814,22,965,2859,30
116308520200,116308520197,-3,931,2624,30
116312411435,116312411430,-5,1545,3766,30
116316193570,116316193566,-4,1243,4103,30
116319954127,116319954121,-6,889,3335,30
116326527362,116326527357,-5,720,2125,30
116327867038,116327867034,-4,1649,3446,30
116328644082,116328644078,-4,1111,3192,30
116332549506,116332549502,-4,909,3666,30
116334225603,116334225601,-2,1108,2497,30
116341964263,116341964258,-5,921,2393,30
116348424395,116348424389,-6,876,1892,30
116348861985,116348862001,16,109,790,30
116358215158,116358215155,-3,1407,2264,30
116358946122,116358946137,15,234,1146,30
116359895821,116359895816,-5,1197,2497,30
116364740889,116364740886,-3,1020,1435,30
116367794694,116367794691,-3,1042,3141,30
116369528225,116369528219,-6,1069,2697,30
116370754052,116370754058,6,2526,1224,30
116374393409,116374393406,-3,1170,2583,30
116380480744,116380480739,-5,1274,2550,30
116382232250,116382232246,-4,1137,2916,30
116385980171,116385980165,-6,760,2761,30
116388136594,116388136590,-4,1161,2931,30
116395524413,116395524411,-2,1638,2571,30
116395920035,116395920031,-4,1337,3642,30
116396800990,116396800986,-4,1068,2597,30
116401670974,116401670972,-2,1250,2546,30
116402367177,116402367178,1,1830,3205,30
116405552268,116405552265,-3,1059,2724,30
116407951525,116407951520,-5,478,927,30
116415366117,116415366112,-5,1145,2606,30
116417074278,116417074273,-5,676,1248,30
116420711277,116420711278,1,1371,2483,30
116422383828,116422383822,-6,410,832,30
116423843234,116423843228,-6,654,1847,30
116435662613,116435662610,-3,1388,1840,30
116438169794,116438169801,7,7290,2553,30
116438614078,116438614073,-5,733,1965,30
116440291699,116440291692,-7,1004,3796,30
116450442130,116450442125,-5,1066,2479,30
116452012595,116452012591,-4,1557,3149,30
116457902071,116457902068,-3,1066,3248,30
116463336199,116463336196,-3,611,1935,30
116471507215,116471507210,-5,969,2721,30
116472277200,116472277220,20,815,3025,30
116474377036,116474377030,-6,1326,3174,30
116475095989,116475095986,-3,1021,1943,30
116476203129,116476203146,17,852,1853,30
116477189751,116477189745,-6,968,2305,30
116478250712,116478250730,18,341,1060,30
116485487150,116485487147,-3,1170,3101,30
116488189882,116488189883,1,1622,1643,30
116490029490,116490029484,-6,863,3257,30
116501077302,116501077298,-4,1287,3983,30
116504185122,116504185118,-4,860,2564,30
116510215170,116510215166,-4,1051,2553,30
116511492502,116511492499,-3,830,2658,30
116514003630,116514003626,-4,1269,2673,30
116515503673,116515503668,-5,787,2150,30
116520059897,116520059894,-3,207,1119,30
116526347355,116526347351,-4,1083,2660,30
116527705713,116527705711,-2,1229,2149,30
116533013223,116533013218,-5,917,2666,30
116533760940,116533760958,18,525,1764,30
116538468791,116538468787,-4,668,2104,30
116541880092,116541880087,-5,1272,3232,30
116542269990,116542269985,-5,901,2508,30
116545951767,116545951768,1,1286,1299,30
116550538113,116550538108,-5,1540,3263,30
116551090137,116551090159,22,1330,3484,30
116552494901,116552494905,4,6386,21974,30
116556673074,116556673069,-5,1186,2519,30
116559052343,116559052337,-6,931,2866,30
116564365330,116564365331,1,1008,1587,30
116567060983,116567060977,-6,768,3560,30
116569217836,116569217837,1,3187,3175,30
116574456734,116574456730,-4,768,3100,30
116576037811,116576037806,-5,929,3472,30
116577432239,116577432234,-5,833,2284,30
116580494302,116580494297,-5,1194,2641,30
116586431347,116586431341,-6,1082,3707,30
116593063632,116593063635,3,2046,1297,30
116595322366,116595322361,-5,916,2482,30
116597654519,116597654522,3,2212,1744,30
116606714557,116606714552,-5,1015,2212,30
116616534222,116616534218,-4,1748,1181,30
116617422813,116617422809,-4,1085,2284,30
116621150099,116621150095,-4,1047,3132,30
116621484681,116621484703,22,558,1999,30
116627253766,116627253766,0,1287,1834,30
116636217287,116636217284,-3,963,1227,30
116649755603,116649755590,-13,229,973,30
116650155011,116650155005,-6,870,3384,30
116651733763,116651733782,19,1006,3152,30
116655481611,116655481606,-5,1073,2474,30
116655830402,116655830423,21,262,1227,30
116657039579,116657039573,-6,1459,2658,30
116662687715,116662687722,7,4861,2371,30
116665362251,116665362247,-4,899,3771,30
116666097598,116666097594,-4,1242,2438,30
116667174997,116667174990,-7,668,1736,30
116670174099,116670174094,-5,12,932,30
116672885438,116672885433,-5,974,2647,30
116674407614,116674407610,-4,996,2168,30
116675266979,116675266962,-17,495,1814,30
116675715617,116675715612,-5,1225,3666,30
116681223190,116681223185,-5,1169,2448,30
116682218839,116682218836,-3,1210,3453,30
116682721091,116682721087,-4,1088,3992,30
116683312520,116683312543,23,746,2411,30
116684338318,116684338314,-4,1139,2896,30
116685437919,116685437898,-21,238,1510,30
116691214783,116691214779,-4,1736,3522,30
116695649976,116695649970,-6,1011,2958,30
116699769832,116699769841,9,13152,35569,30
116704947393,116704947389,-4,1288,2695,30
116712545906,116712545902,-4,1196,2824,30
116713269497,116713269491,-6,1042,2572,30
116716225118,116716225114,-4,1292,3075,30
116718139012,116718139006,-6,1395,3852,30
116718221928,116718221942,14,333,1337,30
116718647103,116718647098,-5,1047,2335,30
116718677264,116718677258,-6,768,2038,30
116721253094,116721253089,-5,1329,3143,30
116726012006,116726012006,0,1179,2356,30
116740795852,116740795849,-3,667,1477,30
116741527959,116741527954,-5,1222,2966,30
116746754969,116746754967,-2,1205,1512,30
116751126318,116751126315,-3,1014,3264,30
116758497046,116758497043,-3,1199,3230,30
116759833363,116759833359,-4,1303,2458,30
116765214678,116765214675,-3,3432,7736,30
116768241574,116768241571,-3,598,1322,30
116770838050,116770838046,-4,837,3173,30
116774266426,116774266410,-16,973,2558,30
116774363522,116774363518,-4,815,3478,30
116781293115,116781293110,-5,872,2098,30
116781588867,116781588885,18,392,1045,30
116781759663,116781759659,-4,966,2664,30
116782573022,116782573023,1,866,1164,30
116786013269,116786013274,5,3821,1680,30
116787298178,116787298173,-5,939,3189,30
116793618362,116793618368,6,9626,5020,30
116796438259,116796438255,-4,867,2339,30
116797679933,116797679929,-4,538,1326,30
116800103149,116800103143,-6,779,1936,30
116801723634,116801723632,-2,1362,2320,30
116814316978,116814316974,-4,1122,3248,30
116814636174,116814636169,-5,1043,3225,30
116815735908,116815735902,-6,1365,3631,30
116817521970,116817521965,-5,1294,3270,30
116819018079,116819018074,-5,991,3289,30
116822304075,116822304077,2,2115,1590,30
116825316724,116825316731,7,2183,676,30
116827023769,116827023765,-4,1258,2830,30
116827372273,116827372259,-14,318,794,30
116828796882,116828796878,-4,1447,3575,30
116829461094,116829461094,0,2154,2862,30
116829992502,116829992497,-5,1054,2123,30
116832533463,116832533458,-5,829,2596,30
116835357815,116835357811,-4,964,3211,30
116838640805,116838640801,-4,1629,3668,30
116840789235,116840789230,-5,1033,2214,30
116845463894,116845463890,-4,1548,3210,30
116846264562,116846264557,-5,949,3015,30
116846387323,116846387342,19,530,606,30
116852851559,116852851555,-4,554,1967,30
116853259432,116853259424,-8,1472,3252,30
116853459044,116853459058,14,459,1742,30
116853871391,116853871388,-3,1124,3382,30
116854287041,116854287058,17,619,2949,30
116855748644,116855748638,-6,999,3369,30
116856408236,116856408245,9,155,826,30
116859227603,116859227599,-4,552,2002,30
116860608923,116860608917,-6,28,776,30
116860935081,116860935075,-6,802,2689,30
116861111949,116861111945,-4,1257,2887,30
116863756486,116863756480,-6,1173,2131,30
116863856456,116863856450,-6,956,3188,30
116864607318,116864607314,-4,747,2159,30
116867684889,116867684887,-2,2252,4662,30
116875454289,116875454283,-6,1201,3181,30
116877404075,116877404074,-1,1174,2241,30
116880127729,116880127725,-4,2682,7642,30
116880746662,116880746658,-4,915,1690,30
116884416018,116884416015,-3,880,2077,30
116885680554,116885680550,-4,1370,3258,30
116890292802,116890292799,-3,1344,2641,30
116898248199,116898248194,-5,1349,2932,30
116899503223,116899503226,3,2030,1528,30
116901413203,116901413198,-5,766,2434,30
116902185691,116902185695,4,340,990,30
116907855688,116907855684,-4,1261,3747,30
116911509493,116911509486,-7,892,2819,30
116914936886,116914936888,2,2934,2538,30
116919896944,116919896940,-4,1061,3134,30
116920724298,116920724285,-13,1050,2635,30
116921084384,116921084378,-6,1122,2060,30
116929360479,116929360474,-5,1046,3409,30
116933207328,116933207322,-6,546,2778,30
116933269524,116933269519,-5,879,3387,30
116934478693,116934478693,0,2106,1782,30
116936950665,116936950660,-5,990,2810,30
116937002917,116937002912,-5,1008,2504,30
116939158514,116939158508,-6,1108,4432,30
116940957062,116940957059,-3,1163,3210,30
116943786130,116943786125,-5,659,2283,30
116944853954,116944853949,-5,1105,2652,30
116945805018,116945805013,-5,872,3391,30
116948306718,116948306714,-4,871,3573,30
116949527941,116949527937,-4,1015,3492,30
116950995180,116950995192,12,933,2296,30
116953118737,116953118733,-4,433,1629,30
116953654457,116953654452,-5,889,3604,30
116954198569,116954198564,-5,905,2855,30
116954273136,116954273138,2,181,596,30
116955840323,116955840319,-4,1148,2231,30
116957529194,116957529198,4,1351,1789,30
116959737977,116959737978,1,1550,1291,30
116965299530,116965299526,-4,751,1958,30
116966771028,116966771022,-6,792,1559,30
116968777434,116968777442,8,3487,1583,30
116970267326,116970267320,-6,1232,3310,30
116977343377,116977343379,2,163,987,30
116978495427,116978495422,-5,1193,2509,30
116980046253,116980046250,-3,1241,2768,30
116982973685,116982973679,-6,725,2626,30
116983385692,116983385704,12,448,1857,30
116984580854,116984580851,-3,1049,2204,30
116984982415,116984982411,-4,1016,2174,30
116985406806,116985406802,-4,1018,3673,30
116985922674,116985922670,-4,1311,2927,30
116986478347,116986478343,-4,812,1857,30
116988817311,116988817317,6,2603,1739,30
116990038523,116990038524,1,1550,1767,30
116996211238,116996211234,-4,860,2676,30
116999241334,116999241331,-3,1210,2616,30
117002650537,117002650534,-3,1456,3580,30
117006071871,117006071870,-1,754,983,30
117006507605,117006507598,-7,1069,2987,30
117007887411,117007887406,-5,1112,3430,30
117010599534,117010599530,-4,994,3618,30
117015895782,117015895777,-5,1108,2610,30
117017722913,117017722911,-2,1200,2499,30
117017755687,117017755683,-4,1664,3152,30
117022192413,117022192409,-4,772,1944,30
117023191256,117023191251,-5,795,2586,30
117029155225,117029155221,-4,997,2060,30
117030797168,117030797166,-2,1877,3016,30
117033178480,117033178477,-3,1790,3295,30
117035093586,117035093584,-2,1181,3315,30
117042334655,117042334661,6,6190,2891,30
117043091188,117043091184,-4,1444,3990,30
117045025102,117045025103,1,49395,25368,30
117049285754,117049285761,7,5849,1832,30
117056192858,117056192854,-4,1274,2647,30
117056507043,117056507053,10,7,3378,30
117059428740,117059428735,-5,1085,2640,30
117065970253,117065970249,-4,1276,2966,30
117066467509,117066467504,-5,1005,2928,30
117066982437,117066982434,-3,1604,3107,30
117070156859,117070156853,-6,842,2615,30
117071003019,117071003013,-6,798,1621,30
117073949706,117073949702,-4,1459,2687,30
117074084334,117074084330,-4,946,2570,30
117081057255,117081057250,-5,646,1106,30
117081364857,117081364853,-4,887,2145,30
117083166798,117083166796,-2,1093,2397,30
117084526665,117084526662,-3,829,2960,30
117091054639,117091054634,-5,752,2751,30
117093927619,117093927616,-3,1330,3107,30
117096098737,117096098733,-4,820,2061,30
117096329547,117096329562,15,1315,3722,30
117098685352,117098685346,-6,1344,2846,30
117101679505,117101679504,-1,742,2859,30
117101824347,117101824351,4,169,1198,30
117104047874,117104047869,-5,963,2442,30
117106715990,117106715986,-4,963,2897,30
117111736249,117111736245,-4,682,2308,30
117115710838,117115710838,0,1857,1936,30
117120369412,117120369406,-6,887,2130,30
117123617051,117123617046,-5,1109,1874,30
117131111171,117131111167,-4,968,1776,30
117137250968,117137250964,-4,1101,2599,30
117140767059,117140767061,2,165,893,30
117145764651,117145764648,-3,1260,2819,30
117148996307,117148996304,-3,451,1509,30
117149478202,117149478200,-2,98,755,30
117150720514,117150720507,-7,182,870,30
117151191955,117151191950,-5,1082,3115,30
117154095921,117154095919,-2,1253,2734,30
117156486901,117156486897,-4,1218,3196,30
117157662153,117157662174,21,1400,2321,30
117157934203,117157934199,-4,847,2303,30
117159119901,117159119895,-6,761,2048,30
117159925099,117159925103,4,2495,1239,30
117161484181,117161484179,-2,1210,3884,30
117166020430,117166020425,-5,1296,3066,30
117171565871,117171565866,-5,1110,2762,30
117171822740,117171822746,6,114,1361,30
117179755802,117179755801,-1,1572,2502,30
117182499062,117182499065,3,2025,1496,30
117184796039,117184796035,-4,911,2933,30
117193765537,117193765532,-5,921,2328,30
117197902200,117197902193,-7,942,2527,30
117198717297,117198717293,-4,927,2023,30
117199232358,117199232354,-4,881,2470,30
117201449164,117201449161,-3,1141,2535,30
117203386752,117203386747,-5,698,2687,30
117204176712,117204176726,14,194,945,30
117204540503,117204540496,-7,2345,7386,30
117208336748,117208336743,-5,864,1671,30
117214180446,117214180442,-4,1084,2125,30
117214604332,117214604327,-5,1310,4251,30
117215328434,117215328427,-7,1131,3905,30
117220617965,117220617959,-6,1265,2874,30
117226597985,117226597978,-7,1206,2526,30
117226986905,117226986927,22,840,1942,30
117236774858,117236774855,-3,1158,2827,30
117242693800,117242693796,-4,1061,2522,30
117247169535,117247169529,-6,943,2635,30
117248939915,117248939914,-1,1301,2225,30
117249242324,117249242319,-5,1452,3088,30
117249818119,117249818114,-5,1132,2564,30
117254460814,117254460810,-4,824,2885,30
117254771703,117254771714,11,12321,23441,30
117261733778,117261733774,-4,958,2646,30
117264165762,117264165758,-4,1122,3015,30
117265335066,117265335081,15,503,1046,30
117271720958,117271720953,-5,1003,3096,30
117279023791,117279023794,3,2679,1648,30
117280236220,117280236213,-7,1640,8305,30
117291396042,117291396035,-7,675,2850,30
117293139003,117293138999,-4,654,2507,30
117298466797,117298466794,-3,1446,3231,30
117300028505,117300028509,4,1960,1066,30
117301387681,117301387681,0,1407,1428,30
117307094455,117307094450,-5,1076,2642,30
117316687076,117316687073,-3,1272,2907,30
117321101551,117321101547,-4,1015,2977,30
117323037921,117323037917,-4,1107,3558,30
117331671479,117331671477,-2,1322,2553,30
117336780658,117336780653,-5,861,3447,30
117337181112,117337181105,-7,1461,3354,30
117337274642,117337274658,16,1319,2398,30
117337701761,117337701757,-4,1022,2830,30
117337885791,117337885786,-5,1045,2442,30
117341312723,117341312719,-4,1760,3970,30
117342525055,117342525051,-4,1376,2962,30
117346995622,117346995618,-4,978,1966,30
117356608882,117356608875,-7,991,3255,30
117362033341,117362033342,1,1534,1891,30
117363744185,117363744182,-3,975,2586,30
117369005130,117369005127,-3,1506,2615,30
117369056501,117369056496,-5,943,2630,30
117371461725,117371461721,-4,1059,4175,30
117374362706,117374362701,-5,965,2254,30
117374693499,117374693477,-22,1162,3498,30
117375041808,117375041826,18,861,2629,30
117376130389,117376130384,-5,918,2164,30
117376576858,117376576854,-4,1172,2358,30
117377834635,117377834632,-3,714,809,30
117382343847,117382343842,-5,1170,3479,30
117383134537,117383134536,-1,1048,1232,30
117386592537,117386592535,-2,2923,4372,30
117387733953,117387733949,-4,1358,3394,30
117387820634,117387820631,-3,666,1402,30
117391039789,117391039782,-7,1192,3768,30
117402288346,117402288347,1,3307,3297,30
117405063008,117405063022,14,1002,2503,30
117406452313,117406452308,-5,1503,4638,30
117408105775,117408105779,4,1894,1324,30
117408675393,117408675389,-4,1208,2509,30
117409984630,117409984625,-5,1136,2286,30
117412632718,117412632713,-5,1050,2940,30
117414992638,117414992633,-5,1018,2755,30
117415269116,117415269134,18,1097,2225,30
117416928987,117416928982,-5,1020,3110,30
117420811804,117420811798,-6,942,3190,30
117421451046,117421451042,-4,873,2281,30
117421935386,117421935376,-10,1724,2902,30
117422262484,117422262497,13,73,1382,30
117422666577,117422666573,-4,1564,2960,30
117426364052,117426364047,-5,407,805,30
117435135175,117435135172,-3,595,1876,30
117435195450,117435195443,-7,908,3710,30
117437542817,117437542809,-8,1812,7396,30
117441577197,117441577190,-7,880,3432,30
117447375141,117447375136,-5,920,2308,30
117449977883,117449977877,-6,1063,2391,30
117463625927,117463625923,-4,735,1411,30
117467179595,117467179599,4,18992,21764,30
117476823435,117476823432,-3,1019,2333,30
117478801145,117478801142,-3,1751,3667,30
117479076322,117479076318,-4,1019,2796,30
117481700726,117481700725,-1,1108,2867,30
117482934086,117482934082,-4,1379,3785,30
117485244061,117485244057,-4,1494,2772,30
117488128053,117488128050,-3,1415,3868,30
117490247951,117490247950,-1,2124,3232,30
117495342074,117495342070,-4,1405,3054,30
117496585362,117496585361,-1,711,1186,30
117496688248,117496688257,9,499,1120,30
117511980844,117511980837,-7,1504,3451,30
117515352526,117515352518,-8,741,1421,30
117515903994,117515903990,-4,967,3108,30
117516059152,117516059157,5,28,664,30
117516405390,117516405387,-3,1126,2176,30
117516583450,117516583445,-5,1174,4321,30
117520508362,117520508358,-4,1440,4488,30
117521074206,117521074203,-3,1174,2610,30
117521781985,117521781979,-6,195,820,30
117525680190,117525680186,-4,1076,2275,30
117526115857,117526115875,18,216,770,30
117533408017,117533408015,-2,1149,2757,30
117535290771,117535290769,-2,1028,1560,30
117536377045,117536377039,-6,1237,2820,30
117536670746,117536670741,-5,674,1764,30
117537333028,117537333042,14,1012,1294,30
117546459010,117546459005,-5,1016,4239,30
117551637325,117551637320,-5,1497,4452,30
117557805638,117557805633,-5,644,2312,30
117559511725,117559511720,-5,1054,4190,30
117561886856,117561886850,-6,1407,3089,30
117564170314,117564170308,-6,1003,4139,30
117564273453,117564273450,-3,1423,3641,30
117571014683,117571014679,-4,1473,2949,30
117572857234,117572857254,20,684,2067,30
117575313882,117575313877,-5,698,1970,30
117578718667,117578718673,6,2557,1355,30
117578768415,117578768410,-5,817,2755,30
117581238893,117581238888,-5,824,2777,30
117582678288,117582678310,22,436,1210,30
117589354582,117589354578,-4,914,2516,30
117593076494,117593076492,-2,1043,1860,30
117601054378,117601054374,-4,827,3177,30
117601472026,117601472022,-4,864,2948,30
117606242294,117606242290,-4,1174,2493,30
117619586665,117619586662,-3,946,1772,30
117619740816,117619740800,-16,168,788,30
117621610658,117621610655,-3,1688,2915,30
117623657530,117623657528,-2,1025,2113,30
117627330458,117627330454,-4,884,2652,30
117629143394,117629143390,-4,1384,3594,30
117630915506,117630915500,-6,1223,3677,30
117630994634,117630994642,8,60,1039,30
117640309966,117640309948,-18,2687,1348,30
117641511859,117641511854,-5,1166,3416,30
117647954475,117647954472,-3,934,3302,30
117648334133,117648334129,-4,1185,2612,30
117669167773,117669167769,-4,919,2288,30
117671025219,117671025214,-5,1010,2661,30
117673446711,117673446706,-5,1054,5023,30
117676734542,117676734538,-4,1440,3210,30
117679152510,117679152506,-4,1423,2983,30
117685612798,117685612794,-4,1058,2427,30
117694765441,117694765437,-4,664,2449,30
117699385322,117699385319,-3,744,2122,30
117699750435,117699750426,-9,1027,2802,30
117700209212,117700209209,-3,1410,2505,30
117701160113,117701160093,-20,1205,3919,30
117704269315,117704269312,-3,2386,5138,30
117704974850,117704974847,-3,1261,3695,30
117706281716,117706281718,2,1624,1464,30
117711677159,117711677160,1,2090,2311,30
117711751943,117711751938,-5,1311,2171,30
117717082619,117717082614,-5,733,1887,30
117720117518,117720117519,1,27968,32089,30
117723934146,117723934141,-5,1172,3315,30
117729061214,117729061209,-5,627,1519,30
117730256866,117730256885,19,1472,2794,30
117732865280,117732865277,-3,808,2177,30
117733869327,117733869321,-6,998,2788,30
117737590561,117737590558,-3,596,1553,30
117737921242,117737921238,-4,1126,2214,30
117742902465,117742902462,-3,867,2350,30
117743128041,117743128057,16,694,1275,30
117748446154,117748446150,-4,829,2336,30
117749471437,117749471431,-6,1304,2738,30
117753712478,117753712474,-4,735,2348,30
117753774515,117753774521,6,139,885,30
117754179113,117754179106,-7,674,2130,30
117754250807,117754250803,-4,653,1560,30
117755562962,117755562959,-3,1209,2827,30
117756200262,117756200257,-5,1808,6023,30
117757829625,117757829630,5,2957,1134,30
117766383787,117766383783,-4,669,3045,30
117767129067,117767129062,-5,863,3665,30
117775500793,117775500786,-7,1299,2284,30
117778270053,117778270048,-5,733,2607,30
117780312262,117780312257,-5,1173,3076,30
117781908576,117781908573,-3,916,2340,30
117789004695,117789004691,-4,1023,2817,30
117791354056,117791354049,-7,924,3380,30
117791510896,117791510893,-3,162,873,30
117797325033,117797325029,-4,972,2979,30
117801053066,117801053066,0,1035,1656,30
117804806433,117804806427,-6,1198,3214,30
117805536120,117805536114,-6,938,3029,30
117810418002,117810417998,-4,834,1893,30
117813759863,117813759857,-6,1476,3623,30
117816686483,117816686480,-3,1307,2567,30
117817394982,117817394985,3,1737,2136,30
117817524999,117817524991,-8,1006,3058,30
117817744236,117817744254,18,428,2176,30
117819909634,117819909629,-5,1103,3505,30
117826410994,117826410991,-3,994,2157,30
117830670235,117830670231,-4,952,1571,30
117831248051,117831248048,-3,1134,3030,30
117833557914,117833557910,-4,803,3104,30
117841395693,117841395689,-4,1351,2320,30
117846067334,117846067330,-4,749,770,30
117853800210,117853800207,-3,1003,2938,30
117855125790,117855125788,-2,2608,10848,30
117861057557,117861057554,-3,1343,2734,30
117861733083,117861733102,19,1042,1912,30
117862236506,117862236503,-3,781,2382,30
117863548212,117863548209,-3,1004,2940,30
117866743415,117866743411,-4,534,1517,30
117868276134,117868276130,-4,666,2726,30
117869731638,117869731633,-5,1042,3747,30
117874336030,117874336024,-6,905,4050,30
117879361931,117879361925,-6,888,2205,30
117882979905,117882979898,-7,890,2910,30
117885505497,117885505493,-4,797,2445,30
117892800019,117892800017,-2,1438,2686,30
117895488543,117895488540,-3,1105,2203,30
117895884080,117895884098,18,162,958,30
117897036551,117897036547,-4,1674,2652,30
117904888214,117904888210,-4,2413,4968,30
117906206949,117906206955,6,3464,1463,30
117908426405,117908426402,-3,963,2622,30
117911564859,117911564854,-5,973,2242,30
117914895004,117914894999,-5,1403,3457,30
117916160611,117916160606,-5,1086,2513,30
117923068586,117923068581,-5,1205,3100,30
117924486879,117924486876,-3,906,2606,30
117924853486,117924853504,18,144,1169,30
117926600837,117926600833,-4,2158,4711,30
117933958333,117933958328,-5,1705,4412,30
117935971683,117935971678,-5,1712,3937,30
117936426073,117936426077,4,2869,1860,30
117938900878,117938900875,-3,1137,3703,30
117947174471,117947174466,-5,948,2243,30
117961051167,117961051162,-5,1228,2580,30
117966542209,117966542203,-6,1110,3597,30
117973218114,117973218110,-4,820,1688,30
117979963423,117979963418,-5,816,2837,30
117980022250,117980022246,-4,973,3699,30
117980570865,117980570887,22,942,3023,30
117994154683,117994154678,-5,1393,3245,30
117999693676,117999693671,-5,787,2629,30
118004354658,118004354655,-3,63088,46501,30
118007826680,118007826678,-2,1014,2567,30
118010255566,118010255561,-5,905,2630,30
118012067646,118012067644,-2,4128,9464,30
118014090947,118014090942,-5,1020,3641,30
118014902897,118014902892,-5,1885,8142,30
118020549374,118020549371,-3,1267,4270,30
118023529598,118023529594,-4,1578,2830,30
118023812194,118023812174,-20,746,2355,30
118023894492,118023894481,-11,217,1288,30
118024597859,118024597874,15,986,4145,30
118024995703,118024995694,-9,781,2520,30
118035756938,118035756934,-4,1289,2618,30
118039324947,118039324941,-6,988,3304,30
118040205578,118040205567,-11,777,2868,30
118045189760,118045189756,-4,994,3688,30
118046179147,118046179141,-6,561,1714,30
118052173738,118052173731,-7,1281,4153,30
118052857074,118052857073,-1,1151,1780,30
118054855264,118054855258,-6,759,2011,30
118057312245,118057312239,-6,932,3302,30
118057811131,118057811109,-22,941,2879,30
118058227000,118058226994,-6,956,2250,30
118058908974,118058908970,-4,753,2864,30
118059150531,118059150509,-22,1077,3279,30
118059393864,118059393886,22,571,1122,30
118061853586,118061853582,-4,1295,3184,30
118068610190,118068610193,3,2015,1393,30
118080228674,118080228682,8,12510,23327,30
118083848255,118083848250,-5,872,2967,30
118086321686,118086321682,-4,1307,2722,30
118088745801,118088745798,-3,1149,1934,30
118091536703,118091536701,-2,796,2804,30
118091948081,118091948065,-16,1286,3063,30
118092722394,118092722389,-5,1311,2705,30
118101223673,118101223668,-5,1171,2900,30
118101869306,118101869302,-4,875,2372,30
118103634999,118103634997,-2,977,2554,30
118103994536,118103994520,-16,952,4908,30
118110706961,118110706963,2,1781,1736,30
118114686546,118114686541,-5,1218,3896,30
118116777285,118116777279,-6,1299,2273,30
118119352123,118119352129,6,6737,2360,30
118120041064,118120041057,-7,1357,4950,30
118120584641,118120584622,-19,87,1494,30
118123855880,118123855898,18,322,1096,30
118124998802,118124998818,16,267,936,30
118126866210,118126866206,-4,1228,2928,30
118131406836,118131406832,-4,1220,2568,30
118139168986,118139168982,-4,720,2209,30
118141547249,118141547244,-5,1236,4130,30
118142941814,118142941807,-7,927,3189,30
118143670492,118143670488,-4,1224,3847,30
118161376746,118161376744,-2,1044,1480,30
118162524602,118162524599,-3,1210,2725,30
118170241874,118170241868,-6,1122,3258,30
118173351366,118173351347,-19,1078,1391,30
118176186281,118176186274,-7,1082,2617,30
118182520926,118182520921,-5,830,2201,30
118182856000,118182855994,-6,1451,5906,30
118184824990,118184824985,-5,408,1618,30
118189205842,118189205839,-3,1028,2592,30
118189390586,118189390578,-8,253,313,30
118195964231,118195964229,-2,1107,2308,30
118196086786,118196086794,8,3738,1095,30
118198519580,118198519575,-5,1578,2969,30
118199251602,118199251622,20,1073,3111,30
118199332772,118199332770,-2,850,2641,30
118201102995,118201102995,0,893,1512,30
118201575989,118201575993,4,1801,235,30
118204430155,118204430149,-6,694,2275,30
118208933854,118208933850,-4,628,2848,30
118211308714,118211308709,-5,1019,2940,30
118212632196,118212632214,18,924,4565,30
118215056209,118215056205,-4,1050,2814,30
118222829810,118222829805,-5,1200,2794,30
118223386250,118223386239,-11,215,842,30
118223622126,118223622120,-6,1138,3415,30
118224098567,118224098562,-5,961,2202,30
118227174560,118227174561,1,1461,1245,30
118228765942,118228765937,-5,1079,3205,30
118231635575,118231635571,-4,793,1774,30
118243204625,118243204617,-8,1671,7340,30
118249156822,118249156819,-3,586,1438,30
118249694025,118249694020,-5,871,1694,30
118252479843,118252479847,4,2851,1728,30
118255597095,118255597090,-5,1304,2996,30
118255695566,118255695562,-4,1107,3295,30
118258833814,118258833809,-5,1394,3548,30
118267612820,118267612815,-5,787,2095,30
118279197726,118279197722,-4,996,2008,30
118281817871,118281817868,-3,1049,2362,30
118283113691,118283113686,-5,907,2674,30
118285381589,118285381585,-4,864,2262,30
118286344508,118286344502,-6,1213,3057,30
118286515269,118286515266,-3,1785,2768,30
118311715945,118311715941,-4,1767,3714,30
118318349319,118318349319,0,1569,1674,30
118320073002,118320072998,-4,1406,3452,30
118320610225,118320610219,-6,1103,2640,30
118324320469,118324320471,2,1451,2002,30
118324570857,118324570874,17,260,832,30
118325048101,118325048101,0,724,2379,30
118325227494,118325227476,-18,957,133,30
118326323903,118326323898,-5,701,2173,30
118331690409,118331690402,-7,972,3199,30
118331744386,118331744393,7,422,2250,30
118335473352,118335473348,-4,28239,13180,30
118350358748,118350358743,-5,1284,4300,30
118354887267,118354887261,-6,779,2366,30
118355961899,118355961898,-1,1630,2056,30
118360811510,118360811505,-5,1033,2767,30
118368398214,118368398210,-4,1025,2605,30
118369571789,118369571784,-5,990,2204,30
118369793619,118369793627,8,102,737,30
118371171447,118371171441,-6,1365,3898,30
118373760994,118373760990,-4,1188,3002,30
118374847621,118374847626,5,3022,1509,30
118383400321,118383400339,18,563,1838,30
118390643882,118390643877,-5,729,3122,30
118396205023,118396205018,-5,869,2052,30
118396777521,118396777525,4,3016,1081,30
118397072453,118397072450,-3,1528,2534,30
118400295653,118400295649,-4,816,2560,30
118401597446,118401597449,3,3389,2013,30
118408174832,118408174826,-6,973,2366,30
118408855965,118408855969,4,1942,1531,30
118420199984,118420199977,-7,1085,2880,30
118420994955,118420994953,-2,1266,2680,30
118421044226,118421044209,-17,929,2909,30
118422316635,118422316629,-6,64,250,30
118425295170,118425295166,-4,1345,2739,30
118426476574,118426476581,7,12563,56478,30
118428986307,118428986305,-2,966,2615,30
118433274910,118433274906,-4,1192,3050,30
118437060578,118437060574,-4,1223,2414,30
118438236199,118438236195,-4,1218,3149,30
118439368767,118439368761,-6,1036,4574,30
118440555102,118440555098,-4,1102,2267,30
118442435057,118442435051,-6,951,2622,30
118443351884,118443351880,-4,964,3319,30
118444383094,118444383090,-4,1044,3796,30
118444934758,118444934753,-5,1255,3133,30
118446451302,118446451296,-6,1043,3208,30
118446650905,118446650926,21,437,1709,30
118458928181,118458928177,-4,1252,3568,30
118464060805,118464060800,-5,806,1558,30
118466391028,118466391024,-4,1118,2657,30
118466623276,118466623286,10,440,2853,30
118467225781,118467225786,5,5716,1971,30
118472930075,118472930074,-1,1180,1924,30
118475177715,118475177710,-5,1241,2603,30
118476044721,118476044719,-2,675,1587,30
118480058174,118480058169,-5,849,2727,30
118480423619,118480423598,-21,2,1072,30
118484671043,118484671037,-6,938,2000,30
118484936649,118484936665,16,617,1701,30
118487900929,118487900924,-5,1161,3838,30
118488869154,118488869150,-4,1050,2843,30
118492315202,118492315195,-7,1772,4514,30
118495117082,118495117077,-5,1401,2760,30
118503584479,118503584474,-5,1227,4174,30
118528129266,118528129261,-5,1102,2610,30
118528675244,118528675242,-2,1208,2454,30
118532111899,118532111878,-21,4779,4904,30
118538756375,118538756370,-5,1324,3033,30
118538966313,118538966310,-3,1134,1681,30
118542198595,118542198589,-6,1491,4048,30
118544784767,118544784765,-2,859,2116,30
118545668728,118545668721,-7,995,2452,30
118556577488,118556577485,-3,922,2063,30
118558597147,118558597129,-18,928,3978,30
118558919194,118558919187,-7,1140,3639,30
118559369523,118559369518,-5,1161,2870,30
118562785866,118562785861,-5,809,3038,30
118563131829,118563131829,0,6528,9673,30
118567009951,118567009947,-4,786,3131,30
118568000842,118568000838,-4,782,2795,30
118572558145,118572558141,-4,1493,3385,30
118572804308,118572804303,-5,1352,3353,30
118573656378,118573656398,20,1113,2700,30
118573748388,118573748406,18,509,1933,30
118575060970,118575060964,-6,1036,3735,30
118579012971,118579012967,-4,1261,2968,30
118580709653,118580709671,18,699,1806,30
118583241350,118583241349,-1,986,1954,30
118583349513,118583349515,2,77,1049,30
118584812806,118584812801,-5,714,1884,30
118594474182,118594474181,-1,1251,3230,30
118594553545,118594553530,-15,6,898,30
118594950102,118594950095,-7,1371,3638,30
118595420570,118595420566,-4,64,1103,30
118596846195,118596846207,12,1221,6046,30
118602948225,118602948221,-4,918,3100,30
118603150329,118603150350,21,972,3098,30
118607214858,118607214854,-4,1276,2339,30
118607476790,118607476805,15,15813,55017,30
118608921019,118608921026,7,2823,1022,30
118610410982,118610410977,-5,1356,3018,30
118612406535,118612406530,-5,707,2815,30
118613942590,118613942585,-5,963,3078,30
118618212035,118618212046,11,12188,39923,30
118619327980,118619327975,-5,1226,2515,30
118622306949,118622306943,-6,1202,3754,30
118623844623,118623844622,-1,1360,2018,30
118629027078,118629027073,-5,1280,3636,30
118629093913,118629093925,12,196,1007,30
118643225851,118643225846,-5,949,2918,30
118650918680,118650918682,2,2711,2294,30
118653721823,118653721817,-6,1076,3464,30
118653898305,118653898311,6,2315,1050,30
118653945601,118653945605,4,2194,1140,30
118659447649,118659447644,-5,2393,5747,30
118661015607,118661015606,-1,1408,2017,30
118665881045,118665881040,-5,1087,3275,30
118675820854,118675820847,-7,500,1269,30
118679811539,118679811534,-5,329,1486,30
118679963147,118679963143,-4,775,1505,30
118681409662,118681409659,-3,1131,2310,30
118682330927,118682330922,-5,1310,2526,30
118684483713,118684483709,-4,1167,2750,30
118686542313,118686542307,-6,1685,3633,30
118688671587,118688671583,-4,1212,3810,30
118693417024,118693417016,-8,1168,4141,30
118695696617,118695696613,-4,996,2333,30
118698256263,118698256259,-4,2262,6430,30
118701175045,118701175041,-4,1275,2884,30
118703557760,118703557761,1,2168,3161,30
118705083515,118705083511,-4,798,3578,30
118705492991,118705492985,-6,990,2889,30
118708486130,118708486126,-4,963,3340,30
118711589289,118711589286,-3,801,1790,30
118713190978,118713190982,4,167,859,30
118714108454,118714108446,-8,980,3163,30
118714266770,118714266766,-4,1065,3894,30
118722961822,118722961815,-7,30696,11424,30
118724056631,118724056626,-5,1183,3667,30
118726275584,118726275590,6,13269,22716,30
118731213064,118731213059,-5,1143,3256,30
118732333630,118732333625,-5,910,2384,30
118732542643,118732542633,-10,200,951,30
118735735696,118735735693,-3,981,2330,30
118735957066,118735957062,-4,775,3171,30
118736993224,118736993219,-5,574,1714,30
118737279667,118737279671,4,189,918,30
118742171793,118742171794,1,3192,3025,30
