fTNear,fTFar,fDelT,fQNear,fQFar,d
118863701517,118863701522,5,36,26,-20
2683106,2683108,2,1359,1150,-20
2948892,2948886,-6,833,4033,-20
3406152,3406154,2,1531,1195,-20
6891805,6891809,4,1563,1982,-20
16871765,16871767,2,1414,1539,-20
16990825,16990827,2,1138,1511,-20
19530381,19530383,2,2485,1590,-20
19824842,19824846,4,1709,1515,-20
20293443,20293446,3,1215,1656,-20
21252554,21252557,3,2024,1211,-20
21445670,21445681,11,2571,1463,-20
27535657,27535658,1,1349,936,-20
27943795,27943799,4,2625,1335,-20
35556791,35556794,3,1400,1188,-20
36894426,36894431,5,1570,1183,-20
39170825,39170826,1,1320,1619,-20
40392682,40392686,4,2113,1138,-20
40705526,40705531,5,2063,1999,-20
50867341,50867346,5,1529,1207,-20
51837333,51837335,2,1018,738,-20
56004524,56004528,4,2276,1461,-20
58096989,58096993,4,1947,1621,-20
59271609,59271611,2,2069,1593,-20
62645303,62645310,7,1095,1042,-20
64683457,64683464,7,10062,2865,-20
65587259,65587262,3,1428,1394,-20
67637266,67637268,2,2322,1301,-20
69130014,69130018,4,1928,1930,-20
69301913,69301915,2,1796,952,-20
72351314,72351319,5,2039,1097,-20
74754637,74754641,4,1859,1671,-20
74895293,74895296,3,2367,1947,-20
75375013,75375018,5,2358,1127,-20
76189838,76189842,4,1746,1310,-20
77567719,77567723,4,2184,1864,-20
77858262,77858266,4,1718,1179,-20
78031397,78031407,10,14059,22831,-20
78591787,78591767,-20,1331,635,-20
78681926,78681930,4,1867,1228,-20
83135290,83135293,3,1752,1850,-20
83748272,83748274,2,1289,1448,-20
86170581,86170582,1,1394,1425,-20
98987049,98987052,3,1991,1715,-20
99850711,99850715,4,1564,1183,-20
100628219,100628212,-7,1772,6549,-20
100957647,100957651,4,1547,1029,-20
101804772,101804778,6,2323,1895,-20
102063986,102063990,4,1797,1831,-20
102905230,102905233,3,1529,1112,-20
105717098,105717101,3,1757,1218,-20
108522225,108522237,12,31,590,-20
109533666,109533670,4,1860,1604,-20
113997345,113997349,4,2215,1424,-20
114057759,114057761,2,1752,1413,-20
115618073,115618077,4,37200,27453,-20
116376726,116376730,4,1961,2161,-20
119040446,119040450,4,2035,1491,-20
121984166,121984171,5,2100,1653,-20
122545545,122545545,0,24895,22575,-20
122731876,122731879,3,683,1021,-20
124423751,124423754,3,1593,1383,-20
126480871,126480874,3,1141,1046,-20
132933123,132933126,3,1711,1487,-20
134338374,134338378,4,2264,1477,-20
134685027,134685030,3,2030,1555,-20
135431736,135431738,2,2132,1391,-20
137300256,137300268,12,325,1119,-20
137725274,137725278,4,1771,1486,-20
138141597,138141598,1,1866,1469,-20
139439617,139439618,1,2170,1589,-20
140295465,140295466,1,1796,2520,-20
144333247,144333251,4,2291,1679,-20
147016645,147016647,2,2425,1610,-20
148616922,148616925,3,1848,2276,-20
155721789,155721793,4,1802,1382,-20
155937042,155937046,4,1462,1443,-20
157296259,157296264,5,3135,1361,-20
159041949,159041953,4,1518,956,-20
161557321,161557324,3,2040,1638,-20
168789823,168789824,1,970,2106,-20
169143277,169143279,2,1402,1502,-20
170889122,170889129,7,4545,1487,-20
171533058,171533062,4,1434,1469,-20
172439515,172439519,4,1355,1071,-20
183307798,183307801,3,2514,1532,-20
183769335,183769340,5,1254,1167,-20
183891917,183891920,3,2261,1014,-20
186521214,186521214,0,1866,4688,-20
186606307,186606311,4,2300,1466,-20
193651601,193651606,5,1418,1020,-20
195210608,195210611,3,2282,1307,-20
201674818,201674822,4,1671,1438,-20
203688447,203688451,4,1726,975,-20
205101465,205101462,-3,1103,2114,-20
205833728,205833729,1,57,976,-20
207941579,207941581,2,1741,1248,-20
209650626,209650636,10,18746,22642,-20
213462910,213462906,-4,23059,10602,-20
218331038,218331035,-3,1012,2165,-20
219223237,219223243,6,2376,1518,-20
220882399,220882401,2,1317,1398,-20
221165118,221165099,-19,859,1205,-20
221246696,221246699,3,2364,2096,-20
221588134,221588137,3,1842,1948,-20
222524158,222524159,1,1697,2889,-20
223352389,223352393,4,2334,1579,-20
223524519,223524517,-2,1083,2958,-20
224561729,224561733,4,1204,1260,-20
228171297,228171300,3,1460,841,-20
233285549,233285551,2,1321,1096,-20
236015926,236015930,4,1749,1929,-20
236171975,236171978,3,1399,1194,-20
237258550,237258550,0,1504,1516,-20
238320542,238320547,5,1582,1076,-20
241206007,241206001,-6,1134,3365,-20
244977565,244977569,4,2974,1928,-20
245106209,245106210,1,2116,1389,-20
247058330,247058332,2,1645,2002,-20
249153084,249153084,0,1311,1825,-20
251499637,251499641,4,1175,1544,-20
252893471,252893474,3,2221,1773,-20
253960286,253960286,0,1800,1226,-20
254053889,254053894,5,1987,1648,-20
257024990,257024993,3,941,829,-20
259837046,259837051,5,1408,1242,-20
261902967,261902967,0,2293,2180,-20
262626529,262626531,2,1521,1326,-20
267192977,267192979,2,1756,1392,-20
277427506,277427508,2,1345,1059,-20
277514143,277514146,3,1005,646,-20
278670466,278670470,4,1246,907,-20
280010877,280010880,3,1736,1205,-20
284691513,284691519,6,1789,1012,-20
284826454,284826459,5,1722,1134,-20
285994674,285994660,-14,1953,1137,-20
287414551,287414555,4,1837,1588,-20
294708560,294708563,3,1408,1307,-20
295148945,295148949,4,1843,1524,-20
297875344,297875345,1,1074,1366,-20
300811589,300811592,3,1484,1050,-20
301613050,301613051,1,2040,1376,-20
304950139,304950142,3,1763,1396,-20
308821104,308821107,3,14265,50095,-20
309506346,309506347,1,3115,3660,-20
310893186,310893193,7,4785,1604,-20
311415687,311415690,3,1470,1557,-20
316234994,316234998,4,1326,1208,-20
316392416,316392418,2,1763,993,-20
317483074,317483078,4,1185,1549,-20
317896197,317896196,-1,1439,1865,-20
319675566,319675569,3,1726,1610,-20
321629105,321629105,0,2336,4150,-20
329787165,329787162,-3,1390,1923,-20
332114219,332114222,3,1601,1016,-20
333953651,333953652,1,1265,1330,-20
334054731,334054735,4,1809,1345,-20
334794527,334794531,4,1791,1098,-20
337587578,337587583,5,1405,707,-20
340384904,340384910,6,2406,1147,-20
340975696,340975701,5,1323,1152,-20
341367605,341367607,2,2151,1298,-20
343453615,343453622,7,6457,2273,-20
347637529,347637533,4,1742,1131,-20
350973214,350973218,4,2295,1523,-20
353675542,353675546,4,2159,1471,-20
356099685,356099693,8,1435,1193,-20
360138645,360138649,4,1719,1599,-20
361054818,361054821,3,1549,1619,-20
362980163,362980166,3,1561,1356,-20
365592148,365592152,4,1706,1510,-20
366018574,366018579,5,1145,795,-20
366600063,366600065,2,1740,1214,-20
367842878,367842858,-20,2075,1673,-20
368274890,368274893,3,1585,1273,-20
372025875,372025878,3,1951,1420,-20
374326058,374326063,5,1959,1675,-20
375032825,375032829,4,2374,1735,-20
376653680,376653683,3,1932,931,-20
382529966,382529970,4,2045,1442,-20
386226604,386226606,2,1582,1228,-20
386550886,386550890,4,1765,1392,-20
387188818,387188822,4,1539,1413,-20
388369715,388369723,8,12973,28502,-20
395935961,395935963,2,1233,909,-20
398661836,398661839,3,1772,1563,-20
402809908,402809911,3,1737,1251,-20
403634186,403634189,3,1791,1904,-20
405474730,405474733,3,1427,943,-20
405829207,405829188,-19,1123,1429,-20
406981671,406981675,4,2074,1201,-20
407725061,407725063,2,1766,1463,-20
410534432,410534434,2,1936,1731,-20
412715811,412715814,3,2063,2204,-20
413064159,413064161,2,1566,1600,-20
416848299,416848300,1,2209,3964,-20
417601495,417601491,-4,1473,3311,-20
422301515,422301519,4,2074,1700,-20
425433018,425433019,1,1501,1046,-20
430383377,430383379,2,2053,2163,-20
434516484,434516486,2,1274,1209,-20
436179824,436179827,3,2114,1261,-20
441798611,441798616,5,2008,1383,-20
449376614,449376618,4,1934,2489,-20
450153549,450153550,1,2408,2609,-20
452082205,452082206,1,1707,2093,-20
452665050,452665052,2,1997,1969,-20
456071198,456071202,4,1979,1539,-20
460376454,460376455,1,1513,1285,-20
463872205,463872207,2,1813,1372,-20
465302216,465302220,4,1741,1908,-20
465705975,465705977,2,1103,763,-20
468838959,468838937,-22,1420,1009,-20
470202038,470202042,4,2608,1787,-20
470927912,470927913,1,930,947,-20
474737424,474737429,5,3573,1813,-20
477273968,477273971,3,1677,1958,-20
477849561,477849564,3,1679,1234,-20
480170593,480170595,2,2324,2068,-20
482862342,482862342,0,1792,1864,-20
483292780,483292773,-7,1236,4490,-20
485005937,485005940,3,1779,1544,-20
487673557,487673561,4,2138,1514,-20
489537229,489537231,2,1878,1288,-20
494344171,494344174,3,1754,1100,-20
495015848,495015846,-2,3596,3834,-20
496256109,496256112,3,1421,1035,-20
498555897,498555900,3,1560,1160,-20
499140134,499140138,4,3226,2006,-20
502289266,502289270,4,1887,1626,-20
506630333,506630334,1,1334,2205,-20
511178474,511178471,-3,1167,3353,-20
512809193,512809184,-9,1342,1269,-20
515586922,515586927,5,1462,1793,-20
518391982,518391985,3,1211,809,-20
520247672,520247675,3,1775,1501,-20
521853654,521853657,3,1631,1660,-20
521897486,521897487,1,1571,1279,-20
523476201,523476203,2,1764,1537,-20
524074465,524074467,2,1487,1497,-20
526717075,526717079,4,1984,1043,-20
529185014,529185018,4,1813,1475,-20
530114674,530114656,-18,1249,1144,-20
530912506,530912510,4,1622,1509,-20
531321313,531321317,4,2275,1929,-20
533702446,533702449,3,1542,1257,-20
534871846,534871848,2,1397,1147,-20
536137072,536137075,3,1379,1053,-20
539237435,539237439,4,2823,1006,-20
540059833,540059827,-6,1194,3041,-20
541242849,541242850,1,2036,1605,-20
544173421,544173424,3,1901,1424,-20
545167114,545167118,4,1922,1151,-20
548651423,548651425,2,1267,1517,-20
553209696,553209700,4,2144,1902,-20
553720335,553720347,12,480,132,-20
555876084,555876082,-2,1487,1688,-20
556732770,556732774,4,1089,1150,-20
560132734,560132737,3,1874,1122,-20
563130639,563130639,0,1236,1319,-20
563521380,563521379,-1,1061,1724,-20
565609709,565609713,4,2576,1382,-20
569461024,569461028,4,1780,1632,-20
570979509,570979512,3,1831,1013,-20
572453954,572453959,5,1555,1020,-20
575962426,575962430,4,2126,2105,-20
578764311,578764290,-21,1652,1479,-20
580228277,580228282,5,1618,1229,-20
580751907,580751892,-15,757,177,-20
581938510,581938514,4,1179,869,-20
582248487,582248490,3,1879,1642,-20
586095298,586095302,4,2041,1474,-20
588709966,588709972,6,2059,1535,-20
589552838,589552843,5,1700,1685,-20
590248040,590248042,2,2203,1697,-20
591520658,591520662,4,2093,1364,-20
597260117,597260123,6,2514,1707,-20
599025315,599025319,4,1875,1487,-20
602421118,602421121,3,2596,1143,-20
603893752,603893756,4,2006,1297,-20
607262386,607262390,4,1798,1270,-20
608069238,608069237,-1,1669,2295,-20
608440962,608440966,4,1528,1543,-20
609849390,609849393,3,1672,1504,-20
610194326,610194331,5,1534,1471,-20
611535373,611535377,4,2997,1708,-20
612341365,612341363,-2,673,1620,-20
613122374,613122379,5,1529,1267,-20
615645830,615645835,5,1649,1129,-20
623969489,623969491,2,2094,1060,-20
625413745,625413748,3,1295,1283,-20
633943931,633943935,4,2080,1301,-20
637822006,637822010,4,1665,878,-20
645184062,645184066,4,1999,1572,-20
646951639,646951641,2,1824,1302,-20
647865242,647865241,-1,1070,1567,-20
649249474,649249481,7,2874,1064,-20
650852511,650852514,3,1634,1551,-20
652221605,652221606,1,2072,1755,-20
653316047,653316051,4,1480,1017,-20
653613922,653613927,5,1846,1036,-20
657416298,657416301,3,1664,1970,-20
658207610,658207614,4,1967,1142,-20
660575854,660575858,4,1408,1615,-20
660642725,660642733,8,4255,40623,-20
663371610,663371615,5,1046,912,-20
664140298,664140302,4,1893,1501,-20
664338747,664338753,6,1977,1195,-20
665112548,665112552,4,2112,1355,-20
668849834,668849836,2,2596,1996,-20
672808305,672808310,5,2782,2273,-20
673131074,673131076,2,1669,1557,-20
673865930,673865934,4,1195,1349,-20
675924613,675924617,4,2226,1673,-20
679011157,679011159,2,1128,864,-20
682106602,682106606,4,2309,1974,-20
683612626,683612630,4,1423,991,-20
686819654,686819658,4,1739,1484,-20
694062377,694062377,0,1771,1531,-20
697926150,697926151,1,2198,2161,-20
702065234,702065237,3,1772,1186,-20
702447740,702447742,2,1860,1746,-20
707418937,707418938,1,2070,1497,-20
708007066,708007063,-3,1111,2502,-20
709274549,709274552,3,2391,1580,-20
710468974,710468977,3,948,1282,-20
714187847,714187851,4,2868,1396,-20
715268181,715268160,-21,1506,1027,-20
715806902,715806905,3,1804,1875,-20
717611042,717611046,4,1438,1310,-20
719481207,719481214,7,17022,40295,-20
719813846,719813850,4,2013,1099,-20
720245230,720245249,19,1303,873,-20
725873641,725873646,5,3023,1648,-20
726965750,726965753,3,1848,1359,-20
727857676,727857678,2,1486,1187,-20
730007599,730007602,3,1678,1389,-20
731205764,731205766,2,1274,1492,-20
733215305,733215306,1,6759,17828,-20
734649494,734649497,3,2662,2421,-20
735103454,735103458,4,1696,1588,-20
735601530,735601534,4,1618,1292,-20
739291229,739291233,4,1441,1031,-20
743279795,743279799,4,2315,1404,-20
748803703,748803707,4,1299,1385,-20
752742600,752742603,3,1615,1024,-20
753031047,753031050,3,2023,1650,-20
753462954,753462956,2,1528,1254,-20
753494291,753494294,3,1448,1551,-20
759807698,759807703,5,2168,1369,-20
761315626,761315629,3,1478,1546,-20
763594126,763594131,5,3385,1415,-20
766087182,766087185,3,2434,1777,-20
768760762,768760763,1,869,1108,-20
774803569,774803571,2,1546,1053,-20
775420460,775420465,5,1811,1100,-20
777801835,777801840,5,1622,1218,-20
778876978,778876979,1,1278,1495,-20
783058086,783058087,1,1197,1092,-20
786359424,786359430,6,1972,1798,-20
787598295,787598294,-1,1030,1323,-20
789548399,789548399,0,1155,1973,-20
792578606,792578611,5,2558,2014,-20
794166034,794166038,4,1819,1475,-20
795114284,795114287,3,2209,2128,-20
797975414,797975422,8,5881,2922,-20
798742763,798742765,2,1552,1987,-20
802297824,802297820,-4,25129,14652,-20
802557292,802557290,-2,1595,2568,-20
802792241,802792243,2,2104,1519,-20
809206801,809206806,5,1124,1448,-20
809748169,809748174,5,2670,1358,-20
809816909,809816911,2,1857,1389,-20
812265442,812265438,-4,1932,3458,-20
814237702,814237707,5,1491,1485,-20
816225817,816225820,3,1584,1473,-20
817055313,817055315,2,1998,1330,-20
823904486,823904506,20,718,1202,-20
827337758,827337762,4,2299,1116,-20
828079181,828079185,4,2713,1526,-20
828471600,828471603,3,1711,1455,-20
828701579,828701584,5,1742,1342,-20
828811494,828811497,3,2488,1390,-20
831258072,831258071,-1,2745,3916,-20
832672160,832672162,2,2055,1180,-20
836221380,836221383,3,1478,1694,-20
841706964,841706969,5,2484,1558,-20
843025745,843025751,6,2004,1306,-20
845697101,845697103,2,1894,1485,-20
846098471,846098482,11,10533,36376,-20
846406326,846406331,5,1375,1093,-20
849937200,849937204,4,2104,1457,-20
850232773,850232775,2,1028,913,-20
853074479,853074461,-18,1042,546,-20
854974978,854974979,1,2426,1505,-20
855068678,855068700,22,1231,1192,-20
857098217,857098221,4,1873,1479,-20
858987221,858987219,-2,1428,2012,-20
862140602,862140604,2,1889,1474,-20
864516369,864516373,4,2873,2079,-20
864701687,864701691,4,2075,1447,-20
865048631,865048610,-21,1359,554,-20
865537001,865537005,4,2050,1630,-20
866433310,866433314,4,1503,1100,-20
871236951,871236950,-1,1360,1367,-20
874824794,874824795,1,1325,1141,-20
877942978,877942980,2,1057,1486,-20
881221636,881221641,5,2968,1590,-20
883116114,883116120,6,1670,1394,-20
883340269,883340269,0,1196,2180,-20
884596967,884596970,3,2087,1239,-20
887537561,887537557,-4,983,2010,-20
889722770,889722774,4,1129,1118,-20
890152713,890152717,4,1699,1310,-20
890692422,890692426,4,1501,1444,-20
891385066,891385070,4,2254,1827,-20
892468899,892468903,4,1730,1501,-20
892802298,892802302,4,2365,1781,-20
893832041,893832043,2,1295,1075,-20
895633559,895633562,3,1672,1120,-20
901161855,901161860,5,2329,1644,-20
902435629,902435630,1,2108,1251,-20
903596218,903596222,4,4193,2271,-20
905416137,905416139,2,1403,1241,-20
905792445,905792446,1,1868,1512,-20
907826030,907826033,3,1435,1269,-20
912865609,912865615,6,1422,1143,-20
914516801,914516802,1,1932,1143,-20
916259537,916259534,-3,1304,1154,-20
919037634,919037638,4,1724,1459,-20
921568258,921568262,4,899,557,-20
926186934,926186938,4,2614,1602,-20
926957435,926957441,6,2125,1385,-20
927473671,927473658,-13,694,281,-20
935146405,935146409,4,2108,1467,-20
935895350,935895329,-21,1203,515,-20
937155402,937155405,3,2569,1999,-20
943170645,943170649,4,2097,783,-20
943509298,943509313,15,512,429,-20
944957034,944957035,1,1741,1206,-20
946763710,946763714,4,1694,1140,-20
948543445,948543451,6,2237,1411,-20
949367931,949367931,0,882,2304,-20
949954128,949954131,3,1165,1052,-20
951017113,951017118,5,1467,1119,-20
954137839,954137837,-2,1105,2174,-20
955410468,955410470,2,1361,1365,-20
958169177,958169179,2,1950,1119,-20
958652566,958652567,1,1709,1386,-20
959610184,959610187,3,1891,1965,-20
961792569,961792573,4,1831,1337,-20
964777915,964777919,4,2508,1711,-20
965645081,965645082,1,1728,1053,-20
968870298,968870302,4,2141,924,-20
973117567,973117570,3,1302,817,-20
977520089,977520092,3,1445,1186,-20
978031482,978031484,2,2418,1313,-20
978493377,978493382,5,2437,1304,-20
980997783,980997786,3,1269,979,-20
981369974,981369970,-4,2349,6220,-20
982585926,982585926,0,150,3385,-20
983254358,983254363,5,1542,1025,-20
983661329,983661333,4,2771,2025,-20
984056419,984056424,5,1861,1259,-20
985084873,985084874,1,1595,1678,-20
988074162,988074164,2,1429,1597,-20
990321861,990321863,2,2533,2034,-20
990881883,990881884,1,1949,1941,-20
991526894,991526899,5,1414,885,-20
992163187,992163191,4,1956,1748,-20
995849872,995849877,5,1693,1169,-20
1000928738,1000928741,3,1267,1210,-20
1003021913,1003021917,4,3269,1904,-20
1010705411,1010705414,3,1368,1755,-20
1014706794,1014706797,3,1240,1248,-20
1014992238,1014992240,2,2693,2079,-20
1015165325,1015165328,3,1715,1572,-20
1016312802,1016312805,3,1447,1543,-20
1019223361,1019223365,4,2303,1597,-20
1019694930,1019694933,3,1476,1302,-20
1022130242,1022130246,4,1898,1361,-20
1022343845,1022343852,7,2326,1201,-20
1025478509,1025478510,1,1153,933,-20
1025831330,1025831322,-8,1030,4650,-20
1028605238,1028605243,5,1660,1314,-20
1031056130,1031056133,3,1822,1475,-20
1034560738,1034560741,3,1248,1431,-20
1035212458,1035212463,5,2239,1478,-20
1037045573,1037045556,-17,3778,2050,-20
1043644171,1043644176,5,1930,1464,-20
1048330050,1048330034,-16,1300,1004,-20
1051899829,1051899833,4,2341,1834,-20
1056259243,1056259242,-1,1651,2491,-20
1058413813,1058413819,6,1809,861,-20
1060010859,1060010861,2,1517,1122,-20
1061476805,1061476808,3,1818,1229,-20
1062179922,1062179928,6,2502,1732,-20
1062653782,1062653786,4,2107,1415,-20
1063481864,1063481868,4,2046,1374,-20
1066040773,1066040775,2,2620,2025,-20
1078841231,1078841238,7,2105,1044,-20
1082201638,1082201644,6,2155,1466,-20
1084855305,1084855301,-4,1908,5319,-20
1087617327,1087617331,4,1586,1521,-20
1091331701,1091331705,4,2543,1481,-20
1099383793,1099383798,5,1525,1207,-20
1102142741,1102142743,2,1987,1438,-20
1103020897,1103020899,2,2238,1444,-20
1104467982,1104467982,0,1198,1256,-20
1105303882,1105303885,3,1469,1334,-20
1111121032,1111121034,2,1515,1453,-20
1111261567,1111261573,6,1976,1648,-20
1111625174,1111625173,-1,1716,2004,-20
1112270321,1112270325,4,1996,946,-20
1113544401,1113544406,5,2621,1630,-20
1114528393,1114528397,4,1785,1018,-20
1117934026,1117934028,2,2145,1666,-20
1119827045,1119827046,1,1376,1282,-20
1121475873,1121475874,1,2214,1710,-20
1123294891,1123294895,4,1159,857,-20
1124692553,1124692555,2,2525,1938,-20
1125391132,1125391136,4,2035,1635,-20
1126538235,1126538240,5,45211,29132,-20
1127086498,1127086503,5,2303,1127,-20
1129678462,1129678442,-20,2723,1468,-20
1131664090,1131664094,4,2526,1640,-20
1133743433,1133743419,-14,278,137,-20
1135431003,1135431006,3,1309,1574,-20
1138081344,1138081346,2,2026,1426,-20
1139785238,1139785242,4,1476,1721,-20
1140301137,1140301139,2,2246,1518,-20
1141311958,1141311962,4,1870,1662,-20
1146245642,1146245646,4,1642,1291,-20
1147359838,1147359841,3,1927,1374,-20
1149313561,1149313566,5,1263,1441,-20
1157016752,1157016755,3,1616,1367,-20
1158088110,1158088111,1,1804,972,-20
1158718248,1158718245,-3,1928,5159,-20
1166572618,1166572619,1,2809,3004,-20
1167243968,1167243970,2,2176,2006,-20
1168835178,1168835182,4,1432,1839,-20
1169060581,1169060582,1,1580,1219,-20
1171330081,1171330086,5,1550,994,-20
1172088801,1172088805,4,2420,1405,-20
1172983582,1172983585,3,1554,1389,-20
1180455401,1180455403,2,1068,779,-20
1182158381,1182158384,3,2110,1476,-20
1186339285,1186339287,2,2103,1380,-20
1188097829,1188097830,1,1846,1531,-20
1191218384,1191218388,4,1528,1539,-20
1192353522,1192353529,7,1453,1496,-20
1194034539,1194034521,-18,961,1467,-20
1196365909,1196365924,15,15311,21690,-20
1196434263,1196434267,4,2013,1496,-20
1207905021,1207905026,5,1505,1355,-20
1212873414,1212873414,0,1520,2004,-20
1213618255,1213618258,3,2049,1214,-20
1216129026,1216129030,4,1528,1295,-20
1217240199,1217240201,2,2402,1663,-20
1220038128,1220038132,4,1788,1452,-20
1222538001,1222538003,2,1785,1907,-20
1222895278,1222895283,5,1437,1630,-20
1224533777,1224533779,2,2880,1598,-20
1227754145,1227754147,2,2344,1427,-20
1228354297,1228354299,2,1885,2384,-20
1229298711,1229298714,3,1679,1697,-20
1229345957,1229345968,11,1485,1199,-20
1232261081,1232261084,3,863,863,-20
1234780486,1234780490,4,1610,1263,-20
1236033099,1236033101,2,2115,1864,-20
1237894704,1237894709,5,1792,1630,-20
1240582337,1240582343,6,1021,787,-20
1241099429,1241099426,-3,1081,2851,-20
1241188342,1241188345,3,1526,1183,-20
1242726323,1242726325,2,1878,1462,-20
1249230529,1249230533,4,2363,1454,-20
1249537397,1249537399,2,1188,1122,-20
1253994699,1253994702,3,1930,1706,-20
1255149530,1255149535,5,2034,1168,-20
1269468965,1269468967,2,1698,1463,-20
1270826849,1270826853,4,1988,1417,-20
1271271432,1271271435,3,1100,926,-20
1278719842,1278719848,6,4139,1616,-20
1279258851,1279258846,-5,786,1613,-20
1279512726,1279512730,4,1397,1226,-20
1280362600,1280362602,2,2258,1895,-20
1291933206,1291933208,2,1661,1233,-20
1292958861,1292958863,2,1695,1669,-20
1295142464,1295142466,2,1179,1410,-20
1296550977,1296550977,0,1406,1671,-20
1297966618,1297966616,-2,1815,3427,-20
1299215350,1299215358,8,6903,2783,-20
1303071655,1303071659,4,998,831,-20
1304061042,1304061043,1,1307,1501,-20
1306226745,1306226749,4,1624,1787,-20
1307211735,1307211733,-2,1423,2391,-20
1308319069,1308319074,5,2426,1427,-20
1308760776,1308760779,3,1318,1212,-20
1308894441,1308894445,4,1642,1494,-20
1314218069,1314218075,6,1892,1062,-20
1316691901,1316691905,4,1699,1614,-20
1317399030,1317399034,4,1692,1794,-20
1318147267,1318147268,1,997,1124,-20
1319060423,1319060427,4,2046,1395,-20
1319679588,1319679589,1,1671,1449,-20
1319911497,1319911488,-9,1543,1857,-20
1322646161,1322646162,1,1423,944,-20
1325148407,1325148413,6,1982,1392,-20
1326927661,1326927664,3,2601,1830,-20
1329825397,1329825401,4,1595,1450,-20
1332391026,1332391029,3,2000,1447,-20
1333027510,1333027514,4,1066,1282,-20
1333393011,1333393014,3,1595,1380,-20
1337086605,1337086606,1,998,1076,-20
1341320167,1341320169,2,1591,1405,-20
1349615970,1349615975,5,1535,1433,-20
1356704393,1356704395,2,1707,1261,-20
1357109141,1357109143,2,1378,1205,-20
1357789707,1357789710,3,1162,721,-20
1358750929,1358750937,8,3784,1332,-20
1360765296,1360765299,3,1773,1921,-20
1360857919,1360857923,4,1647,1022,-20
1361161078,1361161081,3,1490,1266,-20
1362655273,1362655275,2,2758,1326,-20
1369389583,1369389586,3,2550,1210,-20
1375001102,1375001103,1,1422,1013,-20
1380436505,1380436507,2,1447,1484,-20
1382837699,1382837703,4,1945,1530,-20
1386159691,1386159694,3,1125,861,-20
1389956345,1389956347,2,1635,1330,-20
1391012846,1391012850,4,2904,1820,-20
1394882853,1394882856,3,1485,1302,-20
1395014028,1395014031,3,1408,1481,-20
1396314530,1396314532,2,1318,1149,-20
1398753113,1398753113,0,1245,2215,-20
1403173573,1403173575,2,1298,1445,-20
1407140853,1407140859,6,1648,1322,-20
1411055337,1411055338,1,799,965,-20
1413769505,1413769507,2,1750,1709,-20
1414265115,1414265118,3,1565,1451,-20
1420563458,1420563457,-1,1617,2570,-20
1423981575,1423981577,2,1809,1207,-20
1425158474,1425158477,3,1820,1275,-20
1427060808,1427060810,2,1445,1459,-20
1433163190,1433163194,4,1955,1330,-20
1433927830,1433927833,3,1617,1500,-20
1436072164,1436072166,2,1271,1468,-20
1437384735,1437384739,4,1864,1691,-20
1438660206,1438660210,4,1603,1095,-20
1443778448,1443778452,4,1932,1855,-20
1445331545,1445331550,5,1532,1547,-20
1447372638,1447372642,4,2036,1377,-20
1447909886,1447909881,-5,1795,5642,-20
1448264918,1448264919,1,1721,1116,-20
1449536970,1449536975,5,1788,1689,-20
1450270071,1450270077,6,2762,1479,-20
1452928984,1452928988,4,2160,1786,-20
1453268239,1453268238,-1,1064,1040,-20
1457507317,1457507322,5,2369,1228,-20
1461419551,1461419555,4,2251,1681,-20
1462176450,1462176454,4,1778,1766,-20
1462923206,1462923211,5,1971,1133,-20
1465846433,1465846429,-4,1873,5852,-20
1466912559,1466912563,4,2216,1484,-20
1467311084,1467311087,3,1860,1421,-20
1470294202,1470294204,2,2115,1833,-20
1473755486,1473755489,3,1925,1848,-20
1473990493,1473990497,4,2664,2086,-20
1485336971,1485336973,2,1477,1196,-20
1487039811,1487039814,3,1617,1276,-20
1490603183,1490603187,4,1809,1463,-20
1496050594,1496050594,0,1601,1338,-20
1496391141,1496391147,6,2059,740,-20
1496581838,1496581842,4,1420,1471,-20
1498660453,1498660455,2,3281,3852,-20
1499147235,1499147238,3,1826,1248,-20
1500657429,1500657429,0,1401,1159,-20
1501604094,1501604095,1,2052,1041,-20
1503885409,1503885416,7,3548,1342,-20
1506273656,1506273660,4,1872,1267,-20
1508820637,1508820641,4,2062,2165,-20
1509652902,1509652906,4,1823,1308,-20
1511378551,1511378554,3,1994,1733,-20
1511863222,1511863211,-11,887,1820,-20
1513486899,1513486904,5,2191,1611,-20
1515769269,1515769275,6,2379,1717,-20
1518210982,1518210987,5,2132,1263,-20
1518769402,1518769409,7,8822,3925,-20
1523753416,1523753420,4,2086,1682,-20
1525347590,1525347591,1,1527,941,-20
1526612273,1526612275,2,1778,1825,-20
1528929633,1528929634,1,1723,1552,-20
1533671038,1533671042,4,1874,1711,-20
1535762876,1535762880,4,2019,1276,-20
1536900209,1536900215,6,1355,1577,-20
1538104492,1538104494,2,1290,1068,-20
1540533245,1540533247,2,1591,1494,-20
1547773253,1547773254,1,1668,1456,-20
1549298199,1549298202,3,2380,1767,-20
1549356080,1549356083,3,1711,1568,-20
1549650787,1549650790,3,2249,1529,-20
1560770850,1560770855,5,1481,1259,-20
1565969250,1565969254,4,1493,1167,-20
1566463403,1566463408,5,58,1241,-20
1568358618,1568358621,3,1223,1047,-20
1569492142,1569492145,3,1748,1268,-20
1578482489,1578482490,1,1636,1605,-20
1580862342,1580862345,3,1529,1673,-20
1583068830,1583068826,-4,958,2650,-20
1584531934,1584531939,5,1414,1381,-20
1584667917,1584667921,4,1892,1428,-20
1587158795,1587158798,3,1733,1284,-20
1590319622,1590319625,3,2309,1231,-20
1591899523,1591899526,3,1563,1432,-20
1593380450,1593380455,5,911,439,-20
1597428011,1597428014,3,1755,1328,-20
1603233689,1603233693,4,2594,1817,-20
1603917788,1603917791,3,1627,1332,-20
1609998359,1609998360,1,2683,1884,-20
1611603655,1611603658,3,2295,1494,-20
1612657873,1612657874,1,1969,1732,-20
1613679831,1613679834,3,1178,988,-20
1615125545,1615125549,4,1453,1445,-20
1615913933,1615913937,4,2558,1823,-20
1616827222,1616827222,0,1538,1712,-20
1617334251,1617334254,3,2257,2174,-20
1617461018,1617461023,5,1455,1003,-20
1617506033,1617506020,-13,1975,836,-20
1619083766,1619083770,4,1225,1214,-20
1619542345,1619542346,1,759,645,-20
1620916167,1620916171,4,1350,1045,-20
1621324819,1621324823,4,1213,1246,-20
1624019093,1624019098,5,3076,1627,-20
1625827351,1625827345,-6,32286,11566,-20
1626633315,1626633318,3,1834,1193,-20
1628984336,1628984340,4,1844,1524,-20
1630549260,1630549262,2,1841,1469,-20
1632110989,1632110993,4,2392,1547,-20
1634748457,1634748454,-3,25592,12148,-20
1635965897,1635965901,4,3023,1950,-20
1636962232,1636962237,5,1536,1347,-20
1640729842,1640729843,1,1000,1078,-20
1641015871,1641015874,3,2272,1377,-20
1641119454,1641119434,-20,1269,1107,-20
1641481890,1641481873,-17,1742,1185,-20
1643243321,1643243324,3,14502,22738,-20
1644387436,1644387429,-7,2375,6170,-20
1645559738,1645559739,1,1861,1620,-20
1651613509,1651613511,2,1779,1367,-20
1651895543,1651895546,3,1838,1250,-20
1652439339,1652439320,-19,38,203,-20
1653761117,1653761119,2,1073,661,-20
1655470012,1655470013,1,1716,1369,-20
1656170713,1656170717,4,1434,1464,-20
1656292546,1656292550,4,1516,1274,-20
1656545645,1656545626,-19,1440,1627,-20
1658662790,1658662792,2,1705,1074,-20
1660064930,1660064931,1,1496,1010,-20
1666022814,1666022818,4,2419,1101,-20
1666877089,1666877090,1,1662,1705,-20
1668365332,1668365335,3,1358,1395,-20
1669082035,1669082039,4,2387,1772,-20
1669297400,1669297403,3,2115,1452,-20
1670272082,1670272081,-1,917,1187,-20
1671562566,1671562572,6,2542,1626,-20
1675116951,1675116955,4,1377,1169,-20
1676900518,1676900520,2,1988,2228,-20
1678224897,1678224905,8,2308,948,-20
1680860929,1680860934,5,2915,1707,-20
1686684418,1686684422,4,1399,1283,-20
1689314681,1689314683,2,1712,1416,-20
1689535370,1689535371,1,1471,1888,-20
1695256358,1695256359,1,2088,1530,-20
1699751827,1699751830,3,2643,1212,-20
1701970644,1701970647,3,1579,1094,-20
1707138937,1707138939,2,1619,1468,-20
1707975970,1707975974,4,2877,1809,-20
1708852554,1708852557,3,2187,1606,-20
1710432914,1710432899,-15,815,1102,-20
1712943325,1712943328,3,2229,1778,-20
1714290340,1714290342,2,1943,1613,-20
1718770517,1718770518,1,1717,1233,-20
1719552726,1719552731,5,1986,1229,-20
1721566501,1721566505,4,2114,1246,-20
1722210926,1722210929,3,1726,1702,-20
1724399866,1724399870,4,1569,993,-20
1726163606,1726163606,0,1473,1457,-20
1728204654,1728204639,-15,2137,1443,-20
1729400369,1729400374,5,1967,1529,-20
1730275752,1730275755,3,1510,1253,-20
1730398865,1730398870,5,1435,1300,-20
1735654083,1735654087,4,1824,1025,-20
1738638541,1738638543,2,933,1246,-20
1739917172,1739917174,2,1890,2389,-20
1741938900,1741938903,3,1900,785,-20
1744085939,1744085942,3,2115,1394,-20
1744355683,1744355687,4,1908,1263,-20
1744607148,1744607151,3,2009,1337,-20
1747605161,1747605165,4,1946,1181,-20
1749586424,1749586430,6,1966,1353,-20
1750703419,1750703423,4,1442,1067,-20
1750962361,1750962363,2,2005,1298,-20
1756927693,1756927697,4,1922,2114,-20
1757165390,1757165390,0,1161,1183,-20
1759123711,1759123712,1,1558,1409,-20
1759663026,1759663031,5,2126,1423,-20
1761327211,1761327214,3,2433,1625,-20
1764246083,1764246086,3,2903,2640,-20
1764705585,1764705588,3,1433,755,-20
1765029444,1765029464,20,1113,1182,-20
1765526965,1765526966,1,2031,1934,-20
1765934958,1765934961,3,2012,1823,-20
1767583786,1767583789,3,1632,1518,-20
1771466314,1771466314,0,21496,11132,-20
1774157811,1774157814,3,1681,1328,-20
1778278279,1778278282,3,2114,1580,-20
1780169446,1780169453,7,3126,1690,-20
1780453782,1780453787,5,2128,1719,-20
1781066725,1781066730,5,4791,2668,-20
1781132537,1781132541,4,1638,1601,-20
1781223460,1781223474,14,1858,1754,-20
1781426267,1781426269,2,1301,1274,-20
1782569792,1782569796,4,1241,1074,-20
1783938290,1783938307,17,2546,1320,-20
1785034445,1785034450,5,2302,1546,-20
1786954557,1786954562,5,1868,1107,-20
1787716250,1787716255,5,1323,1032,-20
1788421560,1788421563,3,1622,1318,-20
1789010989,1789010994,5,1355,1244,-20
1791450342,1791450347,5,1195,614,-20
1794835067,1794835071,4,1583,1542,-20
1796126527,1796126508,-19,2877,1486,-20
1796695490,1796695494,4,1552,996,-20
1798992832,1798992838,6,2157,1460,-20
1800875398,1800875401,3,1905,1744,-20
1804173426,1804173420,-6,1234,3676,-20
1809679026,1809679027,1,1674,1420,-20
1818657498,1818657502,4,1927,1377,-20
1820270904,1820270906,2,2391,1399,-20
1823241982,1823241987,5,2007,1744,-20
1825100549,1825100552,3,1671,1961,-20
1833179993,1833179993,0,1262,1507,-20
1835847104,1835847107,3,957,1037,-20
1836140565,1836140565,0,29964,41509,-20
1837900080,1837900083,3,1558,1124,-20
1838741864,1838741866,2,2491,1672,-20
1839270315,1839270317,2,1719,1289,-20
1840704231,1840704233,2,2080,1388,-20
1842663505,1842663508,3,1959,1275,-20
1843371500,1843371504,4,2111,1795,-20
1843839534,1843839536,2,1938,1565,-20
1846731369,1846731369,0,17769,8894,-20
1847284006,1847284010,4,1888,1148,-20
1847487369,1847487370,1,1518,1544,-20
1849072631,1849072634,3,1393,1251,-20
1849384238,1849384242,4,2560,1680,-20
1849703751,1849703755,4,1414,1108,-20
1852767017,1852767020,3,1650,1184,-20
1853268202,1853268210,8,1592,1329,-20
1856204854,1856204858,4,1414,1521,-20
1857318009,1857318012,3,1330,1165,-20
1857664641,1857664646,5,139,2066,-20
1858166173,1858166177,4,2313,1478,-20
1860928351,1860928356,5,2089,1495,-20
1861225093,1861225097,4,1380,1085,-20
1864096741,1864096745,4,1798,1168,-20
1867586830,1867586833,3,2083,1496,-20
1870025927,1870025926,-1,837,1427,-20
1879653618,1879653621,3,1541,1392,-20
1880425730,1880425732,2,1537,1749,-20
1881793919,1881793917,-2,1309,2130,-20
1882395749,1882395761,12,2226,1182,-20
1883100688,1883100687,-1,25517,10946,-20
1885755466,1885755468,2,2440,1953,-20
1885818957,1885818944,-13,1354,584,-20
1887424446,1887424450,4,1702,1482,-20
1888322277,1888322279,2,1607,1376,-20
1888655756,1888655759,3,1296,916,-20
1891749126,1891749127,1,2330,1814,-20
1892269169,1892269174,5,1390,1283,-20
1893666350,1893666352,2,1244,1627,-20
1895162889,1895162878,-11,16611,41977,-20
1897539714,1897539718,4,2077,1219,-20
1897989202,1897989204,2,1955,1646,-20
1900531374,1900531374,0,1344,1583,-20
1901098362,1901098363,1,1374,1624,-20
1901182112,1901182115,3,2008,1300,-20
1903232028,1903232030,2,1776,981,-20
1910591223,1910591226,3,1698,1205,-20
1913157884,1913157887,3,1828,1525,-20
1913207881,1913207882,1,1966,1099,-20
1913811985,1913811990,5,2078,1351,-20
1916185505,1916185507,2,1831,1342,-20
1916236182,1916236185,3,2307,1861,-20
1920419258,1920419259,1,1737,1364,-20
1920546519,1920546529,10,1201,1190,-20
1925841559,1925841562,3,1620,1403,-20
1926255467,1926255471,4,1959,1717,-20
1926299864,1926299862,-2,2747,2946,-20
1931035766,1931035770,4,1118,1406,-20
1931094166,1931094172,6,4346,1918,-20
1932594219,1932594200,-19,1836,2172,-20
1937065270,1937065270,0,1654,2646,-20
1941105697,1941105702,5,2389,1504,-20
1943415079,1943415083,4,1621,1604,-20
1946865586,1946865587,1,1694,1952,-20
1948692795,1948692798,3,1287,1048,-20
1955212618,1955212621,3,1457,1276,-20
1957589814,1957589819,5,1969,1257,-20
1961652953,1961652957,4,1300,1463,-20
1963634760,1963634762,2,1394,1366,-20
1967996406,1967996412,6,1727,1075,-20
1968371513,1968371515,2,1963,1046,-20
1977861862,1977861866,4,889,776,-20
1978354379,1978354384,5,2264,1383,-20
1979423745,1979423749,4,1508,1239,-20
1979661280,1979661285,5,1912,1393,-20
1979842614,1979842617,3,1545,1198,-20
1981539020,1981539022,2,1722,1097,-20
1982408630,1982408633,3,1553,1733,-20
1982685538,1982685542,4,2493,1953,-20
1986446502,1986446505,3,1469,1039,-20
1987711367,1987711370,3,1152,1240,-20
1991182441,1991182432,-9,219,942,-20
1991871171,1991871173,2,2049,1469,-20
1993151558,1993151559,1,1652,1256,-20
1994186555,1994186557,2,2003,1417,-20
1997300656,1997300659,3,2347,1305,-20
1999666154,1999666157,3,1859,1618,-20
1999756438,1999756418,-20,2402,1979,-20
1999922689,1999922691,2,1910,1490,-20
2002627099,2002627100,1,1166,1124,-20
2002901138,2002901143,5,3496,948,-20
2003579166,2003579170,4,1915,1294,-20
2008293599,2008293602,3,1779,1138,-20
2012713083,2012713086,3,1278,1286,-20
2012759979,2012759982,3,1493,1467,-20
2013654442,2013654447,5,2533,1865,-20
2016289142,2016289145,3,8243,5672,-20
2017876681,2017876685,4,1287,1708,-20
2019326653,2019326647,-6,1274,5960,-20
2020167662,2020167667,5,1380,1288,-20
2020295134,2020295137,3,1849,1181,-20
2020341771,2020341775,4,1114,846,-20
2022593544,2022593548,4,2017,1075,-20
2023251287,2023251290,3,1819,1638,-20
2023422543,2023422540,-3,1070,2459,-20
2025525713,2025525715,2,1308,1259,-20
2025750608,2025750613,5,1581,1463,-20
2026922514,2026922518,4,1044,1230,-20
2027832606,2027832611,5,1437,1570,-20
2030228789,2030228794,5,2646,1927,-20
2033161382,2033161384,2,981,395,-20
2033276281,2033276274,-7,25540,13216,-20
2036845045,2036845048,3,1405,1642,-20
2040506298,2040506300,2,1608,1550,-20
2044248995,2044248998,3,1765,1997,-20
2044894811,2044894816,5,2238,1685,-20
2046887053,2046887053,0,1483,1509,-20
2047146108,2047146109,1,1112,836,-20
2047825361,2047825364,3,2474,2542,-20
2048678450,2048678454,4,1553,1336,-20
2049031194,2049031197,3,2419,1744,-20
2049083450,2049083451,1,1481,1431,-20
2049570893,2049570898,5,1471,1342,-20
2050550462,2050550466,4,1897,1735,-20
2052040990,2052040993,3,1370,1583,-20
2053599120,2053599123,3,1746,1185,-20
2056924997,2056925001,4,1567,1428,-20
2057170214,2057170215,1,1516,1203,-20
2058146171,2058146174,3,2267,1849,-20
2059390132,2059390137,5,2346,1292,-20
2060748128,2060748129,1,2138,1521,-20
2063369799,2063369801,2,1982,1264,-20
2064311912,2064311915,3,1847,1705,-20
2067487958,2067487963,5,2096,1226,-20
2067611653,2067611633,-20,1669,322,-20
2071707347,2071707350,3,1699,2200,-20
2073180054,2073180052,-2,1752,2488,-20
2074101947,2074101951,4,1482,2077,-20
2074275494,2074275494,0,1519,1163,-20
2078523298,2078523302,4,1866,1615,-20
2079040991,2079040995,4,2169,1334,-20
2084746589,2084746594,5,1254,799,-20
2086415894,2086415897,3,2141,1523,-20
2087981225,2087981229,4,1822,1699,-20
2088615274,2088615278,4,1013,1324,-20
2089605984,2089605987,3,1765,850,-20
2090653130,2090653134,4,1308,1497,-20
2094976273,2094976277,4,1655,1556,-20
2095957733,2095957738,5,1939,1580,-20
2099404611,2099404613,2,1900,1655,-20
2104522110,2104522115,5,2154,1352,-20
2108456278,2108456279,1,1336,1206,-20
2108684453,2108684457,4,2077,1430,-20
2110689297,2110689301,4,1509,1586,-20
2111878919,2111878921,2,1877,1551,-20
2112616137,2112616139,2,1852,1573,-20
2114783523,2114783522,-1,1713,2178,-20
2125992018,2125992022,4,1709,1650,-20
2126151560,2126151564,4,1640,1544,-20
2127743558,2127743559,1,1804,2336,-20
2129678169,2129678173,4,2059,1819,-20
2132101347,2132101349,2,1475,1252,-20
2132845406,2132845410,4,2108,1899,-20
2134351832,2134351835,3,2144,1453,-20
2135385943,2135385946,3,1461,1318,-20
2135661678,2135661680,2,1835,1746,-20
2136031737,2136031740,3,2761,1883,-20
2146991941,2146991943,2,1555,1308,-20
2148333757,2148333759,2,1855,1438,-20
2149535521,2149535525,4,1900,1580,-20
2149592926,2149592906,-20,1775,1330,-20
2149729201,2149729216,15,1941,1412,-20
2152804117,2152804121,4,2077,1440,-20
2154281025,2154281027,2,1768,1547,-20
2154558781,2154558785,4,1274,1598,-20
2156317435,2156317437,2,1797,1483,-20
2156747506,2156747492,-14,1045,488,-20
2163508381,2163508382,1,1953,1308,-20
2166420434,2166420438,4,2006,1370,-20
2166756475,2166756480,5,2480,973,-20
2166786040,2166786043,3,1636,1032,-20
2168715621,2168715622,1,1658,1404,-20
2169813027,2169813031,4,1777,1473,-20
2169989202,2169989208,6,847,1165,-20
2171875617,2171875619,2,1403,1337,-20
2172618371,2172618375,4,2180,1580,-20
2175783253,2175783254,1,1728,1221,-20
2175947775,2175947778,3,1644,1247,-20
2178955526,2178955534,8,3550,1253,-20
2179031141,2179031142,1,1580,1612,-20
2185232356,2185232361,5,1754,1396,-20
2185731637,2185731639,2,1831,1736,-20
2185849307,2185849311,4,1694,1420,-20
2189123830,2189123834,4,1722,1691,-20
2189487620,2189487624,4,1987,1462,-20
2191245618,2191245620,2,1948,1874,-20
2193454194,2193454195,1,1314,995,-20
2197288995,2197288999,4,2143,1666,-20
2197351993,2197351999,6,5748,1883,-20
2200618026,2200618029,3,1712,1596,-20
2204910696,2204910705,9,1817,1164,-20
2205693322,2205693325,3,2045,1473,-20
2206014941,2206014947,6,1853,1051,-20
2207177367,2207177384,17,1953,1224,-20
2210354962,2210354966,4,1697,1484,-20
2211017814,2211017818,4,1824,1571,-20
2213634895,2213634898,3,2060,1636,-20
2217346021,2217346022,1,1793,1805,-20
2217634395,2217634389,-6,1085,2311,-20
2218640595,2218640594,-1,1735,2173,-20
2221869507,2221869514,7,1714,1057,-20
2222189796,2222189812,16,351,1082,-20
2222504158,2222504140,-18,980,856,-20
2225559891,2225559895,4,2443,1335,-20
2231665214,2231665217,3,1376,1251,-20
2237249014,2237249017,3,1960,1406,-20
2237575069,2237575073,4,2433,1902,-20
2239310102,2239310106,4,2120,1452,-20
2251476449,2251476455,6,2792,1742,-20
2252135781,2252135784,3,2166,1420,-20
2252836038,2252836041,3,2812,1910,-20
2253569977,2253569980,3,3730,3548,-20
2256102461,2256102463,2,2114,2524,-20
2257091789,2257091791,2,2230,1189,-20
2260639250,2260639249,-1,1813,1431,-20
2263073578,2263073580,2,1987,1650,-20
2263298761,2263298765,4,2123,1105,-20
2266671794,2266671799,5,1810,1409,-20
2270717366,2270717371,5,1315,1315,-20
2275344402,2275344405,3,1229,1380,-20
2279326593,2279326597,4,1632,1731,-20
2286287002,2286287006,4,1309,1120,-20
2287058150,2287058154,4,1929,1097,-20
2288920703,2288920707,4,2193,1912,-20
2289489806,2289489809,3,2272,1748,-20
2294236953,2294236955,2,2446,1244,-20
2294652151,2294652154,3,2109,1314,-20
2295520906,2295520908,2,1034,1079,-20
2298320055,2298320057,2,1517,948,-20
2300626321,2300626325,4,2120,1380,-20
2300951874,2300951879,5,1842,1370,-20
2303281731,2303281737,6,1758,1238,-20
2305275622,2305275626,4,2184,1331,-20
2306653353,2306653357,4,2288,1112,-20
2307334425,2307334428,3,2683,1834,-20
2314682537,2314682535,-2,1402,2076,-20
2315001314,2315001317,3,1871,1608,-20
2315692107,2315692107,0,1260,1664,-20
2316140963,2316140957,-6,1569,5868,-20
2316401517,2316401520,3,1628,1281,-20
2317583719,2317583722,3,2365,1518,-20
2323864828,2323864831,3,1377,1103,-20
2324195851,2324195855,4,2324,1578,-20
2325206951,2325206955,4,2170,1236,-20
2326641038,2326641041,3,1444,836,-20
2328667750,2328667755,5,2068,1025,-20
2330298019,2330298023,4,2146,1802,-20
2332817289,2332817290,1,1338,805,-20
2332986769,2332986773,4,1396,1382,-20
2336472470,2336472473,3,1617,2127,-20
2336954180,2336954183,3,902,516,-20
2344832234,2344832239,5,3155,1325,-20
2348885045,2348885047,2,1496,1583,-20
2349577101,2349577107,6,2975,1585,-20
2350359028,2350359033,5,1681,1030,-20
2350843867,2350843870,3,1686,1672,-20
2352637282,2352637286,4,2143,1459,-20
2352911973,2352911978,5,2487,1610,-20
2354650370,2354650374,4,1397,1258,-20
2355790770,2355790773,3,1956,1104,-20
2356494055,2356494059,4,1391,946,-20
2356701117,2356701119,2,2499,2356,-20
2360018312,2360018314,2,1705,1056,-20
2360636389,2360636393,4,2350,1366,-20
2360978654,2360978654,0,928,1189,-20
2365909804,2365909824,20,1964,1171,-20
2366153406,2366153411,5,2012,1285,-20
2368169071,2368169074,3,1512,1129,-20
2369871230,2369871235,5,1474,825,-20
2370153795,2370153799,4,1564,1067,-20
2370292967,2370292970,3,518,116,-20
2372684325,2372684326,1,1695,1409,-20
2375440178,2375440181,3,1900,1584,-20
2375666841,2375666839,-2,7234,11600,-20
2378688638,2378688643,5,1288,1311,-20
2382358515,2382358513,-2,2534,4475,-20
2384806851,2384806853,2,1149,1788,-20
2389872882,2389872885,3,1864,1294,-20
2390016439,2390016441,2,1300,1573,-20
2392492867,2392492870,3,1602,1722,-20
2393543330,2393543331,1,1658,713,-20
2396116885,2396116889,4,1936,1625,-20
2399470161,2399470166,5,2081,1310,-20
2400026538,2400026543,5,1538,1037,-20
2401080096,2401080098,2,2623,1440,-20
2405221170,2405221175,5,1757,1787,-20
2405265406,2405265410,4,2035,1370,-20
2412492138,2412492142,4,1618,782,-20
2415235820,2415235822,2,2112,1082,-20
2417402109,2417402110,1,1339,973,-20
2421967025,2421967030,5,2371,1169,-20
2423942516,2423942519,3,1582,1538,-20
2424197513,2424197517,4,1918,882,-20
2429874168,2429874174,6,3031,1475,-20
2432340645,2432340648,3,1346,1442,-20
2434004095,2434004099,4,1832,1367,-20
2434888321,2434888323,2,1636,1449,-20
2434913649,2434913653,4,1358,1302,-20
2435304446,2435304445,-1,2529,4643,-20
2435537515,2435537517,2,2357,1996,-20
2435588761,2435588763,2,1169,931,-20
2437409460,2437409462,2,1585,1601,-20
2438699089,2438699068,-21,1616,1572,-20
2438836710,2438836729,19,2149,1146,-20
2441971262,2441971264,2,891,847,-20
2442293466,2442293470,4,2155,1156,-20
2451612981,2451612985,4,2058,1319,-20
2453166294,2453166299,5,1899,1612,-20
2453436157,2453436162,5,1298,741,-20
2453846672,2453846677,5,1333,1452,-20
2455780590,2455780591,1,1601,1998,-20
2460896373,2460896367,-6,1626,3283,-20
2462645912,2462645902,-10,2362,1911,-20
2463762833,2463762835,2,1885,1425,-20
2465715474,2465715477,3,1463,1735,-20
2465940913,2465940916,3,1355,1030,-20
2467159379,2467159382,3,1722,1342,-20
2468253305,2468253310,5,1671,1451,-20
2469512324,2469512327,3,1855,1167,-20
2469789225,2469789227,2,2015,1681,-20
2479774534,2479774535,1,1354,1353,-20
2480587713,2480587720,7,2508,1460,-20
2486052069,2486052073,4,2167,1940,-20
2489192466,2489192472,6,7479,5002,-20
2490519951,2490519954,3,1564,1376,-20
2494701950,2494701957,7,2111,1517,-20
2499801435,2499801438,3,1701,1369,-20
2500967580,2500967584,4,2018,1534,-20
2501636678,2501636682,4,1841,1323,-20
2505967507,2505967511,4,1171,869,-20
2508986415,2508986419,4,1725,1305,-20
2510101914,2510101916,2,920,1565,-20
2511789544,2511789547,3,1817,931,-20
2513722130,2513722131,1,2106,2258,-20
2514083491,2514083495,4,1581,933,-20
2518257214,2518257207,-7,782,350,-20
2518851821,2518851823,2,2113,2058,-20
2520008922,2520008926,4,2328,1809,-20
2521618070,2521618074,4,1851,1431,-20
2523741412,2523741414,2,1457,1164,-20
2527021661,2527021661,0,1371,2583,-20
2528388701,2528388705,4,1639,1391,-20
2529222678,2529222679,1,1207,1278,-20
2529380653,2529380666,13,1849,944,-20
2531594894,2531594898,4,1741,1099,-20
2537332982,2537332987,5,1353,579,-20
2539727215,2539727218,3,1919,1686,-20
2541571900,2541571902,2,1514,1709,-20
2542603017,2542603022,5,1225,1029,-20
2544124329,2544124333,4,2025,1525,-20
2544442106,2544442111,5,1800,1357,-20
2545508009,2545508013,4,1618,1149,-20
2545912465,2545912469,4,2616,1336,-20
2546940303,2546940297,-6,1106,3812,-20
2548383350,2548383355,5,2012,1356,-20
2548711678,2548711682,4,2698,2210,-20
2548897949,2548897955,6,1816,1174,-20
2555205706,2555205711,5,1771,1633,-20
2557932680,2557932683,3,1885,1703,-20
2559733914,2559733916,2,2353,1853,-20
2560909430,2560909433,3,2031,2081,-20
2561450724,2561450729,5,2384,1284,-20
2563049399,2563049403,4,2521,1669,-20
2565253538,2565253542,4,1367,1087,-20
2565503117,2565503119,2,1861,907,-20
2579687618,2579687622,4,1482,955,-20
2585008543,2585008546,3,1654,1394,-20
2586413336,2586413337,1,1434,1073,-20
2589147701,2589147703,2,1609,995,-20
2590089101,2590089103,2,2596,1924,-20
2592211594,2592211597,3,1240,873,-20
2592522396,2592522399,3,1150,743,-20
2594280203,2594280209,6,2545,1332,-20
2594563105,2594563111,6,1614,868,-20
2595629070,2595629074,4,2096,1746,-20
2596451935,2596451944,9,9320,45927,-20
2601315693,2601315693,0,1430,958,-20
2602258236,2602258240,4,2039,1497,-20
2602878442,2602878446,4,1770,1116,-20
2604476614,2604476615,1,1298,1867,-20
2604645594,2604645586,-8,289,1991,-20
2614147848,2614147851,3,1992,1043,-20
2615554221,2615554223,2,2093,1702,-20
2615979762,2615979767,5,1896,1539,-20
2618315848,2618315851,3,1110,1164,-20
2622408666,2622408686,20,2012,6803,-20
2622809323,2622809328,5,2308,1358,-20
2627436826,2627436831,5,2178,1488,-20
2627851272,2627851274,2,2467,1731,-20
2629713971,2629713975,4,1257,1034,-20
2629979814,2629979818,4,1678,1439,-20
2631093697,2631093702,5,2352,1358,-20
2631828647,2631828652,5,1083,1054,-20
2634322355,2634322359,4,1402,1641,-20
2635467122,2635467126,4,2172,1214,-20
2637465262,2637465267,5,1388,1737,-20
2642422646,2642422648,2,1439,1953,-20
2645435934,2645435938,4,1397,1152,-20
2649782330,2649782334,4,1208,916,-20
2650413950,2650413954,4,1697,1597,-20
2653460688,2653460690,2,1310,1140,-20
2656372254,2656372259,5,2124,1448,-20
2658034683,2658034686,3,1828,1394,-20
2659882410,2659882414,4,1943,1209,-20
2660840549,2660840551,2,2326,2176,-20
2661167582,2661167577,-5,857,5522,-20
2663728625,2663728633,8,7902,2143,-20
2664034173,2664034176,3,1633,1793,-20
2668909260,2668909262,2,1838,1404,-20
2672679094,2672679095,1,2431,1975,-20
2673535439,2673535442,3,2310,1157,-20
2674235226,2674235230,4,1861,1814,-20
2678574246,2678574250,4,1852,1335,-20
2679320049,2679320055,6,1186,1006,-20
2684852432,2684852431,-1,1771,2530,-20
2686995226,2686995230,4,2973,1955,-20
2689261989,2689261990,1,1305,1438,-20
2690855883,2690855892,9,3772,1455,-20
2692364037,2692364041,4,1964,1303,-20
2692970406,2692970410,4,2372,1808,-20
2694040939,2694040942,3,2135,1411,-20
2696014340,2696014342,2,2060,1483,-20
2696760337,2696760339,2,1171,1739,-20
2699214602,2699214605,3,1950,1535,-20
2699608393,2699608396,3,1955,2103,-20
2699970473,2699970478,5,2364,1935,-20
2701772415,2701772418,3,1730,1172,-20
2707589024,2707589029,5,1765,1168,-20
2708145799,2708145786,-13,1890,862,-20
2709278397,2709278400,3,1913,1834,-20
2714950326,2714950329,3,1786,1399,-20
2720057910,2720057917,7,1923,1273,-20
2720653173,2720653185,12,2674,1657,-20
2720858002,2720858006,4,1714,890,-20
2725097859,2725097865,6,2815,2098,-20
2725286422,2725286427,5,1328,1182,-20
2727406258,2727406261,3,1457,997,-20
2729226447,2729226448,1,1207,1797,-20
2729580854,2729580854,0,1867,2901,-20
2730282854,2730282859,5,1790,1316,-20
2734167072,2734167075,3,1532,1168,-20
2735352426,2735352426,0,2290,1345,-20
2735900060,2735900062,2,2208,1711,-20
2736143723,2736143729,6,1066,759,-20
2738157985,2738157989,4,3031,1893,-20
2743382422,2743382427,5,2432,1649,-20
2745235782,2745235785,3,2267,1630,-20
2749215496,2749215498,2,1325,1775,-20
2750308707,2750308710,3,2658,1771,-20
2750382258,2750382262,4,1810,1489,-20
2750532997,2750533002,5,1298,1530,-20
2753024036,2753024040,4,1841,1081,-20
2757166276,2757166279,3,2267,1506,-20
2759241660,2759241662,2,1371,1018,-20
2760818886,2760818890,4,1814,1931,-20
2761828402,2761828407,5,1686,1214,-20
2761986708,2761986710,2,1418,1870,-20
2763722692,2763722695,3,1897,1395,-20
2766999593,2766999597,4,1806,1409,-20
2769664269,2769664273,4,1950,1338,-20
2770347964,2770347967,3,1271,812,-20
2770507102,2770507083,-19,1892,724,-20
2772153898,2772153903,5,1019,1142,-20
2772601461,2772601466,5,2019,1235,-20
2777009612,2777009615,3,2213,1400,-20
2780629550,2780629554,4,2162,1341,-20
2780860973,2780860974,1,1857,1592,-20
2782723170,2782723173,3,1766,1261,-20
2784146938,2784146924,-14,2123,1424,-20
2784306785,2784306789,4,2026,1923,-20
2784414517,2784414521,4,2489,1959,-20
2786803922,2786803925,3,1714,1174,-20
2789032464,2789032467,3,1881,1570,-20
2792276473,2792276474,1,1915,1196,-20
2793853495,2793853499,4,2651,1375,-20
2794893759,2794893762,3,1340,1358,-20
2795550712,2795550718,6,2656,1343,-20
2798773399,2798773402,3,2004,1745,-20
2800527505,2800527507,2,2015,1189,-20
2801824478,2801824481,3,1754,1258,-20
2802437478,2802437478,0,1167,1063,-20
2803481025,2803481026,1,2127,1471,-20
2805319231,2805319234,3,1585,1399,-20
2809793441,2809793443,2,1883,1228,-20
2814807401,2814807403,2,1577,1421,-20
2815904983,2815904985,2,1286,1165,-20
2817827805,2817827807,2,1194,777,-20
2819504482,2819504485,3,1276,1476,-20
2821515104,2821515109,5,9070,19901,-20
2822487106,2822487110,4,1841,1569,-20
2827393527,2827393527,0,1286,1955,-20
2829516942,2829516946,4,1664,1595,-20
2829857815,2829857819,4,1787,1091,-20
2830518139,2830518142,3,1163,1451,-20
2834876420,2834876423,3,1771,1472,-20
2835508734,2835508736,2,1983,1899,-20
2838815121,2838815126,5,2684,2001,-20
2838946997,2838947001,4,1433,1563,-20
2841683593,2841683594,1,1362,1646,-20
2842273547,2842273547,0,1227,1039,-20
2842376094,2842376099,5,2444,1364,-20
2842658818,2842658822,4,1795,1344,-20
2843283840,2843283845,5,2078,1552,-20
2846432925,2846432927,2,1841,1830,-20
2849385946,2849385945,-1,903,918,-20
2851527559,2851527560,1,2679,3543,-20
2853333236,2853333239,3,1822,1479,-20
2854028107,2854028113,6,12002,20857,-20
2855582199,2855582203,4,1977,1379,-20
2856206623,2856206625,2,2272,1402,-20
2857614995,2857614999,4,1690,1157,-20
2859465170,2859465175,5,2038,2073,-20
2860575337,2860575334,-3,2595,5336,-20
2862375589,2862375594,5,1760,1413,-20
2865210342,2865210346,4,2061,1288,-20
2865851576,2865851580,4,2057,1507,-20
2866878366,2866878370,4,2600,1599,-20
2867527085,2867527090,5,2073,1605,-20
2872627707,2872627705,-2,914,2033,-20
2874459961,2874459962,1,1290,948,-20
2875743750,2875743754,4,1810,1862,-20
2876133169,2876133170,1,1926,1697,-20
2877846242,2877846242,0,1161,1964,-20
2881720829,2881720835,6,2196,1326,-20
2883478453,2883478456,3,2127,1312,-20
2884806768,2884806771,3,1795,1632,-20
2885339265,2885339267,2,2268,1727,-20
2885407959,2885407963,4,2860,1373,-20
2888897810,2888897810,0,1569,1197,-20
2890298762,2890298767,5,2387,1376,-20
2891155701,2891155707,6,2714,1525,-20
2899109434,2899109437,3,2048,1833,-20
2900507844,2900507849,5,2339,1107,-20
2903349754,2903349758,4,1338,1082,-20
2905646825,2905646826,1,2403,1399,-20
2908020559,2908020566,7,650,935,-20
2911696546,2911696550,4,1652,1209,-20
2913929424,2913929427,3,2242,1452,-20
2915091221,2915091223,2,2058,1369,-20
2917567950,2917567951,1,1886,853,-20
2918394153,2918394161,8,1778,2031,-20
2919600803,2919600808,5,1355,1001,-20
2921389141,2921389146,5,2614,1129,-20
2922327113,2922327116,3,1681,2081,-20
2923330958,2923330962,4,2093,1671,-20
2928922000,2928922004,4,1871,1372,-20
2934764311,2934764313,2,2412,1526,-20
2941086106,2941086111,5,1941,1417,-20
2941256150,2941256155,5,1222,1389,-20
2944105827,2944105830,3,1336,905,-20
2944719142,2944719145,3,2319,1477,-20
2946967622,2946967627,5,1915,1081,-20
2948966210,2948966224,14,1934,1523,-20
2949304757,2949304762,5,2165,1246,-20
2951343509,2951343511,2,1493,1042,-20
2956529778,2956529781,3,1535,888,-20
2959172825,2959172831,6,1489,1379,-20
2960779789,2960779794,5,2443,1546,-20
2962684164,2962684169,5,3271,1770,-20
2962850094,2962850100,6,1728,1248,-20
2968500749,2968500751,2,1692,1445,-20
2969932856,2969932859,3,2286,1562,-20
2970637185,2970637189,4,1878,1115,-20
2974155053,2974155054,1,1291,1333,-20
2974221942,2974221947,5,1174,1186,-20
2976735155,2976735155,0,1955,1127,-20
2977704070,2977704070,0,2263,2043,-20
2981575438,2981575442,4,1934,1585,-20
2981832020,2981832023,3,1836,1454,-20
2982233137,2982233141,4,2997,2180,-20
2982711239,2982711241,2,1532,2013,-20
2984772994,2984772996,2,2089,1599,-20
2986709408,2986709412,4,1819,1463,-20
2987868267,2987868270,3,1434,1494,-20
2988239864,2988239869,5,2189,1425,-20
2989773314,2989773319,5,2112,1583,-20
2991583029,2991583031,2,1879,1702,-20
2991702166,2991702169,3,2571,1774,-20
2993510143,2993510148,5,2808,1902,-20
2994103079,2994103082,3,1727,1039,-20
3000618241,3000618245,4,2150,1412,-20
3001158974,3001158978,4,2240,1652,-20
3003303433,3003303436,3,1671,1080,-20
3004874450,3004874450,0,1389,1690,-20
3005964414,3005964417,3,1978,1465,-20
3006160066,3006160068,2,2127,1353,-20
3006496408,3006496427,19,1796,1416,-20
3007621926,3007621929,3,2266,1833,-20
3007744340,3007744345,5,2555,1522,-20
3007817329,3007817333,4,2055,1820,-20
3013567194,3013567198,4,1819,1236,-20
3014129536,3014129538,2,1406,1650,-20
3017039852,3017039854,2,1784,1521,-20
3017261400,3017261396,-4,1466,3754,-20
3019649766,3019649770,4,1382,1177,-20
3021683502,3021683505,3,2479,1977,-20
3021925262,3021925265,3,1873,1504,-20
3023675155,3023675160,5,1846,1517,-20
3025807206,3025807210,4,2269,1535,-20
3027020243,3027020246,3,1378,1201,-20
3029955827,3029955830,3,1637,1625,-20
3030599177,3030599181,4,2029,1420,-20
3030786266,3030786270,4,1489,1059,-20
3031688542,3031688537,-5,1770,8129,-20
3034533825,3034533828,3,2009,1446,-20
3040301553,3040301556,3,1818,1448,-20
3040389974,3040389995,21,1363,967,-20
3041530604,3041530607,3,1283,984,-20
3042027088,3042027089,1,1813,1454,-20
3042569737,3042569738,1,1677,1344,-20
3046399575,3046399577,2,2001,1561,-20
3049868014,3049868018,4,1159,856,-20
3054405766,3054405769,3,1424,1256,-20
3059419055,3059419059,4,1984,1190,-20
3059776037,3059776056,19,1612,1379,-20
3060102269,3060102273,4,2184,1416,-20
3063369351,3063369354,3,1939,1222,-20
3064265890,3064265890,0,1068,1270,-20
3064354062,3064354057,-5,21096,14193,-20
3066199600,3066199605,5,1762,1074,-20
3077198321,3077198326,5,1821,1405,-20
3078114336,3078114340,4,1774,1265,-20
3078669872,3078669876,4,1118,1105,-20
3080248596,3080248597,1,1775,1389,-20
3080392526,3080392531,5,1736,1147,-20
3081755757,3081755766,9,9531,31467,-20
3083888342,3083888346,4,2144,1199,-20
3084063680,3084063682,2,2035,1455,-20
3084972978,3084972978,0,1658,1300,-20
3085633417,3085633412,-5,1028,3550,-20
3086336186,3086336190,4,1806,1185,-20
3086885691,3086885692,1,1487,1389,-20
3087130368,3087130370,2,2287,1547,-20
3087767313,3087767319,6,1913,1458,-20
3088844949,3088844945,-4,32287,16365,-20
3089587235,3089587240,5,1521,1425,-20
3094745978,3094745972,-6,2006,12843,-20
3097459249,3097459252,3,1972,1708,-20
3098307176,3098307179,3,2620,1729,-20
3099674592,3099674597,5,2927,1550,-20
3100524342,3100524347,5,1977,1472,-20
3103933020,3103933017,-3,629,2972,-20
3104410003,3104410007,4,2671,1629,-20
3104584223,3104584224,1,1691,1041,-20
3105255365,3105255370,5,2062,1517,-20
3105470223,3105470227,4,1945,1341,-20
3106107183,3106107187,4,2257,1693,-20
3109203443,3109203430,-13,9772,40060,-20
3109321994,3109321998,4,1817,1310,-20
3114190223,3114190225,2,1674,1352,-20
3114368926,3114368930,4,2219,2120,-20
3115806654,3115806658,4,2064,1067,-20
3117325806,3117325809,3,1186,1439,-20
3118968346,3118968350,4,1983,2026,-20
3120142024,3120142026,2,1531,1425,-20
3124188342,3124188346,4,1757,1441,-20
3126975378,3126975380,2,2195,1905,-20
3128253893,3128253897,4,2012,1372,-20
3132114258,3132114261,3,1899,1547,-20
3133337535,3133337537,2,2004,1711,-20
3133673386,3133673387,1,1672,1668,-20
3134451124,3134451131,7,2315,1371,-20
3136272073,3136272077,4,2047,1329,-20
3138871507,3138871510,3,2113,2029,-20
3141242021,3141242027,6,1523,1570,-20
3143496937,3143496939,2,803,1492,-20
3143775967,3143775973,6,2045,1588,-20
3145964179,3145964178,-1,923,789,-20
3148605628,3148605634,6,6061,2047,-20
3151823647,3151823650,3,1365,865,-20
3152113722,3152113727,5,1241,915,-20
3154529980,3154529985,5,2314,1892,-20
3157449869,3157449874,5,2131,1606,-20
3158357989,3158357991,2,1940,1478,-20
3162546205,3162546205,0,1925,1707,-20
3163722982,3163722983,1,1301,1602,-20
3170613248,3170613253,5,2814,1391,-20
3172792143,3172792145,2,1924,2423,-20
3172929181,3172929184,3,1694,1558,-20
3175480313,3175480317,4,1960,1595,-20
3178185355,3178185360,5,1821,1436,-20
3179206414,3179206418,4,1505,1373,-20
3182182875,3182182878,3,1294,1304,-20
3187548165,3187548167,2,971,2256,-20
3188937657,3188937661,4,1682,1295,-20
3190125997,3190125998,1,1406,1093,-20
3191657671,3191657673,2,1730,1107,-20
3197389063,3197389065,2,1902,2109,-20
3198331595,3198331597,2,1428,1299,-20
3199130469,3199130468,-1,1431,2010,-20
3200442037,3200442038,1,1281,1476,-20
3207264131,3207264135,4,2067,1496,-20
3210329334,3210329340,6,3406,2291,-20
3212113982,3212113987,5,1316,1758,-20
3216569810,3216569814,4,2266,1299,-20
3219667137,3219667138,1,1769,1713,-20
3219952378,3219952379,1,1638,1780,-20
3225378107,3225378112,5,1926,1255,-20
3225508120,3225508122,2,1044,1618,-20
3226832725,3226832727,2,1905,1271,-20
3230375005,3230375006,1,1841,1747,-20
3231449071,3231449075,4,1097,1251,-20
3232677592,3232677593,1,1540,1730,-20
3237284081,3237284086,5,1945,1444,-20
3238792667,3238792670,3,1808,1004,-20
3239310563,3239310563,0,1344,2334,-20
3239774013,3239774018,5,1643,1519,-20
3243334786,3243334787,1,1143,1534,-20
3247859791,3247859796,5,2713,1505,-20
3255119396,3255119398,2,1233,1086,-20
3256725367,3256725369,2,1917,2560,-20
3258675214,3258675217,3,1167,1136,-20
3260690050,3260690052,2,2363,1051,-20
3263133074,3263133077,3,1913,1452,-20
3263829529,3263829533,4,2633,2185,-20
3264278843,3264278845,2,1153,933,-20
3266944850,3266944852,2,1967,1219,-20
3267568194,3267568195,1,1001,1008,-20
3270635228,3270635232,4,1189,1363,-20
3275428828,3275428830,2,1492,1634,-20
3280581291,3280581285,-6,1042,4439,-20
3285148550,3285148551,1,1779,1367,-20
3294064397,3294064402,5,1378,1428,-20
3298863354,3298863358,4,2802,1695,-20
3300145678,3300145679,1,1878,2114,-20
3304132038,3304132041,3,2434,1412,-20
3304853386,3304853386,0,1220,1332,-20
3305705315,3305705318,3,2192,2245,-20
3305781365,3305781367,2,1788,1617,-20
3310492105,3310492107,2,1654,1583,-20
3312952403,3312952405,2,972,1270,-20
3315907025,3315907029,4,1865,1783,-20
3316311887,3316311891,4,2041,1336,-20
3319339234,3319339230,-4,1051,2959,-20
3321768370,3321768374,4,1599,1721,-20
3330971648,3330971651,3,1968,1534,-20
3331749082,3331749087,5,977,782,-20
3339169853,3339169854,1,1540,1088,-20
3340084239,3340084242,3,1595,1189,-20
3343126858,3343126862,4,1919,1430,-20
3343184771,3343184773,2,2130,1208,-20
3348925908,3348925913,5,16168,43393,-20
3349981622,3349981624,2,1445,1427,-20
3352310201,3352310203,2,1762,1747,-20
3353015514,3353015517,3,1923,1583,-20
3354055758,3354055762,4,1646,1426,-20
3355690789,3355690793,4,2218,1303,-20
3355783734,3355783735,1,1494,1348,-20
3356910358,3356910362,4,1449,1026,-20
3358026093,3358026098,5,1634,1247,-20
3359864797,3359864797,0,2537,3141,-20
3360776694,3360776695,1,1686,1660,-20
3360989950,3360989951,1,1677,1168,-20
3361152217,3361152219,2,1509,1448,-20
3363966337,3363966341,4,3757,2538,-20
3364157864,3364157868,4,1182,1123,-20
3365173854,3365173857,3,1498,1292,-20
3369070334,3369070338,4,1786,1598,-20
3375682484,3375682487,3,2352,1623,-20
3381943957,3381943958,1,1498,1185,-20
3382720365,3382720365,0,1529,1414,-20
3383610596,3383610601,5,3544,1761,-20
3384762234,3384762233,-1,1257,1408,-20
3390888194,3390888198,4,2491,1651,-20
3391237544,3391237546,2,1725,1701,-20
3393384626,3393384626,0,1030,1631,-20
3394069419,3394069423,4,1820,1278,-20
3394160324,3394160304,-20,1110,709,-20
3394435662,3394435665,3,2276,1841,-20
3394687790,3394687791,1,2170,1938,-20
3394932034,3394932038,4,1673,1434,-20
3395559525,3395559530,5,1518,1382,-20
3396175832,3396175839,7,1443,762,-20
3398200683,3398200685,2,1672,1321,-20
3398609681,3398609667,-14,1859,1017,-20
3399256232,3399256238,6,1751,1510,-20
3399812283,3399812287,4,1440,1197,-20
3400421191,3400421193,2,1530,1318,-20
3401922685,3401922689,4,1849,828,-20
3403123603,3403123606,3,2399,1197,-20
3403920344,3403920347,3,1388,1329,-20
3411360537,3411360539,2,1292,1416,-20
3412380724,3412380729,5,1687,1492,-20
3412544944,3412544942,-2,1361,1846,-20
3416691019,3416691022,3,1096,1090,-20
3418875428,3418875430,2,1653,1080,-20
3423080917,3423080918,1,1302,1292,-20
3423720950,3423720950,0,2058,2310,-20
3436477429,3436477434,5,2208,1743,-20
3437127434,3437127438,4,2506,1782,-20
3442376177,3442376181,4,1664,1314,-20
3443746485,3443746491,6,1805,1210,-20
3444378782,3444378785,3,1393,1372,-20
3445658390,3445658370,-20,1193,958,-20
3449227127,3449227129,2,1567,1312,-20
3449547831,3449547843,12,2297,1240,-20
3450013057,3450013055,-2,2546,3353,-20
3450817098,3450817103,5,2078,2090,-20
3451680579,3451680579,0,2218,1606,-20
3451784878,3451784860,-18,2043,1727,-20
3452698442,3452698443,1,2226,1901,-20
3453312918,3453312921,3,1790,1290,-20
3455109317,3455109321,4,1684,1387,-20
3455550678,3455550682,4,985,760,-20
3456692276,3456692280,4,1563,1409,-20
3456834232,3456834242,10,1917,1126,-20
3457990106,3457990110,4,1541,1321,-20
3458925302,3458925305,3,1615,1808,-20
3460574981,3460574985,4,2534,1863,-20
3462321198,3462321202,4,2121,1839,-20
3462416048,3462416052,4,1551,1053,-20
3463845945,3463845949,4,1921,1875,-20
3465339936,3465339938,2,1761,1468,-20
3466231338,3466231341,3,676,542,-20
3467581122,3467581127,5,2044,921,-20
3470296745,3470296749,4,1699,1117,-20
3470681353,3470681369,16,2357,1662,-20
3470761717,3470761697,-20,1028,656,-20
3474575717,3474575717,0,1088,2018,-20
3481123291,3481123294,3,2510,1339,-20
3486540974,3486540979,5,1708,1614,-20
3487079181,3487079184,3,1511,2531,-20
3487661724,3487661726,2,1667,1043,-20
3490257417,3490257419,2,1416,1280,-20
3492424761,3492424761,0,1356,1328,-20
3493818252,3493818255,3,1332,1284,-20
3494313701,3494313703,2,1639,1789,-20
3501240092,3501240094,2,1815,1458,-20
3501969096,3501969099,3,2541,1976,-20
3504830510,3504830515,5,1949,1318,-20
3505910004,3505910006,2,1887,1371,-20
3507566915,3507566918,3,1522,1477,-20
3508397950,3508397955,5,2146,1501,-20
3509989700,3509989702,2,1824,1316,-20
3512925614,3512925619,5,1443,1018,-20
3514565207,3514565210,3,1540,1347,-20
3514791773,3514791775,2,1600,1689,-20
3517206989,3517206991,2,1796,1641,-20
3519063506,3519063509,3,1383,1127,-20
3519479543,3519479546,3,595,306,-20
3522068852,3522068854,2,1124,814,-20
3524211853,3524211857,4,1278,1542,-20
3525517857,3525517862,5,1951,1465,-20
3526140721,3526140726,5,2041,1124,-20
3527637082,3527637099,17,1354,1045,-20
3530553716,3530553718,2,2400,1639,-20
3531228622,3531228625,3,2059,1490,-20
3534056190,3534056194,4,1500,960,-20
3535039482,3535039485,3,2179,1209,-20
3535645436,3535645436,0,1418,1757,-20
3539121660,3539121662,2,983,839,-20
3540028430,3540028433,3,2257,2303,-20
3541303446,3541303447,1,1572,1443,-20
3546167015,3546167015,0,1441,2045,-20
3557015729,3557015733,4,1744,1021,-20
3557583875,3557583880,5,1699,1636,-20
3560298382,3560298371,-11,1277,1195,-20
3562181227,3562181233,6,1415,1122,-20
3563429194,3563429197,3,2088,1267,-20
3566915325,3566915328,3,1915,1094,-20
3568936406,3568936409,3,1397,1089,-20
3569031176,3569031178,2,1636,1238,-20
3572856447,3572856450,3,1940,1323,-20
3574265502,3574265508,6,1617,1433,-20
3578986093,3578986096,3,1927,1156,-20
3580266983,3580266985,2,1535,1422,-20
3583008681,3583008683,2,2038,1442,-20
3583100226,3583100242,16,1458,1251,-20
3583583806,3583583809,3,1553,1086,-20
3585590698,3585590700,2,2196,1448,-20
3585816436,3585816418,-18,2258,2190,-20
3588030606,3588030608,2,1361,1033,-20
3590498125,3590498128,3,1609,1608,-20
3591088013,3591088018,5,1726,1557,-20
3592297744,3592297738,-6,3594,12392,-20
3592549567,3592549570,3,1442,1691,-20
3596316289,3596316290,1,1813,1488,-20
3598175569,3598175575,6,4042,2506,-20
3598926478,3598926482,4,2047,1407,-20
3600592789,3600592790,1,2335,2223,-20
3605091042,3605091046,4,1620,1133,-20
3608966935,3608966941,6,2023,1396,-20
3615937062,3615937067,5,2013,1102,-20
3616111474,3616111476,2,1934,1582,-20
3616320882,3616320885,3,1549,1940,-20
3620187059,3620187073,14,15890,37517,-20
3620792049,3620792050,1,1531,1651,-20
3622573330,3622573333,3,1330,1259,-20
3624887374,3624887377,3,1971,1677,-20
3625453330,3625453335,5,3120,1865,-20
3629661881,3629661860,-21,1775,1831,-20
3635159073,3635159076,3,1302,1398,-20
3636333378,3636333383,5,3374,1577,-20
3636766647,3636766626,-21,1295,1464,-20
3638782419,3638782422,3,2214,1520,-20
3639903646,3639903650,4,1561,1048,-20
3641073963,3641073966,3,1349,1553,-20
3643676318,3643676322,4,1683,1175,-20
3646964011,3646964015,4,1526,1279,-20
3647132567,3647132573,6,2246,1558,-20
3649526683,3649526675,-8,689,2977,-20
3650813098,3650813101,3,2233,1279,-20
3653175392,3653175397,5,2617,1502,-20
3655063482,3655063486,4,2076,1723,-20
3657117030,3657117034,4,1387,1167,-20
3659497052,3659497055,3,1864,1724,-20
3659593526,3659593530,4,972,1089,-20
3660063965,3660063969,4,1594,1307,-20
3663607489,3663607491,2,2140,1359,-20
3664047296,3664047301,5,2398,1319,-20
3665061763,3665061767,4,1459,847,-20
3666777070,3666777074,4,1987,1028,-20
3666830893,3666830904,11,2038,1054,-20
3668159456,3668159458,2,1289,801,-20
3669343887,3669343892,5,1456,744,-20
3671250606,3671250608,2,2726,1998,-20
3673236797,3673236799,2,1587,1265,-20
3674894819,3674894823,4,2523,1508,-20
3682308887,3682308893,6,1739,926,-20
3689508780,3689508782,2,1692,1244,-20
3691055047,3691055055,8,1628,1023,-20
3691649229,3691649231,2,2209,1579,-20
3693723523,3693723527,4,1586,797,-20
3693822799,3693822802,3,2838,1553,-20
3695108830,3695108834,4,373,654,-20
3696635606,3696635611,5,1332,1061,-20
3699301469,3699301474,5,1402,1333,-20
3702405570,3702405568,-2,1482,2476,-20
3702562678,3702562681,3,2374,1389,-20
3703932592,3703932595,3,1502,1199,-20
3707007163,3707007163,0,2270,1448,-20
3708478966,3708478971,5,2428,1408,-20
3709623073,3709623077,4,2938,2368,-20
3710117699,3710117702,3,1879,1189,-20
3712691895,3712691898,3,2426,1548,-20
3712972352,3712972357,5,1971,1936,-20
3716146403,3716146406,3,1208,1705,-20
3717530330,3717530333,3,2108,1451,-20
3718029670,3718029673,3,2046,1316,-20
3718414314,3718414314,0,1614,1529,-20
3719432537,3719432539,2,1781,1159,-20
3722734026,3722734028,2,1805,1117,-20
3724744094,3724744094,0,1309,1769,-20
3725943317,3725943317,0,1538,2012,-20
3726994587,3726994591,4,2640,2146,-20
3727916446,3727916450,4,1982,1127,-20
3733098711,3733098714,3,1264,780,-20
3734716636,3734716638,2,1755,1806,-20
3735623769,3735623771,2,1406,1332,-20
3737051261,3737051266,5,1705,1347,-20
3739154368,3739154371,3,2017,974,-20
3741594146,3741594135,-11,25615,15296,-20
3741671654,3741671656,2,1482,1278,-20
3743030370,3743030375,5,2033,1262,-20
3743719874,3743719877,3,1432,1191,-20
3745986374,3745986374,0,1295,1786,-20
3747572612,3747572614,2,2350,1574,-20
3748413235,3748413233,-2,1022,2167,-20
3754949038,3754949042,4,759,882,-20
3758179386,3758179387,1,1414,1109,-20
3759348288,3759348294,6,1495,1137,-20
3762342009,3762341988,-21,1987,2186,-20
3764628782,3764628789,7,1932,1363,-20
3771414621,3771414623,2,1384,1829,-20
3774120717,3774120720,3,2337,1195,-20
3774308202,3774308187,-15,527,232,-20
3777153478,3777153483,5,1792,1505,-20
3780219717,3780219720,3,1380,1528,-20
3784625069,3784625075,6,2441,1088,-20
3784670768,3784670773,5,1743,1302,-20
3794090842,3794090837,-5,1175,3513,-20
3801367206,3801367208,2,1545,1239,-20
3801930650,3801930656,6,1140,1003,-20
3803431640,3803431645,5,2225,1304,-20
3803524099,3803524115,16,656,263,-20
3803581409,3803581410,1,1366,1215,-20
3804865828,3804865830,2,1153,862,-20
3808756570,3808756571,1,1557,1868,-20
3814586614,3814586619,5,1540,1540,-20
3815219566,3815219572,6,2180,39579,-20
3815622865,3815622868,3,2026,1428,-20
3817720364,3817720371,7,1323,912,-20
3820287058,3820287053,-5,795,1369,-20
3822908521,3822908526,5,2339,1995,-20
3825560496,3825560502,6,1338,1168,-20
3826052692,3826052694,2,2114,1797,-20
3827769958,3827769958,0,1099,1084,-20
3829606785,3829606765,-20,2358,1425,-20
3830498760,3830498762,2,2138,1433,-20
3832839364,3832839368,4,1818,1433,-20
3834639713,3834639720,7,204,1998,-20
3838382045,3838382042,-3,1211,2006,-20
3841127221,3841127222,1,1397,897,-20
3841658227,3841658230,3,2489,1631,-20
3846539490,3846539495,5,1499,1338,-20
3847753179,3847753179,0,1151,1320,-20
3851642678,3851642681,3,929,1032,-20
3853267962,3853267967,5,1565,1406,-20
3855214614,3855214622,8,3191,1397,-20
3856045261,3856045266,5,2034,1614,-20
3859484963,3859484967,4,2797,1638,-20
3862808205,3862808209,4,1457,948,-20
3863101509,3863101512,3,1581,1228,-20
3864225838,3864225839,1,1943,1666,-20
3864857375,3864857378,3,1745,1380,-20
3865041169,3865041174,5,2433,1696,-20
3865963749,3865963753,4,2057,1330,-20
3868505373,3868505378,5,1280,1215,-20
3869942074,3869942080,6,1797,1367,-20
3870049790,3870049770,-20,1876,1317,-20
3871656783,3871656786,3,1961,1440,-20
3875409175,3875409177,2,2311,1583,-20
3876570661,3876570665,4,1664,1113,-20
3876674685,3876674706,21,2392,1613,-20
3877263399,3877263403,4,1321,1338,-20
3877496758,3877496759,1,1328,1497,-20
3879852965,3879852967,2,2326,1743,-20
3884780590,3884780593,3,1124,1441,-20
3897245355,3897245357,2,1176,1398,-20
3898740126,3898740133,7,2228,1991,-20
3899226246,3899226249,3,1726,1613,-20
3907661790,3907661794,4,2513,2017,-20
3908183107,3908183112,5,1251,1340,-20
3910341100,3910341103,3,2066,1673,-20
3912511600,3912511606,6,1744,1126,-20
3916490593,3916490595,2,1602,1540,-20
3919716995,3919716998,3,1836,1584,-20
3921193632,3921193635,3,1718,1499,-20
3921435355,3921435350,-5,1283,4574,-20
3926191283,3926191287,4,1907,1267,-20
3928406767,3928406770,3,1216,1195,-20
3930391008,3930391011,3,947,1083,-20
3930981816,3930981818,2,1850,1840,-20
3934943035,3934943039,4,1692,1256,-20
3935060583,3935060563,-20,1572,1041,-20
3938525066,3938525069,3,2551,1378,-20
3941167699,3941167703,4,2034,1529,-20
3941722450,3941722454,4,1282,1195,-20
3945235170,3945235171,1,1408,1637,-20
3946813188,3946813194,6,2939,1488,-20
3951799677,3951799680,3,1912,1845,-20
3951916451,3951916455,4,2006,1054,-20
3952528690,3952528693,3,1227,996,-20
3952576195,3952576198,3,1997,1204,-20
3952949670,3952949673,3,1899,1700,-20
3957013632,3957013637,5,1724,1308,-20
3959064267,3959064274,7,3048,1070,-20
3960850367,3960850370,3,1573,1218,-20
3965918605,3965918608,3,1827,778,-20
3966104256,3966104251,-5,865,283,-20
3968546118,3968546114,-4,1179,2245,-20
3969958249,3969958252,3,1035,943,-20
3974215869,3974215871,2,2023,2000,-20
3981676223,3981676226,3,1764,1754,-20
3984533508,3984533511,3,2135,2114,-20
3984637819,3984637823,4,1831,1861,-20
3986185525,3986185529,4,1917,1687,-20
3993337011,3993337002,-9,1536,9336,-20
3995895020,3995895023,3,1548,1463,-20
3996584857,3996584859,2,1364,1153,-20
3996990620,3996990621,1,1446,1563,-20
4002878302,4002878297,-5,1938,8383,-20
4004549978,4004549982,4,2283,1607,-20
4005726657,4005726653,-4,1312,13154,-20
4007407903,4007407906,3,1920,1399,-20
4010176300,4010176303,3,1311,1378,-20
4011270244,4011270248,4,2648,1518,-20
4012141081,4012141086,5,1735,1612,-20
4012996665,4012996667,2,683,997,-20
4016830410,4016830411,1,1772,1349,-20
4017558578,4017558582,4,1601,1659,-20
4020163772,4020163774,2,1826,1585,-20
4020718678,4020718681,3,1785,1986,-20
4021157965,4021157968,3,1391,1308,-20
4022308975,4022308986,11,1185,1501,-20
4022642466,4022642470,4,2106,1087,-20
4022796395,4022796379,-16,2249,1945,-20
4024111445,4024111451,6,2023,1187,-20
4025272707,4025272709,2,1844,1393,-20
4029267151,4029267154,3,1983,1331,-20
4031028166,4031028170,4,2422,1359,-20
4031638866,4031638850,-16,1999,1352,-20
4031720794,4031720798,4,1309,1254,-20
4033807615,4033807619,4,2016,1746,-20
4036883214,4036883218,4,2609,1782,-20
4041109747,4041109750,3,1093,1062,-20
4041973305,4041973306,1,2011,1585,-20
4046151727,4046151739,12,11980,45337,-20
4048471214,4048471218,4,2163,1469,-20
4052973908,4052973908,0,1886,1458,-20
4059751169,4059751171,2,1532,699,-20
4060795002,4060795007,5,2417,1304,-20
4064313131,4064313134,3,1592,2096,-20
4067094038,4067094041,3,1328,1234,-20
4070502453,4070502455,2,1374,1130,-20
4072086402,4072086421,19,82,708,-20
4072828506,4072828510,4,2182,1581,-20
4078189608,4078189611,3,1310,1202,-20
4078467457,4078467471,14,199,660,-20
4083303319,4083303323,4,2204,2024,-20
4084074003,4084074006,3,2384,1898,-20
4084412090,4084412086,-4,1465,4478,-20
4084970204,4084970206,2,2370,1408,-20
4088054154,4088054158,4,1045,973,-20
4089601431,4089601436,5,2661,1416,-20
4089952250,4089952254,4,1469,1257,-20
4091248806,4091248810,4,2931,1606,-20
4091950239,4091950241,2,1120,819,-20
4092469894,4092469898,4,1956,2011,-20
4094208436,4094208438,2,1307,1206,-20
4098430734,4098430737,3,1044,844,-20
4100438955,4100438949,-6,1365,5421,-20
4106283943,4106283945,2,1865,1452,-20
4107528936,4107528939,3,1849,1442,-20
4107786375,4107786383,8,2453,1445,-20
4108403258,4108403263,5,1564,1566,-20
4115855682,4115855685,3,1835,1455,-20
4117983928,4117983930,2,1246,1015,-20
4120751454,4120751461,7,1473,1041,-20
4125348288,4125348291,3,1689,1337,-20
4128946462,4128946466,4,2791,2271,-20
4132332952,4132332955,3,1454,1247,-20
4133952254,4133952259,5,2289,1073,-20
4137578248,4137578251,3,1286,1125,-20
4141193193,4141193194,1,1094,938,-20
4146243939,4146243958,19,1473,900,-20
4146699011,4146699015,4,1543,1124,-20
4151716223,4151716227,4,1570,1234,-20
4153879242,4153879246,4,2059,1383,-20
4158204450,4158204450,0,1288,1240,-20
4158415602,4158415605,3,1757,1713,-20
4158442410,4158442413,3,1352,1182,-20
4162703460,4162703465,5,1603,1111,-20
4163137239,4163137220,-19,949,1264,-20
4164162705,4164162709,4,2264,1500,-20
4164518599,4164518602,3,2191,1509,-20
4168660474,4168660482,8,16160,25692,-20
4169930318,4169930322,4,1666,1529,-20
4173203378,4173203382,4,2602,1420,-20
4174332603,4174332603,0,1185,1849,-20
4176211845,4176211850,5,2588,1720,-20
4178250145,4178250146,1,1746,1556,-20
4188567313,4188567318,5,1634,1446,-20
4188795103,4188795106,3,1474,1148,-20
4190208453,4190208457,4,2174,1061,-20
4190842806,4190842811,5,1724,1096,-20
4191728504,4191728502,-2,1117,2057,-20
4195600094,4195600098,4,1999,1642,-20
4197673369,4197673372,3,2197,1633,-20
4204472610,4204472613,3,2147,1874,-20
4204760967,4204760970,3,1647,1401,-20
4207424729,4207424730,1,2173,1407,-20
4207585691,4207585698,7,2168,1029,-20
4208140529,4208140528,-1,1209,1675,-20
4210499929,4210499931,2,1765,1450,-20
4210620045,4210620040,-5,1167,2588,-20
4216966577,4216966578,1,1350,1283,-20
4222258678,4222258682,4,1546,1405,-20
4222473027,4222473031,4,1831,1515,-20
4223780304,4223780307,3,2400,1866,-20
4224431963,4224431968,5,2246,1151,-20
4229865849,4229865854,5,3773,2207,-20
4230762701,4230762704,3,2007,1488,-20
4232639496,4232639499,3,1393,1458,-20
4233358188,4233358191,3,1449,1025,-20
4233899520,4233899524,4,2617,1475,-20
4234491591,4234491597,6,2498,1802,-20
4234567402,4234567405,3,2053,1444,-20
4234793142,4234793120,-22,2138,1693,-20
4235802471,4235802475,4,2243,1298,-20
4237012147,4237012151,4,2378,1394,-20
4242288109,4242288114,5,1638,1536,-20
4242715454,4242715457,3,1712,1472,-20
4245904142,4245904145,3,1249,1111,-20
4247067819,4247067823,4,1967,1132,-20
4247207919,4247207922,3,1774,1158,-20
4250817611,4250817614,3,1196,1220,-20
4251402241,4251402244,3,1316,1367,-20
4254131728,4254131731,3,1205,1224,-20
4254885358,4254885354,-4,1224,2817,-20
4259572918,4259572923,5,1686,1072,-20
4261575018,4261575021,3,2184,1662,-20
4261978477,4261978479,2,1767,1276,-20
4263412138,4263412143,5,1639,1405,-20
4263729320,4263729323,3,2684,1675,-20
4263963259,4263963261,2,1916,1714,-20
4264697801,4264697803,2,1412,1579,-20
4267331671,4267331675,4,1766,1788,-20
4275895248,4275895252,4,922,1361,-20
4276816838,4276816838,0,1362,1733,-20
4277050607,4277050612,5,2293,1700,-20
4278241758,4278241759,1,1566,1706,-20
4279829274,4279829278,4,2474,1571,-20
4283893531,4283893535,4,1921,1614,-20
4284765982,4284765984,2,1887,1074,-20
4287177775,4287177780,5,2386,1534,-20
4287260752,4287260754,2,2147,1229,-20
4294040363,4294040366,3,2738,1957,-20
4300182186,4300182181,-5,983,3487,-20
4300630170,4300630164,-6,12562,14891,-20
4304393893,4304393897,4,1717,1472,-20
4305560038,4305560042,4,2557,1801,-20
4305589088,4305589091,3,2176,1182,-20
4308312920,4308312922,2,1587,1196,-20
4310075717,4310075723,6,2228,1333,-20
4311327658,4311327661,3,1103,1044,-20
4312176391,4312176370,-21,2000,1229,-20
4315185141,4315185147,6,1893,1471,-20
4320559576,4320559578,2,1830,1601,-20
4321050797,4321050797,0,1488,1930,-20
4322227630,4322227632,2,2096,1324,-20
4336632770,4336632752,-18,944,457,-20
4341597342,4341597346,4,1870,1503,-20
4342238978,4342238982,4,1784,1354,-20
4342399222,4342399226,4,1731,875,-20
4343683628,4343683629,1,1531,1218,-20
4345059697,4345059698,1,1635,1444,-20
4350744485,4350744482,-3,2256,4226,-20
4351129137,4351129141,4,1315,1260,-20
4351352998,4351353002,4,1002,730,-20
4352068166,4352068169,3,1232,1435,-20
4354086245,4354086246,1,1698,1375,-20
4356222935,4356222933,-2,1318,2617,-20
4358379131,4358379137,6,2491,1348,-20
4358690097,4358690102,5,1618,1051,-20
4359177891,4359177897,6,1505,1322,-20
4359232175,4359232179,4,1230,1405,-20
4363060497,4363060502,5,2395,902,-20
4364457421,4364457423,2,1954,1313,-20
4367710583,4367710586,3,1442,1493,-20
4371866018,4371866021,3,1913,1222,-20
4372667772,4372667776,4,2656,1618,-20
4373469650,4373469655,5,1487,1289,-20
4376072750,4376072754,4,1004,1699,-20
4377963553,4377963549,-4,1138,2484,-20
4379453494,4379453493,-1,1193,2115,-20
4383780057,4383780057,0,1172,1265,-20
4385968417,4385968418,1,1719,1471,-20
4386020700,4386020712,12,1253,1024,-20
4389602357,4389602361,4,1630,1310,-20
4394083862,4394083863,1,2106,1731,-20
4394761987,4394761991,4,1830,1185,-20
4396707543,4396707546,3,1604,1227,-20
4396768263,4396768240,-23,1499,1508,-20
4404486167,4404486171,4,2021,1409,-20
4409834691,4409834694,3,1349,1418,-20
4411564583,4411564587,4,1686,1395,-20
4412339364,4412339370,6,3069,1569,-20
4414712175,4414712178,3,1794,1398,-20
4415169726,4415169731,5,1773,1332,-20
4416920821,4416920822,1,1720,923,-20
4422112911,4422112909,-2,740,1352,-20
4423026853,4423026854,1,1766,1430,-20
4428040773,4428040777,4,2133,1645,-20
4430745570,4430745571,1,1804,1455,-20
4431108582,4431108585,3,1047,1047,-20
4432244197,4432244203,6,1574,1302,-20
4442820153,4442820155,2,1009,1225,-20
4443679403,4443679406,3,1843,1525,-20
4445800090,4445800094,4,1638,2152,-20
4448096487,4448096493,6,2176,1121,-20
4458145623,4458145625,2,1340,1003,-20
4464272624,4464272626,2,1367,1054,-20
4466043069,4466043073,4,1639,1587,-20
4466237142,4466237146,4,44734,33474,-20
4466474774,4466474778,4,1383,1489,-20
4467152057,4467152059,2,1821,1613,-20
4467249213,4467249217,4,2356,1219,-20
4471251035,4471251038,3,1419,1496,-20
4477735730,4477735734,4,2167,1407,-20
4478376547,4478376549,2,2652,1998,-20
4483481658,4483481662,4,2592,1778,-20
4484346906,4484346909,3,2391,2084,-20
4486565204,4486565209,5,1888,1021,-20
4486977665,4486977668,3,819,685,-20
4491691825,4491691826,1,1968,1376,-20
4491843034,4491843038,4,2181,1639,-20
4494904905,4494904906,1,1775,1583,-20
4495718016,4495718022,6,1728,1490,-20
4499478973,4499478978,5,1704,1430,-20
4500098667,4500098671,4,1500,1356,-20
4505602684,4505602686,2,1804,1250,-20
4508658712,4508658717,5,1860,890,-20
4509623582,4509623582,0,1351,982,-20
4511054864,4511054860,-4,1844,4559,-20
4512188131,4512188133,2,2161,1838,-20
4514872362,4514872363,1,1059,907,-20
4516392513,4516392517,4,2248,1949,-20
4524811698,4524811702,4,2303,1667,-20
4527138134,4527138134,0,1876,2127,-20
4530745054,4530745057,3,1701,1131,-20
4534718185,4534718186,1,1733,1852,-20
4535090482,4535090486,4,2286,1546,-20
4537789487,4537789496,9,1051,1793,-20
4538535980,4538535982,2,1524,2515,-20
4539936506,4539936510,4,1818,713,-20
4541407198,4541407201,3,1887,1410,-20
4542861407,4542861410,3,1848,1001,-20
4553194140,4553194153,13,16210,46245,-20
4555685135,4555685138,3,2154,1482,-20
4555807025,4555807029,4,1378,1345,-20
4556595679,4556595690,11,1634,1186,-20
4558472248,4558472253,5,2385,1304,-20
4561173452,4561173457,5,2495,1519,-20
4562010120,4562010122,2,1217,1311,-20
4566115678,4566115682,4,1278,1203,-20
4566169710,4566169714,4,2624,1463,-20
4566772178,4566772181,3,1865,1147,-20
4570102781,4570102785,4,2252,2101,-20
4573228489,4573228491,2,1150,1812,-20
4576604468,4576604470,2,2198,1403,-20
4577453615,4577453617,2,1863,1847,-20
4578403560,4578403564,4,2438,2023,-20
4579380258,4579380263,5,2818,1693,-20
4580452482,4580452487,5,1278,1213,-20
4581117545,4581117547,2,1759,1295,-20
4583562982,4583562987,5,2141,1658,-20
4583647295,4583647299,4,1622,1191,-20
4585760996,4585760999,3,2108,1356,-20
4586227146,4586227149,3,1557,1518,-20
4587829091,4587829085,-6,2368,6551,-20
4589410555,4589410563,8,2891,1066,-20
4591398274,4591398277,3,1763,1981,-20
4591984177,4591984181,4,1310,1007,-20
4595324960,4595324965,5,2124,1244,-20
4595574681,4595574683,2,2141,2047,-20
4598642343,4598642340,-3,1138,2646,-20
4599373109,4599373112,3,1170,1556,-20
4601369861,4601369863,2,1285,844,-20
4601535951,4601535954,3,1555,1254,-20
4603319707,4603319708,1,2801,3494,-20
4606690802,4606690805,3,1738,1239,-20
4608655718,4608655721,3,1579,1452,-20
4610628138,4610628142,4,1712,1378,-20
4612065334,4612065338,4,2425,2123,-20
4612195276,4612195271,-5,951,4421,-20
4614660575,4614660578,3,1416,1303,-20
4615227816,4615227821,5,1615,1280,-20
4617436883,4617436885,2,914,481,-20
4619832093,4619832096,3,1898,1751,-20
4620637305,4620637307,2,1716,1552,-20
4621155737,4621155739,2,1240,800,-20
4622954611,4622954616,5,3303,2000,-20
4623695733,4623695735,2,2331,1578,-20
4624957059,4624957063,4,1229,1109,-20
4626482878,4626482882,4,1485,1108,-20
4631290296,4631290300,4,2315,1407,-20
4632847825,4632847828,3,1332,1967,-20
4635185941,4635185944,3,1890,1929,-20
4635299531,4635299534,3,1883,1333,-20
4637187230,4637187235,5,1710,1103,-20
4638519755,4638519758,3,1529,1517,-20
4639132701,4639132705,4,1453,1150,-20
4643538674,4643538675,1,1504,1421,-20
4648578958,4648578962,4,1707,1421,-20
4650954890,4650954891,1,1336,1630,-20
4651803728,4651803730,2,2245,1670,-20
4652464141,4652464146,5,2294,1598,-20
4655420385,4655420387,2,1744,1803,-20
4656327231,4656327234,3,2584,1427,-20
4656627501,4656627503,2,1999,894,-20
4657257068,4657257070,2,1705,967,-20
4665561663,4665561668,5,1519,1340,-20
4665762386,4665762390,4,936,1240,-20
4666330474,4666330477,3,2151,1922,-20
4666577346,4666577350,4,2487,1249,-20
4670063509,4670063511,2,1398,947,-20
4671201841,4671201843,2,1909,1588,-20
4671643133,4671643133,0,1741,1932,-20
4672383358,4672383366,8,9520,28829,-20
4675271400,4675271402,2,1529,1297,-20
4676550038,4676550038,0,2147,1312,-20
4680722682,4680722686,4,1494,1149,-20
4682087277,4682087285,8,2968,976,-20
4682501386,4682501403,17,1670,1110,-20
4685395418,4685395422,4,1826,1149,-20
4686316800,4686316794,-6,1660,6421,-20
4687821004,4687821006,2,1690,927,-20
4689297501,4689297503,2,1607,1469,-20
4697368258,4697368258,0,1615,1702,-20
4700632758,4700632759,1,3382,3124,-20
4702446065,4702446068,3,2409,1612,-20
4706699841,4706699845,4,1741,1688,-20
4716518570,4716518574,4,1371,1130,-20
4720012271,4720012271,0,1641,1032,-20
4721408667,4721408669,2,1779,1515,-20
4721874959,4721874962,3,1511,1031,-20
4723320707,4723320708,1,1234,1730,-20
4727421597,4727421602,5,1458,845,-20
4729716192,4729716194,2,2426,1753,-20
4732951843,4732951847,4,41776,36537,-20
4737853149,4737853151,2,1945,1434,-20
4738668662,4738668666,4,1255,1305,-20
4740902087,4740902091,4,1523,1389,-20
4745093249,4745093252,3,1422,1419,-20
4745471197,4745471198,1,1939,1580,-20
4746439481,4746439486,5,2034,1372,-20
4750447438,4750447433,-5,1464,4071,-20
4750508021,4750508023,2,1843,1604,-20
4750884929,4750884933,4,1939,1733,-20
4751658670,4751658675,5,1937,1141,-20
4757127940,4757127943,3,1801,1300,-20
4766389739,4766389741,2,1520,673,-20
4772621002,4772621008,6,2672,1741,-20
4773335057,4773335062,5,836,1198,-20
4774836354,4774836355,1,1451,1243,-20
4777862657,4777862661,4,1481,1020,-20
4779424353,4779424357,4,1759,1322,-20
4779788122,4779788125,3,1212,1262,-20
4780591850,4780591854,4,1719,1383,-20
4782640707,4782640709,2,1264,1319,-20
4783430373,4783430376,3,2811,1767,-20
4784037972,4784037974,2,2543,1563,-20
4784366697,4784366701,4,1798,1429,-20
4785757846,4785757850,4,1673,1733,-20
4786659093,4786659099,6,2156,1729,-20
4792482995,4792482999,4,2019,1116,-20
4795721985,4795721988,3,887,1268,-20
4796369259,4796369240,-19,855,672,-20
4796731107,4796731111,4,1344,637,-20
4798613481,4798613485,4,1473,1704,-20
4802935412,4802935417,5,2472,1523,-20
4803215862,4803215864,2,1217,1281,-20
4803828057,4803828054,-3,1580,2868,-20
4805664591,4805664595,4,1378,1569,-20
4807048382,4807048386,4,2511,1814,-20
4808830303,4808830306,3,2473,1812,-20
4810604094,4810604096,2,2155,1365,-20
4813140742,4813140746,4,2617,1325,-20
4813543378,4813543383,5,1415,1494,-20
4814249281,4814249282,1,2638,1751,-20
4814312218,4814312222,4,1657,1242,-20
4815780928,4815780931,3,1162,1026,-20
4821493493,4821493496,3,2115,1611,-20
4823544962,4823544966,4,1806,1630,-20
4825614732,4825614738,6,1669,1301,-20
4826536393,4826536393,0,3214,4540,-20
4828053590,4828053594,4,1527,1187,-20
4828761748,4828761761,13,1220,2136,-20
4829871738,4829871742,4,2120,1419,-20
4830076104,4830076107,3,1994,1497,-20
4831720295,4831720299,4,1117,1044,-20
4835198624,4835198627,3,1875,1451,-20
4840766602,4840766603,1,1920,1529,-20
4846826382,4846826385,3,1889,1469,-20
4848227682,4848227689,7,2564,1234,-20
4849331939,4849331946,7,3897,1316,-20
4850349777,4850349780,3,1526,2067,-20
4851463865,4851463869,4,1710,1412,-20
4853044357,4853044360,3,1652,1204,-20
4855389144,4855389146,2,3389,1672,-20
4855546091,4855546094,3,1288,1481,-20
4855775974,4855775987,13,1937,1838,-20
4857546770,4857546774,4,2676,2105,-20
4860120865,4860120871,6,3335,1432,-20
4861928069,4861928072,3,1551,961,-20
4862416782,4862416785,3,1658,1319,-20
4862531596,4862531579,-17,772,909,-20
4863892533,4863892535,2,2000,1302,-20
4867349815,4867349818,3,2316,1594,-20
4871294171,4871294174,3,2368,2228,-20
4877102651,4877102653,2,2349,1711,-20
4879475051,4879475054,3,1309,1441,-20
4880801787,4880801772,-15,1485,1657,-20
4882179002,4882179005,3,7493,28384,-20
4882714566,4882714570,4,1193,880,-20
4885125098,4885125104,6,1567,1190,-20
4893341510,4893341514,4,1714,1648,-20
4898973697,4898973700,3,1888,1440,-20
4901156051,4901156050,-1,2240,3174,-20
4902158445,4902158449,4,1794,1677,-20
4910090080,4910090085,5,4803,2934,-20
4910137354,4910137354,0,1602,1087,-20
4917677513,4917677516,3,1632,1453,-20
4918454107,4918454112,5,1542,1284,-20
4919752302,4919752306,4,1872,1448,-20
4920240173,4920240178,5,2408,1430,-20
4923313698,4923313697,-1,1583,1951,-20
4924208285,4924208290,5,2586,1687,-20
4925111922,4925111927,5,1313,1348,-20
4927616402,4927616403,1,2640,2136,-20
4931230399,4931230402,3,1282,1696,-20
4933316154,4933316158,4,1028,787,-20
4935519830,4935519830,0,3600,3702,-20
4937579569,4937579574,5,2426,1845,-20
4941007343,4941007343,0,1777,1146,-20
4944019214,4944019215,1,2153,1453,-20
4944629771,4944629773,2,2490,2154,-20
4946634418,4946634422,4,1675,1818,-20
4947154646,4947154645,-1,1293,1504,-20
4948317919,4948317923,4,1352,1262,-20
4949212905,4949212910,5,1761,1162,-20
4949681195,4949681197,2,1586,1263,-20
4949823743,4949823747,4,2008,1036,-20
4952201995,4952201999,4,2035,1158,-20
4952343526,4952343526,0,2625,2144,-20
4953582190,4953582194,4,1538,1009,-20
4959664284,4959664288,4,957,1015,-20
4960247003,4960246987,-16,2158,1240,-20
4961821631,4961821635,4,1113,1413,-20
4964216805,4964216809,4,1125,924,-20
4964440631,4964440634,3,2048,1603,-20
4969489144,4969489146,2,1471,891,-20
4969860702,4969860706,4,1551,979,-20
4972400514,4972400517,3,2524,1344,-20
4972748088,4972748091,3,1765,1201,-20
4974716051,4974716053,2,2633,1524,-20
4976978855,4976978858,3,2435,1724,-20
4980995606,4980995609,3,1493,1328,-20
4981092233,4981092229,-4,1261,3212,-20
4982108610,4982108589,-21,49,248,-20
4984658939,4984658942,3,1498,1297,-20
4985604346,4985604349,3,1524,1208,-20
4985960203,4985960206,3,1409,875,-20
4986559286,4986559292,6,2082,1324,-20
4995088163,4995088155,-8,25971,10745,-20
4997333577,4997333581,4,847,1109,-20
4998253599,4998253603,4,2116,1417,-20
5000116339,5000116343,4,2162,1346,-20
5002313540,5002313544,4,2443,1538,-20
5004453059,5004453063,4,1315,931,-20
5007374122,5007374125,3,1677,977,-20
5007970518,5007970522,4,1728,1623,-20
5008773514,5008773517,3,1863,1158,-20
5008801757,5008801760,3,1149,1056,-20
5010089473,5010089480,7,1321,1164,-20
5011107590,5011107594,4,2131,1592,-20
5011924139,5011924143,4,2291,1053,-20
5014429523,5014429525,2,1443,2029,-20
5014635093,5014635095,2,2890,1379,-20
5016571501,5016571480,-21,106,4502,-20
5018189811,5018189815,4,1659,1123,-20
5020773633,5020773638,5,1081,809,-20
5021552938,5021552943,5,1271,1239,-20
5022504679,5022504683,4,2278,1698,-20
5023064938,5023064943,5,2590,2310,-20
5027009805,5027009807,2,1638,1550,-20
5027101937,5027101940,3,1974,1037,-20
5027349775,5027349778,3,1591,1375,-20
5029556633,5029556638,5,1283,1215,-20
5032950077,5032950079,2,1542,1854,-20
5036127495,5036127497,2,958,903,-20
5038228975,5038228975,0,1219,1069,-20
5038890158,5038890158,0,1686,1285,-20
5040829987,5040829990,3,1054,1007,-20
5043241032,5043241033,1,696,767,-20
5048293115,5048293112,-3,1977,5147,-20
5048604645,5048604624,-21,1745,1742,-20
5050245389,5050245390,1,2129,1851,-20
5050305088,5050305091,3,4187,4222,-20
5051637151,5051637158,7,4304,2271,-20
5053028197,5053028200,3,2558,2071,-20
5054665222,5054665227,5,1927,1879,-20
5055881465,5055881470,5,1496,1525,-20
5056443830,5056443834,4,1959,1565,-20
5058413391,5058413395,4,2160,1658,-20
5060553032,5060553012,-20,231,1212,-20
5064295034,5064295038,4,1424,1334,-20
5065708658,5065708662,4,1330,1449,-20
5068076470,5068076473,3,1460,1519,-20
5070493555,5070493559,4,2267,1524,-20
5070887545,5070887552,7,1642,1606,-20
5081698597,5081698578,-19,953,1007,-20
5082428565,5082428569,4,1709,1605,-20
5085510608,5085510614,6,2346,1083,-20
5088906160,5088906163,3,1575,1214,-20
5089246626,5089246629,3,1849,1198,-20
5090095706,5090095708,2,1734,1682,-20
5090800294,5090800299,5,1612,1288,-20
5094028694,5094028698,4,1357,1019,-20
5102509198,5102509201,3,1980,1346,-20
5105180220,5105180222,2,1966,1351,-20
5107577161,5107577164,3,2458,1609,-20
5109649150,5109649152,2,4225,2811,-20
5111737678,5111737682,4,2015,1098,-20
5112226314,5112226319,5,3046,2106,-20
5113700122,5113700127,5,1299,962,-20
5117316523,5117316526,3,1831,1564,-20
5125499156,5125499157,1,1452,1157,-20
5126172082,5126172084,2,1679,961,-20
5128260857,5128260863,6,3213,1758,-20
5129251836,5129251839,3,1402,1785,-20
5135304782,5135304786,4,2481,1676,-20
5135478239,5135478243,4,1843,1622,-20
5136990054,5136990056,2,1602,1891,-20
5137145645,5137145646,1,2208,1850,-20
5140813740,5140813744,4,1975,2102,-20
5143185429,5143185433,4,1802,1297,-20
5143375670,5143375674,4,2171,2041,-20
5145958513,5145958517,4,2227,1874,-20
5146927230,5146927235,5,1815,1827,-20
5147381025,5147381030,5,2027,1411,-20
5147484813,5147484819,6,2433,1375,-20
5150516086,5150516087,1,1440,1218,-20
5152159057,5152159059,2,1645,1026,-20
5154645633,5154645637,4,1606,1712,-20
5155417528,5155417521,-7,1357,5400,-20
5158235383,5158235383,0,1971,1778,-20
5159165899,5159165903,4,1711,1058,-20
5159504090,5159504092,2,1341,1038,-20
5159557914,5159557921,7,1137,261,-20
5160568179,5160568182,3,1275,1324,-20
5163195145,5163195143,-2,1490,1418,-20
5163998402,5163998405,3,1816,1431,-20
5165841308,5165841309,1,43746,31874,-20
5169125618,5169125621,3,1804,1712,-20
5172450945,5172450949,4,1639,1555,-20
5174050437,5174050438,1,1827,1502,-20
5179144612,5179144616,4,1846,1302,-20
5181413419,5181413422,3,2229,1533,-20
5182864980,5182864983,3,1987,763,-20
5183570763,5183570770,7,1699,1412,-20
5184294850,5184294854,4,1549,1451,-20
5187154337,5187154342,5,1811,1701,-20
5190687478,5190687482,4,1720,1331,-20
5193261058,5193261063,5,1621,1362,-20
5193735274,5193735278,4,1331,1021,-20
5194448873,5194448877,4,1812,1371,-20
5195292033,5195292036,3,1949,1399,-20
5195675343,5195675349,6,1206,1183,-20
5196647636,5196647638,2,1517,1385,-20
5198687241,5198687242,1,1843,1052,-20
5201537342,5201537345,3,2228,1454,-20
5202217309,5202217313,4,2912,1502,-20
5206046922,5206046926,4,1494,1183,-20
5207412708,5207412713,5,9096,21077,-20
5210677380,5210677384,4,1379,991,-20
5211846949,5211846953,4,1520,1396,-20
5214795953,5214795954,1,1759,1237,-20
5216784711,5216784714,3,1786,1544,-20
5218419661,5218419660,-1,8756,12074,-20
5221047751,5221047754,3,1653,1156,-20
5222832946,5222832949,3,1740,1537,-20
5224085435,5224085439,4,1237,1479,-20
5224877635,5224877640,5,2314,1419,-20
5224926018,5224926021,3,1558,1369,-20
5231807256,5231807258,2,1667,1621,-20
5234003085,5234003082,-3,2787,4589,-20
5234682163,5234682166,3,2187,1552,-20
5235182791,5235182792,1,2066,1082,-20
5243450553,5243450555,2,2000,952,-20
5244086314,5244086318,4,2234,1487,-20
5245025952,5245025970,18,1562,1791,-20
5245400353,5245400354,1,1437,1538,-20
5247166218,5247166222,4,1707,1967,-20
5247518526,5247518529,3,1754,1078,-20
5248699669,5248699674,5,2141,1269,-20
5248842957,5248842962,5,1962,1359,-20
5251504155,5251504156,1,1934,1250,-20
5253785598,5253785603,5,2009,1464,-20
5254809282,5254809278,-4,1222,3007,-20
5255073500,5255073503,3,1463,1459,-20
5258080723,5258080726,3,1658,1635,-20
5261513946,5261513949,3,1700,1389,-20
5262891109,5262891112,3,2330,1319,-20
5267244558,5267244563,5,1855,1138,-20
5269391849,5269391851,2,2102,1792,-20
5270195189,5270195192,3,2219,1224,-20
5270355809,5270355825,16,1748,1363,-20
5275359794,5275359802,8,2856,1507,-20
5275708092,5275708095,3,1547,1114,-20
5279299343,5279299346,3,2574,1847,-20
5280538598,5280538604,6,3612,2084,-20
5284080469,5284080470,1,1222,801,-20
5286070393,5286070390,-3,3944,7281,-20
5286592137,5286592142,5,3991,1382,-20
5289019352,5289019355,3,2709,1781,-20
5289299526,5289299529,3,1577,1123,-20
5289693726,5289693729,3,3014,1831,-20
5291188497,5291188517,20,1082,975,-20
5291478162,5291478147,-15,1905,991,-20
5292123546,5292123545,-1,1065,2008,-20
5292632863,5292632866,3,1177,1000,-20
5295523902,5295523920,18,175,594,-20
5297276850,5297276855,5,1516,1492,-20
5299870207,5299870205,-2,962,2798,-20
5302186669,5302186673,4,1800,1267,-20
5302320981,5302321002,21,1014,1545,-20
5303594559,5303594563,4,1126,1158,-20
5303801186,5303801193,7,1861,1287,-20
5304762462,5304762466,4,1923,1489,-20
5305269512,5305269517,5,2431,1859,-20
5308096402,5308096406,4,2352,1738,-20
5310478770,5310478774,4,1888,1458,-20
5311245409,5311245411,2,1319,1221,-20
5315503623,5315503624,1,1390,1376,-20
5315926702,5315926705,3,1267,1101,-20
5316882779,5316882777,-2,1408,3057,-20
5319112842,5319112843,1,1557,1386,-20
5320285961,5320285962,1,1332,1189,-20
5321322858,5321322861,3,2375,1422,-20
5321944278,5321944282,4,2561,1794,-20
5323652520,5323652522,2,1624,1082,-20
5326099507,5326099505,-2,1083,2097,-20
5326280446,5326280451,5,1593,1228,-20
5339099993,5339099995,2,2138,1307,-20
5341766650,5341766653,3,1949,1134,-20
5341928306,5341928309,3,1928,1377,-20
5343696922,5343696925,3,1851,1418,-20
5344410199,5344410178,-21,939,1204,-20
5349743221,5349743226,5,1681,812,-20
5355077109,5355077117,8,2209,1597,-20
5360859442,5360859446,4,2536,1365,-20
5360930314,5360930317,3,1794,1484,-20
5364057304,5364057306,2,1477,1486,-20
5364528575,5364528578,3,1377,1498,-20
5369655551,5369655552,1,1070,983,-20
5372726502,5372726506,4,1282,1379,-20
5374425726,5374425726,0,1385,1139,-20
5377837344,5377837347,3,2755,2024,-20
5380402529,5380402532,3,2304,1642,-20
5383006147,5383006150,3,1682,1087,-20
5385805529,5385805513,-16,1483,1472,-20
5386193027,5386193031,4,1924,1463,-20
5387029553,5387029557,4,1499,1194,-20
5388798338,5388798342,4,1601,1519,-20
5392307454,5392307459,5,1029,912,-20
5393675354,5393675354,0,1283,1661,-20
5398297826,5398297830,4,1745,1615,-20
5408113033,5408113037,4,1763,1437,-20
5415546392,5415546395,3,1575,1498,-20
5415964582,5415964585,3,1835,1356,-20
5418964479,5418964457,-22,1081,1880,-20
5419324730,5419324734,4,1723,1292,-20
5421541519,5421541522,3,1714,1247,-20
5422257826,5422257825,-1,1089,1640,-20
5424195762,5424195766,4,1796,1404,-20
5424774190,5424774193,3,1846,1238,-20
5425130659,5425130664,5,3636,2054,-20
5426559034,5426559036,2,1753,1401,-20
5426636517,5426636521,4,1718,1571,-20
5428686982,5428686986,4,1810,872,-20
5430518413,5430518415,2,1693,1317,-20
5431484786,5431484789,3,1635,1192,-20
5433160182,5433160181,-1,1559,1631,-20
5434986022,5434986025,3,1826,1370,-20
5435510633,5435510637,4,4352,2086,-20
5437907964,5437907967,3,2400,1286,-20
5438816446,5438816451,5,2629,2038,-20
5438952911,5438952921,10,13828,22363,-20
5440675629,5440675634,5,1340,713,-20
5445535749,5445535754,5,1949,1446,-20
5447270390,5447270394,4,1829,1244,-20
5452517857,5452517859,2,2268,1861,-20
5453230898,5453230904,6,2170,1391,-20
5453589497,5453589499,2,2719,1854,-20
5453639254,5453639260,6,3090,1552,-20
5454438674,5454438675,1,2103,1319,-20
5454609482,5454609486,4,1944,1388,-20
5455221439,5455221434,-5,663,3653,-20
5462094269,5462094270,1,2131,2046,-20
5464269280,5464269283,3,1758,1628,-20
5466188536,5466188540,4,1743,910,-20
5466688699,5466688702,3,2294,2482,-20
5468653786,5468653790,4,1032,1255,-20
5473064163,5473064166,3,1483,991,-20
5473704205,5473704209,4,1327,1308,-20
5476506389,5476506390,1,1623,1792,-20
5476998381,5476998386,5,2178,1445,-20
5477107149,5477107130,-19,1974,1130,-20
5480387930,5480387935,5,1440,872,-20
5481340261,5481340266,5,1512,1318,-20
5485092788,5485092787,-1,889,1382,-20
5488701462,5488701469,7,2612,1385,-20
5489508759,5489508759,0,1846,1513,-20
5490888395,5490888398,3,1935,1804,-20
5491690880,5491690883,3,2470,1550,-20
5491787540,5491787543,3,1581,1008,-20
5492451414,5492451417,3,1766,1645,-20
5493409097,5493409099,2,1788,1413,-20
5495842062,5495842065,3,1568,1277,-20
5496279946,5496279950,4,2234,1190,-20
5496411513,5496411515,2,1527,1466,-20
5498372914,5498372918,4,1817,1550,-20
5498688190,5498688194,4,1858,1322,-20
5503636801,5503636798,-3,1365,2083,-20
5507929174,5507929176,2,2322,1719,-20
5508320990,5508320994,4,1744,1500,-20
5510560158,5510560154,-4,2255,5252,-20
5513818610,5513818615,5,2777,1384,-20
5514811169,5514811170,1,1377,1086,-20
5515520558,5515520556,-2,886,2068,-20
5516119706,5516119711,5,1451,769,-20
5517897268,5517897268,0,1122,1669,-20
5520615324,5520615322,-2,1929,3691,-20
5524295032,5524295039,7,3279,1191,-20
5525442803,5525442807,4,1841,1355,-20
5527141793,5527141787,-6,1771,1517,-20
5528417041,5528417046,5,2236,1138,-20
5528473105,5528473107,2,1722,1933,-20
5528802309,5528802311,2,1878,1133,-20
5529901327,5529901331,4,1365,1574,-20
5530022414,5530022418,4,1756,1181,-20
5531350881,5531350885,4,2284,1582,-20
5531748435,5531748436,1,1636,1217,-20
5546116447,5546116447,0,1426,1121,-20
5546171616,5546171619,3,1720,1169,-20
5548305883,5548305886,3,2431,1001,-20
5549232310,5549232314,4,1922,1760,-20
5555089330,5555089334,4,1328,689,-20
5555524772,5555524787,15,1146,902,-20
5557968802,5557968807,5,1748,1448,-20
5558294852,5558294856,4,1387,1036,-20
5559425383,5559425386,3,1522,1298,-20
5560288206,5560288207,1,2179,2294,-20
5569903854,5569903857,3,1612,1578,-20
5571607249,5571607252,3,1757,1474,-20
5573183045,5573183047,2,1547,836,-20
5573341002,5573340994,-8,2033,7619,-20
5575441195,5575441198,3,1225,1151,-20
5576885633,5576885637,4,2051,1902,-20
5588521556,5588521558,2,1961,908,-20
5590677594,5590677599,5,2669,1898,-20
5592678439,5592678440,1,23844,32518,-20
5593365350,5593365351,1,1780,2292,-20
5594540971,5594540975,4,1275,1335,-20
5596294909,5596294911,2,1826,1496,-20
5596681993,5596682004,11,1804,884,-20
5596927273,5596927276,3,2472,1450,-20
5598228971,5598228974,3,1911,1309,-20
5605494671,5605494675,4,1516,1002,-20
5613052277,5613052278,1,1742,1634,-20
5614341124,5614341126,2,1737,1797,-20
5615835940,5615835942,2,1656,1090,-20
5621605683,5621605686,3,1991,1613,-20
5623233863,5623233858,-5,529,2172,-20
5623447906,5623447909,3,1740,950,-20
5627131151,5627131154,3,2794,2179,-20
5628240085,5628240089,4,2170,1603,-20
5629054998,5629055002,4,1271,1142,-20
5629817597,5629817599,2,1826,1306,-20
5631158410,5631158413,3,1539,1415,-20
5634815169,5634815169,0,1834,1939,-20
5635857506,5635857510,4,1753,1487,-20
5636297563,5636297544,-19,976,272,-20
5637511534,5637511554,20,1015,973,-20
5640633664,5640633667,3,1650,1136,-20
5642330182,5642330189,7,2419,1358,-20
5644237679,5644237682,3,1289,1019,-20
5648346978,5648346981,3,1695,1635,-20
5648875045,5648875051,6,3896,2544,-20
5650279994,5650279998,4,1907,1014,-20
5650706690,5650706690,0,1182,1175,-20
5650968398,5650968401,3,2352,1399,-20
5654835229,5654835234,5,1660,1554,-20
5662544355,5662544357,2,1601,1301,-20
5664792291,5664792297,6,2018,1285,-20
5666475369,5666475372,3,64375,80554,-20
5667311088,5667311091,3,2914,1743,-20
5668015311,5668015315,4,1672,1109,-20
5671462353,5671462357,4,1148,1711,-20
5673048904,5673048906,2,2466,2159,-20
5673994194,5673994196,2,1474,961,-20
5674731754,5674731756,2,2134,1236,-20
5675658166,5675658169,3,919,944,-20
5676273863,5676273867,4,2397,2046,-20
5678905470,5678905473,3,1145,1101,-20
5680081490,5680081493,3,1532,1134,-20
5680232022,5680232028,6,889,1026,-20
5682299835,5682299839,4,2182,1405,-20
5683198873,5683198877,4,1325,1378,-20
5684156860,5684156861,1,1197,1399,-20
5690158754,5690158758,4,2394,1434,-20
5691225641,5691225642,1,1366,1541,-20
5692939484,5692939490,6,2514,1860,-20
5693254426,5693254427,1,1992,1126,-20
5697555862,5697555865,3,2237,1957,-20
5697985769,5697985774,5,1876,1571,-20
5700586641,5700586646,5,2269,1466,-20
5701425044,5701425047,3,2024,1115,-20
5702150516,5702150518,2,1459,1160,-20
5702725291,5702725296,5,2118,1425,-20
5704447420,5704447422,2,1951,1701,-20
5706496548,5706496553,5,1716,1445,-20
5708102670,5708102672,2,1783,1509,-20
5708834705,5708834710,5,1778,1386,-20
5709836059,5709836062,3,1270,925,-20
5711506607,5711506610,3,1623,1435,-20
5711924075,5711924079,4,1361,1221,-20
5714033782,5714033782,0,812,1069,-20
5715382994,5715382998,4,2396,1595,-20
5717691847,5717691848,1,1729,2427,-20
5719413213,5719413215,2,1810,1539,-20
5723664737,5723664739,2,1661,1013,-20
5724153011,5724153014,3,2214,1330,-20
5724985041,5724985044,3,2454,1386,-20
5729398390,5729398391,1,1313,1247,-20
5731333453,5731333455,2,1762,984,-20
5732653551,5732653551,0,1444,879,-20
5732695319,5732695323,4,1536,1303,-20
5735290913,5735290903,-10,208,672,-20
5743085332,5743085337,5,1761,1613,-20
5748126970,5748126973,3,2086,1152,-20
5751122490,5751122495,5,1820,1096,-20
5753310813,5753310818,5,1890,1620,-20
5758696137,5758696139,2,1412,1287,-20
5762027777,5762027769,-8,38460,14967,-20
5764048717,5764048719,2,1867,1732,-20
5769949143,5769949149,6,3299,1897,-20
5771360126,5771360131,5,2114,1431,-20
5771618447,5771618449,2,2141,1290,-20
5775011365,5775011370,5,1122,1508,-20
5775506331,5775506334,3,1534,1304,-20
5778538871,5778538876,5,2045,1671,-20
5779048872,5779048875,3,875,1037,-20
5781490970,5781490973,3,1674,1532,-20
5781556714,5781556705,-9,469,149,-20
5782367031,5782367035,4,1355,969,-20
5784267574,5784267576,2,1833,1404,-20
5785601957,5785601959,2,1025,774,-20
5789425919,5789425920,1,1179,917,-20
5793700269,5793700273,4,1818,977,-20
5794866729,5794866736,7,1195,698,-20
5796388965,5796388967,2,1533,1469,-20
5800151438,5800151442,4,1957,1345,-20
5800536489,5800536490,1,1514,1516,-20
5802299610,5802299615,5,2333,1449,-20
5809406954,5809406956,2,1036,1413,-20
5810404189,5810404185,-4,965,4776,-20
5813029523,5813029527,4,1637,1861,-20
5816363338,5816363343,5,3053,1771,-20
5816988489,5816988490,1,1623,1134,-20
5823029554,5823029555,1,2416,1596,-20
5823611948,5823611950,2,1447,1137,-20
5823913861,5823913863,2,1115,794,-20
5827555115,5827555112,-3,1897,7175,-20
5829186159,5829186161,2,1804,1477,-20
5836922142,5836922125,-17,1166,1125,-20
5837545274,5837545277,3,1601,1361,-20
5838185734,5838185735,1,1104,991,-20
5839775141,5839775147,6,2859,1750,-20
5842667580,5842667562,-18,1111,908,-20
5844066905,5844066911,6,1322,1256,-20
5846377355,5846377361,6,1095,916,-20
5850832990,5850832994,4,1743,1149,-20
5851505126,5851505123,-3,920,1717,-20
5851707274,5851707262,-12,1538,4826,-20
5854196450,5854196454,4,2137,1539,-20
5855023459,5855023463,4,1966,1243,-20
5856875659,5856875656,-3,2332,4921,-20
5857265394,5857265395,1,1436,1610,-20
5857399247,5857399250,3,1302,1081,-20
5858328798,5858328801,3,1069,1057,-20
5861682119,5861682123,4,1779,1886,-20
5862907751,5862907753,2,1626,1232,-20
5868502137,5868502142,5,1624,1581,-20
5868615719,5868615722,3,2933,2020,-20
5870607917,5870607920,3,1431,1355,-20
5871572307,5871572310,3,2162,2070,-20
5872245132,5872245134,2,1192,1626,-20
5874875497,5874875497,0,2134,4365,-20
5876242559,5876242563,4,2029,1744,-20
5877822421,5877822414,-7,2571,7251,-20
5877976436,5877976441,5,2395,1138,-20
5878733746,5878733747,1,1347,1252,-20
5879131757,5879131758,1,1872,1587,-20
5881269501,5881269505,4,1699,1680,-20
5882960660,5882960663,3,2190,1462,-20
5883103055,5883103058,3,1774,1283,-20
5883694953,5883694955,2,2329,1530,-20
5883977070,5883977075,5,3114,1527,-20
5886292776,5886292768,-8,1573,8958,-20
5887708577,5887708581,4,1573,1424,-20
5888682093,5888682096,3,1551,1245,-20
5891804453,5891804454,1,1970,1538,-20
5899188226,5899188228,2,2465,1781,-20
5902387630,5902387634,4,1631,1338,-20
5902823786,5902823789,3,2420,1157,-20
5903049303,5903049307,4,2211,1269,-20
5904202913,5904202915,2,1187,1124,-20
5905878033,5905878037,4,2091,1450,-20
5909933058,5909933062,4,2264,1768,-20
5910966157,5910966161,4,1722,1289,-20
5911320612,5911320615,3,1994,1784,-20
5914780050,5914780054,4,2138,1510,-20
5916220366,5916220367,1,1636,1503,-20
5917814579,5917814585,6,1367,1177,-20
5918550596,5918550597,1,950,1241,-20
5919005982,5919005986,4,1962,1321,-20
5920652754,5920652757,3,1840,1425,-20
5921508481,5921508483,2,1686,1456,-20
5925254395,5925254399,4,2173,1995,-20
5927077686,5927077689,3,1437,1580,-20
5929009919,5929009922,3,1594,1108,-20
5930745289,5930745293,4,1425,1313,-20
5938509016,5938509019,3,2572,1853,-20
5941197685,5941197689,4,2000,916,-20
5941750730,5941750734,4,1808,1541,-20
5942593557,5942593562,5,1820,1261,-20
5943151864,5943151874,10,1747,1164,-20
5954349794,5954349792,-2,1598,3899,-20
5958174743,5958174741,-2,29186,23089,-20
5960236862,5960236868,6,1935,1434,-20
5961018014,5961018017,3,2695,1734,-20
5965356068,5965356072,4,1425,1150,-20
5967252015,5967252021,6,1911,1558,-20
5967354186,5967354189,3,1367,1227,-20
5971471038,5971471042,4,2025,1262,-20
5973035098,5973035102,4,2322,1934,-20
5973478729,5973478733,4,2056,1616,-20
5974074313,5974074318,5,964,678,-20
5974382070,5974382074,4,1979,1340,-20
5974861925,5974861920,-5,1498,6387,-20
5977827608,5977827610,2,2036,1342,-20
5979334039,5979334044,5,2932,1457,-20
5979571330,5979571334,4,1978,1478,-20
5980453889,5980453890,1,26677,35270,-20
5980504164,5980504168,4,2724,1918,-20
5984681179,5984681184,5,2308,1676,-20
5988433971,5988433975,4,1475,1079,-20
5988754411,5988754396,-15,1607,1112,-20
5993761490,5993761493,3,2021,1476,-20
5996544201,5996544199,-2,1570,4034,-20
5996842995,5996842998,3,2440,1940,-20
5999830869,5999830874,5,2093,1480,-20
6003185289,6003185308,19,1270,1575,-20
6007924845,6007924849,4,1510,776,-20
6008476308,6008476310,2,1905,1449,-20
6008673083,6008673089,6,1687,1270,-20
6009640963,6009640967,4,1404,1529,-20
6010033345,6010033351,6,1741,1196,-20
6013580737,6013580742,5,1759,1406,-20
6014538939,6014538943,4,1665,1369,-20
6015233879,6015233883,4,1309,1095,-20
6016093162,6016093166,4,2271,1464,-20
6016907286,6016907291,5,1074,1146,-20
6019003472,6019003457,-15,1041,1519,-20
6021953963,6021953966,3,1409,1304,-20
6023401906,6023401910,4,2628,1550,-20
6023687250,6023687254,4,2198,1189,-20
6023890202,6023890204,2,1323,779,-20
6024991660,6024991662,2,1774,1193,-20
6028564258,6028564262,4,1557,1543,-20
6031097780,6031097782,2,1460,1147,-20
6033082603,6033082585,-18,932,269,-20
6034151994,6034151998,4,903,1000,-20
6035272722,6035272723,1,1271,1158,-20
6038799569,6038799573,4,1642,1723,-20
6042042565,6042042567,2,1851,1295,-20
6044309680,6044309684,4,1236,851,-20
6050209466,6050209467,1,2045,1167,-20
6051791486,6051791489,3,2222,1491,-20
6053291559,6053291562,3,1912,1916,-20
6055611508,6055611500,-8,1445,1427,-20
6056521442,6056521445,3,1119,1459,-20
6057091762,6057091766,4,1940,1556,-20
6060280817,6060280822,5,2210,721,-20
6062965047,6062965051,4,2073,1179,-20
6063151183,6063151186,3,2135,1631,-20
6064663857,6064663859,2,848,907,-20
6065012971,6065012974,3,1671,886,-20
6065875921,6065875929,8,5857,4531,-20
6067086148,6067086150,2,1345,1166,-20
6068044390,6068044384,-6,853,5804,-20
6068249909,6068249914,5,1961,1395,-20
6072214550,6072214545,-5,1201,2828,-20
6073013897,6073013902,5,1919,1431,-20
6074098538,6074098545,7,1301,993,-20
6074642964,6074642969,5,1480,1129,-20
6078738704,6078738705,1,1747,1591,-20
6079399802,6079399806,4,1818,973,-20
6081995022,6081995027,5,1436,1142,-20
6088258927,6088258927,0,1184,970,-20
6090885599,6090885599,0,1850,1751,-20
6094807690,6094807694,4,1858,1370,-20
6095227405,6095227402,-3,1438,2705,-20
6095545674,6095545678,4,2021,1998,-20
6099869622,6099869627,5,1896,1386,-20
6102163682,6102163688,6,1844,1414,-20
6103045168,6103045170,2,1569,1498,-20
6103364682,6103364699,17,517,2419,-20
6103925111,6103925115,4,1282,1157,-20
6105807648,6105807651,3,902,1195,-20
6107696883,6107696886,3,1509,1057,-20
6116115151,6116115155,4,2022,1411,-20
6116880561,6116880563,2,1244,761,-20
6118061011,6118061015,4,2294,1873,-20
6119840964,6119840968,4,12229,8229,-20
6124533437,6124533433,-4,1157,2239,-20
6130318430,6130318432,2,1295,1917,-20
6132091053,6132091054,1,1658,1582,-20
6132325281,6132325282,1,1047,1330,-20
6132736337,6132736339,2,2472,2092,-20
6133610518,6133610524,6,2164,1337,-20
6138770789,6138770791,2,2036,1336,-20
6139990961,6139990965,4,1358,1238,-20
6140962499,6140962495,-4,1417,6081,-20
6143408699,6143408702,3,1872,1353,-20
6144756949,6144756950,1,1167,2044,-20
6150668638,6150668642,4,1814,1127,-20
6151617865,6151617862,-3,51475,27565,-20
6152469054,6152469059,5,1409,965,-20
6153076817,6153076823,6,1821,1744,-20
6155163119,6155163106,-13,835,1060,-20
6155983930,6155983933,3,2308,2104,-20
6158820000,6158820003,3,1818,1442,-20
6159146714,6159146696,-18,1234,740,-20
6161787256,6161787259,3,1190,895,-20
6162089782,6162089786,4,1902,1583,-20
6162416206,6162416210,4,1462,1208,-20
6164173925,6164173930,5,1808,1379,-20
6165212627,6165212631,4,1753,1237,-20
6168977991,6168977997,6,1658,1165,-20
6170461829,6170461833,4,2240,1048,-20
6171110725,6171110727,2,1168,1173,-20
6173075368,6173075372,4,2362,1913,-20
6183982224,6183982226,2,1378,1392,-20
6184507819,6184507822,3,1826,1536,-20
6188109909,6188109911,2,1479,1409,-20
6190640900,6190640902,2,2198,1516,-20
6190837210,6190837195,-15,1726,1204,-20
6192353248,6192353250,2,1648,1587,-20
6194513106,6194513107,1,995,1077,-20
6200063359,6200063363,4,2692,1606,-20
6202571506,6202571509,3,1898,1719,-20
6203286085,6203286089,4,1813,1913,-20
6204362903,6204362918,15,15035,20636,-20
6204756090,6204756093,3,1515,1497,-20
6205805441,6205805442,1,1479,1269,-20
6206423847,6206423852,5,2652,1681,-20
6208920293,6208920296,3,2130,1623,-20
6210463913,6210463917,4,1755,1584,-20
6212514692,6212514697,5,1453,1222,-20
6213642492,6213642495,3,2152,1642,-20
6215953233,6215953232,-1,2697,4665,-20
6217544076,6217544077,1,1386,1814,-20
6227368438,6227368443,5,1280,755,-20
6230589914,6230589918,4,1672,1463,-20
6230896489,6230896483,-6,1858,8648,-20
6237620599,6237620602,3,2026,1222,-20
6237853991,6237854000,9,2392,1109,-20
6238551098,6238551102,4,1921,1237,-20
6238607759,6238607762,3,2460,1605,-20
6240643671,6240643675,4,1783,1176,-20
6241585282,6241585287,5,1839,1644,-20
6245540596,6245540588,-8,968,5677,-20
6247481421,6247481422,1,1727,1689,-20
6249793281,6249793287,6,1525,1418,-20
6249836170,6249836171,1,1718,1306,-20
6250882598,6250882601,3,1761,1604,-20
6251309065,6251309066,1,1594,1023,-20
6252294866,6252294860,-6,1430,8718,-20
6253657382,6253657385,3,1604,1417,-20
6255256535,6255256539,4,1777,1601,-20
6258307160,6258307163,3,1586,1281,-20
6259557090,6259557095,5,1527,1225,-20
6262603377,6262603379,2,1641,1225,-20
6264476657,6264476663,6,4308,1839,-20
6265834562,6265834566,4,1716,1588,-20
6266785021,6266785025,4,1839,1069,-20
6266903901,6266903900,-1,2168,3645,-20
6267782018,6267782022,4,1926,1196,-20
6271740965,6271740969,4,1474,1541,-20
6275532674,6275532678,4,2106,1443,-20
6277980234,6277980231,-3,1686,3392,-20
6278154679,6278154685,6,1773,1255,-20
6280234108,6280234111,3,1617,1498,-20
6283892858,6283892853,-5,1568,8080,-20
6284200416,6284200422,6,1767,1169,-20
6284958595,6284958599,4,2121,1520,-20
6285823134,6285823134,0,1087,1805,-20
6287194040,6287194043,3,2288,1096,-20
6289969155,6289969158,3,1844,1264,-20
6296860871,6296860873,2,2211,1354,-20
6297000105,6297000110,5,1939,1264,-20
6299487710,6299487712,2,1380,1203,-20
6302339549,6302339553,4,2297,1767,-20
6307687437,6307687439,2,1837,1275,-20
6316138348,6316138350,2,1547,1657,-20
6318740992,6318740993,1,1938,1175,-20
6319528066,6319528071,5,1321,1245,-20
6322166051,6322166055,4,1720,1276,-20
6323436406,6323436407,1,2117,2052,-20
6324587889,6324587889,0,1456,1998,-20
6324973466,6324973470,4,1410,783,-20
6325456570,6325456572,2,3520,2525,-20
6326370302,6326370307,5,3022,1564,-20
6328129728,6328129730,2,1360,1051,-20
6333230808,6333230810,2,1721,1500,-20
6334961767,6334961771,4,1711,1371,-20
6337289798,6337289800,2,2172,1706,-20
6337486982,6337486986,4,1947,1218,-20
6342556940,6342556943,3,1616,1693,-20
6345774086,6345774087,1,1716,2646,-20
6349773251,6349773253,2,1472,1655,-20
6350318432,6350318436,4,2791,1379,-20
6351001281,6351001283,2,1572,1432,-20
6352197291,6352197291,0,1443,1482,-20
6352715321,6352715324,3,1369,1543,-20
6356798778,6356798781,3,2361,1530,-20
6363468861,6363468856,-5,1234,2811,-20
6363672449,6363672434,-15,1269,1229,-20
6364290663,6364290666,3,2655,1643,-20
6365251644,6365251658,14,1859,1359,-20
6366335090,6366335094,4,1871,1657,-20
6368238154,6368238151,-3,1133,2776,-20
6369172562,6369172567,5,2306,1237,-20
6370677250,6370677259,9,3213,1049,-20
6371365077,6371365070,-7,1271,4168,-20
6373694011,6373694015,4,2273,1680,-20
6374306466,6374306466,0,898,1640,-20
6382374993,6382374997,4,2270,1501,-20
6382401890,6382401896,6,1755,1752,-20
6382782146,6382782142,-4,1009,2508,-20
6384607019,6384607022,3,1439,1365,-20
6389835773,6389835777,4,2730,2040,-20
6390574247,6390574251,4,1970,1595,-20
6393621209,6393621205,-4,1259,4002,-20
6394245431,6394245433,2,1367,1109,-20
6394588242,6394588245,3,1846,1219,-20
6398966370,6398966374,4,2076,1421,-20
6399203633,6399203626,-7,913,4012,-20
6399378126,6399378130,4,2718,1638,-20
6399771148,6399771149,1,1610,1120,-20
6403121061,6403121071,10,13663,25822,-20
6409689281,6409689282,1,2827,1940,-20
6415071770,6415071773,3,2440,1144,-20
6415787241,6415787246,5,1343,1631,-20
6415879021,6415879041,20,690,662,-20
6418799953,6418799957,4,2461,1559,-20
6419585337,6419585338,1,2467,2002,-20
6424582909,6424582914,5,1241,965,-20
6431022460,6431022465,5,2898,1283,-20
6435344715,6435344719,4,1110,993,-20
6435389169,6435389187,18,2115,1810,-20
6436824600,6436824601,1,1079,1405,-20
6438275205,6438275210,5,2054,1549,-20
6438809493,6438809493,0,1997,1497,-20
6439115851,6439115854,3,1453,930,-20
6439911531,6439911535,4,1247,743,-20
6440521095,6440521099,4,1995,954,-20
6442389005,6442389006,1,1512,1309,-20
6442899851,6442899850,-1,1118,1244,-20
6446183439,6446183445,6,2057,1535,-20
6448642198,6448642218,20,1416,1272,-20
6448869402,6448869405,3,1684,1493,-20
6451268290,6451268275,-15,1306,626,-20
6451485794,6451485798,4,2131,1596,-20
6451986087,6451986091,4,1818,1275,-20
6461369017,6461369019,2,1488,1397,-20
6462216762,6462216765,3,2629,1652,-20
6466180206,6466180209,3,1742,1363,-20
6466461510,6466461514,4,3520,1559,-20
6467083167,6467083172,5,2137,1517,-20
6467669926,6467669930,4,1712,1587,-20
6470619174,6470619169,-5,1038,4192,-20
6470763302,6470763305,3,1664,1507,-20
6473140850,6473140853,3,1575,1254,-20
6474488130,6474488135,5,1375,869,-20
6475584384,6475584386,2,2076,1789,-20
6476697266,6476697269,3,2168,1723,-20
6476894871,6476894875,4,1631,1631,-20
6480059079,6480059083,4,2060,1370,-20
6481615424,6481615427,3,1804,1860,-20
6484673734,6484673738,4,1793,1485,-20
6487505969,6487505971,2,1815,1477,-20
6488179170,6488179173,3,1971,949,-20
6495215547,6495215543,-4,866,2081,-20
6504741398,6504741403,5,1587,1619,-20
6505169223,6505169226,3,1900,1430,-20
6506036089,6506036094,5,2105,1141,-20
6508181735,6508181736,1,1257,996,-20
6511293480,6511293482,2,1542,1069,-20
6512871462,6512871464,2,1154,1083,-20
6516245732,6516245735,3,1820,1712,-20
6520633187,6520633190,3,1471,759,-20
6524656059,6524656062,3,1687,1508,-20
6532637389,6532637389,0,1176,1661,-20
6536345849,6536345852,3,1523,1119,-20
6537058949,6537058960,11,1867,1423,-20
6537775258,6537775265,7,5662,3160,-20
6541215110,6541215109,-1,1481,1901,-20
6542806133,6542806112,-21,1320,937,-20
6544677371,6544677366,-5,1506,3828,-20
6549219817,6549219819,2,1368,1116,-20
6554694891,6554694894,3,2162,1463,-20
6563039486,6563039481,-5,3149,12048,-20
6567587159,6567587143,-16,1064,726,-20
6568835290,6568835291,1,1693,1877,-20
6568972817,6568972822,5,1386,1156,-20
6571105218,6571105221,3,1544,1381,-20
6572766347,6572766351,4,1536,1411,-20
6574453432,6574453436,4,1653,1331,-20
6578840317,6578840321,4,1683,1500,-20
6586755206,6586755209,3,1774,1359,-20
6587295461,6587295467,6,1892,1277,-20
6597281262,6597281266,4,2240,1946,-20
6598021182,6598021186,4,1232,976,-20
6598576596,6598576596,0,1958,2233,-20
6602064755,6602064762,7,1088,731,-20
6602394935,6602394940,5,1776,1121,-20
6602672689,6602672693,4,1592,906,-20
6603965985,6603965990,5,1704,1289,-20
6607783746,6607783748,2,1850,1478,-20
6607965738,6607965734,-4,1223,2013,-20
6609477677,6609477681,4,2202,1843,-20
6611051810,6611051811,1,2203,1631,-20
6611736778,6611736777,-1,6384,9223,-20
6612009062,6612009063,1,1803,1253,-20
6616783703,6616783703,0,1688,1494,-20
6617310017,6617310016,-1,1517,2155,-20
6617775494,6617775498,4,2098,1865,-20
6620222422,6620222427,5,1573,1347,-20
6623744010,6623744012,2,1291,910,-20
6625128640,6625128643,3,1599,1438,-20
6626657009,6626657013,4,1980,1179,-20
6626882919,6626882922,3,1428,1386,-20
6627981236,6627981247,11,9719,46565,-20
6628076341,6628076346,5,4603,2428,-20
6628559637,6628559639,2,1627,1909,-20
6629927253,6629927256,3,1774,1718,-20
6632820594,6632820598,4,2581,1472,-20
6635706973,6635706990,17,443,1703,-20
6635797613,6635797615,2,1637,1359,-20
6637745611,6637745613,2,1481,978,-20
6642401958,6642401963,5,1219,978,-20
6644930526,6644930530,4,1598,1164,-20
6645655969,6645655972,3,2042,1142,-20
6650621259,6650621261,2,1855,1813,-20
6651934362,6651934350,-12,753,1710,-20
6652648454,6652648452,-2,2427,2853,-20
6663228609,6663228610,1,1253,1819,-20
6670112931,6670112936,5,1412,1338,-20
6670593218,6670593223,5,2806,1018,-20
6671680563,6671680569,6,4101,1882,-20
6672436695,6672436699,4,1791,1301,-20
6673985646,6673985659,13,13714,38244,-20
6675626278,6675626276,-2,1740,3532,-20
6675979149,6675979153,4,1617,1346,-20
6676753246,6676753249,3,1280,1280,-20
6681453774,6681453781,7,1775,1467,-20
6683985153,6683985158,5,1936,1515,-20
6685715014,6685715017,3,2179,1876,-20
6695404791,6695404791,0,1745,1403,-20
6696259107,6696259110,3,1865,1101,-20
6696805201,6696805202,1,2051,1018,-20
6697638461,6697638466,5,2023,1166,-20
6697970927,6697970929,2,1563,1790,-20
6698308306,6698308310,4,1891,1625,-20
6702115083,6702115086,3,2380,1264,-20
6702685809,6702685824,15,2950,1434,-20
6709216382,6709216386,4,2683,1543,-20
6711495463,6711495467,4,1923,1657,-20
6715432942,6715432943,1,1704,1371,-20
6715947780,6715947782,2,2353,1544,-20
6720387295,6720387298,3,1716,925,-20
6722209737,6722209735,-2,1368,1894,-20
6723120206,6723120211,5,2538,1777,-20
6738127538,6738127543,5,2114,1652,-20
6739707389,6739707391,2,1609,1588,-20
6743083175,6743083179,4,1519,1135,-20
6743986902,6743986905,3,1614,823,-20
6744988795,6744988798,3,4494,2931,-20
6745361225,6745361227,2,4058,3621,-20
6751934538,6751934541,3,2033,1966,-20
6753062607,6753062610,3,2014,1580,-20
6755742853,6755742858,5,1688,1557,-20
6756585975,6756585954,-21,1755,1040,-20
6757113112,6757113115,3,1768,1092,-20
6758126774,6758126754,-20,958,898,-20
6760443238,6760443240,2,1304,1070,-20
6765589639,6765589641,2,1149,926,-20
6767130653,6767130656,3,1728,1151,-20
6768146325,6768146326,1,1836,1174,-20
6768824077,6768824081,4,3374,1343,-20
6771179464,6771179466,2,2265,1266,-20
6774541278,6774541282,4,2046,1517,-20
6775096963,6775096958,-5,49629,15697,-20
6776546097,6776546098,1,1478,1402,-20
6780363674,6780363685,11,16528,37931,-20
6780451286,6780451287,1,1939,1475,-20
6785999862,6785999865,3,1733,1212,-20
6791773161,6791773163,2,603,548,-20
6792126183,6792126186,3,2149,1548,-20
6793487707,6793487710,3,2054,1480,-20
6795150211,6795150215,4,1286,1144,-20
6795917738,6795917734,-4,722,2196,-20
6797092971,6797092974,3,2022,1265,-20
6797621437,6797621442,5,2673,1458,-20
6800979082,6800979085,3,1826,1629,-20
6801360642,6801360646,4,1733,1380,-20
6803175391,6803175397,6,2692,1188,-20
6803734565,6803734570,5,1378,1161,-20
6805930860,6805930863,3,2101,1431,-20
6807250663,6807250665,2,1265,1106,-20
6812393714,6812393715,1,1845,2086,-20
6817254143,6817254149,6,2330,1486,-20
6818577079,6818577083,4,2361,1945,-20
6821145858,6821145865,7,2566,1358,-20
6823755741,6823755742,1,1956,1933,-20
6824713902,6824713905,3,2074,1745,-20
6825048477,6825048481,4,3249,1787,-20
6826228666,6826228669,3,1227,1176,-20
6829612686,6829612691,5,1450,1447,-20
6834649356,6834649358,2,1425,1261,-20
6835923036,6835923042,6,4205,1874,-20
6835954229,6835954235,6,992,888,-20
6836933542,6836933538,-4,1010,1973,-20
6837886958,6837886961,3,1721,1917,-20
6842626156,6842626159,3,1855,1473,-20
6844864473,6844864477,4,2205,734,-20
6845873941,6845873946,5,2042,1539,-20
6846047122,6846047128,6,1875,1114,-20
6848382670,6848382674,4,1313,1229,-20
6856855267,6856855270,3,1510,1469,-20
6859585926,6859585929,3,1590,1777,-20
6860900554,6860900557,3,1786,1237,-20
6862084747,6862084751,4,1408,1086,-20
6865499530,6865499534,4,1152,860,-20
6866001023,6866001027,4,2182,1316,-20
6869125039,6869125042,3,1546,1086,-20
6872423320,6872423322,2,1752,1128,-20
6879050722,6879050727,5,1300,916,-20
6880139174,6880139177,3,1970,1274,-20
6883865435,6883865437,2,2562,1393,-20
6884672706,6884672709,3,2081,1983,-20
6888255446,6888255450,4,1744,1131,-20
6889807478,6889807481,3,1642,1570,-20
6889899373,6889899377,4,2082,1194,-20
6890216391,6890216394,3,911,1170,-20
6891070861,6891070867,6,1641,761,-20
6894370433,6894370435,2,1592,1531,-20
6895324379,6895324381,2,1966,1451,-20
6898131246,6898131250,4,2365,1450,-20
6902470685,6902470681,-4,1958,3223,-20
6904317591,6904317594,3,1655,1709,-20
6906663240,6906663243,3,1440,1702,-20
6907479663,6907479666,3,2008,1353,-20
6907699811,6907699817,6,637,184,-20
6908948576,6908948580,4,2276,1255,-20
6909314949,6909314950,1,1551,1113,-20
6910479294,6910479301,7,3423,1679,-20
6911263127,6911263132,5,1203,1273,-20
6911445901,6911445905,4,2103,1664,-20
6913875755,6913875757,2,1514,1248,-20
6914167490,6914167501,11,15693,37238,-20
6916126942,6916126946,4,2055,1875,-20
6918541464,6918541468,4,1695,1412,-20
6919847242,6919847246,4,1936,1354,-20
6921803171,6921803173,2,1392,1930,-20
6922421565,6922421571,6,2077,1103,-20
6924026090,6924026094,4,1671,1414,-20
6924170169,6924170171,2,1748,1494,-20
6925180974,6925180977,3,3715,2310,-20
6925990009,6925990004,-5,1316,7249,-20
6926039620,6926039623,3,1577,1423,-20
6927196679,6927196685,6,1553,1239,-20
6928192842,6928192846,4,2623,1506,-20
6929724270,6929724275,5,2058,1304,-20
6930063622,6930063626,4,2304,1859,-20
6933452550,6933452553,3,2604,1462,-20
6937131405,6937131408,3,1505,1409,-20
6937220367,6937220378,11,2030,1538,-20
6937386549,6937386555,6,1725,1140,-20
6941215133,6941215135,2,1766,1184,-20
6941911633,6941911637,4,2236,1595,-20
6943332983,6943332984,1,1879,1406,-20
6944482167,6944482171,4,1315,1036,-20
6946220890,6946220894,4,1453,1349,-20
6955015259,6955015263,4,1268,1047,-20
6957111953,6957111947,-6,1322,1984,-20
6957323041,6957323044,3,1733,1532,-20
6957755337,6957755340,3,1821,1173,-20
6961343481,6961343484,3,1599,796,-20
6961668537,6961668539,2,2379,2182,-20
6962213667,6962213668,1,1467,1550,-20
6966236119,6966236122,3,1515,1571,-20
6967507112,6967507116,4,2401,1728,-20
6968413541,6968413544,3,1926,1977,-20
6971157066,6971157070,4,951,950,-20
6974347111,6974347113,2,1075,1084,-20
6977454231,6977454234,3,1302,1207,-20
6979625661,6979625665,4,1617,1328,-20
6979806503,6979806504,1,1358,1633,-20
6980498354,6980498361,7,2314,1437,-20
6981821064,6981821082,18,536,973,-20
6981890875,6981890879,4,1701,1469,-20
6982758875,6982758877,2,37351,36747,-20
6984686315,6984686319,4,2162,1642,-20
6986383501,6986383504,3,1831,1322,-20
6988048819,6988048821,2,2307,1600,-20
6991649399,6991649400,1,1278,1824,-20
6992347151,6992347155,4,2068,1358,-20
7000321115,7000321117,2,1923,1321,-20
7001876363,7001876368,5,1431,948,-20
7004463912,7004463914,2,1448,1597,-20
7006524145,7006524146,1,1476,1329,-20
7007779146,7007779152,6,1654,1311,-20
7009336522,7009336525,3,1531,1755,-20
7009958653,7009958655,2,1839,1096,-20
7011495609,7011495614,5,2519,1191,-20
7016480350,7016480354,4,1864,1321,-20
7017746513,7017746515,2,1524,1590,-20
7021098634,7021098637,3,2254,1737,-20
7023201099,7023201102,3,2686,1553,-20
7027125727,7027125731,4,1963,1278,-20
7028386333,7028386336,3,2003,1177,-20
7029703457,7029703459,2,1659,1212,-20
7031693882,7031693885,3,2049,1099,-20
7034821428,7034821430,2,1399,1646,-20
7035516850,7035516853,3,1248,904,-20
7039160318,7039160322,4,1562,1044,-20
7041420670,7041420671,1,1260,1786,-20
7041711304,7041711305,1,2772,1996,-20
7048830224,7048830228,4,2137,1260,-20
7049687926,7049687930,4,1683,1112,-20
7055491613,7055491618,5,1549,1513,-20
7056002751,7056002755,4,2203,1139,-20
7056062309,7056062313,4,2632,1208,-20
7056376302,7056376305,3,2063,1528,-20
7059292346,7059292350,4,1693,896,-20
7060157001,7060157004,3,1342,1462,-20
7061433779,7061433762,-17,845,1102,-20
7063987879,7063987880,1,1487,902,-20
7068498147,7068498147,0,1059,1125,-20
7069620642,7069620646,4,3007,1839,-20
7073483738,7073483742,4,1988,988,-20
7074841339,7074841346,7,3121,1316,-20
7076600381,7076600383,2,985,848,-20
7077979964,7077979967,3,1519,1507,-20
7078380287,7078380305,18,714,3988,-20
7079719032,7079719035,3,3984,1929,-20
7090945975,7090945978,3,2033,1766,-20
7091610734,7091610734,0,1558,1907,-20
7095205650,7095205647,-3,1242,2579,-20
7096930051,7096930054,3,2115,1243,-20
7097546004,7097546006,2,1618,1328,-20
7100849041,7100849045,4,1632,1008,-20
7101280165,7101280160,-5,586,1358,-20
7102917901,7102917906,5,1442,1019,-20
7103455885,7103455887,2,2025,1263,-20
7104432557,7104432560,3,1939,1541,-20
7105259078,7105259082,4,2404,1589,-20
7106777497,7106777500,3,1878,1496,-20
7106980656,7106980662,6,1952,1183,-20
7107069484,7107069502,18,1091,13812,-20
7107170298,7107170301,3,2153,2101,-20
7108866519,7108866523,4,2224,1276,-20
7111459582,7111459586,4,1769,1160,-20
7111616925,7111616931,6,6729,2553,-20
7111793802,7111793805,3,2216,1433,-20
7113617158,7113617162,4,941,969,-20
7123853503,7123853507,4,2006,1338,-20
7124485366,7124485368,2,1666,1678,-20
7129434290,7129434292,2,1397,1121,-20
7134921028,7134921031,3,1540,1197,-20
7135588163,7135588166,3,2704,2150,-20
7138091938,7138091940,2,1971,1560,-20
7139196639,7139196645,6,2273,1280,-20
7144596438,7144596444,6,1545,1773,-20
7149512202,7149512205,3,1407,1068,-20
7151486414,7151486417,3,1217,1131,-20
7156887202,7156887203,1,1762,1936,-20
7158810094,7158810095,1,1522,1531,-20
7159155050,7159155052,2,1581,1353,-20
7162048845,7162048851,6,1903,1073,-20
7164888478,7164888481,3,2343,1535,-20
7168300329,7168300333,4,1883,1694,-20
7169800519,7169800500,-19,1257,1501,-20
7170839774,7170839778,4,2687,1812,-20
7171198360,7171198366,6,3682,2012,-20
7172109679,7172109683,4,1949,1564,-20
7173944466,7173944467,1,1792,1431,-20
7174267746,7174267748,2,1648,1493,-20
7174501917,7174501919,2,2148,1582,-20
7175866449,7175866453,4,2961,1224,-20
7177683534,7177683537,3,1772,1599,-20
7178831209,7178831214,5,3024,2103,-20
7182705116,7182705120,4,1991,1374,-20
7185537657,7185537668,11,10302,43258,-20
7187554502,7187554506,4,1104,1003,-20
7190123246,7190123244,-2,1443,3566,-20
7193610226,7193610231,5,1852,1415,-20
7195160715,7195160718,3,2503,1409,-20
7196386189,7196386194,5,1722,1199,-20
7198976626,7198976630,4,1953,1381,-20
7199380345,7199380349,4,1634,1757,-20
7201586545,7201586548,3,1343,1216,-20
7209483090,7209483090,0,1557,726,-20
7209636534,7209636540,6,2590,1401,-20
7211715297,7211715301,4,1758,961,-20
7218257437,7218257437,0,1753,1545,-20
7220955993,7220955986,-7,825,2965,-20
7225519802,7225519803,1,1241,807,-20
7228159899,7228159902,3,1722,1200,-20
7230094236,7230094239,3,2285,2092,-20
7234316455,7234316459,4,2470,1319,-20
7235907790,7235907795,5,2464,1043,-20
7236176845,7236176851,6,1757,1350,-20
7238138506,7238138510,4,1371,1147,-20
7238885017,7238885022,5,1627,1337,-20
7239919678,7239919685,7,1179,1417,-20
7240965656,7240965660,4,1810,1256,-20
7247646115,7247646117,2,2417,1526,-20
7247754933,7247754952,19,1264,1351,-20
7249113995,7249113999,4,1080,808,-20
7249688022,7249688026,4,1630,1461,-20
7249752662,7249752666,4,4343,2909,-20
7252358806,7252358809,3,1725,1171,-20
7252958307,7252958310,3,1631,1453,-20
7255286810,7255286813,3,1555,1903,-20
7255615633,7255615612,-21,860,1021,-20
7263977690,7263977693,3,1545,1267,-20
7264194237,7264194239,2,1522,1116,-20
7265383037,7265383039,2,1629,1497,-20
7267232578,7267232581,3,1872,1560,-20
7268158360,7268158362,2,2146,1953,-20
7269153099,7269153101,2,691,1022,-20
7270945442,7270945445,3,1711,1519,-20
7273046549,7273046566,17,1765,1489,-20
7275945287,7275945287,0,1496,1639,-20
7278429017,7278429020,3,1597,1690,-20
7279139889,7279139894,5,1340,984,-20
7280575103,7280575103,0,1059,980,-20
7282213141,7282213143,2,2067,1323,-20
7283063783,7283063787,4,1557,1487,-20
7289968942,7289968939,-3,920,1561,-20
7292893057,7292893057,0,1542,1803,-20
7293932666,7293932668,2,1926,1248,-20
7295647361,7295647363,2,2296,1248,-20
7296805250,7296805253,3,2408,1410,-20
7298831535,7298831539,4,1938,1640,-20
7301375661,7301375662,1,1373,1005,-20
7305167469,7305167482,13,691,2807,-20
7306212496,7306212500,4,2183,1893,-20
7307548545,7307548551,6,1946,1100,-20
7308789898,7308789891,-7,2210,11434,-20
7310398369,7310398373,4,1509,1590,-20
7312817493,7312817496,3,1603,1047,-20
7317601049,7317601051,2,2661,1404,-20
7322295470,7322295470,0,1461,1128,-20
7325183166,7325183169,3,2406,1603,-20
7325365250,7325365256,6,3116,1503,-20
7325451139,7325451143,4,1822,1476,-20
7328285574,7328285579,5,1479,922,-20
7332148022,7332148026,4,1880,1206,-20
7341112183,7341112176,-7,1657,5628,-20
7342139942,7342139945,3,1607,1266,-20
7342224462,7342224466,4,1708,1110,-20
7344449074,7344449078,4,1571,1293,-20
7347232467,7347232469,2,1463,1387,-20
7347869575,7347869578,3,1467,1146,-20
7349080586,7349080589,3,1479,1124,-20
7349827327,7349827330,3,1192,1214,-20
7350407590,7350407594,4,2222,1542,-20
7350931814,7350931818,4,1667,1217,-20
7353497331,7353497334,3,1589,1405,-20
7355748182,7355748183,1,2462,1338,-20
7358933923,7358933926,3,1627,1563,-20
7366354518,7366354521,3,993,806,-20
7368893053,7368893056,3,2210,1331,-20
7372447502,7372447506,4,1648,1880,-20
7373461579,7373461582,3,1275,1148,-20
7383091832,7383091834,2,1453,1338,-20
7383618983,7383618987,4,2101,1258,-20
7383961209,7383961211,2,1166,1282,-20
7385998381,7385998382,1,3096,1363,-20
7388772678,7388772683,5,1357,1169,-20
7390650005,7390649987,-18,1839,1107,-20
7393144339,7393144343,4,1985,1221,-20
7393970546,7393970550,4,1513,1246,-20
7397069402,7397069402,0,1410,1098,-20
7399712490,7399712494,4,1799,1652,-20
7400221617,7400221621,4,1376,1218,-20
7401929273,7401929278,5,1790,1296,-20
7402714406,7402714386,-20,1567,1614,-20
7405088179,7405088182,3,2105,1638,-20
7405251965,7405251972,7,5354,1944,-20
7407700798,7407700802,4,2133,1546,-20
7414904814,7414904819,5,1649,1401,-20
7416374954,7416374949,-5,1741,6717,-20
7417995085,7417995091,6,2019,903,-20
7420410889,7420410895,6,2561,967,-20
7421102274,7421102278,4,1708,1281,-20
7424205378,7424205379,1,1414,1233,-20
7425627786,7425627790,4,2370,1495,-20
7425670130,7425670134,4,2559,1673,-20
7430968625,7430968624,-1,1216,2524,-20
7432654577,7432654578,1,743,1073,-20
7434739886,7434739891,5,3214,1322,-20
7435097125,7435097118,-7,1771,6656,-20
7435897159,7435897163,4,1762,1215,-20
7438469054,7438469059,5,1973,1106,-20
7440760378,7440760381,3,2364,2147,-20
7442466451,7442466458,7,4420,1400,-20
7447830794,7447830797,3,1933,1158,-20
7448580263,7448580267,4,1273,1716,-20
7448935149,7448935151,2,1331,1222,-20
7449854649,7449854653,4,2061,1648,-20
7450633937,7450633940,3,2267,1674,-20
7453037151,7453037151,0,1110,1019,-20
7460140748,7460140751,3,1285,1488,-20
7463414477,7463414480,3,1894,2035,-20
7470516894,7470516896,2,881,905,-20
7472211222,7472211224,2,1396,1339,-20
7472246038,7472246048,10,1456,1209,-20
7474097909,7474097913,4,1627,1437,-20
7474306632,7474306642,10,1665,1161,-20
7475292151,7475292154,3,1952,1408,-20
7475819142,7475819146,4,1287,900,-20
7479173783,7479173788,5,2127,1310,-20
7479987805,7479987808,3,2295,1623,-20
7480788782,7480788786,4,1845,1392,-20
7482671348,7482671351,3,1644,1254,-20
7487804062,7487804065,3,2974,3942,-20
7489859073,7489859070,-3,20404,12554,-20
7490336179,7490336182,3,1419,1436,-20
7491056024,7491056021,-3,1448,2777,-20
7491764406,7491764402,-4,22703,14998,-20
7491883698,7491883698,0,2038,1568,-20
7493782571,7493782575,4,1316,629,-20
7497375961,7497375965,4,2045,1303,-20
7500540559,7500540558,-1,1679,1424,-20
7501078593,7501078597,4,2279,1929,-20
7501197138,7501197141,3,1358,1372,-20
7508285560,7508285566,6,2208,2091,-20
7509977143,7509977145,2,1783,956,-20
7512950622,7512950626,4,1261,1255,-20
7515251932,7515251934,2,2299,1320,-20
7515396568,7515396578,10,1794,1237,-20
7521507719,7521507722,3,1692,1860,-20
7523266884,7523266887,3,1355,777,-20
7536054300,7536054302,2,1974,1356,-20
7538066475,7538066475,0,1596,1231,-20
7540033714,7540033727,13,2266,1360,-20
7541218431,7541218433,2,1897,907,-20
7541864437,7541864442,5,2142,1614,-20
7543283213,7543283218,5,2174,1119,-20
7545231756,7545231761,5,2040,1420,-20
7548086974,7548086977,3,1313,1549,-20
7553862957,7553862946,-11,1334,473,-20
7555549511,7555549514,3,1442,1721,-20
7560432026,7560432029,3,1765,1393,-20
7563825359,7563825355,-4,1156,2672,-20
7565825602,7565825605,3,2006,1548,-20
7569803206,7569803211,5,1701,1361,-20
7571754950,7571754951,1,1256,836,-20
7575463334,7575463337,3,2018,1443,-20
7576443499,7576443501,2,2348,1886,-20
7577112934,7577112937,3,1258,1588,-20
7579919090,7579919095,5,1733,906,-20
7580216202,7580216206,4,2480,1293,-20
7580920030,7580920034,4,2240,1625,-20
7581239691,7581239695,4,2022,1381,-20
7581840165,7581840145,-20,1400,802,-20
7583559373,7583559379,6,1954,1069,-20
7588294992,7588294997,5,1746,1202,-20
7592110598,7592110599,1,2072,1455,-20
7592890398,7592890401,3,1739,1527,-20
7594697677,7594697679,2,1766,1509,-20
7595663754,7595663757,3,1507,986,-20
7596307158,7596307161,3,1079,919,-20
7597769274,7597769279,5,1848,1635,-20
7605003514,7605003509,-5,2542,7113,-20
7606227500,7606227504,4,2191,896,-20
7609541990,7609541994,4,2400,1414,-20
7609937870,7609937872,2,1894,1416,-20
7611146171,7611146155,-16,1644,918,-20
7611613491,7611613494,3,1342,1360,-20
7611829221,7611829222,1,1391,1492,-20
7614004758,7614004763,5,1318,661,-20
7614403171,7614403177,6,2410,1431,-20
7615495491,7615495493,2,1589,1607,-20
7616253373,7616253381,8,2373,1342,-20
7619104760,7619104762,2,1569,1406,-20
7619623316,7619623319,3,1564,1582,-20
7621234936,7621234937,1,1814,1165,-20
7623393435,7623393438,3,1928,2017,-20
7625162678,7625162682,4,1878,1464,-20
7626216001,7626216006,5,1338,1165,-20
7629470607,7629470611,4,953,1699,-20
7629935291,7629935295,4,1842,2017,-20
7630108510,7630108514,4,989,1287,-20
7632130137,7632130142,5,2258,2106,-20
7633706948,7633706952,4,2075,1418,-20
7634532410,7634532414,4,2432,1729,-20
7635055473,7635055475,2,1827,1253,-20
7635478923,7635478905,-18,1524,1489,-20
7637741653,7637741656,3,2071,1771,-20
7640935414,7640935418,4,2361,1317,-20
7641063208,7641063211,3,2059,1405,-20
7642897255,7642897256,1,1809,2083,-20
7650380449,7650380452,3,1260,1107,-20
7654098322,7654098322,0,1430,1278,-20
7654629479,7654629483,4,1574,1191,-20
7657376488,7657376491,3,1893,1450,-20
7668110888,7668110890,2,1640,1446,-20
7669330346,7669330349,3,14287,12899,-20
7671987634,7671987637,3,1131,1318,-20
7672528385,7672528391,6,2290,1256,-20
7672860871,7672860873,2,1739,1081,-20
7676304799,7676304799,0,1061,1747,-20
7677658673,7677658675,2,1322,1222,-20
7678742486,7678742490,4,1416,1344,-20
7682384958,7682384962,4,2486,1447,-20
7682784770,7682784765,-5,1126,3598,-20
7686737776,7686737779,3,1843,978,-20
7689890576,7689890579,3,2163,2108,-20
7690531011,7690531015,4,2366,1605,-20
7695775962,7695775962,0,1730,2386,-20
7696281585,7696281587,2,1397,1055,-20
7702412360,7702412367,7,2885,1120,-20
7705202498,7705202500,2,2527,1471,-20
7705373898,7705373901,3,1700,2146,-20
7706991382,7706991386,4,1568,1611,-20
7707218382,7707218381,-1,1044,1662,-20
7708646776,7708646774,-2,1418,1545,-20
7708819583,7708819589,6,980,1043,-20
7711001150,7711001154,4,1874,1571,-20
7712476967,7712476971,4,1691,1369,-20
7713180786,7713180791,5,2308,1910,-20
7714973005,7714973007,2,1943,1605,-20
7717762672,7717762677,5,2630,1683,-20
7717933402,7717933405,3,1859,1395,-20
7720127766,7720127768,2,2101,1600,-20
7722490693,7722490696,3,2075,1532,-20
7729737385,7729737387,2,1349,748,-20
7732725221,7732725226,5,2344,1701,-20
7733155119,7733155139,20,672,239,-20
7733359862,7733359881,19,1420,1492,-20
7734050982,7734050987,5,2130,1392,-20
7735157077,7735157081,4,2428,1893,-20
7735824911,7735824914,3,1522,1081,-20
7735962794,7735962797,3,1143,1456,-20
7736475107,7736475111,4,3631,2751,-20
7736550009,7736550011,2,2033,1729,-20
7740277568,7740277564,-4,1369,4337,-20
7740527920,7740527914,-6,2058,9823,-20
7741356018,7741356021,3,1976,1646,-20
7749877541,7749877545,4,1761,1525,-20
7750409248,7750409250,2,1342,854,-20
7751110454,7751110458,4,1858,1166,-20
7752353396,7752353397,1,1678,1890,-20
7756954166,7756954165,-1,1360,1072,-20
7759715118,7759715121,3,1686,1940,-20
7760120766,7760120771,5,1301,1189,-20
7762648008,7762648013,5,5118,2621,-20
7769926833,7769926833,0,1247,1479,-20
7770044279,7770044278,-1,1187,904,-20
7770852751,7770852755,4,1617,1811,-20
7772472027,7772472031,4,1150,855,-20
7773427154,7773427156,2,1943,1385,-20
7774294462,7774294440,-22,1384,1291,-20
7775820388,7775820391,3,983,683,-20
7776755885,7776755889,4,1858,1377,-20
7780473253,7780473257,4,2013,1907,-20
7787265897,7787265901,4,1965,1578,-20
7788539021,7788539022,1,33734,36758,-20
7793513058,7793513062,4,2184,1490,-20
7797494493,7797494495,2,1427,1225,-20
7798385879,7798385882,3,1682,1439,-20
7802520022,7802520027,5,2551,1461,-20
7803749913,7803749908,-5,1212,2912,-20
7806028908,7806028910,2,1939,1603,-20
7809308863,7809308867,4,2464,1853,-20
7815808179,7815808182,3,1793,1007,-20
7818685706,7818685709,3,1862,1393,-20
7818937269,7818937274,5,2831,1870,-20
7821629523,7821629526,3,1497,1529,-20
7823650353,7823650349,-4,694,3275,-20
7826726033,7826726038,5,1168,1084,-20
7829048318,7829048320,2,1782,1263,-20
7830617342,7830617345,3,1946,1461,-20
7831068645,7831068646,1,1946,1365,-20
7831977229,7831977231,2,2457,1698,-20
7835760326,7835760331,5,1853,1219,-20
7842229721,7842229722,1,1608,1073,-20
7846679422,7846679427,5,2320,1540,-20
7847240579,7847240582,3,2240,1568,-20
7855436122,7855436127,5,1189,1253,-20
7856172543,7856172546,3,1854,1086,-20
7856588698,7856588681,-17,1344,1039,-20
7857872702,7857872704,2,924,1523,-20
7860997147,7860997150,3,2019,1210,-20
7862165283,7862165285,2,1546,1249,-20
7863417194,7863417199,5,2005,2146,-20
7870254612,7870254614,2,1540,1159,-20
7877322525,7877322529,4,1671,1970,-20
7880691330,7880691326,-4,1328,2601,-20
7881795970,7881795974,4,1837,1223,-20
7883672279,7883672282,3,1307,1033,-20
7885338868,7885338870,2,2084,1201,-20
7885503578,7885503582,4,1995,1488,-20
7887071815,7887071818,3,1671,1357,-20
7887886279,7887886275,-4,1720,4984,-20
7888698589,7888698594,5,1908,871,-20
7893044340,7893044342,2,2692,1310,-20
7893485256,7893485258,2,2137,976,-20
7900346107,7900346111,4,2523,1505,-20
7904280570,7904280573,3,1185,1054,-20
7906314588,7906314592,4,1259,1582,-20
7910235103,7910235110,7,3358,977,-20
7912221981,7912221982,1,2283,1877,-20
7914340347,7914340337,-10,1569,1401,-20
7917759494,7917759498,4,1418,1316,-20
7918349399,7918349398,-1,1051,1933,-20
7919558311,7919558315,4,2356,1355,-20
7920274997,7920275001,4,2443,1396,-20
7920360316,7920360320,4,1826,1445,-20
7923137625,7923137630,5,1295,1037,-20
7927200578,7927200584,6,1900,1700,-20
7929344214,7929344218,4,2731,1800,-20
7931512652,7931512650,-2,1442,2060,-20
7932518880,7932518886,6,3092,807,-20
7933647142,7933647144,2,1265,980,-20
7935458266,7935458270,4,2527,1842,-20
7935754112,7935754112,0,1152,2426,-20
7935780935,7935780939,4,1416,1427,-20
7938443392,7938443396,4,1835,882,-20
7939531054,7939531055,1,1283,1159,-20
7947693353,7947693356,3,1541,1394,-20
7947963222,7947963212,-10,1724,710,-20
7950312886,7950312892,6,1045,1378,-20
7951045961,7951045962,1,2389,1851,-20
7951665984,7951665988,4,1439,1253,-20
7954157454,7954157460,6,2355,1292,-20
7954242346,7954242344,-2,26478,11795,-20
7954646443,7954646446,3,1303,1143,-20
7956058488,7956058492,4,1499,1125,-20
7960915465,7960915467,2,839,1236,-20
7963978153,7963978158,5,2460,1405,-20
7964153950,7964153957,7,1211,590,-20
7967839650,7967839657,7,2833,964,-20
7968282442,7968282447,5,2734,1184,-20
7972959697,7972959711,14,1287,1381,-20
7973752823,7973752826,3,1402,1072,-20
7974059151,7974059156,5,2250,1554,-20
7975110996,7975110999,3,3118,2097,-20
7975145765,7975145771,6,1657,1298,-20
7976145932,7976145933,1,1190,1030,-20
7977279454,7977279458,4,1852,1288,-20
7977365091,7977365095,4,1983,1248,-20
7978066061,7978066066,5,2674,1759,-20
7978553680,7978553685,5,1983,1213,-20
7983890478,7983890482,4,1758,1223,-20
7984041237,7984041240,3,1817,1277,-20
7984980259,7984980254,-5,1384,1436,-20
7985663463,7985663466,3,2104,1694,-20
7986633145,7986633148,3,2234,1878,-20
7987094115,7987094119,4,1481,1145,-20
7990292502,7990292504,2,1893,1176,-20
7992534464,7992534471,7,2825,1372,-20
7999145482,7999145480,-2,1407,2768,-20
8001105285,8001105291,6,1575,1090,-20
8002082512,8002082515,3,1463,1286,-20
8004704940,8004704943,3,1302,1020,-20
8005596039,8005596042,3,1676,946,-20
8006961413,8006961418,5,2060,1326,-20
8007133321,8007133331,10,1366,1528,-20
8007497448,8007497435,-13,1003,671,-20
8013153373,8013153377,4,1810,1442,-20
8014024616,8014024620,4,1930,1622,-20
8016334650,8016334642,-8,1121,3983,-20
8022094698,8022094700,2,1383,1805,-20
8024741021,8024741027,6,3523,2023,-20
8026595794,8026595814,20,2150,1434,-20
8030945506,8030945507,1,1539,1377,-20
8032661454,8032661457,3,2657,1433,-20
8035222104,8035222106,2,1758,1493,-20
8039905185,8039905189,4,2991,1628,-20
8039989766,8039989767,1,1293,1003,-20
8041739974,8041739978,4,1772,1231,-20
8042020961,8042020965,4,2096,2193,-20
8042847628,8042847631,3,2302,1019,-20
8045083776,8045083779,3,1726,1329,-20
8046376682,8046376686,4,2202,989,-20
8057200096,8057200099,3,2304,1329,-20
8058595471,8058595474,3,2564,1801,-20
8059305154,8059305158,4,2375,807,-20
8059971422,8059971426,4,2027,1556,-20
8065961310,8065961315,5,2353,1376,-20
8066195627,8066195622,-5,763,2464,-20
8066313077,8066313081,4,1394,1263,-20
8070543466,8070543472,6,1646,1543,-20
8071332300,8071332310,10,142,1012,-20
8074100286,8074100287,1,851,983,-20
8075690233,8075690237,4,2217,1397,-20
8077897500,8077897503,3,1614,1083,-20
8079854548,8079854550,2,1438,1388,-20
8081381730,8081381734,4,1775,1564,-20
8085439626,8085439631,5,1409,1510,-20
8087721409,8087721414,5,1424,1139,-20
8089330686,8089330690,4,1573,1728,-20
8091109648,8091109653,5,2045,1367,-20
8091562335,8091562314,-21,2120,690,-20
8091624682,8091624687,5,1395,1005,-20
8101459296,8101459300,4,1534,1610,-20
8101893005,8101893006,1,2208,1339,-20
8103778131,8103778134,3,2560,1389,-20
8105653797,8105653801,4,1688,1339,-20
8109479339,8109479343,4,2113,1542,-20
8112352702,8112352702,0,3891,3789,-20
8112401121,8112401125,4,1705,1256,-20
8118361833,8118361835,2,1956,1173,-20
8120122290,8120122293,3,1256,1399,-20
8124395881,8124395883,2,2036,1388,-20
8125948826,8125948821,-5,1139,3505,-20
8126660245,8126660245,0,29057,35921,-20
8129819502,8129819506,4,1962,909,-20
8130718309,8130718302,-7,873,4368,-20
8132134360,8132134361,1,1540,1368,-20
8135211139,8135211142,3,1821,983,-20
8136541574,8136541575,1,1503,1053,-20
8138311858,8138311861,3,2093,1230,-20
8142015626,8142015631,5,1113,1769,-20
8144223651,8144223653,2,1648,1538,-20
8144293148,8144293152,4,2222,1915,-20
8147193224,8147193226,2,2140,1413,-20
8151109441,8151109443,2,1425,1084,-20
8151980999,8151981002,3,1091,1003,-20
8153609966,8153609970,4,3035,2048,-20
8154136496,8154136501,5,1904,1753,-20
8154311622,8154311626,4,2508,1607,-20
8154962649,8154962653,4,1455,1416,-20
8158360338,8158360341,3,1886,1296,-20
8160700234,8160700242,8,2359,913,-20
8162021619,8162021622,3,1570,1479,-20
8166275793,8166275798,5,1245,1525,-20
8167888070,8167888066,-4,2042,3290,-20
8168091207,8168091210,3,2060,1811,-20
8169587389,8169587391,2,2199,1514,-20
8170064006,8170064010,4,1852,1203,-20
8174525974,8174525976,2,1246,1133,-20
8174744102,8174744112,10,1258,1859,-20
8181010964,8181010970,6,1841,1238,-20
8181468967,8181468970,3,1987,1488,-20
8182539459,8182539455,-4,985,1838,-20
8188018409,8188018413,4,1721,1680,-20
8189548137,8189548141,4,1790,1443,-20
8193066393,8193066396,3,2249,1636,-20
8197049075,8197049079,4,2110,1881,-20
8198114008,8198114011,3,1060,835,-20
8199105752,8199105757,5,1448,1377,-20
8200338127,8200338130,3,1069,744,-20
8204935366,8204935369,3,1615,1239,-20
8206628946,8206628950,4,1770,1416,-20
8208314853,8208314855,2,1106,1003,-20
8210283668,8210283672,4,1557,1118,-20
8210883186,8210883191,5,1710,1287,-20
8211834882,8211834888,6,1949,1599,-20
8215183637,8215183638,1,1458,1092,-20
8218054714,8218054718,4,1395,1206,-20
8218386914,8218386917,3,1718,1450,-20
8220140702,8220140707,5,2084,1361,-20
8223005890,8223005891,1,1919,1348,-20
8225228214,8225228217,3,2421,1385,-20
8225478766,8225478771,5,2112,1306,-20
8226522497,8226522502,5,1637,1534,-20
8226782632,8226782642,10,22669,46839,-20
8228296694,8228296698,4,2458,1695,-20
8229648018,8229648023,5,2178,1377,-20
8229851065,8229851068,3,1487,1569,-20
8231527069,8231527071,2,2444,1429,-20
8233592056,8233592058,2,1489,1371,-20
8234748709,8234748711,2,1406,1047,-20
8235188228,8235188231,3,2359,1993,-20
8235711076,8235711078,2,1966,1241,-20
8239194986,8239194988,2,1632,1401,-20
8239570048,8239570033,-15,2424,1012,-20
8246379431,8246379409,-22,11684,48580,-20
8247884059,8247884063,4,1417,1379,-20
8248280913,8248280916,3,1695,1504,-20
8248466460,8248466458,-2,1787,2889,-20
8250362671,8250362675,4,1563,1367,-20
8252490359,8252490363,4,2249,1550,-20
8255736630,8255736636,6,2031,1128,-20
8258789994,8258789998,4,1559,1209,-20
8259020866,8259020849,-17,2858,1593,-20
8260640970,8260640974,4,1990,1541,-20
8261079597,8261079599,2,1931,2596,-20
8263376849,8263376854,5,1925,1509,-20
8264248171,8264248175,4,1704,1177,-20
8265904899,8265904906,7,3581,1306,-20
8267146142,8267146146,4,2015,1171,-20
8267232229,8267232233,4,1424,1257,-20
8270114837,8270114839,2,1128,1061,-20
8272685137,8272685141,4,1629,1473,-20
8273475590,8273475593,3,2424,1599,-20
8276512778,8276512783,5,1585,1490,-20
8277751721,8277751727,6,1420,1203,-20
8278510965,8278510967,2,1845,1318,-20
8280964325,8280964330,5,1687,1539,-20
8281772637,8281772641,4,1534,1483,-20
8282116550,8282116533,-17,1230,850,-20
8282519654,8282519658,4,1914,1274,-20
8283654005,8283654009,4,2607,2011,-20
8283901765,8283901766,1,1736,1710,-20
8284472789,8284472794,5,2142,1350,-20
8284602543,8284602562,19,1583,1392,-20
8288555442,8288555450,8,4050,1378,-20
8291836687,8291836691,4,1787,859,-20
8300023990,8300023994,4,994,1244,-20
8303205554,8303205557,3,1679,1510,-20
8304067862,8304067860,-2,1063,1524,-20
8305032581,8305032583,2,1706,1551,-20
8309057695,8309057714,19,1332,1963,-20
8316424851,8316424845,-6,834,3880,-20
8317628637,8317628641,4,2219,979,-20
8317949239,8317949222,-17,1236,831,-20
8318347483,8318347466,-17,1748,1429,-20
8319067221,8319067224,3,2040,1520,-20
8320751878,8320751885,7,2469,1203,-20
8322096329,8322096334,5,1803,1306,-20
8322633697,8322633699,2,1510,1524,-20
8322707706,8322707710,4,1434,1626,-20
8323503003,8323503007,4,1566,1280,-20
8328053012,8328053017,5,1912,1399,-20
8330206632,8330206633,1,1066,1129,-20
8332204707,8332204709,2,2379,1536,-20
8333280470,8333280471,1,994,859,-20
8333557304,8333557306,2,1779,1500,-20
8337873035,8337873039,4,1169,1575,-20
8339151158,8339151160,2,1322,997,-20
8339655024,8339655031,7,2159,1247,-20
8340125605,8340125606,1,2039,1410,-20
8340374694,8340374698,4,1393,1077,-20
8343844883,8343844886,3,2186,1181,-20
8351770765,8351770769,4,2421,912,-20
8352800628,8352800630,2,1963,1547,-20
8354236554,8354236558,4,1388,1511,-20
8355306074,8355306078,4,1687,1602,-20
8357610537,8357610547,10,10016,25576,-20
8358093208,8358093212,4,1776,939,-20
8360184101,8360184103,2,2078,1442,-20
8362170178,8362170182,4,1490,1250,-20
8362650867,8362650872,5,1906,1598,-20
8366196016,8366196019,3,2190,1354,-20
8368668730,8368668735,5,1740,1229,-20
8368728229,8368728225,-4,889,2593,-20
8371120537,8371120539,2,2288,1114,-20
8373853299,8373853300,1,1317,1337,-20
8374093679,8374093682,3,2095,1152,-20
8375724410,8375724414,4,1834,1377,-20
8379872963,8379872964,1,1270,1152,-20
8380065877,8380065898,21,1641,1355,-20
8381486602,8381486608,6,2631,1364,-20
8384942995,8384942998,3,2465,1779,-20
8387414580,8387414582,2,1786,1326,-20
8392079375,8392079380,5,2027,1201,-20
8395875214,8395875218,4,1675,1441,-20
8400273040,8400273039,-1,1008,1208,-20
8401024333,8401024336,3,1386,1304,-20
8402200270,8402200273,3,1129,689,-20
8402617019,8402617023,4,1995,1113,-20
8408154177,8408154181,4,1917,1496,-20
8408507337,8408507341,4,2570,1512,-20
8408723127,8408723131,4,1754,1586,-20
8408950010,8408950016,6,6619,2630,-20
8412880629,8412880631,2,1834,1394,-20
8416961035,8416961038,3,2007,1345,-20
8417273438,8417273436,-2,2779,13254,-20
8419048690,8419048694,4,1557,1622,-20
8425665803,8425665806,3,1581,1178,-20
8427576975,8427576978,3,1897,1195,-20
8434713002,8434713006,4,1743,1140,-20
8438340826,8438340827,1,1845,1221,-20
8439238882,8439238886,4,1732,1149,-20
8439584272,8439584273,1,2008,1056,-20
8442597826,8442597830,4,2429,1225,-20
8443685479,8443685483,4,1663,1259,-20
8444480369,8444480371,2,1237,1020,-20
8448230495,8448230498,3,1897,1082,-20
8457414279,8457414283,4,1730,1305,-20
8458746780,8458746782,2,1804,1816,-20
8460063833,8460063843,10,617,201,-20
8460559417,8460559419,2,1325,1243,-20
8461554612,8461554615,3,1922,1362,-20
8465427666,8465427670,4,2661,1899,-20
8466530447,8466530451,4,4115,3257,-20
8473256959,8473256960,1,2151,1712,-20
8476815686,8476815686,0,1841,1578,-20
8478469433,8478469436,3,2656,1660,-20
8481028806,8481028809,3,2181,2024,-20
8484797530,8484797532,2,1806,1843,-20
8490576205,8490576209,4,1184,1073,-20
8493430320,8493430323,3,1759,1186,-20
8494162669,8494162674,5,2379,1816,-20
8496790667,8496790670,3,1707,1248,-20
8496872839,8496872842,3,1893,1227,-20
8498457110,8498457113,3,2891,1723,-20
8498732606,8498732609,3,2018,1584,-20
8498898811,8498898809,-2,588,368,-20
8499723876,8499723879,3,1541,1524,-20
8507947874,8507947875,1,1589,1293,-20
8508405227,8508405230,3,2450,2005,-20
8508636067,8508636070,3,817,752,-20
8508821802,8508821804,2,1173,997,-20
8509818478,8509818482,4,1780,1636,-20
8510553106,8510553111,5,1428,1106,-20
8510918722,8510918725,3,2143,1593,-20
8516055062,8516055067,5,1175,777,-20
8517761669,8517761672,3,2392,1821,-20
8518119028,8518119033,5,1001,1192,-20
8529053934,8529053935,1,1098,1148,-20
8530749319,8530749323,4,2217,1547,-20
8532321900,8532321903,3,2566,1756,-20
8532378234,8532378238,4,1602,1434,-20
8532496654,8532496657,3,1591,1741,-20
8534437773,8534437775,2,1326,1265,-20
8536075245,8536075224,-21,1604,653,-20
8537284251,8537284257,6,1139,875,-20
8537595575,8537595578,3,1716,1248,-20
8541338270,8541338272,2,1912,1428,-20
8541744999,8541745002,3,1449,845,-20
8542482198,8542482203,5,2699,1937,-20
8543011018,8543011022,4,1841,1228,-20
8545909483,8545909486,3,1546,1001,-20
8549504723,8549504726,3,1940,970,-20
8552638533,8552638538,5,2375,1357,-20
8554108956,8554108958,2,1179,1337,-20
8554313629,8554313630,1,1199,1087,-20
8557562937,8557562942,5,2146,1682,-20
8560601106,8560601110,4,1830,1465,-20
8565947431,8565947434,3,2470,1832,-20
8567940652,8567940656,4,2704,1521,-20
8569391194,8569391199,5,2350,1294,-20
8569839355,8569839359,4,1398,1615,-20
8577911777,8577911779,2,2232,1580,-20
8581164026,8581164030,4,1303,1252,-20
8581434021,8581434025,4,1809,1243,-20
8585709971,8585709965,-6,2143,8405,-20
8587353083,8587353087,4,1824,1050,-20
8588203471,8588203474,3,1437,1089,-20
8595696975,8595696977,2,2083,1216,-20
8597389114,8597389117,3,1015,1115,-20
8601923518,8601923523,5,2495,1047,-20
8602309913,8602309915,2,1512,1079,-20
8603080474,8603080468,-6,1893,7330,-20
8604149904,8604149907,3,1587,1548,-20
8607309197,8607309203,6,2237,1213,-20
8607782460,8607782457,-3,1837,5239,-20
8608299845,8608299846,1,936,1270,-20
8610422970,8610422974,4,2276,1378,-20
8618391485,8618391489,4,1437,981,-20
8621277255,8621277261,6,1818,1284,-20
8621917255,8621917258,3,1674,1433,-20
8624091524,8624091527,3,2288,1344,-20
8633048894,8633048898,4,2134,1201,-20
8636699858,8636699862,4,2547,1360,-20
8638417830,8638417834,4,2605,2008,-20
8640363577,8640363580,3,1605,1032,-20
8641491077,8641491083,6,1431,1601,-20
8646834927,8646834929,2,1952,1530,-20
8647365189,8647365192,3,2344,1892,-20
8649947973,8649947978,5,1814,1618,-20
8651230099,8651230098,-1,1696,2316,-20
8651671732,8651671731,-1,18213,50449,-20
8655652020,8655652024,4,2084,1318,-20
8655969794,8655969810,16,1094,464,-20
8656217426,8656217425,-1,1170,2165,-20
8660138598,8660138602,4,1167,863,-20
8661052375,8661052381,6,1594,972,-20
8664052448,8664052453,5,1516,1311,-20
8666400063,8666400068,5,2378,1845,-20
8673453203,8673453209,6,1937,1219,-20
8681224482,8681224481,-1,4199,8610,-20
8682178627,8682178631,4,959,988,-20
8684158535,8684158535,0,685,807,-20
8684432418,8684432423,5,603,597,-20
8685295198,8685295203,5,2369,1483,-20
8687523866,8687523870,4,920,1200,-20
8688478602,8688478606,4,2015,1208,-20
8690061085,8690061087,2,1638,872,-20
8691341495,8691341497,2,1171,1073,-20
8693439071,8693439074,3,1407,850,-20
8703739790,8703739791,1,1986,1617,-20
8704320454,8704320458,4,1730,1495,-20
8707463697,8707463699,2,1096,1126,-20
8708286041,8708286047,6,1177,835,-20
8708345127,8708345108,-19,700,348,-20
8711298557,8711298558,1,1670,1641,-20
8718129102,8718129105,3,1300,1053,-20
8725059772,8725059775,3,1940,1128,-20
8727477561,8727477565,4,1727,1211,-20
8730168082,8730168087,5,1657,1657,-20
8730618334,8730618335,1,1681,1594,-20
8733364730,8733364735,5,2109,1180,-20
8740228764,8740228770,6,2077,2132,-20
8740982690,8740982695,5,1350,1030,-20
8746442317,8746442318,1,2568,1659,-20
8747275660,8747275663,3,1640,1144,-20
8750263105,8750263107,2,2123,1272,-20
8751430693,8751430698,5,2123,1725,-20
8751798754,8751798738,-16,1067,851,-20
8752147648,8752147651,3,2535,2179,-20
8752787155,8752787159,4,1033,849,-20
8758244113,8758244117,4,1609,1032,-20
8761587880,8761587886,6,3059,1805,-20
8766009840,8766009842,2,1934,1668,-20
8766202565,8766202586,21,1531,1355,-20
8767339574,8767339577,3,1758,1324,-20
8768140223,8768140227,4,1836,1604,-20
8768241110,8768241115,5,2241,1332,-20
8769937942,8769937943,1,2057,1492,-20
8770061806,8770061810,4,1349,978,-20
8770706947,8770706942,-5,832,2484,-20
8771140132,8771140135,3,822,737,-20
8776100944,8776100949,5,2014,1665,-20
8780305696,8780305699,3,2242,1231,-20
8780871082,8780871085,3,1479,1450,-20
8783805755,8783805761,6,1686,1125,-20
8784892521,8784892525,4,2098,1541,-20
8785089021,8785089024,3,1311,1691,-20
8789267221,8789267209,-12,37537,16146,-20
8791179642,8791179645,3,1901,1065,-20
8791617122,8791617104,-18,1944,1278,-20
8791686811,8791686793,-18,1782,1348,-20
8795726342,8795726343,1,1026,594,-20
8797274402,8797274407,5,1415,1031,-20
8798930767,8798930771,4,1648,1446,-20
8799416298,8799416299,1,1289,1086,-20
8801864050,8801864052,2,2559,1948,-20
8804145083,8804145085,2,1467,1274,-20
8808269822,8808269817,-5,1608,3751,-20
8809281391,8809281394,3,1670,1512,-20
8809749102,8809749106,4,2072,1343,-20
8810069293,8810069299,6,4070,998,-20
8812588181,8812588184,3,1729,1653,-20
8813872386,8813872388,2,1660,1202,-20
8815546617,8815546621,4,1664,1075,-20
8818370646,8818370649,3,1243,1668,-20
8818907853,8818907857,4,1549,925,-20
8820340900,8820340903,3,2143,1771,-20
8821724077,8821724070,-7,1315,6684,-20
8830892517,8830892522,5,1653,1338,-20
8834074231,8834074234,3,1397,1558,-20
8835105388,8835105390,2,1392,1536,-20
8835542212,8835542215,3,1499,1407,-20
8836370107,8836370090,-17,1035,960,-20
8839495075,8839495073,-2,989,1710,-20
8839633114,8839633122,8,1070,862,-20
8840460410,8840460409,-1,3014,3615,-20
8842684867,8842684871,4,1344,1413,-20
8842923274,8842923257,-17,831,532,-20
8848269658,8848269662,4,1274,1217,-20
8849719201,8849719206,5,1401,1456,-20
8850273101,8850273106,5,1767,1037,-20
8850459242,8850459227,-15,1129,1130,-20
8852055849,8852055851,2,1335,1370,-20
8852622369,8852622358,-11,41,643,-20
8855042470,8855042474,4,1010,1308,-20
8856675579,8856675579,0,1480,870,-20
8861206074,8861206077,3,2087,1645,-20
8862070207,8862070212,5,1785,1515,-20
8862241895,8862241898,3,1290,1256,-20
8864861065,8864861069,4,1717,1726,-20
8867555342,8867555346,4,1638,1184,-20
8870230799,8870230803,4,1724,1240,-20
8873440198,8873440202,4,1554,2084,-20
8877642551,8877642555,4,2384,984,-20
8878357291,8878357297,6,1543,1443,-20
8879467543,8879467546,3,2052,1917,-20
8880791291,8880791294,3,1698,1442,-20
8882089869,8882089870,1,3488,3775,-20
8883200797,8883200800,3,2600,2083,-20
8884777674,8884777678,4,1955,1267,-20
8885718116,8885718119,3,2893,1231,-20
8891946685,8891946678,-7,1544,7802,-20
8894080171,8894080173,2,2231,1672,-20
8894929481,8894929484,3,1757,1344,-20
8895918885,8895918886,1,1548,1368,-20
8903182267,8903182271,4,2396,1405,-20
8906883314,8906883319,5,770,875,-20
8912001810,8912001813,3,1901,1368,-20
8917101954,8917101959,5,1408,1134,-20
8920779202,8920779206,4,1606,1833,-20
8922134081,8922134086,5,1132,927,-20
8923879647,8923879651,4,1958,1598,-20
8924007239,8924007242,3,1246,808,-20
8924253533,8924253538,5,2095,1187,-20
8924333619,8924333624,5,842,371,-20
8926931432,8926931435,3,2228,1715,-20
8928963210,8928963211,1,1786,1331,-20
8931424746,8931424726,-20,1601,778,-20
8932726167,8932726164,-3,2573,3923,-20
8933136463,8933136464,1,1445,1669,-20
8934166853,8934166852,-1,1183,1896,-20
8935351754,8935351756,2,1770,1536,-20
8936071450,8936071454,4,2588,1767,-20
8938147343,8938147347,4,2720,1759,-20
8939842126,8939842129,3,1750,1900,-20
8940738314,8940738319,5,1581,1714,-20
8941377455,8941377458,3,3104,1560,-20
8942951212,8942951215,3,1923,1391,-20
8943757551,8943757557,6,1224,1371,-20
8946566241,8946566245,4,2019,1388,-20
8949252947,8949252949,2,1988,1715,-20
8953050990,8953050993,3,1959,1757,-20
8955443902,8955443884,-18,1248,888,-20
8959877900,8959877905,5,2895,1494,-20
8960757646,8960757650,4,2228,1385,-20
8965371004,8965371010,6,2718,2045,-20
8966678611,8966678614,3,1514,982,-20
8968295412,8968295415,3,2550,1806,-20
8973254270,8973254274,4,2688,1653,-20
8980427530,8980427531,1,1202,1438,-20
8981082874,8981082878,4,1151,1935,-20
8989164560,8989164561,1,1904,1536,-20
8989680026,8989680010,-16,1362,881,-20
8991852814,8991852817,3,1312,1597,-20
8992345675,8992345659,-16,1194,705,-20
8992965266,8992965269,3,2174,1143,-20
8996102385,8996102389,4,2547,1425,-20
8996321901,8996321913,12,2356,1270,-20
8996894103,8996894107,4,1448,1269,-20
8998607759,8998607762,3,1898,1858,-20
8999080513,8999080514,1,1398,1697,-20
9001637554,9001637559,5,2152,1357,-20
9007481488,9007481491,3,1301,1008,-20
9008689897,9008689915,18,17308,31129,-20
9012827949,9012827953,4,2190,1665,-20
9016649504,9016649507,3,1865,1404,-20
9018146954,9018146949,-5,1080,3198,-20
9018270529,9018270535,6,1090,981,-20
9018739143,9018739146,3,1430,1300,-20
9020560396,9020560401,5,2762,1610,-20
9023863190,9023863194,4,2026,1584,-20
9025016978,9025016982,4,1944,1362,-20
9027696014,9027696019,5,1928,1427,-20
9029171793,9029171795,2,1676,1529,-20
9035155786,9035155791,5,1751,988,-20
9035305190,9035305194,4,1450,1535,-20
9035548341,9035548347,6,2203,1396,-20
9039632927,9039632941,14,2081,1357,-20
9040249002,9040249010,8,13,452,-20
9040703818,9040703821,3,2224,1507,-20
9041729947,9041729950,3,2103,1242,-20
9042539345,9042539350,5,1759,919,-20
9050977404,9050977406,2,1720,1370,-20
9056608753,9056608757,4,2212,1833,-20
9059728656,9059728638,-18,2519,1995,-20
9060930674,9060930679,5,1389,924,-20
9072252805,9072252806,1,1939,1012,-20
9073147664,9073147667,3,1277,997,-20
9076181790,9076181793,3,1875,1541,-20
9077119003,9077119002,-1,613,663,-20
9080840549,9080840551,2,1709,1331,-20
9081341550,9081341557,7,1607,838,-20
9084128149,9084128153,4,1765,2065,-20
9084178010,9084178014,4,1853,1248,-20
9089959297,9089959297,0,1472,1427,-20
9092176480,9092176483,3,900,1136,-20
9092980130,9092980131,1,2062,2321,-20
9094432343,9094432346,3,1870,1155,-20
9096444630,9096444634,4,1648,1193,-20
9101677562,9101677566,4,1773,1060,-20
9102131295,9102131282,-13,785,612,-20
9109952353,9109952371,18,13410,36160,-20
9113141605,9113141607,2,1255,1133,-20
9114996950,9114996954,4,2161,1851,-20
9118875570,9118875574,4,1353,1220,-20
9121512479,9121512484,5,1872,1412,-20
9123796851,9123796857,6,2742,1203,-20
9131458743,9131458746,3,2034,1557,-20
9132925024,9132925027,3,2332,1945,-20
9133980567,9133980573,6,1962,1221,-20
9137842990,9137842993,3,2259,1549,-20
9137877115,9137877098,-17,2101,1393,-20
9137931363,9137931363,0,1157,1139,-20
9142418058,9142418062,4,1713,1292,-20
9147239047,9147239050,3,1423,1472,-20
9151532872,9151532874,2,1753,1509,-20
9154146667,9154146670,3,1534,1461,-20
9156422118,9156422123,5,1131,1510,-20
9158925739,9158925741,2,865,944,-20
9160405753,9160405740,-13,1835,1408,-20
9166396033,9166396038,5,1664,1619,-20
9168747621,9168747624,3,1260,1995,-20
9170865093,9170865096,3,2969,1952,-20
9171109265,9171109267,2,1583,1309,-20
9172349678,9172349681,3,1710,1617,-20
9176423646,9176423648,2,1435,1341,-20
9182344958,9182344962,4,1932,1344,-20
9183430410,9183430413,3,2036,1333,-20
9186028583,9186028586,3,2021,1568,-20
9190014394,9190014399,5,3314,1368,-20
9192259912,9192259915,3,1652,1301,-20
9198367355,9198367359,4,1973,1392,-20
9199433115,9199433119,4,1602,870,-20
9202033878,9202033859,-19,269,1824,-20
9203393974,9203393979,5,2017,1394,-20
9204926173,9204926177,4,2598,1744,-20
9209624636,9209624638,2,1123,1056,-20
9210320088,9210320090,2,1385,1114,-20
9213349999,9213350002,3,1692,2424,-20
9218495934,9218495938,4,2042,1283,-20
9218606486,9218606491,5,1667,1506,-20
9219723894,9219723898,4,1613,1457,-20
9220648765,9220648787,22,1940,1477,-20
9229121581,9229121585,4,2558,1791,-20
9229705202,9229705198,-4,1258,2738,-20
9230247915,9230247917,2,1598,1504,-20
9231136607,9231136609,2,1868,1535,-20
9235367767,9235367771,4,2168,1466,-20
9239186704,9239186706,2,2132,1899,-20
9240521416,9240521419,3,1696,2108,-20
9243694379,9243694383,4,1461,1196,-20
9243948870,9243948852,-18,977,1102,-20
9244661729,9244661735,6,1377,959,-20
9246653690,9246653695,5,1274,964,-20
9249085762,9249085763,1,2070,1709,-20
9250333205,9250333209,4,2086,1426,-20
9251200034,9251200040,6,1698,1482,-20
9251900995,9251901001,6,2280,1479,-20
9252540202,9252540207,5,1517,1135,-20
9254414325,9254414330,5,1712,1246,-20
9256006606,9256006610,4,1784,1603,-20
9256752591,9256752596,5,2599,1853,-20
9257701762,9257701767,5,1979,1355,-20
9258239262,9258239240,-22,863,590,-20
9262262048,9262262050,2,1928,1580,-20
9265521753,9265521757,4,1830,1534,-20
9268790177,9268790179,2,1615,1210,-20
9269581654,9269581653,-1,1460,2772,-20
9272823718,9272823721,3,2732,1933,-20
9273865874,9273865881,7,2948,1316,-20
9281012642,9281012645,3,1252,1272,-20
9284682753,9284682756,3,1637,1510,-20
9286037298,9286037299,1,941,999,-20
9286549338,9286549341,3,1803,1393,-20
9288837964,9288837969,5,1906,1229,-20
9291138920,9291138923,3,1554,1215,-20
9291719942,9291719946,4,1989,1528,-20
9296135094,9296135096,2,2171,1376,-20
9296474377,9296474385,8,1247,699,-20
9299346327,9299346320,-7,949,3115,-20
9300572567,9300572571,4,1880,1589,-20
9301084078,9301084085,7,1834,1067,-20
9301915483,9301915467,-16,1261,1359,-20
9302943370,9302943377,7,1910,1752,-20
9304006550,9304006552,2,2413,2020,-20
9305557803,9305557807,4,1796,1153,-20
9307378981,9307378983,2,2679,1592,-20
9307955270,9307955273,3,2065,1479,-20
9309033922,9309033927,5,1289,1128,-20
9312772842,9312772846,4,2218,1553,-20
9315132385,9315132390,5,1122,937,-20
9315408945,9315408950,5,1517,1107,-20
9316455381,9316455400,19,589,1740,-20
9316977309,9316977305,-4,1598,3226,-20
9317597258,9317597259,1,1794,1184,-20
9320698506,9320698512,6,1468,1042,-20
9321699301,9321699304,3,1730,1290,-20
9321931945,9321931948,3,2298,1716,-20
9325269422,9325269427,5,1500,1296,-20
9326678405,9326678408,3,1691,1782,-20
9327651245,9327651247,2,1432,866,-20
9329165805,9329165808,3,2405,1916,-20
9329482758,9329482761,3,1627,1390,-20
9329781863,9329781873,10,1022,965,-20
9333822539,9333822541,2,2324,1742,-20
9334814750,9334814753,3,2029,1439,-20
9336840003,9336840010,7,2285,887,-20
9339291534,9339291538,4,1574,1023,-20
9340264250,9340264254,4,1923,1475,-20
9341972515,9341972518,3,1513,1329,-20
9342797641,9342797646,5,2257,1708,-20
9344972853,9344972855,2,995,1263,-20
9348999199,9348999204,5,2174,1670,-20
9349415965,9349415969,4,1721,1254,-20
9353062081,9353062085,4,2350,1970,-20
9354310961,9354310961,0,1651,1878,-20
9358056532,9358056534,2,1386,1449,-20
9358448425,9358448428,3,1727,1771,-20
9361382009,9361382013,4,2087,1287,-20
9364936675,9364936678,3,2435,1418,-20
9365886595,9365886599,4,1925,1320,-20
9366963333,9366963338,5,1291,977,-20
9368877046,9368877051,5,3796,1442,-20
9368962769,9368962753,-16,547,497,-20
9369704982,9369704977,-5,1060,1790,-20
9371232669,9371232672,3,2058,1253,-20
9371777499,9371777502,3,2677,1610,-20
9374282745,9374282749,4,1669,1124,-20
9374873277,9374873279,2,1608,1075,-20
9374940886,9374940890,4,1615,1330,-20
9377501877,9377501882,5,2629,2101,-20
9380077722,9380077727,5,2293,1743,-20
9380388358,9380388363,5,2887,2134,-20
9381217198,9381217205,7,3770,1879,-20
9383297441,9383297444,3,1751,1810,-20
9391013973,9391013962,-11,1126,1609,-20
9391394843,9391394846,3,1430,1291,-20
9393707545,9393707549,4,1001,991,-20
9394003302,9394003300,-2,46074,19841,-20
9400085516,9400085518,2,2127,1544,-20
9400830098,9400830100,2,1322,1405,-20
9401100813,9401100816,3,1657,1248,-20
9402879749,9402879752,3,1305,986,-20
9404568337,9404568342,5,2768,1341,-20
9411342418,9411342421,3,2160,1839,-20
9412222151,9412222157,6,4919,2674,-20
9412441646,9412441647,1,1958,1787,-20
9415038105,9415038107,2,2191,1376,-20
9416489973,9416489974,1,1678,1914,-20
9416919754,9416919760,6,2202,1230,-20
9418208434,9418208438,4,2455,1352,-20
9418838127,9418838135,8,2862,1286,-20
9419675962,9419675967,5,1702,1112,-20
9421557310,9421557312,2,917,707,-20
9425018466,9425018470,4,1293,1100,-20
9425403101,9425403106,5,4725,2965,-20
9433671279,9433671279,0,2017,1252,-20
9437829019,9437829022,3,1994,2075,-20
9438723593,9438723598,5,2212,1741,-20
9440065327,9440065331,4,1471,985,-20
9444988332,9444988326,-6,2543,11223,-20
9445560278,9445560282,4,1457,1216,-20
9448002636,9448002638,2,1369,1082,-20
9448186310,9448186313,3,1460,1282,-20
9450024087,9450024091,4,1949,1698,-20
9459493182,9459493188,6,2339,1535,-20
9461336677,9461336679,2,1868,1542,-20
9462212796,9462212799,3,1311,1239,-20
9464260273,9464260273,0,1442,1788,-20
9467025902,9467025903,1,2324,894,-20
9469670901,9469670906,5,1577,1041,-20
9470797365,9470797344,-21,1311,804,-20
9474039133,9474039137,4,2667,1659,-20
9478151787,9478151791,4,1544,2019,-20
9478730961,9478730962,1,1095,1087,-20
9485495810,9485495814,4,1144,1390,-20
9487438373,9487438366,-7,1259,2666,-20
9491004008,9491004013,5,1565,1213,-20
9494668173,9494668175,2,1987,1164,-20
9495935047,9495935051,4,2114,1490,-20
9496514598,9496514577,-21,2281,1449,-20
9496750673,9496750682,9,2035,1385,-20
9497647694,9497647696,2,1674,1489,-20
9497927507,9497927510,3,38597,52834,-20
9500724356,9500724359,3,1190,1265,-20
9501112793,9501112800,7,1136,1005,-20
9507065820,9507065822,2,2503,2614,-20
9508977785,9508977794,9,1707,1255,-20
9509420566,9509420570,4,2912,1708,-20
9510092674,9510092678,4,1354,1243,-20
9510613497,9510613502,5,2225,1263,-20
9513291387,9513291389,2,2680,2205,-20
9513357510,9513357514,4,1932,1497,-20
9514971898,9514971895,-3,1560,2804,-20
9517975185,9517975186,1,1594,1072,-20
9520346798,9520346802,4,2178,1539,-20
9521564087,9521564091,4,1404,1072,-20
9522153998,9522154002,4,1907,1457,-20
9526160218,9526160222,4,1958,1663,-20
9532328243,9532328247,4,1863,1424,-20
9535415031,9535415034,3,2006,1609,-20
9546813804,9546813807,3,1384,1172,-20
9548934608,9548934612,4,2619,1442,-20
9550021444,9550021440,-4,2875,5362,-20
9550244637,9550244639,2,1429,1116,-20
9550924271,9550924275,4,1580,1614,-20
9553824350,9553824354,4,1786,1230,-20
9554818234,9554818237,3,2510,2180,-20
9555069681,9555069684,3,1885,1318,-20
9556577649,9556577656,7,15280,27418,-20
9559588425,9559588428,3,1345,787,-20
9560725393,9560725400,7,2430,1448,-20
9561651945,9561651946,1,2253,1336,-20
9562949631,9562949634,3,2090,2024,-20
9563156445,9563156447,2,1445,1369,-20
9563645227,9563645226,-1,526,1196,-20
9563893513,9563893519,6,2569,1711,-20
9568174430,9568174434,4,1410,1251,-20
9568996142,9568996124,-18,2006,920,-20
9569449702,9569449706,4,1633,1807,-20
9579019090,9579019094,4,1560,1404,-20
9581939665,9581939667,2,1560,1151,-20
9583036125,9583036130,5,1267,1416,-20
9585649864,9585649867,3,1564,1067,-20
9587667838,9587667843,5,2363,1278,-20
9587977346,9587977350,4,1304,1209,-20
9588575653,9588575656,3,1511,1320,-20
9588748732,9588748737,5,2321,1522,-20
9589644763,9589644763,0,1777,1234,-20
9590256486,9590256489,3,1979,1353,-20
9592063966,9592063970,4,1988,1627,-20
9593842896,9593842901,5,1765,1225,-20
9595627193,9595627198,5,1320,1256,-20
9596184410,9596184413,3,1921,1115,-20
9601236926,9601236930,4,1950,974,-20
9603838585,9603838587,2,1288,1226,-20
9604394471,9604394474,3,1191,1052,-20
9611334541,9611334544,3,2143,1111,-20
9611553268,9611553271,3,1404,940,-20
9613011714,9613011709,-5,2616,7338,-20
9613572115,9613572110,-5,1606,5957,-20
9619882213,9619882215,2,1585,1204,-20
9632338996,9632338998,2,2376,1959,-20
9632487474,9632487477,3,1595,1657,-20
9633728166,9633728171,5,1040,958,-20
9636973454,9636973459,5,1828,1068,-20
9637897590,9637897593,3,2324,1118,-20
9638470679,9638470682,3,1735,1509,-20
9639383383,9639383386,3,2042,1576,-20
9643827634,9643827637,3,1104,1052,-20
9644705327,9644705330,3,2362,1866,-20
9649238563,9649238563,0,1604,1647,-20
9649549646,9649549649,3,1249,1636,-20
9654013341,9654013346,5,2255,1221,-20
9658284146,9658284150,4,1835,1536,-20
9658694509,9658694513,4,729,892,-20
9661385770,9661385776,6,1134,1314,-20
9662467226,9662467230,4,1348,1020,-20
9662982465,9662982469,4,2083,1276,-20
9663873994,9663873998,4,1792,1341,-20
9665431471,9665431474,3,2226,1220,-20
9665679336,9665679338,2,1411,1506,-20
9667432690,9667432695,5,1806,1175,-20
9667917177,9667917170,-7,37376,9868,-20
9668007834,9668007838,4,1804,1448,-20
9670297744,9670297746,2,1697,1546,-20
9671973321,9671973324,3,2195,1979,-20
9674951267,9674951271,4,1838,1241,-20
9675248737,9675248742,5,1601,1370,-20
9675732147,9675732150,3,2275,1264,-20
9676437749,9676437751,2,1597,1432,-20
9677680260,9677680264,4,1457,1614,-20
9682358210,9682358209,-1,1156,679,-20
9684231234,9684231238,4,1485,974,-20
9685732349,9685732353,4,1719,1367,-20
9691241413,9691241414,1,1121,1469,-20
9695702194,9695702198,4,2271,1392,-20
9699098394,9699098397,3,1782,1347,-20
9704219878,9704219882,4,1984,1393,-20
9706011835,9706011841,6,1790,1789,-20
9706039197,9706039198,1,1503,1229,-20
9706339744,9706339747,3,2094,1722,-20
9709092159,9709092176,17,1508,1079,-20
9709726305,9709726307,2,1604,1268,-20
9715836403,9715836406,3,999,870,-20
9716126840,9716126842,2,1367,1273,-20
9716887272,9716887275,3,1220,1182,-20
9722940515,9722940518,3,2046,1610,-20
9725195204,9725195207,3,1345,1372,-20
9726487554,9726487560,6,2909,1593,-20
9727171777,9727171780,3,2573,1689,-20
9729989630,9729989637,7,6198,2399,-20
9730298190,9730298195,5,1885,1457,-20
9731046066,9731046070,4,1544,1198,-20
9731784614,9731784617,3,1240,1369,-20
9733203577,9733203582,5,1353,1124,-20
9736247018,9736247017,-1,1663,1242,-20
9744444580,9744444585,5,1872,1485,-20
9751975362,9751975366,4,2126,1781,-20
9754541574,9754541579,5,2281,1005,-20
9755271423,9755271427,4,1192,1373,-20
9757911305,9757911310,5,1666,1212,-20
9760493673,9760493675,2,1901,1359,-20
9761105548,9761105551,3,2840,1113,-20
9762175598,9762175602,4,1818,1129,-20
9763907041,9763907043,2,1506,1308,-20
9764814206,9764814211,5,1467,1129,-20
9766126981,9766126985,4,855,886,-20
9768703363,9768703362,-1,1412,1578,-20
9774785866,9774785871,5,1507,1309,-20
9775018041,9775018022,-19,858,467,-20
9776705773,9776705777,4,1224,1208,-20
9779105010,9779105013,3,1332,856,-20
9785294102,9785294106,4,2513,1227,-20
9786177417,9786177413,-4,1384,3377,-20
9786282285,9786282289,4,2031,1837,-20
9794438486,9794438492,6,4111,1626,-20
9795090859,9795090863,4,2407,2200,-20
9798609575,9798609579,4,1251,917,-20
9801777842,9801777847,5,1817,1125,-20
9804399774,9804399777,3,2974,2013,-20
9805618307,9805618310,3,1284,1074,-20
9808497354,9808497359,5,1993,1462,-20
9809550277,9809550283,6,2072,832,-20
9810022201,9810022202,1,1656,1236,-20
9810790827,9810790831,4,2901,1670,-20
9811053266,9811053269,3,2504,1940,-20
9815234085,9815234075,-10,1034,1154,-20
9816272825,9816272826,1,1957,1202,-20
9816485342,9816485345,3,1012,791,-20
9817331429,9817331434,5,1544,1384,-20
9818318277,9818318281,4,2302,1483,-20
9820324422,9820324426,4,1160,843,-20
9821362423,9821362426,3,1800,1355,-20
9829978806,9829978810,4,1338,1171,-20
9831416202,9831416205,3,1513,1568,-20
9833674515,9833674521,6,1949,1246,-20
9837519438,9837519442,4,1430,1086,-20
9838284643,9838284632,-11,1095,389,-20
9838701209,9838701213,4,1822,1349,-20
9841396404,9841396406,2,2082,1573,-20
9842047446,9842047449,3,1659,1362,-20
9842838986,9842838991,5,1350,1226,-20
9843545134,9843545135,1,1306,1022,-20
9851266966,9851266969,3,1214,1264,-20
9851591973,9851591977,4,2387,2001,-20
9854119700,9854119704,4,2488,1184,-20
9856112658,9856112660,2,2541,1480,-20
9856393838,9856393819,-19,1615,1087,-20
9857471406,9857471408,2,1669,815,-20
9857896567,9857896570,3,2523,1479,-20
9860673300,9860673303,3,2356,1569,-20
9860764719,9860764723,4,740,123,-20
9862217084,9862217087,3,1500,1282,-20
9863251363,9863251363,0,1362,2047,-20
9865648303,9865648306,3,1652,1367,-20
9867197261,9867197262,1,1283,1191,-20
9871725738,9871725743,5,2738,1656,-20
9875184212,9875184217,5,1144,784,-20
9876198192,9876198197,5,1744,1222,-20
9877400176,9877400170,-6,954,1379,-20
9878713405,9878713409,4,2681,1693,-20
9880345661,9880345666,5,2148,1293,-20
9881446709,9881446710,1,1623,1613,-20
9881579316,9881579319,3,2232,1107,-20
9886077182,9886077185,3,2339,1751,-20
9888745887,9888745892,5,1781,1420,-20
9888930892,9888930895,3,1597,2209,-20
9890808814,9890808816,2,1192,1043,-20
9892214352,9892214354,2,1017,1034,-20
9895737998,9895738003,5,1254,825,-20
9899064937,9899064942,5,1680,1408,-20
9900617477,9900617479,2,2771,1354,-20
9900923524,9900923527,3,3310,1639,-20
9902291385,9902291391,6,2438,1190,-20
9902411962,9902411966,4,1932,1551,-20
9906919599,9906919601,2,1296,1250,-20
9907979926,9907979929,3,1870,1126,-20
9908448307,9908448310,3,1903,1531,-20
9911569122,9911569125,3,2440,1694,-20
9911975734,9911975738,4,2120,1477,-20
9913038895,9913038897,2,1820,1251,-20
9913186251,9913186254,3,1497,1906,-20
9914023832,9914023839,7,1413,1361,-20
9917879437,9917879442,5,2224,1267,-20
9919219994,9919219997,3,1691,1293,-20
9921175142,9921175146,4,1230,1405,-20
9921627318,9921627323,5,1982,1117,-20
9925729510,9925729513,3,1156,1204,-20
9927169686,9927169687,1,1788,2133,-20
9927675035,9927675037,2,2186,1587,-20
9928063482,9928063486,4,1680,1576,-20
9928376593,9928376594,1,1719,1171,-20
9929056682,9929056684,2,1929,1347,-20
9932420811,9932420810,-1,32757,23442,-20
9933718229,9933718233,4,1651,1448,-20
9934048622,9934048625,3,1455,1241,-20
9935107630,9935107633,3,2038,1139,-20
9937820752,9937820755,3,2221,1874,-20
9939107909,9939107912,3,1890,1623,-20
9939861098,9939861102,4,1639,1044,-20
9940765480,9940765483,3,1370,1135,-20
9949891765,9949891767,2,1580,1572,-20
9953557019,9953557023,4,1954,1904,-20
9957317713,9957317716,3,2068,2037,-20
9957625563,9957625558,-5,739,2053,-20
9965169610,9965169613,3,1370,1352,-20
9966040169,9966040173,4,1428,745,-20
9967472806,9967472810,4,1504,1163,-20
9968933394,9968933396,2,1477,1855,-20
9972609250,9972609254,4,1843,2135,-20
9973407589,9973407590,1,1973,1492,-20
9974611184,9974611189,5,1819,1255,-20
9975662763,9975662766,3,1738,1505,-20
9979227834,9979227838,4,1693,1305,-20
9980957398,9980957400,2,1160,1699,-20
9982033989,9982033992,3,1440,1362,-20
9983180530,9983180535,5,1369,1079,-20
9984198734,9984198737,3,1686,1326,-20
9985019814,9985019801,-13,666,228,-20
9986199183,9986199185,2,1317,1218,-20
9988455106,9988455109,3,1753,1168,-20
9989694999,9989695001,2,2430,1559,-20
9991011640,9991011643,3,1627,1214,-20
9992070383,9992070387,4,27907,30507,-20
9992353526,9992353531,5,1994,2074,-20
9993645979,9993645981,2,1615,1481,-20
9995487646,9995487651,5,2055,1141,-20
9995615140,9995615143,3,860,1012,-20
9995948859,9995948862,3,1860,1615,-20
9999103966,9999103970,4,1963,1849,-20
10007888716,10007888719,3,2024,1512,-20
10009145423,10009145426,3,1372,931,-20
10009607776,10009607784,8,1474,1024,-20
10018631701,10018631705,4,1131,1366,-20
10023929103,10023929108,5,1999,1409,-20
10026638476,10026638479,3,2035,1175,-20
10029882345,10029882349,4,1381,1218,-20
10030172034,10030172035,1,1203,1041,-20
10032699514,10032699518,4,1877,1311,-20
10033187825,10033187830,5,2379,1781,-20
10034822514,10034822518,4,1540,1307,-20
10036705380,10036705383,3,1300,1177,-20
10038019750,10038019750,0,1081,1253,-20
10038813703,10038813706,3,1420,1233,-20
10041660709,10041660711,2,1519,1423,-20
10042068318,10042068320,2,1300,1240,-20
10043957943,10043957947,4,1816,1189,-20
10045418331,10045418335,4,1668,1236,-20
10047446285,10047446290,5,1095,836,-20
10048490051,10048490052,1,1472,1432,-20
10052814389,10052814391,2,1565,1323,-20
10053231928,10053231930,2,1597,633,-20
10055954706,10055954710,4,1802,1305,-20
10056787604,10056787607,3,1994,1370,-20
10060184395,10060184378,-17,1949,910,-20
10061672867,10061672869,2,1469,1264,-20
10063314597,10063314601,4,1056,1356,-20
10063988734,10063988738,4,1400,1085,-20
10065036947,10065036950,3,1815,1676,-20
10068643171,10068643172,1,1741,1465,-20
10068986587,10068986590,3,1656,1435,-20
10069691008,10069691013,5,2310,1524,-20
10070108725,10070108730,5,1867,1052,-20
10070805398,10070805377,-21,1048,583,-20
10070983981,10070983983,2,1741,1655,-20
10073413446,10073413449,3,1449,757,-20
10073470479,10073470497,18,1236,1131,-20
10073707983,10073707986,3,1958,1627,-20
10074133678,10074133678,0,1619,2586,-20
10076231439,10076231446,7,2305,1129,-20
10083013070,10083013074,4,2334,1064,-20
10083257594,10083257595,1,1535,1363,-20
10087050592,10087050594,2,1681,1192,-20
10087928245,10087928249,4,1656,1168,-20
10091369627,10091369621,-6,1370,7929,-20
10092881261,10092881262,1,1083,1078,-20
10094258810,10094258813,3,1229,1115,-20
10095241051,10095241057,6,1838,1230,-20
10096322094,10096322097,3,2390,1454,-20
10096729461,10096729466,5,2458,1810,-20
10102555614,10102555623,9,2943,1241,-20
10105159955,10105159958,3,1713,1189,-20
10105476340,10105476345,5,1547,1334,-20
10109258660,10109258665,5,1329,1363,-20
10111140241,10111140243,2,1749,1063,-20
10114509522,10114509528,6,1389,1061,-20
10118311573,10118311575,2,1566,1297,-20
10123144531,10123144537,6,2203,1282,-20
10123236937,10123236939,2,1280,904,-20
10125900237,10125900241,4,1605,1416,-20
10127554922,10127554925,3,1762,1585,-20
10131238247,10131238251,4,1430,757,-20
10133059776,10133059779,3,1967,1151,-20
10138474297,10138474301,4,2315,1456,-20
10139399398,10139399379,-19,1082,594,-20
10139622274,10139622275,1,2012,1637,-20
10141175010,10141175013,3,1838,1397,-20
10147043159,10147043163,4,1607,1293,-20
10149081780,10149081782,2,1840,1502,-20
10151452602,10151452605,3,2162,1396,-20
10155306685,10155306689,4,2334,1691,-20
10162896940,10162896946,6,1900,1329,-20
10166960990,10166960998,8,3669,1227,-20
10168099819,10168099836,17,909,2200,-20
10168376527,10168376531,4,1173,1247,-20
10171589293,10171589297,4,1807,1739,-20
10173020258,10173020260,2,1656,1350,-20
10178867444,10178867446,2,1951,1497,-20
10184427585,10184427590,5,1600,1574,-20
10186704322,10186704322,0,1692,1541,-20
10187995694,10187995698,4,1648,1162,-20
10188726477,10188726479,2,1627,1571,-20
10195714055,10195714058,3,2237,1493,-20
10196066581,10196066585,4,1587,1592,-20
10198482952,10198482954,2,1612,1136,-20
10199668418,10199668421,3,4315,4038,-20
10201380826,10201380829,3,1962,1453,-20
10202005631,10202005633,2,1937,1714,-20
10202966740,10202966742,2,2064,1857,-20
10206725590,10206725593,3,2040,2452,-20
10212758781,10212758786,5,1810,1117,-20
10216576341,10216576343,2,1656,991,-20
10216789538,10216789542,4,2364,1409,-20
10217324438,10217324441,3,1209,1068,-20
10221035907,10221035911,4,1010,1463,-20
10226316493,10226316498,5,2096,1270,-20
10228485790,10228485794,4,1682,1381,-20
10230800388,10230800390,2,1467,1456,-20
10233140920,10233140924,4,2498,2102,-20
10234845072,10234845074,2,1506,755,-20
10237253984,10237253986,2,1861,1590,-20
10239661209,10239661229,20,483,2040,-20
10240711390,10240711395,5,1246,1275,-20
10241001174,10241001174,0,1403,1792,-20
10245615059,10245615062,3,2558,1526,-20
10246088363,10246088369,6,1504,735,-20
10246843574,10246843579,5,1632,1683,-20
10247384799,10247384800,1,1040,1496,-20
10247785498,10247785495,-3,1530,5369,-20
10247989235,10247989239,4,2569,1500,-20
10248205582,10248205583,1,1863,1351,-20
10252410186,10252410189,3,1694,1674,-20
10253491786,10253491787,1,1347,1632,-20
10253728965,10253728969,4,2281,1754,-20
10254862029,10254862033,4,1797,938,-20
10257463754,10257463757,3,2540,1665,-20
10258073830,10258073831,1,1432,1732,-20
10261653090,10261653097,7,2063,1547,-20
10263507154,10263507158,4,1803,1161,-20
10265618101,10265618103,2,789,702,-20
10266583694,10266583701,7,1538,990,-20
10267346087,10267346090,3,2152,2096,-20
10269960184,10269960187,3,1947,1540,-20
10271618263,10271618266,3,1247,1142,-20
10272275777,10272275795,18,1858,1331,-20
10278218500,10278218502,2,1980,1196,-20
10279398414,10279398411,-3,1309,2276,-20
10284023824,10284023827,3,1287,878,-20
10286025541,10286025543,2,1273,1038,-20
10286925104,10286925107,3,2100,1596,-20
10289468529,10289468531,2,1974,1422,-20
10291677762,10291677767,5,1950,1625,-20
10293071786,10293071789,3,2036,1622,-20
10295000794,10295000799,5,1542,1517,-20
10299322152,10299322155,3,1558,1582,-20
10299870714,10299870717,3,1605,1476,-20
10304170632,10304170641,9,1937,1339,-20
10305178544,10305178547,3,1278,1158,-20
10305565268,10305565272,4,2167,1777,-20
10306489346,10306489351,5,1975,1496,-20
10308655643,10308655649,6,1672,1164,-20
10311617686,10311617686,0,1425,1282,-20
10313500209,10313500207,-2,29057,11446,-20
10316744607,10316744609,2,2071,1676,-20
10316937371,10316937375,4,1595,1287,-20
10322814310,10322814315,5,2789,1740,-20
10322983121,10322983126,5,2018,1320,-20
10325177163,10325177171,8,1677,1139,-20
10325511170,10325511170,0,1817,1923,-20
10336998706,10336998710,4,2006,1355,-20
10337278277,10337278279,2,2422,1783,-20
10337484367,10337484370,3,2228,1632,-20
10337642898,10337642903,5,1151,991,-20
10339324417,10339324418,1,1984,1706,-20
10343038264,10343038266,2,2528,2050,-20
10345996649,10345996654,5,36866,28518,-20
10348111694,10348111696,2,1678,2029,-20
10350186557,10350186560,3,1511,1363,-20
10352017609,10352017610,1,1696,1613,-20
10358796305,10358796313,8,2955,1412,-20
10361866303,10361866306,3,877,1085,-20
10363047104,10363047106,2,1342,1205,-20
10363754830,10363754828,-2,1572,2077,-20
10366287808,10366287811,3,1687,1208,-20
10366331840,10366331850,10,1544,983,-20
10366385227,10366385231,4,1351,1472,-20
10366998829,10366998834,5,1405,1708,-20
10367544295,10367544297,2,1278,1499,-20
10374981431,10374981433,2,1656,1747,-20
10377000594,10377000578,-16,1324,562,-20
10379706362,10379706366,4,1594,845,-20
10382892356,10382892359,3,1404,1645,-20
10383523273,10383523274,1,2702,1862,-20
10384350497,10384350499,2,1596,1464,-20
10386613451,10386613454,3,2764,1608,-20
10387121006,10387121009,3,2149,1782,-20
10387797070,10387797074,4,1431,996,-20
10389267717,10389267713,-4,2225,4358,-20
10394770618,10394770623,5,1431,1132,-20
10395755336,10395755334,-2,1522,2777,-20
10396464722,10396464726,4,2190,2172,-20
10400222926,10400222930,4,1425,1111,-20
10401372583,10401372600,17,784,603,-20
10405283010,10405283005,-5,817,4261,-20
10406140463,10406140466,3,2248,1656,-20
10406489251,10406489253,2,1967,1126,-20
10407974233,10407974235,2,1230,760,-20
10409568585,10409568588,3,1962,1414,-20
10411934831,10411934834,3,1943,1422,-20
10413281850,10413281856,6,3126,1362,-20
10414112180,10414112185,5,1821,1102,-20
10416391453,10416391459,6,2018,1537,-20
10417059554,10417059558,4,1603,1050,-20
10417320854,10417320858,4,1618,1245,-20
10417353342,10417353330,-12,615,567,-20
10418062707,10418062708,1,1489,1375,-20
10419430520,10419430513,-7,1060,3390,-20
10420759078,10420759082,4,2108,1033,-20
10425264380,10425264383,3,1660,1506,-20
10430908289,10430908285,-4,837,3155,-20
10434142487,10434142490,3,1638,907,-20
10435772688,10435772691,3,1656,2028,-20
10435965068,10435965071,3,2248,1144,-20
10436450458,10436450464,6,1073,1229,-20
10438111658,10438111662,4,1644,1653,-20
10440395309,10440395313,4,1784,1282,-20
10442229878,10442229878,0,1746,1173,-20
10443105429,10443105434,5,2330,1352,-20
10447126977,10447126978,1,1424,1584,-20
10447667628,10447667633,5,1676,917,-20
10448193365,10448193367,2,1480,1279,-20
10452005534,10452005538,4,2467,1638,-20
10454709050,10454709055,5,2373,2146,-20
10457510773,10457510780,7,5086,2212,-20
10463744495,10463744488,-7,914,4287,-20
10465597592,10465597594,2,2022,1106,-20
10465839463,10465839466,3,1749,1554,-20
10466923946,10466923950,4,2595,1356,-20
10470645370,10470645375,5,1900,1308,-20
10470742867,10470742871,4,1154,1253,-20
10471342742,10471342749,7,1765,1328,-20
10472208397,10472208402,5,1862,1507,-20
10476993113,10476993115,2,1321,1270,-20
10479017234,10479017232,-2,1519,2106,-20
10482238118,10482238122,4,1883,1747,-20
10483446298,10483446304,6,2108,1237,-20
10486702691,10486702693,2,1693,1540,-20
10487121684,10487121687,3,1868,1194,-20
10487427652,10487427656,4,2957,1939,-20
10492409356,10492409358,2,2148,1668,-20
10494615522,10494615525,3,1873,1989,-20
10498966342,10498966355,13,12124,36918,-20
10499791506,10499791511,5,1775,1187,-20
10500093294,10500093304,10,1624,1041,-20
10503823349,10503823355,6,1703,1452,-20
10505800922,10505800926,4,2208,2113,-20
10508375087,10508375092,5,1112,1082,-20
10508875963,10508875966,3,1414,1481,-20
10509245055,10509245058,3,1529,1363,-20
10513227365,10513227368,3,1538,1397,-20
10514141723,10514141727,4,2952,2349,-20
10518820813,10518820817,4,1724,1487,-20
10521437577,10521437581,4,1344,1202,-20
10521585409,10521585395,-14,2905,1215,-20
10522229758,10522229756,-2,1641,3686,-20
10523251926,10523251929,3,1829,1266,-20
10525077410,10525077413,3,2364,1556,-20
10525221352,10525221355,3,1660,1672,-20
10525479185,10525479192,7,43037,26068,-20
10525532994,10525532997,3,2060,1246,-20
10526182650,10526182653,3,2094,1415,-20
10526646792,10526646795,3,1465,1509,-20
10527572742,10527572741,-1,1360,2665,-20
10527621796,10527621798,2,1739,1287,-20
10528304680,10528304682,2,2011,1372,-20
10528792977,10528792980,3,2924,1861,-20
10529379102,10529379082,-20,2767,1853,-20
10531890970,10531890966,-4,2095,5545,-20
10532918932,10532918935,3,1919,1833,-20
10533358734,10533358738,4,1406,970,-20
10534752230,10534752232,2,1873,1194,-20
10536728913,10536728918,5,1943,1379,-20
10536803405,10536803388,-17,1114,369,-20
10538119800,10538119807,7,4310,1611,-20
10539407604,10539407606,2,1719,1086,-20
10540924275,10540924279,4,2008,1702,-20
10542013665,10542013669,4,1439,1181,-20
10542505767,10542505769,2,2280,1242,-20
10546396567,10546396571,4,1347,1196,-20
10549419002,10549419018,16,1979,781,-20
10550514362,10550514366,4,1102,1241,-20
10554237022,10554237026,4,1947,1542,-20
10555283398,10555283402,4,2131,1563,-20
10557429902,10557429903,1,1276,518,-20
10557622388,10557622390,2,2375,1595,-20
10558895279,10558895281,2,1891,1457,-20
10559076782,10559076785,3,1831,1303,-20
10559919666,10559919669,3,1432,1024,-20
10559975225,10559975230,5,1905,1314,-20
10560603147,10560603155,8,2604,1398,-20
10560977500,10560977503,3,2557,2122,-20
10561100189,10561100193,4,1977,1408,-20
10565006025,10565006029,4,1147,1657,-20
10565995365,10565995369,4,1708,1000,-20
10568462304,10568462308,4,1843,1284,-20
10568964361,10568964367,6,1114,1009,-20
10570967885,10570967890,5,2248,2211,-20
10571357507,10571357511,4,1765,1475,-20
10572282873,10572282873,0,1916,2014,-20
10574378230,10574378232,2,1380,1160,-20
10574963568,10574963570,2,1337,1345,-20
10575471222,10575471240,18,2173,944,-20
10578414681,10578414682,1,1937,1244,-20
10579882382,10579882384,2,1575,1449,-20
10587838920,10587838922,2,1343,1527,-20
10589722198,10589722201,3,1803,1872,-20
10590355142,10590355145,3,2605,1661,-20
10591705633,10591705637,4,1616,1931,-20
10591965724,10591965727,3,1621,1278,-20
10593344143,10593344148,5,1704,1433,-20
10593640531,10593640536,5,1922,1398,-20
10597243061,10597243067,6,1490,873,-20
10600014197,10600014201,4,1870,1496,-20
10600117870,10600117873,3,2140,1377,-20
10602053646,10602053649,3,1266,1273,-20
10604557278,10604557283,5,2229,1033,-20
10606064679,10606064683,4,1973,1339,-20
10607180653,10607180655,2,1593,1390,-20
10608715870,10608715874,4,2113,1961,-20
10611394153,10611394155,2,1958,1646,-20
10613568882,10613568885,3,1911,1446,-20
10616233288,10616233290,2,2007,1755,-20
10616824848,10616824851,3,2020,1994,-20
10618526498,10618526498,0,1496,1959,-20
10621864995,10621864998,3,1635,1624,-20
10621897571,10621897571,0,918,1383,-20
10625818428,10625818430,2,2377,1744,-20
10627100833,10627100837,4,1487,1285,-20
10638517877,10638517881,4,2093,1355,-20
10641509724,10641509727,3,1558,1033,-20
10642430029,10642430023,-6,3650,11770,-20
10642710393,10642710398,5,1082,737,-20
10643542430,10643542438,8,6261,2191,-20
10644408210,10644408213,3,1840,1379,-20
10644574858,10644574842,-16,1847,1323,-20
10650810869,10650810874,5,2120,1355,-20
10652210392,10652210395,3,2105,1631,-20
10656620814,10656620817,3,1982,1660,-20
10657301735,10657301738,3,1688,1425,-20
10664005942,10664005928,-14,811,236,-20
10664666689,10664666690,1,1557,1225,-20
10668205711,10668205714,3,1568,1249,-20
10669748499,10669748503,4,1917,1228,-20
10670784846,10670784850,4,2124,1916,-20
10670810678,10670810681,3,1660,1755,-20
10673416101,10673416105,4,1416,1277,-20
10674715081,10674715084,3,1590,1540,-20
10678441418,10678441422,4,626,828,-20
10681259217,10681259222,5,1472,1136,-20
10684262750,10684262755,5,2120,1906,-20
10684710737,10684710742,5,2290,1252,-20
10685871077,10685871081,4,2606,2496,-20
10687768042,10687768045,3,1927,1460,-20
10688868843,10688868849,6,3218,1696,-20
10689991503,10689991505,2,1547,1505,-20
10698637494,10698637499,5,1260,1330,-20
10701072780,10701072782,2,1941,1588,-20
10714766344,10714766347,3,1694,1238,-20
10714983864,10714983867,3,979,1180,-20
10715271006,10715271011,5,1991,641,-20
10716922912,10716922916,4,1916,1661,-20
10718413921,10718413929,8,3190,1544,-20
10721810635,10721810633,-2,1223,2144,-20
10723859297,10723859278,-19,1648,1621,-20
10724536064,10724536066,2,1048,863,-20
10732276353,10732276357,4,1773,1138,-20
10740246827,10740246830,3,2077,1382,-20
10741076190,10741076195,5,1719,1278,-20
10747868414,10747868417,3,2387,1995,-20
10748576166,10748576173,7,1934,1163,-20
10753903726,10753903730,4,1685,1557,-20
10754617062,10754617066,4,1476,1425,-20
10759550402,10759550407,5,2534,1489,-20
10760413539,10760413543,4,2969,1226,-20
10760474046,10760474049,3,1872,1571,-20
10762345787,10762345790,3,2569,1669,-20
10768647769,10768647773,4,2653,1828,-20
10768833870,10768833873,3,1966,2220,-20
10769174221,10769174222,1,1894,1389,-20
10772633175,10772633178,3,2027,1152,-20
10775212314,10775212317,3,2295,1815,-20
10775820492,10775820496,4,2068,1590,-20
10776591406,10776591407,1,2005,1275,-20
10776679284,10776679285,1,1380,1290,-20
10777809949,10777809955,6,2274,1585,-20
10780757329,10780757335,6,1689,1232,-20
10781703895,10781703900,5,1782,1804,-20
10782922562,10782922566,4,1469,1797,-20
10783413575,10783413578,3,1467,900,-20
10784653590,10784653596,6,2325,1590,-20
10784917978,10784917978,0,1336,1509,-20
10786238018,10786238019,1,1744,1326,-20
10787390889,10787390894,5,1988,1440,-20
10789165307,10789165313,6,2227,1435,-20
10799550995,10799550998,3,1093,1022,-20
10801627050,10801627053,3,1928,1285,-20
10803241778,10803241782,4,1889,1204,-20
10805792803,10805792806,3,1831,1685,-20
10808410310,10808410315,5,1745,1417,-20
10812095062,10812095066,4,1729,1583,-20
10813041961,10813041965,4,2189,1326,-20
10813112158,10813112163,5,423,954,-20
10813707697,10813707699,2,1923,1658,-20
10816249399,10816249402,3,1909,1130,-20
10818060736,10818060740,4,1988,1268,-20
10820497128,10820497130,2,1716,2313,-20
10821912561,10821912565,4,2115,1258,-20
10824639699,10824639702,3,1870,2162,-20
10826313370,10826313372,2,1361,1313,-20
10828854834,10828854841,7,1603,1031,-20
10834100225,10834100229,4,1489,1238,-20
10838013254,10838013258,4,2275,930,-20
10841079137,10841079139,2,1366,1167,-20
10841514919,10841514922,3,1758,1144,-20
10841861706,10841861711,5,1769,1405,-20
10843154061,10843154066,5,2269,881,-20
10843216089,10843216107,18,2403,1001,-20
10843791226,10843791229,3,2226,1308,-20
10845617313,10845617316,3,1731,1295,-20
10846290933,10846290934,1,1702,1955,-20
10849922363,10849922366,3,1573,1368,-20
10855473738,10855473743,5,1920,1406,-20
10855872223,10855872226,3,1812,1691,-20
10857051682,10857051685,3,1991,1514,-20
10860500034,10860500037,3,1241,1307,-20
10863438809,10863438810,1,1689,1574,-20
10864375897,10864375901,4,1816,1067,-20
10865386701,10865386705,4,1968,1371,-20
10870281149,10870281153,4,2015,1083,-20
10871019122,10871019129,7,3845,1246,-20
10874908209,10874908210,1,1193,1040,-20
10875057316,10875057321,5,2014,1287,-20
10875501511,10875501510,-1,1147,1427,-20
10877100306,10877100312,6,4876,2768,-20
10881202864,10881202867,3,2413,1315,-20
10882060428,10882060430,2,1542,898,-20
10884777647,10884777649,2,1371,1838,-20
10887839898,10887839903,5,2028,1221,-20
10893651785,10893651786,1,2033,1637,-20
10895524042,10895524042,0,2027,1145,-20
10895670586,10895670590,4,1795,1298,-20
10897318114,10897318115,1,2228,1769,-20
10898393515,10898393518,3,1766,1582,-20
10901395198,10901395201,3,1176,1183,-20
10904806604,10904806604,0,1377,2502,-20
10906058630,10906058631,1,1986,1357,-20
10910514769,10910514772,3,1768,1114,-20
10910842075,10910842079,4,1063,885,-20
10912152827,10912152831,4,2009,1401,-20
10913682039,10913682043,4,1810,1078,-20
10919048233,10919048236,3,1602,1043,-20
10923252614,10923252614,0,1540,982,-20
10923385060,10923385066,6,1901,1044,-20
10928101768,10928101771,3,2081,1163,-20
10928372908,10928372912,4,1677,1561,-20
10928487101,10928487083,-18,963,549,-20
10936012114,10936012118,4,2353,1600,-20
10943559085,10943559089,4,1594,903,-20
10944475697,10944475699,2,1802,946,-20
10946689688,10946689689,1,1874,1462,-20
10952960274,10952960279,5,1785,1086,-20
10956919183,10956919181,-2,8250,14770,-20
10957216158,10957216162,4,2152,1363,-20
10962522699,10962522702,3,1528,1259,-20
10962955885,10962955887,2,1412,1124,-20
10964847328,10964847332,4,1896,1501,-20
10967877985,10967877986,1,1163,1525,-20
10970836287,10970836290,3,1567,1048,-20
10976515125,10976515127,2,2046,1251,-20
10977162572,10977162574,2,1628,1046,-20
10981446918,10981446923,5,2037,1561,-20
10982275725,10982275730,5,1868,1284,-20
10985823033,10985823034,1,1832,1863,-20
10986755555,10986755561,6,1823,999,-20
10987024387,10987024390,3,1305,1403,-20
10991693113,10991693116,3,1870,1782,-20
10993258927,10993258931,4,1833,1176,-20
10993526525,10993526527,2,1726,1713,-20
10997947251,10997947255,4,1391,1417,-20
10998340033,10998340034,1,778,770,-20
11005444353,11005444356,3,1840,1228,-20
11006136174,11006136179,5,3145,2160,-20
11008172344,11008172347,3,1227,1229,-20
11009876828,11009876832,4,2206,1572,-20
11010031904,11010031907,3,1461,1421,-20
11011069353,11011069354,1,1466,1809,-20
11014113194,11014113192,-2,1189,1789,-20
11015880053,11015880058,5,1466,1033,-20
11017251066,11017251071,5,1770,1271,-20
11019612872,11019612876,4,2211,1298,-20
11022192646,11022192649,3,1529,1230,-20
11025346085,11025346087,2,2202,1634,-20
11026487745,11026487748,3,2190,1784,-20
11028389415,11028389418,3,2072,1465,-20
11031187005,11031187011,6,4010,1528,-20
11031947818,11031947822,4,1708,1656,-20
11038066700,11038066702,2,1533,1653,-20
11040114150,11040114154,4,1455,1377,-20
11046494914,11046494915,1,1753,1986,-20
11047285343,11047285347,4,1795,939,-20
11047969098,11047969081,-17,2662,1019,-20
11051052575,11051052579,4,2150,1630,-20
11054028418,11054028414,-4,2011,6723,-20
11054636233,11054636235,2,1722,1191,-20
11055270355,11055270354,-1,1405,1280,-20
11062003266,11062003271,5,2141,1198,-20
11063289360,11063289363,3,1458,946,-20
11064160810,11064160814,4,1210,762,-20
11067981583,11067981585,2,1450,1130,-20
11068063935,11068063939,4,1268,1455,-20
11068477515,11068477519,4,2522,1444,-20
11069133017,11069133025,8,1379,942,-20
11070455363,11070455371,8,24409,58041,-20
11071082051,11071082055,4,2109,1176,-20
11071115133,11071115135,2,2159,1279,-20
11071794942,11071794944,2,2199,1647,-20
11072777050,11072777051,1,1491,2008,-20
11073706582,11073706584,2,1700,1641,-20
11075400843,11075400843,0,1372,1415,-20
11078664046,11078664054,8,6513,1016,-20
11079379038,11079379040,2,2212,1721,-20
11081276764,11081276767,3,1687,1282,-20
11083761406,11083761410,4,1964,1448,-20
11094390279,11094390283,4,1788,1804,-20
11101929063,11101929066,3,1785,1151,-20
11105788250,11105788252,2,1779,1492,-20
11109018582,11109018583,1,1737,1394,-20
11110257423,11110257426,3,4731,2638,-20
11113001466,11113001470,4,1735,1485,-20
11114929345,11114929351,6,1338,1330,-20
11118125446,11118125449,3,3097,1601,-20
11122708249,11122708255,6,2066,824,-20
11123872375,11123872381,6,1837,1290,-20
11124699115,11124699119,4,1864,1466,-20
11126403663,11126403666,3,1226,1435,-20
11128036450,11128036455,5,1545,1065,-20
11128775067,11128775069,2,1674,1602,-20
11129591310,11129591314,4,1087,1372,-20
11133719429,11133719433,4,1851,1734,-20
11139218670,11139218671,1,2378,1615,-20
11140560415,11140560418,3,1461,1409,-20
11141390197,11141390198,1,2353,1454,-20
11142108362,11142108361,-1,1111,2260,-20
11143075179,11143075188,9,10843,41400,-20
11143932846,11143932832,-14,1235,707,-20
11144584502,11144584506,4,2311,1611,-20
11145634553,11145634555,2,2054,1554,-20
11146551968,11146551971,3,2035,1652,-20
11149264644,11149264642,-2,1421,1404,-20
11149468967,11149468971,4,1399,1057,-20
11151650344,11151650349,5,1746,1022,-20
11152864813,11152864816,3,1044,959,-20
11155691927,11155691930,3,1780,1359,-20
11156268165,11156268171,6,1145,968,-20
11157666631,11157666634,3,1382,1323,-20
11159782881,11159782886,5,1849,1291,-20
11161613716,11161613721,5,2006,871,-20
11164341894,11164341899,5,2417,1577,-20
11165087378,11165087379,1,1489,2113,-20
11166332945,11166332949,4,2204,1412,-20
11167757913,11167757918,5,1334,1529,-20
11173532785,11173532787,2,1642,1425,-20
11181032105,11181032109,4,1185,1123,-20
11181230751,11181230754,3,2016,1476,-20
11181514030,11181514027,-3,1221,263,-20
11182137106,11182137109,3,1413,1567,-20
11182629666,11182629669,3,1748,1625,-20
11182973334,11182973339,5,1292,1111,-20
11186947843,11186947846,3,1305,1342,-20
11188598150,11188598144,-6,952,4359,-20
11190198206,11190198209,3,2530,1612,-20
11191165768,11191165771,3,2009,1759,-20
11192448308,11192448314,6,1575,1222,-20
11195767317,11195767320,3,2866,2243,-20
11196171223,11196171218,-5,1307,3931,-20
11198885950,11198885951,1,2141,1544,-20
11200377863,11200377867,4,2266,1372,-20
11208414544,11208414546,2,1606,1367,-20
11212990314,11212990318,4,961,1167,-20
11218345211,11218345213,2,1618,1236,-20
11219408801,11219408805,4,1897,1617,-20
11226656202,11226656206,4,11247,21058,-20
11227035306,11227035311,5,1775,1294,-20
11227577174,11227577174,0,1766,1761,-20
11227737855,11227737858,3,1302,1274,-20
11232702118,11232702121,3,5528,6894,-20
11233733927,11233733929,2,1341,1735,-20
11234896356,11234896357,1,1745,1540,-20
11236492046,11236492050,4,1080,604,-20
11242232315,11242232316,1,18548,25936,-20
11242389751,11242389754,3,1544,1575,-20
11242952756,11242952749,-7,1428,5305,-20
11243016578,11243016586,8,8244,29232,-20
11246510230,11246510235,5,1885,1060,-20
11248155243,11248155246,3,1507,939,-20
11249553033,11249553036,3,2390,1597,-20
11261545192,11261545197,5,2292,1759,-20
11261834435,11261834418,-17,951,464,-20
11262917299,11262917302,3,1367,982,-20
11268767858,11268767860,2,1081,932,-20
11269355882,11269355884,2,1991,1526,-20
11269872717,11269872719,2,2357,1194,-20
11270334347,11270334350,3,1881,970,-20
11271274062,11271274062,0,1921,1453,-20
11272625470,11272625462,-8,1078,12938,-20
11273122637,11273122642,5,2174,1329,-20
11274165297,11274165300,3,1655,1164,-20
11275571902,11275571906,4,2248,1328,-20
11277896605,11277896606,1,2117,1807,-20
11287816467,11287816470,3,1093,1140,-20
11288441686,11288441691,5,1720,1281,-20
11289635219,11289635222,3,1353,1017,-20
11290701346,11290701349,3,1202,1160,-20
11295523014,11295523018,4,1567,1332,-20
11296000509,11296000514,5,2152,1543,-20
11298493465,11298493469,4,2135,1324,-20
11301188973,11301188979,6,2066,1624,-20
11303439400,11303439403,3,2378,1421,-20
11310267254,11310267257,3,2433,1631,-20
11310584363,11310584368,5,1755,1110,-20
11313855353,11313855355,2,2323,1601,-20
11318199407,11318199412,5,1295,1263,-20
11318761586,11318761581,-5,41896,18590,-20
11319175162,11319175165,3,1468,1375,-20
11326038949,11326038953,4,1102,867,-20
11329074287,11329074290,3,2346,1724,-20
11331430798,11331430803,5,1632,1642,-20
11333798276,11333798296,20,2426,1332,-20
11334513335,11334513338,3,2137,1685,-20
11335237341,11335237342,1,1627,1069,-20
11336953967,11336953968,1,1714,1648,-20
11338895566,11338895569,3,1955,1363,-20
11340785298,11340785302,4,1406,1129,-20
11345604610,11345604610,0,1938,1777,-20
11346537042,11346537045,3,2299,1630,-20
11346731558,11346731559,1,1617,1538,-20
11351801639,11351801642,3,1666,1167,-20
11359868116,11359868118,2,1751,1568,-20
11365354119,11365354122,3,2057,1583,-20
11366381182,11366381186,4,1723,1498,-20
11367061683,11367061685,2,1253,1139,-20
11368726629,11368726633,4,1891,1794,-20
11370160894,11370160895,1,1378,1126,-20
11370708306,11370708310,4,1248,1385,-20
11372199614,11372199611,-3,1462,2246,-20
11372810208,11372810210,2,1254,1515,-20
11374329832,11374329829,-3,1608,3414,-20
11376982806,11376982805,-1,1182,1508,-20
11378093613,11378093617,4,1670,1307,-20
11382983319,11382983323,4,2532,1886,-20
11383234894,11383234895,1,1200,1551,-20
11386936425,11386936429,4,1828,1744,-20
11387679698,11387679702,4,1975,1414,-20
11389459285,11389459289,4,1475,1133,-20
11390976790,11390976794,4,3176,1105,-20
11392679755,11392679759,4,1055,744,-20
11394558181,11394558186,5,2176,1589,-20
11396683356,11396683358,2,1758,1362,-20
11397798442,11397798447,5,1655,1486,-20
11398104695,11398104696,1,1294,1819,-20
11401499817,11401499826,9,3970,1454,-20
11405686899,11405686904,5,2758,1591,-20
11407479005,11407479009,4,1323,1505,-20
11409717742,11409717745,3,1559,1120,-20
11411633314,11411633319,5,1821,1066,-20
11415256078,11415256083,5,1673,1317,-20
11415328270,11415328274,4,1594,1721,-20
11416420563,11416420567,4,2239,920,-20
11417841399,11417841404,5,2343,1599,-20
11418239662,11418239681,19,2769,1574,-20
11424448625,11424448626,1,1267,1026,-20
11430280227,11430280229,2,1720,1149,-20
11440826860,11440826882,22,2742,2094,-20
11446903574,11446903578,4,1996,1062,-20
11449983602,11449983606,4,1932,1324,-20
11450541649,11450541653,4,1186,1274,-20
11455866331,11455866334,3,1563,1406,-20
11455961650,11455961633,-17,866,1233,-20
11456228694,11456228697,3,1036,683,-20
11466861945,11466861950,5,1896,1301,-20
11471089873,11471089874,1,1415,1645,-20
11471278606,11471278606,0,1609,1303,-20
11479939317,11479939312,-5,22063,14747,-20
11480117340,11480117344,4,2017,1348,-20
11484990466,11484990469,3,2342,1161,-20
11488139785,11488139789,4,1256,1169,-20
11488903815,11488903817,2,1143,994,-20
11493041553,11493041557,4,1919,1985,-20
11497123521,11497123524,3,1664,1312,-20
11498066531,11498066534,3,1895,1304,-20
11499489874,11499489857,-17,1488,860,-20
11499853118,11499853122,4,2171,1225,-20
11501771322,11501771330,8,3042,1140,-20
11505170779,11505170783,4,2048,1743,-20
11511976226,11511976230,4,1046,1127,-20
11515439666,11515439670,4,1491,1057,-20
11517495001,11517495003,2,1666,2117,-20
11517810282,11517810283,1,983,1683,-20
11518056418,11518056424,6,3175,1469,-20
11518711013,11518711017,4,2197,1600,-20
11519521266,11519521245,-21,1347,199,-20
11519904142,11519904146,4,3230,2380,-20
11520422017,11520422009,-8,1631,14310,-20
11521660449,11521660454,5,1696,1326,-20
11524002528,11524002535,7,2600,1373,-20
11524368619,11524368603,-16,1996,742,-20
11530549886,11530549886,0,1815,1903,-20
11531612624,11531612626,2,2118,1260,-20
11534269027,11534269030,3,1640,877,-20
11536873406,11536873410,4,1287,790,-20
11539551327,11539551329,2,1936,1350,-20
11540587878,11540587879,1,1763,1410,-20
11541980074,11541980076,2,1508,1427,-20
11542357312,11542357316,4,2198,2006,-20
11543438433,11543438419,-14,2421,1805,-20
11544581385,11544581371,-14,1591,767,-20
11548447098,11548447101,3,1745,1525,-20
11548976676,11548976658,-18,2192,1422,-20
11553623878,11553623880,2,1956,1984,-20
11558540274,11558540273,-1,1365,1637,-20
11559199861,11559199866,5,3004,1960,-20
11559259458,11559259459,1,1335,1308,-20
11561510649,11561510653,4,2244,1654,-20
11566548405,11566548408,3,2281,1582,-20
11566733282,11566733283,1,1779,1302,-20
11568989241,11568989243,2,1793,1478,-20
11569504113,11569504114,1,1439,1589,-20
11569582006,11569582006,0,1192,1247,-20
11571533245,11571533246,1,2240,1957,-20
11574093570,11574093574,4,1649,1930,-20
11576078780,11576078782,2,1494,920,-20
11578023059,11578023062,3,1449,1058,-20
11578634669,11578634648,-21,2186,734,-20
11578893124,11578893130,6,1854,1273,-20
11580268080,11580268087,7,1632,993,-20
11582039753,11582039758,5,2166,1085,-20
11582541650,11582541654,4,1627,945,-20
11583087812,11583087816,4,1752,1215,-20
11586295750,11586295730,-20,1784,1306,-20
11586949771,11586949774,3,1600,1313,-20
11590401365,11590401367,2,1530,1197,-20
11594418207,11594418209,2,1694,1664,-20
11594808569,11594808571,2,1858,1074,-20
11597205788,11597205793,5,1571,1048,-20
11597404822,11597404825,3,2037,1090,-20
11599834604,11599834607,3,1490,1303,-20
11599980130,11599980114,-16,1167,815,-20
11608807430,11608807433,3,1573,1285,-20
11610164234,11610164238,4,1446,997,-20
11613762133,11613762149,16,701,1941,-20
11613964949,11613964953,4,2016,1622,-20
11618347422,11618347427,5,1860,1311,-20
11622634222,11622634227,5,4234,2767,-20
11628508049,11628508058,9,10436,37800,-20
11630045140,11630045134,-6,1182,3145,-20
11630931729,11630931733,4,2385,1209,-20
11630973774,11630973753,-21,1120,642,-20
11633552401,11633552406,5,1932,1720,-20
11634303702,11634303706,4,2445,1515,-20
11635218321,11635218324,3,1687,1041,-20
11635268204,11635268218,14,1798,1418,-20
11637712617,11637712619,2,1893,1178,-20
11638272438,11638272419,-19,1142,1035,-20
11640954255,11640954263,8,5670,764,-20
11642204184,11642204181,-3,1689,4081,-20
11643992806,11643992807,1,1478,1596,-20
11646030638,11646030639,1,1304,1353,-20
11651759013,11651759017,4,1408,1899,-20
11652450477,11652450479,2,1431,1308,-20
11655756002,11655756002,0,1396,1862,-20
11658730225,11658730206,-19,1100,810,-20
11661139584,11661139588,4,1723,1654,-20
11661202934,11661202938,4,2918,1619,-20
11662054266,11662054266,0,1486,1284,-20
11662624115,11662624119,4,1556,949,-20
11663963016,11663963019,3,1685,1037,-20
11664866990,11664866990,0,10523,14355,-20
11667796674,11667796678,4,1256,1148,-20
11669517575,11669517580,5,1428,1091,-20
11671467634,11671467637,3,1425,1203,-20
11675880386,11675880390,4,2118,1111,-20
11676478502,11676478503,1,1481,1812,-20
11677301689,11677301693,4,1173,1074,-20
11678427751,11678427754,3,1622,1469,-20
11678677118,11678677117,-1,535,989,-20
11693407435,11693407439,4,2222,1262,-20
11695690133,11695690132,-1,1660,911,-20
11696345133,11696345131,-2,1475,2382,-20
11696568529,11696568530,1,1223,1309,-20
11697843494,11697843497,3,1962,1281,-20
11699382345,11699382349,4,2020,2066,-20
11700398938,11700398936,-2,1134,1855,-20
11700858289,11700858292,3,992,1182,-20
11701165002,11701164986,-16,992,613,-20
11703080547,11703080550,3,2359,1970,-20
11707574578,11707574581,3,1796,1594,-20
11711498615,11711498618,3,1354,1376,-20
11712910706,11712910709,3,1756,1110,-20
11714454427,11714454430,3,1170,1188,-20
11717807001,11717807001,0,1091,794,-20
11718225513,11718225516,3,1354,1396,-20
11719161004,11719161006,2,1351,1374,-20
11720303665,11720303669,4,1903,1502,-20
11722863623,11722863625,2,21996,20037,-20
11724646458,11724646463,5,1514,1370,-20
11725284455,11725284458,3,1680,1261,-20
11725590001,11725590003,2,1733,1215,-20
11725672922,11725672926,4,1528,1293,-20
11726441616,11726441619,3,1415,1582,-20
11727654750,11727654745,-5,1804,7375,-20
11728599263,11728599267,4,1985,1306,-20
11728647598,11728647578,-20,2451,1801,-20
11731363241,11731363244,3,2637,1956,-20
11731439851,11731439854,3,1963,1674,-20
11731577454,11731577453,-1,997,2213,-20
11732172154,11732172159,5,1433,1515,-20
11733432082,11733432089,7,6372,2558,-20
11734081578,11734081583,5,1802,1036,-20
11734497084,11734497089,5,1619,1507,-20
11734894278,11734894282,4,1572,1633,-20
11737303935,11737303939,4,1837,1449,-20
11737815188,11737815210,22,1607,1470,-20
11738539314,11738539315,1,1426,904,-20
11740248966,11740248970,4,2383,1804,-20
11740844352,11740844354,2,1606,1331,-20
11744611813,11744611818,5,1628,1339,-20
11745411589,11745411594,5,2179,1340,-20
11745729278,11745729280,2,1626,1736,-20
11746300560,11746300567,7,21080,37456,-20
11750571851,11750571854,3,1988,1889,-20
11751638423,11751638426,3,1243,1193,-20
11757159619,11757159622,3,1484,1189,-20
11758236294,11758236299,5,1699,1456,-20
11758729839,11758729834,-5,835,4422,-20
11760208035,11760208038,3,1559,1335,-20
11761836574,11761836552,-22,1506,1152,-20
11762295682,11762295667,-15,2026,1466,-20
11762736838,11762736843,5,2101,986,-20
11763067693,11763067698,5,1422,1147,-20
11764488796,11764488799,3,1746,1403,-20
11764984069,11764984069,0,1530,1756,-20
11766124709,11766124713,4,1345,1467,-20
11770004988,11770004991,3,1285,967,-20
11773085463,11773085467,4,2142,1670,-20
11776695026,11776695022,-4,1255,1762,-20
11777458260,11777458262,2,1827,1614,-20
11780570490,11780570491,1,1358,1457,-20
11781028421,11781028423,2,1800,1072,-20
11782643145,11782643148,3,1582,1549,-20
11786243017,11786243022,5,1531,1000,-20
11787851744,11787851746,2,976,1462,-20
11788345301,11788345305,4,1913,1249,-20
11789346720,11789346723,3,2361,1907,-20
11790464433,11790464437,4,1335,1087,-20
11792023170,11792023165,-5,1343,4912,-20
11796807098,11796807101,3,1578,1430,-20
11798004017,11798004022,5,2414,1434,-20
11798123391,11798123395,4,2549,1097,-20
11798512307,11798512313,6,1565,1236,-20
11798716126,11798716129,3,1421,725,-20
11799815859,11799815854,-5,1167,5590,-20
11801447134,11801447136,2,2366,1707,-20
11802149830,11802149836,6,12990,26363,-20
11802614623,11802614626,3,2147,1425,-20
11802801003,11802800998,-5,781,3154,-20
11805921299,11805921302,3,2327,1609,-20
11807738295,11807738277,-18,808,811,-20
11811015474,11811015471,-3,1708,2290,-20
11812136113,11812136117,4,2904,1139,-20
11812534695,11812534697,2,1189,887,-20
11812747194,11812747197,3,1486,1424,-20
11817431088,11817431083,-5,2020,5034,-20
11822095664,11822095667,3,1967,2153,-20
11822233049,11822233053,4,1709,1499,-20
11829271952,11829271957,5,1705,1364,-20
11829648334,11829648336,2,2358,1516,-20
11831741634,11831741639,5,1437,1138,-20
11834291409,11834291413,4,1266,1224,-20
11834397754,11834397746,-8,834,869,-20
11836843201,11836843202,1,1055,1358,-20
11841114565,11841114567,2,1155,1062,-20
11842900779,11842900783,4,1333,1571,-20
11848643726,11848643727,1,816,1397,-20
11849877745,11849877748,3,2181,1081,-20
11850348574,11850348574,0,1143,1355,-20
11851423790,11851423793,3,1757,1599,-20
11854637464,11854637467,3,1385,1306,-20
11857119839,11857119842,3,1325,1419,-20
11863622945,11863622946,1,1522,2148,-20
11866647387,11866647391,4,2193,1284,-20
11867028818,11867028821,3,1388,1411,-20
11867120546,11867120546,0,2245,1833,-20
11867278527,11867278531,4,2063,1079,-20
11868774942,11868774944,2,1647,1149,-20
11868959338,11868959341,3,1693,1312,-20
11870604282,11870604283,1,2402,1377,-20
11874836211,11874836210,-1,1016,1849,-20
11877812790,11877812793,3,1285,984,-20
11880908011,11880908011,0,1782,1645,-20
11882137665,11882137666,1,1163,1288,-20
11883563046,11883563050,4,2676,1467,-20
11883835598,11883835601,3,1466,1523,-20
11885950455,11885950458,3,1257,1182,-20
11886457358,11886457355,-3,1539,593,-20
11892495630,11892495635,5,3142,1921,-20
11893220416,11893220423,7,1695,952,-20
11893495931,11893495915,-16,661,208,-20
11894733612,11894733614,2,2032,1277,-20
11894968486,11894968499,13,1771,1115,-20
11895215917,11895215913,-4,620,241,-20
11901855250,11901855255,5,2311,1262,-20
11904803943,11904803946,3,2018,1648,-20
11905176050,11905176046,-4,743,2879,-20
11911856577,11911856582,5,1327,1544,-20
11914068327,11914068329,2,1880,1242,-20
11914776253,11914776257,4,2105,962,-20
11915342409,11915342412,3,1698,1386,-20
11917122738,11917122738,0,2065,1221,-20
11923273864,11923273867,3,1507,1254,-20
11925136370,11925136377,7,1406,939,-20
11926382851,11926382848,-3,767,1773,-20
11931075076,11931075079,3,2049,1696,-20
11934849988,11934849991,3,2487,1311,-20
11937783137,11937783140,3,1995,1046,-20
11938435941,11938435945,4,1458,1182,-20
11938836241,11938836243,2,2119,1319,-20
11939351762,11939351767,5,1485,1416,-20
11941628719,11941628725,6,1605,1521,-20
11942304167,11942304170,3,1403,1838,-20
11943516422,11943516418,-4,19568,16534,-20
11944591175,11944591179,4,1269,1049,-20
11946974041,11946974046,5,1769,1015,-20
11951717976,11951717981,5,2349,1594,-20
11952427702,11952427706,4,1202,878,-20
11953314179,11953314179,0,1180,848,-20
11956613421,11956613422,1,1184,1213,-20
11956858254,11956858260,6,2524,1447,-20
11956983990,11956983995,5,1306,1236,-20
11959900589,11959900593,4,1899,1554,-20
11961337678,11961337673,-5,2035,6819,-20
11961638662,11961638680,18,1763,1411,-20
11965340342,11965340344,2,1813,1177,-20
11965493745,11965493743,-2,21632,13890,-20
11966001027,11966001031,4,2292,2034,-20
11966841219,11966841223,4,1547,1607,-20
11967407294,11967407291,-3,1287,1964,-20
11971003439,11971003438,-1,1201,1042,-20
11974383805,11974383806,1,1803,1397,-20
11974594934,11974594937,3,2006,1358,-20
11975864969,11975864975,6,2389,1216,-20
11977629194,11977629199,5,2265,1856,-20
11977799490,11977799492,2,2064,1736,-20
11978500021,11978500025,4,2356,1378,-20
11978981061,11978981067,6,2230,1071,-20
11979099351,11979099355,4,1335,1282,-20
11980822061,11980822065,4,1362,1429,-20
11981586021,11981586022,1,1597,1304,-20
11983158163,11983158166,3,1876,1582,-20
11985143534,11985143537,3,2044,1848,-20
11987276482,11987276486,4,2243,1764,-20
11989787985,11989787986,1,1479,1172,-20
11992903761,11992903751,-10,165,1255,-20
11996887426,11996887408,-18,51420,59769,-20
12000891938,12000891942,4,1372,1149,-20
12003028926,12003028928,2,2673,1891,-20
12007167072,12007167076,4,1907,1432,-20
12008135730,12008135730,0,1677,1168,-20
12011357346,12011357350,4,1802,1296,-20
12019253095,12019253100,5,1832,1844,-20
12023696114,12023696118,4,1730,1505,-20
12028673651,12028673654,3,979,1188,-20
12033017655,12033017658,3,1024,1377,-20
12035606478,12035606483,5,867,633,-20
12040260429,12040260422,-7,777,2963,-20
12042522550,12042522554,4,1767,1287,-20
12043162406,12043162410,4,1746,1533,-20
12047372324,12047372327,3,1930,1398,-20
12051203527,12051203529,2,1712,957,-20
12052599903,12052599907,4,2367,1622,-20
12065226509,12065226511,2,1675,1615,-20
12065336870,12065336875,5,1811,1106,-20
12067687534,12067687535,1,1397,1227,-20
12082303847,12082303850,3,1280,1075,-20
12082508498,12082508504,6,2397,1132,-20
12084856758,12084856753,-5,1497,4730,-20
12085205246,12085205250,4,1365,1715,-20
12087545620,12087545623,3,2054,1565,-20
12088454202,12088454215,13,391,1082,-20
12089532898,12089532899,1,1814,1340,-20
12089558633,12089558638,5,1769,1047,-20
12096632314,12096632318,4,2017,944,-20
12099846930,12099846934,4,1942,1203,-20
12100263446,12100263452,6,2811,1257,-20
12103525471,12103525474,3,1838,1475,-20
12109353435,12109353438,3,2273,1096,-20
12109406705,12109406690,-15,653,329,-20
12111138783,12111138785,2,1945,1580,-20
12112164365,12112164367,2,1392,1333,-20
12115992379,12115992383,4,1793,1487,-20
12116900485,12116900489,4,1480,1235,-20
12117231483,12117231485,2,2070,1722,-20
12121073829,12121073833,4,1759,1283,-20
12125702480,12125702463,-17,1863,1372,-20
12127378058,12127378062,4,2013,1928,-20
12129074375,12129074378,3,2169,1202,-20
12129609705,12129609712,7,1732,855,-20
12129684231,12129684235,4,2363,1076,-20
12129731170,12129731170,0,1639,1382,-20
12130952997,12130953001,4,1676,1579,-20
12135881885,12135881891,6,2012,830,-20
12137573638,12137573642,4,2221,1414,-20
12137793429,12137793410,-19,1216,1111,-20
12138270050,12138270053,3,1584,1125,-20
12141317567,12141317569,2,1738,1922,-20
12144764537,12144764539,2,1525,1328,-20
12145955102,12145955104,2,2465,2014,-20
12147661609,12147661611,2,1920,1215,-20
12147688648,12147688651,3,2444,1615,-20
12149016738,12149016742,4,1673,548,-20
12149696963,12149696963,0,1129,1394,-20
12150827939,12150827943,4,2089,1422,-20
12151638447,12151638451,4,2177,1437,-20
12153070694,12153070699,5,2071,1823,-20
12153288130,12153288132,2,1904,1746,-20
12156615270,12156615275,5,2500,1469,-20
12157048643,12157048646,3,1341,988,-20
12160003219,12160003223,4,1451,1435,-20
12161682919,12161682921,2,2316,1243,-20
12164322482,12164322485,3,1584,1471,-20
12168517386,12168517390,4,2191,1506,-20
12170464680,12170464687,7,3385,2097,-20
12173302889,12173302887,-2,1483,1403,-20
12176578647,12176578653,6,2640,1509,-20
12176968186,12176968186,0,1008,763,-20
12177382731,12177382726,-5,2288,5390,-20
12179957162,12179957167,5,2830,1052,-20
12182032749,12182032750,1,1882,1626,-20
12182289951,12182289953,2,638,1326,-20
12184587866,12184587862,-4,979,3220,-20
12186452211,12186452216,5,1670,1034,-20
12186493334,12186493335,1,2007,2429,-20
12187746810,12187746814,4,2466,1633,-20
12189098570,12189098574,4,3018,1766,-20
12189546131,12189546135,4,1936,1178,-20
12190159369,12190159373,4,2074,1302,-20
12190867481,12190867483,2,1876,1021,-20
12194772925,12194772927,2,1149,1908,-20
12195102901,12195102905,4,2620,1986,-20
12196290246,12196290246,0,1789,1792,-20
12196564525,12196564528,3,3190,2211,-20
12199328957,12199328962,5,2131,1068,-20
12201532914,12201532918,4,1898,1139,-20
12202241435,12202241419,-16,1483,1144,-20
12203789737,12203789743,6,1300,714,-20
12206177735,12206177735,0,1391,1622,-20
12208143405,12208143408,3,2008,1761,-20
12209562079,12209562083,4,1970,1444,-20
12213543058,12213543058,0,1519,1608,-20
12213875846,12213875853,7,1749,1198,-20
12216997902,12216997907,5,1236,1371,-20
12218852922,12218852926,4,1706,1330,-20
12219885294,12219885299,5,1530,1233,-20
12221505138,12221505143,5,2474,1296,-20
12225659386,12225659390,4,2825,1665,-20
12229922013,12229922014,1,2000,1157,-20
12230913950,12230913953,3,1525,1063,-20
12231522273,12231522277,4,2369,1586,-20
12233190933,12233190939,6,2781,1665,-20
12233244894,12233244897,3,1878,1323,-20
12234294735,12234294740,5,2400,1283,-20
12234442942,12234442945,3,2173,1648,-20
12234619861,12234619866,5,1548,1726,-20
12240176478,12240176482,4,2421,1756,-20
12240936135,12240936137,2,1805,1688,-20
12241442362,12241442368,6,2163,1633,-20
12242073356,12242073359,3,1166,1483,-20
12242332450,12242332452,2,1224,1183,-20
12244443244,12244443243,-1,1672,2562,-20
12246040579,12246040579,0,1102,880,-20
12246761661,12246761663,2,1996,1188,-20
12247748578,12247748563,-15,1301,685,-20
12251180021,12251180027,6,1111,538,-20
12261063311,12261063314,3,1316,1505,-20
12262485649,12262485636,-13,1406,1301,-20
12262932365,12262932371,6,1498,1409,-20
12265086316,12265086323,7,6331,1792,-20
12266746620,12266746623,3,2051,1140,-20
12268638765,12268638767,2,1326,1078,-20
12270999726,12270999731,5,1179,1261,-20
12271642138,12271642140,2,1963,1360,-20
12271908271,12271908274,3,2273,1025,-20
12272302042,12272302046,4,1747,1114,-20
12274604294,12274604296,2,1526,1140,-20
12286097150,12286097153,3,1908,1728,-20
12286630515,12286630522,7,10328,29974,-20
12290733306,12290733310,4,2276,1469,-20
12291044606,12291044614,8,5644,2130,-20
12295458311,12295458314,3,1649,1346,-20
12295645541,12295645543,2,1925,926,-20
12297069105,12297069108,3,1720,1500,-20
12297466407,12297466412,5,1749,1551,-20
12302677178,12302677183,5,1718,1556,-20
12303026942,12303026945,3,1478,1389,-20
12304431458,12304431462,4,1628,754,-20
12305032397,12305032400,3,2131,1449,-20
12305294229,12305294230,1,1325,1872,-20
12306331526,12306331530,4,1951,1868,-20
12307676657,12307676659,2,1259,1745,-20
12310444978,12310444980,2,1800,1464,-20
12316868166,12316868170,4,1282,1136,-20
12318971794,12318971798,4,2020,1468,-20
12320258437,12320258441,4,2749,1716,-20
12326984937,12326984947,10,14711,27455,-20
12330754201,12330754207,6,2397,1568,-20
12331265985,12331265987,2,1377,1014,-20
12332707845,12332707847,2,1881,1415,-20
12335463141,12335463144,3,1569,807,-20
12337002714,12337002719,5,1958,1288,-20
12338322278,12338322259,-19,1771,1303,-20
12340392488,12340392490,2,1788,1812,-20
12341403995,12341403999,4,2359,1408,-20
12342554691,12342554694,3,1491,1442,-20
12343673250,12343673255,5,2882,1788,-20
12344881398,12344881400,2,1738,2290,-20
12346483438,12346483442,4,2026,1068,-20
12347728950,12347728953,3,1751,1669,-20
12348622324,12348622328,4,2008,1103,-20
12350064068,12350064072,4,2168,1516,-20
12352193517,12352193520,3,1257,1397,-20
12353593487,12353593489,2,1815,1545,-20
12353996891,12353996907,16,1222,942,-20
12356443426,12356443427,1,1326,1708,-20
12357047773,12357047779,6,2070,1406,-20
12358050060,12358050065,5,2352,1284,-20
12359706244,12359706249,5,4773,1689,-20
12363387842,12363387844,2,2069,2077,-20
12363560878,12363560882,4,1303,1395,-20
12364032922,12364032926,4,1765,1785,-20
12366847084,12366847087,3,1657,1310,-20
12372495186,12372495191,5,1138,845,-20
12374772124,12374772128,4,1940,1380,-20
12379141231,12379141233,2,2465,2013,-20
12389115578,12389115583,5,1415,1037,-20
12391828615,12391828595,-20,1561,1424,-20
12395683746,12395683750,4,1592,1665,-20
12398235822,12398235825,3,2364,2039,-20
12400110345,12400110351,6,2253,855,-20
12401628534,12401628537,3,1701,1278,-20
12402659645,12402659649,4,1888,1523,-20
12404888811,12404888819,8,2160,1080,-20
12405012159,12405012162,3,2165,2003,-20
12405144057,12405144065,8,19989,20448,-20
12408559429,12408559431,2,1975,1371,-20
12412540981,12412540984,3,2116,1368,-20
12415982250,12415982255,5,1997,1513,-20
12417962314,12417962318,4,3157,1901,-20
12419383866,12419383871,5,2298,1168,-20
12425566908,12425566913,5,1749,1391,-20
12426428379,12426428370,-9,1196,4600,-20
12427973615,12427973620,5,1576,1298,-20
12429789650,12429789654,4,1681,1385,-20
12433031998,12433031978,-20,1480,1011,-20
12438055178,12438055181,3,1762,1234,-20
12439502499,12439502499,0,1299,1562,-20
12443503605,12443503606,1,1217,935,-20
12444464265,12444464269,4,1140,1017,-20
12446407752,12446407752,0,16611,2822,-20
12449316263,12449316266,3,1541,1653,-20
12451348622,12451348626,4,1165,994,-20
12453258585,12453258587,2,1914,2066,-20
12454321127,12454321129,2,1231,1577,-20
12458057189,12458057191,2,1825,1434,-20
12460025356,12460025359,3,2192,1576,-20
12464034121,12464034125,4,1773,1436,-20
12466091168,12466091170,2,1870,1358,-20
12469961270,12469961273,3,1611,1368,-20
12470997250,12470997255,5,1237,1236,-20
12474448529,12474448548,19,778,1294,-20
12478297833,12478297837,4,1803,1114,-20
12481615793,12481615795,2,2648,1967,-20
12483817571,12483817575,4,1958,1805,-20
12484023739,12484023742,3,1252,956,-20
12484521906,12484521902,-4,1829,5257,-20
12487842530,12487842535,5,1581,1052,-20
12491142220,12491142223,3,1782,1301,-20
12491251692,12491251695,3,2182,1071,-20
12494099351,12494099354,3,1663,1302,-20
12494956881,12494956886,5,1667,862,-20
12496159882,12496159886,4,2015,1087,-20
12497672989,12497672990,1,1611,2234,-20
12498998042,12498998046,4,1728,1367,-20
12501654891,12501654893,2,2019,1486,-20
12504254762,12504254767,5,2088,1254,-20
12505911977,12505911981,4,1699,1303,-20
12507150854,12507150858,4,1746,1569,-20
12509299702,12509299686,-16,1381,628,-20
12515720579,12515720583,4,1273,1339,-20
12522212830,12522212832,2,1159,915,-20
12523156198,12523156201,3,2224,1549,-20
12523725342,12523725346,4,2095,1182,-20
12525771874,12525771879,5,2779,1675,-20
12527445329,12527445330,1,1828,1569,-20
12527689082,12527689082,0,1465,1308,-20
12531163535,12531163538,3,1539,1244,-20
12532212319,12532212322,3,1477,1318,-20
12534370758,12534370762,4,2240,1152,-20
12534910435,12534910439,4,1905,1932,-20
12539360035,12539360039,4,1353,1006,-20
12543637934,12543637938,4,2023,1415,-20
12543724227,12543724230,3,1590,1264,-20
12545467786,12545467789,3,1430,1006,-20
12556418542,12556418547,5,2344,865,-20
12560452233,12560452237,4,1794,1603,-20
12562114811,12562114815,4,1712,1793,-20
12562804386,12562804387,1,1983,1649,-20
12565097238,12565097242,4,1302,1301,-20
12565263761,12565263766,5,2270,1638,-20
12566334184,12566334187,3,2008,1783,-20
12570292082,12570292086,4,1454,1313,-20
12575344997,12575345002,5,1406,938,-20
12576314878,12576314878,0,1655,2311,-20
12576612706,12576612709,3,1481,1096,-20
12578042686,12578042690,4,2239,1460,-20
12582252624,12582252631,7,909,989,-20
12583912849,12583912853,4,1577,1554,-20
12584442731,12584442735,4,1791,1245,-20
12586272351,12586272355,4,2196,1277,-20
12590444175,12590444170,-5,1894,6068,-20
12591957446,12591957450,4,1821,1724,-20
12594716369,12594716374,5,1786,1781,-20
12599382126,12599382131,5,2673,1604,-20
12604447082,12604447086,4,1977,2216,-20
12608068171,12608068173,2,1211,2096,-20
12610131611,12610131611,0,1936,1001,-20
12610471221,12610471227,6,1571,1182,-20
12610784897,12610784901,4,1567,1230,-20
12611129450,12611129466,16,1522,1371,-20
12612477836,12612477838,2,1967,1675,-20
12612675349,12612675350,1,1427,1630,-20
12624546854,12624546838,-16,1052,721,-20
12628918602,12628918608,6,3061,1150,-20
12632484654,12632484638,-16,2431,1790,-20
12633342741,12633342747,6,2748,1857,-20
12633711896,12633711898,2,2001,1578,-20
12634193057,12634193062,5,1340,996,-20
12640768422,12640768426,4,1605,1160,-20
12640994441,12640994444,3,2060,893,-20
12646644356,12646644360,4,1233,1321,-20
12646800849,12646800853,4,3652,1731,-20
12646932212,12646932215,3,2417,1493,-20
12649402407,12649402410,3,2019,1400,-20
12652278567,12652278570,3,1653,1249,-20
12655864326,12655864329,3,1209,1402,-20
12659695378,12659695383,5,2474,1658,-20
12660030907,12660030912,5,783,1137,-20
12660519340,12660519343,3,2022,1421,-20
12661930328,12661930330,2,1458,1658,-20
12662915462,12662915466,4,1236,1394,-20
12666112450,12666112453,3,1741,1703,-20
12666961595,12666961599,4,1383,1265,-20
12667581781,12667581783,2,1870,2029,-20
12668893491,12668893496,5,1823,1326,-20
12669348691,12669348694,3,1627,1532,-20
12670331168,12670331168,0,2412,3296,-20
12670402899,12670402903,4,1924,1060,-20
12673750632,12673750636,4,1204,1419,-20
12678360904,12678360895,-9,25425,19340,-20
12680194585,12680194590,5,1843,1157,-20
12680727642,12680727644,2,905,1519,-20
12686914082,12686914085,3,1843,1522,-20
12690844329,12690844334,5,1146,1200,-20
12695652605,12695652610,5,2615,1618,-20
12695892090,12695892094,4,2140,1375,-20
12699814018,12699814024,6,1748,1669,-20
12701079146,12701079149,3,2053,1452,-20
12701773546,12701773549,3,2118,1661,-20
12703527002,12703527007,5,1209,1078,-20
12706122241,12706122245,4,1203,760,-20
12707206499,12707206502,3,1421,1464,-20
12707294025,12707294029,4,46428,39524,-20
12708201110,12708201114,4,1582,1067,-20
12710544906,12710544911,5,1405,985,-20
12713535501,12713535505,4,2531,1874,-20
12713800540,12713800541,1,1756,1216,-20
12716658438,12716658441,3,1559,1592,-20
12717019075,12717019079,4,1876,1790,-20
12717313706,12717313706,0,1453,1643,-20
12718803468,12718803471,3,2443,1520,-20
12720066999,12720067005,6,2075,1472,-20
12724393850,12724393853,3,2535,1675,-20
12727395647,12727395652,5,1890,1287,-20
12727918605,12727918587,-18,1328,1519,-20
12729045073,12729045076,3,2082,1405,-20
12730285826,12730285829,3,2440,1586,-20
12731006329,12731006326,-3,26105,13300,-20
12733773314,12733773318,4,1630,1266,-20
12734653335,12734653338,3,2981,1993,-20
12734717160,12734717162,2,1357,1256,-20
12735464131,12735464133,2,1594,1058,-20
12737821501,12737821502,1,1347,1160,-20
12739437813,12739437817,4,2189,2150,-20
12743915081,12743915086,5,2161,1217,-20
12747422680,12747422683,3,2447,1569,-20
12749364866,12749364865,-1,1369,1900,-20
12749917579,12749917583,4,1593,815,-20
12751531628,12751531633,5,2718,1814,-20
12751829610,12751829614,4,913,1100,-20
12755082556,12755082560,4,2581,1182,-20
12758111110,12758111114,4,1882,1140,-20
12759574457,12759574460,3,891,904,-20
12762010239,12762010241,2,1737,1689,-20
12764458225,12764458229,4,2169,1284,-20
12770641218,12770641220,2,1297,1448,-20
12777642579,12777642579,0,1314,1645,-20
12779242573,12779242575,2,1343,971,-20
12780184382,12780184387,5,1883,1583,-20
12781632178,12781632183,5,3032,1243,-20
12782242366,12782242366,0,1804,1637,-20
12784626790,12784626793,3,1421,1166,-20
12786537879,12786537885,6,1700,1071,-20
12789487138,12789487142,4,2758,1640,-20
12793800167,12793800171,4,1439,1142,-20
12794457655,12794457659,4,1533,758,-20
12795388318,12795388320,2,2142,1217,-20
12795469198,12795469180,-18,1047,1278,-20
12797779239,12797779243,4,1540,1412,-20
12798753864,12798753866,2,2001,1553,-20
12801976417,12801976421,4,2322,1302,-20
12802047486,12802047491,5,1177,1173,-20
12803759671,12803759665,-6,2552,7898,-20
12804727919,12804727921,2,2080,1318,-20
12804792554,12804792554,0,2043,2344,-20
12811058043,12811058043,0,1054,1605,-20
12812059189,12812059195,6,2470,1128,-20
12812138586,12812138587,1,1239,1023,-20
12816341694,12816341686,-8,1086,3013,-20
12817515858,12817515863,5,1974,1361,-20
12819901862,12819901869,7,2462,1611,-20
12820826601,12820826608,7,1665,1414,-20
12824029601,12824029603,2,1835,1655,-20
12829534091,12829534100,9,4071,1683,-20
12830930098,12830930102,4,1957,1598,-20
12831506887,12831506891,4,2239,1447,-20
12833844931,12833844933,2,1794,1407,-20
12838610734,12838610739,5,1620,1304,-20
12841096126,12841096129,3,1678,1745,-20
12845656572,12845656574,2,1365,983,-20
12851275620,12851275610,-10,94,1241,-20
12852110899,12852110901,2,1799,1351,-20
12855562698,12855562701,3,1608,931,-20
12861229625,12861229624,-1,16589,11300,-20
12861381662,12861381668,6,2066,1511,-20
12861600445,12861600425,-20,1533,1072,-20
12863760435,12863760433,-2,977,1851,-20
12865378037,12865378038,1,1389,1071,-20
12867553551,12867553555,4,3076,1460,-20
12875254901,12875254902,1,1399,1489,-20
12876216093,12876216099,6,1401,1063,-20
12880589035,12880589039,4,1232,1359,-20
12884013254,12884013255,1,2288,1350,-20
12884778731,12884778735,4,2061,1249,-20
12885256750,12885256750,0,1640,2075,-20
12888590602,12888590596,-6,1240,3869,-20
12889555965,12889555971,6,1707,1203,-20
12892618586,12892618585,-1,1420,1684,-20
12895098912,12895098915,3,1820,931,-20
12897623726,12897623707,-19,994,375,-20
12898578555,12898578559,4,2134,1338,-20
12901094959,12901094962,3,960,1167,-20
12902345727,12902345731,4,2067,1360,-20
12906003413,12906003416,3,1644,1617,-20
12909364573,12909364573,0,2175,2342,-20
12909911040,12909911044,4,2601,2195,-20
12913662608,12913662610,2,1847,1458,-20
12917203928,12917203931,3,2013,1236,-20
12917786614,12917786615,1,1371,1220,-20
12918180898,12918180902,4,1906,1985,-20
12920326125,12920326130,5,1385,923,-20
12921789218,12921789223,5,2270,1726,-20
12922862959,12922862963,4,2701,1545,-20
12923355222,12923355227,5,1339,1223,-20
12925588396,12925588399,3,1422,66,-20
12926871786,12926871790,4,1354,1115,-20
12928211570,12928211575,5,2144,1392,-20
12929052198,12929052202,4,1950,1695,-20
12929366879,12929366883,4,2132,1505,-20
12937298910,12937298913,3,1489,1621,-20
12940132546,12940132551,5,1966,1677,-20
12941312607,12941312610,3,1518,1259,-20
12944504259,12944504254,-5,1107,4403,-20
12945976569,12945976573,4,2219,1301,-20
12951167360,12951167370,10,17223,22309,-20
12951700031,12951700034,3,1815,1352,-20
12951974825,12951974828,3,1206,1293,-20
12954839239,12954839245,6,2185,1659,-20
12954895975,12954895955,-20,2186,1352,-20
12955133467,12955133450,-17,1644,1235,-20
12956709521,12956709522,1,1698,1657,-20
12957326690,12957326694,4,1728,1826,-20
12962533362,12962533363,1,1951,1650,-20
12963293730,12963293733,3,1290,1292,-20
12964686396,12964686394,-2,3788,8752,-20
12970350701,12970350701,0,1370,1437,-20
12970541586,12970541590,4,1847,1555,-20
12970748541,12970748545,4,2454,1224,-20
12971017598,12971017609,11,1026,822,-20
12977620064,12977620066,2,2151,1190,-20
12979114263,12979114268,5,1381,1012,-20
12979764370,12979764371,1,1304,1554,-20
12980123362,12980123369,7,2417,795,-20
12980423670,12980423680,10,1319,1376,-20
12981955027,12981955030,3,1854,1735,-20
12985224219,12985224221,2,2400,1952,-20
12985500420,12985500423,3,1105,1417,-20
12986335119,12986335122,3,1983,945,-20
12987967152,12987967156,4,2042,1668,-20
12992165476,12992165479,3,1756,1209,-20
12993814383,12993814385,2,1611,1275,-20
12994075483,12994075486,3,1916,1522,-20
12995371424,12995371426,2,1475,878,-20
12995793102,12995793103,1,976,849,-20
12996380027,12996380030,3,1765,780,-20
12997175572,12997175555,-17,1056,881,-20
12997497742,12997497747,5,1293,1305,-20
13000275974,13000275977,3,1906,1419,-20
13000616822,13000616823,1,2529,1712,-20
13002724722,13002724727,5,2177,1163,-20
13004332419,13004332422,3,2182,1356,-20
13005413791,13005413794,3,1827,1437,-20
13007344288,13007344293,5,2169,1671,-20
13010155753,13010155754,1,1673,2033,-20
13011273419,13011273423,4,1530,1400,-20
13012998069,13012998074,5,1888,1432,-20
13015700644,13015700647,3,2002,1128,-20
13017099506,13017099510,4,1936,1248,-20
13020481612,13020481616,4,1887,1238,-20
13021285077,13021285079,2,1855,1224,-20
13027134169,13027134174,5,2011,1478,-20
13028685804,13028685793,-11,498,36,-20
13029838546,13029838531,-15,1242,844,-20
13031207826,13031207827,1,1370,1171,-20
13035287741,13035287741,0,1648,2027,-20
13035477164,13035477168,4,1771,1285,-20
13036146057,13036146062,5,2131,1319,-20
13039922201,13039922205,4,1571,1508,-20
13040791982,13040791984,2,1372,978,-20
13042570123,13042570124,1,1041,1129,-20
13042718146,13042718149,3,1764,1340,-20
13044336890,13044336890,0,1680,1357,-20
13046041145,13046041147,2,1811,1450,-20
13047871931,13047871935,4,821,1125,-20
13049393481,13049393482,1,1491,1644,-20
13050976474,13050976478,4,1719,1239,-20
13056994597,13056994600,3,1911,1598,-20
13059135591,13059135593,2,1733,1242,-20
13063310283,13063310286,3,1521,1515,-20
13064243367,13064243369,2,2252,1543,-20
13065645712,13065645715,3,1921,1313,-20
13069519797,13069519801,4,1432,969,-20
13076694801,13076694806,5,2322,1296,-20
13078686787,13078686790,3,1831,1254,-20
13078798743,13078798744,1,1375,1250,-20
13079091446,13079091424,-22,3335,1512,-20
13080920305,13080920310,5,1963,1526,-20
13088498098,13088498100,2,1491,1328,-20
13089011242,13089011245,3,1811,1658,-20
13091151902,13091151907,5,1336,1039,-20
13101758508,13101758511,3,1949,1309,-20
13102169259,13102169265,6,1418,1327,-20
13102598499,13102598495,-4,1086,1575,-20
13102721114,13102721130,16,1218,3502,-20
13103182687,13103182689,2,2083,1325,-20
13103491116,13103491119,3,1354,1063,-20
13106061561,13106061565,4,2165,1586,-20
13107378629,13107378631,2,1798,1449,-20
13109282780,13109282782,2,1548,1280,-20
13111225638,13111225639,1,2215,2479,-20
13112921530,13112921531,1,1750,1857,-20
13112991009,13112991010,1,1573,1949,-20
13113485433,13113485451,18,345,1142,-20
13116142383,13116142386,3,2280,1549,-20
13116411138,13116411141,3,2174,1541,-20
13116736464,13116736464,0,1281,1179,-20
13117597761,13117597765,4,2174,1449,-20
13118215817,13118215823,6,2163,1586,-20
13118685176,13118685180,4,2552,1191,-20
13120347970,13120347973,3,1221,1657,-20
13120641329,13120641333,4,1811,1675,-20
13125648110,13125648115,5,1374,1426,-20
13129934281,13129934287,6,1482,1089,-20
13131025207,13131025209,2,3402,2968,-20
13132777210,13132777215,5,1608,1496,-20
13137851777,13137851781,4,1308,1216,-20
13139064661,13139064667,6,3898,1571,-20
13141479975,13141479976,1,1679,1803,-20
13141611177,13141611184,7,2354,1115,-20
13143319529,13143319536,7,2061,1344,-20
13145081478,13145081482,4,1080,1067,-20
13148173617,13148173621,4,2212,1615,-20
13151443543,13151443554,11,241,717,-20
13155330290,13155330290,0,1977,1608,-20
13156332007,13156332010,3,2385,1219,-20
13158662830,13158662835,5,3094,1135,-20
13158971618,13158971621,3,1809,1700,-20
13161272253,13161272245,-8,1175,5613,-20
13163894913,13163894916,3,1444,886,-20
13167446119,13167446128,9,16709,11329,-20
13168581755,13168581761,6,4464,2835,-20
13171290255,13171290259,4,2240,1613,-20
13174736274,13174736258,-16,1148,4861,-20
13176153077,13176153077,0,1034,1874,-20
13176294890,13176294894,4,1482,1627,-20
13179658311,13179658315,4,1844,1550,-20
13180715980,13180715982,2,2310,1401,-20
13180756419,13180756422,3,1309,1008,-20
13181171220,13181171225,5,2034,1356,-20
13183407105,13183407108,3,1861,1426,-20
13183862715,13183862716,1,1353,1504,-20
13183940719,13183940739,20,1211,1084,-20
13186387706,13186387710,4,1608,1731,-20
13187365315,13187365319,4,1389,1386,-20
13189946995,13189946994,-1,1077,1307,-20
13190760981,13190760979,-2,1631,1951,-20
13190873001,13190873002,1,1957,1274,-20
13192427592,13192427594,2,1598,1256,-20
13194325290,13194325293,3,1415,1266,-20
13199244295,13199244298,3,1843,1497,-20
13200040396,13200040394,-2,29553,11427,-20
13200916337,13200916338,1,2026,1507,-20
13201737728,13201737732,4,2074,1266,-20
13208583201,13208583207,6,1575,1484,-20
13209845856,13209845859,3,1481,1038,-20
13215980626,13215980614,-12,1677,2664,-20
13217220886,13217220889,3,1914,1594,-20
13219042926,13219042929,3,2116,1547,-20
13219867560,13219867553,-7,32015,14806,-20
13220027042,13220027042,0,1590,1451,-20
13221445742,13221445747,5,2190,1648,-20
13221622444,13221622448,4,1585,1267,-20
13225638178,13225638179,1,2081,1798,-20
13226546868,13226546872,4,1584,1446,-20
13231979699,13231979699,0,967,967,-20
13232273985,13232273988,3,1245,1448,-20
13235933436,13235933446,10,2210,1742,-20
13247036967,13247036970,3,1411,1453,-20
13247542566,13247542567,1,2303,2303,-20
13247816625,13247816630,5,4465,3181,-20
13249258871,13249258872,1,1340,1042,-20
13250274384,13250274387,3,2459,1505,-20
13250744530,13250744534,4,1485,1734,-20
13251289650,13251289654,4,1865,1442,-20
13259495226,13259495229,3,1770,1625,-20
13263924833,13263924838,5,1527,1334,-20
13265215906,13265215911,5,1597,1431,-20
13268332539,13268332539,0,1424,1017,-20
13272548485,13272548489,4,1835,1295,-20
13276241806,13276241811,5,2283,1224,-20
13278467385,13278467390,5,1870,923,-20
13278926101,13278926105,4,1660,1468,-20
13279217404,13279217406,2,1499,1599,-20
13284462185,13284462189,4,2334,1957,-20
13288661805,13288661807,2,2065,1259,-20
13290028970,13290028971,1,2197,1396,-20
13294058901,13294058903,2,1510,2128,-20
13296963970,13296963966,-4,1295,2626,-20
13301862281,13301862286,5,1760,1596,-20
13302150291,13302150285,-6,1404,3538,-20
13303324205,13303324208,3,1709,1349,-20
13304295484,13304295466,-18,1372,1326,-20
13305834751,13305834755,4,2787,1577,-20
13307266737,13307266742,5,1794,1184,-20
13310285935,13310285935,0,2200,1356,-20
13313731881,13313731884,3,1689,1063,-20
13313857393,13313857380,-13,1120,670,-20
13315509636,13315509639,3,2162,1047,-20
13319196298,13319196301,3,2379,2164,-20
13319853371,13319853374,3,2101,1464,-20
13329795588,13329795593,5,2356,1619,-20
13338008189,13338008194,5,3265,1030,-20
13339786751,13339786754,3,2815,2059,-20
13340092089,13340092091,2,1907,1916,-20
13340859141,13340859145,4,1653,1259,-20
13345071178,13345071179,1,1647,1664,-20
13346569174,13346569178,4,1807,1369,-20
13348941086,13348941091,5,1598,1316,-20
13355632212,13355632207,-5,862,2607,-20
13359121969,13359121968,-1,1251,1283,-20
13359831926,13359831930,4,2113,1336,-20
13361488589,13361488591,2,1423,1487,-20
13362467847,13362467850,3,1484,1291,-20
13363077090,13363077094,4,1855,1908,-20
13364546087,13364546090,3,2294,1484,-20
13365325902,13365325905,3,1830,1351,-20
13371234588,13371234592,4,2356,1741,-20
13372083949,13372083953,4,2435,1607,-20
13373223838,13373223842,4,1612,1235,-20
13379162891,13379162895,4,2657,1697,-20
13382680239,13382680244,5,4201,2693,-20
13382794389,13382794391,2,1813,1242,-20
13386443327,13386443332,5,2449,1385,-20
13392336135,13392336139,4,2286,1687,-20
13394990325,13394990322,-3,40328,15328,-20
13395385839,13395385841,2,1354,1126,-20
13395495359,13395495363,4,10600,20244,-20
13402959844,13402959848,4,1926,1388,-20
13405575917,13405575913,-4,838,1675,-20
13407285990,13407285994,4,1497,1221,-20
13408591958,13408591962,4,1574,1261,-20
13413254590,13413254595,5,2152,1570,-20
13415460253,13415460250,-3,1289,1651,-20
13421361110,13421361115,5,2000,1290,-20
13421660400,13421660418,18,1684,1300,-20
13425566630,13425566648,18,41867,18691,-20
13426488128,13426488132,4,1688,1536,-20
13426629911,13426629915,4,1693,1103,-20
13429057278,13429057279,1,1410,1129,-20
13429421102,13429421105,3,1983,1344,-20
13429481871,13429481875,4,2457,1976,-20
13431610146,13431610145,-1,1227,1413,-20
13434547149,13434547154,5,1565,1234,-20
13434763030,13434763033,3,1615,1241,-20
13435162782,13435162783,1,1538,1604,-20
13435828313,13435828314,1,1586,1195,-20
13436167654,13436167655,1,1591,1238,-20
13438093382,13438093383,1,1499,1765,-20
13441170004,13441170002,-2,1423,1808,-20
13441590903,13441590908,5,2159,1806,-20
13441764254,13441764255,1,1197,1456,-20
13444736869,13444736875,6,2664,1597,-20
13446200934,13446200936,2,1712,1525,-20
13450505103,13450505101,-2,2369,4052,-20
13457040120,13457040124,4,2965,2082,-20
13461001663,13461001669,6,2482,1124,-20
13461669519,13461669523,4,1346,980,-20
13462090151,13462090154,3,861,1158,-20
13464112981,13464112986,5,2510,1599,-20
13466946182,13466946184,2,1301,1100,-20
13469103274,13469103279,5,1263,1065,-20
13472964297,13472964297,0,1640,1446,-20
13474825303,13474825309,6,2522,1429,-20
13478287363,13478287366,3,985,1079,-20
13481926594,13481926598,4,2127,1518,-20
13483879800,13483879802,2,1434,1471,-20
13487444341,13487444345,4,1448,1594,-20
13492164678,13492164658,-20,1592,700,-20
13492557261,13492557266,5,2085,1619,-20
13494346642,13494346646,4,1404,1774,-20
13500832581,13500832581,0,1170,2321,-20
13506370496,13506370499,3,1849,2039,-20
13507454943,13507454947,4,1237,1198,-20
13507999301,13507999305,4,1927,1570,-20
13508336042,13508336046,4,1451,1055,-20
13512489445,13512489449,4,1817,1337,-20
13514792174,13514792182,8,1668,1218,-20
13516438105,13516438111,6,1890,1305,-20
13520553379,13520553382,3,2528,1920,-20
13526464505,13526464509,4,1705,1488,-20
13526643635,13526643616,-19,894,929,-20
13531082394,13531082394,0,1570,1667,-20
13534009363,13534009366,3,1519,1387,-20
13540692538,13540692540,2,1988,1785,-20
13541575997,13541575999,2,2196,1981,-20
13543130642,13543130647,5,1773,1249,-20
13543361320,13543361308,-12,726,351,-20
13545001166,13545001169,3,1695,1658,-20
13549406417,13549406420,3,1694,1293,-20
13550306857,13550306861,4,2283,1929,-20
13551833613,13551833616,3,1364,1390,-20
13552123437,13552123435,-2,1711,2265,-20
13554431489,13554431491,2,1433,1635,-20
13555523575,13555523581,6,10626,22850,-20
13555583363,13555583361,-2,1541,3128,-20
13557263549,13557263554,5,1577,1333,-20
13560081360,13560081360,0,1738,1448,-20
13565082688,13565082691,3,1854,1079,-20
13569964822,13569964826,4,2022,1336,-20
13574432667,13574432669,2,1679,1060,-20
13575486528,13575486530,2,1915,1279,-20
13576066056,13576066060,4,2262,1764,-20
13577229431,13577229430,-1,1808,3972,-20
13578169329,13578169331,2,1683,1202,-20
13578368849,13578368854,5,2921,1587,-20
13582014402,13582014407,5,2238,1548,-20
13586812009,13586812013,4,1472,1290,-20
13587927550,13587927555,5,1012,596,-20
13588543180,13588543183,3,2027,2180,-20
13589132903,13589132908,5,19242,55056,-20
13589646412,13589646415,3,2549,1397,-20
13591487114,13591487119,5,2207,1731,-20
13591754404,13591754405,1,1542,1431,-20
13593442397,13593442399,2,1176,1475,-20
13596173556,13596173558,2,1322,767,-20
13599775714,13599775717,3,2056,1306,-20
13608864290,13608864293,3,1573,1205,-20
13610952476,13610952481,5,1513,1771,-20
13613867135,13613867137,2,1494,1171,-20
13614461643,13614461646,3,1525,1560,-20
13624629529,13624629526,-3,1216,1916,-20
13625284990,13625284985,-5,1274,3072,-20
13627497971,13627497976,5,1550,1388,-20
13628375482,13628375487,5,1610,904,-20
13629760486,13629760490,4,1769,1382,-20
13630256093,13630256098,5,1989,1563,-20
13632087156,13632087151,-5,484,1677,-20
13632486754,13632486755,1,1775,1525,-20
13633786597,13633786598,1,1866,1090,-20
13633853634,13633853634,0,1556,1669,-20
13634038813,13634038795,-18,1503,1109,-20
13634468374,13634468377,3,1873,1314,-20
13635984392,13635984394,2,2252,1566,-20
13636171718,13636171721,3,1556,1592,-20
13636342193,13636342197,4,1279,1215,-20
13641879763,13641879766,3,1504,839,-20
13643422045,13643422047,2,1410,1862,-20
13643648413,13643648414,1,2027,1706,-20
13647879762,13647879766,4,1353,1191,-20
13651270246,13651270250,4,1046,1310,-20
13657002017,13657002020,3,2178,2169,-20
13657987630,13657987631,1,1384,1376,-20
13668822313,13668822313,0,943,1163,-20
13673452882,13673452890,8,2454,1013,-20
13674130386,13674130389,3,1610,1339,-20
13674718858,13674718859,1,1428,975,-20
13675288118,13675288123,5,2215,1068,-20
13675615363,13675615363,0,895,147,-20
13679428071,13679428074,3,1836,1410,-20
13679505358,13679505361,3,1285,1157,-20
13680411918,13680411921,3,2296,1931,-20
13683089926,13683089921,-5,1299,4021,-20
13684317474,13684317478,4,817,960,-20
13684769510,13684769512,2,1874,1616,-20
13685396967,13685396971,4,1636,1480,-20
13689540302,13689540305,3,1883,1417,-20
13690215542,13690215546,4,1735,1160,-20
13691323590,13691323599,9,1291,1575,-20
13695513209,13695513211,2,1795,1699,-20
13696918560,13696918563,3,1744,1469,-20
13697341130,13697341136,6,2635,1587,-20
13699476287,13699476291,4,2305,1760,-20
13702266448,13702266454,6,5490,1108,-20
13704045495,13704045499,4,1586,1166,-20
13709361334,13709361338,4,1354,1120,-20
13709915090,13709915086,-4,1290,2096,-20
13710686981,13710686985,4,17632,9047,-20
13713624414,13713624394,-20,1626,1476,-20
13713686704,13713686707,3,1824,2146,-20
13715468504,13715468506,2,1372,1325,-20
13719745750,13719745753,3,2276,1541,-20
13721779137,13721779140,3,1935,1648,-20
13723725648,13723725653,5,2365,1357,-20
13725920632,13725920633,1,1395,1494,-20
13729164285,13729164287,2,1215,1110,-20
13730320202,13730320209,7,2884,1360,-20
13733189598,13733189602,4,1811,1469,-20
13736893697,13736893700,3,2888,1801,-20
13739740950,13739740948,-2,2439,5550,-20
13742897285,13742897289,4,1632,1173,-20
13743386828,13743386833,5,2290,1776,-20
13744117887,13744117890,3,1772,1484,-20
13749249830,13749249838,8,6600,1841,-20
13750980739,13750980741,2,1361,1720,-20
13751773742,13751773740,-2,1038,1732,-20
13752575695,13752575698,3,1511,1396,-20
13753796041,13753796045,4,1990,1015,-20
13754192190,13754192195,5,1920,1733,-20
13754338934,13754338938,4,1916,1416,-20
13757533017,13757533021,4,2427,1648,-20
13757694223,13757694227,4,926,1029,-20
13760857287,13760857292,5,2393,1080,-20
13762339127,13762339131,4,1214,1045,-20
13762785518,13762785522,4,2206,1247,-20
13763787105,13763787106,1,1302,1215,-20
13766668099,13766668101,2,1280,1474,-20
13768236410,13768236417,7,2151,1161,-20
13770068273,13770068277,4,2040,1205,-20
13772610155,13772610159,4,1860,1191,-20
13773986563,13773986578,15,1401,1181,-20
13774845653,13774845656,3,2364,2004,-20
13776854215,13776854220,5,1995,1266,-20
13777462934,13777462939,5,1546,1152,-20
13778360501,13778360502,1,1406,1264,-20
13779454529,13779454533,4,3106,1731,-20
13779818243,13779818250,7,1839,1249,-20
13780572754,13780572758,4,2061,1016,-20
13782158873,13782158877,4,1317,1312,-20
13782648703,13782648706,3,1813,1396,-20
13784273626,13784273630,4,2612,1414,-20
13785270386,13785270390,4,1692,1771,-20
13785416947,13785416951,4,1717,1514,-20
13787106715,13787106692,-23,1298,1125,-20
13788550661,13788550665,4,2162,1775,-20
13791249023,13791249026,3,1842,1672,-20
13794937271,13794937278,7,2114,1730,-20
13797250172,13797250175,3,1679,1278,-20
13798928430,13798928434,4,1073,1087,-20
13800273168,13800273170,2,1526,1076,-20
13804270963,13804270965,2,1972,1199,-20
13805294841,13805294843,2,1468,1237,-20
13805781480,13805781482,2,1905,1638,-20
13806350970,13806350973,3,1259,1096,-20
13808086545,13808086543,-2,1870,2596,-20
13808548552,13808548555,3,1545,1275,-20
13809787250,13809787245,-5,1161,3473,-20
13812915761,13812915765,4,2495,1903,-20
13814177202,13814177199,-3,1113,2150,-20
13815244646,13815244648,2,1741,1616,-20
13819028038,13819028041,3,1781,1737,-20
13823486462,13823486464,2,1688,1581,-20
13830997405,13830997407,2,2019,1175,-20
13831155161,13831155166,5,1482,1052,-20
13836839956,13836839963,7,1824,1382,-20
13840552622,13840552626,4,2076,1878,-20
13841785038,13841785042,4,1795,1416,-20
13842990077,13842990079,2,1677,1495,-20
13844397583,13844397586,3,2350,1853,-20
13844976792,13844976795,3,1398,839,-20
13845294299,13845294303,4,2399,1797,-20
13848651182,13848651187,5,1922,1330,-20
13849463751,13849463755,4,1327,1365,-20
13849952226,13849952231,5,2125,1313,-20
13851669355,13851669351,-4,1343,3691,-20
13851744581,13851744584,3,2179,1775,-20
13854078197,13854078200,3,2091,1560,-20
13862648609,13862648613,4,1769,1186,-20
13864978827,13864978831,4,2220,1132,-20
13865056069,13865056080,11,2000,1354,-20
13866816520,13866816522,2,2359,1589,-20
13871344990,13871345009,19,227,2085,-20
13876090162,13876090166,4,2298,1524,-20
13878359164,13878359166,2,1779,1728,-20
13878933851,13878933854,3,1749,1453,-20
13881437485,13881437475,-10,3414,13552,-20
13883117518,13883117513,-5,1008,2779,-20
13884658586,13884658586,0,1544,1518,-20
13887511864,13887511869,5,1691,1523,-20
13889767778,13889767781,3,1074,914,-20
13895296946,13895296949,3,2577,1472,-20
13895451598,13895451606,8,1429,1445,-20
13905156206,13905156209,3,1898,1279,-20
13905346451,13905346457,6,3389,1453,-20
13906957922,13906957923,1,1558,1437,-20
13910990827,13910990834,7,2650,1325,-20
13912509326,13912509333,7,1300,836,-20
13914331798,13914331802,4,1939,1469,-20
13915038783,13915038786,3,2135,1081,-20
13915920720,13915920723,3,2000,1073,-20
13916552502,13916552506,4,1435,940,-20
13917531656,13917531650,-6,1121,2865,-20
13919202437,13919202442,5,1670,1155,-20
13925955291,13925955295,4,1911,1524,-20
13927495058,13927495060,2,3533,2828,-20
13930224536,13930224542,6,2115,1594,-20
13934356099,13934356106,7,990,804,-20
13935090856,13935090858,2,2161,1947,-20
13938869939,13938869945,6,1627,992,-20
13939409197,13939409203,6,2054,1420,-20
13939482722,13939482726,4,1367,1520,-20
13942302965,13942302962,-3,1339,2704,-20
13943183514,13943183518,4,1847,1132,-20
13946186317,13946186313,-4,20192,9864,-20
13947661729,13947661735,6,3475,1412,-20
13948020050,13948020053,3,2483,1456,-20
13948182852,13948182854,2,2281,1040,-20
13948853418,13948853422,4,2065,1538,-20
13951245894,13951245898,4,1521,1562,-20
13955895039,13955895041,2,1426,1428,-20
13957342482,13957342485,3,1257,1458,-20
13957786287,13957786266,-21,1586,1075,-20
13958954242,13958954246,4,1612,1577,-20
13959670911,13959670915,4,1614,1844,-20
13960724100,13960724098,-2,2143,3914,-20
13963331769,13963331773,4,1739,1574,-20
13969643298,13969643303,5,2091,1380,-20
13970540415,13970540419,4,1602,1406,-20
13970668846,13970668848,2,1525,1302,-20
13972738650,13972738655,5,877,802,-20
13973617770,13973617772,2,1796,1177,-20
13974792451,13974792453,2,3160,2730,-20
13975883750,13975883751,1,1916,1027,-20
13978031193,13978031194,1,2404,1356,-20
13978142931,13978142933,2,1691,1766,-20
13978637397,13978637400,3,1751,1498,-20
13980116304,13980116309,5,2153,1249,-20
13980348047,13980348025,-22,1399,1188,-20
13980736181,13980736186,5,2168,1255,-20
13983257094,13983257099,5,1323,1260,-20
13985201977,13985201978,1,1697,1845,-20
13985976406,13985976408,2,2622,2449,-20
13992483494,13992483501,7,2747,991,-20
13994615010,13994615013,3,1148,1025,-20
13997745155,13997745159,4,1810,1241,-20
13998458389,13998458394,5,2008,1379,-20
14001423551,14001423554,3,1692,1305,-20
14003079369,14003079376,7,3887,1879,-20
14007933987,14007933987,0,2102,3297,-20
14008523102,14008523108,6,4531,1926,-20
14009056260,14009056262,2,1389,1146,-20
14009840009,14009840013,4,1226,1451,-20
14013169138,14013169142,4,1549,1580,-20
14013774159,14013774163,4,1499,1236,-20
14018725167,14018725165,-2,17792,6611,-20
14018977555,14018977559,4,1820,1300,-20
14019285122,14019285131,9,2281,1469,-20
14020502866,14020502870,4,1244,1216,-20
14021972338,14021972341,3,1797,1560,-20
14029338789,14029338794,5,1531,793,-20
14029661218,14029661220,2,1400,1128,-20
14030686846,14030686852,6,1745,1126,-20
14033700905,14033700908,3,1773,1048,-20
14034048691,14034048690,-1,2204,3835,-20
14035543818,14035543820,2,2967,3078,-20
14037349634,14037349637,3,1499,1518,-20
14038387028,14038387031,3,1673,1216,-20
14040388374,14040388375,1,1380,1281,-20
14041119173,14041119177,4,1593,1106,-20
14043247930,14043247934,4,2316,1163,-20
14044792370,14044792373,3,1426,852,-20
14046616404,14046616409,5,1586,1052,-20
14047957494,14047957498,4,2015,1138,-20
14049088778,14049088782,4,2049,1272,-20
14051488642,14051488648,6,2963,1541,-20
14051868300,14051868304,4,2185,1295,-20
14058227424,14058227414,-10,691,3024,-20
14060602930,14060602937,7,2373,1140,-20
14070018538,14070018543,5,2424,1633,-20
14070277734,14070277737,3,1969,1822,-20
14070370786,14070370787,1,1212,1200,-20
14070398093,14070398076,-17,1854,1200,-20
14072602773,14072602777,4,2232,1987,-20
14073549829,14073549840,11,1609,1150,-20
14075047201,14075047204,3,2224,2503,-20
14075479377,14075479381,4,1507,1299,-20
14076879290,14076879295,5,1525,1356,-20
14076907662,14076907663,1,1905,1116,-20
14078339573,14078339580,7,2117,584,-20
14080224598,14080224602,4,1777,1284,-20
14089009966,14089009970,4,2087,1790,-20
14090657587,14090657592,5,1122,1016,-20
14090951550,14090951555,5,5415,2744,-20
14092100158,14092100162,4,1913,1773,-20
14093396874,14093396879,5,1375,1168,-20
14094526011,14094526008,-3,1217,2980,-20
14094960550,14094960552,2,942,946,-20
14099584106,14099584112,6,990,971,-20
14103081025,14103081027,2,1813,961,-20
14104230261,14104230265,4,1241,924,-20
14106580034,14106580035,1,1704,1060,-20
14108336889,14108336892,3,2152,1664,-20
14108866019,14108866022,3,1408,1370,-20
14109303367,14109303370,3,1659,1742,-20
14110846544,14110846525,-19,1801,1159,-20
14112822765,14112822770,5,2794,1814,-20
14113504841,14113504846,5,1240,1227,-20
14117792283,14117792301,18,1885,1541,-20
14122416770,14122416774,4,2847,1380,-20
14122668949,14122668952,3,1572,1061,-20
14122825807,14122825810,3,3055,1480,-20
14123600198,14123600203,5,2451,1499,-20
14127520866,14127520871,5,1478,1414,-20
14130143331,14130143333,2,1546,1594,-20
14134850301,14134850303,2,1565,1125,-20
14135495807,14135495825,18,807,314,-20
14136965929,14136965933,4,1287,922,-20
14142341154,14142341159,5,1309,1290,-20
14144677473,14144677475,2,1555,1058,-20
14147921949,14147921953,4,1200,1026,-20
14153201406,14153201409,3,2095,1461,-20
14156794604,14156794606,2,2272,2164,-20
14161427358,14161427363,5,1249,1090,-20
14161669711,14161669714,3,1917,1361,-20
14168538662,14168538667,5,2015,1159,-20
14172895602,14172895606,4,2015,1754,-20
14180239666,14180239669,3,1452,1352,-20
14182213356,14182213360,4,2270,2096,-20
14186282597,14186282600,3,1981,1576,-20
14187693437,14187693439,2,2583,1985,-20
14198777095,14198777098,3,1538,1361,-20
14199556770,14199556772,2,1513,1605,-20
14200020329,14200020334,5,1911,1574,-20
14201430849,14201430855,6,2546,1368,-20
14203310526,14203310530,4,988,591,-20
14203782593,14203782599,6,2149,1259,-20
14210371359,14210371362,3,1644,1730,-20
14212519767,14212519769,2,1153,780,-20
14214290014,14214290017,3,1944,1216,-20
14215144121,14215144123,2,1545,1438,-20
14215695173,14215695186,13,1800,1343,-20
14217468198,14217468204,6,2087,1330,-20
14218260337,14218260346,9,3212,813,-20
14220178457,14220178454,-3,1449,2358,-20
14220739486,14220739490,4,2228,1440,-20
14221036858,14221036861,3,896,707,-20
14223163083,14223163085,2,1476,1889,-20
14227625128,14227625130,2,1329,1420,-20
14232443434,14232443439,5,1433,1392,-20
14233341078,14233341060,-18,1410,1256,-20
14233952508,14233952512,4,2005,1262,-20
14235257509,14235257513,4,1919,1323,-20
14236298662,14236298666,4,2195,1223,-20
14240548297,14240548297,0,1619,1822,-20
14241105501,14241105502,1,1936,1809,-20
14242873475,14242873479,4,2355,1632,-20
14245254793,14245254798,5,61408,33548,-20
14247423967,14247423970,3,2150,1204,-20
14250292367,14250292371,4,1302,1714,-20
14251385129,14251385127,-2,1013,696,-20
14255929519,14255929522,3,662,940,-20
14256218745,14256218748,3,1680,1166,-20
14257412436,14257412441,5,1451,1625,-20
14258356883,14258356887,4,2081,1117,-20
14260398399,14260398402,3,2306,1492,-20
14261573538,14261573542,4,1830,1284,-20
14262557158,14262557162,4,2245,1570,-20
14267450770,14267450772,2,2017,1144,-20
14271494355,14271494358,3,1834,1134,-20
14272881689,14272881691,2,2171,1484,-20
14277908721,14277908723,2,2038,1554,-20
14278216807,14278216813,6,1960,1136,-20
14278750975,14278750979,4,1986,1419,-20
14278919339,14278919343,4,2198,1109,-20
14279290521,14279290525,4,2148,1629,-20
14279850087,14279850090,3,1026,1079,-20
14280327601,14280327606,5,3008,1222,-20
14281973074,14281973077,3,1265,890,-20
14286520310,14286520314,4,1854,1529,-20
14286805263,14286805266,3,1331,1406,-20
14287409176,14287409178,2,3106,2453,-20
14291365003,14291365008,5,2824,1646,-20
14291801745,14291801750,5,2563,1466,-20
14292899545,14292899551,6,2375,1054,-20
14294872229,14294872233,4,1694,1065,-20
14297629679,14297629681,2,1269,1033,-20
14298143319,14298143321,2,1376,1171,-20
14301152943,14301152938,-5,1136,3416,-20
14301753357,14301753360,3,59305,48954,-20
14303507267,14303507271,4,2614,1853,-20
14304363710,14304363710,0,1827,1473,-20
14308382869,14308382872,3,1601,1619,-20
14309087820,14309087821,1,1485,1673,-20
14310941730,14310941731,1,1237,1392,-20
14311250944,14311250947,3,1114,943,-20
14314675500,14314675504,4,1805,1753,-20
14314958386,14314958388,2,2233,1374,-20
14315947054,14315947057,3,1898,2021,-20
14316809902,14316809906,4,1851,1243,-20
14317474076,14317474059,-17,1766,984,-20
14322457323,14322457326,3,1557,1188,-20
14327986326,14327986322,-4,1154,2959,-20
14335539751,14335539755,4,2076,1146,-20
14335821829,14335821833,4,1878,2006,-20
14343208315,14343208318,3,2820,2423,-20
14343758106,14343758111,5,1544,1225,-20
14346192173,14346192176,3,1903,1840,-20
14347312549,14347312552,3,1692,1542,-20
14347432802,14347432818,16,2183,1409,-20
14348710811,14348710790,-21,1463,1011,-20
14352719074,14352719077,3,1453,1146,-20
14355090316,14355090318,2,2140,1062,-20
14361424514,14361424521,7,2124,1564,-20
14362365154,14362365159,5,1844,902,-20
14363186077,14363186080,3,1876,1423,-20
14363718418,14363718421,3,1511,802,-20
14367580342,14367580345,3,1487,1723,-20
14370839741,14370839742,1,1698,1240,-20
14371867330,14371867335,5,1725,1524,-20
14374851649,14374851647,-2,2425,2828,-20
14375563202,14375563206,4,1879,1497,-20
14382144049,14382144062,13,1255,814,-20
14383879134,14383879137,3,2314,1123,-20
14387953011,14387953015,4,1395,1121,-20
14388680973,14388680979,6,1276,873,-20
14390933688,14390933691,3,1716,1353,-20
14391224246,14391224252,6,1350,959,-20
14394075267,14394075272,5,1876,1504,-20
14394755298,14394755300,2,1108,1570,-20
14397757034,14397757039,5,3243,1123,-20
14398208182,14398208184,2,1828,1890,-20
14399951054,14399951058,4,1618,916,-20
14404928847,14404928852,5,2281,1320,-20
14409337172,14409337174,2,1423,1971,-20
14414469911,14414469915,4,2365,2332,-20
14415105729,14415105731,2,1733,1273,-20
14415481357,14415481359,2,2001,1460,-20
14416811514,14416811519,5,2339,1286,-20
14417745299,14417745298,-1,1953,2393,-20
14418730225,14418730228,3,1838,1639,-20
14420646971,14420646976,5,1909,1406,-20
14422831855,14422831859,4,2221,1779,-20
14427031337,14427031340,3,2459,2533,-20
14428499094,14428499086,-8,1553,7983,-20
14433827970,14433827974,4,1972,1790,-20
14435064207,14435064210,3,2171,1253,-20
14443318984,14443318985,1,1654,1277,-20
14444862860,14444862865,5,1787,1811,-20
14448158878,14448158881,3,1761,1681,-20
14451746066,14451746068,2,1492,1505,-20
14456219003,14456219009,6,1741,1540,-20
14456265117,14456265121,4,1806,1606,-20
14463382678,14463382681,3,1643,1217,-20
14465434303,14465434306,3,1778,1245,-20
14466161961,14466161965,4,3170,1529,-20
14468455219,14468455224,5,1932,1330,-20
14468929515,14468929514,-1,843,1719,-20
14476746871,14476746874,3,1320,1381,-20
14483979773,14483979775,2,1672,1588,-20
14484138274,14484138278,4,1230,1027,-20
14484529346,14484529353,7,1465,1180,-20
14490018922,14490018926,4,2106,1348,-20
14490308539,14490308543,4,1576,1301,-20
14492702302,14492702282,-20,956,1113,-20
14495132349,14495132351,2,1693,1275,-20
14495594409,14495594410,1,1439,1203,-20
14503678809,14503678811,2,946,1367,-20
14504379874,14504379879,5,1894,1632,-20
14504751243,14504751249,6,1381,1518,-20
14506263705,14506263707,2,1910,1337,-20
14518250353,14518250357,4,1626,1581,-20
14522987032,14522987036,4,1847,1343,-20
14525515781,14525515783,2,1338,834,-20
14526037413,14526037415,2,1696,1203,-20
14527180472,14527180475,3,1563,1306,-20
14529851026,14529851031,5,1829,888,-20
14531565920,14531565923,3,1782,1144,-20
14532453101,14532453106,5,2414,1574,-20
14532640429,14532640434,5,1836,1313,-20
14535876682,14535876686,4,2626,1577,-20
14536114079,14536114075,-4,864,1292,-20
14537555649,14537555652,3,1787,1397,-20
14539118097,14539118102,5,4540,1777,-20
14539472413,14539472411,-2,903,336,-20
14543439053,14543439058,5,2055,1548,-20
14544326575,14544326554,-21,1355,921,-20
14546917031,14546917033,2,1394,1448,-20
14547703418,14547703417,-1,1138,2692,-20
14549764863,14549764867,4,1771,1475,-20
14551020808,14551020812,4,1397,1642,-20
14551137773,14551137775,2,1144,1325,-20
14553060430,14553060433,3,1805,1553,-20
14553627099,14553627103,4,1499,1091,-20
14554245337,14554245338,1,1072,1614,-20
14556489150,14556489154,4,2177,1756,-20
14557817995,14557817995,0,1230,1466,-20
14561004061,14561004064,3,1818,1446,-20
14564183746,14564183747,1,2133,1928,-20
14565145558,14565145560,2,1541,1563,-20
14566314028,14566314030,2,1618,1374,-20
14568721682,14568721685,3,1578,1313,-20
14569595779,14569595783,4,1724,1417,-20
14575169241,14575169251,10,18718,34190,-20
14575202696,14575202699,3,1916,1170,-20
14575988734,14575988739,5,2645,1617,-20
14576461153,14576461158,5,1083,1331,-20
14577062733,14577062738,5,2144,1546,-20
14579203107,14579203110,3,1394,1193,-20
14579778718,14579778722,4,1779,1177,-20
14582376242,14582376247,5,1552,787,-20
14582950151,14582950153,2,1504,937,-20
14587845355,14587845361,6,2104,1216,-20
14588322610,14588322611,1,1353,1426,-20
14588771069,14588771071,2,2024,1102,-20
14592774457,14592774461,4,1523,1493,-20
14595678617,14595678618,1,2166,3255,-20
14599112335,14599112338,3,1786,1592,-20
14601625171,14601625174,3,2402,1362,-20
14602664191,14602664193,2,1690,1462,-20
14603945243,14603945248,5,1749,1166,-20
14607041677,14607041681,4,2297,1408,-20
14608290231,14608290235,4,1791,1301,-20
14609407374,14609407377,3,2100,1355,-20
14609579214,14609579196,-18,1058,641,-20
14611468534,14611468537,3,2087,1365,-20
14612806055,14612806058,3,1584,1784,-20
14613915155,14613915157,2,1470,1336,-20
14616439983,14616439987,4,622,636,-20
14616609460,14616609475,15,1572,1380,-20
14617806547,14617806540,-7,1912,10548,-20
14618678407,14618678410,3,699,1046,-20
14621626461,14621626461,0,871,1092,-20
14624754805,14624754810,5,1555,1423,-20
14625450770,14625450773,3,2494,1625,-20
14625642839,14625642846,7,4272,1364,-20
14627677390,14627677393,3,2110,1484,-20
14628393650,14628393653,3,1721,1088,-20
14630186243,14630186247,4,1166,662,-20
14632068671,14632068673,2,1248,1127,-20
14635202460,14635202463,3,1289,1333,-20
14637727319,14637727325,6,2291,1370,-20
14639670193,14639670195,2,1465,1422,-20
14639725757,14639725762,5,2091,1171,-20
14641201798,14641201803,5,1986,1170,-20
14642644418,14642644419,1,1994,1800,-20
14644829851,14644829833,-18,1395,682,-20
14645585087,14645585088,1,1605,1306,-20
14645749895,14645749898,3,1658,1137,-20
14651471664,14651471667,3,1844,1369,-20
14653632591,14653632595,4,1574,818,-20
14653668523,14653668526,3,2796,1965,-20
14657160775,14657160778,3,2298,2360,-20
14658106913,14658106930,17,2417,1370,-20
14658299545,14658299547,2,1386,1838,-20
14660132959,14660132963,4,1780,1793,-20
14663187470,14663187474,4,2488,1572,-20
14667824763,14667824766,3,2680,1425,-20
14669057640,14669057643,3,2854,1612,-20
14671858971,14671858972,1,956,1112,-20
14672028729,14672028731,2,1396,957,-20
14672082678,14672082656,-22,2477,1648,-20
14676410326,14676410327,1,983,1437,-20
14677123674,14677123670,-4,1288,4030,-20
14677186837,14677186840,3,2104,2052,-20
14678132283,14678132287,4,942,1809,-20
14678870414,14678870418,4,2572,2011,-20
14683482030,14683482033,3,1569,1763,-20
14684496579,14684496584,5,1276,976,-20
14685365492,14685365495,3,1629,1503,-20
14691547850,14691547850,0,1211,1219,-20
14695723254,14695723257,3,1578,1107,-20
14698499241,14698499234,-7,1497,4933,-20
14698963241,14698963245,4,1717,1546,-20
14702296499,14702296504,5,1424,1497,-20
14702377490,14702377506,16,1095,1424,-20
14705771524,14705771526,2,1854,1359,-20
14707243990,14707243995,5,1447,1206,-20
14710839564,14710839569,5,2011,1430,-20
14711583366,14711583370,4,2082,2152,-20
14712810182,14712810174,-8,2404,12744,-20
14712854921,14712854925,4,2066,1960,-20
14714346699,14714346702,3,1219,1426,-20
14714372846,14714372849,3,1732,1362,-20
14715925903,14715925908,5,1512,1605,-20
14718145213,14718145217,4,1916,1132,-20
14722416178,14722416182,4,1345,1249,-20
14724058718,14724058722,4,2653,1498,-20
14727861569,14727861571,2,1697,1259,-20
14730903583,14730903586,3,1909,1692,-20
14733049642,14733049645,3,1884,1509,-20
14734332783,14734332786,3,1411,1195,-20
14740042749,14740042752,3,1199,1175,-20
14743842823,14743842826,3,1369,1358,-20
14746354618,14746354623,5,1521,1511,-20
14747571979,14747571975,-4,884,2495,-20
14749451035,14749451039,4,963,1064,-20
14751503602,14751503607,5,2383,1408,-20
14752957806,14752957809,3,2262,1579,-20
14753617425,14753617430,5,1646,1399,-20
14755354482,14755354484,2,2488,1811,-20
14757338535,14757338539,4,958,846,-20
14761891723,14761891726,3,1801,1436,-20
14764066070,14764066073,3,1618,1242,-20
14767322791,14767322793,2,1647,1487,-20
14768512146,14768512150,4,1284,1296,-20
14771224119,14771224124,5,2157,1316,-20
14775649282,14775649284,2,1409,1675,-20
14775876217,14775876219,2,1673,1455,-20
14788974861,14788974866,5,1036,1116,-20
14790006790,14790006794,4,2716,1828,-20
14794655026,14794655031,5,1560,1322,-20
14798361422,14798361425,3,1780,1548,-20
14799144618,14799144621,3,2756,2150,-20
14799238907,14799238911,4,1520,996,-20
14802108006,14802108009,3,2071,1862,-20
14802467696,14802467700,4,2533,1372,-20
14804669837,14804669842,5,1241,1277,-20
14810358006,14810358010,4,1334,561,-20
14811023550,14811023554,4,3192,2342,-20
14812847722,14812847727,5,2237,1622,-20
14814526170,14814526174,4,1983,1656,-20
14817676542,14817676546,4,1907,1517,-20
14819116325,14819116326,1,2218,2191,-20
14819927659,14819927664,5,1498,1564,-20
14826255702,14826255705,3,1693,964,-20
14827160004,14827160006,2,1957,1811,-20
14835497532,14835497535,3,1940,1452,-20
14836646226,14836646229,3,1311,1657,-20
14836758419,14836758416,-3,1193,1901,-20
14839957394,14839957399,5,2091,1233,-20
14842616932,14842616934,2,1938,1236,-20
14844417886,14844417888,2,2214,1786,-20
14845743519,14845743521,2,2510,1582,-20
14847622334,14847622329,-5,802,4525,-20
14848757630,14848757634,4,2715,1502,-20
14852207228,14852207232,4,1809,1384,-20
14860060253,14860060258,5,1830,1141,-20
14861972189,14861972193,4,1577,1140,-20
14863562678,14863562683,5,1757,1318,-20
14870577553,14870577557,4,1377,1389,-20
14873782864,14873782866,2,2828,1954,-20
14875566829,14875566833,4,1194,1107,-20
14876716243,14876716242,-1,1984,2836,-20
14877652738,14877652742,4,1443,1441,-20
14880474763,14880474769,6,1369,1349,-20
14882535443,14882535446,3,1938,1364,-20
14883601292,14883601274,-18,615,925,-20
14883788560,14883788544,-16,1007,1207,-20
14886882373,14886882377,4,2396,1311,-20
14889231450,14889231455,5,1704,954,-20
14889645270,14889645270,0,1422,1873,-20
14891014907,14891014912,5,1982,1552,-20
14893599279,14893599281,2,1682,1094,-20
14896034543,14896034547,4,1851,1434,-20
14897714535,14897714539,4,2714,1805,-20
14900639566,14900639570,4,2404,1276,-20
14900830444,14900830446,2,1787,2198,-20
14902697852,14902697854,2,1768,1227,-20
14904621430,14904621434,4,1317,1358,-20
14906567705,14906567708,3,1146,1245,-20
14907849359,14907849363,4,1665,1271,-20
14909916263,14909916265,2,1058,1018,-20
14914503409,14914503414,5,2254,1303,-20
14916298515,14916298511,-4,974,2205,-20
14919935417,14919935421,4,1555,1210,-20
14920202950,14920202958,8,1489,675,-20
14920918592,14920918593,1,1251,2051,-20
14923386740,14923386733,-7,1526,5367,-20
14925253771,14925253775,4,1658,1068,-20
14927975701,14927975704,3,1463,909,-20
14928033487,14928033475,-12,767,325,-20
14933354166,14933354173,7,2761,1669,-20
14934394374,14934394378,4,2151,1415,-20
14934626054,14934626057,3,2398,1636,-20
14944016209,14944016210,1,2066,1464,-20
14945159423,14945159426,3,1921,1470,-20
14945421460,14945421454,-6,915,5196,-20
14947015240,14947015240,0,1070,1320,-20
14950192994,14950192986,-8,1786,7887,-20
14951047410,14951047414,4,2170,1439,-20
14951606176,14951606159,-17,21060,26104,-20
14957334339,14957334342,3,2349,976,-20
14958146361,14958146362,1,1546,1369,-20
14959270725,14959270729,4,2193,1863,-20
14961214230,14961214216,-14,2552,1729,-20
14961698519,14961698523,4,1558,974,-20
14963886881,14963886865,-16,1468,1134,-20
14964511387,14964511389,2,1969,1514,-20
14967819151,14967819149,-2,1515,2999,-20
14968749272,14968749276,4,1801,1494,-20
14970537347,14970537350,3,1580,1236,-20
14970971066,14970971067,1,1474,1345,-20
14974905383,14974905386,3,1122,855,-20
14979922166,14979922169,3,2048,1275,-20
14981400429,14981400432,3,2206,1261,-20
14982559633,14982559627,-6,3754,12154,-20
14983820646,14983820649,3,1920,1726,-20
14984942559,14984942562,3,2426,1770,-20
14985668536,14985668538,2,1778,1234,-20
14993363521,14993363520,-1,1207,2382,-20
14994074067,14994074072,5,1197,1223,-20
14996476258,14996476262,4,1931,1473,-20
14997108810,14997108815,5,1333,1606,-20
14999539855,14999539855,0,2421,3125,-20
14999574428,14999574430,2,1577,1375,-20
15001287472,15001287476,4,2312,1345,-20
15001366389,15001366393,4,1336,964,-20
15004112086,15004112089,3,1933,1625,-20
15007642188,15007642190,2,1207,1447,-20
15008325776,15008325769,-7,33,1566,-20
15009428299,15009428302,3,2219,1264,-20
15010173126,15010173129,3,2037,1414,-20
15013167437,15013167444,7,1531,1279,-20
15013575340,15013575340,0,1118,1051,-20
15014057924,15014057907,-17,1927,1473,-20
15014640314,15014640319,5,1999,1318,-20
15017680858,15017680862,4,2106,1425,-20
15019698331,15019698335,4,1267,1636,-20
15022462931,15022462935,4,1640,1278,-20
15024922633,15024922635,2,1855,935,-20
15028617877,15028617882,5,1074,744,-20
15029012726,15029012729,3,2923,2065,-20
15029334098,15029334104,6,1495,885,-20
15036756796,15036756801,5,1912,1417,-20
15039628195,15039628198,3,1916,1200,-20
15040248135,15040248140,5,1256,1134,-20
15042985942,15042985941,-1,1838,3098,-20
15043424992,15043424995,3,1738,1093,-20
15044095837,15044095829,-8,1138,7932,-20
15045925905,15045925910,5,2820,1735,-20
15047996210,15047996214,4,2105,1448,-20
15050195005,15050195007,2,1522,1612,-20
15058217530,15058217531,1,1896,1696,-20
15063321190,15063321194,4,2867,2256,-20
15063418113,15063418115,2,1720,1531,-20
15070743670,15070743674,4,1558,957,-20
15071987770,15071987764,-6,1884,6643,-20
15076596494,15076596490,-4,26927,12744,-20
15081256981,15081256986,5,2085,1985,-20
15082557923,15082557927,4,1081,735,-20
15085599070,15085599074,4,2584,2353,-20
15086750295,15086750297,2,1171,1499,-20
15088473982,15088473986,4,2071,1191,-20
15088946705,15088946706,1,1530,1276,-20
15089634041,15089634048,7,1605,1246,-20
15096127473,15096127478,5,2107,1963,-20
15098505469,15098505473,4,1955,1888,-20
15099462533,15099462538,5,1981,1298,-20
15101820734,15101820738,4,1855,1137,-20
15102190749,15102190753,4,2317,1317,-20
15104048072,15104048074,2,2872,2017,-20
15104283685,15104283687,2,1795,1512,-20
15107920933,15107920936,3,903,780,-20
15113923905,15113923909,4,1155,973,-20
15114381960,15114381964,4,1534,1206,-20
15119369558,15119369563,5,1979,1908,-20
15119596126,15119596130,4,2190,1468,-20
15120416758,15120416763,5,1776,958,-20
15124449987,15124449993,6,2660,1344,-20
15125203108,15125203089,-19,2054,1264,-20
15130485399,15130485399,0,894,1568,-20
15132006065,15132006066,1,1975,2849,-20
15133647587,15133647589,2,2595,1761,-20
15136677891,15136677894,3,2324,1593,-20
15138286502,15138286503,1,1363,1845,-20
15139470118,15139470121,3,1612,1779,-20
15140102709,15140102710,1,1400,816,-20
15140167961,15140167965,4,2002,1864,-20
15140608484,15140608502,18,639,1914,-20
15142818136,15142818137,1,1200,993,-20
15143573302,15143573306,4,1276,1228,-20
15147265347,15147265349,2,1788,1518,-20
15149623675,15149623681,6,1742,1121,-20
15151680122,15151680127,5,2313,2311,-20
15154358778,15154358781,3,1769,1628,-20
15154668941,15154668946,5,1910,1336,-20
15155363005,15155363007,2,1973,1677,-20
15156049183,15156049185,2,1536,1187,-20
15158903733,15158903736,3,1758,1629,-20
15159196089,15159196091,2,1841,1197,-20
15162741130,15162741134,4,2084,1542,-20
15163456139,15163456135,-4,3389,40085,-20
15164674080,15164674086,6,1926,1482,-20
15166091817,15166091818,1,1279,821,-20
15166912218,15166912221,3,1176,1074,-20
15170014229,15170014234,5,1698,1226,-20
15171870566,15171870570,4,1472,1360,-20
15172550597,15172550598,1,1392,1196,-20
15173401536,15173401538,2,2102,2115,-20
15175442733,15175442736,3,1678,1556,-20
15179836931,15179836935,4,1664,1047,-20
15180285040,15180285043,3,2164,1655,-20
15183588265,15183588270,5,1343,1310,-20
15183853382,15183853386,4,1828,1622,-20
15185766227,15185766231,4,1154,1208,-20
15199420579,15199420582,3,2073,1520,-20
15201005398,15201005401,3,1768,1916,-20
15202439091,15202439091,0,2041,2641,-20
15203788363,15203788366,3,1254,1009,-20
15205062032,15205062035,3,1622,1315,-20
15205909684,15205909685,1,1671,1480,-20
15206853666,15206853670,4,1187,1236,-20
15206955656,15206955640,-16,1042,513,-20
15209742861,15209742865,4,2145,1875,-20
15210048010,15210048014,4,912,973,-20
15213326137,15213326139,2,1847,1400,-20
15214884734,15214884734,0,1172,1413,-20
15216410808,15216410810,2,1941,1202,-20
15219353263,15219353265,2,2306,1961,-20
15220222770,15220222773,3,1864,1769,-20
15221034439,15221034442,3,1145,1458,-20
15221479717,15221479720,3,2072,1191,-20
15222542714,15222542716,2,1613,1265,-20
15222852625,15222852646,21,353,1515,-20
15227282102,15227282107,5,1518,1053,-20
15230255154,15230255154,0,1573,3224,-20
15231640279,15231640283,4,1858,1707,-20
15231939017,15231939020,3,2446,2138,-20
15232339406,15232339410,4,1586,1397,-20
15233669796,15233669802,6,1947,1410,-20
15234372190,15234372194,4,1976,1572,-20
15236241656,15236241650,-6,2420,6780,-20
15239282715,15239282710,-5,1022,3048,-20
15252250483,15252250479,-4,2334,5724,-20
15255368047,15255368049,2,2202,1655,-20
15256451085,15256451091,6,2240,1247,-20
15258670531,15258670534,3,1278,1172,-20
15259399102,15259399106,4,1638,1099,-20
15259984558,15259984562,4,1704,1893,-20
15260610909,15260610911,2,1903,1600,-20
15260831342,15260831347,5,987,1272,-20
15268063047,15268063049,2,1344,1213,-20
15268118065,15268118070,5,3077,1451,-20
15268723937,15268723943,6,2221,1786,-20
15269039242,15269039246,4,1681,1137,-20
15275509235,15275509225,-10,1135,1074,-20
15278963434,15278963436,2,1402,1484,-20
15280998865,15280998867,2,1809,1341,-20
15281520574,15281520578,4,1920,1323,-20
15281674050,15281674054,4,2818,1300,-20
15282587093,15282587086,-7,1137,3703,-20
15284943109,15284943111,2,2067,1817,-20
15286425393,15286425398,5,1615,1689,-20
15287128053,15287128057,4,2243,1696,-20
15288460915,15288460917,2,2039,1688,-20
15289125113,15289125122,9,94,1180,-20
15290354911,15290354911,0,2257,2225,-20
15291430429,15291430435,6,2487,1832,-20
15291689259,15291689261,2,1193,1216,-20
15292075785,15292075789,4,2068,1149,-20
15293562078,15293562081,3,1746,1611,-20
15295186079,15295186083,4,1169,1396,-20
15295863754,15295863760,6,1945,1529,-20
15302632092,15302632094,2,2071,1304,-20
15306511781,15306511785,4,1843,1503,-20
15306882631,15306882608,-23,1845,1174,-20
15310071538,15310071539,1,2117,1240,-20
15311582571,15311582573,2,1010,877,-20
15312513865,15312513867,2,1822,1311,-20
15316962376,15316962378,2,1147,874,-20
15320710657,15320710659,2,2502,1736,-20
15321048687,15321048690,3,1786,1768,-20
15325148169,15325148174,5,2292,1350,-20
15329163027,15329163029,2,1421,1480,-20
15330478999,15330478993,-6,19953,18981,-20
15330605822,15330605825,3,1691,1851,-20
15332678362,15332678366,4,1729,1360,-20
15336142138,15336142143,5,1734,1690,-20
15339484401,15339484401,0,641,913,-20
15340119834,15340119837,3,1676,1492,-20
15343721174,15343721179,5,2027,1847,-20
15350283168,15350283171,3,2536,1357,-20
15350321310,15350321311,1,2020,1240,-20
15352386706,15352386710,4,2079,1471,-20
15353647922,15353647925,3,2656,1511,-20
15355759421,15355759422,1,1225,1625,-20
15357075330,15357075334,4,2846,2087,-20
15357404502,15357404508,6,2101,1015,-20
15358342361,15358342363,2,2303,1277,-20
15358474358,15358474337,-21,2051,899,-20
15361050517,15361050522,5,1527,1667,-20
15368732862,15368732866,4,1854,1289,-20
15370371673,15370371675,2,1142,1580,-20
15372731738,15372731741,3,2144,1479,-20
15373043479,15373043481,2,1477,1821,-20
15374427249,15374427250,1,2099,1412,-20
15376024529,15376024530,1,2019,1281,-20
15378615310,15378615313,3,1767,1956,-20
15380563115,15380563119,4,1671,1424,-20
15381165651,15381165648,-3,2170,5330,-20
15382257091,15382257094,3,1251,1181,-20
15386993724,15386993726,2,1364,1125,-20
15387403337,15387403338,1,1833,1318,-20
15387901469,15387901473,4,1444,1547,-20
15397585827,15397585826,-1,1195,2635,-20
15401304126,15401304119,-7,977,4717,-20
15401744513,15401744516,3,876,1804,-20
15402915763,15402915765,2,1206,1085,-20
15407652242,15407652247,5,2366,1125,-20
15409143593,15409143597,4,2191,1659,-20
15409617525,15409617529,4,1508,1759,-20
15410081646,15410081650,4,1437,1803,-20
15410191190,15410191191,1,699,707,-20
15410646349,15410646351,2,1774,883,-20
15414169433,15414169435,2,1869,1761,-20
15415077085,15415077089,4,1951,1537,-20
15415501402,15415501387,-15,1960,1118,-20
15416496734,15416496738,4,2059,1332,-20
15417299422,15417299424,2,2470,1449,-20
15420707631,15420707636,5,2222,1601,-20
15420862102,15420862103,1,2001,1400,-20
15420925791,15420925794,3,1000,1055,-20
15421057011,15421057015,4,1656,995,-20
15423212432,15423212435,3,1146,971,-20
15425045151,15425045155,4,1509,1336,-20
15429595962,15429595964,2,1933,1125,-20
15431436393,15431436397,4,2121,1187,-20
15432370294,15432370299,5,2009,1458,-20
15434754859,15434754863,4,2223,1267,-20
15436267893,15436267898,5,1300,1159,-20
15439477074,15439477077,3,1698,1441,-20
15440463747,15440463750,3,1432,1139,-20
15440545357,15440545368,11,1677,1517,-20
15440920060,15440920061,1,1718,1538,-20
15441770002,15441770005,3,2139,1571,-20
15443645943,15443645947,4,1921,1516,-20
15444260734,15444260737,3,2368,1755,-20
15449166311,15449166318,7,1858,1292,-20
15451177622,15451177623,1,1906,1082,-20
15451257191,15451257178,-13,1013,680,-20
15451489350,15451489362,12,2019,1263,-20
15452500316,15452500319,3,1428,1346,-20
15458072076,15458072080,4,1619,1497,-20
15459775810,15459775792,-18,4281,1271,-20
15460025814,15460025815,1,1328,1702,-20
15461696235,15461696238,3,2285,1140,-20
15461937918,15461937926,8,11243,3561,-20
15462065648,15462065652,4,2100,1559,-20
15466690806,15466690809,3,1937,1541,-20
15473240978,15473240981,3,1428,1343,-20
15473715678,15473715681,3,1948,1551,-20
15475258275,15475258279,4,1862,1557,-20
15475380454,15475380458,4,1931,1468,-20
15479463141,15479463145,4,1945,1815,-20
15481068547,15481068530,-17,1504,939,-20
15481830411,15481830413,2,1415,1548,-20
15483296433,15483296436,3,2345,1451,-20
15486117845,15486117846,1,1800,1754,-20
15497468729,15497468730,1,1801,1399,-20
15498188669,15498188675,6,1562,1251,-20
15498992684,15498992690,6,4480,2465,-20
15501032257,15501032259,2,1785,1666,-20
15503664291,15503664295,4,1209,1192,-20
15504462438,15504462441,3,2846,2222,-20
15507035310,15507035314,4,2208,1793,-20
15508731054,15508731059,5,2690,1727,-20
15511645506,15511645509,3,1721,1268,-20
15514438480,15514438481,1,1528,1110,-20
15514686684,15514686664,-20,2351,1576,-20
15521749827,15521749830,3,1389,1145,-20
15523670902,15523670906,4,1737,1510,-20
15524207455,15524207460,5,2167,1660,-20
15524235450,15524235454,4,1567,1137,-20
15524904275,15524904278,3,1363,1081,-20
15530603883,15530603886,3,1794,1196,-20
15530997949,15530997939,-10,656,495,-20
15533015680,15533015683,3,1846,1149,-20
15534526198,15534526199,1,1856,1534,-20
15536032489,15536032494,5,1717,1698,-20
15539204674,15539204679,5,1698,1202,-20
15543731365,15543731366,1,1377,1153,-20
15546245933,15546245937,4,2927,1519,-20
15546350710,15546350711,1,1395,1481,-20
15547798342,15547798343,1,1526,1144,-20
15548435785,15548435788,3,1953,1420,-20
15553725579,15553725583,4,1140,893,-20
15555480146,15555480150,4,2181,1621,-20
15556180186,15556180188,2,1251,1140,-20
15557391821,15557391802,-19,275,276,-20
15559392479,15559392483,4,1594,1800,-20
15561332993,15561332994,1,1487,1036,-20
15563059015,15563059017,2,1967,1370,-20
15564970702,15564970704,2,1370,1350,-20
15566918595,15566918599,4,1766,1621,-20
15568311806,15568311809,3,2176,1579,-20
15570415166,15570415171,5,3350,1116,-20
15571204223,15571204223,0,1459,2074,-20
15572074480,15572074502,22,128,1154,-20
15572842353,15572842362,9,17536,16605,-20
15574389186,15574389167,-19,676,539,-20
15577331708,15577331711,3,2115,1435,-20
15578751045,15578751048,3,1677,1474,-20
15582194252,15582194256,4,2110,1433,-20
15584537128,15584537134,6,1753,1339,-20
15586722962,15586722965,3,1722,1421,-20
15587746955,15587746959,4,1971,1268,-20
15590589319,15590589322,3,1784,1294,-20
15592724341,15592724347,6,1462,1459,-20
15592975143,15592975120,-23,1481,1148,-20
15596303374,15596303378,4,2286,1888,-20
15597122829,15597122832,3,1486,1305,-20
15598815337,15598815341,4,2319,2015,-20
15601222085,15601222090,5,1377,1206,-20
15606361566,15606361569,3,1775,1402,-20
15607426663,15607426662,-1,1119,2283,-20
15611658809,15611658809,0,1876,2263,-20
15612847750,15612847734,-16,2252,683,-20
15613884606,15613884610,4,1331,1221,-20
15615319925,15615319929,4,1821,1462,-20
15617632134,15617632137,3,1454,1396,-20
15619355541,15619355542,1,1711,1119,-20
15624807748,15624807752,4,1364,962,-20
15625240185,15625240189,4,1288,1051,-20
15628787600,15628787602,2,1692,984,-20
15634145737,15634145741,4,1256,998,-20
15636549428,15636549431,3,1924,1486,-20
15637868085,15637868079,-6,1637,7850,-20
15640381122,15640381126,4,1756,1980,-20
15644059078,15644059079,1,1026,932,-20
15650743026,15650743028,2,1695,1135,-20
15653125000,15653125003,3,1989,1273,-20
15654326630,15654326633,3,1292,1159,-20
15656285750,15656285754,4,1863,1182,-20
15656798453,15656798458,5,1629,1492,-20
15657314855,15657314858,3,871,1045,-20
15658556580,15658556582,2,1765,1170,-20
15658894185,15658894185,0,675,198,-20
15659393633,15659393637,4,2040,1591,-20
15662604570,15662604574,4,1868,1581,-20
15663723200,15663723204,4,1893,1415,-20
15667562625,15667562629,4,2019,1562,-20
15671668322,15671668325,3,2547,1811,-20
15671985165,15671985166,1,2009,1980,-20
15673808910,15673808913,3,1008,1387,-20
15674288374,15674288378,4,1988,1879,-20
15676270706,15676270708,2,1563,1182,-20
15687711565,15687711569,4,1925,1281,-20
15688865880,15688865882,2,2710,2187,-20
15691726026,15691726029,3,2096,1468,-20
15691907102,15691907105,3,816,718,-20
15695853152,15695853157,5,2433,1441,-20
15696631356,15696631359,3,1247,975,-20
15699459533,15699459537,4,2715,1644,-20
15701586642,15701586646,4,1783,1755,-20
15701634898,15701634903,5,2561,1476,-20
15701668711,15701668714,3,899,1235,-20
15702860014,15702860019,5,1028,1104,-20
15707879676,15707879680,4,1377,1289,-20
15708671093,15708671098,5,2667,1506,-20
15708779694,15708779695,1,987,990,-20
15709310322,15709310326,4,2101,1569,-20
15710172900,15710172902,2,1288,1689,-20
15717383198,15717383199,1,55,781,-20
15717875701,15717875702,1,3030,1637,-20
15722959501,15722959503,2,854,1215,-20
15726856565,15726856566,1,1591,1396,-20
15736355665,15736355662,-3,928,2767,-20
15738400591,15738400595,4,2497,1761,-20
15738727567,15738727571,4,1991,1806,-20
15738935949,15738935952,3,1781,1987,-20
15740820585,15740820588,3,2555,1422,-20
15740853702,15740853700,-2,1697,3262,-20
15743067406,15743067409,3,2123,2115,-20
15750778942,15750778945,3,1679,1424,-20
15751391113,15751391117,4,2671,1814,-20
15757172741,15757172745,4,1292,1189,-20
15758898178,15758898182,4,2221,1411,-20
15759012240,15759012243,3,1434,1010,-20
15759550234,15759550237,3,1233,1440,-20
15761108743,15761108746,3,2499,1943,-20
15761908056,15761908059,3,1740,1740,-20
15762313636,15762313643,7,4443,1196,-20
15762940158,15762940162,4,2459,1286,-20
15763944063,15763944068,5,1271,1025,-20
15764069045,15764069047,2,1157,1290,-20
15767068938,15767068941,3,1493,1324,-20
15768200818,15768200816,-2,3474,3469,-20
15769322402,15769322405,3,1330,1099,-20
15772998381,15772998385,4,1774,1652,-20
15773176605,15773176587,-18,2416,1704,-20
15774746075,15774746079,4,1686,1175,-20
15774852578,15774852579,1,1259,1647,-20
15779481279,15779481282,3,2100,1629,-20
15779748778,15779748782,4,1718,1144,-20
15781987776,15781987779,3,2198,1809,-20
15782458390,15782458392,2,1966,1608,-20
15791296403,15791296406,3,1099,1947,-20
15792655106,15792655105,-1,1491,2777,-20
15794884078,15794884085,7,3093,1397,-20
15795638826,15795638830,4,1686,1489,-20
15800895319,15800895323,4,2349,1430,-20
15804170841,15804170845,4,2138,1349,-20
15804777790,15804777794,4,2189,2260,-20
15808318670,15808318672,2,1630,1542,-20
15810270404,15810270407,3,1924,1271,-20
15812548991,15812548988,-3,1464,2556,-20
15812647329,15812647331,2,1817,1311,-20
15813298257,15813298261,4,1257,944,-20
15813700042,15813700047,5,2090,1573,-20
15815459624,15815459625,1,2138,2051,-20
15817536954,15817536958,4,2167,1469,-20
15818787566,15818787570,4,1517,1887,-20
15819609382,15819609385,3,1624,1463,-20
15820128631,15820128626,-5,2370,6547,-20
15820619122,15820619126,4,1588,1796,-20
15820645490,15820645495,5,1911,897,-20
15821066339,15821066335,-4,963,3473,-20
15821780246,15821780251,5,2567,1524,-20
15825538746,15825538742,-4,2232,3286,-20
15828768284,15828768287,3,1943,2041,-20
15828897247,15828897246,-1,1201,1869,-20
15833675865,15833675869,4,2042,1212,-20
15833775651,15833775656,5,1754,1147,-20
15837915991,15837915994,3,1885,1431,-20
15840066664,15840066661,-3,1023,1442,-20
15842580982,15842580976,-6,1875,1530,-20
15843831292,15843831294,2,1381,1085,-20
15844119932,15844119935,3,1483,1281,-20
15848289133,15848289138,5,1398,1079,-20
15852952899,15852952902,3,2565,1158,-20
15857377906,15857377910,4,1907,1432,-20
15858400661,15858400662,1,2042,1910,-20
15858511227,15858511215,-12,1299,1484,-20
15859700593,15859700594,1,2654,1723,-20
15859887483,15859887485,2,1776,1566,-20
15860993313,15860993317,4,2099,1190,-20
15861371214,15861371193,-21,1194,800,-20
15863235176,15863235179,3,1543,1118,-20
15866984285,15866984284,-1,18812,7907,-20
15868727859,15868727862,3,1427,990,-20
15869682231,15869682234,3,1577,1227,-20
15871205719,15871205723,4,1730,1334,-20
15871257404,15871257406,2,1587,1487,-20
15872210286,15872210289,3,1803,1402,-20
15875076605,15875076606,1,2858,1972,-20
15876684283,15876684286,3,1974,1619,-20
15877721837,15877721840,3,2712,1565,-20
15882828620,15882828623,3,1730,1648,-20
15884069598,15884069597,-1,1545,1729,-20
15884672258,15884672261,3,1943,1264,-20
15884764937,15884764942,5,2844,1836,-20
15886074291,15886074293,2,1585,867,-20
15887869473,15887869476,3,1684,1200,-20
15891415113,15891415116,3,1490,1539,-20
15891763607,15891763601,-6,2212,8409,-20
15892353906,15892353904,-2,1206,2382,-20
15897288416,15897288418,2,1028,1239,-20
15902778249,15902778254,5,2082,1429,-20
15906523573,15906523576,3,2212,1774,-20
15907005198,15907005199,1,1750,1387,-20
15907970241,15907970244,3,1622,1536,-20
15913093001,15913093004,3,1184,1126,-20
15917428082,15917428085,3,992,990,-20
15921323526,15921323529,3,2059,2056,-20
15922175733,15922175737,4,1164,830,-20
15923386225,15923386228,3,1478,1195,-20
15923572698,15923572701,3,1838,1391,-20
15926342513,15926342517,4,1131,1123,-20
15928528150,15928528155,5,1268,1149,-20
15933243232,15933243234,2,1950,1281,-20
15933685957,15933685962,5,1459,921,-20
15933866286,15933866298,12,813,308,-20
15934340499,15934340481,-18,1360,1380,-20
15934935231,15934935232,1,1768,1427,-20
15944118199,15944118199,0,639,1795,-20
15946067153,15946067157,4,2081,1594,-20
15946246393,15946246394,1,1287,951,-20
15946366624,15946366610,-14,828,324,-20
15948932857,15948932860,3,2297,1807,-20
15950596138,15950596140,2,2080,1748,-20
15952936766,15952936769,3,2420,1627,-20
15957623174,15957623178,4,1541,1337,-20
15962459906,15962459909,3,1137,1031,-20
15963048369,15963048373,4,1653,1466,-20
15966637333,15966637335,2,1694,1568,-20
15966666117,15966666120,3,1753,1033,-20
15967094681,15967094679,-2,1181,2134,-20
15969948226,15969948226,0,1453,1454,-20
15970622273,15970622277,4,2173,1461,-20
15979795002,15979795007,5,2416,1295,-20
15980000314,15980000317,3,2013,1508,-20
15980133199,15980133201,2,1648,1728,-20
15984718367,15984718370,3,2077,1082,-20
15989537514,15989537517,3,1715,1330,-20
15998112502,15998112505,3,2037,1889,-20
15998479539,15998479542,3,1191,1379,-20
16000001774,16000001776,2,2133,1885,-20
16000231585,16000231588,3,2024,1754,-20
16004326750,16004326754,4,1887,797,-20
16004471144,16004471162,18,2859,1221,-20
16006343798,16006343803,5,1895,1842,-20
16006870395,16006870398,3,2180,2211,-20
16008051091,16008051095,4,2080,1781,-20
16010423342,16010423347,5,2114,1614,-20
16011173110,16011173114,4,1986,1798,-20
16016929338,16016929342,4,1587,1531,-20
16019999207,16019999212,5,1958,1152,-20
16022182352,16022182355,3,2297,1662,-20
16026763960,16026763962,2,1402,1193,-20
16027013193,16027013182,-11,23527,50184,-20
16027570434,16027570439,5,1210,1415,-20
16030304229,16030304234,5,2267,1549,-20
16030846994,16030846995,1,1914,2029,-20
16032941644,16032941646,2,1942,1584,-20
16034192467,16034192470,3,1945,1621,-20
16035034732,16035034737,5,1982,1119,-20
16035583779,16035583781,2,1790,1703,-20
16037710761,16037710766,5,1697,1740,-20
16038099468,16038099469,1,1252,2115,-20
16038932230,16038932234,4,1859,1415,-20
16041907469,16041907471,2,1721,1206,-20
16042648166,16042648171,5,11643,7978,-20
16043992670,16043992675,5,1893,1471,-20
16046021721,16046021722,1,1539,1478,-20
16047474065,16047474068,3,1656,1605,-20
16049520711,16049520716,5,501,227,-20
16051155074,16051155078,4,1995,2201,-20
16054310591,16054310594,3,2644,1417,-20
16054470337,16054470342,5,1535,1451,-20
16055854704,16055854706,2,1626,1091,-20
16064103337,16064103338,1,1847,1149,-20
16065013960,16065013962,2,2146,1179,-20
16065752844,16065752838,-6,2128,7732,-20
16066236723,16066236726,3,1504,1267,-20
16067908902,16067908881,-21,890,692,-20
16072144463,16072144467,4,1568,1281,-20
16082741365,16082741369,4,2226,1813,-20
16083285459,16083285463,4,1736,994,-20
16089133893,16089133897,4,1985,1599,-20
16092989162,16092989165,3,1791,1500,-20
16096332183,16096332186,3,1329,1470,-20
16096856573,16096856577,4,1817,1855,-20
16099758417,16099758419,2,1358,1107,-20
16106555533,16106555537,4,1555,1792,-20
16107273811,16107273811,0,1850,1376,-20
16107913577,16107913581,4,2303,1697,-20
16108668759,16108668738,-21,2082,756,-20
16113480554,16113480555,1,800,821,-20
16116505054,16116505059,5,1826,1420,-20
16117250699,16117250703,4,2607,1885,-20
16120159056,16120159042,-14,849,722,-20
16122962543,16122962547,4,2469,1616,-20
16130566165,16130566169,4,2676,2173,-20
16131347431,16131347434,3,2959,1502,-20
16133188692,16133188695,3,1552,1331,-20
16134129114,16134129115,1,1312,1681,-20
16135963706,16135963710,4,1831,1583,-20
16136002209,16136002214,5,1379,967,-20
16141259398,16141259399,1,1948,1433,-20
16145242334,16145242335,1,1842,1529,-20
16146553108,16146553111,3,2911,2368,-20
16147740559,16147740562,3,1128,1311,-20
16148318606,16148318604,-2,1696,2295,-20
16148962593,16148962594,1,1371,1253,-20
16149126650,16149126634,-16,890,357,-20
16153265407,16153265410,3,2076,1822,-20
16157258915,16157258919,4,1509,718,-20
16160864546,16160864550,4,1589,1492,-20
16161907839,16161907841,2,1944,1473,-20
16163711417,16163711421,4,1759,1276,-20
16167623069,16167623069,0,1777,1017,-20
16168762109,16168762113,4,2343,1813,-20
16170767618,16170767622,4,1465,1098,-20
16171978613,16171978614,1,1342,1697,-20
16172218356,16172218339,-17,38393,25084,-20
16173168305,16173168308,3,2631,1680,-20
16177807511,16177807514,3,1471,898,-20
16178580905,16178580915,10,2261,1201,-20
16179768664,16179768668,4,2571,1013,-20
16180358513,16180358515,2,1404,1434,-20
16182826484,16182826486,2,1736,1103,-20
16184322296,16184322299,3,1836,1303,-20
16185901526,16185901531,5,2194,1238,-20
16187661486,16187661491,5,1940,1271,-20
16188709117,16188709114,-3,1360,2224,-20
16193067112,16193067113,1,2005,2044,-20
16193184389,16193184395,6,3797,1783,-20
16194128531,16194128535,4,1493,1770,-20
16195893757,16195893759,2,1542,1642,-20
16198564409,16198564412,3,1148,1142,-20
16203227149,16203227151,2,904,504,-20
16204092063,16204092066,3,1741,1605,-20
16208727201,16208727205,4,1329,1252,-20
16210165178,16210165182,4,2721,2051,-20
16210268744,16210268742,-2,1198,1713,-20
16211831897,16211831903,6,2142,1293,-20
16213715032,16213715035,3,2443,1590,-20
16213830201,16213830204,3,1878,1220,-20
16215003830,16215003835,5,1661,1195,-20
16216800261,16216800264,3,1692,1305,-20
16225769733,16225769735,2,1817,1669,-20
16228528911,16228528915,4,3912,2717,-20
16230592526,16230592521,-5,950,2010,-20
16232233754,16232233755,1,1304,1400,-20
16233208543,16233208546,3,1820,1353,-20
16233553063,16233553069,6,1463,1152,-20
16233966469,16233966473,4,2413,1470,-20
16234606295,16234606297,2,35,1296,-20
16236593952,16236593950,-2,1560,2540,-20
16238492956,16238492958,2,1950,1386,-20
16242244326,16242244330,4,1274,1508,-20
16243496214,16243496219,5,2606,1939,-20
16245280906,16245280909,3,1326,966,-20
16247391509,16247391511,2,1487,1156,-20
16251406865,16251406867,2,1761,1455,-20
16252856822,16252856826,4,1924,1209,-20
16255024735,16255024740,5,1944,1428,-20
16261974235,16261974238,3,1810,907,-20
16263575478,16263575482,4,1674,1349,-20
16265383943,16265383950,7,2466,1215,-20
16268402789,16268402792,3,2054,1253,-20
16269749639,16269749644,5,1589,1426,-20
16270894334,16270894329,-5,980,1839,-20
16271798633,16271798634,1,1005,889,-20
16273580561,16273580562,1,1427,1158,-20
16278933988,16278933990,2,1615,1083,-20
16281283903,16281283906,3,1475,1122,-20
16285850603,16285850606,3,1807,1011,-20
16289539497,16289539509,12,1768,1758,-20
16290520209,16290520213,4,2147,1095,-20
16290795925,16290795945,20,1777,1196,-20
16291114051,16291114057,6,3899,1598,-20
16291433945,16291433947,2,1685,1546,-20
16292682798,16292682804,6,1501,1091,-20
16296562911,16296562915,4,2270,1818,-20
16297553434,16297553437,3,2248,1751,-20
16299252395,16299252397,2,1457,1820,-20
16305654966,16305654968,2,1410,951,-20
16305748226,16305748209,-17,2434,1165,-20
16307009919,16307009926,7,3145,1520,-20
16308494020,16308494023,3,1917,1291,-20
16309130626,16309130629,3,2027,1340,-20
16312597876,16312597879,3,1420,1056,-20
16314333391,16314333394,3,1892,1748,-20
16314557643,16314557649,6,1940,1182,-20
16316472306,16316472311,5,1870,1329,-20
16317856062,16317856063,1,812,985,-20
16318389362,16318389365,3,2313,1619,-20
16318414618,16318414622,4,1701,1344,-20
16318961101,16318961103,2,1279,1169,-20
16319922414,16319922418,4,1423,1598,-20
16320146821,16320146825,4,2515,1642,-20
16320824602,16320824607,5,2376,1287,-20
16322610003,16322610003,0,1120,748,-20
16323058810,16323058814,4,1712,1069,-20
16326213532,16326213535,3,3461,2839,-20
16329712252,16329712255,3,1929,1256,-20
16330086133,16330086133,0,1814,1661,-20
16330839942,16330839936,-6,1263,4062,-20
16332285745,16332285749,4,2364,1960,-20
16332486748,16332486748,0,2373,3167,-20
16333847541,16333847545,4,1923,1837,-20
16334846516,16334846518,2,1483,1270,-20
16336156682,16336156687,5,3808,1606,-20
16338679638,16338679630,-8,1050,3138,-20
16340738516,16340738518,2,1841,1697,-20
16341753053,16341753054,1,1600,1493,-20
16342651066,16342651065,-1,838,974,-20
16343138902,16343138914,12,1525,823,-20
16348011687,16348011690,3,1404,1222,-20
16353345482,16353345486,4,1510,791,-20
16355775616,16355775621,5,1830,1142,-20
16356769997,16356770002,5,2629,1347,-20
16357899507,16357899486,-21,893,2028,-20
16360091087,16360091090,3,2218,1579,-20
16361001594,16361001598,4,2951,1519,-20
16362294746,16362294754,8,1530,1018,-20
16371597457,16371597460,3,1270,977,-20
16374082137,16374082151,14,413,887,-20
16376378007,16376378010,3,2031,1371,-20
16376549389,16376549391,2,1457,1271,-20
16378308965,16378308967,2,1937,1373,-20
16378550174,16378550179,5,2314,1515,-20
16379805648,16379805652,4,1852,2105,-20
16380310159,16380310163,4,1300,1818,-20
16381532035,16381532039,4,2478,1198,-20
16383427552,16383427555,3,2115,1956,-20
16386728783,16386728786,3,1410,1313,-20
16390493893,16390493896,3,1809,1341,-20
16391302783,16391302787,4,1093,1088,-20
16392187913,16392187915,2,2383,1452,-20
16392947353,16392947356,3,2041,2281,-20
16396478261,16396478265,4,1569,1279,-20
16396592198,16396592201,3,2376,1646,-20
16398904296,16398904298,2,1541,1505,-20
16399990254,16399990255,1,2308,1750,-20
16400358931,16400358934,3,1008,724,-20
16402669185,16402669190,5,1923,1797,-20
16403358734,16403358728,-6,758,355,-20
16404394492,16404394497,5,2028,1428,-20
16406071483,16406071486,3,2336,1448,-20
16407614083,16407614085,2,1296,1569,-20
16417454860,16417454863,3,2154,1414,-20
16418671929,16418671930,1,1258,1495,-20
16422082323,16422082327,4,1689,736,-20
16429501937,16429501939,2,1965,1374,-20
16434016731,16434016735,4,1170,1340,-20
16439134627,16439134630,3,1823,1352,-20
16439567210,16439567214,4,1523,1273,-20
16440765991,16440765995,4,1636,1552,-20
16441515646,16441515650,4,1691,1486,-20
16444163462,16444163463,1,1433,890,-20
16446808387,16446808391,4,2001,1590,-20
16448043058,16448043061,3,1787,1501,-20
16448847341,16448847343,2,1949,1936,-20
16450241292,16450241294,2,1037,1245,-20
16452069191,16452069196,5,1996,1128,-20
16452899751,16452899753,2,1759,1321,-20
16460614338,16460614341,3,815,1042,-20
16461479483,16461479486,3,1254,1535,-20
16464748355,16464748358,3,1620,1491,-20
16466421905,16466421909,4,2570,1994,-20
16466683044,16466683047,3,1767,980,-20
16468839922,16468839924,2,1916,1559,-20
16469697167,16469697170,3,2026,1788,-20
16470564008,16470564011,3,1380,1064,-20
16472072413,16472072416,3,1618,1464,-20
16475779201,16475779206,5,1897,1565,-20
16477081140,16477081142,2,1332,1164,-20
16479141795,16479141799,4,1966,1345,-20
16485572662,16485572669,7,2598,1355,-20
16490853101,16490853103,2,1270,1194,-20
16493584649,16493584650,1,1075,1551,-20
16496038115,16496038118,3,1645,819,-20
16497359139,16497359142,3,1372,1335,-20
16498514534,16498514536,2,1323,1145,-20
16499770874,16499770878,4,2001,1723,-20
16503008729,16503008735,6,1120,1214,-20
16503649241,16503649245,4,1963,1569,-20
16504156813,16504156817,4,1595,1150,-20
16504340060,16504340062,2,1514,1165,-20
16505560621,16505560625,4,2235,1315,-20
16506938630,16506938635,5,2524,1481,-20
16507120674,16507120678,4,1559,1405,-20
16507495681,16507495674,-7,1887,5161,-20
16508431769,16508431773,4,2012,1440,-20
16509254164,16509254166,2,1914,1789,-20
16512758330,16512758324,-6,30888,16068,-20
16512852467,16512852471,4,1252,1275,-20
16514257797,16514257802,5,2967,1947,-20
16515012857,16515012861,4,1802,1582,-20
16516686604,16516686613,9,11171,39611,-20
16518879951,16518879954,3,882,929,-20
16521357786,16521357791,5,2077,1450,-20
16522793677,16522793683,6,851,1050,-20
16525490761,16525490762,1,1921,1559,-20
16526960317,16526960322,5,1969,1177,-20
16527353929,16527353929,0,2924,2629,-20
16528279992,16528279996,4,1993,1697,-20
16528962781,16528962786,5,802,986,-20
16530997242,16530997248,6,1543,1406,-20
16537213005,16537213009,4,1557,1370,-20
16538209399,16538209400,1,901,1356,-20
16540869186,16540869189,3,1699,1556,-20
16541062759,16541062763,4,1780,1508,-20
16542862510,16542862513,3,2372,1451,-20
16544116831,16544116838,7,1331,776,-20
16546032870,16546032862,-8,820,2935,-20
16548098197,16548098198,1,823,1415,-20
16549273535,16549273538,3,1769,1738,-20
16550215119,16550215133,14,232,757,-20
16550367851,16550367853,2,1368,1451,-20
16553571974,16553571959,-15,877,380,-20
16554395894,16554395898,4,1381,1184,-20
16555137490,16555137495,5,1516,1152,-20
16561795571,16561795574,3,1986,1170,-20
16562452448,16562452453,5,1775,1255,-20
16563188925,16563188925,0,1242,1743,-20
16563574351,16563574354,3,1130,1388,-20
16566938607,16566938614,7,15105,22034,-20
16567314866,16567314868,2,1639,1833,-20
16570363274,16570363278,4,1102,1003,-20
16571063094,16571063116,22,2283,1402,-20
16571688870,16571688873,3,1388,1607,-20
16574220934,16574220938,4,1921,1245,-20
16575508214,16575508210,-4,1880,1883,-20
16579342884,16579342887,3,2180,1782,-20
16580948181,16580948183,2,1607,1450,-20
16581610260,16581610265,5,2470,1417,-20
16584306721,16584306718,-3,2590,7857,-20
16585750537,16585750537,0,1079,1148,-20
16591786490,16591786493,3,1612,1302,-20
16599443519,16599443523,4,1858,1481,-20
16606452107,16606452112,5,2214,1428,-20
16609656159,16609656162,3,2540,1263,-20
16609868439,16609868440,1,1310,969,-20
16613014742,16613014745,3,2081,1310,-20
16616076029,16616076030,1,2008,1409,-20
16624988110,16624988114,4,1688,1625,-20
16629153593,16629153591,-2,1741,2400,-20
16629884443,16629884447,4,1160,1195,-20
16630693401,16630693405,4,3268,1657,-20
16631561007,16631561010,3,2007,1417,-20
16635070950,16635070954,4,2194,1484,-20
16636364299,16636364303,4,1328,887,-20
16636649132,16636649137,5,2058,1399,-20
16637701309,16637701310,1,1635,1250,-20
16637888649,16637888651,2,1467,1140,-20
16640200394,16640200398,4,1928,1218,-20
16641373595,16641373594,-1,1602,1831,-20
16644824150,16644824154,4,1640,974,-20
16645083830,16645083810,-20,1867,1218,-20
16645656323,16645656325,2,1694,1799,-20
16646570853,16646570856,3,2069,1588,-20
16650858888,16650858892,4,174,126,-20
16651848529,16651848531,2,1777,914,-20
16653040935,16653040936,1,1285,1314,-20
16655509188,16655509190,2,1920,1259,-20
16656133367,16656133369,2,1196,1169,-20
16657465765,16657465770,5,2012,1378,-20
16657952527,16657952514,-13,743,262,-20
16661913146,16661913150,4,794,983,-20
16662296761,16662296762,1,966,805,-20
16662385835,16662385839,4,1626,1249,-20
16663888682,16663888686,4,1941,1681,-20
16665834648,16665834651,3,1375,1078,-20
16666934601,16666934580,-21,1454,1291,-20
16668194055,16668194055,0,180,713,-20
16669038547,16669038551,4,2141,1738,-20
16670370042,16670370046,4,2216,1653,-20
16676951171,16676951173,2,1738,1956,-20
16677709211,16677709216,5,4679,2865,-20
16681297013,16681297019,6,1506,735,-20
16681964003,16681964007,4,1222,999,-20
16684162265,16684162267,2,1837,1031,-20
16684715399,16684715403,4,1618,1515,-20
16686472266,16686472251,-15,856,367,-20
16687284252,16687284253,1,1710,1190,-20
16689093664,16689093667,3,1935,1870,-20
16689640091,16689640093,2,1795,1522,-20
16690062378,16690062382,4,2012,1267,-20
16690113597,16690113599,2,1686,1083,-20
16690287411,16690287413,2,1956,1208,-20
16690704931,16690704914,-17,1503,7282,-20
16691563978,16691563980,2,1641,1121,-20
16693771229,16693771233,4,2404,1463,-20
16695835582,16695835586,4,2131,1748,-20
16696706558,16696706563,5,2030,1080,-20
16699197172,16699197178,6,6305,18262,-20
16700726845,16700726827,-18,2473,1452,-20
16703350967,16703350979,12,13264,30380,-20
16704016604,16704016607,3,1654,1136,-20
16705880915,16705880918,3,1402,1373,-20
16709404613,16709404618,5,1416,1217,-20
16710399765,16710399765,0,1356,2526,-20
16711380627,16711380621,-6,1456,4824,-20
16711985233,16711985238,5,1960,1346,-20
16721527450,16721527457,7,2330,1204,-20
16721673245,16721673246,1,1669,1257,-20
16722095236,16722095241,5,1694,1566,-20
16723265254,16723265259,5,1371,991,-20
16723483538,16723483541,3,1897,1659,-20
16733040295,16733040298,3,1065,1408,-20
16733439106,16733439108,2,1832,1426,-20
16734592633,16734592637,4,1759,1011,-20
16737384824,16737384827,3,1971,1105,-20
16739152402,16739152406,4,1739,1268,-20
16741143123,16741143130,7,1675,976,-20
16742929298,16742929290,-8,17516,17585,-20
16743251910,16743251916,6,2569,1853,-20
16749908618,16749908621,3,1942,1546,-20
16752303758,16752303762,4,1368,1505,-20
16752643861,16752643864,3,1568,1066,-20
16756203994,16756203998,4,2896,1981,-20
16758398269,16758398272,3,1665,1109,-20
16761382096,16761382098,2,1507,919,-20
16762325650,16762325654,4,1996,1458,-20
16765432187,16765432193,6,2655,1283,-20
16767428089,16767428094,5,1557,1383,-20
16769711814,16769711815,1,1726,1185,-20
16771036027,16771036029,2,897,1454,-20
16773952590,16773952591,1,1984,1302,-20
16776656024,16776656029,5,2147,1187,-20
16777738317,16777738320,3,1490,1478,-20
16778326986,16778326990,4,1689,1090,-20
16780924382,16780924385,3,2022,1592,-20
16781299985,16781299989,4,1903,1452,-20
16781551334,16781551337,3,2014,1064,-20
16783340555,16783340559,4,1137,752,-20
16786269070,16786269074,4,2496,1364,-20
16786898530,16786898532,2,1795,1222,-20
16788295157,16788295158,1,1580,1042,-20
16788962573,16788962575,2,1245,897,-20
16789162374,16789162377,3,918,1280,-20
16793788542,16793788546,4,2061,812,-20
16795537334,16795537335,1,17358,22425,-20
16801885894,16801885897,3,1546,843,-20
16803323485,16803323487,2,998,1129,-20
16805348187,16805348192,5,1392,1275,-20
16805395374,16805395356,-18,942,654,-20
16809189384,16809189386,2,2212,1315,-20
16811164275,16811164279,4,1320,1024,-20
16811458488,16811458492,4,2192,1209,-20
16813557866,16813557861,-5,1055,3227,-20
16814122193,16814122195,2,1953,1401,-20
16814886087,16814886089,2,1901,1560,-20
16816174811,16816174810,-1,1769,2115,-20
16817127922,16817127926,4,2212,1619,-20
16817769313,16817769318,5,1748,1284,-20
16819418321,16819418326,5,1204,1350,-20
16823245910,16823245913,3,1419,1268,-20
16823909903,16823909906,3,2258,1130,-20
16824376218,16824376219,1,1863,1432,-20
16827870433,16827870435,2,2159,1801,-20
16828091661,16828091665,4,1332,966,-20
16829403178,16829403180,2,2016,2025,-20
16829881596,16829881587,-9,44871,13062,-20
16831184976,16831184981,5,2460,1495,-20
16832260551,16832260556,5,1540,1320,-20
16833537936,16833537941,5,3010,1467,-20
16835478855,16835478858,3,1409,2009,-20
16838637001,16838637007,6,3793,2278,-20
16839129413,16839129415,2,2326,1860,-20
16839454661,16839454666,5,1504,902,-20
16840928393,16840928394,1,1472,938,-20
16841153473,16841153458,-15,992,390,-20
16842209997,16842210001,4,1266,1642,-20
16843024661,16843024665,4,1803,1143,-20
16843412406,16843412387,-19,980,666,-20
16845386609,16845386610,1,1365,989,-20
16849712191,16849712195,4,1516,1653,-20
16852178395,16852178399,4,2056,1205,-20
16852665315,16852665318,3,2192,1330,-20
16854772471,16854772472,1,1263,1420,-20
16857431438,16857431442,4,1927,1324,-20
16857473876,16857473870,-6,1422,4858,-20
16858353179,16858353184,5,2402,1441,-20
16859011294,16859011298,4,2104,1346,-20
16859412671,16859412668,-3,661,2100,-20
16863722131,16863722127,-4,1068,3458,-20
16865478362,16865478365,3,1592,1414,-20
16868932367,16868932371,4,2178,1750,-20
16869292881,16869292897,16,357,1954,-20
16873009808,16873009811,3,2453,1614,-20
16875909777,16875909779,2,1710,1152,-20
16879379678,16879379680,2,1593,1793,-20
16881085402,16881085405,3,1810,1285,-20
16883534282,16883534278,-4,1616,4263,-20
16884136287,16884136291,4,2037,1130,-20
16884378449,16884378453,4,1379,1133,-20
16884471900,16884471882,-18,1758,576,-20
16888532189,16888532192,3,2546,2266,-20
16890372275,16890372278,3,1322,1439,-20
16891674978,16891674982,4,1741,927,-20
16892445687,16892445691,4,2081,1127,-20
16895878906,16895878910,4,1125,633,-20
16899861805,16899861805,0,1270,2190,-20
16901631233,16901631235,2,1124,1164,-20
16901774867,16901774872,5,1099,1143,-20
16902569883,16902569886,3,2122,1485,-20
16907042830,16907042833,3,1522,996,-20
16910105770,16910105771,1,2020,1357,-20
16910226341,16910226343,2,1284,1220,-20
16914400766,16914400757,-9,41242,14107,-20
16914896010,16914896015,5,1854,1201,-20
16917210113,16917210115,2,1263,994,-20
16918115670,16918115674,4,1672,1684,-20
16918485602,16918485584,-18,1789,790,-20
16920959566,16920959569,3,1911,1396,-20
16923284298,16923284298,0,1709,1636,-20
16924583153,16924583158,5,2324,1316,-20
16924767806,16924767786,-20,1466,1260,-20
16926786738,16926786742,4,2313,1696,-20
16929583391,16929583396,5,2605,1219,-20
16929993965,16929993970,5,2133,1136,-20
16932820099,16932820102,3,1402,1156,-20
16936428634,16936428638,4,1309,1099,-20
16938840673,16938840674,1,1669,892,-20
16944221518,16944221521,3,2422,1571,-20
16944438594,16944438597,3,2223,1575,-20
16950913803,16950913807,4,2211,1570,-20
16951703261,16951703265,4,1735,1251,-20
16954177297,16954177301,4,1638,1170,-20
16955272258,16955272261,3,1788,1726,-20
16959695146,16959695148,2,1738,1296,-20
16962128002,16962128006,4,2937,2076,-20
16963032398,16963032402,4,926,964,-20
16965124067,16965124070,3,2470,1606,-20
16965609357,16965609361,4,1977,1266,-20
16966343257,16966343259,2,1650,1347,-20
16968934802,16968934804,2,1437,1771,-20
16969226528,16969226535,7,2107,1468,-20
16969334702,16969334699,-3,784,319,-20
16969950861,16969950865,4,1545,1405,-20
16970365337,16970365338,1,2179,2325,-20
16972940011,16972940014,3,1685,1073,-20
16974961529,16974961533,4,3258,1904,-20
16975157137,16975157139,2,2010,1539,-20
16976301961,16976301964,3,1766,1361,-20
16977469422,16977469423,1,1625,1347,-20
16979021606,16979021609,3,1522,1809,-20
16991036890,16991036894,4,2587,1555,-20
16991254697,16991254699,2,995,1268,-20
16991572910,16991572915,5,1835,1315,-20
16992038822,16992038825,3,1775,1523,-20
16992550577,16992550580,3,1320,900,-20
16993671635,16993671639,4,2549,1619,-20
16994245863,16994245866,3,1265,1140,-20
16995838194,16995838196,2,1893,1245,-20
16997797614,16997797614,0,1369,1280,-20
16998378123,16998378125,2,1447,1360,-20
17000233134,17000233135,1,975,928,-20
17000487826,17000487830,4,1711,1113,-20
17003497949,17003497953,4,2030,1993,-20
17005298328,17005298330,2,1493,862,-20
17006144153,17006144150,-3,24598,7734,-20
17006188630,17006188631,1,1985,1367,-20
17007657402,17007657408,6,3271,840,-20
17008526649,17008526651,2,1889,1314,-20
17008654273,17008654275,2,1934,1503,-20
17009629838,17009629842,4,2006,1714,-20
17010462298,17010462301,3,2418,1530,-20
17013376786,17013376789,3,1236,1311,-20
17025419257,17025419259,2,1330,1375,-20
17028569673,17028569677,4,2309,1415,-20
17036936720,17036936721,1,1162,1208,-20
17039523746,17039523750,4,1805,1185,-20
17039821217,17039821221,4,2157,1332,-20
17040905526,17040905529,3,2298,1321,-20
17042335307,17042335311,4,2082,1552,-20
17045191985,17045191988,3,2158,1814,-20
17046936878,17046936881,3,1436,1300,-20
17048056336,17048056336,0,99,2178,-20
17048350658,17048350662,4,2112,1145,-20
17051263439,17051263439,0,1126,1228,-20
17052272690,17052272693,3,2411,1733,-20
17053533101,17053533102,1,1446,933,-20
17055268352,17055268355,3,1676,812,-20
17055982524,17055982530,6,1164,1266,-20
17056824338,17056824342,4,2498,1797,-20
17060570962,17060570967,5,1746,1174,-20
17064607094,17064607099,5,1841,1072,-20
17064747570,17064747563,-7,1414,5875,-20
17065383105,17065383106,1,1106,1292,-20
17069054014,17069054019,5,1997,1268,-20
17069915887,17069915892,5,2452,1687,-20
17076895302,17076895307,5,2021,1925,-20
17077585595,17077585601,6,2709,1417,-20
17080792394,17080792397,3,1478,1175,-20
17085739843,17085739847,4,2122,1931,-20
17086207487,17086207490,3,2113,1058,-20
17086935731,17086935737,6,2374,1514,-20
17090070698,17090070699,1,1761,1414,-20
17092754493,17092754495,2,1291,1164,-20
17101469866,17101469871,5,2596,1568,-20
17101817526,17101817526,0,2142,1617,-20
17103027262,17103027265,3,2042,1447,-20
17104731078,17104731083,5,2216,1308,-20
17107203271,17107203275,4,1930,1751,-20
17108451272,17108451272,0,1048,873,-20
17112262230,17112262235,5,1145,1004,-20
17112468016,17112468032,16,1955,860,-20
17116157075,17116157080,5,1620,1285,-20
17118906136,17118906131,-5,1167,7591,-20
17119383486,17119383490,4,1645,1201,-20
17119907330,17119907334,4,1060,1025,-20
17120700570,17120700574,4,1887,1582,-20
17121353262,17121353267,5,1471,934,-20
17123154663,17123154666,3,2565,2026,-20
17124325225,17124325227,2,1706,1339,-20
17125977120,17125977123,3,2038,1433,-20
17126643343,17126643346,3,2656,1564,-20
17127235450,17127235454,4,1239,1396,-20
17127718802,17127718808,6,1932,1429,-20
17130185114,17130185114,0,1438,1747,-20
17130725666,17130725670,4,2009,1378,-20
17131002025,17131002027,2,1467,1116,-20
17131579637,17131579639,2,1704,1322,-20
17133844314,17133844307,-7,1469,8420,-20
17134483566,17134483571,5,2257,1264,-20
17134531249,17134531250,1,1782,1449,-20
17135848273,17135848274,1,323,1019,-20
17137713046,17137713045,-1,867,1108,-20
17137996689,17137996690,1,2019,1493,-20
17140271538,17140271541,3,1833,1345,-20
17141087113,17141087117,4,1703,1004,-20
17141492807,17141492788,-19,1389,990,-20
17144832918,17144832920,2,1579,1350,-20
17148605071,17148605074,3,1449,1070,-20
17150304167,17150304170,3,1161,1064,-20
17151338530,17151338534,4,1618,1012,-20
17153279542,17153279547,5,2020,1365,-20
17154377942,17154377946,4,1870,1773,-20
17154979485,17154979489,4,1407,1540,-20
17155615629,17155615631,2,1137,1520,-20
17158082449,17158082455,6,1392,1026,-20
17160965579,17160965582,3,1393,1303,-20
17161285651,17161285653,2,713,630,-20
17161850948,17161850952,4,119,1288,-20
17163274049,17163274053,4,941,1093,-20
17166550122,17166550125,3,1417,1179,-20
17168202977,17168202971,-6,2033,7883,-20
17169103679,17169103685,6,3952,1999,-20
17169752570,17169752572,2,1297,1512,-20
17171430398,17171430382,-16,1553,1305,-20
17174145572,17174145574,2,2047,1325,-20
17174835851,17174835853,2,1645,1196,-20
17177726641,17177726645,4,1854,1974,-20
17178854725,17178854726,1,1362,1882,-20
17180449785,17180449785,0,1088,1075,-20
17183596401,17183596403,2,1845,1612,-20
17184319311,17184319314,3,2041,2046,-20
17187317650,17187317658,8,2574,1257,-20
17188608242,17188608247,5,2254,1588,-20
17189692307,17189692310,3,1894,1454,-20
17189968917,17189968920,3,18421,15310,-20
17190951593,17190951601,8,3280,1604,-20
17191813677,17191813679,2,2040,991,-20
17194829996,17194829998,2,1615,1110,-20
17195995994,17195995995,1,510,370,-20
17197654663,17197654667,4,1265,1054,-20
17198318885,17198318890,5,1767,1118,-20
17198563323,17198563331,8,1469,888,-20
17201249326,17201249329,3,2055,1568,-20
17203382729,17203382733,4,1395,1067,-20
17204276935,17204276940,5,1692,1788,-20
17204329768,17204329770,2,2499,1960,-20
17209602510,17209602513,3,1496,1201,-20
17213546182,17213546187,5,2383,1170,-20
17218448604,17218448607,3,994,1030,-20
17220961378,17220961382,4,2292,1856,-20
17224283559,17224283563,4,1435,1526,-20
17226424623,17226424628,5,1588,1502,-20
17226594853,17226594857,4,1988,1214,-20
17227012202,17227012206,4,2105,1265,-20
17227147563,17227147567,4,1379,1330,-20
17227630762,17227630765,3,1694,1853,-20
17231943617,17231943619,2,1235,1005,-20
17233157886,17233157888,2,1975,1235,-20
17235141087,17235141090,3,1392,1164,-20
17240478326,17240478326,0,1869,1380,-20
17244806747,17244806750,3,1746,1061,-20
17245459605,17245459609,4,1545,1856,-20
17248562092,17248562103,11,15151,19773,-20
17250293938,17250293943,5,2368,1456,-20
17252287802,17252287785,-17,856,328,-20
17252986161,17252986162,1,1521,1326,-20
17256399467,17256399470,3,1626,1391,-20
17257332198,17257332197,-1,722,1547,-20
17258104274,17258104278,4,1826,1023,-20
17270726546,17270726546,0,3051,2781,-20
17270893824,17270893827,3,2067,1735,-20
17272732394,17272732400,6,16704,18442,-20
17273691923,17273691926,3,2592,2073,-20
17275655955,17275655959,4,1341,1265,-20
17284150323,17284150325,2,1642,1479,-20
17289605182,17289605187,5,1147,858,-20
17291223053,17291223049,-4,1475,5055,-20
17292098644,17292098649,5,1426,1755,-20
17293990771,17293990774,3,2494,1700,-20
17296410198,17296410186,-12,45577,14965,-20
17298333677,17298333686,9,18706,22540,-20
17300276018,17300276022,4,1650,1261,-20
17302975037,17302975041,4,1747,1300,-20
17304459587,17304459590,3,1025,1106,-20
17305883769,17305883775,6,1767,1467,-20
17309015791,17309015794,3,1856,1419,-20
17309255914,17309255920,6,1511,1435,-20
17311365497,17311365498,1,2256,1457,-20
17313049754,17313049756,2,1020,1659,-20
17314102801,17314102805,4,1660,1057,-20
17314687864,17314687868,4,2207,1821,-20
17316943005,17316943006,1,1562,1974,-20
17318456151,17318456158,7,2132,1021,-20
17320925879,17320925884,5,1728,1149,-20
17321794190,17321794195,5,1553,842,-20
17322384496,17322384499,3,1682,1156,-20
17322547421,17322547425,4,1532,1364,-20
17323218105,17323218107,2,2171,1262,-20
17325515908,17325515911,3,1861,1138,-20
17334849390,17334849376,-14,1216,1836,-20
17340115071,17340115066,-5,1177,2324,-20
17341138644,17341138647,3,1767,1202,-20
17343780963,17343780967,4,1527,1408,-20
17344434209,17344434211,2,1813,1025,-20
17347726929,17347726933,4,1599,1387,-20
17348522951,17348522954,3,1447,799,-20
17349770781,17349770785,4,1506,1320,-20
17350180254,17350180262,8,2085,1574,-20
17352671425,17352671437,12,2049,1210,-20
17353833682,17353833683,1,1123,1170,-20
17354831267,17354831270,3,1575,1181,-20
17359753514,17359753521,7,2752,1230,-20
17361279046,17361279048,2,2265,1429,-20
17361453843,17361453850,7,1350,642,-20
17362809677,17362809681,4,1304,1101,-20
17364467187,17364467192,5,1321,1189,-20
17365786646,17365786650,4,991,1001,-20
17366143817,17366143818,1,1831,1927,-20
17367275338,17367275345,7,2832,1465,-20
17367434783,17367434786,3,1783,1732,-20
17368259817,17368259819,2,1770,1376,-20
17371330606,17371330608,2,1776,1234,-20
17375709521,17375709526,5,1736,1656,-20
17377468041,17377468042,1,1779,1045,-20
17381585232,17381585235,3,1604,1051,-20
17381932410,17381932392,-18,701,247,-20
17385309430,17385309434,4,1416,1154,-20
17385944161,17385944165,4,1202,1511,-20
17386736698,17386736699,1,1653,919,-20
17389811441,17389811437,-4,1964,2870,-20
17391201494,17391201495,1,1563,1537,-20
17392884638,17392884642,4,1845,1103,-20
17395716553,17395716553,0,1416,1253,-20
17397853520,17397853522,2,1758,1000,-20
17398404954,17398404957,3,1920,1414,-20
17398957041,17398957042,1,1101,1762,-20
17399740136,17399740158,22,273,1957,-20
17402063734,17402063736,2,1277,1613,-20
17402647037,17402647039,2,1935,1396,-20
17403358481,17403358485,4,2541,1865,-20
17411905434,17411905439,5,1733,1286,-20
17414993694,17414993699,5,1349,822,-20
17417771591,17417771593,2,2119,1015,-20
17417889783,17417889794,11,1969,1134,-20
17418264459,17418264463,4,1541,1376,-20
17421380944,17421380946,2,1542,1010,-20
17421625618,17421625622,4,2308,1325,-20
17422112159,17422112163,4,2193,1152,-20
17422458766,17422458771,5,2120,1436,-20
17422598844,17422598856,12,1234,1181,-20
17424256546,17424256551,5,1523,1364,-20
17427452101,17427452100,-1,1132,1338,-20
17427947527,17427947530,3,1660,1368,-20
17428766877,17428766874,-3,1438,1757,-20
17439720997,17439720998,1,1550,921,-20
17439934495,17439934473,-22,1373,1083,-20
17440038298,17440038302,4,2215,1912,-20
17446785985,17446785978,-7,1522,809,-20
17448353054,17448353059,5,1817,1355,-20
17450120071,17450120069,-2,1071,1217,-20
17464266142,17464266146,4,1836,1238,-20
17465303586,17465303583,-3,820,1114,-20
17465967398,17465967401,3,1821,1170,-20
17467297115,17467297119,4,1068,1014,-20
17471114742,17471114746,4,2548,1848,-20
17476374174,17476374176,2,1391,1434,-20
17476733347,17476733349,2,1610,1288,-20
17485574694,17485574715,21,1321,1344,-20
17487478616,17487478622,6,3101,1098,-20
17495242047,17495242050,3,1906,1845,-20
17501679659,17501679662,3,2255,1286,-20
17502441354,17502441358,4,1577,1211,-20
17506850455,17506850460,5,19564,57229,-20
17512207919,17512207921,2,45878,3971,-20
17514458191,17514458194,3,1479,1646,-20
17514749738,17514749721,-17,1071,956,-20
17516285865,17516285858,-7,890,5179,-20
17517209312,17517209318,6,2041,1284,-20
17521471062,17521471065,3,3283,1937,-20
17522470862,17522470862,0,1000,1202,-20
17526020841,17526020834,-7,1578,7326,-20
17528255474,17528255478,4,2683,1743,-20
17531222409,17531222413,4,1687,1491,-20
17532345248,17532345251,3,1922,1658,-20
17535508133,17535508138,5,1678,1291,-20
17538724802,17538724805,3,1545,1223,-20
17538856030,17538856010,-20,1776,1175,-20
17539759933,17539759937,4,1420,1173,-20
17546394886,17546394890,4,1485,1333,-20
17548714419,17548714421,2,1439,1025,-20
17550640385,17550640385,0,3563,4138,-20
17556092106,17556092114,8,3451,1991,-20
17560884053,17560884055,2,2048,1276,-20
17567760185,17567760187,2,3385,3131,-20
17573026027,17573026030,3,2304,1480,-20
17575244790,17575244790,0,1101,1552,-20
17575418683,17575418666,-17,2188,1248,-20
17575783660,17575783662,2,2340,1351,-20
17579564738,17579564743,5,1404,806,-20
17580847980,17580847982,2,2211,1478,-20
17586162266,17586162270,4,2333,1873,-20
17586812850,17586812854,4,1760,1271,-20
17587946486,17587946490,4,2035,1425,-20
17589863249,17589863250,1,2243,2235,-20
17590376490,17590376494,4,1810,1328,-20
17592240969,17592240974,5,4094,1460,-20
17592809473,17592809477,4,2310,1700,-20
17593518446,17593518458,12,1871,1295,-20
17596213337,17596213342,5,1613,1186,-20
17598235226,17598235228,2,1724,891,-20
17602319302,17602319307,5,2304,1389,-20
17606641807,17606641809,2,1199,954,-20
17608425719,17608425725,6,1822,1598,-20
17609057214,17609057217,3,1894,1614,-20
17611830818,17611830821,3,1705,1271,-20
17615135590,17615135595,5,1992,1954,-20
17615447962,17615447963,1,4748,3931,-20
17616850434,17616850442,8,18758,46290,-20
17617747369,17617747374,5,2067,1908,-20
17618505419,17618505423,4,3209,1609,-20
17618803342,17618803346,4,2303,1868,-20
17620560956,17620560959,3,1784,1374,-20
17623987257,17623987261,4,2137,1771,-20
17632463522,17632463526,4,2403,1436,-20
17632720409,17632720411,2,1205,1358,-20
17636565563,17636565567,4,1629,1499,-20
17639731088,17639731092,4,1740,1610,-20
17646619149,17646619150,1,1673,1819,-20
17647988003,17647988007,4,2054,1406,-20
17649013280,17649013283,3,2321,1438,-20
17649712706,17649712709,3,1379,702,-20
17650244086,17650244089,3,2436,1659,-20
17651282101,17651282104,3,2367,1556,-20
17651399423,17651399427,4,1535,1181,-20
17651785925,17651785930,5,1425,1364,-20
17652415491,17652415494,3,2206,1648,-20
17653243906,17653243910,4,1861,1831,-20
17653489977,17653489979,2,1757,1123,-20
17658594304,17658594306,2,1121,1077,-20
17659387261,17659387265,4,1393,1289,-20
17659789253,17659789254,1,1835,1681,-20
17661088046,17661088050,4,2028,1581,-20
17664747166,17664747170,4,1710,1804,-20
17671139669,17671139670,1,2099,1237,-20
17677270407,17677270411,4,2244,1118,-20
17677783710,17677783715,5,1517,1421,-20
17678335004,17678335007,3,2093,1519,-20
17679174858,17679174854,-4,2867,7482,-20
17680331975,17680331977,2,1136,677,-20
17681516162,17681516164,2,1320,2079,-20
17681774277,17681774281,4,1595,1775,-20
17683248766,17683248772,6,1157,1064,-20
17685570994,17685570999,5,2150,1814,-20
17699674626,17699674629,3,1656,1583,-20
17700922382,17700922385,3,2042,1604,-20
17702043711,17702043716,5,2082,1618,-20
17705141003,17705141004,1,1841,1694,-20
17705795378,17705795379,1,1519,1188,-20
17706182204,17706182187,-17,1777,1397,-20
17706386422,17706386428,6,1879,1787,-20
17712833956,17712833958,2,1971,1417,-20
17713014027,17713014032,5,2415,1710,-20
17717344179,17717344183,4,1700,1504,-20
17717858382,17717858386,4,1264,780,-20
17719709996,17719709998,2,2208,1202,-20
17721953282,17721953286,4,2158,1568,-20
17723741118,17723741122,4,1662,1448,-20
17727313806,17727313810,4,1772,1511,-20
17731056197,17731056205,8,2847,1190,-20
17734584358,17734584358,0,1353,1851,-20
17735351172,17735351174,2,1623,1216,-20
17737430093,17737430094,1,1446,1327,-20
17740130614,17740130616,2,1649,1104,-20
17740211953,17740211958,5,1806,1373,-20
17740471646,17740471658,12,1151,1393,-20
17743119638,17743119642,4,1652,1344,-20
17744218400,17744218406,6,3399,1620,-20
17744251449,17744251447,-2,1448,1160,-20
17744972160,17744972163,3,2363,1529,-20
17746075159,17746075149,-10,1187,2175,-20
17747332072,17747332075,3,1836,1370,-20
17747431941,17747431946,5,2140,1447,-20
17748216123,17748216125,2,1078,594,-20
17751979110,17751979128,18,915,1160,-20
17757302810,17757302814,4,1403,1282,-20
17761813838,17761813841,3,1583,2164,-20
17764074441,17764074446,5,1307,1315,-20
17765068140,17765068142,2,2288,1366,-20
17765859570,17765859573,3,2310,1487,-20
17767032847,17767032849,2,1206,966,-20
17769578297,17769578301,4,2199,1687,-20
17769678197,17769678198,1,1765,1538,-20
17769829950,17769829955,5,1720,1352,-20
17771081613,17771081615,2,2367,1811,-20
17774544853,17774544850,-3,1350,2430,-20
17775098446,17775098446,0,1230,891,-20
17775884574,17775884575,1,1381,1524,-20
17777856331,17777856335,4,1369,1111,-20
17779214121,17779214126,5,2136,1419,-20
17782995487,17782995490,3,1806,1515,-20
17784028825,17784028828,3,1474,1258,-20
17788906978,17788906983,5,2400,1052,-20
17789133625,17789133626,1,2044,1372,-20
17790966113,17790966118,5,7027,20432,-20
17793614833,17793614832,-1,1767,2274,-20
17796673523,17796673524,1,1499,1237,-20
17798367614,17798367615,1,1244,1560,-20
17799886864,17799886868,4,2541,1836,-20
17802991710,17802991714,4,2166,1674,-20
17803498463,17803498465,2,1837,1739,-20
17810062752,17810062755,3,1995,1059,-20
17811883544,17811883546,2,1795,1710,-20
17812482974,17812482979,5,1398,839,-20
17813726431,17813726434,3,1575,1421,-20
17817185918,17817185922,4,1279,820,-20
17820689101,17820689103,2,1202,1693,-20
17824789826,17824789830,4,1699,1400,-20
17830619704,17830619707,3,1564,1344,-20
17830976158,17830976159,1,1579,1397,-20
17831565628,17831565631,3,1717,1158,-20
17832223637,17832223639,2,1455,1422,-20
17837028993,17837028992,-1,1529,1541,-20
17838744965,17838744966,1,1058,1073,-20
17839748114,17839748116,2,1820,1419,-20
17841750185,17841750188,3,1983,1256,-20
17845690378,17845690382,4,2081,1627,-20
17847754885,17847754890,5,1852,1401,-20
17848438363,17848438366,3,2050,1089,-20
17849030702,17849030698,-4,1287,4874,-20
17853310795,17853310799,4,1736,1441,-20
17853560670,17853560675,5,2245,1523,-20
17853749013,17853749019,6,2071,1234,-20
17853961367,17853961348,-19,2008,1209,-20
17857634065,17857634069,4,2103,1457,-20
17857863650,17857863644,-6,1522,8622,-20
17859390358,17859390363,5,2177,1220,-20
17862294430,17862294433,3,1579,1200,-20
17866407047,17866407048,1,1402,1463,-20
17873138083,17873138102,19,1480,1216,-20
17876749354,17876749358,4,1463,1422,-20
17884424302,17884424306,4,1401,1061,-20
17886243464,17886243469,5,2597,1897,-20
17888931905,17888931907,2,1732,1321,-20
17889783762,17889783754,-8,2599,3098,-20
17894189066,17894189066,0,1068,1549,-20
17900554392,17900554396,4,1178,1364,-20
17901638156,17901638159,3,1880,1714,-20
17902187050,17902187054,4,1853,1088,-20
17907649948,17907649952,4,955,1454,-20
17908133848,17908133851,3,1524,908,-20
17912144585,17912144587,2,1554,1013,-20
17914515151,17914515154,3,1431,1430,-20
17915695540,17915695545,5,1869,1506,-20
17915881587,17915881568,-19,1329,611,-20
17920113033,17920113034,1,2939,1753,-20
17920163458,17920163463,5,2219,1628,-20
17920195075,17920195073,-2,1072,1749,-20
17922499407,17922499411,4,1673,1446,-20
17922978160,17922978163,3,786,508,-20
17927828223,17927828226,3,1866,827,-20
17929146452,17929146457,5,1989,1453,-20
17936828770,17936828774,4,1668,1433,-20
17938783490,17938783494,4,1742,1086,-20
17941216989,17941216991,2,1925,1530,-20
17943404877,17943404881,4,1414,1404,-20
17944756385,17944756381,-4,17838,16559,-20
17946008720,17946008722,2,1997,1798,-20
17948636209,17948636211,2,1022,1115,-20
17950163159,17950163164,5,1889,2220,-20
17951981263,17951981266,3,2072,1554,-20
17953036704,17953036709,5,1321,1325,-20
17954754158,17954754136,-22,1964,1474,-20
17956661081,17956661086,5,1451,1376,-20
17959933810,17959933813,3,1452,1350,-20
17960615114,17960615118,4,2867,1486,-20
17962850234,17962850237,3,1730,1047,-20
17965327238,17965327242,4,1494,807,-20
17967877023,17967877027,4,937,998,-20
17969577980,17969577984,4,1835,1639,-20
17969809883,17969809886,3,2095,1516,-20
17971597897,17971597890,-7,37906,15558,-20
17973442975,17973442980,5,2859,1436,-20
17975525257,17975525258,1,2258,1540,-20
17976491710,17976491717,7,2221,1440,-20
17977178139,17977178138,-1,1808,1430,-20
17977495326,17977495330,4,1796,1844,-20
17987900310,17987900314,4,1587,1270,-20
17994696463,17994696466,3,1860,1518,-20
17995852733,17995852736,3,1837,1683,-20
17996583931,17996583934,3,2019,1410,-20
17996884485,17996884487,2,1427,1134,-20
17997050825,17997050830,5,2156,1174,-20
18000192687,18000192690,3,1950,1545,-20
18000509495,18000509499,4,2093,1304,-20
18003068417,18003068419,2,1794,1412,-20
18007589414,18007589418,4,2957,2000,-20
18008100345,18008100347,2,2133,1843,-20
18012173090,18012173094,4,1774,1796,-20
18019378304,18019378305,1,2155,4215,-20
18028329025,18028329026,1,2456,2430,-20
18036271802,18036271805,3,1404,1425,-20
18036573789,18036573794,5,1908,1737,-20
18038627009,18038627010,1,3147,3123,-20
18041152894,18041152890,-4,6065,15880,-20
18042186961,18042186966,5,1593,1209,-20
18043257539,18043257542,3,1374,1446,-20
18043883861,18043883866,5,1578,1369,-20
18044791914,18044791917,3,2183,1373,-20
18048541859,18048541863,4,1512,909,-20
18049585095,18049585098,3,946,1284,-20
18055665840,18055665843,3,1769,1867,-20
18056642674,18056642674,0,1542,1043,-20
18057913053,18057913055,2,2112,1278,-20
18059674322,18059674327,5,4709,2688,-20
18060315683,18060315686,3,1473,1232,-20
18061204681,18061204685,4,1887,1341,-20
18063170009,18063170013,4,1772,1330,-20
18065227217,18065227222,5,2090,1192,-20
18068017214,18068017218,4,1701,1341,-20
18068141194,18068141199,5,1885,1449,-20
18068905665,18068905667,2,1760,1063,-20
18070922686,18070922675,-11,1245,1210,-20
18071435697,18071435699,2,1773,1234,-20
18073198970,18073198964,-6,26717,17251,-20
18075648648,18075648649,1,1826,2229,-20
18077175617,18077175617,0,1691,1232,-20
18077952074,18077952077,3,1443,1553,-20
18080749238,18080749240,2,1630,1363,-20
18083121206,18083121209,3,920,1047,-20
18083306017,18083306018,1,2136,1604,-20
18085893402,18085893403,1,1416,1035,-20
18086492532,18086492535,3,2228,1798,-20
18090065080,18090065083,3,1507,1231,-20
18092167095,18092167097,2,1773,1445,-20
18092556190,18092556194,4,2146,1546,-20
18094989325,18094989327,2,1234,1162,-20
18096696024,18096696027,3,1363,667,-20
18101962798,18101962801,3,1763,1070,-20
18103361441,18103361440,-1,898,1170,-20
18109579140,18109579138,-2,1172,1495,-20
18118364297,18118364302,5,1502,1384,-20
18118688100,18118688106,6,2798,1590,-20
18118873421,18118873422,1,1335,1886,-20
18119756876,18119756878,2,1470,1388,-20
18121567213,18121567217,4,1547,1045,-20
18123128972,18123128978,6,1749,1004,-20
18123987991,18123987995,4,1895,1384,-20
18128572666,18128572670,4,2026,1246,-20
18129737914,18129737916,2,1931,1198,-20
18134462901,18134462907,6,2099,1577,-20
18137244164,18137244167,3,1503,1290,-20
18137404337,18137404342,5,2306,1545,-20
18139633255,18139633255,0,1519,2348,-20
18143156766,18143156769,3,2736,2097,-20
18143478603,18143478607,4,1880,1606,-20
18146869914,18146869916,2,1375,800,-20
18150462013,18150462014,1,1436,1179,-20
18151932345,18151932349,4,1614,1468,-20
18155891189,18155891191,2,1678,1054,-20
18156295673,18156295675,2,1543,1202,-20
18162387623,18162387626,3,2109,1856,-20
18163844422,18163844418,-4,1148,1563,-20
18166868758,18166868761,3,2181,1128,-20
18172210374,18172210378,4,1825,1366,-20
18172662170,18172662172,2,2094,1432,-20
18174944727,18174944730,3,1168,1038,-20
18175419021,18175419022,1,1992,1558,-20
18175461556,18175461571,15,1497,1212,-20
18178965590,18178965585,-5,769,2984,-20
18182445378,18182445380,2,2179,1610,-20
18185201809,18185201814,5,1570,938,-20
18186457219,18186457221,2,1482,1392,-20
18195053457,18195053464,7,2350,1797,-20
18197765450,18197765454,4,2776,1573,-20
18198550529,18198550531,2,2001,1643,-20
18203411184,18203411186,2,1562,1148,-20
18209804766,18209804769,3,1662,1140,-20
18210999254,18210999236,-18,1392,752,-20
18212601022,18212601025,3,1437,1090,-20
18212940580,18212940586,6,1681,1201,-20
18213297617,18213297633,16,2353,1827,-20
18217395257,18217395258,1,2039,1668,-20
18223365716,18223365721,5,1945,1315,-20
18225375182,18225375185,3,1468,1319,-20
18227124069,18227124070,1,1006,1374,-20
18229213801,18229213802,1,3135,3774,-20
18229517942,18229517947,5,1874,1747,-20
18230191049,18230191053,4,2549,1833,-20
18235576006,18235576011,5,5167,2465,-20
18237456270,18237456274,4,1829,1352,-20
18240078091,18240078094,3,1311,1205,-20
18240808424,18240808427,3,2005,1388,-20
18241062290,18241062283,-7,5703,13767,-20
18241511129,18241511131,2,1534,1331,-20
18243651274,18243651278,4,1563,1325,-20
18244083317,18244083298,-19,2396,1923,-20
18245111038,18245111044,6,2431,1387,-20
18248352637,18248352641,4,1879,1487,-20
18253588830,18253588835,5,1923,1429,-20
18254028561,18254028565,4,975,1091,-20
18254116482,18254116478,-4,1701,7453,-20
18255812821,18255812827,6,4197,2469,-20
18257423800,18257423803,3,1863,1268,-20
18257448950,18257448929,-21,635,332,-20
18257462504,18257462504,0,129,74,-20
18260719043,18260719046,3,1450,1072,-20
18263851209,18263851213,4,1920,1752,-20
18267046698,18267046703,5,2268,1393,-20
18267090406,18267090407,1,1283,1150,-20
18268773807,18268773810,3,1535,1089,-20
18276413938,18276413940,2,3849,16558,-20
18277825729,18277825731,2,1759,1044,-20
18280109906,18280109910,4,1306,905,-20
18280767329,18280767315,-14,2186,1265,-20
18284014312,18284014314,2,1177,1407,-20
18287813336,18287813340,4,1577,1263,-20
18289225611,18289225616,5,1875,1471,-20
18290259673,18290259677,4,1623,1079,-20
18290368662,18290368661,-1,1231,1566,-20
18291078726,18291078732,6,3130,1291,-20
18291279959,18291279968,9,1422,1304,-20
18294996880,18294996881,1,2020,1663,-20
18296133190,18296133193,3,1773,1528,-20
18297129898,18297129901,3,1908,1519,-20
18299376682,18299376687,5,1873,1433,-20
18300567716,18300567719,3,1849,1131,-20
18304286050,18304286054,4,2142,1232,-20
18305183982,18305183978,-4,1415,2823,-20
18305441250,18305441251,1,1413,1057,-20
18306707054,18306707058,4,2296,1514,-20
18307424388,18307424391,3,1857,1730,-20
18310502406,18310502391,-15,1802,757,-20
18310827767,18310827770,3,2894,2216,-20
18310861817,18310861810,-7,27345,16124,-20
18311690310,18311690315,5,1409,1005,-20
18311754844,18311754850,6,1839,1103,-20
18313328742,18313328743,1,1382,1318,-20
18318287421,18318287423,2,2124,1192,-20
18318970585,18318970588,3,2200,2514,-20
18319825558,18319825560,2,2489,2127,-20
18320231242,18320231247,5,2195,1247,-20
18324402505,18324402509,4,1559,1697,-20
18324847991,18324847970,-21,2732,1385,-20
18325020156,18325020140,-16,1787,1948,-20
18325462187,18325462192,5,2536,1185,-20
18327739546,18327739550,4,1845,1415,-20
18340832542,18340832545,3,1407,1317,-20
18342132257,18342132259,2,1795,1165,-20
18343901725,18343901722,-3,942,2125,-20
18345380710,18345380714,4,1383,1446,-20
18347826550,18347826554,4,1399,1211,-20
18348618242,18348618244,2,1151,814,-20
18351436566,18351436569,3,1516,1303,-20
18352786626,18352786631,5,2571,1522,-20
18354103807,18354103813,6,980,1175,-20
18355232696,18355232701,5,1872,1184,-20
18355299698,18355299702,4,2542,1854,-20
18356508471,18356508465,-6,1719,5893,-20
18356979062,18356979066,4,2189,1368,-20
18367579757,18367579760,3,2443,1468,-20
18367747527,18367747520,-7,1293,5078,-20
18368909324,18368909327,3,1244,1187,-20
18371927594,18371927599,5,1831,1070,-20
18374600450,18374600451,1,1474,1714,-20
18375708242,18375708246,4,1553,1005,-20
18376109406,18376109409,3,2315,1797,-20
18378077748,18378077751,3,1639,1476,-20
18378404826,18378404826,0,1807,1411,-20
18379773862,18379773865,3,1394,1326,-20
18381814474,18381814475,1,984,1279,-20
18383411829,18383411831,2,1768,1369,-20
18386927655,18386927661,6,1302,914,-20
18392268807,18392268810,3,2378,1839,-20
18393061029,18393061032,3,1994,1936,-20
18394790936,18394790941,5,2021,1365,-20
18397142706,18397142709,3,1714,1001,-20
18397494514,18397494518,4,1542,1959,-20
18398939735,18398939737,2,2030,2126,-20
18401974158,18401974162,4,1753,1913,-20
18402342858,18402342853,-5,993,2106,-20
18402582305,18402582306,1,2219,1603,-20
18410798113,18410798113,0,2019,1288,-20
18410901609,18410901626,17,1158,1627,-20
18411006217,18411006219,2,1753,1071,-20
18412715822,18412715827,5,2093,1200,-20
18412907650,18412907650,0,1822,1491,-20
18421987325,18421987329,4,1485,1516,-20
18422665990,18422665996,6,1811,1788,-20
18424282424,18424282427,3,1339,1212,-20
18429851871,18429851874,3,1951,1745,-20
18430454173,18430454178,5,1156,688,-20
18433075413,18433075415,2,1407,1301,-20
18434179090,18434179093,3,1612,1644,-20
18436555476,18436555482,6,3215,1428,-20
18437760465,18437760464,-1,1751,1673,-20
18437960477,18437960458,-19,1749,1482,-20
18439166748,18439166751,3,1125,1261,-20
18443777035,18443777037,2,1391,1670,-20
18447006038,18447006039,1,1242,1658,-20
18452784130,18452784134,4,2166,1339,-20
18453704962,18453704964,2,1333,1818,-20
18456085442,18456085444,2,1551,1066,-20
18460065893,18460065899,6,2023,1258,-20
18464263286,18464263290,4,1820,1310,-20
18465730605,18465730607,2,1267,1010,-20
18467119664,18467119668,4,1862,1394,-20
18469842248,18469842248,0,1101,1344,-20
18473446122,18473446126,4,1988,1412,-20
18477559462,18477559466,4,1531,1227,-20
18477711401,18477711405,4,50002,23800,-20
18480091257,18480091260,3,2026,1670,-20
18483302432,18483302433,1,1994,2132,-20
18486184457,18486184461,4,2446,1718,-20
18486758883,18486758886,3,2251,1505,-20
18487134438,18487134441,3,1686,1845,-20
18491303182,18491303184,2,1789,2067,-20
18492150131,18492150134,3,1279,1315,-20
18494526520,18494526523,3,1119,920,-20
18497117520,18497117523,3,1284,848,-20
18497481417,18497481418,1,1665,1453,-20
18499493920,18499493924,4,2262,1432,-20
18501875983,18501875987,4,2214,1794,-20
18502038560,18502038562,2,2276,1480,-20
18502570975,18502570970,-5,1449,2317,-20
18505156753,18505156755,2,1406,1949,-20
18506172415,18506172420,5,2686,1891,-20
18507335094,18507335097,3,1546,1482,-20
18507463146,18507463147,1,1515,1370,-20
18507571853,18507571859,6,1284,1001,-20
18509022463,18509022441,-22,1894,915,-20
18509417472,18509417474,2,2479,1686,-20
18509731082,18509731085,3,1378,905,-20
18509794098,18509794084,-14,919,356,-20
18512796075,18512796079,4,1677,1821,-20
18514222860,18514222865,5,1643,1487,-20
18518930842,18518930845,3,1744,1657,-20
18520689106,18520689110,4,2721,1596,-20
18521266408,18521266412,4,1473,1615,-20
18521860787,18521860770,-17,1150,504,-20
18523180737,18523180742,5,2017,1625,-20
18524309333,18524309335,2,2043,1857,-20
18526265078,18526265083,5,4777,1984,-20
18528313131,18528313108,-23,309,1268,-20
18530215309,18530215312,3,1904,2232,-20
18532510661,18532510665,4,1857,1433,-20
18532646836,18532646840,4,1886,1696,-20
18533870315,18533870318,3,1632,1018,-20
18537478466,18537478466,0,772,1788,-20
18540066478,18540066485,7,2674,2450,-20
18543772135,18543772139,4,2058,1255,-20
18548245594,18548245599,5,1913,1520,-20
18549507398,18549507401,3,1234,1540,-20
18549864785,18549864790,5,3027,1450,-20
18551846370,18551846375,5,1666,1384,-20
18554000410,18554000413,3,2271,1964,-20
18558217195,18558217201,6,1649,1868,-20
18562248658,18562248662,4,4122,3126,-20
18566021108,18566021113,5,1426,1928,-20
18566897766,18566897771,5,3157,1469,-20
18566964073,18566964077,4,2403,1925,-20
18569761470,18569761473,3,1877,1338,-20
18570600625,18570600630,5,2624,1253,-20
18570654130,18570654134,4,1948,1511,-20
18572377543,18572377545,2,1426,1658,-20
18574688458,18574688463,5,1803,1740,-20
18575818662,18575818666,4,1709,1321,-20
18581075072,18581075075,3,1990,1457,-20
18581886907,18581886908,1,2081,1734,-20
18584955660,18584955663,3,1971,1255,-20
18585702301,18585702306,5,2519,1122,-20
18591294761,18591294765,4,2369,1505,-20
18591932208,18591932214,6,2027,1224,-20
18594924997,18594925003,6,1649,1362,-20
18596401154,18596401158,4,2189,1540,-20
18598706231,18598706233,2,1328,1272,-20
18599387103,18599387106,3,1764,1723,-20
18603145312,18603145314,2,2274,1478,-20
18604799254,18604799258,4,2061,1162,-20
18605879403,18605879406,3,2140,1002,-20
18607306659,18607306661,2,1483,1314,-20
18609421248,18609421241,-7,1522,7446,-20
18610530984,18610530988,4,1568,1372,-20
18614110561,18614110563,2,1208,919,-20
18615531278,18615531279,1,1892,1422,-20
18616515628,18616515621,-7,2051,6443,-20
18617024043,18617024047,4,1865,970,-20
18617378537,18617378538,1,1587,1475,-20
18620532481,18620532485,4,2022,1652,-20
18620875689,18620875693,4,1867,1185,-20
18621802249,18621802250,1,1672,2135,-20
18622194980,18622194968,-12,1457,880,-20
18622598034,18622598038,4,1589,999,-20
18624614042,18624614048,6,1903,1217,-20
18625746401,18625746407,6,3061,1435,-20
18625830704,18625830707,3,1445,1300,-20
18636877269,18636877274,5,2570,1278,-20
18639678300,18639678300,0,1570,1551,-20
18639802949,18639802954,5,1318,1443,-20
18644642905,18644642911,6,731,1001,-20
18646842354,18646842358,4,1658,1313,-20
18653833378,18653833382,4,1641,1293,-20
18657765638,18657765641,3,2181,1656,-20
18659938251,18659938255,4,1281,475,-20
18660377110,18660377107,-3,1947,1894,-20
18660518172,18660518174,2,1252,1078,-20
18668967622,18668967628,6,19232,56748,-20
18670884642,18670884646,4,2170,1231,-20
18673667597,18673667598,1,2128,1854,-20
18675071895,18675071898,3,2129,1517,-20
18675588904,18675588892,-12,1570,1021,-20
18676410045,18676410046,1,2309,1518,-20
18681078723,18681078726,3,1877,1447,-20
18682643697,18682643699,2,2326,1500,-20
18683933834,18683933836,2,1632,1489,-20
18685657474,18685657477,3,2126,1458,-20
18690498990,18690498993,3,1944,1386,-20
18693304440,18693304442,2,1527,1612,-20
18693348142,18693348145,3,1602,1137,-20
18698946237,18698946237,0,2229,2940,-20
18702459185,18702459190,5,1966,1098,-20
18705537286,18705537288,2,1778,1914,-20
18707957643,18707957645,2,1487,1168,-20
18709663995,18709663996,1,2888,2369,-20
18710695142,18710695146,4,2603,1360,-20
18712939820,18712939823,3,2580,1787,-20
18714528561,18714528566,5,2040,1131,-20
18717476857,18717476862,5,2048,1466,-20
18717808654,18717808657,3,1859,1572,-20
18718742958,18718742961,3,2162,1311,-20
18723387509,18723387512,3,1934,1497,-20
18726113954,18726113958,4,2897,1462,-20
18728217017,18728217019,2,1752,1167,-20
18728884135,18728884130,-5,1450,3344,-20
18729649737,18729649740,3,1835,1472,-20
18731803220,18731803216,-4,22080,16000,-20
18734214518,18734214523,5,1925,1286,-20
18736296311,18736296316,5,1777,1676,-20
18736929232,18736929235,3,1590,1215,-20
18744912254,18744912258,4,1783,1376,-20
18745830913,18745830915,2,1724,1127,-20
18746945050,18746945053,3,1717,1266,-20
18747911862,18747911858,-4,16894,75823,-20
18748188097,18748188101,4,1815,1322,-20
18750701579,18750701582,3,1746,1380,-20
18751828677,18751828679,2,2202,1769,-20
18757721972,18757721957,-15,710,649,-20
18758848327,18758848327,0,1379,1309,-20
18759364675,18759364678,3,1705,1403,-20
18764087298,18764087301,3,1739,1536,-20
18764336500,18764336502,2,1305,929,-20
18764911844,18764911849,5,2355,2011,-20
18765631135,18765631130,-5,931,3329,-20
18766121090,18766121095,5,1618,1584,-20
18767397991,18767398008,17,765,265,-20
18768238882,18768238886,4,2307,1720,-20
18770710798,18770710802,4,1923,1474,-20
18779199146,18779199150,4,1560,1466,-20
18779389982,18779389985,3,2245,1390,-20
18780028227,18780028230,3,2273,996,-20
18780515738,18780515741,3,2016,1580,-20
18782947225,18782947227,2,2314,2437,-20
18783236274,18783236278,4,1826,1546,-20
18783505836,18783505840,4,2670,1654,-20
18785179831,18785179845,14,1609,1354,-20
18786192426,18786192429,3,2265,1941,-20
18786851207,18786851213,6,1956,1185,-20
18791245994,18791245998,4,1914,1690,-20
18791363990,18791363994,4,2353,1166,-20
18792345520,18792345522,2,1433,1049,-20
18793102479,18793102483,4,1741,1212,-20
18796108389,18796108392,3,1752,1408,-20
18798308670,18798308689,19,1580,1339,-20
18806477241,18806477239,-2,902,1681,-20
18809625975,18809625979,4,2074,1697,-20
18810063258,18810063262,4,1403,1030,-20
18811918453,18811918454,1,2055,1548,-20
18813037005,18813037007,2,1415,1749,-20
18814997700,18814997702,2,1480,1324,-20
18816436757,18816436758,1,1806,1499,-20
18819404555,18819404558,3,1883,1218,-20
18820942448,18820942452,4,1721,1252,-20
18821040938,18821040942,4,1802,1205,-20
18824342209,18824342212,3,1480,1057,-20
18825474098,18825474100,2,2201,2227,-20
18825613547,18825613551,4,1562,1129,-20
18826082647,18826082624,-23,2476,945,-20
18832005275,18832005277,2,1766,1066,-20
18837545451,18837545454,3,1955,1147,-20
18838773382,18838773385,3,2152,1343,-20
18841586975,18841586980,5,2154,1665,-20
18842798307,18842798312,5,2429,1638,-20
18844904985,18844904987,2,1603,1063,-20
18847375421,18847375418,-3,1778,4763,-20
18847589314,18847589318,4,2377,1759,-20
18848081017,18848081021,4,1493,1121,-20
18848952321,18848952323,2,1341,1080,-20
18852390039,18852390042,3,1665,1324,-20
18853317137,18853317141,4,1582,1671,-20
18853859739,18853859742,3,1135,949,-20
18855415406,18855415402,-4,927,2013,-20
18855522519,18855522522,3,2039,2168,-20
18859250158,18859250162,4,2186,1581,-20
18859355806,18859355788,-18,1235,1470,-20
18863753087,18863753091,4,954,1145,-20
18867597538,18867597538,0,1304,1366,-20
18870417164,18870417167,3,2042,1301,-20
18872652715,18872652718,3,2156,1665,-20
18873695978,18873695969,-9,1044,291,-20
18875624614,18875624619,5,1549,1212,-20
18877395549,18877395550,1,1414,1106,-20
18878109905,18878109908,3,1893,1610,-20
18881913383,18881913387,4,1299,1090,-20
18882936438,18882936440,2,1665,1874,-20
18883012758,18883012763,5,1466,1227,-20
18884680217,18884680220,3,2021,1765,-20
18887434234,18887434234,0,1492,1234,-20
18890747869,18890747873,4,1224,842,-20
18891011286,18891011289,3,2426,1597,-20
18893699884,18893699888,4,2037,1971,-20
18896230056,18896230044,-12,1491,2914,-20
18897158166,18897158169,3,1712,1570,-20
18902534093,18902534095,2,1482,1309,-20
18909382726,18909382728,2,1622,1064,-20
18909786573,18909786579,6,1295,1142,-20
18911195810,18911195815,5,1981,1801,-20
18911986886,18911986889,3,1620,1619,-20
18912637215,18912637221,6,2209,1316,-20
18913254398,18913254376,-22,2051,1380,-20
18916590543,18916590546,3,1844,2052,-20
18917939074,18917939078,4,1403,999,-20
18918225666,18918225670,4,2198,1091,-20
18918483845,18918483848,3,2271,1287,-20
18921402500,18921402503,3,1490,1237,-20
18921721118,18921721120,2,1764,1130,-20
18922583654,18922583659,5,1828,1316,-20
18923757038,18923757042,4,1808,1646,-20
18925839923,18925839926,3,2335,1551,-20
18926314406,18926314410,4,1838,2048,-20
18932016586,18932016589,3,1260,1208,-20
18932319117,18932319119,2,2511,1963,-20
18932624267,18932624265,-2,1121,1638,-20
18934640226,18934640232,6,1970,1397,-20
18935486101,18935486104,3,2063,1735,-20
18938600391,18938600394,3,2212,2360,-20
18939702529,18939702532,3,1975,1570,-20
18940871536,18940871539,3,1708,1107,-20
18945449177,18945449180,3,1689,1408,-20
18946833579,18946833582,3,1576,1268,-20
18951506031,18951506025,-6,1215,1547,-20
18956328022,18956328026,4,1954,1306,-20
18956563161,18956563166,5,1932,1271,-20
18958870025,18958870027,2,1459,1090,-20
18959849193,18959849197,4,1512,1516,-20
18959907066,18959907069,3,1482,1308,-20
18961327277,18961327281,4,2235,1923,-20
18964728978,18964728981,3,1380,1847,-20
18966187562,18966187565,3,1434,1641,-20
18967438683,18967438687,4,2349,1504,-20
18967672749,18967672753,4,3053,2345,-20
18968830563,18968830546,-17,2012,1459,-20
18969438805,18969438811,6,1529,1589,-20
18975023554,18975023558,4,2013,1157,-20
18976844302,18976844296,-6,1854,10881,-20
18978283861,18978283865,4,1906,1480,-20
18980102186,18980102190,4,2561,2033,-20
18981893234,18981893238,4,2783,1470,-20
18985007942,18985007943,1,979,1134,-20
18986741586,18986741590,4,1262,752,-20
18987714354,18987714357,3,1618,1356,-20
18988312457,18988312459,2,1627,1631,-20
18988889022,18988889025,3,1832,1425,-20
18991328825,18991328832,7,11157,24859,-20
18997827246,18997827250,4,1988,1720,-20
18998264754,18998264757,3,2005,1656,-20
19001847890,19001847896,6,1047,487,-20
19002113930,19002113939,9,15490,23151,-20
19004726295,19004726299,4,2599,1760,-20
19005443522,19005443527,5,1409,1384,-20
19008373673,19008373676,3,870,987,-20
19009965403,19009965408,5,1792,1878,-20
19012619818,19012619821,3,1682,1835,-20
19014457265,19014457269,4,2065,917,-20
19015354707,19015354710,3,1657,1433,-20
19018635818,19018635822,4,1362,1064,-20
19021033219,19021033220,1,1571,1560,-20
19022131270,19022131273,3,2392,2064,-20
19026725030,19026725034,4,1589,1339,-20
19028218978,19028218983,5,2477,1564,-20
19029671570,19029671575,5,1982,1562,-20
19030731729,19030731734,5,1961,1546,-20
19031932930,19031932934,4,2413,1090,-20
19032461060,19032461062,2,1473,1781,-20
19035815110,19035815115,5,1890,1298,-20
19038404487,19038404493,6,3128,1631,-20
19039007646,19039007651,5,2354,1406,-20
19041004723,19041004724,1,976,1359,-20
19041919884,19041919902,18,288,1036,-20
19046831545,19046831553,8,2791,1230,-20
19047671073,19047671075,2,1663,1456,-20
19048616366,19048616374,8,17401,21021,-20
19049006547,19049006550,3,2079,880,-20
19056717135,19056717138,3,560,721,-20
19058235099,19058235107,8,2116,1836,-20
19062395587,19062395591,4,1767,1234,-20
19063706389,19063706395,6,4034,1695,-20
19063780957,19063780953,-4,894,1759,-20
19064817930,19064817924,-6,904,230,-20
19067204982,19067204986,4,2065,1486,-20
19069955142,19069955142,0,959,1196,-20
19070603921,19070603922,1,1344,1192,-20
19074021568,19074021570,2,1626,1167,-20
19075481422,19075481425,3,1565,1631,-20
19075574618,19075574617,-1,1007,1232,-20
19078498530,19078498533,3,1479,1205,-20
19079617643,19079617642,-1,1658,1921,-20
19082993845,19082993850,5,2671,1719,-20
19084243238,19084243242,4,1034,971,-20
19092300942,19092300946,4,2200,1513,-20
19100048332,19100048333,1,1781,1290,-20
19101274819,19101274822,3,2402,1443,-20
19101347350,19101347354,4,2194,1834,-20
19108560590,19108560595,5,2364,2011,-20
19113237858,19113237859,1,1737,2097,-20
19113880034,19113880039,5,1617,1598,-20
19114666206,19114666210,4,1918,1729,-20
19114857433,19114857439,6,3763,1187,-20
19116226288,19116226282,-6,1293,3889,-20
19116720631,19116720634,3,2543,1650,-20
19117808440,19117808433,-7,1042,2566,-20
19120953267,19120953270,3,1344,1171,-20
19121181215,19121181219,4,2084,1556,-20
19122820958,19122820962,4,1651,1201,-20
19125718644,19125718645,1,1829,1170,-20
19129514033,19129514034,1,2001,1696,-20
19132169877,19132169878,1,1225,1810,-20
19136469382,19136469386,4,1987,1567,-20
19140025694,19140025694,0,1719,1409,-20
19142215043,19142215046,3,1579,1219,-20
19142757364,19142757370,6,2786,1783,-20
19144680666,19144680670,4,2436,1384,-20
19145256563,19145256563,0,975,1742,-20
19151771395,19151771398,3,2033,1723,-20
19152220857,19152220861,4,1147,1202,-20
19154722572,19154722576,4,1604,1171,-20
19156927907,19156927910,3,2105,1328,-20
19160095342,19160095347,5,2834,1391,-20
19162054717,19162054721,4,1374,1093,-20
19165537326,19165537331,5,3310,1600,-20
19166448477,19166448482,5,2161,1300,-20
19169935610,19169935614,4,1768,1253,-20
19171491446,19171491448,2,2251,2113,-20
19174982501,19174982505,4,1562,1298,-20
19175181166,19175181153,-13,1780,519,-20
19176225282,19176225286,4,1366,1715,-20
19177522778,19177522782,4,1905,1771,-20
19179797609,19179797613,4,2110,1791,-20
19180834532,19180834533,1,1771,1736,-20
19182097097,19182097095,-2,1462,2973,-20
19182811484,19182811485,1,1825,1094,-20
19183933334,19183933338,4,1916,1054,-20
19191141173,19191141181,8,2846,1384,-20
19191890860,19191890864,4,2505,1668,-20
19194242842,19194242845,3,1217,965,-20
19194382174,19194382184,10,1466,1168,-20
19194446774,19194446779,5,2098,1295,-20
19194726299,19194726304,5,2259,2121,-20
19197713519,19197713525,6,2429,1263,-20
19199905070,19199905074,4,2345,1564,-20
19202509709,19202509713,4,2523,1444,-20
19208882358,19208882362,4,1989,1728,-20
19210458086,19210458089,3,2318,1265,-20
19211297715,19211297718,3,1225,1048,-20
19212449226,19212449231,5,1525,1322,-20
19216585984,19216585985,1,1135,1709,-20
19219011614,19219011609,-5,1258,3072,-20
19220418035,19220418037,2,1361,987,-20
19221902721,19221902723,2,1379,1288,-20
19223064918,19223064922,4,2437,1552,-20
19226460255,19226460258,3,2093,1144,-20
19229576481,19229576485,4,2267,1607,-20
19229730352,19229730354,2,1559,1417,-20
19231739575,19231739579,4,1564,1091,-20
19232829649,19232829654,5,1317,1302,-20
19233250714,19233250718,4,2068,1585,-20
19233775974,19233775978,4,2063,1427,-20
19234609934,19234609937,3,2587,1294,-20
19237161620,19237161642,22,3664,1101,-20
19238277905,19238277910,5,1652,1730,-20
19238763554,19238763559,5,2458,1133,-20
19239037342,19239037324,-18,450,162,-20
19243785607,19243785610,3,2077,1499,-20
19244029387,19244029390,3,1169,1000,-20
19252566243,19252566245,2,1061,1227,-20
19253632042,19253632045,3,2766,1697,-20
19255163730,19255163733,3,1453,1044,-20
19255755839,19255755843,4,1197,1108,-20
19258537915,19258537920,5,1832,1249,-20
19263477761,19263477763,2,2140,1476,-20
19265780951,19265780956,5,2907,1288,-20
19267235561,19267235565,4,856,1509,-20
19272350580,19272350585,5,2280,1260,-20
19274075577,19274075581,4,2546,1623,-20
19274924485,19274924489,4,1542,1492,-20
19276460396,19276460399,3,2130,1464,-20
19276857124,19276857126,2,1642,1118,-20
19278747362,19278747367,5,2171,875,-20
19280120314,19280120318,4,1679,1018,-20
19283045479,19283045481,2,1770,1495,-20
19283614410,19283614413,3,2118,1789,-20
19287893927,19287893931,4,1566,1023,-20
19305862128,19305862131,3,2048,1184,-20
19309297426,19309297430,4,1814,1556,-20
19310651181,19310651183,2,1406,1153,-20
19313988771,19313988774,3,1563,1274,-20
19314251026,19314251030,4,2227,1474,-20
19315134091,19315134095,4,2444,1673,-20
19316500230,19316500234,4,1560,1353,-20
19318604399,19318604403,4,1844,1770,-20
19320052422,19320052423,1,1321,1545,-20
19325185322,19325185327,5,2042,1659,-20
19325293517,19325293523,6,2142,1368,-20
19330095169,19330095171,2,1550,1308,-20
19333403024,19333403028,4,1467,1089,-20
19334196429,19334196425,-4,28451,8003,-20
19336490785,19336490789,4,1875,1559,-20
19337701617,19337701620,3,2352,1346,-20
19338021314,19338021322,8,985,1071,-20
19338788794,19338788797,3,1431,1368,-20
19343766543,19343766547,4,1383,1176,-20
19348187107,19348187111,4,1529,1027,-20
19349887562,19349887566,4,1527,1293,-20
19355136914,19355136919,5,2217,859,-20
19355457695,19355457675,-20,1001,582,-20
19356430558,19356430562,4,1409,649,-20
19356911486,19356911489,3,2466,2380,-20
19358929029,19358929031,2,2121,1559,-20
19360004854,19360004857,3,1264,1119,-20
19365963292,19365963294,2,1816,1214,-20
19369384544,19369384545,1,1607,1196,-20
19370784920,19370784922,2,1564,1774,-20
19372396423,19372396422,-1,1201,2455,-20
19376003914,19376003917,3,1991,1245,-20
19378979403,19378979406,3,2258,1555,-20
19379980135,19379980139,4,1495,1683,-20
19383551033,19383551035,2,1834,1500,-20
19384128203,19384128208,5,2755,1509,-20
19387952937,19387952939,2,1571,1148,-20
19389175239,19389175242,3,1453,879,-20
19390059938,19390059941,3,1160,1786,-20
19393550397,19393550402,5,2312,1072,-20
19396116634,19396116638,4,2068,1730,-20
19397274364,19397274367,3,2314,1629,-20
19410388950,19410388953,3,1914,1554,-20
19410808920,19410808928,8,1753,1325,-20
19419177615,19419177618,3,1479,1406,-20
19422295831,19422295831,0,854,1029,-20
19424121538,19424121542,4,2360,1494,-20
19429559312,19429559326,14,2685,8846,-20
19429876158,19429876162,4,1351,1276,-20
19435273174,19435273174,0,1043,1626,-20
19439437589,19439437589,0,1620,2891,-20
19444267097,19444267099,2,1370,1201,-20
19444538982,19444538987,5,1861,1384,-20
19445732193,19445732192,-1,15857,48805,-20
19446240910,19446240914,4,2371,2122,-20
19447656272,19447656273,1,2237,1569,-20
19448545196,19448545199,3,1522,1378,-20
19448749547,19448749550,3,1499,1400,-20
19448915237,19448915239,2,1455,1492,-20
19449049217,19449049226,9,1159,1004,-20
19450270574,19450270578,4,2199,1877,-20
19451188046,19451188050,4,2998,1716,-20
19451797422,19451797427,5,1796,1587,-20
19452172814,19452172815,1,994,1221,-20
19452861367,19452861369,2,1753,1629,-20
19457088866,19457088871,5,1692,1373,-20
19458527103,19458527106,3,1574,1611,-20
19458728775,19458728775,0,642,1399,-20
19463163281,19463163287,6,5587,2467,-20
19463715226,19463715227,1,1388,1288,-20
19463830453,19463830455,2,1891,1502,-20
19465275444,19465275446,2,2127,1976,-20
19466662657,19466662661,4,2458,1775,-20
19470034138,19470034142,4,2221,1781,-20
19472018167,19472018166,-1,649,1242,-20
19472667470,19472667463,-7,1484,7411,-20
19473476630,19473476633,3,1646,1279,-20
19474306225,19474306228,3,1600,1258,-20
19474776009,19474776024,15,2544,971,-20
19475306357,19475306362,5,1876,1651,-20
19479599437,19479599438,1,1845,1582,-20
19481353049,19481353053,4,1608,1709,-20
19482748414,19482748418,4,1441,1392,-20
19487659064,19487659067,3,1761,1127,-20
19488650390,19488650393,3,1983,1474,-20
19490398698,19490398702,4,2095,1683,-20
19490481661,19490481664,3,2657,2032,-20
19491322381,19491322382,1,1536,1140,-20
19492495359,19492495362,3,1983,1422,-20
19493468684,19493468689,5,1886,1213,-20
19494135721,19494135743,22,169,1092,-20
19494367987,19494367979,-8,1209,1044,-20
19494764471,19494764474,3,1606,1345,-20
19498281694,19498281697,3,1885,1912,-20
19500505286,19500505275,-11,1481,1454,-20
19502232314,19502232315,1,809,1197,-20
19504240662,19504240657,-5,1880,8643,-20
19504545487,19504545491,4,1475,977,-20
19504627994,19504627995,1,1310,1368,-20
19508698469,19508698471,2,2188,1618,-20
19509426137,19509426139,2,1730,1346,-20
19510796174,19510796177,3,2107,1346,-20
19510828677,19510828680,3,2138,1856,-20
19512402418,19512402421,3,942,666,-20
19514114550,19514114553,3,2203,1558,-20
19515144445,19515144449,4,1083,1246,-20
19518386685,19518386687,2,2070,1561,-20
19520884372,19520884374,2,1944,1487,-20
19522381767,19522381760,-7,595,3730,-20
19523913313,19523913316,3,2345,1712,-20
19525562343,19525562346,3,1262,1058,-20
19530185566,19530185570,4,1793,1689,-20
19530338737,19530338742,5,1717,1287,-20
19530976129,19530976131,2,1113,1374,-20
19534628123,19534628126,3,2074,1667,-20
19535709533,19535709528,-5,1449,4677,-20
19536133459,19536133465,6,1735,737,-20
19536517439,19536517442,3,1942,1327,-20
19536634641,19536634647,6,1567,1688,-20
19537363687,19537363689,2,1400,1489,-20
19540920702,19540920705,3,2010,1403,-20
19546459749,19546459756,7,3285,1622,-20
19547156014,19547156008,-6,1451,4664,-20
19550198111,19550198116,5,2704,1720,-20
19550744961,19550744962,1,1626,1147,-20
19561876007,19561876010,3,1858,1255,-20
19562995456,19562995459,3,2521,1535,-20
19563995138,19563995143,5,2227,1559,-20
19564729102,19564729104,2,1414,1623,-20
19565162195,19565162199,4,1067,538,-20
19566605457,19566605462,5,758,526,-20
19568056755,19568056758,3,2023,1544,-20
19568293554,19568293555,1,1324,1472,-20
19568865814,19568865813,-1,1989,1841,-20
19570489286,19570489288,2,1757,1476,-20
19572278226,19572278229,3,1591,1329,-20
19572797263,19572797274,11,1630,1594,-20
19572835270,19572835272,2,2493,2116,-20
19574855037,19574855040,3,1782,1496,-20
19576908025,19576908029,4,1421,825,-20
19578649321,19578649325,4,2502,1576,-20
19579036231,19579036236,5,1967,1239,-20
19584518270,19584518274,4,1949,1328,-20
19585836263,19585836266,3,2038,1424,-20
19585994567,19585994545,-22,905,508,-20
19592901953,19592901957,4,2064,1778,-20
19598041725,19598041727,2,1432,960,-20
19599108067,19599108071,4,1094,1609,-20
19599579234,19599579235,1,1650,1622,-20
19600997163,19600997165,2,2458,1355,-20
19602761200,19602761205,5,1750,1290,-20
19606113534,19606113527,-7,1489,1281,-20
19607110380,19607110383,3,1500,1596,-20
19610359745,19610359752,7,2670,1336,-20
19611351012,19611351035,23,1767,1603,-20
19612165733,19612165736,3,1759,1434,-20
19613121710,19613121714,4,1947,1490,-20
19615673345,19615673349,4,1978,873,-20
19617867126,19617867129,3,1643,1322,-20
19621350113,19621350118,5,2831,1872,-20
19621525449,19621525450,1,1072,937,-20
19625592546,19625592550,4,1681,1232,-20
19625922106,19625922089,-17,1694,1254,-20
19628986909,19628986911,2,1470,1428,-20
19629436192,19629436195,3,2193,1327,-20
19630237741,19630237743,2,2272,2238,-20
19630633995,19630633996,1,1317,1433,-20
19631574497,19631574502,5,1604,1037,-20
19634705888,19634705891,3,1683,943,-20
19636859638,19636859642,4,1207,830,-20
19641648034,19641648035,1,1620,1620,-20
19645605542,19645605546,4,1796,1285,-20
19646702360,19646702364,4,1874,991,-20
19648004652,19648004654,2,1808,1215,-20
19659598225,19659598229,4,1534,820,-20
19662826385,19662826389,4,1353,731,-20
19663564844,19663564848,4,1904,1620,-20
19669256923,19669256926,3,1293,932,-20
19671824668,19671824669,1,1475,1327,-20
19672557750,19672557755,5,1610,1354,-20
19672630242,19672630258,16,1783,1677,-20
19673802417,19673802422,5,2037,1549,-20
19675594668,19675594669,1,1377,1528,-20
19677101857,19677101861,4,1879,1628,-20
19677303571,19677303573,2,1819,1944,-20
19687135184,19687135179,-5,1351,4113,-20
19690256417,19690256422,5,1992,813,-20
19690565087,19690565092,5,2298,1518,-20
19694459574,19694459578,4,1657,1197,-20
19694716868,19694716882,14,1653,1584,-20
19696722842,19696722846,4,2311,1385,-20
19702873085,19702873088,3,1276,1702,-20
19703754994,19703754997,3,1829,1348,-20
19704725955,19704725958,3,1312,1224,-20
19708213100,19708213105,5,2226,1071,-20
19709675461,19709675464,3,2202,1573,-20
19715079962,19715079942,-20,2291,2019,-20
19717190143,19717190146,3,1785,2003,-20
19718251567,19718251570,3,1291,1095,-20
19719890766,19719890771,5,1998,972,-20
19722597198,19722597202,4,1852,1503,-20
19723753734,19723753740,6,3226,1812,-20
19724518606,19724518611,5,2290,1460,-20
19725796968,19725796972,4,2473,2508,-20
19729051780,19729051760,-20,1554,1518,-20
19730198222,19730198223,1,1755,2603,-20
19732425369,19732425371,2,1589,1059,-20
19732667046,19732667047,1,1681,1293,-20
19734086972,19734086975,3,2146,1388,-20
19735419348,19735419350,2,1374,1646,-20
19738129434,19738129435,1,1597,1179,-20
19738892832,19738892836,4,1757,1335,-20
19740397698,19740397701,3,3002,2334,-20
19744047766,19744047769,3,1247,1424,-20
19748917771,19748917773,2,1852,1736,-20
19749317465,19749317467,2,2071,1465,-20
19749470622,19749470625,3,1799,1934,-20
19759090062,19759090066,4,4148,2812,-20
19762663142,19762663141,-1,1315,1899,-20
19763048072,19763048075,3,2464,2474,-20
19766815363,19766815367,4,1929,1207,-20
19767063974,19767063979,5,1505,1731,-20
19768443006,19768443011,5,2239,1194,-20
19770644341,19770644345,4,1809,1627,-20
19770992134,19770992139,5,1938,1380,-20
19774556140,19774556140,0,757,972,-20
19776272347,19776272352,5,1842,1594,-20
19778795462,19778795467,5,3420,1786,-20
19779160828,19779160830,2,2392,992,-20
19779191665,19779191672,7,9974,42921,-20
19780847126,19780847127,1,1526,1182,-20
19782980375,19782980377,2,2346,1337,-20
19783094286,19783094307,21,1451,1246,-20
19785566524,19785566526,2,1620,1243,-20
19788401502,19788401507,5,2408,1951,-20
19788521132,19788521135,3,1586,1701,-20
19793796475,19793796478,3,1682,1627,-20
19796034894,19796034898,4,1052,782,-20
19796163177,19796163181,4,1472,1306,-20
19797496387,19797496393,6,2281,1281,-20
19797921127,19797921131,4,1198,841,-20
19802709064,19802709066,2,1144,1184,-20
19803205282,19803205287,5,1933,1035,-20
19805616741,19805616743,2,1436,1179,-20
19807493543,19807493542,-1,1776,2369,-20
19808849176,19808849178,2,1207,1285,-20
19809400762,19809400760,-2,1533,1563,-20
19810630364,19810630365,1,1883,1811,-20
19813270990,19813270993,3,2161,1399,-20
19816917003,19816917003,0,2464,1837,-20
19820522736,19820522738,2,2139,1763,-20
19822544085,19822544089,4,635,570,-20
19823512469,19823512472,3,1552,1450,-20
19826994543,19826994547,4,1848,1202,-20
19836946376,19836946379,3,2021,1805,-20
19837302549,19837302556,7,3112,1930,-20
19838132654,19838132659,5,2312,1477,-20
19841888290,19841888294,4,2069,1699,-20
19842280217,19842280219,2,1628,1166,-20
19842743306,19842743308,2,1504,1517,-20
19843368043,19843368047,4,2248,1960,-20
19845297666,19845297670,4,1400,1157,-20
19846974137,19846974139,2,1902,1748,-20
19847598405,19847598407,2,1581,1417,-20
19849887515,19849887519,4,1145,834,-20
19852000959,19852000963,4,2779,1134,-20
19854719141,19854719146,5,1968,834,-20
19856913425,19856913427,2,1895,1539,-20
19860293981,19860293989,8,11762,32042,-20
19860640202,19860640202,0,1195,1920,-20
19862592975,19862592964,-11,1480,163,-20
19863314547,19863314528,-19,693,216,-20
19863580037,19863580057,20,2330,1057,-20
19864195078,19864195081,3,1179,1302,-20
19864652168,19864652173,5,2138,2406,-20
19865182390,19865182394,4,1301,1104,-20
19870526286,19870526289,3,1724,1351,-20
19870771869,19870771873,4,1485,1147,-20
19871371992,19871371995,3,1451,1485,-20
19873613124,19873613129,5,1607,975,-20
19874018893,19874018899,6,1575,1226,-20
19877129542,19877129545,3,1082,1161,-20
19877652778,19877652778,0,1412,1212,-20
19877784352,19877784354,2,1554,1312,-20
19879183158,19879183162,4,1100,1017,-20
19885326141,19885326144,3,1599,972,-20
19885605661,19885605663,2,1784,1469,-20
19890660795,19890660798,3,2051,1761,-20
19891305987,19891305988,1,1180,2295,-20
19891343258,19891343247,-11,1103,1307,-20
19891735061,19891735060,-1,1985,2226,-20
19893268119,19893268124,5,1621,1569,-20
19896948638,19896948642,4,3051,1528,-20
19903673529,19903673532,3,1944,1622,-20
19906609349,19906609350,1,2049,1951,-20
19907847964,19907847967,3,1614,1506,-20
19908605606,19908605613,7,2268,1190,-20
19910748280,19910748283,3,1552,982,-20
19911446273,19911446279,6,1025,1406,-20
19916850266,19916850269,3,1305,1587,-20
19918501527,19918501530,3,1491,1630,-20
19923366806,19923366809,3,1719,1065,-20
19924644585,19924644588,3,2160,1752,-20
19924940133,19924940138,5,58993,36590,-20
19926296350,19926296357,7,2090,1341,-20
19928095609,19928095613,4,3171,1878,-20
19933875106,19933875109,3,1430,1348,-20
19937644276,19937644279,3,1837,997,-20
19939015508,19939015505,-3,1286,2513,-20
19939288095,19939288098,3,2139,1894,-20
19941783451,19941783454,3,1874,1594,-20
19944541479,19944541483,4,2052,1398,-20
19946413179,19946413182,3,1934,1945,-20
19946922396,19946922399,3,1316,1163,-20
19948804658,19948804653,-5,804,3922,-20
19949359014,19949359018,4,2585,1696,-20
19952441870,19952441874,4,1699,1753,-20
19952888623,19952888627,4,2075,1401,-20
19956170508,19956170509,1,2188,2072,-20
19960533017,19960533013,-4,1368,3146,-20
19962307499,19962307502,3,2000,1859,-20
19965576783,19965576786,3,1609,1227,-20
19966718455,19966718458,3,1236,928,-20
19968238522,19968238525,3,1876,1776,-20
19972655517,19972655519,2,2614,1333,-20
19975119073,19975119078,5,2391,1865,-20
19976157233,19976157235,2,2053,1664,-20
19977254098,19977254102,4,1322,1369,-20
19978742855,19978742854,-1,1449,2546,-20
19980254364,19980254365,1,1347,1586,-20
19981256061,19981256064,3,1403,1400,-20
19985924176,19985924179,3,1803,1472,-20
19987675629,19987675651,22,1527,1460,-20
19988159734,19988159735,1,1260,1285,-20
19989374182,19989374186,4,2337,1675,-20
19992202894,19992202898,4,1679,892,-20
19999849186,19999849186,0,704,320,-20
20005298429,20005298431,2,1088,1489,-20
20008648634,20008648639,5,1458,1011,-20
20011688883,20011688885,2,838,991,-20
20013574030,20013574035,5,2285,1258,-20
20016730817,20016730822,5,3332,1581,-20
20017083958,20017083959,1,1549,1089,-20
20018383201,20018383205,4,1493,1066,-20
20021245842,20021245847,5,1155,906,-20
20032652634,20032652632,-2,967,1815,-20
20034096995,20034096999,4,1986,1308,-20
20034682501,20034682506,5,1494,1176,-20
20035608598,20035608602,4,1637,545,-20
20039630426,20039630431,5,1771,1435,-20
20040388647,20040388650,3,2319,1374,-20
20041467992,20041467994,2,2521,1764,-20
20044139571,20044139574,3,843,839,-20
20046655220,20046655223,3,1815,1294,-20
20048010382,20048010387,5,1153,1126,-20
20048391689,20048391696,7,2237,1318,-20
20049350877,20049350856,-21,1065,1001,-20
20054396166,20054396172,6,1661,1542,-20
20056983441,20056983445,4,1942,1488,-20
20058268178,20058268179,1,1553,1167,-20
20061076994,20061076995,1,1688,2404,-20
20062508598,20062508601,3,1100,891,-20
20064583255,20064583257,2,2329,1845,-20
20068459934,20068459937,3,1307,946,-20
20068555547,20068555528,-19,1168,1242,-20
20069337607,20069337610,3,1910,1255,-20
20070147029,20070147031,2,2228,1844,-20
20076106521,20076106523,2,1290,1152,-20
20077189036,20077189039,3,1286,1241,-20
20078870670,20078870673,3,2135,1686,-20
20079287243,20079287244,1,1700,1099,-20
20079354909,20079354914,5,1581,1778,-20
20084206650,20084206654,4,1014,1002,-20
20085985613,20085985616,3,2309,1457,-20
20089637971,20089637975,4,1097,1324,-20
20089666708,20089666711,3,2334,1605,-20
20090465132,20090465135,3,1401,1194,-20
20091585354,20091585356,2,2353,1277,-20
20093551979,20093551983,4,1634,1119,-20
20095084682,20095084685,3,1733,1113,-20
20096619748,20096619750,2,2053,1351,-20
20098025267,20098025271,4,2360,2249,-20
20098267443,20098267445,2,1655,1441,-20
20099819196,20099819198,2,1653,1173,-20
20101179751,20101179753,2,1522,1105,-20
20102809066,20102809070,4,1137,1101,-20
20105040564,20105040567,3,1385,1420,-20
20106226493,20106226496,3,1699,1803,-20
20110002125,20110002127,2,2043,1762,-20
20110299475,20110299478,3,1668,1548,-20
20112921299,20112921298,-1,1483,1987,-20
20113196318,20113196323,5,2095,2026,-20
20114404003,20114404006,3,936,905,-20
20117532950,20117532955,5,1736,966,-20
20118854570,20118854571,1,874,1001,-20
20119654333,20119654335,2,1867,1774,-20
20121119451,20121119454,3,1771,1414,-20
20121197339,20121197344,5,1656,1253,-20
20121251618,20121251623,5,1073,913,-20
20121588226,20121588229,3,1761,1810,-20
20124160111,20124160110,-1,2197,2777,-20
20124423222,20124423227,5,1940,1572,-20
20126124177,20126124179,2,1802,1400,-20
20126264743,20126264744,1,1542,1897,-20
20126465718,20126465700,-18,1698,1512,-20
20127532922,20127532905,-17,1341,850,-20
20128594541,20128594544,3,1867,1034,-20
20130771390,20130771394,4,2671,1146,-20
20132359113,20132359116,3,2687,1407,-20
20133348026,20133348030,4,1103,1093,-20
20135381683,20135381685,2,2047,1516,-20
20136615955,20136615957,2,1919,1323,-20
20138887329,20138887334,5,1769,1002,-20
20139023890,20139023887,-3,908,1775,-20
20139828667,20139828669,2,1635,1300,-20
20140592614,20140592619,5,1676,1211,-20
20142374892,20142374893,1,1902,1434,-20
20142632843,20142632846,3,1572,1364,-20
20143764209,20143764211,2,1971,1396,-20
20144194320,20144194324,4,2574,1553,-20
20147126594,20147126598,4,1967,1344,-20
20147170481,20147170484,3,2152,1484,-20
20147395142,20147395143,1,1049,1267,-20
20158075667,20158075671,4,989,747,-20
20159381318,20159381320,2,2510,1363,-20
20159594420,20159594423,3,2454,1952,-20
20160282124,20160282129,5,1510,1083,-20
20161008198,20161008201,3,2496,1366,-20
20166018521,20166018524,3,1438,1688,-20
20166509627,20166509635,8,1376,1090,-20
20167063042,20167063050,8,2129,1414,-20
20169359574,20169359578,4,2552,1644,-20
20170984778,20170984780,2,2133,1548,-20
20171989054,20171989057,3,1630,792,-20
20178601139,20178601142,3,902,981,-20
20181996629,20181996630,1,2434,1574,-20
20182472301,20182472303,2,2139,1525,-20
20184205254,20184205259,5,2189,1069,-20
20187036360,20187036360,0,1525,1530,-20
20188650153,20188650155,2,1132,1061,-20
20189618621,20189618625,4,2220,1910,-20
20189658752,20189658755,3,2352,1760,-20
20189968049,20189968049,0,1343,1652,-20
20200489660,20200489664,4,1105,1139,-20
20202711833,20202711835,2,1539,660,-20
20204737177,20204737174,-3,1569,2028,-20
20205458995,20205458998,3,1632,1371,-20
20210155414,20210155416,2,2059,1354,-20
20210526357,20210526338,-19,2051,1332,-20
20212711268,20212711271,3,1897,1401,-20
20214521346,20214521349,3,1482,1439,-20
20218100509,20218100514,5,1707,1446,-20
20221356179,20221356182,3,121,1012,-20
20229741554,20229741551,-3,848,1671,-20
20232456906,20232456907,1,1995,1400,-20
20233030005,20233030007,2,2080,1406,-20
20237344001,20237344003,2,1361,922,-20
20237376735,20237376714,-21,558,500,-20
20239005572,20239005573,1,1997,1909,-20
20239479851,20239479855,4,1118,790,-20
20241039910,20241039914,4,1708,1603,-20
20246412695,20246412696,1,1211,1264,-20
20247293750,20247293751,1,1997,828,-20
20253087098,20253087104,6,3117,1705,-20
20253279753,20253279758,5,1761,826,-20
20253873647,20253873650,3,1586,986,-20
20255711658,20255711663,5,1894,1210,-20
20256564826,20256564831,5,1856,1722,-20
20259153581,20259153587,6,4446,1734,-20
20260786354,20260786358,4,1408,991,-20
20261570095,20261570098,3,1573,787,-20
20262487082,20262487085,3,1904,1750,-20
20264688901,20264688904,3,1388,929,-20
20265644158,20265644162,4,2332,1544,-20
20266461591,20266461595,4,2147,1625,-20
20266592606,20266592611,5,822,978,-20
20269434050,20269434057,7,1598,944,-20
20273923865,20273923870,5,1475,1205,-20
20275034257,20275034260,3,1326,1353,-20
20277704375,20277704379,4,2285,1348,-20
20279861231,20279861234,3,1928,1427,-20
20283745302,20283745305,3,1850,2037,-20
20286367798,20286367803,5,2359,1501,-20
20288346446,20288346452,6,2658,1745,-20
20290515650,20290515654,4,2257,1421,-20
20292027073,20292027076,3,1744,1331,-20
20294883405,20294883406,1,832,953,-20
20295810392,20295810394,2,1304,1842,-20
20296300399,20296300404,5,2121,1732,-20
20298143643,20298143645,2,2005,1925,-20
20301436350,20301436354,4,1813,1458,-20
20301959501,20301959504,3,1660,1591,-20
20302099058,20302099064,6,2546,1592,-20
20304166114,20304166115,1,1452,1524,-20
20304435625,20304435629,4,1787,1518,-20
20305183854,20305183855,1,927,1077,-20
20305363685,20305363687,2,1505,1177,-20
20307789456,20307789455,-1,1440,1749,-20
20307846790,20307846772,-18,2092,1367,-20
20308062626,20308062630,4,2428,1628,-20
20309351703,20309351704,1,1791,1551,-20
20313296528,20313296532,4,2576,1532,-20
20313969284,20313969287,3,2214,1371,-20
20314955634,20314955639,5,1749,1503,-20
20315834274,20315834278,4,2022,1387,-20
20317178522,20317178515,-7,1963,7785,-20
20319637759,20319637762,3,1336,1044,-20
20324922349,20324922351,2,1827,1288,-20
20327518086,20327518089,3,2145,1397,-20
20329530616,20329530617,1,1509,1414,-20
20330102796,20330102800,4,1516,1099,-20
20330548406,20330548410,4,2483,1151,-20
20330993220,20330993222,2,1475,1403,-20
20332576243,20332576248,5,2174,1855,-20
20335873020,20335873023,3,2118,1369,-20
20336447112,20336447116,4,1774,1324,-20
20336558698,20336558702,4,2672,1594,-20
20337567423,20337567423,0,1741,1814,-20
20339228249,20339228251,2,1771,1022,-20
20346461653,20346461657,4,1519,1276,-20
20347929765,20347929767,2,2136,1658,-20
20351680230,20351680234,4,2184,1504,-20
20352758857,20352758862,5,1343,1363,-20
20355255783,20355255786,3,1612,1062,-20
20357964233,20357964235,2,1258,1179,-20
20358475610,20358475615,5,1380,1219,-20
20361437177,20361437179,2,1473,1691,-20
20363805051,20363805055,4,2140,1090,-20
20365159982,20365159987,5,1547,1750,-20
20365538557,20365538562,5,1813,1912,-20
20366514210,20366514215,5,1194,1260,-20
20367610538,20367610540,2,1321,1253,-20
20370520810,20370520814,4,1035,1430,-20
20372609423,20372609427,4,1447,1036,-20
20376787490,20376787494,4,2596,1876,-20
20379152249,20379152249,0,1811,2718,-20
20381346614,20381346616,2,1176,1765,-20
20384639345,20384639349,4,2036,1537,-20
20389478699,20389478703,4,1745,1141,-20
20392348141,20392348146,5,1615,1275,-20
20395088878,20395088881,3,1991,1825,-20
20396694353,20396694359,6,2275,683,-20
20400785355,20400785359,4,1736,1187,-20
20401402839,20401402851,12,1289,969,-20
20404308148,20404308150,2,2004,1432,-20
20404463301,20404463302,1,1214,1199,-20
20406013838,20406013843,5,2395,1060,-20
20406065625,20406065629,4,1945,2112,-20
20406888235,20406888239,4,1075,1382,-20
20408302468,20408302472,4,2002,1350,-20
20408773162,20408773166,4,2000,1584,-20
20409304560,20409304565,5,1173,1695,-20
20409685721,20409685722,1,1507,1439,-20
20411482978,20411482981,3,984,1218,-20
20411850861,20411850865,4,1517,1435,-20
20412894386,20412894389,3,1736,696,-20
20414213933,20414213938,5,1870,1213,-20
20415611946,20415611949,3,2173,1403,-20
20415812196,20415812179,-17,2102,980,-20
20416145439,20416145442,3,1670,1506,-20
20416285810,20416285816,6,859,714,-20
20416602763,20416602766,3,2306,2305,-20
20418108584,20418108577,-7,1043,7488,-20
20418595796,20418595799,3,1539,1082,-20
20423328086,20423328082,-4,849,2544,-20
20423722435,20423722438,3,1467,1503,-20
20426857949,20426857952,3,1557,1609,-20
20432143056,20432143061,5,11735,19426,-20
20433510888,20433510890,2,2393,1545,-20
20434539799,20434539802,3,1405,1374,-20
20435277769,20435277771,2,2072,1781,-20
20440311783,20440311786,3,2008,1719,-20
20443089038,20443089037,-1,910,2102,-20
20444552507,20444552510,3,1439,959,-20
20447446362,20447446366,4,1648,1262,-20
20447477861,20447477864,3,1062,1074,-20
20448539234,20448539238,4,1814,1691,-20
20449809002,20449809006,4,3175,1648,-20
20449910728,20449910734,6,1764,1359,-20
20451210089,20451210094,5,1607,1164,-20
20451953398,20451953402,4,1643,1397,-20
20454329180,20454329183,3,1808,1628,-20
20459450520,20459450523,3,1612,1467,-20
20461422366,20461422370,4,1351,1590,-20
20462974811,20462974814,3,1811,1363,-20
20464818157,20464818162,5,1477,1581,-20
20465118910,20465118910,0,1236,2168,-20
20465146248,20465146253,5,2313,1674,-20
20467567534,20467567537,3,1601,1149,-20
20471694050,20471694055,5,2141,1445,-20
20472591549,20472591550,1,806,751,-20
20475960873,20475960876,3,2197,1853,-20
20480827491,20480827495,4,1890,1744,-20
20481539085,20481539086,1,1506,1233,-20
20482212991,20482212993,2,2087,1180,-20
20485220636,20485220639,3,2492,1736,-20
20486231784,20486231787,3,1839,1257,-20
20486419257,20486419258,1,1923,1565,-20
20487064682,20487064677,-5,35325,15041,-20
20495779868,20495779869,1,1777,1955,-20
20495866793,20495866794,1,1522,1274,-20
20498360742,20498360747,5,1578,1367,-20
20504529088,20504529090,2,6950,6011,-20
20506185658,20506185661,3,1557,1257,-20
20509736109,20509736111,2,2227,1397,-20
20513585235,20513585239,4,2305,1548,-20
20515715584,20515715587,3,1816,1679,-20
20515834478,20515834482,4,1954,1142,-20
20518052048,20518052052,4,2458,2104,-20
20518305427,20518305430,3,863,1092,-20
20518510042,20518510035,-7,2932,7801,-20
20522833666,20522833666,0,1561,1446,-20
20524043910,20524043914,4,2861,1059,-20
20524270597,20524270602,5,1160,1107,-20
20528148594,20528148597,3,1324,969,-20
20528251585,20528251587,2,1512,1237,-20
20530894750,20530894751,1,1512,1235,-20
20531191982,20531191986,4,1623,999,-20
20532081978,20532081982,4,1763,1317,-20
20536051874,20536051879,5,2168,2087,-20
20540949729,20540949731,2,1812,1372,-20
20544634437,20544634440,3,1913,1453,-20
20549324359,20549324364,5,2439,1234,-20
20556361334,20556361338,4,1632,1376,-20
20557940274,20557940279,5,2149,1095,-20
20565949569,20565949572,3,1445,1147,-20
20568824670,20568824675,5,2300,955,-20
20569170986,20569170968,-18,766,784,-20
20571295136,20571295138,2,2015,1467,-20
20576336933,20576336937,4,2775,2375,-20
20576503407,20576503410,3,1318,1021,-20
20577415628,20577415637,9,12,2810,-20
20578406960,20578406962,2,1175,634,-20
20579335465,20579335468,3,1948,1959,-20
20579646306,20579646306,0,1826,1869,-20
20581094138,20581094142,4,1379,935,-20
20582765154,20582765151,-3,673,2407,-20
20583589482,20583589485,3,1334,980,-20
20585967037,20585967041,4,2226,1550,-20
20587136180,20587136182,2,1825,1383,-20
20587930939,20587930942,3,1408,680,-20
20588899217,20588899221,4,1255,911,-20
20591491316,20591491319,3,1813,1572,-20
20594357996,20594358001,5,1532,1119,-20
20594624766,20594624769,3,1789,1081,-20
20595041610,20595041625,15,1583,1804,-20
20596373500,20596373503,3,1701,1427,-20
20598740646,20598740641,-5,1565,2730,-20
20603642370,20603642373,3,1976,1315,-20
20608433882,20608433883,1,2396,3495,-20
20616942919,20616942922,3,2547,1648,-20
20616991574,20616991569,-5,1441,4115,-20
20617803637,20617803639,2,1878,1272,-20
20619905386,20619905389,3,915,1258,-20
20621729095,20621729098,3,1871,1540,-20
20621799085,20621799087,2,2226,1715,-20
20623179685,20623179687,2,1249,1536,-20
20623955618,20623955622,4,670,910,-20
20627011727,20627011730,3,1739,1230,-20
20630891246,20630891252,6,2129,1187,-20
20632269254,20632269255,1,1813,1331,-20
20632634673,20632634676,3,1702,1452,-20
20636396438,20636396441,3,2391,2212,-20
20640809494,20640809498,4,858,1024,-20
20641928032,20641928029,-3,2053,4019,-20
20642635430,20642635435,5,1356,864,-20
20644482374,20644482378,4,2079,1926,-20
20646528431,20646528436,5,1319,1439,-20
20646662927,20646662905,-22,1292,889,-20
20648832116,20648832119,3,1880,1274,-20
20649714718,20649714722,4,1916,1702,-20
20650713495,20650713498,3,1540,1166,-20
20653213189,20653213191,2,1400,1195,-20
20654827319,20654827322,3,1801,1653,-20
20660892682,20660892676,-6,712,2143,-20
20668996995,20668996998,3,1463,1257,-20
20670032268,20670032274,6,2214,1062,-20
20670362646,20670362650,4,1835,1135,-20
20670928170,20670928175,5,1838,1891,-20
20673090341,20673090342,1,1483,1405,-20
20673244959,20673244962,3,1989,1670,-20
20678275882,20678275883,1,1275,720,-20
20680009690,20680009691,1,1751,2106,-20
20680859970,20680859974,4,1767,1257,-20
20681381153,20681381158,5,2808,2181,-20
20682570053,20682570058,5,1891,1408,-20
20685702155,20685702158,3,1473,1437,-20
20691149898,20691149903,5,1755,1351,-20
20692975183,20692975167,-16,1372,776,-20
20693360118,20693360122,4,1534,1132,-20
20697499606,20697499601,-5,962,3469,-20
20699921902,20699921903,1,1414,1598,-20
20702816666,20702816669,3,1472,1573,-20
20703690809,20703690811,2,1721,1688,-20
20703882319,20703882323,4,1804,1423,-20
20704239175,20704239178,3,1531,1359,-20
20705881749,20705881751,2,1096,693,-20
20706409278,20706409281,3,2473,1271,-20
20707369294,20707369297,3,1459,1470,-20
20708449497,20708449500,3,2309,1645,-20
20708701710,20708701714,4,1135,1560,-20
20714599893,20714599894,1,1976,1374,-20
20715009430,20715009433,3,2341,1872,-20
20717118263,20717118267,4,599,364,-20
20720624106,20720624112,6,3797,1617,-20
20721027469,20721027473,4,2542,1709,-20
20723284037,20723284039,2,1763,1427,-20
20727693842,20727693844,2,1188,817,-20
20728089155,20728089170,15,1586,814,-20
20730765461,20730765465,4,2007,1655,-20
20734632875,20734632879,4,1174,969,-20
20736476069,20736476072,3,2335,2208,-20
20737080206,20737080210,4,903,943,-20
20737945696,20737945699,3,1774,1049,-20
20745219991,20745219987,-4,1501,2949,-20
20745907603,20745907607,4,1652,1448,-20
20746933203,20746933205,2,2076,1763,-20
20747819853,20747819855,2,2272,1275,-20
20748861158,20748861166,8,12321,30811,-20
20750059704,20750059707,3,1325,1132,-20
20753438726,20753438730,4,1178,1445,-20
20757576505,20757576508,3,2652,1243,-20
20758334806,20758334784,-22,1877,1565,-20
20759612617,20759612607,-10,3382,23824,-20
20760669505,20760669507,2,2821,2260,-20
20762842770,20762842774,4,2454,1529,-20
20762999582,20762999585,3,1814,1954,-20
20765087738,20765087741,3,591,786,-20
20765937010,20765937014,4,1561,1626,-20
20769231762,20769231763,1,1262,1439,-20
20770161135,20770161138,3,1837,1296,-20
20771609142,20771609147,5,2695,1918,-20
20775601790,20775601791,1,492,1236,-20
20777564403,20777564390,-13,386,10007,-20
20778731850,20778731853,3,1803,1154,-20
20779930932,20779930912,-20,2231,1063,-20
20781090145,20781090147,2,2016,1509,-20
20781944625,20781944619,-6,2137,7943,-20
20783426950,20783426953,3,1449,946,-20
20784738118,20784738122,4,1914,1621,-20
20785439521,20785439523,2,1623,1217,-20
20789055319,20789055322,3,1708,1799,-20
20789289023,20789289028,5,3004,1664,-20
20790853835,20790853838,3,1573,1241,-20
20795263123,20795263131,8,4812,1669,-20
20797693018,20797693018,0,1478,1410,-20
20799369624,20799369628,4,1476,1409,-20
20800643426,20800643442,16,1242,2357,-20
20802572576,20802572581,5,2017,1377,-20
20803599533,20803599514,-19,1482,1260,-20
20812181005,20812181010,5,2110,1058,-20
20813327531,20813327532,1,1683,1729,-20
20813662499,20813662502,3,1906,1576,-20
20813809021,20813809028,7,1688,1627,-20
20814539395,20814539394,-1,1297,1233,-20
20817140169,20817140171,2,2434,1442,-20
20818614942,20818614950,8,1578,1414,-20
20819655059,20819655062,3,2125,1352,-20
20820732381,20820732386,5,1785,1428,-20
20822426802,20822426795,-7,1633,3407,-20
20825949783,20825949787,4,1261,1178,-20
20826512158,20826512162,4,1979,1076,-20
20830981174,20830981178,4,2170,1372,-20
20831327142,20831327145,3,1653,1414,-20
20835999766,20835999770,4,1679,1222,-20
20843277803,20843277806,3,1242,764,-20
20843370698,20843370698,0,1327,848,-20
20843742442,20843742443,1,11689,14192,-20
20844216914,20844216914,0,2044,2528,-20
20845912102,20845912106,4,2413,1789,-20
20847076386,20847076383,-3,17969,73185,-20
20847130724,20847130727,3,2317,1507,-20
20849720699,20849720704,5,1832,1453,-20
20853901546,20853901550,4,1956,1390,-20
20859749617,20859749618,1,1892,1226,-20
20862352718,20862352729,11,1889,1606,-20
20862741373,20862741378,5,2161,1160,-20
20864228925,20864228930,5,2361,1152,-20
20869155771,20869155775,4,1837,1097,-20
20869971658,20869971662,4,1979,1377,-20
20870926536,20870926538,2,1976,1498,-20
20871866057,20871866060,3,1870,1110,-20
20871906363,20871906367,4,1717,1484,-20
20877325595,20877325595,0,2114,1464,-20
20881642289,20881642291,2,1363,1541,-20
20884261866,20884261867,1,2766,2543,-20
20886881005,20886881009,4,2105,1573,-20
20887898473,20887898477,4,2024,1408,-20
20891960713,20891960717,4,1559,1575,-20
20897941547,20897941540,-7,1101,6894,-20
20902416098,20902416104,6,1920,831,-20
20906249768,20906249770,2,1883,1234,-20
20906502074,20906502078,4,1981,1108,-20
20908118371,20908118373,2,1892,1572,-20
20910072374,20910072376,2,2657,2105,-20
20910975324,20910975327,3,1739,1500,-20
20912258437,20912258438,1,2001,1916,-20
20916671169,20916671172,3,2480,1647,-20
20918279879,20918279882,3,1825,1283,-20
20919265458,20919265442,-16,1985,1481,-20
20920089494,20920089515,21,1537,1233,-20
20923942698,20923942703,5,1534,1071,-20
20924031830,20924031808,-22,1708,1399,-20
20927995934,20927995938,4,1940,1436,-20
20928246573,20928246578,5,1381,1445,-20
20928792070,20928792073,3,1809,1482,-20
20932589057,20932589058,1,1404,1244,-20
20934292809,20934292809,0,1340,1063,-20
20936125918,20936125924,6,1469,1210,-20
20937385466,20937385467,1,909,1385,-20
20940016199,20940016202,3,1947,1568,-20
20944259554,20944259559,5,2239,1482,-20
20946476286,20946476288,2,2359,1625,-20
20948802561,20948802564,3,1390,1112,-20
20952227954,20952227955,1,1633,1442,-20
20953909592,20953909589,-3,1828,2933,-20
20955310138,20955310142,4,1612,970,-20
20957518511,20957518515,4,952,890,-20
20958609987,20958609991,4,1330,1175,-20
20966935307,20966935309,2,1147,1444,-20
20968253298,20968253301,3,1931,1179,-20
20969221269,20969221272,3,1939,1494,-20
20970052407,20970052410,3,2407,1604,-20
20971193262,20971193266,4,1637,1331,-20
20974632590,20974632595,5,1349,991,-20
20978414291,20978414293,2,1993,1534,-20
20978794215,20978794219,4,1809,1514,-20
20979846082,20979846087,5,2120,1065,-20
20980706563,20980706566,3,1466,1133,-20
20984335865,20984335869,4,2721,1643,-20
20984962462,20984962452,-10,1369,1138,-20
20987088422,20987088426,4,830,1175,-20
20990270500,20990270504,4,2156,1571,-20
20991035437,20991035456,19,1792,1217,-20
20999912168,20999912171,3,1964,1289,-20
21001419539,21001419541,2,1507,1060,-20
21008173278,21008173274,-4,1713,3559,-20
21015989877,21015989880,3,1290,1128,-20
21016553861,21016553864,3,1942,1575,-20
21017804850,21017804851,1,2831,3446,-20
21019043167,21019043169,2,1413,1273,-20
21020808130,21020808131,1,1805,1527,-20
21024857053,21024857055,2,1518,1411,-20
21027631990,21027631994,4,2111,1121,-20
21031481074,21031481075,1,1789,904,-20
21035123152,21035123157,5,1971,1449,-20
21035568142,21035568146,4,1306,1623,-20
21038156859,21038156862,3,444,619,-20
21038950109,21038950111,2,1991,1299,-20
21041697994,21041697990,-4,2073,5587,-20
21043903668,21043903671,3,1431,1466,-20
21046676482,21046676486,4,1797,1505,-20
21048631812,21048631814,2,2622,2216,-20
21049844341,21049844345,4,2200,1450,-20
21049986710,21049986689,-21,834,806,-20
21050193011,21050193013,2,1166,1037,-20
21050392697,21050392701,4,2155,1436,-20
21051745408,21051745411,3,2551,1796,-20
21053979938,21053979938,0,2206,1644,-20
21054745306,21054745310,4,2645,2083,-20
21054983749,21054983753,4,1679,1424,-20
21057324973,21057324977,4,1942,1912,-20
21057390736,21057390737,1,2017,1397,-20
21058742028,21058742031,3,2206,1584,-20
21063362546,21063362551,5,1115,1083,-20
21064020314,21064020335,21,1353,989,-20
21065430858,21065430850,-8,1105,17552,-20
21071109845,21071109851,6,1478,1166,-20
21071837781,21071837782,1,1669,1601,-20
21071948303,21071948307,4,1554,1645,-20
21072243475,21072243478,3,2002,2182,-20
21073121914,21073121918,4,2092,1923,-20
21074297723,21074297727,4,1326,1018,-20
21075302722,21075302722,0,1444,1985,-20
21077321226,21077321227,1,1659,1841,-20
21079683736,21079683738,2,1652,1409,-20
21081408573,21081408577,4,1760,1364,-20
21081729880,21081729882,2,1722,1093,-20
21082493478,21082493482,4,2013,1746,-20
21082661514,21082661518,4,2258,1582,-20
21084013894,21084013899,5,2353,1787,-20
21086686231,21086686234,3,1007,808,-20
21088434497,21088434501,4,3706,2119,-20
21090851561,21090851564,3,3047,1708,-20
21091039758,21091039760,2,1662,1595,-20
21093602880,21093602879,-1,1288,1537,-20
21093741576,21093741589,13,213,1633,-20
21107791494,21107791498,4,2611,1726,-20
21113035264,21113035270,6,9388,32942,-20
21114426561,21114426565,4,2509,1390,-20
21115750204,21115750208,4,1614,1058,-20
21117405662,21117405667,5,3286,1630,-20
21121287413,21121287416,3,2024,1223,-20
21125444569,21125444573,4,1192,1164,-20
21127650616,21127650621,5,1846,1518,-20
21129574006,21129574009,3,1543,1228,-20
21135317426,21135317430,4,1652,1247,-20
21135949657,21135949659,2,1853,1897,-20
21136866188,21136866190,2,1426,1774,-20
21141743753,21141743754,1,1414,1596,-20
21143346706,21143346709,3,1838,1091,-20
21143405069,21143405073,4,2140,1289,-20
21144841429,21144841431,2,2292,1998,-20
21148758055,21148758059,4,2258,1816,-20
21148884382,21148884382,0,1310,1208,-20
21150897746,21150897748,2,1634,1640,-20
21151160730,21151160730,0,2408,1844,-20
21151790866,21151790866,0,1390,1659,-20
21153124691,21153124694,3,2237,1634,-20
21158159129,21158159135,6,1916,885,-20
21158548550,21158548528,-22,1066,835,-20
21163558446,21163558448,2,23070,25094,-20
21164698484,21164698489,5,1914,1909,-20
21167256522,21167256527,5,2054,1661,-20
21167611345,21167611349,4,1599,1284,-20
21168382825,21168382828,3,1615,1266,-20
21168676711,21168676715,4,963,1122,-20
21172985010,21172985015,5,990,952,-20
21178330140,21178330145,5,2291,1529,-20
21179679583,21179679589,6,11474,6484,-20
21180482922,21180482926,4,1652,1254,-20
21182858663,21182858666,3,1596,1207,-20
21183478623,21183478622,-1,7614,12078,-20
21186177146,21186177149,3,1733,1739,-20
21187359067,21187359071,4,1540,1082,-20
21192982771,21192982773,2,1461,1153,-20
21193009587,21193009585,-2,1355,1088,-20
21193456833,21193456837,4,2387,1409,-20
21194558358,21194558361,3,2101,1765,-20
21195066684,21195066687,3,2286,1913,-20
21195837032,21195837034,2,2438,2248,-20
21197247346,21197247351,5,1130,941,-20
21201135402,21201135405,3,1264,1260,-20
21203478423,21203478421,-2,7586,11628,-20
21206671951,21206671955,4,2535,1877,-20
21209596179,21209596181,2,1464,993,-20
21210567696,21210567699,3,1450,1395,-20
21210864553,21210864558,5,1875,1244,-20
21211776457,21211776461,4,1654,1120,-20
21211842501,21211842480,-21,2142,1586,-20
21213628583,21213628586,3,1474,1128,-20
21220263716,21220263717,1,1349,1118,-20
21221585226,21221585230,4,2029,1161,-20
21221705990,21221705994,4,1395,1086,-20
21227082651,21227082654,3,1552,1045,-20
21230499983,21230499988,5,1807,943,-20
21233360178,21233360182,4,2723,1949,-20
21235306234,21235306235,1,2091,1998,-20
21235887418,21235887421,3,1804,989,-20
21236616101,21236616105,4,2377,1542,-20
21239354357,21239354363,6,1715,970,-20
21240750862,21240750867,5,1863,1473,-20
21243441024,21243441024,0,1244,1904,-20
21244742333,21244742337,4,1720,1778,-20
21248471616,21248471621,5,1971,1428,-20
21250199182,21250199186,4,1631,1401,-20
21250504950,21250504954,4,1406,1835,-20
21251240062,21251240065,3,1234,1784,-20
21253860928,21253860930,2,1927,1274,-20
21254348034,21254348035,1,1427,1037,-20
21256874893,21256874895,2,1251,906,-20
21260915882,21260915888,6,2563,1819,-20
21261846874,21261846877,3,1836,2152,-20
21262494166,21262494170,4,1794,1410,-20
21263540894,21263540902,8,4531,2260,-20
21265804111,21265804114,3,601,575,-20
21265974258,21265974267,9,11602,36637,-20
21266134703,21266134707,4,2491,1095,-20
21267057187,21267057207,20,233,845,-20
21269108169,21269108175,6,1959,1129,-20
21269929979,21269929982,3,2412,1187,-20
21270670546,21270670551,5,3456,2008,-20
21281165080,21281165082,2,1753,1037,-20
21281782408,21281782396,-12,1215,1598,-20
21282590880,21282590883,3,1512,1287,-20
21285249264,21285249268,4,2180,1535,-20
21288837268,21288837270,2,1881,1453,-20
21291505833,21291505834,1,2056,2008,-20
21292338755,21292338760,5,2565,1735,-20
21297296426,21297296421,-5,1343,5368,-20
21297786777,21297786781,4,1911,1628,-20
21297830418,21297830423,5,1846,892,-20
21297966350,21297966332,-18,1799,1333,-20
21298753673,21298753675,2,2392,1586,-20
21299164378,21299164382,4,2288,1338,-20
21299300747,21299300750,3,2038,1217,-20
21302163759,21302163762,3,1874,1190,-20
21303945537,21303945542,5,2080,1743,-20
21304602082,21304602084,2,2050,2166,-20
21305059482,21305059487,5,2201,1399,-20
21309660331,21309660335,4,1658,1270,-20
21315239091,21315239089,-2,1063,1630,-20
21316746699,21316746691,-8,1308,5517,-20
21317281529,21317281532,3,1920,1713,-20
21319782290,21319782298,8,1648,1272,-20
21321491001,21321491006,5,1810,1355,-20
21326681247,21326681232,-15,1263,932,-20
21328251251,21328251255,4,1744,1032,-20
21328656935,21328656938,3,1671,1608,-20
21333040442,21333040446,4,1627,980,-20
21335156328,21335156330,2,1590,1313,-20
21336845838,21336845847,9,11989,31963,-20
21337253501,21337253505,4,1692,1530,-20
21341975439,21341975441,2,1337,1485,-20
21344213981,21344213974,-7,1563,7826,-20
21345898339,21345898343,4,2676,1570,-20
21347272166,21347272170,4,2560,1353,-20
21348536057,21348536061,4,1926,1205,-20
21348613828,21348613830,2,1703,1201,-20
21350967845,21350967849,4,2498,1442,-20
21351257550,21351257555,5,1768,1130,-20
21356967206,21356967210,4,1769,1269,-20
21357570194,21357570197,3,1820,1241,-20
21357720670,21357720665,-5,1557,4491,-20
21358731437,21358731441,4,1688,1303,-20
21358987259,21358987262,3,1823,1496,-20
21360922568,21360922571,3,1387,1431,-20
21362219078,21362219079,1,1835,1157,-20
21362932839,21362932842,3,1543,1737,-20
21368246901,21368246907,6,2676,999,-20
21368738338,21368738343,5,3434,1112,-20
21376300053,21376300058,5,2138,1977,-20
21378027718,21378027722,4,1775,1051,-20
21378190143,21378190145,2,1575,1598,-20
21379773785,21379773789,4,2260,1358,-20
21384433537,21384433538,1,2062,1929,-20
21385964119,21385964121,2,2347,2128,-20
21386491958,21386491961,3,1916,1591,-20
21386534076,21386534077,1,37192,41046,-20
21387826281,21387826276,-5,2435,6424,-20
21388707221,21388707226,5,1780,1593,-20
21392306676,21392306679,3,1500,1556,-20
21392788258,21392788261,3,1215,1257,-20
21393981833,21393981836,3,2045,1115,-20
21395980919,21395980921,2,1606,1129,-20
21396898999,21396899001,2,1723,1335,-20
21397218681,21397218682,1,1340,1226,-20
21403862476,21403862480,4,2355,1652,-20
21410563461,21410563458,-3,1224,1653,-20
21420627739,21420627742,3,1438,1576,-20
21421152986,21421152989,3,1986,1212,-20
21429405402,21429405402,0,2083,3323,-20
21435514982,21435514984,2,1039,1440,-20
21439314363,21439314367,4,1516,1648,-20
21439700241,21439700245,4,1641,2061,-20
21442579754,21442579757,3,1826,953,-20
21443983761,21443983770,9,2072,1371,-20
21446567024,21446567026,2,1679,1703,-20
21457148076,21457148079,3,1546,1119,-20
21461989643,21461989647,4,1369,1563,-20
21463589331,21463589345,14,921,3899,-20
21465535610,21465535614,4,1481,1014,-20
21467434609,21467434614,5,1797,993,-20
21469379700,21469379703,3,2150,2114,-20
21470283966,21470283970,4,1722,1114,-20
21475697547,21475697550,3,2873,1724,-20
21476170853,21476170856,3,1739,1616,-20
21476824877,21476824881,4,2281,1312,-20
21476868004,21476868011,7,1976,1324,-20
21479726459,21479726463,4,1713,1299,-20
21484178733,21484178735,2,887,920,-20
21486835083,21486835088,5,1871,1266,-20
21487342841,21487342846,5,2409,1642,-20
21488382766,21488382767,1,1825,1309,-20
21490458035,21490458039,4,1232,834,-20
21490555855,21490555835,-20,1525,1464,-20
21492618198,21492618201,3,1391,1538,-20
21497233786,21497233782,-4,1451,1903,-20
21505314408,21505314413,5,2242,1366,-20
21507564785,21507564788,3,920,990,-20
21519779253,21519779255,2,1691,1499,-20
21521796970,21521796971,1,1256,1298,-20
21524113342,21524113344,2,1628,1162,-20
21526221278,21526221272,-6,30945,17069,-20
21528451783,21528451786,3,1337,1005,-20
21529278629,21529278610,-19,1951,1494,-20
21530753550,21530753553,3,1880,1375,-20
21531027410,21531027412,2,1711,1265,-20
21532876760,21532876762,2,2796,2195,-20
21534918363,21534918362,-1,1563,1701,-20
21536182171,21536182175,4,2491,1683,-20
21537681442,21537681446,4,2028,1247,-20
21541346258,21541346263,5,2050,1423,-20
21545567122,21545567125,3,1698,1292,-20
21546933198,21546933201,3,2354,1653,-20
21548049323,21548049327,4,2271,1285,-20
21550603589,21550603593,4,1131,1264,-20
21558289123,21558289125,2,1446,1447,-20
21560711775,21560711779,4,1707,1405,-20
21563128222,21563128234,12,1657,1541,-20
21568044777,21568044780,3,2528,1500,-20
21568727374,21568727373,-1,766,2147,-20
21569730747,21569730751,4,5895,2835,-20
21570404646,21570404650,4,1947,1044,-20
21570671311,21570671316,5,2615,1994,-20
21571844149,21571844150,1,1560,1547,-20
21574104989,21574104993,4,2415,1346,-20
21574620277,21574620279,2,1229,1669,-20
21582004363,21582004367,4,2059,1508,-20
21583527021,21583527026,5,1723,1472,-20
21586061101,21586061104,3,1925,1434,-20
21586625727,21586625730,3,2191,1271,-20
21589902180,21589902183,3,1617,1175,-20
21595786864,21595786866,2,2268,1878,-20
21599446358,21599446362,4,1330,781,-20
21599824494,21599824495,1,1815,1690,-20
21607581488,21607581482,-6,2468,7924,-20
21610225315,21610225318,3,1884,1348,-20
21612731750,21612731745,-5,794,3629,-20
21615796914,21615796916,2,1381,1335,-20
21617004309,21617004311,2,1598,2016,-20
21621466721,21621466723,2,2339,1240,-20
21622396752,21622396759,7,3184,1346,-20
21625686146,21625686149,3,1375,1495,-20
21628286856,21628286858,2,1469,1176,-20
21628878602,21628878615,13,464,1605,-20
21630676879,21630676882,3,1743,1249,-20
21631131191,21631131193,2,1893,1102,-20
21631943491,21631943494,3,1635,1195,-20
21632605750,21632605755,5,1336,999,-20
21634138231,21634138237,6,2540,2162,-20
21635718088,21635718091,3,2278,1432,-20
21637870675,21637870682,7,1321,1236,-20
21642233085,21642233066,-19,1305,1430,-20
21642873926,21642873927,1,1062,1490,-20
21642938423,21642938428,5,1865,1610,-20
21652849609,21652849611,2,1274,1460,-20
21653136782,21653136787,5,10334,7506,-20
21655839559,21655839562,3,1797,1602,-20
21660079751,21660079755,4,1346,1050,-20
21661362069,21661362071,2,2010,1644,-20
21662274378,21662274383,5,2239,1044,-20
21662567105,21662567110,5,2907,1134,-20
21662789807,21662789811,4,2714,1873,-20
21666281990,21666281993,3,2184,1395,-20
21666785002,21666785005,3,1383,1093,-20
21669375877,21669375881,4,1657,1491,-20
21669828912,21669828913,1,1139,1129,-20
21671109425,21671109430,5,2371,1077,-20
21678176720,21678176722,2,1860,1068,-20
21678662571,21678662556,-15,1130,1092,-20
21679277923,21679277927,4,841,486,-20
21679904281,21679904283,2,1702,1646,-20
21682615390,21682615393,3,1455,910,-20
21685526679,21685526683,4,2166,2143,-20
21685669233,21685669235,2,1439,1256,-20
21688229080,21688229083,3,1447,1501,-20
21696864286,21696864290,4,2312,1558,-20
21698683672,21698683675,3,1523,1487,-20
21699586619,21699586622,3,2171,1040,-20
21701995322,21701995325,3,1535,1764,-20
21703284728,21703284733,5,2235,1153,-20
21708327758,21708327763,5,1841,1484,-20
21712248974,21712248978,4,1874,1496,-20
21713022376,21713022379,3,2266,1566,-20
21713681023,21713681026,3,1220,1084,-20
21714283493,21714283495,2,1358,1097,-20
21716542335,21716542332,-3,743,2604,-20
21718015762,21718015765,3,2088,1971,-20
21718848978,21718848984,6,1997,1449,-20
21724222989,21724222993,4,2247,1954,-20
21725753587,21725753593,6,2201,1117,-20
21732109814,21732109817,3,1287,1055,-20
21737588687,21737588691,4,2079,1127,-20
21738189742,21738189749,7,11717,4293,-20
21739418894,21739418898,4,2228,1167,-20
21739821372,21739821353,-19,843,808,-20
21741904458,21741904463,5,1298,469,-20
21743256124,21743256128,4,2218,977,-20
21743488871,21743488869,-2,1435,2352,-20
21743799641,21743799641,0,1446,2027,-20
21745597986,21745597981,-5,2047,4585,-20
21745889208,21745889210,2,2113,2072,-20
21747290727,21747290721,-6,1758,7344,-20
21749407495,21749407497,2,2030,2191,-20
21753023982,21753023962,-20,2120,1622,-20
21753669250,21753669253,3,1670,947,-20
21755030879,21755030884,5,1115,992,-20
21760640777,21760640778,1,1748,1400,-20
21765319266,21765319269,3,3148,2033,-20
21766467089,21766467090,1,2126,1234,-20
21771456153,21771456154,1,1531,1443,-20
21772509263,21772509266,3,2568,1493,-20
21773976063,21773976067,4,2257,1670,-20
21774172854,21774172858,4,1871,1423,-20
21775206674,21775206676,2,1228,1247,-20
21780048158,21780048158,0,1754,1235,-20
21782197109,21782197115,6,1572,1486,-20
21787767962,21787767965,3,1758,1081,-20
21792921447,21792921451,4,2098,1804,-20
21793057415,21793057392,-23,1384,1542,-20
21794032070,21794032074,4,2134,1405,-20
21795198865,21795198870,5,1517,1420,-20
21795379610,21795379614,4,1980,1505,-20
21795468889,21795468893,4,1165,1391,-20
21803493522,21803493524,2,1564,1829,-20
21805595053,21805595048,-5,825,2753,-20
21809101541,21809101545,4,1559,1373,-20
21811191297,21811191297,0,2200,1642,-20
21814764462,21814764466,4,1194,988,-20
21817648510,21817648515,5,1592,1027,-20
21817698506,21817698507,1,1419,1064,-20
21819705108,21819705113,5,2597,2285,-20
21820049626,21820049627,1,1850,1358,-20
21821305798,21821305799,1,1158,1706,-20
21822479134,21822479138,4,2320,2237,-20
21822917467,21822917470,3,1003,1105,-20
21827974639,21827974643,4,2098,1824,-20
21828319337,21828319341,4,1281,911,-20
21828964634,21828964637,3,2183,1821,-20
21837983925,21837983930,5,2606,1512,-20
21838631095,21838631098,3,1420,1389,-20
21839426222,21839426226,4,2008,1398,-20
21841255826,21841255829,3,2002,1172,-20
21842484312,21842484315,3,1002,1176,-20
21843699803,21843699809,6,1868,1416,-20
21843761957,21843761963,6,2482,1173,-20
21845032664,21845032668,4,1998,1407,-20
21849565871,21849565874,3,1767,1668,-20
21849646289,21849646297,8,1570,1214,-20
21851148442,21851148447,5,1459,925,-20
21851396697,21851396698,1,2288,1577,-20
21860702922,21860702927,5,1704,1414,-20
21863180808,21863180814,6,1923,1529,-20
21864233590,21864233593,3,1812,1392,-20
21865841766,21865841771,5,1980,971,-20
21869541065,21869541066,1,1602,1596,-20
21870082268,21870082273,5,1609,1549,-20
21870224813,21870224817,4,1546,1249,-20
21872137493,21872137498,5,1714,1348,-20
21872862880,21872862883,3,1943,1122,-20
21879485230,21879485234,4,1995,1968,-20
21879967914,21879967918,4,2323,1312,-20
21880665527,21880665530,3,2922,1762,-20
21881551582,21881551587,5,2026,1370,-20
21881682053,21881682057,4,1914,1524,-20
21886237990,21886237994,4,2044,1692,-20
21887384294,21887384298,4,1690,1319,-20
21889759214,21889759217,3,2228,1516,-20
21891361325,21891361328,3,1527,1333,-20
21892998914,21892998918,4,936,760,-20
21897766347,21897766351,4,1575,1212,-20
21898958577,21898958579,2,1396,1087,-20
21904242727,21904242731,4,1339,1249,-20
21906886399,21906886395,-4,18687,10005,-20
21908306845,21908306850,5,2300,1807,-20
21908365142,21908365147,5,1410,834,-20
21909772364,21909772385,21,631,374,-20
21916571247,21916571251,4,2533,1520,-20
21918885026,21918885030,4,1662,1193,-20
21921835920,21921835923,3,1275,1472,-20
21924991141,21924991147,6,3000,1658,-20
21926210734,21926210738,4,5173,3361,-20
21927402501,21927402502,1,1402,1330,-20
21929058146,21929058150,4,1845,1270,-20
21929522461,21929522462,1,1721,1639,-20
21934437871,21934437874,3,1797,1282,-20
21935346137,21935346142,5,1639,1077,-20
21935694833,21935694850,17,433,1822,-20
21936997730,21936997730,0,1754,1806,-20
21937219731,21937219724,-7,606,3760,-20
21937420663,21937420667,4,1360,1211,-20
21942539654,21942539658,4,1503,1425,-20
21946558966,21946558970,4,1932,1790,-20
21948037856,21948037875,19,1540,1421,-20
21949072864,21949072865,1,1463,1544,-20
21953102243,21953102247,4,2937,1713,-20
21953669253,21953669255,2,2023,1106,-20
21953778542,21953778520,-22,1271,348,-20
21956692403,21956692407,4,1868,1173,-20
21960844477,21960844481,4,1706,1535,-20
21963146070,21963146074,4,1208,861,-20
21963660498,21963660502,4,1619,1366,-20
21964100385,21964100386,1,1860,1903,-20
21965987329,21965987333,4,1083,1346,-20
21968022231,21968022239,8,4762,979,-20
21968999443,21968999447,4,1630,927,-20
21970008453,21970008458,5,2018,1797,-20
21977733690,21977733694,4,1775,1157,-20
21978299473,21978299477,4,1684,1362,-20
21979574270,21979574272,2,1256,1325,-20
21979974838,21979974842,4,1321,861,-20
21984196394,21984196397,3,1561,1274,-20
21986829280,21986829285,5,2001,1120,-20
21989574267,21989574269,2,2023,1358,-20
21989967521,21989967523,2,2404,1544,-20
21991046981,21991046987,6,2890,1452,-20
21991381296,21991381298,2,1853,1211,-20
21992560255,21992560254,-1,1632,1712,-20
21997533069,21997533072,3,2306,1671,-20
22000108085,22000108087,2,1346,1263,-20
22008306499,22008306502,3,1460,1633,-20
22009096317,22009096319,2,1936,1497,-20
22011348811,22011348813,2,1692,1228,-20
22011991884,22011991890,6,2552,1546,-20
22013221611,22013221614,3,2686,1767,-20
22015543573,22015543578,5,2397,1078,-20
22016236561,22016236565,4,2486,1695,-20
22018356610,22018356615,5,1878,1430,-20
22019313559,22019313564,5,1894,1641,-20
22020614198,22020614202,4,2381,1471,-20
22021186735,22021186739,4,1501,1294,-20
22022684134,22022684138,4,1522,1267,-20
22023201717,22023201720,3,1626,1497,-20
22023348567,22023348574,7,2473,1308,-20
22028594569,22028594566,-3,1482,2947,-20
22029492448,22029492454,6,2914,1820,-20
22033092789,22033092794,5,2804,1137,-20
22033417269,22033417249,-20,1253,936,-20
22037327460,22037327463,3,3519,1664,-20
22042370680,22042370682,2,1916,1508,-20
22042621009,22042621011,2,1309,1178,-20
22043811762,22043811766,4,1385,1541,-20
22048587706,22048587710,4,1197,1000,-20
22048774516,22048774519,3,1871,1571,-20
22049517474,22049517477,3,1530,1510,-20
22050783514,22050783519,5,1640,2027,-20
22052047214,22052047217,3,1285,1514,-20
22054845588,22054845593,5,2011,1104,-20
22060099747,22060099751,4,930,709,-20
22062210927,22062210926,-1,1237,2080,-20
22063532008,22063532010,2,2098,1802,-20
22064029651,22064029654,3,1722,1250,-20
22064394831,22064394809,-22,1572,1423,-20
22065355862,22065355864,2,1972,1298,-20
22066705819,22066705832,13,28290,15409,-20
22067934074,22067934058,-16,1418,745,-20
22072081930,22072081933,3,1580,1302,-20
22073691269,22073691273,4,2427,1815,-20
22076099558,22076099559,1,2165,1201,-20
22080067756,22080067758,2,1672,1627,-20
22090926653,22090926656,3,1851,1658,-20
22091597093,22091597096,3,2601,1489,-20
22095823641,22095823645,4,1450,1535,-20
22097210774,22097210776,2,1411,1818,-20
22098874293,22098874295,2,2133,1667,-20
22100001733,22100001737,4,1821,1378,-20
22100941569,22100941575,6,1641,1111,-20
22102138970,22102138975,5,2300,1100,-20
22103420118,22103420114,-4,1690,1125,-20
22103939795,22103939798,3,1440,1255,-20
22105077774,22105077776,2,2341,1673,-20
22107036441,22107036442,1,1452,1346,-20
22109744121,22109744125,4,1501,1136,-20
22117179532,22117179532,0,1341,1860,-20
22117363256,22117363259,3,1938,1088,-20
22120277063,22120277067,4,2558,1184,-20
22121010415,22121010419,4,2577,1384,-20
22121679818,22121679823,5,2011,981,-20
22122062610,22122062614,4,2720,1315,-20
22124371673,22124371675,2,1709,1696,-20
22125498776,22125498780,4,1913,1958,-20
22127162718,22127162722,4,1370,1228,-20
22133504450,22133504450,0,1687,1322,-20
22135000891,22135000897,6,2524,1508,-20
22135124501,22135124520,19,1452,805,-20
22145291388,22145291390,2,1384,1484,-20
22146729126,22146729130,4,1676,1459,-20
22146964669,22146964670,1,1178,995,-20
22149121030,22149121031,1,2702,1803,-20
22149685014,22149685019,5,1782,1652,-20
22150276722,22150276737,15,932,220,-20
22151320261,22151320281,20,1512,1092,-20
22152873269,22152873274,5,2307,1508,-20
22153496569,22153496573,4,1515,1538,-20
22153756655,22153756658,3,2175,1552,-20
22153864159,22153864163,4,1227,1058,-20
22157893001,22157893001,0,1247,1904,-20
22158449367,22158449367,0,1267,794,-20
22158646403,22158646408,5,1564,1168,-20
22159086753,22159086754,1,1946,1649,-20
22167521860,22167521863,3,1830,1247,-20
22168364887,22168364891,4,1608,1408,-20
22169317949,22169317951,2,1588,1216,-20
22172771930,22172771933,3,1732,1168,-20
22172985652,22172985656,4,1573,1186,-20
22176650750,22176650753,3,796,1416,-20
22178234909,22178234909,0,1761,2098,-20
22184747275,22184747275,0,1499,2019,-20
22192334805,22192334807,2,1929,1028,-20
22197494974,22197494978,4,1384,1163,-20
22200211867,22200211868,1,976,1780,-20
22202113449,22202113452,3,1914,1838,-20
22203084836,22203084851,15,1717,1661,-20
22203179012,22203179014,2,1778,1126,-20
22206429924,22206429925,1,1271,905,-20
22207413880,22207413882,2,1590,1522,-20
22208296697,22208296699,2,1165,1141,-20
22211315278,22211315282,4,2167,1468,-20
22216015378,22216015382,4,1611,1148,-20
22217207022,22217207026,4,1883,1322,-20
22217468639,22217468642,3,2339,2062,-20
22222496491,22222496490,-1,1381,1516,-20
22223966022,22223966023,1,1540,1339,-20
22224335342,22224335354,12,2117,1373,-20
22224685410,22224685414,4,2554,1602,-20
22228660478,22228660483,5,2900,2101,-20
22231608247,22231608250,3,1743,898,-20
22232635357,22232635358,1,1605,992,-20
22233442743,22233442746,3,963,838,-20
22234904521,22234904523,2,2743,1725,-20
22235141397,22235141402,5,1845,1321,-20
22238230201,22238230201,0,1972,1582,-20
22238698622,22238698625,3,1552,1587,-20
22243158497,22243158499,2,1195,1475,-20
22245421521,22245421525,4,906,986,-20
22247622217,22247622220,3,1643,1479,-20
22248174982,22248174964,-18,1265,560,-20
22248997435,22248997438,3,1931,1687,-20
22250678763,22250678767,4,1864,1882,-20
22252211858,22252211862,4,2323,1498,-20
22256610582,22256610586,4,991,717,-20
22260110699,22260110702,3,1747,1238,-20
22261643188,22261643193,5,1367,1156,-20
22262047203,22262047184,-19,2510,482,-20
22264075145,22264075146,1,2053,1562,-20
22267121196,22267121193,-3,1058,2063,-20
22270003263,22270003267,4,2339,1530,-20
22272988470,22272988475,5,1385,1028,-20
22275971586,22275971591,5,2287,1042,-20
22278112501,22278112505,4,1674,1153,-20
22287146879,22287146879,0,1911,1081,-20
22290556892,22290556894,2,2391,1939,-20
22296298772,22296298775,3,2354,1458,-20
22298551537,22298551539,2,1376,1449,-20
22299880803,22299880806,3,1322,1356,-20
22301206988,22301206992,4,1958,1262,-20
22308324423,22308324426,3,1365,1047,-20
22308895245,22308895250,5,2247,1410,-20
22309282677,22309282682,5,1039,1226,-20
22311238214,22311238220,6,2597,1232,-20
22317440849,22317440851,2,2244,3050,-20
22318259554,22318259557,3,1302,1240,-20
22319802685,22319802686,1,1508,1398,-20
22320649533,22320649528,-5,1287,4272,-20
22324636374,22324636379,5,2101,1211,-20
22326896189,22326896194,5,2663,2113,-20
22327408982,22327408986,4,2729,1375,-20
22328294066,22328294070,4,2424,1743,-20
22329106902,22329106904,2,1593,1161,-20
22330257218,22330257216,-2,1145,2232,-20
22332198026,22332198030,4,1415,887,-20
22340288921,22340288922,1,1855,1553,-20
22340971690,22340971693,3,1307,1763,-20
22341419150,22341419153,3,2156,1775,-20
22343307184,22343307186,2,2324,1547,-20
22343851140,22343851143,3,1846,1142,-20
22349705202,22349705206,4,1494,1753,-20
22354945742,22354945743,1,1442,1714,-20
22358309630,22358309634,4,2058,1367,-20
22366135231,22366135238,7,2665,1321,-20
22366870557,22366870562,5,2279,1407,-20
22368143487,22368143491,4,2269,1440,-20
22369345874,22369345878,4,1518,1414,-20
22371833059,22371833062,3,1690,1245,-20
22372555570,22372555574,4,2234,1465,-20
22377455302,22377455306,4,1440,1317,-20
22378607924,22378607926,2,1465,1071,-20
22378976751,22378976729,-22,1223,1345,-20
22379112502,22379112507,5,2277,1416,-20
22379593767,22379593769,2,1633,1552,-20
22380044868,22380044870,2,1962,1307,-20
22383607508,22383607511,3,1835,1986,-20
22383643493,22383643498,5,1722,895,-20
22386938507,22386938511,4,1387,1330,-20
22388037375,22388037379,4,1417,760,-20
22388634494,22388634497,3,1340,1682,-20
22391050493,22391050497,4,1702,832,-20
22394540477,22394540478,1,2120,2124,-20
22397353785,22397353787,2,1441,830,-20
22398118004,22398118008,4,2019,1224,-20
22399798428,22399798432,4,2023,1458,-20
22402396984,22402396990,6,1400,472,-20
22404277309,22404277314,5,1859,1074,-20
22405867369,22405867375,6,1695,1114,-20
22406754480,22406754482,2,2049,1146,-20
22411685334,22411685338,4,2030,1642,-20
22414018365,22414018367,2,1524,1213,-20
22414125813,22414125814,1,1307,1037,-20
22414758325,22414758331,6,1085,1421,-20
22414966619,22414966623,4,761,767,-20
22417267765,22417267767,2,1510,1249,-20
22421545525,22421545528,3,1638,1933,-20
22422266834,22422266838,4,1970,1565,-20
22423828132,22423828135,3,1873,1862,-20
22424898008,22424898011,3,1333,1247,-20
22425427871,22425427875,4,2537,1330,-20
22429050570,22429050574,4,2073,1243,-20
22429376479,22429376483,4,1657,1136,-20
22430705742,22430705721,-21,2124,1306,-20
22431154396,22431154398,2,1736,1729,-20
22432681963,22432681967,4,1525,969,-20
22433860582,22433860585,3,2700,1676,-20
22434571561,22434571563,2,2302,1344,-20
22436091895,22436091897,2,1450,1513,-20
22437319627,22437319631,4,1318,1021,-20
22438536674,22438536676,2,2164,1716,-20
22439307814,22439307818,4,1369,1228,-20
22439567610,22439567613,3,2245,1711,-20
22441731422,22441731426,4,1780,1199,-20
22446078985,22446078988,3,1709,1307,-20
22446578509,22446578514,5,1359,867,-20
22448264022,22448264023,1,2264,1296,-20
22448581702,22448581705,3,2194,1513,-20
22449967313,22449967316,3,1397,1732,-20
22452674521,22452674523,2,2092,1207,-20
22454907404,22454907406,2,2075,1765,-20
22457050057,22457050060,3,1735,1637,-20
22458307670,22458307675,5,1759,1274,-20
22459537402,22459537406,4,2042,1880,-20
22459885814,22459885820,6,2007,1630,-20
22460055206,22460055210,4,2036,1782,-20
22464520791,22464520793,2,1091,1216,-20
22465137292,22465137294,2,1428,1068,-20
22468685402,22468685402,0,1725,1313,-20
22469515643,22469515649,6,3622,1324,-20
22471359749,22471359754,5,4234,2824,-20
22472530864,22472530861,-3,893,1648,-20
22473905588,22473905590,2,1241,1174,-20
22478080834,22478080840,6,2953,1291,-20
22478384250,22478384253,3,991,907,-20
22480332041,22480332045,4,1792,1399,-20
22486800638,22486800643,5,2050,1732,-20
22487984130,22487984130,0,1053,1616,-20
22488456214,22488456218,4,1919,1097,-20
22489326364,22489326370,6,1955,1319,-20
22489783338,22489783342,4,2072,1372,-20
22490924426,22490924433,7,2330,1479,-20
22497848872,22497848878,6,1702,1084,-20
22502715095,22502715101,6,818,738,-20
22504426234,22504426240,6,1334,840,-20
22506492500,22506492503,3,2016,1340,-20
22506774347,22506774330,-17,1000,1189,-20
22510926882,22510926887,5,1429,1282,-20
22512571050,22512571052,2,1230,1417,-20
22513325829,22513325830,1,1851,1308,-20
22513819039,22513819043,4,1042,997,-20
22519355074,22519355076,2,1857,1200,-20
22519414452,22519414473,21,2139,1377,-20
22519993771,22519993773,2,1082,1501,-20
22520702168,22520702178,10,2302,1177,-20
22522785053,22522785053,0,1477,1309,-20
22525242979,22525242985,6,1746,1627,-20
22525408264,22525408266,2,1634,1880,-20
22528512277,22528512279,2,1946,1193,-20
22529354646,22529354650,4,1640,1303,-20
22537436891,22537436895,4,1977,1696,-20
22537924993,22537924996,3,1456,1102,-20
22538238945,22538238947,2,1690,1351,-20
22539377236,22539377244,8,2122,1276,-20
22539662949,22539662953,4,2464,1953,-20
22539692681,22539692685,4,2253,1188,-20
22540773630,22540773633,3,1369,1490,-20
22543444414,22543444417,3,1467,1575,-20
22545045080,22545045082,2,1861,2154,-20
22545722091,22545722093,2,2327,2052,-20
22546808409,22546808410,1,1302,1907,-20
22550190802,22550190784,-18,1492,1161,-20
22554892790,22554892794,4,1697,1296,-20
22555178529,22555178530,1,1829,1293,-20
22556737681,22556737683,2,1741,1663,-20
22556886578,22556886578,0,1431,2324,-20
22557309913,22557309917,4,2111,1596,-20
22557362374,22557362375,1,1918,1568,-20
22557492705,22557492708,3,1952,1430,-20
22558143520,22558143523,3,1342,1123,-20
22561561018,22561561018,0,1183,1643,-20
22563211446,22563211451,5,1978,1353,-20
22565499742,22565499748,6,8340,3248,-20
22570467970,22570467977,7,2348,1227,-20
22572600459,22572600461,2,1699,2403,-20
22573663344,22573663347,3,1893,1417,-20
22576283676,22576283683,7,1703,1185,-20
22578966836,22578966823,-13,2153,1235,-20
22581332862,22581332865,3,2203,1606,-20
22583696192,22583696195,3,2248,1386,-20
22585130497,22585130502,5,2255,1528,-20
22585896752,22585896753,1,14846,50156,-20
22585962806,22585962810,4,2198,1486,-20
22586998710,22586998712,2,1697,1459,-20
22588817334,22588817340,6,1592,974,-20
22590991442,22590991446,4,1802,1099,-20
22594877906,22594877905,-1,2775,4296,-20
22598462992,22598462993,1,1544,1294,-20
22600317682,22600317687,5,2971,1813,-20
22602430928,22602430931,3,1955,1715,-20
22604171259,22604171263,4,1391,1021,-20
22604323511,22604323491,-20,1017,615,-20
22604487022,22604487026,4,715,791,-20
22607863002,22607863005,3,1566,1124,-20
22608271926,22608271930,4,2045,1285,-20
22609734781,22609734786,5,1465,948,-20
22610403773,22610403776,3,1170,1128,-20
22621515490,22621515494,4,2839,1914,-20
22625017845,22625017847,2,1490,1514,-20
22625528061,22625528062,1,1567,1522,-20
22625563750,22625563752,2,1414,1031,-20
22625814292,22625814295,3,1918,1333,-20
22625961118,22625961122,4,1810,1662,-20
22629280158,22629280161,3,1925,1367,-20
22633103842,22633103847,5,1922,1712,-20
22633338214,22633338218,4,1613,1249,-20
22637028653,22637028658,5,1531,1230,-20
22637895234,22637895237,3,1470,1195,-20
22638405942,22638405946,4,1692,1683,-20
22639573697,22639573713,16,1971,1052,-20
22640712617,22640712616,-1,1970,2074,-20
22641265333,22641265337,4,1032,1056,-20
22646328803,22646328806,3,529,1426,-20
22647789827,22647789830,3,2124,1324,-20
22648576446,22648576448,2,1789,1636,-20
22654629218,22654629224,6,1815,1240,-20
22655550478,22655550479,1,1618,1333,-20
22657014809,22657014814,5,2212,1139,-20
22659770353,22659770354,1,1443,1308,-20
22662679540,22662679547,7,3605,2621,-20
22663751481,22663751486,5,1757,1643,-20
22667712775,22667712780,5,1468,1087,-20
22669801301,22669801305,4,1712,1514,-20
22670426207,22670426210,3,979,1364,-20
22670556173,22670556175,2,1842,1594,-20
22672229233,22672229236,3,2729,1711,-20
22679687033,22679687038,5,1891,1375,-20
22680177381,22680177384,3,2048,1713,-20
22683830106,22683830113,7,3176,1801,-20
22684536301,22684536315,14,735,308,-20
22687423629,22687423626,-3,1850,3824,-20
22688219386,22688219390,4,1991,1421,-20
22688795058,22688795062,4,1691,1452,-20
22694799166,22694799170,4,1518,1063,-20
22698724426,22698724428,2,1743,1912,-20
22699648423,22699648426,3,1737,1343,-20
22709323626,22709323630,4,2026,1390,-20
22715279297,22715279298,1,1593,1627,-20
22715611974,22715611977,3,2013,1734,-20
22717411476,22717411478,2,1437,1660,-20
22718682843,22718682846,3,1187,1110,-20
22720320955,22720320958,3,1738,2042,-20
22721389822,22721389827,5,1860,1268,-20
22722095466,22722095470,4,2444,1729,-20
22723603845,22723603846,1,1629,1292,-20
22726793982,22726793985,3,1930,1247,-20
22727211342,22727211345,3,1813,1072,-20
22730392113,22730392117,4,2325,1368,-20
22731997032,22731997037,5,2273,1315,-20
22735091014,22735091017,3,2389,1440,-20
22740420925,22740420917,-8,812,1336,-20
22741026129,22741026118,-11,31,1303,-20
22744894122,22744894127,5,2332,1483,-20
22745229089,22745229090,1,1125,808,-20
22745582130,22745582133,3,1209,1257,-20
22747287233,22747287236,3,2005,1309,-20
22752921014,22752920994,-20,1632,1216,-20
22753295677,22753295681,4,2183,1741,-20
22762874482,22762874486,4,1278,756,-20
22764271522,22764271525,3,1763,1926,-20
22764889544,22764889548,4,1834,1266,-20
22769244132,22769244134,2,1999,1412,-20
22770651070,22770651082,12,1584,1174,-20
22771042966,22771042978,12,1919,964,-20
22771538443,22771538446,3,1738,1355,-20
22775967628,22775967630,2,1455,1393,-20
22776464455,22776464438,-17,1324,1706,-20
22779131805,22779131810,5,2224,1152,-20
22780449405,22780449407,2,1820,1767,-20
22784828623,22784828628,5,2635,1734,-20
22784968623,22784968627,4,1316,1217,-20
22787289151,22787289146,-5,2950,9141,-20
22787651570,22787651572,2,1576,1390,-20
22789694405,22789694410,5,1885,1172,-20
22790451111,22790451116,5,1899,1500,-20
22791135564,22791135566,2,1633,1310,-20
22791449817,22791449819,2,1698,1547,-20
22793756740,22793756742,2,1454,1593,-20
22795804595,22795804598,3,1918,1768,-20
22796775065,22796775068,3,1915,1754,-20
22797352211,22797352214,3,1898,1405,-20
22797737780,22797737783,3,1596,1164,-20
22797995057,22797995061,4,2971,1885,-20
22798349924,22798349927,3,1961,995,-20
22800789121,22800789122,1,1849,1402,-20
22802703167,22802703172,5,1907,1183,-20
22808628190,22808628193,3,1642,2164,-20
22809920859,22809920861,2,2108,1747,-20
22811330074,22811330077,3,2259,1710,-20
22812457159,22812457160,1,1559,1335,-20
22812897094,22812897096,2,1855,1422,-20
22813448884,22813448887,3,1476,1296,-20
22814868938,22814868942,4,2072,1425,-20
22815282460,22815282465,5,1797,1708,-20
22819034672,22819034675,3,1246,1045,-20
22820432704,22820432707,3,1585,1751,-20
22823730987,22823730993,6,3131,1029,-20
22824254053,22824254075,22,2356,1126,-20
22825585655,22825585656,1,1218,1497,-20
22826483128,22826483132,4,2520,1443,-20
22826746746,22826746749,3,2464,1768,-20
22835444893,22835444890,-3,1820,1417,-20
22836538785,22836538789,4,1709,1626,-20
22839195404,22839195410,6,2862,1380,-20
22839293490,22839293499,9,1156,248,-20
22841197821,22841197825,4,2031,1417,-20
22847117228,22847117234,6,2185,1638,-20
22851793925,22851793925,0,1526,2016,-20
22853755605,22853755611,6,2077,1097,-20
22857223965,22857223969,4,2506,1725,-20
22860212083,22860212086,3,1859,1630,-20
22860350068,22860350070,2,1492,1080,-20
22861117136,22861117137,1,1946,1748,-20
22863819073,22863819075,2,1721,1875,-20
22864992841,22864992844,3,2180,1170,-20
22865701642,22865701643,1,1318,925,-20
22865971198,22865971201,3,2063,1507,-20
22867699848,22867699851,3,1254,1474,-20
22871341794,22871341795,1,1480,1495,-20
22875394033,22875394037,4,1946,994,-20
22878523287,22878523290,3,1431,761,-20
22879143841,22879143833,-8,1759,1195,-20
22880787240,22880787244,4,2534,1358,-20
22882708667,22882708671,4,2462,1195,-20
22883977582,22883977586,4,1769,1164,-20
22885279650,22885279654,4,1295,1305,-20
22886231267,22886231270,3,1099,1032,-20
22888710991,22888710993,2,1393,1692,-20
22890960830,22890960834,4,1760,1175,-20
22893345447,22893345450,3,2669,1393,-20
22894338790,22894338793,3,1734,1560,-20
22895338544,22895338546,2,1630,1183,-20
22895726126,22895726129,3,1524,1446,-20
22899974366,22899974369,3,1493,1088,-20
22904847549,22904847551,2,2472,1360,-20
22906141945,22906141950,5,1873,1018,-20
22906499592,22906499594,2,1548,1591,-20
22907998748,22907998751,3,2356,1424,-20
22909301999,22909302002,3,1865,1354,-20
22916193430,22916193434,4,3894,2847,-20
22926679499,22926679503,4,2235,1558,-20
22929544336,22929544338,2,1825,1129,-20
22933881280,22933881278,-2,1428,1645,-20
22934376646,22934376650,4,2434,1461,-20
22938947498,22938947502,4,1756,1485,-20
22945292368,22945292371,3,1974,1244,-20
22947168763,22947168767,4,887,778,-20
22949906763,22949906767,4,2058,1102,-20
22949969366,22949969361,-5,1388,5245,-20
22950177035,22950177037,2,1755,1415,-20
22952195970,22952195973,3,1248,1035,-20
22952669993,22952669995,2,2115,1600,-20
22956489175,22956489170,-5,2248,10188,-20
22959805139,22959805141,2,2492,1897,-20
22961670865,22961670869,4,1449,1608,-20
22970183142,22970183141,-1,888,1899,-20
22973822854,22973822856,2,1904,1791,-20
22973994859,22973994864,5,2061,1403,-20
22974730365,22974730367,2,1311,825,-20
22975248081,22975248067,-14,2233,1126,-20
22976450846,22976450849,3,1900,1556,-20
22978222296,22978222299,3,1947,1451,-20
22982183427,22982183421,-6,837,4147,-20
22990619437,22990619441,4,1330,1391,-20
22995571630,22995571645,15,1044,1514,-20
22997776170,22997776173,3,1052,1003,-20
22999811047,22999811049,2,1787,1056,-20
23003031053,23003031058,5,1533,1345,-20
23005148387,23005148391,4,1383,1491,-20
23007460605,23007460606,1,1418,1742,-20
23007903861,23007903866,5,2063,1312,-20
23008731981,23008731985,4,4571,2681,-20
23011216385,23011216386,1,1338,1165,-20
23011279431,23011279434,3,1410,1247,-20
23013761810,23013761814,4,1258,1614,-20
23014205082,23014205089,7,5036,1988,-20
23016794415,23016794421,6,1620,1849,-20
23019204760,23019204764,4,1924,1581,-20
23019410702,23019410706,4,2281,1212,-20
23020697951,23020697952,1,2432,3107,-20
23023056152,23023056153,1,1290,1540,-20
23024100118,23024100119,1,1637,1461,-20
23024968105,23024968107,2,1825,1389,-20
23026113622,23026113625,3,1748,1469,-20
23026729981,23026729985,4,2561,1691,-20
23028883322,23028883327,5,1089,929,-20
23037678995,23037678998,3,2477,1691,-20
23037723465,23037723468,3,1801,1701,-20
23040416604,23040416606,2,113,3111,-20
23041497218,23041497222,4,1844,1376,-20
23042058431,23042058434,3,1133,1147,-20
23043050045,23043050051,6,3812,1554,-20
23043537866,23043537869,3,1493,1391,-20
23046025521,23046025525,4,2587,1481,-20
23046848642,23046848642,0,1224,1722,-20
23047861472,23047861475,3,1991,1330,-20
23050614822,23050614826,4,1207,1072,-20
23055742461,23055742481,20,1714,1044,-20
23057973950,23057973954,4,4136,2766,-20
23058212429,23058212434,5,2093,1101,-20
23060052494,23060052497,3,2075,1495,-20
23063817939,23063817942,3,1066,982,-20
23064576108,23064576112,4,1805,1521,-20
23064859483,23064859488,5,1481,1493,-20
23065988498,23065988500,2,3386,3203,-20
23066076202,23066076206,4,2454,1298,-20
23066487871,23066487875,4,1291,1162,-20
23066526809,23066526825,16,1523,1543,-20
23070946364,23070946368,4,2487,2039,-20
23072259610,23072259613,3,1583,1238,-20
23076640269,23076640273,4,1793,1515,-20
23077481145,23077481149,4,2206,1640,-20
23077804522,23077804523,1,1572,1675,-20
23078743230,23078743234,4,1459,1232,-20
23078825550,23078825529,-21,1019,829,-20
23082333359,23082333362,3,1575,1585,-20
23083724745,23083724748,3,2171,1224,-20
23085671758,23085671762,4,1731,1061,-20
23086810070,23086810075,5,858,829,-20
23087290053,23087290058,5,1657,1716,-20
23088712363,23088712365,2,2101,1019,-20
23089533013,23089533015,2,1633,1487,-20
23093848935,23093848939,4,2354,1681,-20
23100487591,23100487592,1,2704,2818,-20
23102300850,23102300854,4,1571,1424,-20
23105486838,23105486843,5,2661,1897,-20
23106041666,23106041671,5,2213,1306,-20
23107168929,23107168931,2,1845,1674,-20
23113732374,23113732377,3,1201,1045,-20
23118864906,23118864909,3,1739,1290,-20
23123795141,23123795148,7,3972,1728,-20
23127108146,23127108146,0,1459,2444,-20
23128793201,23128793206,5,2403,1252,-20
23130019839,23130019842,3,1798,1746,-20
23131226770,23131226775,5,2754,1755,-20
23132569485,23132569490,5,1574,1129,-20
23134138813,23134138815,2,2222,1778,-20
23139962720,23139962723,3,1545,1303,-20
23140223609,23140223626,17,1278,1764,-20
23140738504,23140738505,1,1917,1512,-20
23140999331,23140999336,5,1696,1750,-20
23142342586,23142342589,3,1977,1466,-20
23142732402,23142732407,5,1622,1472,-20
23143339274,23143339278,4,2224,1427,-20
23145106634,23145106635,1,971,1217,-20
23147015723,23147015722,-1,1177,1667,-20
23148624945,23148624946,1,1590,1747,-20
23149831809,23149831811,2,2234,1670,-20
23150970514,23150970517,3,2541,1373,-20
23151256213,23151256218,5,1969,1217,-20
23153624416,23153624419,3,1456,1336,-20
23153964450,23153964454,4,2547,1588,-20
23154805171,23154805174,3,1692,1481,-20
23156488351,23156488354,3,2295,1192,-20
23159699506,23159699508,2,1830,2827,-20
23160340218,23160340222,4,1430,1179,-20
23160882611,23160882616,5,2268,1310,-20
23161941418,23161941423,5,3155,1410,-20
23164955283,23164955286,3,892,1182,-20
23173795794,23173795798,4,1992,1665,-20
23175150400,23175150402,2,1495,1101,-20
23175344085,23175344087,2,2058,1329,-20
23177318511,23177318515,4,1233,1138,-20
23184888541,23184888545,4,2038,1431,-20
23194292470,23194292473,3,2217,1227,-20
23194904702,23194904706,4,2353,1292,-20
23197872686,23197872691,5,2073,1530,-20
23198886427,23198886429,2,1424,1732,-20
23199206639,23199206643,4,1932,1135,-20
23200057781,23200057780,-1,841,1277,-20
23200730056,23200730059,3,1342,835,-20
23203368326,23203368331,5,1258,1193,-20
23205156010,23205156014,4,1332,949,-20
23207081202,23207081207,5,1594,1897,-20
23208265621,23208265626,5,2097,1162,-20
23209956813,23209956818,5,1311,902,-20
23215878711,23215878714,3,972,1323,-20
23218694038,23218694042,4,1439,1180,-20
23220761093,23220761094,1,1581,1019,-20
23227098784,23227098786,2,2110,1698,-20
23233661770,23233661772,2,1528,1239,-20
23236324350,23236324353,3,1852,1578,-20
23237892536,23237892539,3,1642,1474,-20
23240195803,23240195806,3,1484,745,-20
23242246762,23242246766,4,2703,2435,-20
23243345555,23243345562,7,1323,607,-20
23243392213,23243392196,-17,962,930,-20
23243958504,23243958505,1,1289,1058,-20
23245588999,23245589002,3,1963,1181,-20
23245741148,23245741150,2,2035,1880,-20
23246007521,23246007522,1,2016,1770,-20
23246804092,23246804096,4,1657,1619,-20
23250354576,23250354579,3,2542,1855,-20
23251373422,23251373425,3,2146,1967,-20
23253462033,23253462039,6,1093,1086,-20
23254250074,23254250078,4,1711,1595,-20
23259141848,23259141851,3,2320,1003,-20
23261279297,23261279303,6,2698,1283,-20
23265966618,23265966622,4,1454,1694,-20
23269153743,23269153743,0,1487,1080,-20
23269560433,23269560417,-16,1581,674,-20
23272044626,23272044630,4,2581,1719,-20
23273827696,23273827698,2,2473,1485,-20
23275128710,23275128712,2,1976,1251,-20
23275531994,23275532000,6,1707,1550,-20
23276614802,23276614807,5,1816,1850,-20
23279019704,23279019700,-4,1029,3285,-20
23281411887,23281411889,2,835,1004,-20
23281926318,23281926324,6,2153,1243,-20
23284857401,23284857394,-7,1589,5682,-20
23287146082,23287146079,-3,974,1663,-20
23288965038,23288965043,5,1430,865,-20
23289332786,23289332789,3,1127,975,-20
23289889230,23289889235,5,2514,1184,-20
23291888575,23291888578,3,1950,1125,-20
23295899375,23295899378,3,2302,1635,-20
23297132182,23297132187,5,1713,1347,-20
23298140111,23298140114,3,1290,1583,-20
23299957934,23299957938,4,1738,1352,-20
23300750802,23300750806,4,1336,1358,-20
23307402392,23307402394,2,2008,1748,-20
23309704701,23309704705,4,1635,1333,-20
23311669963,23311669966,3,2176,1475,-20
23315257098,23315257102,4,1868,1241,-20
23315291588,23315291591,3,1986,1260,-20
23317944930,23317944931,1,2029,1749,-20
23318978954,23318978956,2,1715,1283,-20
23319634185,23319634187,2,2362,2226,-20
23319882766,23319882772,6,1622,916,-20
23320437728,23320437734,6,2235,1347,-20
23320926812,23320926814,2,3399,2778,-20
23321761133,23321761133,0,900,1712,-20
23322257579,23322257583,4,2011,1065,-20
23323432095,23323432097,2,1570,1253,-20
23324860511,23324860508,-3,1199,2594,-20
23325445453,23325445455,2,1933,1210,-20
23325886716,23325886718,2,1759,1518,-20
23326177840,23326177835,-5,982,3408,-20
23326310803,23326310806,3,2012,2220,-20
23326744358,23326744362,4,1657,1675,-20
23327412123,23327412128,5,12804,20644,-20
23327793817,23327793818,1,1993,1114,-20
23328221762,23328221767,5,1717,1232,-20
23329434386,23329434390,4,2577,1682,-20
23330046669,23330046672,3,1672,1389,-20
23332526884,23332526886,2,1411,1335,-20
23334901029,23334901033,4,1996,1738,-20
23338846197,23338846199,2,1570,2077,-20
23341007552,23341007554,2,1505,873,-20
23341493231,23341493243,12,1759,981,-20
23342014423,23342014432,9,10804,46323,-20
23345035415,23345035419,4,2599,1259,-20
23346862569,23346862571,2,1868,1521,-20
23347733667,23347733671,4,1583,1521,-20
23348793599,23348793603,4,2103,1614,-20
23349884569,23349884574,5,3013,1488,-20
23350867674,23350867677,3,958,1118,-20
23355379190,23355379193,3,1430,1327,-20
23356171309,23356171314,5,1772,1179,-20
23358329906,23358329907,1,2019,1523,-20
23358767885,23358767890,5,1817,1171,-20
23358925580,23358925587,7,2783,1079,-20
23362416621,23362416623,2,1082,1316,-20
23363824683,23363824679,-4,2223,3612,-20
23364135813,23364135816,3,1528,1509,-20
23364899158,23364899160,2,2217,1636,-20
23369021773,23369021778,5,1696,1507,-20
23369575490,23369575496,6,1479,1075,-20
23370803138,23370803141,3,2163,1794,-20
23371426361,23371426365,4,1922,1734,-20
23377708762,23377708765,3,1250,1134,-20
23381781819,23381781823,4,1737,1488,-20
23385270889,23385270886,-3,1471,2612,-20
23388708790,23388708794,4,1839,1640,-20
23389592942,23389592945,3,1706,1188,-20
23391691506,23391691509,3,1741,1244,-20
23397196648,23397196650,2,2630,1721,-20
23400111213,23400111214,1,1917,1245,-20
23402037212,23402037214,2,1578,1407,-20
23402682363,23402682365,2,2068,2052,-20
23409760692,23409760695,3,2075,1134,-20
23411001482,23411001485,3,1609,1820,-20
23418232940,23418232946,6,1848,1228,-20
23418454510,23418454514,4,1941,1607,-20
23420480862,23420480870,8,1712,1287,-20
23429214144,23429214138,-6,645,4049,-20
23429296494,23429296489,-5,1017,3529,-20
23433283434,23433283437,3,1777,1322,-20
23436624342,23436624346,4,1888,1569,-20
23444542796,23444542803,7,2225,859,-20
23450673704,23450673707,3,1856,1576,-20
23455519158,23455519150,-8,1267,5845,-20
23458247266,23458247267,1,1244,1274,-20
23460314862,23460314844,-18,907,708,-20
23460843259,23460843262,3,1766,1493,-20
23469255247,23469255251,4,960,1277,-20
23470354040,23470354043,3,1932,1539,-20
23470454667,23470454671,4,808,805,-20
23470645465,23470645469,4,2451,1734,-20
23472629119,23472629123,4,2297,1571,-20
23472877259,23472877256,-3,2075,3589,-20
23484198959,23484198963,4,1304,976,-20
23487683126,23487683120,-6,1141,3971,-20
23493009791,23493009791,0,997,1136,-20
23493165550,23493165552,2,1813,1107,-20
23493814533,23493814534,1,1513,1543,-20
23494154706,23494154710,4,1905,1187,-20
23496037465,23496037468,3,1851,1539,-20
23503809979,23503809986,7,2678,757,-20
23504883235,23504883238,3,1754,1232,-20
23507439097,23507439098,1,1144,1239,-20
23507758017,23507758033,16,1163,215,-20
23508927107,23508927111,4,1240,843,-20
23509491283,23509491286,3,1558,1489,-20
23520352153,23520352155,2,1333,988,-20
23522504737,23522504739,2,1663,1407,-20
23523864571,23523864575,4,2074,1371,-20
23525589701,23525589702,1,1704,1064,-20
23528201609,23528201613,4,1803,1330,-20
23530354963,23530354963,0,1400,1013,-20
23531290204,23531290208,4,2264,1458,-20
23533068342,23533068342,0,1367,1716,-20
23535958103,23535958108,5,9674,25446,-20
23538423515,23538423518,3,1163,1154,-20
23539433128,23539433131,3,1721,1574,-20
23543529941,23543529945,4,1954,1436,-20
23546306015,23546306032,17,150,1384,-20
23547296169,23547296173,4,2041,1400,-20
23547935785,23547935787,2,1741,1231,-20
23548776439,23548776442,3,1609,1082,-20
23549326231,23549326234,3,1558,1356,-20
23551099853,23551099855,2,2117,1892,-20
23552238870,23552238874,4,1886,1036,-20
23553623824,23553623827,3,1274,1841,-20
23558987571,23558987574,3,1975,1583,-20
23559766388,23559766391,3,1434,1219,-20
23560540665,23560540669,4,1835,1743,-20
23562114181,23562114184,3,1695,1240,-20
23564066595,23564066593,-2,6308,14842,-20
23568346982,23568346986,4,1451,1088,-20
23570231640,23570231642,2,1482,1481,-20
23570381140,23570381142,2,1676,1696,-20
23571727808,23571727805,-3,1837,1176,-20
23571915025,23571915027,2,1681,1408,-20
23573929535,23573929539,4,1830,1317,-20
23574863921,23574863923,2,1946,1727,-20
23576646745,23576646744,-1,1124,1589,-20
23580884260,23580884254,-6,1288,4275,-20
23584375580,23584375582,2,1340,1036,-20
23588363846,23588363850,4,2732,1557,-20
23588497863,23588497872,9,26488,4209,-20
23589512236,23589512239,3,2717,2346,-20
23589844004,23589844006,2,2411,1542,-20
23593190408,23593190410,2,1820,900,-20
23595776592,23595776593,1,1945,1189,-20
23596524305,23596524309,4,1863,1928,-20
23596607438,23596607442,4,2402,2278,-20
23598385518,23598385521,3,1556,1874,-20
23598854618,23598854624,6,2208,2002,-20
23599368966,23599368970,4,1912,1236,-20
23604061237,23604061239,2,1596,1295,-20
23604796141,23604796145,4,1701,1585,-20
23605092122,23605092126,4,2531,1772,-20
23606806237,23606806238,1,1664,2272,-20
23608625608,23608625611,3,1451,1398,-20
23608998677,23608998679,2,1925,1790,-20
23611238145,23611238148,3,1176,1126,-20
23611379153,23611379153,0,1424,1132,-20
23613368442,23613368446,4,1895,1356,-20
23614702474,23614702469,-5,972,1625,-20
23620031208,23620031211,3,2281,1595,-20
23620489894,23620489888,-6,1841,9307,-20
23622105266,23622105271,5,2084,1196,-20
23627410074,23627410078,4,2473,1227,-20
23627986570,23627986565,-5,2044,6261,-20
23628253058,23628253063,5,1854,1657,-20
23631941479,23631941481,2,2078,1126,-20
23633510256,23633510260,4,1518,943,-20
23634530701,23634530705,4,1728,1672,-20
23634819680,23634819685,5,1434,1154,-20
23639244776,23639244780,4,2196,1335,-20
23639648589,23639648591,2,1446,947,-20
23640838145,23640838147,2,2112,1262,-20
23643477743,23643477746,3,2139,1344,-20
23648041895,23648041898,3,902,698,-20
23649440551,23649440555,4,2548,1489,-20
23651692558,23651692546,-12,1502,3294,-20
23654459793,23654459814,21,1352,2271,-20
23657911640,23657911642,2,775,958,-20
23661405018,23661405022,4,2240,1658,-20
23662436002,23662436006,4,1654,1502,-20
23664522946,23664522943,-3,1007,2582,-20
23666920675,23666920679,4,1480,1286,-20
23667194366,23667194369,3,1724,1554,-20
23668627594,23668627609,15,1361,4038,-20
23672890013,23672890010,-3,1485,1688,-20
23674076379,23674076379,0,1509,2276,-20
23675566446,23675566449,3,1402,1225,-20
23679080134,23679080137,3,1349,1259,-20
23682250881,23682250884,3,2334,1742,-20
23683096865,23683096869,4,1948,1263,-20
23683462666,23683462669,3,2455,1760,-20
23683696522,23683696526,4,1602,1460,-20
23685466586,23685466589,3,2657,1718,-20
23686753653,23686753658,5,2338,1597,-20
23687351002,23687351008,6,1174,1204,-20
23688496419,23688496425,6,2151,1504,-20
23689680296,23689680299,3,1369,1219,-20
23691593121,23691593123,2,1696,1265,-20
23692251109,23692251114,5,576,649,-20
23693386386,23693386390,4,1520,1174,-20
23694380234,23694380239,5,1358,895,-20
23697179997,23697179998,1,1388,1536,-20
23697406778,23697406782,4,1574,1250,-20
23697519504,23697519506,2,1728,1508,-20
23701947528,23701947531,3,2028,1101,-20
23702606210,23702606209,-1,1775,2983,-20
23702759159,23702759162,3,2013,1083,-20
23704016066,23704016070,4,1559,1293,-20
23704164878,23704164883,5,1697,1065,-20
23704738511,23704738505,-6,964,2543,-20
23709494631,23709494630,-1,2543,3570,-20
23711905539,23711905543,4,1423,887,-20
23714077499,23714077502,3,1418,1589,-20
23714285953,23714285957,4,2351,1269,-20
23714529282,23714529290,8,1615,970,-20
23718525226,23718525229,3,1814,1490,-20
23721244345,23721244349,4,1428,1411,-20
23721314014,23721314017,3,1761,1398,-20
23724926881,23724926883,2,1643,1642,-20
23732054481,23732054485,4,1926,1235,-20
23736422382,23736422384,2,1836,1569,-20
23736787082,23736787082,0,1188,1834,-20
23737091723,23737091726,3,1890,1847,-20
23737589904,23737589906,2,1557,1207,-20
23740922213,23740922214,1,1668,1311,-20
23741982743,23741982745,2,953,881,-20
23747241361,23747241367,6,2972,952,-20
23748163895,23748163898,3,2968,1489,-20
23748823189,23748823191,2,1568,1136,-20
23751777785,23751777787,2,1713,1207,-20
23753447281,23753447285,4,1931,1280,-20
23759022534,23759022539,5,2479,1794,-20
23761234804,23761234807,3,988,962,-20
23762578987,23762578990,3,1757,1255,-20
23766183290,23766183296,6,1020,1093,-20
23769263535,23769263536,1,1125,1257,-20
23772625999,23772625997,-2,1310,1576,-20
23773275474,23773275467,-7,1416,3832,-20
23775373535,23775373539,4,1182,1158,-20
23779679901,23779679906,5,2259,1286,-20
23781988746,23781988751,5,2015,1206,-20
23785102609,23785102613,4,1842,1562,-20
23786110432,23786110435,3,1056,1045,-20
23787650437,23787650418,-19,1836,968,-20
23791610506,23791610511,5,1294,1016,-20
23793487181,23793487171,-10,22490,15866,-20
23795093743,23795093724,-19,2011,1375,-20
23799990494,23799990496,2,1562,1147,-20
23800907226,23800907235,9,4912,831,-20
23802663369,23802663373,4,1293,1048,-20
23804646691,23804646693,2,1255,1488,-20
23806685312,23806685316,4,1981,1828,-20
23808529698,23808529701,3,2063,1761,-20
23813400320,23813400322,2,1633,1426,-20
23815973981,23815973980,-1,5087,17800,-20
23817446515,23817446518,3,1870,1732,-20
23819098530,23819098535,5,1518,1126,-20
23819184222,23819184236,14,1463,1287,-20
23819433581,23819433586,5,2129,1585,-20
23820512654,23820512655,1,2352,1413,-20
23823554778,23823554777,-1,1680,1281,-20
23824652235,23824652237,2,1861,1098,-20
23824773373,23824773379,6,2342,1531,-20
23824848396,23824848401,5,1505,1130,-20
23829772809,23829772806,-3,5909,11479,-20
23831218294,23831218299,5,1593,1240,-20
23833538877,23833538885,8,1391,795,-20
23834843795,23834843798,3,1876,1391,-20
23836579024,23836579027,3,1722,1439,-20
23837592389,23837592394,5,1952,1281,-20
23837927083,23837927086,3,2183,1227,-20
23851925708,23851925713,5,2478,1283,-20
23852009579,23852009581,2,1581,1749,-20
23852062090,23852062091,1,1889,1505,-20
23857526197,23857526198,1,1415,1580,-20
23860196174,23860196174,0,1543,1259,-20
23860612958,23860612962,4,1600,1397,-20
23862833537,23862833541,4,1622,1703,-20
23863096352,23863096360,8,2892,1189,-20
23863960655,23863960659,4,2706,1867,-20
23864063609,23864063613,4,2509,1201,-20
23864325546,23864325551,5,2045,2164,-20
23870202104,23870202108,4,1724,1466,-20
23871943149,23871943151,2,1969,1558,-20
23880129168,23880129169,1,2426,2193,-20
23880990123,23880990125,2,1791,1580,-20
23881697175,23881697186,11,1918,1170,-20
23885851754,23885851754,0,1314,985,-20
23891322066,23891322065,-1,941,1890,-20
23892375631,23892375635,4,2038,1959,-20
23896456712,23896456714,2,2243,1886,-20
23899573809,23899573813,4,1362,1692,-20
23900660041,23900660045,4,1712,1638,-20
23900702889,23900702893,4,2485,1130,-20
23903571738,23903571738,0,1532,1794,-20
23906948773,23906948776,3,1387,1067,-20
23907806812,23907806816,4,1706,1814,-20
23910907104,23910907106,2,1213,1608,-20
23912356555,23912356555,0,1955,1613,-20
23913337222,23913337225,3,1876,1424,-20
23914025381,23914025387,6,1958,1397,-20
23917309073,23917309074,1,1757,1248,-20
23924322277,23924322279,2,2031,1523,-20
23926010002,23926010006,4,2482,1347,-20
23926352409,23926352415,6,1694,1465,-20
23927551873,23927551879,6,1725,988,-20
23930191407,23930191410,3,2790,1849,-20
23931402646,23931402651,5,1744,941,-20
23932799002,23932799006,4,1849,1255,-20
23933681789,23933681793,4,1729,1396,-20
23933801880,23933801882,2,2201,1701,-20
23934141990,23934141994,4,1957,1342,-20
23938259266,23938259270,4,1783,1016,-20
23940272310,23940272314,4,2066,1435,-20
23942562588,23942562593,5,2047,1312,-20
23944261367,23944261370,3,1244,1004,-20
23944875749,23944875754,5,2103,1671,-20
23947720281,23947720283,2,2212,1237,-20
23948506815,23948506819,4,2120,56101,-20
23948904347,23948904352,5,1922,1714,-20
23949359983,23949359986,3,1324,1105,-20
23950628079,23950628082,3,1647,936,-20
23954419133,23954419137,4,1467,1499,-20
23954650270,23954650268,-2,26828,67692,-20
23956933086,23956933066,-20,1583,708,-20
23958101315,23958101318,3,1400,1423,-20
23958865907,23958865910,3,1970,1462,-20
23959005849,23959005852,3,1452,1342,-20
23959417093,23959417096,3,1621,1829,-20
23960218182,23960218194,12,14140,42617,-20
23961243273,23961243275,2,1329,1043,-20
23964365078,23964365082,4,2231,1453,-20
23968761480,23968761482,2,1262,1555,-20
23969592338,23969592342,4,1309,1075,-20
23970501894,23970501897,3,1505,885,-20
23971481378,23971481380,2,1829,1656,-20
23973066378,23973066383,5,1836,1425,-20
23973828690,23973828694,4,1434,1154,-20
23978485863,23978485867,4,2681,2435,-20
23981662097,23981662099,2,2357,1854,-20
23981698086,23981698087,1,954,1556,-20
23982817658,23982817663,5,2007,1789,-20
23983921603,23983921606,3,1351,1431,-20
23985603494,23985603498,4,2110,1441,-20
23986633406,23986633399,-7,641,3697,-20
23987484063,23987484067,4,1847,1245,-20
23987615314,23987615317,3,1571,1108,-20
23990691782,23990691786,4,1935,1210,-20
23997874029,23997874030,1,2279,2389,-20
23997930205,23997930208,3,1614,613,-20
23998652769,23998652771,2,1287,1474,-20
24001910511,24001910514,3,1262,1405,-20
24002557542,24002557546,4,2112,2000,-20
24002963578,24002963582,4,1275,1488,-20
24003211546,24003211548,2,1305,1282,-20
24008011809,24008011815,6,1992,1311,-20
24011352659,24011352662,3,2291,1593,-20
24011645831,24011645835,4,2418,1463,-20
24014296720,24014296722,2,2419,1513,-20
24022235978,24022235979,1,1463,1196,-20
24023104293,24023104294,1,1301,728,-20
24028374557,24028374561,4,1748,1489,-20
24032312746,24032312747,1,2140,1228,-20
24032693946,24032693949,3,1961,1096,-20
24032964065,24032964069,4,2662,1179,-20
24033583061,24033583062,1,1525,1806,-20
24033853897,24033853901,4,1971,1615,-20
24036951004,24036951008,4,2551,1592,-20
24041703631,24041703611,-20,1434,1302,-20
24042086113,24042086113,0,942,1152,-20
24042170865,24042170871,6,1546,1014,-20
24042958649,24042958654,5,1947,1064,-20
24043867168,24043867170,2,1839,1228,-20
24044428021,24044428026,5,1306,1010,-20
24046539338,24046539343,5,2113,1070,-20
24046890164,24046890145,-19,1592,1210,-20
24050485819,24050485813,-6,1096,3375,-20
24051920425,24051920427,2,2091,1793,-20
24052277181,24052277186,5,2319,1519,-20
24052767319,24052767322,3,1594,1399,-20
24057021794,24057021798,4,1703,1673,-20
24057182398,24057182404,6,2213,1576,-20
24057678378,24057678377,-1,3078,3687,-20
24058548500,24058548502,2,1315,1474,-20
24061727136,24061727138,2,2174,1550,-20
24064829301,24064829305,4,1750,1561,-20
24065290635,24065290637,2,1976,1575,-20
24067153943,24067153948,5,1221,944,-20
24068805359,24068805363,4,2862,1794,-20
24072023295,24072023296,1,1547,1369,-20
24075878661,24075878663,2,1764,1197,-20
24083369797,24083369802,5,1412,869,-20
24090468123,24090468126,3,1560,1083,-20
24090781058,24090781060,2,2027,1172,-20
24092116161,24092116165,4,2234,1810,-20
24097517471,24097517451,-20,1747,1298,-20
24110009045,24110009049,4,3047,2094,-20
24115725437,24115725441,4,2525,1631,-20
24123004014,24123004017,3,1671,1021,-20
24123788062,24123788065,3,1505,1352,-20
24125282104,24125282106,2,1632,1518,-20
24129148602,24129148605,3,2231,1344,-20
24135202042,24135202048,6,1551,1431,-20
24135824659,24135824663,4,1410,1099,-20
24138014818,24138014831,13,300,1420,-20
24138047203,24138047206,3,2256,1227,-20
24138815141,24138815138,-3,1309,3331,-20
24141011188,24141011191,3,1769,1247,-20
24142833366,24142833370,4,1679,1442,-20
24144468462,24144468466,4,2624,1473,-20
24145080066,24145080071,5,7295,1896,-20
24148770138,24148770141,3,2371,1748,-20
24149207403,24149207404,1,1515,2221,-20
24152080178,24152080181,3,2278,1629,-20
24153534621,24153534626,5,1345,1176,-20
24154881417,24154881422,5,2523,1785,-20
24156636180,24156636184,4,1779,1734,-20
24156914686,24156914706,20,1386,1309,-20
24159324007,24159324010,3,1095,1144,-20
24161083518,24161083521,3,1581,1476,-20
24162561314,24162561318,4,1706,1268,-20
24166929550,24166929551,1,1682,1440,-20
24170363079,24170363084,5,2907,1587,-20
24172497382,24172497386,4,1415,1437,-20
24173399141,24173399144,3,1725,1192,-20
24174035778,24174035781,3,1399,1112,-20
24174247102,24174247102,0,1771,1572,-20
24177911050,24177911051,1,1178,824,-20
24181955718,24181955723,5,1957,1342,-20
24182446038,24182446018,-20,1565,1573,-20
24185899644,24185899631,-13,1734,1229,-20
24189476329,24189476333,4,1324,743,-20
24192740880,24192740882,2,1771,1436,-20
24194863678,24194863682,4,1122,1390,-20
24196705170,24196705174,4,2379,1128,-20
24197573476,24197573478,2,1265,1150,-20
24198215686,24198215690,4,1545,1121,-20
24204894746,24204894749,3,1689,1184,-20
24205152562,24205152564,2,1589,1521,-20
24206649988,24206649988,0,31551,29798,-20
24213650449,24213650452,3,2143,1340,-20
24214302717,24214302721,4,1561,1620,-20
24215018936,24215018937,1,1502,1083,-20
24216188639,24216188641,2,1849,1444,-20
24216632390,24216632393,3,2075,1268,-20
24217084878,24217084884,6,1678,1039,-20
24219442620,24219442623,3,1786,928,-20
24219555089,24219555106,17,1875,1824,-20
24219822326,24219822329,3,1489,1193,-20
24222477691,24222477693,2,2014,1896,-20
24223805078,24223805083,5,2667,1531,-20
24224195178,24224195182,4,2524,1257,-20
24224726454,24224726457,3,2084,1585,-20
24229894258,24229894238,-20,1992,1081,-20
24231218553,24231218555,2,1609,1584,-20
24231482589,24231482590,1,1114,1399,-20
24232354752,24232354758,6,1075,814,-20
24233351196,24233351198,2,1634,1328,-20
24233776969,24233776972,3,1219,994,-20
24234980911,24234980916,5,1573,1381,-20
24238486326,24238486329,3,1697,1287,-20
24244134173,24244134177,4,2757,1605,-20
24244933573,24244933579,6,2461,1198,-20
24245209459,24245209462,3,1929,1762,-20
24248396953,24248396958,5,2258,1642,-20
24250889497,24250889501,4,1417,1239,-20
24251930762,24251930757,-5,2258,7736,-20
24254062246,24254062250,4,1381,1211,-20
24254145166,24254145170,4,1959,1736,-20
24255704413,24255704418,5,1480,1264,-20
24258680455,24258680457,2,1895,1441,-20
24260128606,24260128608,2,2082,1633,-20
24260502508,24260502513,5,1512,1350,-20
24262250654,24262250654,0,1267,1260,-20
24264459045,24264459049,4,1897,1228,-20
24265605923,24265605927,4,1802,1118,-20
24266486559,24266486563,4,2021,1803,-20
24266658588,24266658571,-17,1886,1314,-20
24271418577,24271418580,3,1192,1214,-20
24274632042,24274632044,2,2612,1261,-20
24275364730,24275364733,3,1630,1358,-20
24276323826,24276323830,4,2071,1527,-20
24279569147,24279569152,5,2454,1677,-20
24280318511,24280318513,2,11994,13428,-20
24283674339,24283674342,3,1489,1967,-20
24284068132,24284068134,2,2206,1323,-20
24286165994,24286165997,3,2415,1832,-20
24290387445,24290387447,2,1797,1297,-20
24292417446,24292417451,5,2009,1508,-20
24294550913,24294550915,2,1316,1829,-20
24297241850,24297241851,1,1448,1458,-20
24297961483,24297961486,3,2070,1699,-20
24299495206,24299495209,3,1526,1277,-20
24302943092,24302943096,4,2729,1835,-20
24303658441,24303658443,2,1637,1515,-20
24306249549,24306249554,5,1604,1210,-20
24306465286,24306465293,7,3248,1138,-20
24308194493,24308194497,4,2398,1138,-20
24308983746,24308983749,3,2250,1799,-20
24310574398,24310574403,5,3279,1471,-20
24311713354,24311713358,4,2668,1949,-20
24312902134,24312902139,5,1359,1114,-20
24315983475,24315983479,4,3186,1980,-20
24320218194,24320218197,3,975,1051,-20
24321122833,24321122837,4,2123,1471,-20
24321887531,24321887546,15,1355,1383,-20
24321988125,24321988129,4,2403,1856,-20
24326337071,24326337073,2,2873,1827,-20
24331542122,24331542123,1,1467,1626,-20
24333804670,24333804671,1,1498,1622,-20
24335482579,24335482584,5,2434,1211,-20
24336372146,24336372151,5,1240,1018,-20
24337120398,24337120402,4,2033,1901,-20
24337154970,24337154975,5,1355,1612,-20
24337431047,24337431051,4,1792,1376,-20
24337583818,24337583822,4,1549,1600,-20
24342563563,24342563567,4,1034,800,-20
24343916113,24343916117,4,2062,1365,-20
24344218443,24344218447,4,1953,1730,-20
24344439070,24344439074,4,1916,1438,-20
24344990720,24344990724,4,1794,1272,-20
24345091849,24345091851,2,2280,1556,-20
24348777836,24348777838,2,2007,1611,-20
24351133676,24351133678,2,1618,1480,-20
24354160435,24354160439,4,1359,1691,-20
24355249975,24355249978,3,1567,1095,-20
24357487522,24357487521,-1,1099,1798,-20
24357548317,24357548318,1,1381,1731,-20
24365186407,24365186411,4,1005,601,-20
24368987257,24368987261,4,2231,1745,-20
24369959218,24369959220,2,1932,1848,-20
24374039945,24374039948,3,1867,1446,-20
24374697693,24374697694,1,1122,939,-20
24375241081,24375241078,-3,1997,4031,-20
24375740565,24375740570,5,1572,1220,-20
24379073597,24379073601,4,1790,1278,-20
24381181070,24381181073,3,2383,1763,-20
24381598616,24381598619,3,1258,1110,-20
24382505882,24382505886,4,2338,1468,-20
24386332539,24386332542,3,1288,1095,-20
24386362534,24386362516,-18,1965,1035,-20
24386809583,24386809587,4,2264,1281,-20
24399528299,24399528303,4,1161,1281,-20
24400595273,24400595266,-7,811,1932,-20
24400893256,24400893258,2,2197,1430,-20
24406667174,24406667178,4,1603,1491,-20
24408133667,24408133671,4,1096,1003,-20
24409591039,24409591043,4,3253,1379,-20
24414488821,24414488824,3,1459,1265,-20
24414970907,24414970901,-6,348,2917,-20
24417378134,24417378134,0,1809,1733,-20
24417407460,24417407463,3,2270,1561,-20
24420718209,24420718202,-7,1007,2505,-20
24423056526,24423056526,0,1680,2154,-20
24428241106,24428241112,6,1507,1362,-20
24428932462,24428932467,5,1335,1286,-20
24429801977,24429801986,9,16570,19665,-20
24432999402,24432999405,3,1846,1392,-20
24439152765,24439152772,7,1709,1229,-20
24442195038,24442195041,3,2476,1807,-20
24443464277,24443464279,2,1364,813,-20
24447829365,24447829371,6,2121,1298,-20
24449207864,24449207866,2,1710,1712,-20
24449908369,24449908371,2,1410,1356,-20
24450103564,24450103566,2,1671,1663,-20
24450336122,24450336125,3,2132,1267,-20
24451412209,24451412214,5,1211,941,-20
24452327433,24452327435,2,2081,1524,-20
24453021586,24453021590,4,1402,1248,-20
24456191327,24456191331,4,2083,1542,-20
24459691545,24459691547,2,2211,1277,-20
24459788702,24459788696,-6,736,2813,-20
24460972011,24460972014,3,1876,1217,-20
24464458618,24464458621,3,2034,1261,-20
24469891576,24469891578,2,1209,1318,-20
24473673391,24473673395,4,2235,1437,-20
24474132745,24474132748,3,1251,1118,-20
24474627715,24474627718,3,1659,1438,-20
24474946711,24474946714,3,2793,1624,-20
24476734705,24476734709,4,1783,1579,-20
24479778358,24479778362,4,1944,1847,-20
24480209025,24480209025,0,1362,978,-20
24481217512,24481217514,2,2382,1447,-20
24484082058,24484082063,5,2514,1593,-20
24485691354,24485691359,5,2087,1133,-20
24487147979,24487147983,4,1302,1752,-20
24490373618,24490373620,2,1853,1523,-20
24495299423,24495299426,3,1763,2047,-20
24498459179,24498459173,-6,1525,4021,-20
24502089178,24502089181,3,1432,1573,-20
24503009918,24503009922,4,1171,1009,-20
24503779506,24503779503,-3,1492,3663,-20
24504098731,24504098736,5,1888,1467,-20
24505455730,24505455718,-12,1334,77,-20
24506333335,24506333338,3,1997,1501,-20
24506628802,24506628805,3,1599,1658,-20
24507830694,24507830701,7,1492,927,-20
24514824273,24514824277,4,1948,1675,-20
24518399725,24518399727,2,2449,1591,-20
24518607754,24518607758,4,1469,1345,-20
24520773154,24520773158,4,1668,1608,-20
24526884898,24526884883,-15,1350,193,-20
24529535004,24529535001,-3,20180,15349,-20
24531258217,24531258222,5,1427,1174,-20
24531659045,24531659049,4,2096,1608,-20
24533733713,24533733715,2,2051,1414,-20
24535671048,24535671053,5,2356,2047,-20
24537553541,24537553545,4,988,1073,-20
24538604033,24538604036,3,1363,989,-20
24539735702,24539735707,5,1253,1404,-20
24541341741,24541341745,4,1354,1280,-20
24541977454,24541977434,-20,1812,1283,-20
24543345298,24543345303,5,1572,1568,-20
24545143722,24545143726,4,1851,1263,-20
24546748611,24546748613,2,1933,1675,-20
24550156736,24550156738,2,1950,1407,-20
24554668966,24554668970,4,2565,1530,-20
24558315207,24558315209,2,1608,1526,-20
24561478086,24561478091,5,1085,1005,-20
24562877823,24562877827,4,1471,1039,-20
24563648183,24563648187,4,1223,982,-20
24565723458,24565723467,9,1312,1042,-20
24566287789,24566287793,4,1770,1511,-20
24568195289,24568195291,2,1513,1824,-20
24572608431,24572608415,-16,2062,974,-20
24572666741,24572666721,-20,1888,1119,-20
24574528357,24574528362,5,2211,1191,-20
24576853961,24576853965,4,1654,997,-20
24577417056,24577417059,3,1939,1628,-20
24579192089,24579192097,8,3082,1157,-20
24583145749,24583145754,5,1711,951,-20
24584377219,24584377222,3,1922,1507,-20
24584553094,24584553096,2,1327,1406,-20
24585184858,24585184862,4,1642,1379,-20
24585981600,24585981602,2,1471,916,-20
24587603111,24587603113,2,2025,1895,-20
24588259914,24588259918,4,2217,1734,-20
24588420074,24588420079,5,2017,1478,-20
24591928187,24591928191,4,2175,1246,-20
24592778508,24592778512,4,1211,1661,-20
24596328413,24596328416,3,1922,1616,-20
24598875378,24598875383,5,2656,1056,-20
24602599839,24602599840,1,1485,1395,-20
24602639962,24602639948,-14,1814,1155,-20
24612291188,24612291191,3,1520,1268,-20
24613548183,24613548188,5,1477,1113,-20
24613636918,24613636921,3,1425,1119,-20
24614147502,24614147506,4,1235,926,-20
24614597530,24614597531,1,1775,1738,-20
24614682282,24614682286,4,1933,1934,-20
24615886655,24615886654,-1,2791,3460,-20
24616532915,24616532921,6,1376,1123,-20
24620193035,24620193038,3,2343,1184,-20
24624300865,24624300870,5,2794,1087,-20
24627264150,24627264144,-6,1798,7455,-20
24627507417,24627507419,2,1248,807,-20
24636632465,24636632468,3,1697,1552,-20
24637237659,24637237657,-2,982,1835,-20
24637536873,24637536877,4,1494,1131,-20
24641363902,24641363906,4,1594,1107,-20
24641703577,24641703578,1,1623,1634,-20
24644972655,24644972659,4,2731,1525,-20
24645873598,24645873603,5,2511,1604,-20
24646147133,24646147134,1,1543,811,-20
24651741914,24651741914,0,1623,2084,-20
24651957583,24651957585,2,2249,1257,-20
24655639298,24655639301,3,2663,1356,-20
24660576626,24660576631,5,1432,1342,-20
24661461015,24661461019,4,2350,1604,-20
24664956353,24664956355,2,1863,1334,-20
24669409586,24669409591,5,1788,1927,-20
24673224721,24673224726,5,1536,1393,-20
24678436361,24678436365,4,2527,1764,-20
24679780037,24679780041,4,1886,1741,-20
24682972482,24682972487,5,1411,700,-20
24685881950,24685881954,4,1765,1028,-20
24687388639,24687388638,-1,2593,4355,-20
24688982466,24688982469,3,2048,1648,-20
24690197925,24690197927,2,2032,1535,-20
24691730835,24691730839,4,1313,1047,-20
24694539819,24694539824,5,2418,1370,-20
24696097926,24696097930,4,2005,1272,-20
24700662312,24700662316,4,1952,1321,-20
24702364053,24702364056,3,2174,851,-20
24703667722,24703667726,4,1955,1624,-20
24705346878,24705346883,5,2078,1210,-20
24705607050,24705607057,7,3823,2090,-20
24706617487,24706617493,6,4806,2146,-20
24706963438,24706963443,5,1529,1534,-20
24707895921,24707895925,4,1695,1124,-20
24717503541,24717503545,4,1450,1064,-20
24720550496,24720550490,-6,1826,5350,-20
24721942953,24721942957,4,2005,1494,-20
24723993050,24723993051,1,1637,917,-20
24732245131,24732245135,4,1234,1319,-20
24734600795,24734600798,3,1738,1522,-20
24739448555,24739448559,4,1655,1870,-20
24741528886,24741528887,1,1594,1173,-20
24745961276,24745961280,4,1550,1279,-20
24747877255,24747877258,3,1636,1412,-20
24756326521,24756326523,2,1838,1442,-20
24758911049,24758911051,2,1093,815,-20
24763030408,24763030412,4,1798,1641,-20
24764096330,24764096335,5,2044,1360,-20
24765055329,24765055334,5,1900,1336,-20
24765852991,24765852995,4,2375,1061,-20
24765948186,24765948191,5,1999,1078,-20
24768329575,24768329577,2,1369,980,-20
24772580806,24772580811,5,1570,1200,-20
24774497074,24774497079,5,786,832,-20
24777140701,24777140706,5,2084,1706,-20
24783991061,24783991065,4,2369,1854,-20
24784170426,24784170429,3,1988,1550,-20
24785006936,24785006937,1,1323,1658,-20
24790556143,24790556146,3,1652,1338,-20
24791886356,24791886357,1,1467,1875,-20
24795157094,24795157097,3,1855,1279,-20
24796497402,24796497406,4,1120,841,-20
24797221098,24797221102,4,754,704,-20
24806764537,24806764538,1,1126,1780,-20
24808024862,24808024865,3,2202,1350,-20
24810672173,24810672177,4,1789,1389,-20
24811302548,24811302550,2,1497,1006,-20
24811499895,24811499899,4,1801,1490,-20
24812529651,24812529657,6,1962,715,-20
24812935069,24812935071,2,2564,1262,-20
24813049285,24813049287,2,1867,1560,-20
24813416519,24813416525,6,1930,1620,-20
24815648220,24815648222,2,2831,1320,-20
24816173263,24816173261,-2,884,2469,-20
24816840421,24816840425,4,2236,1671,-20
24816890001,24816890003,2,1627,1342,-20
24822311545,24822311546,1,2213,1888,-20
24824639470,24824639473,3,2000,1331,-20
24827534468,24827534470,2,1021,907,-20
24831838129,24831838131,2,1094,1347,-20
24834771113,24834771116,3,1612,1396,-20
24837362810,24837362813,3,1277,1459,-20
24838152006,24838152007,1,2056,1557,-20
24838783432,24838783433,1,2049,1480,-20
24839038190,24839038193,3,1739,1403,-20
24839764170,24839764173,3,2316,1684,-20
24842656473,24842656477,4,2147,1460,-20
24843302159,24843302162,3,1760,1644,-20
24843406973,24843406977,4,2071,1693,-20
24844354252,24844354255,3,3258,1528,-20
24845280796,24845280796,0,2211,1029,-20
24845501754,24845501760,6,2685,1256,-20
24847075522,24847075522,0,1748,2084,-20
24851740867,24851740870,3,2054,1450,-20
24852354716,24852354719,3,2106,1482,-20
24852488414,24852488417,3,1276,1147,-20
24852998682,24852998685,3,2273,1760,-20
24853708940,24853708943,3,2551,1381,-20
24855433282,24855433285,3,2298,1726,-20
24857133189,24857133190,1,1385,1382,-20
24860205739,24860205743,4,1378,1487,-20
24864436382,24864436384,2,1853,1935,-20
24864510739,24864510734,-5,557,3288,-20
24864888809,24864888829,20,1426,2809,-20
24868128630,24868128633,3,1826,1397,-20
24872767953,24872767955,2,2787,1451,-20
24874409842,24874409846,4,2130,1857,-20
24875534668,24875534671,3,864,1417,-20
24879258094,24879258098,4,1903,1517,-20
24879289275,24879289278,3,1592,811,-20
24881892707,24881892710,3,1430,1063,-20
24883513695,24883513698,3,1850,1080,-20
24883853951,24883853946,-5,1876,2754,-20
24884147857,24884147861,4,1992,1821,-20
24885003546,24885003528,-18,1239,998,-20
24886238217,24886238220,3,2074,2026,-20
24887615143,24887615146,3,1488,1445,-20
24888433546,24888433550,4,2222,1856,-20
24889817762,24889817781,19,872,1048,-20
24896195147,24896195161,14,11916,46225,-20
24897408422,24897408425,3,2169,1612,-20
24897692779,24897692783,4,1705,1536,-20
24899685338,24899685343,5,2473,1580,-20
24899752014,24899752019,5,1346,1182,-20
24901878793,24901878811,18,450,1423,-20
24906275273,24906275275,2,1727,1356,-20
24909548823,24909548825,2,1558,1159,-20
24909721013,24909721018,5,1816,1502,-20
24910759429,24910759430,1,1570,812,-20
24914052763,24914052770,7,1506,1494,-20
24914300062,24914300044,-18,1482,1327,-20
24919286064,24919286067,3,2161,1653,-20
24921670315,24921670332,17,1279,3431,-20
24924211425,24924211429,4,2415,1397,-20
24924917979,24924917962,-17,1553,1207,-20
24927931483,24927931486,3,1691,1839,-20
24927968450,24927968451,1,1229,1816,-20
24930603566,24930603570,4,1336,1061,-20
24931930501,24931930505,4,1938,1813,-20
24932272282,24932272287,5,2336,1439,-20
24936165509,24936165511,2,1824,2168,-20
24940753790,24940753791,1,1960,1192,-20
24943548919,24943548921,2,1162,1248,-20
24944369666,24944369670,4,980,1139,-20
24945739292,24945739296,4,1652,1678,-20
24947302643,24947302646,3,1543,1080,-20
24947714126,24947714130,4,1972,1032,-20
24947996553,24947996557,4,1932,1507,-20
24949097269,24949097271,2,1343,1221,-20
24949647573,24949647575,2,1501,985,-20
24951526398,24951526401,3,1376,1187,-20
24960686578,24960686581,3,1901,1477,-20
24966260130,24966260133,3,2230,1782,-20
24967364363,24967364344,-19,1613,275,-20
24967947182,24967947185,3,1804,1481,-20
24968037360,24968037363,3,1841,1442,-20
24968104150,24968104155,5,1846,1258,-20
24970867550,24970867553,3,1922,965,-20
24971314005,24971314010,5,1417,783,-20
24972559843,24972559826,-17,1255,902,-20
24973834384,24973834387,3,1815,1220,-20
24977149222,24977149226,4,1367,1388,-20
24979849817,24979849819,2,1947,1232,-20
24984541683,24984541686,3,1676,1471,-20
24985161043,24985161047,4,1547,918,-20
24986109502,24986109505,3,1979,1692,-20
24988700961,24988700954,-7,2269,8221,-20
24990220206,24990220210,4,2086,1765,-20
24990441535,24990441512,-23,688,498,-20
24991423802,24991423805,3,1941,1588,-20
24991906454,24991906457,3,2430,1801,-20
24992004893,24992004896,3,2013,1429,-20
24998056058,24998056060,2,1789,1450,-20
25001044523,25001044522,-1,1635,1537,-20
25001634363,25001634366,3,1911,1344,-20
25005151303,25005151305,2,1107,1030,-20
25007537874,25007537878,4,1715,1039,-20
25010095324,25010095325,1,1406,1207,-20
25014064646,25014064651,5,1873,1001,-20
25015114673,25015114677,4,1540,1386,-20
25018493449,25018493450,1,2310,1979,-20
25022376843,25022376847,4,1697,962,-20
25022986719,25022986716,-3,1258,3231,-20
25028625133,25028625139,6,1595,1002,-20
25029968651,25029968654,3,1949,1369,-20
25030906461,25030906466,5,38812,20244,-20
25037579533,25037579535,2,1461,1201,-20
25039726885,25039726888,3,1794,1196,-20
25040360445,25040360445,0,1353,1610,-20
25041061069,25041061072,3,2023,1762,-20
25041303030,25041303037,7,2436,1231,-20
25043689573,25043689578,5,1885,1238,-20
25043721892,25043721898,6,1796,1401,-20
25043792234,25043792241,7,487,237,-20
25044121310,25044121303,-7,1258,3940,-20
25045016882,25045016888,6,887,678,-20
25045825818,25045825823,5,1895,1711,-20
25046313121,25046313124,3,1944,1234,-20
25050145018,25050145021,3,2316,1415,-20
25050258378,25050258380,2,2155,1500,-20
25052589195,25052589201,6,1769,1122,-20
25052823861,25052823862,1,1369,1831,-20
25054082869,25054082877,8,10065,3100,-20
25054128949,25054128953,4,2193,1887,-20
25054269011,25054269015,4,1778,1430,-20
25054478979,25054478986,7,2893,1440,-20
25055864287,25055864290,3,1725,1780,-20
25058634799,25058634803,4,1287,923,-20
25062237430,25062237433,3,2034,1389,-20
25063387764,25063387768,4,1802,1358,-20
25065297210,25065297214,4,2152,1166,-20
25066583850,25066583852,2,2022,1038,-20
25067249243,25067249247,4,1513,1273,-20
25069669452,25069669454,2,1204,1463,-20
25073715822,25073715822,0,2418,2691,-20
25076379347,25076379347,0,1455,719,-20
25077253336,25077253317,-19,1175,947,-20
25083571065,25083571068,3,2109,1704,-20
25086955611,25086955613,2,2129,1318,-20
25089434972,25089434974,2,1155,700,-20
25092827398,25092827402,4,1727,1232,-20
25093188061,25093188064,3,2169,1335,-20
25094666110,25094666111,1,1206,973,-20
25097988305,25097988307,2,1120,1612,-20
25105782890,25105782894,4,1490,1371,-20
25106978983,25106978986,3,2051,2265,-20
25109227572,25109227575,3,1897,1284,-20
25109355572,25109355574,2,1524,1135,-20
25115783313,25115783318,5,2612,1534,-20
25120613810,25120613810,0,1222,1273,-20
25121086286,25121086289,3,1402,1154,-20
25121723149,25121723153,4,1874,1414,-20
25122316738,25122316743,5,1883,1370,-20
25122961916,25122961916,0,1307,1955,-20
25123542607,25123542608,1,1511,947,-20
25123669899,25123669883,-16,1874,1551,-20
25124241917,25124241920,3,2259,1677,-20
25124461949,25124461947,-2,1085,2138,-20
25124687856,25124687873,17,160,893,-20
25129285886,25129285886,0,1769,1413,-20
25130761552,25130761553,1,1146,1084,-20
25130923093,25130923097,4,2123,1551,-20
25131754622,25131754626,4,1888,1663,-20
25133524590,25133524577,-13,1762,1470,-20
25135267433,25135267438,5,1232,688,-20
25136441150,25136441154,4,1640,1357,-20
25137478357,25137478360,3,2504,1471,-20
25142009094,25142009097,3,1474,1227,-20
25143327779,25143327782,3,1733,1499,-20
25144289313,25144289317,4,2026,1498,-20
25144426088,25144426097,9,4747,1342,-20
25145089257,25145089259,2,1801,1066,-20
25154029067,25154029070,3,1173,1097,-20
25157092750,25157092754,4,2681,1755,-20
25161802135,25161802122,-13,858,473,-20
25162002614,25162002619,5,1614,1265,-20
25163454889,25163454891,2,2004,1375,-20
25164290897,25164290900,3,1641,1487,-20
25167478640,25167478641,1,1617,1230,-20
25173773663,25173773667,4,976,1359,-20
25181531989,25181531992,3,1288,1346,-20
25185444323,25185444326,3,1953,1905,-20
25186039890,25186039893,3,1563,1526,-20
25186550880,25186550883,3,2724,1641,-20
25188213444,25188213450,6,1368,916,-20
25190255358,25190255359,1,1213,1215,-20
25191174430,25191174409,-21,811,754,-20
25194155362,25194155366,4,1891,1586,-20
25196712306,25196712308,2,1473,1655,-20
25197448676,25197448678,2,1651,1470,-20
25200265994,25200265999,5,1574,1726,-20
25200901110,25200901113,3,1770,1400,-20
25202515917,25202515922,5,1480,1543,-20
25202913657,25202913673,16,1916,2015,-20
25203202529,25203202533,4,1645,1154,-20
25205028125,25205028129,4,1599,1149,-20
25205462199,25205462201,2,1150,964,-20
25205971934,25205971938,4,1659,1262,-20
25213510823,25213510826,3,2171,1233,-20
25216763808,25216763810,2,2138,1507,-20
25220845150,25220845153,3,1564,1342,-20
25222616615,25222616619,4,1672,1455,-20
25224438090,25224438093,3,2182,1592,-20
25225670153,25225670155,2,1680,1556,-20
25226252430,25226252435,5,2378,2215,-20
25230228489,25230228494,5,2126,1524,-20
25233618786,25233618789,3,2667,2040,-20
25240908774,25240908775,1,1097,1286,-20
25243805557,25243805560,3,1910,1457,-20
25245686646,25245686651,5,1198,824,-20
25252050180,25252050183,3,1808,1436,-20
25254495434,25254495439,5,2363,1681,-20
25254591493,25254591498,5,2251,1881,-20
25258463010,25258463014,4,2193,1794,-20
25259013023,25259013026,3,1698,808,-20
25259248529,25259248537,8,1805,985,-20
25261342611,25261342614,3,2042,1225,-20
25266337965,25266337965,0,1203,1526,-20
25267886503,25267886508,5,996,1182,-20
25269312712,25269312715,3,1985,1752,-20
25269778892,25269778895,3,1441,1200,-20
25272740608,25272740613,5,1275,1504,-20
25273177646,25273177649,3,2085,1219,-20
25276163908,25276163914,6,1565,805,-20
25277393898,25277393901,3,2132,1497,-20
25277612935,25277612939,4,1713,1096,-20
25278150119,25278150122,3,2220,1712,-20
25278990559,25278990560,1,1022,1063,-20
25279911534,25279911533,-1,1179,1204,-20
25281093387,25281093390,3,1588,1164,-20
25281487103,25281487105,2,1359,1459,-20
25281741412,25281741433,21,1761,1448,-20
25282901570,25282901574,4,2082,1626,-20
25283978514,25283978518,4,1595,1041,-20
25289624107,25289624110,3,1425,1687,-20
25290549505,25290549509,4,1765,1229,-20
25290642382,25290642360,-22,1165,1245,-20
25294220309,25294220310,1,1386,919,-20
25295762446,25295762451,5,1894,1337,-20
25296216333,25296216334,1,4851,4732,-20
25298494829,25298494832,3,2061,1399,-20
25299860772,25299860774,2,1588,1125,-20
25299894625,25299894627,2,1208,1263,-20
25304888615,25304888621,6,1924,1239,-20
25305168418,25305168418,0,10939,48614,-20
25308990500,25308990519,19,2208,1179,-20
25309481354,25309481339,-15,2190,1399,-20
25311887049,25311887050,1,1578,1627,-20
25312345592,25312345595,3,2378,1558,-20
25314407699,25314407706,7,14718,10250,-20
25316270685,25316270700,15,16376,49668,-20
25318684500,25318684504,4,2186,1436,-20
25318760193,25318760195,2,2272,1254,-20
25318900510,25318900515,5,1702,1657,-20
25319499151,25319499154,3,2344,1154,-20
25320652670,25320652674,4,1709,1554,-20
25323548049,25323548052,3,1963,1153,-20
25326082301,25326082306,5,1636,1143,-20
25326953486,25326953487,1,1450,1542,-20
25328501945,25328501948,3,1539,1059,-20
25329509001,25329509004,3,1114,1005,-20
25329686115,25329686098,-17,670,498,-20
25332318954,25332318955,1,2151,1704,-20
25334947803,25334947807,4,1209,923,-20
25336009734,25336009739,5,1512,1346,-20
25337340587,25337340586,-1,842,812,-20
25338823531,25338823531,0,1194,1424,-20
25341390246,25341390251,5,1400,1591,-20
25341946211,25341946203,-8,1160,1179,-20
25343715793,25343715797,4,1647,1392,-20
25345308131,25345308135,4,1832,1427,-20
25345908689,25345908687,-2,1766,1972,-20
25347443815,25347443811,-4,18141,7681,-20
25348161789,25348161771,-18,2005,1438,-20
25351528170,25351528171,1,1598,1412,-20
25351931755,25351931758,3,1581,1641,-20
25352169915,25352169917,2,1248,1910,-20
25354003861,25354003864,3,1616,1054,-20
25358010049,25358010051,2,2094,1472,-20
25358489956,25358489959,3,2762,1748,-20
25360626892,25360626894,2,1971,1552,-20
25363764377,25363764381,4,2011,1326,-20
25365910713,25365910715,2,971,658,-20
25368917712,25368917716,4,1501,1448,-20
25371629653,25371629656,3,2125,1846,-20
25375384068,25375384071,3,2120,1556,-20
25388842281,25388842284,3,2029,1692,-20
25388951720,25388951723,3,1568,1119,-20
25389169684,25389169689,5,1253,1281,-20
25389960690,25389960696,6,1831,1192,-20
25391227130,25391227133,3,1941,1555,-20
25396244618,25396244622,4,2475,1872,-20
25396535882,25396535871,-11,1294,1643,-20
25398526735,25398526740,5,1994,1051,-20
25399662937,25399662941,4,1115,976,-20
25400515976,25400515981,5,1355,1516,-20
25402030946,25402030950,4,2348,1754,-20
25405940226,25405940230,4,1133,1414,-20
25412355496,25412355497,1,1489,1955,-20
25412922106,25412922111,5,2146,1276,-20
25413432362,25413432371,9,1876,1174,-20
25414161161,25414161165,4,2283,1665,-20
25415018848,25415018853,5,1601,1249,-20
25415339122,25415339120,-2,1204,15431,-20
25415734297,25415734303,6,1539,1303,-20
25418196484,25418196489,5,2534,1395,-20
25421621211,25421621215,4,2167,1225,-20
25423729470,25423729475,5,733,89,-20
25425236735,25425236738,3,1990,1108,-20
25425420965,25425420985,20,2833,1414,-20
25431208931,25431208933,2,1297,825,-20
25431996742,25431996743,1,1331,1449,-20
25434478346,25434478350,4,2051,954,-20
25439961107,25439961109,2,1540,1331,-20
25441040870,25441040874,4,1518,812,-20
25447824252,25447824255,3,1396,1299,-20
25450784625,25450784629,4,3471,1614,-20
25453637277,25453637279,2,1743,1273,-20
25454159157,25454159162,5,2796,1363,-20
25454804705,25454804692,-13,834,529,-20
25457884098,25457884101,3,1614,945,-20
25458269221,25458269224,3,2447,1590,-20
25463599980,25463599983,3,1177,936,-20
25464425270,25464425272,2,1622,1017,-20
25465191845,25465191849,4,1895,1447,-20
25466634942,25466634946,4,2148,992,-20
25467162298,25467162298,0,2198,1434,-20
25467376739,25467376743,4,2088,1678,-20
25467868425,25467868431,6,1866,1479,-20
25473425052,25473425055,3,1465,1633,-20
25474469149,25474469153,4,1783,1750,-20
25479578115,25479578118,3,1260,1057,-20
25483513550,25483513554,4,1760,2019,-20
25487495379,25487495383,4,1624,1254,-20
25490476161,25490476162,1,2101,1597,-20
25490754906,25490754909,3,1491,1561,-20
25491228518,25491228500,-18,2282,1456,-20
25492277689,25492277693,4,2692,1391,-20
25493617322,25493617326,4,1649,1142,-20
25494457759,25494457763,4,1748,1133,-20
25495074280,25495074300,20,1972,1379,-20
25499902383,25499902387,4,1498,1120,-20
25500392269,25500392271,2,1844,1139,-20
25502262381,25502262386,5,2852,1151,-20
25505154341,25505154345,4,1795,1477,-20
25506273686,25506273690,4,1590,1436,-20
25506843717,25506843720,3,1901,1815,-20
25510410325,25510410327,2,1466,990,-20
25512127033,25512127035,2,1148,1538,-20
25512936259,25512936261,2,1430,1512,-20
25515702247,25515702250,3,1448,1278,-20
25516224191,25516224194,3,2165,1189,-20
25516493942,25516493945,3,1156,938,-20
25518425711,25518425714,3,1391,1260,-20
25519254503,25519254506,3,1940,911,-20
25521958293,25521958297,4,1202,1174,-20
25523232909,25523232912,3,2718,2065,-20
25527889054,25527889057,3,2701,1266,-20
25529653898,25529653904,6,1813,1751,-20
25534373267,25534373267,0,1214,1852,-20
25536330511,25536330514,3,1056,1288,-20
25536408049,25536408059,10,1019,402,-20
25539297442,25539297446,4,1440,1035,-20
25542177612,25542177614,2,2546,1594,-20
25543794126,25543794126,0,1258,1517,-20
25547449830,25547449832,2,1347,1616,-20
25550331189,25550331191,2,1677,1583,-20
25552170704,25552170708,4,1674,1488,-20
25553806342,25553806346,4,2198,1494,-20
25556499473,25556499477,4,1789,1543,-20
25557868775,25557868778,3,1052,1048,-20
25560806513,25560806515,2,1672,1561,-20
25563097582,25563097587,5,2618,1698,-20
25564200861,25564200866,5,2766,1285,-20
25564622468,25564622470,2,5663,24224,-20
25566237132,25566237134,2,1766,1521,-20
25567494598,25567494602,4,1545,975,-20
25576028796,25576028795,-1,41750,19201,-20
25577083518,25577083522,4,1429,1539,-20
25578658091,25578658096,5,1951,1252,-20
25580675132,25580675130,-2,366,1243,-20
25583805072,25583805078,6,2077,1035,-20
25585235846,25585235850,4,2523,1644,-20
25585352817,25585352820,3,1506,1218,-20
25585573774,25585573777,3,2181,1322,-20
25585652068,25585652071,3,1330,1550,-20
25588092365,25588092370,5,1522,1254,-20
25596313093,25596313096,3,1054,1317,-20
25598632182,25598632185,3,1721,1460,-20
25603532793,25603532796,3,1980,1369,-20
25604386602,25604386606,4,1093,919,-20
25605447556,25605447559,3,1435,1285,-20
25608883759,25608883762,3,2366,1662,-20
25609936447,25609936447,0,1756,1114,-20
25610465805,25610465807,2,1589,1113,-20
25611247482,25611247489,7,804,821,-20
25613888317,25613888319,2,1440,1027,-20
25615946931,25615946915,-16,1136,995,-20
25617111905,25617111908,3,1567,1589,-20
25618956687,25618956692,5,1458,1189,-20
25623061839,25623061843,4,1537,1150,-20
25623481845,25623481850,5,1270,1389,-20
25624001539,25624001547,8,1612,1325,-20
25626519235,25626519241,6,1817,1521,-20
25631444317,25631444322,5,1789,1324,-20
25632694144,25632694146,2,2322,951,-20
25638528956,25638528958,2,1572,1180,-20
25639039090,25639039093,3,1610,1408,-20
25642366769,25642366754,-15,63,760,-20
25643193181,25643193185,4,1886,1397,-20
25646331865,25646331868,3,2097,1234,-20
25649199764,25649199767,3,2952,1309,-20
25650388639,25650388643,4,2410,1522,-20
25651205146,25651205150,4,1917,1225,-20
25652153830,25652153835,5,1082,858,-20
25653395372,25653395380,8,2183,1660,-20
25660792829,25660792833,4,1515,1488,-20
25664909009,25664909015,6,2099,1073,-20
25666011233,25666011235,2,1374,1482,-20
25667081835,25667081838,3,1733,1412,-20
25667323389,25667323392,3,1255,855,-20
25669281745,25669281748,3,2232,1464,-20
25672298367,25672298369,2,1471,1306,-20
25672339906,25672339910,4,1580,1239,-20
25674765818,25674765818,0,1250,1426,-20
25679066338,25679066341,3,2503,1213,-20
25679493037,25679493042,5,2287,1749,-20
25681682421,25681682427,6,1122,995,-20
25685218306,25685218303,-3,1609,3325,-20
25687054654,25687054658,4,1296,1293,-20
25694299001,25694299006,5,1541,1443,-20
25694841078,25694841083,5,1452,1300,-20
25695567000,25695567005,5,2229,1543,-20
25696810384,25696810385,1,2082,1839,-20
25701350004,25701350004,0,35469,19948,-20
25706576613,25706576615,2,1607,1774,-20
25712491037,25712491037,0,1303,1569,-20
25717672070,25717672074,4,924,1099,-20
25719289430,25719289430,0,1474,1721,-20
25720153844,25720153846,2,1984,962,-20
25721081421,25721081417,-4,780,362,-20
25724048167,25724048170,3,2772,1982,-20
25725437271,25725437277,6,2209,1495,-20
25726641216,25726641217,1,1395,1432,-20
25730518314,25730518317,3,13458,10548,-20
25731332549,25731332535,-14,1540,918,-20
25732958926,25732958930,4,1665,1233,-20
25734739554,25734739559,5,1487,1116,-20
25735034738,25735034741,3,1487,1428,-20
25736913281,25736913283,2,1277,730,-20
25738281825,25738281830,5,2695,1777,-20
25741582687,25741582690,3,1830,1313,-20
25743088377,25743088382,5,1792,1102,-20
25743708979,25743708994,15,1355,1073,-20
25744761790,25744761802,12,1685,1849,-20
25747627162,25747627166,4,1567,1324,-20
25747842430,25747842433,3,2031,1177,-20
25748187433,25748187434,1,1002,916,-20
25749034189,25749034193,4,1831,1993,-20
25750406786,25750406790,4,1794,1315,-20
25753915442,25753915445,3,1846,1575,-20
25755272258,25755272255,-3,1506,1252,-20
25759207515,25759207518,3,2398,1333,-20
25759688610,25759688614,4,2027,1792,-20
25765086906,25765086910,4,1765,1330,-20
25769219964,25769219967,3,2087,1426,-20
25770102027,25770102030,3,1493,1332,-20
25771959547,25771959550,3,1779,1606,-20
25772146278,25772146288,10,1128,960,-20
25774354875,25774354879,4,1445,1433,-20
25776054386,25776054383,-3,1232,2739,-20
25777358530,25777358525,-5,1203,2968,-20
25779404923,25779404923,0,1565,2328,-20
25780757737,25780757740,3,1210,1583,-20
25781264806,25781264784,-22,1297,1239,-20
25781646931,25781646934,3,2017,1660,-20
25784358017,25784358021,4,2464,921,-20
25785620918,25785620918,0,1215,1206,-20
25785892148,25785892149,1,1045,1188,-20
25786865511,25786865511,0,1458,1062,-20
25787750550,25787750553,3,7748,20399,-20
25788637807,25788637811,4,1543,1202,-20
25789832534,25789832547,13,16174,19775,-20
25790383853,25790383857,4,1150,1393,-20
25792224426,25792224428,2,1328,1138,-20
25793382306,25793382310,4,2022,2042,-20
25795190278,25795190284,6,2364,1462,-20
25796563086,25796563080,-6,1982,8077,-20
25799178983,25799178987,4,2462,1823,-20
25799262958,25799262964,6,1781,1168,-20
25801627809,25801627814,5,1975,1086,-20
25803403879,25803403882,3,1728,1924,-20
25803954834,25803954838,4,1795,1233,-20
25806275879,25806275883,4,1732,1413,-20
25808741333,25808741329,-4,1646,3972,-20
25809197814,25809197819,5,2328,1341,-20
25810627983,25810627978,-5,2376,7276,-20
25810831347,25810831351,4,2226,1220,-20
25811632113,25811632110,-3,1565,3519,-20
25813638333,25813638335,2,1170,1188,-20
25814906608,25814906609,1,1983,1360,-20
25816889129,25816889132,3,1242,1141,-20
25824318417,25824318420,3,2502,1072,-20
25828447225,25828447225,0,1904,1304,-20
25829097655,25829097658,3,1325,1077,-20
25832579489,25832579491,2,1938,1366,-20
25840136942,25840136943,1,1522,1360,-20
25840519210,25840519214,4,1808,1097,-20
25843396503,25843396507,4,662,775,-20
25848023419,25848023434,15,544,1501,-20
25853238074,25853238078,4,1883,1544,-20
25861116405,25861116408,3,2438,2298,-20
25866257282,25866257287,5,1578,1281,-20
25866439926,25866439934,8,2815,1500,-20
25868211911,25868211914,3,2233,1616,-20
25871078327,25871078330,3,1141,1136,-20
25876682566,25876682571,5,1637,1309,-20
25877962151,25877962155,4,1626,1462,-20
25879818184,25879818187,3,1556,1143,-20
25882822546,25882822545,-1,1042,1884,-20
25882959606,25882959610,4,2575,1311,-20
25883554346,25883554348,2,2756,1107,-20
25884241994,25884241998,4,1337,1166,-20
25887054290,25887054294,4,2224,2045,-20
25887128227,25887128229,2,1457,1051,-20
25890543025,25890543029,4,1990,1371,-20
25891106568,25891106571,3,1924,1567,-20
25892078141,25892078143,2,2129,1642,-20
25895689656,25895689659,3,1517,1074,-20
25896868327,25896868331,4,1898,1601,-20
25897225384,25897225387,3,1776,1690,-20
25898899654,25898899655,1,1557,1455,-20
25899512350,25899512351,1,1699,1451,-20
25900750851,25900750855,4,1369,910,-20
25902158381,25902158384,3,1632,1530,-20
25903974747,25903974749,2,2705,2033,-20
25905584617,25905584620,3,1679,1329,-20
25907293577,25907293581,4,2363,1613,-20
25911576403,25911576409,6,2099,1494,-20
25911780600,25911780603,3,1734,1432,-20
25920542741,25920542745,4,1492,1659,-20
25920916116,25920916119,3,1523,1241,-20
25921657629,25921657634,5,1955,1659,-20
25923538441,25923538443,2,1871,1921,-20
25924258346,25924258351,5,2325,1034,-20
25925311823,25925311826,3,1299,989,-20
25926666603,25926666606,3,1050,1071,-20
25927862213,25927862215,2,1774,1091,-20
25941785221,25941785216,-5,31498,12483,-20
25944894137,25944894134,-3,1986,2249,-20
25945034883,25945034883,0,1324,1314,-20
25950925803,25950925806,3,2438,1254,-20
25952738641,25952738645,4,2661,1484,-20
25957722743,25957722747,4,1641,1427,-20
25958450084,25958450083,-1,2481,4034,-20
25959512341,25959512343,2,1207,1288,-20
25963650870,25963650874,4,2387,1380,-20
25964939097,25964939098,1,1594,1283,-20
25968687178,25968687181,3,1960,1662,-20
25969089782,25969089786,4,2233,1366,-20
25974526222,25974526226,4,2318,1472,-20
25974764338,25974764342,4,1233,1413,-20
25975601649,25975601651,2,1590,1067,-20
25977771155,25977771159,4,823,823,-20
25978616697,25978616699,2,2006,1557,-20
25984598795,25984598790,-5,1256,6199,-20
25984751942,25984751945,3,1469,1133,-20
25985288795,25985288799,4,1447,1422,-20
25992011975,25992011978,3,1147,1104,-20
25993219177,25993219181,4,2430,1878,-20
26004735022,26004735026,4,2268,1527,-20
26007639859,26007639858,-1,1112,1435,-20
26011608405,26011608406,1,1818,1444,-20
26013497934,26013497935,1,1634,1510,-20
26014865687,26014865690,3,1124,1218,-20
26016903493,26016903498,5,2475,1748,-20
26017080384,26017080388,4,2455,2018,-20
26017998896,26017998887,-9,24630,14775,-20
26020429565,26020429568,3,1467,1112,-20
26024654995,26024654998,3,1500,894,-20
26025339129,26025339134,5,1899,1312,-20
26029294925,26029294927,2,1768,920,-20
26032275598,26032275599,1,1392,1160,-20
26033204085,26033204089,4,1255,1423,-20
26033443567,26033443571,4,1185,1589,-20
26036040111,26036040115,4,1949,1425,-20
26036132728,26036132730,2,2165,1433,-20
26039360090,26039360093,3,1777,1141,-20
26042323139,26042323142,3,1481,1259,-20
26043071354,26043071362,8,2576,1242,-20
26044043950,26044043954,4,1822,1140,-20
26044238877,26044238858,-19,1188,871,-20
26046347278,26046347282,4,1837,1361,-20
26048070118,26048070120,2,1202,721,-20
26051372807,26051372810,3,1742,1188,-20
26052218465,26052218466,1,1456,1200,-20
26053938151,26053938155,4,1365,1068,-20
26056169126,26056169129,3,2020,1735,-20
26057780218,26057780221,3,1801,1107,-20
26060134655,26060134659,4,1241,1482,-20
26060754418,26060754422,4,1597,1083,-20
26061113810,26061113813,3,1095,1042,-20
26061239238,26061239246,8,2383,990,-20
26067028688,26067028690,2,1530,1368,-20
26069611579,26069611584,5,2109,1652,-20
26071851990,26071851993,3,1276,1600,-20
26074320398,26074320405,7,2272,1542,-20
26076610542,26076610543,1,1286,1673,-20
26080590880,26080590883,3,940,909,-20
26081326967,26081326961,-6,1129,6411,-20
26082632659,26082632662,3,2689,1898,-20
26084775126,26084775132,6,2131,1823,-20
26084824939,26084824942,3,2014,2294,-20
26085955453,26085955457,4,2297,1362,-20
26087044428,26087044431,3,1534,1165,-20
26087312164,26087312147,-17,1639,610,-20
26095651601,26095651606,5,1511,1419,-20
26096072814,26096072818,4,1350,1036,-20
26096206006,26096206012,6,2086,1487,-20
26098558589,26098558593,4,1798,1112,-20
26099381731,26099381731,0,1076,1988,-20
26102222390,26102222393,3,1501,1335,-20
26104521974,26104521978,4,1654,1396,-20
26104773027,26104773026,-1,27577,17308,-20
26109593099,26109593103,4,1162,1041,-20
26113273362,26113273367,5,2680,1205,-20
26113835000,26113835003,3,1552,1424,-20
26114246215,26114246199,-16,1274,775,-20
26115204550,26115204554,4,2365,1629,-20
26115816918,26115816922,4,2630,1915,-20
26116634921,26116634923,2,1316,1435,-20
26118988234,26118988238,4,1935,1024,-20
26119721209,26119721211,2,1361,1786,-20
26122538909,26122538911,2,1901,1505,-20
26122825002,26122825005,3,1831,1090,-20
26124039912,26124039917,5,1850,1138,-20
26126161567,26126161570,3,1572,1659,-20
26127143477,26127143475,-2,1288,2114,-20
26129160268,26129160271,3,913,828,-20
26131536932,26131536935,3,1682,1275,-20
26131972035,26131972040,5,2333,1884,-20
26132761939,26132761943,4,1328,859,-20
26133563342,26133563345,3,2020,1555,-20
26136016241,26136016242,1,2542,3303,-20
26143686930,26143686934,4,1436,1237,-20
26144134278,26144134269,-9,851,3558,-20
26145827890,26145827892,2,1954,1580,-20
26148774789,26148774791,2,1716,1543,-20
26149052755,26149052754,-1,847,1363,-20
26150431309,26150431312,3,1435,1101,-20
26152633247,26152633251,4,1975,1383,-20
26154037566,26154037569,3,1750,1855,-20
26154488690,26154488693,3,2488,1216,-20
26154806881,26154806885,4,1864,1156,-20
26163638385,26163638387,2,2434,1835,-20
26169306828,26169306830,2,1885,1261,-20
26171064550,26171064555,5,1707,1286,-20
26171130275,26171130289,14,2396,1679,-20
26172508753,26172508755,2,989,857,-20
26173459335,26173459338,3,2184,1106,-20
26173898149,26173898153,4,1224,1062,-20
26176557580,26176557586,6,1732,1439,-20
26181431813,26181431817,4,1842,1490,-20
26182657726,26182657729,3,1664,1375,-20
26183376803,26183376806,3,1046,1071,-20
26185207046,26185207047,1,1648,1572,-20
26186933803,26186933798,-5,1099,3269,-20
26189105760,26189105763,3,1977,1091,-20
26189843106,26189843110,4,2003,1471,-20
26191888763,26191888766,3,1956,1459,-20
26192487856,26192487859,3,1286,1262,-20
26193078782,26193078786,4,1656,1507,-20
26197587347,26197587351,4,2327,1791,-20
26198373828,26198373836,8,11826,28273,-20
26199755893,26199755889,-4,1671,4210,-20
26201045755,26201045759,4,1573,1343,-20
26203934415,26203934418,3,1603,1733,-20
26204437491,26204437495,4,1359,1214,-20
26208045470,26208045472,2,1475,953,-20
26209790118,26209790105,-13,1543,228,-20
26214359008,26214359010,2,1527,967,-20
26215666512,26215666515,3,995,997,-20
26216616366,26216616372,6,1690,1375,-20
26216661841,26216661849,8,1828,1365,-20
26216871102,26216871107,5,4100,26859,-20
26220731903,26220731907,4,1781,1067,-20
26221090905,26221090924,19,1706,1313,-20
26222428057,26222428059,2,2098,1929,-20
26224241214,26224241217,3,2258,1839,-20
26224543489,26224543493,4,1674,1879,-20
26229769178,26229769185,7,2864,883,-20
26230292186,26230292168,-18,1908,1470,-20
26233936171,26233936174,3,1759,1347,-20
26238374090,26238374092,2,1866,1018,-20
26239806394,26239806403,9,1834,1215,-20
26243026817,26243026819,2,1677,1156,-20
26244901789,26244901792,3,1358,916,-20
26250439079,26250439083,4,2224,1320,-20
26251076534,26251076539,5,3632,1651,-20
26256709558,26256709563,5,1598,959,-20
26257227550,26257227557,7,6457,2933,-20
26258940738,26258940742,4,1284,1250,-20
26261873121,26261873122,1,1461,1024,-20
26266159600,26266159604,4,2222,1678,-20
26269076300,26269076303,3,1719,1149,-20
26270967875,26270967877,2,2373,1947,-20
26271220127,26271220131,4,2659,1334,-20
26272015127,26272015130,3,2107,1967,-20
26272307126,26272307130,4,1876,1556,-20
26274665145,26274665148,3,1742,1551,-20
26275360723,26275360727,4,2073,1274,-20
26275579554,26275579557,3,1511,1513,-20
26277580686,26277580691,5,1502,1374,-20
26278853003,26278853007,4,2429,1624,-20
26280523099,26280523104,5,2106,2021,-20
26281735459,26281735463,4,2300,1396,-20
26282495789,26282495791,2,1975,1261,-20
26283635198,26283635203,5,1865,1987,-20
26284324865,26284324863,-2,1079,1834,-20
26284614982,26284614985,3,1464,1843,-20
26286318041,26286318047,6,1510,1202,-20
26286520726,26286520730,4,2452,1471,-20
26287417106,26287417109,3,1015,1412,-20
26291753054,26291753055,1,1992,1586,-20
26291953277,26291953279,2,2347,1580,-20
26293968908,26293968908,0,1107,1393,-20
26294462789,26294462794,5,1161,1046,-20
26297659681,26297659683,2,1352,1165,-20
26298475009,26298475014,5,2314,1253,-20
26298549871,26298549878,7,1969,635,-20
26302900003,26302900005,2,1348,1197,-20
26304420130,26304420133,3,1568,1287,-20
26305512376,26305512392,16,2544,1440,-20
26313145791,26313145794,3,2120,1637,-20
26316612025,26316612028,3,1452,1660,-20
26318705499,26318705503,4,650,743,-20
26320871287,26320871291,4,1343,1738,-20
26321940786,26321940790,4,2531,1662,-20
26323652551,26323652555,4,1697,1078,-20
26323711195,26323711198,3,1803,1630,-20
26325865706,26325865711,5,1784,1234,-20
26326801519,26326801522,3,1871,1629,-20
26328584197,26328584198,1,854,975,-20
26329021326,26329021330,4,2657,1399,-20
26329496395,26329496397,2,1604,1806,-20
26330329138,26330329122,-16,1669,1043,-20
26331512416,26331512418,2,1739,1231,-20
26336684789,26336684785,-4,26330,10548,-20
26339694631,26339694635,4,2208,1359,-20
26340978631,26340978634,3,2007,1805,-20
26345096495,26345096500,5,1281,1432,-20
26347005052,26347005054,2,2368,1686,-20
26350476080,26350476083,3,2395,1589,-20
26351712218,26351712221,3,2051,1713,-20
26351748718,26351748721,3,1808,1503,-20
26359494522,26359494524,2,2096,1127,-20
26361164546,26361164550,4,1757,1650,-20
26361945712,26361945715,3,1742,881,-20
26362549830,26362549830,0,2067,1996,-20
26362680785,26362680789,4,1557,1154,-20
26365856843,26365856842,-1,1667,2223,-20
26368571916,26368571921,5,1868,1682,-20
26370224415,26370224418,3,958,1281,-20
26371436030,26371436028,-2,2579,2840,-20
26372158670,26372158669,-1,1596,1396,-20
26372626763,26372626766,3,1994,1316,-20
26377419394,26377419396,2,1411,1298,-20
26379189609,26379189614,5,2049,1733,-20
26390932087,26390932090,3,1596,1078,-20
26392928113,26392928111,-2,1196,2144,-20
26395288987,26395288990,3,1708,1241,-20
26395680538,26395680542,4,2076,966,-20
26397301981,26397301982,1,1636,1327,-20
26401182872,26401182854,-18,1697,1871,-20
26402049169,26402049171,2,1669,1017,-20
26402776167,26402776172,5,2144,1505,-20
26404671409,26404671413,4,1564,1494,-20
26408224404,26408224406,2,1358,1278,-20
26413101097,26413101099,2,1418,1018,-20
26422009171,26422009179,8,12927,27326,-20
26422487595,26422487598,3,1990,1697,-20
26423892470,26423892474,4,1506,1417,-20
26425353810,26425353815,5,1704,1643,-20
26426946793,26426946794,1,2013,1541,-20
26429270247,26429270253,6,2508,1622,-20
26430625666,26430625665,-1,1973,3624,-20
26430974379,26430974379,0,1493,1597,-20
26432304710,26432304714,4,1631,1336,-20
26432565421,26432565424,3,1653,1251,-20
26436802149,26436802153,4,1271,894,-20
26439190547,26439190550,3,1695,1085,-20
26442268010,26442268015,5,1571,1803,-20
26442855796,26442855800,4,2758,1716,-20
26445355237,26445355241,4,2157,1871,-20
26450700271,26450700275,4,1579,1063,-20
26453049034,26453049037,3,1478,1115,-20
26454777014,26454777019,5,1855,1238,-20
26456243673,26456243677,4,1363,1460,-20
26460475567,26460475571,4,1417,1467,-20
26470953294,26470953299,5,1416,1610,-20
26471006905,26471006910,5,1449,866,-20
26476031337,26476031338,1,1314,1044,-20
26476722333,26476722338,5,1695,745,-20
26477807617,26477807622,5,1960,1349,-20
26478363166,26478363171,5,1589,1750,-20
26479177813,26479177815,2,1529,1256,-20
26480305375,26480305373,-2,2461,3801,-20
26481032214,26481032217,3,1616,1102,-20
26483246231,26483246234,3,1541,1643,-20
26487986045,26487986050,5,2015,1237,-20
26489916102,26489916107,5,1469,1405,-20
26490679959,26490679974,15,15003,37445,-20
26492962935,26492962935,0,1642,1661,-20
26498105654,26498105657,3,2361,1758,-20
26499208489,26499208490,1,1795,1740,-20
26502793343,26502793347,4,1187,875,-20
26503216521,26503216523,2,2515,3185,-20
26503792102,26503792106,4,1132,1294,-20
26503913824,26503913829,5,1103,819,-20
26506363693,26506363695,2,1836,1081,-20
26507768008,26507768012,4,1848,1089,-20
26508463021,26508463027,6,1688,919,-20
26510887607,26510887611,4,1357,1319,-20
26511037637,26511037642,5,1999,1409,-20
26511751990,26511752003,13,1745,1027,-20
26515369393,26515369397,4,1496,1300,-20
26517566826,26517566829,3,1729,1400,-20
26524049793,26524049797,4,2308,1578,-20
26528337488,26528337490,2,1775,1153,-20
26529149798,26529149801,3,1705,1264,-20
26529567606,26529567613,7,172,1510,-20
26533775111,26533775114,3,1663,1215,-20
26535379758,26535379763,5,3313,1515,-20
26538757740,26538757742,2,3304,1700,-20
26539023266,26539023270,4,2007,1327,-20
26540212447,26540212451,4,1777,1395,-20
26542288862,26542288865,3,1487,1362,-20
26542664910,26542664913,3,1430,1479,-20
26542989466,26542989470,4,1770,1578,-20
26547808307,26547808311,4,1014,927,-20
26552540910,26552540915,5,1446,1435,-20
26552590386,26552590390,4,1715,1506,-20
26553246731,26553246736,5,1443,1144,-20
26555295946,26555295932,-14,747,593,-20
26558563620,26558563622,2,1589,975,-20
26565418065,26565418068,3,1824,1427,-20
26570380734,26570380737,3,696,934,-20
26575029399,26575029402,3,2843,1474,-20
26575132680,26575132683,3,1977,1092,-20
26575365343,26575365345,2,1902,1922,-20
26576284302,26576284297,-5,2375,7210,-20
26580114670,26580114675,5,2343,1387,-20
26583727340,26583727344,4,1411,1157,-20
26586770274,26586770276,2,2033,1785,-20
26587125314,26587125318,4,2245,1377,-20
26589852447,26589852450,3,2058,1357,-20
26595649919,26595649921,2,2968,2429,-20
26597845006,26597845006,0,1100,1412,-20
26598933973,26598933977,4,2710,1242,-20
26601413821,26601413827,6,1409,1229,-20
26604250518,26604250522,4,3026,2030,-20
26605668934,26605668938,4,1632,1360,-20
26607416981,26607416990,9,4987,1253,-20
26607804343,26607804322,-21,1127,472,-20
26609316106,26609316110,4,2714,1980,-20
26610037360,26610037364,4,2318,1694,-20
26610113190,26610113194,4,2042,1481,-20
26612150114,26612150117,3,1503,1419,-20
26614039643,26614039650,7,1890,1835,-20
26618566560,26618566562,2,2107,1633,-20
26619482348,26619482353,5,2531,1429,-20
26622059598,26622059601,3,1068,1475,-20
26622816948,26622816951,3,1370,1576,-20
26624699410,26624699414,4,1627,1364,-20
26626451575,26626451579,4,1952,1418,-20
26627512387,26627512391,4,2103,1495,-20
26629454875,26629454878,3,1634,1578,-20
26629800772,26629800787,15,1834,1383,-20
26631532767,26631532771,4,2061,1749,-20
26632141532,26632141533,1,1692,1185,-20
26632405717,26632405721,4,1463,1321,-20
26632453152,26632453170,18,1275,1314,-20
26633110362,26633110366,4,1636,1502,-20
26637299241,26637299242,1,1492,1691,-20
26638597563,26638597567,4,2132,1695,-20
26639059195,26639059197,2,1720,1386,-20
26641260827,26641260829,2,1704,1476,-20
26645333638,26645333642,4,1753,1068,-20
26645745326,26645745331,5,2697,1935,-20
26646663922,26646663926,4,2183,1218,-20
26650455525,26650455526,1,1628,1115,-20
26650731847,26650731850,3,1430,1377,-20
26651042307,26651042309,2,2014,1421,-20
26652644756,26652644761,5,2317,1788,-20
26654049688,26654049668,-20,2076,1064,-20
26654110738,26654110720,-18,7376,2587,-20
26657611422,26657611423,1,1553,1135,-20
26657989053,26657989060,7,2424,2056,-20
26658661434,26658661439,5,2142,1733,-20
26666656719,26666656722,3,1315,1507,-20
26666755729,26666755733,4,2168,1844,-20
26667596245,26667596246,1,2077,2198,-20
26667693325,26667693327,2,1735,1585,-20
26675551097,26675551103,6,1081,990,-20
26677737046,26677737052,6,1046,1371,-20
26678613386,26678613390,4,2144,1591,-20
26679158389,26679158394,5,2057,1314,-20
26682116426,26682116430,4,1716,1743,-20
26684345353,26684345357,4,1772,1178,-20
26685207454,26685207457,3,1306,1756,-20
26685985674,26685985676,2,1673,1756,-20
26686108174,26686108176,2,1716,949,-20
26688845127,26688845130,3,1594,1230,-20
26696342774,26696342776,2,2205,1896,-20
26697005215,26697005218,3,1588,1630,-20
26697600812,26697600814,2,1397,997,-20
26700892844,26700892849,5,2490,1706,-20
26702702612,26702702615,3,2248,1405,-20
26707074962,26707074964,2,2185,1868,-20
26708023726,26708023718,-8,1313,6402,-20
26708319651,26708319655,4,1549,1302,-20
26709391562,26709391566,4,1963,982,-20
26710183158,26710183161,3,1274,1457,-20
26710405274,26710405283,9,2495,1292,-20
26710677505,26710677506,1,1414,1252,-20
26710831714,26710831710,-4,1510,4606,-20
26713232126,26713232130,4,1528,1381,-20
26714564029,26714564032,3,1911,1433,-20
26715994707,26715994711,4,1720,1149,-20
26716228006,26716228009,3,1220,1479,-20
26717270489,26717270490,1,1823,1133,-20
26719148925,26719148926,1,1809,1934,-20
26729999819,26729999824,5,1725,1606,-20
26733906934,26733906938,4,1335,860,-20
26734464433,26734464434,1,1972,1320,-20
26737383557,26737383560,3,1363,1530,-20
26739376374,26739376377,3,1827,1315,-20
26739472624,26739472626,2,2355,1282,-20
26740489702,26740489705,3,2603,3675,-20
26743337926,26743337931,5,1319,1284,-20
26743623344,26743623349,5,1982,1289,-20
26751279551,26751279557,6,1598,995,-20
26752266004,26752266008,4,1854,1092,-20
26755644125,26755644129,4,2303,1586,-20
26758134789,26758134793,4,1907,1264,-20
26759267274,26759267277,3,1310,1171,-20
26759523198,26759523202,4,1813,1484,-20
26761137516,26761137515,-1,17648,11641,-20
26761824099,26761824103,4,1771,1443,-20
26775265872,26775265876,4,1692,1450,-20
26777319150,26777319154,4,1164,1107,-20
26779799913,26779799917,4,1641,1519,-20
26780483167,26780483171,4,2382,1801,-20
26786739534,26786739535,1,1920,1118,-20
26787153595,26787153599,4,2097,1086,-20
26788252781,26788252787,6,1325,1059,-20
26793068682,26793068687,5,1673,1420,-20
26793105299,26793105281,-18,532,360,-20
26794877405,26794877406,1,1838,1559,-20
26794951074,26794951079,5,1473,1467,-20
26795606955,26795606959,4,1850,972,-20
26797044886,26797044891,5,1965,1134,-20
26797743999,26797744002,3,1656,1406,-20
26798023023,26798023017,-6,397,1602,-20
26803481137,26803481143,6,2494,1150,-20
26804771457,26804771462,5,2182,1723,-20
26805591224,26805591225,1,1443,1229,-20
26810850306,26810850310,4,1866,1175,-20
26810883267,26810883271,4,1679,1515,-20
26816022087,26816022090,3,1570,1196,-20
26817074047,26817074050,3,2410,1703,-20
26817602813,26817602813,0,1316,1250,-20
26820592054,26820592053,-1,1675,2099,-20
26823898557,26823898559,2,1813,1401,-20
26832378587,26832378590,3,1630,1409,-20
26833459797,26833459800,3,1790,1692,-20
26834665269,26834665273,4,1829,1326,-20
26835550723,26835550728,5,1884,1097,-20
26836027063,26836027058,-5,2441,5852,-20
26836423225,26836423229,4,2086,1817,-20
26838569410,26838569413,3,1602,1055,-20
26838887250,26838887254,4,2229,1193,-20
26839042185,26839042186,1,1444,1628,-20
26839607707,26839607711,4,1497,1221,-20
26841531352,26841531354,2,1477,1356,-20
26844824913,26844824915,2,1298,1112,-20
26845991764,26845991767,3,2437,1326,-20
26846287558,26846287566,8,2263,953,-20
26846773559,26846773566,7,2608,1465,-20
26852074501,26852074502,1,1664,1292,-20
26852669276,26852669278,2,1927,1764,-20
26853087046,26853087042,-4,555,253,-20
26855536994,26855536999,5,1609,1678,-20
26857890647,26857890650,3,2175,1461,-20
26858280549,26858280530,-19,1592,893,-20
26858499386,26858499401,15,1198,1149,-20
26859897023,26859897027,4,2337,1350,-20
26860111553,26860111557,4,976,831,-20
26860270253,26860270254,1,2007,1104,-20
26862700119,26862700123,4,968,1152,-20
26864254021,26864254024,3,2235,1708,-20
26868481442,26868481446,4,1965,1245,-20
26869146065,26869146067,2,1921,1747,-20
26871464857,26871464859,2,946,1260,-20
26872944993,26872944998,5,1623,1470,-20
26879866696,26879866699,3,2327,1171,-20
26882807128,26882807130,2,1631,1313,-20
26884846171,26884846176,5,3372,2157,-20
26885695786,26885695790,4,1902,1112,-20
26886914031,26886914034,3,1747,1149,-20
26887916033,26887916034,1,1474,1190,-20
26888498674,26888498683,9,2181,1361,-20
26891969755,26891969760,5,1011,1024,-20
26893595808,26893595822,14,2063,1383,-20
26897342953,26897342961,8,2297,1488,-20
26897850066,26897850069,3,2068,1886,-20
26899841806,26899841813,7,1949,1180,-20
26901784057,26901784053,-4,1822,6698,-20
26902993453,26902993457,4,1660,1566,-20
26908493790,26908493794,4,2123,1320,-20
26912380409,26912380415,6,2365,1238,-20
26922313515,26922313518,3,1996,1157,-20
26923005269,26923005271,2,1539,1148,-20
26927923105,26927923111,6,1842,1239,-20
26928602670,26928602670,0,1536,1178,-20
26935844989,26935844992,3,1573,1642,-20
26937545801,26937545802,1,1574,1408,-20
26938741857,26938741859,2,1309,1518,-20
26940559597,26940559599,2,1095,1153,-20
26945302680,26945302682,2,1507,1290,-20
26949064383,26949064388,5,2655,1860,-20
26950184793,26950184780,-13,1234,478,-20
26951956782,26951956783,1,1541,1520,-20
26955185618,26955185622,4,2358,2058,-20
26956409100,26956409105,5,1921,1621,-20
26957214741,26957214735,-6,1390,4081,-20
26957908818,26957908821,3,1405,1572,-20
26958701258,26958701260,2,1497,1408,-20
26962288533,26962288526,-7,1826,1338,-20
26964810308,26964810309,1,1405,1542,-20
26972244621,26972244623,2,2590,1707,-20
26974441010,26974441011,1,1760,1518,-20
26975107791,26975107798,7,1891,1201,-20
26975357530,26975357534,4,2600,1638,-20
26977259199,26977259205,6,1801,1069,-20
26979425634,26979425638,4,1599,1231,-20
26982120976,26982120980,4,2045,1628,-20
26982728239,26982728244,5,1729,1359,-20
26985522414,26985522419,5,1942,1045,-20
26985731303,26985731307,4,2337,1203,-20
26988898694,26988898698,4,1909,1417,-20
26989992061,26989992064,3,2167,1766,-20
26992845270,26992845266,-4,2544,5382,-20
26993090809,26993090813,4,1272,1153,-20
26998368205,26998368198,-7,267,1104,-20
27002527963,27002527968,5,2474,2246,-20
27003444871,27003444875,4,2565,1719,-20
27005663715,27005663718,3,1543,1079,-20
27010410771,27010410774,3,1540,1187,-20
27011280935,27011280939,4,930,512,-20
27012539123,27012539138,15,1837,1299,-20
27014380043,27014380047,4,1168,1065,-20
27021311900,27021311905,5,2312,1257,-20
27022814814,27022814820,6,2253,1567,-20
27023713806,27023713802,-4,1015,2026,-20
27026254318,27026254319,1,1883,1004,-20
27031011261,27031011266,5,2288,1749,-20
27034128914,27034128917,3,1631,1094,-20
27036296274,27036296279,5,2194,1497,-20
27037129392,27037129393,1,1544,926,-20
27042726833,27042726834,1,1736,1191,-20
27043204714,27043204715,1,1177,1008,-20
27054888566,27054888570,4,1592,1305,-20
27063829150,27063829151,1,1836,1321,-20
27065661243,27065661245,2,1335,1211,-20
27068984171,27068984176,5,1490,1139,-20
27070177250,27070177250,0,1810,1188,-20
27073093944,27073093949,5,1583,1617,-20
27075287807,27075287813,6,2658,1385,-20
27076247845,27076247851,6,1743,1121,-20
27076821985,27076821984,-1,2611,3218,-20
27078876334,27078876339,5,1674,1684,-20
27079660943,27079660946,3,1955,1414,-20
27082011046,27082011049,3,1709,1223,-20
27083655193,27083655189,-4,1744,3672,-20
27084144563,27084144569,6,2170,1376,-20
27086470137,27086470138,1,1611,1522,-20
27090224038,27090224040,2,1814,1273,-20
27091161270,27091161273,3,1911,891,-20
27094208376,27094208379,3,2205,1636,-20
27096077895,27096077897,2,1163,976,-20
27098057840,27098057845,5,2257,1564,-20
27098452292,27098452295,3,2123,1025,-20
27099832793,27099832795,2,1998,1496,-20
27100087018,27100087019,1,1226,1173,-20
27101211670,27101211673,3,1434,1260,-20
27104691318,27104691322,4,1879,1233,-20
27104718571,27104718574,3,1603,1214,-20
27105034689,27105034695,6,1947,1905,-20
27106711534,27106711538,4,2232,1942,-20
27108285066,27108285066,0,1044,1470,-20
27108523010,27108523012,2,2646,2534,-20
27122807266,27122807267,1,2170,1427,-20
27122895727,27122895730,3,1753,1582,-20
27124504179,27124504183,4,2186,1548,-20
27124905218,27124905215,-3,1341,834,-20
27127808522,27127808521,-1,1005,1644,-20
27129338224,27129338225,1,1792,1419,-20
27130320793,27130320795,2,1001,1144,-20
27139364467,27139364469,2,1494,793,-20
27143221498,27143221501,3,2036,1404,-20
27145548116,27145548119,3,2066,1216,-20
27146492300,27146492303,3,2044,1367,-20
27147696386,27147696391,5,2199,1679,-20
27147961402,27147961406,4,1959,1219,-20
27151339609,27151339610,1,1085,965,-20
27151603113,27151603119,6,944,593,-20
27153606722,27153606725,3,2142,1364,-20
27160233373,27160233377,4,2475,1531,-20
27161381191,27161381195,4,1503,1432,-20
27165077534,27165077537,3,1652,1507,-20
27167637358,27167637362,4,2010,1424,-20
27169853955,27169853958,3,2488,1604,-20
27176547890,27176547895,5,1950,1337,-20
27177107723,27177107719,-4,1463,3145,-20
27177219242,27177219246,4,2807,2002,-20
27180041193,27180041189,-4,1828,5629,-20
27185049112,27185049114,2,1322,1058,-20
27190585741,27190585745,4,2075,1350,-20
27190969733,27190969737,4,2154,1810,-20
27191385081,27191385082,1,1627,1435,-20
27192721723,27192721718,-5,785,3426,-20
27195952741,27195952743,2,1690,1244,-20
27195980122,27195980120,-2,8,1235,-20
27203411253,27203411255,2,1731,1390,-20
27205109262,27205109267,5,2533,1235,-20
27208204615,27208204618,3,1933,1467,-20
27212587068,27212587072,4,2153,1342,-20
27213007206,27213007209,3,2070,1566,-20
27213407321,27213407326,5,2336,1252,-20
27215861702,27215861722,20,584,42,-20
27217608594,27217608597,3,2253,1459,-20
27219509620,27219509624,4,2745,2001,-20
27220585437,27220585438,1,1399,1720,-20
27220705314,27220705318,4,1958,1200,-20
27220967765,27220967771,6,1677,1353,-20
27221243509,27221243511,2,1739,1210,-20
27222137183,27222137190,7,1602,1339,-20
27225580701,27225580705,4,1655,1503,-20
27231768800,27231768803,3,1253,1290,-20
27237375748,27237375751,3,2063,1603,-20
27239514879,27239514881,2,1333,1229,-20
27240471473,27240471466,-7,1338,10064,-20
27243941989,27243941991,2,1649,1044,-20
27244438926,27244438930,4,1924,1195,-20
27245013246,27245013226,-20,1777,1498,-20
27250080231,27250080233,2,1585,1055,-20
27250366714,27250366719,5,1501,1043,-20
27250570379,27250570377,-2,4741,13073,-20
27251910861,27251910866,5,1387,1421,-20
27253081974,27253081978,4,1843,1332,-20
27255670898,27255670903,5,1699,1342,-20
27255887653,27255887657,4,2035,1489,-20
27256003574,27256003577,3,1563,549,-20
27256298287,27256298289,2,1246,1096,-20
27258613573,27258613579,6,1991,1420,-20
27261320823,27261320803,-20,2861,1559,-20
27264657848,27264657847,-1,1511,1153,-20
27265095239,27265095226,-13,954,542,-20
27268268699,27268268703,4,2970,1672,-20
27268649166,27268649169,3,1601,1424,-20
27270129849,27270129850,1,1312,1085,-20
27270397502,27270397506,4,2259,1337,-20
27270546398,27270546379,-19,1896,1152,-20
27279290208,27279290211,3,2424,1818,-20
27280880909,27280880912,3,1717,1701,-20
27282767894,27282767889,-5,1772,3082,-20
27284174557,27284174562,5,2081,1651,-20
27287669671,27287669664,-7,955,2059,-20
27290731241,27290731242,1,916,19227,-20
27296013410,27296013413,3,2129,1454,-20
27296296507,27296296511,4,1367,1567,-20
27298983257,27298983258,1,1525,1554,-20
27300891556,27300891554,-2,1268,2924,-20
27301631230,27301631233,3,1925,1611,-20
27301911342,27301911337,-5,810,134,-20
27303378774,27303378778,4,2560,2115,-20
27303474703,27303474707,4,1716,1502,-20
27305036682,27305036686,4,2161,1431,-20
27306077485,27306077489,4,2107,1645,-20
27306191942,27306191945,3,1487,1419,-20
27306456373,27306456352,-21,2067,904,-20
27306854996,27306854998,2,1938,1573,-20
27308695940,27308695938,-2,1339,2185,-20
27309009754,27309009759,5,2353,1553,-20
27309794230,27309794234,4,2126,1622,-20
27311213252,27311213257,5,1457,863,-20
27311427233,27311427237,4,1748,1191,-20
27312866153,27312866157,4,1520,1146,-20
27314093650,27314093650,0,1609,1273,-20
27316925874,27316925877,3,1880,1524,-20
27320774254,27320774258,4,1993,1421,-20
27321314298,27321314299,1,1476,1790,-20
27322506829,27322506832,3,1519,1633,-20
27324019905,27324019909,4,1752,1437,-20
27326560889,27326560891,2,1768,971,-20
27328695268,27328695265,-3,1097,1563,-20
27329093481,27329093483,2,1092,1439,-20
27329188690,27329188694,4,1715,1156,-20
27329375046,27329375049,3,1641,1260,-20
27329981535,27329981555,20,1597,1158,-20
27330367770,27330367774,4,2258,1921,-20
27331970750,27331970755,5,2727,1857,-20
27336137525,27336137527,2,1665,1238,-20
27336694056,27336694059,3,1361,1331,-20
27336837382,27336837386,4,1466,1070,-20
27339913473,27339913475,2,1365,1181,-20
27340493158,27340493162,4,1555,1134,-20
27341424742,27341424744,2,2200,1590,-20
27341947253,27341947258,5,725,826,-20
27343698787,27343698791,4,832,825,-20
27350488846,27350488850,4,1462,1136,-20
27351333641,27351333643,2,1497,1552,-20
27352817421,27352817422,1,1590,1286,-20
27354394698,27354394702,4,2218,1475,-20
27355010301,27355010305,4,2822,1572,-20
27357318202,27357318207,5,2181,975,-20
27361363508,27361363510,2,1366,987,-20
27363272254,27363272261,7,2079,1445,-20
27364134555,27364134560,5,2263,1221,-20
27366608359,27366608362,3,1506,1801,-20
27370244798,27370244803,5,1434,818,-20
27370740138,27370740136,-2,1170,1,-20
27372717271,27372717267,-4,984,2512,-20
27374422904,27374422898,-6,1125,2587,-20
27374578134,27374578130,-4,1985,4146,-20
27376102914,27376102917,3,1831,1502,-20
27379188313,27379188315,2,2129,1110,-20
27385352274,27385352275,1,1488,1829,-20
27386018983,27386018985,2,1625,1530,-20
27387419695,27387419697,2,1079,1978,-20
27389255000,27389255003,3,1474,1422,-20
27389589145,27389589153,8,1643,1153,-20
27392767937,27392767939,2,1186,1503,-20
27393134590,27393134593,3,2136,1351,-20
27395666946,27395666949,3,1383,1542,-20
27395710005,27395710010,5,1600,936,-20
27398703277,27398703279,2,498,519,-20
27398812744,27398812760,16,1577,8597,-20
27401408705,27401408707,2,1401,1354,-20
27404016160,27404016163,3,2003,1552,-20
27407684927,27407684929,2,1669,1137,-20
27407792037,27407792043,6,1412,915,-20
27409591987,27409591991,4,1808,949,-20
27410319057,27410319062,5,3873,1132,-20
27412613589,27412613591,2,1409,1029,-20
27413212114,27413212118,4,928,1030,-20
27414737322,27414737322,0,1642,1448,-20
27416293132,27416293135,3,1780,1564,-20
27420951118,27420951122,4,1414,1416,-20
27421654754,27421654757,3,2161,1501,-20
27428242631,27428242635,4,1098,1561,-20
27429565049,27429565052,3,1688,1263,-20
27432959482,27432959486,4,1741,1473,-20
27433165411,27433165427,16,2259,1455,-20
27434117461,27434117469,8,1877,1153,-20
27434479100,27434479123,23,1128,685,-20
27435201914,27435201929,15,1971,1134,-20
27439236380,27439236379,-1,1523,1571,-20
27439350710,27439350690,-20,1568,2109,-20
27439629584,27439629590,6,2979,1033,-20
27440276502,27440276506,4,1783,1328,-20
27440919918,27440919923,5,1294,787,-20
27443572530,27443572530,0,1673,1444,-20
27448055542,27448055546,4,2243,1395,-20
27448172678,27448172682,4,1847,1108,-20
27448295548,27448295551,3,1660,1282,-20
27448627017,27448627019,2,2081,1018,-20
27452026941,27452026947,6,3370,1361,-20
27457787213,27457787217,4,2382,1719,-20
27463223745,27463223759,14,12803,48797,-20
27466623402,27466623398,-4,1274,2743,-20
27469027343,27469027346,3,1954,1562,-20
27469173343,27469173346,3,1993,1237,-20
27470043802,27470043805,3,1425,1190,-20
27470939539,27470939540,1,1570,1633,-20
27471669742,27471669746,4,1829,2117,-20
27473099019,27473099023,4,1870,1153,-20
27476539458,27476539461,3,2111,1851,-20
27477608876,27477608878,2,1647,1610,-20
27478805558,27478805561,3,1989,1639,-20
27481757255,27481757257,2,1046,861,-20
27488141003,27488141007,4,1257,851,-20
27488227002,27488227006,4,2665,1932,-20
27488485382,27488485386,4,2178,1676,-20
27488763445,27488763450,5,1825,1354,-20
27489115772,27489115776,4,1972,1380,-20
27489715864,27489715866,2,3211,2852,-20
27491313950,27491313953,3,1755,1284,-20
27495566509,27495566514,5,2525,1298,-20
27499144733,27499144738,5,2186,1107,-20
27500985742,27500985743,1,1442,1522,-20
27503414670,27503414673,3,1931,1277,-20
27504544406,27504544409,3,1631,1067,-20
27509661222,27509661226,4,741,1138,-20
27515366604,27515366606,2,1918,1440,-20
27520698934,27520698940,6,4268,2260,-20
27522235255,27522235261,6,2198,1562,-20
27523348510,27523348514,4,4046,3197,-20
27525265743,27525265747,4,1703,1368,-20
27532132673,27532132677,4,1735,1234,-20
27532791706,27532791690,-16,2027,1419,-20
27539271703,27539271705,2,1797,1529,-20
27539494426,27539494430,4,2253,1454,-20
27544938292,27544938295,3,1886,1519,-20
27548293855,27548293858,3,1487,1478,-20
27548488659,27548488665,6,1677,1140,-20
27549708984,27549708987,3,1494,1405,-20
27555824847,27555824826,-21,957,1585,-20
27557551422,27557551425,3,1996,1675,-20
27557932078,27557932083,5,3060,2150,-20
27558482701,27558482702,1,1512,1465,-20
27560800457,27560800462,5,1849,1357,-20
27560860211,27560860195,-16,1655,1034,-20
27561604684,27561604687,3,1908,1533,-20
27569113435,27569113441,6,2345,1268,-20
27569871301,27569871303,2,2255,1962,-20
27569930507,27569930511,4,1728,1317,-20
27572318878,27572318881,3,1748,1739,-20
27575897630,27575897633,3,2240,1481,-20
27576556894,27576556897,3,1473,1227,-20
27577063392,27577063395,3,1365,1386,-20
27582577341,27582577346,5,3997,1297,-20
27584717614,27584717619,5,2142,1311,-20
27585034810,27585034812,2,2099,1361,-20
27586446932,27586446934,2,1694,1540,-20
27589270591,27589270594,3,1144,1100,-20
27590676482,27590676486,4,1686,1306,-20
27590962509,27590962513,4,1586,1385,-20
27600459420,27600459414,-6,2651,9527,-20
27602138614,27602138616,2,1398,1697,-20
27607994354,27607994358,4,1911,1234,-20
27608281438,27608281418,-20,2179,1524,-20
27609410762,27609410767,5,1680,1590,-20
27611614200,27611614203,3,1659,1069,-20
27611829991,27611829994,3,2055,1481,-20
27612135976,27612135979,3,1396,785,-20
27614145613,27614145618,5,4759,2097,-20
27615586782,27615586784,2,1809,1758,-20
27616825472,27616825474,2,1749,1092,-20
27620982247,27620982251,4,2183,1254,-20
27623148417,27623148421,4,2193,1833,-20
27626907358,27626907361,3,1727,1658,-20
27627659438,27627659438,0,1406,1600,-20
27630079546,27630079550,4,12316,21832,-20
27632428610,27632428613,3,2167,1960,-20
27636222140,27636222143,3,1405,854,-20
27640694408,27640694411,3,1760,1665,-20
27641552767,27641552769,2,1185,1174,-20
27641836771,27641836773,2,1116,1138,-20
27643321381,27643321385,4,1383,1161,-20
27646538831,27646538838,7,1386,1530,-20
27648437871,27648437873,2,1529,1266,-20
27649014393,27649014395,2,2008,1598,-20
27657671202,27657671205,3,1484,1170,-20
27660264142,27660264146,4,2007,1384,-20
27661591435,27661591438,3,1870,1502,-20
27663578518,27663578517,-1,2646,4363,-20
27665232323,27665232329,6,1801,1469,-20
27667565723,27667565726,3,1956,1403,-20
27669222229,27669222232,3,1648,1739,-20
27669733915,27669733922,7,2599,1248,-20
27670492025,27670492031,6,4264,1603,-20
27672510979,27672510983,4,1467,1545,-20
27672714378,27672714382,4,1622,1684,-20
27673007530,27673007534,4,1807,1847,-20
27675818444,27675818448,4,1441,1006,-20
27677393267,27677393271,4,1988,1868,-20
27682895438,27682895442,4,1549,1322,-20
27687853690,27687853693,3,1649,1349,-20
27688005843,27688005847,4,1650,1945,-20
27690902302,27690902307,5,1342,1172,-20
27691238319,27691238322,3,1542,935,-20
27697486583,27697486583,0,984,1072,-20
27698098838,27698098843,5,2094,1541,-20
27699988589,27699988593,4,1235,1063,-20
27700592557,27700592559,2,2058,1105,-20
27700927610,27700927611,1,1417,1228,-20
27703602038,27703602042,4,1448,1121,-20
27703716763,27703716767,4,2801,1417,-20
27705693693,27705693695,2,1928,1197,-20
27706405198,27706405203,5,2008,1520,-20
27708356048,27708356054,6,2166,1123,-20
27708392431,27708392410,-21,1915,1766,-20
27709135845,27709135847,2,3715,3740,-20
27710527454,27710527456,2,1403,1683,-20
27710792007,27710792010,3,1440,1266,-20
27711647085,27711647088,3,1368,922,-20
27716124342,27716124348,6,1465,903,-20
27716681038,27716681038,0,1486,1749,-20
27717638920,27717638923,3,1073,942,-20
27720598566,27720598574,8,211,6069,-20
27720721721,27720721723,2,1578,1045,-20
27723448558,27723448563,5,1359,944,-20
27725729375,27725729377,2,1890,1583,-20
27728752046,27728752051,5,2251,1128,-20
27728842669,27728842650,-19,1706,787,-20
27729143247,27729143250,3,1494,1094,-20
27731930876,27731930879,3,2380,1320,-20
27733721265,27733721269,4,1989,1353,-20
27734264018,27734264025,7,1520,1419,-20
27740107038,27740107041,3,1625,1285,-20
27747231566,27747231568,2,1516,1633,-20
27747803126,27747803129,3,1420,1017,-20
27749808948,27749808950,2,1787,1083,-20
27752293606,27752293603,-3,904,2209,-20
27754314091,27754314095,4,1235,975,-20
27755926075,27755926079,4,1711,1270,-20
27756513086,27756513091,5,990,978,-20
27760954975,27760954978,3,1641,1888,-20
27761478797,27761478801,4,2711,1586,-20
27767498471,27767498479,8,1333,1019,-20
27769116921,27769116925,4,2400,1752,-20
27772724736,27772724739,3,887,1071,-20
27774514751,27774514749,-2,1160,1474,-20
27776939709,27776939710,1,1243,1356,-20
27777311942,27777311923,-19,1785,1510,-20
27779774554,27779774561,7,3436,1704,-20
27781063702,27781063705,3,2580,1960,-20
27782033903,27782033906,3,2086,1763,-20
27783037714,27783037719,5,2588,1495,-20
27784906473,27784906478,5,2020,1644,-20
27788241788,27788241790,2,1452,1473,-20
27788273442,27788273446,4,1661,1253,-20
27790232822,27790232826,4,1579,1719,-20
27796254063,27796254065,2,2235,2780,-20
27796343436,27796343439,3,1680,1281,-20
27796699974,27796699954,-20,1194,758,-20
27797487451,27797487454,3,1838,1636,-20
27799356417,27799356413,-4,994,1786,-20
27800213443,27800213447,4,1881,728,-20
27801409834,27801409836,2,2162,1843,-20
27802809474,27802809477,3,2154,1429,-20
27806843189,27806843192,3,1729,1240,-20
27807763941,27807763944,3,1365,993,-20
27809181950,27809181945,-5,1161,5043,-20
27811805030,27811805034,4,1544,1093,-20
27812283886,27812283907,21,2226,1360,-20
27812871613,27812871594,-19,1372,1134,-20
27813199369,27813199375,6,4241,1594,-20
27817297505,27817297507,2,1366,953,-20
27823963679,27823963681,2,1889,1710,-20
27826307532,27826307536,4,2202,1728,-20
27830017630,27830017635,5,2116,1524,-20
27833444369,27833444373,4,1190,992,-20
27835239707,27835239710,3,1779,1405,-20
27839122576,27839122578,2,1900,1396,-20
27841444571,27841444574,3,1849,1805,-20
27844270219,27844270223,4,1717,1380,-20
27846636953,27846636953,0,1785,1530,-20
27848048959,27848048963,4,1433,726,-20
27850294497,27850294498,1,1806,1226,-20
27854779101,27854779103,2,1324,1316,-20
27857501549,27857501551,2,1631,1281,-20
27859249730,27859249732,2,1321,683,-20
27860527768,27860527775,7,1759,881,-20
27862503043,27862503045,2,1491,1571,-20
27864488326,27864488329,3,1420,1763,-20
27864823714,27864823719,5,1549,1509,-20
27865631700,27865631706,6,2358,1634,-20
27865995259,27865995262,3,1426,1307,-20
27866874630,27866874633,3,1629,1190,-20
27874897097,27874897104,7,2195,2020,-20
27878015665,27878015668,3,1113,1570,-20
27878521508,27878521510,2,1887,1691,-20
27885586519,27885586514,-5,41651,20112,-20
27885830701,27885830702,1,1238,1430,-20
27886654522,27886654523,1,1584,1207,-20
27892505032,27892505034,2,2211,1298,-20
27894086641,27894086643,2,2149,1264,-20
27897980069,27897980071,2,1572,1133,-20
27901182774,27901182776,2,1302,1102,-20
27901670227,27901670227,0,1087,1780,-20
27902059650,27902059653,3,2131,1158,-20
27903773839,27903773842,3,1526,1162,-20
27903952054,27903952058,4,1716,1050,-20
27904012228,27904012233,5,1993,1403,-20
27905492846,27905492848,2,1531,1880,-20
27906416502,27906416507,5,2874,1571,-20
27906597784,27906597787,3,2118,1646,-20
27907703264,27907703266,2,1413,835,-20
27908717396,27908717398,2,1101,1387,-20
27910344845,27910344848,3,2054,1600,-20
27910662691,27910662694,3,1680,1513,-20
27911115921,27911115925,4,1721,1440,-20
27911146836,27911146839,3,2550,1402,-20
27911489033,27911489035,2,2031,2092,-20
27911738732,27911738735,3,2232,1331,-20
27912324952,27912324956,4,1471,1161,-20
27913795051,27913795053,2,1821,1437,-20
27919448869,27919448871,2,1534,1667,-20
27922660220,27922660223,3,1799,1518,-20
27924164864,27924164868,4,1432,1869,-20
27926498169,27926498170,1,1774,1015,-20
27929304458,27929304465,7,6513,1533,-20
27930303242,27930303241,-1,568,1213,-20
27931925618,27931925622,4,1730,1611,-20
27936546331,27936546335,4,1155,1094,-20
27944876537,27944876541,4,1927,1206,-20
27946183609,27946183610,1,1754,1931,-20
27947133877,27947133879,2,1764,1324,-20
27953398596,27953398599,3,1379,1210,-20
27955056210,27955056214,4,1972,1556,-20
27956459903,27956459906,3,1849,1331,-20
27961045654,27961045658,4,2688,1533,-20
27962577966,27962577946,-20,67,496,-20
27963016689,27963016691,2,685,733,-20
27963603006,27963603012,6,1444,987,-20
27964556120,27964556122,2,1482,1381,-20
27965982702,27965982705,3,1750,1074,-20
27970009363,27970009365,2,1584,1402,-20
27970199231,27970199235,4,2001,1478,-20
27972261717,27972261721,4,1796,941,-20
27972461555,27972461569,14,1889,1167,-20
27974526485,27974526487,2,1152,786,-20
27974977574,27974977576,2,1944,2160,-20
27975192053,27975192056,3,1249,1479,-20
27977318217,27977318221,4,1569,1062,-20
27981568693,27981568698,5,2127,1186,-20
27981767636,27981767639,3,1468,1473,-20
27983395070,27983395075,5,2519,794,-20
27983603007,27983602986,-21,1161,737,-20
27984557163,27984557162,-1,1557,1675,-20
27986523250,27986523254,4,2034,1504,-20
27986620596,27986620601,5,1685,1046,-20
27988116481,27988116483,2,1245,1171,-20
27992835226,27992835230,4,2011,1297,-20
27994200834,27994200839,5,2234,1078,-20
27995058687,27995058664,-23,1205,1294,-20
27996988418,27996988421,3,2089,1568,-20
27997509723,27997509710,-13,82,1439,-20
27999070732,27999070736,4,1676,1147,-20
28003680502,28003680506,4,2157,1364,-20
28004071776,28004071781,5,1992,1092,-20
28008822695,28008822690,-5,1265,3485,-20
28009035438,28009035441,3,1275,993,-20
28010504046,28010504051,5,1548,1370,-20
28010962647,28010962650,3,1845,1547,-20
28012643378,28012643382,4,1188,1457,-20
28014783983,28014783987,4,2118,1274,-20
28015192090,28015192094,4,1745,1640,-20
28015642749,28015642752,3,1804,1132,-20
28015861497,28015861515,18,1777,1224,-20
28021654685,28021654690,5,1517,1324,-20
28027209850,28027209855,5,1889,1205,-20
28029840725,28029840718,-7,1320,8688,-20
28035106963,28035106970,7,1865,1288,-20
28039923180,28039923182,2,1475,1133,-20
28043900457,28043900460,3,2186,1457,-20
28043999998,28044000000,2,2365,1449,-20
28044789322,28044789326,4,1543,1565,-20
28046628585,28046628588,3,1604,1209,-20
28051417630,28051417637,7,3142,1944,-20
28052649359,28052649363,4,2425,1895,-20
28052841531,28052841545,14,280,2356,-20
28062520465,28062520470,5,1825,1190,-20
28063498513,28063498514,1,1598,1436,-20
28067629043,28067629043,0,3116,4175,-20
28068668401,28068668406,5,1431,1065,-20
28068765069,28068765071,2,1368,1113,-20
28069818274,28069818271,-3,1258,1856,-20
28070074062,28070074066,4,1964,1613,-20
28071351950,28071351949,-1,3836,14774,-20
28072608467,28072608469,2,2015,1347,-20
28078111019,28078111023,4,1708,1242,-20
28079513281,28079513281,0,2299,2156,-20
28087661422,28087661426,4,2156,1427,-20
28092042592,28092042594,2,1988,1675,-20
28092661341,28092661346,5,2010,900,-20
28095904505,28095904508,3,17980,13973,-20
28097199266,28097199271,5,1686,1067,-20
28101368893,28101368897,4,2087,1104,-20
28102861787,28102861791,4,2600,1499,-20
28106476533,28106476537,4,1259,478,-20
28107411945,28107411951,6,16631,54973,-20
28107691906,28107691910,4,1702,1885,-20
28109913557,28109913559,2,1634,1563,-20
28110670890,28110670893,3,15821,10904,-20
28113242551,28113242554,3,1446,1084,-20
28118919762,28118919764,2,2265,1544,-20
28119144190,28119144193,3,1736,2205,-20
28123623658,28123623659,1,34059,36289,-20
28129581468,28129581470,2,2358,1567,-20
28130697160,28130697160,0,2887,4231,-20
28134240706,28134240710,4,1810,1279,-20
28136086065,28136086069,4,1911,1202,-20
28140276689,28140276697,8,5217,1836,-20
28142350777,28142350778,1,1180,644,-20
28146085223,28146085227,4,1384,1092,-20
28146795539,28146795541,2,1359,1137,-20
28148250597,28148250601,4,1665,1338,-20
28151807429,28151807431,2,1780,1024,-20
28158479664,28158479667,3,1775,631,-20
28158740054,28158740059,5,1331,813,-20
28162346249,28162346253,4,2104,1708,-20
28164181450,28164181450,0,1751,2105,-20
28164968844,28164968847,3,1396,1360,-20
28165635013,28165635017,4,1903,1324,-20
28170405145,28170405143,-2,1431,2279,-20
28170718810,28170718813,3,2829,2018,-20
28170972367,28170972368,1,1616,1338,-20
28171226151,28171226171,20,1745,1285,-20
28174408418,28174408417,-1,1130,1797,-20
28174965874,28174965877,3,2119,1347,-20
28177861739,28177861743,4,2139,1101,-20
28180085454,28180085443,-11,1674,1085,-20
28181281892,28181281897,5,1865,1594,-20
28182854296,28182854299,3,1607,1547,-20
28183290655,28183290658,3,1628,1386,-20
28184972938,28184972942,4,2047,1143,-20
28186452822,28186452825,3,1627,983,-20
28192130935,28192130939,4,2051,1531,-20
28192970841,28192970843,2,1851,1173,-20
28194210218,28194210221,3,1503,1497,-20
28198407380,28198407383,3,1790,1701,-20
28200270274,28200270275,1,886,1498,-20
28201622209,28201622211,2,1645,1706,-20
28208932667,28208932660,-7,1362,5415,-20
28209209561,28209209564,3,1818,1132,-20
28210183806,28210183810,4,2847,1525,-20
28214806438,28214806439,1,1536,1085,-20
28219243481,28219243484,3,1266,1396,-20
28221352893,28221352895,2,2332,1754,-20
28224420369,28224420368,-1,2566,2711,-20
28227106398,28227106397,-1,870,1807,-20
28227699645,28227699649,4,1714,1229,-20
28229136557,28229136558,1,1343,1538,-20
28229225094,28229225099,5,1159,660,-20
28230601421,28230601423,2,1631,1189,-20
28232119134,28232119136,2,2551,1837,-20
28237068473,28237068477,4,1284,1183,-20
28238980214,28238980217,3,1337,1750,-20
28240624653,28240624660,7,4351,1986,-20
28245936947,28245936952,5,1550,1667,-20
28247635300,28247635301,1,2683,1364,-20
28247858070,28247858075,5,2089,1650,-20
28254158931,28254158935,4,971,1235,-20
28257007197,28257007179,-18,1392,1170,-20
28257850304,28257850306,2,1703,1506,-20
28262951270,28262951273,3,1509,1337,-20
28264848530,28264848534,4,1423,1156,-20
28272292809,28272292812,3,1367,1490,-20
28272965508,28272965515,7,4761,1005,-20
28273210148,28273210151,3,1183,1228,-20
28273592905,28273592910,5,1460,1073,-20
28273823078,28273823077,-1,1369,2198,-20
28273916322,28273916325,3,1951,1236,-20
28275374962,28275374961,-1,3004,4368,-20
28278134345,28278134350,5,1599,1129,-20
28278895163,28278895171,8,2084,1402,-20
28280351429,28280351431,2,1996,1302,-20
28281330330,28281330332,2,1286,1294,-20
28281398389,28281398368,-21,1729,1454,-20
28288444898,28288444905,7,1870,1596,-20
28290540622,28290540626,4,2375,1878,-20
28290612613,28290612615,2,2369,1785,-20
28292818645,28292818650,5,2231,1096,-20
28295008934,28295008937,3,1807,1144,-20
28296790376,28296790378,2,1360,1643,-20
28299034734,28299034738,4,2244,1435,-20
28304007832,28304007827,-5,2151,5945,-20
28309213657,28309213660,3,1991,1816,-20
28315217163,28315217167,4,1515,1255,-20
28317701077,28317701082,5,1560,1224,-20
28319462233,28319462236,3,1589,1671,-20
28319879857,28319879863,6,7356,26422,-20
28320593130,28320593131,1,1454,1124,-20
28321429741,28321429745,4,1901,1865,-20
28322549622,28322549627,5,1846,1683,-20
28322973167,28322973171,4,2277,1266,-20
28324158752,28324158754,2,1516,906,-20
28326200169,28326200170,1,1881,1532,-20
28329995395,28329995397,2,2089,1790,-20
28330993583,28330993589,6,2915,1815,-20
28331810630,28331810635,5,2246,1021,-20
28333376082,28333376084,2,1778,1380,-20
28333575377,28333575379,2,2315,1623,-20
28335219188,28335219192,4,1540,1193,-20
28337611978,28337611978,0,2181,1464,-20
28337704584,28337704585,1,20129,8239,-20
28341528429,28341528434,5,1979,1815,-20
28345338849,28345338854,5,1969,805,-20
28346228777,28346228785,8,2899,1159,-20
28346588370,28346588377,7,3589,1344,-20
28349443013,28349443016,3,1670,1605,-20
28357242722,28357242723,1,1439,1143,-20
28359744046,28359744048,2,2447,1980,-20
28364097322,28364097318,-4,738,2676,-20
28365133860,28365133865,5,2181,1079,-20
28369340334,28369340337,3,2046,1454,-20
28372096619,28372096622,3,2269,2111,-20
28372462130,28372462133,3,2175,1635,-20
28372745214,28372745210,-4,1960,4999,-20
28375451942,28375451947,5,1243,1090,-20
28376886011,28376886013,2,1213,1380,-20
28379133808,28379133811,3,1692,1554,-20
28388293190,28388293191,1,1147,1037,-20
28390175233,28390175237,4,1683,874,-20
28392823450,28392823451,1,1725,1254,-20
28392901521,28392901522,1,1670,1955,-20
28394612987,28394612989,2,1603,1421,-20
28396837234,28396837237,3,1610,1370,-20
28398835490,28398835492,2,1210,1679,-20
28402449895,28402449898,3,1401,1502,-20
28405470306,28405470301,-5,1720,4751,-20
28405536364,28405536367,3,2127,1838,-20
28407362845,28407362844,-1,1110,1467,-20
28410703702,28410703707,5,1751,1204,-20
28411103137,28411103140,3,2229,1668,-20
28411567627,28411567630,3,1914,1273,-20
28413166780,28413166791,11,14491,30398,-20
28414211280,28414211282,2,1869,1015,-20
28415008569,28415008570,1,1741,1816,-20
28420388626,28420388620,-6,3265,9924,-20
28420673982,28420673973,-9,1404,2241,-20
28422928698,28422928706,8,3840,1459,-20
28423734284,28423734287,3,1708,1054,-20
28425030221,28425030223,2,1353,1159,-20
28426061954,28426061958,4,2105,1525,-20
28428190638,28428190644,6,2921,1728,-20
28436389151,28436389152,1,2136,1518,-20
28440939307,28440939311,4,1738,1260,-20
28449735186,28449735173,-13,998,307,-20
28450284517,28450284519,2,1867,1650,-20
28451625161,28451625165,4,2277,1711,-20
28453598585,28453598588,3,1503,1065,-20
28454644959,28454644962,3,1537,1313,-20
28457450063,28457450066,3,1977,1430,-20
28464954490,28464954494,4,2165,1272,-20
28466119170,28466119171,1,1897,1919,-20
28467321465,28467321468,3,2121,1857,-20
28468562915,28468562917,2,1994,1501,-20
28468626494,28468626497,3,1580,1433,-20
28469565422,28469565426,4,2196,1182,-20
28472860607,28472860613,6,1729,1085,-20
28473195425,28473195427,2,2089,1979,-20
28480605660,28480605663,3,2197,1072,-20
28481119904,28481119908,4,1627,1160,-20
28481817789,28481817790,1,1442,1209,-20
28486601832,28486601834,2,1226,883,-20
28486834371,28486834375,4,2527,1474,-20
28487330822,28487330827,5,2181,1054,-20
28488303721,28488303725,4,3022,1781,-20
28490256745,28490256749,4,1506,1259,-20
28490932822,28490932825,3,1992,1564,-20
28491530946,28491530951,5,1343,953,-20
28491849482,28491849485,3,1916,1067,-20
28493804133,28493804138,5,2188,1649,-20
28494645454,28494645458,4,1279,761,-20
28497279759,28497279762,3,1700,1519,-20
28498797913,28498797918,5,1673,1110,-20
28511976427,28511976428,1,2876,1777,-20
28512007350,28512007353,3,1646,1685,-20
28512484786,28512484790,4,1431,1432,-20
28513262213,28513262217,4,2055,1939,-20
28513412820,28513412825,5,1363,1821,-20
28515308014,28515308017,3,1891,1627,-20
28518104379,28518104382,3,1103,1226,-20
28518824464,28518824467,3,2015,1246,-20
28519522627,28519522630,3,1608,1217,-20
28519647154,28519647154,0,1372,1666,-20
28521802266,28521802269,3,1515,1176,-20
28526851811,28526851815,4,2630,1826,-20
28527243888,28527243891,3,2350,1501,-20
28529105420,28529105423,3,1791,1630,-20
28538888233,28538888237,4,2475,1520,-20
28539910156,28539910158,2,1508,1390,-20
28540448468,28540448473,5,1032,912,-20
28544188102,28544188108,6,1665,1240,-20
28544334683,28544334687,4,1357,1796,-20
28545743021,28545743024,3,2633,1157,-20
28549244723,28549244727,4,2351,1513,-20
28552881957,28552881961,4,2381,1369,-20
28561026550,28561026553,3,1173,832,-20
28563300997,28563301002,5,4290,1616,-20
28567682140,28567682143,3,1433,1290,-20
28567877574,28567877577,3,2005,1067,-20
28572300214,28572300218,4,1513,812,-20
28574132688,28574132691,3,2055,1576,-20
28575154301,28575154303,2,2145,1671,-20
28576049772,28576049771,-1,1084,1299,-20
28576857310,28576857314,4,1233,1014,-20
28577496659,28577496662,3,2218,950,-20
28578653765,28578653763,-2,8689,15018,-20
28579514950,28579514954,4,1593,1373,-20
28582873414,28582873418,4,1158,1446,-20
28583401164,28583401167,3,1738,1171,-20
28583656471,28583656475,4,2076,1408,-20
28583822622,28583822627,5,2223,1500,-20
28591090804,28591090810,6,1639,1057,-20
28591619785,28591619790,5,1852,1384,-20
28594290242,28594290238,-4,954,2926,-20
28599537158,28599537164,6,1556,1362,-20
28600127909,28600127912,3,1662,1211,-20
28600754113,28600754116,3,1843,1358,-20
28603189971,28603189977,6,1996,1366,-20
28603394522,28603394523,1,1316,945,-20
28609588689,28609588695,6,1358,1191,-20
28611135110,28611135113,3,2666,1513,-20
28611554285,28611554288,3,1786,1641,-20
28611630750,28611630731,-19,1597,1219,-20
28612402293,28612402297,4,1782,1153,-20
28612718603,28612718606,3,1283,1187,-20
28613110211,28613110211,0,2173,2687,-20
28615951987,28615951993,6,1630,1717,-20
28618795586,28618795590,4,2350,1801,-20
28623062288,28623062293,5,1556,1562,-20
28623568543,28623568542,-1,1083,1804,-20
28624420182,28624420183,1,1216,983,-20
28626003959,28626003961,2,1352,840,-20
28629246590,28629246594,4,1404,1358,-20
28634897989,28634897992,3,2476,1454,-20
28639515424,28639515426,2,1818,1640,-20
28642785276,28642785278,2,1244,1373,-20
28653185582,28653185565,-17,1612,939,-20
28660461635,28660461638,3,2632,1232,-20
28662862643,28662862644,1,1140,1599,-20
28667150770,28667150770,0,1310,1275,-20
28668087606,28668087611,5,1167,947,-20
28668656951,28668656945,-6,1661,4936,-20
28669387781,28669387779,-2,1208,1660,-20
28673861219,28673861223,4,1615,826,-20
28675263600,28675263602,2,1401,1628,-20
28675734386,28675734390,4,2221,1606,-20
28677711184,28677711186,2,2728,1144,-20
28679440582,28679440587,5,1553,1420,-20
28679843313,28679843314,1,1792,1527,-20
28681073194,28681073197,3,2215,1874,-20
28687021366,28687021369,3,1659,1828,-20
28687229245,28687229249,4,1503,1058,-20
28689299965,28689299966,1,1742,1370,-20
28692738431,28692738434,3,1129,1599,-20
28694565369,28694565374,5,2523,1971,-20
28698724313,28698724316,3,2019,1387,-20
28700064705,28700064709,4,1786,1590,-20
28700343886,28700343889,3,1658,1539,-20
28702671758,28702671758,0,2111,1496,-20
28703932094,28703932099,5,1371,1323,-20
28704278621,28704278623,2,1075,937,-20
28706611714,28706611718,4,1746,1256,-20
28708167566,28708167571,5,1842,1115,-20
28710299517,28710299520,3,1398,1144,-20
28712743846,28712743849,3,1288,1187,-20
28713606489,28713606491,2,1848,1587,-20
28714192582,28714192587,5,2304,1233,-20
28717781493,28717781495,2,1694,1391,-20
28718055517,28718055519,2,1564,1496,-20
28721510549,28721510533,-16,1061,436,-20
28724741477,28724741481,4,1511,1669,-20
28726778150,28726778154,4,1952,1165,-20
28728448694,28728448697,3,1642,1377,-20
28730193082,28730193085,3,1777,1646,-20
28731315358,28731315362,4,1891,1315,-20
28732708430,28732708433,3,1999,1514,-20
28735012562,28735012566,4,1768,1677,-20
28735083342,28735083343,1,1451,779,-20
28737897193,28737897197,4,1051,677,-20
28743765507,28743765514,7,3669,1423,-20
28747982254,28747982248,-6,2277,7514,-20
28748652685,28748652686,1,1967,1619,-20
28749380886,28749380894,8,1434,802,-20
28750916062,28750916066,4,1502,1558,-20
28760033943,28760033947,4,1732,1385,-20
28760583102,28760583105,3,2013,2376,-20
28761225054,28761225057,3,1593,1577,-20
28761995692,28761995695,3,2059,1197,-20
28766316478,28766316482,4,1965,1753,-20
28771030202,28771030206,4,1863,1834,-20
28772223798,28772223801,3,3219,1458,-20
28780229522,28780229528,6,1682,1370,-20
28783297859,28783297863,4,1876,1919,-20
28784549154,28784549157,3,1669,1606,-20
28785889423,28785889427,4,2147,1128,-20
28787895554,28787895558,4,1256,1056,-20
28789057406,28789057407,1,1877,1435,-20
28791452765,28791452770,5,1480,1362,-20
28792251010,28792251015,5,1219,1852,-20
28801019983,28801019985,2,1124,989,-20
28802283562,28802283565,3,1601,1682,-20
28802750069,28802750051,-18,1903,1677,-20
28802971448,28802971449,1,1134,1157,-20
28804730163,28804730166,3,2024,1320,-20
28808719720,28808719724,4,2475,1669,-20
28814079803,28814079807,4,1916,1567,-20
28825902262,28825902265,3,2407,1705,-20
28826172483,28826172485,2,2465,1366,-20
28829239216,28829239219,3,1526,1342,-20
28833304122,28833304122,0,1609,1379,-20
28845971054,28845971057,3,1683,1374,-20
28846030761,28846030763,2,1660,1047,-20
28846166819,28846166802,-17,1236,1050,-20
28846804617,28846804617,0,1495,1422,-20
28848250644,28848250647,3,1502,1348,-20
28852303061,28852303056,-5,896,3661,-20
28852927509,28852927511,2,1878,1005,-20
28854116031,28854116035,4,1757,1796,-20
28856355771,28856355765,-6,1094,4982,-20
28856987174,28856987175,1,2149,1766,-20
28858325663,28858325667,4,2168,1417,-20
28858826254,28858826234,-20,746,245,-20
28859987283,28859987296,13,1991,1025,-20
28860704658,28860704663,5,2438,1553,-20
28861559690,28861559692,2,2362,1513,-20
28864327497,28864327501,4,1872,1252,-20
28864676698,28864676686,-12,152,4545,-20
28864889467,28864889470,3,2065,1616,-20
28867013765,28867013771,6,1410,1036,-20
28873307046,28873307049,3,1714,1552,-20
28873664369,28873664370,1,1548,868,-20
28874508570,28874508574,4,2744,1384,-20
28874761561,28874761568,7,1365,1068,-20
28878177639,28878177642,3,2371,1141,-20
28878225582,28878225587,5,1300,1384,-20
28879619679,28879619684,5,1892,1314,-20
28880762594,28880762597,3,1073,1331,-20
28882182634,28882182643,9,1790,1234,-20
28884460217,28884460219,2,1226,1314,-20
28885175980,28885175983,3,1336,836,-20
28887076915,28887076910,-5,1052,2337,-20
28889176868,28889176871,3,2402,1332,-20
28894586657,28894586658,1,1211,1202,-20
28897833814,28897833819,5,2270,1190,-20
28900167747,28900167749,2,1236,1484,-20
28901455664,28901455662,-2,2230,3570,-20
28903646718,28903646718,0,1662,1339,-20
28905287370,28905287371,1,2005,2388,-20
28906933986,28906933989,3,2075,1808,-20
28908245838,28908245843,5,1881,1485,-20
28910337595,28910337599,4,1442,874,-20
28913780106,28913780108,2,1374,1870,-20
28915324390,28915324386,-4,1572,2288,-20
28917140449,28917140451,2,2441,1802,-20
28918799217,28918799222,5,1333,961,-20
28919952344,28919952347,3,1381,1147,-20
28924616670,28924616673,3,1590,1400,-20
28928282076,28928282079,3,1645,1003,-20
28928376966,28928376969,3,2265,1481,-20
28931151789,28931151790,1,1517,975,-20
28933069021,28933069027,6,2225,1132,-20
28933502542,28933502546,4,1628,1321,-20
28933907742,28933907747,5,1505,1416,-20
28936259215,28936259220,5,2082,946,-20
28939218245,28939218238,-7,1299,5187,-20
28942672150,28942672155,5,2004,1396,-20
28943938503,28943938505,2,1307,1116,-20
28944519900,28944519903,3,2006,1275,-20
28945145589,28945145590,1,1842,1186,-20
28948108592,28948108599,7,2442,932,-20
28955038305,28955038307,2,2131,1163,-20
28956679318,28956679322,4,1242,1457,-20
28957209581,28957209586,5,2187,1247,-20
28959192877,28959192881,4,2088,1490,-20
28959274912,28959274916,4,1839,1939,-20
28963834725,28963834730,5,1836,1210,-20
28968029167,28968029170,3,1657,1774,-20
28968580263,28968580267,4,1647,1116,-20
28970135786,28970135793,7,2455,1811,-20
28974805564,28974805567,3,1825,1231,-20
28975880758,28975880762,4,1423,977,-20
28975957672,28975957683,11,1883,1840,-20
28981700038,28981700041,3,2006,1895,-20
28982413909,28982413910,1,1527,1163,-20
28983750445,28983750449,4,1237,1127,-20
28984663792,28984663795,3,1263,1154,-20
28990437596,28990437598,2,2266,1519,-20
28991350752,28991350755,3,1801,1117,-20
28994948852,28994948852,0,867,1709,-20
28998085539,28998085542,3,2322,2143,-20
29002642110,29002642114,4,2005,1303,-20
29002946096,29002946099,3,1118,1023,-20
29005030491,29005030494,3,2151,1671,-20
29006557823,29006557826,3,1502,906,-20
29010951073,29010951076,3,2133,1101,-20
29011241729,29011241736,7,998,226,-20
29013156038,29013156043,5,1385,1162,-20
29013237061,29013237044,-17,843,765,-20
29014117171,29014117174,3,2767,1714,-20
29014581069,29014581072,3,1371,1288,-20
29016148938,29016148942,4,1398,1427,-20
29017573148,29017573159,11,15708,9747,-20
29017761304,29017761288,-16,1284,860,-20
29017965253,29017965255,2,1418,866,-20
29018784751,29018784753,2,1791,1766,-20
29020169642,29020169646,4,2585,1681,-20
29022744449,29022744451,2,1787,1405,-20
29023192441,29023192446,5,1736,1145,-20
29025122542,29025122546,4,1468,1694,-20
29025573038,29025573042,4,2176,1302,-20
29025916112,29025916122,10,2579,1253,-20
29026311635,29026311629,-6,1426,4924,-20
29030354125,29030354129,4,1990,1575,-20
29030940142,29030940144,2,1214,1235,-20
29031515793,29031515795,2,2346,2086,-20
29031801201,29031801207,6,1132,1502,-20
29032335725,29032335730,5,1431,1361,-20
29034168469,29034168471,2,1730,1145,-20
29036334757,29036334753,-4,1447,3169,-20
29040752502,29040752503,1,1711,1557,-20
29040829450,29040829442,-8,1573,8245,-20
29047394706,29047394709,3,2255,1501,-20
29047621818,29047621817,-1,1735,1151,-20
29050399118,29050399122,4,2204,1462,-20
29052472092,29052472094,2,1104,1058,-20
29053668686,29053668690,4,2057,1772,-20
29055374834,29055374836,2,1221,1197,-20
29059273203,29059273207,4,1815,1987,-20
29063746710,29063746715,5,1803,1945,-20
29064947155,29064947159,4,2278,1493,-20
29066035854,29066035857,3,2025,1665,-20
29067314086,29067314089,3,1740,1426,-20
29070739202,29070739204,2,1250,1309,-20
29071197452,29071197455,3,1519,1378,-20
29072475182,29072475185,3,1438,1373,-20
29074983901,29074983906,5,1707,837,-20
29075397988,29075397991,3,1677,1351,-20
29076226207,29076226209,2,1329,1237,-20
29077150518,29077150525,7,2329,906,-20
29077917441,29077917445,4,2953,1968,-20
29078738005,29078738007,2,2175,1318,-20
29082990969,29082990969,0,1334,2338,-20
29083969391,29083969395,4,2577,1160,-20
29086123834,29086123836,2,1635,1395,-20
29087825918,29087825918,0,2085,1326,-20
29088383783,29088383794,11,868,1119,-20
29091140409,29091140413,4,2348,1656,-20
29094959025,29094959027,2,1843,2101,-20
29095057472,29095057477,5,2126,1238,-20
29097090171,29097090175,4,1588,986,-20
29097880023,29097880027,4,1012,638,-20
29100513440,29100513441,1,1243,1267,-20
29101467038,29101467042,4,2190,1475,-20
29102674577,29102674578,1,1569,1574,-20
29103007182,29103007185,3,2014,1374,-20
29106559562,29106559564,2,1727,879,-20
29106636597,29106636579,-18,2336,1233,-20
29108012113,29108012118,5,2185,1540,-20
29108551154,29108551157,3,1528,1471,-20
29109028062,29109028066,4,731,256,-20
29109337982,29109337987,5,1942,1376,-20
29112233291,29112233295,4,1679,1357,-20
29116022507,29116022511,4,1090,1137,-20
29119288453,29119288459,6,3116,1412,-20
29119728213,29119728218,5,1390,1126,-20
29129917601,29129917605,4,1987,1542,-20
29130505538,29130505549,11,15346,33480,-20
29135216657,29135216659,2,1853,1550,-20
29137763963,29137763967,4,1803,1301,-20
29138510887,29138510892,5,1553,1033,-20
29141552978,29141552980,2,1932,1794,-20
29143071584,29143071587,3,1675,1499,-20
29148430158,29148430160,2,2122,2007,-20
29151790714,29151790718,4,3110,1428,-20
29151831364,29151831367,3,1748,1694,-20
29152031245,29152031247,2,1391,1258,-20
29153591052,29153591055,3,1422,1550,-20
29154309936,29154309938,2,1703,1341,-20
29155089106,29155089111,5,939,568,-20
29155801385,29155801388,3,2258,1174,-20
29160011018,29160011022,4,2105,1435,-20
29166237872,29166237874,2,2463,1811,-20
29169723906,29169723907,1,1489,1337,-20
29171998349,29171998352,3,1591,1632,-20
29177329484,29177329488,4,2051,1390,-20
29178483894,29178483898,4,1759,960,-20
29182231847,29182231849,2,1664,946,-20
29188821775,29188821778,3,1149,988,-20
29196132790,29196132794,4,1856,1572,-20
29199695020,29199695022,2,1922,1405,-20
29201258778,29201258782,4,2057,1527,-20
29203325937,29203325940,3,1796,1166,-20
29205254411,29205254395,-16,1316,1011,-20
29206331813,29206331793,-20,1747,702,-20
29206821989,29206821994,5,1707,1395,-20
29213291234,29213291238,4,2474,2351,-20
29213386470,29213386471,1,991,1280,-20
29215677965,29215677962,-3,1482,1325,-20
29217261257,29217261261,4,1190,1466,-20
29217972482,29217972485,3,1993,1542,-20
29218887596,29218887600,4,1856,1765,-20
29219718809,29219718814,5,1554,1737,-20
29223636623,29223636621,-2,976,1866,-20
29225742605,29225742607,2,2046,1383,-20
29225823091,29225823093,2,1185,1384,-20
29234754165,29234754169,4,1983,1529,-20
29242180105,29242180108,3,1915,1054,-20
29242348727,29242348704,-23,405,648,-20
29245288482,29245288486,4,1733,1385,-20
29248648806,29248648809,3,1521,1382,-20
29253871068,29253871069,1,1584,1130,-20
29255071561,29255071568,7,690,399,-20
29257643018,29257643022,4,2168,1195,-20
29258591695,29258591701,6,2090,1512,-20
29261034254,29261034257,3,1698,1383,-20
29273401836,29273401833,-3,1169,2201,-20
29274975485,29274975489,4,1789,1023,-20
29275450465,29275450470,5,1529,1329,-20
29275730487,29275730490,3,4983,3248,-20
29277643685,29277643686,1,1174,2208,-20
29279037124,29279037130,6,2320,1221,-20
29279934875,29279934878,3,2090,1461,-20
29281741313,29281741314,1,2023,1559,-20
29289599602,29289599604,2,1538,1218,-20
29290890383,29290890388,5,2620,2051,-20
29292574392,29292574395,3,1846,1090,-20
29293089710,29293089713,3,2005,1340,-20
29300170929,29300170932,3,764,1489,-20
29300554270,29300554274,4,2095,1457,-20
29303352262,29303352266,4,1900,1289,-20
29303596007,29303596011,4,1842,1129,-20
29303939506,29303939502,-4,3129,9175,-20
29304219033,29304219038,5,1487,941,-20
29304738059,29304738054,-5,1385,3435,-20
29309759025,29309759028,3,2115,1642,-20
29310103327,29310103330,3,1659,1143,-20
29310151238,29310151241,3,9787,53032,-20
29312156646,29312156651,5,1240,1457,-20
29312418422,29312418428,6,10837,26968,-20
29313045087,29313045090,3,1855,1571,-20
29313751987,29313751991,4,1741,1163,-20
29319301217,29319301219,2,1485,1216,-20
29322075482,29322075479,-3,2424,3455,-20
29323157035,29323157037,2,2032,1279,-20
29324611425,29324611429,4,1601,1259,-20
29325341538,29325341542,4,1586,1367,-20
29334815958,29334815963,5,1537,1344,-20
29334915602,29334915606,4,1509,1135,-20
29337931014,29337931018,4,2087,1400,-20
29339065771,29339065756,-15,1486,1157,-20
29339652025,29339652028,3,1977,1232,-20
29340517414,29340517414,0,3307,3358,-20
29344032933,29344032937,4,2213,1430,-20
29344552011,29344552013,2,1994,1479,-20
29348388667,29348388670,3,2090,1330,-20
29354606921,29354606922,1,1439,1213,-20
29356235331,29356235334,3,1681,1308,-20
29358098931,29358098934,3,1511,1244,-20
29361485278,29361485281,3,2074,1293,-20
29362251722,29362251725,3,2633,1864,-20
29364774345,29364774349,4,2862,1606,-20
29365090686,29365090690,4,1431,1310,-20
29370024250,29370024254,4,1449,1279,-20
29370994568,29370994566,-2,1472,2033,-20
29371709406,29371709411,5,1501,1156,-20
29372029172,29372029174,2,2113,1876,-20
29375236905,29375236909,4,1442,903,-20
29375918955,29375918961,6,3397,1352,-20
29379655342,29379655346,4,1711,1585,-20
29380710618,29380710623,5,3146,1448,-20
29381685220,29381685222,2,1462,1438,-20
29385356497,29385356498,1,1936,1583,-20
29386627595,29386627600,5,1503,932,-20
29387640954,29387640957,3,2290,1763,-20
29390072566,29390072570,4,1918,1381,-20
29390524430,29390524433,3,1612,1332,-20
29393419898,29393419903,5,1847,1557,-20
29393918831,29393918835,4,1695,1356,-20
29399670261,29399670262,1,1530,1514,-20
29400339385,29400339388,3,1403,1410,-20
29400511319,29400511317,-2,1245,1239,-20
29401518299,29401518301,2,1753,1341,-20
29402683454,29402683459,5,1210,662,-20
29404285400,29404285403,3,1414,1066,-20
29404437021,29404437022,1,1083,963,-20
29407367661,29407367665,4,2249,1371,-20
29413545819,29413545821,2,1713,2300,-20
29414793814,29414793818,4,1456,769,-20
29416319126,29416319130,4,2422,1427,-20
29418565945,29418565947,2,2041,1202,-20
29421053667,29421053688,21,484,252,-20
29426813573,29426813575,2,1857,1745,-20
29447213580,29447213582,2,1837,1908,-20
29449401250,29449401255,5,2163,1275,-20
29450416765,29450416766,1,1294,1844,-20
29453706904,29453706908,4,2841,1532,-20
29454284357,29454284363,6,2879,1124,-20
29454680649,29454680647,-2,1091,1985,-20
29457979522,29457979531,9,1916,975,-20
29463641544,29463641546,2,1976,1498,-20
29464053226,29464053229,3,1727,1350,-20
29464213147,29464213154,7,2959,1366,-20
29466612015,29466612019,4,1871,992,-20
29467228046,29467228051,5,2474,1269,-20
29469538216,29469538222,6,1547,1355,-20
29471112942,29471112946,4,2171,1069,-20
29472613051,29472613054,3,2273,1576,-20
29474920770,29474920773,3,1834,1784,-20
29476292215,29476292219,4,2140,1951,-20
29479447402,29479447396,-6,1122,8152,-20
29481002884,29481002886,2,1927,1276,-20
29481217138,29481217142,4,1206,833,-20
29482794028,29482794030,2,2042,1633,-20
29482835220,29482835224,4,2369,1983,-20
29485993945,29485993949,4,1416,1006,-20
29487085921,29487085923,2,1698,1207,-20
29488270781,29488270785,4,1472,1798,-20
29488606298,29488606303,5,1984,1275,-20
29488717770,29488717773,3,1410,1444,-20
29490314921,29490314924,3,1370,1237,-20
29490717943,29490717944,1,1683,1541,-20
29490982702,29490982705,3,1884,1384,-20
29493132042,29493132046,4,1576,1303,-20
29493200398,29493200402,4,1770,1368,-20
29496279701,29496279704,3,1153,968,-20
29498978110,29498978115,5,2228,1018,-20
29499930818,29499930821,3,1970,1580,-20
29502713393,29502713395,2,1981,1537,-20
29504474729,29504474732,3,2116,1781,-20
29504534133,29504534136,3,2415,1629,-20
29507216348,29507216350,2,2626,2152,-20
29508948323,29508948326,3,2592,1645,-20
29509855058,29509855061,3,1300,1278,-20
29512659355,29512659359,4,1081,1220,-20
29518600548,29518600542,-6,1121,4322,-20
29518919014,29518919016,2,1306,1121,-20
29520343794,29520343799,5,1435,1586,-20
29521485337,29521485327,-10,45,356,-20
29523634037,29523634040,3,2112,1719,-20
29524099020,29524099011,-9,1572,1105,-20
29526309262,29526309264,2,1674,24572,-20
29527417622,29527417623,1,742,1078,-20
29529272265,29529272270,5,2507,1342,-20
29533012802,29533012805,3,1565,1243,-20
29534897246,29534897252,6,7045,34065,-20
29536387347,29536387350,3,1162,1090,-20
29536760648,29536760651,3,2345,1617,-20
29537432533,29537432536,3,1956,1454,-20
29543093363,29543093366,3,883,850,-20
29546273916,29546273918,2,1414,1457,-20
29548508749,29548508753,4,2956,1715,-20
29550880566,29550880570,4,2398,1550,-20
29551996321,29551996306,-15,2248,1137,-20
29552384049,29552384051,2,1249,1467,-20
29553246852,29553246855,3,1829,1774,-20
29553868757,29553868750,-7,2795,9749,-20
29554696710,29554696714,4,2874,1804,-20
29561145457,29561145461,4,1643,1193,-20
29561274092,29561274074,-18,1331,1267,-20
29563217879,29563217884,5,2670,1540,-20
29564346994,29564346998,4,2002,1060,-20
29568399229,29568399231,2,1718,1652,-20
29568828372,29568828368,-4,2332,6022,-20
29573881027,29573881030,3,1822,1693,-20
29575770176,29575770183,7,2244,1260,-20
29576006916,29576006919,3,1055,805,-20
29578856387,29578856391,4,2128,1423,-20
29580293472,29580293474,2,1597,1350,-20
29584095989,29584095992,3,1829,1492,-20
29587063350,29587063353,3,2004,1444,-20
29593278644,29593278647,3,1705,1434,-20
29596560382,29596560382,0,2515,2747,-20
29597383700,29597383703,3,976,1115,-20
29599386873,29599386875,2,1672,1595,-20
29600246503,29600246483,-20,1558,1457,-20
29603461215,29603461223,8,1040,1047,-20
29610130337,29610130341,4,1539,1183,-20
29610853247,29610853249,2,2174,1340,-20
29615306530,29615306535,5,1411,1253,-20
29615461502,29615461505,3,1660,1505,-20
29619447998,29619448002,4,1795,1257,-20
29623434903,29623434906,3,1809,1640,-20
29627823930,29627823932,2,2344,1241,-20
29629186585,29629186589,4,1983,2226,-20
29634604182,29634604186,4,1590,1256,-20
29636265319,29636265323,4,2315,1736,-20
29637840111,29637840116,5,1619,1085,-20
29639158634,29639158637,3,2200,2035,-20
29640446946,29640446946,0,1519,921,-20
29640930024,29640930026,2,1921,1407,-20
29642558603,29642558605,2,1924,1512,-20
29643922446,29643922450,4,2015,1229,-20
29646397482,29646397486,4,1925,1567,-20
29648370273,29648370278,5,1359,1236,-20
29649002900,29649002903,3,1860,930,-20
29650035879,29650035883,4,1805,1361,-20
29651377837,29651377838,1,1248,1215,-20
29651808090,29651808094,4,2299,1521,-20
29653658334,29653658331,-3,1482,2620,-20
29653854872,29653854875,3,1271,1229,-20
29654580534,29654580514,-20,1497,1130,-20
29656330532,29656330534,2,1949,2189,-20
29660006918,29660006924,6,1360,1046,-20
29662473582,29662473585,3,2008,1577,-20
29665034191,29665034194,3,1795,1632,-20
29668649759,29668649763,4,2198,1481,-20
29674546010,29674546014,4,1555,1451,-20
29675693402,29675693405,3,1331,1634,-20
29678153482,29678153464,-18,1495,825,-20
29679069530,29679069535,5,2091,1573,-20
29682724269,29682724270,1,1458,1011,-20
29682882595,29682882581,-14,1572,1768,-20
29684703743,29684703745,2,1918,1675,-20
29688429262,29688429264,2,1412,1453,-20
29690728441,29690728446,5,1916,1314,-20
29692947874,29692947875,1,1879,1198,-20
29693323410,29693323415,5,1577,1469,-20
29697254222,29697254225,3,1996,1683,-20
29698727678,29698727683,5,1990,1167,-20
29699685386,29699685390,4,1033,787,-20
29702891822,29702891826,4,1872,1388,-20
29706106105,29706106114,9,267,1798,-20
29708723939,29708723943,4,1646,1396,-20
29711316525,29711316529,4,1526,1083,-20
29712019054,29712019032,-22,1494,1581,-20
29712079122,29712079126,4,1488,1473,-20
29712299708,29712299710,2,1247,1156,-20
29714021171,29714021176,5,2932,2080,-20
29714203264,29714203266,2,1315,1365,-20
29714901170,29714901151,-19,758,386,-20
29717135378,29717135382,4,3320,1524,-20
29717729013,29717729018,5,1786,1129,-20
29720615461,29720615463,2,1266,1046,-20
29721916754,29721916756,2,1788,1427,-20
29723422349,29723422351,2,1885,1616,-20
29726509210,29726509214,4,1105,800,-20
29728895925,29728895930,5,1958,1103,-20
29730428214,29730428218,4,2493,1240,-20
29735904922,29735904926,4,1983,1973,-20
29736540829,29736540835,6,1935,996,-20
29737815405,29737815407,2,2070,1226,-20
29738764981,29738764986,5,2009,1245,-20
29739579621,29739579625,4,2124,1769,-20
29739883658,29739883661,3,1592,1278,-20
29741148709,29741148710,1,1473,1233,-20
29743461161,29743461165,4,1771,1245,-20
29743837365,29743837369,4,1781,1774,-20
29747204470,29747204475,5,866,755,-20
29749181374,29749181378,4,1992,1255,-20
29751151221,29751151226,5,1356,735,-20
29751778353,29751778356,3,2773,1773,-20
29752723422,29752723426,4,1944,1410,-20
29756618824,29756618805,-19,1458,820,-20
29758384045,29758384049,4,1554,1436,-20
29761737872,29761737874,2,1872,1345,-20
29763945562,29763945565,3,1987,1760,-20
29764442766,29764442768,2,1251,1064,-20
29765506701,29765506705,4,1939,1130,-20
29766856084,29766856089,5,1993,867,-20
29768417027,29768417030,3,1684,1234,-20
29769118304,29769118306,2,1479,1301,-20
29773827310,29773827314,4,2326,1526,-20
29777605433,29777605436,3,1919,1245,-20
29783751296,29783751298,2,1294,1239,-20
29790215802,29790215805,3,1127,991,-20
29790743438,29790743420,-18,817,1066,-20
29791089729,29791089730,1,1307,1460,-20
29792205140,29792205142,2,1226,979,-20
29793290517,29793290522,5,1579,1060,-20
29800014689,29800014694,5,1864,1169,-20
29800480127,29800480133,6,2912,1789,-20
29802764651,29802764656,5,1657,1599,-20
29803501085,29803501088,3,2691,1699,-20
29806408734,29806408737,3,1711,1107,-20
29809192106,29809192110,4,1472,1679,-20
29809816193,29809816198,5,1279,1244,-20
29810491816,29810491818,2,1948,1263,-20
29811176087,29811176090,3,1636,1331,-20
29813819866,29813819875,9,9180,34558,-20
29813886822,29813886825,3,1683,1416,-20
29815765145,29815765146,1,1665,1093,-20
29816573919,29816573922,3,1825,1645,-20
29816746515,29816746520,5,1971,1414,-20
29818077132,29818077137,5,2326,1583,-20
29819251898,29819251902,4,3401,1706,-20
29820292537,29820292542,5,2035,1412,-20
29821924535,29821924540,5,1374,1279,-20
29823759383,29823759385,2,1491,1601,-20
29824713425,29824713429,4,1635,1693,-20
29828853595,29828853599,4,1383,1170,-20
29830381414,29830381397,-17,1119,1100,-20
29833167452,29833167454,2,2064,1780,-20
29835319437,29835319442,5,1457,1445,-20
29835426583,29835426587,4,1815,1436,-20
29836722593,29836722599,6,3744,1951,-20
29836914571,29836914575,4,2331,1434,-20
29837657237,29837657248,11,1527,1488,-20
29845211404,29845211406,2,1802,1461,-20
29846998246,29846998249,3,1487,1423,-20
29849497526,29849497528,2,1878,1706,-20
29851990965,29851990969,4,1264,945,-20
29853386599,29853386601,2,1878,1168,-20
29858042422,29858042423,1,1275,1168,-20
29858915473,29858915479,6,2373,1299,-20
29859212738,29859212742,4,1309,1557,-20
29859373378,29859373382,4,1511,1282,-20
29860962941,29860962946,5,1300,1154,-20
29866812030,29866812033,3,1989,1571,-20
29867903491,29867903490,-1,2759,4098,-20
29868775606,29868775608,2,1764,1055,-20
29873754398,29873754402,4,2038,840,-20
29876337814,29876337817,3,1909,1728,-20
29876940011,29876940014,3,1522,1833,-20
29877261293,29877261294,1,1511,1461,-20
29881005358,29881005359,1,1813,1684,-20
29881226903,29881226907,4,1643,1153,-20
29882033835,29882033836,1,808,1186,-20
29884868966,29884868969,3,1910,1169,-20
29890468481,29890468482,1,2509,2065,-20
29896494993,29896494990,-3,790,2413,-20
29899971190,29899971195,5,1695,1623,-20
29900443034,29900443039,5,1774,1205,-20
29904112320,29904112322,2,1840,1430,-20
29912874830,29912874834,4,1639,961,-20
29913337792,29913337796,4,1630,1471,-20
29918909472,29918909476,4,1937,1727,-20
29923687525,29923687526,1,1985,1649,-20
29924090658,29924090662,4,2394,1454,-20
29925377118,29925377120,2,3550,3073,-20
29929101299,29929101296,-3,36929,21469,-20
29930172297,29930172299,2,2181,1046,-20
29930880782,29930880784,2,1982,1154,-20
29931282998,29931282999,1,1013,838,-20
29933134732,29933134733,1,1133,1379,-20
29934528121,29934528116,-5,1513,1514,-20
29935053385,29935053385,0,1695,1762,-20
29936613369,29936613374,5,1528,1125,-20
29937577171,29937577175,4,1535,1261,-20
29948840650,29948840654,4,1365,1546,-20
29949187386,29949187387,1,1612,1340,-20
29951778011,29951778014,3,2121,1124,-20
29952044422,29952044418,-4,1116,1801,-20
29954173425,29954173413,-12,1430,1323,-20
29956211113,29956211118,5,1978,1393,-20
29956782569,29956782574,5,2264,1854,-20
29961081941,29961081944,3,1828,1285,-20
29961453381,29961453394,13,18657,7630,-20
29962538619,29962538621,2,2003,1612,-20
29966275732,29966275735,3,2488,1479,-20
29968144893,29968144896,3,1424,1202,-20
29968892729,29968892714,-15,1560,944,-20
29969780290,29969780293,3,1553,1303,-20
29972212263,29972212265,2,1812,1370,-20
29976786238,29976786241,3,2018,1903,-20
29976908025,29976908027,2,1468,1295,-20
29977132209,29977132215,6,3541,1253,-20
29978133474,29978133475,1,1188,1204,-20
29981684334,29981684339,5,1667,1465,-20
29983867631,29983867635,4,1524,1313,-20
29985966118,29985966121,3,1763,1408,-20
29986027565,29986027568,3,1937,942,-20
29986437979,29986437984,5,1820,1197,-20
29986985646,29986985651,5,1599,1440,-20
29988398287,29988398290,3,1381,1186,-20
29988517886,29988517889,3,1803,1373,-20
29989022222,29989022218,-4,1599,3106,-20
29991866631,29991866638,7,2109,1275,-20
29992303542,29992303541,-1,1756,1954,-20
29993062240,29993062245,5,1430,1014,-20
29995625286,29995625289,3,2716,1122,-20
29997833506,29997833499,-7,1242,5757,-20
30000199657,30000199660,3,1345,1238,-20
30002526431,30002526435,4,1869,1044,-20
30005077403,30005077408,5,1902,1411,-20
30010208350,30010208354,4,1720,1177,-20
30011687297,30011687318,21,1631,1250,-20
30012317170,30012317172,2,1593,1672,-20
30012566294,30012566300,6,2127,1398,-20
30014112703,30014112707,4,1322,966,-20
30014443383,30014443386,3,2244,1769,-20
30017291765,30017291768,3,1984,1442,-20
30021825725,30021825715,-10,15108,27563,-20
30027946624,30027946628,4,1617,1316,-20
30028301414,30028301393,-21,1397,1400,-20
30031100148,30031100148,0,1436,1643,-20
30034276639,30034276643,4,1544,907,-20
30036181427,30036181431,4,1549,1160,-20
30037551324,30037551329,5,2549,1500,-20
30039583166,30039583171,5,1677,1387,-20
30041065028,30041065032,4,2340,971,-20
30041984127,30041984126,-1,1513,1753,-20
30042353803,30042353806,3,1700,1633,-20
30044037712,30044037715,3,2267,1634,-20
30045410319,30045410323,4,1356,1241,-20
30045666267,30045666272,5,2447,1347,-20
30046855927,30046855931,4,1381,1505,-20
30047413379,30047413386,7,1970,1158,-20
30047706042,30047706045,3,1543,1468,-20
30049828970,30049828973,3,2150,2102,-20
30050934411,30050934415,4,1250,1178,-20
30051779778,30051779783,5,1542,1358,-20
30052107790,30052107795,5,1940,1819,-20
30052763454,30052763457,3,1108,1267,-20
30054985331,30054985334,3,1860,1473,-20
30055114229,30055114231,2,1589,1226,-20
30056981414,30056981421,7,7053,2882,-20
30057256469,30057256473,4,1485,779,-20
30060385449,30060385453,4,1955,1533,-20
30063415123,30063415118,-5,1110,4271,-20
30064400100,30064400104,4,1384,1141,-20
30067281997,30067281999,2,1455,974,-20
30069178998,30069179001,3,3675,2152,-20
30069463391,30069463394,3,1924,1817,-20
30069694175,30069694178,3,1806,1380,-20
30070812274,30070812276,2,1518,1219,-20
30071774711,30071774715,4,1163,1006,-20
30072132057,30072132060,3,2413,1803,-20
30079701953,30079701958,5,1978,1353,-20
30080250124,30080250127,3,1925,1254,-20
30081512385,30081512390,5,1645,1447,-20
30082616926,30082616929,3,1833,1550,-20
30082667834,30082667836,2,1552,1558,-20
30083098376,30083098382,6,2664,1352,-20
30084383042,30084383046,4,1412,1111,-20
30085166307,30085166310,3,2220,1250,-20
30085991741,30085991741,0,1405,1259,-20
30087365727,30087365730,3,1802,1623,-20
30089167246,30089167250,4,2244,1677,-20
30096662363,30096662367,4,1549,1834,-20
30097007162,30097007163,1,2204,1442,-20
30097737458,30097737459,1,1879,1453,-20
30098639258,30098639259,1,1779,1511,-20
30099304374,30099304379,5,1072,1031,-20
30102506638,30102506642,4,959,1135,-20
30104020994,30104020998,4,1430,957,-20
30104341151,30104341132,-19,1520,892,-20
30108059024,30108059026,2,1722,1482,-20
30110439430,30110439433,3,1459,1613,-20
30120343610,30120343613,3,1312,1275,-20
30123533130,30123533134,4,1788,1392,-20
30126157113,30126157116,3,1654,1286,-20
30127234451,30127234455,4,1803,1320,-20
30135255208,30135255213,5,1591,1026,-20
30136920107,30136920109,2,2646,1980,-20
30145064503,30145064510,7,3946,1573,-20
30147716086,30147716090,4,2050,1297,-20
30148809857,30148809862,5,1494,1556,-20
30150656855,30150656858,3,1316,1848,-20
30151334944,30151334946,2,1713,968,-20
30151885912,30151885916,4,2475,1480,-20
30152671110,30152671113,3,2393,1391,-20
30154504118,30154504122,4,1599,1449,-20
30157313976,30157313979,3,2239,1422,-20
30157666711,30157666713,2,1654,1533,-20
30159560538,30159560542,4,1869,844,-20
30161465539,30161465541,2,1462,1561,-20
30162275897,30162275902,5,1246,981,-20
30162996360,30162996363,3,2396,1658,-20
30163573624,30163573604,-20,1161,1339,-20
30169329602,30169329604,2,1551,1067,-20
30171605971,30171605979,8,2605,1098,-20
30174129105,30174129109,4,2163,1429,-20
30175099656,30175099642,-14,1473,760,-20
30180477181,30180477186,5,1504,1383,-20
30181000968,30181000969,1,1428,1507,-20
30186317317,30186317321,4,1642,1644,-20
30186574618,30186574622,4,2217,1739,-20
30189705173,30189705176,3,1861,1186,-20
30196137479,30196137481,2,1699,1922,-20
30197137231,30197137234,3,2459,1724,-20
30201175758,30201175760,2,1787,1761,-20
30202888288,30202888291,3,2419,1501,-20
30204425391,30204425388,-3,1431,3180,-20
30204857932,30204857935,3,1242,1075,-20
30209444571,30209444573,2,1922,1334,-20
30211372598,30211372597,-1,1165,2038,-20
30212107373,30212107373,0,2829,3950,-20
30216260874,30216260870,-4,1833,2651,-20
30216873538,30216873541,3,1346,974,-20
30223849463,30223849466,3,1458,1058,-20
30224010002,30224010006,4,1382,1207,-20
30229023098,30229023102,4,1975,1380,-20
30229777227,30229777230,3,2073,1116,-20
30230591520,30230591523,3,2065,1619,-20
30230917170,30230917174,4,2179,1374,-20
30231297007,30231297017,10,1667,1427,-20
30233780057,30233780060,3,1522,1178,-20
30238951106,30238951107,1,1968,1674,-20
30239056414,30239056394,-20,2398,1302,-20
30242366077,30242366082,5,1585,1142,-20
30244381669,30244381673,4,1806,1836,-20
30245191754,30245191759,5,1519,1248,-20
30246461969,30246461973,4,1534,1408,-20
30249624050,30249624053,3,1367,1176,-20
30251834427,30251834430,3,1730,1544,-20
30253033113,30253033114,1,1869,1536,-20
30253698152,30253698155,3,2333,1537,-20
30253836285,30253836279,-6,30715,13122,-20
30266137508,30266137512,4,1891,1321,-20
30267950043,30267950048,5,2430,1727,-20
30270786846,30270786850,4,2072,1548,-20
30274299062,30274299066,4,1992,1575,-20
30277102994,30277102979,-15,1487,1247,-20
30279932152,30279932154,2,1703,1037,-20
30287859450,30287859447,-3,1272,1616,-20
30289685922,30289685925,3,1823,1225,-20
30290759994,30290759998,4,1836,1258,-20
30294614799,30294614802,3,1847,1191,-20
30303127131,30303127134,3,1883,1408,-20
30305349253,30305349257,4,1728,1357,-20
30307352723,30307352706,-17,4191,2611,-20
30308064966,30308064970,4,1674,1377,-20
30310898545,30310898550,5,2666,1731,-20
30311230855,30311230859,4,1240,1038,-20
30311304209,30311304214,5,2235,1464,-20
30311950076,30311950077,1,1236,1105,-20
30317115052,30317115054,2,2282,1294,-20
30317150782,30317150781,-1,1265,2294,-20
30318602345,30318602350,5,2342,1618,-20
30322864181,30322864185,4,2034,1288,-20
30327599797,30327599799,2,1513,1592,-20
30328234722,30328234726,4,1464,1371,-20
30329995605,30329995607,2,2161,1570,-20
30331064294,30331064297,3,1251,1343,-20
30336152805,30336152807,2,1889,1410,-20
30336410004,30336410007,3,1422,1155,-20
30336822613,30336822616,3,2579,1587,-20
30337477028,30337477030,2,1139,814,-20
30339123043,30339123046,3,2103,1541,-20
30342286426,30342286428,2,1492,1359,-20
30343149273,30343149277,4,1381,1208,-20
30344714725,30344714727,2,2058,1682,-20
30347430216,30347430219,3,2319,1633,-20
30351267149,30351267150,1,2514,1642,-20
30358969135,30358969129,-6,994,4309,-20
30359717999,30359717982,-17,114,1132,-20
30360849974,30360849979,5,1603,1393,-20
30362765359,30362765358,-1,1356,2468,-20
30363385466,30363385466,0,1189,1025,-20
30363569198,30363569199,1,2008,1491,-20
30364675306,30364675310,4,3542,1615,-20
30367805713,30367805718,5,3623,1418,-20
30369260033,30369260033,0,2029,2046,-20
30372274448,30372274454,6,1609,1136,-20
30374199223,30374199227,4,1114,1228,-20
30374642991,30374642993,2,1967,1409,-20
30375987703,30375987707,4,2278,1648,-20
30382060830,30382060834,4,1331,1264,-20
30384685167,30384685171,4,2315,1171,-20
30387662390,30387662395,5,954,1349,-20
30391562519,30391562523,4,1579,1297,-20
30391759087,30391759092,5,1912,1287,-20
30392049612,30392049616,4,1896,1666,-20
30392150751,30392150752,1,1192,1080,-20
30395304771,30395304768,-3,761,1302,-20
30396212907,30396212911,4,2093,2004,-20
30397706948,30397706951,3,1324,1438,-20
30398547143,30398547146,3,1813,1090,-20
30400737683,30400737686,3,1789,1300,-20
30402898984,30402898986,2,1678,1274,-20
30403294011,30403294014,3,1666,1576,-20
30406998177,30406998179,2,1885,1517,-20
30411252537,30411252540,3,1799,1795,-20
30412444010,30412444013,3,43910,31871,-20
30414935952,30414935957,5,1548,1556,-20
30415926833,30415926835,2,1493,808,-20
30416446326,30416446330,4,1436,1152,-20
30417743209,30417743211,2,1222,1348,-20
30420857851,30420857854,3,1140,1350,-20
30421832057,30421832061,4,1800,1475,-20
30422656172,30422656176,4,2394,1976,-20
30425765655,30425765659,4,2118,1157,-20
30435572586,30435572586,0,1444,1155,-20
30437025346,30437025351,5,2043,2169,-20
30439411656,30439411658,2,1370,1068,-20
30440296223,30440296225,2,2272,1212,-20
30442522578,30442522583,5,1104,1390,-20
30444196651,30444196653,2,1113,1229,-20
30444771349,30444771356,7,2261,1302,-20
30445194388,30445194391,3,1755,1163,-20
30450626649,30450626650,1,1624,1283,-20
30452825449,30452825451,2,2139,1595,-20
30454003830,30454003835,5,1479,958,-20
30456683055,30456683059,4,1798,1214,-20
30461506795,30461506799,4,1020,1067,-20
30468524310,30468524314,4,1096,1156,-20
30471329323,30471329326,3,1607,1473,-20
30471715749,30471715747,-2,1331,2151,-20
30474859232,30474859234,2,2497,2054,-20
30476290433,30476290438,5,1360,1332,-20
30477490072,30477490062,-10,1499,1464,-20
30477731950,30477731954,4,2162,1351,-20
30478256753,30478256755,2,1728,787,-20
30479502190,30479502194,4,1863,1242,-20
30479886459,30479886461,2,2327,2191,-20
30480255356,30480255360,4,1884,1661,-20
30483825025,30483825030,5,2204,1317,-20
30489567488,30489567493,5,1890,1412,-20
30497940770,30497940772,2,2825,1421,-20
30499017523,30499017523,0,888,791,-20
30502804054,30502804058,4,2781,2110,-20
30503643657,30503643659,2,1594,1216,-20
30505199543,30505199548,5,1607,1186,-20
30509251605,30509251607,2,1998,1068,-20
30516559451,30516559455,4,1626,1489,-20
30519532259,30519532263,4,1751,1399,-20
30520259160,30520259162,2,1805,1596,-20
30525536735,30525536738,3,1606,1659,-20
30527430937,30527430940,3,1819,1509,-20
30528031542,30528031551,9,7880,28666,-20
30528512809,30528512813,4,2048,1226,-20
30530456081,30530456085,4,2625,1576,-20
30535506854,30535506858,4,2054,1118,-20
30537111867,30537111871,4,1587,1913,-20
30538694489,30538694490,1,1578,1549,-20
30544574265,30544574267,2,1944,1170,-20
30545395095,30545395099,4,2363,1425,-20
30545859722,30545859726,4,1753,1397,-20
30548931274,30548931279,5,2304,1162,-20
30550124339,30550124343,4,2697,1437,-20
30551053836,30551053839,3,1512,1417,-20
30552533529,30552533531,2,2016,1337,-20
30556341801,30556341803,2,2503,1305,-20
30557248707,30557248709,2,1579,1586,-20
30557711180,30557711182,2,1714,1285,-20
30558382855,30558382866,11,1923,1024,-20
30558939981,30558939985,4,2259,1253,-20
30560102327,30560102331,4,1503,1336,-20
30560260111,30560260113,2,2091,2023,-20
30563252177,30563252179,2,1383,1720,-20
30563859642,30563859643,1,1,1434,-20
30566645290,30566645291,1,1279,1069,-20
30567784438,30567784441,3,1643,1488,-20
30568022830,30568022828,-2,1645,2098,-20
30569838143,30569838144,1,1341,1647,-20
30571487607,30571487610,3,1342,1898,-20
30571612589,30571612593,4,2178,1518,-20
30571976952,30571976954,2,1468,1204,-20
30573656383,30573656378,-5,1089,4653,-20
30575733082,30575733087,5,1238,1554,-20
30576237905,30576237910,5,2358,1131,-20
30581477268,30581477271,3,2542,1245,-20
30582657272,30582657274,2,2499,1547,-20
30585296381,30585296389,8,3679,1327,-20
30587370028,30587370031,3,1592,1565,-20
30589496258,30589496260,2,1231,1162,-20
30590835398,30590835402,4,2232,1379,-20
30592292147,30592292152,5,2159,1625,-20
30594977350,30594977350,0,1467,1715,-20
30595809581,30595809585,4,2203,1588,-20
30597974509,30597974512,3,2597,1416,-20
30598305965,30598305967,2,2521,1653,-20
30598811095,30598811099,4,2163,1127,-20
30600699951,30600699954,3,2084,1714,-20
30605558423,30605558426,3,1694,1324,-20
30606001521,30606001526,5,1620,1048,-20
30607616846,30607616848,2,1930,1518,-20
30608295949,30608295953,4,1951,1528,-20
30608869169,30608869170,1,1291,1119,-20
30610642465,30610642467,2,1666,1034,-20
30611677661,30611677667,6,2717,1604,-20
30612313127,30612313130,3,2071,1635,-20
30613712522,30613712526,4,2736,1586,-20
30615820295,30615820299,4,1642,1310,-20
30621213513,30621213514,1,1320,878,-20
30623033818,30623033817,-1,1719,3999,-20
30624157510,30624157515,5,2280,1422,-20
30631194803,30631194806,3,1491,1953,-20
30638513141,30638513145,4,2337,1624,-20
30639294502,30639294514,12,1962,1268,-20
30639738047,30639738050,3,1740,1324,-20
30641371387,30641371391,4,1701,1200,-20
30647167289,30647167306,17,2425,1516,-20
30661399746,30661399749,3,1731,1552,-20
30663100914,30663100919,5,1750,1304,-20
30663704093,30663704104,11,1268,1075,-20
30668506390,30668506395,5,2099,1400,-20
30688775984,30688775988,4,44161,13028,-20
30689835761,30689835766,5,4622,1967,-20
30690588191,30690588194,3,1318,1209,-20
30690817339,30690817341,2,1384,1214,-20
30691522806,30691522810,4,2309,1478,-20
30691848009,30691848014,5,2097,1384,-20
30694688021,30694688022,1,1196,1013,-20
30695346926,30695346930,4,2004,1214,-20
30702436938,30702436942,4,1497,1192,-20
30704396470,30704396471,1,1684,1068,-20
30708455578,30708455581,3,1257,748,-20
30709641282,30709641286,4,1950,1168,-20
30713519900,30713519902,2,2029,1490,-20
30716657442,30716657434,-8,2599,7717,-20
30718659393,30718659397,4,1702,990,-20
30720981692,30720981694,2,1673,1316,-20
30722302242,30722302246,4,1991,1629,-20
30725064708,30725064710,2,2233,1570,-20
30727242526,30727242530,4,2118,1885,-20
30733885755,30733885757,2,1876,1469,-20
30737101838,30737101839,1,1780,1401,-20
30740170922,30740170923,1,1610,817,-20
30741490438,30741490442,4,1892,1637,-20
30741532312,30741532316,4,1820,1308,-20
30743917636,30743917639,3,2228,1659,-20
30745926732,30745926735,3,1791,1330,-20
30749475941,30749475942,1,1489,1553,-20
30750852103,30750852100,-3,850,992,-20
30751930170,30751930174,4,1897,1108,-20
30752923951,30752923955,4,1138,1167,-20
30753470979,30753470986,7,2156,1161,-20
30754194982,30754194988,6,1891,1287,-20
30759369519,30759369521,2,1839,1312,-20
30759623634,30759623637,3,1634,1615,-20
30760718190,30760718192,2,1578,1413,-20
30761293228,30761293230,2,1982,801,-20
30762992738,30762992742,4,1827,1383,-20
30766911149,30766911150,1,1651,930,-20
30767152587,30767152591,4,1672,1366,-20
30768358318,30768358319,1,1785,1234,-20
30771619529,30771619529,0,1905,2272,-20
30774760878,30774760879,1,1836,2606,-20
30777794565,30777794569,4,2235,1765,-20
30780420874,30780420882,8,2364,965,-20
30782407950,30782407955,5,1567,758,-20
30783028106,30783028126,20,1244,4067,-20
30783719090,30783719093,3,2084,1625,-20
30787154858,30787154862,4,1481,1145,-20
30787677724,30787677726,2,1632,1308,-20
30790235674,30790235677,3,1825,1376,-20
30796333790,30796333795,5,2430,1256,-20
30797515725,30797515731,6,3803,763,-20
30798328495,30798328502,7,2073,1419,-20
30799526442,30799526447,5,2383,1734,-20
30806040378,30806040382,4,1326,936,-20
30810180117,30810180122,5,1573,763,-20
30811084169,30811084173,4,1961,1184,-20
30813376477,30813376481,4,1856,1198,-20
30817494111,30817494115,4,2528,1620,-20
30818388786,30818388790,4,1009,1291,-20
30820856778,30820856773,-5,1198,2348,-20
30821268646,30821268654,8,1398,874,-20
30826584662,30826584666,4,1617,1093,-20
30830924600,30830924598,-2,1204,2052,-20
30832520418,30832520424,6,2311,1311,-20
30835261867,30835261864,-3,1255,2698,-20
30835657804,30835657806,2,1927,1556,-20
30837083470,30837083472,2,1692,1177,-20
30837341518,30837341522,4,1843,1192,-20
30837741438,30837741442,4,1492,1445,-20
30847461163,30847461166,3,2539,1890,-20
30848602722,30848602725,3,1581,1291,-20
30849978430,30849978433,3,1780,1466,-20
30850143186,30850143194,8,1261,1475,-20
30851143834,30851143837,3,1492,2135,-20
30854273934,30854273937,3,2061,1414,-20
30855325763,30855325761,-2,1731,3229,-20
30856095190,30856095192,2,1553,1541,-20
30856673594,30856673598,4,1851,1158,-20
30860340695,30860340699,4,1596,1315,-20
30860994022,30860994019,-3,1150,2081,-20
30861019366,30861019369,3,1784,1190,-20
30863202114,30863202119,5,1255,762,-20
30870978127,30870978131,4,2425,1743,-20
30874793142,30874793144,2,2264,1520,-20
30875124727,30875124707,-20,1500,1162,-20
30885000929,30885000932,3,1289,715,-20
30885072724,30885072730,6,1861,1340,-20
30889283769,30889283771,2,1891,1146,-20
30891025208,30891025211,3,2543,1161,-20
30891805364,30891805366,2,1679,1563,-20
30894157642,30894157644,2,2120,2807,-20
30896913413,30896913415,2,1692,1264,-20
30898279169,30898279166,-3,2382,4600,-20
30903630187,30903630191,4,1295,1098,-20
30905150770,30905150778,8,12882,21989,-20
30907285149,30907285153,4,1577,1526,-20
30909018337,30909018340,3,2446,1599,-20
30910401334,30910401337,3,3194,2371,-20
30912039515,30912039519,4,1631,1327,-20
30916888675,30916888678,3,2766,1715,-20
30919034055,30919034058,3,1422,1405,-20
30924471798,30924471801,3,2004,1364,-20
30926443678,30926443682,4,1035,929,-20
30929224846,30929224846,0,1107,1568,-20
30932124210,30932124214,4,1441,925,-20
30933965704,30933965702,-2,1214,2007,-20
30935160805,30935160809,4,2082,1097,-20
30941270834,30941270837,3,1231,1313,-20
30944642497,30944642502,5,2032,1691,-20
30946588581,30946588581,0,1963,1623,-20
30947731705,30947731710,5,1780,1660,-20
30949112385,30949112386,1,1744,1758,-20
30951368153,30951368156,3,1373,1774,-20
30951996830,30951996834,4,1163,1066,-20
30953267932,30953267935,3,1407,1060,-20
30953574142,30953574147,5,1797,1629,-20
30955080674,30955080679,5,1483,1009,-20
30958897606,30958897602,-4,1010,4078,-20
30960168675,30960168678,3,1582,1689,-20
30961017316,30961017319,3,1888,1318,-20
30962667897,30962667899,2,2004,1951,-20
30965007812,30965007816,4,2495,1608,-20
30966154162,30966154161,-1,1010,1538,-20
30966701929,30966701933,4,1999,1010,-20
30968577300,30968577288,-12,2677,875,-20
30968942418,30968942419,1,1464,1619,-20
30972941914,30972941915,1,1432,1555,-20
30975214533,30975214535,2,1699,1790,-20
30978192973,30978192977,4,1218,800,-20
30987222436,30987222432,-4,1714,3564,-20
30987689577,30987689580,3,2115,1815,-20
30992048815,30992048810,-5,1394,2795,-20
30993876190,30993876194,4,3551,2394,-20
30996410842,30996410846,4,2772,1707,-20
30996815569,30996815569,0,1567,1941,-20
31000022595,31000022598,3,2046,2120,-20
31000694799,31000694794,-5,38969,2385,-20
31001302095,31001302101,6,1303,1206,-20
31001563896,31001563899,3,2640,1420,-20
31002116349,31002116350,1,2164,1717,-20
31002585831,31002585835,4,1488,1329,-20
31002656174,31002656177,3,1801,1391,-20
31003030683,31003030686,3,1279,1088,-20
31006741926,31006741930,4,1755,1456,-20
31008377614,31008377615,1,1388,1239,-20
31010766578,31010766582,4,1721,1435,-20
31015736733,31015736735,2,1722,1619,-20
31018326792,31018326796,4,2145,2208,-20
31020143363,31020143367,4,1379,1529,-20
31022171374,31022171379,5,1921,2108,-20
31022940188,31022940193,5,2411,1303,-20
31023500390,31023500393,3,1329,1501,-20
31027419271,31027419274,3,1353,1087,-20
31030113917,31030113922,5,1796,1173,-20
31033413814,31033413818,4,1808,1602,-20
31033761546,31033761542,-4,566,1928,-20
31037996144,31037996147,3,1917,1689,-20
31039713114,31039713122,8,2137,1224,-20
31040297265,31040297271,6,2245,1138,-20
31042326827,31042326831,4,1807,1395,-20
31042981613,31042981617,4,1811,1371,-20
31046140498,31046140503,5,2058,1472,-20
31046833080,31046833082,2,2375,1696,-20
31047678416,31047678421,5,2601,1140,-20
31050181493,31050181497,4,1756,1147,-20
31053054741,31053054742,1,1179,1024,-20
31055801770,31055801754,-16,1208,691,-20
31057251547,31057251549,2,2249,1196,-20
31057681435,31057681438,3,2774,1727,-20
31058219603,31058219598,-5,1055,3600,-20
31063889207,31063889211,4,2058,1726,-20
31066334249,31066334254,5,2262,1214,-20
31067430385,31067430388,3,2216,1556,-20
31068500166,31068500187,21,1593,1228,-20
31068871097,31068871099,2,1659,1669,-20
31073624313,31073624317,4,2494,1760,-20
31073670214,31073670217,3,2554,1765,-20
31074356298,31074356303,5,2328,1576,-20
31078065309,31078065313,4,2632,2062,-20
31078587066,31078587070,4,1835,1169,-20
31080214106,31080214107,1,1257,921,-20
31080420763,31080420765,2,1455,1599,-20
31083918060,31083918062,2,1845,1587,-20
31086896854,31086896859,5,1741,1554,-20
31087244294,31087244296,2,1601,1310,-20
31087802005,31087801988,-17,2759,1510,-20
31088979444,31088979449,5,1337,1075,-20
31089466142,31089466142,0,1783,1742,-20
31092137874,31092137879,5,3177,1699,-20
31092515582,31092515585,3,1972,1536,-20
31093045370,31093045373,3,1916,1890,-20
31095738800,31095738809,9,15110,43451,-20
31098462513,31098462518,5,2300,1543,-20
31100595743,31100595747,4,2168,1395,-20
31101142364,31101142346,-18,674,482,-20
31106398439,31106398445,6,1078,1057,-20
31107847158,31107847162,4,2255,1785,-20
31114670878,31114670884,6,1396,1380,-20
31116577518,31116577522,4,2148,1116,-20
31122591334,31122591336,2,2391,1690,-20
31126846630,31126846638,8,7304,2796,-20
31127299066,31127299066,0,1366,925,-20
31129677451,31129677455,4,1607,880,-20
31130269380,31130269386,6,2120,1336,-20
31131013070,31131013073,3,1679,1025,-20
31135277797,31135277818,21,1458,4639,-20
31140743043,31140743046,3,1688,1937,-20
31147178990,31147178993,3,1448,1044,-20
31149790357,31149790363,6,1641,1426,-20
31157518410,31157518411,1,1390,1099,-20
31158782726,31158782726,0,2482,2054,-20
31160447098,31160447098,0,19333,35172,-20
31162428139,31162428142,3,1537,1465,-20
31164103207,31164103211,4,1985,1021,-20
31166631410,31166631412,2,2444,1687,-20
31167001163,31167001162,-1,1281,2294,-20
31169164621,31169164622,1,2173,951,-20
31170656281,31170656284,3,1989,1571,-20
31174596263,31174596269,6,1410,856,-20
31176044006,31176044010,4,2938,2052,-20
31176588750,31176588752,2,1720,1462,-20
31178561226,31178561229,3,1906,1491,-20
31179664825,31179664829,4,2192,1249,-20
31181001359,31181001336,-23,2200,1541,-20
31181442601,31181442606,5,1254,1323,-20
31186896273,31186896275,2,1872,1767,-20
31188184258,31188184262,4,1584,1337,-20
31188722369,31188722372,3,2518,1733,-20
31188957990,31188957994,4,1975,1156,-20
31190263687,31190263691,4,1396,1075,-20
31190782982,31190782986,4,1487,1425,-20
31192047961,31192047965,4,1645,1500,-20
31193652146,31193652148,2,1567,1186,-20
31195187263,31195187266,3,2289,1685,-20
31197112198,31197112202,4,2945,1663,-20
31197310386,31197310389,3,5347,5145,-20
31197669767,31197669767,0,1518,2224,-20
31202096746,31202096749,3,1675,1466,-20
31207097490,31207097493,3,1958,1534,-20
31210716514,31210716517,3,2334,1292,-20
31211869450,31211869454,4,1820,1099,-20
31213030947,31213030929,-18,1422,1208,-20
31217493815,31217493818,3,1576,1587,-20
31221080306,31221080301,-5,1061,9490,-20
31222704586,31222704564,-22,1632,1078,-20
31224238957,31224238963,6,2694,1339,-20
31227906850,31227906853,3,1675,1267,-20
31230186007,31230186011,4,1686,1083,-20
31231131906,31231131909,3,1542,1389,-20
31232139897,31232139898,1,1733,1250,-20
31233283215,31233283218,3,1444,1286,-20
31233762922,31233762925,3,1888,2016,-20
31234422553,31234422556,3,2358,1379,-20
31234908630,31234908632,2,1646,1367,-20
31236718737,31236718740,3,1162,1149,-20
31237970698,31237970702,4,1878,1506,-20
31238373162,31238373166,4,1992,1222,-20
31238497119,31238497126,7,2981,1494,-20
31238917105,31238917109,4,1863,860,-20
31240535316,31240535319,3,1451,1469,-20
31242378311,31242378314,3,1970,1498,-20
31243094088,31243094093,5,1365,993,-20
31247346897,31247346902,5,2210,987,-20
31249026762,31249026766,4,915,884,-20
31251396718,31251396724,6,1683,1309,-20
31255896458,31255896454,-4,1745,3605,-20
31260072882,31260072884,2,1684,1346,-20
31265060894,31265060892,-2,14877,36194,-20
31267758650,31267758655,5,2315,1639,-20
31269335991,31269335994,3,1833,1766,-20
31271325593,31271325595,2,1589,768,-20
31272000122,31272000125,3,1891,1361,-20
31275609010,31275609015,5,2021,1456,-20
31276846627,31276846633,6,1078,1114,-20
31279990165,31279990169,4,2289,1800,-20
31281178470,31281178474,4,1169,1070,-20
31281352808,31281352810,2,2027,1832,-20
31286114257,31286114262,5,959,962,-20
31287988282,31287988288,6,2188,1314,-20
31288318106,31288318104,-2,2751,3912,-20
31290856241,31290856245,4,2164,1202,-20
31295196187,31295196191,4,1510,1241,-20
31302584467,31302584469,2,1569,1236,-20
31302691901,31302691906,5,785,807,-20
31304320742,31304320744,2,1132,1205,-20
31304652298,31304652302,4,30313,22910,-20
31310842566,31310842569,3,1983,1111,-20
31312043685,31312043688,3,2147,2102,-20
31313948795,31313948797,2,1672,1844,-20
31320351903,31320351905,2,1832,829,-20
31323387251,31323387254,3,2304,1330,-20
31323867708,31323867711,3,2394,1753,-20
31323934019,31323934024,5,1941,1212,-20
31327758078,31327758081,3,1713,1909,-20
31329922052,31329922054,2,1887,1260,-20
31330456792,31330456794,2,1744,1167,-20
31331889355,31331889358,3,1230,1028,-20
31335003470,31335003473,3,2140,1662,-20
31335480505,31335480509,4,1541,1239,-20
31336138199,31336138200,1,1735,1768,-20
31336547674,31336547675,1,2147,1300,-20
31344650261,31344650265,4,36383,23495,-20
31344748930,31344748933,3,2172,2159,-20
31352866910,31352866912,2,1377,1338,-20
31354388151,31354388150,-1,1530,1949,-20
31357912528,31357912534,6,10102,3889,-20
31360835203,31360835206,3,2268,1798,-20
31363394110,31363394114,4,1362,1548,-20
31365251654,31365251658,4,1875,1165,-20
31366026045,31366026049,4,2202,1750,-20
31369447114,31369447117,3,1549,1243,-20
31371269724,31371269732,8,9269,1356,-20
31378296336,31378296339,3,1298,1565,-20
31380266710,31380266714,4,1691,1496,-20
31380541724,31380541726,2,2112,1213,-20
31383633985,31383633989,4,2201,1744,-20
31384023974,31384023978,4,1941,1186,-20
31384807965,31384807966,1,1679,1449,-20
31386697099,31386697103,4,2080,1109,-20
31392217630,31392217635,5,1576,905,-20
31399206845,31399206849,4,1735,1280,-20
31400311558,31400311562,4,1257,1113,-20
31404027822,31404027826,4,1697,1215,-20
31405104972,31405104974,2,2318,2010,-20
31405530292,31405530295,3,1325,1086,-20
31407581354,31407581358,4,1095,1298,-20
31407927765,31407927768,3,1882,1488,-20
31409530109,31409530113,4,1343,2082,-20
31414678231,31414678227,-4,695,1465,-20
31415982198,31415982199,1,1542,1035,-20
31418051586,31418051590,4,1370,1571,-20
31418176954,31418176939,-15,853,422,-20
31419157370,31419157375,5,1863,1531,-20
31419599577,31419599581,4,1410,869,-20
31421185013,31421185017,4,1444,1021,-20
31423940947,31423940953,6,2298,1365,-20
31425222620,31425222622,2,1803,1544,-20
31425860848,31425860850,2,2078,1772,-20
31433004477,31433004479,2,2086,1848,-20
31434604586,31434604586,0,1559,1673,-20
31437118461,31437118463,2,2149,2066,-20
31438205222,31438205228,6,2387,1653,-20
31438668718,31438668721,3,1853,1333,-20
31439135399,31439135404,5,1925,1426,-20
31440349133,31440349135,2,34200,33007,-20
31440765211,31440765214,3,1481,1212,-20
31442674129,31442674134,5,3636,1495,-20
31443164658,31443164659,1,2674,3944,-20
31444810526,31444810529,3,1612,1639,-20
31445030034,31445030034,0,1205,988,-20
31446885702,31446885697,-5,2053,7251,-20
31448611232,31448611234,2,870,901,-20
31449317556,31449317577,21,1873,1630,-20
31449579786,31449579791,5,982,1565,-20
31449668670,31449668672,2,1867,1524,-20
31454544986,31454544992,6,1804,1971,-20
31454589195,31454589201,6,1460,1187,-20
31454753110,31454753114,4,2146,1453,-20
31461673998,31461674002,4,1435,1239,-20
31462195038,31462195042,4,1996,1259,-20
31463169832,31463169848,16,1373,1170,-20
31466508249,31466508251,2,1429,1196,-20
31466790561,31466790562,1,1482,1609,-20
31468616137,31468616138,1,1732,1466,-20
31478011102,31478011105,3,2364,1432,-20
31478241091,31478241098,7,1711,1441,-20
31479763572,31479763586,14,14886,51802,-20
31480362250,31480362252,2,1491,1394,-20
31482226005,31482226008,3,2155,1860,-20
31482304762,31482304767,5,981,1070,-20
31482554330,31482554334,4,1788,1052,-20
31485407491,31485407494,3,1503,1768,-20
31489472722,31489472725,3,1007,1057,-20
31490578060,31490578062,2,2463,1322,-20
31492791954,31492791957,3,967,828,-20
31493760723,31493760726,3,1577,1186,-20
31494553503,31494553504,1,1276,1906,-20
31497196121,31497196124,3,1292,1579,-20
31497701258,31497701263,5,1409,1140,-20
31498122908,31498122910,2,1277,926,-20
31500501091,31500501094,3,1839,1460,-20
31502169290,31502169294,4,1760,931,-20
31502449937,31502449940,3,1254,1576,-20
31505361386,31505361390,4,1668,813,-20
31512301782,31512301790,8,2831,1374,-20
31513858870,31513858874,4,1994,1234,-20
31517359778,31517359782,4,1389,1116,-20
31518271610,31518271614,4,1102,801,-20
31520253394,31520253396,2,2157,1532,-20
31520580710,31520580713,3,1998,1810,-20
31521122539,31521122542,3,1640,1284,-20
31522572054,31522572057,3,1669,1927,-20
31526752295,31526752301,6,2145,1518,-20
31529165267,31529165271,4,1552,1329,-20
31533469307,31533469311,4,1853,1959,-20
31535890262,31535890267,5,1876,1622,-20
31535993405,31535993406,1,1640,1560,-20
31536418702,31536418705,3,1495,1592,-20
31538048786,31538048789,3,2146,1424,-20
31539241571,31539241575,4,2053,1255,-20
31539866511,31539866507,-4,343,69,-20
31541548695,31541548694,-1,1051,1447,-20
31541829427,31541829431,4,2127,1177,-20
31542278685,31542278690,5,2568,1468,-20
31543153278,31543153281,3,1637,1332,-20
31547093329,31547093330,1,1444,1664,-20
31551279196,31551279201,5,1935,1501,-20
31551356211,31551356217,6,1818,1444,-20
31552503471,31552503474,3,2357,1455,-20
31553557649,31553557653,4,1679,1189,-20
31554284640,31554284642,2,1803,1694,-20
31554594272,31554594275,3,1798,1871,-20
31559245884,31559245887,3,2057,1463,-20
31562174799,31562174802,3,1735,1762,-20
31563602566,31563602569,3,1337,1201,-20
31566097518,31566097519,1,1882,1045,-20
31566418767,31566418771,4,1656,1328,-20
31569420949,31569420953,4,2489,1626,-20
31574893513,31574893518,5,2035,1609,-20
31576668443,31576668444,1,1456,2952,-20
31580499457,31580499459,2,1434,1319,-20
31581044304,31581044308,4,2273,1829,-20
31581394782,31581394785,3,1296,1292,-20
31584174565,31584174569,4,1759,1501,-20
31584260901,31584260905,4,1786,911,-20
31586980787,31586980790,3,980,755,-20
31587326226,31587326227,1,1580,1031,-20
31588653015,31588653015,0,1487,1615,-20
31592043741,31592043743,2,1482,1160,-20
31592117767,31592117771,4,1040,784,-20
31595931698,31595931690,-8,2060,7101,-20
31596691362,31596691367,5,1270,875,-20
31597399251,31597399253,2,1670,1715,-20
31598659774,31598659778,4,1857,1127,-20
31600878741,31600878743,2,1616,1191,-20
31604272829,31604272833,4,1599,1584,-20
31605589487,31605589493,6,1503,1248,-20
31609172190,31609172194,4,2562,1919,-20
31609871003,31609871009,6,2368,1420,-20
31610274018,31610274021,3,1665,1842,-20
31611085857,31611085861,4,1746,1459,-20
31612961136,31612961139,3,1578,964,-20
31614571024,31614571027,3,1593,1022,-20
31615462934,31615462936,2,636,851,-20
31616998152,31616998155,3,1945,1150,-20
31617426502,31617426482,-20,985,1342,-20
31618062609,31618062613,4,2731,1984,-20
31621188538,31621188539,1,1623,1174,-20
31622347614,31622347618,4,1978,1176,-20
31624229561,31624229567,6,2983,1258,-20
31624302541,31624302542,1,1561,1473,-20
31625415243,31625415245,2,1252,1283,-20
31625837653,31625837654,1,1464,1040,-20
31627920202,31627920206,4,2573,1302,-20
31630483404,31630483407,3,1913,1464,-20
31632087958,31632087961,3,2294,2315,-20
31635796250,31635796254,4,2355,1457,-20
31636104442,31636104444,2,1483,1490,-20
31639593458,31639593461,3,2074,1235,-20
31641310314,31641310317,3,1658,1054,-20
31642423503,31642423506,3,2027,1163,-20
31643625576,31643625581,5,2428,1337,-20
31643713409,31643713411,2,1360,1480,-20
31644378769,31644378775,6,2441,1205,-20
31645095707,31645095710,3,1263,897,-20
31649499306,31649499311,5,2266,1465,-20
31651226226,31651226229,3,1918,1064,-20
31651596905,31651596908,3,1775,1340,-20
31654163241,31654163243,2,2590,2052,-20
31655652104,31655652106,2,1821,1935,-20
31665299810,31665299815,5,1732,1480,-20
31666358496,31666358499,3,2717,1459,-20
31667269673,31667269678,5,1628,1215,-20
31668609573,31668609579,6,2203,1327,-20
31668713248,31668713242,-6,24340,16973,-20
31669988823,31669988827,4,1860,1712,-20
31670832243,31670832247,4,29898,53683,-20
31672131113,31672131116,3,1464,1613,-20
31675109402,31675109405,3,1638,1801,-20
31677028608,31677028610,2,1981,1256,-20
31680125943,31680125938,-5,1564,5423,-20
31681530870,31681530872,2,1594,1169,-20
31683470638,31683470641,3,1674,1708,-20
31684089306,31684089307,1,1043,964,-20
31686627009,31686627014,5,1716,1822,-20
31689836975,31689836978,3,1738,1189,-20
31690177617,31690177621,4,2602,1514,-20
31691956309,31691956311,2,1990,1753,-20
31692280737,31692280740,3,1850,1660,-20
31692423079,31692423082,3,1232,1826,-20
31692669720,31692669724,4,1643,1310,-20
31693852354,31693852359,5,3734,1974,-20
31695634453,31695634458,5,1797,1106,-20
31695697970,31695697985,15,2180,915,-20
31695872621,31695872634,13,1254,1235,-20
31699395245,31699395246,1,1367,1653,-20
31700526512,31700526515,3,1364,1330,-20
31705963760,31705963763,3,2275,1886,-20
31706386718,31706386721,3,1686,1414,-20
31706805571,31706805559,-12,21599,16511,-20
31709639047,31709639047,0,1726,1891,-20
31711869290,31711869294,4,2281,2359,-20
31712967419,31712967419,0,35565,40108,-20
31715191518,31715191522,4,1714,1362,-20
31723184705,31723184713,8,13180,29519,-20
31728469328,31728469332,4,1364,996,-20
31728650146,31728650148,2,1594,1167,-20
31730513707,31730513713,6,2048,1222,-20
31730919222,31730919227,5,2204,1410,-20
31731451027,31731451030,3,1824,1372,-20
31733766710,31733766714,4,1654,1222,-20
31733813845,31733813826,-19,811,419,-20
31735533938,31735533942,4,1752,923,-20
31735841889,31735841892,3,1437,1625,-20
31737831308,31737831312,4,1854,1643,-20
31739352567,31739352570,3,3654,2571,-20
31739633491,31739633494,3,1764,1833,-20
31741881138,31741881142,4,2511,1726,-20
31746292878,31746292881,3,1386,1043,-20
31746753750,31746753745,-5,1474,5204,-20
31746799897,31746799899,2,1779,1388,-20
31752169100,31752169103,3,2257,1152,-20
31755503939,31755503941,2,3782,3094,-20
31756642482,31756642484,2,1737,1514,-20
31756794074,31756794079,5,2417,1813,-20
31760497479,31760497482,3,2296,1963,-20
31766112312,31766112317,5,1845,1592,-20
31767103902,31767103905,3,2049,1212,-20
31768461419,31768461423,4,2213,1787,-20
31771234730,31771234734,4,1474,780,-20
31772708230,31772708233,3,1603,1845,-20
31775308723,31775308718,-5,1754,7879,-20
31776741402,31776741403,1,1075,1191,-20
31783112620,31783112602,-18,2592,1092,-20
31788481226,31788481222,-4,1668,4661,-20
31788693857,31788693861,4,2866,2320,-20
31791216874,31791216877,3,2001,1268,-20
31792315289,31792315293,4,2046,1513,-20
31801863686,31801863702,16,683,5334,-20
31802268106,31802268105,-1,1050,1851,-20
31802851658,31802851662,4,2595,1670,-20
31803338518,31803338522,4,1587,1899,-20
31807014047,31807014050,3,2214,1703,-20
31814027613,31814027614,1,1802,1387,-20
31814385978,31814385983,5,2402,1350,-20
31817517135,31817517139,4,1663,1300,-20
31819425771,31819425765,-6,1120,4786,-20
31823284174,31823284177,3,1843,1773,-20
31823431894,31823431898,4,1870,1405,-20
31824552005,31824552010,5,2392,1749,-20
31828157274,31828157275,1,2219,1018,-20
31828310700,31828310704,4,2469,1315,-20
31831353263,31831353267,4,1935,1384,-20
31834236178,31834236181,3,1224,1199,-20
31840778183,31840778187,4,2064,1748,-20
31842622002,31842622006,4,1583,1057,-20
31842662723,31842662718,-5,1045,1676,-20
31843465275,31843465279,4,1168,1167,-20
31849158760,31849158762,2,1550,1211,-20
31852469078,31852469057,-21,1852,1411,-20
31852884913,31852884916,3,1833,1260,-20
31857771446,31857771448,2,1046,1047,-20
31860029524,31860029527,3,2018,1359,-20
31862132199,31862132197,-2,1349,2700,-20
31863658461,31863658465,4,1885,1662,-20
31864930765,31864930766,1,1542,1372,-20
31865640402,31865640406,4,2679,1603,-20
31866591856,31866591849,-7,2232,7466,-20
31868416664,31868416667,3,1622,1087,-20
31868834759,31868834769,10,1567,966,-20
31870232813,31870232816,3,1147,1221,-20
31871505054,31871505058,4,2375,1898,-20
31871602010,31871602014,4,1642,1672,-20
31871700485,31871700490,5,2387,2002,-20
31872752198,31872752201,3,1635,1226,-20
31873264249,31873264252,3,2393,1654,-20
31874099301,31874099303,2,2745,1216,-20
31875194185,31875194189,4,1726,1225,-20
31875577961,31875577964,3,1989,1299,-20
31876420685,31876420686,1,1933,1714,-20
31877814006,31877814009,3,1993,1416,-20
31879782043,31879782046,3,1432,1216,-20
31884802278,31884802283,5,1892,1210,-20
31888452978,31888452981,3,1876,2081,-20
31890980105,31890980109,4,2170,1571,-20
31896229501,31896229505,4,1722,1557,-20
31896559681,31896559686,5,1495,1236,-20
31897753647,31897753651,4,781,759,-20
31899457341,31899457344,3,1585,1429,-20
31900350442,31900350446,4,9811,6806,-20
31903022312,31903022314,2,1405,1507,-20
31904813447,31904813449,2,1588,1198,-20
31905543944,31905543960,16,2080,1385,-20
31906275119,31906275123,4,1554,956,-20
31914557701,31914557707,6,12253,4881,-20
31914602106,31914602103,-3,997,2409,-20
31915629198,31915629202,4,1819,1441,-20
31915964838,31915964838,0,1451,1442,-20
31916424818,31916424822,4,1956,1297,-20
31917900530,31917900535,5,1717,1377,-20
31921273158,31921273162,4,1585,1640,-20
31923956713,31923956718,5,2050,1716,-20
31927341337,31927341340,3,2784,1726,-20
31929149335,31929149338,3,3013,1810,-20
31929589304,31929589307,3,1728,1349,-20
31930050225,31930050229,4,2215,1303,-20
31930911382,31930911386,4,1875,915,-20
31933110719,31933110723,4,1896,1601,-20
31933668202,31933668207,5,1959,1342,-20
31937040231,31937040235,4,1639,1309,-20
31937195738,31937195739,1,4565,3060,-20
31937832292,31937832295,3,1618,1472,-20
31938662915,31938662918,3,2542,1450,-20
31940349809,31940349812,3,2459,1871,-20
31947016833,31947016837,4,1454,1702,-20
31948386105,31948386108,3,1787,1108,-20
31949309673,31949309674,1,1827,1670,-20
31950978439,31950978446,7,5504,2931,-20
31951624818,31951624820,2,1346,1103,-20
31955030472,31955030452,-20,1591,1303,-20
31961958152,31961958154,2,1296,1093,-20
31964314020,31964314022,2,1679,1517,-20
31964798493,31964798497,4,2103,1490,-20
31973949363,31973949361,-2,1346,2644,-20
31976419533,31976419516,-17,6685,1948,-20
31977758219,31977758222,3,1419,1528,-20
31978243534,31978243538,4,1842,1122,-20
31982488693,31982488695,2,1657,1325,-20
31983288166,31983288171,5,2446,1443,-20
31985047772,31985047776,4,2519,2366,-20
31985081082,31985081086,4,1558,1742,-20
31986241666,31986241671,5,1747,1208,-20
31990903572,31990903577,5,1724,842,-20
31993525315,31993525318,3,1869,1503,-20
31994595162,31994595165,3,1723,1697,-20
31995715383,31995715387,4,2466,1210,-20
31997752046,31997752049,3,2582,1998,-20
31999189309,31999189312,3,2633,1320,-20
32001981067,32001981075,8,3940,1491,-20
32003342906,32003342910,4,1905,993,-20
32003433131,32003433130,-1,3616,4260,-20
32006521510,32006521513,3,2375,2001,-20
32007313578,32007313583,5,2205,1654,-20
32012791142,32012791147,5,1549,916,-20
32014152681,32014152685,4,2242,1659,-20
32015101587,32015101590,3,2077,1543,-20
32018613398,32018613402,4,2170,2067,-20
32020119262,32020119269,7,975,1492,-20
32022050027,32022050031,4,2361,1546,-20
32024171434,32024171438,4,1631,1061,-20
32024991718,32024991722,4,2628,1530,-20
32025485682,32025485668,-14,1012,649,-20
32025865134,32025865137,3,1915,1291,-20
32027886439,32027886442,3,1247,2027,-20
32028569101,32028569103,2,2238,1419,-20
32036017043,32036017044,1,1128,1567,-20
32038851038,32038851045,7,1716,1093,-20
32039576703,32039576710,7,2075,1447,-20
32041148477,32041148480,3,1324,1053,-20
32042561876,32042561879,3,1289,1252,-20
32046206461,32046206466,5,1624,1255,-20
32046476605,32046476585,-20,1242,1660,-20
32047961379,32047961379,0,1152,1630,-20
32048429713,32048429715,2,1423,1752,-20
32049466594,32049466596,2,1051,1109,-20
32049942651,32049942654,3,1594,1393,-20
32052310865,32052310870,5,1712,1621,-20
32057235696,32057235701,5,1496,1458,-20
32057778123,32057778126,3,1412,982,-20
32062615671,32062615675,4,2246,1682,-20
32063202308,32063202312,4,1717,1596,-20
32064110286,32064110305,19,1995,1353,-20
32068482347,32068482350,3,2458,1677,-20
32069350598,32069350605,7,2704,979,-20
32070972954,32070972958,4,1453,1465,-20
32071997168,32071997171,3,1767,1519,-20
32081444381,32081444383,2,1643,1336,-20
32082787876,32082787879,3,1682,1628,-20
32087016813,32087016816,3,1642,1744,-20
32089921015,32089921014,-1,1087,2731,-20
32090536824,32090536830,6,6260,2391,-20
32094176763,32094176770,7,6022,2708,-20
32095110690,32095110693,3,1898,1344,-20
32095876253,32095876256,3,2091,1304,-20
32096064250,32096064253,3,1455,1329,-20
32101046731,32101046732,1,10947,15325,-20
32101418313,32101418316,3,1158,1698,-20
32105229658,32105229667,9,13030,35352,-20
32108027556,32108027550,-6,858,1699,-20
32108836053,32108836046,-7,1619,6953,-20
32110852314,32110852317,3,1955,1952,-20
32113310055,32113310056,1,1558,1456,-20
32114156359,32114156363,4,1871,1440,-20
32116958099,32116958102,3,1869,1184,-20
32117024841,32117024843,2,1484,1257,-20
32118094855,32118094858,3,3394,2786,-20
32118490906,32118490909,3,1293,1528,-20
32122018733,32122018741,8,1161,868,-20
32123287709,32123287711,2,1319,1126,-20
32127488664,32127488669,5,1666,1136,-20
32128124353,32128124359,6,2348,1141,-20
32128429717,32128429722,5,2302,1525,-20
32129623088,32129623090,2,1646,1345,-20
32131110157,32131110161,4,1763,1222,-20
32131894853,32131894857,4,2507,2035,-20
32135009764,32135009767,3,2359,1654,-20
32135918470,32135918474,4,2415,1380,-20
32138025470,32138025474,4,1872,1579,-20
32138457553,32138457555,2,1669,1171,-20
32138917607,32138917613,6,1951,1753,-20
32140658403,32140658405,2,1736,1622,-20
32144235723,32144235727,4,1565,1589,-20
32148802415,32148802417,2,1966,1660,-20
32151253593,32151253597,4,1788,1233,-20
32153246131,32153246136,5,2306,1623,-20
32154764951,32154764955,4,1870,1367,-20
32155253208,32155253212,4,1218,1339,-20
32158295437,32158295441,4,1685,1581,-20
32158610414,32158610416,2,1838,1972,-20
32158660541,32158660552,11,2051,1487,-20
32162805729,32162805733,4,1527,1546,-20
32165806481,32165806483,2,1907,1740,-20
32168770281,32168770283,2,1637,1339,-20
32170015566,32170015571,5,4908,23328,-20
32171603317,32171603322,5,936,958,-20
32174944026,32174944027,1,1409,1480,-20
32178208853,32178208856,3,1857,1439,-20
32182214909,32182214914,5,1733,966,-20
32183001714,32183001719,5,1986,1354,-20
32183570940,32183570941,1,1425,1386,-20
32188924224,32188924226,2,1545,1321,-20
32188997575,32188997578,3,1510,1655,-20
32193011381,32193011385,4,1978,1905,-20
32193950934,32193950937,3,1233,1200,-20
32195016009,32195016011,2,1078,1430,-20
32195197107,32195197110,3,1596,1248,-20
32195408587,32195408586,-1,1466,1547,-20
32200945057,32200945062,5,2043,1796,-20
32210695638,32210695618,-20,1859,1575,-20
32213377972,32213377975,3,1812,1368,-20
32214370609,32214370616,7,1460,1356,-20
32215656951,32215656955,4,1451,1484,-20
32221941854,32221941858,4,2804,2034,-20
32224642960,32224642959,-1,1469,2089,-20
32226417561,32226417563,2,1552,1115,-20
32229482542,32229482546,4,1779,1419,-20
32230556648,32230556651,3,1041,1455,-20
32231678998,32231679002,4,2636,1561,-20
32234511488,32234511472,-16,1799,1424,-20
32236854108,32236854105,-3,1749,3574,-20
32237068162,32237068166,4,1201,1305,-20
32238429685,32238429687,2,2155,1122,-20
32239831766,32239831770,4,1754,1358,-20
32245405434,32245405438,4,1296,905,-20
32248425007,32248425009,2,1239,850,-20
32251849556,32251849557,1,1345,1732,-20
32254142790,32254142795,5,1863,1199,-20
32256193357,32256193358,1,1505,1737,-20
32259365114,32259365117,3,1471,1079,-20
32259670774,32259670775,1,1215,1897,-20
32262357912,32262357916,4,1860,1433,-20
32263048098,32263048101,3,1190,1481,-20
32273029742,32273029745,3,1903,1890,-20
32274011208,32274011212,4,2214,1572,-20
32274245657,32274245659,2,2669,2396,-20
32275524751,32275524755,4,3177,1469,-20
32275599269,32275599272,3,2709,1653,-20
32279614474,32279614477,3,1803,1274,-20
32281822613,32281822618,5,966,640,-20
32283841381,32283841383,2,1377,1395,-20
32285023832,32285023834,2,2126,1113,-20
32285650442,32285650445,3,1742,1926,-20
32288952990,32288952989,-1,4409,8184,-20
32290211424,32290211426,2,2034,1728,-20
32291090423,32291090426,3,2502,1554,-20
32291522802,32291522805,3,1184,1113,-20
32294550373,32294550377,4,1581,1472,-20
32295080206,32295080209,3,2154,1733,-20
32298268269,32298268274,5,1148,800,-20
32299776374,32299776376,2,862,1072,-20
32300257663,32300257666,3,1509,1035,-20
32300380364,32300380376,12,1967,1912,-20
32303808417,32303808422,5,1634,1161,-20
32304156077,32304156057,-20,1929,1099,-20
32305123041,32305123044,3,2013,1268,-20
32305713193,32305713196,3,924,997,-20
32306550054,32306550058,4,1623,1289,-20
32307782744,32307782741,-3,1830,4244,-20
32310245366,32310245370,4,1613,1074,-20
32313411689,32313411691,2,1218,1156,-20
32314595488,32314595493,5,2844,1160,-20
32315887768,32315887772,4,2230,1342,-20
32319046338,32319046340,2,1995,1283,-20
32319933985,32319933988,3,1797,1559,-20
32320942943,32320942946,3,1794,1414,-20
32323497110,32323497116,6,2950,1580,-20
32327567190,32327567192,2,1357,1221,-20
32334521201,32334521203,2,2080,1452,-20
32336233054,32336233052,-2,1524,2220,-20
32337057418,32337057422,4,1897,1680,-20
32338219410,32338219414,4,1677,1250,-20
32338510743,32338510746,3,1526,1176,-20
32339348805,32339348807,2,2215,1306,-20
32343365295,32343365299,4,1994,975,-20
32345398038,32345398041,3,939,777,-20
32348460933,32348460936,3,1797,1034,-20
32348770618,32348770623,5,1223,1363,-20
32350266834,32350266839,5,3394,1586,-20
32350340270,32350340249,-21,1936,1173,-20
32350574629,32350574633,4,2249,2125,-20
32351291261,32351291263,2,1342,1481,-20
32353485878,32353485882,4,1681,1218,-20
32357583676,32357583679,3,2746,1344,-20
32359760860,32359760862,2,4202,3684,-20
32365593926,32365593931,5,1496,1256,-20
32370677346,32370677347,1,1593,1656,-20
32372789171,32372789177,6,1568,1137,-20
32374006699,32374006702,3,1887,1860,-20
32377208167,32377208170,3,1736,1855,-20
32379132867,32379132859,-8,405,2369,-20
32379906155,32379906160,5,2102,1940,-20
32380064897,32380064899,2,1812,1599,-20
32384465255,32384465252,-3,1785,5426,-20
32384734418,32384734422,4,2528,2207,-20
32390065958,32390065966,8,11521,35579,-20
32392098639,32392098642,3,1433,1254,-20
32392842701,32392842700,-1,1474,2347,-20
32395926663,32395926666,3,2422,2206,-20
32396588070,32396588073,3,1783,1336,-20
32397196336,32397196339,3,1232,1469,-20
32398752158,32398752161,3,1577,1351,-20
32399442552,32399442555,3,1273,1362,-20
32401981983,32401981986,3,1529,1591,-20
32402866706,32402866709,3,2098,1776,-20
32406325193,32406325197,4,2331,1743,-20
32406368675,32406368660,-15,1310,669,-20
32407698646,32407698650,4,1324,1168,-20
32411460713,32411460717,4,1875,1772,-20
32413099602,32413099613,11,1409,1233,-20
32418462322,32418462328,6,2063,1177,-20
32419045094,32419045097,3,4290,3217,-20
32419295873,32419295876,3,1680,1432,-20
32419657428,32419657434,6,2435,1577,-20
32422269890,32422269891,1,1500,1283,-20
32426186817,32426186822,5,1608,1174,-20
32428190934,32428190938,4,1786,1761,-20
32428846197,32428846191,-6,1695,7694,-20
32428895372,32428895375,3,1934,1061,-20
32430144275,32430144258,-17,3058,1033,-20
32432894246,32432894249,3,2069,1585,-20
32433347585,32433347587,2,1960,1242,-20
32436174779,32436174785,6,1933,1326,-20
32436480054,32436480058,4,1400,1622,-20
32438145633,32438145636,3,1972,1312,-20
32444456763,32444456767,4,1450,777,-20
32444573084,32444573087,3,1575,1455,-20
32445021746,32445021748,2,2062,1834,-20
32455721606,32455721613,7,2344,1069,-20
32455887254,32455887233,-21,1267,826,-20
32462648233,32462648235,2,1679,1923,-20
32465263386,32465263390,4,1269,805,-20
32467449367,32467449369,2,1278,1082,-20
32467930375,32467930380,5,1460,1538,-20
32468575190,32468575195,5,1269,1197,-20
32470835362,32470835364,2,2006,2190,-20
32472554292,32472554293,1,1782,1482,-20
32474272106,32474272110,4,2081,2322,-20
32474757495,32474757498,3,1867,1656,-20
32479184817,32479184818,1,1545,1156,-20
32480087508,32480087512,4,1719,1448,-20
32481968007,32481968011,4,2181,1338,-20
32482826835,32482826838,3,449,749,-20
32487184430,32487184436,6,3532,2069,-20
32489279757,32489279763,6,1568,937,-20
32491745522,32491745526,4,2293,913,-20
32492623637,32492623656,19,2112,1107,-20
32493133259,32493133262,3,1825,1404,-20
32494896452,32494896454,2,2136,1852,-20
32494923206,32494923210,4,1568,1958,-20
32495025509,32495025512,3,2602,2003,-20
32495080702,32495080705,3,1440,1361,-20
32495697850,32495697854,4,1975,1151,-20
32497532534,32497532538,4,1514,1722,-20
32499399578,32499399578,0,1169,1041,-20
32500424812,32500424814,2,1497,1096,-20
32500904487,32500904495,8,6417,2502,-20
32502476249,32502476255,6,3868,1658,-20
32502523415,32502523418,3,1430,1577,-20
32503401163,32503401166,3,2201,2024,-20
32503534254,32503534255,1,987,1023,-20
32504035537,32504035542,5,1860,1338,-20
32507629472,32507629475,3,1424,1419,-20
32508440368,32508440367,-1,1597,1123,-20
32509363336,32509363325,-11,319,1450,-20
32509593569,32509593563,-6,1942,1588,-20
32518256338,32518256342,4,1457,842,-20
32519369781,32519369783,2,1780,1360,-20
32519814019,32519814023,4,1871,1323,-20
32525456548,32525456550,2,1866,1865,-20
32531300090,32531300094,4,1572,1503,-20
32531734610,32531734613,3,2400,1663,-20
32532337997,32532338001,4,1399,1303,-20
32538375113,32538375115,2,1414,862,-20
32538673239,32538673220,-19,1141,797,-20
32538957506,32538957510,4,2888,1668,-20
32539773533,32539773537,4,2513,1265,-20
32540920414,32540920418,4,2164,1856,-20
32541196288,32541196292,4,1402,1419,-20
32541687446,32541687446,0,1291,1673,-20
32543791720,32543791723,3,1300,1338,-20
32543923937,32543923940,3,1728,1681,-20
32544831158,32544831162,4,3088,1958,-20
32546807044,32546807042,-2,1130,1296,-20
32547325452,32547325456,4,1647,1773,-20
32548950085,32548950086,1,3452,3280,-20
32551349102,32551349106,4,1607,1153,-20
32552101326,32552101330,4,2218,1734,-20
32556387517,32556387522,5,1813,1465,-20
32558327583,32558327586,3,1861,1379,-20
32560332089,32560332091,2,2061,1748,-20
32561337482,32561337484,2,1424,1194,-20
32563157976,32563157980,4,1915,1553,-20
32566416249,32566416253,4,2271,1770,-20
32566871555,32566871559,4,2458,1242,-20
32570414934,32570414936,2,1618,1221,-20
32572355411,32572355416,5,1440,1159,-20
32572688172,32572688175,3,1663,1087,-20
32572947968,32572947971,3,1847,1363,-20
32572978926,32572978905,-21,1150,1104,-20
32577035105,32577035111,6,1977,1416,-20
32577829482,32577829485,3,1252,1055,-20
32578143383,32578143387,4,1650,1257,-20
32579289835,32579289838,3,1356,1176,-20
32580210492,32580210495,3,1527,1456,-20
32581896554,32581896559,5,2205,1128,-20
32584149411,32584149414,3,2023,1410,-20
32587504985,32587504987,2,1160,1777,-20
32590671815,32590671818,3,1531,1300,-20
32590990523,32590990526,3,1308,1130,-20
32591021231,32591021235,4,2034,1758,-20
32595559821,32595559826,5,3134,1338,-20
32596639578,32596639584,6,1686,902,-20
32601735086,32601735090,4,1460,1079,-20
32609042690,32609042693,3,1439,814,-20
32609737339,32609737320,-19,1425,1068,-20
32610532251,32610532245,-6,1635,6145,-20
32610772387,32610772389,2,1191,1232,-20
32611751477,32611751480,3,1757,1511,-20
32611865035,32611865041,6,1900,1085,-20
32617520784,32617520787,3,1399,1309,-20
32617902590,32617902594,4,1711,912,-20
32621007578,32621007580,2,1618,981,-20
32624550787,32624550792,5,2178,1348,-20
32625010139,32625010140,1,1304,1239,-20
32626185256,32626185260,4,2302,1347,-20
32632174917,32632174920,3,2482,1467,-20
32632653870,32632653873,3,1477,1190,-20
32635942440,32635942458,18,185,545,-20
32636883969,32636883975,6,2475,1499,-20
32637962518,32637962522,4,2071,966,-20
32641061531,32641061532,1,1146,1426,-20
32642778430,32642778433,3,1700,1500,-20
32644945562,32644945564,2,1562,1208,-20
32645692673,32645692677,4,1556,1576,-20
32652964060,32652964064,4,2692,1843,-20
32654023460,32654023463,3,1551,1209,-20
32654490503,32654490506,3,2621,1909,-20
32656701722,32656701726,4,2100,1283,-20
32661551650,32661551655,5,2011,1333,-20
32664869090,32664869094,4,1866,1090,-20
32665024457,32665024461,4,1820,1484,-20
32667648802,32667648805,3,1347,1253,-20
32669554119,32669554098,-21,981,836,-20
32669715468,32669715475,7,2252,1035,-20
32670915518,32670915513,-5,1888,8056,-20
32672168378,32672168382,4,3341,1740,-20
32673223154,32673223161,7,2925,1248,-20
32674247014,32674247018,4,1661,1309,-20
32675669829,32675669834,5,1570,1991,-20
32676398885,32676398887,2,2439,1799,-20
32679078426,32679078429,3,1501,1498,-20
32679235671,32679235674,3,1527,1259,-20
32684286279,32684286278,-1,1539,1176,-20
32688996019,32688996023,4,1853,1391,-20
32690467191,32690467194,3,1332,703,-20
32690546574,32690546577,3,1750,1540,-20
32695342072,32695342070,-2,1055,1864,-20
32695999468,32695999472,4,2223,1733,-20
32696392789,32696392789,0,2302,1429,-20
32697302454,32697302455,1,1883,2297,-20
32702250290,32702250294,4,1504,1300,-20
32705658801,32705658807,6,1933,931,-20
32713311120,32713311123,3,1787,1700,-20
32714425234,32714425238,4,2603,1837,-20
32717451002,32717451006,4,1166,1050,-20
32718417732,32718417732,0,1476,2107,-20
32730661134,32730661138,4,1859,919,-20
32731693436,32731693437,1,1982,1599,-20
32734141323,32734141326,3,2215,1565,-20
32738180201,32738180202,1,1070,1347,-20
32741490195,32741490198,3,1591,1378,-20
32743474370,32743474373,3,1870,1602,-20
32748150923,32748150925,2,1791,1176,-20
32749503714,32749503716,2,1924,1371,-20
32751491922,32751491922,0,1871,1186,-20
32751836621,32751836623,2,1546,1794,-20
32754047350,32754047353,3,1310,981,-20
32755769805,32755769807,2,1362,1519,-20
32755860811,32755860815,4,1159,847,-20
32759738141,32759738144,3,2117,1449,-20
32763221572,32763221574,2,2552,1707,-20
32765098366,32765098370,4,2728,1294,-20
32766193339,32766193344,5,2787,1299,-20
32771128034,32771128036,2,1697,1766,-20
32771242421,32771242440,19,2310,1774,-20
32774073497,32774073498,1,1103,494,-20
32775258086,32775258068,-18,2549,1378,-20
32775589390,32775589402,12,1980,1372,-20
32776016702,32776016697,-5,1616,2592,-20
32777880048,32777880050,2,2002,1431,-20
32778702249,32778702253,4,1512,1032,-20
32779511768,32779511765,-3,1493,4600,-20
32780001454,32780001458,4,1575,1261,-20
32780728111,32780728115,4,743,1092,-20
32785110998,32785110992,-6,1065,2900,-20
32787768589,32787768593,4,2168,1366,-20
32788346063,32788346058,-5,698,2875,-20
32789552122,32789552123,1,1889,1866,-20
32790824762,32790824766,4,2255,1608,-20
32794510013,32794510014,1,1026,1091,-20
32796772198,32796772203,5,2283,1073,-20
32797284965,32797284966,1,1063,1045,-20
32803007142,32803007145,3,1540,1588,-20
32807436675,32807436676,1,1826,1511,-20
32808074730,32808074734,4,1648,1322,-20
32815717503,32815717505,2,1695,1269,-20
32820096660,32820096664,4,2746,1509,-20
32822170034,32822170037,3,1611,810,-20
32822785772,32822785775,3,2128,1398,-20
32824576152,32824576155,3,2390,2029,-20
32825772299,32825772301,2,2019,1704,-20
32826464067,32826464049,-18,678,580,-20
32828308769,32828308775,6,2252,1294,-20
32828803661,32828803662,1,1358,1489,-20
32832872368,32832872371,3,1787,1805,-20
32833746952,32833746946,-6,1376,1015,-20
32834213099,32834213105,6,1656,915,-20
32840145168,32840145174,6,2735,900,-20
32844254321,32844254322,1,1563,1630,-20
32850283353,32850283355,2,2134,2207,-20
32851959999,32851960004,5,1962,1665,-20
32855797023,32855797026,3,2143,1409,-20
32856018409,32856018414,5,1467,1109,-20
32858303797,32858303801,4,1851,1684,-20
32863463505,32863463507,2,2421,1504,-20
32865809457,32865809461,4,2216,1277,-20
32865836729,32865836735,6,1967,1698,-20
32866109604,32866109606,2,2100,1583,-20
32868865216,32868865219,3,1707,822,-20
32869491034,32869491019,-15,785,538,-20
32870715719,32870715724,5,1504,1228,-20
32873607858,32873607862,4,2479,1958,-20
32874348503,32874348506,3,1168,929,-20
32877562325,32877562327,2,1343,1151,-20
32878057351,32878057354,3,1549,1411,-20
32879151758,32879151762,4,864,809,-20
32879472374,32879472377,3,1902,1156,-20
32882821702,32882821707,5,1713,1434,-20
32888659638,32888659642,4,2247,1307,-20
32890444591,32890444595,4,1840,1790,-20
32894202378,32894202382,4,1978,2029,-20
32894594374,32894594379,5,1118,1176,-20
32895032637,32895032617,-20,2196,1866,-20
32896161670,32896161673,3,1531,1419,-20
32898847482,32898847483,1,1317,1253,-20
32903094108,32903094108,0,1585,1775,-20
32903588884,32903588883,-1,1234,271,-20
32903943008,32903943013,5,3172,1142,-20
32906508578,32906508582,4,1864,1710,-20
32909247596,32909247599,3,2199,1332,-20
32909825715,32909825719,4,1966,1629,-20
32913668895,32913668898,3,1791,1460,-20
32915900602,32915900602,0,1382,1629,-20
32916734445,32916734449,4,2559,1527,-20
32918357130,32918357112,-18,868,303,-20
32919104009,32919104011,2,1793,1458,-20
32925024344,32925024346,2,2110,1562,-20
32926247229,32926247231,2,2013,1630,-20
32926817179,32926817182,3,1493,1181,-20
32929302470,32929302472,2,1444,1160,-20
32931661005,32931661006,1,2702,1368,-20
32933281745,32933281747,2,1433,1138,-20
32934172506,32934172509,3,2181,2027,-20
32936990929,32936990931,2,2277,1777,-20
32937810983,32937810980,-3,21471,17035,-20
32939615189,32939615193,4,1924,1790,-20
32940734033,32940734035,2,1480,994,-20
32944799785,32944799788,3,1145,954,-20
32946770739,32946770737,-2,1038,1297,-20
32948430666,32948430670,4,2590,1676,-20
32951634131,32951634134,3,2062,1626,-20
32952928847,32952928850,3,1675,1564,-20
32954203458,32954203462,4,1830,1208,-20
32955706953,32955706956,3,1603,1168,-20
32956523657,32956523660,3,1443,1578,-20
32957190452,32957190455,3,1204,1386,-20
32957661846,32957661833,-13,564,549,-20
32958280014,32958280017,3,1257,1407,-20
32962018155,32962018155,0,1199,1867,-20
32963877670,32963877670,0,2556,3498,-20
32970623453,32970623456,3,1974,1994,-20
32977761637,32977761634,-3,6548,11960,-20
32979782182,32979782186,4,1799,1310,-20
32982168619,32982168617,-2,1193,2735,-20
32986849843,32986849846,3,2040,2198,-20
32988527928,32988527932,4,1678,2036,-20
32989984490,32989984493,3,2128,1398,-20
32991295508,32991295511,3,1643,1277,-20
32994952777,32994952779,2,1633,1460,-20
32997827489,32997827495,6,1397,1073,-20
32998047533,32998047535,2,1777,2026,-20
33000880878,33000880881,3,1857,1543,-20
33002075664,33002075662,-2,682,1050,-20
33005149948,33005149951,3,1809,1339,-20
33011506353,33011506356,3,1933,1326,-20
33013125774,33013125778,4,1571,1556,-20
33014697755,33014697762,7,2961,1898,-20
33015130519,33015130523,4,1647,1298,-20
33015878430,33015878432,2,1908,1949,-20
33016723840,33016723843,3,1581,1276,-20
33017969262,33017969265,3,2495,1812,-20
33022588137,33022588123,-14,1732,933,-20
33022718954,33022718958,4,1800,1402,-20
33025073619,33025073626,7,4634,1328,-20
33025784955,33025784959,4,1765,1277,-20
33028638015,33028638017,2,1257,1372,-20
33030178971,33030178974,3,1668,1168,-20
33030236374,33030236354,-20,1695,1067,-20
33031027874,33031027878,4,1845,1526,-20
33033576082,33033576086,4,1949,1221,-20
33035173466,33035173469,3,2070,2014,-20
33036755954,33036755958,4,2006,1900,-20
33040772061,33040772063,2,1756,2109,-20
33044981969,33044981974,5,2593,1413,-20
33045112303,33045112298,-5,1222,3112,-20
33047905925,33047905930,5,2284,1792,-20
33048791290,33048791294,4,1607,1176,-20
33049007738,33049007743,5,1961,1137,-20
33051326746,33051326749,3,1747,1320,-20
33052371307,33052371305,-2,889,299,-20
33053279269,33053279248,-21,2330,1330,-20
33055323624,33055323627,3,1937,1931,-20
33055992771,33055992763,-8,1565,1178,-20
33057905695,33057905693,-2,8710,14314,-20
33058057202,33058057202,0,1401,2351,-20
33058567019,33058567024,5,1510,1089,-20
33060949154,33060949156,2,1490,1261,-20
33062305817,33062305821,4,1842,1405,-20
33063249010,33063249013,3,1352,882,-20
33065635871,33065635874,3,2366,1424,-20
33066792466,33066792473,7,1892,1506,-20
33067171977,33067171979,2,2417,2310,-20
33067884635,33067884638,3,1783,1373,-20
33069195154,33069195151,-3,2168,5597,-20
33071506028,33071506030,2,645,811,-20
33071866943,33071866947,4,1909,1322,-20
33073561027,33073561030,3,2081,1207,-20
33074675533,33074675555,22,1238,1104,-20
33076700293,33076700297,4,2279,1621,-20
33077584089,33077584090,1,1668,1444,-20
33080474013,33080474019,6,1844,914,-20
33081109446,33081109449,3,1108,1113,-20
33082959542,33082959546,4,2144,1306,-20
33083487822,33083487802,-20,1955,1172,-20
33084881103,33084881107,4,1261,913,-20
33087102791,33087102795,4,1839,1619,-20
33087789235,33087789238,3,2701,1583,-20
33091274805,33091274809,4,2113,2060,-20
33094244246,33094244246,0,1593,1213,-20
33100648418,33100648420,2,2129,1557,-20
33102491754,33102491758,4,2069,1095,-20
33104216110,33104216115,5,1553,1372,-20
33104396571,33104396574,3,1484,1503,-20
33105311342,33105311341,-1,1391,1806,-20
33106480894,33106480908,14,12723,51662,-20
33108186212,33108186217,5,1494,945,-20
33108892812,33108892814,2,2052,1736,-20
33109442518,33109442521,3,1738,1467,-20
33111645174,33111645175,1,1949,1280,-20
33111684009,33111684011,2,2003,1515,-20
33112118567,33112118571,4,1455,1242,-20
33112258373,33112258374,1,1959,1308,-20
33113973182,33113973183,1,1503,861,-20
33115339155,33115339158,3,2302,1414,-20
33119009630,33119009633,3,2541,1513,-20
33119772497,33119772502,5,1474,1136,-20
33120184862,33120184866,4,1634,1126,-20
33121370471,33121370474,3,1869,1296,-20
33124782151,33124782150,-1,1065,732,-20
33125664986,33125664989,3,1658,1490,-20
33126647395,33126647399,4,1887,1776,-20
33127679313,33127679317,4,1647,1601,-20
33130707770,33130707774,4,2073,1511,-20
33131379265,33131379269,4,1373,1370,-20
33134148467,33134148470,3,1777,1592,-20
33135530859,33135530858,-1,1110,1484,-20
33139457926,33139457927,1,1157,1392,-20
33141429856,33141429864,8,2892,1015,-20
33141785571,33141785574,3,2087,1909,-20
33141892551,33141892550,-1,1002,1452,-20
33152378353,33152378357,4,1607,1497,-20
33155093689,33155093695,6,1788,1283,-20
33156113574,33156113578,4,1285,1728,-20
33157910151,33157910150,-1,1766,1588,-20
33158611579,33158611582,3,1834,1325,-20
33158730082,33158730065,-17,1167,1151,-20
33161621468,33161621470,2,2080,1908,-20
33161671463,33161671465,2,1477,1585,-20
33163231255,33163231259,4,1645,1270,-20
33168977173,33168977178,5,2075,1426,-20
33169840613,33169840619,6,2288,1378,-20
33170341144,33170341146,2,1829,1455,-20
33172811259,33172811264,5,1602,1329,-20
33175834208,33175834211,3,1503,1420,-20
33176076382,33176076378,-4,1385,3962,-20
33177634853,33177634857,4,2150,1324,-20
33177897559,33177897558,-1,1267,1163,-20
33177977699,33177977700,1,1691,1591,-20
33178166263,33178166266,3,1740,1413,-20
33178242188,33178242186,-2,2132,3256,-20
33179113761,33179113764,3,959,713,-20
33180952205,33180952209,4,1808,1307,-20
33182043462,33182043465,3,1389,1533,-20
33182657796,33182657802,6,2830,2325,-20
33184592932,33184592937,5,1568,1581,-20
33186734903,33186734907,4,1466,1516,-20
33187695615,33187695618,3,1060,1209,-20
33188674343,33188674346,3,1781,1874,-20
33191240879,33191240882,3,2457,1287,-20
33193342212,33193342215,3,1005,1074,-20
33194698941,33194698943,2,2437,1386,-20
33197454072,33197454079,7,2461,1694,-20
33210329610,33210329612,2,1330,1324,-20
33216518179,33216518182,3,2036,1565,-20
33217537149,33217537155,6,1600,1001,-20
33218734822,33218734824,2,1920,1932,-20
33222061669,33222061672,3,2379,1429,-20
33223793054,33223793058,4,1654,849,-20
33225980956,33225980958,2,1914,1048,-20
33234136083,33234136086,3,1689,1576,-20
33234256047,33234256052,5,2580,1479,-20
33235288810,33235288813,3,1907,1265,-20
33235539450,33235539454,4,1704,1297,-20
33239816827,33239816831,4,2306,1209,-20
33241336941,33241336943,2,1443,1382,-20
33247161215,33247161218,3,1560,943,-20
33247499630,33247499627,-3,1217,1741,-20
33253363782,33253363784,2,1260,993,-20
33255971619,33255971622,3,1212,1354,-20
33259922482,33259922484,2,1345,1066,-20
33262141479,33262141485,6,2167,1408,-20
33262417100,33262417104,4,1352,1536,-20
33263044054,33263044058,4,2263,1422,-20
33266758433,33266758439,6,2185,1244,-20
33267267639,33267267641,2,1800,1624,-20
33268595252,33268595257,5,1689,1515,-20
33270523183,33270523187,4,1414,1290,-20
33273573614,33273573616,2,1566,1474,-20
33274265026,33274265032,6,2110,1377,-20
33276562797,33276562801,4,2472,1177,-20
33277531122,33277531125,3,1154,1546,-20
33278660142,33278660146,4,2221,1444,-20
33279346183,33279346190,7,2847,1290,-20
33279745010,33279745014,4,2161,1573,-20
33279857536,33279857540,4,2063,1384,-20
33287095563,33287095567,4,1347,930,-20
33290770501,33290770502,1,1933,1191,-20
33292565466,33292565469,3,1772,949,-20
33294484310,33294484313,3,2575,1927,-20
33298295335,33298295339,4,2029,1671,-20
33301803425,33301803429,4,2304,1552,-20
33307133042,33307133047,5,930,1031,-20
33308387239,33308387243,4,1497,1227,-20
33317189495,33317189491,-4,1268,3208,-20
33318064507,33318064492,-15,961,713,-20
33322914638,33322914643,5,2108,1311,-20
33325468838,33325468843,5,1410,928,-20
33329322940,33329322944,4,2262,1012,-20
33331391090,33331391092,2,1559,1818,-20
33333953261,33333953264,3,1660,1259,-20
33335596738,33335596740,2,1884,1586,-20
33338111602,33338111607,5,2079,1186,-20
33338672377,33338672360,-17,2704,1379,-20
33340812301,33340812307,6,1742,1161,-20
33341833444,33341833447,3,1534,1652,-20
33341961830,33341961834,4,1888,1086,-20
33342017856,33342017859,3,2287,1388,-20
33342574128,33342574122,-6,1383,5835,-20
33344039721,33344039727,6,1427,1141,-20
33345556708,33345556710,2,1946,1640,-20
33347560853,33347560856,3,1885,1275,-20
33348499345,33348499346,1,3511,3464,-20
33350309433,33350309437,4,2091,1588,-20
33357052082,33357052088,6,2661,1866,-20
33357243171,33357243156,-15,1870,1210,-20
33358967449,33358967453,4,2265,1558,-20
33359066026,33359066031,5,2017,1928,-20
33359165603,33359165605,2,1746,1534,-20
33362358332,33362358327,-5,1196,4927,-20
33363460889,33363460893,4,1935,1772,-20
33366711426,33366711430,4,1066,1382,-20
33368198459,33368198464,5,1532,1532,-20
33370487212,33370487214,2,1544,1569,-20
33370880473,33370880478,5,2168,1331,-20
33374677259,33374677262,3,2522,2201,-20
33374981750,33374981753,3,1295,1336,-20
33375950042,33375950045,3,1416,1095,-20
33377188899,33377188903,4,2373,1393,-20
33381496644,33381496666,22,866,1778,-20
33383036978,33383036982,4,1743,1250,-20
33384182636,33384182638,2,1372,979,-20
33386672420,33386672424,4,1528,1548,-20
33388641673,33388641678,5,3566,2089,-20
33389487722,33389487726,4,2640,1279,-20
33390449223,33390449223,0,826,1670,-20
33390967384,33390967389,5,2771,1803,-20
33391957906,33391957909,3,2413,1318,-20
33393794414,33393794418,4,1551,1393,-20
33393943308,33393943292,-16,1633,1232,-20
33395142640,33395142643,3,1789,1459,-20
33398260742,33398260742,0,1476,1036,-20
33398516421,33398516425,4,1950,1224,-20
33401097702,33401097707,5,2928,1779,-20
33402977447,33402977449,2,1348,1258,-20
33403790316,33403790318,2,2062,2150,-20
33411667766,33411667770,4,1366,1009,-20
33413572553,33413572555,2,1828,1163,-20
33414657486,33414657490,4,1354,1753,-20
33420030266,33420030270,4,1267,1266,-20
33422487200,33422487203,3,2131,847,-20
33425569931,33425569933,2,1696,1408,-20
33429165453,33429165457,4,826,1008,-20
33430554803,33430554810,7,7736,24178,-20
33431140466,33431140471,5,1795,1507,-20
33432371506,33432371509,3,2067,1667,-20
33437301839,33437301834,-5,1117,4828,-20
33437348792,33437348790,-2,1420,1999,-20
33438060998,33438061002,4,2751,1927,-20
33444544031,33444544035,4,2396,1196,-20
33448346706,33448346708,2,1563,1419,-20
33451445473,33451445474,1,1401,1154,-20
33453381039,33453381042,3,1468,1386,-20
33454661944,33454661947,3,1684,1447,-20
33455259781,33455259784,3,1266,1423,-20
33455725883,33455725890,7,4405,1971,-20
33458093166,33458093170,4,1956,1489,-20
33463191563,33463191563,0,1288,1550,-20
33465603783,33465603786,3,1185,1379,-20
33467476657,33467476658,1,2048,1413,-20
33470970356,33470970359,3,2097,1198,-20
33471542559,33471542562,3,750,1182,-20
33475987297,33475987300,3,1393,1084,-20
33479570510,33479570515,5,3264,1190,-20
33480002871,33480002875,4,1372,1015,-20
33481695472,33481695474,2,1796,1379,-20
33484562431,33484562435,4,1430,1293,-20
33488484438,33488484439,1,1487,1172,-20
33489900227,33489900230,3,1185,968,-20
33490909945,33490909947,2,2134,1795,-20
33492153474,33492153480,6,1460,833,-20
33495457325,33495457330,5,1640,1099,-20
33496365619,33496365623,4,2329,2083,-20
33498696219,33498696222,3,2084,1680,-20
33499646616,33499646618,2,1688,1417,-20
33499886551,33499886554,3,2161,1488,-20
33502070472,33502070477,5,1496,1368,-20
33503119718,33503119721,3,1209,1059,-20
33507497507,33507497510,3,904,858,-20
33519438374,33519438378,4,1246,1204,-20
33522027347,33522027350,3,1695,1163,-20
33525570546,33525570547,1,2433,1501,-20
33527208713,33527208718,5,2375,1008,-20
33527475407,33527475424,17,1807,1055,-20
33529649015,33529649019,4,2370,1866,-20
33529957491,33529957494,3,2013,1107,-20
33535181454,33535181455,1,1554,1087,-20
33537946070,33537946073,3,2009,1251,-20
33539396872,33539396875,3,2083,1897,-20
33542368677,33542368680,3,2445,1520,-20
33543494155,33543494156,1,1874,1405,-20
33550819143,33550819146,3,1657,2152,-20
33551943923,33551943926,3,1178,1161,-20
33553566904,33553566905,1,2257,1871,-20
33555320507,33555320511,4,2700,1717,-20
33558594724,33558594728,4,2341,2090,-20
33559880125,33559880131,6,1565,913,-20
33566919053,33566919049,-4,24814,17644,-20
33567761656,33567761663,7,2430,1327,-20
33568026924,33568026926,2,1489,1132,-20
33569628981,33569628983,2,2179,1974,-20
33571438738,33571438742,4,2062,1453,-20
33578630287,33578630290,3,1433,1146,-20
33578767040,33578767042,2,1885,820,-20
33579058249,33579058253,4,2307,1534,-20
33579657026,33579657030,4,1432,1541,-20
33581286605,33581286586,-19,1748,1413,-20
33585744440,33585744434,-6,1202,3538,-20
33587587565,33587587569,4,1840,1536,-20
33592330378,33592330381,3,1368,1286,-20
33594137414,33594137417,3,866,1422,-20
33595104285,33595104306,21,22915,3099,-20
33598343569,33598343572,3,2104,1506,-20
33604318763,33604318766,3,1733,1641,-20
33605074347,33605074352,5,2058,1923,-20
33605343674,33605343677,3,2349,1442,-20
33606336750,33606336755,5,1398,1210,-20
33608916481,33608916486,5,1795,1042,-20
33612676570,33612676574,4,1329,1211,-20
33615502698,33615502703,5,1568,1477,-20
33615701982,33615701986,4,1434,913,-20
33616998015,33616998014,-1,2257,2820,-20
33617427412,33617427414,2,1515,1169,-20
33620743826,33620743835,9,1223,784,-20
33623542604,33623542598,-6,2416,6973,-20
33625433588,33625433591,3,6714,4593,-20
33625537004,33625537005,1,1963,1519,-20
33625781869,33625781873,4,2349,1705,-20
33632007071,33632007074,3,1693,1289,-20
33633623169,33633623173,4,1810,1449,-20
33639048846,33639048849,3,1463,1269,-20
33639888167,33639888174,7,1998,1462,-20
33642672810,33642672814,4,1964,1227,-20
33642869034,33642869040,6,2586,1583,-20
33643554745,33643554739,-6,1378,1391,-20
33643925841,33643925846,5,1457,1306,-20
33644176354,33644176358,4,1484,1585,-20
33644263403,33644263405,2,1600,1618,-20
33649167126,33649167129,3,1849,1287,-20
33649308189,33649308191,2,1290,965,-20
33649459312,33649459314,2,2286,1442,-20
33652900610,33652900614,4,1798,1169,-20
33657912179,33657912182,3,1623,1532,-20
33657947632,33657947635,3,2024,1635,-20
33659094682,33659094686,4,2023,2020,-20
33661040313,33661040315,2,1450,1369,-20
33661386867,33661386871,4,1093,1146,-20
33670547241,33670547241,0,1747,894,-20
33672532134,33672532138,4,1891,988,-20
33673102611,33673102616,5,2126,1409,-20
33676122230,33676122233,3,2556,1631,-20
33676302285,33676302287,2,1820,1516,-20
33676520971,33676520976,5,18954,55875,-20
33677289951,33677289955,4,1141,945,-20
33681051491,33681051493,2,2085,2024,-20
33681644164,33681644166,2,1077,1308,-20
33682530306,33682530307,1,1568,1765,-20
33689937763,33689937767,4,2383,1436,-20
33693247619,33693247623,4,1677,1529,-20
33695096910,33695096914,4,1553,1151,-20
33695362302,33695362305,3,1808,820,-20
33698711313,33698711315,2,2210,1889,-20
33701462678,33701462683,5,2132,1656,-20
33701912346,33701912349,3,1837,1046,-20
33703195126,33703195131,5,2243,1418,-20
33704576081,33704576080,-1,1636,2502,-20
33704692228,33704692234,6,1863,1128,-20
33709816899,33709816897,-2,1342,3890,-20
33714666094,33714666099,5,2131,1236,-20
33720212378,33720212383,5,2280,1278,-20
33721663874,33721663878,4,1913,1234,-20
33723415998,33723416001,3,2429,1625,-20
33724826339,33724826345,6,1560,1014,-20
33729028265,33729028270,5,1535,1178,-20
33730299927,33730299929,2,1529,1094,-20
33731272417,33731272422,5,2596,1633,-20
33732719174,33732719178,4,2070,1167,-20
33734504866,33734504871,5,1664,1411,-20
33736977665,33736977667,2,1082,1266,-20
33737824812,33737824815,3,2415,1506,-20
33738009507,33738009510,3,2291,1330,-20
33740044653,33740044657,4,1707,1222,-20
33744978598,33744978599,1,1613,1515,-20
33747667681,33747667683,2,1302,998,-20
33749102441,33749102446,5,5064,2340,-20
33749954798,33749954805,7,6175,2726,-20
33756677282,33756677284,2,1892,1486,-20
33756739211,33756739224,13,1776,932,-20
33757131900,33757131902,2,1386,1164,-20
33758263671,33758263674,3,1215,1235,-20
33759738444,33759738447,3,1622,1227,-20
33760044508,33760044509,1,1606,1077,-20
33763456722,33763456726,4,1735,1238,-20
33763526554,33763526560,6,2276,1289,-20
33766930250,33766930254,4,1094,1233,-20
33767531726,33767531729,3,2112,2104,-20
33774079951,33774079955,4,2176,1613,-20
33775445922,33775445924,2,1854,1371,-20
33776718602,33776718602,0,1217,1108,-20
33777600003,33777599988,-15,2377,1889,-20
33779532416,33779532419,3,2244,1807,-20
33780313010,33780313013,3,1391,1111,-20
33780764207,33780764209,2,1909,1567,-20
33781285947,33781285950,3,2257,1207,-20
33782784989,33782784990,1,1792,1254,-20
33784901298,33784901302,4,1644,1448,-20
33786709625,33786709627,2,2385,1361,-20
33787006948,33787006950,2,1966,1468,-20
33787907176,33787907182,6,3128,1746,-20
33788851450,33788851454,4,1315,926,-20
33791090266,33791090269,3,2008,1210,-20
33796053642,33796053647,5,2779,1322,-20
33798683479,33798683482,3,1707,1466,-20
33799471082,33799471085,3,1096,1306,-20
33801068937,33801068942,5,1680,1210,-20
33802415947,33802415950,3,1839,1194,-20
33804337954,33804337956,2,1802,1871,-20
33810004335,33810004338,3,1803,1252,-20
33810553422,33810553438,16,467,2374,-20
33812195974,33812195977,3,2116,1621,-20
33814903702,33814903706,4,1265,1148,-20
33815620956,33815620961,5,1998,1336,-20
33816505961,33816505962,1,1982,1156,-20
33817461607,33817461609,2,1953,1172,-20
33818934657,33818934662,5,1608,1298,-20
33821263802,33821263806,4,1444,1588,-20
33822019458,33822019460,2,2224,1486,-20
33823337424,33823337427,3,1222,1114,-20
33826166009,33826166014,5,2181,1498,-20
33826555373,33826555374,1,1718,1199,-20
33828405901,33828405907,6,2319,1864,-20
33833063474,33833063476,2,1794,1544,-20
33834246943,33834246947,4,878,659,-20
33836817398,33836817402,4,2577,1356,-20
33838814238,33838814242,4,1903,1512,-20
33841449622,33841449625,3,1859,1531,-20
33845010314,33845010319,5,1665,1310,-20
33845385665,33845385669,4,2258,1801,-20
33850791961,33850791963,2,1487,1276,-20
33853229014,33853229018,4,1867,1278,-20
33854614983,33854614983,0,1682,1246,-20
33856594134,33856594137,3,2488,1466,-20
33859382042,33859382043,1,1105,1000,-20
33859984760,33859984763,3,984,931,-20
33861131992,33861131994,2,2033,1464,-20
33865223775,33865223779,4,1977,1068,-20
33866395592,33866395594,2,1799,1485,-20
33872155185,33872155187,2,1568,1514,-20
33873565517,33873565519,2,1217,1013,-20
33874755739,33874755743,4,1494,1067,-20
33881213898,33881213898,0,1831,2860,-20
33884621397,33884621401,4,970,632,-20
33891957742,33891957747,5,2726,2082,-20
33893177005,33893177009,4,1534,1681,-20
33895110421,33895110425,4,1829,1697,-20
33898274995,33898274999,4,1035,1221,-20
33898604637,33898604641,4,2215,2029,-20
33901178906,33901178910,4,1728,1522,-20
33904358088,33904358091,3,1942,1314,-20
33905639725,33905639728,3,1570,1519,-20
33907239030,33907239030,0,1077,2492,-20
33907864678,33907864682,4,2005,1822,-20
33907900291,33907900272,-19,1472,1022,-20
33909933153,33909933155,2,2165,1635,-20
33911713805,33911713809,4,1654,1630,-20
33911997407,33911997410,3,2087,1470,-20
33922078386,33922078387,1,2402,1768,-20
33922361555,33922361558,3,1474,1303,-20
33926929189,33926929192,3,2238,1342,-20
33927223175,33927223179,4,1946,1163,-20
33929985992,33929985995,3,1106,968,-20
33932467232,33932467238,6,32720,21239,-20
33933557454,33933557457,3,1899,1073,-20
33934631263,33934631268,5,1976,1418,-20
33936206224,33936206230,6,1876,1455,-20
33939253072,33939253075,3,2064,1284,-20
33939289546,33939289530,-16,1274,1076,-20
33940171711,33940171717,6,3014,1191,-20
33940237413,33940237416,3,1953,1322,-20
33947731525,33947731531,6,1003,617,-20
33950302733,33950302736,3,1447,1408,-20
33952179965,33952179967,2,1234,1217,-20
33954039690,33954039693,3,2023,1343,-20
33959837490,33959837483,-7,1475,5472,-20
33961678515,33961678515,0,1967,2128,-20
33963483943,33963483942,-1,722,1369,-20
33964596918,33964596916,-2,1058,1152,-20
33965193298,33965193301,3,1469,2065,-20
33965904794,33965904798,4,1688,1597,-20
33966537167,33966537168,1,1480,2053,-20
33969852636,33969852638,2,1612,1451,-20
33971540306,33971540309,3,2283,1770,-20
33980151258,33980151261,3,2401,2212,-20
33980492985,33980492991,6,9238,1268,-20
33981827120,33981827127,7,2285,1728,-20
33986671967,33986671972,5,2068,1409,-20
33988026223,33988026228,5,2084,1491,-20
33988582170,33988582187,17,1389,1130,-20
33994040309,33994040315,6,1953,1139,-20
33995369726,33995369730,4,2092,1685,-20
33996077126,33996077120,-6,20583,15096,-20
33997972159,33997972163,4,1725,1378,-20
33999431705,33999431707,2,987,627,-20
34000845597,34000845601,4,1294,1020,-20
34005788670,34005788673,3,1192,758,-20
34006556755,34006556751,-4,1762,3370,-20
34006704809,34006704813,4,3026,1439,-20
34007852589,34007852582,-7,1096,5949,-20
34008110001,34008110002,1,1688,1688,-20
34010335281,34010335287,6,3593,1379,-20
34011533665,34011533666,1,1471,1348,-20
34012701463,34012701469,6,2506,1665,-20
34014112725,34014112728,3,1669,1416,-20
34014560895,34014560899,4,2467,938,-20
34014973174,34014973194,20,675,232,-20
34015557460,34015557472,12,2328,1221,-20
34016659928,34016659929,1,2177,1386,-20
34017416357,34017416367,10,9891,34323,-20
34019851574,34019851575,1,1531,1402,-20
34024715090,34024715093,3,1848,1315,-20
34025854971,34025854977,6,2036,1398,-20
34026331806,34026331787,-19,1288,942,-20
34026401574,34026401577,3,2091,1271,-20
34026728890,34026728898,8,2896,1780,-20
34027244969,34027244975,6,3206,1163,-20
34029698097,34029698101,4,2021,1939,-20
34030277346,34030277350,4,1806,1027,-20
34032222768,34032222770,2,2066,1146,-20
34034182471,34034182475,4,1272,978,-20
34040771607,34040771611,4,1629,1362,-20
34042276178,34042276182,4,2763,1568,-20
34045701580,34045701583,3,2188,1552,-20
34048114551,34048114555,4,1922,1073,-20
34049946423,34049946422,-1,1281,1084,-20
34053365854,34053365858,4,2122,1539,-20
34056274163,34056274166,3,2325,1305,-20
34058953234,34058953237,3,1426,1329,-20
34064823958,34064823962,4,1344,1464,-20
34068666534,34068666537,3,2016,1382,-20
34076581437,34076581443,6,2073,2085,-20
34076735719,34076735726,7,1264,944,-20
34077877002,34077877008,6,2044,1740,-20
34079847922,34079847926,4,1720,1263,-20
34080638998,34080639000,2,1543,1809,-20
34083556573,34083556576,3,2737,1926,-20
34084940982,34084940986,4,1782,1566,-20
34085796106,34085796108,2,1651,1620,-20
34089252374,34089252377,3,1175,1443,-20
34089782747,34089782752,5,1316,983,-20
34090625113,34090625110,-3,1124,2800,-20
34091806220,34091806223,3,1428,947,-20
34093907239,34093907251,12,1525,884,-20
34096664502,34096664504,2,1717,1777,-20
34097081888,34097081892,4,2055,1574,-20
34097227293,34097227297,4,1664,1621,-20
34098647121,34098647125,4,1900,1481,-20
34100507642,34100507646,4,1825,1038,-20
34101250669,34101250661,-8,1656,1340,-20
34103233206,34103233210,4,2324,1705,-20
34104836134,34104836135,1,32018,16123,-20
34106833968,34106833972,4,994,1075,-20
34109294258,34109294263,5,1675,1279,-20
34112762004,34112762009,5,1857,1129,-20
34113813972,34113813977,5,1208,743,-20
34114565455,34114565462,7,2501,1326,-20
34117709198,34117709202,4,2238,2005,-20
34118295614,34118295618,4,1816,950,-20
34118647818,34118647818,0,1526,1354,-20
34118867217,34118867218,1,1253,974,-20
34120220822,34120220829,7,6322,2614,-20
34121132408,34121132411,3,1800,1818,-20
34122041771,34122041774,3,2253,1573,-20
34124667109,34124667113,4,2402,1796,-20
34127274462,34127274469,7,2310,1389,-20
34131575143,34131575146,3,2121,1111,-20
34134442917,34134442922,5,2195,1896,-20
34139438088,34139438092,4,2981,1762,-20
34141714367,34141714370,3,1357,1244,-20
34144944025,34144944029,4,2285,1832,-20
34147323930,34147323934,4,2905,2228,-20
34148079747,34148079750,3,784,965,-20
34156461164,34156461166,2,2770,1287,-20
34160099472,34160099474,2,1795,1387,-20
34163600157,34163600150,-7,977,2012,-20
34168461690,34168461694,4,2243,1545,-20
34169112533,34169112534,1,1928,1023,-20
34169455081,34169455083,2,2136,1397,-20
34172835965,34172835967,2,1317,1347,-20
34180122937,34180122940,3,1861,1400,-20
34183225911,34183225913,2,1989,1336,-20
34183683707,34183683709,2,993,1499,-20
34183985149,34183985151,2,1505,1231,-20
34189152782,34189152786,4,2502,1755,-20
34189573978,34189573979,1,1515,1387,-20
34191323882,34191323885,3,2037,1391,-20
34192561705,34192561707,2,1473,1424,-20
34198862825,34198862827,2,1439,1029,-20
34204931834,34204931840,6,1829,1364,-20
34208625340,34208625344,4,1935,1390,-20
34209298838,34209298856,18,1765,1064,-20
34213051411,34213051413,2,1683,1376,-20
34215889929,34215889933,4,2238,1194,-20
34217337509,34217337488,-21,1249,3918,-20
34217970887,34217970891,4,909,1301,-20
34219004354,34219004347,-7,2850,8313,-20
34219543424,34219543428,4,1669,1479,-20
34222700773,34222700777,4,1923,1721,-20
34223287166,34223287168,2,327,142,-20
34224646922,34224646922,0,1438,1520,-20
34225272833,34225272836,3,2342,1122,-20
34228076784,34228076789,5,1417,928,-20
34229481175,34229481178,3,1980,1860,-20
34230344019,34230344023,4,1717,833,-20
34233293158,34233293160,2,1903,1530,-20
34235032719,34235032720,1,1253,1509,-20
34235763171,34235763175,4,2682,1522,-20
34238242341,34238242346,5,1852,799,-20
34238903610,34238903614,4,2148,1713,-20
34240482410,34240482414,4,2448,2135,-20
34240608659,34240608664,5,1769,1432,-20
34243933637,34243933639,2,2466,1582,-20
34244824688,34244824693,5,2042,1531,-20
34244911986,34244911988,2,710,753,-20
34245570923,34245570925,2,1523,1204,-20
34248912723,34248912727,4,1228,1084,-20
34253393145,34253393149,4,1461,1511,-20
34257619037,34257619037,0,1197,1747,-20
34259695606,34259695607,1,1463,1166,-20
34263530567,34263530570,3,1376,1238,-20
34267168417,34267168422,5,1858,1243,-20
34267876095,34267876081,-14,812,168,-20
34269908143,34269908144,1,2918,3407,-20
34272820298,34272820304,6,1557,1274,-20
34273464887,34273464890,3,1490,1266,-20
34274703218,34274703223,5,1820,1519,-20
34277449915,34277449918,3,2276,1775,-20
34279888553,34279888556,3,2162,1502,-20
34284364838,34284364842,4,1660,1401,-20
34285522753,34285522756,3,1725,1315,-20
34289510224,34289510225,1,1824,1850,-20
34290058185,34290058183,-2,1852,4766,-20
34290553169,34290553155,-14,2413,1438,-20
34294571204,34294571206,2,1789,1254,-20
34294781727,34294781704,-23,1651,1304,-20
34295822109,34295822113,4,1888,2434,-20
34296563419,34296563414,-5,1227,3152,-20
34297787695,34297787699,4,1999,1525,-20
34298412538,34298412542,4,734,1785,-20
34301163451,34301163453,2,1906,1226,-20
34303104394,34303104398,4,1314,1489,-20
34307529962,34307529963,1,1771,1429,-20
34310020304,34310020305,1,1733,1205,-20
34315425739,34315425737,-2,3130,4243,-20
34316288927,34316288931,4,1588,1273,-20
34318840741,34318840743,2,1295,1166,-20
34324047098,34324047102,4,2324,1574,-20
34325035679,34325035682,3,1946,1649,-20
34325444486,34325444485,-1,1204,2399,-20
34329257694,34329257694,0,1413,918,-20
34331834971,34331834954,-17,1242,1795,-20
34335578754,34335578753,-1,778,1283,-20
34335745286,34335745265,-21,1842,2015,-20
34338580598,34338580602,4,2682,1371,-20
34339302707,34339302689,-18,1902,1127,-20
34344501884,34344501887,3,1518,1418,-20
34344637289,34344637296,7,1766,1317,-20
34345576009,34345576015,6,4902,1378,-20
34345638931,34345638933,2,2049,1316,-20
34348251405,34348251408,3,2554,1790,-20
34349841806,34349841810,4,2063,1622,-20
34355177548,34355177549,1,2232,1431,-20
34361037290,34361037293,3,1563,1514,-20
34362792141,34362792141,0,1511,1902,-20
34365449397,34365449398,1,1433,1606,-20
34371527813,34371527819,6,1983,1124,-20
34371846609,34371846606,-3,1418,1135,-20
34376885757,34376885762,5,2066,1871,-20
34380374630,34380374634,4,1406,1186,-20
34384501184,34384501186,2,2235,1976,-20
34390498054,34390498055,1,1700,1323,-20
34394161061,34394161064,3,2097,1666,-20
34395302751,34395302753,2,2053,1494,-20
34395630266,34395630268,2,1574,1260,-20
34400919767,34400919771,4,1717,1556,-20
34401594762,34401594767,5,1832,1327,-20
34403621572,34403621575,3,1483,1446,-20
34405251098,34405251102,4,1498,1147,-20
34407951902,34407951906,4,723,263,-20
34409189397,34409189401,4,978,1278,-20
34409791731,34409791735,4,2397,1381,-20
34411780323,34411780328,5,1827,1583,-20
34411959736,34411959739,3,1703,1076,-20
34412466186,34412466189,3,1307,1942,-20
34414996054,34414996035,-19,1540,1026,-20
34416046153,34416046155,2,1512,1420,-20
34420576094,34420576098,4,1458,1266,-20
34421913182,34421913186,4,2169,1726,-20
34426535226,34426535230,4,1761,1749,-20
34436103202,34436103208,6,1916,1196,-20
34438418644,34438418646,2,1449,1815,-20
34439282198,34439282201,3,1140,1489,-20
34441182950,34441182954,4,1893,1187,-20
34441710302,34441710306,4,2563,1668,-20
34442353594,34442353599,5,1269,968,-20
34447715856,34447715861,5,2434,1830,-20
34447946467,34447946470,3,1272,1651,-20
34448504891,34448504891,0,1659,1372,-20
34450177141,34450177143,2,3203,2231,-20
34452174305,34452174326,21,368,2148,-20
34453373431,34453373435,4,1453,823,-20
34453415659,34453415662,3,3664,3082,-20
34456929443,34456929461,18,27159,23207,-20
34461549242,34461549246,4,1736,1146,-20
34461674717,34461674721,4,1606,1245,-20
34467985155,34467985159,4,1895,1156,-20
34468328682,34468328665,-17,2115,914,-20
34474947994,34474947998,4,1337,1523,-20
34475587502,34475587506,4,2114,1153,-20
34478988345,34478988345,0,1389,987,-20
34479193127,34479193128,1,1641,1548,-20
34480104609,34480104610,1,1851,1587,-20
34481641286,34481641291,5,1879,782,-20
34482241658,34482241666,8,3044,1324,-20
34482611489,34482611494,5,2245,1166,-20
34487841831,34487841835,4,1954,1663,-20
34487972528,34487972533,5,37063,17918,-20
34488409908,34488409912,4,1937,1740,-20
34489280882,34489280885,3,1698,1417,-20
34489309800,34489309801,1,77,923,-20
34489856901,34489856905,4,2296,1512,-20
34492322213,34492322217,4,2684,1988,-20
34492565363,34492565366,3,2515,1387,-20
34497370266,34497370269,3,1843,1504,-20
34499107374,34499107378,4,1987,1588,-20
34500810181,34500810184,3,1576,1931,-20
34503233796,34503233798,2,1288,1174,-20
34509079692,34509079696,4,1476,1334,-20
34509950810,34509950812,2,1709,1226,-20
34516957906,34516957907,1,1115,1257,-20
34518183170,34518183172,2,1159,1327,-20
34520146131,34520146135,4,1400,1128,-20
34521702289,34521702293,4,1373,683,-20
34523392965,34523392958,-7,1289,3630,-20
34525319013,34525319018,5,2277,1565,-20
34529962667,34529962671,4,2347,1222,-20
34535925934,34535925938,4,2430,1286,-20
34537508726,34537508731,5,2247,1660,-20
34537684771,34537684775,4,1960,1086,-20
34538738306,34538738310,4,1528,1003,-20
34542171262,34542171266,4,1867,1622,-20
34542909209,34542909209,0,1099,1571,-20
34545968573,34545968574,1,1348,1156,-20
34550750470,34550750473,3,1437,1134,-20
34554480190,34554480193,3,2203,1418,-20
34555322213,34555322217,4,2351,1422,-20
34557171538,34557171541,3,1466,988,-20
34557441686,34557441690,4,678,541,-20
34558563103,34558563098,-5,1947,8049,-20
34559007867,34559007871,4,1352,713,-20
34560959772,34560959776,4,2141,938,-20
34564782148,34564782152,4,1496,1482,-20
34566684893,34566684899,6,2061,1135,-20
34573087121,34573087114,-7,955,2029,-20
34576142406,34576142410,4,2210,1091,-20
34577628991,34577628994,3,2009,1607,-20
34580238661,34580238666,5,3571,1279,-20
34582264354,34582264357,3,1606,1070,-20
34583912726,34583912730,4,2364,1687,-20
34584754482,34584754486,4,1817,950,-20
34587241602,34587241604,2,1914,1310,-20
34587494022,34587494020,-2,1607,4257,-20
34590321472,34590321477,5,1863,1035,-20
34602670443,34602670447,4,1281,989,-20
34604184693,34604184698,5,2218,904,-20
34606435166,34606435166,0,895,1053,-20
34607436242,34607436241,-1,23653,21372,-20
34607952449,34607952451,2,2222,2097,-20
34613825422,34613825426,4,1742,1697,-20
34614206419,34614206423,4,2004,1874,-20
34615572933,34615572934,1,2215,1582,-20
34621393754,34621393758,4,1637,1413,-20
34621457666,34621457672,6,1716,1493,-20
34621533675,34621533680,5,1399,1427,-20
34625732858,34625732873,15,1683,783,-20
34626671874,34626671877,3,1859,1136,-20
34630132590,34630132588,-2,20509,18329,-20
34637338376,34637338378,2,4539,3179,-20
34638079154,34638079158,4,1760,666,-20
34643820726,34643820728,2,2123,1699,-20
34647927013,34647927018,5,1511,1509,-20
34650779166,34650779170,4,1845,1687,-20
34652960462,34652960466,4,1317,875,-20
34654850203,34654850208,5,1340,1114,-20
34657205551,34657205555,4,1940,1536,-20
34660182510,34660182514,4,1075,1527,-20
34660458889,34660458892,3,1846,1716,-20
34662946102,34662946103,1,1501,2100,-20
34663427633,34663427637,4,1477,1072,-20
34664309731,34664309735,4,2062,1273,-20
34664354506,34664354488,-18,2344,1644,-20
34664570829,34664570832,3,2308,1473,-20
34667259134,34667259138,4,1496,1567,-20
34667668517,34667668522,5,2310,1635,-20
34669611029,34669611033,4,2510,2368,-20
34672995782,34672995785,3,1604,1590,-20
34676995006,34676995009,3,1692,1317,-20
34679439101,34679439103,2,1431,1358,-20
34680235366,34680235363,-3,720,1608,-20
34681773189,34681773193,4,1826,1017,-20
34682935390,34682935394,4,2999,1544,-20
34683641302,34683641306,4,1831,1326,-20
34684954333,34684954336,3,1911,1046,-20
34687457530,34687457534,4,1135,644,-20
34689495660,34689495665,5,2337,1698,-20
34692426503,34692426506,3,1830,1453,-20
34692629473,34692629478,5,2030,1882,-20
34692682000,34692682006,6,1536,1246,-20
34695911223,34695911215,-8,1659,1920,-20
34698122580,34698122583,3,676,817,-20
34703063113,34703063115,2,1991,1534,-20
34704056142,34704056143,1,1455,1480,-20
34705205179,34705205182,3,2227,1643,-20
34707290800,34707290804,4,2137,1621,-20
34708771971,34708771975,4,1598,1037,-20
34709929608,34709929614,6,1862,1201,-20
34713209428,34713209431,3,2118,1610,-20
34714355761,34714355765,4,1392,1261,-20
34716007239,34716007241,2,1548,1067,-20
34717873040,34717873043,3,1775,1673,-20
34719231965,34719231969,4,1395,1352,-20
34720557252,34720557251,-1,45298,19138,-20
34721383154,34721383159,5,1941,1226,-20
34721712322,34721712326,4,1949,1780,-20
34722613239,34722613241,2,1900,1118,-20
34724863695,34724863699,4,1578,829,-20
34725546441,34725546446,5,2529,1260,-20
34726118871,34726118873,2,1733,1340,-20
34726822582,34726822583,1,1245,1908,-20
34729243847,34729243847,0,1460,1496,-20
34729941111,34729941115,4,1744,1380,-20
34731113225,34731113229,4,2096,1248,-20
34731873495,34731873498,3,1626,1222,-20
34736998263,34736998266,3,1059,1220,-20
34746705647,34746705649,2,1894,1810,-20
34746980114,34746980118,4,1960,1301,-20
34752375054,34752375058,4,2216,1505,-20
34759109491,34759109495,4,2356,1339,-20
34760519305,34760519309,4,1283,1302,-20
34761678094,34761678095,1,2141,1538,-20
34763962115,34763962120,5,2199,1022,-20
34764416128,34764416128,0,18490,14338,-20
34765137554,34765137559,5,2540,1620,-20
34768453822,34768453826,4,4632,2699,-20
34774383411,34774383410,-1,1452,2694,-20
34777084367,34777084370,3,1897,1394,-20
34779143905,34779143910,5,1656,1180,-20
34783468626,34783468631,5,2511,1503,-20
34785126037,34785126039,2,1628,1752,-20
34785762961,34785762965,4,2711,1363,-20
34786341862,34786341866,4,1575,1131,-20
34787978181,34787978187,6,1670,1059,-20
34799401845,34799401851,6,1977,1494,-20
34799728234,34799728220,-14,18948,14548,-20
34804913044,34804913046,2,1482,1348,-20
34805103973,34805103978,5,2950,1436,-20
34809507208,34809507213,5,2145,2091,-20
34813834094,34813834095,1,1985,986,-20
34817130352,34817130356,4,2125,2133,-20
34817882575,34817882578,3,1765,1546,-20
34823664302,34823664304,2,1349,1861,-20
34826509399,34826509406,7,2227,853,-20
34829598182,34829598186,4,1589,1576,-20
34831538234,34831538237,3,1602,1730,-20
34831820646,34831820649,3,1161,1154,-20
34835097794,34835097797,3,1836,1839,-20
34835127039,34835127043,4,1589,1189,-20
34835310342,34835310347,5,1598,1281,-20
34840394462,34840394463,1,1681,1377,-20
34843926582,34843926586,4,1989,1517,-20
34844300203,34844300206,3,1209,1265,-20
34844699716,34844699721,5,2251,1519,-20
34844927217,34844927220,3,1673,1535,-20
34847525772,34847525775,3,1924,1413,-20
34847636798,34847636801,3,1854,1374,-20
34848206909,34848206912,3,1782,1553,-20
34849273298,34849273303,5,2302,1410,-20
34851036139,34851036143,4,956,724,-20
34851849987,34851849981,-6,987,3237,-20
34851907455,34851907458,3,1972,2353,-20
34852074436,34852074441,5,1868,1062,-20
34853102995,34853102998,3,2166,1586,-20
34853303588,34853303590,2,1632,1380,-20
34855834919,34855834922,3,488,157,-20
34861434833,34861434837,4,1573,1029,-20
34862198863,34862198865,2,1320,1492,-20
34862227134,34862227138,4,1254,1626,-20
34863881192,34863881193,1,1938,1587,-20
34868380526,34868380530,4,2195,1370,-20
34870186330,34870186334,4,2241,2179,-20
34871871099,34871871102,3,1069,799,-20
34874469083,34874469085,2,2085,1473,-20
34875049371,34875049373,2,2278,1544,-20
34882939045,34882939051,6,1883,1073,-20
34883073312,34883073314,2,1249,984,-20
34885824762,34885824766,4,1465,1255,-20
34890092195,34890092198,3,3178,2714,-20
34890152059,34890152062,3,2038,1620,-20
34890650277,34890650281,4,1466,1111,-20
34894980648,34894980653,5,2365,1237,-20
34896787606,34896787609,3,1785,1916,-20
34897893746,34897893750,4,2276,1382,-20
34898485684,34898485690,6,2987,1204,-20
34900635667,34900635671,4,2063,1186,-20
34902315724,34902315725,1,2439,1951,-20
34902668014,34902668017,3,2342,1619,-20
34903350474,34903350475,1,1481,1403,-20
34904482141,34904482145,4,2425,1791,-20
34904996886,34904996890,4,1603,830,-20
34906589581,34906589584,3,1886,1359,-20
34907410217,34907410219,2,1972,1652,-20
34907622508,34907622510,2,2418,1532,-20
34907912807,34907912784,-23,623,594,-20
34909908602,34909908606,4,1371,1587,-20
34911931029,34911931031,2,1880,1264,-20
34913708529,34913708534,5,1619,968,-20
34923433654,34923433659,5,1806,1018,-20
34926979851,34926979856,5,1560,1493,-20
34928726734,34928726737,3,1682,1657,-20
34934563961,34934563955,-6,990,4140,-20
34935429730,34935429734,4,2386,1213,-20
34938524303,34938524297,-6,553,2989,-20
34938778905,34938778913,8,3027,1160,-20
34942076355,34942076359,4,2830,1964,-20
34944326838,34944326838,0,1211,2013,-20
34945344617,34945344622,5,2491,1382,-20
34946494162,34946494166,4,2204,1279,-20
34947082409,34947082413,4,1329,1574,-20
34949305868,34949305870,2,2017,1628,-20
34952688949,34952688952,3,2046,1090,-20
34953874709,34953874711,2,2347,1603,-20
34953984461,34953984468,7,8504,34274,-20
34954453473,34954453479,6,2283,1536,-20
34957641019,34957641024,5,1926,1273,-20
34958146268,34958146271,3,1810,1700,-20
34958721215,34958721218,3,2136,907,-20
34959231261,34959231243,-18,1383,922,-20
34965236289,34965236291,2,874,364,-20
34970894578,34970894583,5,1493,1147,-20
34971087345,34971087348,3,1590,1657,-20
34973812377,34973812378,1,1320,1669,-20
34974595533,34974595531,-2,1283,1217,-20
34974827056,34974827042,-14,1850,1341,-20
34974977001,34974977002,1,1725,1319,-20
34975108912,34975108914,2,863,637,-20
34976768494,34976768499,5,2000,1596,-20
34978433229,34978433226,-3,1096,1577,-20
34978897874,34978897879,5,2464,1351,-20
34982161646,34982161649,3,2221,1572,-20
34987097453,34987097458,5,2140,1100,-20
34987187655,34987187659,4,1668,849,-20
34990930520,34990930522,2,1824,1406,-20
34991528061,34991528065,4,1488,1153,-20
34993709300,34993709302,2,1668,1674,-20
34995184857,34995184858,1,3629,3246,-20
34996234253,34996234257,4,1606,1086,-20
34998453027,34998453030,3,1122,1167,-20
35001167594,35001167598,4,2316,1527,-20
35006163410,35006163415,5,1759,1515,-20
35006851830,35006851829,-1,2309,5266,-20
35007236460,35007236465,5,1802,1771,-20
35009510843,35009510841,-2,1062,1483,-20
35010530814,35010530818,4,1637,1291,-20
35013590690,35013590693,3,1952,1589,-20
35014150839,35014150846,7,4005,2329,-20
35015717314,35015717312,-2,1969,1318,-20
35017356345,35017356347,2,1453,1924,-20
35018111878,35018111882,4,2155,1933,-20
35019784425,35019784430,5,1804,1148,-20
35020881214,35020881219,5,1703,1255,-20
35021522743,35021522747,4,2196,1483,-20
35022848473,35022848478,5,1542,948,-20
35025356674,35025356677,3,1678,1993,-20
35026640598,35026640602,4,2060,1044,-20
35028066098,35028066103,5,2719,2095,-20
35028834238,35028834242,4,1654,1215,-20
35029654301,35029654303,2,1572,810,-20
35031058300,35031058310,10,9966,31993,-20
35033451473,35033451476,3,1635,1228,-20
35034045263,35034045264,1,1557,1410,-20
35036055465,35036055469,4,1871,1512,-20
35040687974,35040687978,4,1490,1309,-20
35047280935,35047280938,3,856,793,-20
35048504733,35048504738,5,1552,1024,-20
35049625003,35049625005,2,1421,1577,-20
35052804227,35052804231,4,2379,1782,-20
35054862668,35054862670,2,1656,1748,-20
35055566325,35055566329,4,1968,1328,-20
35058124033,35058124037,4,2025,1324,-20
35061244032,35061244035,3,2367,1397,-20
35063175316,35063175333,17,848,2257,-20
35066362444,35066362446,2,1528,1074,-20
35068742243,35068742247,4,2014,1421,-20
35069388434,35069388437,3,1679,1182,-20
35070765529,35070765531,2,1633,2029,-20
35071339697,35071339699,2,1156,1202,-20
35076746530,35076746513,-17,911,155,-20
35076938950,35076938954,4,1511,897,-20
35080989378,35080989383,5,1555,1742,-20
35081458138,35081458139,1,1867,1092,-20
35082977594,35082977598,4,1845,1737,-20
35084946354,35084946358,4,4074,2798,-20
35085004954,35085004957,3,1514,1407,-20
35087679218,35087679222,4,1434,1323,-20
35089270548,35089270551,3,1462,1320,-20
35090500579,35090500587,8,3736,1124,-20
35090925340,35090925342,2,1530,1463,-20
35091668354,35091668359,5,1582,1152,-20
35091711977,35091711980,3,2414,1854,-20
35097956539,35097956543,4,1233,1284,-20
35099164095,35099164075,-20,761,509,-20
35100702753,35100702756,3,1922,1114,-20
35110951698,35110951701,3,1119,937,-20
35114600618,35114600623,5,2761,1400,-20
35121359136,35121359139,3,2218,2160,-20
35122825626,35122825630,4,1622,1658,-20
35123778612,35123778618,6,1571,1550,-20
35124884319,35124884322,3,2404,1530,-20
35125209778,35125209781,3,14019,20378,-20
35126459727,35126459729,2,1366,1377,-20
35127137733,35127137735,2,2244,1396,-20
35131384566,35131384567,1,1208,1082,-20
35134892169,35134892170,1,1230,1934,-20
35137210534,35137210538,4,1022,1087,-20
35137727882,35137727886,4,2375,1424,-20
35138937242,35138937245,3,1690,1489,-20
35139746321,35139746325,4,1868,1817,-20
35140781421,35140781415,-6,9047,15808,-20
35141110300,35141110305,5,2069,1564,-20
35144460485,35144460487,2,1054,886,-20
35146763023,35146763026,3,1661,992,-20
35146980954,35146980969,15,1090,1226,-20
35152986536,35152986538,2,1581,2032,-20
35156193956,35156193958,2,1405,1800,-20
35156641509,35156641514,5,3396,1512,-20
35157083670,35157083675,5,1742,1113,-20
35159680686,35159680689,3,2033,1708,-20
35165166767,35165166770,3,1763,1245,-20
35165214120,35165214120,0,16018,18434,-20
35165333053,35165333055,2,1617,1189,-20
35165734804,35165734785,-19,1390,1169,-20
35167058522,35167058525,3,1658,1528,-20
35168476946,35168476950,4,2187,1123,-20
35172897695,35172897698,3,739,745,-20
35182574754,35182574758,4,1463,1263,-20
35183226997,35183227001,4,1837,1322,-20
35189759119,35189759123,4,2076,1310,-20
35191612991,35191612997,6,52629,34022,-20
35192793290,35192793285,-5,1453,2305,-20
35193352708,35193352711,3,2043,1827,-20
35198697870,35198697874,4,1690,1659,-20
35199582684,35199582686,2,1867,1406,-20
35204105542,35204105545,3,1705,1472,-20
35205789845,35205789848,3,2130,1183,-20
35207539265,35207539266,1,1301,1079,-20
35209130078,35209130079,1,1541,1292,-20
35210714574,35210714574,0,1320,1532,-20
35216608351,35216608358,7,2198,1737,-20
35220988150,35220988154,4,1998,1574,-20
35222120749,35222120751,2,2009,1820,-20
35222956534,35222956542,8,1958,893,-20
35223334207,35223334211,4,1563,1072,-20
35228137925,35228137927,2,1635,933,-20
35228520254,35228520259,5,1889,989,-20
35230258363,35230258356,-7,1621,1426,-20
35232624649,35232624656,7,2123,1662,-20
35232672223,35232672201,-22,1313,1416,-20
35234458220,35234458223,3,1929,1313,-20
35234640405,35234640409,4,1738,1395,-20
35237480089,35237480093,4,1895,1493,-20
35239133790,35239133792,2,2162,1870,-20
35246422346,35246422346,0,936,978,-20
35249204061,35249204066,5,1901,1133,-20
35250041628,35250041633,5,1341,960,-20
35251386891,35251386895,4,1384,1002,-20
35252562994,35252562998,4,2158,1521,-20
35253239189,35253239192,3,2061,1550,-20
35253319158,35253319138,-20,1387,1091,-20
35257210462,35257210466,4,1673,1752,-20
35260933260,35260933263,3,1572,1336,-20
35263882083,35263882086,3,1376,1487,-20
35265580059,35265580057,-2,1573,2548,-20
35267053893,35267053897,4,1554,1051,-20
35272498127,35272498130,3,1616,1237,-20
35274191206,35274191211,5,1550,1232,-20
35274787729,35274787729,0,1529,1219,-20
35281395235,35281395239,4,1974,1246,-20
35282400445,35282400428,-17,1696,942,-20
35283956964,35283956966,2,1958,2076,-20
35289102222,35289102226,4,1706,1337,-20
35292770271,35292770276,5,1942,1156,-20
35293979869,35293979873,4,1519,930,-20
35299088405,35299088410,5,1674,1992,-20
35299114755,35299114759,4,1721,1342,-20
35299659008,35299659010,2,1985,1454,-20
35300787958,35300787961,3,1641,1378,-20
35301633580,35301633583,3,1620,1416,-20
35303070742,35303070747,5,1043,1135,-20
35304411090,35304411090,0,1781,1219,-20
35309085922,35309085917,-5,1355,4137,-20
35309119751,35309119754,3,1442,1500,-20
35309602678,35309602679,1,1757,1665,-20
35310259507,35310259510,3,1243,1057,-20
35310779802,35310779806,4,1642,1124,-20
35310971198,35310971200,2,1601,1600,-20
35312275580,35312275582,2,1774,1125,-20
35313565042,35313565046,4,1674,1004,-20
35316397962,35316397965,3,1534,1242,-20
35320942091,35320942093,2,1883,1922,-20
35321726259,35321726263,4,1721,1416,-20
35321895701,35321895723,22,1562,1204,-20
35322486093,35322486096,3,2712,1137,-20
35323919359,35323919363,4,1895,1648,-20
35324756543,35324756547,4,1800,1237,-20
35326267994,35326267999,5,1706,1141,-20
35328805872,35328805873,1,1602,1083,-20
35329028531,35329028534,3,2221,1864,-20
35332806813,35332806817,4,1912,1262,-20
35333840335,35333840337,2,2080,1705,-20
35340883154,35340883156,2,1857,1283,-20
35341101441,35341101445,4,1724,1288,-20
35343221223,35343221226,3,1281,1254,-20
35346405778,35346405781,3,1463,1225,-20
35350608883,35350608880,-3,826,2018,-20
35350788524,35350788510,-14,138,6027,-20
35353628603,35353628605,2,2032,1835,-20
35354586724,35354586727,3,2348,2119,-20
35356654250,35356654252,2,1417,1284,-20
35358999261,35358999265,4,2727,1987,-20
35361586690,35361586693,3,1863,1187,-20
35363714163,35363714162,-1,21805,25389,-20
35365486325,35365486332,7,2324,1325,-20
35366341209,35366341214,5,1423,1416,-20
35366685061,35366685054,-7,1466,5954,-20
35369259594,35369259598,4,1743,1267,-20
35376420290,35376420294,4,1959,1527,-20
35376447333,35376447335,2,1227,1379,-20
35376997231,35376997234,3,2211,1607,-20
35378635450,35378635451,1,1736,1294,-20
35379003356,35379003361,5,1506,1534,-20
35382006248,35382006251,3,2372,1999,-20
35386670141,35386670143,2,2318,1648,-20
35389559803,35389559803,0,1604,1126,-20
35391590480,35391590483,3,1144,860,-20
35391881150,35391881155,5,1915,1443,-20
35398546704,35398546697,-7,2358,7576,-20
35400489222,35400489227,5,1603,1274,-20
35408735600,35408735609,9,1807,1236,-20
35414632250,35414632253,3,2775,1852,-20
35415462317,35415462321,4,1870,1181,-20
35416243794,35416243797,3,1213,1263,-20
35416689108,35416689113,5,1631,1678,-20
35418055755,35418055760,5,1989,1414,-20
35424667266,35424667270,4,2115,1601,-20
35425211858,35425211864,6,2195,1528,-20
35426110978,35426110981,3,2111,1338,-20
35428527761,35428527765,4,1536,961,-20
35431842454,35431842458,4,1623,1542,-20
35431896834,35431896837,3,1732,1319,-20
35435271087,35435271090,3,1400,1461,-20
35438786022,35438786022,0,1713,1276,-20
35443791381,35443791379,-2,1197,1757,-20
35444016334,35444016336,2,1501,952,-20
35444611538,35444611544,6,2044,1179,-20
35444790005,35444789986,-19,1719,1144,-20
35449610878,35449610874,-4,1050,1708,-20
35452138302,35452138307,5,2882,1452,-20
35452271213,35452271219,6,1237,1117,-20
35453433588,35453433591,3,2618,1830,-20
35454258549,35454258552,3,833,794,-20
35462852722,35462852725,3,1420,1372,-20
35464596098,35464596102,4,1493,1246,-20
35466675458,35466675463,5,2327,1445,-20
35467195954,35467195958,4,2797,1820,-20
35470516315,35470516321,6,2533,1676,-20
35473950142,35473950147,5,1482,1143,-20
35474116018,35474116021,3,2219,1667,-20
35474327466,35474327470,4,1355,1335,-20
35475738364,35475738367,3,1641,1287,-20
35477486568,35477486572,4,1448,1550,-20
35478317658,35478317663,5,1833,940,-20
35478421812,35478421794,-18,3133,1410,-20
35479227021,35479227032,11,1277,854,-20
35482861758,35482861763,5,1507,1024,-20
35485590229,35485590230,1,1895,1788,-20
35486626944,35486626947,3,1930,1981,-20
35489193002,35489192999,-3,399,345,-20
35493364234,35493364237,3,1896,1587,-20
35494077845,35494077850,5,1756,1449,-20
35494623983,35494623986,3,1930,1203,-20
35495883729,35495883733,4,2542,2182,-20
35496032069,35496032074,5,1957,1286,-20
35496131456,35496131458,2,1706,1584,-20
35501889862,35501889869,7,1569,910,-20
35501924264,35501924267,3,1653,958,-20
35502016235,35502016238,3,2110,1519,-20
35504720600,35504720602,2,1968,1886,-20
35505792415,35505792417,2,1315,1717,-20
35506094082,35506094086,4,1499,1333,-20
35512018494,35512018500,6,1678,1004,-20
35513517720,35513517723,3,2682,1765,-20
35514106336,35514106338,2,2396,2012,-20
35515193086,35515193090,4,2217,1564,-20
35517431481,35517431486,5,2114,1627,-20
35518503703,35518503705,2,1350,992,-20
35519240867,35519240867,0,1688,1363,-20
35519672172,35519672175,3,1822,1170,-20
35520795127,35520795131,4,1697,1053,-20
35521810432,35521810441,9,23,3906,-20
35522187682,35522187686,4,2251,1882,-20
35523242403,35523242407,4,1329,1041,-20
35529241465,35529241466,1,1084,1027,-20
35539462809,35539462811,2,1671,1033,-20
35542594861,35542594867,6,1348,1085,-20
35543334245,35543334250,5,1571,1243,-20
35543359775,35543359778,3,1346,1568,-20
35543843846,35543843850,4,1680,1296,-20
35546058220,35546058221,1,1918,1380,-20
35546845686,35546845690,4,1658,1294,-20
35549399335,35549399338,3,1795,993,-20
35552266753,35552266758,5,1879,1217,-20
35557279777,35557279780,3,1749,1266,-20
35557530033,35557530038,5,2121,1638,-20
35558886681,35558886682,1,2197,1316,-20
35561106401,35561106403,2,1460,1590,-20
35565428410,35565428414,4,1421,1105,-20
35567964901,35567964904,3,2144,1246,-20
35568854138,35568854142,4,1927,1611,-20
35572343366,35572343371,5,2846,1523,-20
35576466875,35576466880,5,2781,1682,-20
35576560029,35576560031,2,1550,1075,-20
35581448052,35581448054,2,2082,2430,-20
35582772252,35582772234,-18,1183,762,-20
35585986896,35585986898,2,1716,1105,-20
35586104459,35586104461,2,1420,1421,-20
35586806305,35586806299,-6,1865,8262,-20
35587011815,35587011818,3,2295,2025,-20
35587498714,35587498712,-2,1850,2133,-20
35590383485,35590383487,2,1324,1350,-20
35592756262,35592756266,4,1724,1140,-20
35594122846,35594122850,4,2277,1638,-20
35594305801,35594305805,4,1864,1558,-20
35595285131,35595285134,3,2392,1486,-20
35601436350,35601436353,3,1593,1148,-20
35601698923,35601698927,4,547,268,-20
35606308371,35606308375,4,1361,885,-20
35608529639,35608529644,5,9354,28141,-20
35610907804,35610907807,3,1850,1202,-20
35611892785,35611892788,3,1888,1719,-20
35613106494,35613106498,4,1714,1485,-20
35615199741,35615199741,0,1031,1852,-20
35616197390,35616197397,7,4070,824,-20
35616252751,35616252762,11,552,82,-20
35618934360,35618934363,3,2112,1203,-20
35620463970,35620463973,3,2140,1414,-20
35627086944,35627086948,4,1436,1779,-20
35628200032,35628200036,4,1918,1285,-20
35629238213,35629238214,1,1830,1970,-20
35630636635,35630636639,4,2766,1766,-20
35633863514,35633863518,4,2030,1771,-20
35635916737,35635916739,2,1482,1035,-20
35637703395,35637703399,4,2054,1817,-20
35640616532,35640616536,4,2141,1847,-20
35641638079,35641638085,6,2276,1278,-20
35641968276,35641968286,10,1890,927,-20
35645377424,35645377426,2,2000,1222,-20
35650013857,35650013859,2,943,1132,-20
35658779042,35658779046,4,1979,1223,-20
35671279788,35671279787,-1,1384,2256,-20
35675953688,35675953702,14,498,1150,-20
35677907312,35677907315,3,2210,1689,-20
35678482905,35678482909,4,1711,1363,-20
35678582457,35678582459,2,1455,2269,-20
35681418057,35681418062,5,2129,1825,-20
35683478889,35683478891,2,2340,1459,-20
35685167146,35685167152,6,1999,1191,-20
35689262066,35689262073,7,3539,1380,-20
35692512570,35692512575,5,2039,1274,-20
35696017757,35696017759,2,1497,1696,-20
35698366400,35698366403,3,1195,987,-20
35706125213,35706125215,2,934,1069,-20
35711855301,35711855304,3,1412,1584,-20
35713355742,35713355745,3,1553,1128,-20
35715829697,35715829699,2,2442,1849,-20
35715950383,35715950386,3,1452,1638,-20
35720979880,35720979882,2,2095,1743,-20
35721607667,35721607671,4,1625,1008,-20
35724002077,35724002079,2,1609,1738,-20
35725799358,35725799361,3,2094,1363,-20
35726058953,35726058969,16,1007,879,-20
35727422089,35727422094,5,18744,35186,-20
35728217215,35728217219,4,2578,1903,-20
35729029809,35729029816,7,3775,1974,-20
35732624922,35732624927,5,1613,1129,-20
35734520947,35734520950,3,1346,1355,-20
35735479225,35735479228,3,1917,1489,-20
35736557614,35736557617,3,1698,1469,-20
35739204974,35739204980,6,3465,1763,-20
35740377495,35740377501,6,1571,1436,-20
35741470707,35741470711,4,2819,2483,-20
35744335202,35744335203,1,1670,1260,-20
35745276539,35745276542,3,1360,1290,-20
35746873329,35746873335,6,5090,2492,-20
35752819091,35752819093,2,1533,814,-20
35760145985,35760145978,-7,703,4738,-20
35762592237,35762592242,5,2376,1296,-20
35764475041,35764475043,2,931,1180,-20
35769054902,35769054906,4,1546,1469,-20
35771129254,35771129257,3,1916,917,-20
35773166580,35773166583,3,2366,1409,-20
35776677616,35776677619,3,1644,1090,-20
35781937989,35781937991,2,2214,2184,-20
35785938418,35785938421,3,1598,1127,-20
35786104942,35786104953,11,2568,1250,-20
35788960425,35788960430,5,1674,995,-20
35789704718,35789704736,18,1088,979,-20
35793930352,35793930356,4,1978,1549,-20
35794468771,35794468774,3,1520,1383,-20
35794790804,35794790807,3,1256,954,-20
35796661952,35796661955,3,1669,1418,-20
35799587767,35799587771,4,3463,1993,-20
35799704243,35799704248,5,1966,1648,-20
35800049858,35800049863,5,1100,733,-20
35800499989,35800499993,4,1950,1832,-20
35801565481,35801565483,2,1568,1080,-20
35805504737,35805504741,4,2533,1463,-20
35807778493,35807778499,6,1391,922,-20
35811611040,35811611039,-1,1341,2821,-20
35812170258,35812170262,4,2676,1696,-20
35812658747,35812658753,6,2446,1369,-20
35812966197,35812966198,1,1328,1245,-20
35815796303,35815796306,3,2127,1750,-20
35816923653,35816923659,6,2063,1047,-20
35820451244,35820451227,-17,33665,31783,-20
35820664716,35820664721,5,2181,1095,-20
35822345242,35822345246,4,1561,1598,-20
35825287135,35825287138,3,1792,1142,-20
35828266243,35828266247,4,2486,1254,-20
35829000446,35829000449,3,1660,1365,-20
35829151666,35829151667,1,961,827,-20
35830046650,35830046649,-1,20111,8173,-20
35831494691,35831494694,3,1553,1221,-20
35832079624,35832079627,3,2168,1274,-20
35832121179,35832121179,0,919,1267,-20
35833854205,35833854211,6,1859,1124,-20
35835561094,35835561098,4,2362,1455,-20
35836142722,35836142726,4,1599,1918,-20
35836210348,35836210350,2,1984,1905,-20
35838606355,35838606358,3,1518,1130,-20
35839559778,35839559782,4,1446,1661,-20
35844058738,35844058741,3,1373,1706,-20
35844251154,35844251159,5,1376,1309,-20
35848475498,35848475482,-16,1232,457,-20
35849174014,35849174017,3,2087,2044,-20
35853776775,35853776779,4,1394,894,-20
35855177437,35855177442,5,1951,1189,-20
35856026607,35856026586,-21,1484,1678,-20
35857020573,35857020575,2,1859,1286,-20
35858463688,35858463691,3,2032,1306,-20
35858838889,35858838891,2,1829,1129,-20
35860995693,35860995698,5,2975,1325,-20
35863275752,35863275756,4,2015,1612,-20
35866640575,35866640578,3,2123,1201,-20
35868642093,35868642097,4,2353,1111,-20
35871306907,35871306910,3,1766,1253,-20
35872297209,35872297210,1,1747,1283,-20
35872920765,35872920767,2,1642,1339,-20
35877153281,35877153284,3,2294,1660,-20
35879086138,35879086142,4,1751,1277,-20
35880975550,35880975554,4,1978,1465,-20
35882790598,35882790604,6,1539,1196,-20
35887130281,35887130285,4,1930,1601,-20
35888875469,35888875473,4,2275,1429,-20
35888937690,35888937693,3,1762,1838,-20
35890335194,35890335189,-5,1218,3991,-20
35894511200,35894511203,3,1735,1052,-20
35895823957,35895823962,5,1089,756,-20
35897448293,35897448298,5,1977,1648,-20
35898712257,35898712262,5,2727,1367,-20
35899537884,35899537888,4,1624,1209,-20
35900616603,35900616586,-17,1148,1268,-20
35903557814,35903557817,3,1786,1294,-20
35909769630,35909769647,17,13814,49658,-20
35910317501,35910317503,2,13442,12149,-20
35912061256,35912061273,17,1914,1292,-20
35912837702,35912837706,4,1871,1420,-20
35915359877,35915359879,2,1459,1314,-20
35919317728,35919317729,1,6352,18939,-20
35919473294,35919473298,4,1248,1384,-20
35923590126,35923590130,4,1861,1051,-20
35924326025,35924326031,6,2200,1466,-20
35924932102,35924932099,-3,107,1247,-20
35928337626,35928337633,7,1715,1088,-20
35928807589,35928807590,1,2378,1509,-20
35935803479,35935803485,6,1391,1468,-20
35937280997,35937280998,1,2015,1329,-20
35937776617,35937776618,1,1692,1266,-20
35942073947,35942073950,3,2369,1657,-20
35943777271,35943777275,4,1521,1560,-20
35943970032,35943970035,3,1185,1161,-20
35946056504,35946056507,3,867,824,-20
35946286601,35946286606,5,2175,742,-20
35947409525,35947409526,1,1535,1479,-20
35947464082,35947464086,4,2140,1608,-20
35948327204,35948327207,3,1552,1235,-20
35949349430,35949349434,4,1353,883,-20
35949862043,35949862024,-19,987,425,-20
35950802717,35950802719,2,2384,1850,-20
35952062987,35952062992,5,2001,1171,-20
35952344606,35952344609,3,2192,1921,-20
35953339030,35953339031,1,2025,1632,-20
35954467385,35954467389,4,1575,1384,-20
35957494926,35957494928,2,2964,3035,-20
35959439511,35959439516,5,1918,1855,-20
35959613214,35959613213,-1,723,1368,-20
35960340585,35960340589,4,2269,1677,-20
35962345838,35962345841,3,2458,2063,-20
35966402382,35966402386,4,1737,1158,-20
35966511303,35966511300,-3,2650,4781,-20
35966696101,35966696105,4,1602,1438,-20
35967795481,35967795485,4,2284,1439,-20
35968599121,35968599125,4,1194,1463,-20
35969026534,35969026536,2,1473,1072,-20
35971780076,35971780080,4,1946,1311,-20
35972318170,35972318171,1,1759,1281,-20
35980725334,35980725338,4,1707,1138,-20
35981470025,35981470029,4,2068,1309,-20
35984783594,35984783597,3,2080,1705,-20
35987571389,35987571374,-15,43495,12671,-20
35989489010,35989489011,1,1467,748,-20
35989563430,35989563434,4,2416,159,-20
35989934565,35989934572,7,2929,1452,-20
35992131010,35992131014,4,1811,2060,-20
35992818430,35992818431,1,1598,1150,-20
35996113291,35996113297,6,2890,1030,-20
35996337881,35996337882,1,1514,1580,-20
35998098122,35998098126,4,1635,1689,-20
35999220655,35999220658,3,46711,39334,-20
35999264028,35999264030,2,2043,1716,-20
35999423860,35999423863,3,1721,1440,-20
35999949643,35999949647,4,1780,1372,-20
35999992636,35999992624,-12,778,284,-20
36002442517,36002442522,5,1672,1519,-20
36003060839,36003060841,2,2214,1205,-20
36008094010,36008094014,4,1565,1015,-20
36011491681,36011491682,1,2021,1521,-20
36015693059,36015693078,19,1268,87,-20
36016903040,36016903042,2,1274,806,-20
36017189695,36017189699,4,1690,1370,-20
36017747063,36017747060,-3,1531,2547,-20
36018677977,36018677981,4,1883,1160,-20
36018907733,36018907735,2,1356,1000,-20
36020121990,36020121988,-2,1106,2135,-20
36037914362,36037914363,1,967,1522,-20
36039316575,36039316578,3,1135,1150,-20
36040735187,36040735191,4,2170,1726,-20
36042943138,36042943140,2,2009,1597,-20
36047699524,36047699530,6,3141,1342,-20
36048200629,36048200633,4,1590,1664,-20
36048515193,36048515201,8,1692,1064,-20
36049322737,36049322741,4,1659,1548,-20
36049386799,36049386803,4,1688,1523,-20
36050003931,36050003912,-19,553,89,-20
36050887874,36050887878,4,1530,1984,-20
36052135972,36052135978,6,1804,1429,-20
36052622700,36052622704,4,1661,1422,-20
36054103710,36054103713,3,2097,1644,-20
36054165977,36054165993,16,804,274,-20
36056857332,36056857336,4,2073,2329,-20
36059353342,36059353346,4,1292,1233,-20
36060119742,36060119746,4,1606,1451,-20
36062901432,36062901435,3,2433,2150,-20
36064231587,36064231589,2,2442,1207,-20
36065256938,36065256939,1,3647,3888,-20
36065464476,36065464479,3,2262,1349,-20
36069130905,36069130910,5,1624,1611,-20
36073077494,36073077499,5,2379,1349,-20
36073534085,36073534089,4,3052,1625,-20
36074759866,36074759869,3,1656,1721,-20
36075550823,36075550827,4,2182,1620,-20
36076523517,36076523521,4,2109,1529,-20
36076793843,36076793846,3,1898,1454,-20
36076951313,36076951305,-8,1479,91,-20
36078008265,36078008267,2,1856,2741,-20
36078314627,36078314630,3,2091,1807,-20
36078694590,36078694594,4,1798,1880,-20
36084181137,36084181149,12,276,1787,-20
36084778325,36084778329,4,1826,1225,-20
36090179701,36090179703,2,1646,1171,-20
36090274541,36090274543,2,1817,1106,-20
36091759888,36091759893,5,2665,1233,-20
36093335229,36093335233,4,2517,1669,-20
36094674670,36094674671,1,1820,1754,-20
36097186213,36097186217,4,1922,1970,-20
36097771765,36097771766,1,1432,1198,-20
36098689512,36098689511,-1,1312,1142,-20
36106040327,36106040331,4,1620,1146,-20
36106745199,36106745194,-5,925,2486,-20
36111324434,36111324439,5,2662,2090,-20
36115630841,36115630843,2,1573,1116,-20
36121828577,36121828578,1,1677,1635,-20
36127860700,36127860703,3,1406,1157,-20
36129965701,36129965703,2,2013,1379,-20
36131498940,36131498945,5,2483,1715,-20
36133052558,36133052562,4,1527,1119,-20
36133245823,36133245825,2,1852,1586,-20
36134129055,36134129059,4,1681,1711,-20
36134263728,36134263731,3,1612,1017,-20
36136578273,36136578277,4,2200,1341,-20
36138467637,36138467631,-6,2188,8360,-20
36140037134,36140037136,2,1801,1340,-20
36142741629,36142741635,6,1624,1124,-20
36143755031,36143755034,3,2766,2069,-20
36145900050,36145900055,5,2240,1362,-20
36146641703,36146641707,4,1604,1148,-20
36147413790,36147413793,3,1562,1299,-20
36148307164,36148307169,5,2473,1749,-20
36148946459,36148946461,2,1492,1366,-20
36153315334,36153315337,3,1609,1584,-20
36154515166,36154515169,3,1959,1645,-20
36155478377,36155478391,14,8777,49914,-20
36157178841,36157178844,3,1510,1436,-20
36160436930,36160436938,8,1060,863,-20
36171916460,36171916462,2,1632,1396,-20
36172491843,36172491845,2,1549,1210,-20
36173598345,36173598348,3,1674,1123,-20
36174343458,36174343459,1,1582,1071,-20
36175603515,36175603518,3,2559,2068,-20
36175698605,36175698607,2,1233,956,-20
36177864142,36177864146,4,1829,1719,-20
36180758537,36180758539,2,2747,2088,-20
36181126475,36181126478,3,2137,1384,-20
36183333021,36183333023,2,1577,1057,-20
36187241984,36187241986,2,1821,1173,-20
36187372063,36187372044,-19,672,418,-20
36190843366,36190843372,6,2520,1442,-20
36190937055,36190937042,-13,671,703,-20
36191715561,36191715562,1,1759,1922,-20
36191869782,36191869787,5,2341,1339,-20
36193205450,36193205446,-4,1828,5356,-20
36193281875,36193281880,5,2399,1388,-20
36193683069,36193683090,21,1934,1300,-20
36193905420,36193905425,5,4349,1811,-20
36195666606,36195666610,4,1661,1240,-20
36200776771,36200776774,3,1933,1246,-20
36202014822,36202014825,3,2218,1556,-20
36204842406,36204842410,4,1628,1503,-20
36208230740,36208230743,3,1996,1174,-20
36210699454,36210699436,-18,2134,1560,-20
36212322837,36212322841,4,2770,1232,-20
36215350599,36215350603,4,2204,1232,-20
36220043851,36220043858,7,4788,1646,-20
36221961734,36221961737,3,1844,2101,-20
36225253118,36225253125,7,8417,35792,-20
36226097502,36226097506,4,2194,1853,-20
36230901821,36230901822,1,1518,829,-20
36231130422,36231130424,2,1716,1533,-20
36233883609,36233883615,6,2150,1263,-20
36236726922,36236726923,1,1346,1239,-20
36237452161,36237452154,-7,1527,4989,-20
36240150315,36240150321,6,2041,1317,-20
36243966625,36243966627,2,1392,1508,-20
36244164985,36244164990,5,1726,1046,-20
36244666190,36244666196,6,2460,1794,-20
36246361848,36246361851,3,1788,1208,-20
36246615369,36246615369,0,1609,1289,-20
36248401477,36248401482,5,1897,1472,-20
36249506957,36249506960,3,1615,1595,-20
36252420826,36252420831,5,2600,1777,-20
36255170701,36255170710,9,1630,997,-20
36256636773,36256636775,2,1600,1717,-20
36257159323,36257159328,5,939,816,-20
36257723285,36257723286,1,1687,1369,-20
36257755921,36257755926,5,2650,1679,-20
36258417060,36258417064,4,1766,1017,-20
36259581138,36259581139,1,1661,1168,-20
36262920681,36262920684,3,1712,1341,-20
36263126496,36263126501,5,1452,880,-20
36263551804,36263551806,2,1905,1504,-20
36267732797,36267732801,4,2181,1757,-20
36272015771,36272015774,3,1773,1912,-20
36272169157,36272169161,4,2000,1571,-20
36272280718,36272280738,20,1427,1350,-20
36276959967,36276959973,6,1554,1209,-20
36278429454,36278429455,1,3316,3149,-20
36278482262,36278482266,4,1631,1194,-20
36289385673,36289385666,-7,1235,6165,-20
36292021637,36292021635,-2,1774,2348,-20
36292096634,36292096641,7,1775,1363,-20
36296269320,36296269323,3,1533,1418,-20
36298060470,36298060473,3,1951,1256,-20
36300047121,36300047126,5,1867,972,-20
36301170422,36301170425,3,1980,1372,-20
36305286882,36305286886,4,2059,1025,-20
36306290337,36306290339,2,1245,998,-20
36306699562,36306699562,0,1324,1016,-20
36306740070,36306740048,-22,2070,1596,-20
36308461574,36308461578,4,1853,1650,-20
36309048162,36309048157,-5,882,1858,-20
36309876039,36309876043,4,1548,1909,-20
36309990501,36309990506,5,2158,1396,-20
36310492201,36310492203,2,1943,2118,-20
36315821480,36315821483,3,1653,2042,-20
36317382468,36317382471,3,998,928,-20
36321687749,36321687738,-11,946,1011,-20
36326698646,36326698649,3,1950,1035,-20
36327941908,36327941910,2,2056,1513,-20
36332202646,36332202647,1,1679,1232,-20
36333636517,36333636524,7,6082,1924,-20
36334482869,36334482871,2,1450,983,-20
36336514960,36336514963,3,2731,1829,-20
36338336869,36338336874,5,1994,965,-20
36347081312,36347081314,2,2534,1506,-20
36351373212,36351373219,7,1148,901,-20
36352931492,36352931495,3,1485,933,-20
36356051051,36356051055,4,1326,1423,-20
36357479596,36357479601,5,857,916,-20
36359070536,36359070525,-11,712,89,-20
36361521477,36361521479,2,1468,1508,-20
36362884828,36362884833,5,2364,1124,-20
36363229877,36363229879,2,1420,1349,-20
36364712186,36364712186,0,1564,1647,-20
36365163580,36365163582,2,1595,1112,-20
36370479383,36370479386,3,1083,1045,-20
36370645953,36370645958,5,1502,1361,-20
36372799722,36372799726,4,2336,1863,-20
36373935009,36373935013,4,1908,1266,-20
36374639400,36374639405,5,1782,1729,-20
36379991805,36379991807,2,1762,1310,-20
36380473504,36380473506,2,2073,1320,-20
36382456568,36382456569,1,1402,1230,-20
36382997538,36382997541,3,1634,1933,-20
36384031464,36384031465,1,1510,1056,-20
36385104094,36385104097,3,1853,1862,-20
36385187590,36385187595,5,2679,1464,-20
36390825513,36390825496,-17,1648,1209,-20
36395924631,36395924625,-6,1555,1858,-20
36399529822,36399529826,4,2156,1653,-20
36399930519,36399930521,2,1719,1209,-20
36405573932,36405573935,3,2254,1705,-20
36407686657,36407686660,3,3171,2383,-20
36409329513,36409329518,5,2626,1847,-20
36411209348,36411209349,1,2664,2834,-20
36412086745,36412086747,2,1681,1604,-20
36413119206,36413119211,5,1956,1569,-20
36416439273,36416439274,1,1344,1672,-20
36418444460,36418444462,2,1246,708,-20
36420667681,36420667681,0,1724,1110,-20
36428631977,36428631980,3,1098,863,-20
36429097283,36429097287,4,2064,1118,-20
36432636005,36432636010,5,2375,973,-20
36432713154,36432713161,7,2315,1171,-20
36432860210,36432860214,4,1658,1266,-20
36436461190,36436461193,3,1496,1442,-20
36443527834,36443527834,0,1375,1366,-20
36443611843,36443611859,16,1295,408,-20
36444510241,36444510251,10,1573,1782,-20
36446765265,36446765266,1,20891,9684,-20
36448575719,36448575724,5,1474,975,-20
36449448993,36449448995,2,1436,1029,-20
36452816475,36452816478,3,1596,1624,-20
36453725326,36453725331,5,2095,993,-20
36456136966,36456136970,4,1592,1323,-20
36461020994,36461020995,1,1438,1472,-20
36461863660,36461863665,5,1206,999,-20
36464997313,36464997318,5,1366,1163,-20
36465338533,36465338535,2,1499,957,-20
36465555195,36465555179,-16,770,620,-20
36465943078,36465943084,6,2668,1660,-20
36467094958,36467094962,4,1516,1641,-20
36470398418,36470398417,-1,808,1362,-20
36471584741,36471584744,3,1663,1450,-20
36472354616,36472354619,3,1521,1112,-20
36474342505,36474342506,1,1542,1012,-20
36475794009,36475794011,2,1102,1000,-20
36477367562,36477367566,4,2066,1110,-20
36479889006,36479889009,3,1015,1604,-20
36489832779,36489832781,2,1799,1882,-20
36490288651,36490288655,4,2465,1682,-20
36493022995,36493022998,3,1540,1488,-20
36493573693,36493573697,4,1265,892,-20
36495655401,36495655403,2,1603,1327,-20
36496408789,36496408793,4,1883,1586,-20
36500155531,36500155534,3,2792,2110,-20
36501169710,36501169713,3,2094,1669,-20
36504049227,36504049232,5,2172,1194,-20
36504680309,36504680306,-3,1592,3664,-20
36504735910,36504735918,8,1990,1114,-20
36514403433,36514403435,2,1768,1329,-20
36516099549,36516099553,4,2225,1552,-20
36518472391,36518472390,-1,1467,1656,-20
36520712779,36520712777,-2,1910,4549,-20
36521530565,36521530567,2,1151,958,-20
36522070770,36522070774,4,2215,1783,-20
36523796777,36523796780,3,2781,1376,-20
36527194789,36527194794,5,2049,1033,-20
36528955903,36528955907,4,1708,1669,-20
36529676963,36529676966,3,1504,2142,-20
36532041367,36532041373,6,2329,1163,-20
36537224507,36537224506,-1,830,1169,-20
36538126297,36538126305,8,2216,1746,-20
36539342569,36539342572,3,1638,1922,-20
36542677650,36542677651,1,1380,1202,-20
36543089565,36543089569,4,2065,1633,-20
36545018215,36545018219,4,1467,1593,-20
36545531263,36545531265,2,1474,1063,-20
36547524741,36547524743,2,1217,1464,-20
36549948503,36549948507,4,2050,1611,-20
36551106054,36551106050,-4,624,2096,-20
36551256501,36551256502,1,1786,1431,-20
36561012723,36561012725,2,2328,1408,-20
36562488430,36562488437,7,11724,26145,-20
36563510602,36563510607,5,2559,1562,-20
36565362301,36565362303,2,1955,1521,-20
36572164662,36572164663,1,1639,1255,-20
36573781033,36573781037,4,2306,1629,-20
36574988515,36574988517,2,2074,1274,-20
36575135966,36575135945,-21,1302,629,-20
36578059365,36578059367,2,1732,1653,-20
36578807297,36578807302,5,1984,1685,-20
36579066878,36579066883,5,2698,1664,-20
36579676788,36579676790,2,1554,1411,-20
36581612947,36581612948,1,1858,1712,-20
36581699630,36581699634,4,2086,1713,-20
36581740202,36581740207,5,2448,1420,-20
36584839079,36584839079,0,2269,3412,-20
36585619914,36585619917,3,2074,1534,-20
36590116705,36590116711,6,2021,1104,-20
36590650835,36590650829,-6,2552,7116,-20
36591301745,36591301750,5,1256,992,-20
36593474091,36593474094,3,2268,1590,-20
36594307183,36594307187,4,1773,1408,-20
36598916431,36598916434,3,1767,1452,-20
36599416463,36599416462,-1,2813,4638,-20
36600152026,36600152029,3,2024,994,-20
36600285602,36600285587,-15,1896,1190,-20
36601287312,36601287316,4,2803,1817,-20
36603821042,36603821046,4,1570,906,-20
36606287397,36606287398,1,1890,1554,-20
36610812926,36610812926,0,6038,7190,-20
36611778225,36611778228,3,1708,1513,-20
36613008401,36613008403,2,1245,1367,-20
36613304362,36613304363,1,943,801,-20
36614297952,36614297950,-2,2046,2912,-20
36616223145,36616223147,2,1536,1447,-20
36616885039,36616885043,4,1860,1336,-20
36617912739,36617912743,4,989,870,-20
36620623457,36620623459,2,1106,1302,-20
36620763562,36620763544,-18,1549,1003,-20
36625618467,36625618470,3,1781,1547,-20
36626526361,36626526364,3,2554,1606,-20
36629176407,36629176413,6,1382,681,-20
36630193703,36630193681,-22,1601,888,-20
36631221956,36631221959,3,1891,867,-20
36633367400,36633367404,4,2579,1578,-20
36634539094,36634539097,3,1489,932,-20
36634583513,36634583523,10,1070,1208,-20
36636897794,36636897798,4,2400,2114,-20
36637825499,36637825503,4,870,1010,-20
36640717901,36640717906,5,1850,1884,-20
36641858196,36641858200,4,1806,1067,-20
36643121926,36643121930,4,2152,1579,-20
36644092178,36644092174,-4,1324,1667,-20
36645482755,36645482758,3,1420,872,-20
36646036735,36646036737,2,2322,1178,-20
36648579656,36648579654,-2,2485,4313,-20
36648657126,36648657127,1,1937,1363,-20
36648761106,36648761109,3,1118,1166,-20
36649079341,36649079322,-19,2284,1539,-20
36650237789,36650237793,4,1837,1170,-20
36652781085,36652781085,0,1436,1145,-20
36653558526,36653558529,3,1886,1314,-20
36653941311,36653941315,4,1653,1134,-20
36655882789,36655882793,4,1342,1097,-20
36659230604,36659230616,12,1231,813,-20
36660399169,36660399152,-17,807,199,-20
36662180975,36662180973,-2,1308,2494,-20
36664717086,36664717090,4,35705,51438,-20
36666909743,36666909746,3,2069,1678,-20
36671708742,36671708748,6,1747,1387,-20
36673752469,36673752474,5,1896,1261,-20
36679726427,36679726430,3,1855,1942,-20
36683180607,36683180609,2,1249,1137,-20
36684778362,36684778365,3,1551,1063,-20
36689591433,36689591436,3,1809,1441,-20
36690449223,36690449225,2,1795,1730,-20
36691069518,36691069522,4,1518,1569,-20
36691746167,36691746171,4,1758,1475,-20
36692257764,36692257767,3,1746,1423,-20
36692947990,36692947990,0,847,1463,-20
36696632602,36696632610,8,1920,1374,-20
36697149870,36697149873,3,1741,1380,-20
36698718203,36698718206,3,1360,1635,-20
36701829492,36701829495,3,1635,1445,-20
36706858942,36706858945,3,1665,1166,-20
36709924066,36709924067,1,1747,1673,-20
36713801958,36713801955,-3,1017,2022,-20
36714278162,36714278165,3,1826,1223,-20
36717248289,36717248293,4,1700,1625,-20
36718460894,36718460898,4,1248,1427,-20
36727380379,36727380391,12,340,1436,-20
36728369625,36728369629,4,1871,1761,-20
36734290683,36734290688,5,3016,1815,-20
36736717802,36736717806,4,2106,1148,-20
36741426958,36741426940,-18,1744,1241,-20
36742676805,36742676810,5,1216,1564,-20
36742814361,36742814366,5,1747,1335,-20
36742857878,36742857882,4,2527,1846,-20
36745711967,36745711974,7,2242,1705,-20
36746220370,36746220373,3,1891,1437,-20
36746794798,36746794811,13,1477,1212,-20
36751809158,36751809160,2,10789,10663,-20
36753361662,36753361665,3,1541,1613,-20
36756299392,36756299395,3,1168,1092,-20
36756611253,36756611256,3,1452,1551,-20
36764474126,36764474127,1,1568,1412,-20
36764749449,36764749450,1,1650,985,-20
36765371877,36765371881,4,2662,1580,-20
36768299650,36768299655,5,1833,1459,-20
36768640994,36768641000,6,469,736,-20
36776096391,36776096394,3,1949,1637,-20
36777294116,36777294119,3,3283,3372,-20
36780962264,36780962266,2,1295,1166,-20
36782524834,36782524837,3,1966,1643,-20
36783985149,36783985151,2,1172,955,-20
36785864606,36785864610,4,1907,1627,-20
36786099186,36786099190,4,1759,1331,-20
36790595840,36790595844,4,2231,1416,-20
36791831793,36791831794,1,2146,2654,-20
36792031485,36792031488,3,1682,1598,-20
36792407454,36792407457,3,1800,1658,-20
36794360341,36794360343,2,2074,1752,-20
36799432194,36799432198,4,2292,1501,-20
36800027893,36800027914,21,1156,1382,-20
36801570181,36801570183,2,1424,1192,-20
36806300987,36806300991,4,1765,1003,-20
36813780749,36813780746,-3,35044,10756,-20
36814999399,36814999404,5,1690,1447,-20
36820511472,36820511474,2,1992,1841,-20
36824052305,36824052309,4,1705,1399,-20
36826349102,36826349105,3,2011,1731,-20
36826629073,36826629075,2,1007,1197,-20
36829058294,36829058297,3,2348,1966,-20
36830361477,36830361480,3,1851,1491,-20
36831561916,36831561919,3,1785,1251,-20
36834666851,36834666855,4,3154,1961,-20
36837705053,36837705058,5,1592,1225,-20
36840053113,36840053118,5,1829,1723,-20
36840090509,36840090510,1,1537,1551,-20
36840220653,36840220658,5,1315,1409,-20
36841889630,36841889634,4,1551,1438,-20
36844673469,36844673470,1,1437,1741,-20
36845609918,36845609922,4,1506,1723,-20
36848614978,36848614982,4,1868,1322,-20
36849917512,36849917517,5,2276,1446,-20
36853718298,36853718303,5,1874,1327,-20
36855692057,36855692063,6,3547,1716,-20
36855950044,36855950046,2,3090,2357,-20
36858477001,36858476999,-2,2621,4363,-20
36860363409,36860363414,5,2136,1024,-20
36863030277,36863030279,2,1560,1305,-20
36865464526,36865464529,3,934,876,-20
36865689119,36865689121,2,1925,1756,-20
36868051993,36868051995,2,1576,1112,-20
36869723166,36869723171,5,2591,1303,-20
36875079574,36875079575,1,1636,1489,-20
36875253230,36875253234,4,1686,1375,-20
36875334165,36875334167,2,1670,1264,-20
36877124254,36877124257,3,2227,1417,-20
36878590897,36878590903,6,8353,2628,-20
36881033197,36881033200,3,1683,1819,-20
36883632699,36883632702,3,1749,975,-20
36885360514,36885360518,4,1085,882,-20
36891160168,36891160171,3,2507,2022,-20
36891847992,36891847995,3,1924,1257,-20
36894623394,36894623399,5,2485,1740,-20
36894696097,36894696102,5,2821,1637,-20
36897596332,36897596332,0,1697,1818,-20
36898043901,36898043903,2,1172,731,-20
36900595781,36900595783,2,2240,1200,-20
36901086562,36901086564,2,1355,895,-20
36902827771,36902827775,4,1536,1011,-20
36904894326,36904894330,4,1912,1474,-20
36905772614,36905772619,5,1972,1548,-20
36910959602,36910959606,4,1773,1273,-20
36911448414,36911448419,5,1835,1154,-20
36916430579,36916430585,6,1868,1501,-20
36916499530,36916499535,5,2452,1196,-20
36917530933,36917530936,3,2187,1656,-20
36921464262,36921464265,3,1898,1450,-20
36921513975,36921513979,4,1215,1075,-20
36922256757,36922256759,2,2012,1481,-20
36922800525,36922800531,6,1681,1103,-20
36929408939,36929408937,-2,1648,1610,-20
36931387726,36931387730,4,1980,1507,-20
36932617954,36932617957,3,1340,1048,-20
36934094642,36934094646,4,1298,1398,-20
36934388699,36934388699,0,1128,2312,-20
36935025331,36935025334,3,1527,1474,-20
36935339484,36935339467,-17,1944,1743,-20
36937543582,36937543583,1,1325,1561,-20
36941814586,36941814591,5,2626,905,-20
36943413930,36943413935,5,1770,1048,-20
36947506385,36947506388,3,1634,1468,-20
36947708797,36947708803,6,1548,1242,-20
36955240066,36955240071,5,1128,1124,-20
36959191398,36959191401,3,2218,1600,-20
36959515828,36959515831,3,2213,1460,-20
36961583554,36961583558,4,1012,931,-20
36963189537,36963189539,2,1546,1108,-20
36963787269,36963787256,-13,549,290,-20
36966998564,36966998568,4,2413,1356,-20
36967651764,36967651765,1,986,1488,-20
36967882522,36967882525,3,2159,1651,-20
36974985667,36974985670,3,1849,1527,-20
36977312625,36977312626,1,1678,1719,-20
36981505074,36981505077,3,1594,1486,-20
36986419978,36986419982,4,2091,1296,-20
36992282684,36992282686,2,2233,1584,-20
36994071480,36994071474,-6,490,2873,-20
37000813539,37000813540,1,2186,3046,-20
37004994992,37004994996,4,2459,1717,-20
37010392907,37010392907,0,940,1350,-20
37011401908,37011401911,3,2604,1680,-20
37013251481,37013251484,3,2137,1760,-20
37013364391,37013364395,4,1683,1708,-20
37014186181,37014186193,12,394,2470,-20
37014559358,37014559362,4,2426,1982,-20
37018720017,37018720022,5,2107,1179,-20
37020040906,37020040910,4,1952,1307,-20
37021132598,37021132602,4,1900,1602,-20
37021179828,37021179809,-19,1501,1471,-20
37021291834,37021291837,3,1512,1349,-20
37023066894,37023066895,1,830,1043,-20
37023903417,37023903420,3,2111,1471,-20
37024695039,37024695058,19,1748,1349,-20
37024906734,37024906712,-22,1736,1100,-20
37025578722,37025578727,5,1445,1263,-20
37029142575,37029142578,3,2540,1668,-20
37030097565,37030097569,4,2297,931,-20
37032023242,37032023245,3,47077,84243,-20
37032051627,37032051633,6,2316,1580,-20
37033480165,37033480167,2,2023,1157,-20
37035044373,37035044376,3,1838,1207,-20
37035148998,37035148995,-3,1364,2524,-20
37042702325,37042702331,6,1434,1011,-20
37042996561,37042996564,3,1484,1234,-20
37043266317,37043266319,2,2389,2035,-20
37043723362,37043723367,5,2550,1870,-20
37044662456,37044662445,-11,1428,1474,-20
37047205534,37047205537,3,2245,1314,-20
37047887694,37047887693,-1,1501,2302,-20
37051107217,37051107220,3,2371,2192,-20
37052178671,37052178675,4,282,8816,-20
37057411161,37057411164,3,2107,2418,-20
37059555158,37059555166,8,4426,1630,-20
37063751602,37063751607,5,1326,963,-20
37068413950,37068413953,3,1017,1043,-20
37069632654,37069632635,-19,960,627,-20
37073191916,37073191918,2,2405,1485,-20
37077585574,37077585576,2,1228,1159,-20
37084941811,37084941810,-1,1981,3681,-20
37088384559,37088384562,3,1463,1051,-20
37089361170,37089361172,2,1195,855,-20
37098432330,37098432334,4,2160,1316,-20
37100241983,37100241987,4,1249,1187,-20
37105254732,37105254735,3,2105,1739,-20
37106311410,37106311411,1,1458,1118,-20
37107810213,37107810216,3,2553,1324,-20
37115830346,37115830350,4,2633,1515,-20
37115906590,37115906593,3,1765,1155,-20
37119319510,37119319514,4,1591,1109,-20
37121275545,37121275549,4,2566,920,-20
37121715492,37121715495,3,1200,1154,-20
37124530655,37124530659,4,1545,1481,-20
37126814971,37126814974,3,2161,1561,-20
37129799157,37129799160,3,1739,1510,-20
37130730390,37130730392,2,1302,1207,-20
37131012660,37131012663,3,2432,1024,-20
37133588439,37133588442,3,2048,1015,-20
37134938399,37134938403,4,1929,1184,-20
37142255802,37142255805,3,1537,1462,-20
37143910007,37143910025,18,1047,1178,-20
37144059075,37144059079,4,1414,1166,-20
37145411602,37145411604,2,2884,1720,-20
37148425462,37148425465,3,1254,1519,-20
37149388925,37149388928,3,2241,2020,-20
37151214726,37151214731,5,1594,979,-20
37155855070,37155855074,4,1978,1165,-20
37156380818,37156380822,4,2440,1234,-20
37156409757,37156409740,-17,936,573,-20
37156585937,37156585931,-6,1293,1205,-20
37158674587,37158674594,7,2642,1453,-20
37163535236,37163535239,3,1268,1774,-20
37164673622,37164673622,0,1274,1864,-20
37166818310,37166818315,5,1537,917,-20
37168264713,37168264715,2,2155,1316,-20
37168843660,37168843662,2,1467,1440,-20
37170420865,37170420865,0,1308,1801,-20
37173676854,37173676859,5,2396,1223,-20
37179558420,37179558425,5,2135,1845,-20
37183136382,37183136387,5,2844,1775,-20
37187069682,37187069686,4,2125,1808,-20
37189287165,37189287169,4,2895,1610,-20
37190035083,37190035088,5,1432,1054,-20
37195697153,37195697155,2,2178,1438,-20
37206777363,37206777366,3,1428,1198,-20
37211720077,37211720083,6,2452,1237,-20
37217981972,37217981974,2,1523,1065,-20
37218348673,37218348674,1,1845,1165,-20
37219430475,37219430478,3,2679,1317,-20
37219455724,37219455718,-6,1876,7339,-20
37221306117,37221306116,-1,1603,1679,-20
37222175593,37222175594,1,1137,1701,-20
37223523374,37223523378,4,1616,1288,-20
37224012750,37224012755,5,1570,1271,-20
37224132427,37224132430,3,1713,1416,-20
37224853073,37224853076,3,1914,1642,-20
37225478602,37225478609,7,2343,1919,-20
37229276574,37229276580,6,1760,1128,-20
37231553550,37231553555,5,2377,1894,-20
37231687318,37231687319,1,1486,1319,-20
37233647549,37233647552,3,2825,1765,-20
37234586309,37234586313,4,2381,1272,-20
37239016376,37239016378,2,1106,1211,-20
37240863880,37240863883,3,1715,1291,-20
37245562706,37245562710,4,1818,1693,-20
37247457776,37247457780,4,1962,1144,-20
37248041022,37248041002,-20,1783,1230,-20
37251796347,37251796349,2,1921,1652,-20
37252040943,37252040945,2,1888,1854,-20
37253576040,37253576042,2,1724,1180,-20
37255976474,37255976479,5,1302,857,-20
37260700337,37260700344,7,14019,36395,-20
37264432200,37264432203,3,1273,1307,-20
37264521873,37264521874,1,1120,1124,-20
37265954272,37265954278,6,2410,1831,-20
37266610762,37266610766,4,1559,1289,-20
37266983430,37266983412,-18,1447,803,-20
37268221326,37268221331,5,2641,1994,-20
37270357111,37270357121,10,13488,43027,-20
37270738386,37270738388,2,1889,1588,-20
37272527413,37272527413,0,14428,18936,-20
37272905242,37272905245,3,1720,1706,-20
37273890338,37273890342,4,1048,962,-20
37281183556,37281183559,3,1692,1230,-20
37286680214,37286680218,4,2537,1827,-20
37286764977,37286764981,4,1392,1577,-20
37289856627,37289856630,3,1651,1332,-20
37299647599,37299647601,2,2172,2089,-20
37303267341,37303267343,2,1808,1049,-20
37304313573,37304313574,1,1957,2244,-20
37306920677,37306920659,-18,1916,1241,-20
37308808032,37308808037,5,1919,877,-20
37311388010,37311388015,5,1686,1040,-20
37313753699,37313753701,2,1049,1655,-20
37315422950,37315422950,0,1127,1294,-20
37315647015,37315647018,3,1922,1293,-20
37318117117,37318117123,6,1545,1212,-20
37324428077,37324428073,-4,1607,4011,-20
37324497370,37324497371,1,1816,1796,-20
37326377721,37326377726,5,2440,1729,-20
37329871339,37329871342,3,1396,1471,-20
37330673886,37330673893,7,1799,1381,-20
37331481458,37331481464,6,2175,1357,-20
37332675734,37332675737,3,1657,1523,-20
37333008614,37333008618,4,1946,864,-20
37333429991,37333429997,6,1459,1614,-20
37338596292,37338596295,3,1731,1352,-20
37338707682,37338707687,5,2539,1686,-20
37339116211,37339116213,2,1483,1504,-20
37340272978,37340272982,4,2412,1797,-20
37342547257,37342547259,2,1798,1207,-20
37343466574,37343466578,4,987,550,-20
37344487643,37344487647,4,1586,1467,-20
37346204970,37346204970,0,1821,2441,-20
37346268257,37346268240,-17,1697,949,-20
37347225353,37347225357,4,1641,1378,-20
37352466262,37352466264,2,1778,1104,-20
37353797413,37353797415,2,1526,1439,-20
37354812803,37354812807,4,1124,903,-20
37356632794,37356632798,4,1290,1403,-20
37358894995,37358894998,3,1159,775,-20
37362441153,37362441156,3,1878,1486,-20
37362787238,37362787259,21,1850,1413,-20
37363349295,37363349297,2,1338,855,-20
37364380002,37364379999,-3,586,1252,-20
37365738021,37365738020,-1,252,2384,-20
37370534997,37370535002,5,1838,1286,-20
37372101734,37372101737,3,1759,1394,-20
37377916821,37377916822,1,1832,1241,-20
37380055746,37380055749,3,1509,1729,-20
37380578249,37380578252,3,1757,1605,-20
37383221198,37383221179,-19,1517,1443,-20
37385041757,37385041759,2,1558,1930,-20
37389229834,37389229838,4,1794,1341,-20
37391505987,37391505991,4,1982,2117,-20
37392496074,37392496078,4,2032,1249,-20
37393263522,37393263526,4,1152,1480,-20
37395100550,37395100554,4,2287,1389,-20
37406915482,37406915486,4,1917,1233,-20
37409783038,37409783042,4,1413,1566,-20
37410026704,37410026705,1,2321,1551,-20
37411981360,37411981364,4,1793,1538,-20
37413814903,37413814908,5,1647,1758,-20
37414845490,37414845495,5,1827,1160,-20
37415137014,37415137018,4,1359,992,-20
37417005232,37417005234,2,2700,1812,-20
37419862939,37419862920,-19,1241,748,-20
37421062723,37421062726,3,1440,1201,-20
37423893629,37423893632,3,2581,1621,-20
37424646167,37424646172,5,1210,1238,-20
37426987846,37426987849,3,2315,1701,-20
37428337565,37428337567,2,479,422,-20
37428433148,37428433148,0,1507,1646,-20
37435699909,37435699916,7,1970,894,-20
37436325815,37436325818,3,2890,1728,-20
37438519475,37438519480,5,1979,1221,-20
37441069327,37441069330,3,1934,1892,-20
37442215345,37442215346,1,1658,1162,-20
37449491626,37449491629,3,1832,1699,-20
37452832676,37452832680,4,2118,1411,-20
37454579279,37454579281,2,1690,2014,-20
37455273684,37455273690,6,2511,1234,-20
37455523646,37455523649,3,1720,1406,-20
37456097743,37456097747,4,1769,1046,-20
37456880522,37456880525,3,2015,1535,-20
37457465141,37457465143,2,2067,2254,-20
37457946471,37457946463,-8,21377,12369,-20
37462154911,37462154914,3,1638,1557,-20
37462777921,37462777925,4,1969,1121,-20
37464566942,37464566943,1,2250,1855,-20
37466181795,37466181798,3,729,758,-20
37470690926,37470690928,2,1817,1080,-20
37471043917,37471043920,3,2155,1189,-20
37471392667,37471392670,3,1761,1329,-20
37472554546,37472554549,3,1436,1382,-20
37473319624,37473319628,4,1200,815,-20
37475086746,37475086751,5,2238,1103,-20
37478921791,37478921795,4,2192,1374,-20
37479724096,37479724098,2,1832,1967,-20
37479870266,37479870269,3,1704,1338,-20
37483200514,37483200517,3,2280,1798,-20
37483525504,37483525506,2,1883,1197,-20
37486397686,37486397691,5,1826,1117,-20
37486861438,37486861441,3,1616,1330,-20
37486891330,37486891331,1,1663,1970,-20
37490329430,37490329433,3,1486,1214,-20
37491842945,37491842950,5,1811,1567,-20
37495520815,37495520817,2,1769,979,-20
37497729630,37497729633,3,1955,1661,-20
37498850850,37498850850,0,1714,1904,-20
37499054415,37499054418,3,1864,1503,-20
37499510302,37499510308,6,2554,1691,-20
37499969123,37499969123,0,1904,2250,-20
37501489262,37501489263,1,1957,1622,-20
37501874258,37501874261,3,1791,1719,-20
37502075432,37502075438,6,2603,868,-20
37503373319,37503373323,4,2196,1187,-20
37505230075,37505230079,4,2322,1526,-20
37505511139,37505511142,3,1493,1038,-20
37506710970,37506710978,8,6341,1512,-20
37507290384,37507290389,5,2214,1723,-20
37510796620,37510796622,2,1635,1065,-20
37515654446,37515654434,-12,1586,1116,-20
37518882956,37518882941,-15,403,1726,-20
37521067072,37521067091,19,1638,2653,-20
37522209798,37522209799,1,1480,1361,-20
37522608193,37522608193,0,1283,1310,-20
37528309035,37528309037,2,1805,1906,-20
37539143782,37539143763,-19,1997,2207,-20
37540002482,37540002486,4,1889,844,-20
37542893200,37542893203,3,864,711,-20
37544731367,37544731371,4,1570,1219,-20
37546290983,37546290987,4,1535,1196,-20
37546451154,37546451159,5,1601,1173,-20
37548310664,37548310668,4,1872,1162,-20
37550632155,37550632158,3,2394,995,-20
37551066379,37551066384,5,2334,1775,-20
37556806725,37556806727,2,1577,1374,-20
37558332822,37558332804,-18,1597,1356,-20
37558983254,37558983254,0,1664,896,-20
37559124542,37559124548,6,3163,1469,-20
37560321921,37560321925,4,827,684,-20
37563856253,37563856255,2,1690,1745,-20
37569716946,37569716949,3,1403,1387,-20
37571153687,37571153691,4,1411,1212,-20
37578311490,37578311494,4,1142,1235,-20
37580723297,37580723299,2,1835,1678,-20
37581280534,37581280537,3,1766,1438,-20
37582138165,37582138170,5,1864,1108,-20
37583854334,37583854338,4,1638,1304,-20
37585947522,37585947504,-18,997,4761,-20
37588857943,37588857946,3,1004,1026,-20
37590872639,37590872637,-2,1204,2353,-20
37591593039,37591593043,4,2142,1487,-20
37593281355,37593281359,4,2098,1777,-20
37597316622,37597316625,3,2125,1419,-20
37597853879,37597853881,2,1716,1857,-20
37600919814,37600919818,4,2294,1569,-20
37603970364,37603970365,1,1602,1588,-20
37606394585,37606394589,4,2044,1134,-20
37606508143,37606508147,4,1010,1017,-20
37608308973,37608308976,3,2511,1776,-20
37620845171,37620845174,3,1920,1138,-20
37621339583,37621339585,2,1594,1059,-20
37624026658,37624026662,4,1615,1181,-20
37625279019,37625279025,6,1706,1347,-20
37628392333,37628392335,2,1963,1446,-20
37629240734,37629240737,3,1507,1381,-20
37633327114,37633327119,5,2089,1209,-20
37637231312,37637231299,-13,2646,1312,-20
37637339742,37637339747,5,2655,1916,-20
37638100182,37638100186,4,1639,1296,-20
37640523452,37640523455,3,2052,1449,-20
37645476746,37645476749,3,1876,1592,-20
37650186115,37650186112,-3,1193,2471,-20
37650237961,37650237965,4,1664,1184,-20
37650579022,37650579031,9,12391,25645,-20
37654355903,37654355906,3,1835,1821,-20
37655528511,37655528516,5,1498,1184,-20
37656035622,37656035626,4,2664,1196,-20
37662875894,37662875898,4,1460,1663,-20
37663541393,37663541394,1,1507,1851,-20
37664222878,37664222882,4,2256,1237,-20
37664390277,37664390283,6,1228,1175,-20
37665250140,37665250144,4,1807,1602,-20
37666234107,37666234111,4,1789,783,-20
37666515807,37666515810,3,2144,1520,-20
37668712953,37668712951,-2,29936,45489,-20
37669796531,37669796537,6,2188,1528,-20
37671360721,37671360726,5,2271,1467,-20
37671965190,37671965194,4,1384,986,-20
37672481415,37672481420,5,1924,1700,-20
37674090597,37674090598,1,1764,1331,-20
37674878503,37674878503,0,1547,1364,-20
37680550915,37680550910,-5,2191,5436,-20
37681915678,37681915682,4,1709,1097,-20
37683115383,37683115385,2,1985,1718,-20
37683388473,37683388476,3,2555,1564,-20
37683552417,37683552422,5,2334,1884,-20
37687971685,37687971687,2,2072,1934,-20
37693517454,37693517458,4,2631,1577,-20
37698502392,37698502394,2,1264,1791,-20
37698702806,37698702811,5,3317,1668,-20
37698934792,37698934798,6,1998,980,-20
37699253647,37699253651,4,1182,886,-20
37699790396,37699790397,1,1458,1929,-20
37701762387,37701762390,3,1679,1472,-20
37702525847,37702525852,5,2123,1461,-20
37705951914,37705951919,5,2188,1329,-20
37710104965,37710104967,2,1112,1100,-20
37716113008,37716113014,6,1821,1851,-20
37717672994,37717672998,4,248,968,-20
37719339098,37719339099,1,1400,2017,-20
37720626975,37720626977,2,1670,1432,-20
37721181947,37721181952,5,1733,1116,-20
37722681515,37722681518,3,1723,1513,-20
37723179338,37723179341,3,1390,1627,-20
37723855687,37723855689,2,1880,1420,-20
37724408975,37724408978,3,1216,961,-20
37725732473,37725732476,3,1301,1245,-20
37728081495,37728081500,5,1961,1213,-20
37728399161,37728399164,3,2484,1491,-20
37728998793,37728998799,6,2986,1501,-20
37734544085,37734544090,5,2052,1149,-20
37736332195,37736332197,2,1295,1096,-20
37738005343,37738005347,4,1710,1362,-20
37739257870,37739257874,4,2455,1689,-20
37739949712,37739949715,3,1733,1117,-20
37740223038,37740223043,5,2726,1420,-20
37741701519,37741701522,3,1666,1282,-20
37743430311,37743430314,3,1487,1415,-20
37744834128,37744834126,-2,955,1880,-20
37745154971,37745154973,2,2142,2436,-20
37746130813,37746130817,4,1373,1225,-20
37751282882,37751282885,3,1721,1408,-20
37752155585,37752155590,5,1934,1809,-20
37752607060,37752607063,3,1754,1380,-20
37754302687,37754302691,4,1946,1239,-20
37756956601,37756956603,2,2672,2037,-20
37758147769,37758147771,2,1898,1696,-20
37758292776,37758292781,5,1183,1159,-20
37759200099,37759200102,3,2210,1595,-20
37761405750,37761405755,5,1649,1684,-20
37762261157,37762261136,-21,1625,1031,-20
37764015458,37764015462,4,1661,1186,-20
37765393572,37765393575,3,1876,1173,-20
37767002693,37767002698,5,2360,1380,-20
37767994375,37767994371,-4,1519,2779,-20
37771069257,37771069251,-6,2631,7605,-20
37772254937,37772254937,0,1096,981,-20
37772460069,37772460071,2,2176,1155,-20
37772882688,37772882690,2,2243,1511,-20
37773275735,37773275739,4,3208,1800,-20
37781661621,37781661623,2,1465,1006,-20
37789989071,37789989066,-5,4681,15092,-20
37793497834,37793497838,4,1734,1769,-20
37794333792,37794333794,2,1468,1487,-20
37797572722,37797572727,5,2026,1272,-20
37798615593,37798615595,2,1735,1480,-20
37802914198,37802914201,3,1309,1028,-20
37803043763,37803043762,-1,1159,1479,-20
37803291239,37803291243,4,2405,1893,-20
37804722766,37804722770,4,2001,1649,-20
37806847951,37806847954,3,1744,1664,-20
37807320163,37807320167,4,1359,1063,-20
37814374959,37814374964,5,2145,1674,-20
37814903092,37814903097,5,1679,1163,-20
37816309158,37816309157,-1,917,1387,-20
37822619699,37822619702,3,1507,1635,-20
37824144409,37824144412,3,1159,1130,-20
37828260241,37828260242,1,1745,1051,-20
37832968279,37832968282,3,1572,1565,-20
37834230245,37834230247,2,2089,1190,-20
37835905346,37835905349,3,2344,1876,-20
37837657007,37837657011,4,2113,1436,-20
37838048601,37838048605,4,2326,1748,-20
37844043777,37844043777,0,963,1597,-20
37845770142,37845770146,4,1994,1547,-20
37846544428,37846544434,6,1576,980,-20
37851900890,37851900891,1,1881,1777,-20
37852596776,37852596778,2,1854,1142,-20
37857996258,37857996261,3,1461,1707,-20
37862640319,37862640323,4,1814,1344,-20
37862790389,37862790391,2,1367,1041,-20
37864007357,37864007355,-2,1608,2202,-20
37865585685,37865585688,3,1679,1156,-20
37873781474,37873781479,5,2418,1264,-20
37874176887,37874176906,19,49071,4090,-20
37875172274,37875172279,5,1944,1647,-20
37877428621,37877428622,1,1409,1500,-20
37877874722,37877874729,7,2255,1314,-20
37879970465,37879970466,1,2378,1436,-20
37881603258,37881603258,0,1750,1409,-20
37882017253,37882017260,7,1822,1324,-20
37889113666,37889113669,3,1663,1756,-20
37890308254,37890308259,5,2363,1378,-20
37891648751,37891648763,12,10654,38668,-20
37891892700,37891892702,2,2032,1397,-20
37892849530,37892849536,6,2605,1706,-20
37894046357,37894046360,3,1989,1783,-20
37895827273,37895827274,1,1414,1083,-20
37897777258,37897777261,3,2507,1835,-20
37903105393,37903105397,4,2053,1764,-20
37906654213,37906654217,4,1460,1553,-20
37908318257,37908318261,4,2853,1758,-20
37911248930,37911248934,4,2325,1085,-20
37911896494,37911896498,4,2381,1219,-20
37913457942,37913457945,3,1673,1078,-20
37916433968,37916433970,2,1753,1637,-20
37917921497,37917921502,5,2399,1481,-20
37919581707,37919581714,7,1823,1653,-20
37919787186,37919787189,3,1956,1358,-20
37927940879,37927940882,3,2021,1577,-20
37930619525,37930619528,3,1619,1258,-20
37931292734,37931292733,-1,1119,1634,-20
37933953570,37933953570,0,2266,1540,-20
37934409519,37934409499,-20,2956,652,-20
37934628522,37934628529,7,2190,1957,-20
37936335597,37936335594,-3,1122,2887,-20
37937325545,37937325541,-4,1879,3847,-20
37939045731,37939045735,4,2522,1722,-20
37939139476,37939139479,3,2723,2146,-20
37941182712,37941182715,3,2170,1649,-20
37941669222,37941669223,1,1144,1041,-20
37942073719,37942073722,3,1164,1661,-20
37946079689,37946079688,-1,1490,2769,-20
37946615792,37946615794,2,1680,1249,-20
37948830638,37948830641,3,1903,1881,-20
37949278886,37949278887,1,2117,1694,-20
37956690699,37956690702,3,1750,1253,-20
37956904932,37956904934,2,1492,1270,-20
37957460165,37957460169,4,1518,1347,-20
37960864220,37960864223,3,2089,1914,-20
37962116946,37962116947,1,1896,2240,-20
37964998443,37964998446,3,937,1480,-20
37968846501,37968846502,1,1937,1693,-20
37971461310,37971461314,4,1249,1240,-20
37972736575,37972736577,2,1435,1334,-20
37974714266,37974714270,4,1743,1083,-20
37977997405,37977997409,4,1966,1568,-20
37978126406,37978126410,4,983,226,-20
37979115994,37979115998,4,1973,1203,-20
37986363031,37986363027,-4,39523,14516,-20
37990124755,37990124758,3,1870,1438,-20
37991472377,37991472380,3,1471,1705,-20
37994973390,37994973394,4,1600,1171,-20
38001679823,38001679827,4,1879,1255,-20
38003805237,38003805240,3,1601,1337,-20
38005102082,38005102083,1,1227,1395,-20
38006992536,38006992518,-18,1998,1169,-20
38008828139,38008828139,0,1690,1308,-20
38009592662,38009592666,4,1537,926,-20
38011926257,38011926240,-17,933,555,-20
38012600701,38012600704,3,2481,1593,-20
38013372209,38013372213,4,1804,1692,-20
38014051519,38014051524,5,1873,1620,-20
38015385906,38015385911,5,1415,921,-20
38021022524,38021022527,3,1520,1161,-20
38022676353,38022676353,0,11943,16779,-20
38023800101,38023800104,3,2167,1404,-20
38024911192,38024911194,2,1011,1667,-20
38030067654,38030067659,5,1347,1151,-20
38032656246,38032656253,7,1280,880,-20
38032939011,38032939014,3,1786,1609,-20
38033905398,38033905417,19,1993,1187,-20
38036401542,38036401546,4,1729,1265,-20
38044293318,38044293322,4,1825,862,-20
38045951378,38045951363,-15,1889,887,-20
38048087168,38048087171,3,1612,1367,-20
38048632704,38048632709,5,2174,1567,-20
38055515547,38055515550,3,1432,942,-20
38059118789,38059118791,2,1456,1303,-20
38061748505,38061748508,3,2514,1233,-20
38072338587,38072338603,16,6258,1590,-20
38072803579,38072803587,8,1999,1001,-20
38073002000,38073002002,2,1570,978,-20
38074757669,38074757672,3,1487,1771,-20
38075688955,38075688955,0,1481,1476,-20
38077672927,38077672937,10,3975,1307,-20
38079214510,38079214513,3,1428,1431,-20
38083440621,38083440626,5,1267,1131,-20
38084027929,38084027931,2,1495,1043,-20
38084380341,38084380342,1,2586,1391,-20
38090116877,38090116880,3,1312,885,-20
38090404016,38090404021,5,2191,1515,-20
38093895921,38093895924,3,1860,1835,-20
38095184372,38095184368,-4,1468,3942,-20
38099345361,38099345367,6,2524,1446,-20
38101142967,38101142969,2,1694,949,-20
38111511353,38111511349,-4,1531,2236,-20
38113011191,38113011194,3,2385,1345,-20
38114543282,38114543285,3,1690,1536,-20
38115257622,38115257628,6,2797,1659,-20
38118976178,38118976182,4,1573,1487,-20
38120529263,38120529266,3,1763,1281,-20
38121852676,38121852681,5,1504,1601,-20
38126446213,38126446215,2,1245,774,-20
38139284085,38139284089,4,2453,1328,-20
38142635937,38142635939,2,1706,1358,-20
38144751439,38144751442,3,2019,1367,-20
38146205322,38146205328,6,2115,1748,-20
38148115391,38148115394,3,1836,1638,-20
38148343058,38148343061,3,1817,1208,-20
38149222350,38149222354,4,1728,1536,-20
38149861566,38149861571,5,1529,1199,-20
38150620875,38150620894,19,471,1423,-20
38151117112,38151117115,3,1841,1763,-20
38151231102,38151231101,-1,1889,4135,-20
38151500767,38151500774,7,2868,1163,-20
38161724290,38161724293,3,2569,1252,-20
38161941175,38161941178,3,1717,1137,-20
38165313436,38165313447,11,29,877,-20
38166917116,38166917119,3,1680,1057,-20
38167232738,38167232741,3,2696,2480,-20
38167681365,38167681367,2,1638,1134,-20
38169640879,38169640887,8,2448,1232,-20
38178583117,38178583122,5,2256,1703,-20
38178985390,38178985394,4,2210,1270,-20
38179205966,38179205969,3,1188,1395,-20
38180203684,38180203691,7,2149,725,-20
38181883139,38181883145,6,2446,1557,-20
38183687989,38183687988,-1,2165,2995,-20
38184674577,38184674579,2,1537,1143,-20
38184797869,38184797871,2,2244,2029,-20
38185875689,38185875693,4,1878,1271,-20
38186234342,38186234345,3,1111,769,-20
38187047534,38187047538,4,1842,877,-20
38188491654,38188491658,4,2228,1626,-20
38189184414,38189184419,5,3252,1626,-20
38189731394,38189731401,7,1958,1454,-20
38197655377,38197655379,2,1604,1884,-20
38197802387,38197802390,3,1709,1426,-20
38198782589,38198782593,4,1875,1218,-20
38200408961,38200408968,7,1690,1492,-20
38201015263,38201015265,2,2116,1743,-20
38201149283,38201149289,6,1531,1356,-20
38202284940,38202284944,4,1231,1928,-20
38202783792,38202783799,7,2797,928,-20
38207381022,38207381026,4,947,944,-20
38209691370,38209691374,4,2025,1470,-20
38211221575,38211221579,4,2174,1399,-20
38211885123,38211885126,3,1213,1421,-20
38213429367,38213429371,4,1961,1856,-20
38215033946,38215033951,5,2105,1342,-20
38215867466,38215867471,5,1967,1021,-20
38216142006,38216142011,5,1313,1170,-20
38219223422,38219223426,4,1986,1394,-20
38220143332,38220143338,6,2017,949,-20
38220390831,38220390833,2,2045,1057,-20
38221317805,38221317809,4,2072,1381,-20
38223394957,38223394960,3,1663,1755,-20
38223482350,38223482354,4,1619,1443,-20
38225714854,38225714858,4,5396,25753,-20
38228543561,38228543565,4,2066,1638,-20
38230535975,38230535979,4,1315,1538,-20
38232225882,38232225886,4,1711,1518,-20
38232644369,38232644370,1,1844,1599,-20
38233879101,38233879097,-4,748,1776,-20
38234243078,38234243082,4,1724,1907,-20
38235069817,38235069821,4,1659,1648,-20
38239106133,38239106139,6,2335,1352,-20
38239717168,38239717167,-1,1906,2603,-20
38242502667,38242502671,4,2019,1334,-20
38243559218,38243559223,5,4855,1682,-20
38244132887,38244132891,4,1884,1276,-20
38247838438,38247838442,4,2204,1451,-20
38247995645,38247995639,-6,24347,9928,-20
38253458609,38253458610,1,1600,1031,-20
38254228290,38254228293,3,973,1092,-20
38259050458,38259050462,4,2568,1661,-20
38259485915,38259485918,3,1843,1334,-20
38259777366,38259777347,-19,1157,1121,-20
38261842155,38261842157,2,3396,2869,-20
38262440133,38262440133,0,1290,913,-20
38263515738,38263515743,5,1759,1505,-20
38264090633,38264090638,5,2045,1499,-20
38265665934,38265665955,21,764,1286,-20
38270960402,38270960403,1,1411,1791,-20
38273667640,38273667647,7,2927,1339,-20
38275916494,38275916496,2,2369,2194,-20
38278772552,38278772557,5,2586,1486,-20
38279370177,38279370182,5,2179,1588,-20
38281970386,38281970390,4,1758,1661,-20
38283788620,38283788625,5,1606,1012,-20
38285740785,38285740788,3,1548,1145,-20
38285859467,38285859470,3,27536,24084,-20
38286828491,38286828494,3,1366,1004,-20
38287192728,38287192731,3,2233,2151,-20
38287456336,38287456340,4,1491,1599,-20
38287810693,38287810694,1,1242,1518,-20
38293156700,38293156702,2,1414,1210,-20
38294443207,38294443209,2,1632,1487,-20
38294885302,38294885314,12,4366,1856,-20
38299469330,38299469333,3,1481,1434,-20
38299746985,38299746986,1,1498,1469,-20
38300098892,38300098896,4,1544,748,-20
38302425639,38302425644,5,2283,1118,-20
38304366699,38304366705,6,2847,1759,-20
38307228854,38307228860,6,2018,1082,-20
38308517984,38308517986,2,1409,1305,-20
38312611981,38312611984,3,2198,1657,-20
38314337693,38314337695,2,2507,1418,-20
38327128171,38327128176,5,2729,1407,-20
38327608646,38327608649,3,1628,1136,-20
38328834315,38328834319,4,1718,1652,-20
38330196513,38330196514,1,1326,1040,-20
38331499423,38331499426,3,1535,1023,-20
38331669918,38331669900,-18,2260,1303,-20
38332302987,38332302990,3,2603,1487,-20
38334425107,38334425109,2,1514,1624,-20
38337042025,38337042030,5,1500,1149,-20
38341857705,38341857707,2,1761,1260,-20
38350147093,38350147115,22,1869,1627,-20
38352482310,38352482314,4,2006,1612,-20
38356552840,38356552844,4,1738,1132,-20
38356657406,38356657411,5,1702,1629,-20
38358506529,38358506531,2,1493,1220,-20
38360621796,38360621799,3,957,692,-20
38364173958,38364173979,21,1530,1285,-20
38365261022,38365261025,3,1901,1161,-20
38367179497,38367179502,5,1784,1512,-20
38367298272,38367298274,2,1574,1541,-20
38371037025,38371037030,5,1285,1107,-20
38374086016,38374086013,-3,2758,9152,-20
38377464202,38377464203,1,1617,2045,-20
38382378345,38382378349,4,1895,1270,-20
38382787849,38382787846,-3,20395,7890,-20
38382962674,38382962676,2,1402,1294,-20
38383270446,38383270449,3,2781,1460,-20
38384994003,38384994002,-1,1495,1535,-20
38385822494,38385822497,3,1930,1678,-20
38386428467,38386428471,4,1842,1171,-20
38388864591,38388864594,3,1589,1100,-20
38392075881,38392075885,4,3575,2020,-20
38395042407,38395042411,4,2114,1506,-20
38396395577,38396395580,3,1221,1316,-20
38396891942,38396891921,-21,1293,906,-20
38400813110,38400813110,0,1419,1761,-20
38405081539,38405081541,2,1991,1999,-20
38405590582,38405590585,3,1815,1580,-20
38406567154,38406567158,4,2114,1082,-20
38414290781,38414290786,5,2241,1033,-20
38422026515,38422026518,3,1388,1102,-20
38425390889,38425390894,5,1957,1633,-20
38425651717,38425651723,6,2093,1068,-20
38426338434,38426338431,-3,1435,1170,-20
38426833755,38426833758,3,1414,1086,-20
38427715553,38427715555,2,2140,1529,-20
38428947887,38428947890,3,1727,1200,-20
38436556785,38436556786,1,1561,1649,-20
38437811984,38437811986,2,1333,1320,-20
38439015686,38439015690,4,1318,899,-20
38440822575,38440822578,3,1217,1331,-20
38443272621,38443272624,3,1281,1156,-20
38443736376,38443736378,2,1503,1351,-20
38445064259,38445064264,5,2109,1170,-20
38445730681,38445730683,2,2273,1742,-20
38446128569,38446128574,5,2374,1191,-20
38447215262,38447215267,5,2103,946,-20
38452669122,38452669126,4,1038,724,-20
38454799208,38454799212,4,2182,1394,-20
38456494041,38456494042,1,1396,1185,-20
38459028940,38459028942,2,1812,1171,-20
38459607691,38459607698,7,1887,1349,-20
38460701177,38460701179,2,1845,2120,-20
38462460994,38462460999,5,2354,1719,-20
38465371755,38465371758,3,2180,1369,-20
38468945372,38468945375,3,2262,1440,-20
38472425758,38472425762,4,2148,1466,-20
38474189247,38474189251,4,1726,1107,-20
38478025349,38478025350,1,1901,2145,-20
38480463958,38480463960,2,1001,1032,-20
38482742034,38482742037,3,3668,3398,-20
38482959170,38482959173,3,1552,1326,-20
38485655975,38485655978,3,1459,719,-20
38485796142,38485796155,13,13867,32487,-20
38491729019,38491729022,3,2803,1635,-20
38492274571,38492274575,4,1957,1740,-20
38492773023,38492773028,5,957,1044,-20
38496067746,38496067750,4,1868,1700,-20
38498815651,38498815655,4,1611,1054,-20
38503343414,38503343417,3,2830,2194,-20
38503929734,38503929740,6,2741,1495,-20
38505135137,38505135143,6,3314,1270,-20
38508839381,38508839385,4,1444,871,-20
38509935497,38509935498,1,1925,900,-20
38511524487,38511524490,3,1129,892,-20
38512730767,38512730772,5,3261,1876,-20
38514695526,38514695533,7,1945,1061,-20
38516679225,38516679220,-5,2557,7358,-20
38518425749,38518425750,1,1803,844,-20
38522354175,38522354178,3,2342,1571,-20
38523797738,38523797740,2,1749,1547,-20
38525214756,38525214751,-5,815,1996,-20
38528016683,38528016685,2,1396,1157,-20
38529201896,38529201896,0,1385,1465,-20
38532643477,38532643479,2,1540,1294,-20
38535175963,38535175958,-5,1189,3546,-20
38535334138,38535334141,3,2286,1444,-20
38537812433,38537812437,4,1090,849,-20
38539294353,38539294358,5,1897,1272,-20
38540035333,38540035335,2,2227,1674,-20
38540212913,38540212917,4,2027,1302,-20
38545529609,38545529614,5,2104,1209,-20
38550127883,38550127886,3,2020,916,-20
38551499182,38551499188,6,2174,1425,-20
38555303863,38555303866,3,1391,1180,-20
38561004904,38561004909,5,2270,1535,-20
38564061095,38564061098,3,1768,1162,-20
38564802266,38564802270,4,1497,1286,-20
38566787945,38566787949,4,2294,1361,-20
38568187522,38568187524,2,1837,1454,-20
38568382345,38568382347,2,1437,740,-20
38569960365,38569960368,3,1845,1336,-20
38570532409,38570532410,1,1468,1040,-20
38572019244,38572019246,2,1336,956,-20
38573967463,38573967466,3,2508,1507,-20
38576095818,38576095822,4,1959,1498,-20
38581203410,38581203411,1,2303,1701,-20
38585103152,38585103146,-6,1645,8007,-20
38586708798,38586708802,4,1461,1271,-20
38586968083,38586968087,4,1664,986,-20
38587684540,38587684545,5,2682,1180,-20
38591225186,38591225190,4,1568,992,-20
38592860922,38592860926,4,1239,1513,-20
38593768630,38593768631,1,1844,1517,-20
38593854333,38593854337,4,2220,1627,-20
38595860544,38595860547,3,1778,1045,-20
38597153787,38597153773,-14,2161,1842,-20
38603625833,38603625838,5,2059,1357,-20
38608129068,38608129071,3,1948,1685,-20
38609178422,38609178426,4,2815,1637,-20
38610425233,38610425235,2,1477,1367,-20
38612420257,38612420260,3,2065,2172,-20
38612482750,38612482752,2,1498,1032,-20
38613844753,38613844757,4,1753,1298,-20
38615293955,38615293960,5,2113,1393,-20
38615557995,38615557994,-1,973,1863,-20
38615895498,38615895501,3,1855,1572,-20
38616431790,38616431791,1,1194,1138,-20
38617225265,38617225269,4,1531,1832,-20
38617925137,38617925139,2,1852,1266,-20
38617953819,38617953822,3,1640,1541,-20
38621628016,38621628019,3,1445,1430,-20
38622359663,38622359666,3,1853,1146,-20
38622728614,38622728619,5,1277,1048,-20
38629650559,38629650562,3,1401,1328,-20
38631430350,38631430353,3,2260,1391,-20
38632350367,38632350366,-1,792,1016,-20
38634084111,38634084114,3,1351,1203,-20
38634322490,38634322494,4,2306,1740,-20
38634348871,38634348874,3,1169,1163,-20
38636183057,38636183060,3,1685,1150,-20
38638308434,38638308439,5,1760,1704,-20
38640656451,38640656456,5,1379,1625,-20
38643666563,38643666569,6,1899,1638,-20
38646127745,38646127751,6,2115,1173,-20
38650360009,38650360010,1,1179,1512,-20
38652013125,38652013130,5,1744,1065,-20
38652961142,38652961140,-2,5559,12255,-20
38654392271,38654392275,4,2000,1222,-20
38654798074,38654798075,1,1054,1182,-20
38656085970,38656085975,5,1162,850,-20
38657724741,38657724747,6,2236,1020,-20
38661314614,38661314618,4,1841,1869,-20
38663340189,38663340194,5,1710,1003,-20
38663570340,38663570345,5,1679,1639,-20
38666744679,38666744682,3,1433,1240,-20
38667224387,38667224394,7,3887,1309,-20
38669023074,38669023077,3,2064,1350,-20
38674536126,38674536130,4,2296,1426,-20
38677429389,38677429394,5,2449,1274,-20
38678803863,38678803866,3,1735,1137,-20
38681786355,38681786361,6,2037,1279,-20
38683305408,38683305411,3,1779,1655,-20
38685800617,38685800620,3,1772,1521,-20
38687127754,38687127757,3,1102,797,-20
38689207727,38689207730,3,2258,1736,-20
38689460038,38689460041,3,1755,1255,-20
38694678754,38694678756,2,2433,1713,-20
38696143298,38696143300,2,1905,1552,-20
38696193923,38696193925,2,1974,2169,-20
38698770242,38698770248,6,1820,1739,-20
38698828818,38698828821,3,2370,1673,-20
38700426102,38700426106,4,1082,1341,-20
38706916163,38706916165,2,1825,1385,-20
38711053282,38711053288,6,2290,1638,-20
38712249642,38712249647,5,1188,1048,-20
38712587508,38712587514,6,2379,1385,-20
38713300331,38713300318,-13,1058,1264,-20
38715242521,38715242523,2,1844,1397,-20
38718217065,38718217070,5,1941,1769,-20
38719182230,38719182232,2,1916,1718,-20
38724480458,38724480463,5,2396,1669,-20
38724593994,38724594001,7,1746,1224,-20
38725871664,38725871666,2,1311,865,-20
38726858295,38726858298,3,1904,1822,-20
38731687470,38731687474,4,2906,2063,-20
38734875397,38734875401,4,1941,1467,-20
38736348077,38736348080,3,1661,1366,-20
38737518203,38737518207,4,1515,1702,-20
38737882057,38737882058,1,1699,1781,-20
38740699287,38740699285,-2,1258,2321,-20
38746097653,38746097657,4,1087,972,-20
38747532625,38747532627,2,1651,1529,-20
38751823318,38751823322,4,1353,1819,-20
38755962973,38755962977,4,1957,1338,-20
38758598950,38758598953,3,1502,1705,-20
38758969963,38758969983,20,1148,2534,-20
38761346899,38761346902,3,1525,862,-20
38763574809,38763574813,4,2580,1120,-20
38764867450,38764867453,3,2330,1513,-20
38767008559,38767008547,-12,1420,1039,-20
38770264567,38770264571,4,870,670,-20
38770386383,38770386386,3,2177,1288,-20
38772570539,38772570543,4,942,879,-20
38774288297,38774288298,1,1952,1723,-20
38774340978,38774340982,4,2326,1544,-20
38777387349,38777387346,-3,1082,1026,-20
38780889323,38780889325,2,2116,1076,-20
38781089361,38781089364,3,1709,1328,-20
38781277835,38781277839,4,993,812,-20
38783790005,38783790009,4,1584,1125,-20
38784528255,38784528258,3,1353,2007,-20
38787282750,38787282754,4,2213,2127,-20
38789506831,38789506835,4,1765,1473,-20
38789730474,38789730478,4,2027,1749,-20
38790953175,38790953178,3,1679,1546,-20
38793166014,38793166018,4,1565,1459,-20
38793875412,38793875415,3,2157,1106,-20
38794485084,38794485084,0,1668,1950,-20
38797198995,38797198997,2,1632,1333,-20
38798788173,38798788176,3,1973,1608,-20
38803656125,38803656127,2,1684,1991,-20
38803829118,38803829120,2,1986,1369,-20
38804249732,38804249735,3,1602,1099,-20
38806653602,38806653597,-5,1385,3814,-20
38807494676,38807494678,2,1517,1676,-20
38808473484,38808473486,2,1387,1215,-20
38809059817,38809059821,4,1768,1365,-20
38811865173,38811865177,4,1881,1288,-20
38813220383,38813220387,4,1395,1316,-20
38818645484,38818645489,5,1438,1425,-20
38821256807,38821256810,3,1907,1337,-20
38821518057,38821518061,4,2540,1478,-20
38822072824,38822072827,3,1566,2224,-20
38822486239,38822486243,4,2543,1558,-20
38824046650,38824046652,2,1740,1456,-20
38824506035,38824506035,0,5963,8664,-20
38824815686,38824815690,4,1291,1382,-20
38828413374,38828413378,4,1230,1096,-20
38830431428,38830431431,3,2426,1658,-20
38830919242,38830919259,17,570,2147,-20
38832165282,38832165288,6,4778,1871,-20
38835072554,38835072558,4,2319,1645,-20
38837358250,38837358253,3,2272,1477,-20
38838065179,38838065182,3,2016,1544,-20
38839552998,38839553002,4,1208,1126,-20
38841725030,38841725033,3,1814,1383,-20
38842825257,38842825259,2,1416,1718,-20
38843225551,38843225554,3,1907,1344,-20
38847956491,38847956494,3,2319,1855,-20
38848310503,38848310507,4,2189,1815,-20
38849127194,38849127200,6,1738,872,-20
38850760570,38850760573,3,1664,1631,-20
38854038745,38854038749,4,2010,1398,-20
38855794735,38855794738,3,1763,1234,-20
38857695823,38857695826,3,2253,1447,-20
38861635808,38861635811,3,1562,1639,-20
38868011702,38868011705,3,1746,1240,-20
38869501703,38869501707,4,1654,1524,-20
38876126698,38876126703,5,1474,1529,-20
38877513405,38877513412,7,2878,1966,-20
38884542366,38884542368,2,1882,2200,-20
38886140688,38886140690,2,2050,1279,-20
38894774928,38894774927,-1,2344,3244,-20
38896426528,38896426536,8,853,295,-20
38897568383,38897568380,-3,28939,18539,-20
38898850727,38898850730,3,1700,889,-20
38898924146,38898924149,3,1496,1050,-20
38899597102,38899597081,-21,1949,1379,-20
38900066419,38900066422,3,1362,1340,-20
38900627924,38900627927,3,1634,1188,-20
38909191820,38909191823,3,2036,1249,-20
38913690522,38913690526,4,1596,1331,-20
38915402819,38915402822,3,1991,1272,-20
38916364518,38916364522,4,1672,1252,-20
38920082541,38920082543,2,1711,1681,-20
38920761187,38920761189,2,2133,1447,-20
38921218985,38921218988,3,1486,1475,-20
38921985087,38921985090,3,1665,1344,-20
38923245669,38923245673,4,1811,1439,-20
38929286960,38929286964,4,2359,1269,-20
38929837910,38929837909,-1,1631,1608,-20
38934003952,38934003956,4,1487,984,-20
38938491680,38938491684,4,2666,2018,-20
38938729223,38938729210,-13,993,419,-20
38940586367,38940586371,4,1450,1409,-20
38941226218,38941226221,3,1866,1576,-20
38943094967,38943094972,5,2663,1907,-20
38943270926,38943270930,4,874,750,-20
38945441213,38945441214,1,2073,1738,-20
38955329224,38955329226,2,2035,1384,-20
38957225725,38957225725,0,1894,1389,-20
38957610906,38957610901,-5,2464,5610,-20
38959545278,38959545281,3,1496,1201,-20
38963230255,38963230259,4,1510,997,-20
38969043261,38969043266,5,2314,1546,-20
38969163179,38969163183,4,2781,1897,-20
38969825036,38969825040,4,2371,2141,-20
38971055241,38971055224,-17,2175,1600,-20
38971167652,38971167632,-20,1731,1258,-20
38973163703,38973163697,-6,2393,7388,-20
38973445099,38973445102,3,2129,1391,-20
38973539004,38973539011,7,1551,1276,-20
38974319844,38974319827,-17,1196,279,-20
38974576161,38974576162,1,1888,1616,-20
38978751632,38978751634,2,1478,1386,-20
38979761234,38979761235,1,1221,785,-20
38980057513,38980057516,3,1662,1428,-20
38982135607,38982135601,-6,1417,4467,-20
38986226472,38986226477,5,1978,1259,-20
38988115354,38988115354,0,1582,1139,-20
38988293575,38988293578,3,2317,1338,-20
38993472296,38993472302,6,1903,1570,-20
39001696692,39001696695,3,2039,1269,-20
39003703311,39003703315,4,1593,1146,-20
39006607582,39006607585,3,1773,1113,-20
39007449924,39007449926,2,2116,1179,-20
39007827017,39007827019,2,1821,1509,-20
39009233878,39009233881,3,1795,1875,-20
39009489178,39009489182,4,2656,1518,-20
39009764463,39009764467,4,1856,1103,-20
39012762059,39012762063,4,1434,1882,-20
39013269034,39013269037,3,1775,1561,-20
39015298950,39015298954,4,1008,1339,-20
39016106753,39016106755,2,1279,1082,-20
39016423551,39016423557,6,1971,1305,-20
39016776587,39016776570,-17,460,288,-20
39017520279,39017520296,17,1156,848,-20
39019767096,39019767089,-7,936,3716,-20
39022803990,39022803994,4,1821,1046,-20
39024010584,39024010587,3,828,1294,-20
39025060969,39025060971,2,1004,1325,-20
39029129338,39029129342,4,2443,1421,-20
39029942445,39029942451,6,1691,1316,-20
39030841926,39030841930,4,2388,1524,-20
39035197140,39035197142,2,1648,863,-20
39038052984,39038052986,2,1994,1388,-20
39044405111,39044405115,4,1431,1116,-20
39050116600,39050116603,3,1932,2014,-20
39053315901,39053315903,2,1928,1305,-20
39055249566,39055249573,7,1850,1406,-20
39056277257,39056277259,2,1104,1396,-20
39078099395,39078099398,3,1423,1241,-20
39079534634,39079534639,5,2002,1257,-20
39080437314,39080437318,4,1243,1042,-20
39080646717,39080646718,1,1696,1478,-20
39080980887,39080980891,4,1998,1493,-20
39081151467,39081151469,2,7611,28520,-20
39088575009,39088575013,4,11339,25574,-20
39089086979,39089086978,-1,1827,2546,-20
39090101190,39090101194,4,1664,1345,-20
39093697151,39093697150,-1,1657,2176,-20
39094960324,39094960328,4,2045,1159,-20
39097884023,39097884026,3,2328,1522,-20
39097937546,39097937549,3,1649,1258,-20
39103593121,39103593122,1,1253,776,-20
39104112594,39104112597,3,1213,1159,-20
39104758032,39104758038,6,2424,912,-20
39105686836,39105686839,3,1728,1254,-20
39107281214,39107281220,6,1235,1009,-20
39109069842,39109069843,1,2402,1734,-20
39113374551,39113374558,7,2458,1144,-20
39114983417,39114983422,5,2006,1221,-20
39116188374,39116188377,3,1213,890,-20
39117668761,39117668762,1,1462,1510,-20
39118508674,39118508676,2,1279,1497,-20
39123197104,39123197103,-1,1084,1200,-20
39123401130,39123401122,-8,122,1612,-20
39124546675,39124546679,4,1967,776,-20
39125708283,39125708286,3,1537,1120,-20
39131391498,39131391502,4,1614,1267,-20
39134570882,39134570887,5,1438,1199,-20
39134913685,39134913690,5,5681,2858,-20
39135231849,39135231851,2,1609,1269,-20
39135349372,39135349374,2,2063,1526,-20
39136648856,39136648858,2,1617,1740,-20
39137715274,39137715279,5,2213,1576,-20
39138100734,39138100738,4,1698,1530,-20
39138273234,39138273238,4,2582,1256,-20
39139098657,39139098659,2,1339,1363,-20
39140751218,39140751211,-7,998,3787,-20
39142727214,39142727217,3,1289,996,-20
39142789250,39142789259,9,1611,1055,-20
39144513147,39144513150,3,2474,1797,-20
39147942001,39147942005,4,1638,1576,-20
39148492514,39148492518,4,2212,1388,-20
39148777465,39148777471,6,2267,1239,-20
39157887748,39157887750,2,1923,1107,-20
39157935140,39157935145,5,2222,1407,-20
39158277762,39158277745,-17,2087,544,-20
39160319007,39160319009,2,1208,1469,-20
39161141608,39161141605,-3,1562,2420,-20
39163389091,39163389095,4,2474,1826,-20
39168546514,39168546509,-5,1384,1473,-20
39170142665,39170142667,2,1826,1806,-20
39173330354,39173330360,6,1052,1264,-20
39176244058,39176244060,2,2424,1732,-20
39179052285,39179052285,0,1501,2380,-20
39180246876,39180246880,4,1855,1472,-20
39184451940,39184451932,-8,70,2727,-20
39185992210,39185992214,4,2418,1167,-20
39187334055,39187334060,5,1354,1562,-20
39187620056,39187620058,2,1695,1418,-20
39188452956,39188452958,2,1357,1162,-20
39191844404,39191844406,2,1759,1389,-20
39198025744,39198025746,2,1943,1871,-20
39200853997,39200853998,1,1901,1441,-20
39204368700,39204368704,4,2164,1573,-20
39204957673,39204957674,1,1112,838,-20
39205756958,39205756961,3,1898,1480,-20
39206060567,39206060570,3,1392,938,-20
39206756563,39206756566,3,1814,1588,-20
39209406118,39209406123,5,2053,1163,-20
39219386240,39219386244,4,1716,1519,-20
39225209826,39225209831,5,1780,1330,-20
39225336782,39225336785,3,2483,1795,-20
39230122849,39230122854,5,2900,978,-20
39231365351,39231365355,4,2163,1554,-20
39232630045,39232630045,0,1974,2009,-20
39233302699,39233302702,3,1225,1410,-20
39234987806,39234987810,4,1641,1219,-20
39235979550,39235979563,13,3557,1643,-20
39238610429,39238610435,6,2066,1261,-20
39238847327,39238847331,4,1596,1481,-20
39239356237,39239356216,-21,2460,1274,-20
39240253453,39240253458,5,1332,1130,-20
39241310524,39241310528,4,1836,1036,-20
39243999024,39243999027,3,1321,1061,-20
39245803543,39245803547,4,1424,1403,-20
39247536372,39247536390,18,20,1829,-20
39251538970,39251538970,0,1603,2080,-20
39251670524,39251670526,2,1582,1267,-20
39251909923,39251909927,4,2940,1648,-20
39253498228,39253498230,2,3229,3168,-20
39253754462,39253754463,1,2435,2046,-20
39255519017,39255519021,4,2980,2288,-20
39255712614,39255712617,3,1254,1053,-20
39257870806,39257870809,3,1461,1400,-20
39259166964,39259166968,4,1278,1290,-20
39267992541,39267992544,3,1278,1202,-20
39268930482,39268930487,5,2185,1610,-20
39270159670,39270159674,4,1454,1016,-20
39270582453,39270582457,4,1961,1168,-20
39271325706,39271325710,4,1883,1289,-20
39271827458,39271827463,5,1554,866,-20
39276565634,39276565633,-1,1438,1919,-20
39277304452,39277304456,4,1773,1478,-20
39277950853,39277950855,2,1914,1268,-20
39284944964,39284944966,2,1743,1633,-20
39285504422,39285504426,4,2084,1215,-20
39285710905,39285710907,2,1602,1638,-20
39287721756,39287721757,1,1819,1425,-20
39288446638,39288446643,5,2078,1101,-20
39289206610,39289206613,3,2097,1285,-20
39292331327,39292331329,2,1553,1387,-20
39292760682,39292760682,0,1675,1664,-20
39295722309,39295722313,4,1685,1621,-20
39297943875,39297943879,4,2205,1496,-20
39299585070,39299585074,4,1646,1429,-20
39301396237,39301396241,4,1700,1078,-20
39301926293,39301926295,2,2132,1540,-20
39304298917,39304298919,2,1845,1567,-20
39312178911,39312178913,2,1678,1425,-20
39314397262,39314397266,4,1872,1244,-20
39314938687,39314938689,2,1583,1809,-20
39315174254,39315174242,-12,37646,17265,-20
39315321275,39315321278,3,1518,1630,-20
39319080926,39319080926,0,2555,1731,-20
39323484703,39323484706,3,2347,1178,-20
39331211095,39331211101,6,1776,941,-20
39332515879,39332515883,4,1952,1260,-20
39335730859,39335730865,6,2062,1466,-20
39335909558,39335909562,4,1678,1828,-20
39337153512,39337153515,3,1667,1118,-20
39337499154,39337499157,3,821,1059,-20
39340615808,39340615823,15,10974,46277,-20
39340715314,39340715319,5,2989,1891,-20
39343935005,39343935009,4,2495,1693,-20
39349128471,39349128478,7,2037,1185,-20
39359690909,39359690914,5,2038,1860,-20
39361868891,39361868894,3,1976,1409,-20
39366826816,39366826818,2,916,911,-20
39368687274,39368687279,5,1830,1487,-20
39368975127,39368975126,-1,1686,2016,-20
39373716158,39373716159,1,1229,1113,-20
39377071321,39377071323,2,1122,959,-20
39380061726,39380061715,-11,14330,28760,-20
39380865794,39380865798,4,2078,1590,-20
39380964043,39380964046,3,1969,2060,-20
39383906504,39383906505,1,2331,2453,-20
39384227074,39384227078,4,1354,916,-20
39385330430,39385330435,5,1476,1420,-20
39391684024,39391684009,-15,37981,17212,-20
39395872566,39395872570,4,1987,1341,-20
39396126487,39396126466,-21,515,297,-20
39396542281,39396542265,-16,730,651,-20
39404108314,39404108317,3,2033,2135,-20
39405575946,39405575950,4,1892,1141,-20
39409348861,39409348867,6,2006,1407,-20
39411207058,39411207062,4,1866,1139,-20
39411656287,39411656266,-21,1072,475,-20
39412754268,39412754269,1,1045,2050,-20
39413031356,39413031362,6,2002,1249,-20
39413262409,39413262414,5,2315,1077,-20
39413744365,39413744366,1,2616,1739,-20
39415358064,39415358066,2,1452,1121,-20
39416626187,39416626186,-1,1173,1150,-20
39420681954,39420681955,1,383,963,-20
39422389878,39422389882,4,1800,1110,-20
39422475914,39422475918,4,1442,1087,-20
39426146550,39426146550,0,1115,1271,-20
39428863038,39428863041,3,1977,1374,-20
39430408130,39430408134,4,2033,1495,-20
39430835727,39430835730,3,1212,1774,-20
39435542482,39435542477,-5,1120,4098,-20
39435629582,39435629585,3,1777,1549,-20
39437388969,39437388971,2,1783,1821,-20
39442265267,39442265270,3,2254,1093,-20
39443498603,39443498597,-6,1006,6489,-20
39446726146,39446726151,5,1582,1231,-20
39448649720,39448649721,1,1575,1927,-20
39449588527,39449588530,3,2508,1534,-20
39449995559,39449995546,-13,1905,1391,-20
39451015726,39451015729,3,1517,995,-20
39451352321,39451352325,4,1890,1222,-20
39453445401,39453445404,3,2393,1936,-20
39456017261,39456017263,2,1822,1839,-20
39460689222,39460689226,4,2430,1783,-20
39461678685,39461678688,3,2300,1378,-20
39462337273,39462337279,6,1584,989,-20
39464612641,39464612644,3,2315,2027,-20
39466362572,39466362574,2,2556,2361,-20
39467274190,39467274194,4,1979,1104,-20
39468220150,39468220154,4,1253,1354,-20
39475149242,39475149242,0,1507,1512,-20
39475513595,39475513598,3,1754,1342,-20
39479316307,39479316311,4,1160,984,-20
39480630376,39480630381,5,2079,1473,-20
39480934818,39480934825,7,1876,1237,-20
39487915450,39487915457,7,1585,1308,-20
39488102114,39488102118,4,1385,1339,-20
39488497445,39488497450,5,2439,1774,-20
39488618626,39488618631,5,1537,1183,-20
39490941713,39490941714,1,2270,1191,-20
39495248106,39495248106,0,1097,870,-20
39499573151,39499573157,6,1081,938,-20
39500276189,39500276189,0,1741,1294,-20
39503742687,39503742691,4,1845,821,-20
39505587402,39505587407,5,1658,887,-20
39506413254,39506413257,3,2369,1377,-20
39511062338,39511062341,3,1470,1767,-20
39521455650,39521455654,4,2224,1770,-20
39523097129,39523097130,1,1954,1780,-20
39523913807,39523913809,2,1133,1188,-20
39525087717,39525087720,3,1597,1422,-20
39528220338,39528220342,4,1523,1500,-20
39529859654,39529859656,2,1610,1358,-20
39530735334,39530735338,4,1382,1365,-20
39534483533,39534483537,4,1424,1618,-20
39535523076,39535523078,2,1661,1097,-20
39539332178,39539332184,6,1479,1159,-20
39540524019,39540524023,4,1415,1626,-20
39540855494,39540855497,3,2060,1526,-20
39545129118,39545129123,5,1026,848,-20
39547739762,39547739765,3,2254,1717,-20
39547844662,39547844666,4,2479,1376,-20
39548126985,39548126989,4,1818,1708,-20
39552064274,39552064273,-1,2109,4590,-20
39553592798,39553592802,4,1527,1468,-20
39554868862,39554868865,3,2328,1257,-20
39561116671,39561116673,2,1339,949,-20
39563901552,39563901555,3,2077,1229,-20
39564958749,39564958752,3,2127,1104,-20
39568124686,39568124690,4,1347,1546,-20
39573027182,39573027160,-22,1958,1011,-20
39575171296,39575171299,3,1668,1527,-20
39579119729,39579119733,4,2731,1301,-20
39580971053,39580971055,2,1251,1357,-20
39581123794,39581123798,4,2556,2095,-20
39583174154,39583174153,-1,933,1017,-20
39583782010,39583782013,3,1758,1586,-20
39588249058,39588249061,3,1807,1739,-20
39593295771,39593295774,3,1250,1064,-20
39593384446,39593384450,4,1931,1165,-20
39596362687,39596362691,4,1659,1787,-20
39596914503,39596914508,5,2931,1614,-20
39598080921,39598080925,4,1699,1489,-20
39600306556,39600306558,2,1811,1509,-20
39601597607,39601597610,3,1857,1718,-20
39603748177,39603748195,18,2018,1606,-20
39604526932,39604526934,2,1981,1430,-20
39605800563,39605800567,4,2031,1727,-20
39606902973,39606902974,1,1900,1308,-20
39609270014,39609270018,4,1362,1196,-20
39609488187,39609488191,4,2430,1962,-20
39611413189,39611413193,4,2354,1865,-20
39612466842,39612466846,4,1907,1730,-20
39612774084,39612774087,3,1743,1681,-20
39615538285,39615538286,1,1062,980,-20
39616649378,39616649379,1,1341,1756,-20
39617071781,39617071783,2,1169,732,-20
39618374265,39618374259,-6,1384,6440,-20
39624556778,39624556779,1,1756,1282,-20
39626066209,39626066210,1,1981,1576,-20
39627777179,39627777181,2,2176,1318,-20
39631753822,39631753826,4,1881,1779,-20
39633288747,39633288738,-9,1021,4625,-20
39635625036,39635625038,2,1653,1776,-20
39638703458,39638703461,3,1266,1316,-20
39643027562,39643027566,4,2000,1295,-20
39645728902,39645728899,-3,787,2126,-20
39647615088,39647615082,-6,24605,13932,-20
39647760882,39647760885,3,1517,1424,-20
39648142671,39648142675,4,1997,1339,-20
39648900557,39648900559,2,2327,1524,-20
39652124176,39652124179,3,2279,1561,-20
39652278694,39652278695,1,1268,965,-20
39652503902,39652503881,-21,2238,1161,-20
39655706594,39655706599,5,2216,1505,-20
39657642611,39657642616,5,2286,1461,-20
39658010295,39658010273,-22,1147,597,-20
39658404350,39658404355,5,1824,1477,-20
39661309998,39661310002,4,1217,914,-20
39662979798,39662979803,5,1978,1755,-20
39665582406,39665582407,1,1277,755,-20
39667241020,39667241026,6,1694,1302,-20
39668518398,39668518403,5,2444,2098,-20
39669429934,39669429938,4,2186,1748,-20
39670930860,39670930862,2,1677,1439,-20
39676164246,39676164249,3,1645,1148,-20
39676346854,39676346856,2,1543,1350,-20
39678209239,39678209242,3,1731,1581,-20
39682060856,39682060858,2,1684,1365,-20
39686510553,39686510558,5,1906,1445,-20
39687162066,39687162082,16,1664,1237,-20
39687866993,39687866995,2,1599,1078,-20
39691357975,39691357978,3,1624,887,-20
39694126495,39694126500,5,2868,1917,-20
39696710620,39696710619,-1,2104,2180,-20
39698548635,39698548641,6,1727,1576,-20
39698857214,39698857217,3,2400,2206,-20
39699516087,39699516085,-2,1034,2271,-20
39700223499,39700223502,3,1428,1112,-20
39700858787,39700858779,-8,1825,1676,-20
39701664039,39701664033,-6,1102,7992,-20
39702466040,39702466044,4,2201,1560,-20
39702585384,39702585393,9,1296,1291,-20
39704747369,39704747373,4,2108,1705,-20
39704807397,39704807401,4,2233,1844,-20
39708833998,39708834003,5,1983,1178,-20
39709823066,39709823071,5,1567,1691,-20
39710276641,39710276645,4,2125,1166,-20
39711112534,39711112541,7,1981,1267,-20
39714016489,39714016491,2,2297,1884,-20
39719240306,39719240308,2,2394,1535,-20
39720106915,39720106919,4,1561,1303,-20
39720584195,39720584198,3,1363,872,-20
39723883515,39723883515,0,1310,1679,-20
39724186973,39724186975,2,1962,1323,-20
39724417666,39724417666,0,1100,1161,-20
39725407293,39725407294,1,2511,1478,-20
39725585762,39725585765,3,1771,1527,-20
39726623210,39726623214,4,2152,2029,-20
39734363158,39734363158,0,1353,1118,-20
39737261317,39737261317,0,1550,1607,-20
39737685951,39737685953,2,822,1206,-20
39738492746,39738492749,3,1110,890,-20
39738645910,39738645892,-18,2545,1195,-20
39739044712,39739044699,-13,1826,1378,-20
39741497543,39741497545,2,2197,1702,-20
39744053710,39744053717,7,982,952,-20
39747294471,39747294475,4,1353,988,-20
39749233929,39749233934,5,2498,1445,-20
39749749030,39749749033,3,1772,1783,-20
39758834456,39758834463,7,1652,1051,-20
39759032738,39759032724,-14,1443,1378,-20
39759286024,39759286026,2,1225,1319,-20
39764764471,39764764478,7,2549,1155,-20
39768355625,39768355630,5,1991,1414,-20
39771029230,39771029235,5,1615,1615,-20
39771766607,39771766610,3,2853,1887,-20
39773022144,39773022147,3,1890,931,-20
39775285809,39775285813,4,1645,1129,-20
39777329570,39777329571,1,1568,999,-20
39778114317,39778114319,2,1377,1010,-20
39785160336,39785160338,2,2201,1892,-20
39787396702,39787396706,4,2324,1815,-20
39791461280,39791461284,4,1694,1790,-20
39792367201,39792367198,-3,1736,4980,-20
39793376970,39793376963,-7,1102,2943,-20
39793461134,39793461139,5,1021,1107,-20
39794374873,39794374878,5,993,944,-20
39794523325,39794523327,2,2677,1575,-20
39795454489,39795454491,2,1491,1428,-20
39797231267,39797231270,3,1630,1273,-20
39803181194,39803181195,1,1677,1297,-20
39803969289,39803969291,2,2096,1444,-20
39806407793,39806407797,4,1943,1126,-20
39809563450,39809563454,4,2116,1976,-20
39815155283,39815155282,-1,1540,2854,-20
39815362084,39815362086,2,1850,1266,-20
39817392966,39817392961,-5,1766,4849,-20
39818462756,39818462759,3,2349,1971,-20
39819117961,39819117964,3,1507,1664,-20
39822849973,39822849975,2,1234,1045,-20
39826788710,39826788712,2,1419,1042,-20
39828792492,39828792509,17,48,1406,-20
39829181202,39829181204,2,2030,2128,-20
39831337827,39831337831,4,2690,1097,-20
39834383386,39834383388,2,1016,1383,-20
39838037738,39838037740,2,2154,1543,-20
39839198024,39839198030,6,1897,1247,-20
39843746338,39843746341,3,2296,1845,-20
39844305226,39844305232,6,4572,2929,-20
39845492301,39845492302,1,1867,1383,-20
39848594257,39848594260,3,2520,1819,-20
39849552486,39849552489,3,1935,1335,-20
39850172453,39850172456,3,1107,1163,-20
39851607197,39851607198,1,3097,1898,-20
39854065159,39854065161,2,1284,1545,-20
39854348285,39854348289,4,1569,868,-20
39863492012,39863492016,4,1575,1045,-20
39863640774,39863640794,20,3374,1346,-20
39866633936,39866633938,2,1857,1867,-20
39867194102,39867194104,2,2404,1580,-20
39868273058,39868273060,2,2089,1081,-20
39876058602,39876058608,6,2101,1453,-20
39876165635,39876165634,-1,1098,1018,-20
39878546186,39878546189,3,2892,2268,-20
39883341556,39883341558,2,2029,1694,-20
39883645610,39883645631,21,144,1657,-20
39885299004,39885299008,4,1678,1183,-20
39886018951,39886018955,4,1884,1419,-20
39892264579,39892264582,3,1310,1057,-20
39895205138,39895205142,4,2111,1087,-20
39896241523,39896241527,4,1863,1390,-20
39898908067,39898908071,4,2399,1742,-20
39899179147,39899179152,5,1613,1796,-20
39904290486,39904290485,-1,869,1181,-20
39906227352,39906227354,2,1927,1650,-20
39913052406,39913052410,4,1634,1102,-20
39916191187,39916191195,8,1647,1077,-20
39918984533,39918984537,4,1482,847,-20
39919918338,39919918344,6,1729,1386,-20
39921095786,39921095790,4,1131,960,-20
39921277385,39921277389,4,2050,1560,-20
39921433411,39921433415,4,1524,1211,-20
39925146651,39925146654,3,1638,2448,-20
39933989743,39933989745,2,2129,1519,-20
39934274460,39934274462,2,2143,1657,-20
39938946332,39938946333,1,911,1021,-20
39940756290,39940756297,7,15402,22606,-20
39940808070,39940808073,3,1300,1215,-20
39942507266,39942507270,4,1754,1793,-20
39943864626,39943864641,15,212,1059,-20
39945605633,39945605638,5,2120,1520,-20
39946178823,39946178826,3,1922,1687,-20
39950630062,39950630066,4,2286,2141,-20
39951813656,39951813648,-8,83,1377,-20
39956736182,39956736186,4,3481,2423,-20
39957149761,39957149765,4,1876,1592,-20
39961618330,39961618330,0,12037,13246,-20
39962213816,39962213818,2,1913,1002,-20
39967697183,39967697188,5,1292,990,-20
39968460543,39968460548,5,2152,1488,-20
39969175659,39969175665,6,3057,1734,-20
39969466706,39969466710,4,1674,1519,-20
39969852937,39969852946,9,2674,1013,-20
39970536318,39970536321,3,1366,1331,-20
39971095852,39971095854,2,1342,803,-20
39972358094,39972358095,1,1447,1826,-20
39973619125,39973619127,2,1900,1728,-20
39976894571,39976894575,4,1018,900,-20
39977531589,39977531594,5,1945,1388,-20
39979187531,39979187534,3,1969,1346,-20
39979949746,39979949748,2,1444,1084,-20
39983019023,39983019026,3,1448,1502,-20
39987156259,39987156254,-5,1100,2580,-20
39988855202,39988855206,4,1759,1256,-20
39988893236,39988893240,4,2379,1664,-20
39989327585,39989327586,1,8926,9015,-20
39995762989,39995762991,2,1588,1041,-20
39996883133,39996883127,-6,592,2509,-20
39998339105,39998339107,2,811,631,-20
39999156146,39999156153,7,2126,1241,-20
40003074416,40003074421,5,1413,1516,-20
40005825092,40005825097,5,2031,1286,-20
40009449619,40009449622,3,1207,1083,-20
40011993598,40011993602,4,1731,1113,-20
40016457524,40016457520,-4,1204,2601,-20
40018381355,40018381358,3,1919,1367,-20
40019752559,40019752560,1,2057,2746,-20
40020696065,40020696067,2,1705,1572,-20
40024344239,40024344242,3,1961,1518,-20
40029050395,40029050399,4,886,707,-20
40029859096,40029859093,-3,4347,9767,-20
40031519986,40031519989,3,1693,1963,-20
40032260262,40032260265,3,1297,827,-20
40034974583,40034974586,3,2050,1514,-20
40036476498,40036476502,4,1396,1237,-20
40036547754,40036547756,2,1945,2132,-20
40039155322,40039155326,4,2099,1699,-20
40040554131,40040554139,8,10113,1371,-20
40041022848,40041022853,5,3733,1274,-20
40041241266,40041241264,-2,729,1632,-20
40048274438,40048274438,0,1286,1325,-20
40050480239,40050480239,0,6562,6639,-20
40057991929,40057991935,6,1914,1290,-20
40060177488,40060177490,2,2427,1837,-20
40060779198,40060779201,3,1796,974,-20
40062668413,40062668417,4,2074,1329,-20
40063440951,40063440955,4,1769,1385,-20
40064325382,40064325385,3,1824,1696,-20
40064733687,40064733691,4,1235,1094,-20
40067959964,40067959966,2,1817,1642,-20
40068159091,40068159094,3,1601,1513,-20
40068626134,40068626138,4,1805,1416,-20
40070205326,40070205329,3,925,1130,-20
40071242927,40071242931,4,2241,1257,-20
40072398215,40072398218,3,1132,745,-20
40072860644,40072860649,5,1998,1446,-20
40073241176,40073241178,2,911,1332,-20
40074620351,40074620351,0,1708,3004,-20
40074909915,40074909911,-4,859,2094,-20
40080948342,40080948343,1,1982,1445,-20
40083624118,40083624122,4,2860,1432,-20
40084844128,40084844131,3,1524,1028,-20
40085170467,40085170472,5,1484,1391,-20
40085294332,40085294337,5,1667,827,-20
40085334547,40085334553,6,1848,1703,-20
40085544894,40085544900,6,1394,1337,-20
40087942033,40087942038,5,2457,1489,-20
40089152706,40089152710,4,1357,1364,-20
40091384025,40091384027,2,1142,1156,-20
40092805067,40092805071,4,2658,1656,-20
40094719033,40094719037,4,1487,1232,-20
40097601762,40097601766,4,1733,1401,-20
40102237479,40102237482,3,1699,1042,-20
40104690070,40104690074,4,2314,1540,-20
40107266726,40107266731,5,1107,906,-20
40107310392,40107310393,1,2013,1599,-20
40111251438,40111251445,7,1397,1005,-20
40112380577,40112380569,-8,1155,2610,-20
40113229982,40113229983,1,3576,2905,-20
40113441255,40113441253,-2,1135,2941,-20
40113618285,40113618279,-6,881,1154,-20
40114517739,40114517743,4,1732,1294,-20
40115578667,40115578672,5,1705,1555,-20
40121611108,40121611112,4,2242,1848,-20
40122802134,40122802142,8,3212,1604,-20
40123578858,40123578855,-3,1070,3640,-20
40124281542,40124281542,0,1344,1149,-20
40127270319,40127270317,-2,1601,2804,-20
40129129854,40129129856,2,2240,1321,-20
40130128850,40130128855,5,1385,1195,-20
40131159845,40131159849,4,2740,1865,-20
40132510580,40132510583,3,1494,1267,-20
40133019909,40133019915,6,1928,1390,-20
40136084200,40136084204,4,2502,1138,-20
40136957359,40136957353,-6,1092,4621,-20
40139647250,40139647253,3,2037,1266,-20
40141881226,40141881227,1,2060,1416,-20
40143103758,40143103764,6,1376,1627,-20
40144262190,40144262193,3,2077,1379,-20
40144413002,40144413005,3,1310,1222,-20
40144700119,40144700140,21,1542,1092,-20
40147196226,40147196230,4,2102,1315,-20
40150675617,40150675622,5,2840,1108,-20
40153725970,40153725974,4,2286,1864,-20
40154046471,40154046474,3,768,584,-20
40159783898,40159783904,6,3319,2077,-20
40161224276,40161224281,5,1089,1118,-20
40161896813,40161896817,4,2132,1281,-20
40163817033,40163817037,4,1846,1147,-20
40165300992,40165300997,5,2019,1194,-20
40166152266,40166152260,-6,2135,8399,-20
40166996055,40166996054,-1,1038,2180,-20
40170405465,40170405470,5,1856,1114,-20
40171444430,40171444433,3,1785,1240,-20
40175678590,40175678593,3,1668,1217,-20
40175712138,40175712141,3,2055,2026,-20
40176101486,40176101491,5,927,577,-20
40177991871,40177991876,5,1176,1243,-20
40182592867,40182592870,3,1953,1277,-20
40183192055,40183192058,3,1644,1745,-20
40184175374,40184175378,4,1650,1648,-20
40186788435,40186788439,4,1610,1234,-20
40187443473,40187443477,4,1143,1006,-20
40189178567,40189178572,5,1576,1177,-20
40192992430,40192992431,1,1485,2034,-20
40193877588,40193877589,1,2250,1323,-20
40194006691,40194006694,3,1874,1531,-20
40197128092,40197128095,3,1481,1257,-20
40197502358,40197502362,4,1481,1349,-20
40198783808,40198783809,1,1655,1592,-20
40205934678,40205934683,5,1829,1927,-20
40207058026,40207058029,3,1856,1446,-20
40209649676,40209649674,-2,2060,1834,-20
40211515170,40211515173,3,2107,1579,-20
40212239408,40212239411,3,2162,1472,-20
40215656178,40215656183,5,972,1022,-20
40216305925,40216305929,4,2449,1710,-20
40217084447,40217084453,6,1875,1668,-20
40217309475,40217309479,4,2480,1477,-20
40217391708,40217391710,2,1161,937,-20
40218102106,40218102112,6,941,1063,-20
40218756113,40218756118,5,1494,1118,-20
40220125674,40220125676,2,1756,1786,-20
40220565250,40220565254,4,1475,1430,-20
40225867166,40225867168,2,1640,1031,-20
40229473762,40229473765,3,1288,1273,-20
40232564674,40232564678,4,1398,1521,-20
40234563810,40234563814,4,1987,1365,-20
40235850694,40235850698,4,3369,3325,-20
40236238435,40236238438,3,1982,1703,-20
40236434027,40236434032,5,2786,1264,-20
40237852696,40237852692,-4,1250,3139,-20
40242382994,40242382997,3,2242,1716,-20
40243405001,40243405002,1,1166,1795,-20
40244433549,40244433551,2,2243,1902,-20
40245573499,40245573502,3,1448,1501,-20
40247199450,40247199453,3,783,837,-20
40248430261,40248430266,5,1526,1545,-20
40251769874,40251769877,3,1416,1106,-20
40252073763,40252073766,3,1426,1046,-20
40252506844,40252506845,1,1082,1194,-20
40253044494,40253044498,4,1601,1425,-20
40255297645,40255297650,5,2790,1464,-20
40257053567,40257053571,4,2561,1496,-20
40257408874,40257408878,4,2276,1684,-20
40258121151,40258121154,3,2205,1974,-20
40260108619,40260108623,4,2477,1496,-20
40263490754,40263490747,-7,1188,3700,-20
40266267032,40266267035,3,1796,1006,-20
40267446198,40267446203,5,2464,1048,-20
40271088376,40271088378,2,2002,1193,-20
40273085560,40273085555,-5,1609,5645,-20
40277446768,40277446773,5,1969,1141,-20
40279627781,40279627784,3,1943,1383,-20
40284263669,40284263671,2,1749,950,-20
40286800894,40286800894,0,2557,2712,-20
40287519506,40287519505,-1,1794,1573,-20
40292290283,40292290287,4,1197,1147,-20
40297177741,40297177747,6,1889,1654,-20
40298206599,40298206602,3,1093,981,-20
40299516755,40299516758,3,1164,1545,-20
40300254038,40300254042,4,2971,1613,-20
40301341770,40301341773,3,2101,1739,-20
40301735193,40301735197,4,1602,1158,-20
40302858466,40302858471,5,1956,1147,-20
40304048807,40304048810,3,1827,1396,-20
40304305971,40304305977,6,2648,1386,-20
40305585154,40305585156,2,1733,1117,-20
40307394339,40307394343,4,2931,1394,-20
40310263964,40310263965,1,2188,1619,-20
40311314265,40311314270,5,2261,1088,-20
40315577680,40315577681,1,1080,1640,-20
40318132709,40318132711,2,1656,1769,-20
40318813008,40318813010,2,1532,1174,-20
40326859652,40326859650,-2,1385,1696,-20
40328721048,40328721049,1,1165,1354,-20
40330197595,40330197600,5,1640,1024,-20
40332449310,40332449316,6,2799,1337,-20
40332654483,40332654483,0,1171,1589,-20
40333816640,40333816640,0,1141,1411,-20
40335630918,40335630922,4,1840,998,-20
40339252646,40339252648,2,1976,953,-20
40339542895,40339542890,-5,1014,349,-20
40340753866,40340753871,5,1954,988,-20
40340878489,40340878494,5,1710,1542,-20
40341914656,40341914657,1,1713,1278,-20
40345381562,40345381566,4,1964,925,-20
40345411165,40345411170,5,1829,1165,-20
40347465050,40347465050,0,1003,1598,-20
40348765319,40348765322,3,2332,1758,-20
40350897985,40350897990,5,1239,1078,-20
40352018706,40352018711,5,1681,1772,-20
40352660543,40352660546,3,1500,1215,-20
40353165689,40353165694,5,2135,1357,-20
40353596760,40353596765,5,1823,1904,-20
40353961695,40353961698,3,1438,952,-20
40354242346,40354242329,-17,1629,838,-20
40355023739,40355023743,4,2416,1365,-20
40362258462,40362258467,5,1450,1309,-20
40362949594,40362949609,15,1380,1280,-20
40366328318,40366328320,2,2477,1547,-20
40368269274,40368269277,3,1508,1346,-20
40369325965,40369325970,5,2148,1685,-20
40371570523,40371570526,3,1654,1432,-20
40372193614,40372193613,-1,1883,2373,-20
40375217899,40375217901,2,1251,1039,-20
40377070073,40377070085,12,1781,1186,-20
40378831634,40378831636,2,1598,1784,-20
40379769065,40379769070,5,2107,1523,-20
40383582381,40383582381,0,1362,1337,-20
40386683530,40386683534,4,2171,2263,-20
40386964047,40386964050,3,2647,1828,-20
40390798578,40390798582,4,1894,1101,-20
40392644553,40392644553,0,2227,970,-20
40395253642,40395253638,-4,1369,3277,-20
40401813244,40401813247,3,3106,2135,-20
40405081436,40405081438,2,2063,1348,-20
40405775287,40405775285,-2,20992,53373,-20
40411297597,40411297599,2,1217,776,-20
40415727426,40415727431,5,1278,969,-20
40418718757,40418718761,4,1773,1914,-20
40421467974,40421467978,4,1526,2181,-20
40421775644,40421775650,6,2215,1216,-20
40422976276,40422976280,4,2264,1595,-20
40428331978,40428331979,1,1526,1132,-20
40428766930,40428766933,3,1816,1623,-20
40429119679,40429119661,-18,1719,576,-20
40431580887,40431580890,3,1485,1040,-20
40432447519,40432447523,4,2171,1643,-20
40437952099,40437952103,4,1562,1384,-20
40438371835,40438371838,3,1435,1123,-20
40440606819,40440606824,5,1203,705,-20
40441778380,40441778382,2,1974,1116,-20
40443181061,40443181066,5,877,627,-20
40445008701,40445008704,3,2018,1588,-20
40447633559,40447633547,-12,1553,1184,-20
40447886505,40447886507,2,1665,1280,-20
40448506846,40448506851,5,1994,1246,-20
40452874887,40452874890,3,1466,835,-20
40457685803,40457685806,3,1413,1539,-20
40458402865,40458402869,4,2078,1703,-20
40462314514,40462314518,4,2143,1519,-20
40462427830,40462427835,5,1639,981,-20
40462784126,40462784115,-11,835,361,-20
40464221078,40464221082,4,2480,1314,-20
40464996718,40464996739,21,1464,1854,-20
40466145887,40466145889,2,1569,1431,-20
40467626941,40467626943,2,2322,1670,-20
40468982787,40468982793,6,2201,1142,-20
40475239418,40475239422,4,1384,1392,-20
40477468822,40477468829,7,5260,1942,-20
40481846411,40481846418,7,2865,1301,-20
40482270043,40482270048,5,2200,2324,-20
40485770887,40485770889,2,2012,1744,-20
40486119436,40486119437,1,1675,1576,-20
40486427168,40486427171,3,2391,1819,-20
40486891686,40486891690,4,2147,1239,-20
40487398070,40487398074,4,2173,1267,-20
40488081829,40488081830,1,1744,1568,-20
40488357591,40488357595,4,1585,1367,-20
40489385782,40489385784,2,1927,1073,-20
40492930586,40492930589,3,1590,1080,-20
40494050426,40494050420,-6,3608,295,-20
40495398310,40495398312,2,1618,1179,-20
40496207307,40496207309,2,1957,1643,-20
40498872846,40498872850,4,2506,1031,-20
40499719279,40499719282,3,3139,1070,-20
40501700429,40501700431,2,1669,1142,-20
40504880229,40504880230,1,1989,1755,-20
40507956914,40507956918,4,1305,923,-20
40508227549,40508227560,11,1071,1358,-20
40509207036,40509207041,5,1783,1174,-20
40510195084,40510195088,4,2620,1487,-20
40511601222,40511601226,4,2218,1421,-20
40514117067,40514117070,3,1672,1165,-20
40518149198,40518149200,2,1416,1689,-20
40519457426,40519457429,3,2575,1798,-20
40523230259,40523230263,4,1792,2091,-20
40523678782,40523678785,3,2643,1830,-20
40525677395,40525677402,7,1875,1297,-20
40527727490,40527727496,6,5656,3293,-20
40528221420,40528221425,5,1718,1366,-20
40528547131,40528547135,4,2097,1359,-20
40529034821,40529034825,4,2002,1491,-20
40530343561,40530343565,4,2443,1273,-20
40538474502,40538474503,1,1100,1069,-20
40545921617,40545921621,4,1905,1594,-20
40549161853,40549161855,2,1123,879,-20
40550935402,40550935406,4,2606,2425,-20
40551544599,40551544604,5,2127,1208,-20
40551858831,40551858833,2,974,1141,-20
40553960832,40553960834,2,1214,663,-20
40554034991,40554034970,-21,1327,777,-20
40554813966,40554813971,5,2038,1376,-20
40556564494,40556564494,0,12376,12848,-20
40558961697,40558961701,4,1878,1160,-20
40561414862,40561414864,2,1986,1762,-20
40564702108,40564702109,1,2071,1594,-20
40566954066,40566954069,3,1700,1334,-20
40569121289,40569121289,0,1896,2353,-20
40571228822,40571228826,4,2066,1617,-20
40571727334,40571727338,4,2148,2154,-20
40573571686,40573571688,2,1557,1428,-20
40578422222,40578422227,5,1345,1221,-20
40581400059,40581400063,4,1613,1219,-20
40583724689,40583724693,4,2321,1343,-20
40586080028,40586080031,3,2186,1623,-20
40587070015,40587070020,5,4840,3119,-20
40587871877,40587871881,4,1373,1371,-20
40588659579,40588659583,4,1345,1206,-20
40592469122,40592469126,4,1640,892,-20
40594853669,40594853674,5,2922,1401,-20
40596370647,40596370653,6,1888,1156,-20
40599474849,40599474850,1,2282,1978,-20
40600404426,40600404429,3,2515,2048,-20
40601444925,40601444929,4,2193,2057,-20
40601562944,40601562949,5,1470,1035,-20
40601588670,40601588650,-20,2132,1546,-20
40605892225,40605892226,1,1065,1202,-20
40606416674,40606416678,4,1766,1228,-20
40608426934,40608426939,5,2451,1585,-20
40608488267,40608488270,3,1596,1112,-20
40609008129,40609008130,1,1470,1408,-20
40611036359,40611036361,2,3256,3650,-20
40612644827,40612644830,3,1920,937,-20
40613933507,40613933511,4,2347,1919,-20
40619290882,40619290886,4,2429,1412,-20
40620104866,40620104867,1,1877,1731,-20
40628961878,40628961881,3,1126,1563,-20
40629272559,40629272553,-6,1190,3457,-20
40631190119,40631190113,-6,265,2866,-20
40634344578,40634344582,4,1660,927,-20
40635123326,40635123305,-21,1321,1468,-20
40635961866,40635961869,3,1587,1138,-20
40637307862,40637307866,4,1576,1188,-20
40638850878,40638850880,2,1511,1574,-20
40642423569,40642423571,2,1464,1380,-20
40643108162,40643108164,2,1607,1403,-20
40644744204,40644744207,3,1780,1146,-20
40644829491,40644829476,-15,1377,1154,-20
40648803214,40648803217,3,2263,1220,-20
40649155563,40649155565,2,1636,1432,-20
40650552588,40650552592,4,1785,1200,-20
40654428842,40654428846,4,1956,1394,-20
40657255298,40657255302,4,1083,1160,-20
40659028621,40659028626,5,1442,1147,-20
40660847228,40660847231,3,959,1269,-20
40661468014,40661468017,3,2048,1675,-20
40664777779,40664777782,3,1959,1486,-20
40666199466,40666199470,4,2564,1625,-20
40671368671,40671368674,3,3483,3675,-20
40671662241,40671662246,5,1692,1066,-20
40671891617,40671891621,4,2405,1625,-20
40673187650,40673187650,0,1258,1331,-20
40673372038,40673372042,4,1856,1903,-20
40676982337,40676982339,2,1256,650,-20
40680931983,40680931987,4,1818,1512,-20
40681380626,40681380627,1,1968,1328,-20
40682563141,40682563145,4,1477,1235,-20
40683894006,40683894009,3,1330,983,-20
40686291019,40686291022,3,1273,1515,-20
40688133080,40688133083,3,1516,1330,-20
40689644261,40689644262,1,1840,1698,-20
40690254317,40690254319,2,2041,1626,-20
40691981079,40691981084,5,2749,1708,-20
40692946971,40692946976,5,2082,1436,-20
40694852919,40694852912,-7,1170,4322,-20
40696140776,40696140769,-7,876,3561,-20
40697582094,40697582093,-1,1305,2368,-20
40702027068,40702027070,2,2416,2049,-20
40705644102,40705644081,-21,1260,1030,-20
40707194415,40707194411,-4,608,806,-20
40709174437,40709174442,5,1902,1399,-20
40710638739,40710638742,3,1613,1484,-20
40710850006,40710850010,4,1663,1060,-20
40712366737,40712366739,2,1632,1366,-20
40715818081,40715818084,3,1897,1612,-20
40717319413,40717319417,4,2134,1378,-20
40720185371,40720185374,3,1805,1286,-20
40727475866,40727475869,3,344,1948,-20
40729348941,40729348945,4,1384,1081,-20
40735080086,40735080087,1,1919,1992,-20
40739674925,40739674929,4,2168,1466,-20
40741229970,40741229974,4,2265,2194,-20
40741273427,40741273430,3,2448,1242,-20
40742703564,40742703567,3,2718,1980,-20
40743527766,40743527770,4,1496,1458,-20
40747223335,40747223334,-1,1008,1518,-20
40748953424,40748953429,5,1853,1091,-20
40749928677,40749928682,5,2092,1424,-20
40750886325,40750886329,4,2263,1815,-20
40751700689,40751700693,4,2374,1683,-20
40752214132,40752214137,5,1881,1555,-20
40755411746,40755411750,4,2257,1364,-20
40756344030,40756344029,-1,1780,1432,-20
40756403857,40756403859,2,267,757,-20
40757225479,40757225481,2,1607,1446,-20
40758010919,40758010939,20,1274,1662,-20
40759267329,40759267335,6,1743,1468,-20
40761006462,40761006466,4,2736,1432,-20
40762194074,40762194081,7,2249,1490,-20
40763222691,40763222689,-2,1025,1934,-20
40765030462,40765030466,4,1430,1528,-20
40767717218,40767717219,1,1398,1697,-20
40771135851,40771135855,4,1113,1134,-20
40774004662,40774004665,3,1931,1656,-20
40779972930,40779972932,2,2603,1886,-20
40780176062,40780176043,-19,906,748,-20
40782438216,40782438219,3,2143,1446,-20
40782607970,40782607973,3,1188,1156,-20
40785159319,40785159322,3,1632,1312,-20
40785676677,40785676681,4,2172,1605,-20
40788456355,40788456357,2,2569,1944,-20
40788731174,40788731173,-1,1481,1891,-20
40788836246,40788836265,19,1544,1275,-20
40791800809,40791800808,-1,1391,2023,-20
40792320974,40792320974,0,958,1187,-20
40793516790,40793516794,4,1303,1477,-20
40794582482,40794582486,4,1727,1243,-20
40795916446,40795916450,4,1579,1613,-20
40796136862,40796136867,5,2697,1813,-20
40799466461,40799466467,6,4039,1597,-20
40803241304,40803241310,6,2116,1730,-20
40809912974,40809912978,4,1814,1624,-20
40815701030,40815701034,4,919,1404,-20
40816549501,40816549502,1,1253,912,-20
40818454387,40818454389,2,1592,1793,-20
40818806205,40818806209,4,2541,1309,-20
40819206481,40819206482,1,1670,1454,-20
40820608072,40820608059,-13,539,223,-20
40821800013,40821800014,1,1260,1059,-20
40828252144,40828252137,-7,2054,1336,-20
40831642849,40831642851,2,1784,1538,-20
40832105266,40832105267,1,1827,1557,-20
40834119563,40834119568,5,2871,1039,-20
40843271465,40843271468,3,1885,1982,-20
40845120698,40845120702,4,2026,748,-20
40847026905,40847026910,5,1344,1130,-20
40847309898,40847309898,0,1560,2043,-20
40848095423,40848095427,4,2076,2306,-20
40848554382,40848554382,0,1669,2544,-20
40850175085,40850175086,1,1499,1102,-20
40851262329,40851262333,4,1618,1518,-20
40851975787,40851975791,4,2076,1403,-20
40853580010,40853580017,7,4002,2213,-20
40855683554,40855683557,3,1300,1642,-20
40855955726,40855955730,4,1723,1447,-20
40856126847,40856126851,4,1942,1332,-20
40857255030,40857255030,0,1432,1134,-20
40858133190,40858133194,4,2560,1025,-20
40858290430,40858290432,2,1827,1222,-20
40858598117,40858598109,-8,1246,4001,-20
40861807146,40861807150,4,1944,1292,-20
40867620092,40867620098,6,2718,1391,-20
40873773696,40873773698,2,2057,1073,-20
40877442313,40877442317,4,1788,1548,-20
40877705682,40877705685,3,968,1155,-20
40883542869,40883542872,3,1589,1586,-20
40884232059,40884232065,6,2391,1822,-20
40885325051,40885325057,6,2752,1042,-20
40886678553,40886678537,-16,1108,931,-20
40889120013,40889120017,4,2507,1587,-20
40890035990,40890035993,3,1425,1495,-20
40891629411,40891629414,3,1513,1105,-20
40894184098,40894184102,4,2155,1678,-20
40895832212,40895832217,5,1874,1208,-20
40900321752,40900321754,2,2437,1653,-20
40901451821,40901451823,2,1815,974,-20
40901662809,40901662815,6,1076,482,-20
40902476115,40902476113,-2,1072,2667,-20
40905068685,40905068690,5,1823,1211,-20
40905709186,40905709189,3,2834,1460,-20
40905884775,40905884778,3,1337,904,-20
40907363615,40907363610,-5,1454,3933,-20
40909472217,40909472217,0,3247,3488,-20
40911097785,40911097787,2,1448,1676,-20
40913506684,40913506685,1,1473,1446,-20
40918133531,40918133533,2,2131,1503,-20
40918524836,40918524849,13,1622,1458,-20
40921012527,40921012530,3,2446,1718,-20
40921510271,40921510273,2,1848,1549,-20
40923878231,40923878235,4,1709,1286,-20
40924500728,40924500731,3,2051,1350,-20
40924790911,40924790915,4,2368,1811,-20
40929575573,40929575582,9,3646,1211,-20
40929651066,40929651070,4,2049,1319,-20
40929915079,40929915083,4,1566,1358,-20
40935642889,40935642893,4,1593,1323,-20
40940403249,40940403242,-7,1857,4408,-20
40940577986,40940577990,4,869,1368,-20
40945009618,40945009618,0,1687,1396,-20
40945228298,40945228302,4,1612,1489,-20
40948009834,40948009839,5,1365,1121,-20
40950271384,40950271390,6,1760,691,-20
40951182969,40951182973,4,1979,1700,-20
40951599451,40951599454,3,1534,1759,-20
40952921100,40952921103,3,1547,1097,-20
40957912478,40957912485,7,1255,896,-20
40960587996,40960587990,-6,1433,5927,-20
40969754607,40969754605,-2,1129,2288,-20
40971614890,40971614893,3,2175,1572,-20
40975052688,40975052688,0,1497,1290,-20
40979629938,40979629942,4,1414,1168,-20
40981805557,40981805560,3,1528,1866,-20
40983125715,40983125718,3,2429,1327,-20
40984210697,40984210700,3,2243,1153,-20
40984384822,40984384825,3,1893,967,-20
40988812930,40988812933,3,1706,969,-20
40989209254,40989209261,7,2286,1027,-20
40989487461,40989487442,-19,1162,1131,-20
40990078814,40990078818,4,981,909,-20
40992951610,40992951617,7,2794,1006,-20
40996964416,40996964419,3,1481,2082,-20
40998160430,40998160433,3,1717,2220,-20
40998545382,40998545372,-10,615,124,-20
40999221346,40999221349,3,1773,1232,-20
41004790583,41004790587,4,1704,987,-20
41009146862,41009146866,4,1236,1641,-20
41011120686,41011120690,4,2043,1459,-20
41012622082,41012622086,4,1963,1751,-20
41013810675,41013810680,5,2226,1606,-20
41016826257,41016826263,6,2164,1133,-20
41020173954,41020173954,0,1443,585,-20
41023671345,41023671349,4,1217,1336,-20
41029914557,41029914561,4,2866,2146,-20
41030770037,41030770040,3,2242,1730,-20
41039164790,41039164796,6,1389,1239,-20
41043288769,41043288773,4,2513,1977,-20
41044561463,41044561466,3,1390,838,-20
41047961947,41047961950,3,2186,1577,-20
41049039913,41049039915,2,1918,1413,-20
41049987659,41049987662,3,2109,1849,-20
41051983138,41051983139,1,1569,1544,-20
41053488010,41053488014,4,2279,1763,-20
41054165158,41054165159,1,1195,1639,-20
41055751540,41055751543,3,1978,1433,-20
41056471461,41056471465,4,1400,1564,-20
41059344862,41059344866,4,2424,1497,-20
41059598756,41059598759,3,1936,1680,-20
41061169930,41061169933,3,1542,1617,-20
41061480452,41061480453,1,1645,1284,-20
41062983853,41062983855,2,1783,1161,-20
41071920681,41071920686,5,2543,1295,-20
41074336983,41074336987,4,1409,1171,-20
41079051060,41079051062,2,1273,1232,-20
41082661303,41082661306,3,1716,1207,-20
41084713931,41084713934,3,1440,659,-20
41088032034,41088032030,-4,936,2939,-20
41088232368,41088232371,3,1621,1088,-20
41088331334,41088331338,4,2487,1595,-20
41089358332,41089358335,3,1281,1112,-20
41093014132,41093014135,3,1894,1578,-20
41093475254,41093475262,8,1201,1075,-20
41093951745,41093951748,3,2167,1498,-20
41094049154,41094049158,4,1747,1226,-20
41095212284,41095212286,2,2166,1079,-20
41102274573,41102274575,2,1291,1268,-20
41102304266,41102304273,7,2489,1742,-20
41107087230,41107087234,4,2772,1400,-20
41112651510,41112651513,3,1356,1263,-20
41114447853,41114447854,1,1439,1667,-20
41118413765,41118413767,2,1926,1304,-20
41122874658,41122874651,-7,40205,13215,-20
41123915208,41123915212,4,1912,1528,-20
41126388277,41126388282,5,2207,1962,-20
41128407854,41128407857,3,1830,1346,-20
41129411095,41129411100,5,1703,1314,-20
41131384126,41131384118,-8,21165,16439,-20
41138406246,41138406241,-5,1053,3149,-20
41138907319,41138907322,3,1408,993,-20
41139412501,41139412506,5,2513,2249,-20
41140184632,41140184636,4,1565,1919,-20
41140467616,41140467598,-18,37,1226,-20
41142159242,41142159246,4,1739,1585,-20
41145908184,41145908189,5,1644,1023,-20
41153399106,41153399111,5,1629,1202,-20
41154907804,41154907807,3,2598,1677,-20
41155941303,41155941306,3,1000,1147,-20
41156079250,41156079255,5,1407,1455,-20
41156309196,41156309200,4,1741,1631,-20
41159542902,41159542908,6,1612,1358,-20
41162321381,41162321384,3,2443,1769,-20
41165507229,41165507211,-18,1195,965,-20
41167342384,41167342386,2,1398,1325,-20
41169670943,41169670948,5,1439,981,-20
41170393115,41170393119,4,1532,872,-20
41175567024,41175567027,3,1510,750,-20
41176151977,41176151979,2,1854,1370,-20
41180580824,41180580827,3,2073,1978,-20
41181951460,41181951460,0,1940,1955,-20
41182059958,41182059961,3,1633,1439,-20
41184290202,41184290205,3,1170,859,-20
41185813470,41185813474,4,1629,1704,-20
41187435150,41187435155,5,1930,1117,-20
41200477951,41200477931,-20,1754,864,-20
41203930109,41203930110,1,2596,2741,-20
41204187195,41204187198,3,2330,1551,-20
41204585502,41204585506,4,1317,917,-20
41205702551,41205702554,3,1586,1195,-20
41208838036,41208838042,6,1727,1167,-20
41210124042,41210124045,3,1701,1153,-20
41211473068,41211473071,3,1322,1320,-20
41219656306,41219656306,0,1490,967,-20
41220305345,41220305348,3,1971,1338,-20
41222574010,41222574014,4,969,896,-20
41223833749,41223833755,6,2212,1786,-20
41224044826,41224044835,9,2073,1368,-20
41224192422,41224192416,-6,1291,1662,-20
41226024407,41226024411,4,1907,1479,-20
41226762345,41226762349,4,1247,1265,-20
41227749706,41227749710,4,1540,1430,-20
41228195028,41228195032,4,2430,1083,-20
41229024681,41229024688,7,714,62,-20
41230191883,41230191887,4,1379,1275,-20
41230342002,41230341981,-21,1078,1627,-20
41230774745,41230774747,2,1679,1329,-20
41231529708,41231529711,3,1799,1173,-20
41234515158,41234515162,4,1919,1669,-20
41235365559,41235365563,4,2613,1792,-20
41238265738,41238265742,4,1696,1447,-20
41239037252,41239037258,6,1934,1791,-20
41240542775,41240542778,3,1547,994,-20
41249558985,41249558979,-6,1497,6360,-20
41251599830,41251599830,0,1092,878,-20
41253882317,41253882319,2,1630,1080,-20
41254950191,41254950194,3,1309,1139,-20
41255128140,41255128144,4,1780,1497,-20
41257638321,41257638326,5,1763,1163,-20
41258132673,41258132675,2,2072,1166,-20
41259046465,41259046468,3,1637,960,-20
41260016753,41260016756,3,1267,1257,-20
41260198183,41260198187,4,1642,853,-20
41262411077,41262411078,1,2978,2195,-20
41264804404,41264804406,2,1497,1113,-20
41266421870,41266421870,0,1516,1686,-20
41269020392,41269020396,4,1697,1291,-20
41270477058,41270477061,3,1200,1193,-20
41270611537,41270611538,1,1927,1156,-20
41274460193,41274460199,6,1911,1350,-20
41275311070,41275311075,5,1887,1226,-20
41275542498,41275542501,3,1856,1442,-20
41275774761,41275774762,1,1640,1935,-20
41276440713,41276440720,7,1975,1123,-20
41280958101,41280958105,4,1948,1399,-20
41281886578,41281886582,4,2059,1515,-20
41283665954,41283665958,4,1325,997,-20
41284726093,41284726095,2,1177,826,-20
41287533636,41287533642,6,1674,1090,-20
41288290681,41288290683,2,1439,2147,-20
41295187630,41295187634,4,1786,1212,-20
41295620146,41295620151,5,1505,1057,-20
41301623407,41301623410,3,1297,922,-20
41305123855,41305123855,0,1197,1368,-20
41305633494,41305633498,4,1864,1405,-20
41308833179,41308833183,4,1994,1166,-20
41312941205,41312941224,19,105,1582,-20
41316064885,41316064890,5,1846,1060,-20
41318534062,41318534067,5,2002,1337,-20
41318781382,41318781385,3,1649,1201,-20
41323516314,41323516318,4,1725,1182,-20
41325353607,41325353610,3,1172,2284,-20
41326404798,41326404802,4,2106,1648,-20
41326605572,41326605576,4,1645,1666,-20
41328715105,41328715112,7,3447,1368,-20
41331494711,41331494713,2,1511,1309,-20
41333514992,41333514998,6,1895,1234,-20
41340180251,41340180257,6,1230,1500,-20
41341422934,41341422937,3,1577,1901,-20
41341505714,41341505717,3,1828,1136,-20
41346322580,41346322583,3,1568,2198,-20
41348119889,41348119890,1,2387,1854,-20
41350893002,41350893005,3,2091,1218,-20
41352346230,41352346233,3,1689,2321,-20
41355314863,41355314865,2,1374,1711,-20
41356809183,41356809186,3,1473,910,-20
41359455064,41359455069,5,3066,1140,-20
41359637695,41359637683,-12,9840,39549,-20
41361664971,41361664974,3,4506,18931,-20
41362871180,41362871182,2,1370,1806,-20
41364621127,41364621130,3,1238,1196,-20
41366177204,41366177223,19,44,1401,-20
41368887326,41368887330,4,2352,1390,-20
41371633194,41371633197,3,1497,956,-20
41372392713,41372392715,2,1682,1025,-20
41372482279,41372482258,-21,825,374,-20
41372581050,41372581053,3,1843,1541,-20
41374284712,41374284715,3,2002,693,-20
41377797378,41377797381,3,1778,1672,-20
41384139517,41384139521,4,2591,1698,-20
41384842880,41384842880,0,1964,1338,-20
41385043511,41385043513,2,1885,1464,-20
41385626060,41385626062,2,2000,1042,-20
41386117413,41386117418,5,3837,2909,-20
41386864822,41386864825,3,1987,815,-20
41389728858,41389728861,3,1549,1444,-20
41391829770,41391829771,1,1081,1619,-20
41392722434,41392722434,0,1205,1506,-20
41394158525,41394158527,2,2101,1317,-20
41397953308,41397953310,2,2138,1680,-20
41398598967,41398598967,0,1758,1457,-20
41401215295,41401215298,3,1824,1334,-20
41401340669,41401340649,-20,2642,1859,-20
41403090070,41403090073,3,1924,1850,-20
41403286437,41403286442,5,4555,1642,-20
41403951562,41403951562,0,1282,1679,-20
41405064498,41405064503,5,1653,1524,-20
41408186447,41408186451,4,1959,1014,-20
41408927938,41408927941,3,2266,1503,-20
41410764502,41410764507,5,2029,1566,-20
41411336150,41411336151,1,1132,1262,-20
41414830637,41414830641,4,2587,1030,-20
41416690062,41416690061,-1,1844,1625,-20
41422877722,41422877726,4,1314,996,-20
41423370120,41423370123,3,1926,1592,-20
41423534393,41423534396,3,1952,1617,-20
41424840314,41424840319,5,1173,959,-20
41426374258,41426374261,3,1921,1418,-20
41427016589,41427016592,3,4946,2873,-20
41429900714,41429900716,2,1985,1998,-20
41430468798,41430468802,4,2164,1739,-20
41434040707,41434040709,2,1922,1636,-20
41434610189,41434610190,1,1699,1062,-20
41435088199,41435088203,4,1200,745,-20
41439099473,41439099481,8,7165,2059,-20
41439352885,41439352889,4,1711,1228,-20
41440150249,41440150251,2,1723,1193,-20
41442219864,41442219867,3,1446,1639,-20
41445868897,41445868901,4,1627,1370,-20
41446640483,41446640486,3,1889,1627,-20
41446903382,41446903384,2,2229,2152,-20
41447636312,41447636314,2,1710,1486,-20
41452052797,41452052798,1,1344,1498,-20
41458695541,41458695545,4,1648,1148,-20
41458775450,41458775454,4,1737,1553,-20
41459804406,41459804409,3,2450,1441,-20
41463589158,41463589162,4,1461,1151,-20
41466210525,41466210531,6,1597,900,-20
41466767778,41466767779,1,784,1215,-20
41473614347,41473614349,2,1460,1395,-20
41475136933,41475136929,-4,1646,4381,-20
41476941154,41476941161,7,1844,1041,-20
41478725356,41478725363,7,2516,1443,-20
41478791381,41478791385,4,1333,1075,-20
41482090407,41482090410,3,1690,1376,-20
41485260286,41485260286,0,2712,2029,-20
41485335043,41485335047,4,2507,2182,-20
41486530185,41486530186,1,2006,856,-20
41487918071,41487918074,3,2260,1303,-20
41489535996,41489536001,5,2241,1266,-20
41489595910,41489595929,19,2026,1038,-20
41490397141,41490397124,-17,570,420,-20
41490581541,41490581545,4,2080,1410,-20
41491169301,41491169305,4,1492,1404,-20
41491296318,41491296319,1,2708,1158,-20
41491669512,41491669515,3,1063,1787,-20
41496728414,41496728418,4,1381,1549,-20
41497205479,41497205479,0,1587,1454,-20
41497502806,41497502808,2,1115,1205,-20
41498188966,41498188987,21,1664,1356,-20
41500451387,41500451389,2,1231,1072,-20
41500606486,41500606489,3,1524,1299,-20
41502413827,41502413832,5,1943,1006,-20
41507206922,41507206926,4,1719,1339,-20
41512800319,41512800318,-1,1471,2174,-20
41513973675,41513973680,5,2131,1256,-20
41517650599,41517650604,5,1847,1166,-20
41522455571,41522455574,3,1794,1353,-20
41525994624,41525994627,3,2114,1576,-20
41526880391,41526880396,5,1549,1642,-20
41527470685,41527470689,4,1661,1809,-20
41528759668,41528759671,3,1266,1041,-20
41529993073,41529993076,3,2012,1625,-20
41532654807,41532654812,5,1414,1599,-20
41534271246,41534271250,4,2028,1358,-20
41536078850,41536078854,4,1910,1158,-20
41539127866,41539127870,4,2501,1522,-20
41540320082,41540320085,3,2040,1563,-20
41542016894,41542016894,0,7006,9228,-20
41542383601,41542383607,6,1724,1004,-20
41545082924,41545082926,2,1432,823,-20
41547436546,41547436548,2,1686,1476,-20
41551512566,41551512575,9,12580,31315,-20
41551563468,41551563472,4,2179,1235,-20
41551852641,41551852650,9,1932,1622,-20
41552222708,41552222710,2,972,1353,-20
41552480155,41552480158,3,1978,859,-20
41552524540,41552524544,4,2045,1416,-20
41552854586,41552854571,-15,2176,1027,-20
41553044744,41553044746,2,1783,1031,-20
41563196027,41563196032,5,1038,1576,-20
41565654386,41565654389,3,2228,1283,-20
41566170244,41566170249,5,2464,2450,-20
41566304916,41566304934,18,2218,6885,-20
41567925025,41567925029,4,1420,1137,-20
41572870259,41572870260,1,2015,2183,-20
41575996247,41575996250,3,1948,1952,-20
41576097684,41576097686,2,1739,2001,-20
41576221178,41576221180,2,2016,1494,-20
41577116477,41577116480,3,1672,1820,-20
41579757398,41579757401,3,1655,1896,-20
41581294429,41581294438,9,10848,34144,-20
41584653463,41584653467,4,1641,1550,-20
41587084614,41587084618,4,1450,1534,-20
41589865235,41589865241,6,2094,1331,-20
41590215722,41590215724,2,2462,1973,-20
41592236455,41592236457,2,1663,1516,-20
41592403838,41592403845,7,4602,1904,-20
41596002633,41596002638,5,2075,1294,-20
41597954852,41597954855,3,2272,1522,-20
41599701679,41599701678,-1,1270,2603,-20
41602325210,41602325214,4,1576,1009,-20
41603390373,41603390378,5,2166,1497,-20
41605535173,41605535175,2,1355,1222,-20
41605571321,41605571339,18,555,311,-20
41606968946,41606968950,4,2114,1063,-20
41607724996,41607724999,3,2311,1801,-20
41608202601,41608202604,3,1608,1251,-20
41610231498,41610231500,2,2168,2167,-20
41610257218,41610257221,3,1640,1582,-20
41610935388,41610935390,2,1826,1139,-20
41612055280,41612055282,2,1656,1028,-20
41614689494,41614689497,3,1407,1177,-20
41616645869,41616645871,2,2028,1908,-20
41617378157,41617378160,3,1814,1635,-20
41617943126,41617943131,5,2292,1107,-20
41620182992,41620182995,3,1450,1361,-20
41623147746,41623147747,1,1610,1400,-20
41625277757,41625277736,-21,1017,2630,-20
41630109100,41630109117,17,152,4919,-20
41631330134,41631330137,3,1479,1069,-20
41631874315,41631874318,3,2116,1389,-20
41635329755,41635329758,3,2224,1464,-20
41637472624,41637472627,3,1611,1578,-20
41638438318,41638438322,4,1899,1421,-20
41642235573,41642235577,4,1864,1426,-20
41645152009,41645152014,5,2016,1760,-20
41646475968,41646475973,5,2522,1384,-20
41647735006,41647735010,4,1900,1239,-20
41648262317,41648262320,3,1961,1537,-20
41649511399,41649511402,3,1151,1010,-20
41650162559,41650162562,3,2427,1985,-20
41652650102,41652650109,7,2323,1096,-20
41653098365,41653098374,9,7929,1599,-20
41653275681,41653275683,2,1795,1334,-20
41654608886,41654608889,3,2134,1603,-20
41658168318,41658168324,6,1663,1435,-20
41658350047,41658350024,-23,1125,1032,-20
41659371007,41659371010,3,1359,1218,-20
41662681233,41662681239,6,3670,1266,-20
41667705871,41667705874,3,1531,792,-20
41669300434,41669300435,1,1061,1829,-20
41669492246,41669492250,4,1976,978,-20
41673437415,41673437418,3,2521,1790,-20
41675041962,41675041965,3,1719,1060,-20
41675806586,41675806589,3,1886,1279,-20
41678829394,41678829399,5,1778,1094,-20
41682021201,41682021205,4,1638,1680,-20
41683757472,41683757478,6,1475,1124,-20
41689761385,41689761388,3,2233,1323,-20
41692200207,41692200212,5,2138,1428,-20
41692856026,41692856030,4,1639,1170,-20
41693063666,41693063668,2,1621,1410,-20
41693279605,41693279609,4,2214,1723,-20
41694537671,41694537678,7,1977,1170,-20
41696915414,41696915417,3,2135,1742,-20
41697523337,41697523340,3,1305,1218,-20
41700033442,41700033446,4,2740,2211,-20
41701348447,41701348448,1,927,1049,-20
41701513498,41701513502,4,1504,1257,-20
41701696259,41701696263,4,1699,1271,-20
41702240014,41702240026,12,2093,786,-20
41704396097,41704396099,2,1323,1399,-20
41705284263,41705284266,3,1125,1141,-20
41707611052,41707611049,-3,943,869,-20
41710783745,41710783747,2,2513,2219,-20
41721054386,41721054385,-1,6922,10143,-20
41722517582,41722517585,3,1504,1661,-20
41723638093,41723638093,0,1837,1766,-20
41724166643,41724166644,1,2061,1501,-20
41726201985,41726201990,5,2360,1285,-20
41727861367,41727861370,3,2246,1611,-20
41728024429,41728024432,3,2203,1310,-20
41731061174,41731061178,4,1929,1210,-20
41731435066,41731435075,9,1487,1055,-20
41733060486,41733060465,-21,2427,1372,-20
41735554565,41735554567,2,1182,959,-20
41736758142,41736758144,2,48646,22445,-20
41739260836,41739260841,5,2165,1480,-20
41740351033,41740351035,2,2466,2307,-20
41743463958,41743463963,5,1677,1562,-20
41749618390,41749618395,5,2273,1737,-20
41751241168,41751241171,3,1524,1469,-20
41752868532,41752868537,5,1809,1532,-20
41755780032,41755780036,4,1697,1096,-20
41762818238,41762818242,4,1867,1224,-20
41763298258,41763298261,3,1683,1114,-20
41767580351,41767580353,2,1560,1944,-20
41769782328,41769782330,2,1722,1658,-20
41771035301,41771035305,4,2115,1327,-20
41771598022,41771598032,10,1929,1360,-20
41775937525,41775937527,2,1755,1327,-20
41777158823,41777158827,4,1358,1110,-20
41778085553,41778085555,2,1910,1404,-20
41778701170,41778701174,4,1705,1402,-20
41780094565,41780094574,9,2628,1240,-20
41780556717,41780556719,2,2175,1765,-20
41782073333,41782073336,3,1334,1311,-20
41783792491,41783792495,4,2319,1240,-20
41787747717,41787747720,3,2430,2111,-20
41790087981,41790087985,4,2439,1617,-20
41790763785,41790763786,1,1500,881,-20
41790818914,41790818895,-19,927,1723,-20
41795354046,41795354050,4,1729,1468,-20
41797418008,41797418009,1,1682,1202,-20
41797953817,41797953818,1,1489,1417,-20
41800807303,41800807306,3,1269,1219,-20
41800925652,41800925656,4,2174,1403,-20
41804801762,41804801766,4,1928,1491,-20
41806234792,41806234795,3,1303,987,-20
41807544362,41807544365,3,2335,1752,-20
41810527686,41810527691,5,1395,1033,-20
41811191601,41811191603,2,1318,1149,-20
41814083787,41814083789,2,1831,1843,-20
41814987582,41814987585,3,1628,1172,-20
41815735305,41815735306,1,1807,1002,-20
41817575559,41817575559,0,1675,1534,-20
41825145879,41825145873,-6,2290,6657,-20
41825751994,41825751995,1,1565,1298,-20
41830402865,41830402868,3,1722,1359,-20
41832188959,41832188964,5,1792,1383,-20
41832322530,41832322535,5,2606,1690,-20
41835009537,41835009540,3,1713,1391,-20
41836993134,41836993138,4,2004,1413,-20
41837762780,41837762783,3,2620,2046,-20
41841727593,41841727597,4,1206,1568,-20
41842250933,41842250934,1,2246,2212,-20
41842349078,41842349080,2,1683,1561,-20
41842500758,41842500760,2,1727,1197,-20
41845932088,41845932090,2,1634,1040,-20
41848262845,41848262848,3,2703,1906,-20
41848424314,41848424318,4,1853,1334,-20
41849321552,41849321555,3,2082,1646,-20
41853140599,41853140604,5,1985,1637,-20
41861787097,41861787098,1,1413,1249,-20
41861963177,41861963181,4,1994,1434,-20
41863592337,41863592338,1,2423,2253,-20
41863718075,41863718079,4,1672,945,-20
41865704876,41865704881,5,1343,1185,-20
41865765064,41865765067,3,1299,909,-20
41869471554,41869471553,-1,919,1242,-20
41869878863,41869878867,4,2312,1508,-20
41870912219,41870912224,5,2603,1445,-20
41872455102,41872455107,5,1708,1325,-20
41872554782,41872554787,5,1202,1287,-20
41879002129,41879002133,4,1702,1249,-20
41879807059,41879807061,2,1111,1581,-20
41881723098,41881723104,6,1259,1250,-20
41884805813,41884805815,2,2370,1580,-20
41886449151,41886449154,3,1657,1571,-20
41888783331,41888783335,4,1731,1096,-20
41893440988,41893440984,-4,1200,4349,-20
41896236261,41896236265,4,5018,2622,-20
41897885789,41897885794,5,1495,862,-20
41898849052,41898849054,2,1254,1163,-20
41899949829,41899949835,6,1677,1052,-20
41901056238,41901056241,3,1213,884,-20
41904401463,41904401466,3,1738,1963,-20
41908010843,41908010846,3,1890,1321,-20
41909109831,41909109835,4,1537,1043,-20
41912124335,41912124339,4,2635,1570,-20
41912281392,41912281396,4,2092,1375,-20
41912763311,41912763314,3,1755,1394,-20
41917898902,41917898904,2,2227,1422,-20
41918036434,41918036451,17,1361,1104,-20
41918514051,41918514061,10,505,3669,-20
41919564169,41919564166,-3,1072,1749,-20
41921644253,41921644256,3,2681,1722,-20
41922089154,41922089162,8,2769,1486,-20
41927780123,41927780129,6,1947,1353,-20
41928472256,41928472260,4,1742,1153,-20
41930575497,41930575500,3,1811,1347,-20
41930950655,41930950658,3,2203,1488,-20
41932305296,41932305299,3,1771,1187,-20
41937167878,41937167878,0,1548,1417,-20
41941172062,41941172057,-5,674,1038,-20
41941220612,41941220627,15,315,1370,-20
41943617416,41943617421,5,255,555,-20
41947376697,41947376710,13,889,367,-20
41949997410,41949997414,4,1256,1553,-20
41951792215,41951792219,4,1973,1663,-20
41958692220,41958692223,3,1702,1138,-20
41958848835,41958848820,-15,2079,1032,-20
41962565586,41962565590,4,1075,1120,-20
41966239651,41966239652,1,2033,1753,-20
41966650256,41966650259,3,1951,1761,-20
41967571303,41967571297,-6,871,4737,-20
41968088666,41968088669,3,1272,1451,-20
41971727819,41971727821,2,1650,1401,-20
41972792076,41972792078,2,1342,1368,-20
41974755306,41974755310,4,1597,924,-20
41976731587,41976731588,1,1663,1529,-20
41976878841,41976878843,2,1326,1214,-20
41978711109,41978711112,3,2235,2078,-20
41983524559,41983524562,3,1231,1292,-20
41984412707,41984412711,4,2096,1083,-20
41990091138,41990091143,5,1257,1059,-20
41991292454,41991292458,4,2277,1672,-20
41995535133,41995535136,3,1280,1722,-20
41995744404,41995744406,2,2023,1681,-20
41997371443,41997371449,6,1812,1249,-20
41998077322,41998077325,3,2242,1911,-20
41998275218,41998275221,3,2068,1565,-20
42000800492,42000800495,3,1355,1197,-20
42001600212,42001600216,4,1586,1438,-20
42007997312,42007997316,4,1954,1436,-20
42012332584,42012332587,3,2433,1666,-20
42012673365,42012673368,3,2074,1425,-20
42015019774,42015019779,5,1602,1108,-20
42019107182,42019107185,3,1049,905,-20
42020303894,42020303896,2,2252,1623,-20
42020503160,42020503166,6,1775,1211,-20
42024998549,42024998551,2,2079,1359,-20
42027940413,42027940417,4,1154,1350,-20
42031784466,42031784470,4,1800,1616,-20
42031870575,42031870583,8,4558,1370,-20
42044539492,42044539495,3,1426,1632,-20
42045151195,42045151197,2,1497,1197,-20
42046811015,42046811018,3,1660,1404,-20
42046930717,42046930722,5,1352,1538,-20
42047169950,42047169953,3,1665,940,-20
42047306982,42047306986,4,1638,998,-20
42048334853,42048334857,4,2407,1713,-20
42051133300,42051133304,4,2037,1703,-20
42054980763,42054980766,3,2470,2079,-20
42058601378,42058601382,4,1337,1175,-20
42059161010,42059161011,1,2054,1527,-20
42064470210,42064470215,5,2097,1526,-20
42066180404,42066180406,2,1222,1111,-20
42067751704,42067751706,2,1861,1666,-20
42069370308,42069370313,5,1714,1315,-20
42069737545,42069737549,4,1949,1173,-20
42070031541,42070031521,-20,2186,1565,-20
42070143950,42070143954,4,1292,700,-20
42070992843,42070992845,2,1820,1477,-20
42072314172,42072314174,2,1633,1103,-20
42075252645,42075252650,5,1635,1392,-20
42076158542,42076158546,4,2621,1726,-20
42076588870,42076588875,5,1711,1444,-20
42077862326,42077862326,0,1527,1219,-20
42080899065,42080899067,2,1172,924,-20
42087088255,42087088258,3,1660,1639,-20
42089211411,42089211411,0,1778,1099,-20
42090317582,42090317585,3,2179,1513,-20
42091553825,42091553827,2,1737,1708,-20
42093963507,42093963510,3,1086,914,-20
42095891985,42095891986,1,1221,1140,-20
42096308175,42096308179,4,2260,1391,-20
42099283761,42099283763,2,1125,1250,-20
42103616445,42103616446,1,1543,1442,-20
42103800430,42103800423,-7,1464,1138,-20
42104509419,42104509423,4,1919,1821,-20
42106947671,42106947674,3,2184,1514,-20
42108733972,42108733976,4,1735,1435,-20
42110848681,42110848682,1,1587,1117,-20
42113361128,42113361123,-5,1762,4290,-20
42115990410,42115990406,-4,1527,3383,-20
42120310909,42120310913,4,3393,1181,-20
42131013824,42131013823,-1,1930,2499,-20
42132261462,42132261467,5,1492,1038,-20
42133526898,42133526903,5,1129,1142,-20
42141197320,42141197323,3,2165,1196,-20
42142378097,42142378101,4,2085,1929,-20
42147101638,42147101641,3,1803,1437,-20
42149526101,42149526105,4,1841,1343,-20
42151420323,42151420327,4,1763,971,-20
42161654335,42161654338,3,1307,680,-20
42161769244,42161769226,-18,1736,887,-20
42166534618,42166534620,2,1861,1231,-20
42171357501,42171357505,4,1718,1600,-20
42171857771,42171857775,4,1217,1361,-20
42172426675,42172426678,3,1525,1189,-20
42180153388,42180153389,1,1717,1757,-20
42180713925,42180713930,5,6270,2832,-20
42185296180,42185296182,2,1702,1253,-20
42189302617,42189302620,3,1890,1760,-20
42193629718,42193629721,3,1594,1457,-20
42194057000,42194057003,3,1628,1615,-20
42197355843,42197355846,3,2126,1143,-20
42197710399,42197710402,3,2570,1609,-20
42198515811,42198515815,4,1218,1068,-20
42201351234,42201351238,4,1939,1549,-20
42201917038,42201917042,4,1997,926,-20
42204822202,42204822205,3,1850,1501,-20
42205860067,42205860071,4,1815,1370,-20
42211679949,42211679953,4,2236,1277,-20
42212054811,42212054810,-1,1079,1644,-20
42214377022,42214377027,5,1814,1468,-20
42217449128,42217449132,4,2085,1754,-20
42217797250,42217797252,2,1732,1510,-20
42220252106,42220252110,4,2059,1994,-20
42220699511,42220699514,3,1520,891,-20
42222423463,42222423456,-7,1049,4799,-20
42224048298,42224048301,3,1505,1886,-20
42224692977,42224692981,4,1879,1686,-20
42225618585,42225618589,4,1182,1262,-20
42227516933,42227516943,10,13402,24994,-20
42227817877,42227817881,4,1738,1434,-20
42228521545,42228521552,7,15618,30372,-20
42228990967,42228990970,3,1522,989,-20
42241175731,42241175734,3,1552,1350,-20
42241937280,42241937283,3,1852,1382,-20
42242334956,42242334959,3,1868,1268,-20
42243419547,42243419553,6,3080,1787,-20
42243612251,42243612253,2,1670,1486,-20
42249661908,42249661911,3,2048,1508,-20
42251308048,42251308050,2,1731,1143,-20
42253336523,42253336526,3,1171,1145,-20
42254264549,42254264554,5,2756,1386,-20
42255741334,42255741339,5,1773,1260,-20
42261752621,42261752623,2,1873,1587,-20
42268302726,42268302731,5,4980,2886,-20
42269542968,42269542970,2,1447,1139,-20
42271051442,42271051447,5,1029,795,-20
42274104049,42274104049,0,1720,2005,-20
42275700093,42275700096,3,1970,1671,-20
42275882521,42275882524,3,1455,1075,-20
42278078086,42278078091,5,2208,1290,-20
42281137941,42281137945,4,2364,1763,-20
42284585565,42284585570,5,1618,1471,-20
42285363753,42285363755,2,2841,2189,-20
42285645022,42285645026,4,1899,1055,-20
42285711067,42285711050,-17,1063,1231,-20
42286669515,42286669515,0,1603,1241,-20
42288956419,42288956418,-1,602,1175,-20
42289634702,42289634709,7,1358,1109,-20
42293020689,42293020693,4,2501,1640,-20
42296916842,42296916846,4,1802,1339,-20
42299114526,42299114509,-17,1390,1023,-20
42303526609,42303526612,3,1684,1609,-20
42303862091,42303862095,4,2060,1471,-20
42304318190,42304318194,4,1877,1510,-20
42310105679,42310105680,1,1281,1322,-20
42312170787,42312170790,3,1991,1361,-20
42312859031,42312859035,4,1825,1378,-20
42313146438,42313146441,3,2145,1325,-20
42313704959,42313704956,-3,1572,1181,-20
42313860158,42313860157,-1,22568,40097,-20
42313888374,42313888377,3,1706,1562,-20
42313954214,42313954218,4,1964,1352,-20
42315032649,42315032649,0,1165,1364,-20
42315365527,42315365526,-1,556,928,-20
42319385405,42319385409,4,1973,1141,-20
42319412653,42319412657,4,1581,1113,-20
42322474782,42322474784,2,1267,1354,-20
42322631780,42322631782,2,2033,1447,-20
42322668187,42322668189,2,1813,1599,-20
42326005421,42326005425,4,1641,1482,-20
42326529441,42326529443,2,2073,1760,-20
42326582728,42326582732,4,2208,1769,-20
42327444821,42327444826,5,2122,1633,-20
42333912474,42333912477,3,2044,1354,-20
42338471593,42338471594,1,1294,1422,-20
42339003067,42339003066,-1,1217,1458,-20
42339552093,42339552095,2,1803,1360,-20
42344251521,42344251523,2,1209,858,-20
42345018300,42345018303,3,1485,1105,-20
42347795883,42347795885,2,1266,1423,-20
42349247783,42349247786,3,1762,1332,-20
42350499766,42350499767,1,1721,1735,-20
42352378805,42352378805,0,1523,1687,-20
42352429875,42352429874,-1,685,1205,-20
42357317002,42357317007,5,1850,1548,-20
42357939601,42357939605,4,2770,2347,-20
42359105451,42359105457,6,3332,1097,-20
42359737740,42359737743,3,1813,1066,-20
42362451691,42362451694,3,1162,1001,-20
42363578043,42363578047,4,1003,853,-20
42364086064,42364086067,3,1738,1210,-20
42364827093,42364827098,5,2108,1239,-20
42365959245,42365959251,6,2112,1304,-20
42369452526,42369452530,4,1813,1000,-20
42369769660,42369769642,-18,1995,1419,-20
42369826335,42369826338,3,1938,1697,-20
42375786721,42375786726,5,1957,1233,-20
42378758938,42378758942,4,1249,1085,-20
42382493274,42382493279,5,1915,1096,-20
42383538522,42383538522,0,1737,1253,-20
42383789643,42383789646,3,2315,1284,-20
42386168041,42386168046,5,2522,1402,-20
42386841625,42386841627,2,1716,1053,-20
42386933641,42386933643,2,1372,968,-20
42388098037,42388098040,3,2221,1496,-20
42390081681,42390081684,3,2353,1477,-20
42391195752,42391195754,2,2251,1182,-20
42391466502,42391466506,4,1278,1275,-20
42396214736,42396214738,2,1389,1981,-20
42401198385,42401198386,1,1657,1794,-20
42404928520,42404928526,6,2717,1078,-20
42408918338,42408918341,3,1395,1252,-20
42409909122,42409909105,-17,933,676,-20
42410260584,42410260586,2,1393,1028,-20
42414609631,42414609634,3,1622,1266,-20
42415008577,42415008580,3,1577,1626,-20
42416586714,42416586715,1,2027,1552,-20
42416733445,42416733449,4,1675,1906,-20
42416787033,42416787037,4,2690,1884,-20
42416862013,42416862015,2,2055,1543,-20
42417874029,42417874030,1,1609,1919,-20
42423981942,42423981945,3,1602,1362,-20
42426426918,42426426907,-11,1217,1320,-20
42430250321,42430250326,5,2485,1188,-20
42432743356,42432743359,3,1956,1526,-20
42436841403,42436841409,6,1649,950,-20
42437086850,42437086853,3,1461,1191,-20
42438238343,42438238346,3,2013,1230,-20
42439091403,42439091408,5,1847,1376,-20
42441347710,42441347715,5,1290,849,-20
42444732262,42444732258,-4,1191,3468,-20
42446572266,42446572269,3,1399,1098,-20
42447380543,42447380548,5,1679,1434,-20
42447829950,42447829953,3,1840,1835,-20
42450510941,42450510943,2,2097,1630,-20
42453909915,42453909917,2,1760,1526,-20
42454580978,42454580983,5,2933,1448,-20
42459007538,42459007542,4,1727,1163,-20
42462423801,42462423804,3,1571,1576,-20
42464469126,42464469131,5,1599,960,-20
42464640617,42464640620,3,1586,1380,-20
42465956624,42465956626,2,1460,1335,-20
42470188428,42470188431,3,1543,1351,-20
42471310526,42471310530,4,1859,1439,-20
42474410946,42474410951,5,2183,1039,-20
42474538670,42474538650,-20,1358,882,-20
42477692274,42477692276,2,2413,1995,-20
42479820778,42479820783,5,2097,1287,-20
42481429797,42481429799,2,1287,1492,-20
42481554534,42481554538,4,1674,1517,-20
42483696798,42483696806,8,7323,33415,-20
42489444255,42489444258,3,1699,1452,-20
42490382017,42490382021,4,2142,1631,-20
42490998837,42490998839,2,1846,1392,-20
42491540418,42491540421,3,1858,905,-20
42493666830,42493666831,1,1488,1026,-20
42494011744,42494011748,4,2574,1904,-20
42495684845,42495684848,3,2170,1104,-20
42498081746,42498081748,2,2075,1342,-20
42505852769,42505852773,4,1126,930,-20
42506040898,42506040903,5,1340,842,-20
42506801127,42506801131,4,1168,870,-20
42507487481,42507487463,-18,1096,1048,-20
42508377579,42508377583,4,2106,1444,-20
42508903943,42508903950,7,3214,2083,-20
42509211133,42509211136,3,1502,1522,-20
42512352629,42512352632,3,2214,1443,-20
42516254268,42516254270,2,1483,1059,-20
42516543522,42516543518,-4,1942,3452,-20
42517090218,42517090218,0,1834,1990,-20
42517688391,42517688390,-1,1562,5004,-20
42523346627,42523346630,3,1870,1173,-20
42526791441,42526791443,2,860,740,-20
42528852737,42528852741,4,1757,1496,-20
42529514470,42529514473,3,1625,1403,-20
42534174230,42534174234,4,2072,1281,-20
42536001374,42536001378,4,1938,1474,-20
42536833945,42536833947,2,1448,1388,-20
42539027338,42539027344,6,3913,1537,-20
42540600395,42540600398,3,1968,1093,-20
42540985543,42540985546,3,1767,1336,-20
42546045827,42546045833,6,1805,1452,-20
42549554202,42549554207,5,1679,1476,-20
42549713891,42549713895,4,1744,1316,-20
42552444940,42552444942,2,1552,1332,-20
42554497387,42554497390,3,1849,1714,-20
42554963035,42554963039,4,1591,1193,-20
42558119990,42558119995,5,1811,958,-20
42558283955,42558283937,-18,767,231,-20
42558888537,42558888523,-14,1079,6191,-20
42560230774,42560230779,5,1482,1107,-20
42561449703,42561449706,3,2068,860,-20
42565437543,42565437547,4,1236,961,-20
42567037787,42567037790,3,2019,1402,-20
42568000013,42568000017,4,1948,1058,-20
42568437026,42568437027,1,2105,1058,-20
42568768647,42568768633,-14,940,350,-20
42571899886,42571899890,4,2166,1310,-20
42575113145,42575113148,3,1771,1060,-20
42575667443,42575667426,-17,489,403,-20
42577795537,42577795541,4,1849,1404,-20
42578136478,42578136482,4,1707,1176,-20
42580397882,42580397887,5,2052,1452,-20
42581284857,42581284862,5,1533,1549,-20
42584114885,42584114888,3,1725,1049,-20
42586412925,42586412927,2,2243,1843,-20
42589467750,42589467753,3,1530,1604,-20
42591774398,42591774403,5,1348,978,-20
42599470826,42599470830,4,1573,1436,-20
42599917064,42599917067,3,1494,1013,-20
42600810342,42600810350,8,2156,963,-20
42602213373,42602213359,-14,1777,1342,-20
42605506287,42605506265,-22,1343,1226,-20
42608134617,42608134618,1,2085,1666,-20
42608666018,42608666022,4,1528,1492,-20
42610050631,42610050635,4,888,696,-20
42611994721,42611994722,1,1412,1394,-20
42613391802,42613391806,4,2205,1834,-20
42615089906,42615089909,3,1349,1308,-20
42615197498,42615197502,4,1637,1130,-20
42616341325,42616341328,3,1827,979,-20
42616587497,42616587498,1,1286,1444,-20
42617680667,42617680670,3,1933,1451,-20
42618802739,42618802747,8,24102,32992,-20
42619169385,42619169386,1,1975,1353,-20
42621875872,42621875874,2,1777,1547,-20
42624159204,42624159207,3,2007,1069,-20
42626593247,42626593248,1,1801,990,-20
42627253681,42627253686,5,1593,1073,-20
42629489121,42629489125,4,1736,1225,-20
42631187682,42631187689,7,2017,1303,-20
42632094358,42632094361,3,1532,1539,-20
42633553215,42633553224,9,1110,1195,-20
42633940251,42633940255,4,1765,1069,-20
42634324826,42634324826,0,1606,1974,-20
42635814955,42635814959,4,1446,1120,-20
42636939842,42636939846,4,2347,1015,-20
42637221977,42637221979,2,1683,1455,-20
42638222379,42638222382,3,1230,1469,-20
42641187978,42641187983,5,1687,886,-20
42641836115,42641836097,-18,1710,1442,-20
42645993847,42645993854,7,1892,1189,-20
42646041937,42646041939,2,1661,1424,-20
42648258046,42648258049,3,1661,1462,-20
42651212951,42651212953,2,1482,1646,-20
42655529775,42655529758,-17,46192,16733,-20
42656598169,42656598172,3,2301,1567,-20
42656901704,42656901709,5,2322,1307,-20
42658688801,42658688804,3,1633,1198,-20
42660081877,42660081875,-2,1520,2152,-20
42660181978,42660181958,-20,1973,1181,-20
42661337736,42661337743,7,1294,1021,-20
42661879635,42661879639,4,2838,2001,-20
42663489264,42663489266,2,2741,2072,-20
42665071035,42665071034,-1,1713,3424,-20
42668104581,42668104586,5,1995,1806,-20
42668269946,42668269946,0,1411,1134,-20
42668349888,42668349891,3,2340,1530,-20
42671611365,42671611368,3,1855,1213,-20
42672383815,42672383818,3,862,517,-20
42674951144,42674951148,4,1350,1202,-20
42677616570,42677616574,4,2871,1748,-20
42677747720,42677747722,2,1678,1296,-20
42678857452,42678857455,3,2003,1728,-20
42691695525,42691695530,5,1208,1521,-20
42694478596,42694478599,3,1730,1498,-20
42695337705,42695337710,5,1713,1613,-20
42696757986,42696757989,3,2430,1887,-20
42697156516,42697156518,2,1380,1215,-20
42699608374,42699608379,5,2233,1214,-20
42699849171,42699849175,4,1238,1014,-20
42699878841,42699878843,2,1667,1433,-20
42699940618,42699940622,4,1214,1296,-20
42702577695,42702577698,3,2324,1696,-20
42703087055,42703087059,4,2142,1833,-20
42703269009,42703269011,2,1535,1426,-20
42706799156,42706799159,3,2513,1922,-20
42708590113,42708590115,2,1507,802,-20
42711978853,42711978854,1,1479,1835,-20
42713016249,42713016250,1,1858,1537,-20
42717305709,42717305711,2,1681,1078,-20
42720273139,42720273144,5,1936,1251,-20
42725554317,42725554317,0,1334,1933,-20
42728793696,42728793702,6,1588,1480,-20
42736685921,42736685926,5,1575,993,-20
42737664301,42737664307,6,1375,864,-20
42742524014,42742524017,3,1253,1651,-20
42742667091,42742667094,3,959,749,-20
42743039174,42743039178,4,2472,1134,-20
42745033239,42745033243,4,1993,1287,-20
42748098607,42748098610,3,1635,1475,-20
42748893280,42748893285,5,1667,942,-20
42753118754,42753118755,1,1395,1197,-20
42753227358,42753227362,4,2266,970,-20
42757640677,42757640683,6,1389,921,-20
42758492549,42758492551,2,1473,1076,-20
42760573535,42760573540,5,1213,1145,-20
42763585432,42763585436,4,1879,1293,-20
42766828031,42766828035,4,1734,1024,-20
42767218218,42767218202,-16,1124,326,-20
42770896943,42770896945,2,1562,1775,-20
42771637629,42771637631,2,913,1121,-20
42773995160,42773995163,3,2208,1852,-20
42774119134,42774119138,4,2448,1165,-20
42777368120,42777368123,3,2089,1387,-20
42777834978,42777834981,3,2249,1494,-20
42778059457,42778059459,2,892,706,-20
42779027181,42779027184,3,2281,1578,-20
42780902985,42780902989,4,1249,983,-20
42782799882,42782799886,4,1842,1271,-20
42787802315,42787802320,5,1660,1493,-20
42790974034,42790974033,-1,1015,2302,-20
42797983527,42797983541,14,168,1119,-20
42798969432,42798969435,3,2076,1364,-20
42801857497,42801857501,4,2006,1332,-20
42802029279,42802029282,3,1805,1349,-20
42803851642,42803851643,1,1195,1475,-20
42805013342,42805013345,3,1725,1918,-20
42806577891,42806577895,4,1350,1036,-20
42809610343,42809610346,3,1065,950,-20
42810426097,42810426101,4,2168,1830,-20
42810983741,42810983749,8,10815,36542,-20
42811219253,42811219256,3,1554,1317,-20
42815244229,42815244232,3,1619,1401,-20
42821167279,42821167274,-5,1075,3461,-20
42823318602,42823318603,1,1358,1122,-20
42826320435,42826320434,-1,1270,1603,-20
42828502666,42828502669,3,1955,1378,-20
42831225180,42831225182,2,1958,1353,-20
42831689148,42831689151,3,1707,1514,-20
42834356107,42834356110,3,1887,1740,-20
42834442570,42834442573,3,1484,1150,-20
42834648238,42834648241,3,2206,1739,-20
42835327411,42835327419,8,1891,1438,-20
42835395371,42835395374,3,1619,1300,-20
42835740761,42835740770,9,10368,33276,-20
42836938399,42836938403,4,1628,1088,-20
42839991748,42839991746,-2,1406,2954,-20
42841723162,42841723163,1,1788,1175,-20
42841968618,42841968618,0,1614,1250,-20
42842594964,42842594967,3,1342,934,-20
42849130034,42849130037,3,2413,1628,-20
42850636582,42850636586,4,2137,1533,-20
42851053936,42851053941,5,2338,1821,-20
42852008827,42852008832,5,2683,1323,-20
42858759352,42858759354,2,2093,1075,-20
42860030951,42860030954,3,2080,1033,-20
42865205112,42865205114,2,2276,1732,-20
42866620747,42866620745,-2,596,1783,-20
42868097095,42868097090,-5,760,4071,-20
42871630080,42871630083,3,1511,1145,-20
42873222986,42873222990,4,2085,1160,-20
42875742262,42875742263,1,2015,2182,-20
42876031830,42876031832,2,1306,1496,-20
42877965537,42877965543,6,6745,2073,-20
42888092222,42888092226,4,1850,1596,-20
42889491887,42889491891,4,1823,1022,-20
42891454290,42891454290,0,845,1213,-20
42893565485,42893565488,3,1970,1958,-20
42894185821,42894185826,5,1736,1590,-20
42899307248,42899307247,-1,1346,2532,-20
42900623725,42900623729,4,2301,1822,-20
42900838020,42900838022,2,1821,1439,-20
42911850571,42911850574,3,2054,1412,-20
42914944334,42914944330,-4,1186,5241,-20
42915173602,42915173605,3,1690,1914,-20
42916047646,42916047651,5,2722,1821,-20
42917026809,42917026813,4,2220,1679,-20
42920699055,42920699058,3,1846,1412,-20
42923266455,42923266458,3,1381,1694,-20
42926696954,42926696957,3,2252,1227,-20
42926824079,42926824083,4,2639,1465,-20
42930203905,42930203907,2,2171,1461,-20
42931499198,42931499202,4,1303,1005,-20
42934878681,42934878676,-5,26431,15566,-20
42937091721,42937091735,14,164,710,-20
42940345610,42940345614,4,2026,1556,-20
42943294393,42943294395,2,1488,1513,-20
42950166178,42950166174,-4,28342,13531,-20
42950987098,42950987101,3,1537,1306,-20
42953902590,42953902593,3,2047,1737,-20
42954846320,42954846323,3,1670,1497,-20
42958268322,42958268325,3,1281,1148,-20
42959014062,42959014065,3,1758,1478,-20
42961028362,42961028367,5,2549,1755,-20
42962367463,42962367463,0,1490,1171,-20
42965566753,42965566757,4,1934,1265,-20
42966518873,42966518875,2,1804,1577,-20
42967256310,42967256312,2,1552,2197,-20
42967976749,42967976752,3,1720,1555,-20
42968699129,42968699122,-7,1522,1188,-20
42972369183,42972369182,-1,3109,4724,-20
42980781256,42980781258,2,1825,1639,-20
42980806641,42980806642,1,1409,1344,-20
42981510204,42981510207,3,982,1064,-20
42982906644,42982906658,14,11060,52563,-20
42983453935,42983453938,3,1492,1153,-20
42986007118,42986007123,5,1617,1180,-20
42987247914,42987247917,3,1903,1761,-20
42992822189,42992822192,3,1660,1270,-20
42993559712,42993559715,3,1480,1477,-20
42993789521,42993789525,4,2413,1720,-20
42996491579,42996491582,3,2300,1614,-20
42999766757,42999766759,2,1413,1215,-20
43001523415,43001523420,5,1861,1607,-20
43002399633,43002399636,3,2561,1804,-20
43004049188,43004049191,3,2481,1887,-20
43004675245,43004675247,2,1570,1722,-20
43008052911,43008052915,4,1205,970,-20
43009006300,43009006301,1,1285,1233,-20
43013304243,43013304246,3,1695,1994,-20
43014670823,43014670827,4,2077,1296,-20
43015266802,43015266805,3,1837,1283,-20
43015419264,43015419266,2,1261,1244,-20
43020157393,43020157397,4,1621,1647,-20
43023779335,43023779340,5,2032,1280,-20
43027770165,43027770166,1,1201,1142,-20
43028537796,43028537798,2,1480,1420,-20
43029427577,43029427578,1,2363,1191,-20
43034853608,43034853610,2,1864,1180,-20
43035318246,43035318251,5,1303,1019,-20
43037325201,43037325205,4,2617,1311,-20
43037946978,43037946974,-4,1044,3962,-20
43038091401,43038091405,4,2480,1701,-20
43045857935,43045857937,2,1424,1218,-20
43046175200,43046175204,4,1653,883,-20
43046924714,43046924714,0,1828,2111,-20
43047649874,43047649878,4,1646,1650,-20
43048786735,43048786735,0,1393,1616,-20
43052031990,43052031997,7,1502,1207,-20
43053792429,43053792427,-2,1509,1520,-20
43055647463,43055647458,-5,1915,1470,-20
43059281670,43059281674,4,1685,1108,-20
43059379526,43059379531,5,2684,1678,-20
43060328438,43060328444,6,2388,1440,-20
43060491495,43060491498,3,1899,1777,-20
43062353553,43062353556,3,1465,1860,-20
43064467434,43064467438,4,1740,1450,-20
43068631567,43068631567,0,1277,2176,-20
43069362114,43069362118,4,2280,1923,-20
43072091797,43072091800,3,1907,1185,-20
43072218287,43072218290,3,1329,1159,-20
43073711931,43073711933,2,1289,1161,-20
43074987936,43074987939,3,2129,1606,-20
43076495117,43076495123,6,2273,1055,-20
43082348643,43082348645,2,1583,1329,-20
43087226738,43087226741,3,1174,1338,-20
43088865413,43088865417,4,1881,1809,-20
43090364491,43090364495,4,2270,1967,-20
43091014846,43091014849,3,2344,1330,-20
43091514378,43091514380,2,1908,1412,-20
43091765670,43091765667,-3,1388,3113,-20
43094830454,43094830455,1,1566,1166,-20
43095871970,43095871974,4,1550,991,-20
43102122034,43102122038,4,1736,1333,-20
43105314647,43105314646,-1,1838,1433,-20
43106472969,43106472974,5,2958,1359,-20
43107256213,43107256197,-16,1132,411,-20
43109636683,43109636685,2,2452,1187,-20
43109756478,43109756481,3,1564,1196,-20
43110159574,43110159577,3,1825,1947,-20
43114543593,43114543597,4,1676,1245,-20
43116171990,43116171994,4,2587,2149,-20
43116639324,43116639327,3,2254,1119,-20
43119636097,43119636099,2,2080,1767,-20
43119907938,43119907941,3,2151,1720,-20
43121433767,43121433773,6,2388,1755,-20
43121755746,43121755747,1,909,1696,-20
43123324469,43123324474,5,1556,1222,-20
43124857104,43124857108,4,1213,1070,-20
43127352842,43127352841,-1,1023,1489,-20
43131200226,43131200230,4,1936,1552,-20
43132120094,43132120097,3,1432,717,-20
43134200610,43134200614,4,1981,1482,-20
43134763213,43134763196,-17,1607,1643,-20
43135605589,43135605592,3,1789,1559,-20
43136298113,43136298117,4,2539,1394,-20
43137200908,43137200913,5,2533,1005,-20
43144827569,43144827573,4,2297,1200,-20
43145738258,43145738259,1,1143,1121,-20
43146373162,43146373182,20,563,3283,-20
43149307253,43149307258,5,1867,1747,-20
43152035861,43152035866,5,1922,1569,-20
43152595208,43152595212,4,1574,1331,-20
43154684121,43154684123,2,1516,1015,-20
43156041663,43156041665,2,1746,1501,-20
43157486330,43157486332,2,1665,1389,-20
43164706853,43164706857,4,1359,1166,-20
43168339715,43168339719,4,2565,2301,-20
43169556531,43169556537,6,2263,1216,-20
43172535672,43172535675,3,2228,1397,-20
43177847153,43177847156,3,2033,1250,-20
43178494610,43178494613,3,1681,1175,-20
43178868382,43178868387,5,1951,1544,-20
43181263219,43181263222,3,1454,1603,-20
43181868378,43181868379,1,1241,1132,-20
43185662766,43185662770,4,2297,2147,-20
43185895791,43185895795,4,1594,1444,-20
43191228512,43191228518,6,6512,3174,-20
43191635285,43191635287,2,1962,1246,-20
43193906277,43193906280,3,1676,1500,-20
43194550557,43194550563,6,953,869,-20
43197298234,43197298241,7,2415,1714,-20
43198571126,43198571127,1,1438,1019,-20
43199953359,43199953359,0,651,268,-20
43201257458,43201257463,5,2002,1398,-20
43202376585,43202376587,2,1608,1528,-20
43203008069,43203008074,5,1588,775,-20
43203338727,43203338727,0,1516,1083,-20
43207946926,43207946931,5,3029,1867,-20
43208272441,43208272442,1,2500,1870,-20
43210392376,43210392379,3,1332,1396,-20
43215503889,43215503894,5,1990,2160,-20
43215921653,43215921656,3,1697,857,-20
43216762666,43216762673,7,2150,1176,-20
43221820075,43221820077,2,1672,1066,-20
43222624954,43222624958,4,2310,1270,-20
43222888161,43222888163,2,2030,1133,-20
43224704601,43224704605,4,2003,1654,-20
43227382030,43227382032,2,1904,1354,-20
43228109262,43228109263,1,1597,1338,-20
43229831386,43229831391,5,1368,946,-20
43231603290,43231603295,5,1970,1311,-20
43232357310,43232357312,2,1933,1477,-20
43233485349,43233485350,1,1664,1398,-20
43235936082,43235936087,5,1699,989,-20
43237035330,43237035329,-1,1253,2017,-20
43237126418,43237126421,3,1463,1381,-20
43239392718,43239392724,6,2146,1033,-20
43240170618,43240170633,15,494,532,-20
43249819554,43249819559,5,2130,1404,-20
43250084943,43250084924,-19,1022,851,-20
43252610891,43252610895,4,1166,1105,-20
43253167947,43253167950,3,1756,1331,-20
43258547533,43258547537,4,1425,1190,-20
43258683695,43258683698,3,1097,1273,-20
43259981131,43259981126,-5,2337,6172,-20
43262921562,43262921566,4,2003,1626,-20
43263048430,43263048433,3,2042,1259,-20
43263989501,43263989505,4,2314,1367,-20
43264539607,43264539608,1,1560,734,-20
43268846893,43268846896,3,1545,1210,-20
43269475082,43269475086,4,1844,1627,-20
43270245458,43270245463,5,2254,1829,-20
43274808916,43274808919,3,1736,1390,-20
43276666747,43276666745,-2,619,1212,-20
43277952083,43277952087,4,2047,1425,-20
43278562557,43278562561,4,1361,1073,-20
43278823366,43278823367,1,1224,1067,-20
43280276185,43280276189,4,1753,1281,-20
43285820792,43285820794,2,1392,972,-20
43289974191,43289974186,-5,2071,5533,-20
43290388653,43290388650,-3,1191,3645,-20
43290759854,43290759859,5,1914,1128,-20
43292138474,43292138478,4,2425,2368,-20
43295141836,43295141829,-7,1177,1016,-20
43295776046,43295776050,4,3614,2312,-20
43298103385,43298103390,5,1535,1565,-20
43298785579,43298785583,4,1567,1318,-20
43299832151,43299832154,3,1484,944,-20
43302356826,43302356830,4,1463,1189,-20
43304652113,43304652117,4,2490,1737,-20
43305530700,43305530699,-1,1495,1749,-20
43310441105,43310441107,2,1504,1553,-20
43311162760,43311162761,1,1860,1916,-20
43313571167,43313571172,5,1746,1347,-20
43317203635,43317203638,3,2143,1238,-20
43319092749,43319092750,1,2202,1507,-20
43320174460,43320174463,3,1753,1480,-20
43320716549,43320716554,5,1715,864,-20
43320782978,43320782982,4,1986,1258,-20
43321107421,43321107435,14,1351,1221,-20
43326234185,43326234183,-2,822,1328,-20
43326579564,43326579567,3,1797,1157,-20
43328045385,43328045382,-3,616,569,-20
43328381454,43328381458,4,986,898,-20
43330723018,43330723019,1,1675,2097,-20
43334623429,43334623433,4,1727,1405,-20
43336628034,43336628039,5,2423,1718,-20
43337122407,43337122411,4,1995,1217,-20
43338359346,43338359350,4,1728,1966,-20
43340935627,43340935634,7,1923,1273,-20
43342995566,43342995570,4,1886,1120,-20
43346196817,43346196816,-1,2643,3943,-20
43348673489,43348673493,4,2189,1902,-20
43350991161,43350991164,3,1425,1170,-20
43351442485,43351442490,5,2074,1536,-20
43351622496,43351622489,-7,2205,11236,-20
43359977774,43359977777,3,1379,1297,-20
43361806606,43361806607,1,1532,1687,-20
43364982342,43364982345,3,1769,1391,-20
43366147656,43366147660,4,3149,1378,-20
43367167298,43367167302,4,1511,1608,-20
43367944137,43367944139,2,1658,1214,-20
43368238213,43368238219,6,2195,1159,-20
43368699527,43368699527,0,1219,1239,-20
43372170114,43372170118,4,2021,2021,-20
43372532939,43372532941,2,1315,1063,-20
43373161021,43373161023,2,2427,1871,-20
43376544371,43376544374,3,1539,1081,-20
43377676915,43377676908,-7,1185,5100,-20
43378618177,43378618176,-1,2378,4205,-20
43379279378,43379279379,1,1222,713,-20
43381746867,43381746870,3,1572,1036,-20
43385012146,43385012150,4,1894,1611,-20
43396678537,43396678538,1,1505,1700,-20
43399069817,43399069820,3,1996,1604,-20
43403865523,43403865526,3,2342,1809,-20
43405461231,43405461235,4,2214,1609,-20
43407400337,43407400342,5,2780,1525,-20
43407862834,43407862839,5,1950,1389,-20
43408292423,43408292426,3,1241,975,-20
43410687375,43410687381,6,3075,1635,-20
43410822284,43410822284,0,1559,1931,-20
43411270017,43411270020,3,1854,1518,-20
43412698366,43412698371,5,1485,1445,-20
43416209031,43416209038,7,6793,2575,-20
43419477353,43419477357,4,1443,1443,-20
43419901461,43419901463,2,614,902,-20
43423578222,43423578227,5,2083,1411,-20
43424613227,43424613229,2,1966,1457,-20
43426377367,43426377344,-23,1442,1242,-20
43427751527,43427751528,1,1243,1576,-20
43429804215,43429804218,3,1820,1522,-20
43431022157,43431022160,3,1937,1160,-20
43438162877,43438162878,1,1736,1729,-20
43439029805,43439029808,3,1727,1838,-20
43439838808,43439838810,2,1837,1842,-20
43442742177,43442742179,2,922,963,-20
43443990970,43443990973,3,1772,1246,-20
43444090034,43444090019,-15,3239,1552,-20
43444123431,43444123434,3,1708,1273,-20
43448340483,43448340486,3,2478,1523,-20
43448606814,43448606816,2,1457,1281,-20
43450257310,43450257314,4,1513,977,-20
43454644152,43454644156,4,847,960,-20
43458229645,43458229650,5,1895,1328,-20
43460262569,43460262571,2,1334,1207,-20
43461710211,43461710214,3,1568,1485,-20
43463325727,43463325732,5,2485,1606,-20
43466044883,43466044886,3,1844,1530,-20
43466206046,43466206053,7,1175,824,-20
43467337922,43467337927,5,2229,1846,-20
43468694237,43468694243,6,30934,13655,-20
43471502926,43471502930,4,1912,1522,-20
43472867537,43472867541,4,1960,1705,-20
43480255112,43480255112,0,1630,1348,-20
43482425171,43482425174,3,1746,1799,-20
43484021111,43484021114,3,3070,1647,-20
43493194847,43493194851,4,1548,1492,-20
43496938853,43496938856,3,2552,2138,-20
43499048896,43499048900,4,2525,1873,-20
43502665269,43502665271,2,1333,1381,-20
43507393022,43507393025,3,1457,867,-20
43510309738,43510309742,4,1839,1241,-20
43510535046,43510535024,-22,1450,808,-20
43512937941,43512937945,4,2180,1409,-20
43517283289,43517283290,1,1159,994,-20
43523565078,43523565082,4,1922,1348,-20
43524403393,43524403397,4,1485,1244,-20
43526307883,43526307886,3,1709,1241,-20
43527023109,43527023112,3,2049,1447,-20
43528413390,43528413390,0,1271,1654,-20
43529526281,43529526282,1,2624,1574,-20
43529763397,43529763390,-7,833,3996,-20
43532333586,43532333590,4,1957,1441,-20
43535733639,43535733644,5,2016,1452,-20
43537167555,43537167558,3,2174,1724,-20
43542487902,43542487907,5,2693,1938,-20
43543674182,43543674183,1,1654,1433,-20
43544460561,43544460563,2,1193,1050,-20
43545793926,43545793929,3,1955,1284,-20
43547418866,43547418871,5,2571,1483,-20
43548823104,43548823106,2,2517,1745,-20
43548915353,43548915355,2,1612,730,-20
43550439395,43550439399,4,1225,1135,-20
43550948462,43550948462,0,1893,2679,-20
43550982522,43550982527,5,1773,1272,-20
43551249180,43551249188,8,1646,1634,-20
43557644970,43557644973,3,1916,1293,-20
43558591462,43558591464,2,1811,1256,-20
43559834797,43559834790,-7,2368,7561,-20
43561807202,43561807202,0,1434,2040,-20
43563462838,43563462843,5,2454,1706,-20
43570303298,43570303304,6,1952,1331,-20
43571177489,43571177493,4,1620,1265,-20
43571303469,43571303474,5,2632,1385,-20
43574566574,43574566575,1,1384,1321,-20
43576671576,43576671581,5,1184,963,-20
43577506474,43577506479,5,1854,1510,-20
43579362369,43579362372,3,2107,1730,-20
43580619103,43580619102,-1,965,875,-20
43581649917,43581649920,3,1942,1391,-20
43582057432,43582057435,3,1904,1783,-20
43586965949,43586965951,2,2535,1272,-20
43590120930,43590120934,4,1565,1217,-20
43591820926,43591820931,5,1895,1064,-20
43591995243,43591995247,4,1393,1163,-20
43594520257,43594520260,3,2078,1890,-20
43597105189,43597105191,2,1723,1475,-20
43599244970,43599244975,5,1493,902,-20
43600823346,43600823352,6,1504,973,-20
43601625757,43601625759,2,1265,1213,-20
43601776226,43601776228,2,1414,1658,-20
43601903891,43601903895,4,1124,689,-20
43605579907,43605579910,3,1506,1252,-20
43606322491,43606322496,5,2074,1319,-20
43606435703,43606435706,3,1469,1119,-20
43607124431,43607124426,-5,1346,2861,-20
43607737839,43607737844,5,1898,1268,-20
43615409117,43615409120,3,1884,1628,-20
43615553435,43615553441,6,1522,1096,-20
43623040522,43623040524,2,1842,1213,-20
43624964945,43624964949,4,1906,1871,-20
43627822489,43627822492,3,1600,1320,-20
43629136166,43629136171,5,1660,1279,-20
43634471858,43634471863,5,1413,944,-20
43643988493,43643988498,5,749,959,-20
43647227289,43647227291,2,1489,1016,-20
43647684640,43647684644,4,2095,1724,-20
43650871958,43650871964,6,3683,1788,-20
43654527609,43654527614,5,2085,1771,-20
43658302922,43658302926,4,2342,1451,-20
43665709569,43665709575,6,1904,1111,-20
43665973976,43665973979,3,1814,1564,-20
43667404148,43667404153,5,2123,1344,-20
43667526952,43667526957,5,1789,1549,-20
43668022429,43668022434,5,2957,1888,-20
43668203821,43668203825,4,1609,1606,-20
43669150578,43669150581,3,1852,1363,-20
43669688230,43669688232,2,2593,1880,-20
43670459099,43670459102,3,2096,1498,-20
43675753710,43675753714,4,1890,1421,-20
43676139702,43676139704,2,1403,1136,-20
43678588437,43678588440,3,1435,1720,-20
43680610563,43680610567,4,2158,1182,-20
43682037247,43682037250,3,1747,1057,-20
43682891264,43682891266,2,1184,1019,-20
43683618353,43683618357,4,1560,1441,-20
43685965065,43685965069,4,1917,1433,-20
43688999166,43688999169,3,3247,1896,-20
43689084626,43689084628,2,1079,1072,-20
43692898121,43692898126,5,1976,1577,-20
43693230813,43693230814,1,1848,1325,-20
43693609379,43693609379,0,1921,1328,-20
43694732345,43694732348,3,2117,1307,-20
43696309510,43696309514,4,2429,1679,-20
43702676333,43702676315,-18,2740,1210,-20
43703368179,43703368178,-1,1898,1606,-20
43703459143,43703459147,4,2286,1370,-20
43706735182,43706735185,3,1901,1605,-20
43707345050,43707345054,4,1980,1582,-20
43708451894,43708451897,3,1896,1774,-20
43709702508,43709702507,-1,1156,1859,-20
43724279014,43724279018,4,1482,1164,-20
43726734714,43726734714,0,2201,1333,-20
43729145606,43729145608,2,1612,1093,-20
43730904525,43730904529,4,2027,1396,-20
43734673381,43734673378,-3,1557,4087,-20
43738100250,43738100256,6,1347,1925,-20
43738297699,43738297699,0,2275,1181,-20
43740461731,43740461734,3,2408,1553,-20
43746719970,43746719971,1,1439,1275,-20
43755039670,43755039674,4,2051,2061,-20
43761805551,43761805554,3,1056,1660,-20
43764698924,43764698926,2,1831,1189,-20
43764872248,43764872250,2,1122,770,-20
43777411623,43777411627,4,1865,1028,-20
43777699938,43777699939,1,2158,2033,-20
43782681093,43782681096,3,942,1162,-20
43783370651,43783370655,4,1309,1278,-20
43783751122,43783751126,4,2136,1797,-20
43785307850,43785307855,5,1109,902,-20
43787696151,43787696146,-5,1681,9047,-20
43790555549,43790555553,4,1508,1267,-20
43795290715,43795290718,3,1985,1294,-20
43796004639,43796004645,6,2264,1058,-20
43797336340,43797336342,2,2528,1470,-20
43798118872,43798118874,2,2034,1506,-20
43805144991,43805144995,4,886,916,-20
43806253035,43806253039,4,2890,1579,-20
43808843593,43808843596,3,2530,1413,-20
43812075959,43812075961,2,1750,1212,-20
43813203522,43813203525,3,1763,1238,-20
43815953810,43815953812,2,1745,1356,-20
43815994169,43815994169,0,1881,2515,-20
43816279891,43816279895,4,1189,1267,-20
43817650240,43817650244,4,2084,1756,-20
43818913749,43818913743,-6,2295,8704,-20
43820589074,43820589077,3,2572,1094,-20
43820722146,43820722147,1,2065,2809,-20
43821861301,43821861305,4,2002,1901,-20
43825366386,43825366385,-1,1308,1809,-20
43828284575,43828284579,4,2108,1870,-20
43828742089,43828742094,5,1621,1257,-20
43835372202,43835372204,2,2533,2048,-20
43835773578,43835773580,2,1735,1465,-20
43838039197,43838039201,4,1647,1141,-20
43839745015,43839744994,-21,725,200,-20
43840898115,43840898118,3,2166,1211,-20
43844335762,43844335767,5,1767,1299,-20
43845846118,43845846119,1,1844,1829,-20
43848308092,43848308109,17,1425,983,-20
43848795736,43848795741,5,1698,951,-20
43850302120,43850302123,3,2014,1259,-20
43852338106,43852338110,4,1073,1096,-20
43853547445,43853547450,5,1261,1439,-20
43856057785,43856057788,3,2214,2245,-20
43858814454,43858814460,6,2482,1447,-20
43861743561,43861743558,-3,996,1220,-20
43862293504,43862293508,4,1658,1290,-20
43867122241,43867122242,1,1707,1373,-20
43870230605,43870230607,2,1258,1091,-20
43872361436,43872361441,5,1558,712,-20
43874866246,43874866244,-2,2166,4261,-20
43876907028,43876907029,1,1456,1204,-20
43878281160,43878281163,3,2080,1502,-20
43879636121,43879636117,-4,58685,35023,-20
43882593633,43882593637,4,1954,1379,-20
43884171179,43884171183,4,1037,1200,-20
43884665831,43884665834,3,1716,1282,-20
43884918258,43884918258,0,1665,1830,-20
43885035900,43885035903,3,1896,1080,-20
43886102326,43886102329,3,1954,1610,-20
43886556715,43886556718,3,1757,1337,-20
43887346233,43887346235,2,1631,1180,-20
43888741109,43888741110,1,1323,1300,-20
43889779426,43889779430,4,1260,1389,-20
43892065470,43892065473,3,1864,1681,-20
43893076011,43893076021,10,1721,1251,-20
43894822396,43894822399,3,1351,1325,-20
43897533442,43897533447,5,1291,1450,-20
43898236265,43898236267,2,26820,24247,-20
43898288138,43898288143,5,1189,1265,-20
43898398571,43898398573,2,1485,2363,-20
43899512683,43899512686,3,1886,1810,-20
43901025453,43901025457,4,1894,1288,-20
43901485875,43901485882,7,2054,1025,-20
43902119830,43902119840,10,1602,1132,-20
43905951368,43905951370,2,2049,1734,-20
43906111415,43906111414,-1,1266,3345,-20
43908173218,43908173219,1,2333,1850,-20
43908727366,43908727365,-1,1963,2273,-20
43910789581,43910789584,3,1722,1518,-20
43914115126,43914115131,5,4971,2762,-20
43914915778,43914915782,4,1503,1074,-20
43917629277,43917629281,4,2255,1556,-20
43919706363,43919706362,-1,3014,5442,-20
43921064366,43921064368,2,1639,1125,-20
43924917332,43924917336,4,2494,1516,-20
43925265172,43925265176,4,1701,1461,-20
43927426113,43927426115,2,1264,737,-20
43929399138,43929399139,1,1556,1254,-20
43930140782,43930140787,5,1461,1128,-20
43932555230,43932555234,4,1583,1681,-20
43938085070,43938085073,3,1956,1582,-20
43940254384,43940254389,5,1444,1065,-20
43942355273,43942355276,3,2038,1276,-20
43947135460,43947135462,2,2033,1440,-20
43951709070,43951709072,2,1387,1253,-20
43954016731,43954016733,2,2057,1093,-20
43958417113,43958417115,2,1827,1589,-20
43959086740,43959086743,3,1851,2398,-20
43959553093,43959553094,1,1847,1914,-20
43960097802,43960097806,4,2059,1692,-20
43960408117,43960408119,2,1587,1645,-20
43963976821,43963976824,3,2672,1780,-20
43966956282,43966956285,3,1521,1484,-20
43975265554,43975265557,3,1649,1194,-20
43979878461,43979878462,1,1503,1330,-20
43981348235,43981348238,3,1628,1183,-20
43982840967,43982840971,4,1522,1314,-20
43985262744,43985262747,3,2103,1424,-20
43986371640,43986371642,2,2445,1564,-20
43988065937,43988065942,5,2222,1965,-20
43989821366,43989821370,4,1646,1507,-20
43991496703,43991496707,4,1886,1317,-20
43992877345,43992877346,1,2695,2561,-20
43993351493,43993351495,2,1633,1560,-20
43994200324,43994200347,23,1188,1027,-20
43998183475,43998183478,3,1407,1543,-20
43998706198,43998706203,5,1811,1425,-20
43999116369,43999116386,17,1383,939,-20
44000516331,44000516334,3,2100,1036,-20
44010323789,44010323793,4,1592,1343,-20
44013604650,44013604654,4,1904,1620,-20
44018753125,44018753130,5,1780,1278,-20
44019174789,44019174793,4,1872,1141,-20
44019457494,44019457496,2,1877,1813,-20
44019699281,44019699287,6,2455,1246,-20
44021619534,44021619538,4,2233,1440,-20
44023138870,44023138874,4,2167,864,-20
44023330529,44023330531,2,2347,1455,-20
44024339445,44024339450,5,3226,1901,-20
44025973450,44025973455,5,1847,1274,-20
44027081022,44027081025,3,2419,1399,-20
44027832878,44027832882,4,1566,1606,-20
44028048741,44028048763,22,368,159,-20
44032931296,44032931298,2,1400,1974,-20
44034990441,44034990445,4,2028,1780,-20
44035761147,44035761149,2,1700,2029,-20
44037833715,44037833717,2,1289,1174,-20
44040636673,44040636657,-16,1441,1047,-20
44041757354,44041757356,2,1648,1198,-20
44044949002,44044949006,4,2140,1796,-20
44045553210,44045553213,3,1658,1665,-20
44047889757,44047889760,3,1757,1006,-20
44048953540,44048953542,2,2010,2013,-20
44050577286,44050577290,4,1821,1848,-20
44051089921,44051089922,1,2030,1727,-20
44053630378,44053630381,3,1921,1451,-20
44055320754,44055320759,5,2029,1417,-20
44056813591,44056813578,-13,1319,1637,-20
44065316410,44065316409,-1,15299,23390,-20
44067550151,44067550154,3,1900,1030,-20
44067933410,44067933413,3,1773,1417,-20
44070473706,44070473703,-3,1075,1814,-20
44079144460,44079144467,7,843,995,-20
44080342393,44080342394,1,1817,2647,-20
44081546719,44081546721,2,1405,1866,-20
44081593175,44081593179,4,1615,1038,-20
44083450931,44083450935,4,1844,1668,-20
44088067325,44088067326,1,1486,1755,-20
44089799215,44089799217,2,1929,1468,-20
44090791157,44090791161,4,2183,1309,-20
44091967032,44091967034,2,1317,1236,-20
44092895039,44092895045,6,3938,2116,-20
44094271786,44094271792,6,1677,1370,-20
44094985561,44094985563,2,1384,1100,-20
44095586675,44095586690,15,1768,1702,-20
44097868613,44097868618,5,2290,1747,-20
44098027977,44098027978,1,1764,1319,-20
44098670730,44098670733,3,1933,1598,-20
44098699651,44098699655,4,2575,1998,-20
44100158054,44100158055,1,1768,1658,-20
44100203321,44100203325,4,1743,1424,-20
44100335157,44100335162,5,2460,1741,-20
44100649196,44100649202,6,2184,1002,-20
44101726388,44101726391,3,945,845,-20
44102114844,44102114845,1,1627,1774,-20
44102316998,44102316998,0,1488,1741,-20
44104280874,44104280876,2,1917,1444,-20
44107611524,44107611525,1,1533,1992,-20
44109470119,44109470122,3,2653,1776,-20
44114331018,44114331022,4,1545,1252,-20
44121594086,44121594089,3,1800,1519,-20
44128932104,44128932107,3,2010,2008,-20
44135568211,44135568214,3,2094,1026,-20
44137501026,44137501029,3,1182,1006,-20
44139638070,44139638074,4,2187,1631,-20
44140173702,44140173706,4,1563,1534,-20
44141103112,44141103131,19,146,9027,-20
44141498807,44141498811,4,2321,1207,-20
44142862082,44142862085,3,1974,1755,-20
44143237495,44143237496,1,3284,3114,-20
44143495268,44143495266,-2,1193,2548,-20
44143549868,44143549886,18,912,2414,-20
44143596272,44143596270,-2,1080,829,-20
44146584124,44146584130,6,17123,18340,-20
44149375154,44149375158,4,2628,2088,-20
44162679126,44162679127,1,1449,1643,-20
44162805170,44162805174,4,1162,1176,-20
44166649901,44166649906,5,2209,1519,-20
44167642198,44167642199,1,2192,1860,-20
44169013554,44169013555,1,1471,1885,-20
44172731315,44172731318,3,1722,1553,-20
44174217024,44174217027,3,1556,1346,-20
44180381607,44180381612,5,2127,2234,-20
44180705301,44180705306,5,2630,1330,-20
44183184241,44183184245,4,1751,1335,-20
44183978688,44183978692,4,1375,1582,-20
44184089366,44184089369,3,1480,1421,-20
44185295207,44185295211,4,877,1174,-20
44185978472,44185978469,-3,1200,1864,-20
44186490601,44186490602,1,1998,1534,-20
44191034718,44191034723,5,1483,1014,-20
44193464531,44193464535,4,2579,1438,-20
44198253131,44198253135,4,2605,1753,-20
44201356202,44201356205,3,2250,1227,-20
44205486101,44205486097,-4,2814,6512,-20
44205848506,44205848514,8,2296,808,-20
44208140099,44208140099,0,1298,1948,-20
44208478726,44208478730,4,1247,1169,-20
44214043334,44214043338,4,1572,912,-20
44214668099,44214668095,-4,2489,5796,-20
44216097991,44216097991,0,671,969,-20
44217774750,44217774750,0,1483,1480,-20
44218725726,44218725729,3,1712,1723,-20
44221673610,44221673613,3,2636,1795,-20
44226941341,44226941346,5,1893,993,-20
44227708202,44227708206,4,1937,1439,-20
44230223733,44230223734,1,1822,1559,-20
44232865772,44232865775,3,1737,1438,-20
44232956886,44232956885,-1,916,2469,-20
44235287443,44235287444,1,1495,1639,-20
44235392769,44235392776,7,6451,3036,-20
44238874366,44238874370,4,1733,1561,-20
44239767652,44239767655,3,1566,1481,-20
44240187170,44240187186,16,1786,1676,-20
44241284564,44241284567,3,2001,1621,-20
44243411866,44243411871,5,1840,1551,-20
44243896936,44243896938,2,1559,1105,-20
44245869157,44245869179,22,2167,1473,-20
44246525138,44246525143,5,2496,1198,-20
44249461081,44249461087,6,1596,1672,-20
44250054228,44250054232,4,2770,1664,-20
44250948478,44250948483,5,1382,1375,-20
44256142239,44256142238,-1,2868,3798,-20
44257297640,44257297643,3,2022,1759,-20
44260005025,44260005028,3,2596,1541,-20
44261372882,44261372883,1,1709,1470,-20
44262986937,44262986941,4,1701,1381,-20
44264566426,44264566430,4,1455,1475,-20
44265156051,44265156054,3,2253,1725,-20
44268241777,44268241782,5,2182,1827,-20
44268514398,44268514400,2,2192,1717,-20
44269085332,44269085332,0,938,1673,-20
44272277322,44272277326,4,1611,1200,-20
44272996656,44272996659,3,2070,1201,-20
44274328998,44274329005,7,1639,1298,-20
44276334613,44276334618,5,2128,1774,-20
44286973846,44286973848,2,1323,1083,-20
44288101043,44288101048,5,1043,521,-20
44289271169,44289271173,4,1858,1481,-20
44289872098,44289872099,1,1484,968,-20
44290056165,44290056167,2,2406,1296,-20
44292586961,44292586966,5,2186,1348,-20
44293198678,44293198698,20,1455,1093,-20
44298267886,44298267887,1,1401,1227,-20
44302895930,44302895934,4,1809,1557,-20
44305799594,44305799594,0,1702,1319,-20
44310215176,44310215181,5,1923,1377,-20
44310667786,44310667794,8,2403,1425,-20
44311006581,44311006602,21,1590,1546,-20
44311883263,44311883266,3,1149,1322,-20
44313374281,44313374285,4,1767,1490,-20
44317015005,44317015007,2,2073,929,-20
44317766853,44317766859,6,21397,29839,-20
44324979931,44324979935,4,1281,1302,-20
44326276734,44326276735,1,1593,1462,-20
44326774431,44326774433,2,1599,1328,-20
44327231350,44327231354,4,2590,1317,-20
44327528943,44327528947,4,2514,1367,-20
44329763481,44329763484,3,1694,892,-20
44330278057,44330278064,7,1901,708,-20
44331694589,44331694592,3,1383,1422,-20
44333848494,44333848498,4,1772,1586,-20
44336126119,44336126125,6,2639,1720,-20
44337356688,44337356690,2,1472,1346,-20
44337882499,44337882502,3,1636,1302,-20
44338216903,44338216906,3,1745,1305,-20
44338956678,44338956684,6,1368,771,-20
44339621382,44339621361,-21,2297,1601,-20
44341536243,44341536248,5,798,1178,-20
44346344285,44346344287,2,1937,1319,-20
44347011234,44347011238,4,1620,1066,-20
44352498298,44352498303,5,2354,1770,-20
44356254325,44356254329,4,2243,1636,-20
44356527846,44356527851,5,2512,1422,-20
44356756123,44356756126,3,1141,1044,-20
44357856078,44357856083,5,3458,1601,-20
44361731064,44361731069,5,2426,1987,-20
44363060692,44363060678,-14,960,3120,-20
44365267113,44365267114,1,1941,1320,-20
44365983598,44365983602,4,1840,1337,-20
44367449068,44367449072,4,2518,1662,-20
44369172486,44369172488,2,1778,1267,-20
44369868690,44369868694,4,1671,1077,-20
44370672946,44370672950,4,1379,1464,-20
44373319599,44373319605,6,3304,1164,-20
44373350161,44373350164,3,1807,1578,-20
44374071190,44374071193,3,1762,1540,-20
44374414047,44374414051,4,2416,1766,-20
44375925232,44375925235,3,2302,1622,-20
44377385981,44377385986,5,2039,1233,-20
44377728074,44377728078,4,1886,1501,-20
44380812183,44380812187,4,1744,1229,-20
44382264041,44382264046,5,3301,1053,-20
44382841751,44382841748,-3,1593,2443,-20
44389549176,44389549181,5,1897,1528,-20
44391405910,44391405913,3,1401,1271,-20
44394134238,44394134242,4,1495,1315,-20
44396062871,44396062871,0,1919,1614,-20
44398593337,44398593341,4,1423,1503,-20
44405237261,44405237265,4,1652,1251,-20
44405318252,44405318257,5,2565,1069,-20
44405916709,44405916711,2,2075,2357,-20
44406015046,44406015052,6,2399,1662,-20
44406187808,44406187813,5,1701,1455,-20
44409421984,44409421987,3,2198,1643,-20
44411444361,44411444364,3,2339,1976,-20
44415414988,44415414991,3,921,989,-20
44416493361,44416493363,2,1469,1127,-20
44418239279,44418239283,4,2364,1805,-20
44426730230,44426730235,5,2892,2434,-20
44426776787,44426776786,-1,1980,2115,-20
44427059949,44427059954,5,1577,1205,-20
44428870401,44428870402,1,1773,2025,-20
44428952023,44428952024,1,2002,1692,-20
44429208769,44429208772,3,1201,970,-20
44431920110,44431920105,-5,1094,3456,-20
44433167479,44433167483,4,1851,1439,-20
44433915863,44433915866,3,1388,981,-20
44437788015,44437788018,3,2522,1488,-20
44439758845,44439758846,1,1314,1102,-20
44440131390,44440131394,4,2247,1473,-20
44443210118,44443210124,6,7207,3047,-20
44448454123,44448454126,3,1555,1094,-20
44452790674,44452790678,4,1727,1879,-20
44453389949,44453389951,2,2191,1707,-20
44458853157,44458853159,2,1225,944,-20
44459099343,44459099347,4,1207,641,-20
44459564584,44459564586,2,1858,1742,-20
44462225519,44462225528,9,3931,2333,-20
44464255201,44464255203,2,1091,1474,-20
44465040589,44465040591,2,1352,908,-20
44466401222,44466401218,-4,369,171,-20
44480991205,44480991210,5,1506,1063,-20
44485833837,44485833842,5,2280,1200,-20
44496796698,44496796701,3,1532,822,-20
44499096428,44499096429,1,991,1483,-20
44499183217,44499183221,4,1501,1222,-20
44501303870,44501303873,3,2182,2088,-20
44504167831,44504167834,3,1752,1432,-20
44508379142,44508379146,4,1707,1356,-20
44508732345,44508732349,4,1341,1517,-20
44510952699,44510952702,3,2120,1490,-20
44512959289,44512959294,5,1721,1523,-20
44515532957,44515532957,0,1537,2248,-20
44521292962,44521292965,3,1339,1152,-20
44523614833,44523614836,3,2126,1597,-20
44523934512,44523934517,5,1974,1204,-20
44526056653,44526056658,5,1277,972,-20
44528549053,44528549058,5,1657,1575,-20
44528854253,44528854255,2,1558,1602,-20
44529104718,44529104721,3,1106,1265,-20
44529733931,44529733935,4,2811,1167,-20
44529876749,44529876750,1,1297,913,-20
44530423667,44530423670,3,2412,1810,-20
44531683614,44531683617,3,2165,1529,-20
44531815066,44531815070,4,1396,1385,-20
44532242459,44532242462,3,1245,1069,-20
44536638805,44536638812,7,2121,1179,-20
44539534321,44539534321,0,1218,2514,-20
44539608758,44539608761,3,1756,1767,-20
44540699909,44540699913,4,2012,1449,-20
44541773079,44541773081,2,2245,2502,-20
44547386332,44547386334,2,2189,1375,-20
44554086729,44554086730,1,1523,774,-20
44554813410,44554813414,4,1437,1398,-20
44555114930,44555114933,3,1633,1353,-20
44556358737,44556358741,4,1860,1360,-20
44556940238,44556940241,3,1895,1055,-20
44558369801,44558369805,4,2524,1661,-20
44560376258,44560376262,4,1440,1638,-20
44565075192,44565075194,2,1745,1648,-20
44565836626,44565836629,3,1578,1005,-20
44566277770,44566277770,0,1608,1802,-20
44566395503,44566395507,4,1616,848,-20
44567726531,44567726534,3,1424,1298,-20
44569195031,44569195034,3,1605,1448,-20
44572524130,44572524134,4,2357,1562,-20
44572938421,44572938423,2,2043,2191,-20
44574023006,44574023008,2,1486,1415,-20
44577896702,44577896704,2,1329,1447,-20
44578301341,44578301345,4,2224,1583,-20
44578872038,44578872042,4,724,787,-20
44581809559,44581809562,3,2010,1583,-20
44582078910,44582078913,3,2071,1623,-20
44583726627,44583726627,0,2255,1086,-20
44584849843,44584849846,3,1426,1485,-20
44584998247,44584998246,-1,1547,1221,-20
44585666041,44585666043,2,3051,1798,-20
44586517723,44586517727,4,1359,1216,-20
44586580086,44586580092,6,2322,2185,-20
44589387454,44589387457,3,1379,1528,-20
44590117639,44590117643,4,1169,860,-20
44591088713,44591088716,3,1812,1342,-20
44592122270,44592122271,1,2088,1480,-20
44595204400,44595204402,2,1706,1098,-20
44595447810,44595447814,4,1796,1062,-20
44596845551,44596845555,4,1503,1012,-20
44597592710,44597592716,6,1277,607,-20
44600858006,44600858007,1,1819,1257,-20
44602297632,44602297645,13,13649,49121,-20
44606788184,44606788187,3,1876,1016,-20
44610642422,44610642427,5,1117,814,-20
44614239927,44614239936,9,31274,1461,-20
44614964603,44614964605,2,1798,1563,-20
44615104994,44615104978,-16,1220,1283,-20
44615705960,44615705962,2,2153,1390,-20
44617051166,44617051170,4,2212,1485,-20
44623167741,44623167744,3,1627,1210,-20
44624555351,44624555349,-2,2018,3945,-20
44626335361,44626335366,5,2478,1127,-20
44627053465,44627053467,2,1981,922,-20
44628012803,44628012818,15,1256,1161,-20
44633925866,44633925866,0,1713,1581,-20
44636093706,44636093711,5,2350,1490,-20
44637449813,44637449815,2,1603,1324,-20
44638384158,44638384162,4,1368,768,-20
44641671291,44641671293,2,1783,988,-20
44643132613,44643132615,2,2994,2059,-20
44645504850,44645504851,1,1152,1849,-20
44646264710,44646264715,5,2135,1298,-20
44647668342,44647668346,4,1522,1173,-20
44649093797,44649093800,3,2184,1216,-20
44649758859,44649758862,3,1270,971,-20
44654966029,44654966035,6,3860,1194,-20
44658251866,44658251871,5,2718,1570,-20
44659089802,44659089805,3,1428,1301,-20
44659399350,44659399354,4,1890,1684,-20
44661420632,44661420637,5,3059,1897,-20
44662006618,44662006622,4,1202,1043,-20
44664016366,44664016365,-1,2633,4163,-20
44669335973,44669335976,3,2624,1810,-20
44675324883,44675324887,4,1917,1397,-20
44675562581,44675562600,19,1864,1286,-20
44676811851,44676811854,3,2145,1227,-20
44684369555,44684369558,3,1387,941,-20
44685733570,44685733551,-19,103,872,-20
44686365035,44686365037,2,20111,43168,-20
44689270136,44689270137,1,1637,1688,-20
44689794286,44689794289,3,1157,821,-20
44690465623,44690465629,6,1311,1428,-20
44690762934,44690762915,-19,1551,1161,-20
44695243778,44695243781,3,1567,1037,-20
44695760920,44695760923,3,1004,766,-20
44696125440,44696125456,16,1209,900,-20
44705286583,44705286586,3,1906,1642,-20
44706440133,44706440136,3,2089,1906,-20
44706837940,44706837943,3,1481,1735,-20
44709200409,44709200413,4,1556,1088,-20
44710358349,44710358354,5,1957,1565,-20
44710534408,44710534410,2,1888,1648,-20
44711267099,44711267105,6,1279,869,-20
44715673650,44715673653,3,1584,1246,-20
44717307469,44717307471,2,1385,944,-20
44717622717,44717622722,5,2020,1470,-20
44719389593,44719389595,2,2218,1495,-20
44721276356,44721276358,2,2428,1013,-20
44723084830,44723084827,-3,1433,2370,-20
44725150636,44725150639,3,1837,1645,-20
44726002826,44726002833,7,1880,1050,-20
44726175146,44726175129,-17,1428,751,-20
44728442315,44728442314,-1,1649,1946,-20
44729407892,44729407894,2,1749,1317,-20
44730221281,44730221282,1,1676,1177,-20
44731009538,44731009541,3,1981,1857,-20
44733219345,44733219346,1,1665,1280,-20
44736348773,44736348774,1,1840,1623,-20
44737257050,44737257056,6,1942,1367,-20
44737329566,44737329569,3,1637,1395,-20
44738403665,44738403667,2,2433,1253,-20
44739051548,44739051550,2,2483,1848,-20
44747511039,44747511042,3,1816,1200,-20
44751789438,44751789441,3,1502,1018,-20
44751908410,44751908410,0,1915,1528,-20
44754977370,44754977373,3,1891,1734,-20
44756614481,44756614486,5,2217,1166,-20
44756974751,44756974754,3,2203,1200,-20
44757548999,44757549002,3,2088,1543,-20
44758070932,44758070936,4,1834,1415,-20
44759133545,44759133547,2,2164,1788,-20
44759189499,44759189503,4,1893,1297,-20
44759412358,44759412339,-19,1127,842,-20
44760055918,44760055920,2,2051,1603,-20
44760867554,44760867573,19,1560,2338,-20
44761243146,44761243150,4,1751,1347,-20
44761862335,44761862339,4,2236,1066,-20
44769224716,44769224719,3,1565,1504,-20
44774289174,44774289173,-1,864,863,-20
44776503251,44776503245,-6,1987,7188,-20
44780213538,44780213542,4,1952,1650,-20
44782176018,44782176022,4,2048,1592,-20
44783929054,44783929057,3,1694,1361,-20
44784433892,44784433898,6,1447,1186,-20
44786413743,44786413726,-17,2387,1864,-20
44787173821,44787173823,2,1537,1952,-20
44788699669,44788699670,1,1908,1276,-20
44788778265,44788778267,2,1703,1674,-20
44791983102,44791983106,4,1627,1099,-20
44792833791,44792833795,4,1132,884,-20
44795268278,44795268279,1,1627,1034,-20
44797200431,44797200426,-5,1096,3507,-20
44798796541,44798796544,3,1568,779,-20
44800035444,44800035449,5,2250,1435,-20
44802313575,44802313578,3,1107,1170,-20
44803180380,44803180382,2,2198,2017,-20
44806315677,44806315678,1,1703,1638,-20
44812541894,44812541899,5,2457,1723,-20
44812781366,44812781371,5,2523,1710,-20
44813404754,44813404755,1,1281,1290,-20
44814458202,44814458206,4,1745,790,-20
44815500892,44815500910,18,811,1977,-20
44815723701,44815723705,4,5049,3506,-20
44820315090,44820315097,7,5404,2024,-20
44823499819,44823499829,10,10939,38811,-20
44826160070,44826160084,14,1719,857,-20
44828838283,44828838289,6,2275,1075,-20
44830808566,44830808571,5,1202,1378,-20
44831687593,44831687597,4,2573,2047,-20
44832434880,44832434885,5,1476,1090,-20
44834305710,44834305714,4,2078,1766,-20
44835852952,44835852954,2,1366,1184,-20
44839143251,44839143253,2,2185,2229,-20
44839308511,44839308514,3,1885,1086,-20
44848648067,44848648070,3,1472,1082,-20
44849394257,44849394259,2,2041,777,-20
44850234555,44850234558,3,1614,1399,-20
44852310575,44852310580,5,1610,1567,-20
44856715863,44856715870,7,3714,1767,-20
44858614925,44858614927,2,1706,1709,-20
44861158225,44861158230,5,1964,1101,-20
44864436477,44864436479,2,2334,1377,-20
44864754501,44864754505,4,1335,1642,-20
44865426546,44865426528,-18,558,174,-20
44868287440,44868287447,7,2105,1002,-20
44869484057,44869484056,-1,1403,1524,-20
44869737142,44869737145,3,1949,1665,-20
44871080800,44871080791,-9,47716,11638,-20
44873197721,44873197726,5,1748,1712,-20
44874842893,44874842898,5,1248,1235,-20
44883704578,44883704582,4,3310,1801,-20
44887002090,44887002092,2,2000,2047,-20
44889159209,44889159212,3,1532,1498,-20
44890837726,44890837731,5,1389,1444,-20
44891237979,44891237982,3,1276,905,-20
44892984213,44892984214,1,1649,1223,-20
44895468874,44895468878,4,1558,1031,-20
44896508018,44896508023,5,3186,1559,-20
44901764253,44901764254,1,1547,1622,-20
44901962917,44901962896,-21,1409,1237,-20
44902932320,44902932321,1,1662,1600,-20
44903679373,44903679376,3,2463,1477,-20
44904937726,44904937729,3,1866,1409,-20
44905274248,44905274250,2,1660,1601,-20
44905810635,44905810641,6,2093,1008,-20
44907213885,44907213888,3,1622,1486,-20
44910479013,44910479014,1,1855,1338,-20
44916381485,44916381488,3,1512,1361,-20
44916756198,44916756204,6,532,254,-20
44917411065,44917411067,2,1405,1223,-20
44917550966,44917550946,-20,1126,1257,-20
44918156626,44918156629,3,1341,1005,-20
44921924794,44921924798,4,1416,1164,-20
44924500697,44924500700,3,1304,1086,-20
44924943173,44924943174,1,1187,1132,-20
44929651006,44929651011,5,1409,1351,-20
44930089346,44930089350,4,1112,1311,-20
44930608642,44930608646,4,1866,1306,-20
44930696258,44930696264,6,1605,1412,-20
44933038085,44933038088,3,2218,1476,-20
44933762087,44933762091,4,1891,1280,-20
44935669419,44935669422,3,1673,1852,-20
44938089472,44938089474,2,1801,1408,-20
44938117650,44938117653,3,1920,1217,-20
44939798710,44939798714,4,2475,1874,-20
44940508799,44940508803,4,1596,1130,-20
44940618989,44940618990,1,1817,1290,-20
44941202774,44941202778,4,2006,1540,-20
44945639670,44945639674,4,1081,1502,-20
44945733710,44945733714,4,1701,1400,-20
44946733969,44946733971,2,1335,986,-20
44953320678,44953320682,4,1993,1733,-20
44956350790,44956350795,5,2095,1266,-20
44956453658,44956453661,3,2485,1530,-20
44957302074,44957302078,4,2060,1686,-20
44959170831,44959170831,0,1352,1745,-20
44959998940,44959998942,2,1244,1237,-20
44960189797,44960189800,3,1967,1454,-20
44969317877,44969317879,2,1774,1645,-20
44970905821,44970905809,-12,1644,1522,-20
44973083863,44973083865,2,1627,1552,-20
44975083073,44975083077,4,1619,1176,-20
44977029501,44977029506,5,2085,1546,-20
44977318694,44977318695,1,1221,1273,-20
44978232021,44978232031,10,20623,44941,-20
44978956898,44978956903,5,1199,1011,-20
44979475517,44979475514,-3,1797,2552,-20
44979631844,44979631846,2,1717,1455,-20
44980942278,44980942283,5,1971,1345,-20
44987361426,44987361429,3,2466,1840,-20
44990933321,44990933323,2,1033,796,-20
44991913811,44991913815,4,1860,1458,-20
44996534475,44996534478,3,1422,1365,-20
45003536032,45003536034,2,1376,678,-20
45005300308,45005300311,3,2163,1230,-20
45007754637,45007754641,4,1645,1262,-20
45010733907,45010733911,4,1695,1485,-20
45012251758,45012251760,2,1409,1259,-20
45014919139,45014919134,-5,1084,2071,-20
45015570918,45015570923,5,1952,1676,-20
45016068362,45016068367,5,2080,1438,-20
45018428821,45018428823,2,2129,1001,-20
45021986914,45021986917,3,1256,1576,-20
45026218402,45026218407,5,1240,872,-20
45028260577,45028260583,6,2266,1572,-20
45028625625,45028625629,4,2031,1292,-20
45030500905,45030500907,2,1947,1696,-20
45030749720,45030749730,10,1540,1711,-20
45033044770,45033044776,6,2496,1664,-20
45034932736,45034932739,3,1929,1287,-20
45036372202,45036372204,2,2271,1272,-20
45038842742,45038842741,-1,1175,2339,-20
45041117802,45041117805,3,2175,2108,-20
45042051298,45042051302,4,2369,1721,-20
45046337808,45046337811,3,1686,1481,-20
45047506298,45047506300,2,2528,2286,-20
45048168935,45048168936,1,1241,2413,-20
45048764999,45048765005,6,1616,1289,-20
45050197589,45050197589,0,1212,1483,-20
45050968010,45050968015,5,1512,1755,-20
45054315040,45054315043,3,2635,1808,-20
45056830034,45056830038,4,2120,1290,-20
45061102246,45061102245,-1,1374,1840,-20
45061972339,45061972341,2,1792,1185,-20
45063061464,45063061467,3,1515,1708,-20
45064647694,45064647699,5,2565,1785,-20
45065623466,45065623469,3,1630,1757,-20
45065682039,45065682041,2,1708,1804,-20
45066295970,45066295963,-7,730,2469,-20
45066725574,45066725579,5,2143,1534,-20
45066816933,45066816939,6,1441,1310,-20
45068150388,45068150390,2,3134,2063,-20
45068217961,45068217963,2,1682,1465,-20
45071020498,45071020501,3,1502,1362,-20
45072534870,45072534874,4,1441,1540,-20
45073950779,45073950783,4,1100,1153,-20
45082484986,45082484989,3,1541,1189,-20
45084631428,45084631431,3,1367,1480,-20
45084920305,45084920309,4,1006,1372,-20
45085521386,45085521392,6,2902,1119,-20
45089368664,45089368667,3,1716,1174,-20
45094749522,45094749525,3,971,899,-20
45106181106,45106181110,4,2678,1745,-20
45113638574,45113638579,5,1935,1422,-20
45114706803,45114706807,4,1845,1824,-20
45116042484,45116042487,3,2055,1370,-20
45116588689,45116588690,1,1331,1104,-20
45117418578,45117418582,4,1603,1223,-20
45118381102,45118381105,3,1806,1799,-20
45118558333,45118558339,6,1569,878,-20
45121098694,45121098699,5,1348,974,-20
45121971713,45121971715,2,1585,1533,-20
45131935927,45131935943,16,1786,8273,-20
45132615050,45132615050,0,1341,1465,-20
45134528779,45134528782,3,1302,1409,-20
45134560882,45134560886,4,3203,1940,-20
45135768462,45135768468,6,1665,1586,-20
45136532294,45136532299,5,2113,1751,-20
45139056491,45139056491,0,1162,1139,-20
45140605369,45140605371,2,2558,1223,-20
45142785001,45142785006,5,2083,1059,-20
45144610003,45144610007,4,1483,996,-20
45146202228,45146202209,-19,713,1306,-20
45149110746,45149110749,3,1445,1577,-20
45149529411,45149529405,-6,1308,5612,-20
45152702941,45152702947,6,21321,27642,-20
45153580041,45153580042,1,1090,656,-20
45156101890,45156101891,1,1713,1502,-20
45156750265,45156750267,2,2230,1535,-20
45157876631,45157876633,2,2891,2591,-20
45158879875,45158879878,3,1579,1567,-20
45159084957,45159084961,4,2130,1444,-20
45162586747,45162586750,3,2215,1516,-20
45166666297,45166666296,-1,1142,358,-20
45167716408,45167716414,6,2155,1129,-20
45172809850,45172809850,0,1052,1586,-20
45173565773,45173565775,2,1339,1269,-20
45173734566,45173734567,1,1183,941,-20
45174130130,45174130135,5,1472,1241,-20
45182835546,45182835550,4,2238,1437,-20
45184799277,45184799279,2,1778,1157,-20
45185424653,45185424654,1,1929,1531,-20
45187090315,45187090317,2,1755,1653,-20
45187351630,45187351634,4,2780,1994,-20
45188816070,45188816072,2,1654,1334,-20
45190046092,45190046097,5,1585,1329,-20
45199942678,45199942661,-17,1504,1111,-20
45204194025,45204194027,2,1718,1280,-20
45204747810,45204747809,-1,1808,2780,-20
45210792517,45210792522,5,1791,1271,-20
45214140268,45214140275,7,2622,1107,-20
45216102390,45216102394,4,2606,1435,-20
45220011883,45220011891,8,44800,58969,-20
45221638680,45221638684,4,1632,1466,-20
45223104174,45223104179,5,2789,1299,-20
45224639710,45224639714,4,1447,1195,-20
45225038312,45225038330,18,592,144,-20
45225511463,45225511466,3,1844,1701,-20
45225765847,45225765851,4,1377,1525,-20
45226240111,45226240116,5,1681,1840,-20
45230558307,45230558311,4,1075,1261,-20
45232849527,45232849530,3,992,1313,-20
45238542622,45238542625,3,1327,1360,-20
45240860744,45240860745,1,8432,12325,-20
45241146710,45241146713,3,1868,1187,-20
45241355855,45241355859,4,1745,1265,-20
45241895285,45241895304,19,1560,1058,-20
45244477234,45244477237,3,1700,1214,-20
45244829875,45244829878,3,2462,1018,-20
45249413608,45249413614,6,1730,924,-20
45249861413,45249861415,2,1749,1255,-20
45252302646,45252302649,3,695,1170,-20
45253061117,45253061120,3,2036,1741,-20
45256475478,45256475482,4,1734,1564,-20
45256605350,45256605353,3,2754,1929,-20
45258050513,45258050517,4,2126,1634,-20
45258480729,45258480733,4,1866,1668,-20
45259334700,45259334704,4,1408,1482,-20
45262027710,45262027713,3,1225,1006,-20
45262204625,45262204627,2,1757,1301,-20
45264292003,45264292005,2,1931,1719,-20
45265734822,45265734825,3,1254,1091,-20
45267042242,45267042248,6,2768,1888,-20
45267396614,45267396618,4,1988,1860,-20
45268618941,45268618946,5,899,984,-20
45269266669,45269266673,4,1926,1308,-20
45273916665,45273916668,3,1413,1605,-20
45274159745,45274159748,3,1405,1258,-20
45274976017,45274976019,2,1764,1805,-20
45276941938,45276941939,1,1594,1598,-20
45279833770,45279833776,6,2321,1451,-20
45281702610,45281702614,4,2464,2427,-20
45283882923,45283882925,2,1582,1652,-20
45288134482,45288134483,1,1695,1299,-20
45289031962,45289031965,3,1933,1350,-20
45289316110,45289316111,1,1439,1243,-20
45293042889,45293042891,2,2162,1246,-20
45295796546,45295796548,2,1525,1681,-20
45301445702,45301445703,1,2242,1477,-20
45304206398,45304206400,2,1735,1423,-20
45306445802,45306445807,5,1894,1155,-20
45307697182,45307697186,4,1713,1117,-20
45311613196,45311613199,3,2170,1255,-20
45312297030,45312297030,0,1077,1342,-20
45313517418,45313517423,5,1799,1505,-20
45315311840,45315311843,3,1864,1482,-20
45316977599,45316977603,4,2177,1998,-20
45321018100,45321018104,4,2045,1218,-20
45321257919,45321257938,19,1375,765,-20
45324914593,45324914594,1,1583,1040,-20
45325356717,45325356722,5,1635,1448,-20
45325804295,45325804296,1,1355,2813,-20
45326453586,45326453587,1,1447,801,-20
45330014576,45330014580,4,2111,1460,-20
45331316305,45331316307,2,1949,1762,-20
45334346325,45334346326,1,2133,1873,-20
45334833872,45334833874,2,1308,711,-20
45338504192,45338504196,4,1925,1486,-20
45341093604,45341093607,3,1747,1136,-20
45342219049,45342219053,4,884,1093,-20
45342934166,45342934177,11,1383,1162,-20
45343287904,45343287908,4,2197,1538,-20
45349358425,45349358427,2,2095,1680,-20
45353153752,45353153753,1,1778,1126,-20
45356219575,45356219580,5,1273,965,-20
45358609997,45358609993,-4,1317,2453,-20
45360386164,45360386162,-2,1194,2640,-20
45363301900,45363301905,5,2268,2175,-20
45363553603,45363553607,4,1111,1330,-20
45364623087,45364623091,4,2306,1679,-20
45370730130,45370730133,3,2048,1738,-20
45371660289,45371660293,4,2329,1352,-20
45373596447,45373596451,4,1398,1662,-20
45378496942,45378496950,8,4970,2240,-20
45379362934,45379362938,4,2326,1538,-20
45379418795,45379418799,4,1705,1288,-20
45379703650,45379703648,-2,2261,1519,-20
45380421818,45380421817,-1,832,1630,-20
45380756415,45380756418,3,1432,1307,-20
45382880378,45382880379,1,2041,1485,-20
45387950438,45387950441,3,1535,1447,-20
45388049652,45388049635,-17,1683,1536,-20
45395667080,45395667082,2,1773,1802,-20
45397801704,45397801711,7,1995,1358,-20
45397994736,45397994733,-3,2407,5533,-20
45398803195,45398803199,4,2150,1338,-20
45402883715,45402883719,4,1544,1571,-20
45403775203,45403775208,5,2446,1873,-20
45405580869,45405580870,1,2184,1221,-20
45407480037,45407480041,4,1902,1500,-20
45408112236,45408112239,3,1774,1107,-20
45411028565,45411028570,5,1656,1267,-20
45411256913,45411256931,18,1242,1306,-20
45414896331,45414896332,1,1394,1266,-20
45415338653,45415338659,6,2307,1200,-20
45416023819,45416023821,2,1694,1455,-20
45416848894,45416848895,1,1107,790,-20
45418270150,45418270154,4,2455,1063,-20
45418306095,45418306099,4,1755,1412,-20
45420639986,45420639989,3,1671,1747,-20
45420721403,45420721403,0,1402,1032,-20
45426106447,45426106451,4,1370,1374,-20
45426789648,45426789650,2,1168,1269,-20
45427317623,45427317629,6,1854,1097,-20
45433715136,45433715141,5,3126,1423,-20
45433840470,45433840473,3,1509,1476,-20
45440503485,45440503487,2,1674,1318,-20
45441789054,45441789057,3,49700,43146,-20
45443469979,45443469981,2,819,903,-20
45443961678,45443961674,-4,670,2263,-20
45447191085,45447191087,2,2062,1357,-20
45449661888,45449661893,5,1280,722,-20
45450990049,45450990050,1,1474,1166,-20
45452724538,45452724538,0,906,1166,-20
45453828641,45453828656,15,1145,739,-20
45454850919,45454850922,3,1141,1135,-20
45455994397,45455994397,0,1889,1641,-20
45457533798,45457533778,-20,1173,874,-20
45459009753,45459009757,4,2137,1412,-20
45460457165,45460457169,4,2584,1781,-20
45468368437,45468368439,2,1622,1462,-20
45480215564,45480215569,5,1657,1030,-20
45480247870,45480247850,-20,1324,1148,-20
45480455082,45480455085,3,2783,1679,-20
45482405606,45482405611,5,1530,937,-20
45483967327,45483967326,-1,1463,1784,-20
45486824974,45486824980,6,3970,2083,-20
45487142275,45487142279,4,1429,1289,-20
45490995282,45490995281,-1,2581,4921,-20
45496402777,45496402781,4,1147,1626,-20
45497733497,45497733501,4,1867,1510,-20
45498482500,45498482497,-3,25416,13714,-20
45499426270,45499426271,1,1580,1451,-20
45499565606,45499565611,5,1586,1062,-20
45502186202,45502186206,4,1481,1059,-20
45502631454,45502631457,3,2004,1606,-20
45506291307,45506291310,3,1623,1507,-20
45509141282,45509141283,1,1877,2164,-20
45509394483,45509394485,2,1606,1783,-20
45511377463,45511377458,-5,1189,2831,-20
45517063045,45517063049,4,1449,1475,-20
45518176342,45518176349,7,2590,1232,-20
45520749913,45520749917,4,2174,1598,-20
45521601257,45521601259,2,2406,1461,-20
45522041103,45522041105,2,2147,1512,-20
45523064647,45523064651,4,2175,1358,-20
45531073233,45531073235,2,1855,1113,-20
45531181483,45531181497,14,1901,1201,-20
45531680565,45531680569,4,2543,1685,-20
45532813576,45532813580,4,2024,1839,-20
45535445162,45535445167,5,1964,1369,-20
45537224262,45537224265,3,2198,1793,-20
45538045578,45538045581,3,2190,1551,-20
45538634639,45538634643,4,1565,1163,-20
45538674097,45538674100,3,1934,1109,-20
45539231785,45539231787,2,2048,1292,-20
45542387560,45542387562,2,1418,1054,-20
45542766281,45542766285,4,1882,1400,-20
45545559357,45545559360,3,2093,1966,-20
45546178947,45546178951,4,1797,1580,-20
45546323448,45546323448,0,1380,1245,-20
45547877331,45547877333,2,1680,1521,-20
45549447474,45549447477,3,1328,1361,-20
45556997858,45556997862,4,1617,1215,-20
45559582994,45559582998,4,2298,1387,-20
45559725419,45559725434,15,2470,1295,-20
45560363811,45560363815,4,2438,1895,-20
45563752340,45563752342,2,1241,1802,-20
45566358158,45566358162,4,1815,1245,-20
45567514760,45567514761,1,1928,1246,-20
45571542038,45571542043,5,617,1061,-20
45575747154,45575747159,5,1977,1797,-20
45578372530,45578372532,2,1750,1149,-20
45580125642,45580125647,5,999,772,-20
45580335309,45580335314,5,2132,1680,-20
45583478558,45583478561,3,1592,1430,-20
45589584561,45589584561,0,1228,1094,-20
45592142070,45592142074,4,1539,1409,-20
45593182409,45593182415,6,2315,1206,-20
45595780803,45595780805,2,1840,1649,-20
45596069661,45596069642,-19,1412,734,-20
45596513992,45596513994,2,2259,1475,-20
45597607897,45597607897,0,1528,1391,-20
45598114269,45598114270,1,1557,1405,-20
45601361533,45601361535,2,767,832,-20
45606814800,45606814802,2,1908,1378,-20
45606990951,45606990955,4,1010,989,-20
45607277185,45607277187,2,1704,1149,-20
45611658802,45611658807,5,1249,1285,-20
45612919946,45612919941,-5,2002,5822,-20
45616300457,45616300455,-2,983,1748,-20
45617163231,45617163237,6,5481,3137,-20
45617764771,45617764768,-3,1038,3381,-20
45618525596,45618525591,-5,1554,3987,-20
45620305658,45620305663,5,1698,1157,-20
45621831436,45621831441,5,2498,1130,-20
45625358765,45625358766,1,1768,1568,-20
45635018242,45635018246,4,1393,1370,-20
45635987547,45635987550,3,892,820,-20
45639165613,45639165617,4,1895,1701,-20
45642544181,45642544181,0,1120,921,-20
45648492341,45648492339,-2,1693,2320,-20
45651339942,45651339946,4,1321,787,-20
45652541046,45652541024,-22,1493,1260,-20
45652644458,45652644462,4,1100,1388,-20
45653718180,45653718184,4,1517,1455,-20
45658177997,45658177999,2,1766,1274,-20
45659703638,45659703642,4,2079,1596,-20
45660810798,45660810803,5,1232,1076,-20
45662055844,45662055847,3,1606,1653,-20
45662224029,45662224033,4,757,762,-20
45664001326,45664001331,5,2334,858,-20
45667715643,45667715648,5,2124,1593,-20
45669759941,45669759945,4,1744,1680,-20
45673344101,45673344103,2,1301,1049,-20
45677646512,45677646514,2,1313,1103,-20
45679070031,45679070035,4,2382,1403,-20
45680991814,45680991818,4,2013,729,-20
45683125791,45683125794,3,1978,1505,-20
45683276463,45683276444,-19,2115,855,-20
45683385229,45683385230,1,1396,1642,-20
45683704682,45683704687,5,2514,1605,-20
45683944462,45683944466,4,1318,1118,-20
45684808807,45684808809,2,1449,1000,-20
45685641435,45685641438,3,1926,1816,-20
45685789325,45685789328,3,1569,1392,-20
45685959722,45685959721,-1,2552,2680,-20
45689140654,45689140659,5,1375,1416,-20
45690541463,45690541466,3,1479,1178,-20
45694276825,45694276828,3,2232,1732,-20
45694592413,45694592419,6,3965,2129,-20
45697298366,45697298371,5,2734,1756,-20
45704750758,45704750762,4,1953,1339,-20
45705137357,45705137360,3,1388,1130,-20
45708531201,45708531205,4,2414,1421,-20
45711758910,45711758912,2,1645,1682,-20
45714294511,45714294513,2,1464,2065,-20
45716123608,45716123611,3,1752,1244,-20
45717576955,45717576958,3,2102,1271,-20
45718037702,45718037694,-8,2354,8900,-20
45719992581,45719992585,4,2103,1308,-20
45720507679,45720507683,4,1607,1535,-20
45720999483,45720999485,2,1988,1337,-20
45721840878,45721840881,3,2416,1588,-20
45722454437,45722454440,3,1356,1227,-20
45722622482,45722622482,0,1197,1488,-20
45729414609,45729414614,5,1406,894,-20
45730559227,45730559229,2,1926,1412,-20
45732429598,45732429601,3,16713,14048,-20
45733003038,45733003041,3,1200,986,-20
45737012985,45737012988,3,1581,1628,-20
45738996767,45738996769,2,2307,1504,-20
45741100833,45741100835,2,1674,1408,-20
45741133220,45741133225,5,2159,1226,-20
45741636706,45741636708,2,1596,1105,-20
45745527649,45745527655,6,2139,1215,-20
45745563067,45745563048,-19,2056,1770,-20
45746998364,45746998367,3,2054,1879,-20
45748678983,45748678987,4,1690,1308,-20
45751266527,45751266529,2,1772,1368,-20
45758229606,45758229606,0,1597,883,-20
45760657954,45760657955,1,1313,955,-20
45766478399,45766478402,3,1856,1731,-20
45767410949,45767410954,5,1207,1096,-20
45769764553,45769764554,1,1976,2132,-20
45769906954,45769906959,5,1799,826,-20
45770850309,45770850311,2,1694,1354,-20
45770959588,45770959591,3,1557,1531,-20
45771650345,45771650347,2,2197,1431,-20
45771729509,45771729521,12,2073,1163,-20
45772234645,45772234646,1,2154,1273,-20
45776855906,45776855911,5,1943,929,-20
45777125008,45777125013,5,1006,706,-20
45779427758,45779427762,4,1977,1455,-20
45782434983,45782434986,3,1306,746,-20
45784068452,45784068458,6,2245,1271,-20
45790647691,45790647693,2,1785,1769,-20
45792724453,45792724449,-4,1004,2348,-20
45795397671,45795397673,2,1437,1137,-20
45796527167,45796527171,4,1566,1361,-20
45800965723,45800965726,3,1740,1329,-20
45801064013,45801064009,-4,1456,2156,-20
45805637610,45805637616,6,1462,1122,-20
45808219177,45808219175,-2,24373,12564,-20
45809256062,45809256062,0,932,873,-20
45809566985,45809566988,3,1635,1286,-20
45810001364,45810001367,3,1195,1334,-20
45810246221,45810246226,5,5378,1878,-20
45810856022,45810856022,0,1247,948,-20
45811799837,45811799839,2,1920,788,-20
45813470413,45813470417,4,1647,1688,-20
45813868514,45813868519,5,1860,1776,-20
45815209907,45815209907,0,1391,2007,-20
45815979991,45815979994,3,2140,1380,-20
45817491091,45817491095,4,1954,1105,-20
45818630538,45818630541,3,2661,1505,-20
45826307199,45826307201,2,1005,774,-20
45828909240,45828909242,2,2145,1248,-20
45830590738,45830590741,3,1006,1132,-20
45840209102,45840209106,4,1539,1348,-20
45840922710,45840922714,4,1959,1129,-20
45843151013,45843151014,1,2572,1893,-20
45848011341,45848011344,3,1670,1267,-20
45848811956,45848811954,-2,1695,2421,-20
45849207086,45849207091,5,1639,1219,-20
45851722874,45851722877,3,1433,1001,-20
45853925880,45853925884,4,2728,1623,-20
45858609280,45858609283,3,2303,1473,-20
45864412658,45864412661,3,2881,1693,-20
45869666013,45869666018,5,1363,1301,-20
45870752377,45870752379,2,1994,1595,-20
45871303881,45871303886,5,1489,1297,-20
45872822230,45872822232,2,1686,1802,-20
45875906745,45875906747,2,1587,1114,-20
45877244983,45877244983,0,1214,1674,-20
45883430815,45883430818,3,1036,1041,-20
45885024741,45885024745,4,1785,1561,-20
45886981394,45886981398,4,1646,919,-20
45887698535,45887698537,2,730,179,-20
45889088184,45889088187,3,2185,1568,-20
45889150165,45889150167,2,2027,1160,-20
45890582998,45890582999,1,1653,1078,-20
45890785766,45890785766,0,2613,2753,-20
45891932737,45891932743,6,2073,1080,-20
45895748786,45895748787,1,1737,1655,-20
45896237794,45896237797,3,1967,1718,-20
45898208977,45898208983,6,5634,2610,-20
45899743042,45899743042,0,1542,1638,-20
45900472550,45900472533,-17,1604,1657,-20
45902539962,45902539966,4,1988,2033,-20
45906264026,45906264031,5,1529,1116,-20
45906792867,45906792871,4,920,938,-20
45907151610,45907151614,4,2491,1525,-20
45910994622,45910994628,6,2872,2093,-20
45912055317,45912055322,5,1637,1336,-20
45918663666,45918663668,2,1384,1797,-20
45919385011,45919385014,3,2305,1305,-20
45919537737,45919537742,5,13582,6253,-20
45919761243,45919761246,3,1565,1042,-20
45924722110,45924722105,-5,1856,5775,-20
45925811645,45925811650,5,1991,1433,-20
45926920752,45926920754,2,2106,1872,-20
45926979899,45926979903,4,1466,1390,-20
45927679226,45927679226,0,1447,1762,-20
45931115266,45931115269,3,1822,1694,-20
45935701050,45935701053,3,1460,1223,-20
45936126635,45936126638,3,1615,1603,-20
45936804092,45936804095,3,1270,1196,-20
45938157396,45938157380,-16,1623,1252,-20
45941540693,45941540695,2,1450,1070,-20
45941609559,45941609562,3,1742,1238,-20
45942602051,45942602053,2,1791,1710,-20
45946688445,45946688450,5,2426,1785,-20
45950437114,45950437118,4,1247,1137,-20
45953826441,45953826442,1,1306,1298,-20
45956071489,45956071491,2,1622,1542,-20
45959032261,45959032264,3,2237,1687,-20
45966072731,45966072730,-1,1019,1710,-20
45967106607,45967106610,3,1707,1267,-20
45969483662,45969483670,8,3133,1105,-20
45971334967,45971334972,5,2856,1680,-20
45976911223,45976911227,4,1576,1197,-20
45977307548,45977307550,2,1529,1271,-20
45982121450,45982121454,4,2084,1890,-20
45987917066,45987917069,3,2074,1562,-20
45993470874,45993470878,4,1293,1240,-20
45994892941,45994892946,5,1676,1731,-20
45999239279,45999239291,12,2092,1351,-20
46000488966,46000488969,3,1592,1643,-20
46003371819,46003371822,3,1273,1270,-20
46006753955,46006753959,4,1288,1193,-20
46007353144,46007353149,5,2191,1300,-20
46009591192,46009591196,4,2377,1693,-20
46010142691,46010142686,-5,1864,4580,-20
46010650018,46010650021,3,1470,1810,-20
46012684611,46012684614,3,1677,1440,-20
46023572727,46023572730,3,1558,965,-20
46024289365,46024289368,3,2285,1442,-20
46026399745,46026399748,3,1660,1223,-20
46033147274,46033147278,4,1455,1632,-20
46035012362,46035012363,1,1451,1706,-20
46036930355,46036930358,3,2076,1489,-20
46037505278,46037505282,4,2099,1896,-20
46037572695,46037572701,6,1937,996,-20
46043751405,46043751407,2,2195,1287,-20
46046160546,46046160546,0,662,1474,-20
46047064344,46047064346,2,1989,1691,-20
46048260039,46048260041,2,1687,1600,-20
46050284097,46050284101,4,1585,1362,-20
46051222139,46051222142,3,1844,1050,-20
46053352077,46053352081,4,2070,1258,-20
46055850006,46055850010,4,1665,1279,-20
46057144604,46057144607,3,2093,1870,-20
46057434326,46057434323,-3,861,2425,-20
46057827666,46057827668,2,2042,1519,-20
46060138599,46060138603,4,2100,1468,-20
46064569939,46064569942,3,1665,1255,-20
46065041202,46065041206,4,2418,1547,-20
46067875278,46067875281,3,1404,1211,-20
46070766777,46070766779,2,1145,1390,-20
46071430198,46071430202,4,2032,1584,-20
46074268057,46074268061,4,2016,1531,-20
46076311878,46076311882,4,1506,1507,-20
46078497737,46078497744,7,1379,587,-20
46080778638,46080778642,4,1389,1319,-20
46081494659,46081494642,-17,2207,1554,-20
46085971350,46085971356,6,3317,1964,-20
46086114787,46086114781,-6,1300,4582,-20
46086230686,46086230690,4,2260,2009,-20
46086984258,46086984259,1,1980,1926,-20
46087034577,46087034579,2,907,965,-20
46096657125,46096657125,0,1471,1504,-20
46096947499,46096947501,2,2181,1987,-20
46099869361,46099869366,5,1017,960,-20
46101695618,46101695622,4,1857,1346,-20
46109229472,46109229475,3,1703,1502,-20
46110903506,46110903510,4,1867,1590,-20
46111656057,46111656057,0,1554,2054,-20
46114039378,46114039380,2,2316,1635,-20
46115677378,46115677384,6,1652,1546,-20
46117757177,46117757180,3,1602,1164,-20
46117921633,46117921649,16,1768,1363,-20
46120169311,46120169314,3,1994,1921,-20
46120417087,46120417091,4,1070,1146,-20
46123040765,46123040768,3,2401,2433,-20
46125380921,46125380923,2,2069,1532,-20
46129551719,46129551713,-6,18719,10758,-20
46129774270,46129774274,4,1761,1900,-20
46132005289,46132005292,3,2588,2090,-20
46137004065,46137004070,5,2491,1510,-20
46137092494,46137092497,3,1282,1347,-20
46137982433,46137982433,0,2058,1330,-20
46138178537,46138178540,3,2023,1756,-20
46138536654,46138536660,6,1324,1058,-20
46139223748,46139223752,4,1347,1266,-20
46145055482,46145055486,4,2112,1382,-20
46147175888,46147175895,7,2349,1124,-20
46148027866,46148027871,5,1300,1177,-20
46149349165,46149349170,5,2057,1240,-20
46150981554,46150981558,4,1484,1357,-20
46152705674,46152705678,4,1737,1084,-20
46157513064,46157513067,3,1045,870,-20
46157896163,46157896166,3,1757,1323,-20
46159910913,46159910917,4,2215,1531,-20
46160047546,46160047549,3,1785,1283,-20
46163801937,46163801941,4,1961,1555,-20
46164940885,46164940885,0,1236,1791,-20
46166521533,46166521534,1,2067,2572,-20
46169197951,46169197953,2,1638,1064,-20
46170903287,46170903289,2,1346,1023,-20
46171449934,46171449934,0,1484,1666,-20
46172904305,46172904310,5,2348,1321,-20
46175413959,46175413962,3,1863,2443,-20
46175742447,46175742446,-1,1137,1333,-20
46176695893,46176695897,4,1730,1506,-20
46177642674,46177642674,0,1535,1704,-20
46178192566,46178192570,4,1666,1942,-20
46178335599,46178335602,3,2095,1058,-20
46181692259,46181692262,3,1842,1819,-20
46183204788,46183204791,3,2583,1885,-20
46184570425,46184570428,3,1497,1538,-20
46185225358,46185225360,2,1933,1244,-20
46185453377,46185453384,7,1503,1046,-20
46189299286,46189299289,3,2136,1505,-20
46198350291,46198350294,3,1831,1572,-20
46201196070,46201196075,5,1065,927,-20
46204309375,46204309380,5,1679,1095,-20
46205061977,46205061978,1,1381,1350,-20
46212568394,46212568397,3,1901,1727,-20
46215207126,46215207137,11,9568,41819,-20
46215279957,46215279961,4,1459,1442,-20
46215631257,46215631261,4,1764,1739,-20
46224201058,46224201060,2,2777,3020,-20
46227595194,46227595182,-12,946,693,-20
46231221049,46231221053,4,2217,1473,-20
46231664344,46231664340,-4,1661,4893,-20
46232637761,46232637764,3,1300,1844,-20
46235379134,46235379132,-2,1320,2051,-20
46240880530,46240880532,2,2680,1845,-20
46241619850,46241619854,4,2323,1603,-20
46243968031,46243968035,4,2282,1491,-20
46244517042,46244517045,3,2006,1793,-20
46248932327,46248932330,3,1257,1546,-20
46249585502,46249585501,-1,1817,1667,-20
46251257676,46251257681,5,2348,1400,-20
46251623103,46251623110,7,3960,1240,-20
46252543639,46252543641,2,2040,1463,-20
46253022957,46253022960,3,1779,1074,-20
46253327083,46253327067,-16,1214,881,-20
46256342850,46256342853,3,2090,1397,-20
46256403792,46256403794,2,1645,1761,-20
46264490173,46264490178,5,2498,1622,-20
46266623314,46266623318,4,2278,1823,-20
46266812027,46266812006,-21,1696,1122,-20
46267996547,46267996550,3,1490,1316,-20
46268457741,46268457743,2,1548,1222,-20
46271518166,46271518169,3,1909,1339,-20
46272964365,46272964370,5,2042,1242,-20
46274045017,46274045019,2,1903,1804,-20
46277021984,46277021986,2,2227,1505,-20
46281059587,46281059591,4,1613,982,-20
46281378978,46281378983,5,2698,1160,-20
46281930915,46281930917,2,2061,1524,-20
46284709185,46284709187,2,1088,1178,-20
46286912871,46286912875,4,1663,1498,-20
46287732349,46287732349,0,1127,1851,-20
46291055398,46291055402,4,1616,1129,-20
46293890333,46293890337,4,2053,813,-20
46295770485,46295770487,2,2444,2340,-20
46296469906,46296469906,0,2768,3040,-20
46296946617,46296946620,3,2191,1833,-20
46297239397,46297239386,-11,1684,1424,-20
46298765887,46298765889,2,1057,904,-20
46299020406,46299020411,5,1356,1470,-20
46308107313,46308107315,2,1778,1047,-20
46309036874,46309036877,3,1843,1407,-20
46309912746,46309912749,3,2234,1733,-20
46310145785,46310145788,3,1853,1671,-20
46310724593,46310724594,1,1593,1332,-20
46314727698,46314727702,4,2415,1681,-20
46315838825,46315838829,4,1996,1593,-20
46318686269,46318686264,-5,1612,4420,-20
46321524138,46321524142,4,2675,1606,-20
46324757002,46324757009,7,3249,1324,-20
46328536535,46328536538,3,2221,1768,-20
46331933126,46331933131,5,1984,1082,-20
46334346533,46334346535,2,1510,1524,-20
46335107535,46335107538,3,979,865,-20
46335222376,46335222381,5,2487,1840,-20
46335976845,46335976846,1,1469,1981,-20
46338950716,46338950721,5,1577,994,-20
46347200217,46347200221,4,1974,1142,-20
46347858584,46347858589,5,1512,824,-20
46356530351,46356530353,2,2648,1653,-20
46356832602,46356832606,4,1637,982,-20
46360633961,46360633964,3,2672,1880,-20
46361730090,46361730095,5,1925,1364,-20
46363178124,46363178130,6,1047,1035,-20
46368653022,46368653026,4,1886,1534,-20
46369561672,46369561688,16,1677,1268,-20
46370467678,46370467682,4,1389,1488,-20
46370504197,46370504201,4,1549,1263,-20
46374031877,46374031880,3,946,1420,-20
46375783694,46375783692,-2,2165,4019,-20
46376047386,46376047389,3,1408,1242,-20
46379167137,46379167140,3,2171,1177,-20
46386457099,46386457102,3,1418,1161,-20
46390469423,46390469425,2,1947,1103,-20
46391193306,46391193309,3,1847,1380,-20
46392735053,46392735063,10,14872,39830,-20
46394894170,46394894176,6,1238,1091,-20
46395498557,46395498570,13,1612,1158,-20
46402085970,46402085975,5,1662,1156,-20
46402266093,46402266100,7,1096,1283,-20
46402884774,46402884794,20,2014,1566,-20
46409687238,46409687242,4,1507,1388,-20
46412610045,46412610050,5,1873,1309,-20
46418268424,46418268426,2,1545,1747,-20
46423843510,46423843513,3,1897,1073,-20
46425210481,46425210485,4,1549,1254,-20
46426125569,46426125573,4,1210,995,-20
46428348233,46428348223,-10,870,9108,-20
46433496327,46433496330,3,2971,1958,-20
46437616930,46437616935,5,1556,1278,-20
46438462018,46438462019,1,1192,1215,-20
46438946047,46438946050,3,1064,623,-20
46440809626,46440809631,5,2326,1237,-20
46442012487,46442012481,-6,810,2326,-20
46446800847,46446800850,3,1148,900,-20
46447101370,46447101371,1,1606,1023,-20
46447916632,46447916638,6,1666,1348,-20
46448203984,46448203987,3,1839,1369,-20
46449519882,46449519866,-16,2746,1526,-20
46451618186,46451618190,4,1173,867,-20
46452090068,46452090072,4,1562,1246,-20
46452941338,46452941341,3,1744,1317,-20
46453496286,46453496290,4,1548,921,-20
46453655022,46453655001,-21,1208,399,-20
46459535425,46459535428,3,1250,944,-20
46463429329,46463429331,2,1504,1199,-20
46467494655,46467494659,4,2052,1058,-20
46469670426,46469670428,2,2108,1771,-20
46470498190,46470498194,4,1747,1005,-20
46470903599,46470903578,-21,918,482,-20
46473153036,46473153039,3,1941,1436,-20
46477187115,46477187099,-16,1162,815,-20
46478646473,46478646474,1,1282,1634,-20
46483365008,46483365015,7,2470,1310,-20
46483592298,46483592301,3,935,740,-20
46484941029,46484941033,4,1519,1457,-20
46485311583,46485311587,4,1702,1619,-20
46487282460,46487282462,2,2039,1264,-20
46490185650,46490185654,4,1869,1091,-20
46491930955,46491930958,3,1844,1331,-20
46503920408,46503920412,4,2243,1029,-20
46508719137,46508719140,3,1662,1245,-20
46508901754,46508901754,0,470,43,-20
46510002443,46510002447,4,1473,1207,-20
46510419293,46510419297,4,1789,1505,-20
46511539528,46511539529,1,850,1015,-20
46512587245,46512587249,4,2851,1077,-20
46514185242,46514185247,5,1006,907,-20
46514420807,46514420810,3,2218,1414,-20
46515030087,46515030090,3,1817,1432,-20
46526389086,46526389091,5,1849,1659,-20
46526714721,46526714722,1,2138,1529,-20
46530578688,46530578690,2,1707,667,-20
46532209483,46532209489,6,1825,1165,-20
46535773498,46535773502,4,1625,1539,-20
46539538926,46539538931,5,1466,979,-20
46541825942,46541825946,4,2808,1617,-20
46543778832,46543778834,2,2046,1628,-20
46544370450,46544370455,5,1496,1245,-20
46545775323,46545775327,4,1908,1559,-20
46547385417,46547385424,7,3136,1140,-20
46547865038,46547865016,-22,1694,1493,-20
46548358718,46548358724,6,1761,1510,-20
46551037820,46551037824,4,2089,1523,-20
46552035833,46552035838,5,2405,2326,-20
46552525206,46552525209,3,2019,1575,-20
46553448726,46553448728,2,1611,1430,-20
46556803203,46556803205,2,1961,1336,-20
46557136131,46557136117,-14,18878,16293,-20
46558827002,46558827006,4,1783,1157,-20
46559255525,46559255527,2,1874,1226,-20
46560602253,46560602257,4,1530,1716,-20
46563905098,46563905102,4,1728,1335,-20
46567603034,46567603038,4,2111,1422,-20
46570042890,46570042895,5,1225,1298,-20
46575813445,46575813447,2,2303,1384,-20
46577205718,46577205721,3,1600,1591,-20
46578803226,46578803231,5,1951,1241,-20
46579878196,46579878200,4,1830,1404,-20
46581627830,46581627835,5,1532,1132,-20
46583159716,46583159718,2,1356,1144,-20
46583545900,46583545903,3,1555,1410,-20
46585371367,46585371370,3,1908,1496,-20
46587833715,46587833719,4,1831,1455,-20
46589558685,46589558689,4,1765,906,-20
46591130977,46591130979,2,1699,1347,-20
46591560755,46591560759,4,2044,1531,-20
46596212714,46596212718,4,1856,1141,-20
46596878554,46596878554,0,668,1078,-20
46603840878,46603840880,2,1570,1387,-20
46604997947,46604997951,4,1712,1140,-20
46606981129,46606981130,1,1594,1622,-20
46607610425,46607610428,3,1833,1502,-20
46615165892,46615165895,3,1998,1642,-20
46617377705,46617377707,2,2095,1038,-20
46623504396,46623504399,3,1837,1462,-20
46624489411,46624489414,3,982,1005,-20
46625754914,46625754917,3,2413,1040,-20
46626736501,46626736501,0,1300,1046,-20
46629317531,46629317534,3,2087,1569,-20
46630249507,46630249513,6,2332,1885,-20
46631891692,46631891694,2,2125,1291,-20
46633935107,46633935112,5,1470,1221,-20
46637465992,46637465995,3,1559,1230,-20
46638084113,46638084114,1,1172,1039,-20
46640434247,46640434251,4,1804,966,-20
46643862923,46643862921,-2,2263,3953,-20
46645151728,46645151731,3,1153,1456,-20
46648171328,46648171331,3,1930,1486,-20
46651207399,46651207403,4,1514,1254,-20
46652707510,46652707512,2,1621,2687,-20
46653339286,46653339290,4,1790,1462,-20
46656225792,46656225796,4,1863,1622,-20
46665923265,46665923266,1,36418,38420,-20
46670894235,46670894232,-3,1091,2803,-20
46673179939,46673179941,2,2242,2096,-20
46678095745,46678095747,2,1367,1229,-20
46678632954,46678632961,7,10586,35042,-20
46679852951,46679852954,3,968,910,-20
46681767071,46681767069,-2,690,1174,-20
46682195113,46682195118,5,2247,1948,-20
46688906091,46688906094,3,1779,1406,-20
46689252706,46689252708,2,2032,1693,-20
46689901542,46689901546,4,1276,1227,-20
46691344300,46691344304,4,1836,1520,-20
46692729461,46692729463,2,2023,893,-20
46693284278,46693284279,1,1817,1619,-20
46694181762,46694181766,4,1612,1189,-20
46701491510,46701491514,4,2040,808,-20
46702166006,46702166010,4,2353,1355,-20
46702513156,46702513158,2,2581,1867,-20
46704007192,46704007196,4,1875,1721,-20
46705676711,46705676716,5,1357,1237,-20
46709265214,46709265217,3,1377,1188,-20
46709531268,46709531281,13,1622,1566,-20
46714174326,46714174304,-22,2163,1530,-20
46715102004,46715102008,4,2123,1848,-20
46715194645,46715194651,6,2438,1515,-20
46715999884,46715999886,2,1589,906,-20
46723567078,46723567083,5,1487,1219,-20
46729012185,46729012189,4,1951,1599,-20
46730732542,46730732546,4,1662,1272,-20
46732441928,46732441930,2,1606,1307,-20
46735243162,46735243162,0,888,695,-20
46741134186,46741134188,2,1976,1236,-20
46743425270,46743425274,4,2708,1955,-20
46743616462,46743616466,4,1915,1615,-20
46744771670,46744771672,2,1394,1092,-20
46745047898,46745047899,1,1894,1412,-20
46749272346,46749272350,4,2111,1365,-20
46753020649,46753020653,4,1532,719,-20
46753356431,46753356433,2,959,1153,-20
46758780309,46758780314,5,1393,905,-20
46759326076,46759326079,3,2295,1078,-20
46759793266,46759793270,4,2075,2313,-20
46762792106,46762792107,1,1402,1385,-20
46765317210,46765317214,4,2246,1513,-20
46768882759,46768882761,2,2173,1386,-20
46773125550,46773125554,4,1955,1496,-20
46776193130,46776193134,4,1844,1697,-20
46777951233,46777951234,1,1190,1369,-20
46780966481,46780966485,4,1886,1477,-20
46781311025,46781311029,4,1215,928,-20
46782073895,46782073891,-4,1048,2578,-20
46785669311,46785669307,-4,1862,4486,-20
46787204350,46787204350,0,1253,1163,-20
46788186227,46788186230,3,2194,1203,-20
46789969677,46789969681,4,1518,1276,-20
46792483702,46792483705,3,1801,1794,-20
46792913710,46792913711,1,2772,1244,-20
46796951778,46796951781,3,2276,1405,-20
46797962522,46797962526,4,2161,1447,-20
46798647634,46798647635,1,1361,1108,-20
46799228478,46799228483,5,1423,954,-20
46800059289,46800059283,-6,2285,5367,-20
46802023923,46802023932,9,1738,1151,-20
46802494550,46802494553,3,1794,1292,-20
46803483471,46803483474,3,2033,2258,-20
46805636224,46805636227,3,1538,1637,-20
46808017167,46808017158,-9,679,4607,-20
46810510421,46810510424,3,2168,1236,-20
46811870718,46811870720,2,2478,1941,-20
46815553908,46815553912,4,1204,1657,-20
46816183417,46816183419,2,1780,1161,-20
46817160770,46817160774,4,2054,1660,-20
46822431525,46822431524,-1,1568,1547,-20
46831998228,46831998218,-10,1081,686,-20
46832671757,46832671763,6,3113,1345,-20
46833819264,46833819268,4,2059,1560,-20
46836744817,46836744820,3,1866,1583,-20
46838609881,46838609885,4,1609,1455,-20
46838860667,46838860670,3,1021,1667,-20
46841327434,46841327436,2,1705,1659,-20
46845924382,46845924386,4,1762,1093,-20
46846158966,46846158970,4,3003,1699,-20
46847062029,46847062034,5,2440,1520,-20
46847101355,46847101370,15,1272,1252,-20
46848258243,46848258241,-2,1798,2935,-20
46852000301,46852000306,5,2814,1889,-20
46852296950,46852296954,4,1407,847,-20
46854148696,46854148701,5,2530,1279,-20
46854765392,46854765377,-15,3009,1142,-20
46858540028,46858540030,2,2064,1338,-20
46859409479,46859409483,4,1644,1054,-20
46863699906,46863699909,3,1535,1445,-20
46864870962,46864870965,3,1308,1581,-20
46866869275,46866869275,0,1520,2093,-20
46869035073,46869035079,6,1673,1880,-20
46870931270,46870931271,1,2872,3320,-20
46872312785,46872312786,1,1799,1287,-20
46873470336,46873470339,3,1898,1438,-20
46875363905,46875363910,5,1640,1115,-20
46876381154,46876381158,4,1218,870,-20
46877875137,46877875138,1,1052,1035,-20
46878457446,46878457450,4,1682,1209,-20
46878958719,46878958722,3,1758,1235,-20
46879812906,46879812906,0,1646,1631,-20
46880438593,46880438596,3,2169,1491,-20
46884550322,46884550326,4,1469,1098,-20
46893925150,46893925153,3,2155,1345,-20
46896446574,46896446576,2,2281,1311,-20
46897354358,46897354362,4,1973,1713,-20
46899632765,46899632769,4,1651,1186,-20
46901006013,46901006020,7,13777,21146,-20
46902878594,46902878595,1,928,697,-20
46906149191,46906149193,2,1807,1615,-20
46911949198,46911949201,3,2289,1580,-20
46913276970,46913276974,4,1255,969,-20
46917508609,46917508613,4,1660,1299,-20
46917805811,46917805815,4,1721,1118,-20
46925423714,46925423715,1,1476,1340,-20
46927465052,46927465058,6,1569,1251,-20
46928361914,46928361918,4,1312,984,-20
46931755287,46931755291,4,1872,1406,-20
46933945428,46933945430,2,1705,1519,-20
46935439018,46935439019,1,1590,1176,-20
46936927006,46936927007,1,8799,10745,-20
46937419381,46937419377,-4,929,3656,-20
46946459433,46946459437,4,2015,1492,-20
46949267847,46949267850,3,1871,1851,-20
46952451023,46952451026,3,1219,1153,-20
46961313895,46961313900,5,1695,1757,-20
46962579095,46962579074,-21,1902,1262,-20
46963647894,46963647897,3,1855,1640,-20
46967238443,46967238449,6,2135,1295,-20
46971001422,46971001427,5,2651,1829,-20
46971338585,46971338587,2,1099,1528,-20
46973135669,46973135671,2,1460,1258,-20
46973345863,46973345865,2,1204,851,-20
46974700241,46974700243,2,2226,1005,-20
46976854609,46976854610,1,1400,1388,-20
46977931374,46977931377,3,2200,1418,-20
46978240406,46978240402,-4,1462,2198,-20
46979304597,46979304602,5,1930,1193,-20
46981676474,46981676479,5,1656,1186,-20
46981710058,46981710062,4,1171,901,-20
46984840763,46984840767,4,2127,1376,-20
46984928424,46984928435,11,2105,1556,-20
46985219211,46985219195,-16,4009,1282,-20
46986587554,46986587558,4,3794,2688,-20
46988667313,46988667314,1,1370,1095,-20
46990435423,46990435426,3,1681,1436,-20
46992567000,46992567002,2,1767,2063,-20
46994215181,46994215182,1,2045,1367,-20
46997912314,46997912317,3,1317,1285,-20
47001706333,47001706338,5,1776,1303,-20
47003653482,47003653482,0,1316,1575,-20
47007307790,47007307791,1,1743,1862,-20
47007618427,47007618430,3,2012,987,-20
47008904342,47008904346,4,949,866,-20
47009796831,47009796834,3,981,1120,-20
47010862609,47010862613,4,1764,1219,-20
47011424626,47011424626,0,1583,1204,-20
47014496879,47014496877,-2,1425,1999,-20
47015011419,47015011423,4,1936,1181,-20
47018208352,47018208357,5,2050,1454,-20
47018544014,47018544017,3,1844,1569,-20
47019512700,47019512682,-18,1129,717,-20
47020015142,47020015147,5,2391,1546,-20
47020128370,47020128374,4,2441,1851,-20
47021512250,47021512252,2,1218,1666,-20
47025686274,47025686278,4,1552,1331,-20
47029962965,47029962966,1,1848,2094,-20
47032244286,47032244290,4,1363,1218,-20
47039583160,47039583163,3,1800,1002,-20
47046086304,47046086313,9,2815,948,-20
47047058358,47047058339,-19,1702,1153,-20
47048543189,47048543193,4,2671,2256,-20
47050445145,47050445150,5,3290,1342,-20
47051137059,47051137063,4,2247,1591,-20
47054572857,47054572859,2,927,827,-20
47058739606,47058739605,-1,1793,1830,-20
47061249003,47061249005,2,1165,823,-20
47064652194,47064652198,4,1762,1715,-20
47068920092,47068920094,2,2412,1034,-20
47069214575,47069214564,-11,33700,16921,-20
47072353822,47072353827,5,1165,981,-20
47072718367,47072718370,3,1493,1179,-20
47074422479,47074422478,-1,645,1371,-20
47076128908,47076128912,4,1889,1327,-20
47077276446,47077276453,7,3117,1172,-20
47088389121,47088389122,1,2734,1603,-20
47088845163,47088845165,2,1784,1600,-20
47093387664,47093387667,3,1673,1251,-20
47096026860,47096026863,3,1537,1233,-20
47097240753,47097240758,5,2668,1217,-20
47099342869,47099342875,6,2436,1370,-20
47100392534,47100392536,2,1232,1379,-20
47100870486,47100870490,4,1833,1360,-20
47101097018,47101097024,6,1057,472,-20
47101271531,47101271536,5,1755,1547,-20
47104023233,47104023236,3,2367,1558,-20
47104504570,47104504553,-17,1793,1498,-20
47106907653,47106907656,3,1766,1746,-20
47110176182,47110176185,3,1343,1219,-20
47110915271,47110915273,2,1810,1691,-20
47112016069,47112016073,4,861,837,-20
47114304415,47114304419,4,2220,2081,-20
47117094283,47117094287,4,1274,1384,-20
47119179071,47119179073,2,1347,979,-20
47122243831,47122243835,4,1955,1167,-20
47124900365,47124900370,5,1436,1472,-20
47125836330,47125836334,4,1496,1140,-20
47126920725,47126920730,5,2525,1744,-20
47129726917,47129726919,2,1346,1060,-20
47130102068,47130102070,2,1611,1370,-20
47130872349,47130872351,2,2095,2041,-20
47132050872,47132050875,3,1173,855,-20
47134603477,47134603456,-21,1089,1944,-20
47135833372,47135833354,-18,1961,1478,-20
47138698914,47138698915,1,1193,1534,-20
47138839209,47138839213,4,1968,1419,-20
47142092349,47142092354,5,2503,1341,-20
47142397587,47142397588,1,1524,2518,-20
47149652178,47149652181,3,1840,1169,-20
47150794762,47150794765,3,1454,1605,-20
47151576852,47151576855,3,1842,2071,-20
47152786062,47152786066,4,2012,1404,-20
47158270414,47158270415,1,1609,1361,-20
47167542408,47167542413,5,2118,1507,-20
47170722440,47170722435,-5,1302,3448,-20
47172693946,47172693950,4,2159,1299,-20
47173608072,47173608077,5,1740,1604,-20
47175930221,47175930224,3,1607,1448,-20
47179111432,47179111435,3,1244,935,-20
47180226779,47180226782,3,1766,1624,-20
47180579611,47180579611,0,1458,1493,-20
47182870139,47182870142,3,2261,967,-20
47184510379,47184510383,4,1364,962,-20
47185459470,47185459475,5,1483,760,-20
47187320645,47187320650,5,1926,1100,-20
47188971171,47188971175,4,975,957,-20
47189686410,47189686414,4,2180,1285,-20
47191226250,47191226253,3,1147,958,-20
47192668918,47192668922,4,1859,1146,-20
47193787794,47193787798,4,985,949,-20
47194959973,47194959979,6,1903,1052,-20
47198677848,47198677851,3,2765,1581,-20
47204900316,47204900319,3,1676,1371,-20
47205222535,47205222515,-20,2157,1632,-20
47205328790,47205328794,4,1798,1391,-20
47208290322,47208290326,4,2850,2027,-20
47210546246,47210546249,3,1652,1307,-20
47215665082,47215665085,3,1665,1119,-20
47215930534,47215930537,3,2070,927,-20
47216900243,47216900251,8,4482,1583,-20
47217459914,47217459918,4,1573,1344,-20
47217969469,47217969472,3,2084,1936,-20
47218904887,47218904892,5,2019,1342,-20
47219663525,47219663525,0,12304,14688,-20
47226059510,47226059503,-7,1229,4752,-20
47227195777,47227195780,3,1964,1299,-20
47231113582,47231113586,4,2142,1451,-20
47233239003,47233239007,4,1610,1925,-20
47236018433,47236018437,4,2271,1217,-20
47236331246,47236331226,-20,2311,2044,-20
47239197694,47239197690,-4,1435,2393,-20
47240394517,47240394518,1,2252,2995,-20
47240695884,47240695890,6,1772,1060,-20
47242646217,47242646218,1,1742,1435,-20
47243729558,47243729562,4,2695,2323,-20
47244652793,47244652797,4,1655,1848,-20
47245484934,47245484936,2,1298,1132,-20
47248070362,47248070365,3,1746,622,-20
47251817340,47251817345,5,1954,1802,-20
47253725646,47253725652,6,2121,1576,-20
47260419923,47260419926,3,1818,1290,-20
47265663394,47265663394,0,1283,1454,-20
47266674430,47266674429,-1,1642,1381,-20
47267655266,47267655270,4,2101,1266,-20
47267980545,47267980549,4,2774,1599,-20
47268166255,47268166258,3,1898,1689,-20
47269895756,47269895757,1,1362,1275,-20
47276611649,47276611653,4,2744,1616,-20
47277786363,47277786366,3,1394,1360,-20
47278640167,47278640168,1,1195,1103,-20
47282485322,47282485324,2,1389,1296,-20
47287027571,47287027574,3,2026,1127,-20
47287361458,47287361463,5,2108,1538,-20
47288021545,47288021548,3,2603,1713,-20
47288525810,47288525818,8,1485,557,-20
47288726215,47288726193,-22,1073,501,-20
47289428201,47289428202,1,1201,1059,-20
47293588511,47293588514,3,1904,1576,-20
47304137141,47304137142,1,2646,3576,-20
47308771070,47308771068,-2,1056,2273,-20
47309613391,47309613398,7,2248,1288,-20
47316411559,47316411562,3,1986,1448,-20
47317247717,47317247697,-20,1110,545,-20
47322614792,47322614794,2,2057,1475,-20
47325016325,47325016329,4,1542,1128,-20
47326229270,47326229274,4,3392,2265,-20
47329369385,47329369390,5,2181,1068,-20
47333970879,47333970880,1,1485,2314,-20
47335152327,47335152330,3,1488,1820,-20
47335367816,47335367823,7,2673,1042,-20
47341085706,47341085709,3,1715,1524,-20
47343012898,47343012902,4,2014,1443,-20
47344112607,47344112609,2,1786,1065,-20
47345172810,47345172817,7,1715,975,-20
47346085342,47346085344,2,1734,1237,-20
47347516917,47347516919,2,1972,1248,-20
47349676087,47349676091,4,1585,1846,-20
47354804690,47354804695,5,1053,1268,-20
47357225478,47357225479,1,1374,1246,-20
47357722405,47357722406,1,2148,1271,-20
47358693386,47358693391,5,2040,1361,-20
47359190727,47359190729,2,1558,1431,-20
47359439473,47359439479,6,1860,1185,-20
47360924222,47360924232,10,1324,1029,-20
47362757251,47362757251,0,1888,1597,-20
47363944734,47363944738,4,1715,1233,-20
47368047593,47368047596,3,1223,1426,-20
47369822922,47369822903,-19,1531,1677,-20
47371239253,47371239255,2,1648,1553,-20
47373619851,47373619854,3,1568,835,-20
47375626718,47375626720,2,1887,1543,-20
47375976866,47375976867,1,2860,1860,-20
47376163757,47376163762,5,1808,1322,-20
47379125670,47379125671,1,1818,1054,-20
47383210613,47383210616,3,1999,1351,-20
47386374342,47386374346,4,2397,1642,-20
47387799978,47387799980,2,1718,1379,-20
47390251002,47390251005,3,1128,771,-20
47391828666,47391828670,4,1881,886,-20
47393625518,47393625523,5,1179,1461,-20
47393799503,47393799507,4,1622,1308,-20
47394424418,47394424421,3,1603,1572,-20
47394654895,47394654899,4,2057,1307,-20
47395942112,47395942114,2,1806,1368,-20
47396873636,47396873640,4,2983,1824,-20
47397014065,47397014067,2,1562,1380,-20
47397402372,47397402373,1,2255,1798,-20
47397794108,47397794111,3,2190,1439,-20
47401391002,47401391002,0,1305,1779,-20
47402977138,47402977143,5,2198,1056,-20
47405931154,47405931157,3,1462,1786,-20
47407610671,47407610674,3,2188,1610,-20
47409334938,47409334937,-1,1479,2580,-20
47410441409,47410441410,1,1748,1362,-20
47410495048,47410495042,-6,1105,1566,-20
47411246705,47411246707,2,1892,1572,-20
47411398916,47411398919,3,2317,1342,-20
47413759746,47413759741,-5,3191,9406,-20
47414035398,47414035403,5,1868,1203,-20
47416051085,47416051086,1,1840,939,-20
47416644437,47416644443,6,2353,1159,-20
47423116186,47423116189,3,1895,1372,-20
47426171682,47426171686,4,2108,1123,-20
47427919629,47427919617,-12,1359,1257,-20
47431185555,47431185560,5,2654,1624,-20
47435240592,47435240597,5,2757,1556,-20
47437913766,47437913770,4,1668,1779,-20
47438580831,47438580835,4,1484,1186,-20
47439933110,47439933111,1,1729,1680,-20
47442937822,47442937827,5,1818,1839,-20
47442979518,47442979520,2,2607,1830,-20
47445932530,47445932531,1,1667,2029,-20
47446309883,47446309879,-4,93,2240,-20
47446762549,47446762555,6,2240,1209,-20
47447899700,47447899706,6,36591,17385,-20
47450094680,47450094685,5,2102,1439,-20
47454500298,47454500301,3,1683,953,-20
47455993890,47455993895,5,1782,897,-20
47457904752,47457904755,3,1631,1602,-20
47458211614,47458211615,1,1439,1090,-20
47463819677,47463819682,5,1839,1495,-20
47464303958,47464303955,-3,912,2590,-20
47465590108,47465590111,3,2782,1064,-20
47468973810,47468973802,-8,1048,6363,-20
47469359226,47469359211,-15,1173,1546,-20
47470245695,47470245698,3,2847,1774,-20
47470726747,47470726742,-5,1780,5287,-20
47471440678,47471440683,5,945,915,-20
47474988559,47474988562,3,1189,824,-20
47476841738,47476841742,4,2303,1738,-20
47478232097,47478232100,3,1780,1513,-20
47479950150,47479950155,5,2124,1319,-20
47480776913,47480776910,-3,30426,15777,-20
47481131359,47481131363,4,2075,2132,-20
47489108363,47489108368,5,1969,1319,-20
47489736871,47489736878,7,1619,1265,-20
47491090218,47491090221,3,1320,938,-20
47492013659,47492013662,3,2906,1939,-20
47496001371,47496001374,3,1706,1113,-20
47498835550,47498835553,3,1696,1641,-20
47508531158,47508531162,4,1403,1296,-20
47511112569,47511112573,4,2869,1839,-20
47512059514,47512059519,5,2476,850,-20
47512431110,47512431113,3,1483,1580,-20
47519813111,47519813113,2,1181,1650,-20
47521304094,47521304079,-15,1616,892,-20
47522468292,47522468303,11,1245,963,-20
47522964666,47522964670,4,2167,1855,-20
47523684338,47523684343,5,1880,1165,-20
47523895743,47523895747,4,2510,1724,-20
47524594833,47524594835,2,1520,924,-20
47525401005,47525401010,5,2095,2072,-20
47525654143,47525654146,3,2302,1184,-20
47526640308,47526640311,3,1892,1035,-20
47527828607,47527828611,4,1946,2217,-20
47529219330,47529219334,4,1986,998,-20
47530992596,47530992599,3,1877,1391,-20
47532771491,47532771487,-4,1130,3081,-20
47532899921,47532899922,1,1725,958,-20
47533756877,47533756884,7,1825,1070,-20
47535047534,47535047539,5,1438,1180,-20
47536107950,47536107954,4,2198,1989,-20
47538091536,47538091540,4,1913,1853,-20
47542892691,47542892694,3,1458,2071,-20
47549935528,47549935534,6,2000,949,-20
47558669909,47558669910,1,1470,1256,-20
47572604708,47572604712,4,2044,1466,-20
47573750173,47573750175,2,1499,1393,-20
47573980074,47573980078,4,2596,1798,-20
47577969025,47577969027,2,2183,1597,-20
47578612614,47578612618,4,2015,1624,-20
47578640426,47578640434,8,1699,965,-20
47579101186,47579101191,5,2153,1462,-20
47579806922,47579806922,0,1941,1136,-20
47584885514,47584885518,4,2121,1378,-20
47585448465,47585448467,2,1486,1082,-20
47587814477,47587814479,2,1468,1133,-20
47588797698,47588797700,2,1363,1270,-20
47591131865,47591131870,5,1460,1341,-20
47592461809,47592461810,1,1767,1505,-20
47593082276,47593082279,3,2468,1362,-20
47593179147,47593179151,4,1851,1089,-20
47594860086,47594860082,-4,884,2739,-20
47596333219,47596333221,2,1352,1310,-20
47599696615,47599696629,14,1421,1277,-20
47599929566,47599929545,-21,2106,1594,-20
47603769204,47603769209,5,2120,1534,-20
47608650562,47608650547,-15,1751,843,-20
47608954566,47608954572,6,2159,1221,-20
47609751233,47609751226,-7,1027,1051,-20
47610096109,47610096110,1,17840,22613,-20
47610306573,47610306576,3,1589,966,-20
47613523166,47613523149,-17,1086,406,-20
47613572931,47613572931,0,1752,1422,-20
47619064061,47619064063,2,1195,1276,-20
47620295701,47620295697,-4,2478,6244,-20
47622419770,47622419774,4,798,1017,-20
47629601074,47629601078,4,2259,1082,-20
47631648297,47631648299,2,1404,1339,-20
47631896773,47631896775,2,1847,1284,-20
47633688703,47633688705,2,1092,987,-20
47634455315,47634455318,3,1603,1566,-20
47638601293,47638601296,3,1840,1616,-20
47641101558,47641101562,4,1261,1179,-20
47641892937,47641892922,-15,1609,1231,-20
47643311369,47643311370,1,1530,1415,-20
47646057906,47646057909,3,1208,1400,-20
47652385746,47652385751,5,1520,1600,-20
47653253834,47653253837,3,1091,1655,-20
47654302236,47654302239,3,2164,1022,-20
47654510965,47654510969,4,1671,1642,-20
47658199436,47658199440,4,2411,1329,-20
47658372987,47658372991,4,2190,1922,-20
47658535524,47658535531,7,2606,1472,-20
47662142735,47662142737,2,2553,1198,-20
47665269262,47665269255,-7,827,4434,-20
47665512381,47665512383,2,1738,1183,-20
47667142012,47667142010,-2,1121,2749,-20
47668245399,47668245396,-3,1351,3070,-20
47668554786,47668554790,4,971,1259,-20
47670258028,47670258029,1,1906,1437,-20
47670925182,47670925185,3,1649,1107,-20
47672824262,47672824266,4,1709,1063,-20
47674728514,47674728517,3,1493,1566,-20
47679050249,47679050253,4,1421,1566,-20
47680817101,47680817106,5,4905,2455,-20
47683373491,47683373486,-5,1838,5003,-20
47683699155,47683699159,4,1647,1170,-20
47683866278,47683866278,0,1172,1492,-20
47684013000,47684013002,2,1286,1586,-20
47688048082,47688048082,0,1237,1426,-20
47688222496,47688222497,1,1860,1523,-20
47688690172,47688690175,3,1467,1448,-20
47694508647,47694508650,3,1663,1408,-20
47695599059,47695599062,3,1708,1484,-20
47697261990,47697261994,4,1679,923,-20
47697945011,47697945011,0,1362,2360,-20
47699979755,47699979756,1,1461,1528,-20
47701803503,47701803509,6,1374,1063,-20
47704632783,47704632786,3,1193,1143,-20
47710208242,47710208246,4,1391,1510,-20
47713363657,47713363662,5,1576,1306,-20
47716688718,47716688738,20,1054,1317,-20
47717252371,47717252374,3,2630,1129,-20
47719662034,47719662035,1,2315,1587,-20
47720640617,47720640624,7,1682,1514,-20
47722603006,47722602988,-18,2075,1546,-20
47723610037,47723610039,2,1748,1569,-20
47725224149,47725224153,4,1632,1132,-20
47728250269,47728250273,4,2850,1709,-20
47728307910,47728307912,2,1619,1506,-20
47729080945,47729080947,2,1382,929,-20
47729812459,47729812463,4,1756,1719,-20
47731172073,47731172076,3,2200,1694,-20
47731738403,47731738406,3,1431,1241,-20
47735095630,47735095623,-7,1948,1770,-20
47736446785,47736446787,2,1530,1500,-20
47741687250,47741687246,-4,1246,972,-20
47743469687,47743469691,4,1791,862,-20
47747585662,47747585664,2,1896,1410,-20
47747870602,47747870617,15,2092,1465,-20
47749628017,47749628019,2,2789,1925,-20
47750292463,47750292467,4,1426,1151,-20
47751884798,47751884799,1,1496,883,-20
47754787969,47754787962,-7,916,4016,-20
47754902714,47754902721,7,4181,1190,-20
47756204630,47756204631,1,981,1149,-20
47759823638,47759823640,2,1371,1748,-20
47762830469,47762830473,4,1198,1144,-20
47768233734,47768233739,5,1184,837,-20
47769601083,47769601085,2,2709,1998,-20
47772003676,47772003698,22,1641,1237,-20
47775575889,47775575893,4,2009,1617,-20
47778475827,47778475829,2,1981,1572,-20
47778751565,47778751568,3,2046,1652,-20
47781935478,47781935483,5,2687,2080,-20
47782457153,47782457157,4,1574,1445,-20
47788827966,47788827968,2,1222,1371,-20
47793978577,47793978581,4,1748,1700,-20
47794095037,47794095039,2,1940,1681,-20
47797710822,47797710826,4,1636,900,-20
47798528782,47798528786,4,1912,925,-20
47800659617,47800659621,4,1656,1838,-20
47802313268,47802313271,3,1790,1951,-20
47804153302,47804153304,2,1974,1328,-20
47810865906,47810865909,3,2208,1321,-20
47812205870,47812205848,-22,1127,1130,-20
47814780710,47814780715,5,2034,1240,-20
47817174422,47817174426,4,1381,1016,-20
47817528721,47817528724,3,1742,1165,-20
47817762271,47817762273,2,1665,1095,-20
47818491550,47818491552,2,2202,1319,-20
47818684946,47818684946,0,1994,1424,-20
47821496871,47821496875,4,1919,927,-20
47822097894,47822097907,13,2161,1815,-20
47824535211,47824535215,4,2457,1252,-20
47825733541,47825733546,5,1918,1379,-20
47826630785,47826630789,4,2229,1910,-20
47827375817,47827375820,3,1607,1172,-20
47830301482,47830301485,3,2744,1756,-20
47833252711,47833252714,3,1918,1779,-20
47835345001,47835345003,2,1539,1872,-20
47837176028,47837176033,5,1363,1002,-20
47837638063,47837638063,0,1636,1045,-20
47838004203,47838004201,-2,904,2570,-20
47838104946,47838104951,5,2516,2117,-20
47838197467,47838197471,4,2172,1590,-20
47840401226,47840401228,2,1430,1583,-20
47842061093,47842061098,5,2769,1575,-20
47843025384,47843025390,6,1344,1193,-20
47846782978,47846782982,4,1763,1154,-20
47847726546,47847726551,5,1992,1288,-20
47849912502,47849912505,3,1389,1428,-20
47852274250,47852274257,7,2626,1831,-20
47853091032,47853091037,5,2505,1618,-20
47853461478,47853461478,0,1824,1651,-20
47856783715,47856783719,4,2384,1224,-20
47857245406,47857245411,5,1079,1518,-20
47866719537,47866719542,5,1200,832,-20
47869227183,47869227189,6,2089,1601,-20
47870467365,47870467358,-7,1532,6581,-20
47871805171,47871805173,2,1971,1292,-20
47876415899,47876415904,5,1535,1546,-20
47877947806,47877947811,5,2269,1425,-20
47878924294,47878924294,0,1981,1655,-20
47882400037,47882400039,2,1305,1341,-20
47889876042,47889876046,4,1926,1409,-20
47890446216,47890446220,4,1920,1582,-20
47891133697,47891133682,-15,1363,1385,-20
47892362132,47892362134,2,1582,1039,-20
47892890482,47892890485,3,2553,1418,-20
47896129594,47896129598,4,1898,1501,-20
47896370983,47896370987,4,2146,1662,-20
47898535034,47898535039,5,1989,1941,-20
47901660899,47901660903,4,3209,1892,-20
47902051227,47902051230,3,1370,1474,-20
47905764254,47905764254,0,2100,2388,-20
47908512234,47908512217,-17,1150,672,-20
47911464550,47911464555,5,1339,1110,-20
47913672652,47913672673,21,828,347,-20
47914805341,47914805342,1,1496,1218,-20
47915912039,47915912043,4,2132,1336,-20
47922541451,47922541458,7,2737,56421,-20
47922748534,47922748539,5,2782,1197,-20
47923113307,47923113309,2,1620,1362,-20
47923445650,47923445655,5,1608,1386,-20
47928574371,47928574374,3,2170,1676,-20
47929779412,47929779417,5,2127,1729,-20
47932387220,47932387222,2,1557,2093,-20
47935230765,47935230771,6,1239,1366,-20
47937151047,47937151050,3,1858,1312,-20
47940772064,47940772067,3,1827,1737,-20
47941820679,47941820685,6,3894,1474,-20
47946378754,47946378757,3,2003,2274,-20
47947134518,47947134522,4,1342,682,-20
47950158108,47950158113,5,1847,1205,-20
47951374562,47951374566,4,1256,1260,-20
47952873076,47952873077,1,1180,1376,-20
47953381422,47953381423,1,1545,1418,-20
47956183497,47956183502,5,1978,1193,-20
47961788590,47961788595,5,1646,1124,-20
47963853958,47963853961,3,1558,1281,-20
47964792266,47964792266,0,1069,1167,-20
47967840425,47967840430,5,2083,1162,-20
47970994494,47970994500,6,2239,891,-20
47974625161,47974625163,2,2102,1640,-20
47975246397,47975246399,2,1381,1731,-20
47981201224,47981201226,2,2309,1754,-20
47984074092,47984074095,3,1315,1534,-20
47984204721,47984204719,-2,2069,1844,-20
47986252410,47986252411,1,1408,1457,-20
47988122291,47988122297,6,2111,1470,-20
47990879798,47990879802,4,1261,1714,-20
47993160738,47993160741,3,1548,875,-20
47996614397,47996614400,3,1868,1248,-20
47998393106,47998393102,-4,1349,2444,-20
48001439712,48001439710,-2,1099,2474,-20
48002785801,48002785804,3,1978,2098,-20
48004491387,48004491393,6,2165,1679,-20
48005224420,48005224423,3,1885,1493,-20
48006312761,48006312762,1,1880,1679,-20
48007447991,48007447996,5,2131,1427,-20
48007838559,48007838566,7,2626,1546,-20
48013815453,48013815458,5,1740,1420,-20
48019441087,48019441091,4,1392,1624,-20
48020816015,48020816019,4,2084,1358,-20
48021469817,48021469818,1,972,1147,-20
48024072217,48024072222,5,1495,1077,-20
48025289877,48025289882,5,9370,31837,-20
48025953994,48025953999,5,2311,1484,-20
48026623138,48026623137,-1,1488,1719,-20
48032579569,48032579572,3,1833,1163,-20
48034194138,48034194145,7,1453,1193,-20
48035111850,48035111851,1,1627,1866,-20
48035727291,48035727293,2,1349,1619,-20
48035949385,48035949387,2,2016,1258,-20
48040784446,48040784447,1,2080,1400,-20
48041779591,48041779593,2,1484,1063,-20
48047444031,48047444033,2,2345,2190,-20
48047712633,48047712638,5,2049,1704,-20
48047756098,48047756103,5,1635,1397,-20
48053102052,48053102054,2,2277,1588,-20
48053700102,48053700105,3,1232,944,-20
48054955998,48054956000,2,1422,1389,-20
48057851084,48057851089,5,1992,1423,-20
48059420132,48059420130,-2,1171,2803,-20
48061361838,48061361842,4,1608,1065,-20
48064298546,48064298549,3,2708,1933,-20
48064763619,48064763620,1,2065,1229,-20
48066039733,48066039735,2,1627,1233,-20
48067013147,48067013151,4,1261,1302,-20
48068735096,48068735098,2,1894,1862,-20
48069278455,48069278459,4,2081,1063,-20
48070644709,48070644713,4,1265,1548,-20
48070817815,48070817824,9,1530,1518,-20
48071146764,48071146767,3,1823,921,-20
48072031323,48072031323,0,1898,1925,-20
48075473167,48075473171,4,2429,1703,-20
48075719748,48075719746,-2,2049,1909,-20
48077731035,48077731039,4,1755,1594,-20
48078529020,48078529024,4,1387,1266,-20
48080854482,48080854485,3,1759,1854,-20
48082013986,48082013991,5,1486,1207,-20
48082227997,48082228000,3,2025,1334,-20
48083241204,48083241209,5,2257,1902,-20
48083631157,48083631163,6,1133,943,-20
48086734227,48086734227,0,1732,1388,-20
48090648166,48090648172,6,7548,5657,-20
48091091441,48091091444,3,2130,1512,-20
48092028243,48092028246,3,1631,1168,-20
48092249909,48092249930,21,853,1143,-20
48093654143,48093654139,-4,1715,3775,-20
48100715722,48100715725,3,2219,1284,-20
48105910133,48105910135,2,1644,1275,-20
48107150558,48107150561,3,2948,1449,-20
48109228707,48109228711,4,2230,1406,-20
48110391487,48110391490,3,1043,1168,-20
48112123515,48112123520,5,1870,1071,-20
48112496383,48112496385,2,2137,1114,-20
48113455287,48113455285,-2,1748,1322,-20
48118245534,48118245537,3,1572,887,-20
48120501371,48120501375,4,2361,1760,-20
48120645466,48120645468,2,1700,1392,-20
48120876616,48120876620,4,2140,1367,-20
48122850346,48122850346,0,1698,998,-20
48125241022,48125241028,6,2891,1641,-20
48126434638,48126434630,-8,1005,12422,-20
48131081942,48131081945,3,2734,1395,-20
48138100439,48138100442,3,1503,1470,-20
48138389772,48138389775,3,1752,1126,-20
48139245223,48139245226,3,2580,2032,-20
48140205384,48140205386,2,1633,1782,-20
48141176924,48141176928,4,1553,1572,-20
48142744737,48142744742,5,1103,1252,-20
48144178276,48144178279,3,1609,1781,-20
48149927042,48149927039,-3,1688,5662,-20
48150359415,48150359418,3,1991,1637,-20
48150596709,48150596712,3,1843,1295,-20
48151176176,48151176198,22,815,1448,-20
48156375329,48156375333,4,1946,1324,-20
48163799480,48163799483,3,2579,1658,-20
48164786562,48164786562,0,1531,1557,-20
48169788490,48169788495,5,2289,1322,-20
48171218930,48171218934,4,2692,1800,-20
48173698723,48173698727,4,3238,1612,-20
48177444498,48177444497,-1,952,2097,-20
48177955000,48177954996,-4,1275,985,-20
48180848314,48180848317,3,1924,1378,-20
48180978956,48180978960,4,2872,2116,-20
48188142349,48188142350,1,1367,1650,-20
48190698630,48190698633,3,2066,1445,-20
48191259997,48191260002,5,1767,1377,-20
48192052811,48192052815,4,1857,1820,-20
48192707949,48192707953,4,758,989,-20
48192848324,48192848327,3,1702,1591,-20
48193515738,48193515743,5,1082,1100,-20
48194129030,48194129022,-8,1165,5282,-20
48196768725,48196768728,3,2318,1556,-20
48198674801,48198674798,-3,1663,4236,-20
48200908566,48200908569,3,1961,1639,-20
48202186418,48202186421,3,1497,1388,-20
48203799411,48203799415,4,2096,1797,-20
48204553620,48204553618,-2,2034,3887,-20
48208197085,48208197086,1,1818,1298,-20
48212071051,48212071054,3,1374,1173,-20
48212869004,48212869005,1,29368,25364,-20
48217265932,48217265934,2,1420,1396,-20
48217695079,48217695083,4,1735,1265,-20
48224020596,48224020599,3,1818,1557,-20
48224147057,48224147061,4,636,480,-20
48225708670,48225708691,21,1086,1355,-20
48226239987,48226239989,2,1808,1839,-20
48228001390,48228001394,4,2204,1513,-20
48229948235,48229948239,4,1929,1137,-20
48231848714,48231848717,3,2395,1235,-20
48234593458,48234593459,1,13649,15272,-20
48235953847,48235953850,3,1608,1349,-20
48238904995,48238904998,3,1378,1072,-20
48241061589,48241061592,3,2079,1801,-20
48242755548,48242755552,4,1855,1088,-20
48243020269,48243020275,6,2438,1541,-20
48243881502,48243881505,3,1444,1566,-20
48247458426,48247458430,4,1900,1050,-20
48247812803,48247812807,4,2121,1164,-20
48248051641,48248051646,5,1801,1358,-20
48249216774,48249216777,3,1822,1906,-20
48250297670,48250297675,5,2065,1114,-20
48251607422,48251607427,5,2395,1627,-20
48253467535,48253467539,4,2350,1286,-20
48253977574,48253977579,5,1559,1067,-20
48254042981,48254042983,2,1621,1555,-20
48257288998,48257288998,0,1423,1874,-20
48258373129,48258373133,4,1900,1290,-20
48260648419,48260648424,5,1821,1768,-20
48261275678,48261275684,6,1275,930,-20
48261336860,48261336863,3,1343,1132,-20
48263386353,48263386354,1,1435,1486,-20
48265254655,48265254659,4,1702,1334,-20
48267363694,48267363694,0,2359,2021,-20
48268142998,48268143003,5,1630,1381,-20
48269733268,48269733272,4,1606,1528,-20
48272319287,48272319289,2,1857,1882,-20
48282420526,48282420528,2,1685,1298,-20
48285772785,48285772787,2,1666,1298,-20
48286806040,48286806043,3,1360,1494,-20
48289532754,48289532742,-12,1094,527,-20
48290354775,48290354779,4,1576,1032,-20
48290765981,48290765983,2,1868,1964,-20
48294780258,48294780262,4,2026,1507,-20
48295233153,48295233154,1,1478,1123,-20
48295670449,48295670451,2,1026,1230,-20
48295891926,48295891921,-5,1005,4175,-20
48299511098,48299511102,4,1383,1147,-20
48300448075,48300448057,-18,1061,786,-20
48303415597,48303415600,3,2060,1465,-20
48303795858,48303795863,5,1326,816,-20
48304028449,48304028454,5,1636,891,-20
48304915794,48304915800,6,1895,1044,-20
48305354515,48305354519,4,1938,1399,-20
48307271113,48307271117,4,1537,1316,-20
48309460510,48309460513,3,1208,1138,-20
48317292533,48317292536,3,2190,1468,-20
48319748278,48319748282,4,1734,953,-20
48319995614,48319995617,3,1550,1218,-20
48322135853,48322135864,11,1647,1209,-20
48325146069,48325146073,4,2198,2028,-20
48325190899,48325190907,8,2492,1285,-20
48332265391,48332265391,0,1243,820,-20
48334746112,48334746117,5,1965,1277,-20
48335842678,48335842682,4,1413,1333,-20
48337582815,48337582814,-1,1132,917,-20
48340137935,48340137939,4,1909,1699,-20
48348449965,48348449962,-3,1461,2540,-20
48351929681,48351929682,1,1427,1025,-20
48352308511,48352308514,3,1662,1414,-20
48354666049,48354666052,3,24900,40026,-20
48355895730,48355895735,5,1173,1613,-20
48360565539,48360565542,3,2258,1473,-20
48362315939,48362315940,1,1134,1295,-20
48365297404,48365297405,1,2061,1679,-20
48365374529,48365374534,5,2247,1835,-20
48368253410,48368253415,5,3051,1187,-20
48372553085,48372553090,5,2162,1290,-20
48374458270,48374458273,3,2086,1509,-20
48374792255,48374792258,3,1861,1085,-20
48376656432,48376656435,3,1143,1291,-20
48382894321,48382894326,5,2417,1224,-20
48383551222,48383551223,1,1460,990,-20
48384260225,48384260226,1,1643,1348,-20
48384387267,48384387271,4,2504,1749,-20
48386429178,48386429182,4,1792,1131,-20
48387048540,48387048543,3,1524,1488,-20
48387188164,48387188168,4,1891,1254,-20
48388131763,48388131768,5,1792,1009,-20
48389967988,48389967991,3,1954,1738,-20
48390037150,48390037145,-5,1183,2653,-20
48392386086,48392386089,3,1732,1384,-20
48394683492,48394683494,2,1199,1728,-20
48399310760,48399310765,5,1295,1258,-20
48400896675,48400896678,3,1564,1492,-20
48402138150,48402138154,4,1716,1364,-20
48402333400,48402333403,3,1629,1193,-20
48402413462,48402413465,3,1624,1754,-20
48406294516,48406294522,6,1792,1839,-20
48406749563,48406749566,3,1944,1334,-20
48407754734,48407754740,6,1529,1204,-20
48414315446,48414315447,1,1194,1357,-20
48419334714,48419334717,3,2144,1768,-20
48421315454,48421315457,3,3108,2970,-20
48421440902,48421440907,5,2358,1464,-20
48425916694,48425916699,5,2550,1429,-20
48426583181,48426583194,13,10480,46398,-20
48426629776,48426629777,1,1910,2400,-20
48426681303,48426681307,4,1724,1032,-20
48427861763,48427861756,-7,1655,4763,-20
48436402453,48436402456,3,2296,1629,-20
48439647024,48439647027,3,2540,1156,-20
48442758658,48442758653,-5,19798,10221,-20
48443689809,48443689813,4,1747,1721,-20
48444493146,48444493148,2,2130,1467,-20
48449511859,48449511862,3,1737,1165,-20
48450325522,48450325530,8,2665,1186,-20
48453119896,48453119898,2,1434,1413,-20
48454045272,48454045275,3,2102,1725,-20
48454947178,48454947183,5,1317,1012,-20
48456766506,48456766508,2,677,858,-20
48460587793,48460587795,2,1965,1563,-20
48463801965,48463801969,4,2285,1764,-20
48465784120,48465784122,2,1650,1079,-20
48468063802,48468063806,4,2090,1662,-20
48470749504,48470749507,3,1393,1648,-20
48475534451,48475534454,3,2799,1381,-20
48475715597,48475715602,5,969,1038,-20
48477383135,48477383138,3,903,1020,-20
48478157332,48478157333,1,2293,1432,-20
48479463246,48479463250,4,2861,1362,-20
48483121183,48483121188,5,1274,835,-20
48483379075,48483379078,3,1848,1925,-20
48487007223,48487007221,-2,1058,3099,-20
48490273043,48490273045,2,1611,1243,-20
48491397651,48491397649,-2,1043,2161,-20
48493602367,48493602370,3,884,685,-20
48495394506,48495394509,3,2022,983,-20
48497355570,48497355574,4,2244,1541,-20
48502984623,48502984609,-14,1085,1714,-20
48504119693,48504119686,-7,2033,8329,-20
48505568426,48505568423,-3,887,3158,-20
48505864897,48505864917,20,1688,1776,-20
48508276267,48508276271,4,2028,1532,-20
48510062751,48510062754,3,2378,1924,-20
48512434852,48512434855,3,1364,1044,-20
48513874525,48513874529,4,1771,1738,-20
48515243682,48515243682,0,1144,1883,-20
48515371092,48515371093,1,1520,860,-20
48518708882,48518708886,4,1305,1274,-20
48520019478,48520019481,3,2250,1295,-20
48520048820,48520048822,2,2396,1265,-20
48520374559,48520374561,2,1377,1499,-20
48525208494,48525208498,4,2260,1489,-20
48528092769,48528092772,3,2492,1797,-20
48530727410,48530727404,-6,1220,4321,-20
48534774545,48534774550,5,2278,1748,-20
48536369775,48536369777,2,1357,1623,-20
48542596222,48542596225,3,1337,1743,-20
48543217545,48543217547,2,857,1205,-20
48546096020,48546096024,4,1805,1523,-20
48546313298,48546313299,1,1972,2101,-20
48547437256,48547437260,4,3565,2581,-20
48551408998,48551409002,4,1643,1367,-20
48553790135,48553790138,3,1615,1052,-20
48554251358,48554251361,3,1558,1548,-20
48557085698,48557085702,4,2063,1195,-20
48559513891,48559513896,5,1792,856,-20
48560269191,48560269191,0,1332,2553,-20
48563496659,48563496654,-5,19054,16281,-20
48563561398,48563561402,4,1710,1681,-20
48563946053,48563946056,3,1810,1725,-20
48564752018,48564752021,3,1416,977,-20
48566043786,48566043769,-17,1163,1091,-20
48568671894,48568671907,13,12997,48744,-20
48569398234,48569398238,4,1051,912,-20
48570391108,48570391110,2,1854,1727,-20
48571041838,48571041842,4,2132,1637,-20
48571892839,48571892843,4,1978,1309,-20
48572362267,48572362270,3,2061,1483,-20
48572582822,48572582825,3,1314,1237,-20
48573831843,48573831845,2,1438,1544,-20
48579287189,48579287194,5,1056,803,-20
48579610882,48579610882,0,1569,790,-20
48580703752,48580703756,4,2060,1229,-20
48580888823,48580888829,6,5922,2931,-20
48580983235,48580983238,3,1297,1425,-20
48581697060,48581697065,5,1555,1196,-20
48582601965,48582601987,22,1164,1036,-20
48585388749,48585388771,22,1894,1383,-20
48586197534,48586197544,10,3245,925,-20
48589028441,48589028445,4,1592,1143,-20
48591742837,48591742841,4,1998,1822,-20
48591819015,48591818993,-22,1817,1711,-20
48593458638,48593458642,4,1768,1514,-20
48595331969,48595331974,5,1368,1368,-20
48595791600,48595791601,1,1428,1643,-20
48597269738,48597269733,-5,3406,11532,-20
48597440260,48597440263,3,1811,1137,-20
48598007497,48598007501,4,2103,1259,-20
48599450189,48599450193,4,1376,1181,-20
48603944020,48603944022,2,2000,1832,-20
48604365842,48604365846,4,1558,1347,-20
48605587492,48605587497,5,2115,2136,-20
48611934294,48611934297,3,1293,1742,-20
48612195361,48612195368,7,5955,2200,-20
48613521075,48613521079,4,1909,1385,-20
48615094119,48615094119,0,1918,2215,-20
48615135091,48615135093,2,1670,1633,-20
48617250803,48617250808,5,1893,1821,-20
48618257781,48618257786,5,6017,2441,-20
48621189518,48621189525,7,1052,1213,-20
48621842977,48621842981,4,2720,1910,-20
48623271186,48623271188,2,1598,989,-20
48624251429,48624251433,4,1718,1630,-20
48625160757,48625160758,1,1742,1684,-20
48625696662,48625696663,1,1131,782,-20
48627694189,48627694190,1,1653,1326,-20
48627735559,48627735537,-22,2232,1422,-20
48629000733,48629000736,3,2524,1994,-20
48634298241,48634298244,3,1434,799,-20
48635710658,48635710662,4,1844,994,-20
48636623910,48636623913,3,2258,2147,-20
48639701473,48639701473,0,1239,1659,-20
48640267147,48640267153,6,1774,1594,-20
48641733732,48641733736,4,1348,1518,-20
48641788403,48641788385,-18,1240,1323,-20
48642630957,48642630958,1,1519,1245,-20
48644761866,48644761878,12,1435,867,-20
48645577087,48645577090,3,2028,1594,-20
48647681313,48647681318,5,1850,1173,-20
48650086363,48650086363,0,1569,1304,-20
48652451891,48652451894,3,1839,1406,-20
48658508896,48658508901,5,2244,931,-20
48659377227,48659377243,16,2460,1158,-20
48659640037,48659640019,-18,3007,2412,-20
48660238369,48660238374,5,2110,2300,-20
48661648543,48661648548,5,1559,1344,-20
48665243096,48665243099,3,1737,1203,-20
48669857974,48669857978,4,1404,1208,-20
48670287121,48670287123,2,1378,1428,-20
48672001325,48672001333,8,2007,1219,-20
48676592073,48676592078,5,2455,1288,-20
48682392934,48682392935,1,1651,1114,-20
48685775183,48685775186,3,2321,1896,-20
48687350683,48687350689,6,1823,1918,-20
48688413207,48688413211,4,2265,1735,-20
48691549517,48691549521,4,1939,1031,-20
48694125787,48694125790,3,1402,1456,-20
48697540299,48697540295,-4,1183,3521,-20
48699060155,48699060159,4,1942,1776,-20
48700871331,48700871331,0,1513,1709,-20
48703128135,48703128139,4,1923,2013,-20
48704908754,48704908753,-1,956,1602,-20
48707893518,48707893523,5,1634,1235,-20
48709103802,48709103802,0,1812,1393,-20
48716348502,48716348505,3,2365,2097,-20
48717013938,48717013942,4,2014,1479,-20
48718269374,48718269377,3,1356,1167,-20
48718346777,48718346779,2,2912,1694,-20
48719055622,48719055627,5,2705,1353,-20
48722568517,48722568520,3,2367,1603,-20
48722759504,48722759507,3,2184,1223,-20
48723746709,48723746713,4,1397,981,-20
48723906245,48723906251,6,1450,1540,-20
48724028649,48724028651,2,2371,1379,-20
48729751460,48729751463,3,1419,1607,-20
48731266733,48731266737,4,1557,1147,-20
48737807471,48737807476,5,2442,1098,-20
48738116281,48738116285,4,2023,1660,-20
48738988359,48738988362,3,2321,1687,-20
48740081195,48740081197,2,838,261,-20
48740572968,48740572969,1,1621,1774,-20
48741142533,48741142536,3,1202,1562,-20
48744223907,48744223916,9,2049,1201,-20
48744820926,48744820928,2,2405,2304,-20
48745061059,48745061062,3,2235,1198,-20
48747696165,48747696170,5,1452,1220,-20
48749334895,48749334898,3,1729,1079,-20
48752950162,48752950166,4,1977,1518,-20
48754850907,48754850914,7,3569,1111,-20
48757156730,48757156735,5,2034,1644,-20
48758709681,48758709687,6,5073,1824,-20
48758832884,48758832888,4,1377,1166,-20
48762607466,48762607470,4,1861,1353,-20
48764038477,48764038481,4,2042,782,-20
48764302418,48764302422,4,2466,1340,-20
48764939090,48764939093,3,1562,1116,-20
48765807366,48765807371,5,1725,751,-20
48768765097,48768765099,2,1073,1159,-20
48773432204,48773432208,4,2173,1822,-20
48775398464,48775398469,5,1072,1173,-20
48779873235,48779873243,8,7243,2286,-20
48781013802,48781013806,4,3202,962,-20
48784853766,48784853768,2,2563,1858,-20
48787419311,48787419311,0,1541,712,-20
48791937207,48791937210,3,1561,1223,-20
48792185694,48792185698,4,1086,598,-20
48794701108,48794701112,4,1675,1057,-20
48795397560,48795397559,-1,1268,1723,-20
48796577867,48796577870,3,1431,1178,-20
48798671099,48798671102,3,1391,1355,-20
48798951025,48798951029,4,1539,1436,-20
48799421670,48799421675,5,1325,984,-20
48800826350,48800826353,3,1552,1264,-20
48802980206,48802980210,4,2013,1582,-20
48803163435,48803163439,4,976,1004,-20
48804984003,48804983986,-17,288,1513,-20
48808383022,48808383026,4,923,1098,-20
48810748469,48810748474,5,1520,1506,-20
48811524864,48811524867,3,1862,1502,-20
48815543162,48815543168,6,2768,1798,-20
48816136149,48816136154,5,1346,1458,-20
48817655075,48817655079,4,1494,1183,-20
48817919245,48817919249,4,1725,1723,-20
48818761579,48818761583,4,1821,1339,-20
48819062162,48819062165,3,1792,1037,-20
48819252098,48819252102,4,1715,1448,-20
48820066365,48820066369,4,1550,1222,-20
48820845115,48820845119,4,2051,1240,-20
48824794307,48824794306,-1,928,1897,-20
48825954626,48825954631,5,1608,867,-20
48826148111,48826148091,-20,1123,1308,-20
48828874145,48828874147,2,1585,1239,-20
48833143132,48833143137,5,2659,1579,-20
48834522173,48834522175,2,1678,1756,-20
48835010045,48835010047,2,1467,1006,-20
48836511076,48836511078,2,2169,1659,-20
48837099366,48837099370,4,1629,860,-20
48837837320,48837837324,4,2618,1711,-20
48844057518,48844057522,4,2567,1726,-20
48844312493,48844312496,3,1906,1542,-20
48845039679,48845039683,4,1664,1406,-20
48847045221,48847045225,4,1587,1522,-20
48847601877,48847601859,-18,1296,648,-20
48847662138,48847662127,-11,1663,1603,-20
48849943551,48849943570,19,2657,652,-20
48850514074,48850514081,7,1622,1496,-20
48850743249,48850743255,6,2151,1212,-20
48852681199,48852681201,2,1293,881,-20
48857026370,48857026375,5,1817,1379,-20
48860070443,48860070445,2,1210,1429,-20
48860465750,48860465757,7,2125,1557,-20
48861319041,48861319044,3,1812,1028,-20
48862265106,48862265109,3,2887,1806,-20
48863426143,48863426151,8,9147,2267,-20
48864940408,48864940411,3,1980,1694,-20
48865199113,48865199115,2,1424,1449,-20
48872649982,48872649967,-15,446,410,-20
48874293282,48874293287,5,2080,1211,-20
48874931380,48874931385,5,1319,1238,-20
48875584127,48875584127,0,1444,1251,-20
48876405806,48876405809,3,1534,1161,-20
48877049296,48877049301,5,1642,1923,-20
48877692100,48877692103,3,1717,1521,-20
48880236890,48880236894,4,2360,1388,-20
48882547562,48882547556,-6,2156,6606,-20
48883454935,48883454937,2,1711,1307,-20
48883481370,48883481371,1,2023,1600,-20
48884280598,48884280602,4,1502,1226,-20
48885113203,48885113207,4,2444,1690,-20
48885586938,48885586941,3,1280,1389,-20
48885884498,48885884502,4,2092,1548,-20
48890784978,48890784981,3,1751,2053,-20
48893574530,48893574533,3,1346,1643,-20
48894277282,48894277282,0,1466,951,-20
48895999842,48895999847,5,1869,1406,-20
48908033626,48908033631,5,1459,1568,-20
48910016619,48910016624,5,2075,1480,-20
48911556280,48911556282,2,1907,1696,-20
48913744679,48913744681,2,1030,1019,-20
48914579267,48914579273,6,1368,1358,-20
48917822579,48917822582,3,1526,1524,-20
48920131295,48920131300,5,2170,1973,-20
48923735410,48923735412,2,1629,1254,-20
48933486950,48933486953,3,1688,1716,-20
48935683233,48935683233,0,1597,2451,-20
48936521341,48936521343,2,1417,1141,-20
48937174138,48937174144,6,2021,1779,-20
48937503711,48937503690,-21,1816,817,-20
48938383844,48938383846,2,1921,1345,-20
48938843246,48938843251,5,2415,1831,-20
48940626354,48940626358,4,2517,1929,-20
48940778234,48940778239,5,1289,1011,-20
48941852094,48941852094,0,1327,1041,-20
48942679941,48942679944,3,2144,1671,-20
48947023807,48947023812,5,1533,929,-20
48947591450,48947591453,3,2025,1302,-20
48947675219,48947675223,4,1285,778,-20
48951289346,48951289350,4,1721,1117,-20
48954679117,48954679121,4,1762,1121,-20
48958551814,48958551821,7,5233,1524,-20
48960306183,48960306187,4,1742,1035,-20
48961356819,48961356822,3,2083,1594,-20
48965282774,48965282778,4,1498,1399,-20
48966076126,48966076128,2,1847,1349,-20
48966219419,48966219421,2,1658,1633,-20
48967075518,48967075519,1,1679,1327,-20
48968297779,48968297783,4,1541,1487,-20
48970541899,48970541903,4,854,736,-20
48975291454,48975291457,3,1305,1251,-20
48983304894,48983304898,4,1537,1615,-20
48984096416,48984096419,3,1317,1285,-20
48986305131,48986305139,8,2739,916,-20
48988118538,48988118539,1,1596,1067,-20
48988604444,48988604451,7,7686,31932,-20
48991543394,48991543399,5,1425,1105,-20
48991699263,48991699266,3,1814,1239,-20
48992450438,48992450441,3,1711,1323,-20
48996063605,48996063602,-3,1221,2660,-20
48997499880,48997499865,-15,1844,1586,-20
49002107603,49002107607,4,1459,1289,-20
49004563858,49004563860,2,1422,1873,-20
49006940086,49006940088,2,1597,1550,-20
49008287035,49008287040,5,1810,1523,-20
49008423553,49008423550,-3,5146,14781,-20
49010815059,49010815057,-2,942,1849,-20
49013655536,49013655539,3,1750,1513,-20
49015405268,49015405274,6,1367,1373,-20
49018420311,49018420314,3,1589,1332,-20
49020565995,49020565999,4,1563,1078,-20
49022561682,49022561686,4,1420,1482,-20
49023395588,49023395589,1,1813,1655,-20
49024340564,49024340567,3,1840,1139,-20
49025124017,49025124022,5,1610,977,-20
49027251922,49027251929,7,3904,1384,-20
49030255530,49030255545,15,205,813,-20
49031662710,49031662714,4,1931,2158,-20
49033192087,49033192090,3,1497,866,-20
49036367530,49036367532,2,1961,1621,-20
49039567017,49039567021,4,2322,1371,-20
49040019933,49040019936,3,1374,1462,-20
49040321114,49040321118,4,1405,1237,-20
49041606289,49041606293,4,1605,1120,-20
49044799152,49044799158,6,1944,1289,-20
49046110735,49046110738,3,1637,894,-20
49046240130,49046240134,4,1986,1405,-20
49052842753,49052842758,5,2031,1424,-20
49054776238,49054776240,2,1959,1606,-20
49056277134,49056277134,0,1383,1598,-20
49057261135,49057261139,4,2129,1805,-20
49057712232,49057712237,5,1171,1283,-20
49059078396,49059078398,2,4207,18376,-20
49062017475,49062017479,4,2208,1646,-20
49072729160,49072729163,3,1741,1451,-20
49073307877,49073307879,2,1391,928,-20
49077786127,49077786130,3,1795,1254,-20
49079370917,49079370922,5,2349,904,-20
49084610515,49084610519,4,2178,1192,-20
49088306501,49088306503,2,1455,1519,-20
49089221022,49089221027,5,1669,1165,-20
49091516980,49091516984,4,1746,1689,-20
49092857689,49092857690,1,1745,1594,-20
49098737945,49098737947,2,2628,1939,-20
49098849749,49098849753,4,1144,1130,-20
49099419463,49099419468,5,2480,1137,-20
49103139362,49103139364,2,2073,1538,-20
49103814954,49103814957,3,2119,1118,-20
49105339426,49105339408,-18,931,1251,-20
49110745145,49110745149,4,1672,1453,-20
49115323246,49115323250,4,2056,1601,-20
49116144090,49116144092,2,1440,1096,-20
49119386745,49119386746,1,2074,1646,-20
49121412826,49121412831,5,1746,1287,-20
49122853741,49122853743,2,1649,1594,-20
49129558626,49129558630,4,2280,2006,-20
49129630579,49129630585,6,1898,1343,-20
49130246882,49130246887,5,1192,1205,-20
49131776207,49131776211,4,1900,931,-20
49131850421,49131850426,5,1004,1210,-20
49143441920,49143441923,3,2226,1548,-20
49144195786,49144195790,4,2196,1266,-20
49144620291,49144620275,-16,1583,930,-20
49145083486,49145083482,-4,5499,12694,-20
49151166145,49151166148,3,2454,1966,-20
49154485900,49154485903,3,2271,1403,-20
49155688942,49155688948,6,2231,1363,-20
49156079718,49156079739,21,950,571,-20
49158249472,49158249474,2,1690,1105,-20
49158564328,49158564350,22,562,2493,-20
49159034051,49159034055,4,2118,1138,-20
49160533981,49160533985,4,2151,1588,-20
49163199843,49163199846,3,1772,2107,-20
49166144064,49166144068,4,1876,1434,-20
49166331002,49166331006,4,1092,891,-20
49168838004,49168838007,3,2821,2099,-20
49168991774,49168991778,4,2099,1128,-20
49169393247,49169393250,3,1373,1036,-20
49170084266,49170084280,14,1579,1033,-20
49175732446,49175732449,3,958,1184,-20
49177475638,49177475640,2,1379,786,-20
49178194618,49178194621,3,1806,1219,-20
49178721105,49178721106,1,992,139,-20
49181018970,49181018974,4,1673,1278,-20
49181391698,49181391702,4,1751,1536,-20
49181535558,49181535577,19,1513,1421,-20
49187626570,49187626571,1,1852,1866,-20
49188077397,49188077399,2,2313,1459,-20
49192871154,49192871158,4,1668,1201,-20
49194712833,49194712837,4,1794,1111,-20
49197855001,49197854988,-13,1398,1214,-20
49202356366,49202356368,2,2085,1606,-20
49204772938,49204772941,3,2249,1608,-20
49205732957,49205732963,6,1229,900,-20
49206529910,49206529913,3,2654,1767,-20
49210143226,49210143245,19,1961,1650,-20
49211751487,49211751493,6,2337,1189,-20
49214557847,49214557850,3,1326,1248,-20
49215378487,49215378491,4,2134,1257,-20
49217114336,49217114340,4,1367,1486,-20
49222729063,49222729070,7,3752,1538,-20
49223767102,49223767105,3,1439,1389,-20
49224754238,49224754242,4,1731,1433,-20
49227006111,49227006114,3,2585,1518,-20
49227942443,49227942447,4,1707,1370,-20
49229996758,49229996761,3,1272,789,-20
49231629096,49231629098,2,2442,1362,-20
49233941382,49233941380,-2,1053,1778,-20
49237041444,49237041447,3,1776,1109,-20
49240771375,49240771378,3,1854,1812,-20
49242409502,49242409505,3,1737,1153,-20
49244345643,49244345647,4,1941,1286,-20
49244644607,49244644611,4,2268,1709,-20
49246850629,49246850632,3,1567,1175,-20
49250111098,49250111103,5,1180,1783,-20
49251567118,49251567123,5,1690,1314,-20
49252790477,49252790479,2,1814,1722,-20
49252987045,49252987050,5,2184,1533,-20
49253623835,49253623837,2,1537,1530,-20
49256983918,49256983922,4,1833,1202,-20
49263132445,49263132449,4,1544,1475,-20
49264020676,49264020680,4,1954,1107,-20
49264448535,49264448534,-1,626,1066,-20
49265516817,49265516819,2,1530,1829,-20
49267226057,49267226058,1,1169,1332,-20
49268993356,49268993356,0,2799,3027,-20
49270527451,49270527455,4,1733,1820,-20
49271022271,49271022274,3,1771,1036,-20
49271596087,49271596091,4,1595,912,-20
49271936032,49271936049,17,1512,1405,-20
49273187758,49273187759,1,1395,2245,-20
49273650230,49273650233,3,2594,2500,-20
49275064623,49275064627,4,2004,1366,-20
49277778912,49277778902,-10,1539,1315,-20
49284660924,49284660927,3,2053,1853,-20
49287860168,49287860172,4,1713,1691,-20
49288490048,49288490040,-8,30188,15897,-20
49289153471,49289153475,4,2544,2497,-20
49296086257,49296086259,2,1793,1357,-20
49297206522,49297206527,5,2547,1196,-20
49303073658,49303073659,1,1924,1335,-20
49303634177,49303634182,5,1975,1048,-20
49305981791,49305981797,6,1281,1379,-20
49306735938,49306735933,-5,1080,3192,-20
49308732771,49308732774,3,787,519,-20
49309156843,49309156845,2,1575,1238,-20
49311108813,49311108814,1,1082,1543,-20
49314419914,49314419918,4,1689,1358,-20
49316777677,49316777677,0,872,1063,-20
49318369215,49318369217,2,1534,1750,-20
49322987443,49322987458,15,1191,1308,-20
49324027223,49324027212,-11,789,244,-20
49324850058,49324850059,1,1170,2008,-20
49326367238,49326367242,4,1349,1049,-20
49326554052,49326554057,5,1557,1252,-20
49327687466,49327687470,4,1373,1580,-20
49329277262,49329277267,5,1322,1204,-20
49330519689,49330519691,2,1306,1074,-20
49333145510,49333145513,3,1140,1037,-20
49334573963,49334573957,-6,511,8085,-20
49336729765,49336729769,4,1152,859,-20
49337051325,49337051348,23,1407,894,-20
49339090806,49339090806,0,1737,1138,-20
49340930155,49340930160,5,1471,1213,-20
49343317419,49343317422,3,1483,942,-20
49343961117,49343961137,20,1035,2919,-20
49345227240,49345227237,-3,843,1633,-20
49346756923,49346756926,3,1724,1595,-20
49350452937,49350452941,4,3365,1543,-20
49350855179,49350855179,0,1254,957,-20
49351971244,49351971246,2,2211,1567,-20
49352647994,49352648002,8,900,118,-20
49353625502,49353625505,3,2389,1573,-20
49355269658,49355269661,3,1777,1705,-20
49360696128,49360696134,6,2268,1396,-20
49361080987,49361080969,-18,800,702,-20
49364649847,49364649850,3,1046,1018,-20
49366373686,49366373689,3,1783,1334,-20
49368002573,49368002578,5,1858,1446,-20
49371449905,49371449907,2,1759,1275,-20
49373043755,49373043762,7,3061,1392,-20
49375071557,49375071553,-4,948,3976,-20
49380454182,49380454186,4,2638,1561,-20
49383842751,49383842754,3,1782,1413,-20
49384043039,49384043043,4,2386,996,-20
49388006726,49388006730,4,1289,733,-20
49388378794,49388378779,-15,1497,1008,-20
49389244219,49389244223,4,2169,1950,-20
49390654704,49390654709,5,1197,838,-20
49392348870,49392348874,4,1513,1287,-20
49395661901,49395661902,1,1892,1653,-20
49396089740,49396089742,2,1712,1505,-20
49396340398,49396340416,18,2728,1455,-20
49396810138,49396810141,3,1628,1379,-20
49398112758,49398112763,5,2195,1336,-20
49399542279,49399542282,3,2351,1911,-20
49400219367,49400219371,4,1767,1334,-20
49400606614,49400606618,4,1874,1084,-20
49401534567,49401534570,3,2246,1295,-20
49401856461,49401856462,1,1391,1381,-20
49402697657,49402697659,2,1145,839,-20
49403815253,49403815255,2,1999,1524,-20
49404877464,49404877466,2,1517,1283,-20
49405331123,49405331136,13,1825,1279,-20
49409153165,49409153147,-18,1947,1367,-20
49409457009,49409457013,4,1807,1578,-20
49415145029,49415145033,4,1862,1676,-20
49416361665,49416361667,2,1521,1030,-20
49418853733,49418853737,4,2086,1502,-20
49419373381,49419373385,4,1400,1246,-20
49421252362,49421252347,-15,1436,923,-20
49421563232,49421563235,3,1977,1169,-20
49422575287,49422575290,3,795,346,-20
49422832783,49422832786,3,1581,1282,-20
49426405973,49426405977,4,1817,1319,-20
49432934702,49432934706,4,1662,1548,-20
49434088898,49434088903,5,1874,863,-20
49439257017,49439257018,1,2452,1367,-20
49443566025,49443566028,3,1758,1194,-20
49443806229,49443806243,14,1614,1130,-20
49445460138,49445460140,2,1572,1651,-20
49447610486,49447610490,4,2033,1270,-20
49447937318,49447937322,4,2567,2060,-20
49457194771,49457194774,3,1195,1631,-20
49457454301,49457454303,2,1610,1424,-20
49458471442,49458471447,5,1708,1469,-20
49462397341,49462397343,2,1457,1095,-20
49466806524,49466806530,6,1463,1012,-20
49467604162,49467604163,1,1705,1370,-20
49468844167,49468844171,4,1633,1131,-20
49471069122,49471069128,6,2744,1589,-20
49472546322,49472546327,5,1685,1433,-20
49473158822,49473158826,4,2291,2042,-20
49474984890,49474984909,19,258,5911,-20
49475592235,49475592241,6,3226,1669,-20
49475925959,49475925963,4,22911,35907,-20
49478336126,49478336130,4,1258,938,-20
49479317854,49479317857,3,1771,1789,-20
49481545225,49481545227,2,2487,1659,-20
49482804029,49482804031,2,2193,2159,-20
49483276709,49483276713,4,1912,1600,-20
49486085317,49486085322,5,2944,1460,-20
49490606729,49490606732,3,2358,2036,-20
49492674318,49492674323,5,1496,1204,-20
49500956369,49500956370,1,32596,34567,-20
49501309282,49501309284,2,1639,1290,-20
49502339818,49502339821,3,1427,1206,-20
49507725377,49507725380,3,1188,1050,-20
49508942141,49508942145,4,1748,1445,-20
49510841146,49510841150,4,1890,1718,-20
49512698861,49512698867,6,1597,976,-20
49513174683,49513174686,3,1325,884,-20
49513897310,49513897314,4,1706,1378,-20
49514249771,49514249775,4,1873,1242,-20
49516037630,49516037633,3,2076,1612,-20
49517145514,49517145518,4,1497,1530,-20
49519092814,49519092817,3,1659,1645,-20
49522728704,49522728707,3,1296,1089,-20
49523748640,49523748644,4,2400,1612,-20
49529715500,49529715503,3,1033,1132,-20
49530573856,49530573858,2,1516,1375,-20
49535320371,49535320376,5,2020,1422,-20
49536922202,49536922206,4,2216,1180,-20
49539784825,49539784827,2,1622,1613,-20
49540479224,49540479227,3,1855,1523,-20
49548857863,49548857868,5,2279,1609,-20
49550439009,49550439018,9,1845,834,-20
49552142874,49552142879,5,1668,1122,-20
49557206909,49557206910,1,2748,1843,-20
49557609039,49557609043,4,2032,1350,-20
49559197250,49559197250,0,1429,1457,-20
49559277151,49559277155,4,2070,1673,-20
49565794517,49565794501,-16,662,1747,-20
49566819595,49566819576,-19,719,372,-20
49572472322,49572472326,4,2405,1232,-20
49574947937,49574947938,1,1333,910,-20
49576347731,49576347734,3,1080,793,-20
49578533159,49578533162,3,2135,2039,-20
49580260289,49580260294,5,4670,1937,-20
49581306671,49581306673,2,996,1120,-20
49582129969,49582129974,5,1746,1396,-20
49584081110,49584081111,1,2011,1754,-20
49586803559,49586803562,3,1889,1659,-20
49587588225,49587588226,1,1195,1636,-20
49588732989,49588732993,4,1169,1125,-20
49590497798,49590497807,9,15686,23483,-20
49591369112,49591369114,2,1195,969,-20
49592432182,49592432182,0,2000,1871,-20
49596531495,49596531498,3,1337,906,-20
49597081426,49597081428,2,1534,1341,-20
49597350030,49597350034,4,2127,2376,-20
49601097034,49601097035,1,1418,1826,-20
49601684281,49601684283,2,1512,1667,-20
49602502958,49602502960,2,2364,1319,-20
49603647742,49603647745,3,1792,1184,-20
49603916098,49603916102,4,1195,1205,-20
49605748409,49605748415,6,1930,1206,-20
49607171428,49607171425,-3,1090,2642,-20
49607927789,49607927791,2,2252,1751,-20
49610599366,49610599368,2,1167,997,-20
49615586653,49615586657,4,1636,1186,-20
49616785988,49616785994,6,44378,47110,-20
49617134394,49617134397,3,897,811,-20
49617765124,49617765126,2,1760,1237,-20
49621320119,49621320123,4,953,732,-20
49623776523,49623776530,7,3114,1515,-20
49624917243,49624917246,3,1062,912,-20
49627415078,49627415082,4,1719,1239,-20
49628773702,49628773707,5,2527,1461,-20
49629067744,49629067748,4,1552,1758,-20
49636932849,49636932844,-5,1390,1964,-20
49637711498,49637711503,5,1606,1211,-20
49639019141,49639019142,1,1430,1382,-20
49639552567,49639552570,3,2374,1849,-20
49643313204,49643313208,4,1798,1461,-20
49644611070,49644611066,-4,2811,5518,-20
49645214923,49645214926,3,2545,1997,-20
49645748055,49645748060,5,1834,1505,-20
49649145402,49649145405,3,2090,1644,-20
49651501202,49651501204,2,2107,1115,-20
49651656321,49651656325,4,1782,1774,-20
49652570294,49652570298,4,1571,1311,-20
49655685306,49655685309,3,1743,1286,-20
49656211382,49656211363,-19,2260,998,-20
49657051598,49657051603,5,1757,1131,-20
49657173902,49657173881,-21,1436,859,-20
49662853530,49662853530,0,1717,2764,-20
49663502642,49663502643,1,1434,1115,-20
49666081665,49666081669,4,2183,1791,-20
49666266998,49666267002,4,1661,1249,-20
49667307182,49667307186,4,2055,1414,-20
49667375618,49667375621,3,1363,970,-20
49671237150,49671237154,4,1139,1234,-20
49672982970,49672982968,-2,977,2866,-20
49680867693,49680867693,0,2031,1730,-20
49684326125,49684326128,3,1607,1446,-20
49685814092,49685814095,3,1600,1308,-20
49686185684,49686185688,4,1805,1338,-20
49686625443,49686625446,3,1672,1204,-20
49689488286,49689488293,7,4524,2241,-20
49693553454,49693553458,4,1454,1316,-20
49697198521,49697198523,2,1751,1576,-20
49698884930,49698884934,4,5477,2249,-20
49700205682,49700205682,0,1947,2750,-20
49701530577,49701530581,4,1914,2022,-20
49702255722,49702255726,4,2021,1666,-20
49705934672,49705934675,3,1743,1453,-20
49707821606,49707821610,4,2381,1349,-20
49708908351,49708908354,3,2493,1860,-20
49710081806,49710081809,3,2644,1393,-20
49712799865,49712799866,1,1544,1226,-20
49714816854,49714816858,4,1881,1567,-20
49715190106,49715190112,6,2703,1472,-20
49715990095,49715990098,3,1793,2027,-20
49716375725,49716375727,2,1869,1251,-20
49717429287,49717429291,4,1994,1348,-20
49722098354,49722098358,4,1749,965,-20
49726794054,49726794056,2,1679,1296,-20
49728463125,49728463128,3,2034,1506,-20
49733198834,49733198837,3,1680,1696,-20
49733829871,49733829874,3,596,963,-20
49736989676,49736989679,3,2461,1540,-20
49741337059,49741337065,6,2950,1250,-20
49741394946,49741394929,-17,2255,1687,-20
49741992302,49741992307,5,982,687,-20
49746681978,49746681983,5,1315,1219,-20
49747665458,49747665462,4,2953,2060,-20
49747849802,49747849805,3,1954,1913,-20
49748492655,49748492658,3,2094,1228,-20
49748664726,49748664726,0,1572,1580,-20
49748861202,49748861198,-4,2460,5668,-20
49750431968,49750431973,5,1291,1150,-20
49750950208,49750950210,2,2144,1899,-20
49752259470,49752259474,4,1679,1493,-20
49752645199,49752645204,5,1837,1380,-20
49753021401,49753021402,1,1437,1154,-20
49757287658,49757287662,4,1852,1112,-20
49760850527,49760850530,3,1930,1181,-20
49762370420,49762370423,3,2280,1285,-20
49764650239,49764650243,4,1829,1031,-20
49764978721,49764978731,10,1848,1988,-20
49765269647,49765269650,3,1910,908,-20
49770209279,49770209277,-2,1475,1234,-20
49771212877,49771212882,5,1305,635,-20
49771693889,49771693893,4,1363,1272,-20
49771806406,49771806424,18,1606,1765,-20
49777208662,49777208671,9,1692,775,-20
49777738946,49777738950,4,791,1000,-20
49782358035,49782358038,3,1882,1450,-20
49784889681,49784889685,4,1163,1370,-20
49787319697,49787319695,-2,1446,1560,-20
49787910281,49787910290,9,1703,1141,-20
49788380869,49788380873,4,1723,1318,-20
49792526977,49792526980,3,2348,1651,-20
49793235456,49793235460,4,1971,1437,-20
49794005121,49794005128,7,1772,1424,-20
49795456214,49795456229,15,17204,36243,-20
49795817573,49795817574,1,2407,1503,-20
49796720559,49796720565,6,1385,1039,-20
49807837195,49807837198,3,4088,1932,-20
49809974702,49809974708,6,1488,1452,-20
49810051462,49810051466,4,1816,1404,-20
49812366850,49812366844,-6,2358,8613,-20
49814657882,49814657883,1,1178,1201,-20
49816327302,49816327305,3,1251,1086,-20
49816631510,49816631514,4,1784,1276,-20
49821404998,49821405002,4,1870,1333,-20
49823180825,49823180825,0,1472,1158,-20
49828354619,49828354622,3,1334,1635,-20
49830137394,49830137396,2,2016,1642,-20
49830322683,49830322699,16,15204,24205,-20
49834628279,49834628285,6,2288,1341,-20
49834669126,49834669108,-18,1181,1207,-20
49835509514,49835509518,4,1747,1220,-20
49835834970,49835834975,5,1158,891,-20
49838490046,49838490049,3,1282,1346,-20
49839490871,49839490871,0,1805,2379,-20
49842731618,49842731618,0,1746,1263,-20
49844575455,49844575440,-15,1675,925,-20
49850294578,49850294581,3,1824,1363,-20
49852473826,49852473831,5,1770,1170,-20
49852757725,49852757728,3,1306,1192,-20
49854918366,49854918370,4,1533,1223,-20
49858094680,49858094677,-3,1275,1615,-20
49860510332,49860510333,1,1278,1982,-20
49863234237,49863234242,5,2010,1071,-20
49863766224,49863766227,3,2121,1301,-20
49866313534,49866313537,3,1804,1673,-20
49867171929,49867171935,6,3221,1025,-20
49871333041,49871333046,5,1476,1056,-20
49871766638,49871766642,4,1730,1179,-20
49873574478,49873574482,4,1469,1242,-20
49873610305,49873610315,10,1335,1274,-20
49876471878,49876471878,0,1346,2016,-20
49877807942,49877807947,5,2432,1359,-20
49879966514,49879966521,7,2751,1390,-20
49884944828,49884944831,3,1591,1283,-20
49885123943,49885123941,-2,2182,2012,-20
49900125042,49900125043,1,1687,1329,-20
49907084912,49907084916,4,1874,1575,-20
49914264703,49914264706,3,2219,1644,-20
49915087901,49915087883,-18,1762,1255,-20
49921141112,49921141115,3,1575,1127,-20
49921309630,49921309632,2,1813,1356,-20
49921443071,49921443050,-21,1742,1095,-20
49922863999,49922864003,4,2566,1226,-20
49927056958,49927056963,5,2005,1265,-20
49931828244,49931828251,7,2699,1346,-20
49933744172,49933744174,2,1987,1542,-20
49934804623,49934804627,4,1528,1050,-20
49936239834,49936239837,3,1934,1174,-20
49940705262,49940705265,3,1774,1670,-20
49944343784,49944343787,3,1216,1251,-20
49950622952,49950622954,2,1474,1480,-20
49952118891,49952118892,1,1693,1803,-20
49952592314,49952592318,4,1407,1424,-20
49953889876,49953889878,2,1804,1680,-20
49956666159,49956666159,0,1455,1364,-20
49956759990,49956759994,4,2140,1705,-20
49958307937,49958307940,3,1516,1680,-20
49960463569,49960463571,2,1624,1423,-20
49961021628,49961021640,12,1939,1320,-20
49962848298,49962848300,2,22250,20037,-20
49967555615,49967555619,4,1937,1388,-20
49968144274,49968144277,3,1547,1413,-20
49970434079,49970434082,3,1384,1257,-20
49971670115,49971670119,4,2048,1687,-20
49973041470,49973041470,0,1347,1555,-20
49974203041,49974203046,5,2198,1392,-20
49974545250,49974545252,2,1359,1482,-20
49974636567,49974636570,3,2141,1358,-20
49974784590,49974784576,-14,13215,45737,-20
49975265662,49975265665,3,1157,1476,-20
49976855039,49976855042,3,2484,1131,-20
49977755567,49977755567,0,1824,1495,-20
49979805425,49979805431,6,2120,1133,-20
49987786881,49987786885,4,1912,1393,-20
49989275712,49989275716,4,1422,1098,-20
49990419954,49990419958,4,1633,1550,-20
49994352547,49994352538,-9,4781,9366,-20
49994860174,49994860177,3,2710,1460,-20
49995220175,49995220153,-22,1599,1325,-20
49995830923,49995830929,6,3103,1413,-20
49996093704,49996093707,3,1634,1279,-20
49996567401,49996567406,5,2744,1674,-20
49996698608,49996698611,3,1906,1836,-20
50003177601,50003177604,3,1736,1386,-20
50008260890,50008260894,4,2677,1693,-20
50008697647,50008697650,3,2237,1937,-20
50009410394,50009410397,3,1956,1298,-20
50009995974,50009995978,4,1854,1260,-20
50017708462,50017708466,4,1434,1282,-20
50020142266,50020142270,4,1387,1267,-20
50021786478,50021786481,3,1498,1400,-20
50022094588,50022094590,2,2156,1813,-20
50023289504,50023289507,3,1425,926,-20
50024314305,50024314306,1,1641,1480,-20
50025486378,50025486383,5,2065,1272,-20
50032906822,50032906825,3,2141,1612,-20
50033805678,50033805672,-6,1316,8256,-20
50036222919,50036222923,4,1703,1060,-20
50036992649,50036992654,5,2077,1342,-20
50039431303,50039431305,2,1555,1689,-20
50041077682,50041077686,4,740,1035,-20
50042226026,50042226029,3,1316,864,-20
50045355602,50045355606,4,1465,1326,-20
50046144158,50046144171,13,2099,1365,-20
50046584658,50046584642,-16,1735,1343,-20
50046913104,50046913110,6,2772,1227,-20
50047527557,50047527561,4,1707,1755,-20
50048188702,50048188706,4,1535,944,-20
50053377839,50053377843,4,2028,1399,-20
50053607551,50053607554,3,1609,1045,-20
50055223687,50055223687,0,1351,1519,-20
50059789570,50059789574,4,2302,1961,-20
50064925338,50064925343,5,1997,869,-20
50071392883,50071392887,4,1558,1571,-20
50074341731,50074341738,7,2902,1190,-20
50074539681,50074539687,6,1289,1489,-20
50076541264,50076541266,2,1510,990,-20
50077675559,50077675562,3,1746,1973,-20
50077783759,50077783762,3,1600,1390,-20
50078075762,50078075765,3,1943,1335,-20
50082075219,50082075222,3,1980,1777,-20
50083664477,50083664481,4,1532,1628,-20
50085533609,50085533613,4,1362,1232,-20
50086798778,50086798769,-9,31495,13738,-20
50091724137,50091724141,4,1653,1438,-20
50094127477,50094127481,4,2042,1321,-20
50094612714,50094612717,3,2633,1665,-20
50097440005,50097440007,2,1856,2002,-20
50099113352,50099113359,7,1750,1093,-20
50100389622,50100389602,-20,1550,1206,-20
50100949857,50100949863,6,2016,1388,-20
50107496880,50107496881,1,2391,1987,-20
50108358841,50108358843,2,1867,1324,-20
50111988785,50111988786,1,1935,1613,-20
50112363278,50112363257,-21,1754,746,-20
50112676507,50112676511,4,2211,1272,-20
50115689877,50115689876,-1,1585,2520,-20
50116284192,50116284194,2,2418,1999,-20
50120712811,50120712814,3,1811,1392,-20
50122129497,50122129486,-11,24136,18514,-20
50122846817,50122846822,5,1377,1229,-20
50123246421,50123246422,1,1298,998,-20
50125950173,50125950175,2,1905,1649,-20
50133344294,50133344298,4,1600,1458,-20
50134900510,50134900498,-12,1293,381,-20
50135052484,50135052485,1,1737,1608,-20
50135604929,50135604932,3,2040,1642,-20
50143360266,50143360271,5,1471,1482,-20
50143666650,50143666652,2,1942,1478,-20
50144975074,50144975079,5,1698,1171,-20
50145604643,50145604638,-5,2205,7085,-20
50148537242,50148537245,3,1816,1477,-20
50151561505,50151561489,-16,1599,1171,-20
50154473268,50154473271,3,1570,1301,-20
50158975679,50158975681,2,2542,1697,-20
50159223678,50159223681,3,1446,1400,-20
50159945526,50159945531,5,1592,1592,-20
50166278030,50166278034,4,2457,1486,-20
50167306200,50167306202,2,1611,1074,-20
50168020166,50168020179,13,1223,1343,-20
50168455633,50168455635,2,1126,1119,-20
50169003853,50169003867,14,1123,843,-20
50169706943,50169706946,3,1699,960,-20
50170841676,50170841680,4,2043,1726,-20
50176168940,50176168943,3,3591,2785,-20
50179974048,50179974050,2,1604,943,-20
50186836518,50186836523,5,2387,1026,-20
50188732931,50188732932,1,1156,1763,-20
50190185454,50190185456,2,1534,1425,-20
50190494590,50190494594,4,2402,1472,-20
50190906288,50190906291,3,2345,1327,-20
50190996434,50190996439,5,2023,1337,-20
50192206558,50192206564,6,1673,1331,-20
50193139917,50193139918,1,1520,754,-20
50194416290,50194416295,5,2644,2123,-20
50198266818,50198266822,4,1971,1412,-20
50199072506,50199072511,5,1805,913,-20
50203458979,50203458982,3,1827,1688,-20
50207062237,50207062241,4,2480,1913,-20
50207277754,50207277759,5,1233,969,-20
50209134146,50209134151,5,1067,698,-20
50209363648,50209363658,10,1021,1115,-20
50211574859,50211574861,2,1788,1543,-20
50212082621,50212082624,3,1603,1512,-20
50213972946,50213972949,3,2404,1281,-20
50216281648,50216281651,3,1893,1008,-20
50217639159,50217639162,3,2723,1499,-20
50220269963,50220269949,-14,1133,1021,-20
50221084563,50221084567,4,2140,1726,-20
50223260438,50223260439,1,1984,1351,-20
50228114674,50228114678,4,1364,1215,-20
50231398252,50231398260,8,8762,38718,-20
50234040125,50234040128,3,2550,1928,-20
50235663307,50235663320,13,1756,652,-20
50236489423,50236489427,4,1412,1376,-20
50236560101,50236560103,2,1945,1260,-20
50240715698,50240715698,0,1450,2349,-20
50242464550,50242464546,-4,801,3069,-20
50249208063,50249208066,3,2381,1449,-20
50252551206,50252551205,-1,1493,2282,-20
50252827320,50252827302,-18,408,819,-20
50257798670,50257798675,5,1891,1434,-20
50260115010,50260115010,0,1876,2100,-20
50263992837,50263992841,4,1619,1127,-20
50265631974,50265631978,4,2260,1513,-20
50270846289,50270846292,3,1373,1183,-20
50271205038,50271205040,2,1229,1075,-20
50271514278,50271514280,2,1691,1541,-20
50275443633,50275443637,4,2157,1535,-20
50280049689,50280049692,3,2105,1710,-20
50284598743,50284598747,4,2223,2308,-20
50284831490,50284831494,4,1380,1112,-20
50285588380,50285588382,2,1552,1493,-20
50288830908,50288830912,4,2089,1507,-20
50289680925,50289680927,2,1913,1453,-20
50291553541,50291553544,3,2603,2142,-20
50293737563,50293737567,4,1845,1415,-20
50296685951,50296685953,2,1981,1387,-20
50298316126,50298316125,-1,854,1425,-20
50298706738,50298706720,-18,1831,1166,-20
50301067493,50301067496,3,2048,1445,-20
50303355923,50303355927,4,1853,1530,-20
50304813217,50304813220,3,1863,1708,-20
50305771025,50305771023,-2,4119,8622,-20
50307518994,50307518993,-1,1861,3171,-20
50308207730,50308207733,3,1854,1136,-20
50309738553,50309738558,5,1813,1404,-20
50310660625,50310660626,1,2443,1252,-20
50312653409,50312653412,3,1456,1667,-20
50312874094,50312874093,-1,5329,8440,-20
50315830523,50315830526,3,2349,2060,-20
50318213414,50318213417,3,1522,1105,-20
50323589889,50323589893,4,1569,1480,-20
50324560165,50324560169,4,2030,1255,-20
50327796555,50327796559,4,1532,2035,-20
50328403747,50328403749,2,2261,978,-20
50328984496,50328984499,3,1731,1204,-20
50329716252,50329716258,6,2154,1264,-20
50330508470,50330508474,4,1382,1947,-20
50335682669,50335682671,2,871,611,-20
50337050240,50337050244,4,1533,1033,-20
50337351427,50337351432,5,1619,942,-20
50341235149,50341235153,4,1628,1656,-20
50342951042,50342951043,1,1417,1515,-20
50344677569,50344677570,1,2376,2226,-20
50345818350,50345818352,2,2194,1656,-20
50351776752,50351776753,1,26042,19093,-20
50360597282,50360597291,9,3830,1218,-20
50361293326,50361293330,4,2370,1423,-20
50361358594,50361358598,4,1944,1415,-20
50362469209,50362469213,4,2401,1553,-20
50367088845,50367088847,2,1870,1233,-20
50367282921,50367282924,3,1632,1964,-20
50367708566,50367708567,1,2072,1774,-20
50368753333,50368753336,3,2743,2092,-20
50368953539,50368953540,1,1376,1398,-20
50372561754,50372561759,5,1421,1290,-20
50374027102,50374027106,4,1694,1842,-20
50374490201,50374490206,5,2291,1455,-20
50375172287,50375172290,3,1664,1638,-20
50376713717,50376713720,3,1745,1448,-20
50379259674,50379259677,3,1944,1650,-20
50384965090,50384965094,4,1490,1430,-20
50390775522,50390775526,4,1029,1057,-20
50399783325,50399783327,2,1936,1376,-20
50400169760,50400169781,21,1284,1402,-20
50400463649,50400463653,4,2386,1545,-20
50402859577,50402859581,4,2451,1701,-20
50404898199,50404898203,4,2440,1968,-20
50405932193,50405932194,1,1901,1332,-20
50406567450,50406567453,3,1149,1547,-20
50408623430,50408623431,1,1871,1710,-20
50409288282,50409288287,5,1921,1660,-20
50410931911,50410931915,4,1900,1492,-20
50413411057,50413411059,2,1963,1074,-20
50417236003,50417236006,3,1229,1189,-20
50417486722,50417486717,-5,1718,6277,-20
50419151292,50419151299,7,2498,1356,-20
50419483458,50419483461,3,1700,1731,-20
50425231180,50425231182,2,1874,1237,-20
50432947769,50432947772,3,1600,1642,-20
50433088790,50433088771,-19,610,174,-20
50436827002,50436827003,1,1386,1130,-20
50438374055,50438374066,11,2286,1424,-20
50438661811,50438661814,3,1130,765,-20
50440414046,50440414049,3,1890,1669,-20
50441047777,50441047781,4,1871,1706,-20
50442287466,50442287470,4,1898,1209,-20
50442444101,50442444112,11,2455,1769,-20
50442803607,50442803610,3,2273,1646,-20
50443367058,50443367060,2,2201,1325,-20
50443492412,50443492416,4,2015,1358,-20
50444513236,50444513235,-1,1137,1585,-20
50447397439,50447397434,-5,827,3513,-20
50452377726,50452377727,1,2245,1167,-20
50452730054,50452730058,4,2001,1390,-20
50458133732,50458133736,4,1553,1237,-20
50459935122,50459935120,-2,1036,1248,-20
50460434948,50460434951,3,1550,1144,-20
50461795707,50461795713,6,1258,1570,-20
50464124946,50464124951,5,2037,1343,-20
50464203267,50464203274,7,2312,966,-20
50465180302,50465180306,4,1468,1518,-20
50465412561,50465412555,-6,859,334,-20
50469089783,50469089788,5,1595,1412,-20
50471084214,50471084218,4,1480,1284,-20
50472815627,50472815631,4,1405,1342,-20
50479667376,50479667379,3,1997,1667,-20
50481123497,50481123501,4,1836,2356,-20
50483853664,50483853665,1,1462,1412,-20
50491678568,50491678571,3,1700,1287,-20
50492999057,50492999063,6,2385,1053,-20
50497625722,50497625725,3,3078,3372,-20
50500851575,50500851579,4,1636,1425,-20
50501688666,50501688671,5,1820,2004,-20
50502270214,50502270219,5,2868,1904,-20
50502723298,50502723299,1,2671,1555,-20
50502877562,50502877566,4,1581,1490,-20
50504535450,50504535452,2,1706,1901,-20
50504767995,50504767998,3,1554,981,-20
50505706283,50505706286,3,1816,1136,-20
50508859463,50508859466,3,2012,1742,-20
50509225206,50509225211,5,1849,1189,-20
50513047078,50513047081,3,2017,1088,-20
50516724905,50516724909,4,1994,1752,-20
50517390507,50517390510,3,1797,1269,-20
50520455094,50520455099,5,2984,1897,-20
50520542092,50520542095,3,2307,1346,-20
50521769751,50521769754,3,1993,1587,-20
50523095590,50523095593,3,844,1047,-20
50523175565,50523175568,3,1307,1218,-20
50524350332,50524350334,2,1368,922,-20
50525741689,50525741687,-2,1333,1463,-20
50525957091,50525957095,4,1536,794,-20
50529968191,50529968194,3,1620,724,-20
50533485937,50533485939,2,1772,1830,-20
50538307748,50538307754,6,1786,1128,-20
50541534459,50541534463,4,2162,1631,-20
50541837286,50541837267,-19,1844,1183,-20
50542432053,50542432057,4,1453,1589,-20
50545588559,50545588562,3,2268,1455,-20
50550556097,50550556097,0,1236,1649,-20
50551175445,50551175448,3,1753,1487,-20
50561081418,50561081421,3,1811,1294,-20
50565814599,50565814602,3,1377,1838,-20
50566170714,50566170718,4,2000,1246,-20
50571014456,50571014459,3,1741,1308,-20
50575338351,50575338354,3,1299,911,-20
50575662294,50575662298,4,1701,1354,-20
50576111497,50576111501,4,2383,1500,-20
50579848798,50579848801,3,2411,1535,-20
50580127095,50580127099,4,1328,925,-20
50581453892,50581453896,4,1675,1633,-20
50584093926,50584093931,5,1807,1119,-20
50586146920,50586146923,3,1939,1209,-20
50587685955,50587685960,5,1594,1466,-20
50594591778,50594591782,4,1547,1148,-20
50596290701,50596290705,4,1864,1350,-20
50598237128,50598237131,3,1607,1391,-20
50604958261,50604958265,4,1905,1796,-20
50610126474,50610126480,6,1188,1276,-20
50610176614,50610176617,3,2167,1366,-20
50611853162,50611853165,3,1477,1320,-20
50613009409,50613009413,4,1754,1192,-20
50613439586,50613439587,1,1568,1633,-20
50621186594,50621186599,5,1521,1455,-20
50623242145,50623242150,5,2219,1365,-20
50624741673,50624741677,4,1480,1546,-20
50624984117,50624984101,-16,1041,1178,-20
50627446050,50627446053,3,1609,1357,-20
50631328946,50631328949,3,1090,1516,-20
50633787005,50633787008,3,1984,2125,-20
50635481120,50635481122,2,1918,1793,-20
50637870490,50637870493,3,1906,1547,-20
50638791798,50638791803,5,1791,1463,-20
50648314668,50648314671,3,1854,1307,-20
50655157028,50655157033,5,2064,1397,-20
50664576766,50664576771,5,2977,1387,-20
50668037710,50668037714,4,1924,1154,-20
50668168421,50668168440,19,1466,1176,-20
50668313846,50668313859,13,1279,1381,-20
50668960405,50668960409,4,973,1287,-20
50670455045,50670455050,5,1864,1078,-20
50672205126,50672205132,6,2268,1234,-20
50673347276,50673347282,6,2809,1210,-20
50676083823,50676083827,4,1476,725,-20
50680671082,50680671084,2,1600,1342,-20
50681347457,50681347462,5,2120,1589,-20
50683257295,50683257299,4,1769,1370,-20
50684354647,50684354651,4,2176,1001,-20
50686388766,50686388762,-4,1448,3928,-20
50689098400,50689098404,4,2287,1468,-20
50691079033,50691079038,5,2032,1190,-20
50692518863,50692518865,2,1753,1238,-20
50695195314,50695195319,5,1083,883,-20
50695847903,50695847898,-5,1513,912,-20
50698273009,50698272995,-14,9027,42027,-20
50698933238,50698933243,5,2556,1278,-20
50702389095,50702389098,3,1848,1660,-20
50703345069,50703345071,2,1464,1344,-20
50707646477,50707646478,1,2032,1537,-20
50713037934,50713037938,4,1218,1334,-20
50714225637,50714225640,3,1836,1189,-20
50715363350,50715363353,3,1516,1314,-20
50719056673,50719056677,4,2198,1999,-20
50720736738,50720736741,3,1195,1149,-20
50721644298,50721644300,2,1477,1243,-20
50729535736,50729535740,4,1618,1374,-20
50729608315,50729608318,3,1697,1753,-20
50729758514,50729758518,4,1470,1371,-20
50734970609,50734970606,-3,1719,3341,-20
50737489402,50737489405,3,2127,1233,-20
50741220187,50741220190,3,1659,1295,-20
50744296765,50744296770,5,1417,1626,-20
50745087060,50745087065,5,1599,1404,-20
50748066067,50748066072,5,3050,1762,-20
50748593510,50748593517,7,2654,1195,-20
50750455578,50750455581,3,2402,1250,-20
50750728658,50750728672,14,1725,1107,-20
50752510431,50752510434,3,1428,1080,-20
50753865474,50753865475,1,1925,1453,-20
50754221801,50754221804,3,1986,2219,-20
50754821410,50754821414,4,1841,1255,-20
50760327925,50760327931,6,2341,1451,-20
50760561792,50760561794,2,2765,1644,-20
50760822569,50760822571,2,1706,1486,-20
50762196290,50762196286,-4,2270,5882,-20
50762477188,50762477193,5,1717,1522,-20
50762737815,50762737818,3,2038,1453,-20
50763368709,50763368714,5,1890,1432,-20
50769498948,50769498951,3,1599,1563,-20
50770206154,50770206158,4,1991,1194,-20
50771038358,50771038363,5,1915,1129,-20
50776735053,50776735054,1,1207,1183,-20
50777217921,50777217926,5,1260,834,-20
50778966421,50778966424,3,1704,1589,-20
50779196743,50779196746,3,1623,868,-20
50780042987,50780042989,2,1814,1523,-20
50780184621,50780184624,3,1655,1523,-20
50780771841,50780771843,2,1531,1396,-20
50782731537,50782731542,5,1321,794,-20
50786017185,50786017190,5,1340,1239,-20
50790466758,50790466762,4,1950,1397,-20
50793845477,50793845482,5,1681,1086,-20
50795994529,50795994532,3,1454,1142,-20
50796354249,50796354253,4,1749,1252,-20
50796713370,50796713371,1,1572,1684,-20
50796885141,50796885135,-6,1534,7528,-20
50797058636,50797058655,19,1793,1868,-20
50798007604,50798007608,4,2395,1541,-20
50799261958,50799261962,4,1725,1754,-20
50799560210,50799560214,4,1669,1174,-20
50800531050,50800531054,4,1885,1293,-20
50800914761,50800914763,2,1617,1176,-20
50801995166,50801995168,2,1634,1569,-20
50804484811,50804484814,3,1353,1319,-20
50805235485,50805235490,5,1660,1305,-20
50805776269,50805776273,4,2073,1758,-20
50806482779,50806482786,7,3455,986,-20
50809961711,50809961713,2,2401,1776,-20
50810017699,50810017705,6,1679,1104,-20
50814000456,50814000459,3,1179,1151,-20
50814493126,50814493130,4,1632,1539,-20
50815493067,50815493073,6,2179,1382,-20
50816565811,50816565815,4,1460,945,-20
50819213279,50819213281,2,1557,1490,-20
50820715029,50820715034,5,2330,1853,-20
50821239442,50821239447,5,1987,1240,-20
50828046701,50828046706,5,2273,2067,-20
50828259295,50828259298,3,2242,1219,-20
50830676746,50830676750,4,1503,1497,-20
50831011258,50831011262,4,1289,1135,-20
50833910801,50833910803,2,1444,1462,-20
50835893502,50835893507,5,1667,1368,-20
50836171509,50836171515,6,2097,1270,-20
50842276358,50842276361,3,1873,1808,-20
50842582276,50842582279,3,1763,1054,-20
50844231666,50844231670,4,1831,1498,-20
50846699551,50846699558,7,1913,1228,-20
50846846431,50846846408,-23,1491,1000,-20
50850471038,50850471042,4,2344,1309,-20
50852674597,50852674599,2,1940,1390,-20
50853534410,50853534415,5,3445,1253,-20
50856736754,50856736760,6,1182,974,-20
50857426056,50857426059,3,1475,1544,-20
50859762631,50859762633,2,1313,1524,-20
50859869266,50859869266,0,1661,2182,-20
50861501236,50861501240,4,2614,2236,-20
50864594496,50864594502,6,2175,859,-20
50865714657,50865714659,2,1897,1632,-20
50866043288,50866043290,2,1477,1612,-20
50869461662,50869461662,0,1881,1389,-20
50872941579,50872941583,4,1664,1136,-20
50874200314,50874200315,1,1710,1342,-20
50878339886,50878339892,6,3727,1989,-20
50879290113,50879290115,2,1720,1428,-20
50879429267,50879429280,13,11549,49716,-20
50880005216,50880005219,3,1829,912,-20
50881057977,50881057981,4,1962,1748,-20
50883963918,50883963924,6,2394,1730,-20
50891290881,50891290882,1,1554,1404,-20
50894638338,50894638343,5,2052,969,-20
50895275300,50895275304,4,2174,1989,-20
50897134370,50897134374,4,2333,1454,-20
50899694570,50899694573,3,1527,1382,-20
50900297141,50900297142,1,1541,1239,-20
50901691302,50901691282,-20,1272,133,-20
50903473953,50903473958,5,1780,1245,-20
50907799809,50907799812,3,1819,1266,-20
50907971969,50907971974,5,1849,1180,-20
50909214533,50909214535,2,1523,1234,-20
50911151079,50911151082,3,2263,1388,-20
50914515962,50914515967,5,1761,1146,-20
50915298157,50915298162,5,2553,1610,-20
50925770942,50925770945,3,1630,1796,-20
50927335714,50927335718,4,1193,1380,-20
50928197504,50928197507,3,1594,1366,-20
50929887510,50929887513,3,1486,822,-20
50930035740,50930035743,3,2007,1515,-20
50938084208,50938084211,3,1857,1425,-20
50940830901,50940830905,4,2672,1744,-20
50945935870,50945935874,4,1948,1168,-20
50948213025,50948213027,2,1731,896,-20
50949464614,50949464618,4,1829,1173,-20
50950827489,50950827491,2,1614,1488,-20
50954725667,50954725662,-5,39165,2124,-20
50958303025,50958303030,5,1784,1554,-20
50963895605,50963895609,4,1244,1342,-20
50965557746,50965557746,0,1313,982,-20
50968022007,50968022006,-1,1144,1290,-20
50970275158,50970275163,5,1204,916,-20
50976522574,50976522579,5,1639,1203,-20
50982298036,50982298039,3,2062,1229,-20
50983745186,50983745190,4,1999,1601,-20
50983829014,50983829019,5,1059,1459,-20
50987113558,50987113560,2,1683,1312,-20
50988858365,50988858368,3,1573,1383,-20
50992227124,50992227127,3,1128,1829,-20
50992337502,50992337504,2,1476,1102,-20
50993274626,50993274630,4,615,841,-20
50995136597,50995136600,3,1525,1426,-20
50995997840,50995997843,3,2600,1745,-20
50998979950,50998979954,4,2310,1190,-20
50999326648,50999326657,9,23262,53631,-20
51001914305,51001914308,3,1303,1224,-20
51004766086,51004766089,3,1859,1653,-20
51008735238,51008735241,3,1456,1643,-20
51012689473,51012689477,4,1484,1190,-20
51017525639,51017525641,2,1989,2048,-20
51021414723,51021414724,1,4032,13770,-20
51026139694,51026139698,4,1370,1084,-20
51029999238,51029999243,5,2288,1125,-20
51031346351,51031346355,4,1507,1238,-20
51034462522,51034462527,5,1045,844,-20
51039004314,51039004317,3,2526,1892,-20
51044113940,51044113946,6,2532,1663,-20
51046452169,51046452173,4,2303,1821,-20
51049120861,51049120862,1,1762,1215,-20
51049917959,51049917963,4,2214,2060,-20
51053813117,51053813119,2,1619,1439,-20
51054154377,51054154381,4,1877,1514,-20
51055168272,51055168274,2,1564,846,-20
51056474710,51056474715,5,4283,2996,-20
51065324969,51065324974,5,1668,1278,-20
51065944902,51065944901,-1,1188,1566,-20
51067271161,51067271166,5,1790,919,-20
51068708926,51068708931,5,4169,2523,-20
51069640960,51069640963,3,1173,960,-20
51071081679,51071081682,3,1834,1455,-20
51075287009,51075287010,1,2237,1079,-20
51075470198,51075470202,4,2504,1527,-20
51075711522,51075711526,4,1463,1105,-20
51075980386,51075980388,2,1928,1446,-20
51076164322,51076164326,4,2303,1616,-20
51076347761,51076347766,5,1388,794,-20
51080142522,51080142522,0,1418,2140,-20
51080872915,51080872918,3,1583,1151,-20
51081523614,51081523607,-7,849,3843,-20
51082171234,51082171237,3,1974,1511,-20
51083602287,51083602280,-7,880,3531,-20
51083852619,51083852623,4,2327,1335,-20
51084483063,51084483067,4,2108,1747,-20
51084550050,51084550053,3,1825,1830,-20
51085385537,51085385536,-1,2645,3936,-20
51087005845,51087005847,2,1368,1319,-20
51089619788,51089619808,20,351,1892,-20
51090945469,51090945470,1,1678,2741,-20
51094310077,51094310081,4,1561,1767,-20
51094645018,51094645021,3,1611,1281,-20
51100396030,51100396032,2,1656,1454,-20
51100555409,51100555414,5,2857,1385,-20
51103862856,51103862859,3,1306,1244,-20
51103954204,51103954206,2,2014,1654,-20
51106512823,51106512826,3,1958,1415,-20
51109458902,51109458904,2,2408,1324,-20
51110749248,51110749249,1,37783,18315,-20
51115533050,51115533053,3,2200,1720,-20
51116681983,51116681985,2,1646,1638,-20
51117621311,51117621315,4,1885,1475,-20
51118511156,51118511159,3,2365,2284,-20
51118838279,51118838282,3,1866,1617,-20
51121478157,51121478163,6,2478,1175,-20
51122796229,51122796227,-2,1356,1059,-20
51124228819,51124228823,4,2042,1358,-20
51125727669,51125727670,1,1840,1515,-20
51126983441,51126983445,4,1462,1199,-20
51127055190,51127055194,4,1089,680,-20
51127573861,51127573867,6,1819,1034,-20
51130157881,51130157886,5,1729,1211,-20
51140344242,51140344246,4,1858,1624,-20
51140821923,51140821927,4,2241,1950,-20
51142125247,51142125249,2,1636,1474,-20
51142713232,51142713236,4,2682,1218,-20
51142964065,51142964061,-4,1899,6725,-20
51147194092,51147194095,3,1508,1071,-20
51149983798,51149983803,5,2245,1410,-20
51151994498,51151994501,3,1431,1313,-20
51152261933,51152261938,5,1726,1344,-20
51153282353,51153282358,5,2098,1312,-20
51153988554,51153988559,5,2163,1012,-20
51157865303,51157865306,3,1031,1286,-20
51162445322,51162445327,5,19882,33541,-20
51162917002,51162917007,5,1602,939,-20
51163581008,51163580995,-13,1841,1546,-20
51163970948,51163970970,22,788,817,-20
51165751842,51165751853,11,16412,34932,-20
51167414274,51167414278,4,2060,1262,-20
51168039297,51168039298,1,1490,1675,-20
51171275638,51171275641,3,1735,1401,-20
51172933448,51172933451,3,1852,1226,-20
51175793350,51175793355,5,1954,1565,-20
51177246109,51177246114,5,1912,1213,-20
51179423022,51179423026,4,1460,1460,-20
51181292509,51181292513,4,1852,1479,-20
51188070634,51188070639,5,2419,1486,-20
51188346573,51188346573,0,1218,1285,-20
51189392923,51189392926,3,1319,1129,-20
51194246982,51194246986,4,1976,1183,-20
51194665669,51194665668,-1,1800,2745,-20
51196233997,51196234001,4,1575,1273,-20
51196588574,51196588587,13,14099,24956,-20
51197780294,51197780295,1,1770,2045,-20
51203509935,51203509939,4,1339,1520,-20
51207423386,51207423390,4,1364,1122,-20
51209063016,51209063018,2,1229,1122,-20
51209914962,51209914965,3,1846,1215,-20
51211055845,51211055826,-19,2031,1601,-20
51212362326,51212362329,3,1262,1003,-20
51213412798,51213412801,3,1781,1418,-20
51214631714,51214631717,3,1539,749,-20
51220083868,51220083870,2,1338,1008,-20
51223373398,51223373402,4,1462,1273,-20
51224232693,51224232697,4,1704,1259,-20
51232063814,51232063819,5,2135,1371,-20
51232324113,51232324120,7,1610,1223,-20
51233973837,51233973842,5,1743,1570,-20
51234487971,51234487976,5,1475,1172,-20
51236432245,51236432250,5,1746,1238,-20
51236537725,51236537730,5,1056,457,-20
51237256222,51237256240,18,832,1021,-20
51245521932,51245521935,3,2849,1941,-20
51247574821,51247574824,3,1636,1635,-20
51248408711,51248408730,19,1430,1278,-20
51252087327,51252087330,3,2097,1157,-20
51252390275,51252390278,3,1053,1123,-20
51253470859,51253470861,2,1730,1674,-20
51254304302,51254304302,0,1583,1207,-20
51259374141,51259374143,2,1553,768,-20
51261411093,51261411098,5,1905,982,-20
51263579510,51263579515,5,1655,1209,-20
51263623615,51263623615,0,1315,1257,-20
51265043129,51265043131,2,1681,1720,-20
51266253925,51266253927,2,1490,1243,-20
51267544241,51267544241,0,898,1661,-20
51269132527,51269132531,4,2072,1095,-20
51272408158,51272408159,1,1594,1194,-20
51273426647,51273426650,3,993,1031,-20
51273937425,51273937431,6,1566,1133,-20
51274908834,51274908841,7,1659,1286,-20
51277113074,51277113079,5,1895,1373,-20
51278157341,51278157345,4,2060,1269,-20
51282028970,51282028975,5,2669,1289,-20
51283427389,51283427391,2,1307,1424,-20
51289175485,51289175486,1,1922,1423,-20
51290282565,51290282566,1,1766,1188,-20
51290344682,51290344678,-4,1911,3412,-20
51292972221,51292972223,2,1431,783,-20
51298660466,51298660469,3,1876,1607,-20
51300283889,51300283890,1,1314,1368,-20
51300347297,51300347301,4,1810,1470,-20
51300377046,51300377047,1,1595,1395,-20
51304139643,51304139646,3,1992,1744,-20
51304610647,51304610650,3,1025,976,-20
51308417114,51308417115,1,1546,1233,-20
51312076513,51312076518,5,1382,1123,-20
51315434634,51315434638,4,2339,1432,-20
51316886273,51316886277,4,1180,1162,-20
51321376515,51321376521,6,1629,1454,-20
51322213546,51322213550,4,2316,1674,-20
51323933614,51323933616,2,1590,1327,-20
51326531395,51326531398,3,1541,1417,-20
51327773833,51327773839,6,1517,1136,-20
51329199833,51329199835,2,1189,1403,-20
51330938396,51330938398,2,1733,1220,-20
51331081236,51331081217,-19,1650,1065,-20
51331334762,51331334765,3,1261,1630,-20
51331979910,51331979914,4,2067,1509,-20
51334654674,51334654678,4,2307,1616,-20
51341287491,51341287495,4,2164,1142,-20
51342685372,51342685375,3,2043,1607,-20
51347581126,51347581130,4,2238,1498,-20
51347621426,51347621430,4,1588,1225,-20
51348901950,51348901953,3,3053,1464,-20
51349618241,51349618237,-4,50,1425,-20
51351721825,51351721829,4,2396,1380,-20
51356521848,51356521851,3,1854,908,-20
51356866080,51356866060,-20,372,1172,-20
51357677022,51357677027,5,2098,1168,-20
51360053754,51360053755,1,1935,1501,-20
51360657045,51360657046,1,1927,1430,-20
51364656975,51364656981,6,1858,1287,-20
51365737977,51365737981,4,2844,1830,-20
51365883287,51365883288,1,1613,1591,-20
51367593538,51367593539,1,1992,1565,-20
51370602911,51370602915,4,1332,1234,-20
51372100089,51372100093,4,1493,1280,-20
51372445589,51372445593,4,1256,1250,-20
51373397886,51373397891,5,2284,1855,-20
51375322661,51375322665,4,1254,1292,-20
51384782987,51384782986,-1,1554,1003,-20
51385769898,51385769896,-2,1273,2894,-20
51385816529,51385816534,5,858,801,-20
51388638145,51388638150,5,1431,1361,-20
51389472723,51389472726,3,1967,1666,-20
51391089529,51391089533,4,2659,1174,-20
51395282538,51395282541,3,2263,2099,-20
51397140190,51397140180,-10,195,800,-20
51398384817,51398384822,5,2906,884,-20
51402698976,51402698978,2,1518,1231,-20
51405770482,51405770486,4,2841,1320,-20
51410151050,51410151053,3,2109,1683,-20
51417883873,51417883876,3,1658,1604,-20
51422235315,51422235322,7,2201,1055,-20
51425239242,51425239248,6,1487,1413,-20
51427840583,51427840586,3,1814,1415,-20
51429539578,51429539584,6,1735,1745,-20
51429988918,51429988922,4,1917,1114,-20
51430249670,51430249683,13,1976,1503,-20
51431211378,51431211382,4,2240,1570,-20
51431748450,51431748454,4,1550,990,-20
51433778988,51433778991,3,1834,1624,-20
51439956342,51439956345,3,1363,1399,-20
51441136170,51441136173,3,2427,1811,-20
51444157582,51444157582,0,1278,1553,-20
51445742418,51445742426,8,1726,1128,-20
51446823149,51446823153,4,1033,1353,-20
51447166058,51447166061,3,1715,1812,-20
51448255812,51448255816,4,1732,1083,-20
51448933119,51448933123,4,2873,1770,-20
51449979663,51449979666,3,2364,1684,-20
51450570522,51450570526,4,1776,1518,-20
51450690565,51450690547,-18,930,817,-20
51451404590,51451404590,0,1300,1521,-20
51454183213,51454183216,3,2585,1967,-20
51454367281,51454367286,5,2274,1477,-20
51454553986,51454553991,5,1375,1580,-20
51454735466,51454735470,4,1719,1679,-20
51455125295,51455125298,3,1665,1290,-20
51455511469,51455511472,3,2516,1708,-20
51457432560,51457432557,-3,909,1741,-20
51457671210,51457671215,5,1895,1303,-20
51459788243,51459788242,-1,1358,2611,-20
51460784198,51460784201,3,2045,1246,-20
51466881824,51466881826,2,1151,1083,-20
51469796291,51469796297,6,1923,1697,-20
51470007574,51470007575,1,1377,1423,-20
51471077460,51471077464,4,1431,1459,-20
51474250102,51474250101,-1,1023,1541,-20
51479905054,51479905053,-1,1129,1189,-20
51481713387,51481713391,4,1178,1163,-20
51481832173,51481832177,4,1835,1239,-20
51484730743,51484730746,3,1757,1195,-20
51490889668,51490889673,5,1813,1737,-20
51493322595,51493322597,2,1753,1472,-20
51493370339,51493370341,2,1244,2129,-20
51493689494,51493689498,4,1791,1976,-20
51493976503,51493976508,5,1840,1183,-20
51498920177,51498920179,2,1461,1463,-20
51500221426,51500221426,0,1559,1258,-20
51501185009,51501185015,6,1629,1207,-20
51502714501,51502714505,4,1905,1790,-20
51503239678,51503239679,1,1386,1273,-20
51504797174,51504797178,4,1785,1392,-20
51504828131,51504828134,3,1420,1042,-20
51508350700,51508350701,1,1834,1452,-20
51508705039,51508705041,2,1970,1492,-20
51512347697,51512347698,1,1897,2045,-20
51514124118,51514124122,4,1601,1241,-20
51515269844,51515269845,1,1562,1322,-20
51517788857,51517788861,4,1413,1426,-20
51518921145,51518921149,4,2204,1445,-20
51519764854,51519764854,0,1749,2154,-20
51519809125,51519809130,5,1557,811,-20
51521716691,51521716693,2,1602,1244,-20
51522629755,51522629760,5,1083,1095,-20
51526896850,51526896846,-4,1044,2923,-20
51528891904,51528891906,2,1740,1892,-20
51531579849,51531579853,4,1310,1319,-20
51535283618,51535283622,4,1757,1181,-20
51537577981,51537577987,6,2052,1134,-20
51540277875,51540277879,4,2131,1289,-20
51542836585,51542836587,2,2561,1259,-20
51544671927,51544671932,5,1972,1370,-20
51545412097,51545412095,-2,43591,20500,-20
51546022804,51546022805,1,1520,1718,-20
51549388366,51549388366,0,1712,1230,-20
51550107001,51550107003,2,2183,1428,-20
51552119081,51552119083,2,1481,1079,-20
51555117781,51555117786,5,1875,1179,-20
51555792699,51555792702,3,1314,817,-20
51559821526,51559821530,4,1781,1227,-20
51564505433,51564505436,3,2535,2077,-20
51565079943,51565079920,-23,2503,1847,-20
51570101146,51570101152,6,2415,1138,-20
51572783729,51572783733,4,1766,1747,-20
51575070173,51575070176,3,1745,1375,-20
51575260511,51575260514,3,1306,1207,-20
51575663301,51575663303,2,1541,1406,-20
51576558926,51576558930,4,2018,1105,-20
51576913954,51576913958,4,1770,999,-20
51578179381,51578179385,4,1723,1290,-20
51581610486,51581610486,0,1471,1000,-20
51582089307,51582089310,3,1878,1514,-20
51582189034,51582189036,2,1904,2148,-20
51583804473,51583804476,3,1814,1445,-20
51585337808,51585337810,2,1649,1562,-20
51587828886,51587828890,4,1739,1622,-20
51588164827,51588164831,4,1197,599,-20
51588598441,51588598434,-7,788,295,-20
51590657716,51590657712,-4,1622,5022,-20
51591477305,51591477310,5,2957,1923,-20
51591937715,51591937734,19,2225,1277,-20
51592573819,51592573800,-19,2061,1234,-20
51592669975,51592669977,2,1807,1683,-20
51598479979,51598479982,3,1173,912,-20
51599289638,51599289642,4,2785,1995,-20
51599946458,51599946453,-5,1009,2559,-20
51602618173,51602618174,1,1526,1300,-20
51604426997,51604427001,4,1528,1504,-20
51608082465,51608082470,5,1602,1552,-20
51608564843,51608564846,3,1452,1627,-20
51609651631,51609651626,-5,554,271,-20
51610555648,51610555650,2,2033,1491,-20
51610882570,51610882574,4,1710,1302,-20
51617515061,51617515064,3,1837,1082,-20
51619250836,51619250839,3,1409,1493,-20
51619432775,51619432772,-3,1706,5479,-20
51620154587,51620154591,4,2118,1813,-20
51623125735,51623125738,3,1349,1144,-20
51624962721,51624962726,5,1634,1347,-20
51626378277,51626378281,4,1552,1426,-20
51630660526,51630660521,-5,1361,3065,-20
51634693434,51634693437,3,713,780,-20
51635801511,51635801514,3,1159,1428,-20
51637644543,51637644545,2,1508,1139,-20
51639905850,51639905845,-5,2366,6846,-20
51640532388,51640532392,4,2391,1355,-20
51640987398,51640987400,2,1802,1192,-20
51643507106,51643507112,6,1814,1749,-20
51646932238,51646932241,3,1589,1643,-20
51647640939,51647640942,3,1959,1344,-20
51649174685,51649174690,5,1908,1953,-20
51649718120,51649718123,3,1889,1204,-20
51655115389,51655115390,1,1742,1381,-20
51655322842,51655322843,1,1333,1154,-20
51655465628,51655465625,-3,1246,1740,-20
51658234481,51658234483,2,2167,1582,-20
51658420111,51658420117,6,2413,1162,-20
51661893145,51661893150,5,1562,834,-20
51666869106,51666869111,5,3142,1813,-20
51667354743,51667354722,-21,3246,2091,-20
51667856938,51667856943,5,2187,2064,-20
51668082725,51668082730,5,2104,1661,-20
51670945930,51670945937,7,2565,943,-20
51677760490,51677760494,4,1564,1531,-20
51678661017,51678661019,2,931,1242,-20
51679191214,51679191219,5,1412,1037,-20
51681196866,51681196867,1,1110,1661,-20
51683418483,51683418463,-20,821,1293,-20
51684056482,51684056483,1,1646,2768,-20
51686321614,51686321617,3,1735,1379,-20
51687807599,51687807602,3,2324,1160,-20
51693300079,51693300086,7,1724,1377,-20
51696028205,51696028207,2,1226,1540,-20
51697166783,51697166786,3,2014,1594,-20
51699503052,51699503055,3,2807,1520,-20
51701914390,51701914391,1,1449,1336,-20
51703243790,51703243771,-19,891,534,-20
51704337879,51704337883,4,965,880,-20
51706235550,51706235555,5,1705,1085,-20
51706367574,51706367576,2,1478,1309,-20
51707476938,51707476941,3,1979,1211,-20
51707554672,51707554674,2,2369,1622,-20
51710447225,51710447228,3,2051,1505,-20
51710646038,51710646017,-21,1000,610,-20
51713592058,51713592058,0,2779,4369,-20
51716259138,51716259140,2,1368,1317,-20
51716651338,51716651336,-2,23706,31661,-20
51716718100,51716718102,2,1855,1702,-20
51717471577,51717471582,5,2261,1649,-20
51720142090,51720142094,4,2587,1928,-20
51720686880,51720686882,2,1977,1544,-20
51722332823,51722332829,6,1799,1678,-20
51722564946,51722564929,-17,475,724,-20
51725989038,51725989034,-4,1218,3519,-20
51731344207,51731344210,3,1685,1242,-20
51731654179,51731654183,4,2435,1565,-20
51731734123,51731734126,3,2192,1745,-20
51732888332,51732888333,1,1223,1385,-20
51737975502,51737975505,3,1229,978,-20
51739691173,51739691176,3,1278,1473,-20
51740383603,51740383607,4,2618,1806,-20
51741138097,51741138101,4,1591,1007,-20
51741566034,51741566035,1,1764,1525,-20
51741949619,51741949622,3,2510,1667,-20
51742458741,51742458746,5,1659,1480,-20
51744121385,51744121387,2,2685,2174,-20
51745477770,51745477775,5,2412,1354,-20
51747970270,51747970275,5,2342,1268,-20
51750094374,51750094378,4,1615,1532,-20
51750961596,51750961599,3,1648,1517,-20
51752447495,51752447499,4,2105,1979,-20
51756176713,51756176715,2,1245,1164,-20
51759518075,51759518067,-8,697,2110,-20
51760248603,51760248607,4,1941,1607,-20
51760560750,51760560752,2,1436,914,-20
51761422028,51761422034,6,1722,1232,-20
51762113523,51762113527,4,871,734,-20
51763517373,51763517377,4,1672,1569,-20
51766824041,51766824045,4,2147,1211,-20
51768339783,51768339787,4,1886,1642,-20
51768569696,51768569684,-12,3143,1359,-20
51768735638,51768735641,3,1521,1140,-20
51769267007,51769267010,3,2154,1563,-20
51770313059,51770313050,-9,1103,447,-20
51770365222,51770365225,3,1519,1544,-20
51771395655,51771395654,-1,1077,1834,-20
51774320755,51774320759,4,2250,1630,-20
51774613819,51774613823,4,2930,1684,-20
51775067862,51775067867,5,2164,1022,-20
51775593060,51775593062,2,1391,1517,-20
51775883846,51775883850,4,1416,763,-20
51777770792,51777770794,2,1379,1307,-20
51779527623,51779527624,1,1448,1284,-20
51779700013,51779700016,3,1391,965,-20
51780824355,51780824359,4,1763,1479,-20
51781557025,51781557029,4,1540,1543,-20
51788772619,51788772611,-8,24705,16564,-20
51789020804,51789020802,-2,1321,958,-20
51789067321,51789067323,2,2362,1800,-20
51789647359,51789647363,4,1225,848,-20
51790980821,51790980842,21,1439,2488,-20
51795027729,51795027734,5,2772,1258,-20
51799435969,51799435971,2,1668,1667,-20
51801022877,51801022878,1,1757,1584,-20
51801757789,51801757793,4,2129,1540,-20
51802655080,51802655082,2,2232,1584,-20
51804745922,51804745927,5,1327,1146,-20
51805128803,51805128807,4,1991,1744,-20
51805546665,51805546672,7,3925,1924,-20
51809745477,51809745479,2,2273,1801,-20
51810246716,51810246714,-2,1884,3702,-20
51810713542,51810713544,2,1868,1412,-20
51814853743,51814853744,1,1573,1332,-20
51817284522,51817284526,4,1836,1570,-20
51817729186,51817729170,-16,2078,651,-20
51821580740,51821580743,3,890,900,-20
51822827531,51822827532,1,1623,1314,-20
51825763169,51825763159,-10,32092,14992,-20
51825931395,51825931399,4,1876,1394,-20
51829145394,51829145398,4,1840,1252,-20
51830312092,51830312095,3,1260,910,-20
51835787561,51835787559,-2,21650,46916,-20
51843434006,51843434013,7,2053,1443,-20
51844976826,51844976830,4,2053,1294,-20
51846219614,51846219618,4,2266,1221,-20
51846517518,51846517520,2,1574,1218,-20
51850324794,51850324790,-4,1963,5205,-20
51851303303,51851303306,3,1825,1466,-20
51851505843,51851505850,7,3334,1345,-20
51852202499,51852202503,4,2090,1405,-20
51853602780,51853602783,3,1938,1219,-20
51855457985,51855457989,4,1843,1556,-20
51857574551,51857574555,4,1738,1821,-20
51858455349,51858455353,4,1786,1834,-20
51864557769,51864557771,2,1562,1361,-20
51865691856,51865691858,2,1674,1713,-20
51866964493,51866964494,1,2776,3459,-20
51868088157,51868088161,4,927,1020,-20
51878064721,51878064722,1,1781,1372,-20
51880289126,51880289130,4,1487,1101,-20
51887618766,51887618769,3,1355,1454,-20
51891461114,51891461119,5,2735,1061,-20
51891833326,51891833334,8,4638,1453,-20
51893887098,51893887100,2,2553,1816,-20
51894854149,51894854152,3,1763,1638,-20
51896629161,51896629158,-3,1090,2376,-20
51897306754,51897306775,21,1128,834,-20
51897344826,51897344812,-14,2109,1547,-20
51899998918,51899998922,4,2073,1157,-20
51903596775,51903596778,3,985,1103,-20
51904572282,51904572286,4,1374,1173,-20
51905065698,51905065701,3,1666,1311,-20
51906448449,51906448455,6,2023,1293,-20
51906671193,51906671198,5,2029,1784,-20
51907393401,51907393402,1,1947,1533,-20
51907856882,51907856889,7,2029,1793,-20
51908589491,51908589495,4,1435,1259,-20
51909267003,51909267006,3,1035,803,-20
51913433641,51913433644,3,1540,732,-20
51914767046,51914767047,1,1946,1524,-20
51915104784,51915104789,5,1718,1216,-20
51925831116,51925831120,4,3133,1953,-20
51926411554,51926411563,9,2132,1446,-20
51926640046,51926640067,21,1077,1019,-20
51929200648,51929200650,2,2275,1768,-20
51929952751,51929952755,4,1527,1288,-20
51932355087,51932355090,3,1140,1603,-20
51934343925,51934343926,1,1379,1650,-20
51935238249,51935238251,2,1191,1142,-20
51937068821,51937068823,2,2453,1512,-20
51938102159,51938102162,3,1639,1152,-20
51938173781,51938173779,-2,2272,5048,-20
51942990050,51942990054,4,2478,1229,-20
51945147368,51945147371,3,2322,1861,-20
51947892427,51947892432,5,1899,1318,-20
51958599693,51958599696,3,1791,1272,-20
51960160877,51960160881,4,1738,1691,-20
51960823134,51960823139,5,2291,1110,-20
51966203204,51966203209,5,1961,1131,-20
51969078929,51969078923,-6,704,2292,-20
51970351997,51970352000,3,1503,889,-20
51973643134,51973643139,5,1508,1198,-20
51973759203,51973759207,4,1552,1252,-20
51978685523,51978685526,3,1781,1484,-20
51978886631,51978886635,4,2096,1390,-20
51983011335,51983011339,4,3093,2102,-20
51984662126,51984662129,3,2182,1064,-20
51989710914,51989710917,3,1433,1420,-20
52002769278,52002769281,3,1604,1451,-20
52007313745,52007313749,4,1833,1211,-20
52010034983,52010034986,3,1193,979,-20
52012216488,52012216480,-8,1891,1799,-20
52017392717,52017392719,2,1655,1798,-20
52023364750,52023364755,5,1312,1312,-20
52025031802,52025031805,3,2152,1408,-20
52025620118,52025620121,3,1686,1251,-20
52027633119,52027633124,5,1595,1146,-20
52033777307,52033777302,-5,1722,3365,-20
52035126126,52035126129,3,1988,1886,-20
52036030510,52036030512,2,1723,2059,-20
52041405110,52041405114,4,1486,1641,-20
52041785598,52041785604,6,2644,1627,-20
52042017802,52042017804,2,1547,1441,-20
52042150062,52042150068,6,2093,1611,-20
52044442962,52044442963,1,1280,1798,-20
52046437069,52046437072,3,2014,1400,-20
52047289238,52047289242,4,2248,1785,-20
52047639985,52047639988,3,1714,1406,-20
52048508362,52048508366,4,1923,1557,-20
52049292354,52049292355,1,1298,1210,-20
52056642731,52056642733,2,1946,1208,-20
52056866909,52056866913,4,1380,1236,-20
52057402608,52057402614,6,1881,1665,-20
52057692805,52057692793,-12,734,339,-20
52059159079,52059159084,5,1450,1158,-20
52063382506,52063382511,5,1162,930,-20
52069352583,52069352586,3,1897,2102,-20
52074867902,52074867902,0,1016,1204,-20
52076370166,52076370170,4,2640,2441,-20
52082834038,52082834042,4,1290,1111,-20
52088743042,52088743045,3,1513,1274,-20
52102227955,52102227959,4,1902,1545,-20
52102875756,52102875758,2,1371,1541,-20
52108814206,52108814209,3,1889,1518,-20
52108980229,52108980235,6,3882,1678,-20
52109073873,52109073874,1,1490,1305,-20
52109465221,52109465243,22,2239,1708,-20
52111924347,52111924350,3,1403,1176,-20
52113223938,52113223944,6,2053,1314,-20
52114031262,52114031262,0,1588,1701,-20
52118084163,52118084167,4,1866,1169,-20
52118150566,52118150569,3,1774,1449,-20
52118701662,52118701662,0,1902,1157,-20
52123320421,52123320424,3,1909,1482,-20
52128300145,52128300150,5,1423,1829,-20
52129138190,52129138193,3,1871,1540,-20
52129917954,52129917959,5,1503,1223,-20
52130032266,52130032268,2,1505,1173,-20
52130761965,52130761969,4,2324,1887,-20
52132403256,52132403260,4,2018,931,-20
52136462235,52136462238,3,1736,1082,-20
52138427749,52138427751,2,896,1000,-20
52138704094,52138704101,7,6293,2602,-20
52144204582,52144204586,4,2203,1481,-20
52146618426,52146618430,4,1760,1268,-20
52147478545,52147478550,5,2202,1742,-20
52152410173,52152410177,4,1669,1539,-20
52153547004,52153547007,3,1708,1713,-20
52155640596,52155640609,13,1276,2734,-20
52155680110,52155680111,1,1308,1279,-20
52159654865,52159654868,3,2405,1761,-20
52164667647,52164667651,4,1741,1152,-20
52166232242,52166232244,2,2659,1820,-20
52166432196,52166432197,1,1548,1322,-20
52166567148,52166567150,2,1639,1446,-20
52167475894,52167475898,4,2203,1691,-20
52168069407,52168069410,3,1429,1707,-20
52170344047,52170344048,1,1164,1500,-20
52175901847,52175901851,4,2353,1647,-20
52176343241,52176343247,6,1800,1131,-20
52183166378,52183166379,1,1744,1055,-20
52183747600,52183747603,3,1180,970,-20
52192564226,52192564229,3,1608,1129,-20
52199154724,52199154728,4,2051,1356,-20
52199514773,52199514756,-17,3677,953,-20
52203405209,52203405213,4,1546,1678,-20
52205720919,52205720922,3,1917,1681,-20
52207605401,52207605405,4,1983,1408,-20
52208191674,52208191678,4,1642,1328,-20
52210367689,52210367693,4,2109,1653,-20
52212599571,52212599577,6,2185,1626,-20
52214634198,52214634200,2,1293,1099,-20
52219340827,52219340831,4,1717,1360,-20
52219431975,52219431979,4,1729,988,-20
52221783738,52221783742,4,1149,1491,-20
52224139925,52224139929,4,2106,1646,-20
52226214066,52226214070,4,1526,1183,-20
52227558409,52227558411,2,1579,1208,-20
52228677246,52228677251,5,2267,2123,-20
52230382684,52230382687,3,3165,2004,-20
52232161998,52232162000,2,2422,1876,-20
52233900921,52233900915,-6,1104,900,-20
52235610274,52235610276,2,1986,1388,-20
52235838402,52235838403,1,1021,963,-20
52236848493,52236848498,5,1971,1237,-20
52236987874,52236987878,4,1752,1473,-20
52238008197,52238008201,4,1692,1459,-20
52239872781,52239872786,5,983,679,-20
52244257343,52244257346,3,1969,1821,-20
52244897271,52244897274,3,1860,1580,-20
52246028182,52246028178,-4,1043,2871,-20
52246070938,52246070938,0,1079,844,-20
52246409739,52246409721,-18,1476,1414,-20
52246779783,52246779785,2,1464,1557,-20
52247457431,52247457434,3,1682,939,-20
52248191994,52248191995,1,1988,1424,-20
52251596186,52251596193,7,4170,872,-20
52253122312,52253122314,2,2260,1562,-20
52253301641,52253301644,3,1071,1255,-20
52254423825,52254423827,2,1270,915,-20
52258708526,52258708530,4,14115,1458,-20
52260220941,52260220934,-7,1531,7987,-20
52262204884,52262204889,5,1156,771,-20
52263105786,52263105787,1,1731,2093,-20
52263229090,52263229090,0,1602,1831,-20
52264234310,52264234313,3,2874,2980,-20
52266326778,52266326783,5,1589,1068,-20
52267265197,52267265200,3,2991,1656,-20
52271826318,52271826321,3,1960,1768,-20
52275512413,52275512415,2,1483,1579,-20
52277269811,52277269814,3,2249,1667,-20
52278131294,52278131300,6,2533,2191,-20
52278359283,52278359287,4,2023,1180,-20
52279148121,52279148123,2,1008,1994,-20
52280702510,52280702514,4,2222,1615,-20
52280751998,52280751977,-21,1747,1132,-20
52288324962,52288324963,1,1601,1714,-20
52289236599,52289236602,3,2111,1636,-20
52301310315,52301310318,3,1732,1518,-20
52301937438,52301937441,3,1935,1440,-20
52306917871,52306917874,3,1894,1506,-20
52309174306,52309174309,3,1684,1672,-20
52314463986,52314463992,6,3377,784,-20
52316039385,52316039389,4,1681,1660,-20
52317572782,52317572787,5,1823,1848,-20
52318931004,52318931007,3,1240,993,-20
52319061152,52319061149,-3,1339,1613,-20
52319633029,52319633031,2,1614,1503,-20
52321215061,52321215066,5,1229,1048,-20
52326638036,52326638041,5,1317,897,-20
52326668558,52326668559,1,6053,6188,-20
52327352822,52327352823,1,1384,1124,-20
52336915380,52336915382,2,1896,1775,-20
52343420956,52343420975,19,736,754,-20
52343793541,52343793524,-17,1948,635,-20
52348948598,52348948598,0,1348,1633,-20
52353312075,52353312075,0,1437,1680,-20
52353689243,52353689245,2,1269,1245,-20
52354700110,52354700113,3,1785,1541,-20
52357345410,52357345415,5,1563,1108,-20
52359768336,52359768339,3,1956,1909,-20
52360623670,52360623649,-21,2220,1426,-20
52360963535,52360963538,3,1533,1163,-20
52361705419,52361705422,3,2163,1704,-20
52362652562,52362652567,5,2314,1502,-20
52364189060,52364189065,5,2201,1358,-20
52364540755,52364540739,-16,1240,691,-20
52364808325,52364808318,-7,1108,3763,-20
52366093523,52366093526,3,1344,1503,-20
52367357851,52367357849,-2,1752,1753,-20
52372633782,52372633785,3,2029,1312,-20
52373728187,52373728191,4,934,520,-20
52378046689,52378046691,2,1932,1219,-20
52378454762,52378454765,3,1653,1458,-20
52382846969,52382846974,5,1377,1720,-20
52383625322,52383625326,4,2341,1470,-20
52387743532,52387743535,3,1820,1040,-20
52390297715,52390297719,4,1835,1279,-20
52391000700,52391000703,3,1666,1442,-20
52392368198,52392368203,5,1545,1120,-20
52392483190,52392483191,1,1924,1165,-20
52393076318,52393076321,3,1451,1718,-20
52394524640,52394524642,2,1655,1548,-20
52397631977,52397631978,1,1520,1424,-20
52399905811,52399905809,-2,1799,2370,-20
52400224079,52400224082,3,1625,1367,-20
52404232087,52404232090,3,2043,1907,-20
52405170076,52405170079,3,2787,1771,-20
52405919914,52405919910,-4,1487,1421,-20
52406509389,52406509391,2,1865,1403,-20
52409371011,52409371013,2,1380,1449,-20
52410712707,52410712705,-2,670,1756,-20
52411047071,52411047075,4,2035,1892,-20
52415763395,52415763399,4,2027,1731,-20
52417041418,52417041423,5,2341,1638,-20
52418785290,52418785293,3,1613,1484,-20
52421889862,52421889868,6,1895,1232,-20
52424618717,52424618721,4,2640,2009,-20
52426228790,52426228794,4,1873,1634,-20
52430871325,52430871329,4,1934,1433,-20
52432161438,52432161442,4,1464,1629,-20
52432376286,52432376268,-18,660,922,-20
52434792318,52434792323,5,958,488,-20
52438360492,52438360494,2,1578,852,-20
52442937001,52442936999,-2,1351,1114,-20
52446773278,52446773282,4,1626,1208,-20
52450905478,52450905480,2,2103,1740,-20
52453588962,52453588966,4,1765,1220,-20
52453977277,52453977257,-20,1046,454,-20
52454568869,52454568873,4,1140,1236,-20
52456737591,52456737595,4,2620,1997,-20
52456961611,52456961615,4,1292,1103,-20
52461235026,52461235030,4,1983,1610,-20
52464938409,52464938412,3,1565,1187,-20
52465491334,52465491339,5,2658,2546,-20
52469116810,52469116809,-1,911,751,-20
52472652398,52472652402,4,1563,1351,-20
52472811879,52472811882,3,2380,1538,-20
52474333483,52474333486,3,1677,1394,-20
52474635153,52474635154,1,2286,2090,-20
52477985951,52477985954,3,1734,1534,-20
52483422126,52483422130,4,1658,1125,-20
52483826918,52483826919,1,3694,2897,-20
52486939742,52486939746,4,2041,1565,-20
52489127626,52489127631,5,2148,1016,-20
52491268450,52491268451,1,1683,952,-20
52491917349,52491917351,2,1513,1293,-20
52498381445,52498381450,5,2106,1648,-20
52499164402,52499164406,4,1664,695,-20
52501503653,52501503653,0,798,1446,-20
52501849122,52501849126,4,2194,1357,-20
52503897674,52503897676,2,1479,1190,-20
52504385385,52504385388,3,1429,1366,-20
52504742875,52504742878,3,3293,2369,-20
52505264007,52505263985,-22,1508,774,-20
52509763001,52509763004,3,1768,1521,-20
52509879977,52509879980,3,1627,1305,-20
52511539838,52511539843,5,1686,929,-20
52515348799,52515348801,2,881,891,-20
52520047263,52520047267,4,1344,1392,-20
52523061202,52523061203,1,1938,1836,-20
52526089359,52526089364,5,1697,1402,-20
52526907229,52526907234,5,1494,970,-20
52528749246,52528749250,4,2620,1504,-20
52530248786,52530248790,4,1837,1580,-20
52530275831,52530275835,4,2048,1688,-20
52531083738,52531083741,3,1600,1764,-20
52531833829,52531833831,2,1930,1645,-20
52534595334,52534595337,3,1951,1136,-20
52536742950,52536742953,3,1417,1640,-20
52538155157,52538155162,5,1815,1157,-20
52540419195,52540419199,4,2537,951,-20
52540624010,52540624014,4,943,612,-20
52543709059,52543709054,-5,1309,3715,-20
52544191462,52544191467,5,1548,1180,-20
52545369718,52545369720,2,1733,1209,-20
52546292704,52546292707,3,1665,1316,-20
52549056414,52549056418,4,1728,1227,-20
52550118727,52550118731,4,2247,1438,-20
52550937974,52550937977,3,1759,1778,-20
52551885878,52551885877,-1,9247,13853,-20
52555104915,52555104918,3,1459,1316,-20
52557586289,52557586295,6,1625,769,-20
52558838804,52558838825,21,1428,942,-20
52558895318,52558895322,4,1597,1050,-20
52561841729,52561841734,5,2160,1167,-20
52563124191,52563124187,-4,655,323,-20
52564578747,52564578750,3,1759,1404,-20
52565117009,52565117014,5,1886,1532,-20
52565475403,52565475408,5,2098,962,-20
52565873839,52565873844,5,1940,1751,-20
52569392002,52569392006,4,1434,1107,-20
52572915688,52572915694,6,1444,771,-20
52573226683,52573226699,16,1009,4434,-20
52574015290,52574015295,5,1203,1147,-20
52575656541,52575656545,4,1558,1156,-20
52578326523,52578326520,-3,1367,2011,-20
52578392428,52578392448,20,1553,1376,-20
52585273426,52585273426,0,1576,1408,-20
52588721077,52588721081,4,1730,1601,-20
52589193763,52589193768,5,2833,1782,-20
52589481371,52589481375,4,1689,931,-20
52591510557,52591510562,5,1641,1084,-20
52597335419,52597335422,3,2424,1235,-20
52597758645,52597758659,14,546,132,-20
52598882534,52598882537,3,1193,1008,-20
52604059525,52604059530,5,1802,1717,-20
52605023858,52605023861,3,2499,1914,-20
52607823850,52607823854,4,2302,1582,-20
52610837031,52610837032,1,1297,1679,-20
52617729895,52617729898,3,1568,1342,-20
52620786039,52620786032,-7,753,3669,-20
52620938526,52620938527,1,2354,1611,-20
52622883098,52622883107,9,10261,30530,-20
52625647555,52625647557,2,1159,1577,-20
52627858541,52627858545,4,1790,1215,-20
52628945082,52628945087,5,2081,1093,-20
52629549809,52629549813,4,2476,2103,-20
52632563111,52632563112,1,1127,1301,-20
52634284186,52634284191,5,1070,1010,-20
52635874001,52635874002,1,1417,1890,-20
52638405357,52638405358,1,1977,1233,-20
52648259019,52648259023,4,2724,1379,-20
52650687548,52650687553,5,1506,1203,-20
52651013795,52651013795,0,948,1344,-20
52651905815,52651905818,3,2450,1558,-20
52652473543,52652473546,3,1568,1355,-20
52656133993,52656133996,3,1782,1150,-20
52657802342,52657802345,3,1479,1457,-20
52666649951,52666649954,3,2025,1324,-20
52667963326,52667963327,1,2454,1286,-20
52669249270,52669249272,2,1195,1316,-20
52670478554,52670478559,5,2233,1091,-20
52672379711,52672379713,2,1686,1408,-20
52673024092,52673024094,2,1557,1401,-20
52675207882,52675207886,4,1774,1278,-20
52683134379,52683134384,5,4536,2028,-20
52685249349,52685249350,1,1562,1413,-20
52688089624,52688089626,2,1020,1058,-20
52691815373,52691815377,4,1587,1064,-20
52692381302,52692381305,3,1045,1403,-20
52695466292,52695466296,4,1780,1317,-20
52696986411,52696986410,-1,1441,2118,-20
52697264674,52697264678,4,1470,925,-20
52697696532,52697696535,3,2672,1658,-20
52698590048,52698590051,3,1636,1297,-20
52701352957,52701352959,2,1755,1466,-20
52702893601,52702893605,4,1768,1572,-20
52705579256,52705579258,2,1300,766,-20
52707742949,52707742951,2,1357,1144,-20
52709949255,52709949259,4,1651,1144,-20
52713589755,52713589758,3,2511,1392,-20
52716759049,52716759050,1,1868,1779,-20
52720168957,52720168961,4,1850,1135,-20
52723948016,52723948022,6,2797,1173,-20
52723987957,52723987977,20,2100,1838,-20
52728282946,52728282950,4,1095,745,-20
52730939691,52730939694,3,2579,1785,-20
52733843441,52733843445,4,2879,1455,-20
52738735033,52738735036,3,1577,1198,-20
52742536299,52742536303,4,1493,1006,-20
52742988450,52742988451,1,1448,1443,-20
52743781926,52743781932,6,1740,1523,-20
52746133250,52746133256,6,1086,842,-20
52746749251,52746749259,8,3940,881,-20
52747716894,52747716897,3,1622,969,-20
52748609831,52748609831,0,930,1364,-20
52751716430,52751716435,5,2277,1452,-20
52752403574,52752403571,-3,4582,12019,-20
52752759142,52752759146,4,2294,1204,-20
52753516128,52753516130,2,1768,1444,-20
52755071753,52755071755,2,1991,1712,-20
52756541293,52756541292,-1,1547,2091,-20
52757411353,52757411356,3,1511,1359,-20
52759552106,52759552113,7,2962,1589,-20
52764855001,52764855005,4,1434,1293,-20
52767816882,52767816887,5,1559,1078,-20
52771383862,52771383862,0,1600,1433,-20
52771879146,52771879149,3,1198,1369,-20
52773367778,52773367783,5,1956,1405,-20
52775778326,52775778330,4,2024,1694,-20
52775826627,52775826644,17,1306,915,-20
52776178757,52776178769,12,2181,1462,-20
52776545841,52776545850,9,20357,55375,-20
52776699155,52776699161,6,3252,1498,-20
52780479607,52780479611,4,1484,1074,-20
52781382743,52781382746,3,2143,1432,-20
52782295406,52782295409,3,1772,1500,-20
52784930792,52784930799,7,11637,27045,-20
52785220921,52785220923,2,2126,1598,-20
52790072842,52790072849,7,2791,1347,-20
52790841889,52790841890,1,1699,1513,-20
52793058526,52793058529,3,2015,1305,-20
52797534569,52797534563,-6,2303,8019,-20
52798460439,52798460427,-12,1399,1530,-20
52799234530,52799234525,-5,1411,3910,-20
52802050997,52802050983,-14,1678,1698,-20
52802907761,52802907764,3,1826,1714,-20
52804258214,52804258218,4,1586,1184,-20
52804972201,52804972205,4,1890,1783,-20
52809622924,52809622926,2,1693,1202,-20
52811495337,52811495342,5,1736,1184,-20
52811531254,52811531259,5,1458,710,-20
52812663862,52812663842,-20,1571,1016,-20
52812988255,52812988260,5,2061,1480,-20
52813339151,52813339153,2,1533,1533,-20
52813712086,52813712091,5,2147,1369,-20
52816075038,52816075044,6,2765,1215,-20
52820014562,52820014562,0,1046,676,-20
52821520174,52821520177,3,2077,1492,-20
52822224778,52822224782,4,1533,1306,-20
52823968026,52823968036,10,1243,1100,-20
52826582079,52826582082,3,2037,1376,-20
52826912066,52826912070,4,1765,1119,-20
52830100608,52830100611,3,1726,1549,-20
52831354006,52831354009,3,2142,1842,-20
52831830882,52831830886,4,2048,1928,-20
52832719740,52832719745,5,1554,1101,-20
52833643731,52833643738,7,5149,1275,-20
52837726754,52837726753,-1,1538,1819,-20
52840071225,52840071231,6,1569,1609,-20
52840859474,52840859478,4,1229,871,-20
52841609941,52841609943,2,1470,1234,-20
52844110316,52844110325,9,258,1835,-20
52849441454,52849441457,3,1654,1548,-20
52851609799,52851609802,3,1999,1527,-20
52853198533,52853198539,6,1949,1412,-20
52853613554,52853613558,4,1389,962,-20
52855023444,52855023445,1,12324,15271,-20
52856726570,52856726574,4,1763,1745,-20
52859905553,52859905557,4,1703,1159,-20
52863779323,52863779326,3,1286,930,-20
52865550133,52865550142,9,12204,24706,-20
52866181889,52866181890,1,1465,1318,-20
52866976934,52866976936,2,1837,1129,-20
52867804058,52867804059,1,1547,1277,-20
52871515546,52871515550,4,2030,1454,-20
52872847124,52872847129,5,2548,1900,-20
52872877350,52872877350,0,1290,1378,-20
52877536037,52877536040,3,1891,1544,-20
52878063745,52878063749,4,2353,1482,-20
52883458829,52883458811,-18,830,738,-20
52885404662,52885404665,3,1590,1536,-20
52889700690,52889700691,1,1698,1384,-20
52890237850,52890237854,4,2172,1483,-20
52891589126,52891589130,4,2102,1577,-20
52892019591,52892019594,3,2213,1410,-20
52892424893,52892424894,1,1535,1226,-20
52894314992,52894314993,1,1695,1547,-20
52899079661,52899079666,5,1796,1537,-20
52899211318,52899211320,2,1786,1882,-20
52903830513,52903830513,0,1500,1800,-20
52905922294,52905922298,4,1687,1593,-20
52907148844,52907148848,4,1608,1043,-20
52908106094,52908106098,4,2794,1577,-20
52910287237,52910287241,4,1929,1553,-20
52910319194,52910319195,1,1487,1681,-20
52916662829,52916662835,6,2218,972,-20
52917504007,52917504012,5,2701,1689,-20
52921172779,52921172784,5,2139,1498,-20
52924079413,52924079416,3,1228,1051,-20
52924978650,52924978653,3,1847,1294,-20
52925308591,52925308593,2,1375,1450,-20
52929774759,52929774765,6,3660,1689,-20
52932891510,52932891512,2,1896,1669,-20
52936023275,52936023277,2,1393,1377,-20
52937799231,52937799231,0,1395,2057,-20
52939675068,52939675071,3,1238,1359,-20
52941928597,52941928601,4,754,799,-20
52942432090,52942432094,4,2537,1773,-20
52943493984,52943493986,2,1784,1172,-20
52943847439,52943847444,5,808,997,-20
52943910554,52943910558,4,1765,1518,-20
52947407059,52947407063,4,1507,1380,-20
52951225142,52951225146,4,1691,1048,-20
52955357788,52955357772,-16,32939,18711,-20
52955761682,52955761688,6,1919,1260,-20
52957814712,52957814714,2,1271,1510,-20
52958391479,52958391481,2,2137,1202,-20
52958516036,52958516017,-19,909,1252,-20
52962349698,52962349702,4,1772,1514,-20
52963419705,52963419708,3,1804,1341,-20
52966330309,52966330313,4,2117,1535,-20
52968315022,52968315022,0,1075,1107,-20
52970138582,52970138586,4,2102,1707,-20
52971887511,52971887515,4,1882,1381,-20
52975354382,52975354387,5,1607,1102,-20
52976765290,52976765295,5,1466,1083,-20
52977649552,52977649556,4,1534,1478,-20
52979605317,52979605320,3,2176,1488,-20
52980717201,52980717205,4,2117,1362,-20
52981006102,52981006106,4,2332,1217,-20
52981418890,52981418893,3,1731,1272,-20
52983998490,52983998493,3,1717,1445,-20
52984124853,52984124856,3,2205,1775,-20
52984404657,52984404673,16,2315,1603,-20
52985582996,52985582998,2,733,959,-20
52989468982,52989468982,0,1693,1697,-20
52991764591,52991764594,3,1425,780,-20
52992024740,52992024742,2,1422,1244,-20
52992399306,52992399309,3,1450,1378,-20
52996045884,52996045887,3,1398,967,-20
52996723668,52996723670,2,1472,1178,-20
52998859073,52998859077,4,2206,2130,-20
53001539775,53001539774,-1,1266,2151,-20
53003804610,53003804614,4,1897,979,-20
53004039764,53004039766,2,2696,2032,-20
53006911392,53006911397,5,1699,935,-20
53009640429,53009640432,3,1650,1013,-20
53021324280,53021324283,3,2527,1695,-20
53026190151,53026190156,5,2052,1476,-20
53026895995,53026895997,2,1781,1179,-20
53027666438,53027666419,-19,2329,1431,-20
53030645238,53030645238,0,1600,2102,-20
53031754046,53031754050,4,1936,1187,-20
53031926275,53031926275,0,1653,1274,-20
53032997928,53032997930,2,1186,867,-20
53033947750,53033947755,5,1043,924,-20
53035518017,53035518022,5,1490,1168,-20
53037186540,53037186542,2,1077,1446,-20
53037265437,53037265438,1,1702,1721,-20
53038216891,53038216893,2,1364,1650,-20
53039604806,53039604809,3,1465,1133,-20
53039927282,53039927284,2,1709,1912,-20
53040591900,53040591903,3,2057,1508,-20
53046636355,53046636366,11,15659,20936,-20
53046704803,53046704802,-1,1203,967,-20
53049733374,53049733377,3,1815,1493,-20
53052941999,53052942005,6,2246,1259,-20
53055161639,53055161642,3,1728,1056,-20
53055274002,53055273985,-17,2101,1575,-20
53055573462,53055573465,3,1979,1705,-20
53056011578,53056011583,5,2530,1138,-20
53058688013,53058688016,3,2139,1610,-20
53059729581,53059729586,5,1222,1041,-20
53060121137,53060121139,2,1030,1303,-20
53064300161,53064300166,5,1674,1007,-20
53065412067,53065412071,4,1706,1476,-20
53066236963,53066236965,2,2159,1735,-20
53066889854,53066889857,3,1634,1555,-20
53069239015,53069239018,3,1539,1115,-20
53069742071,53069742077,6,2150,998,-20
53071436302,53071436298,-4,1690,1143,-20
53072095894,53072095899,5,1323,997,-20
53077586522,53077586523,1,1823,947,-20
53078039361,53078039362,1,2370,2374,-20
53079288415,53079288420,5,2974,1869,-20
53080589769,53080589774,5,2332,1048,-20
53085143280,53085143283,3,2184,1444,-20
53089652530,53089652534,4,1355,1062,-20
53091400194,53091400197,3,2453,1756,-20
53091758933,53091758937,4,2055,1587,-20
53092997584,53092997588,4,2638,1612,-20
53094736503,53094736499,-4,1007,2703,-20
53099969515,53099969519,4,2031,1589,-20
53102460537,53102460540,3,2137,1970,-20
53103984355,53103984354,-1,547,1017,-20
53106333337,53106333339,2,1424,1141,-20
53106419594,53106419598,4,1715,1459,-20
53107154967,53107154967,0,24963,21507,-20
53111216930,53111216933,3,2389,1606,-20
53112597261,53112597262,1,1495,1293,-20
53112870226,53112870210,-16,1332,625,-20
53113114181,53113114184,3,1616,1339,-20
53113625973,53113625978,5,1711,1080,-20
53115575313,53115575315,2,1573,1447,-20
53116836132,53116836135,3,1684,1014,-20
53116890603,53116890584,-19,1700,969,-20
53119631305,53119631306,1,2130,1781,-20
53125713890,53125713893,3,1801,1266,-20
53128821210,53128821215,5,1813,1416,-20
53130441617,53130441619,2,1458,1735,-20
53131753649,53131753652,3,1635,1219,-20
53131916256,53131916260,4,1650,1648,-20
53133443093,53133443094,1,2369,2059,-20
53136154140,53136154140,0,1350,1535,-20
53136419928,53136419938,10,1632,1388,-20
53136643781,53136643785,4,1585,1889,-20
53137516186,53137516191,5,1820,1808,-20
53137834204,53137834209,5,2027,1374,-20
53139014684,53139014687,3,1389,1345,-20
53140268332,53140268335,3,2289,1521,-20
53146716965,53146716970,5,1371,1191,-20
53148688163,53148688167,4,1352,1102,-20
53148930022,53148930027,5,1983,1160,-20
53149052834,53149052838,4,2688,2290,-20
53151333412,53151333415,3,1324,1220,-20
53153512474,53153512469,-5,1365,4688,-20
53157563710,53157563710,0,2536,3119,-20
53158044082,53158044083,1,1994,2190,-20
53162749617,53162749618,1,1481,872,-20
53165060280,53165060281,1,2044,1850,-20
53167443834,53167443839,5,1907,1354,-20
53174140159,53174140162,3,1810,1181,-20
53175254510,53175254514,4,2031,1537,-20
53175683780,53175683783,3,1295,816,-20
53176451856,53176451862,6,4517,2035,-20
53183841135,53183841139,4,2026,1612,-20
53185372627,53185372633,6,6147,2987,-20
53191470140,53191470145,5,2444,1513,-20
53193413772,53193413774,2,1457,1304,-20
53202803311,53202803314,3,1545,1085,-20
53203081033,53203081018,-15,782,393,-20
53204385854,53204385861,7,4697,1807,-20
53207182779,53207182781,2,1531,1304,-20
53207284137,53207284143,6,1445,1246,-20
53208244280,53208244286,6,3813,1908,-20
53212753485,53212753492,7,1429,702,-20
53213184425,53213184428,3,1832,1964,-20
53215640554,53215640556,2,1625,1342,-20
53216254699,53216254698,-1,905,1024,-20
53220253447,53220253452,5,1606,1408,-20
53222993516,53222993519,3,1607,1144,-20
53224456079,53224456082,3,1485,1929,-20
53226834417,53226834420,3,1490,1132,-20
53228294661,53228294663,2,1295,1578,-20
53230878678,53230878682,4,1857,1343,-20
53231613791,53231613795,4,1895,1725,-20
53232358722,53232358725,3,1540,1724,-20
53234210881,53234210885,4,1527,1029,-20
53243336345,53243336347,2,1566,1653,-20
53249723930,53249723933,3,2286,1301,-20
53251271243,53251271246,3,1466,1191,-20
53253304643,53253304646,3,1623,1421,-20
53256030220,53256030223,3,1835,1078,-20
53256800329,53256800330,1,1889,1013,-20
53261013486,53261013490,4,2740,1222,-20
53264602810,53264602813,3,1183,1264,-20
53266754133,53266754131,-2,1071,934,-20
53270615037,53270615040,3,1756,1986,-20
53275719498,53275719502,4,1567,1507,-20
53276275131,53276275134,3,1381,1217,-20
53277123318,53277123322,4,1719,1494,-20
53277377546,53277377551,5,2108,1061,-20
53285264584,53285264587,3,2224,1682,-20
53285682650,53285682654,4,2089,2027,-20
53286550306,53286550309,3,1026,1381,-20
53288266303,53288266308,5,1797,1597,-20
53289735466,53289735470,4,2381,1430,-20
53290723314,53290723317,3,1563,1278,-20
53291259182,53291259187,5,1297,1095,-20
53292557627,53292557631,4,1396,997,-20
53292612950,53292612951,1,1141,1570,-20
53295171398,53295171402,4,2248,1260,-20
53295811246,53295811251,5,2160,1322,-20
53296843348,53296843361,13,916,1667,-20
53297135088,53297135089,1,1597,1203,-20
53298468842,53298468847,5,1423,1969,-20
53302062667,53302062678,11,12496,40162,-20
53302292237,53302292237,0,1856,2146,-20
53302447856,53302447859,3,2374,1252,-20
53302499275,53302499288,13,639,385,-20
53302606816,53302606835,19,1018,25,-20
53307669636,53307669639,3,1630,995,-20
53309345312,53309345317,5,2052,1458,-20
53310295114,53310295119,5,2033,1600,-20
53314496091,53314496094,3,2060,1682,-20
53315392845,53315392848,3,1545,1576,-20
53316533350,53316533352,2,2039,1324,-20
53317827260,53317827262,2,2425,1759,-20
53319639894,53319639895,1,3145,3641,-20
53324943822,53324943826,4,2257,1123,-20
53325004289,53325004293,4,2535,1290,-20
53325079094,53325079097,3,1743,1285,-20
53325201429,53325201426,-3,1338,3340,-20
53327206874,53327206879,5,2676,2018,-20
53331017095,53331017099,4,2075,1449,-20
53333072747,53333072753,6,2077,1424,-20
53333207718,53333207723,5,3739,1114,-20
53335804666,53335804670,4,1998,1215,-20
53337417946,53337417948,2,1751,1394,-20
53338539370,53338539370,0,841,855,-20
53338982001,53338982004,3,2265,1866,-20
53342243866,53342243868,2,1442,1891,-20
53342745716,53342745718,2,1730,1415,-20
53342809021,53342809001,-20,1763,1446,-20
53343567271,53343567275,4,1394,1662,-20
53347362820,53347362825,5,2884,1647,-20
53348422261,53348422265,4,1494,1524,-20
53352235857,53352235862,5,1462,1187,-20
53353182459,53353182462,3,2587,1596,-20
53358977145,53358977145,0,1152,1199,-20
53359419725,53359419733,8,3909,1904,-20
53359484595,53359484596,1,1441,1577,-20
53361501303,53361501305,2,2166,1621,-20
53367135313,53367135315,2,1273,1254,-20
53368345149,53368345146,-3,1262,1967,-20
53369362441,53369362443,2,1767,1783,-20
53369620286,53369620287,1,1572,947,-20
53370491190,53370491169,-21,1620,1375,-20
53371042957,53371042961,4,2670,1615,-20
53377149496,53377149500,4,2620,1181,-20
53378397519,53378397521,2,2591,1417,-20
53380973472,53380973479,7,3182,1745,-20
53382023367,53382023365,-2,1143,2097,-20
53382607350,53382607358,8,4895,1500,-20
53383723376,53383723379,3,1337,1259,-20
53385333479,53385333480,1,1975,1480,-20
53385840298,53385840302,4,1347,1061,-20
53388314167,53388314161,-6,1029,4465,-20
53389277872,53389277875,3,1867,1550,-20
53395495775,53395495777,2,1560,1282,-20
53397333665,53397333670,5,2606,1867,-20
53397729262,53397729263,1,1658,1565,-20
53398780588,53398780590,2,1398,1376,-20
53399252285,53399252286,1,1367,2047,-20
53401517310,53401517313,3,2190,1637,-20
53404370929,53404370932,3,1248,1205,-20
53404873565,53404873560,-5,2080,7567,-20
53405096570,53405096573,3,1509,1317,-20
53405689918,53405689921,3,815,959,-20
53407649326,53407649333,7,1921,1244,-20
53408246978,53408246982,4,2243,1325,-20
53415814325,53415814328,3,2486,1310,-20
53417033830,53417033837,7,2062,1515,-20
53419158041,53419158042,1,1529,1169,-20
53420007937,53420007941,4,2341,1331,-20
53421034049,53421034050,1,1614,1213,-20
53423476459,53423476462,3,1656,1049,-20
53424430333,53424430334,1,2843,2269,-20
53425569449,53425569453,4,1199,940,-20
53426803271,53426803275,4,1887,1405,-20
53427322651,53427322645,-6,2709,7786,-20
53427492238,53427492239,1,1132,1121,-20
53429841614,53429841617,3,1159,1595,-20
53433916749,53433916753,4,1174,1148,-20
53435662858,53435662861,3,1369,935,-20
53437068263,53437068265,2,1697,1518,-20
53438390013,53438390011,-2,27913,5787,-20
53442167593,53442167595,2,1998,1385,-20
53446994111,53446994114,3,1696,1782,-20
53448591859,53448591861,2,1168,970,-20
53450722958,53450722960,2,1744,1267,-20
53453552163,53453552161,-2,1429,2783,-20
53454534934,53454534938,4,2283,1388,-20
53458686850,53458686856,6,1884,1602,-20
53459113594,53459113594,0,1142,1555,-20
53459890997,53459890979,-18,3326,1912,-20
53461288687,53461288691,4,1621,961,-20
53463004354,53463004360,6,1733,1217,-20
53464421871,53464421873,2,972,960,-20
53465223275,53465223282,7,1214,1134,-20
53473419318,53473419323,5,1800,936,-20
53473490293,53473490297,4,2296,1762,-20
53474861897,53474861883,-14,2186,1190,-20
53475504085,53475504085,0,35557,26141,-20
53475716583,53475716585,2,960,1044,-20
53478458382,53478458386,4,2320,1618,-20
53480685786,53480685790,4,1225,1521,-20
53482846835,53482846842,7,974,1105,-20
53484083742,53484083745,3,1639,1360,-20
53487646756,53487646759,3,1906,1276,-20
53487952883,53487952887,4,2240,1869,-20
53488492006,53488492010,4,1403,1293,-20
53491939166,53491939170,4,1418,1053,-20
53492178076,53492178080,4,2307,2487,-20
53496016515,53496016522,7,691,238,-20
53496290089,53496290090,1,984,1709,-20
53498163007,53498163012,5,1799,1632,-20
53499791482,53499791485,3,2126,1307,-20
53500195429,53500195432,3,1492,1615,-20
53505932869,53505932873,4,2278,1495,-20
53506992655,53506992657,2,1880,1450,-20
53511334102,53511334105,3,1826,1344,-20
53511840619,53511840623,4,1907,1329,-20
53512115974,53512115984,10,15346,33267,-20
53514924295,53514924294,-1,935,1176,-20
53515949263,53515949267,4,1978,1443,-20
53518766909,53518766915,6,1629,1125,-20
53519420739,53519420741,2,1403,1193,-20
53520135285,53520135289,4,1831,968,-20
53524161700,53524161703,3,1706,1816,-20
53524404942,53524404948,6,1753,1017,-20
53525033202,53525033190,-12,1192,1071,-20
53526140250,53526140255,5,2466,1309,-20
53527896621,53527896623,2,1663,1159,-20
53530526450,53530526455,5,1393,1295,-20
53532316134,53532316134,0,1423,1249,-20
53535195104,53535195107,3,1754,1341,-20
53537350800,53537350802,2,1848,1772,-20
53537905654,53537905657,3,1762,1401,-20
53539513629,53539513633,4,1887,1269,-20
53545452662,53545452668,6,2539,1954,-20
53548866491,53548866497,6,2016,1888,-20
53557546024,53557546026,2,1849,1638,-20
53558187490,53558187491,1,1325,878,-20
53559876339,53559876343,4,1836,1218,-20
53561493521,53561493511,-10,1754,2103,-20
53565028819,53565028823,4,1832,1295,-20
53566184994,53566184997,3,2339,1201,-20
53568555362,53568555364,2,971,1641,-20
53569631845,53569631850,5,2131,1288,-20
53569684030,53569684050,20,850,318,-20
53571972821,53571972822,1,1835,1522,-20
53572352669,53572352673,4,2147,1383,-20
53572849208,53572849210,2,1896,1562,-20
53578127859,53578127862,3,2461,1724,-20
53579650273,53579650274,1,1735,1058,-20
53584592817,53584592819,2,1716,1509,-20
53585508734,53585508738,4,2438,1578,-20
53588074323,53588074328,5,1958,1184,-20
53591471772,53591471777,5,2316,1303,-20
53592451371,53592451374,3,896,526,-20
53593884682,53593884689,7,3749,1041,-20
53593969693,53593969675,-18,808,410,-20
53596408643,53596408646,3,1783,1245,-20
53597245962,53597245962,0,1234,2663,-20
53598275533,53598275537,4,1686,1389,-20
53602271207,53602271210,3,1409,1168,-20
53604367996,53604367998,2,1613,1118,-20
53604508243,53604508236,-7,957,4964,-20
53605604443,53605604444,1,2639,2763,-20
53607256036,53607256036,0,953,1585,-20
53611809921,53611809925,4,1347,1321,-20
53613084674,53613084678,4,1708,1215,-20
53614145370,53614145374,4,1868,1006,-20
53615137269,53615137272,3,1223,1195,-20
53617428423,53617428420,-3,2743,5106,-20
53617488852,53617488846,-6,1698,7325,-20
53618194386,53618194388,2,1388,1379,-20
53618927870,53618927873,3,2259,1438,-20
53626530141,53626530145,4,1901,1551,-20
53628521786,53628521786,0,958,1653,-20
53629692679,53629692681,2,1684,1332,-20
53630578311,53630578318,7,1699,1137,-20
53631091299,53631091302,3,1253,1051,-20
53633485769,53633485773,4,1902,1588,-20
53634468862,53634468866,4,1333,729,-20
53635620242,53635620246,4,1216,1163,-20
53641263674,53641263671,-3,2091,4218,-20
53642846085,53642846089,4,2376,1776,-20
53644854289,53644854290,1,2560,2235,-20
53646172146,53646172150,4,1516,900,-20
53647841144,53647841150,6,2572,1902,-20
53648561366,53648561369,3,10787,18900,-20
53649193562,53649193557,-5,2133,5677,-20
53650807818,53650807822,4,1431,1355,-20
53652024408,53652024411,3,2437,1622,-20
53653902178,53653902182,4,1652,2144,-20
53654518520,53654518522,2,2089,2022,-20
53655534621,53655534623,2,1550,838,-20
53662359891,53662359895,4,1672,1125,-20
53667125638,53667125642,4,1775,1544,-20
53670154005,53670154007,2,1813,1026,-20
53671403403,53671403392,-11,38605,11043,-20
53672244192,53672244198,6,1032,1063,-20
53675904822,53675904801,-21,1298,835,-20
53676583067,53676583070,3,1998,1582,-20
53677485448,53677485452,4,2098,1520,-20
53677918895,53677918898,3,1547,1416,-20
53682200338,53682200344,6,1838,1665,-20
53682972138,53682972142,4,2390,1921,-20
53684242153,53684242155,2,1840,1077,-20
53686385134,53686385138,4,2011,990,-20
53687674878,53687674882,4,1622,681,-20
53692573021,53692573024,3,2030,1192,-20
53694385248,53694385250,2,1826,1490,-20
53696178896,53696178902,6,4897,2226,-20
53697490990,53697490991,1,1976,1736,-20
53700613814,53700613817,3,1238,1154,-20
53701093094,53701093072,-22,1861,1352,-20
53701268287,53701268265,-22,1619,1529,-20
53703025081,53703025084,3,1988,1387,-20
53705897480,53705897485,5,2668,2226,-20
53708768509,53708768515,6,2191,1386,-20
53712279695,53712279699,4,1618,1205,-20
53713654295,53713654299,4,1508,939,-20
53714425935,53714425939,4,1362,1252,-20
53718187478,53718187482,4,2834,1473,-20
53718974153,53718974157,4,1843,1835,-20
53719611885,53719611889,4,1831,1019,-20
53719787244,53719787258,14,916,294,-20
53725634234,53725634238,4,1333,1140,-20
53726863916,53726863919,3,1191,1494,-20
53727582786,53727582789,3,1869,1431,-20
53727918529,53727918534,5,2398,1413,-20
53728987488,53728987492,4,1818,1005,-20
53731717372,53731717375,3,2700,1813,-20
53731847914,53731847918,4,2019,1366,-20
53732023681,53732023682,1,1960,1347,-20
53734021697,53734021699,2,1685,1293,-20
53736492024,53736492027,3,1816,934,-20
53737654577,53737654579,2,1006,980,-20
53739429899,53739429901,2,11276,10776,-20
53740577919,53740577916,-3,927,1834,-20
53741817664,53741817667,3,2795,1358,-20
53745232852,53745232857,5,1231,1035,-20
53745718261,53745718262,1,1950,1647,-20
53748282077,53748282081,4,1875,1367,-20
53748727105,53748727107,2,2181,1028,-20
53749051293,53749051295,2,1481,1980,-20
53750269428,53750269430,2,1665,1488,-20
53750637582,53750637582,0,1509,1453,-20
53752109663,53752109667,4,1650,1298,-20
53756487576,53756487581,5,1512,1512,-20
53756924010,53756924012,2,1799,1392,-20
53762213957,53762213962,5,1996,1441,-20
53762548440,53762548435,-5,791,1602,-20
53764570785,53764570789,4,1378,966,-20
53771038188,53771038191,3,1390,1394,-20
53772023478,53772023479,1,1644,1096,-20
53772765418,53772765422,4,2146,1169,-20
53774515845,53774515849,4,2323,1763,-20
53776524650,53776524654,4,2606,1068,-20
53779806564,53779806567,3,1810,1255,-20
53782168053,53782168059,6,1758,1066,-20
53783237117,53783237122,5,2454,1584,-20
53784038170,53784038172,2,1738,1560,-20
53791779893,53791779897,4,1901,1438,-20
53795187245,53795187249,4,2147,1620,-20
53796982346,53796982350,4,1989,1018,-20
53797521238,53797521221,-17,635,3890,-20
53800757792,53800757798,6,1975,1365,-20
53801435322,53801435328,6,2072,1076,-20
53805055139,53805055143,4,1882,1563,-20
53806771159,53806771158,-1,3252,3692,-20
53806960800,53806960798,-2,1586,2236,-20
53810822762,53810822764,2,1708,1363,-20
53811983141,53811983144,3,1509,1202,-20
53812322957,53812322959,2,1459,1394,-20
53815108027,53815108027,0,1298,774,-20
53819594063,53819594067,4,1580,1096,-20
53820780293,53820780294,1,1256,1078,-20
53822000175,53822000178,3,3926,2787,-20
53822648809,53822648813,4,2912,2057,-20
53825481926,53825481929,3,2044,1722,-20
53826001275,53826001279,4,1372,1296,-20
53826832421,53826832423,2,1380,885,-20
53829328917,53829328919,2,1463,1448,-20
53829831270,53829831274,4,1481,859,-20
53830556440,53830556443,3,2174,1598,-20
53832193654,53832193658,4,2473,1697,-20
53833442415,53833442418,3,2778,1424,-20
53833832614,53833832628,14,2370,1460,-20
53834768569,53834768573,4,2564,2170,-20
53837550171,53837550175,4,1338,1133,-20
53838704819,53838704822,3,3704,3972,-20
53840682484,53840682486,2,2534,2053,-20
53843197738,53843197741,3,1589,1431,-20
53845105245,53845105247,2,1953,1701,-20
53854173133,53854173135,2,1053,1112,-20
53855732364,53855732367,3,1721,856,-20
53857182466,53857182473,7,5160,1508,-20
53857257636,53857257620,-16,1552,1079,-20
53859484707,53859484710,3,1259,1519,-20
53862905603,53862905607,4,1802,2060,-20
53863536821,53863536824,3,2253,1619,-20
53864478270,53864478270,0,1731,2366,-20
53864700282,53864700288,6,2367,1317,-20
53866311499,53866311502,3,1421,2022,-20
53866784892,53866784895,3,1747,1131,-20
53867681585,53867681589,4,1837,1074,-20
53867719163,53867719161,-2,2111,3516,-20
53868497912,53868497917,5,1822,1100,-20
53873497866,53873497869,3,1756,1167,-20
53874323140,53874323145,5,2475,1639,-20
53874524114,53874524119,5,2834,2206,-20
53875437222,53875437227,5,1952,1076,-20
53877699573,53877699575,2,1296,1452,-20
53879308934,53879308937,3,2274,1587,-20
53879380912,53879380914,2,1644,1728,-20
53883195030,53883195034,4,1904,1711,-20
53889425491,53889425493,2,1102,1646,-20
53891664160,53891664162,2,1723,1754,-20
53896556895,53896556899,4,1608,1355,-20
53897258139,53897258141,2,2131,1452,-20
53897734567,53897734571,4,1953,1552,-20
53897814586,53897814591,5,1746,1773,-20
53903213270,53903213278,8,6285,2806,-20
53906253077,53906253080,3,1934,1299,-20
53910514026,53910514031,5,1894,1141,-20
53915017388,53915017391,3,2142,1277,-20
53915561359,53915561362,3,1797,1557,-20
53924197226,53924197223,-3,633,233,-20
53925928913,53925928917,4,2344,1600,-20
53928320815,53928320818,3,1795,1385,-20
53934484489,53934484491,2,1502,1778,-20
53934577012,53934577018,6,2849,1748,-20
53934890564,53934890567,3,2344,842,-20
53934961943,53934961945,2,2527,1849,-20
53935675786,53935675790,4,2084,1372,-20
53938907271,53938907275,4,1794,956,-20
53938981507,53938981510,3,1478,1258,-20
53939209946,53939209962,16,1437,808,-20
53941393894,53941393898,4,1385,973,-20
53943174579,53943174582,3,1403,907,-20
53943797970,53943797976,6,2223,1047,-20
53946385834,53946385837,3,2482,1052,-20
53949100467,53949100471,4,2096,1219,-20
53956499205,53956499209,4,2731,1474,-20
53957316401,53957316403,2,1684,973,-20
53959528070,53959528074,4,2385,1420,-20
53961232730,53961232734,4,2106,1502,-20
53965115161,53965115163,2,1361,1234,-20
53965856819,53965856822,3,1326,1288,-20
53967661531,53967661534,3,1518,1474,-20
53968088285,53968088287,2,1217,933,-20
53969968900,53969968903,3,1677,1572,-20
53970105140,53970105142,2,2439,1266,-20
53970539702,53970539706,4,2171,1245,-20
53970900986,53970900987,1,1448,1618,-20
53973872017,53973872020,3,1903,1283,-20
53975380570,53975380573,3,3243,1463,-20
53978922511,53978922515,4,1596,1365,-20
53979611329,53979611321,-8,1804,9962,-20
53981946419,53981946424,5,2272,1727,-20
53982600602,53982600605,3,2159,1469,-20
53988035887,53988035889,2,1191,1332,-20
53988188673,53988188675,2,2002,1432,-20
53988863770,53988863773,3,2072,1486,-20
53991645082,53991645086,4,2274,1663,-20
53996263154,53996263154,0,2076,1830,-20
53997400329,53997400330,1,1461,1345,-20
53997634803,53997634805,2,1651,1545,-20
53999405704,53999405707,3,2709,2107,-20
54006126211,54006126217,6,2052,639,-20
54010744841,54010744845,4,1677,1216,-20
54014279688,54014279691,3,1928,1223,-20
54016573492,54016573494,2,1529,1162,-20
54029740576,54029740579,3,1394,1164,-20
54030330938,54030330945,7,3806,802,-20
54031373594,54031373577,-17,1455,1127,-20
54033197244,54033197248,4,1976,1210,-20
54035708754,54035708758,4,2560,1568,-20
54039609211,54039609214,3,2112,1620,-20
54049223484,54049223485,1,1345,1160,-20
54050288425,54050288426,1,1541,1383,-20
54050781759,54050781768,9,1325,736,-20
54055972730,54055972734,4,1821,1219,-20
54059820945,54059820949,4,2484,1374,-20
54063905758,54063905753,-5,875,2779,-20
54065165350,54065165353,3,1716,1272,-20
54068761997,54068761999,2,2067,936,-20
54069064426,54069064429,3,1582,1440,-20
54070456707,54070456712,5,2895,1608,-20
54070938878,54070938881,3,2302,1721,-20
54073641778,54073641781,3,1256,1403,-20
54073835210,54073835213,3,2094,1127,-20
54076857501,54076857504,3,1350,1215,-20
54079939898,54079939901,3,2026,1200,-20
54080333434,54080333427,-7,724,248,-20
54082812002,54082811984,-18,2968,1936,-20
54089059026,54089059030,4,1884,1297,-20
54089544365,54089544369,4,1997,1347,-20
54092581251,54092581254,3,2126,1027,-20
54094700306,54094700310,4,1235,1254,-20
54096771498,54096771501,3,2401,1757,-20
54098164795,54098164799,4,643,642,-20
54100649742,54100649724,-18,806,520,-20
54104767948,54104767951,3,1847,1095,-20
54108009406,54108009409,3,1613,1087,-20
54108304012,54108304018,6,1770,1356,-20
54108680235,54108680243,8,4956,1172,-20
54109552226,54109552231,5,2037,1842,-20
54109818946,54109818951,5,1083,975,-20
54110782820,54110782822,2,1788,1602,-20
54110924094,54110924105,11,1091,1215,-20
54112836549,54112836552,3,1531,1385,-20
54114534006,54114534010,4,2097,892,-20
54116701754,54116701759,5,2264,1531,-20
54116897641,54116897643,2,1748,1211,-20
54123585840,54123585842,2,1068,837,-20
54125563154,54125563157,3,2100,1944,-20
54129560719,54129560723,4,1008,902,-20
54131286313,54131286305,-8,1850,1195,-20
54133698262,54133698265,3,1739,1404,-20
54133933536,54133933539,3,1237,1263,-20
54136108418,54136108420,2,1717,1015,-20
54136707600,54136707603,3,1445,1249,-20
54137594701,54137594705,4,1735,1545,-20
54142529818,54142529821,3,1970,1756,-20
54145308661,54145308666,5,1492,1346,-20
54149022337,54149022337,0,1956,1568,-20
54149537888,54149537891,3,2013,1228,-20
54152283423,54152283425,2,1864,1746,-20
54154127450,54154127454,4,2122,2053,-20
54155278667,54155278670,3,2325,1455,-20
54156444637,54156444642,5,2936,1274,-20
54156638009,54156638013,4,1607,1397,-20
54157034577,54157034582,5,1608,1310,-20
54157679738,54157679724,-14,2259,1895,-20
54158779325,54158779327,2,2386,2058,-20
54163236299,54163236303,4,2714,2248,-20
54165234886,54165234889,3,1987,1434,-20
54165420483,54165420486,3,1909,1419,-20
54165779805,54165779785,-20,1191,645,-20
54166746561,54166746563,2,1749,1463,-20
54167573246,54167573254,8,1051,594,-20
54168828093,54168828095,2,2420,1475,-20
54170091767,54170091769,2,2042,1028,-20
54174320864,54174320866,2,1311,1335,-20
54175462729,54175462732,3,1536,645,-20
54175875069,54175875073,4,2082,1348,-20
54180950949,54180950952,3,1844,1410,-20
54183739760,54183739763,3,1469,1216,-20
54184220570,54184220574,4,2105,1724,-20
54184778682,54184778686,4,1454,1241,-20
54185611724,54185611725,1,33905,28167,-20
54187787808,54187787812,4,1958,1653,-20
54188129078,54188129086,8,3394,1032,-20
54191059854,54191059858,4,1733,1215,-20
54191180297,54191180301,4,1789,1417,-20
54192359693,54192359696,3,1914,1398,-20
54192660150,54192660153,3,1691,1273,-20
54194542418,54194542423,5,2869,1412,-20
54197940501,54197940502,1,1714,1153,-20
54198777278,54198777283,5,2007,1541,-20
54200659326,54200659330,4,1865,1427,-20
54200923513,54200923514,1,1125,1354,-20
54206590635,54206590638,3,1491,1751,-20
54211526718,54211526721,3,2061,1785,-20
54215926795,54215926798,3,1892,1477,-20
54215974489,54215974493,4,1566,1670,-20
54217681765,54217681769,4,2046,1002,-20
54222146810,54222146811,1,1324,1150,-20
54223447476,54223447480,4,1877,1258,-20
54223669641,54223669642,1,1511,1569,-20
54224741903,54224741898,-5,915,3412,-20
54226629088,54226629093,5,88,1522,-20
54227534678,54227534658,-20,2024,964,-20
54227727312,54227727314,2,2131,1498,-20
54229668162,54229668166,4,1778,1342,-20
54229977369,54229977372,3,2640,1385,-20
54231385799,54231385801,2,2062,1286,-20
54237758082,54237758085,3,1244,1058,-20
54238343609,54238343613,4,2257,1924,-20
54239595335,54239595340,5,2097,1337,-20
54240009218,54240009222,4,1788,1404,-20
54241241840,54241241836,-4,1288,1235,-20
54242236882,54242236887,5,1753,1552,-20
54242803924,54242803925,1,1920,2236,-20
54249799063,54249799050,-13,53649,13936,-20
54251594730,54251594734,4,1729,1535,-20
54252593350,54252593354,4,1684,1599,-20
54259413567,54259413568,1,1035,1472,-20
54267609874,54267609882,8,4835,1309,-20
54268183200,54268183203,3,1167,1146,-20
54270388563,54270388566,3,1965,903,-20
54271023438,54271023441,3,2071,1300,-20
54272539469,54272539471,2,1484,1222,-20
54275780706,54275780711,5,1903,1619,-20
54276014411,54276014414,3,2129,1391,-20
54277133211,54277133218,7,2691,1373,-20
54279388880,54279388884,4,1678,1622,-20
54280393181,54280393161,-20,835,1192,-20
54283279294,54283279294,0,1057,2924,-20
54283906914,54283906915,1,745,912,-20
54284974505,54284974507,2,1105,1078,-20
54287875175,54287875177,2,2050,1324,-20
54293676510,54293676515,5,1878,1218,-20
54298404219,54298404221,2,1281,1603,-20
54299933853,54299933855,2,2327,1414,-20
54300242468,54300242472,4,1953,1642,-20
54301978301,54301978306,5,1580,1292,-20
54302577369,54302577374,5,1829,1193,-20
54305293737,54305293742,5,2356,1486,-20
54310504909,54310504911,2,1620,1287,-20
54311337940,54311337955,15,395,2849,-20
54311530569,54311530571,2,1829,1634,-20
54311769824,54311769814,-10,1456,1587,-20
54312477090,54312477097,7,1701,1187,-20
54315059665,54315059666,1,1719,996,-20
54315123691,54315123675,-16,4610,1628,-20
54315378610,54315378592,-18,704,411,-20
54317663800,54317663803,3,1942,1071,-20
54335024706,54335024709,3,1885,1995,-20
54335088535,54335088539,4,1254,992,-20
54338113532,54338113535,3,2057,1360,-20
54342860554,54342860555,1,1242,1361,-20
54350065586,54350065590,4,2054,1931,-20
54355664450,54355664452,2,2091,1444,-20
54356320747,54356320751,4,2779,1626,-20
54356981909,54356981913,4,1352,1176,-20
54357659239,54357659241,2,1199,1372,-20
54358178281,54358178282,1,1798,1476,-20
54361393557,54361393558,1,1325,1538,-20
54362672965,54362672966,1,1354,1325,-20
54363230901,54363230902,1,1330,1867,-20
54365293813,54365293817,4,1758,1967,-20
54369845351,54369845356,5,1838,1812,-20
54374531618,54374531621,3,1987,1496,-20
54384242438,54384242439,1,1314,1501,-20
54386428138,54386428141,3,1272,1374,-20
54387101045,54387101047,2,1774,1576,-20
54389329514,54389329514,0,1538,1166,-20
54389429983,54389429988,5,2112,1626,-20
54390392181,54390392181,0,1372,1412,-20
54390981149,54390981146,-3,1136,2355,-20
54395697641,54395697642,1,1352,1201,-20
54401970824,54401970828,4,1748,1429,-20
54402013193,54402013196,3,2320,1671,-20
54404414095,54404414098,3,1554,922,-20
54407374971,54407374974,3,2417,1648,-20
54407616045,54407616047,2,1876,1678,-20
54407748742,54407748747,5,1506,1349,-20
54408052472,54408052474,2,1282,1014,-20
54409116137,54409116141,4,1932,1023,-20
54409142282,54409142281,-1,1218,1507,-20
54410610712,54410610717,5,1571,1440,-20
54410737874,54410737868,-6,1433,5400,-20
54412924427,54412924430,3,1652,1360,-20
54414099798,54414099802,4,1374,1177,-20
54414634058,54414634063,5,2840,1564,-20
54417450109,54417450115,6,2279,1286,-20
54417478654,54417478657,3,1567,985,-20
54417939149,54417939152,3,2764,1203,-20
54418361513,54418361516,3,1195,1444,-20
54418643566,54418643569,3,1811,1451,-20
54419819855,54419819858,3,1589,1158,-20
54421410038,54421410042,4,2480,2133,-20
54424376951,54424376955,4,1095,1100,-20
54431576674,54431576678,4,2137,1254,-20
54432928241,54432928244,3,2455,1691,-20
54434815501,54434815505,4,2554,1400,-20
54435935277,54435935281,4,1657,1036,-20
54440712404,54440712410,6,12533,4159,-20
54440853385,54440853387,2,1882,1470,-20
54441356675,54441356678,3,854,1016,-20
54442336830,54442336834,4,2251,1313,-20
54442680962,54442680958,-4,1737,2364,-20
54443460711,54443460715,4,1737,1772,-20
54449379337,54449379341,4,1670,1634,-20
54450603959,54450603964,5,1233,1164,-20
54458288996,54458288996,0,811,788,-20
54458947153,54458947157,4,4324,3158,-20
54459962704,54459962708,4,3123,1294,-20
54461699883,54461699879,-4,1812,5440,-20
54462495006,54462495006,0,975,1811,-20
54466035368,54466035371,3,1643,1377,-20
54467536481,54467536476,-5,1440,2978,-20
54472388504,54472388507,3,1858,1181,-20
54473608925,54473608927,2,1112,668,-20
54473750322,54473750326,4,1918,1313,-20
54474641125,54474641123,-2,1708,1827,-20
54475390599,54475390601,2,2095,1260,-20
54478117186,54478117191,5,1559,1361,-20
54478717674,54478717675,1,1745,1643,-20
54484522435,54484522439,4,2021,1337,-20
54486534625,54486534631,6,3224,1169,-20
54488692517,54488692522,5,1663,1490,-20
54495219187,54495219185,-2,3067,5104,-20
54497204640,54497204643,3,1459,1737,-20
54497525882,54497525884,2,1822,1338,-20
54502383574,54502383576,2,2170,1572,-20
54506233294,54506233298,4,1475,1572,-20
54506467855,54506467859,4,1723,1144,-20
54507773785,54507773782,-3,1621,2846,-20
54508071782,54508071786,4,1471,1084,-20
54508576399,54508576403,4,3178,1770,-20
54511413826,54511413824,-2,1113,1276,-20
54511942877,54511942874,-3,774,1792,-20
54515283065,54515283067,2,1375,1095,-20
54517242915,54517242918,3,1822,1277,-20
54519064098,54519064100,2,34668,36103,-20
54527111732,54527111735,3,1691,1096,-20
54529272801,54529272803,2,2192,1790,-20
54529971865,54529971861,-4,2281,6918,-20
54538080998,54538081001,3,1509,1478,-20
54538247987,54538247990,3,2042,1780,-20
54538662101,54538662103,2,1645,920,-20
54539985089,54539985090,1,2474,1704,-20
54542907742,54542907746,4,2112,1412,-20
54543189234,54543189234,0,2332,1404,-20
54558211093,54558211098,5,2487,1347,-20
54561151426,54561151430,4,2473,1953,-20
54562629858,54562629862,4,1850,1190,-20
54564196483,54564196487,4,1577,1458,-20
54567855745,54567855749,4,8522,6648,-20
54568552080,54568552084,4,2098,1731,-20
54570878998,54570878999,1,892,1107,-20
54571799000,54571799004,4,1996,1409,-20
54577073526,54577073529,3,1691,1542,-20
54582823890,54582823890,0,1035,1033,-20
54584750650,54584750646,-4,1016,2504,-20
54586723797,54586723799,2,29133,17527,-20
54587943135,54587943138,3,1897,1465,-20
54589205460,54589205466,6,4416,1277,-20
54590200728,54590200730,2,1606,1362,-20
54590692466,54590692469,3,1305,1638,-20
54594271962,54594271962,0,1253,1281,-20
54594404426,54594404430,4,1497,1074,-20
54595977543,54595977545,2,1501,1346,-20
54596230065,54596230067,2,2281,1968,-20
54596703854,54596703856,2,1971,1662,-20
54597237285,54597237290,5,1499,1706,-20
54597798942,54597798942,0,719,1496,-20
54600329437,54600329441,4,1493,1483,-20
54600571100,54600571103,3,1775,1721,-20
54606130665,54606130670,5,2227,1375,-20
54606876487,54606876490,3,1009,1035,-20
54620070243,54620070247,4,1629,1461,-20
54621516203,54621516211,8,4730,2104,-20
54622654091,54622654095,4,2051,1331,-20
54626006062,54626006067,5,1166,1313,-20
54626150797,54626150801,4,1595,1093,-20
54632221376,54632221379,3,2009,1143,-20
54638621368,54638621370,2,1642,1158,-20
54639168681,54639168684,3,1720,1489,-20
54645314843,54645314842,-1,1422,2135,-20
54646907310,54646907311,1,1368,927,-20
54649392482,54649392487,5,3927,1828,-20
54649732111,54649732114,3,1471,1367,-20
54649965713,54649965710,-3,861,1878,-20
54651297453,54651297436,-17,1066,1172,-20
54651477623,54651477625,2,1842,1042,-20
54652862233,54652862235,2,1912,1291,-20
54654563275,54654563278,3,1259,1060,-20
54659637571,54659637574,3,3024,1611,-20
54660413097,54660413103,6,2246,1437,-20
54666854046,54666854047,1,1695,1590,-20
54667157207,54667157210,3,2037,965,-20
54669672702,54669672708,6,2074,1809,-20
54674851507,54674851509,2,1434,1185,-20
54675080388,54675080381,-7,34053,18311,-20
54675117538,54675117538,0,1602,1557,-20
54675346345,54675346347,2,1222,944,-20
54679022402,54679022406,4,946,1285,-20
54679669909,54679669914,5,1415,917,-20
54683174173,54683174155,-18,1666,1344,-20
54687823002,54687823007,5,1380,1439,-20
54688021337,54688021339,2,1745,1318,-20
54688462348,54688462351,3,1971,1332,-20
54690802021,54690802023,2,1912,1285,-20
54691921670,54691921672,2,2014,1690,-20
54695213400,54695213403,3,2490,1682,-20
54697506222,54697506225,3,1245,757,-20
54700456993,54700456996,3,2518,1588,-20
54705484827,54705484831,4,1912,1303,-20
54705680378,54705680379,1,1895,2373,-20
54706649682,54706649683,1,1434,2058,-20
54710402573,54710402576,3,2473,2084,-20
54713327011,54713326994,-17,1533,1809,-20
54713440717,54713440719,2,1396,1165,-20
54715230455,54715230457,2,1391,700,-20
54720179853,54720179839,-14,1408,1191,-20
54721867017,54721867021,4,2177,1313,-20
54722197491,54722197495,4,1833,898,-20
54723884688,54723884694,6,4094,16291,-20
54724347436,54724347441,5,2059,1507,-20
54725746544,54725746546,2,1899,1899,-20
54728045045,54728045049,4,1376,1295,-20
54729227941,54729227946,5,1660,975,-20
54729916759,54729916764,5,2415,1713,-20
54730444323,54730444331,8,4436,1693,-20
54734252486,54734252490,4,1404,1136,-20
54734352039,54734352019,-20,1038,839,-20
54734672315,54734672320,5,2198,1793,-20
54739424227,54739424230,3,880,1031,-20
54739556245,54739556248,3,2033,1432,-20
54741164421,54741164424,3,2053,1469,-20
54742188833,54742188837,4,1997,1489,-20
54742922177,54742922181,4,2343,1771,-20
54743242899,54743242902,3,1284,847,-20
54744398602,54744398606,4,1166,1001,-20
54746151301,54746151303,2,1700,1796,-20
54749823846,54749823853,7,2733,995,-20
54753226878,54753226880,2,1785,1305,-20
54754135308,54754135311,3,1635,1182,-20
54755570325,54755570327,2,2009,1267,-20
54756209470,54756209473,3,1890,1697,-20
54757529926,54757529925,-1,1674,2766,-20
54760629197,54760629198,1,1379,739,-20
54781037518,54781037522,4,2185,1320,-20
54782185707,54782185713,6,1860,1414,-20
54782765004,54782765005,1,1177,1010,-20
54785483900,54785483906,6,1732,1000,-20
54788088385,54788088389,4,1309,1262,-20
54789980160,54789980163,3,1568,877,-20
54795080346,54795080349,3,1505,1152,-20
54797879699,54797879707,8,2910,42497,-20
54799087726,54799087730,4,2317,1120,-20
54803376544,54803376549,5,1745,1367,-20
54810637774,54810637773,-1,1393,2612,-20
54811161686,54811161690,4,1691,1033,-20
54819363674,54819363679,5,2087,1305,-20
54819911365,54819911369,4,2163,1583,-20
54823260051,54823260054,3,945,848,-20
54825515641,54825515641,0,1748,2324,-20
54825685264,54825685266,2,1946,1102,-20
54827430062,54827430065,3,1894,1267,-20
54827597132,54827597134,2,1843,960,-20
54827642190,54827642179,-11,723,334,-20
54828688770,54828688774,4,2254,1176,-20
54831710385,54831710391,6,1727,1093,-20
54832327414,54832327419,5,1815,1126,-20
54834823150,54834823155,5,2114,1699,-20
54836058336,54836058340,4,1997,1784,-20
54837280567,54837280571,4,854,1010,-20
54838426705,54838426710,5,2117,1296,-20
54843174057,54843174058,1,1129,1669,-20
54843543502,54843543505,3,1716,770,-20
54845426043,54845426046,3,2096,1906,-20
54845825989,54845825991,2,1382,1739,-20
54851950107,54851950102,-5,689,1738,-20
54855464595,54855464600,5,2025,1029,-20
54856400001,54856400003,2,1875,1471,-20
54856445696,54856445696,0,1269,2395,-20
54856520174,54856520178,4,1907,1401,-20
54857456273,54857456272,-1,1373,1567,-20
54860541346,54860541349,3,1210,1009,-20
54861458171,54861458174,3,1663,1738,-20
54868965034,54868965030,-4,1892,4205,-20
54869386573,54869386585,12,1471,1157,-20
54871025656,54871025637,-19,954,2867,-20
54871104312,54871104314,2,1188,1189,-20
54873362381,54873362383,2,1673,1221,-20
54875431671,54875431674,3,3596,2245,-20
54875702931,54875702933,2,1469,1495,-20
54876881052,54876881054,2,2415,2056,-20
54877955719,54877955703,-16,1429,976,-20
54881703272,54881703277,5,1806,861,-20
54883217745,54883217750,5,1595,1249,-20
54885690016,54885690019,3,2924,1873,-20
54888223737,54888223741,4,1728,1647,-20
54891010297,54891010300,3,1470,1311,-20
54896614644,54896614650,6,1440,1427,-20
54897175083,54897175089,6,2303,1299,-20
54897843353,54897843358,5,1767,1057,-20
54913223685,54913223698,13,4,1158,-20
54914439138,54914439142,4,1205,1334,-20
54922253994,54922253998,4,1473,1700,-20
54926185868,54926185871,3,1305,1785,-20
54928724320,54928724324,4,1254,1332,-20
54935200933,54935200934,1,1332,1184,-20
54935796566,54935796584,18,2061,1708,-20
54937377066,54937377069,3,1583,1437,-20
54938828217,54938828219,2,1606,2168,-20
54939473537,54939473540,3,2263,1109,-20
54940332870,54940332871,1,1314,1141,-20
54940977913,54940977918,5,1590,1326,-20
54941787783,54941787787,4,1608,1304,-20
54943595350,54943595352,2,654,775,-20
54946771082,54946771087,5,1609,1201,-20
54949045362,54949045358,-4,1240,958,-20
54950490347,54950490341,-6,1918,8629,-20
54952497898,54952497902,4,1516,1297,-20
54953280793,54953280799,6,2017,1303,-20
54953370653,54953370659,6,1673,1186,-20
54954299550,54954299554,4,690,735,-20
54954833873,54954833877,4,2363,2032,-20
54955945289,54955945297,8,2358,897,-20
54956562894,54956562898,4,1289,990,-20
54957049642,54957049663,21,1672,1039,-20
54957301695,54957301698,3,1408,1109,-20
54959044646,54959044649,3,2504,1409,-20
54959227074,54959227079,5,1722,1317,-20
54960458942,54960458943,1,1004,860,-20
54962353430,54962353434,4,1666,1373,-20
54962561175,54962561174,-1,1139,2012,-20
54964789926,54964789929,3,1381,987,-20
54972142968,54972142971,3,1988,1047,-20
54973100066,54973100069,3,1746,1795,-20
54974287060,54974287063,3,2193,1879,-20
54978189403,54978189407,4,1903,1611,-20
54979329622,54979329625,3,1231,1255,-20
54982091363,54982091368,5,2255,1501,-20
54982452156,54982452162,6,2280,1327,-20
54982961363,54982961378,15,15693,18917,-20
54983410485,54983410489,4,1978,1437,-20
54986181037,54986181051,14,2295,1212,-20
54986352853,54986352857,4,2061,1385,-20
54990778586,54990778589,3,2161,2091,-20
54993024324,54993024326,2,1827,1642,-20
54993900198,54993900203,5,2333,1783,-20
55000279543,55000279546,3,2299,2035,-20
55000402813,55000402818,5,2101,1614,-20
55001587654,55001587658,4,1446,1347,-20
55006244300,55006244303,3,1558,1587,-20
55006525697,55006525693,-4,1484,4276,-20
55006606753,55006606755,2,1692,1611,-20
55006661559,55006661561,2,1170,1528,-20
55011411150,55011411153,3,1859,1634,-20
55012425129,55012425130,1,1189,1648,-20
55014268890,55014268894,4,1700,1388,-20
55017139378,55017139382,4,1742,1654,-20
55017230880,55017230883,3,2134,1176,-20
55018495986,55018495991,5,2261,1613,-20
55022467417,55022467422,5,2013,1095,-20
55024195207,55024195211,4,1793,1190,-20
55024528369,55024528374,5,2012,1389,-20
55025149661,55025149666,5,2118,1333,-20
55025179510,55025179513,3,1259,1064,-20
55032130675,55032130679,4,1769,1334,-20
55033983161,55033983164,3,2041,1559,-20
55034435717,55034435718,1,1972,1973,-20
55034825850,55034825854,4,1258,1425,-20
55039196538,55039196541,3,1793,1284,-20
55041021837,55041021842,5,1776,1212,-20
55043236734,55043236738,4,1818,1589,-20
55043483557,55043483555,-2,1233,1892,-20
55051017462,55051017465,3,1929,1694,-20
55052367005,55052367011,6,1542,1143,-20
55052778041,55052778040,-1,1505,1980,-20
55055265329,55055265330,1,1378,1398,-20
55056746373,55056746376,3,2170,2148,-20
55056853664,55056853668,4,1975,1404,-20
55064183002,55064182997,-5,614,3384,-20
55066924911,55066924914,3,2187,1239,-20
55067383914,55067383915,1,1370,1224,-20
55068431766,55068431772,6,1370,1442,-20
55068848383,55068848384,1,1430,1224,-20
55071335043,55071335046,3,1458,1468,-20
55071454378,55071454385,7,1834,1257,-20
55072586998,55072586999,1,1427,998,-20
55073805059,55073805063,4,1937,1638,-20
55075128242,55075128247,5,1209,1454,-20
55075627975,55075627977,2,2007,899,-20
55081688908,55081688910,2,2209,1801,-20
55082278752,55082278755,3,1230,987,-20
55084750582,55084750589,7,1410,1173,-20
55084987614,55084987633,19,1502,1116,-20
55087590445,55087590450,5,1612,1271,-20
55088372114,55088372119,5,1419,1188,-20
55091593632,55091593635,3,1843,1255,-20
55096024185,55096024190,5,1928,1132,-20
55096304494,55096304497,3,1128,763,-20
55097099487,55097099485,-2,1648,1923,-20
55098512462,55098512466,4,2292,1437,-20
55098811597,55098811577,-20,1661,783,-20
55100986303,55100986306,3,2206,1483,-20
55105209341,55105209343,2,2028,1608,-20
55105280061,55105280065,4,1813,1515,-20
55106714544,55106714546,2,1061,1382,-20
55107877179,55107877170,-9,759,5171,-20
55109614070,55109614073,3,1272,1170,-20
55110836725,55110836705,-20,2116,1769,-20
55113700110,55113700112,2,2636,1932,-20
55113941677,55113941679,2,1766,1553,-20
55114018830,55114018835,5,897,755,-20
55122679103,55122679107,4,1934,986,-20
55123999551,55123999554,3,1231,1013,-20
55126036801,55126036806,5,2400,1314,-20
55126608248,55126608251,3,1449,938,-20
55127224515,55127224521,6,1222,1480,-20
55128541422,55128541426,4,2066,1441,-20
55131349210,55131349217,7,2903,1092,-20
55133329968,55133329972,4,2270,1839,-20
55137391510,55137391511,1,1949,1928,-20
55139468307,55139468311,4,1868,1184,-20
55141018424,55141018426,2,1748,1093,-20
55145596828,55145596830,2,1779,1738,-20
55146068393,55146068397,4,1402,1368,-20
55146192605,55146192609,4,1821,1263,-20
55146390883,55146390873,-10,739,570,-20
55148749750,55148749753,3,2018,841,-20
55149415414,55149415418,4,1635,998,-20
55154738142,55154738146,4,1610,1556,-20
55155661100,55155661101,1,1736,1388,-20
55158529789,55158529792,3,2104,1792,-20
55160019662,55160019666,4,1751,1120,-20
55161096838,55161096843,5,1667,1320,-20
55163326779,55163326776,-3,1271,2129,-20
55164753966,55164753969,3,904,1252,-20
55167753321,55167753325,4,2631,1750,-20
55169404837,55169404839,2,1585,1525,-20
55169434770,55169434773,3,1515,1369,-20
55173926174,55173926177,3,1438,1423,-20
55173952809,55173952814,5,1852,1162,-20
55174325956,55174325937,-19,1161,1513,-20
55180064049,55180064047,-2,1148,1458,-20
55180541472,55180541475,3,1877,1523,-20
55182684176,55182684178,2,1672,1454,-20
55184564448,55184564445,-3,2462,5513,-20
55188128214,55188128218,4,1568,1198,-20
55189832512,55189832506,-6,1238,6376,-20
55190810749,55190810750,1,1253,1579,-20
55192230465,55192230468,3,1502,991,-20
55194331477,55194331481,4,2015,1668,-20
55199510069,55199510070,1,2229,1205,-20
55205109445,55205109448,3,2086,936,-20
55209398106,55209398111,5,2514,1992,-20
55212998089,55212998091,2,1731,1550,-20
55213609881,55213609885,4,2476,1766,-20
55216698658,55216698663,5,1083,1230,-20
55221341525,55221341526,1,1448,1771,-20
55227947427,55227947434,7,2150,1392,-20
55228247067,55228247075,8,2250,1415,-20
55229429181,55229429184,3,1888,1234,-20
55230336934,55230336938,4,2367,1485,-20
55231375134,55231375139,5,1297,1366,-20
55232833241,55232833242,1,1212,1045,-20
55234095280,55234095283,3,1211,969,-20
55234140329,55234140318,-11,1661,1297,-20
55235024154,55235024156,2,1026,1378,-20
55235278099,55235278086,-13,58,2504,-20
55237303470,55237303473,3,1645,1596,-20
55237506645,55237506647,2,1815,1445,-20
55237849211,55237849214,3,1899,1411,-20
55241622055,55241622057,2,1226,1066,-20
55246395997,55246395998,1,1287,711,-20
55250706621,55250706624,3,2422,1813,-20
55251250722,55251250724,2,1541,1058,-20
55253336825,55253336827,2,1728,1076,-20
55255705586,55255705592,6,2532,1671,-20
55259884362,55259884366,4,1550,1036,-20
55260391847,55260391850,3,1445,1369,-20
55261971378,55261971382,4,2572,1433,-20
55262457689,55262457693,4,1822,1048,-20
55264589259,55264589260,1,1695,1281,-20
55270202358,55270202358,0,1571,1448,-20
55270553883,55270553889,6,2450,1427,-20
55271047009,55271047011,2,1558,964,-20
55271409069,55271409073,4,6231,2612,-20
55275959833,55275959838,5,1885,1692,-20
55280908470,55280908474,4,2079,1121,-20
55284322349,55284322354,5,1710,730,-20
55286861734,55286861738,4,1424,1038,-20
55292616291,55292616281,-10,1508,2220,-20
55294699742,55294699744,2,1917,2035,-20
55295522111,55295522115,4,2970,1875,-20
55295702372,55295702374,2,2941,1976,-20
55299707251,55299707254,3,1912,2001,-20
55301983442,55301983447,5,1610,1196,-20
55302178470,55302178474,4,1312,1157,-20
55306787499,55306787504,5,1948,1371,-20
55307087293,55307087298,5,2330,1571,-20
55308024438,55308024440,2,1499,1166,-20
55309134360,55309134363,3,1949,1173,-20
55311590734,55311590738,4,1470,1525,-20
55314485749,55314485742,-7,1277,5433,-20
55317587692,55317587711,19,935,1610,-20
55319123541,55319123542,1,1278,1311,-20
55320410200,55320410183,-17,1167,1441,-20
55321249563,55321249567,4,1242,916,-20
55321780786,55321780790,4,1496,1316,-20
55322659339,55322659342,3,1129,1291,-20
55324180739,55324180740,1,1722,1266,-20
55329112832,55329112837,5,2561,1318,-20
55336471733,55336471734,1,1515,1100,-20
55336695956,55336695958,2,1360,1370,-20
55336919521,55336919538,17,784,188,-20
55337919262,55337919266,4,1503,1533,-20
55338166124,55338166126,2,1557,1744,-20
55339845374,55339845378,4,1334,1376,-20
55343670917,55343670921,4,1936,1569,-20
55344947347,55344947362,15,1271,857,-20
55351558291,55351558294,3,1984,1457,-20
55351793151,55351793130,-21,753,111,-20
55352927811,55352927811,0,1612,1186,-20
55355709129,55355709133,4,1931,1184,-20
55359630153,55359630155,2,1411,1275,-20
55359935805,55359935807,2,1997,927,-20
55362773965,55362773982,17,373,2354,-20
55365473327,55365473321,-6,1664,1342,-20
55369227137,55369227137,0,4310,6376,-20
55373032128,55373032131,3,1741,1315,-20
55376147880,55376147879,-1,30823,42229,-20
55381338170,55381338174,4,1719,1765,-20
55381404598,55381404601,3,1032,1458,-20
55381748236,55381748238,2,1969,1386,-20
55387017665,55387017668,3,2124,1860,-20
55387189226,55387189230,4,1442,1259,-20
55388782313,55388782315,2,1591,1467,-20
55398225973,55398225975,2,1875,1270,-20
55398519290,55398519275,-15,2263,1281,-20
55400320850,55400320853,3,1368,1135,-20
55402729384,55402729386,2,1750,1953,-20
55402964299,55402964304,5,1103,958,-20
55405131691,55405131695,4,1928,1997,-20
55405612961,55405612963,2,1685,1622,-20
55406118722,55406118728,6,1778,1362,-20
55414123619,55414123622,3,1879,1461,-20
55414466918,55414466921,3,1254,1143,-20
55417794008,55417794010,2,2796,1655,-20
55418844101,55418844105,4,2430,1524,-20
55423662178,55423662181,3,2131,1643,-20
55425867091,55425867094,3,2597,1169,-20
55430222919,55430222923,4,2159,1509,-20
55433119388,55433119389,1,1248,1165,-20
55436102659,55436102662,3,2042,1432,-20
55436225446,55436225451,5,2965,1523,-20
55437055112,55437055115,3,1911,1364,-20
55438902250,55438902254,4,2340,2140,-20
55443911109,55443911112,3,1717,1208,-20
55447237448,55447237459,11,16426,28817,-20
55448317210,55448317213,3,2500,1645,-20
55448858982,55448858986,4,2211,1769,-20
55450092685,55450092686,1,1379,1130,-20
55451014929,55451014912,-17,23092,102881,-20
55451693538,55451693541,3,1855,1290,-20
55452124055,55452124075,20,1352,885,-20
55452788556,55452788559,3,1830,1120,-20
55455830830,55455830829,-1,1960,2473,-20
55456300669,55456300675,6,1834,914,-20
55457810011,55457810013,2,1280,911,-20
55466780371,55466780369,-2,959,2024,-20
55466931150,55466931152,2,1895,1288,-20
55469978634,55469978637,3,1902,1491,-20
55473196606,55473196607,1,2416,1766,-20
55473643026,55473643031,5,2775,1822,-20
55475243287,55475243290,3,2074,1731,-20
55478477322,55478477327,5,1695,1219,-20
55478825881,55478825885,4,2121,1739,-20
55482550330,55482550334,4,2842,1292,-20
55486604177,55486604181,4,2012,1363,-20
55487097331,55487097334,3,2080,1067,-20
55491565478,55491565482,4,1519,1182,-20
55492987003,55492987007,4,1539,1461,-20
55493053880,55493053882,2,1109,1078,-20
55494517142,55494517142,0,1480,1835,-20
55499920843,55499920847,4,2748,1600,-20
55500942914,55500942919,5,1898,1457,-20
55504470903,55504470905,2,1407,1261,-20
55507528831,55507528835,4,3005,1940,-20
55509142343,55509142347,4,1759,711,-20
55510597026,55510597030,4,2309,1695,-20
55512603477,55512603482,5,2066,1613,-20
55514835661,55514835667,6,2047,1673,-20
55516177303,55516177309,6,3289,1150,-20
55520576250,55520576253,3,1986,1844,-20
55521888321,55521888323,2,1233,1247,-20
55525047442,55525047445,3,2404,2055,-20
55525707038,55525707041,3,1694,1536,-20
55527759202,55527759203,1,1621,1320,-20
55528479958,55528479963,5,1975,1228,-20
55528936051,55528936054,3,1006,681,-20
55529555662,55529555666,4,2205,1473,-20
55532622279,55532622282,3,1566,1279,-20
55535321193,55535321195,2,2160,1155,-20
55537875295,55537875298,3,1716,1366,-20
55538370017,55538370021,4,2237,1058,-20
55539656807,55539656810,3,1515,1029,-20
55541550013,55541550029,16,1460,1582,-20
55556073473,55556073477,4,1371,1403,-20
55558461557,55558461571,14,1630,1037,-20
55564992818,55564992824,6,1938,1348,-20
55565159758,55565159762,4,1460,1221,-20
55570108571,55570108574,3,1281,1230,-20
55571232830,55571232834,4,1807,1261,-20
55572117706,55572117708,2,1341,1553,-20
55572677564,55572677566,2,2178,1185,-20
55573647787,55573647790,3,1696,1152,-20
55575446154,55575446152,-2,1689,2348,-20
55579359669,55579359671,2,2258,1584,-20
55579988919,55579988924,5,2021,1132,-20
55582976480,55582976483,3,1857,1318,-20
55583521221,55583521226,5,1750,1187,-20
55583662634,55583662637,3,2557,1277,-20
55583711866,55583711870,4,1826,1553,-20
55585827537,55585827541,4,2009,1508,-20
55586086350,55586086353,3,1569,1244,-20
55586971564,55586971544,-20,2282,1379,-20
55587309634,55587309637,3,1934,1306,-20
55588463855,55588463858,3,1379,700,-20
55588617435,55588617455,20,993,1088,-20
55589684850,55589684857,7,2170,1198,-20
55589968054,55589968059,5,1429,998,-20
55592589862,55592589866,4,2151,1879,-20
55593858025,55593858027,2,1858,1147,-20
55594156960,55594156965,5,2429,1321,-20
55598462994,55598462998,4,1488,974,-20
55600674691,55600674693,2,2224,1976,-20
55603473880,55603473883,3,2270,1471,-20
55607532595,55607532599,4,1637,1362,-20
55610195235,55610195238,3,1697,1100,-20
55614776181,55614776186,5,1541,1170,-20
55616652279,55616652282,3,2648,1896,-20
55617449466,55617449470,4,2039,1313,-20
55617734955,55617734960,5,1823,920,-20
55624787939,55624787943,4,1549,1172,-20
55628102253,55628102255,2,1912,1331,-20
55628777634,55628777638,4,2068,1293,-20
55629941221,55629941222,1,1381,1480,-20
55630532830,55630532832,2,3271,1536,-20
55632061282,55632061286,4,2047,1493,-20
55633557046,55633557049,3,2381,1376,-20
55633758293,55633758289,-4,24103,10457,-20
55638899704,55638899707,3,2121,1526,-20
55640072524,55640072527,3,1663,1262,-20
55643568917,55643568919,2,1815,1699,-20
55646339929,55646339931,2,1695,1149,-20
55647230334,55647230338,4,1280,865,-20
55647794676,55647794683,7,2413,959,-20
55650544331,55650544335,4,2150,1435,-20
55652180214,55652180218,4,1262,1413,-20
55652492027,55652492029,2,2395,1694,-20
55653210498,55653210503,5,2025,1655,-20
55657241174,55657241179,5,1251,1351,-20
55659520077,55659520078,1,1789,1535,-20
55660291971,55660291975,4,1560,1404,-20
55663831169,55663831172,3,2304,1872,-20
55665226230,55665226234,4,1605,1379,-20
55665898401,55665898406,5,1835,1050,-20
55666084762,55666084764,2,1804,1364,-20
55666955322,55666955326,4,1579,1511,-20
55670023893,55670023897,4,1803,1739,-20
55672635065,55672635069,4,1655,1485,-20
55674694069,55674694073,4,2279,1589,-20
55675069606,55675069609,3,2249,1125,-20
55677013642,55677013646,4,2042,1242,-20
55679444746,55679444750,4,1894,1061,-20
55679551982,55679551984,2,1792,1356,-20
55679813097,55679813081,-16,1772,692,-20
55684885541,55684885543,2,1728,2322,-20
55685587474,55685587478,4,1800,1060,-20
55686033550,55686033553,3,1815,1527,-20
55687259482,55687259485,3,1457,1631,-20
55687363165,55687363171,6,2164,1574,-20
55688071789,55688071792,3,1584,1483,-20
55688662998,55688663000,2,1992,1484,-20
55690630580,55690630582,2,1670,1244,-20
55691050409,55691050412,3,1749,1150,-20
55693782478,55693782478,0,1413,1352,-20
55694543266,55694543263,-3,1058,2416,-20
55694904454,55694904453,-1,1370,2422,-20
55696637032,55696637049,17,1621,1173,-20
55697783701,55697783704,3,2226,1875,-20
55701642062,55701642062,0,1614,1659,-20
55703223733,55703223736,3,2603,2012,-20
55704400529,55704400532,3,1689,1283,-20
55704557002,55704557005,3,1593,2351,-20
55705835662,55705835664,2,1772,1233,-20
55707665866,55707665872,6,4321,1637,-20
55709768546,55709768547,1,1326,799,-20
55711947582,55711947584,2,1248,1588,-20
55712413034,55712413038,4,1611,1758,-20
55714172094,55714172099,5,1734,1212,-20
55714620827,55714620831,4,1256,1188,-20
55714781571,55714781555,-16,1473,964,-20
55715785670,55715785671,1,1925,1376,-20
55720826352,55720826357,5,1943,1410,-20
55729558306,55729558309,3,1414,1294,-20
55731042460,55731042463,3,2579,2260,-20
55731125554,55731125557,3,2083,1695,-20
55733273878,55733273883,5,2758,1853,-20
55735059161,55735059162,1,2335,1203,-20
55736146621,55736146623,2,1273,1224,-20
55738655911,55738655914,3,2428,2083,-20
55740788071,55740788075,4,2085,1441,-20
55741812675,55741812677,2,1858,1504,-20
55742415933,55742415934,1,1477,1375,-20
55743354458,55743354458,0,1567,1931,-20
55744106226,55744106230,4,1675,1436,-20
55744562561,55744562564,3,1236,1623,-20
55745265366,55745265374,8,1820,1349,-20
55745925392,55745925403,11,850,1523,-20
55747711826,55747711826,0,1399,1884,-20
55748187922,55748187926,4,1709,1127,-20
55752787120,55752787123,3,1488,1402,-20
55755307883,55755307886,3,1125,1361,-20
55755436830,55755436833,3,2477,1760,-20
55758557563,55758557567,4,1859,1379,-20
55762986683,55762986688,5,1571,1465,-20
55764503771,55764503776,5,1986,1215,-20
55767875070,55767875065,-5,21479,11544,-20
55768574818,55768574820,2,1584,1083,-20
55769612382,55769612363,-19,2033,1506,-20
55770559229,55770559233,4,1654,1068,-20
55774503301,55774503304,3,2523,1301,-20
55774628352,55774628369,17,2111,1364,-20
55778307992,55778307994,2,1542,1604,-20
55784084114,55784084118,4,1807,1253,-20
55789324793,55789324795,2,2053,1611,-20
55792123710,55792123714,4,1789,1331,-20
55792989153,55792989158,5,1575,1500,-20
55793517875,55793517878,3,1832,1569,-20
55793874407,55793874410,3,2242,1127,-20
55795865810,55795865823,13,1603,1359,-20
55796364390,55796364369,-21,960,353,-20
55797796945,55797796947,2,1422,1566,-20
55801773934,55801773934,0,1047,1438,-20
55804013221,55804013225,4,2026,2037,-20
55805577490,55805577493,3,2369,1725,-20
55809709934,55809709940,6,2273,1646,-20
55810019570,55810019571,1,1426,1048,-20
55810977962,55810977963,1,1826,1295,-20
55813383523,55813383526,3,1452,708,-20
55813712593,55813712597,4,1893,1474,-20
55814717845,55814717847,2,1955,1041,-20
55816410198,55816410203,5,1121,962,-20
55817378873,55817378876,3,2121,1688,-20
55820325213,55820325215,2,1984,1440,-20
55821004106,55821004110,4,1556,1309,-20
55821291773,55821291774,1,1870,1589,-20
55823355421,55823355426,5,2004,1311,-20
55825148353,55825148354,1,1484,1249,-20
55826454244,55826454250,6,1808,1199,-20
55826946531,55826946515,-16,863,584,-20
55831697710,55831697716,6,2772,970,-20
55833382438,55833382442,4,1456,1300,-20
55838595105,55838595110,5,2213,1064,-20
55839157195,55839157198,3,1826,1225,-20
55841529456,55841529458,2,2074,1498,-20
55841687737,55841687731,-6,1262,3687,-20
55844720338,55844720341,3,1386,1294,-20
55845609461,55845609463,2,2178,1444,-20
55846069103,55846069097,-6,1344,6604,-20
55852181963,55852181965,2,1427,1341,-20
55852284454,55852284459,5,1062,1157,-20
55854244702,55854244704,2,1271,1160,-20
55855116945,55855116947,2,1291,1176,-20
55857868398,55857868403,5,2982,1962,-20
55858471653,55858471655,2,1823,1100,-20
55859380802,55859380806,4,1753,986,-20
55862280393,55862280395,2,1637,1302,-20
55863140362,55863140363,1,1757,1527,-20
55866235629,55866235634,5,1472,1520,-20
55867680462,55867680480,18,2125,1112,-20
55872172730,55872172732,2,2716,1818,-20
55873524858,55873524863,5,2474,1598,-20
55873555168,55873555168,0,1585,1277,-20
55878483987,55878483990,3,1300,1237,-20
55881327889,55881327891,2,1825,956,-20
55883043854,55883043859,5,2087,1622,-20
55885702639,55885702642,3,1230,1414,-20
55888076497,55888076503,6,1907,1122,-20
55897412185,55897412187,2,1824,1790,-20
55898352555,55898352559,4,2402,1690,-20
55898545830,55898545834,4,2147,784,-20
55900805578,55900805582,4,1169,1391,-20
55903618299,55903618293,-6,1254,9791,-20
55905821323,55905821326,3,1442,1190,-20
55913870686,55913870690,4,1566,1303,-20
55916821484,55916821488,4,1585,1526,-20
55917289161,55917289164,3,1981,2027,-20
55919548294,55919548297,3,1727,1635,-20
55921635065,55921635075,10,116,292,-20
55923407678,55923407683,5,2104,1199,-20
55924012301,55924012302,1,1350,1465,-20
55924209421,55924209425,4,1587,1528,-20
55927239494,55927239497,3,2269,1760,-20
55928318284,55928318287,3,1921,1336,-20
55934752102,55934752107,5,2048,2305,-20
55937912025,55937912027,2,1915,1796,-20
55940952989,55940952993,4,2249,1312,-20
55945095390,55945095391,1,2035,1131,-20
55946876513,55946876518,5,1754,1145,-20
55947046697,55947046700,3,2118,1542,-20
55948877073,55948877079,6,1214,1282,-20
55951148481,55951148487,6,2090,1256,-20
55955231138,55955231139,1,1218,810,-20
55956286377,55956286371,-6,2886,8046,-20
55956495443,55956495448,5,1036,936,-20
55956706290,55956706295,5,1829,1320,-20
55957162810,55957162814,4,1269,1280,-20
55960085887,55960085895,8,26803,16205,-20
55966863518,55966863526,8,2043,1054,-20
55968366868,55968366871,3,1996,1328,-20
55970300625,55970300624,-1,1206,1304,-20
55970905883,55970905879,-4,129,1186,-20
55972709657,55972709659,2,1766,1551,-20
55974787590,55974787597,7,2094,1365,-20
55978933492,55978933493,1,2089,1527,-20
55982555281,55982555283,2,1690,1498,-20
55983986528,55983986530,2,1308,1921,-20
55988613774,55988613774,0,1596,1295,-20
55993804619,55993804621,2,1295,1177,-20
55999568739,55999568741,2,1606,1638,-20
56000052622,56000052627,5,2677,1571,-20
56001950223,56001950227,4,1868,1861,-20
56006118118,56006118122,4,1867,1368,-20
56008103868,56008103870,2,1329,973,-20
56009280391,56009280397,6,2234,1357,-20
56015862054,56015862058,4,2366,1667,-20
56017538153,56017538146,-7,1352,3364,-20
56018073207,56018073211,4,875,959,-20
56018569550,56018569530,-20,1579,1351,-20
56019650668,56019650669,1,1736,1499,-20
56019708345,56019708347,2,2090,1452,-20
56020385086,56020385090,4,2250,1744,-20
56021739064,56021739068,4,2142,1424,-20
56023524761,56023524762,1,1095,1461,-20
56027077803,56027077806,3,2005,1084,-20
56032240445,56032240447,2,2239,1940,-20
56039591256,56039591259,3,2129,1571,-20
56044421022,56044421023,1,1498,1858,-20
56048514456,56048514458,2,1770,1678,-20
56050157159,56050157158,-1,2015,3687,-20
56050250761,56050250764,3,2057,1459,-20
56050867378,56050867383,5,1405,1127,-20
56050973550,56050973529,-21,2089,1262,-20
56052791919,56052791923,4,1651,1034,-20
56053193170,56053193174,4,1525,1532,-20
56055852806,56055852812,6,1916,1314,-20
56056578520,56056578523,3,1731,1416,-20
56057913210,56057913212,2,2235,1724,-20
56059093227,56059093229,2,2017,2310,-20
56060924705,56060924709,4,2254,1335,-20
56061693118,56061693121,3,871,1069,-20
56061996453,56061996450,-3,1605,3188,-20
56065706703,56065706704,1,1204,2069,-20
56068810086,56068810086,0,1192,1336,-20
56077550681,56077550682,1,2193,1642,-20
56079363177,56079363182,5,1313,1353,-20
56080042332,56080042334,2,1568,1647,-20
56081190561,56081190564,3,2224,1495,-20
56082917281,56082917287,6,1527,1539,-20
56088057021,56088057022,1,1822,1709,-20
56093327752,56093327755,3,1257,1055,-20
56095490131,56095490134,3,1962,1635,-20
56098610795,56098610797,2,1802,1440,-20
56101110269,56101110272,3,2115,1862,-20
56112617741,56112617745,4,1614,804,-20
56113919727,56113919728,1,3494,2970,-20
56114289305,56114289308,3,1300,1560,-20
56115194050,56115194052,2,1888,1149,-20
56117011666,56117011669,3,1206,947,-20
56117857936,56117857939,3,2225,1384,-20
56118576989,56118576989,0,1707,1143,-20
56121088440,56121088442,2,2488,1404,-20
56121755923,56121755912,-11,47703,19365,-20
56122864924,56122864922,-2,1053,1786,-20
56124562638,56124562641,3,1985,1739,-20
56125243569,56125243569,0,1607,1398,-20
56125304514,56125304515,1,1362,807,-20
56125938210,56125938213,3,1617,1735,-20
56126596485,56126596491,6,1197,1067,-20
56127830383,56127830384,1,1519,1428,-20
56128837778,56128837781,3,1816,1399,-20
56130990533,56130990533,0,1398,1453,-20
56134572474,56134572472,-2,2631,4922,-20
56134919826,56134919822,-4,2279,5151,-20
56135435003,56135435006,3,1423,801,-20
56135854046,56135854049,3,2205,1357,-20
56135970824,56135970826,2,1428,1561,-20
56136077489,56136077496,7,2433,1033,-20
56137441722,56137441724,2,1671,1236,-20
56138062182,56138062196,14,1802,1933,-20
56140364450,56140364455,5,1855,1580,-20
56141995964,56141995962,-2,2678,4220,-20
56147085791,56147085794,3,2106,1297,-20
56149182868,56149182865,-3,1405,3260,-20
56150687522,56150687525,3,1830,2235,-20
56153010369,56153010369,0,1205,1292,-20
56154860909,56154860902,-7,2229,7172,-20
56155435894,56155435897,3,2106,1899,-20
56155530163,56155530148,-15,709,526,-20
56157296779,56157296783,4,1506,1229,-20
56157420034,56157420017,-17,1522,1511,-20
56158660474,56158660478,4,3370,2113,-20
56159448361,56159448363,2,2201,1940,-20
56163989190,56163989195,5,2461,1540,-20
56165559509,56165559506,-3,862,2285,-20
56169950770,56169950774,4,1627,1124,-20
56170431130,56170431134,4,2416,1298,-20
56171779386,56171779390,4,2283,1570,-20
56175323639,56175323643,4,2018,1296,-20
56178825065,56178825069,4,1885,1532,-20
56179313122,56179313126,4,2457,1021,-20
56181118817,56181118820,3,2031,1202,-20
56181647547,56181647550,3,1642,1865,-20
56182605269,56182605271,2,1627,1594,-20
56187744686,56187744690,4,1249,937,-20
56192569203,56192569206,3,1217,1550,-20
56194223695,56194223697,2,1726,1516,-20
56194268682,56194268686,4,2077,1202,-20
56197455263,56197455265,2,1314,1117,-20
56199103067,56199103070,3,2096,1677,-20
56200276249,56200276254,5,2243,1321,-20
56200690457,56200690461,4,1481,938,-20
56201154915,56201154931,16,3388,1013,-20
56205667142,56205667138,-4,1583,3062,-20
56205754857,56205754857,0,434,193,-20
56207329185,56207329189,4,1669,1079,-20
56207372317,56207372319,2,1700,1341,-20
56208987280,56208987283,3,1251,911,-20
56215331136,56215331135,-1,857,972,-20
56216640135,56216640138,3,2037,1439,-20
56222711734,56222711734,0,1572,2913,-20
56225303995,56225304001,6,1936,1215,-20
56225389856,56225389857,1,1686,1648,-20
56228757164,56228757166,2,1671,1631,-20
56229931819,56229931824,5,1183,954,-20
56237091206,56237091210,4,1444,1213,-20
56237988842,56237988846,4,2221,1859,-20
56238659885,56238659889,4,2121,1281,-20
56241048003,56241048006,3,2628,1977,-20
56242312758,56242312762,4,1980,1263,-20
56243568799,56243568801,2,1587,1547,-20
56244205521,56244205522,1,1892,1099,-20
56244957797,56244957802,5,2607,1770,-20
56245506514,56245506518,4,2453,2081,-20
56245631330,56245631330,0,1260,3132,-20
56245792230,56245792233,3,1624,1566,-20
56251096887,56251096886,-1,2151,2440,-20
56254593842,56254593846,4,1856,1325,-20
56254763038,56254763044,6,2087,1781,-20
56256603217,56256603220,3,1471,1072,-20
56258954678,56258954679,1,1581,1384,-20
56261319777,56261319781,4,1192,1531,-20
56265966930,56265966935,5,2211,1234,-20
56266100502,56266100505,3,1872,1303,-20
56266955185,56266955188,3,1943,1551,-20
56267294954,56267294955,1,1848,2029,-20
56269102970,56269102971,1,1116,1183,-20
56270502923,56270502927,4,1520,1186,-20
56273408274,56273408276,2,2467,1960,-20
56273995161,56273995164,3,1953,1163,-20
56275497797,56275497801,4,1698,1728,-20
56278292214,56278292210,-4,1532,2090,-20
56279401762,56279401766,4,1450,1225,-20
56281565817,56281565822,5,2448,1428,-20
56282411947,56282411948,1,5125,6363,-20
56282477112,56282477115,3,2312,1364,-20
56286626661,56286626661,0,1928,1336,-20
56289010235,56289010239,4,1702,1375,-20
56292880048,56292880051,3,1171,1188,-20
56293696414,56293696415,1,1682,1211,-20
56299219793,56299219797,4,1869,1199,-20
56304800826,56304800830,4,1584,985,-20
56307699773,56307699774,1,1338,1269,-20
56312477330,56312477334,4,2207,1373,-20
56321306428,56321306432,4,2524,1553,-20
56322929885,56322929866,-19,2622,2143,-20
56327468317,56327468325,8,727,317,-20
56329679473,56329679475,2,3575,3561,-20
56330057368,56330057370,2,2098,1635,-20
56330755230,56330755233,3,1147,993,-20
56332511961,56332511966,5,1434,1001,-20
56347350118,56347350121,3,937,1314,-20
56347992271,56347992269,-2,1806,3166,-20
56349977823,56349977827,4,664,609,-20
56351819843,56351819846,3,1495,1723,-20
56354020492,56354020494,2,1456,1502,-20
56354941605,56354941607,2,1387,1339,-20
56355747337,56355747339,2,1900,1124,-20
56355832562,56355832564,2,1776,1430,-20
56356890640,56356890644,4,1788,1704,-20
56357589738,56357589745,7,4280,1194,-20
56358083898,56358083901,3,2257,1731,-20
56364092873,56364092876,3,1750,1489,-20
56365169206,56365169210,4,2782,1344,-20
56367600066,56367600069,3,1871,1099,-20
56370428046,56370428049,3,2038,1562,-20
56372003066,56372003067,1,1041,1161,-20
56377890491,56377890494,3,1147,1295,-20
56379878375,56379878369,-6,1181,4832,-20
56380101314,56380101317,3,1422,1222,-20
56381832272,56381832274,2,1544,1545,-20
56382185753,56382185755,2,2406,1111,-20
56383800073,56383800074,1,1108,1590,-20
56389207858,56389207860,2,1262,1044,-20
56391683627,56391683631,4,2054,1264,-20
56391777620,56391777621,1,2054,2101,-20
56393808829,56393808831,2,1783,1127,-20
56394082295,56394082298,3,1164,837,-20
56395882371,56395882373,2,1990,1754,-20
56398307226,56398307228,2,2251,1542,-20
56398408840,56398408843,3,1893,1543,-20
56401913942,56401913945,3,1962,1314,-20
56403292103,56403292106,3,2080,1576,-20
56408919054,56408919059,5,2267,1258,-20
56409329693,56409329696,3,1631,1344,-20
56410681647,56410681650,3,1540,1598,-20
56410992410,56410992402,-8,1688,5154,-20
56415705327,56415705331,4,1716,1136,-20
56423420825,56423420832,7,472,119,-20
56424596560,56424596564,4,2182,1505,-20
56426461297,56426461293,-4,1497,2505,-20
56433145436,56433145439,3,1990,1808,-20
56435947307,56435947311,4,1354,1387,-20
56438248706,56438248709,3,1389,1152,-20
56439503062,56439503063,1,1523,1036,-20
56441526961,56441526963,2,1564,1272,-20
56452867061,56452867064,3,1747,1461,-20
56455249563,56455249568,5,1781,1190,-20
56455735085,56455735088,3,2033,885,-20
56457659481,56457659486,5,1960,1195,-20
56458147547,56458147550,3,1520,1250,-20
56461597168,56461597170,2,1988,1458,-20
56466625521,56466625526,5,1374,1153,-20
56467971681,56467971683,2,1508,1237,-20
56473539867,56473539871,4,1404,1072,-20
56473725542,56473725543,1,1227,1055,-20
56476016092,56476016094,2,1357,982,-20
56478358301,56478358306,5,1479,1228,-20
56480618040,56480618047,7,2835,1545,-20
56484105395,56484105394,-1,1170,1360,-20
56485844434,56485844439,5,1471,1187,-20
56485953033,56485953037,4,1415,965,-20
56486882286,56486882290,4,1724,1605,-20
56489713481,56489713496,15,1655,926,-20
56490969180,56490969182,2,1790,1438,-20
56492058165,56492058169,4,2557,1483,-20
56494260826,56494260830,4,2448,1545,-20
56494492621,56494492615,-6,825,2028,-20
56496743146,56496743148,2,2874,1532,-20
56498303079,56498303082,3,1825,1380,-20
56500743952,56500743953,1,2036,1590,-20
56502469650,56502469653,3,1136,1396,-20
56504482091,56504482094,3,1812,1684,-20
56505623586,56505623587,1,2327,1646,-20
56506108842,56506108845,3,1679,1191,-20
56511540943,56511540945,2,838,1047,-20
56513646550,56513646553,3,1611,1186,-20
56514496762,56514496761,-1,1807,2674,-20
56522773213,56522773219,6,2015,1440,-20
56528972971,56528972974,3,1374,1349,-20
56531332862,56531332864,2,1624,1573,-20
56531455233,56531455234,1,1544,1324,-20
56532664690,56532664692,2,1388,1555,-20
56533103645,56533103649,4,1584,990,-20
56537034526,56537034530,4,2008,1468,-20
56538044609,56538044611,2,1528,1765,-20
56538308251,56538308236,-15,1459,1240,-20
56542162657,56542162662,5,2275,1567,-20
56544840855,56544840858,3,1523,1202,-20
56546584374,56546584375,1,1667,1390,-20
56547096595,56547096600,5,2041,1628,-20
56548354874,56548354878,4,1800,1496,-20
56550990790,56550990793,3,2173,1479,-20
56552015736,56552015741,5,1411,1254,-20
56553125362,56553125367,5,1884,1125,-20
56555494177,56555494178,1,2133,2425,-20
56560066547,56560066547,0,1470,1488,-20
56560469878,56560469879,1,1106,1829,-20
56562455725,56562455730,5,2413,1445,-20
56563526758,56563526759,1,1301,1247,-20
56564387947,56564387927,-20,2372,1656,-20
56564577473,56564577477,4,1633,1166,-20
56565358956,56565358959,3,1203,1263,-20
56570143274,56570143278,4,2177,1359,-20
56574502725,56574502729,4,1532,1491,-20
56575029453,56575029449,-4,1172,3438,-20
56575643870,56575643874,4,2676,1355,-20
56576197233,56576197235,2,1415,1399,-20
56578482521,56578482526,5,2723,1432,-20
56582392069,56582392073,4,1941,1621,-20
56587089217,56587089197,-20,1657,1045,-20
56588016728,56588016730,2,1336,957,-20
56589708633,56589708637,4,1880,1459,-20
56589904326,56589904331,5,1939,1565,-20
56594016470,56594016473,3,1619,1497,-20
56594249329,56594249325,-4,1061,2662,-20
56594588397,56594588400,3,2271,1902,-20
56598532608,56598532612,4,2392,1964,-20
56602999601,56602999605,4,2093,1489,-20
56604236247,56604236250,3,2323,1541,-20
56605948374,56605948375,1,1930,1781,-20
56606546735,56606546738,3,1683,1446,-20
56606745690,56606745694,4,1695,933,-20
56609286145,56609286141,-4,38883,34719,-20
56612350860,56612350863,3,1787,2126,-20
56613580151,56613580154,3,1299,1297,-20
56615830864,56615830866,2,1814,1578,-20
56618823976,56618823978,2,2157,1194,-20
56619601706,56619601710,4,1477,1194,-20
56619844984,56619844987,3,1110,1578,-20
56620161213,56620161217,4,2011,1227,-20
56620302793,56620302799,6,3919,1398,-20
56625027470,56625027474,4,1828,1797,-20
56626035355,56626035353,-2,1106,1948,-20
56626764502,56626764506,4,1974,1239,-20
56629893725,56629893730,5,2089,1551,-20
56631709233,56631709234,1,1885,1276,-20
56640301235,56640301238,3,1383,1410,-20
56642334426,56642334429,3,1004,1120,-20
56645988304,56645988306,2,1065,1322,-20
56649507954,56649507956,2,2046,1695,-20
56653987107,56653987109,2,1150,1592,-20
56657106958,56657106961,3,1343,1221,-20
56657997527,56657997531,4,904,634,-20
56661337206,56661337206,0,1395,1047,-20
56661810045,56661810046,1,1323,2100,-20
56664160427,56664160433,6,2046,1391,-20
56664561182,56664561186,4,2745,2096,-20
56664757772,56664757770,-2,1200,1656,-20
56665165475,56665165478,3,1731,1248,-20
56665571455,56665571459,4,1618,1507,-20
56667398672,56667398674,2,1582,1293,-20
56670126634,56670126636,2,1850,1701,-20
56671826446,56671826446,0,995,1083,-20
56673795901,56673795904,3,1448,853,-20
56674519149,56674519150,1,1591,1400,-20
56674909447,56674909445,-2,1189,3000,-20
56676609537,56676609542,5,2228,1223,-20
56677078702,56677078707,5,1529,1418,-20
56678019573,56678019577,4,1649,1584,-20
56687440078,56687440080,2,1356,1066,-20
56688645970,56688645977,7,1600,1664,-20
56689058579,56689058578,-1,1239,1239,-20
56689500467,56689500471,4,2007,1152,-20
56695593389,56695593392,3,1701,1587,-20
56698330683,56698330688,5,1918,1238,-20
56699027258,56699027261,3,1268,1330,-20
56701671720,56701671724,4,2090,1139,-20
56704697437,56704697439,2,1899,1220,-20
56710077010,56710077010,0,1422,1333,-20
56714813830,56714813833,3,1409,1576,-20
56718459790,56718459794,4,5084,2467,-20
56721387786,56721387790,4,1874,1128,-20
56723819318,56723819323,5,2383,1222,-20
56725472117,56725472120,3,1842,1672,-20
56726579179,56726579184,5,1533,1109,-20
56727392102,56727392106,4,1297,1530,-20
56728731394,56728731397,3,1667,1485,-20
56729882006,56729882011,5,1402,1029,-20
56730570323,56730570306,-17,602,467,-20
56734709085,56734709089,4,1572,1187,-20
56736494782,56736494778,-4,1665,1567,-20
56736887333,56736887339,6,4715,2508,-20
56737423162,56737423164,2,1764,1710,-20
56738173817,56738173819,2,1604,1434,-20
56738428352,56738428355,3,1898,1746,-20
56738509037,56738509042,5,1729,1230,-20
56738761421,56738761425,4,2470,1429,-20
56739432912,56739432922,10,1672,917,-20
56743949460,56743949467,7,1360,668,-20
56744289790,56744289791,1,1609,1240,-20
56744853709,56744853715,6,1937,1171,-20
56746671812,56746671816,4,2297,1211,-20
56752365537,56752365540,3,2202,1744,-20
56756600643,56756600646,3,1473,1385,-20
56761461338,56761461341,3,1413,1604,-20
56762668556,56762668560,4,1549,1085,-20
56767150814,56767150816,2,1855,1197,-20
56768816037,56768816042,5,1723,1246,-20
56769127466,56769127464,-2,25,1632,-20
56770960080,56770960077,-3,1078,2219,-20
56771618650,56771618653,3,2653,1551,-20
56772965065,56772965067,2,1730,1261,-20
56773178167,56773178170,3,1919,1682,-20
56776936687,56776936690,3,2448,2031,-20
56777459085,56777459090,5,2443,1751,-20
56779791506,56779791511,5,2226,1385,-20
56781697075,56781697077,2,1920,920,-20
56782029354,56782029359,5,1624,1017,-20
56782542783,56782542787,4,2062,1494,-20
56786397375,56786397377,2,1627,1216,-20
56788070364,56788070371,7,2169,773,-20
56789111676,56789111679,3,2099,1412,-20
56789812624,56789812628,4,1672,1427,-20
56790008363,56790008346,-17,1644,967,-20
56797361408,56797361412,4,2386,1593,-20
56799930053,56799930057,4,2234,1086,-20
56802956219,56802956221,2,2501,1308,-20
56804501870,56804501876,6,2278,1512,-20
56805991946,56805991933,-13,985,284,-20
56812612601,56812612604,3,1799,1568,-20
56817010898,56817010903,5,1974,1396,-20
56817931983,56817931986,3,2040,1661,-20
56819277157,56819277162,5,1533,1608,-20
56819473615,56819473619,4,2168,1336,-20
56820677525,56820677529,4,1806,1324,-20
56822172606,56822172609,3,1845,1377,-20
56822212554,56822212556,2,5190,6013,-20
56823409689,56823409689,0,1381,1319,-20
56824201373,56824201355,-18,1122,1570,-20
56826340055,56826340056,1,1505,1486,-20
56826462906,56826462915,9,2149,1656,-20
56828267793,56828267798,5,2206,1753,-20
56829767937,56829767941,4,1652,1219,-20
56834283423,56834283428,5,1892,1363,-20
56835705257,56835705260,3,1589,1152,-20
56837826733,56837826741,8,2212,1661,-20
56841061383,56841061380,-3,1109,1956,-20
56844841376,56844841378,2,2605,1608,-20
56847657991,56847657995,4,1616,1469,-20
56851469317,56851469321,4,2084,2119,-20
56858775281,56858775284,3,1392,1159,-20
56866003591,56866003595,4,2211,1407,-20
56866456803,56866456797,-6,1323,4474,-20
56867867644,56867867648,4,2615,933,-20
56868676182,56868676185,3,1783,1163,-20
56874561509,56874561508,-1,445,1366,-20
56877535653,56877535658,5,1994,1294,-20
56877961222,56877961224,2,3108,2714,-20
56879050851,56879050855,4,1526,1278,-20
56879373215,56879373192,-23,1731,1155,-20
56881559685,56881559689,4,2288,1584,-20
56883207607,56883207610,3,2538,1852,-20
56884512662,56884512662,0,920,1187,-20
56889086877,56889086879,2,1657,1448,-20
56891360186,56891360190,4,2464,1358,-20
56892653895,56892653898,3,1628,959,-20
56895901226,56895901230,4,1888,995,-20
56900407946,56900407948,2,1692,1575,-20
56902245267,56902245273,6,1840,1250,-20
56903325318,56903325322,4,2037,1106,-20
56904398523,56904398527,4,1895,1180,-20
56904979401,56904979402,1,1831,1190,-20
56907089289,56907089282,-7,1385,1238,-20
56909446329,56909446331,2,1994,1701,-20
56913943734,56913943735,1,1468,1240,-20
56914557313,56914557317,4,2007,1585,-20
56914797286,56914797289,3,1285,1699,-20
56920724756,56920724758,2,1431,1373,-20
56923937499,56923937502,3,1662,1242,-20
56924452159,56924452169,10,984,874,-20
56927170183,56927170187,4,1506,1346,-20
56927457330,56927457333,3,1278,1375,-20
56928552387,56928552391,4,2658,1797,-20
56929701392,56929701395,3,1451,1091,-20
56929997398,56929997401,3,1470,1533,-20
56931077220,56931077223,3,1878,1438,-20
56932007418,56932007421,3,1043,1404,-20
56932957682,56932957696,14,2154,1870,-20
56934184035,56934184038,3,2012,1369,-20
56937079538,56937079539,1,1694,1382,-20
56937676149,56937676150,1,2479,1244,-20
56938042286,56938042267,-19,1369,1502,-20
56940619097,56940619102,5,2070,1337,-20
56940837738,56940837742,4,1415,1271,-20
56941834302,56941834306,4,1291,1033,-20
56943202489,56943202493,4,1962,1608,-20
56944145356,56944145359,3,1993,1303,-20
56946408079,56946408081,2,2067,1689,-20
56947574425,56947574428,3,1975,1556,-20
56949575661,56949575665,4,1748,1390,-20
56953303650,56953303654,4,1887,1029,-20
56954980054,56954980053,-1,1255,1329,-20
56955679530,56955679533,3,1730,1615,-20
56955757420,56955757423,3,2400,1409,-20
56959188759,56959188747,-12,1482,1071,-20
56963893146,56963893150,4,2236,1402,-20
56964979671,56964979675,4,1319,1399,-20
56968213643,56968213646,3,1850,1288,-20
56969651309,56969651312,3,2391,1756,-20
56971463074,56971463076,2,1985,1450,-20
56972183455,56972183436,-19,1208,159,-20
56973738589,56973738594,5,1625,1051,-20
56975398291,56975398293,2,1534,1270,-20
56976275318,56976275297,-21,2172,1288,-20
56980941086,56980941093,7,2003,1398,-20
56982141875,56982141881,6,2310,1517,-20
56984029446,56984029450,4,1903,1148,-20
56985554935,56985554936,1,1690,1171,-20
56985641506,56985641510,4,1681,1424,-20
56986376352,56986376356,4,1995,1721,-20
56987920107,56987920112,5,2263,1873,-20
56988232259,56988232267,8,2612,958,-20
56989004654,56989004657,3,1908,1525,-20
56991398861,56991398863,2,1478,1597,-20
56996009294,56996009302,8,3601,1439,-20
56996134944,56996134946,2,1393,778,-20
56998783093,56998783095,2,1947,1395,-20
57000155207,57000155210,3,1668,1407,-20
57001153294,57001153298,4,1699,1461,-20
57008113359,57008113363,4,2274,1610,-20
57011635617,57011635614,-3,873,2378,-20
57014704361,57014704361,0,2428,1296,-20
57015316447,57015316450,3,2690,2079,-20
57017531350,57017531340,-10,1346,492,-20
57017616314,57017616318,4,1683,1424,-20
57021336985,57021336985,0,1643,1377,-20
57023631215,57023631218,3,1903,1677,-20
57024626291,57024626274,-17,1380,831,-20
57027084318,57027084318,0,1087,1055,-20
57029353782,57029353782,0,908,2080,-20
57030516277,57030516279,2,1052,954,-20
57031521489,57031521488,-1,853,251,-20
57032854121,57032854125,4,1989,1499,-20
57035384501,57035384502,1,1777,1568,-20
57037843777,57037843781,4,1913,1283,-20
57040094228,57040094233,5,2348,1995,-20
57047093366,57047093370,4,1590,1422,-20
57050622525,57050622529,4,1774,1766,-20
57050671346,57050671350,4,1284,1229,-20
57052498958,57052498961,3,1787,1432,-20
57053272253,57053272259,6,2115,1859,-20
57056809332,57056809333,1,1651,954,-20
57057270382,57057270384,2,1831,1272,-20
57058070401,57058070405,4,1135,1144,-20
57061602920,57061602925,5,1954,1549,-20
57062229843,57062229833,-10,1251,1186,-20
57072763920,57072763924,4,1904,1575,-20
57073321391,57073321369,-22,872,722,-20
57080178831,57080178834,3,1003,996,-20
57082008674,57082008677,3,1499,1051,-20
57082120517,57082120520,3,2602,2221,-20
57084301696,57084301703,7,2696,1373,-20
57086881027,57086881032,5,2265,1354,-20
57087273485,57087273487,2,1294,988,-20
57096130999,57096131002,3,1982,1266,-20
57096558634,57096558626,-8,1754,9603,-20
57099036771,57099036773,2,695,1238,-20
57099271811,57099271815,4,2270,1117,-20
57103425593,57103425597,4,1876,1457,-20
57106976730,57106976733,3,1941,1281,-20
57108575945,57108575950,5,2143,1951,-20
57109143638,57109143641,3,1989,1301,-20
57109353003,57109353006,3,1208,1035,-20
57110041257,57110041265,8,53293,35982,-20
57110408546,57110408553,7,2049,1095,-20
57113391626,57113391618,-8,713,3619,-20
57115393814,57115393818,4,2843,1722,-20
57116011558,57116011563,5,1460,1116,-20
57118975625,57118975629,4,1486,1561,-20
57121213258,57121213259,1,1302,929,-20
57123054424,57123054426,2,1806,1435,-20
57124334514,57124334518,4,1914,1781,-20
57127593117,57127593121,4,2090,1403,-20
57128853079,57128853082,3,1835,1187,-20
57132498581,57132498587,6,1994,1382,-20
57133546408,57133546409,1,1499,1211,-20
57134894170,57134894174,4,2245,1324,-20
57135146689,57135146691,2,1992,1443,-20
57135987733,57135987735,2,1549,1348,-20
57143106994,57143106996,2,2697,1664,-20
57143944921,57143944926,5,2547,1800,-20
57144604882,57144604886,4,1667,1102,-20
57150076158,57150076159,1,1322,1015,-20
57151368490,57151368497,7,2366,1349,-20
57151725465,57151725471,6,1259,1124,-20
57153059238,57153059242,4,2599,1853,-20
57153320768,57153320773,5,2084,1174,-20
57154354287,57154354282,-5,3642,11998,-20
57154631076,57154631082,6,2086,1285,-20
57157566330,57157566323,-7,1087,1054,-20
57158062377,57158062382,5,3001,1533,-20
57161905683,57161905686,3,1794,1123,-20
57165291307,57165291310,3,856,924,-20
57169193712,57169193712,0,1604,1803,-20
57170045786,57170045777,-9,1539,1631,-20
57172950462,57172950466,4,1737,1259,-20
57174895753,57174895755,2,1916,1636,-20
57175793630,57175793633,3,1548,768,-20
57180461146,57180461147,1,2289,1410,-20
57181909778,57181909778,0,1240,1273,-20
57182544939,57182544940,1,1576,1392,-20
57183676391,57183676393,2,1355,1063,-20
57184223333,57184223335,2,2145,1802,-20
57184553317,57184553314,-3,1129,1055,-20
57184747110,57184747114,4,1932,1267,-20
57185336614,57185336614,0,1438,1910,-20
57190154787,57190154792,5,1783,1433,-20
57192508075,57192508079,4,1880,1483,-20
57194680621,57194680622,1,11346,11894,-20
57195596669,57195596673,4,2049,1266,-20
57196305816,57196305818,2,1828,1394,-20
57199121986,57199121982,-4,4475,9859,-20
57199327230,57199327210,-20,1656,835,-20
57199428950,57199428955,5,1997,1605,-20
57200564883,57200564886,3,1842,1349,-20
57201435571,57201435566,-5,857,5575,-20
57205148849,57205148852,3,1825,1504,-20
57206040378,57206040382,4,1960,1384,-20
57206629877,57206629878,1,1163,968,-20
57210223187,57210223191,4,1663,1198,-20
57210268342,57210268343,1,1863,1780,-20
57211195469,57211195473,4,1873,1455,-20
57213720989,57213720991,2,1910,1739,-20
57213958793,57213958794,1,1584,1182,-20
57214555685,57214555687,2,923,1108,-20
57215486234,57215486237,3,2539,1664,-20
57223016658,57223016654,-4,1108,2055,-20
57223145708,57223145713,5,2283,1267,-20
57224503509,57224503511,2,2467,1949,-20
57225380395,57225380398,3,1976,1079,-20
57230461301,57230461305,4,2399,1773,-20
57232446026,57232446029,3,2088,1270,-20
57234127721,57234127724,3,2345,2020,-20
57234193358,57234193362,4,1513,1230,-20
57235657804,57235657807,3,1989,1508,-20
57235863969,57235863974,5,1303,1471,-20
57238670078,57238670081,3,2467,1754,-20
57239285978,57239285994,16,1348,1088,-20
57240162614,57240162592,-22,1666,1507,-20
57241199583,57241199583,0,934,234,-20
57244447010,57244447010,0,1015,1773,-20
57244861386,57244861387,1,1122,802,-20
57245894559,57245894562,3,1005,1255,-20
57246246377,57246246379,2,2166,1476,-20
57249625022,57249625027,5,1722,1203,-20
57253557447,57253557450,3,1248,1261,-20
57254459796,57254459799,3,1016,1207,-20
57258301924,57258301925,1,1532,2022,-20
57259074345,57259074349,4,2452,1764,-20
57261625574,57261625576,2,1261,1124,-20
57263803569,57263803567,-2,1611,1829,-20
57266541860,57266541865,5,1637,1148,-20
57269122977,57269122981,4,2389,1410,-20
57274146358,57274146362,4,2282,1508,-20
57274759910,57274759912,2,1608,1712,-20
57275582217,57275582218,1,1385,1360,-20
57277109971,57277109973,2,1610,2310,-20
57277666485,57277666490,5,2120,1700,-20
57278347489,57278347492,3,1889,1488,-20
57282085412,57282085415,3,2026,1428,-20
57283213872,57283213876,4,1977,1558,-20
57284608544,57284608543,-1,1373,1939,-20
57292282178,57292282185,7,7758,2371,-20
57293383259,57293383263,4,1601,1076,-20
57293542707,57293542710,3,1723,1293,-20
57295598835,57295598839,4,1965,1087,-20
57298245473,57298245476,3,1728,1435,-20
57301228008,57301228011,3,2307,1276,-20
57302769627,57302769631,4,1612,1224,-20
57306154921,57306154923,2,872,1259,-20
57306723661,57306723662,1,2392,1770,-20
57311267471,57311267474,3,1866,1373,-20
57311603326,57311603321,-5,1234,4250,-20
57312746354,57312746359,5,2081,1359,-20
57314663855,57314663851,-4,1976,3759,-20
57318377967,57318377959,-8,953,5241,-20
57320536088,57320536091,3,2118,1986,-20
57321805511,57321805514,3,1511,1231,-20
57323530546,57323530561,15,1957,1571,-20
57323963102,57323963094,-8,2287,9594,-20
57328180818,57328180823,5,1336,1096,-20
57332150486,57332150489,3,2165,1372,-20
57332855799,57332855802,3,965,753,-20
57336700508,57336700503,-5,1387,4455,-20
57338802921,57338802923,2,28012,18615,-20
57339207470,57339207474,4,1849,1127,-20
57339915622,57339915627,5,1925,1375,-20
57343853341,57343853343,2,1342,953,-20
57345082953,57345082955,2,2173,1255,-20
57346009729,57346009732,3,1102,1084,-20
57347758901,57347758901,0,1340,1528,-20
57348659963,57348659966,3,1591,989,-20
57350561603,57350561609,6,1508,1149,-20
57352154147,57352154149,2,1965,1440,-20
57353904358,57353904362,4,1277,543,-20
57356341833,57356341837,4,1783,1202,-20
57358741638,57358741641,3,1617,1111,-20
57359410805,57359410806,1,1946,1607,-20
57359562559,57359562562,3,491,32,-20
57363171699,57363171703,4,1915,1772,-20
57365410178,57365410182,4,1928,1100,-20
57367270799,57367270801,2,1844,1415,-20
57368751803,57368751805,2,171,1008,-20
57370111012,57370111013,1,1337,1793,-20
57371638453,57371638456,3,1424,998,-20
57372451782,57372451783,1,2025,1572,-20
57375210661,57375210664,3,1893,1553,-20
57375694503,57375694507,4,1690,1182,-20
57376698222,57376698226,4,2356,1732,-20
57377476882,57377476874,-8,1176,5497,-20
57382643747,57382643751,4,1779,1095,-20
57386175765,57386175770,5,1351,1282,-20
57387573775,57387573782,7,4144,711,-20
57390638570,57390638574,4,1102,1181,-20
57391463822,57391463834,12,1656,991,-20
57392308349,57392308351,2,1786,1366,-20
57393760735,57393760739,4,2090,1711,-20
57395065160,57395065162,2,2294,1723,-20
57397852169,57397852173,4,2554,1393,-20
57398859563,57398859565,2,1182,786,-20
57402132952,57402132954,2,1507,1366,-20
57403039627,57403039631,4,2536,1638,-20
57403116294,57403116303,9,3108,1594,-20
57403305894,57403305896,2,1917,1396,-20
57405711044,57405711047,3,2286,1626,-20
57407342661,57407342666,5,2021,1105,-20
57408121163,57408121166,3,2243,1718,-20
57415289554,57415289556,2,2063,1371,-20
57416786112,57416786115,3,2403,1255,-20
57417618574,57417618577,3,1275,1251,-20
57418790443,57418790446,3,2231,1331,-20
57419608993,57419608997,4,2169,1699,-20
57422595785,57422595785,0,1572,1074,-20
57425262422,57425262425,3,1759,1169,-20
57425551523,57425551525,2,775,1041,-20
57428940543,57428940548,5,1897,1216,-20
57429896499,57429896492,-7,477,184,-20
57434258481,57434258487,6,2337,1366,-20
57435515013,57435515014,1,2093,1255,-20
57436986018,57436986021,3,1630,1317,-20
57439254049,57439254051,2,1936,1894,-20
57440429478,57440429482,4,1943,1194,-20
57442383257,57442383258,1,1726,1270,-20
57443957864,57443957867,3,1075,1046,-20
57444630422,57444630423,1,1666,2005,-20
57446480623,57446480628,5,2778,1275,-20
57454266849,57454266853,4,1374,899,-20
57454294973,57454294975,2,1790,1921,-20
57455913546,57455913549,3,2792,1857,-20
57457781349,57457781350,1,1796,1544,-20
57458753713,57458753713,0,1424,2466,-20
57463141985,57463141989,4,2588,1845,-20
57463179154,57463179161,7,1599,1488,-20
57467166194,57467166195,1,1634,1775,-20
57470713734,57470713739,5,1250,1100,-20
57472260354,57472260360,6,1525,1135,-20
57472900199,57472900176,-23,1802,1251,-20
57474858357,57474858358,1,1720,1183,-20
57474915030,57474915034,4,1112,1269,-20
57475838355,57475838357,2,1496,1895,-20
57478168686,57478168689,3,2417,1734,-20
57479147576,57479147576,0,1553,1666,-20
57484373057,57484373038,-19,1630,1147,-20
57485158338,57485158339,1,1785,1395,-20
57489285336,57489285337,1,6910,5756,-20
57490555786,57490555787,1,1866,1944,-20
57490685306,57490685305,-1,1524,1821,-20
57491199997,57491199999,2,1120,1249,-20
57491882543,57491882545,2,1514,794,-20
57492263385,57492263387,2,2010,1324,-20
57494104821,57494104824,3,2312,1617,-20
57495806147,57495806150,3,1130,1116,-20
57496018910,57496018911,1,1381,1064,-20
57496207008,57496207012,4,2459,1443,-20
57496283964,57496283978,14,1222,1072,-20
57496865882,57496865884,2,1948,1319,-20
57497719630,57497719636,6,2052,1404,-20
57498349510,57498349514,4,1814,1210,-20
57499513062,57499513066,4,2367,1537,-20
57500983984,57500983986,2,1678,1137,-20
57501560983,57501560987,4,855,837,-20
57504221135,57504221138,3,1899,1608,-20
57507493526,57507493526,0,1236,1405,-20
57508136054,57508136059,5,1521,1215,-20
57511884541,57511884545,4,1752,1832,-20
57513979306,57513979309,3,2792,1674,-20
57522056282,57522056289,7,3097,1511,-20
57523138897,57523138895,-2,2725,4055,-20
57524756114,57524756119,5,2496,1928,-20
57525643708,57525643710,2,1619,1178,-20
57527702527,57527702531,4,2074,1309,-20
57528134506,57528134511,5,1490,958,-20
57529572369,57529572374,5,1555,1397,-20
57536044610,57536044613,3,1487,860,-20
57536301643,57536301625,-18,1720,1373,-20
57539264734,57539264728,-6,925,5581,-20
57540736139,57540736145,6,1428,1278,-20
57545555673,57545555675,2,2113,1608,-20
57547182561,57547182562,1,2872,3429,-20
57547271785,57547271790,5,2495,1531,-20
57547404165,57547404166,1,1811,1377,-20
57549059829,57549059834,5,2822,1114,-20
57554490028,57554490031,3,1759,1505,-20
57555987849,57555987829,-20,1257,1134,-20
57559694482,57559694487,5,1829,1261,-20
57559856754,57559856759,5,1428,1283,-20
57560955076,57560955080,4,1794,1056,-20
57563407752,57563407754,2,1745,1861,-20
57563666314,57563666312,-2,2965,3950,-20
57565480853,57565480858,5,1323,1175,-20
57566810312,57566810320,8,11137,35558,-20
57566981082,57566981085,3,1717,1456,-20
57568034525,57568034527,2,1690,1972,-20
57573638770,57573638772,2,1458,1764,-20
57575309738,57575309741,3,1523,1831,-20
57576973810,57576973815,5,1340,1459,-20
57577150558,57577150561,3,1385,1202,-20
57577690894,57577690874,-20,1242,754,-20
57589688998,57589689001,3,1608,1445,-20
57592055278,57592055281,3,1655,1471,-20
57592249511,57592249515,4,2185,1153,-20
57593693337,57593693340,3,1767,1485,-20
57594595914,57594595914,0,1964,1732,-20
57598876134,57598876131,-3,1074,2679,-20
57600148565,57600148567,2,1550,1536,-20
57600868773,57600868778,5,1798,1655,-20
57603959716,57603959721,5,2778,845,-20
57605351804,57605351808,4,2765,2112,-20
57608294625,57608294626,1,714,1345,-20
57608939121,57608939119,-2,1377,1906,-20
57611940083,57611940087,4,1591,1462,-20
57612254896,57612254905,9,16954,25879,-20
57614516743,57614516746,3,2485,1438,-20
57616484685,57616484688,3,2303,1761,-20
57618185081,57618185085,4,2190,1499,-20
57623932212,57623932217,5,1922,1723,-20
57624967473,57624967479,6,1875,812,-20
57625004562,57625004567,5,1283,1133,-20
57626061369,57626061354,-15,737,417,-20
57626903119,57626903117,-2,1493,2438,-20
57631837565,57631837567,2,1029,1020,-20
57632652570,57632652563,-7,1775,8755,-20
57634924942,57634924945,3,1669,1397,-20
57637169962,57637169965,3,2467,1460,-20
57637608067,57637608069,2,1255,1749,-20
57640348760,57640348763,3,1668,1404,-20
57642120547,57642120550,3,2118,1918,-20
57642444718,57642444721,3,2354,1944,-20
57646806527,57646806530,3,1309,1221,-20
57647646630,57647646637,7,1988,1698,-20
57648724982,57648724984,2,1168,1590,-20
57656904740,57656904744,4,1705,1661,-20
57657769866,57657769869,3,2501,1644,-20
57658993926,57658993929,3,2534,1772,-20
57660322806,57660322809,3,2006,1251,-20
57660505446,57660505427,-19,1192,391,-20
57662340363,57662340367,4,1025,898,-20
57664837489,57664837489,0,1212,1009,-20
57668726631,57668726634,3,1948,2180,-20
57676114047,57676114051,4,1394,1255,-20
57676289772,57676289775,3,1904,1955,-20
57678129094,57678129093,-1,2425,3526,-20
57679243855,57679243859,4,1819,1339,-20
57683727498,57683727502,4,1898,1173,-20
57685806754,57685806757,3,2109,1609,-20
57686574262,57686574260,-2,935,3202,-20
57688767365,57688767366,1,1288,1526,-20
57689757026,57689757030,4,1758,1733,-20
57694183735,57694183738,3,2426,2311,-20
57699765924,57699765928,4,3334,1655,-20
57700657668,57700657670,2,1675,1623,-20
57703184464,57703184467,3,442,54,-20
57706870286,57706870290,4,1442,1078,-20
57707814382,57707814384,2,2058,1812,-20
57710340037,57710340038,1,958,691,-20
57711339377,57711339379,2,1474,1501,-20
57713444170,57713444173,3,947,1269,-20
57715163914,57715163918,4,1455,2025,-20
57715456222,57715456225,3,1464,1032,-20
57716068375,57716068377,2,1218,1213,-20
57717316741,57717316744,3,1837,1612,-20
57718500980,57718500985,5,1937,959,-20
57718539122,57718539129,7,2739,1644,-20
57721241337,57721241341,4,1624,1577,-20
57723926932,57723926937,5,2254,1521,-20
57725443741,57725443745,4,5190,2760,-20
57732367009,57732367013,4,2511,1915,-20
57734999685,57734999687,2,1848,1295,-20
57741064775,57741064781,6,22090,50824,-20
57742591688,57742591691,3,2109,1532,-20
57742686618,57742686628,10,16301,43482,-20
57743267745,57743267746,1,2438,2184,-20
57743901554,57743901557,3,1077,799,-20
57744172645,57744172647,2,2189,1026,-20
57744900833,57744900835,2,2498,1777,-20
57747624468,57747624483,15,890,1149,-20
57748455773,57748455780,7,2282,1801,-20
57750432608,57750432610,2,1680,1563,-20
57751462350,57751462355,5,2235,1313,-20
57751589336,57751589338,2,2836,2832,-20
57751895301,57751895306,5,1859,1466,-20
57752262738,57752262742,4,1377,1146,-20
57753775629,57753775633,4,1760,1603,-20
57755413558,57755413562,4,1670,889,-20
57756548555,57756548559,4,2614,1225,-20
57757288678,57757288683,5,2089,1312,-20
57757768254,57757768257,3,1322,1314,-20
57757817392,57757817396,4,2605,1718,-20
57758869826,57758869830,4,1174,1065,-20
57760128541,57760128543,2,1484,1331,-20
57760329846,57760329851,5,1881,1218,-20
57760435180,57760435182,2,1802,1327,-20
57763302581,57763302583,2,1438,1196,-20
57763693811,57763693815,4,1921,1348,-20
57766993366,57766993370,4,1498,928,-20
57769437547,57769437550,3,2516,1980,-20
57769554545,57769554547,2,2229,1514,-20
57770900835,57770900836,1,2327,1861,-20
57772147401,57772147403,2,2069,1595,-20
57774418216,57774418218,2,2077,1598,-20
57774722808,57774722813,5,1819,1716,-20
57774905942,57774905947,5,682,480,-20
57778138451,57778138449,-2,1318,2302,-20
57778953342,57778953346,4,1426,1226,-20
57782070122,57782070134,12,1202,1478,-20
57783388645,57783388647,2,1568,1030,-20
57784067462,57784067476,14,1750,1201,-20
57787883680,57787883697,17,16267,17897,-20
57796962642,57796962646,4,1566,1377,-20
57798338319,57798338322,3,1654,1350,-20
57798941994,57798941997,3,1142,1256,-20
57801311613,57801311617,4,1766,1179,-20
57801853526,57801853530,4,1550,929,-20
57803794251,57803794250,-1,664,1133,-20
57804457047,57804457050,3,1361,1010,-20
57804949163,57804949167,4,1128,1175,-20
57806054652,57806054674,22,1926,1779,-20
57806473637,57806473644,7,11571,37273,-20
57806637490,57806637495,5,1416,1052,-20
57808048265,57808048269,4,1604,1222,-20
57811130414,57811130417,3,1501,1270,-20
57811524919,57811524906,-13,997,391,-20
57816029478,57816029480,2,1525,1626,-20
57817990531,57817990537,6,1266,830,-20
57821536448,57821536450,2,2006,1434,-20
57822419926,57822419925,-1,1542,2191,-20
57828101017,57828101019,2,2077,1495,-20
57828203672,57828203678,6,3471,1023,-20
57831866042,57831866046,4,2323,1052,-20
57831953615,57831953618,3,1653,1541,-20
57832936547,57832936551,4,1835,1142,-20
57834353538,57834353540,2,1160,1335,-20
57834976204,57834976207,3,1846,1271,-20
57835756683,57835756686,3,1464,1527,-20
57839009771,57839009773,2,1678,1476,-20
57840197474,57840197480,6,1733,1390,-20
57840337524,57840337530,6,1310,1111,-20
57842110074,57842110077,3,2522,1342,-20
57850083027,57850083030,3,1322,1230,-20
57851420679,57851420682,3,1321,1084,-20
57852168261,57852168263,2,1335,1169,-20
57855757858,57855757854,-4,1227,3362,-20
57862067489,57862067491,2,1883,1438,-20
57862434278,57862434279,1,830,900,-20
57864863414,57864863416,2,1288,998,-20
57868724313,57868724316,3,1666,1852,-20
57873418937,57873418939,2,1579,1222,-20
57873801554,57873801555,1,1304,1387,-20
57874282872,57874282874,2,2289,1917,-20
57876468494,57876468497,3,2036,1466,-20
57876870346,57876870346,0,1731,2078,-20
57879040394,57879040399,5,1501,1207,-20
57879393729,57879393732,3,1325,2398,-20
57879813322,57879813327,5,1765,1182,-20
57881367870,57881367874,4,2015,1372,-20
57882708407,57882708410,3,1904,1515,-20
57885296770,57885296770,0,1610,1363,-20
57888337135,57888337138,3,2149,1378,-20
57890941690,57890941694,4,2128,1159,-20
57891061884,57891061904,20,1853,1399,-20
57891837790,57891837795,5,1464,1079,-20
57892299458,57892299459,1,1877,1451,-20
57892535513,57892535516,3,2019,959,-20
57892720354,57892720358,4,1596,1609,-20
57893559601,57893559605,4,1596,1449,-20
57894762561,57894762563,2,1590,1247,-20
57902400970,57902400973,3,1975,781,-20
57902537221,57902537229,8,17917,20311,-20
57903399203,57903399210,7,6275,2058,-20
57903613031,57903613034,3,2009,1303,-20
57903651558,57903651562,4,1725,1176,-20
57908362857,57908362861,4,1778,1159,-20
57918321580,57918321583,3,2259,1658,-20
57918386562,57918386567,5,4113,2660,-20
57919466845,57919466838,-7,736,3686,-20
57923955085,57923955086,1,1120,1089,-20
57926984874,57926984878,4,2049,1239,-20
57927347255,57927347259,4,1935,1295,-20
57928201643,57928201646,3,1786,1216,-20
57933143878,57933143881,3,1097,1138,-20
57935081014,57935081015,1,2329,1371,-20
57936790001,57936790003,2,2080,1680,-20
57938796922,57938796928,6,2439,1620,-20
57940736846,57940736850,4,1597,1653,-20
57950837962,57950837966,4,1576,1397,-20
57952108631,57952108634,3,1317,1113,-20
57952221883,57952221886,3,2256,1800,-20
57952327033,57952327037,4,1891,1343,-20
57952385774,57952385778,4,1899,1280,-20
57957266543,57957266550,7,3265,1610,-20
57959124328,57959124333,5,1990,1479,-20
57960141681,57960141683,2,1739,1995,-20
57961624361,57961624364,3,1446,1632,-20
57963981580,57963981579,-1,767,845,-20
57964276595,57964276600,5,2027,1315,-20
57966145090,57966145085,-5,23462,16355,-20
57967180525,57967180536,11,1765,1679,-20
57967219202,57967219203,1,1712,1696,-20
57969448066,57969448062,-4,1092,1783,-20
57969643591,57969643587,-4,970,3528,-20
57969844728,57969844722,-6,1487,956,-20
57970142984,57970142980,-4,1136,2460,-20
57971255865,57971255869,4,1461,1119,-20
57975282817,57975282821,4,1524,1843,-20
57977203833,57977203838,5,1552,1486,-20
57979050257,57979050263,6,1944,1253,-20
57981339458,57981339462,4,1038,682,-20
57981715375,57981715380,5,1191,1028,-20
57982411031,57982411035,4,1460,855,-20
57986268429,57986268431,2,1841,1531,-20
57987619588,57987619591,3,1358,987,-20
57989097495,57989097498,3,1698,948,-20
57991297084,57991297085,1,1746,2407,-20
57998149182,57998149182,0,1237,2601,-20
58001208347,58001208351,4,1822,1760,-20
58002407445,58002407444,-1,32934,56435,-20
58003241974,58003241978,4,1593,1161,-20
58008272706,58008272708,2,2058,1720,-20
58009540793,58009540796,3,2478,1761,-20
58010223344,58010223351,7,1664,1469,-20
58013226381,58013226385,4,1393,892,-20
58021795773,58021795779,6,1108,1199,-20
58023118394,58023118397,3,1288,1296,-20
58023318415,58023318419,4,2362,1528,-20
58023911622,58023911626,4,2212,1453,-20
58025005503,58025005508,5,1463,1157,-20
58026453734,58026453724,-10,40777,12096,-20
58027981955,58027981959,4,2097,1231,-20
58028499177,58028499177,0,663,178,-20
58029381639,58029381641,2,1582,2509,-20
58032230092,58032230095,3,2658,1950,-20
58032320949,58032320942,-7,1883,9586,-20
58032402252,58032402234,-18,1374,1009,-20
58033845269,58033845270,1,1487,1283,-20
58037845559,58037845558,-1,1415,2869,-20
58045282520,58045282522,2,2434,1682,-20
58046997074,58046997074,0,963,1426,-20
58048020662,58048020663,1,2180,1450,-20
58048340117,58048340122,5,1579,1423,-20
58048539729,58048539732,3,2276,1456,-20
58053284520,58053284522,2,1720,1241,-20
58054986293,58054986290,-3,2139,3773,-20
58055610834,58055610840,6,1814,1519,-20
58055849395,58055849398,3,1623,1785,-20
58056466679,58056466683,4,2611,1878,-20
58060202308,58060202311,3,2233,1537,-20
58061579775,58061579779,4,2539,1929,-20
58065501403,58065501393,-10,1770,1656,-20
58067673757,58067673762,5,2219,1138,-20
58069751385,58069751391,6,2786,1177,-20
58071144995,58071144997,2,1846,1497,-20
58072038619,58072038621,2,1877,1740,-20
58076646734,58076646734,0,2180,1703,-20
58077086201,58077086198,-3,51767,20938,-20
58080049365,58080049367,2,1754,1671,-20
58086300330,58086300334,4,2382,1692,-20
58087458590,58087458594,4,1601,1034,-20
58088000249,58088000252,3,1795,1670,-20
58089417294,58089417299,5,2406,1435,-20
58090452445,58090452450,5,2144,1714,-20
58092109645,58092109651,6,1898,1478,-20
58095457076,58095457079,3,1988,1684,-20
58096290654,58096290658,4,1705,1497,-20
58096866561,58096866563,2,1485,1707,-20
58099319452,58099319456,4,2029,1126,-20
58100940243,58100940250,7,5494,2461,-20
58105072788,58105072790,2,1249,1008,-20
58107531403,58107531402,-1,1795,2645,-20
58108275195,58108275197,2,1620,1471,-20
58109366221,58109366224,3,1695,1760,-20
58116744044,58116744048,4,1770,1154,-20
58118033456,58118033457,1,1441,1321,-20
58118534382,58118534389,7,1072,1173,-20
58121444562,58121444567,5,1736,1565,-20
58122727222,58122727206,-16,1073,1359,-20
58128003899,58128003903,4,1467,664,-20
58128950825,58128950825,0,1817,1548,-20
58129497341,58129497337,-4,32050,14334,-20
58130756147,58130756140,-7,717,4436,-20
58135578947,58135578950,3,1255,1387,-20
58136597623,58136597628,5,2218,1430,-20
58137368884,58137368886,2,2380,1611,-20
58137821380,58137821383,3,2141,1228,-20
58138536824,58138536827,3,2060,1690,-20
58139280850,58139280855,5,1869,1473,-20
58140044330,58140044334,4,1829,1543,-20
58145697541,58145697545,4,1610,1453,-20
58146399209,58146399214,5,3043,2070,-20
58148281202,58148281205,3,1850,1680,-20
58151784437,58151784439,2,2001,1703,-20
58154403916,58154403918,2,1752,1202,-20
58154501616,58154501619,3,1586,1388,-20
58155374623,58155374628,5,2255,1414,-20
58155545763,58155545765,2,1960,1575,-20
58155791310,58155791317,7,1746,918,-20
58157150785,58157150790,5,2414,1946,-20
58160140278,58160140281,3,1801,1475,-20
58160953800,58160953806,6,2982,1401,-20
58161998465,58161998448,-17,613,209,-20
58166052875,58166052871,-4,2588,5535,-20
58167463994,58167463998,4,2226,1745,-20
58171290993,58171290994,1,1032,940,-20
58178229506,58178229509,3,1750,1592,-20
58180513869,58180513873,4,1502,1294,-20
58182836919,58182836923,4,2101,1274,-20
58183790052,58183790054,2,1352,1068,-20
58186771305,58186771297,-8,687,2179,-20
58189399922,58189399926,4,2039,1365,-20
58189785166,58189785169,3,2033,1591,-20
58190892010,58190892014,4,2385,1296,-20
58191337319,58191337319,0,1134,1310,-20
58192492479,58192492483,4,1759,1539,-20
58204437498,58204437501,3,2037,1133,-20
58204575698,58204575699,1,1504,1581,-20
58205111490,58205111494,4,2437,1843,-20
58205851802,58205851806,4,2196,1596,-20
58207122233,58207122212,-21,2962,3399,-20
58207658258,58207658263,5,1705,1202,-20
58208232214,58208232220,6,2220,2032,-20
58212160444,58212160448,4,1441,779,-20
58213031008,58213031012,4,1856,1804,-20
58215119151,58215119153,2,1308,1813,-20
58219607817,58219607820,3,1474,1605,-20
58220611822,58220611825,3,1911,1343,-20
58222419922,58222419925,3,1603,1144,-20
58223579154,58223579159,5,1325,1056,-20
58223865873,58223865875,2,1464,1524,-20
58226005918,58226005921,3,2447,1530,-20
58226681562,58226681564,2,1599,1269,-20
58227435635,58227435639,4,1343,949,-20
58228526439,58228526443,4,765,841,-20
58235949846,58235949850,4,2175,1585,-20
58242906739,58242906744,5,2030,1299,-20
58243168688,58243168691,3,1213,1153,-20
58243661321,58243661322,1,2432,1339,-20
58244882661,58244882663,2,1495,1087,-20
58246033378,58246033382,4,1382,1389,-20
58246175990,58246175994,4,1289,1088,-20
58246985490,58246985491,1,2338,1111,-20
58252949994,58252949997,3,2049,1181,-20
58253377302,58253377305,3,1627,1425,-20
58255588581,58255588585,4,2819,1951,-20
58256286557,58256286558,1,1137,1079,-20
58258519726,58258519730,4,1411,1372,-20
58261723857,58261723861,4,1738,1323,-20
58264021379,58264021385,6,4565,1907,-20
58270631210,58270631211,1,2086,913,-20
58275936698,58275936703,5,2057,900,-20
58279788514,58279788519,5,2032,1133,-20
58280133487,58280133489,2,1692,1258,-20
58288921359,58288921364,5,3077,1599,-20
58288968725,58288968719,-6,1665,6533,-20
58296357105,58296357111,6,2178,1189,-20
58304893535,58304893538,3,1958,1448,-20
58306001340,58306001342,2,1669,1668,-20
58310005961,58310005966,5,1925,1314,-20
58311228978,58311228982,4,1862,1462,-20
58313551978,58313551981,3,1764,1257,-20
58314549428,58314549430,2,1454,1081,-20
58317109996,58317109999,3,1317,1308,-20
58319210522,58319210527,5,1196,763,-20
58321753449,58321753446,-3,977,2593,-20
58325962614,58325962616,2,1874,1351,-20
58326621735,58326621739,4,1652,1507,-20
58327894746,58327894744,-2,1023,1804,-20
58328278969,58328278971,2,1643,1137,-20
58330258807,58330258811,4,1053,880,-20
58330799907,58330799909,2,1614,2112,-20
58339870689,58339870692,3,1747,1428,-20
58342468947,58342468948,1,1376,957,-20
58347820298,58347820299,1,870,1088,-20
58351118114,58351118119,5,1847,899,-20
58357848754,58357848758,4,2163,1334,-20
58358131995,58358131998,3,1190,1239,-20
58362060930,58362060935,5,6204,3281,-20
58368570190,58368570195,5,2177,1546,-20
58370174174,58370174177,3,1555,1183,-20
58370832749,58370832750,1,1918,2605,-20
58370885924,58370885929,5,1072,920,-20
58373705722,58373705725,3,2721,1815,-20
58375113830,58375113833,3,2075,1763,-20
58379797744,58379797746,2,1471,1040,-20
58380219638,58380219639,1,1912,894,-20
58380778472,58380778475,3,1181,1380,-20
58386100014,58386100019,5,790,575,-20
58388892118,58388892121,3,2501,1138,-20
58389500543,58389500547,4,1182,1019,-20
58392434795,58392434802,7,2206,1284,-20
58397940893,58397940894,1,1945,1777,-20
58398967849,58398967855,6,2660,1445,-20
58403459446,58403459451,5,1835,1145,-20
58404490111,58404490114,3,1258,848,-20
58404663345,58404663345,0,1733,1581,-20
58406258754,58406258750,-4,1149,1003,-20
58408407833,58408407837,4,1986,1542,-20
58409576473,58409576471,-2,1115,1556,-20
58409617403,58409617405,2,2358,1389,-20
58412605479,58412605482,3,1473,801,-20
58412881198,58412881217,19,415,98,-20
58414555781,58414555783,2,1856,1343,-20
58424090871,58424090876,5,2015,1697,-20
58427606297,58427606302,5,3044,1938,-20
58428849615,58428849618,3,2293,1725,-20
58432026749,58432026751,2,1718,945,-20
58436413118,58436413118,0,1199,1212,-20
58436853698,58436853681,-17,797,461,-20
58439235085,58439235086,1,1030,1348,-20
58442849987,58442849993,6,2196,1419,-20
58444635650,58444635654,4,1094,978,-20
58447176139,58447176142,3,1604,914,-20
58450619710,58450619714,4,1228,1709,-20
58451345649,58451345652,3,1966,1656,-20
58454577935,58454577921,-14,1583,853,-20
58456303183,58456303186,3,2252,1286,-20
58457434567,58457434571,4,2140,1581,-20
58457965247,58457965230,-17,2151,1254,-20
58458611929,58458611930,1,1908,1569,-20
58459841986,58459841991,5,1454,1087,-20
58460091497,58460091499,2,1624,1476,-20
58461766156,58461766162,6,592,1023,-20
58463303236,58463303216,-20,1994,1017,-20
58465877652,58465877655,3,1357,1698,-20
58466682953,58466682958,5,2120,1193,-20
58471187866,58471187869,3,1808,1544,-20
58471964396,58471964400,4,1643,1398,-20
58475111382,58475111389,7,3826,1248,-20
58475477304,58475477307,3,1921,1605,-20
58475807373,58475807376,3,2184,1775,-20
58480069291,58480069295,4,1511,734,-20
58480937390,58480937395,5,1370,1446,-20
58481431634,58481431636,2,1852,1584,-20
58482512850,58482512855,5,2238,1963,-20
58484554567,58484554571,4,1368,1107,-20
58488263668,58488263670,2,1684,1282,-20
58488530291,58488530293,2,1479,1631,-20
58489192589,58489192593,4,1528,1113,-20
58490289596,58490289593,-3,2538,5998,-20
58490648111,58490648115,4,1756,1596,-20
58492580621,58492580625,4,1349,1097,-20
58495059509,58495059513,4,1643,1618,-20
58496014314,58496014311,-3,828,1953,-20
58506751702,58506751702,0,1059,1230,-20
58511968112,58511968115,3,1691,1263,-20
58513759882,58513759886,4,2269,1354,-20
58526255527,58526255529,2,1851,1328,-20
58526766634,58526766632,-2,1661,3125,-20
58527534694,58527534697,3,2474,2162,-20
58528151082,58528151086,4,2511,1759,-20
58529283979,58529283978,-1,955,1224,-20
58529788322,58529788324,2,1410,1372,-20
58531003302,58531003284,-18,1369,1508,-20
58532846854,58532846853,-1,1464,1592,-20
58534656310,58534656313,3,1945,1773,-20
58537782184,58537782185,1,1931,1782,-20
58538858202,58538858207,5,2494,2002,-20
58538979153,58538979154,1,1590,890,-20
58539356873,58539356873,0,2765,3242,-20
58546427714,58546427719,5,2593,977,-20
58546960459,58546960458,-1,1756,1313,-20
58547742932,58547742935,3,1905,1169,-20
58550059039,58550059042,3,2045,1190,-20
58550792646,58550792650,4,2292,1180,-20
58561207177,58561207181,4,1720,1718,-20
58561821253,58561821256,3,2476,1546,-20
58566932266,58566932268,2,2672,1855,-20
58567056848,58567056851,3,2492,1602,-20
58568078527,58568078530,3,1008,1118,-20
58572600755,58572600749,-6,651,1463,-20
58573047720,58573047723,3,1797,1169,-20
58573131479,58573131460,-19,1131,1118,-20
58574126888,58574126890,2,1495,1137,-20
58579722173,58579722175,2,1949,1756,-20
58584420148,58584420151,3,1928,1274,-20
58587951777,58587951777,0,46368,21227,-20
58588131603,58588131605,2,1711,1188,-20
58590037051,58590037055,4,1601,906,-20
58590171346,58590171330,-16,986,662,-20
58590528515,58590528518,3,925,1560,-20
58591468394,58591468377,-17,1467,828,-20
58593649306,58593649311,5,1406,1186,-20
58593744758,58593744761,3,1386,1651,-20
58599754745,58599754746,1,1606,1655,-20
58602710362,58602710365,3,1888,1525,-20
58603935638,58603935643,5,2887,1322,-20
58605129104,58605129107,3,1868,1573,-20
58605569742,58605569747,5,1796,1640,-20
58619442599,58619442602,3,1299,826,-20
58621052014,58621052018,4,2568,1376,-20
58621131653,58621131673,20,1729,1340,-20
58621993751,58621993729,-22,1721,1099,-20
58623095157,58623095161,4,2609,1645,-20
58623850624,58623850612,-12,583,389,-20
58625158165,58625158164,-1,2450,4335,-20
58625532978,58625532981,3,2242,1593,-20
58625768045,58625768046,1,1836,1309,-20
58626332426,58626332431,5,1648,1427,-20
58626620842,58626620846,4,2011,1413,-20
58628819341,58628819343,2,2437,1933,-20
58632141757,58632141759,2,1320,1079,-20
58633920564,58633920569,5,2932,937,-20
58634811198,58634811197,-1,10973,17537,-20
58635468714,58635468719,5,2089,1240,-20
58637029449,58637029453,4,993,1374,-20
58637252183,58637252188,5,1697,1652,-20
58639615338,58639615341,3,1557,1478,-20
58640061078,58640061079,1,1726,1071,-20
58641110333,58641110336,3,1944,2177,-20
58641350125,58641350132,7,10059,37956,-20
58641953978,58641953981,3,15330,11225,-20
58641997191,58641997194,3,1404,853,-20
58642698464,58642698468,4,2024,1391,-20
58643990815,58643990818,3,1266,937,-20
58649927187,58649927190,3,1453,1302,-20
58650895170,58650895156,-14,1409,600,-20
58651362837,58651362838,1,1840,1439,-20
58653175601,58653175603,2,2260,1513,-20
58653658862,58653658864,2,1943,1298,-20
58654834366,58654834370,4,2857,1852,-20
58655034034,58655034038,4,2133,1492,-20
58655721047,58655721037,-10,967,318,-20
58657062322,58657062326,4,1580,1122,-20
58658973583,58658973586,3,2842,1596,-20
58661875953,58661875956,3,1318,1700,-20
58665962532,58665962533,1,1188,758,-20
58674923253,58674923256,3,2388,1312,-20
58675179984,58675179986,2,1379,1099,-20
58677349127,58677349129,2,1921,1429,-20
58679076090,58679076095,5,5295,3028,-20
58682233858,58682233859,1,1399,1487,-20
58685013421,58685013415,-6,932,3805,-20
58686606542,58686606545,3,5429,4694,-20
58686732898,58686732903,5,2055,1454,-20
58687292458,58687292462,4,1362,903,-20
58687884931,58687884947,16,2120,1888,-20
58688656042,58688656041,-1,1370,2321,-20
58691063918,58691063914,-4,54519,22303,-20
58692992386,58692992390,4,1578,1235,-20
58694071915,58694071914,-1,885,1674,-20
58696687665,58696687669,4,2457,1588,-20
58697577851,58697577854,3,1799,1329,-20
58699386173,58699386176,3,1814,1532,-20
58701049206,58701049210,4,2045,1007,-20
58706295864,58706295866,2,1306,1078,-20
58713795163,58713795166,3,1722,1271,-20
58717397900,58717397887,-13,1328,696,-20
58723868055,58723868055,0,990,1378,-20
58725049234,58725049235,1,1934,1403,-20
58725992128,58725992151,23,778,3240,-20
58728216935,58728216938,3,2227,1476,-20
58728744770,58728744772,2,1727,1011,-20
58731633603,58731633605,2,2811,1635,-20
58731861778,58731861782,4,1772,1275,-20
58732995986,58732995989,3,2311,1465,-20
58733601509,58733601513,4,2285,1720,-20
58734918293,58734918295,2,1402,1142,-20
58740262598,58740262601,3,2177,1555,-20
58741062262,58741062266,4,1803,1682,-20
58744345302,58744345305,3,1249,1136,-20
58747372629,58747372630,1,1982,1552,-20
58748594554,58748594560,6,2028,1378,-20
58749063870,58749063883,13,2792,1525,-20
58750324242,58750324246,4,1024,984,-20
58758081218,58758081222,4,2354,1652,-20
58771678097,58771678101,4,2764,1645,-20
58772619621,58772619626,5,1540,1152,-20
58774295591,58774295593,2,1501,1268,-20
58776163670,58776163668,-2,942,1714,-20
58778493339,58778493346,7,1432,1155,-20
58779505442,58779505442,0,1071,1348,-20
58782082172,58782082173,1,2781,2167,-20
58784465965,58784465968,3,2912,1950,-20
58788394423,58788394427,4,1345,1081,-20
58789689306,58789689310,4,1138,1232,-20
58790249150,58790249142,-8,24284,14618,-20
58790567317,58790567322,5,1954,1231,-20
58792382614,58792382620,6,1650,1405,-20
58796623395,58796623398,3,1688,1797,-20
58797927618,58797927619,1,1572,1328,-20
58800818115,58800818119,4,2162,827,-20
58801555715,58801555718,3,2314,926,-20
58803072726,58803072729,3,2326,2059,-20
58805813770,58805813772,2,1900,1486,-20
58805951248,58805951251,3,2387,1599,-20
58806863000,58806863002,2,1809,1555,-20
58812942226,58812942230,4,2335,1482,-20
58814333981,58814333983,2,1435,1959,-20
58815603786,58815603797,11,11,4872,-20
58827008980,58827008983,3,1822,1301,-20
58828442138,58828442142,4,1791,1722,-20
58830303813,58830303817,4,1798,1225,-20
58830563148,58830563152,4,2058,1613,-20
58833192406,58833192409,3,1875,1635,-20
58835176661,58835176676,15,1919,1666,-20
58838308546,58838308551,5,1991,1608,-20
58839166426,58839166430,4,1831,1634,-20
58841026596,58841026597,1,1293,1324,-20
58842264963,58842264958,-5,1077,2107,-20
58844262389,58844262392,3,1509,1393,-20
58846576253,58846576255,2,985,1063,-20
58846917867,58846917861,-6,876,4102,-20
58850192976,58850192978,2,1375,993,-20
58852291586,58852291587,1,1147,1097,-20
58854273455,58854273459,4,2100,1431,-20
58854322872,58854322875,3,1849,1285,-20
58854914090,58854914094,4,2241,1249,-20
58856996530,58856996534,4,2857,1349,-20
58858129844,58858129858,14,12516,51210,-20
58859988073,58859988077,4,1414,1038,-20
58862030828,58862030831,3,1965,1734,-20
58864099181,58864099186,5,1401,1134,-20
58864505865,58864505867,2,1755,1745,-20
58865261304,58865261309,5,2011,1516,-20
58866963042,58866963028,-14,500,446,-20
58867014401,58867014401,0,1701,1852,-20
58867270222,58867270227,5,1544,1448,-20
58868381099,58868381103,4,1387,1137,-20
58868802928,58868802911,-17,30066,27828,-20
58869354727,58869354729,2,1139,1292,-20
58872203014,58872203018,4,1152,1354,-20
58874630907,58874630891,-16,1785,1252,-20
58876266041,58876266043,2,2307,1539,-20
58877061617,58877061622,5,2358,1916,-20
58880324637,58880324641,4,2108,2190,-20
58880974819,58880974823,4,1736,1229,-20
58883551737,58883551742,5,2429,1642,-20
58886594866,58886594869,3,1549,1219,-20
58886843073,58886843089,16,841,226,-20
58888537410,58888537414,4,2037,1407,-20
58889683369,58889683371,2,1233,1148,-20
58895303426,58895303430,4,1747,1286,-20
58896018333,58896018335,2,1224,1079,-20
58896422953,58896422960,7,1715,1074,-20
58899969010,58899969014,4,2067,1456,-20
58910371569,58910371572,3,1800,1318,-20
58910811998,58910812002,4,1510,1322,-20
58911211102,58911211105,3,2414,2252,-20
58911915625,58911915631,6,1452,1158,-20
58913514216,58913514225,9,1861,1224,-20
58931933090,58931933093,3,1222,853,-20
58937414842,58937414844,2,55850,49407,-20
58938905673,58938905677,4,2642,1644,-20
58941036501,58941036503,2,1007,1330,-20
58953736798,58953736800,2,1658,1497,-20
58955311350,58955311352,2,2172,1749,-20
58958097965,58958097967,2,1446,1219,-20
58958256429,58958256432,3,2089,2146,-20
58962076653,58962076654,1,2225,1282,-20
58964603057,58964603061,4,2349,1281,-20
58965285007,58965285010,3,1805,1429,-20
58966127152,58966127154,2,1509,1038,-20
58966354000,58966354001,1,1915,1347,-20
58971701314,58971701316,2,1454,1511,-20
58971741093,58971741097,4,1779,1410,-20
58972867094,58972867097,3,1685,1613,-20
58979243769,58979243773,4,1736,1529,-20
58981845746,58981845746,0,1934,1962,-20
58981904685,58981904688,3,2058,1269,-20
58985547695,58985547697,2,2115,2239,-20
58985863335,58985863338,3,1751,1238,-20
58987785341,58987785345,4,1877,999,-20
58987984570,58987984569,-1,1132,1209,-20
58988978275,58988978278,3,1539,1051,-20
58991578488,58991578490,2,1364,965,-20
58994494976,58994494980,4,2096,1356,-20
58995178474,58995178474,0,1637,1212,-20
58995790742,58995790744,2,1274,1409,-20
58996202516,58996202538,22,1650,1631,-20
58997099798,58997099783,-15,578,698,-20
59000491823,59000491828,5,2068,1746,-20
59002491799,59002491803,4,1123,721,-20
59009913983,59009913986,3,2108,986,-20
59013473925,59013473931,6,3045,1766,-20
59014956005,59014956007,2,1879,2010,-20
59021792488,59021792490,2,1457,1280,-20
59022148879,59022148885,6,3218,1567,-20
59022213385,59022213386,1,1231,1899,-20
59024180035,59024180038,3,2505,2065,-20
59026258969,59026258972,3,1151,947,-20
59027277681,59027277685,4,1827,1289,-20
59029966495,59029966499,4,1563,1845,-20
59031115506,59031115509,3,1857,1170,-20
59031712139,59031712141,2,1494,1870,-20
59036064429,59036064432,3,1900,2120,-20
59041539162,59041539162,0,1563,2137,-20
59044496099,59044496106,7,2247,1149,-20
59048774709,59048774711,2,1891,1586,-20
59048972210,59048972215,5,2447,1011,-20
59049039244,59049039248,4,2041,1609,-20
59050562507,59050562511,4,2173,1244,-20
59050644410,59050644406,-4,2135,5125,-20
59050890712,59050890714,2,1944,1344,-20
59051433850,59051433852,2,1840,1281,-20
59054057022,59054057019,-3,753,1417,-20
59055706837,59055706840,3,2115,1661,-20
59056548069,59056548071,2,1538,1238,-20
59060384262,59060384258,-4,1036,803,-20
59065774190,59065774185,-5,1424,5554,-20
59069519637,59069519641,4,1991,1465,-20
59071569617,59071569624,7,5952,2469,-20
59072861737,59072861742,5,6401,1959,-20
59075585182,59075585185,3,1952,1772,-20
59076886155,59076886158,3,1381,1010,-20
59079135983,59079135986,3,1374,1470,-20
59081344811,59081344814,3,2618,1348,-20
59083687710,59083687707,-3,1518,2043,-20
59087227250,59087227256,6,2660,1694,-20
59087516537,59087516539,2,1699,950,-20
59095042193,59095042198,5,1837,1129,-20
59102098297,59102098299,2,1477,1247,-20
59103659487,59103659480,-7,894,4572,-20
59107775485,59107775490,5,1383,1390,-20
59107967529,59107967534,5,1854,1886,-20
59110830398,59110830400,2,2081,2087,-20
59115258129,59115258133,4,1495,1098,-20
59116446221,59116446223,2,2329,1651,-20
59116667722,59116667727,5,1676,635,-20
59122500150,59122500153,3,2079,1300,-20
59124684658,59124684662,4,1372,1675,-20
59127512706,59127512708,2,1333,1380,-20
59131111958,59131111962,4,1910,1263,-20
59131352497,59131352501,4,3870,2264,-20
59132902086,59132902091,5,2438,1468,-20
59134581960,59134581965,5,1743,1268,-20
59137388602,59137388605,3,2139,1711,-20
59138627141,59138627146,5,2227,1390,-20
59141153445,59141153451,6,1305,865,-20
59146461505,59146461509,4,2559,1416,-20
59148504515,59148504522,7,2041,1387,-20
59149715822,59149715827,5,2521,1657,-20
59150767665,59150767658,-7,1293,3851,-20
59153429474,59153429477,3,1865,1708,-20
59157489486,59157489486,0,1225,1530,-20
59157619441,59157619441,0,1559,1259,-20
59158184714,59158184695,-19,1187,1177,-20
59158789237,59158789239,2,2106,1680,-20
59162864901,59162864906,5,1770,1321,-20
59165041750,59165041754,4,2769,1571,-20
59167504074,59167504079,5,1658,1195,-20
59167706395,59167706399,4,1917,1095,-20
59168384618,59168384623,5,2575,1462,-20
59169430770,59169430774,4,2368,1228,-20
59172412914,59172412916,2,2174,1071,-20
59173322960,59173322963,3,1784,1323,-20
59177255837,59177255839,2,1612,1177,-20
59177338865,59177338867,2,1173,1095,-20
59177715102,59177715107,5,1099,786,-20
59178577487,59178577490,3,1757,1493,-20
59181336066,59181336069,3,1433,1139,-20
59182196732,59182196734,2,1727,1231,-20
59184549320,59184549323,3,1595,1249,-20
59184692523,59184692527,4,1221,1244,-20
59188302785,59188302790,5,2283,944,-20
59188578674,59188578677,3,2251,1451,-20
59194520713,59194520715,2,1677,1108,-20
59195842175,59195842179,4,1351,1357,-20
59196306050,59196306052,2,1274,1030,-20
59198330940,59198330942,2,1631,1750,-20
59199509439,59199509444,5,2012,1716,-20
59203477486,59203477487,1,1717,1185,-20
59204827809,59204827812,3,1351,1100,-20
59209499834,59209499838,4,2063,1747,-20
59224281177,59224281179,2,1513,1109,-20
59225774631,59225774634,3,1033,1225,-20
59226036610,59226036613,3,1427,1351,-20
59228639914,59228639917,3,1411,1112,-20
59231297110,59231297114,4,1270,1324,-20
59245237336,59245237338,2,1537,1285,-20
59245674662,59245674667,5,1549,1021,-20
59247329798,59247329803,5,2463,1707,-20
59250217599,59250217604,5,1478,1058,-20
59251274693,59251274696,3,2312,1885,-20
59251537154,59251537159,5,1596,1170,-20
59253166480,59253166486,6,1786,1141,-20
59254738730,59254738727,-3,1242,1854,-20
59258897141,59258897145,4,1679,1273,-20
59259303935,59259303939,4,1266,861,-20
59263584798,59263584799,1,1448,1333,-20
59264551078,59264551078,0,2161,1881,-20
59264759226,59264759229,3,2132,1167,-20
59267047315,59267047319,4,1780,777,-20
59268348861,59268348866,5,2277,1759,-20
59270498354,59270498360,6,1774,1264,-20
59272915346,59272915350,4,1769,1328,-20
59273163798,59273163816,18,1556,1433,-20
59274053061,59274053063,2,1428,1171,-20
59274790930,59274790933,3,2083,1559,-20
59277082471,59277082474,3,1803,1353,-20
59278698002,59278698003,1,1639,1573,-20
59279076063,59279076065,2,1581,1193,-20
59284821510,59284821514,4,1092,1210,-20
59285213121,59285213126,5,1862,1384,-20
59287467778,59287467782,4,1411,1617,-20
59289404169,59289404171,2,2727,1664,-20
59291492157,59291492163,6,3565,1399,-20
59291887626,59291887632,6,2723,1910,-20
59292079683,59292079686,3,2048,1390,-20
59293320470,59293320472,2,1509,1085,-20
59295149491,59295149493,2,2138,1736,-20
59295514285,59295514289,4,2300,1117,-20
59296027502,59296027502,0,2245,2580,-20
59297208174,59297208178,4,1594,1648,-20
59297541478,59297541482,4,1783,1359,-20
59301142163,59301142163,0,1046,1209,-20
59302443133,59302443136,3,2153,1568,-20
59302992547,59302992551,4,1279,937,-20
59305448725,59305448727,2,2571,2063,-20
59309208449,59309208453,4,2209,1732,-20
59310539654,59310539657,3,2189,1610,-20
59311021201,59311021205,4,1881,1022,-20
59312902709,59312902711,2,1681,1457,-20
59312967194,59312967198,4,1908,1661,-20
59314169446,59314169450,4,2014,1225,-20
59314865970,59314865952,-18,1939,938,-20
59316423458,59316423463,5,1801,1811,-20
59316845962,59316845966,4,1651,1470,-20
59321272261,59321272262,1,2077,1356,-20
59324214664,59324214666,2,1769,1288,-20
59324244763,59324244766,3,1587,1506,-20
59330525799,59330525803,4,1676,1380,-20
59331425146,59331425150,4,1768,1527,-20
59343731265,59343731267,2,2155,1314,-20
59345408954,59345408957,3,1490,1296,-20
59347849569,59347849571,2,1897,1807,-20
59348244591,59348244595,4,1405,1001,-20
59348744775,59348744779,4,1418,1222,-20
59356966708,59356966710,2,1426,1559,-20
59357299725,59357299729,4,1596,1563,-20
59359832042,59359832050,8,4204,2101,-20
59359985217,59359985221,4,1234,1004,-20
59361248731,59361248729,-2,1356,2398,-20
59362461774,59362461773,-1,1090,1894,-20
59367879001,59367879005,4,1568,1100,-20
59368026434,59368026437,3,1632,1156,-20
59368740109,59368740111,2,1833,1484,-20
59374673964,59374673967,3,1866,989,-20
59376324397,59376324400,3,1292,1373,-20
59376662190,59376662193,3,2705,1257,-20
59383573307,59383573306,-1,1663,1722,-20
59388840640,59388840643,3,2265,1455,-20
59388932723,59388932727,4,2894,2169,-20
59390062432,59390062434,2,2512,1639,-20
59395895684,59395895686,2,1898,1766,-20
59399520314,59399520314,0,1486,1564,-20
59400813006,59400813011,5,1848,1506,-20
59405771747,59405771750,3,1835,1178,-20
59408839439,59408839442,3,1158,1104,-20
59416377519,59416377524,5,1613,1169,-20
59416440825,59416440827,2,1773,1341,-20
59416528742,59416528745,3,1369,1169,-20
59417309867,59417309870,3,2120,1487,-20
59418867815,59418867818,3,1840,1088,-20
59419970271,59419970274,3,1523,1391,-20
59422396982,59422396987,5,2572,1585,-20
59431373557,59431373561,4,1825,1386,-20
59432001569,59432001573,4,1985,1700,-20
59433404197,59433404191,-6,819,1037,-20
59433703506,59433703511,5,1897,1004,-20
59434572829,59434572833,4,3018,1441,-20
59437178708,59437178712,4,1282,859,-20
59443405426,59443405429,3,897,1315,-20
59444060498,59444060501,3,1383,972,-20
59444446194,59444446197,3,1617,1554,-20
59445612256,59445612258,2,1461,1286,-20
59449486831,59449486835,4,1631,1112,-20
59458660327,59458660330,3,1076,893,-20
59458942033,59458942035,2,2009,1968,-20
59460382363,59460382366,3,1426,1157,-20
59461790591,59461790595,4,1456,1527,-20
59462835081,59462835098,17,1697,1249,-20
59463035788,59463035811,23,1359,1924,-20
59464508411,59464508414,3,1087,1083,-20
59469676733,59469676730,-3,1177,2558,-20
59473973834,59473973838,4,2161,1114,-20
59477140605,59477140610,5,1801,991,-20
59479520286,59479520288,2,2438,1493,-20
59484538662,59484538666,4,1853,1654,-20
59484986045,59484986048,3,1622,1246,-20
59485021653,59485021656,3,1911,1429,-20
59485643430,59485643432,2,1776,1615,-20
59486460336,59486460338,2,1593,1484,-20
59487035385,59487035387,2,1541,903,-20
59487130162,59487130167,5,2080,1978,-20
59488245129,59488245135,6,3347,1575,-20
59488290639,59488290642,3,1490,1299,-20
59489977655,59489977658,3,1362,1399,-20
59490121300,59490121302,2,1702,1524,-20
59492138916,59492138920,4,1380,1374,-20
59493004493,59493004491,-2,1399,2014,-20
59494080331,59494080335,4,1936,1455,-20
59494210700,59494210703,3,1557,1080,-20
59496201746,59496201750,4,1573,1736,-20
59497203354,59497203358,4,1751,1246,-20
59497802320,59497802321,1,2413,1573,-20
59500310573,59500310577,4,1025,1087,-20
59507567937,59507567941,4,1522,1474,-20
59507658919,59507658922,3,1918,1595,-20
59509734171,59509734150,-21,1062,640,-20
59510464038,59510464041,3,1867,1066,-20
59517213482,59517213485,3,1425,1008,-20
59523075457,59523075459,2,2204,1927,-20
59525460234,59525460237,3,2150,1063,-20
59526894128,59526894133,5,1290,717,-20
59527210060,59527210043,-17,1218,859,-20
59530438957,59530438961,4,7110,4902,-20
59532932744,59532932747,3,1469,1017,-20
59533796648,59533796651,3,2122,1795,-20
59537637594,59537637597,3,1677,1381,-20
59539933485,59539933485,0,1211,1355,-20
59540571645,59540571650,5,1498,1206,-20
59540695537,59540695541,4,2078,1616,-20
59543882725,59543882731,6,2833,1186,-20
59545414669,59545414665,-4,1076,4622,-20
59545835976,59545835978,2,2038,1620,-20
59547000033,59547000038,5,1560,1131,-20
59547709710,59547709715,5,1622,992,-20
59548996667,59548996671,4,1410,1342,-20
59551673669,59551673673,4,806,942,-20
59555058583,59555058589,6,1630,1457,-20
59556186876,59556186878,2,1936,1358,-20
59556744762,59556744766,4,1592,1485,-20
59561965854,59561965858,4,2467,1564,-20
59567143499,59567143502,3,1847,1590,-20
59569267366,59569267359,-7,2051,8064,-20
59574141531,59574141534,3,1814,1684,-20
59574808769,59574808771,2,2940,3207,-20
59579756919,59579756923,4,1343,1041,-20
59580420878,59580420882,4,1844,1528,-20
59581442512,59581442513,1,1928,1611,-20
59583577277,59583577281,4,1248,618,-20
59584652667,59584652661,-6,999,2476,-20
59587015014,59587015017,3,1680,1228,-20
59587944282,59587944286,4,1824,1048,-20
59588525531,59588525535,4,1446,1596,-20
59589237919,59589237923,4,2038,1347,-20
59591554645,59591554653,8,1586,1017,-20
59592557323,59592557326,3,2016,1653,-20
59592812835,59592812838,3,1531,919,-20
59595706871,59595706875,4,1791,1006,-20
59597125047,59597125052,5,1738,1016,-20
59597403530,59597403534,4,1835,1210,-20
59599224365,59599224369,4,1965,1398,-20
59604688718,59604688716,-2,770,1497,-20
59607219379,59607219383,4,2259,1283,-20
59608287761,59608287766,5,1699,1383,-20
59611577181,59611577182,1,1097,1025,-20
59615840379,59615840382,3,1117,1480,-20
59617989050,59617989054,4,1673,1168,-20
59620445970,59620445970,0,1492,1210,-20
59622733514,59622733517,3,2173,1557,-20
59624437693,59624437696,3,1855,2031,-20
59626491318,59626491326,8,2500,999,-20
59627212030,59627212034,4,1735,1304,-20
59630463978,59630463981,3,2730,1466,-20
59631985483,59631985486,3,1783,1404,-20
59634261200,59634261206,6,1686,1417,-20
59635482667,59635482671,4,1647,1200,-20
59642361365,59642361368,3,1356,1850,-20
59642459666,59642459662,-4,637,2675,-20
59644738079,59644738080,1,181,4352,-20
59646163677,59646163683,6,2035,1417,-20
59646328310,59646328313,3,2621,1677,-20
59648566037,59648566044,7,3832,1494,-20
59652156287,59652156291,4,2308,1887,-20
59653417493,59653417497,4,2819,1981,-20
59658956493,59658956495,2,1532,1464,-20
59659647269,59659647270,1,2206,1291,-20
59660872481,59660872485,4,2333,1616,-20
59665184475,59665184478,3,1169,1059,-20
59666392354,59666392358,4,1504,1291,-20
59667281587,59667281591,4,2289,1544,-20
59667456050,59667456053,3,1897,1600,-20
59669244698,59669244703,5,1629,1479,-20
59670132222,59670132226,4,1996,748,-20
59672681127,59672681130,3,1515,1433,-20
59676321187,59676321191,4,1330,1161,-20
59677490411,59677490417,6,1600,1195,-20
59683966575,59683966577,2,1505,1377,-20
59687458037,59687458039,2,1077,1518,-20
59689712570,59689712572,2,1897,2063,-20
59701072082,59701072085,3,2012,1370,-20
59701264405,59701264409,4,2224,1474,-20
59702219660,59702219654,-6,1222,4750,-20
59705843833,59705843837,4,1979,1629,-20
59708785338,59708785342,4,1977,1122,-20
59710193675,59710193679,4,2658,1568,-20
59712107119,59712107123,4,1161,962,-20
59712978778,59712978782,4,2394,2007,-20
59713447310,59713447314,4,2199,1753,-20
59716777805,59716777809,4,1986,1283,-20
59720450724,59720450727,3,1499,1131,-20
59720639453,59720639433,-20,1557,763,-20
59723655158,59723655162,4,1894,1628,-20
59724416452,59724416455,3,2892,1539,-20
59725311361,59725311362,1,1799,1698,-20
59726415326,59726415330,4,1136,1329,-20
59729711147,59729711150,3,2064,1938,-20
59731068760,59731068761,1,1750,1560,-20
59734592375,59734592380,5,5814,3120,-20
59735420130,59735420131,1,2215,1522,-20
59736772177,59736772178,1,31645,33169,-20
59737927673,59737927678,5,2015,1731,-20
59743655817,59743655821,4,1612,1603,-20
59746888657,59746888662,5,1464,1597,-20
59748912447,59748912451,4,3466,1645,-20
59752174463,59752174466,3,2223,1292,-20
59756420913,59756420915,2,2523,1221,-20
59759904752,59759904736,-16,1698,1430,-20
59760430460,59760430462,2,2446,1574,-20
59763815778,59763815781,3,1446,1516,-20
59767729830,59767729834,4,2116,1553,-20
59767960890,59767960881,-9,1419,354,-20
59769816558,59769816561,3,904,1025,-20
59770580756,59770580758,2,1826,1596,-20
59771224317,59771224321,4,1614,1328,-20
59772438478,59772438478,0,1170,1636,-20
59774787934,59774787937,3,1634,1814,-20
59774954293,59774954298,5,2851,1331,-20
59775562728,59775562731,3,1464,1501,-20
59776589510,59776589514,4,1772,1336,-20
59777808389,59777808393,4,1918,1073,-20
59778181900,59778181902,2,1445,1384,-20
59780795203,59780795199,-4,1316,2447,-20
59783853467,59783853472,5,1701,1610,-20
59784273895,59784273897,2,1573,1344,-20
59789586990,59789586994,4,1154,1302,-20
59791073745,59791073747,2,1636,1680,-20
59794579405,59794579412,7,3304,972,-20
59795402365,59795402346,-19,1408,931,-20
59799595033,59799595035,2,1761,1369,-20
59800454627,59800454634,7,2149,1277,-20
59801093731,59801093734,3,1565,1307,-20
59808577437,59808577440,3,696,1064,-20
59810824183,59810824185,2,1742,1191,-20
59813007641,59813007643,2,2260,1465,-20
59814640789,59814640797,8,2359,1363,-20
59816109274,59816109278,4,2724,1482,-20
59816606499,59816606501,2,1588,1332,-20
59816673234,59816673241,7,2545,1993,-20
59818005643,59818005646,3,2563,2122,-20
59819092637,59819092638,1,1422,797,-20
59821244711,59821244718,7,1268,1206,-20
59821794115,59821794120,5,2024,1285,-20
59822646357,59822646337,-20,1091,667,-20
59823976748,59823976750,2,2477,1579,-20
59829094042,59829094044,2,1596,1462,-20
59831411328,59831411329,1,2157,1753,-20
59833216273,59833216276,3,1595,1558,-20
59834849355,59834849361,6,2012,1079,-20
59840397642,59840397646,4,1662,1352,-20
59844448734,59844448738,4,1344,1624,-20
59845637534,59845637539,5,2150,1462,-20
59846164522,59846164506,-16,833,14,-20
59847474781,59847474783,2,1914,1692,-20
59849844113,59849844116,3,2027,1792,-20
59851886446,59851886449,3,2324,2094,-20
59856045379,59856045383,4,1858,1751,-20
59857550285,59857550281,-4,1358,2119,-20
59857691153,59857691154,1,1221,928,-20
59859718286,59859718287,1,1891,1445,-20
59869609557,59869609560,3,1359,1757,-20
59870724807,59870724801,-6,9370,1908,-20
59875583698,59875583701,3,1496,1465,-20
59879410402,59879410405,3,2674,1917,-20
59879653042,59879653046,4,1776,1364,-20
59881764043,59881764047,4,2509,1925,-20
59883817991,59883817996,5,2976,1545,-20
59886467894,59886467898,4,1827,1131,-20
59888632042,59888632046,4,1931,1521,-20
59892084245,59892084251,6,2060,1048,-20
59896657963,59896657966,3,1142,816,-20
59904228917,59904228922,5,1982,1040,-20
59905137066,59905137071,5,2029,1200,-20
59912897916,59912897919,3,1206,1170,-20
59917253423,59917253429,6,1612,1452,-20
59917533250,59917533271,21,357,1631,-20
59919748037,59919748041,4,1688,1315,-20
59923109921,59923109925,4,2954,1862,-20
59925342836,59925342839,3,1645,1486,-20
59930018268,59930018269,1,9316,10767,-20
59930434197,59930434201,4,1929,1201,-20
59934006006,59934006008,2,1614,1246,-20
59937551207,59937551209,2,1480,1632,-20
59941724153,59941724155,2,1773,1131,-20
59944174617,59944174624,7,2747,2277,-20
59946088182,59946088185,3,2088,1484,-20
59958224219,59958224218,-1,1584,1871,-20
59960440765,59960440761,-4,1116,3069,-20
59961165747,59961165752,5,1662,1607,-20
59967447489,59967447491,2,1346,1700,-20
59978302054,59978302057,3,1026,1093,-20
59978564950,59978564953,3,1777,1389,-20
59982988798,59982988802,4,1587,1368,-20
59984634613,59984634618,5,2392,1905,-20
59986701270,59986701271,1,1871,1577,-20
59987393118,59987393122,4,1856,1376,-20
59989040858,59989040861,3,1769,732,-20
59990325675,59990325682,7,2609,1285,-20
59991749270,59991749274,4,1859,862,-20
59993261202,59993261207,5,1608,962,-20
59995185494,59995185498,4,2120,1906,-20
59995501665,59995501670,5,2701,1524,-20
59996154437,59996154443,6,2406,1180,-20
59996725309,59996725311,2,1327,1398,-20
59997043967,59997043970,3,1490,1070,-20
59999978859,59999978860,1,994,1319,-20
60001050268,60001050271,3,2233,1309,-20
60007640791,60007640795,4,2276,800,-20
60008018155,60008018160,5,1811,1778,-20
60009564128,60009564130,2,1728,1377,-20
60010822630,60010822634,4,1589,1165,-20
60018825326,60018825329,3,1724,1199,-20
60019642718,60019642722,4,1363,1125,-20
60020083625,60020083626,1,2014,1599,-20
60020281133,60020281137,4,1959,1393,-20
60024268210,60024268215,5,2138,1435,-20
60024739754,60024739758,4,1957,1312,-20
60024986031,60024986025,-6,1644,6578,-20
60026229890,60026229894,4,2516,1819,-20
60028841306,60028841310,4,2287,1723,-20
60031276909,60031276915,6,2631,1439,-20
60035493334,60035493336,2,1551,1591,-20
60035598443,60035598446,3,1931,1666,-20
60036266888,60036266889,1,2116,1507,-20
60039716916,60039716921,5,1674,1695,-20
60041725026,60041725027,1,1599,1643,-20
60042365671,60042365676,5,1736,1936,-20
60043666580,60043666592,12,953,112,-20
60045151496,60045151499,3,1849,1120,-20
60046539859,60046539864,5,1500,1115,-20
60050800904,60050800907,3,1626,1693,-20
60054507665,60054507668,3,2069,1298,-20
60054575918,60054575923,5,1496,1265,-20
60055726182,60055726183,1,1645,1420,-20
60056764707,60056764711,4,1197,998,-20
60060368310,60060368315,5,1680,1326,-20
60061244394,60061244398,4,27002,27053,-20
60062576348,60062576351,3,1639,1365,-20
60064349657,60064349658,1,1769,1307,-20
60065327896,60065327897,1,1294,1712,-20
60065612331,60065612334,3,2267,1731,-20
60067455718,60067455721,3,2289,1132,-20
60068604733,60068604737,4,1734,1281,-20
60069516253,60069516257,4,1765,1369,-20
60072299330,60072299335,5,1453,1591,-20
60075605420,60075605422,2,2311,1712,-20
60076181278,60076181283,5,951,983,-20
60079298577,60079298581,4,1903,1429,-20
60080835242,60080835246,4,1946,1819,-20
60081432478,60081432481,3,1515,1624,-20
60084648343,60084648346,3,1870,1604,-20
60085835434,60085835437,3,1555,1305,-20
60085981290,60085981288,-2,2362,4113,-20
60086030511,60086030514,3,1945,1837,-20
60087465253,60087465258,5,2306,1661,-20
60092251392,60092251393,1,1069,1073,-20
60094333982,60094333985,3,1910,1509,-20
60094802357,60094802365,8,2598,1224,-20
60097341060,60097341062,2,2542,1683,-20
60098058237,60098058238,1,1435,1394,-20
60100120967,60100120973,6,1817,1464,-20
60100982874,60100982878,4,1540,1649,-20
60108224181,60108224183,2,1404,1465,-20
60109774649,60109774643,-6,1726,4239,-20
60112271863,60112271869,6,1821,2166,-20
60115487885,60115487889,4,1966,1708,-20
60117668507,60117668509,2,1566,1179,-20
60122794903,60122794906,3,1947,1562,-20
60123912264,60123912267,3,2382,1464,-20
60130583077,60130583080,3,1996,1386,-20
60131187069,60131187055,-14,1654,1060,-20
60141293660,60141293665,5,2331,1783,-20
60142063122,60142063128,6,1757,1385,-20
60142449098,60142449098,0,1226,914,-20
60151866450,60151866450,0,1422,2114,-20
60153210679,60153210685,6,14743,36573,-20
60153672135,60153672138,3,2199,1892,-20
60154657247,60154657247,0,1392,1575,-20
60157832605,60157832606,1,1281,1142,-20
60158653378,60158653382,4,2087,1667,-20
60159634134,60159634128,-6,882,3549,-20
60164453568,60164453571,3,668,850,-20
60165047956,60165047977,21,1778,1302,-20
60166336206,60166336224,18,958,926,-20
60170696940,60170696946,6,2141,1973,-20
60172083441,60172083448,7,11942,42206,-20
60173424526,60173424529,3,1553,1264,-20
60179082810,60179082813,3,1714,1577,-20
60182786177,60182786183,6,2133,974,-20
60185234455,60185234458,3,2229,1901,-20
60190819751,60190819754,3,1470,1618,-20
60194544425,60194544407,-18,2751,1346,-20
60195748554,60195748558,4,2199,1357,-20
60202395025,60202395030,5,1853,1054,-20
60203807397,60203807397,0,11252,464,-20
60204355166,60204355145,-21,1513,1366,-20
60204926588,60204926592,4,2219,1187,-20
60206403024,60206403026,2,1797,1292,-20
60206915297,60206915302,5,2650,1477,-20
60207423325,60207423330,5,1251,650,-20
60210175017,60210175021,4,1440,1509,-20
60210233840,60210233832,-8,1381,1945,-20
60216462437,60216462439,2,1556,1294,-20
60218095993,60218095997,4,1781,1017,-20
60219707105,60219707108,3,1577,1296,-20
60220147543,60220147545,2,1810,1842,-20
60220710166,60220710169,3,1212,1504,-20
60223089170,60223089169,-1,1571,1474,-20
60224518058,60224518063,5,2592,1691,-20
60224736537,60224736541,4,934,859,-20
60226944181,60226944186,5,2097,1655,-20
60228149198,60228149203,5,2015,1395,-20
60232058341,60232058338,-3,2105,4291,-20
60235361143,60235361144,1,1333,1249,-20
60236557586,60236557571,-15,1802,1493,-20
60238761758,60238761762,4,1479,1482,-20
60240604685,60240604689,4,1454,1568,-20
60241978632,60241978635,3,2543,1434,-20
60242063775,60242063769,-6,1235,3978,-20
60244077166,60244077169,3,2182,1134,-20
60244926658,60244926663,5,1225,1073,-20
60245683393,60245683394,1,1146,1448,-20
60247512918,60247512924,6,2761,1843,-20
60248535218,60248535221,3,2587,1451,-20
60249373349,60249373353,4,2108,1841,-20
60250083263,60250083266,3,1861,1070,-20
60253784465,60253784469,4,1711,1800,-20
60255622314,60255622317,3,2348,1630,-20
60255869737,60255869740,3,2409,1822,-20
60256699406,60256699410,4,2235,1457,-20
60256744526,60256744529,3,1689,1174,-20
60257127218,60257127222,4,1746,1581,-20
60257319303,60257319304,1,1230,1143,-20
60258357710,60258357712,2,1606,2068,-20
60260236220,60260236222,2,1861,1759,-20
60260834291,60260834270,-21,2359,1410,-20
60262069714,60262069717,3,1783,1371,-20
60263659586,60263659590,4,2106,1629,-20
60263769498,60263769498,0,2045,1224,-20
60263821995,60263821999,4,1739,1439,-20
60264206334,60264206340,6,1903,1396,-20
60265409563,60265409568,5,1560,1256,-20
60270299044,60270299046,2,1888,1223,-20
60273671326,60273671329,3,1761,1717,-20
60274242103,60274242107,4,1656,1152,-20
60274477607,60274477613,6,1313,1355,-20
60274578498,60274578484,-14,636,299,-20
60276950474,60276950479,5,3255,1966,-20
60277820251,60277820253,2,1820,1550,-20
60280830238,60280830235,-3,694,1876,-20
60282816227,60282816229,2,10044,11786,-20
60285012040,60285012041,1,1977,2171,-20
60286965012,60286964998,-14,1400,1151,-20
60287351927,60287351931,4,1356,1593,-20
60287775794,60287775802,8,292,4177,-20
60288485569,60288485574,5,5587,1308,-20
60292775393,60292775395,2,1430,1257,-20
60293052243,60293052246,3,1470,1142,-20
60297791197,60297791176,-21,1772,1850,-20
60298879767,60298879771,4,1856,1324,-20
60300003142,60300003146,4,1886,1311,-20
60301087009,60301087011,2,733,499,-20
60302054823,60302054826,3,2309,1485,-20
60306984222,60306984226,4,1644,955,-20
60307205938,60307205942,4,1942,1081,-20
60310147145,60310147148,3,2087,1427,-20
60310296679,60310296690,11,1619,1327,-20
60312445069,60312445074,5,2028,1309,-20
60314386593,60314386597,4,2128,1233,-20
60318973195,60318973197,2,1877,1789,-20
60319108649,60319108654,5,2214,1601,-20
60321287510,60321287515,5,1815,1277,-20
60322344848,60322344847,-1,1571,1661,-20
60326654839,60326654843,4,1689,1285,-20
60329288679,60329288684,5,3678,1134,-20
60329621625,60329621628,3,1628,1776,-20
60330556591,60330556594,3,1660,1349,-20
60332166830,60332166830,0,1526,1744,-20
60336222058,60336222062,4,1867,1373,-20
60342479690,60342479694,4,1643,1507,-20
60347154394,60347154397,3,1929,1108,-20
60352276625,60352276631,6,1781,876,-20
60352441620,60352441622,2,1813,1308,-20
60353221350,60353221358,8,3610,1731,-20
60353371929,60353371931,2,2728,2115,-20
60354789993,60354789998,5,2363,1174,-20
60355203264,60355203248,-16,1719,952,-20
60356293805,60356293805,0,1782,1661,-20
60359552175,60359552177,2,1983,1551,-20
60359712935,60359712938,3,1783,1351,-20
60360124445,60360124449,4,1534,1398,-20
60363654093,60363654095,2,1194,1247,-20
60364029035,60364029038,3,2750,1745,-20
60365016935,60365016938,3,1592,1592,-20
60366409470,60366409476,6,1449,1212,-20
60367616433,60367616425,-8,1180,1034,-20
60370830866,60370830870,4,1907,1257,-20
60372995398,60372995401,3,1136,877,-20
60376897815,60376897818,3,1439,1170,-20
60377969286,60377969288,2,1535,1060,-20
60380543829,60380543829,0,1005,1060,-20
60382671014,60382671013,-1,22267,37495,-20
60385533565,60385533570,5,1432,1194,-20
60386456293,60386456295,2,1724,1231,-20
60387809114,60387809117,3,2340,1555,-20
60388713034,60388713037,3,1362,1207,-20
60389286266,60389286271,5,1899,1711,-20
60390391874,60390391880,6,2508,1421,-20
60395142718,60395142723,5,2252,1442,-20
60397632658,60397632661,3,1511,1666,-20
60399240907,60399240906,-1,1436,2577,-20
60401900674,60401900678,4,1646,1689,-20
60403552886,60403552876,-10,1410,1959,-20
60405841170,60405841172,2,2211,1982,-20
60406586854,60406586856,2,2191,1868,-20
60406968629,60406968634,5,1310,1651,-20
60407843460,60407843463,3,2015,1369,-20
60412566827,60412566830,3,1341,1267,-20
60413408261,60413408266,5,1756,1356,-20
60415208978,60415208982,4,1551,1420,-20
60415766222,60415766226,4,5100,2950,-20
60417917030,60417917033,3,1556,1093,-20
60418727313,60418727317,4,1627,1580,-20
60423380934,60423380937,3,986,599,-20
60425554492,60425554490,-2,1162,663,-20
60426551317,60426551324,7,10498,29102,-20
60427171110,60427171115,5,1763,1934,-20
60432346111,60432346111,0,1624,929,-20
60432897885,60432897889,4,1635,1986,-20
60436382861,60436382862,1,1120,1229,-20
60438426091,60438426094,3,1847,1274,-20
60438485935,60438485938,3,1329,1166,-20
60439687274,60439687281,7,2447,1263,-20
60442171257,60442171259,2,1978,2041,-20
60442258413,60442258418,5,2950,1049,-20
60446521095,60446521099,4,1920,1411,-20
60448057693,60448057696,3,2842,1863,-20
60448231641,60448231643,2,1485,1600,-20
60449161401,60449161397,-4,1034,2965,-20
60450744858,60450744863,5,2402,1393,-20
60451473309,60451473312,3,2372,1745,-20
60454734723,60454734721,-2,894,2128,-20
60456040331,60456040335,4,1666,1493,-20
60456979903,60456979906,3,1980,1652,-20
60457294650,60457294651,1,1011,1138,-20
60462422553,60462422557,4,2101,1728,-20
60463572414,60463572417,3,2104,1418,-20
60466366455,60466366458,3,2003,1216,-20
60466587238,60466587239,1,1543,1220,-20
60467007132,60467007115,-17,1500,802,-20
60469117255,60469117258,3,1191,1123,-20
60473492075,60473492079,4,1810,1113,-20
60473648804,60473648817,13,1709,1304,-20
60477146248,60477146249,1,1532,1610,-20
60477480689,60477480692,3,2003,1437,-20
60478005510,60478005516,6,1787,1568,-20
60483680299,60483680303,4,2144,995,-20
60484981025,60484981029,4,1658,1473,-20
60485711371,60485711366,-5,1831,5999,-20
60489431369,60489431370,1,254,1134,-20
60490041395,60490041398,3,1471,1494,-20
60493766983,60493766976,-7,1342,4115,-20
60494639643,60494639646,3,1711,1000,-20
60495393739,60495393742,3,2239,1814,-20
60495649641,60495649643,2,1899,1794,-20
60496265106,60496265110,4,2585,1839,-20
60497670969,60497670973,4,1846,1380,-20
60505637227,60505637231,4,1216,1283,-20
60506797738,60506797741,3,1856,1065,-20
60508949196,60508949200,4,2449,1206,-20
60514651769,60514651774,5,1544,1151,-20
60517842509,60517842514,5,1946,875,-20
60521270376,60521270369,-7,2139,8204,-20
60524365102,60524365108,6,2075,1741,-20
60525076434,60525076438,4,1577,1065,-20
60525583429,60525583426,-3,2339,5576,-20
60526979093,60526979097,4,2065,1509,-20
60530534626,60530534629,3,1446,1692,-20
60534553894,60534553895,1,1399,1431,-20
60535957022,60535957026,4,2345,1426,-20
60536485672,60536485676,4,4446,3384,-20
60538552983,60538552987,4,1775,1458,-20
60542467679,60542467682,3,1876,1385,-20
60544059021,60544059024,3,2268,1521,-20
60547926195,60547926197,2,1409,1946,-20
60548013607,60548013609,2,2243,1722,-20
60548485467,60548485469,2,2229,1813,-20
60551425263,60551425267,4,1903,1839,-20
60554560319,60554560334,15,1707,1508,-20
60555872754,60555872751,-3,719,2350,-20
60556486229,60556486233,4,2104,1932,-20
60559348708,60559348712,4,1785,1552,-20
60560695641,60560695646,5,1181,1167,-20
60565779553,60565779549,-4,1286,3842,-20
60566147698,60566147702,4,1512,1508,-20
60572888049,60572888045,-4,18557,16368,-20
60573474982,60573474986,4,2140,1819,-20
60576784486,60576784490,4,1936,1280,-20
60579551916,60579551918,2,1558,1111,-20
60580546197,60580546198,1,1581,2172,-20
60582307029,60582307032,3,1547,1520,-20
60584102127,60584102129,2,595,581,-20
60585201834,60585201838,4,1958,1238,-20
60585895833,60585895837,4,1633,1656,-20
60590729324,60590729328,4,1968,1406,-20
60590949651,60590949656,5,2492,2368,-20
60591316757,60591316762,5,1943,1410,-20
60593848991,60593848994,3,1248,1106,-20
60594550969,60594550970,1,630,698,-20
60594688089,60594688091,2,1794,1305,-20
60594903353,60594903356,3,1684,1641,-20
60595334938,60595334941,3,2184,1689,-20
60595925247,60595925254,7,1080,526,-20
60597351287,60597351290,3,2031,949,-20
60598002962,60598002965,3,1782,1670,-20
60600668037,60600668041,4,2640,1517,-20
60611860556,60611860559,3,1595,1012,-20
60623367867,60623367871,4,2274,1353,-20
60623648311,60623648317,6,2346,2058,-20
60627086227,60627086227,0,1516,1598,-20
60627412416,60627412423,7,3116,2149,-20
60633283795,60633283800,5,2437,1560,-20
60637325879,60637325882,3,1952,1340,-20
60638099880,60638099886,6,2282,1364,-20
60639401384,60639401389,5,2468,1581,-20
60639457095,60639457100,5,2579,1737,-20
60644474723,60644474727,4,2276,1416,-20
60645966753,60645966755,2,2115,1629,-20
60648324638,60648324643,5,1671,1227,-20
60650659625,60650659627,2,1321,1361,-20
60655441748,60655441750,2,1583,1707,-20
60662074510,60662074514,4,2042,1287,-20
60664767040,60664767043,3,1216,849,-20
60665994275,60665994275,0,1068,1620,-20
60666492128,60666492130,2,1233,1376,-20
60668731598,60668731590,-8,1366,8542,-20
60669970675,60669970681,6,3410,1464,-20
60670190901,60670190883,-18,2001,1362,-20
60672899675,60672899679,4,1115,1873,-20
60673436461,60673436461,0,1732,1939,-20
60675049802,60675049806,4,1644,989,-20
60676278762,60676278764,2,2118,1379,-20
60677056094,60677056097,3,1695,1316,-20
60677850298,60677850301,3,1616,885,-20
60677963115,60677963118,3,2109,1695,-20
60682176065,60682176071,6,1704,1538,-20
60685040943,60685040946,3,1386,1185,-20
60689416746,60689416748,2,1587,1463,-20
60689769655,60689769659,4,1793,1290,-20
60690600226,60690600231,5,2128,1160,-20
60692377182,60692377188,6,1579,1286,-20
60694329993,60694329999,6,1650,959,-20
60694656605,60694656609,4,2092,1963,-20
60698058466,60698058466,0,1565,1081,-20
60698759738,60698759742,4,2360,1803,-20
60698797561,60698797563,2,1857,1489,-20
60699542994,60699542994,0,1586,1365,-20
60701053966,60701053958,-8,8361,16464,-20
60701287955,60701287960,5,1686,1211,-20
60701760895,60701760899,4,1152,993,-20
60702324562,60702324567,5,1873,1229,-20
60704557058,60704557062,4,1321,954,-20
60706055354,60706055358,4,2201,1514,-20
60706132764,60706132754,-10,881,276,-20
60707335866,60707335864,-2,786,1165,-20
60710291686,60710291690,4,1352,1129,-20
60712663198,60712663201,3,2266,1080,-20
60712708120,60712708126,6,1625,1658,-20
60712975091,60712975074,-17,1662,920,-20
60717543572,60717543574,2,1781,1247,-20
60717682602,60717682606,4,2450,1523,-20
60718854061,60718854066,5,2150,1261,-20
60724437021,60724437022,1,2061,1647,-20
60724549226,60724549229,3,1529,1166,-20
60728576042,60728576045,3,1643,1342,-20
60730548696,60730548702,6,3021,1145,-20
60730703239,60730703242,3,1545,773,-20
60733926341,60733926345,4,2516,1853,-20
60739743356,60739743361,5,1643,1017,-20
60744182746,60744182750,4,1188,1272,-20
60746731728,60746731732,4,1484,1187,-20
60750272536,60750272539,3,1957,962,-20
60753332806,60753332811,5,2479,1219,-20
60756046778,60756046786,8,1926,922,-20
60757206668,60757206675,7,1385,859,-20
60758533050,60758533056,6,4340,3588,-20
60759110279,60759110283,4,2387,1524,-20
60762437074,60762437079,5,2008,1516,-20
60762614669,60762614672,3,1337,1326,-20
60762968845,60762968849,4,1650,1753,-20
60764948299,60764948301,2,1746,1579,-20
60765817392,60765817395,3,2519,2345,-20
60766188754,60766188759,5,1949,1280,-20
60766822710,60766822714,4,2152,1503,-20
60771131884,60771131891,7,2181,1651,-20
60778023077,60778023081,4,2688,1326,-20
60780652162,60780652163,1,1527,1273,-20
60781583690,60781583694,4,1054,863,-20
60784732253,60784732257,4,1205,734,-20
60791390174,60791390178,4,2103,1755,-20
60792391496,60792391499,3,1467,1072,-20
60792721767,60792721770,3,1585,1320,-20
60793866433,60793866439,6,1461,1412,-20
60794204681,60794204668,-13,604,388,-20
60794465181,60794465184,3,1712,1151,-20
60795576999,60795577002,3,1628,1350,-20
60798675688,60798675690,2,1197,1357,-20
60800165547,60800165550,3,1819,1319,-20
60803260518,60803260522,4,8100,5119,-20
60805481571,60805481573,2,1617,1291,-20
60805945423,60805945426,3,2742,1398,-20
60807902311,60807902310,-1,1615,1815,-20
60808721381,60808721386,5,1578,1499,-20
60808817169,60808817173,4,2048,1406,-20
60809208413,60809208416,3,2084,1580,-20
60809535428,60809535425,-3,1965,3320,-20
60812018787,60812018791,4,1158,1111,-20
60821987744,60821987748,4,2006,1211,-20
60825271609,60825271603,-6,712,1949,-20
60825481553,60825481557,4,2308,1708,-20
60831767429,60831767431,2,1625,1095,-20
60833153966,60833153971,5,15738,6411,-20
60836416185,60836416189,4,2122,1756,-20
60839582956,60839582959,3,1025,886,-20
60840223010,60840223012,2,1899,1266,-20
60842651389,60842651395,6,1968,1020,-20
60843845219,60843845221,2,2296,1509,-20
60847904653,60847904658,5,1790,1228,-20
60848338935,60848338938,3,2078,1695,-20
60848384709,60848384715,6,4135,1668,-20
60851301052,60851301054,2,2322,1093,-20
60851648614,60851648617,3,2003,1363,-20
60856119644,60856119647,3,1749,1299,-20
60860317531,60860317534,3,1507,1237,-20
60863430788,60863430792,4,2622,1493,-20
60863531085,60863531089,4,1807,1528,-20
60870000820,60870000823,3,1331,920,-20
60871611729,60871611731,2,1771,1036,-20
60878537052,60878537055,3,2128,2151,-20
60884928142,60884928142,0,1350,1423,-20
60885341359,60885341362,3,1676,1036,-20
60889485996,60889485999,3,1765,1206,-20
60896836365,60896836371,6,1674,2004,-20
60899898302,60899898303,1,1468,1234,-20
60902432540,60902432543,3,1021,1377,-20
60907635526,60907635531,5,1279,1195,-20
60907910410,60907910415,5,1402,1212,-20
60910039704,60910039702,-2,1261,1466,-20
60911776082,60911776082,0,1620,1812,-20
60915960295,60915960301,6,1445,1517,-20
60916249482,60916249487,5,1734,1404,-20
60919019784,60919019785,1,1413,1717,-20
60921798550,60921798553,3,2048,1467,-20
60922232609,60922232611,2,1645,1227,-20
60922845037,60922845044,7,1569,1034,-20
60926493363,60926493366,3,2795,2604,-20
60927503887,60927503890,3,1190,1121,-20
60929516946,60929516951,5,2187,1265,-20
60932701901,60932701902,1,1795,1430,-20
60933005610,60933005611,1,1809,1224,-20
60935840815,60935840819,4,1311,924,-20
60937096081,60937096086,5,1099,1128,-20
60938541865,60938541867,2,1532,1100,-20
60941155949,60941155953,4,1451,1262,-20
60943916518,60943916522,4,1869,1129,-20
60948990997,60948990998,1,2281,1911,-20
60951885570,60951885574,4,1509,1400,-20
60953495562,60953495566,4,1268,1600,-20
60953885330,60953885332,2,1592,876,-20
60960379774,60960379768,-6,1096,3364,-20
60961292354,60961292357,3,1825,1300,-20
60962531415,60962531420,5,2472,1517,-20
60965450460,60965450462,2,1686,1069,-20
60966213045,60966213047,2,1801,1400,-20
60966287248,60966287250,2,1859,1487,-20
60967675606,60967675607,1,1589,1261,-20
60968569236,60968569239,3,2320,1129,-20
60969022864,60969022868,4,1548,1311,-20
60969250024,60969250028,4,2434,2246,-20
60970314486,60970314487,1,1677,1502,-20
60970671334,60970671337,3,1842,1555,-20
60970902810,60970902812,2,1518,1265,-20
60972605037,60972605041,4,1927,1852,-20
60972743858,60972743862,4,1722,1400,-20
60976467105,60976467108,3,2072,1795,-20
60985322906,60985322909,3,1504,1176,-20
60987088439,60987088443,4,1688,1405,-20
60990153474,60990153481,7,3560,1060,-20
60991321298,60991321303,5,2296,1218,-20
60993932762,60993932765,3,1603,1292,-20
60995363110,60995363114,4,1641,1560,-20
60995864011,60995864014,3,2792,1666,-20
60998207913,60998207916,3,2239,2004,-20
60999064303,60999064303,0,2881,2744,-20
60999854522,60999854525,3,2753,1939,-20
61001212961,61001212965,4,1678,1430,-20
61001481507,61001481510,3,3019,1767,-20
61001767625,61001767629,4,1711,1434,-20
61002317223,61002317227,4,1341,833,-20
61010752554,61010752556,2,1612,1360,-20
61020375861,61020375870,9,2396,1386,-20
61021156450,61021156456,6,1056,820,-20
61021863551,61021863554,3,1348,1298,-20
61024432968,61024432974,6,1430,1235,-20
61026300569,61026300572,3,2454,1375,-20
61026526846,61026526866,20,1984,1096,-20
61026796267,61026796267,0,583,521,-20
61028180621,61028180626,5,1461,1218,-20
61032834907,61032834911,4,1309,1217,-20
61035900236,61035900239,3,1294,1158,-20
61038900739,61038900734,-5,769,3700,-20
61039046512,61039046509,-3,2086,1413,-20
61040830175,61040830178,3,1448,1314,-20
61041473478,61041473483,5,1922,1210,-20
61044128017,61044128019,2,1925,1226,-20
61044491158,61044491162,4,1181,1219,-20
61045524261,61045524264,3,1872,1591,-20
61049208392,61049208396,4,1354,1005,-20
61049988573,61049988577,4,2324,1451,-20
61050162520,61050162523,3,1648,986,-20
61051166598,61051166600,2,1823,1653,-20
61051560886,61051560887,1,1023,1247,-20
61054094270,61054094271,1,1942,1495,-20
61054695827,61054695831,4,1535,1460,-20
61054931189,61054931191,2,1318,1131,-20
61058501334,61058501338,4,1672,1236,-20
61059943530,61059943534,4,1895,1479,-20
61061390346,61061390350,4,1868,1327,-20
61062205710,61062205714,4,2485,2462,-20
61063489390,61063489393,3,1747,1153,-20
61078619644,61078619647,3,2302,1325,-20
61078963021,61078963022,1,1665,1672,-20
61084529186,61084529191,5,1667,1217,-20
61089713371,61089713374,3,1432,863,-20
61090648266,61090648271,5,1503,1216,-20
61093644104,61093644106,2,2743,1790,-20
61093826968,61093826971,3,1998,1526,-20
61094017854,61094017858,4,1623,1620,-20
61094297935,61094297939,4,1977,1082,-20
61096621092,61096621096,4,1749,1252,-20
61100543776,61100543779,3,1866,1641,-20
61103284182,61103284187,5,1803,1242,-20
61107709814,61107709817,3,1874,853,-20
61112137369,61112137374,5,2349,1933,-20
61115581450,61115581448,-2,1263,2434,-20
61116259422,61116259425,3,2547,1707,-20
61116681222,61116681220,-2,23507,24560,-20
61119249822,61119249826,4,2187,1493,-20
61119605038,61119605038,0,1938,1392,-20
61122480797,61122480801,4,3103,1719,-20
61122817743,61122817749,6,1613,966,-20
61125098851,61125098855,4,2812,1955,-20
61126245457,61126245461,4,1484,1196,-20
61126802366,61126802367,1,1006,1070,-20
61132440901,61132440902,1,1561,1468,-20
61132544536,61132544538,2,1495,1079,-20
61133881954,61133881959,5,2551,1614,-20
61138158863,61138158867,4,1249,1172,-20
61138451642,61138451621,-21,1550,1116,-20
61139886835,61139886835,0,2005,1171,-20
61140693498,61140693503,5,806,606,-20
61143145589,61143145594,5,1964,1189,-20
61143964589,61143964590,1,1252,1247,-20
61145029463,61145029466,3,1934,1555,-20
61152015588,61152015590,2,1953,1256,-20
61152637095,61152637098,3,2225,1568,-20
61153183402,61153183407,5,2604,1713,-20
61154458514,61154458517,3,1711,1352,-20
61154707950,61154707955,5,1885,897,-20
61155239461,61155239466,5,1839,1757,-20
61158622909,61158622914,5,1696,1202,-20
61163729765,61163729766,1,1769,1603,-20
61166145206,61166145209,3,2182,1204,-20
61176547982,61176547986,4,1621,1295,-20
61177561767,61177561767,0,1361,1371,-20
61178586312,61178586314,2,947,943,-20
61179075236,61179075217,-19,1428,1184,-20
61185047518,61185047521,3,2037,947,-20
61187014317,61187014322,5,2116,1491,-20
61192070314,61192070319,5,1229,617,-20
61193430494,61193430499,5,1870,1679,-20
61194166737,61194166739,2,2623,1967,-20
61196858800,61196858802,2,1731,1395,-20
61196993382,61196993386,4,1149,1128,-20
61199724202,61199724206,4,1586,1090,-20
61201067290,61201067294,4,2080,1300,-20
61203423371,61203423375,4,2005,1183,-20
61203986201,61203986206,5,1895,1409,-20
61204087238,61204087242,4,1969,1545,-20
61205838995,61205838998,3,1804,1250,-20
61210552733,61210552735,2,1393,1182,-20
61211248551,61211248555,4,2675,2049,-20
61211788248,61211788252,4,1829,726,-20
61214482293,61214482297,4,1427,1200,-20
61217514686,61217514690,4,1584,1695,-20
61218268274,61218268260,-14,684,202,-20
61218828105,61218828108,3,1617,1811,-20
61220518924,61220518926,2,1791,1006,-20
61221808812,61221808815,3,1887,1433,-20
61221937139,61221937143,4,1934,1232,-20
61222645358,61222645358,0,1049,1437,-20
61226731806,61226731810,4,1743,1092,-20
61227520462,61227520457,-5,814,3015,-20
61228331510,61228331513,3,2485,1340,-20
61233528783,61233528786,3,1712,1243,-20
61235821382,61235821387,5,1549,1026,-20
61237663594,61237663598,4,1312,1246,-20
61237698557,61237698561,4,1117,234,-20
61239930203,61239930206,3,2437,2071,-20
61240583718,61240583722,4,1551,1502,-20
61243657626,61243657629,3,1704,1443,-20
61246356081,61246356083,2,1692,1910,-20
61250401410,61250401413,3,2137,1526,-20
61251465577,61251465580,3,2546,1413,-20
61251513165,61251513169,4,1917,1417,-20
61251936719,61251936723,4,2090,1078,-20
61252388833,61252388834,1,1109,1641,-20
61254361943,61254361947,4,4354,2603,-20
61254423186,61254423187,1,1622,1448,-20
61254606858,61254606862,4,2047,1302,-20
61256022934,61256022939,5,1494,1462,-20
61256451314,61256451318,4,2017,1393,-20
61257001989,61257001991,2,1388,1605,-20
61259614634,61259614633,-1,1377,3172,-20
61260703371,61260703374,3,1752,1161,-20
61263595545,61263595547,2,2481,2027,-20
61264156052,61264156046,-6,2573,6101,-20
61266031125,61266031126,1,1406,1434,-20
61267212317,61267212321,4,2274,1153,-20
61269761793,61269761778,-15,1511,869,-20
61270784234,61270784237,3,1850,1679,-20
61272426434,61272426437,3,1227,1459,-20
61272774574,61272774576,2,2098,1791,-20
61277030734,61277030738,4,1691,995,-20
61281684153,61281684157,4,1959,1321,-20
61282544411,61282544413,2,1407,1100,-20
61284266232,61284266235,3,1594,1434,-20
61288255191,61288255194,3,1573,1771,-20
61288404403,61288404407,4,1232,978,-20
61288467457,61288467460,3,2209,1605,-20
61289210253,61289210255,2,2741,1725,-20
61292220694,61292220697,3,1689,1425,-20
61296377869,61296377871,2,1514,1162,-20
61297807650,61297807654,4,1451,1200,-20
61298550654,61298550658,4,2141,1375,-20
61303560670,61303560670,0,1686,1427,-20
61304197187,61304197186,-1,1614,2085,-20
61309998543,61309998546,3,1384,1360,-20
61312208359,61312208362,3,1778,1307,-20
61312458343,61312458323,-20,1518,888,-20
61312891693,61312891698,5,2459,1722,-20
61313262030,61313262031,1,4134,2867,-20
61314698376,61314698379,3,1442,1152,-20
61316425429,61316425424,-5,53388,17809,-20
61318283134,61318283139,5,2279,1662,-20
61319157559,61319157559,0,1429,2227,-20
61324818991,61324818993,2,1391,1195,-20
61327441790,61327441795,5,702,635,-20
61327780395,61327780397,2,1716,1358,-20
61328899369,61328899371,2,1846,1127,-20
61330770729,61330770731,2,1718,1427,-20
61331085697,61331085702,5,2558,1359,-20
61333116666,61333116669,3,1655,1296,-20
61333500209,61333500210,1,1560,1549,-20
61337735245,61337735247,2,2368,1587,-20
61342148540,61342148542,2,1396,1298,-20
61342402091,61342402098,7,814,368,-20
61343035509,61343035511,2,1690,1642,-20
61343697227,61343697227,0,1886,2659,-20
61346069050,61346069053,3,1691,1393,-20
61346115488,61346115491,3,1634,1399,-20
61346262782,61346262786,4,2161,1506,-20
61353942781,61353942783,2,2094,1485,-20
61354960108,61354960112,4,1954,1200,-20
61356624507,61356624507,0,821,1406,-20
61358647011,61358647016,5,1795,1467,-20
61360686136,61360686140,4,1430,1288,-20
61362955674,61362955678,4,1850,1423,-20
61364185617,61364185618,1,2103,1151,-20
61369820186,61369820189,3,1652,1348,-20
61372848005,61372848010,5,1129,1149,-20
61374049726,61374049727,1,1809,1571,-20
61374577575,61374577579,4,2672,2092,-20
61376374067,61376374070,3,1975,1966,-20
61377626542,61377626546,4,2711,1499,-20
61379164346,61379164350,4,1414,1275,-20
61379562337,61379562340,3,1610,1633,-20
61381482039,61381482042,3,2183,1567,-20
61389264752,61389264757,5,1633,1289,-20
61394858103,61394858108,5,1215,1519,-20
61395488151,61395488153,2,1044,1245,-20
61397709792,61397709798,6,2210,1401,-20
61398109602,61398109603,1,1952,1446,-20
61398266348,61398266350,2,1743,1346,-20
61400203945,61400203948,3,1450,1064,-20
61404754494,61404754498,4,1400,1009,-20
61405361384,61405361387,3,1738,1671,-20
61407870356,61407870358,2,2166,1632,-20
61408834646,61408834656,10,2291,1556,-20
61410600958,61410600960,2,1912,1322,-20
61411002726,61411002730,4,2731,1996,-20
61417598826,61417598831,5,2412,1167,-20
61419366982,61419366986,4,2035,2021,-20
61419662766,61419662770,4,1572,1472,-20
61419722908,61419722911,3,2221,1533,-20
61423011775,61423011776,1,1599,1624,-20
61423920466,61423920470,4,2204,1798,-20
61427383216,61427383218,2,1446,1161,-20
61430914122,61430914126,4,2054,1420,-20
61433374849,61433374853,4,1906,1305,-20
61436125211,61436125210,-1,1737,1646,-20
61436169669,61436169670,1,1382,1051,-20
61437912514,61437912517,3,2357,1391,-20
61439744770,61439744770,0,1807,2180,-20
61439978521,61439978526,5,2231,1815,-20
61442477816,61442477811,-5,1439,929,-20
61444409923,61444409926,3,2708,1932,-20
61445104430,61445104434,4,1675,1208,-20
61447104080,61447104081,1,926,1379,-20
61447424150,61447424168,18,2271,1986,-20
61450729622,61450729623,1,1272,1913,-20
61451347134,61451347137,3,1252,1418,-20
61453610070,61453610073,3,2084,1627,-20
61454514929,61454514930,1,1963,1317,-20
61456002037,61456002040,3,1964,1439,-20
61456029157,61456029138,-19,2646,1799,-20
61456958781,61456958782,1,1375,1275,-20
61464158437,61464158442,5,2625,1094,-20
61465348369,61465348372,3,2231,1924,-20
61471832258,61471832262,4,2853,2007,-20
61473473813,61473473816,3,1816,1525,-20
61476385722,61476385726,4,1736,1038,-20
61477645447,61477645450,3,1869,1283,-20
61479372030,61479372034,4,1652,1336,-20
61479561913,61479561917,4,1783,1800,-20
61481442071,61481442075,4,1493,955,-20
61487608986,61487608991,5,1131,1192,-20
61488702108,61488702111,3,1850,1450,-20
61495607303,61495607305,2,1768,1662,-20
61500398233,61500398236,3,1530,1334,-20
61501719248,61501719250,2,1825,1325,-20
61503665328,61503665331,3,1540,1431,-20
61503899896,61503899899,3,1326,1601,-20
61504117372,61504117376,4,1492,1201,-20
61505457108,61505457128,20,3565,1018,-20
61506242279,61506242284,5,1664,1541,-20
61507534025,61507534030,5,1964,1424,-20
61510345139,61510345139,0,20069,21897,-20
61512644708,61512644712,4,1689,1149,-20
61513242172,61513242173,1,1961,1482,-20
61515241974,61515241977,3,1444,1599,-20
61515958080,61515958085,5,1603,1550,-20
61518378102,61518378103,1,1323,1195,-20
61525416429,61525416433,4,2113,1418,-20
61525604464,61525604474,10,3026,2036,-20
61526942491,61526942491,0,1519,1262,-20
61531086948,61531086951,3,1664,1592,-20
61538706112,61538706115,3,1449,1234,-20
61539292710,61539292712,2,1589,1688,-20
61540385486,61540385490,4,1388,928,-20
61542202274,61542202278,4,2093,1279,-20
61543466034,61543466026,-8,1078,5828,-20
61545947950,61545947947,-3,882,1314,-20
61546193649,61546193655,6,1392,1134,-20
61551354294,61551354304,10,15099,21367,-20
61554006422,61554006427,5,1359,1175,-20
61556051914,61556051895,-19,17829,27061,-20
61556599926,61556599926,0,1604,1495,-20
61557552116,61557552118,2,2285,1502,-20
61558825649,61558825650,1,1608,2391,-20
61559681055,61559681058,3,1770,1398,-20
61561241896,61561241899,3,2162,1289,-20
61563824154,61563824158,4,2029,1811,-20
61566477200,61566477204,4,1503,1409,-20
61566721410,61566721413,3,1216,2023,-20
61566842075,61566842078,3,1290,1388,-20
61569297652,61569297654,2,1736,1216,-20
61579115374,61579115379,5,2016,1559,-20
61581141233,61581141237,4,2032,1407,-20
61581447374,61581447354,-20,2038,1482,-20
61581679102,61581679102,0,1411,1653,-20
61585123565,61585123570,5,1796,1191,-20
61585720819,61585720821,2,1977,1607,-20
61586386516,61586386519,3,1571,1833,-20
61587333741,61587333723,-18,2263,1766,-20
61588885985,61588885990,5,1344,785,-20
61595645262,61595645266,4,1911,877,-20
61600790538,61600790546,8,11407,36598,-20
61601613960,61601613963,3,1298,1057,-20
61602183786,61602183789,3,2425,1649,-20
61602286113,61602286115,2,1879,1615,-20
61603245320,61603245323,3,1569,1560,-20
61605275834,61605275838,4,1639,1437,-20
61605613007,61605613010,3,2041,1519,-20
61608561840,61608561843,3,1809,1663,-20
61610494649,61610494650,1,1715,1508,-20
61613962837,61613962842,5,1995,928,-20
61617389282,61617389284,2,2985,2562,-20
61622231993,61622231998,5,1679,1321,-20
61626923381,61626923385,4,2928,1362,-20
61631118305,61631118307,2,1541,1321,-20
61632811445,61632811447,2,1545,1387,-20
61633114122,61633114125,3,2229,1705,-20
61634771085,61634771083,-2,949,2816,-20
61634838503,61634838502,-1,1022,1154,-20
61636865709,61636865702,-7,1029,5576,-20
61640649979,61640649983,4,1246,1383,-20
61647327743,61647327746,3,2414,1078,-20
61648312182,61648312186,4,2057,1186,-20
61650340480,61650340497,17,10,722,-20
61652278035,61652278035,0,1070,2153,-20
61652769754,61652769756,2,1353,1136,-20
61654889921,61654889922,1,1645,1270,-20
61655237038,61655237038,0,1920,1656,-20
61657182506,61657182510,4,1601,1191,-20
61657830135,61657830139,4,53968,43614,-20
61658015395,61658015399,4,1317,966,-20
61662543981,61662543984,3,1768,1804,-20
61665807202,61665807204,2,1674,1010,-20
61667815755,61667815759,4,1357,912,-20
61671958958,61671958964,6,1840,1484,-20
61673568684,61673568686,2,2365,1206,-20
61674669083,61674669083,0,1665,2384,-20
61674812621,61674812623,2,1531,1654,-20
61678955786,61678955791,5,1965,1269,-20
61683773542,61683773545,3,1744,891,-20
61688248756,61688248754,-2,1289,1459,-20
61691821458,61691821463,5,2519,1890,-20
61698956766,61698956771,5,1962,1364,-20
61699982301,61699982305,4,1678,1559,-20
61701030902,61701030907,5,1783,1114,-20
61703073004,61703073007,3,1773,1860,-20
61703562587,61703562589,2,959,1013,-20
61705860028,61705860029,1,1280,873,-20
61709623170,61709623170,0,1893,2128,-20
61712054633,61712054636,3,1431,1267,-20
61713549534,61713549535,1,1512,957,-20
61714300618,61714300622,4,1427,1130,-20
61720663630,61720663630,0,2154,1632,-20
61723801878,61723801881,3,1415,1383,-20
61723861213,61723861233,20,1221,1170,-20
61724566226,61724566231,5,1702,1639,-20
61724803787,61724803791,4,1644,1602,-20
61728819179,61728819179,0,1450,1103,-20
61731233338,61731233342,4,2162,1272,-20
61731349665,61731349667,2,1748,1639,-20
61739278023,61739278027,4,1872,1566,-20
61746219713,61746219717,4,1903,1385,-20
61747721394,61747721394,0,1222,2643,-20
61752457801,61752457805,4,1739,1176,-20
61754567951,61754567954,3,1025,803,-20
61756137631,61756137633,2,1798,1575,-20
61759040201,61759040206,5,1670,1335,-20
61762012026,61762012047,21,585,935,-20
61766722526,61766722527,1,1472,1426,-20
61767314827,61767314831,4,1562,601,-20
61768251305,61768251310,5,1806,1366,-20
61770166985,61770166978,-7,1000,3587,-20
61771238862,61771238868,6,6649,2754,-20
61771346944,61771346950,6,3560,1120,-20
61772825616,61772825622,6,1559,1277,-20
61774420083,61774420087,4,1271,1107,-20
61776397042,61776397042,0,1439,1369,-20
61777586425,61777586430,5,2186,1558,-20
61777793294,61777793288,-6,1325,5471,-20
61779741962,61779741966,4,1441,1750,-20
61779864998,61779865002,4,1890,1404,-20
61781284118,61781284123,5,1512,1204,-20
61784330887,61784330891,4,2008,1313,-20
61785187141,61785187142,1,2190,1618,-20
61791063008,61791062992,-16,1317,1015,-20
61791584310,61791584314,4,1541,1187,-20
61792427500,61792427498,-2,1057,1205,-20
61797698871,61797698871,0,1655,928,-20
61801615978,61801615980,2,1390,1696,-20
61808003383,61808003391,8,11841,4614,-20
61808715515,61808715519,4,1635,1618,-20
61812690174,61812690176,2,1333,1472,-20
61814945351,61814945353,2,1775,1262,-20
61815488703,61815488707,4,1937,1129,-20
61815913686,61815913688,2,2447,1204,-20
61816568709,61816568713,4,1360,1486,-20
61825274182,61825274186,4,1541,1245,-20
61825533336,61825533339,3,2217,1375,-20
61828225030,61828225035,5,1874,1549,-20
61830590813,61830590815,2,1000,1044,-20
61832096555,61832096560,5,2143,1014,-20
61834666646,61834666649,3,2095,1651,-20
61834974285,61834974289,4,1750,1176,-20
61836325534,61836325513,-21,868,261,-20
61842958867,61842958869,2,1850,1483,-20
61843712414,61843712418,4,2216,1656,-20
61845424020,61845424033,13,15839,52320,-20
61845498767,61845498770,3,2084,1682,-20
61847970935,61847970937,2,1311,841,-20
61848625692,61848625697,5,2408,1912,-20
61849688632,61849688631,-1,1826,1597,-20
61850521833,61850521836,3,1993,1556,-20
61852340293,61852340299,6,2015,854,-20
61857421989,61857421991,2,1862,2035,-20
61857641538,61857641540,2,1629,1617,-20
61862926015,61862926018,3,2358,1530,-20
61870416626,61870416630,4,1353,1275,-20
61874027375,61874027370,-5,1207,2591,-20
61874649634,61874649639,5,1952,1791,-20
61876789418,61876789424,6,34714,61448,-20
61877009186,61877009191,5,1282,1108,-20
61879820142,61879820145,3,2190,1121,-20
61881228119,61881228123,4,1918,1378,-20
61881814134,61881814137,3,1859,1778,-20
61882668714,61882668718,4,1386,1488,-20
61894698366,61894698371,5,1526,1137,-20
61896594200,61896594197,-3,1052,2634,-20
61903635208,61903635203,-5,2775,6092,-20
61903883529,61903883533,4,1878,1298,-20
61903967468,61903967471,3,1606,1520,-20
61907912965,61907912973,8,1828,1179,-20
61908867774,61908867782,8,3391,1661,-20
61912337386,61912337390,4,1669,1077,-20
61913230133,61913230113,-20,978,549,-20
61919015466,61919015481,15,1523,1057,-20
61920160827,61920160833,6,1525,1172,-20
61922218113,61922218114,1,1421,1785,-20
61923540279,61923540292,13,1039,1294,-20
61924598411,61924598413,2,1528,1756,-20
61926171018,61926171021,3,2225,1761,-20
61928153847,61928153851,4,2281,1821,-20
61932472909,61932472911,2,1566,1076,-20
61934223784,61934223786,2,1422,1182,-20
61937359306,61937359313,7,1706,702,-20
61937618142,61937618153,11,1701,1133,-20
61937727693,61937727697,4,2574,1533,-20
61939239354,61939239362,8,2292,1105,-20
61940920748,61940920753,5,1359,1265,-20
61942237418,61942237418,0,1785,1388,-20
61945215629,61945215626,-3,792,1031,-20
61945247126,61945247129,3,2418,1587,-20
61951938722,61951938700,-22,1399,1203,-20
61952324670,61952324675,5,2387,1693,-20
61952810287,61952810286,-1,1417,1929,-20
61954393494,61954393498,4,3045,2094,-20
61958495950,61958495953,3,1647,1593,-20
61959020628,61959020631,3,1889,1448,-20
61960283574,61960283578,4,2069,1840,-20
61961636683,61961636686,3,1433,936,-20
61963864382,61963864387,5,1763,1207,-20
61964679419,61964679400,-19,1410,686,-20
61965362086,61965362090,4,2410,1841,-20
61966551098,61966551100,2,1338,1318,-20
61966730930,61966730934,4,1630,1505,-20
61967046695,61967046694,-1,1625,1746,-20
61968131101,61968131106,5,2144,1349,-20
61974969354,61974969355,1,1585,889,-20
61975097679,61975097682,3,1606,965,-20
61978616425,61978616427,2,2076,1317,-20
61979471927,61979471904,-23,2099,1531,-20
61979981598,61979981602,4,1656,1249,-20
61980187170,61980187165,-5,2440,7139,-20
61983111492,61983111493,1,2156,1182,-20
61987494522,61987494525,3,1662,2086,-20
61988551690,61988551694,4,1624,1566,-20
61989005026,61989005031,5,2117,937,-20
61989710362,61989710364,2,1542,1581,-20
61993906757,61993906760,3,1890,938,-20
61995117605,61995117601,-4,696,2484,-20
61998742009,61998742011,2,2014,1963,-20
62003300765,62003300767,2,1387,1133,-20
62004342559,62004342562,3,1843,1477,-20
62005538989,62005538993,4,1921,1600,-20
62006086958,62006086961,3,2122,1687,-20
62007155686,62007155690,4,1999,1330,-20
62012979074,62012979077,3,1391,1597,-20
62014413742,62014413743,1,1780,1269,-20
62017720084,62017720105,21,200,1109,-20
62018031890,62018031894,4,2540,1668,-20
62019643185,62019643192,7,1725,1124,-20
62025706180,62025706183,3,2078,1434,-20
62027303090,62027303094,4,1539,1088,-20
62032053995,62032053997,2,1303,1353,-20
62036845669,62036845670,1,1850,1282,-20
62036898931,62036898934,3,1783,1309,-20
62037672371,62037672375,4,2120,1453,-20
62038892743,62038892747,4,1691,1461,-20
62044313246,62044313249,3,1648,1407,-20
62045061270,62045061275,5,2109,1705,-20
62046083057,62046083059,2,1334,1148,-20
62047830325,62047830329,4,1618,1377,-20
62051862273,62051862277,4,1868,1224,-20
62053042631,62053042636,5,1825,1661,-20
62056752202,62056752205,3,1908,1914,-20
62058207415,62058207419,4,2460,1799,-20
62060898420,62060898423,3,1702,1210,-20
62067966298,62067966301,3,2378,1300,-20
62068089797,62068089778,-19,1524,1006,-20
62069496737,62069496742,5,2816,1841,-20
62069951098,62069951101,3,1188,707,-20
62070001838,62070001857,19,3291,946,-20
62071728264,62071728266,2,1826,1565,-20
62074861856,62074861850,-6,24229,46614,-20
62075334776,62075334782,6,2764,1516,-20
62080823566,62080823570,4,2378,1516,-20
62081330766,62081330769,3,1190,1342,-20
62082518862,62082518865,3,1531,1622,-20
62083101473,62083101477,4,1321,730,-20
62086009870,62086009872,2,2650,1819,-20
62089623141,62089623147,6,1416,1029,-20
62095943084,62095943089,5,1466,1020,-20
62096803125,62096803130,5,2814,1522,-20
62100348486,62100348491,5,1489,1260,-20
62108510691,62108510695,4,1862,1126,-20
62113459787,62113459791,4,2485,1911,-20
62123831946,62123831950,4,2448,2021,-20
62126249422,62126249402,-20,2563,1272,-20
62126616178,62126616194,16,14459,53732,-20
62129996614,62129996615,1,2201,1275,-20
62137002075,62137002080,5,2495,1735,-20
62137540863,62137540867,4,1742,1230,-20
62143355109,62143355111,2,2053,1273,-20
62145649573,62145649576,3,2698,1382,-20
62146463822,62146463827,5,1806,1443,-20
62147854148,62147854150,2,1866,1201,-20
62148299311,62148299310,-1,1327,1699,-20
62151586965,62151586966,1,2110,1293,-20
62161832637,62161832638,1,1460,994,-20
62162940999,62162940977,-22,2458,1446,-20
62165917054,62165917033,-21,2638,2108,-20
62166042147,62166042151,4,1596,634,-20
62166384982,62166384986,4,1695,1378,-20
62167987198,62167987200,2,2233,1876,-20
62168368857,62168368860,3,1609,1212,-20
62168891382,62168891386,4,1340,1214,-20
62169284283,62169284288,5,1651,1269,-20
62170485455,62170485453,-2,2828,5590,-20
62170580232,62170580234,2,1704,1632,-20
62171499438,62171499439,1,1774,1326,-20
62171601513,62171601509,-4,1339,2803,-20
62179376362,62179376364,2,1961,1542,-20
62180370902,62180370904,2,1383,1101,-20
62185817449,62185817453,4,1929,1936,-20
62186395581,62186395584,3,1777,1359,-20
62187791280,62187791287,7,4252,1524,-20
62188844750,62188844750,0,1822,2987,-20
62195613575,62195613577,2,1690,1464,-20
62200658981,62200658985,4,1638,1210,-20
62204053851,62204053851,0,1401,1228,-20
62204804500,62204804503,3,1540,1571,-20
62205091774,62205091780,6,1257,882,-20
62210363441,62210363444,3,1610,1250,-20
62210794349,62210794352,3,1802,1661,-20
62212483926,62212483927,1,1704,1462,-20
62213763596,62213763593,-3,2533,3891,-20
62218418729,62218418735,6,1606,1057,-20
62219938617,62219938622,5,1596,1015,-20
62225326334,62225326338,4,1847,1224,-20
62232651706,62232651710,4,1962,1632,-20
62240793221,62240793222,1,1256,869,-20
62241889502,62241889506,4,1317,1266,-20
62248156423,62248156426,3,2004,1024,-20
62252591350,62252591349,-1,2287,2902,-20
62253987074,62253987078,4,2059,1549,-20
62254136558,62254136562,4,1489,902,-20
62255503226,62255503231,5,1752,1536,-20
62256611106,62256611112,6,2324,1654,-20
62257234913,62257234912,-1,1434,1485,-20
62261074371,62261074370,-1,1117,1706,-20
62262034666,62262034670,4,2645,2062,-20
62262945501,62262945498,-3,41098,16028,-20
62264162357,62264162359,2,1087,694,-20
62264659032,62264659038,6,1830,1805,-20
62264798523,62264798526,3,2043,1557,-20
62265252059,62265252064,5,1717,1689,-20
62270034034,62270034039,5,3376,2068,-20
62271053618,62271053621,3,1810,1385,-20
62272069696,62272069698,2,1928,1185,-20
62272461921,62272461926,5,1676,1052,-20
62272801247,62272801247,0,2311,1410,-20
62280876931,62280876930,-1,1625,1625,-20
62285725431,62285725433,2,1789,1359,-20
62291341882,62291341885,3,1346,965,-20
62292717327,62292717330,3,1758,1535,-20
62298229783,62298229783,0,757,907,-20
62300365669,62300365669,0,1589,1146,-20
62301263724,62301263728,4,2092,1072,-20
62304310914,62304310915,1,1575,1420,-20
62307303969,62307303971,2,1591,597,-20
62307677007,62307677019,12,13507,32516,-20
62308612809,62308612813,4,1313,1068,-20
62317709103,62317709108,5,2430,1929,-20
62320056982,62320056986,4,2470,2073,-20
62321152115,62321152120,5,1751,1064,-20
62321743999,62321744005,6,1636,1500,-20
62324640062,62324640066,4,2084,1819,-20
62324785941,62324785962,21,724,155,-20
62326948097,62326948100,3,2049,1648,-20
62327892630,62327892633,3,1854,1310,-20
62327933585,62327933590,5,2574,1774,-20
62331925879,62331925882,3,1510,1250,-20
62332383786,62332383778,-8,1461,4950,-20
62332725487,62332725490,3,1331,1484,-20
62333707875,62333707878,3,2032,1022,-20
62334069921,62334069926,5,1266,1003,-20
62334536819,62334536823,4,1507,1329,-20
62338481316,62338481320,4,1462,1500,-20
62340595893,62340595898,5,2258,1051,-20
62345467230,62345467232,2,1603,1642,-20
62345971541,62345971544,3,1880,1197,-20
62347981757,62347981762,5,2017,2110,-20
62348216518,62348216522,4,2041,1632,-20
62348886690,62348886692,2,1524,1500,-20
62350720427,62350720427,0,1022,970,-20
62351229418,62351229430,12,12921,21386,-20
62356239186,62356239188,2,2824,1348,-20
62356364774,62356364780,6,2188,1293,-20
62357655642,62357655645,3,1549,1342,-20
62359149115,62359149121,6,3943,2195,-20
62359354360,62359354353,-7,1148,5161,-20
62363278310,62363278314,4,2561,2066,-20
62363472916,62363472919,3,889,1237,-20
62364616774,62364616779,5,1800,1150,-20
62365265265,62365265269,4,1680,1524,-20
62365426528,62365426527,-1,1320,1261,-20
62366086989,62366086991,2,1161,828,-20
62369177483,62369177486,3,1504,938,-20
62371013365,62371013371,6,1416,722,-20
62375702936,62375702938,2,933,672,-20
62381312383,62381312387,4,1728,1296,-20
62382822682,62382822685,3,1792,1267,-20
62384805645,62384805648,3,1729,1394,-20
62385101029,62385101030,1,1298,1415,-20
62386296685,62386296686,1,1064,714,-20
62387880943,62387880946,3,1250,893,-20
62388988113,62388988117,4,1673,1322,-20
62389239477,62389239479,2,1874,1671,-20
62390677682,62390677681,-1,2191,2672,-20
62396317892,62396317895,3,1420,1013,-20
62396709360,62396709366,6,3383,1252,-20
62397000135,62397000138,3,1545,1469,-20
62397818103,62397818106,3,2172,2146,-20
62398507202,62398507209,7,3286,1489,-20
62399199410,62399199403,-7,978,5010,-20
62403301602,62403301603,1,1482,1925,-20
62404893719,62404893700,-19,1142,1089,-20
62405149215,62405149219,4,2087,1836,-20
62407428070,62407428068,-2,1153,1563,-20
62410357342,62410357345,3,2008,1642,-20
62412512157,62412512161,4,1520,1314,-20
62413400083,62413400087,4,1928,1796,-20
62415248089,62415248090,1,2100,1351,-20
62416079666,62416079672,6,1666,1401,-20
62418216864,62418216867,3,1405,1237,-20
62418722550,62418722554,4,1888,1549,-20
62423580767,62423580769,2,1229,1451,-20
62424980503,62424980507,4,1420,1283,-20
62426327519,62426327522,3,1804,1255,-20
62428817490,62428817495,5,2160,1167,-20
62429754568,62429754572,4,2367,1744,-20
62429873853,62429873874,21,1826,1188,-20
62434973566,62434973574,8,2746,1621,-20
62435724381,62435724385,4,1625,1176,-20
62439183387,62439183391,4,1782,1130,-20
62440143090,62440143094,4,1821,1305,-20
62441527425,62441527427,2,1189,1252,-20
62444004853,62444004855,2,2202,1721,-20
62445598591,62445598593,2,1883,1083,-20
62447488034,62447488038,4,1720,1519,-20
62448143304,62448143307,3,2143,1318,-20
62454152101,62454152102,1,1791,1343,-20
62454201482,62454201486,4,1308,1508,-20
62454970629,62454970608,-21,922,910,-20
62458033154,62458033157,3,1970,1348,-20
62459726765,62459726767,2,1652,1211,-20
62461247070,62461247073,3,2236,1888,-20
62461787099,62461787101,2,633,1023,-20
62468389875,62468389881,6,1579,1081,-20
62476102806,62476102810,4,1900,1140,-20
62476676335,62476676329,-6,877,3716,-20
62478029138,62478029142,4,768,895,-20
62482556501,62482556486,-15,894,484,-20
62487133384,62487133387,3,1094,795,-20
62487692852,62487692854,2,2024,1193,-20
62488690559,62488690562,3,1720,1693,-20
62488789381,62488789383,2,1907,1037,-20
62489268095,62489268100,5,2108,1112,-20
62490727334,62490727339,5,2252,1125,-20
62491977989,62491977994,5,2587,1159,-20
62494506657,62494506659,2,1480,1512,-20
62494702978,62494702982,4,2160,1221,-20
62497543062,62497543063,1,1470,1201,-20
62498484040,62498484026,-14,1291,988,-20
62502167205,62502167207,2,1645,995,-20
62504906925,62504906929,4,1831,1848,-20
62504980853,62504980856,3,2376,2002,-20
62509495430,62509495428,-2,20515,11331,-20
62513433523,62513433527,4,1685,1059,-20
62516954973,62516954978,5,2038,1102,-20
62517318643,62517318647,4,2237,1733,-20
62517813576,62517813578,2,2063,1436,-20
62519370722,62519370722,0,1598,1463,-20
62521461439,62521461437,-2,1245,1260,-20
62523071222,62523071227,5,2736,1330,-20
62526211394,62526211401,7,3423,985,-20
62526388922,62526388929,7,1012,1004,-20
62527973376,62527973378,2,1468,1585,-20
62532278445,62532278447,2,2217,1784,-20
62533521690,62533521695,5,2096,1083,-20
62536040515,62536040517,2,1422,1237,-20
62536648566,62536648570,4,1813,1394,-20
62536687929,62536687931,2,2053,999,-20
62537991816,62537991817,1,1838,1421,-20
62538104646,62538104653,7,1654,1255,-20
62538840165,62538840160,-5,1583,10179,-20
62540827460,62540827464,4,1435,1329,-20
62543494825,62543494829,4,1772,1229,-20
62556165332,62556165334,2,1032,755,-20
62557038791,62557038793,2,1456,1150,-20
62557601146,62557601149,3,1429,1706,-20
62557705610,62557705616,6,1985,1361,-20
62558976458,62558976462,4,1367,991,-20
62568300842,62568300842,0,1293,1099,-20
62568715538,62568715537,-1,18624,32629,-20
62569097627,62569097631,4,2315,1448,-20
62571557099,62571557099,0,2253,3260,-20
62575491725,62575491729,4,2322,1488,-20
62577100431,62577100435,4,2619,1837,-20
62579466907,62579466907,0,1015,1826,-20
62588794049,62588794056,7,3076,1116,-20
62588972615,62588972595,-20,1609,1545,-20
62592286710,62592286715,5,2091,1671,-20
62593321414,62593321425,11,1297,1285,-20
62596103575,62596103578,3,1762,1363,-20
62596853903,62596853905,2,2067,1311,-20
62598004914,62598004911,-3,1289,3210,-20
62600513913,62600513915,2,2543,1887,-20
62602409089,62602409090,1,1396,1268,-20
62605316230,62605316232,2,2054,1996,-20
62606540945,62606540949,4,1764,1808,-20
62607822658,62607822663,5,1470,1052,-20
62610733052,62610733054,2,2504,1581,-20
62611589178,62611589183,5,1754,1785,-20
62613457803,62613457806,3,1701,965,-20
62616088298,62616088302,4,1967,1130,-20
62617884046,62617884051,5,1900,1146,-20
62618331009,62618331011,2,1955,1106,-20
62621498190,62621498194,4,1509,861,-20
62622833190,62622833195,5,2195,1865,-20
62622898082,62622898081,-1,904,936,-20
62627733733,62627733738,5,3441,2228,-20
62628558786,62628558791,5,1860,1110,-20
62630364207,62630364211,4,2008,1355,-20
62633507238,62633507242,4,1584,1659,-20
62635744992,62635744995,3,2622,1338,-20
62637814693,62637814699,6,1996,1164,-20
62639343072,62639343077,5,2444,1386,-20
62640365849,62640365852,3,2231,1726,-20
62641042407,62641042407,0,1756,1077,-20
62643061631,62643061635,4,2254,1595,-20
62643629226,62643629223,-3,1669,1196,-20
62647810612,62647810614,2,1913,1605,-20
62648570882,62648570887,5,1352,1814,-20
62651800754,62651800761,7,2398,1420,-20
62656664417,62656664420,3,2050,2055,-20
62657686114,62657686118,4,1179,1596,-20
62657737135,62657737139,4,1963,1502,-20
62659208886,62659208883,-3,1605,1685,-20
62659765483,62659765489,6,1652,1351,-20
62660072743,62660072746,3,2045,1263,-20
62660725302,62660725306,4,1174,1097,-20
62660984005,62660984010,5,1931,1567,-20
62662148190,62662148194,4,1821,1164,-20
62662249155,62662249158,3,2140,1240,-20
62662874825,62662874823,-2,1584,2370,-20
62664627621,62664627622,1,1571,970,-20
62665472556,62665472560,4,2035,1889,-20
62672612680,62672612685,5,1848,971,-20
62675197382,62675197386,4,2226,1446,-20
62675744609,62675744612,3,1412,1049,-20
62677503640,62677503637,-3,26470,11839,-20
62681977797,62681977798,1,1476,1873,-20
62682252523,62682252527,4,2023,1311,-20
62684427286,62684427286,0,1292,1075,-20
62684972384,62684972389,5,1537,1054,-20
62692246424,62692246427,3,1853,2190,-20
62692602543,62692602547,4,2732,2212,-20
62694474725,62694474729,4,2065,1360,-20
62695287015,62695287016,1,1475,1351,-20
62699061882,62699061887,5,1820,1147,-20
62700739071,62700739081,10,647,306,-20
62700808946,62700808948,2,1817,1598,-20
62704430828,62704430832,4,1914,1656,-20
62705324107,62705324113,6,2435,1338,-20
62709193054,62709193059,5,1629,1866,-20
62710168067,62710168072,5,1812,1464,-20
62712535107,62712535111,4,2669,1493,-20
62714912002,62714912002,0,2210,1748,-20
62717746706,62717746713,7,2011,1545,-20
62718463531,62718463536,5,2369,1870,-20
62718923442,62718923446,4,1801,1383,-20
62721832456,62721832463,7,7889,35783,-20
62723650716,62723650724,8,2627,1118,-20
62725995317,62725995312,-5,1071,3075,-20
62727043399,62727043402,3,1386,1028,-20
62727592058,62727592057,-1,1639,2509,-20
62728834993,62728835001,8,4036,879,-20
62729868460,62729868463,3,2265,1475,-20
62731619593,62731619597,4,1470,1185,-20
62734594850,62734594853,3,1868,1467,-20
62738678313,62738678318,5,1947,975,-20
62740775906,62740775910,4,1937,1324,-20
62741201017,62741201020,3,7585,5538,-20
62748552282,62748552286,4,1910,1492,-20
62750455007,62750455010,3,2077,1529,-20
62753178922,62753178927,5,2327,1038,-20
62754145718,62754145719,1,2417,1680,-20
62755197582,62755197585,3,1114,1117,-20
62755855895,62755855898,3,2129,2057,-20
62756606695,62756606700,5,1571,1201,-20
62758160247,62758160250,3,1607,1446,-20
62759082641,62759082643,2,2523,1624,-20
62760067673,62760067674,1,1951,1324,-20
62762537215,62762537215,0,1097,1183,-20
62763405982,62763405988,6,2477,1182,-20
62765560937,62765560939,2,1896,1453,-20
62766709830,62766709834,4,1740,1176,-20
62767621219,62767621223,4,2574,1355,-20
62774807046,62774807049,3,1095,933,-20
62775968578,62775968581,3,2647,1904,-20
62776201517,62776201521,4,1508,1657,-20
62778165043,62778165045,2,2035,1893,-20
62778514186,62778514189,3,1831,1317,-20
62779309473,62779309475,2,2164,1419,-20
62780938114,62780938118,4,955,1287,-20
62781708837,62781708842,5,2454,1682,-20
62781924636,62781924640,4,2575,1693,-20
62785929733,62785929735,2,1689,1255,-20
62786125192,62786125193,1,1407,1081,-20
62788162598,62788162576,-22,1642,985,-20
62789749924,62789749927,3,1714,1372,-20
62792574255,62792574259,4,1496,1370,-20
62797171426,62797171430,4,2573,1530,-20
62797649166,62797649169,3,2305,1205,-20
62798145103,62798145106,3,1673,1515,-20
62800367582,62800367586,4,1215,1359,-20
62802506147,62802506146,-1,1899,2030,-20
62804963985,62804963986,1,1731,2104,-20
62805873094,62805873099,5,2192,1249,-20
62806485029,62806485034,5,1310,1359,-20
62807166854,62807166850,-4,19001,15033,-20
62810368166,62810368170,4,1853,1744,-20
62813542161,62813542164,3,2104,1330,-20
62813679343,62813679336,-7,1881,11192,-20
62815545434,62815545438,4,1612,1336,-20
62816940129,62816940129,0,51569,33354,-20
62821382530,62821382534,4,2748,1501,-20
62822407005,62822407008,3,1813,1720,-20
62823121234,62823121237,3,1551,1045,-20
62824326910,62824326911,1,909,754,-20
62825254517,62825254522,5,1388,1265,-20
62828329295,62828329298,3,1042,408,-20
62829789430,62829789432,2,1333,1655,-20
62831008402,62831008407,5,2876,1609,-20
62832671992,62832671995,3,2426,2285,-20
62834937773,62834937775,2,1512,1330,-20
62836801360,62836801366,6,1885,1706,-20
62839881251,62839881252,1,1078,1658,-20
62840237498,62840237499,1,956,1009,-20
62841446243,62841446246,3,2714,1205,-20
62842396120,62842396125,5,1246,1274,-20
62844310758,62844310764,6,1480,1378,-20
62845910549,62845910551,2,1475,953,-20
62847611197,62847611202,5,1450,1516,-20
62854494267,62854494270,3,1687,1378,-20
62857740000,62857740002,2,1678,1378,-20
62858543762,62858543765,3,1255,1546,-20
62861448791,62861448794,3,2366,1283,-20
62863758172,62863758171,-1,1552,2826,-20
62864717298,62864717301,3,2069,859,-20
62865595575,62865595578,3,1675,1539,-20
62868906909,62868906914,5,1630,1316,-20
62869885341,62869885343,2,2201,1312,-20
62872575670,62872575675,5,1917,1181,-20
62874209018,62874209021,3,1729,1274,-20
62878140787,62878140793,6,2388,1543,-20
62879731454,62879731457,3,2133,2079,-20
62881013510,62881013515,5,2093,1261,-20
62882089247,62882089250,3,2010,1580,-20
62882260418,62882260420,2,1489,1166,-20
62885942034,62885942038,4,1760,1251,-20
62886992166,62886992169,3,2300,1884,-20
62893631962,62893631969,7,1727,1261,-20
62893938298,62893938281,-17,2067,1476,-20
62895249947,62895249953,6,2233,1367,-20
62896702103,62896702107,4,1731,1022,-20
62897039081,62897039083,2,1950,1379,-20
62899061688,62899061687,-1,995,2594,-20
62904321206,62904321209,3,1455,1394,-20
62906148005,62906148006,1,1566,1913,-20
62909389754,62909389759,5,1816,967,-20
62910102430,62910102434,4,1753,1176,-20
62914319854,62914319857,3,1932,1380,-20
62914415865,62914415867,2,1550,956,-20
62915603018,62915603022,4,1407,1220,-20
62917268534,62917268539,5,1641,1499,-20
62919332705,62919332709,4,1589,1074,-20
62920716940,62920716939,-1,4734,6964,-20
62923892718,62923892714,-4,1565,2988,-20
62925830066,62925830070,4,1838,1771,-20
62931283806,62931283807,1,984,1630,-20
62932199869,62932199871,2,1474,1518,-20
62932296239,62932296243,4,1926,1290,-20
62932888293,62932888296,3,2493,1419,-20
62936361647,62936361650,3,1622,1320,-20
62939127107,62939127112,5,2218,1837,-20
62941890568,62941890570,2,2783,1726,-20
62954290294,62954290298,4,1068,986,-20
62954447718,62954447724,6,1442,909,-20
62955604855,62955604859,4,1634,1398,-20
62957023320,62957023324,4,1503,1425,-20
62957123141,62957123145,4,1819,1901,-20
62959011045,62959011047,2,1978,1251,-20
62961161316,62961161320,4,1312,1195,-20
62964332157,62964332159,2,1801,1087,-20
62965991905,62965991907,2,1044,1406,-20
62967701910,62967701914,4,1877,1154,-20
62968593718,62968593723,5,1299,935,-20
62977542185,62977542189,4,2147,1666,-20
62978782702,62978782705,3,2001,1496,-20
62982822605,62982822606,1,2411,1601,-20
62985702509,62985702492,-17,934,368,-20
62992484525,62992484529,4,2389,1908,-20
62993089770,62993089774,4,2283,1899,-20
63001687714,63001687718,4,1955,1311,-20
63003552792,63003552795,3,1609,996,-20
63013779925,63013779934,9,1739,1274,-20
63014931197,63014931199,2,1442,1007,-20
63019077821,63019077824,3,1834,1389,-20
63026604186,63026604189,3,1235,1329,-20
63027491360,63027491359,-1,929,982,-20
63028057830,63028057825,-5,1619,3921,-20
63028270370,63028270375,5,3121,1736,-20
63030056786,63030056787,1,1649,2008,-20
63033031783,63033031786,3,1996,1725,-20
63033461209,63033461211,2,1874,1141,-20
63033774500,63033774502,2,695,1176,-20
63034922097,63034922099,2,2304,1881,-20
63035408621,63035408626,5,2194,1833,-20
63035784664,63035784682,18,2051,963,-20
63036185357,63036185361,4,2283,1420,-20
63037410717,63037410730,13,2289,1248,-20
63038180335,63038180334,-1,1066,890,-20
63038543803,63038543806,3,1156,868,-20
63040379858,63040379863,5,1582,1199,-20
63048604172,63048604173,1,1424,1361,-20
63049231839,63049231837,-2,1572,3317,-20
63049749275,63049749278,3,2508,1432,-20
63055452127,63055452132,5,1879,1339,-20
63056428681,63056428687,6,1547,1323,-20
63062262965,63062262965,0,1638,1115,-20
63070772800,63070772804,4,1570,987,-20
63073175414,63073175417,3,1720,1402,-20
63075567372,63075567376,4,2150,1795,-20
63076833941,63076833945,4,1866,993,-20
63078497490,63078497494,4,1453,1318,-20
63079400993,63079400989,-4,965,2296,-20
63080765874,63080765878,4,2236,1751,-20
63081274191,63081274170,-21,1049,739,-20
63081431790,63081431794,4,1204,1092,-20
63086810412,63086810411,-1,1968,2989,-20
63087380446,63087380450,4,1693,1217,-20
63089325713,63089325717,4,1976,1170,-20
63089736437,63089736438,1,1777,1224,-20
63090760118,63090760122,4,2565,1733,-20
63091933488,63091933491,3,1926,826,-20
63094139030,63094139033,3,1642,1290,-20
63101456855,63101456859,4,1411,1250,-20
63103409066,63103409069,3,1878,1326,-20
63103691837,63103691840,3,1397,1444,-20
63109166646,63109166650,4,1738,1397,-20
63118449246,63118449249,3,1456,1777,-20
63125695722,63125695726,4,1037,1054,-20
63126823921,63126823924,3,2289,1217,-20
63126907914,63126907900,-14,1623,1415,-20
63127377198,63127377200,2,2186,2545,-20
63127610618,63127610621,3,1426,1135,-20
63130263762,63130263764,2,2665,1545,-20
63132724536,63132724537,1,1507,1498,-20
63133542646,63133542651,5,1668,2006,-20
63134160250,63134160254,4,1594,1118,-20
63134763459,63134763440,-19,1843,1217,-20
63136391934,63136391938,4,1941,1525,-20
63139020918,63139020896,-22,2813,1261,-20
63139349241,63139349245,4,1955,1701,-20
63144779194,63144779199,5,1299,1657,-20
63148099618,63148099613,-5,1042,4348,-20
63148150522,63148150523,1,1223,509,-20
63149681807,63149681811,4,1472,1015,-20
63151924553,63151924554,1,2018,2307,-20
63152298610,63152298614,4,1609,1550,-20
63152830997,63152830998,1,1650,1246,-20
63154148944,63154148947,3,1917,1813,-20
63155816676,63155816674,-2,1802,2541,-20
63155971702,63155971704,2,1857,1495,-20
63156903847,63156903851,4,1448,1086,-20
63158774978,63158774978,0,2219,1864,-20
63159575313,63159575318,5,1742,1162,-20
63159712316,63159712318,2,1598,1295,-20
63166471755,63166471758,3,1707,1673,-20
63167445854,63167445858,4,2057,1531,-20
63168394499,63168394503,4,1953,1639,-20
63172583966,63172583961,-5,2614,12169,-20
63179134378,63179134385,7,1129,1394,-20
63186020850,63186020855,5,2888,1812,-20
63190949252,63190949255,3,1702,1007,-20
63196311897,63196311901,4,1687,1875,-20
63200027434,63200027438,4,1619,745,-20
63203497474,63203497470,-4,862,2436,-20
63209613267,63209613269,2,1199,1089,-20
63209868723,63209868727,4,1530,1185,-20
63210568105,63210568087,-18,2143,1476,-20
63213326262,63213326266,4,2008,1360,-20
63214793769,63214793751,-18,2479,2126,-20
63216368602,63216368603,1,1338,1097,-20
63219087777,63219087778,1,1608,912,-20
63222970832,63222970835,3,2462,1601,-20
63225009653,63225009657,4,1515,1632,-20
63225515627,63225515630,3,1154,885,-20
63225681278,63225681283,5,1385,1558,-20
63228110986,63228110989,3,2065,1826,-20
63229512133,63229512134,1,2082,1864,-20
63232747966,63232747970,4,1758,1430,-20
63233282398,63233282398,0,938,566,-20
63236154698,63236154703,5,1952,1197,-20
63240850662,63240850666,4,1459,1217,-20
63245699263,63245699246,-17,1362,1337,-20
63248500118,63248500121,3,2159,1652,-20
63252983511,63252983511,0,1163,1369,-20
63254487228,63254487209,-19,1770,1132,-20
63255947707,63255947710,3,2379,1139,-20
63261537779,63261537782,3,846,1018,-20
63263247114,63263247120,6,2398,1490,-20
63269736545,63269736547,2,1306,1272,-20
63270325013,63270325009,-4,1583,6038,-20
63271285092,63271285094,2,1517,869,-20
63271627319,63271627322,3,987,1298,-20
63276739573,63276739574,1,1494,1412,-20
63277573798,63277573800,2,1708,1457,-20
63279416418,63279416421,3,1413,1271,-20
63279649070,63279649051,-19,1650,1031,-20
63282578198,63282578198,0,1823,1610,-20
63284921355,63284921359,4,1231,1031,-20
63285504546,63285504547,1,974,1087,-20
63286036877,63286036879,2,1320,1703,-20
63286548156,63286548158,2,1734,1195,-20
63289342328,63289342334,6,1453,794,-20
63291013906,63291013912,6,2614,1312,-20
63301758218,63301758222,4,1877,881,-20
63301889419,63301889423,4,2008,1199,-20
63307509830,63307509833,3,2287,1616,-20
63309021177,63309021180,3,2705,1597,-20
63309213852,63309213857,5,2658,1512,-20
63311346730,63311346730,0,1942,2702,-20
63311452779,63311452782,3,1790,1332,-20
63311980883,63311980899,16,911,844,-20
63312826677,63312826679,2,1972,1492,-20
63317200484,63317200489,5,1679,1152,-20
63318401446,63318401449,3,1381,2516,-20
63318917995,63318918000,5,1674,984,-20
63321134458,63321134461,3,1257,1303,-20
63321337058,63321337040,-18,1953,1020,-20
63325245771,63325245776,5,1429,1649,-20
63327394632,63327394624,-8,955,380,-20
63328818450,63328818454,4,944,949,-20
63329820441,63329820447,6,2442,1620,-20
63330318969,63330318971,2,1508,1023,-20
63333412683,63333412686,3,1456,1422,-20
63333518342,63333518355,13,1589,1472,-20
63336299846,63336299851,5,1384,1212,-20
63337134207,63337134211,4,1710,1053,-20
63337892861,63337892864,3,2114,1376,-20
63343919369,63343919372,3,1798,1594,-20
63346116261,63346116267,6,2073,1154,-20
63346654597,63346654599,2,1738,1331,-20
63349258730,63349258736,6,2772,1286,-20
63350577426,63350577430,4,1750,1156,-20
63352690892,63352690894,2,1870,1174,-20
63353668486,63353668490,4,2154,1272,-20
63356339882,63356339886,4,4342,2353,-20
63362843957,63362843961,4,1874,1560,-20
63364325999,63364326002,3,1989,1108,-20
63372127061,63372127066,5,2758,1459,-20
63377878905,63377878910,5,1371,1111,-20
63378331026,63378331029,3,2576,1751,-20
63380937525,63380937512,-13,2080,1208,-20
63382722342,63382722347,5,968,842,-20
63382893575,63382893588,13,431,174,-20
63387248878,63387248878,0,1451,2451,-20
63388012647,63388012641,-6,1142,1229,-20
63388884662,63388884666,4,1513,1111,-20
63390309371,63390309366,-5,1376,3801,-20
63394346809,63394346814,5,840,1040,-20
63395219130,63395219132,2,1552,1109,-20
63400503846,63400503850,4,1698,1480,-20
63402010966,63402010970,4,2034,1374,-20
63409685513,63409685519,6,1948,1756,-20
63413063334,63413063342,8,3634,917,-20
63417640447,63417640448,1,1408,940,-20
63417939476,63417939479,3,2648,1942,-20
63420554622,63420554625,3,2524,1322,-20
63424808293,63424808298,5,1122,808,-20
63425519345,63425519349,4,2332,1681,-20
63426210988,63426210991,3,1834,1340,-20
63427096963,63427096969,6,2281,1312,-20
63427763692,63427763694,2,1943,1612,-20
63430475875,63430475878,3,1830,977,-20
63432691629,63432691633,4,2422,1643,-20
63435228237,63435228240,3,1911,1962,-20
63438153682,63438153686,4,2358,1168,-20
63439836618,63439836621,3,1917,1405,-20
63441809297,63441809300,3,1758,1397,-20
63444468462,63444468466,4,1957,1704,-20
63447195488,63447195491,3,1719,1538,-20
63447709593,63447709597,4,1988,1443,-20
63448410094,63448410095,1,1540,1412,-20
63449653791,63449653795,4,1382,1060,-20
63451979175,63451979177,2,1026,918,-20
63453632162,63453632169,7,4891,1876,-20
63454558819,63454558823,4,1447,1074,-20
63454599765,63454599769,4,2963,1910,-20
63456565499,63456565502,3,2472,1596,-20
63456677557,63456677559,2,1769,1051,-20
63457506354,63457506360,6,3198,1585,-20
63460196023,63460196026,3,1641,1343,-20
63461760882,63461760887,5,2143,1236,-20
63463232475,63463232477,2,1009,1097,-20
63463543025,63463543027,2,1396,1336,-20
63465093132,63465093138,6,3494,1164,-20
63467789270,63467789275,5,2955,1250,-20
63471261290,63471261285,-5,1155,2579,-20
63475248458,63475248461,3,1364,1357,-20
63477553294,63477553297,3,1818,1519,-20
63478031153,63478031158,5,2691,1839,-20
63479249430,63479249433,3,2027,1379,-20
63480311289,63480311294,5,1591,1588,-20
63480579854,63480579858,4,1192,756,-20
63482406471,63482406473,2,1306,1410,-20
63483033430,63483033430,0,2239,1479,-20
63485018119,63485018121,2,2303,1796,-20
63485524166,63485524170,4,929,1017,-20
63485942157,63485942160,3,1955,1472,-20
63487171517,63487171521,4,1658,1574,-20
63488999348,63488999351,3,1600,992,-20
63494387849,63494387851,2,1493,1290,-20
63495053944,63495053946,2,1417,1363,-20
63495820316,63495820319,3,1716,941,-20
63502235321,63502235325,4,1838,1607,-20
63504236335,63504236341,6,2538,1275,-20
63506001702,63506001710,8,1766,786,-20
63512246507,63512246509,2,1393,1687,-20
63513051438,63513051443,5,958,959,-20
63515100079,63515100083,4,1711,1690,-20
63515184782,63515184785,3,1787,1421,-20
63516120908,63516120912,4,1752,1077,-20
63519421570,63519421576,6,2229,1500,-20
63520955850,63520955855,5,2643,1014,-20
63521856918,63521856921,3,1434,1371,-20
63526607290,63526607294,4,1753,1385,-20
63527587389,63527587381,-8,30107,15796,-20
63533948267,63533948271,4,1354,1198,-20
63536053004,63536053007,3,1232,1901,-20
63536962496,63536962502,6,1981,1041,-20
63539159418,63539159419,1,1017,1078,-20
63541875933,63541875936,3,2022,1352,-20
63543721708,63543721711,3,1731,1703,-20
63545518846,63545518849,3,1619,1260,-20
63546702247,63546702250,3,2335,2453,-20
63549859069,63549859075,6,2495,1369,-20
63550491894,63550491894,0,1498,1570,-20
63550855672,63550855673,1,1794,1853,-20
63551579007,63551579010,3,1374,1036,-20
63552608029,63552608011,-18,781,262,-20
63555674346,63555674352,6,2110,1659,-20
63560011235,63560011237,2,2048,1925,-20
63560491664,63560491666,2,1579,1344,-20
63562576073,63562576077,4,871,1087,-20
63563393567,63563393570,3,1030,1565,-20
63563481482,63563481483,1,1531,1835,-20
63564447899,63564447902,3,2311,1872,-20
63564610250,63564610254,4,1135,1141,-20
63565358117,63565358118,1,3337,3594,-20
63566801378,63566801379,1,1143,1245,-20
63569393044,63569393049,5,1814,1286,-20
63570291353,63570291358,5,2121,953,-20
63570783552,63570783556,4,1831,1368,-20
63580500568,63580500570,2,2412,1471,-20
63585955709,63585955709,0,1181,1665,-20
63588774557,63588774561,4,2775,1138,-20
63595182060,63595182064,4,1990,1392,-20
63597055065,63597055066,1,1836,1448,-20
63599631559,63599631564,5,2461,1534,-20
63600101814,63600101818,4,1022,677,-20
63600453111,63600453113,2,2140,1400,-20
63602988712,63602988715,3,2119,1271,-20
63608214789,63608214793,4,1692,975,-20
63608969394,63608969396,2,1513,1098,-20
63609182249,63609182254,5,2353,1752,-20
63616590280,63616590282,2,2440,1475,-20
63616898546,63616898550,4,1191,1176,-20
63618593925,63618593926,1,1313,1044,-20
63619113065,63619113063,-2,1538,1591,-20
63620539504,63620539508,4,2186,1490,-20
63620613971,63620613975,4,1728,766,-20
63620847533,63620847513,-20,1324,741,-20
63622428794,63622428798,4,2000,1650,-20
63625879969,63625879966,-3,498,1656,-20
63629940125,63629940128,3,1381,1593,-20
63631876743,63631876747,4,1735,952,-20
63639482069,63639482071,2,3005,1590,-20
63640629054,63640629057,3,2195,2099,-20
63640774009,63640774012,3,2189,1064,-20
63642947730,63642947726,-4,22307,14844,-20
63643629534,63643629538,4,1534,1251,-20
63644692276,63644692278,2,2039,1205,-20
63645181828,63645181831,3,1646,940,-20
63645888496,63645888500,4,1598,1137,-20
63649134469,63649134474,5,2214,1621,-20
63649577292,63649577297,5,1981,1408,-20
63651625106,63651625111,5,1950,900,-20
63652410718,63652410723,5,1419,904,-20
63653823011,63653823014,3,1610,1219,-20
63653923161,63653923165,4,1901,1575,-20
63658966875,63658966879,4,1565,1275,-20
63660716637,63660716641,4,2117,1095,-20
63663627286,63663627290,4,1895,1406,-20
63670347832,63670347834,2,1202,1052,-20
63673704745,63673704747,2,2139,1563,-20
63682932487,63682932491,4,1786,1311,-20
63685844409,63685844413,4,1589,1683,-20
63687704531,63687704535,4,1836,1079,-20
63691233000,63691233002,2,1666,1374,-20
63693406415,63693406419,4,2759,2072,-20
63694974610,63694974614,4,2455,1628,-20
63697817486,63697817490,4,1776,1557,-20
63699957130,63699957136,6,1625,1313,-20
63701285001,63701285002,1,1842,949,-20
63702404671,63702404675,4,1756,1862,-20
63706921530,63706921535,5,1808,1525,-20
63710436397,63710436409,12,2469,1341,-20
63712446851,63712446853,2,1922,1940,-20
63716721286,63716721285,-1,2233,5106,-20
63717771981,63717771984,3,1670,2243,-20
63719914964,63719914945,-19,1392,955,-20
63721869354,63721869358,4,1815,1090,-20
63724590245,63724590246,1,1060,898,-20
63725527646,63725527649,3,1734,1366,-20
63727544541,63727544543,2,1596,1608,-20
63729407587,63729407594,7,1637,1134,-20
63731615222,63731615228,6,1148,1280,-20
63734051440,63734051440,0,1378,1685,-20
63734342542,63734342548,6,1882,1569,-20
63738359726,63738359729,3,2042,1466,-20
63739866406,63739866409,3,2090,1614,-20
63742477983,63742477986,3,1120,1221,-20
63747214088,63747214090,2,1881,1256,-20
63748148521,63748148526,5,1851,1098,-20
63748389249,63748389253,4,1718,1725,-20
63751503193,63751503194,1,1568,990,-20
63760782117,63760782121,4,2517,1763,-20
63767399776,63767399781,5,2497,1471,-20
63770372339,63770372338,-1,1536,868,-20
63771137198,63771137207,9,1075,1041,-20
63773717153,63773717158,5,1260,1572,-20
63774244186,63774244191,5,2367,1313,-20
63777256488,63777256490,2,2060,1449,-20
63778369833,63778369833,0,1333,1663,-20
63780832227,63780832230,3,1926,1580,-20
63782158298,63782158301,3,1425,1639,-20
63782234008,63782234019,11,1329,1222,-20
63783995608,63783995611,3,2367,1355,-20
63785711951,63785711955,4,1547,1503,-20
63787780674,63787780675,1,1776,1270,-20
63788702771,63788702774,3,1321,1186,-20
63794841017,63794841020,3,1602,1329,-20
63797116435,63797116433,-2,1006,2208,-20
63798520326,63798520330,4,2056,1320,-20
63798931196,63798931197,1,2148,1995,-20
63799458673,63799458676,3,1988,1592,-20
63801810638,63801810640,2,1940,1621,-20
63807024034,63807024038,4,1441,1041,-20
63808298165,63808298167,2,1887,1764,-20
63809745731,63809745734,3,1390,1466,-20
63810489910,63810489914,4,1383,1188,-20
63812085430,63812085435,5,2112,1912,-20
63814359186,63814359190,4,1755,1205,-20
63814766281,63814766297,16,898,1475,-20
63815373266,63815373269,3,2223,1963,-20
63818535631,63818535635,4,1764,1678,-20
63819466663,63819466667,4,1744,1892,-20
63819755634,63819755634,0,1094,2070,-20
63822006973,63822006974,1,1064,1172,-20
63826922460,63826922466,6,1947,1624,-20
63830656980,63830656982,2,1425,988,-20
63831650526,63831650530,4,2470,1564,-20
63836429669,63836429673,4,2937,1826,-20
63837015457,63837015459,2,2329,1385,-20
63837644749,63837644751,2,2123,2076,-20
63840241675,63840241679,4,1885,1163,-20
63841282059,63841282062,3,1056,916,-20
63845007657,63845007661,4,1488,1176,-20
63845450337,63845450339,2,1785,1608,-20
63848783877,63848783881,4,1803,1903,-20
63849454593,63849454598,5,1437,1157,-20
63850237166,63850237167,1,1850,1093,-20
63850568259,63850568243,-16,2136,904,-20
63852134209,63852134211,2,1685,1012,-20
63853198315,63853198319,4,1756,1148,-20
63853987818,63853987821,3,1801,1334,-20
63862017052,63862017055,3,1715,1257,-20
63862752649,63862752653,4,1807,858,-20
63863143721,63863143725,4,2004,1093,-20
63871631210,63871631214,4,1918,1415,-20
63879653812,63879653818,6,1555,1090,-20
63881366975,63881366979,4,1946,1357,-20
63882416214,63882416216,2,2542,1668,-20
63883008445,63883008467,22,1853,1160,-20
63883063514,63883063511,-3,1679,1166,-20
63885852925,63885852932,7,3634,1037,-20
63889817798,63889817805,7,8148,2790,-20
63893396126,63893396130,4,2063,1102,-20
63898113721,63898113725,4,1719,1302,-20
63899553265,63899553268,3,1958,1625,-20
63903732645,63903732646,1,3757,3113,-20
63904608855,63904608860,5,2666,2199,-20
63905586782,63905586784,2,1784,2264,-20
63907003319,63907003322,3,1208,914,-20
63908040252,63908040256,4,1706,1619,-20
63911495390,63911495395,5,2009,1609,-20
63911682225,63911682230,5,1374,1132,-20
63912443174,63912443177,3,2819,1869,-20
63913063434,63913063437,3,2246,1243,-20
63913828039,63913828043,4,1293,1149,-20
63914049152,63914049154,2,1950,2138,-20
63915918648,63915918651,3,2405,2000,-20
63917234838,63917234842,4,1178,845,-20
63920992217,63920992222,5,1440,1251,-20
63924093818,63924093819,1,1803,1682,-20
63926437493,63926437498,5,1851,1355,-20
63927708397,63927708401,4,1812,1572,-20
63930138418,63930138410,-8,1562,7191,-20
63930389125,63930389127,2,2050,1552,-20
63931644815,63931644818,3,941,823,-20
63932927146,63932927151,5,1450,855,-20
63942987316,63942987319,3,1829,1193,-20
63943363127,63943363131,4,906,1311,-20
63950249811,63950249815,4,2437,1683,-20
63951155480,63951155487,7,3460,1186,-20
63951638004,63951638006,2,1752,1899,-20
63956325882,63956325885,3,1322,1195,-20
63958095973,63958095978,5,1924,2043,-20
63964173610,63964173617,7,1788,1410,-20
63965123859,63965123847,-12,1592,1175,-20
63969112770,63969112774,4,2166,1444,-20
63969197573,63969197577,4,4221,2638,-20
63975041126,63975041132,6,2207,1414,-20
63977178976,63977178981,5,1916,1275,-20
63978219771,63978219774,3,1282,1258,-20
63985246666,63985246661,-5,1209,2931,-20
63987672878,63987672880,2,1408,1561,-20
63988343189,63988343193,4,2353,1028,-20
63998052972,63998052979,7,2917,1140,-20
64001347117,64001347120,3,2080,1700,-20
64004084706,64004084711,5,1988,1649,-20
64006689466,64006689467,1,1435,1516,-20
64009774712,64009774731,19,1464,1053,-20
64010419137,64010419139,2,1076,1177,-20
64013438695,64013438699,4,1911,1428,-20
64014445654,64014445657,3,1787,2038,-20
64015392822,64015392822,0,1902,1221,-20
64015483108,64015483110,2,1867,1174,-20
64017080176,64017080179,3,1822,1352,-20
64018249222,64018249224,2,1564,1528,-20
64021986041,64021986043,2,1730,1697,-20
64023935852,64023935855,3,2069,1348,-20
64024151706,64024151710,4,1254,1116,-20
64026909113,64026909114,1,1045,1217,-20
64029252636,64029252634,-2,1567,1313,-20
64032250447,64032250451,4,1504,926,-20
64035754799,64035754802,3,1499,1344,-20
64037308065,64037308070,5,1894,1825,-20
64040126520,64040126523,3,2169,1190,-20
64041341233,64041341235,2,2052,1843,-20
64045666078,64045666078,0,879,724,-20
64047887590,64047887597,7,1823,1247,-20
64047937999,64047938019,20,1386,1400,-20
64048609481,64048609486,5,1860,1273,-20
64056148310,64056148313,3,1431,1392,-20
64057730662,64057730666,4,2102,1151,-20
64059496142,64059496143,1,1437,2030,-20
64066905251,64066905254,3,2011,1966,-20
64068489593,64068489595,2,1695,1329,-20
64069377838,64069377842,4,1004,871,-20
64070948351,64070948354,3,1580,1463,-20
64071761163,64071761167,4,2874,1246,-20
64079845733,64079845735,2,1446,1067,-20
64083067102,64083067105,3,1950,1446,-20
64083940562,64083940565,3,2030,1358,-20
64084713677,64084713678,1,1497,1290,-20
64088506147,64088506150,3,2731,1734,-20
64088747941,64088747945,4,2502,1621,-20
64093206985,64093206991,6,2137,1624,-20
64093654671,64093654675,4,1959,1139,-20
64100340204,64100340208,4,1957,1258,-20
64101524522,64101524527,5,2247,1292,-20
64104073306,64104073312,6,2051,985,-20
64105449044,64105449045,1,2320,1633,-20
64108161743,64108161748,5,1804,1399,-20
64109295615,64109295619,4,2736,1925,-20
64110723294,64110723298,4,2183,2184,-20
64111372046,64111372048,2,1660,1301,-20
64112492757,64112492778,21,1938,827,-20
64113185246,64113185250,4,2084,1495,-20
64117411699,64117411698,-1,658,1028,-20
64119616537,64119616544,7,1304,1609,-20
64120515694,64120515700,6,1870,1637,-20
64122384561,64122384561,0,1435,956,-20
64123418305,64123418298,-7,1544,7812,-20
64124058003,64124058006,3,1528,1383,-20
64124544168,64124544172,4,1718,1420,-20
64125747189,64125747195,6,2111,1060,-20
64126529834,64126529838,4,1547,1509,-20
64128135098,64128135101,3,2022,2031,-20
64129404706,64129404709,3,2005,1218,-20
64131236332,64131236334,2,1669,1584,-20
64132107630,64132107634,4,1382,1290,-20
64134220264,64134220264,0,22659,17303,-20
64134275363,64134275369,6,2098,1627,-20
64135549032,64135549029,-3,1382,3021,-20
64137738379,64137738383,4,2095,984,-20
64144457294,64144457297,3,1870,1151,-20
64145191150,64145191154,4,1831,1244,-20
64161945505,64161945506,1,1403,1219,-20
64167883373,64167883375,2,1397,1034,-20
64168647254,64168647258,4,1850,1386,-20
64171760542,64171760546,4,2223,2167,-20
64173882602,64173882605,3,2225,1499,-20
64174249686,64174249690,4,1978,1392,-20
64174919883,64174919886,3,2553,1462,-20
64176538386,64176538390,4,1456,1302,-20
64178217585,64178217590,5,1352,1170,-20
64182586503,64182586509,6,1670,1571,-20
64190674454,64190674460,6,5854,2573,-20
64192550229,64192550230,1,1942,1767,-20
64192755467,64192755469,2,1256,1290,-20
64195101681,64195101683,2,1399,1226,-20
64195458841,64195458847,6,2217,1227,-20
64197186802,64197186807,5,1104,731,-20
64200018309,64200018312,3,1664,1339,-20
64200979963,64200979949,-14,1925,1159,-20
64205494473,64205494463,-10,19498,28848,-20
64207001126,64207001123,-3,751,1627,-20
64207678261,64207678266,5,1466,1193,-20
64208809595,64208809599,4,1516,1269,-20
64211595638,64211595645,7,1530,1489,-20
64215169134,64215169138,4,2286,1495,-20
64217247064,64217247059,-5,985,2156,-20
64218198402,64218198403,1,1645,1118,-20
64221194651,64221194655,4,2087,1450,-20
64227237381,64227237383,2,894,728,-20
64227510921,64227510924,3,1713,1482,-20
64228339937,64228339941,4,1710,1466,-20
64228586759,64228586762,3,1828,1418,-20
64229772545,64229772551,6,944,900,-20
64234598800,64234598803,3,1934,954,-20
64235110027,64235110034,7,1762,816,-20
64240222362,64240222366,4,1626,932,-20
64240585158,64240585169,11,1589,802,-20
64241687819,64241687823,4,1632,1283,-20
64243319286,64243319281,-5,1276,3767,-20
64243696871,64243696875,4,2634,1390,-20
64245080741,64245080746,5,1393,1137,-20
64245448947,64245448951,4,958,1164,-20
64246761838,64246761842,4,1905,1276,-20
64247984786,64247984788,2,1669,1153,-20
64249305182,64249305185,3,2272,1682,-20
64254916090,64254916091,1,1989,1240,-20
64255587378,64255587383,5,1927,1555,-20
64257041770,64257041770,0,1368,1133,-20
64262641166,64262641167,1,1918,1322,-20
64263432280,64263432283,3,1633,1299,-20
64269827822,64269827826,4,1464,1747,-20
64272044438,64272044440,2,1704,1497,-20
64273005202,64273005205,3,1920,1653,-20
64279458783,64279458786,3,2330,1898,-20
64281214226,64281214230,4,1908,1300,-20
64284006528,64284006531,3,2030,2097,-20
64286530176,64286530178,2,1842,1448,-20
64286944372,64286944360,-12,720,552,-20
64288117386,64288117389,3,3569,2557,-20
64288847123,64288847126,3,1461,1601,-20
64290423594,64290423598,4,1757,1201,-20
64292013457,64292013460,3,1642,1019,-20
64295674452,64295674453,1,1306,1472,-20
64297099235,64297099238,3,1325,817,-20
64299282429,64299282433,4,1148,1215,-20
64301381918,64301381923,5,1366,1425,-20
64302830821,64302830823,2,1027,1091,-20
64306274782,64306274786,4,1867,1271,-20
64309441403,64309441406,3,2138,1908,-20
64310208557,64310208555,-2,2485,4551,-20
64311180727,64311180731,4,1849,1114,-20
64312420230,64312420234,4,1117,1433,-20
64312929549,64312929552,3,2160,1687,-20
64313379503,64313379506,3,2579,1560,-20
64315471946,64315471951,5,1921,1896,-20
64315538884,64315538886,2,1869,1101,-20
64316017070,64316017080,10,2012,1661,-20
64318642721,64318642727,6,1608,1029,-20
64318973753,64318973756,3,1730,1857,-20
64319962890,64319962894,4,1464,1319,-20
64321173905,64321173907,2,2327,1953,-20
64321677425,64321677429,4,1837,1828,-20
64322749847,64322749850,3,1983,1410,-20
64323204143,64323204149,6,2457,1386,-20
64323282661,64323282665,4,1670,1625,-20
64327362375,64327362379,4,2137,1038,-20
64333729250,64333729253,3,1705,1405,-20
64334172375,64334172382,7,2421,1435,-20
64335383966,64335383970,4,1927,1370,-20
64335824068,64335824071,3,1775,1263,-20
64338669770,64338669770,0,1625,1753,-20
64339159759,64339159763,4,1471,987,-20
64340469527,64340469529,2,1180,1063,-20
64341629827,64341629830,3,1994,1311,-20
64342207657,64342207659,2,2462,1549,-20
64342420458,64342420458,0,1661,1996,-20
64342912837,64342912839,2,1334,1127,-20
64346989982,64346989987,5,4702,3862,-20
64348371617,64348371618,1,1251,1635,-20
64348920205,64348920198,-7,1869,7125,-20
64358105553,64358105558,5,1112,899,-20
64363982502,64363982506,4,1870,1671,-20
64364153243,64364153245,2,1180,1431,-20
64365705370,64365705374,4,2229,1769,-20
64365793905,64365793908,3,2784,1505,-20
64366062806,64366062809,3,1903,1212,-20
64367927306,64367927307,1,1087,966,-20
64368510180,64368510185,5,1421,1539,-20
64369935461,64369935462,1,2077,1961,-20
64370527227,64370527227,0,1590,1657,-20
64374495676,64374495679,3,1442,915,-20
64376523353,64376523358,5,1970,1078,-20
64378960358,64378960362,4,848,485,-20
64380224226,64380224228,2,1475,847,-20
64381449722,64381449725,3,2514,1425,-20
64383462287,64383462294,7,5173,2072,-20
64384408447,64384408452,5,1374,1261,-20
64384966358,64384966360,2,1667,1427,-20
64386643284,64386643284,0,1676,1992,-20
64387296031,64387296034,3,1538,1528,-20
64388255656,64388255661,5,1442,1429,-20
64394482631,64394482617,-14,28629,15393,-20
64395558042,64395558044,2,1197,1500,-20
64398591383,64398591384,1,2137,1367,-20
64399379476,64399379478,2,1634,1232,-20
64400965254,64400965256,2,1720,1453,-20
64402997173,64402997176,3,1840,1864,-20
64409935510,64409935514,4,1966,1485,-20
64410810789,64410810792,3,1969,1419,-20
64414714201,64414714206,5,2049,1113,-20
64414850489,64414850498,9,1542,846,-20
64419404702,64419404709,7,2069,677,-20
64423584050,64423584055,5,1859,1618,-20
64427193045,64427193050,5,1740,1071,-20
64428343663,64428343683,20,453,80,-20
64429624205,64429624210,5,2718,2080,-20
64432194557,64432194558,1,1781,1497,-20
64433443174,64433443178,4,1833,1557,-20
64433531151,64433531154,3,1855,1522,-20
64434344795,64434344789,-6,1343,5695,-20
64434566001,64434566004,3,2795,1594,-20
64435803377,64435803379,2,1142,1159,-20
64436706134,64436706127,-7,2475,8223,-20
64441921014,64441921017,3,1604,1397,-20
64446329418,64446329420,2,2079,1592,-20
64447492391,64447492396,5,1668,1305,-20
64454229221,64454229223,2,1781,1175,-20
64456468579,64456468583,4,1437,1046,-20
64457382486,64457382474,-12,1286,563,-20
64463243566,64463243569,3,2308,1558,-20
64467036350,64467036354,4,1884,1293,-20
64467948933,64467948938,5,1344,1358,-20
64472531509,64472531514,5,2050,1840,-20
64474782848,64474782852,4,1826,989,-20
64483285653,64483285655,2,14863,14456,-20
64484629274,64484629268,-6,1048,4066,-20
64487760930,64487760935,5,1801,1298,-20
64487828643,64487828647,4,1405,1242,-20
64489231046,64489231049,3,1847,1499,-20
64491018337,64491018341,4,1999,1492,-20
64494723130,64494723134,4,1803,1173,-20
64497478122,64497478125,3,1405,1142,-20
64498587774,64498587760,-14,1302,1250,-20
64501107020,64501107022,2,1804,1692,-20
64502215702,64502215704,2,1765,1515,-20
64506610150,64506610151,1,1453,1111,-20
64508962058,64508962061,3,2336,1879,-20
64511204135,64511204138,3,1749,1414,-20
64514350790,64514350795,5,1388,1171,-20
64519112031,64519112035,4,1951,1136,-20
64519168469,64519168472,3,1607,1253,-20
64520212935,64520212935,0,993,1532,-20
64520853174,64520853176,2,2486,1597,-20
64522368159,64522368162,3,2188,1612,-20
64522460337,64522460339,2,1530,1158,-20
64524231123,64524231127,4,1589,1180,-20
64525308744,64525308746,2,1647,1927,-20
64525574410,64525574414,4,1708,951,-20
64527780380,64527780373,-7,1072,4795,-20
64532756755,64532756758,3,1898,971,-20
64535226411,64535226414,3,1840,1434,-20
64537683102,64537683106,4,1453,1399,-20
64537924580,64537924582,2,1703,1475,-20
64540768721,64540768726,5,2075,1241,-20
64540799642,64540799658,16,1647,1424,-20
64545568946,64545568950,4,3031,2072,-20
64546712930,64546712931,1,1896,1421,-20
64549547096,64549547098,2,1605,1221,-20
64550481621,64550481626,5,2073,1184,-20
64553179511,64553179511,0,1042,871,-20
64555688190,64555688193,3,2138,2031,-20
64559992847,64559992845,-2,1106,2639,-20
64562237042,64562237043,1,1185,1054,-20
64564578897,64564578899,2,1428,1213,-20
64568075859,64568075863,4,2022,1475,-20
64574074265,64574074267,2,1930,1841,-20
64577424218,64577424222,4,1540,1386,-20
64577893245,64577893249,4,2008,1225,-20
64578067909,64578067914,5,1602,1274,-20
64578548200,64578548203,3,1878,1308,-20
64578732206,64578732209,3,1283,1427,-20
64578918257,64578918261,4,2001,1462,-20
64579797546,64579797550,4,1420,1549,-20
64579868832,64579868834,2,2364,1739,-20
64582410705,64582410710,5,841,678,-20
64586709615,64586709599,-16,1265,1228,-20
64588083584,64588083586,2,1419,1038,-20
64588180538,64588180537,-1,1657,2250,-20
64588980861,64588980865,4,2030,1435,-20
64591799877,64591799878,1,1452,1742,-20
64592460950,64592460954,4,1640,1789,-20
64599391214,64599391213,-1,2463,3936,-20
64608205818,64608205822,4,1516,1251,-20
64608506811,64608506814,3,2002,1505,-20
64615349867,64615349869,2,788,1026,-20
64620114108,64620114113,5,1514,1479,-20
64623554572,64623554577,5,1308,1125,-20
64626244745,64626244748,3,2327,1322,-20
64627072837,64627072828,-9,557,400,-20
64629782030,64629782035,5,1914,1793,-20
64629933385,64629933387,2,997,723,-20
64634284426,64634284426,0,2676,4722,-20
64640816900,64640816905,5,1977,1483,-20
64641081171,64641081177,6,3711,1693,-20
64641830141,64641830144,3,1341,1171,-20
64644143378,64644143380,2,1933,1864,-20
64644467649,64644467653,4,2232,1291,-20
64645366691,64645366691,0,1043,1619,-20
64649748065,64649748070,5,2357,1347,-20
64651057273,64651057276,3,1781,1591,-20
64651697439,64651697441,2,1642,1715,-20
64652604318,64652604321,3,1371,1097,-20
64655473260,64655473258,-2,736,1701,-20
64655848351,64655848345,-6,1964,9857,-20
64661448990,64661448993,3,1579,1200,-20
64662869090,64662869094,4,1775,1242,-20
64667698263,64667698267,4,1888,1085,-20
64667864253,64667864275,22,1832,1051,-20
64668906466,64668906466,0,1112,1002,-20
64670194754,64670194757,3,1511,1079,-20
64672880929,64672880934,5,2424,1250,-20
64673315802,64673315805,3,2612,2559,-20
64674854173,64674854175,2,1690,1233,-20
64676167188,64676167186,-2,1835,2554,-20
64677305830,64677305823,-7,1278,3577,-20
64678476382,64678476384,2,1993,1527,-20
64689909758,64689909763,5,1546,1270,-20
64690642431,64690642446,15,11141,46522,-20
64693783917,64693783920,3,2091,1406,-20
64695975041,64695975042,1,12899,13363,-20
64696049682,64696049687,5,2561,1718,-20
64700228511,64700228513,2,1130,1220,-20
64704954537,64704954539,2,1847,1374,-20
64706747318,64706747323,5,2068,1540,-20
64714139030,64714139034,4,1961,1297,-20
64714970735,64714970738,3,1753,1758,-20
64716157259,64716157262,3,1442,1006,-20
64718432091,64718432095,4,849,976,-20
64719704473,64719704473,0,2132,1815,-20
64720092429,64720092443,14,112,1132,-20
64725978115,64725978123,8,20489,53041,-20
64726847601,64726847606,5,2684,1593,-20
64729256475,64729256478,3,2220,1655,-20
64730397914,64730397919,5,1566,1399,-20
64732358360,64732358362,2,1252,1094,-20
64733300829,64733300832,3,2258,1438,-20
64735242620,64735242622,2,1704,1684,-20
64737646483,64737646488,5,1727,1206,-20
64739341677,64739341682,5,2224,1520,-20
64740027103,64740027107,4,1438,945,-20
64740298173,64740298176,3,2309,1209,-20
64740703706,64740703710,4,2121,1337,-20
64743264449,64743264454,5,3577,1775,-20
64746308517,64746308519,2,1346,1256,-20
64747825683,64747825689,6,2633,1305,-20
64749001702,64749001704,2,1684,1126,-20
64753733586,64753733589,3,1703,1222,-20
64756464046,64756464049,3,2619,1819,-20
64756823512,64756823515,3,1084,973,-20
64757783254,64757783259,5,1927,872,-20
64758697702,64758697703,1,1258,1526,-20
64759462548,64759462553,5,2221,1561,-20
64759505355,64759505358,3,2208,1610,-20
64761327700,64761327703,3,2601,1809,-20
64762145941,64762145942,1,2133,1956,-20
64762515911,64762515913,2,672,721,-20
64763364406,64763364409,3,1867,1578,-20
64764321929,64764321934,5,1429,1336,-20
64767456527,64767456527,0,1125,1677,-20
64767587635,64767587639,4,2050,1370,-20
64768674328,64768674331,3,1064,810,-20
64769480722,64769480726,4,1706,1789,-20
64772763511,64772763514,3,1716,1389,-20
64777867108,64777867111,3,1579,1348,-20
64778544415,64778544418,3,1965,1595,-20
64779009051,64779009054,3,1293,1256,-20
64782933050,64782933053,3,3379,3625,-20
64783225397,64783225402,5,1374,1338,-20
64785480491,64785480495,4,1419,799,-20
64786875418,64786875422,4,1392,814,-20
64787266990,64787266994,4,1844,1555,-20
64788962073,64788962077,4,1549,1140,-20
64792271949,64792271954,5,2138,1616,-20
64793680129,64793680134,5,2122,1091,-20
64795288518,64795288519,1,1177,1199,-20
64796287551,64796287556,5,1961,1377,-20
64796904518,64796904523,5,1546,1487,-20
64797008483,64797008467,-16,2824,2161,-20
64797115510,64797115514,4,1803,1051,-20
64801135982,64801135987,5,2119,1841,-20
64801469233,64801469235,2,1989,1897,-20
64803026581,64803026583,2,1398,1056,-20
64803404537,64803404540,3,1932,1343,-20
64806154974,64806154978,4,2180,1693,-20
64809309844,64809309847,3,1241,1328,-20
64812216536,64812216537,1,1861,1494,-20
64812287530,64812287533,3,2137,1858,-20
64815157675,64815157679,4,2699,1520,-20
64815448258,64815448261,3,1212,1737,-20
64817896350,64817896354,4,2255,1129,-20
64818817707,64818817690,-17,1960,1267,-20
64820335287,64820335290,3,1439,1314,-20
64821423982,64821423985,3,1431,1362,-20
64821733520,64821733521,1,1546,1358,-20
64822141615,64822141592,-23,754,767,-20
64823448726,64823448730,4,1494,1455,-20
64823857354,64823857353,-1,727,1131,-20
64825467563,64825467567,4,1328,1265,-20
64825621232,64825621215,-17,778,862,-20
64826742974,64826742974,0,1317,1239,-20
64830176467,64830176472,5,2899,2087,-20
64830841674,64830841674,0,1537,847,-20
64836203382,64836203386,4,1209,1019,-20
64838825623,64838825622,-1,1306,2024,-20
64839658041,64839658043,2,1852,1444,-20
64841744005,64841744010,5,2070,1424,-20
64843568344,64843568347,3,1376,1170,-20
64849510371,64849510374,3,1539,1642,-20
64852341782,64852341786,4,2051,1412,-20
64852607381,64852607399,18,2111,1466,-20
64855436034,64855436035,1,1169,1031,-20
64860043545,64860043547,2,2482,1585,-20
64860156698,64860156702,4,2355,1982,-20
64860491147,64860491151,4,2146,1646,-20
64860732101,64860732105,4,1904,1284,-20
64870499867,64870499871,4,1760,1908,-20
64871927134,64871927135,1,2077,1148,-20
64873452807,64873452810,3,1238,1119,-20
64876653034,64876653038,4,1109,1119,-20
64877492130,64877492133,3,2005,1456,-20
64878930769,64878930772,3,1946,1430,-20
64887417000,64887417003,3,1668,1141,-20
64887695170,64887695170,0,1862,1334,-20
64889778811,64889778814,3,1268,1166,-20
64892298402,64892298406,4,1635,1770,-20
64894655670,64894655673,3,1444,1535,-20
64894832032,64894832035,3,1846,1387,-20
64896527666,64896527670,4,1552,1323,-20
64896567989,64896568010,21,1611,1128,-20
64896840223,64896840243,20,1478,1900,-20
64902968396,64902968399,3,1975,1480,-20
64903858159,64903858162,3,1847,1050,-20
64904092923,64904092927,4,1576,1191,-20
64912195653,64912195651,-2,1258,3376,-20
64914274274,64914274275,1,2425,1890,-20
64915057767,64915057771,4,1759,1216,-20
64915716944,64915716949,5,2008,1076,-20
64916261085,64916261086,1,2004,1447,-20
64916825379,64916825384,5,1922,2016,-20
64917375139,64917375153,14,1409,1150,-20
64919545921,64919545925,4,2374,1634,-20
64921101065,64921101072,7,1808,1568,-20
64921415162,64921415163,1,1424,1122,-20
64929501745,64929501739,-6,2218,7014,-20
64935712968,64935712974,6,1307,916,-20
64936412554,64936412558,4,1099,848,-20
64941671123,64941671127,4,1146,1199,-20
64943573498,64943573502,4,1855,1292,-20
64943603253,64943603236,-17,2215,1458,-20
64944355994,64944355998,4,2037,1389,-20
64945627599,64945627602,3,1577,1098,-20
64946410430,64946410438,8,13502,19568,-20
64949488871,64949488874,3,1534,1564,-20
64951693361,64951693366,5,1792,1050,-20
64951989355,64951989359,4,1422,802,-20
64964337282,64964337286,4,1660,880,-20
64967277226,64967277232,6,2140,1387,-20
64967355722,64967355739,17,1859,1584,-20
64967807124,64967807126,2,1709,1484,-20
64969873428,64969873431,3,1740,1179,-20
64971041874,64971041879,5,1419,1173,-20
64973045130,64973045133,3,2327,1996,-20
64975413588,64975413593,5,3035,1281,-20
64977636051,64977636055,4,2600,1606,-20
64979030771,64979030774,3,1662,1401,-20
64980352474,64980352477,3,1090,1038,-20
64980684457,64980684458,1,15464,14635,-20
64981092742,64981092746,4,1240,1854,-20
64981313822,64981313826,4,1346,1157,-20
64983853989,64983853994,5,1822,1088,-20
64987100242,64987100245,3,2238,1829,-20
64996063741,64996063743,2,2535,1318,-20
64998726990,64998726994,4,2515,1798,-20
65003211769,65003211773,4,2496,1877,-20
65005200430,65005200435,5,2100,1054,-20
65007943050,65007943050,0,1086,2900,-20
65010681915,65010681922,7,1685,1475,-20
65010894038,65010894041,3,2118,1541,-20
65011964158,65011964165,7,965,1208,-20
65014760853,65014760850,-3,1266,2068,-20
65019482700,65019482702,2,2410,1633,-20
65019811066,65019811070,4,1657,1464,-20
65019973858,65019973838,-20,1615,1742,-20
65026131998,65026132002,4,1303,1767,-20
65027716950,65027716955,5,1396,1056,-20
65031615372,65031615368,-4,1611,4752,-20
65034023155,65034023160,5,2327,2029,-20
65034177905,65034177907,2,2151,1049,-20
65035394307,65035394311,4,1386,1140,-20
65038133093,65038133097,4,1679,1164,-20
65038625498,65038625502,4,1876,1190,-20
65039291117,65039291110,-7,1306,3995,-20
65044530241,65044530242,1,1469,1491,-20
65044698847,65044698851,4,2030,2304,-20
65050837204,65050837207,3,2334,1334,-20
65052109785,65052109790,5,1675,1033,-20
65053199421,65053199425,4,2840,1261,-20
65054437159,65054437142,-17,1645,1398,-20
65054751990,65054751994,4,2241,1497,-20
65061412642,65061412642,0,1453,1943,-20
65062011329,65062011331,2,2182,1156,-20
65063216635,65063216641,6,2468,1685,-20
65065285272,65065285276,4,1967,1351,-20
65066048344,65066048356,12,1533,1739,-20
65069993277,65069993282,5,1699,832,-20
65070720031,65070720033,2,1143,934,-20
65072603258,65072603260,2,1685,1697,-20
65077393746,65077393750,4,1832,1224,-20
65077437406,65077437406,0,1773,2257,-20
65077530479,65077530485,6,1998,1322,-20
65078041382,65078041386,4,2234,1898,-20
65078284676,65078284682,6,2005,1456,-20
65080391518,65080391519,1,1832,1461,-20
65080535905,65080535906,1,2111,1554,-20
65082215073,65082215075,2,1585,1757,-20
65083239094,65083239098,4,1357,1544,-20
65084385319,65084385323,4,1551,1771,-20
65084436337,65084436341,4,1703,1840,-20
65085159858,65085159864,6,2456,1224,-20
65085431514,65085431520,6,1889,929,-20
65086824249,65086824252,3,2218,1552,-20
65087256143,65087256147,4,1574,1110,-20
65088620780,65088620786,6,4520,1346,-20
65089347070,65089347052,-18,451,378,-20
65089988739,65089988743,4,1142,786,-20
65091274071,65091274073,2,1993,1388,-20
65091550718,65091550724,6,1654,1273,-20
65092193389,65092193391,2,1086,998,-20
65092319255,65092319253,-2,1307,2409,-20
65095456430,65095456431,1,1892,1226,-20
65096443482,65096443483,1,1661,1127,-20
65098014746,65098014751,5,1767,891,-20
65108312539,65108312543,4,2124,1101,-20
65111088069,65111088074,5,1857,1024,-20
65111691906,65111691911,5,2365,1572,-20
65121822570,65121822574,4,2156,1572,-20
65127912380,65127912383,3,1505,1616,-20
65129362351,65129362342,-9,940,2669,-20
65129519258,65129519261,3,1411,1293,-20
65130423886,65130423891,5,1341,1131,-20
65131292519,65131292522,3,1443,1434,-20
65132421602,65132421606,4,2243,1297,-20
65133908707,65133908710,3,2516,1942,-20
65134834987,65134834987,0,964,989,-20
65138470328,65138470332,4,1985,1036,-20
65139224576,65139224577,1,1953,1285,-20
65143589917,65143589922,5,1942,1593,-20
65144248889,65144248896,7,1342,956,-20
65147432526,65147432530,4,2138,1638,-20
65149397888,65149397894,6,1629,1146,-20
65157577435,65157577439,4,1875,1193,-20
65158112296,65158112298,2,1247,978,-20
65161704574,65161704578,4,1512,1224,-20
65166330809,65166330814,5,2333,2016,-20
65167339169,65167339171,2,1683,1754,-20
65174915002,65174915005,3,1644,1721,-20
65177363647,65177363649,2,1363,1694,-20
65180778310,65180778313,3,1829,1483,-20
65182282189,65182282194,5,1876,1062,-20
65183799473,65183799476,3,2629,1997,-20
65183963593,65183963596,3,1905,1726,-20
65184502548,65184502552,4,2584,1765,-20
65186336787,65186336790,3,1905,1458,-20
65186905758,65186905765,7,14400,18560,-20
65187503699,65187503702,3,1276,929,-20
65189531326,65189531332,6,1719,1116,-20
65190925840,65190925842,2,1753,1221,-20
65191723218,65191723222,4,1668,1225,-20
65191802102,65191802105,3,1462,1375,-20
65192386497,65192386501,4,1897,1696,-20
65193650358,65193650362,4,1818,1304,-20
65194260372,65194260375,3,1360,1188,-20
65197478689,65197478692,3,1661,1663,-20
65198720774,65198720779,5,1345,1180,-20
65201374573,65201374575,2,1413,1241,-20
65204641906,65204641909,3,1844,1430,-20
65205597863,65205597865,2,1291,1653,-20
65206166806,65206166785,-21,1282,958,-20
65210984554,65210984559,5,2764,1661,-20
65211547769,65211547773,4,1834,1349,-20
65213898237,65213898242,5,2259,1189,-20
65218846346,65218846350,4,1437,1309,-20
65222771686,65222771688,2,1763,2012,-20
65227714977,65227714979,2,1950,1596,-20
65227876757,65227876759,2,1496,1429,-20
65228512360,65228512361,1,1345,1480,-20
65235689447,65235689450,3,1007,1256,-20
65235934598,65235934593,-5,1331,5292,-20
65240753817,65240753821,4,1532,1642,-20
65242159304,65242159310,6,2150,1540,-20
65243364256,65243364258,2,2657,1763,-20
65246386999,65246387003,4,1222,764,-20
65249403672,65249403652,-20,2591,1841,-20
65251630454,65251630458,4,1914,1623,-20
65251901711,65251901713,2,1933,1155,-20
65255815325,65255815330,5,2926,1158,-20
65258235475,65258235479,4,2184,1586,-20
65263076068,65263076069,1,469,1513,-20
65264012873,65264012874,1,1320,1160,-20
65264386046,65264386049,3,2390,1623,-20
65266270243,65266270247,4,1664,727,-20
65266860434,65266860430,-4,2210,8449,-20
65267143158,65267143179,21,1788,1202,-20
65270769303,65270769303,0,1582,1557,-20
65272190858,65272190865,7,12776,4325,-20
65276321213,65276321218,5,2163,1274,-20
65277553909,65277553930,21,1961,1271,-20
65277949670,65277949674,4,1816,1710,-20
65278750634,65278750638,4,1421,1374,-20
65288201726,65288201732,6,1894,1292,-20
65293024298,65293024301,3,2121,1627,-20
65293849831,65293849834,3,2219,1529,-20
65293939633,65293939638,5,1886,1534,-20
65297240405,65297240409,4,1541,1012,-20
65297717827,65297717831,4,1587,1649,-20
65298520793,65298520795,2,2147,1765,-20
65305138617,65305138620,3,2132,1807,-20
65306776994,65306776997,3,1822,1503,-20
65311028802,65311028797,-5,1189,3428,-20
65311743605,65311743609,4,1729,1281,-20
65312643971,65312643974,3,2388,2029,-20
65312716903,65312716907,4,1827,1431,-20
65314707305,65314707309,4,1572,1554,-20
65315015664,65315015666,2,1822,1722,-20
65315567577,65315567578,1,1635,1203,-20
65315627218,65315627225,7,1217,1525,-20
65319506601,65319506602,1,1562,1191,-20
65320816606,65320816610,4,2510,1210,-20
65323055431,65323055435,4,3090,2228,-20
65324960667,65324960673,6,1422,1054,-20
65325993419,65325993422,3,1569,1362,-20
65327872615,65327872619,4,2397,1680,-20
65330612864,65330612866,2,1147,1002,-20
65331924368,65331924372,4,1682,1258,-20
65336160723,65336160726,3,1984,1945,-20
65336232293,65336232297,4,2261,1466,-20
65341258540,65341258543,3,1331,1474,-20
65341431423,65341431427,4,2891,2872,-20
65342389774,65342389777,3,1524,1198,-20
65344714770,65344714773,3,1557,1074,-20
65345714365,65345714369,4,1470,855,-20
65346467021,65346467023,2,1385,1100,-20
65346749586,65346749590,4,2355,1592,-20
65348375771,65348375774,3,1429,1605,-20
65355951205,65355951209,4,2327,1668,-20
65361011929,65361011934,5,1582,1191,-20
65364969997,65364970000,3,1735,992,-20
65365409994,65365409994,0,952,146,-20
65366448973,65366448975,2,1668,1090,-20
65369817794,65369817799,5,2154,1092,-20
65373312951,65373312953,2,1560,2026,-20
65374125542,65374125523,-19,1384,1715,-20
65378087561,65378087564,3,1189,1411,-20
65378207491,65378207478,-13,844,610,-20
65379842413,65379842415,2,1884,1802,-20
65381549506,65381549511,5,2224,968,-20
65385114059,65385114061,2,1555,1412,-20
65389737726,65389737734,8,2389,530,-20
65391696815,65391696818,3,2090,1637,-20
65392625153,65392625157,4,1730,1558,-20
65393288665,65393288668,3,2090,1305,-20
65394087569,65394087584,15,1319,1174,-20
65395087692,65395087697,5,2020,1316,-20
65395941193,65395941197,4,1812,1665,-20
65396423825,65396423828,3,2055,1747,-20
65396955193,65396955194,1,1306,1388,-20
65402314780,65402314782,2,1710,1226,-20
65404926196,65404926200,4,2530,1612,-20
65405178747,65405178752,5,894,145,-20
65406478396,65406478396,0,1453,2038,-20
65413203454,65413203457,3,1569,1241,-20
65413876774,65413876778,4,2470,1674,-20
65414429277,65414429278,1,1972,1385,-20
65414845674,65414845676,2,1749,1693,-20
65417047230,65417047230,0,1145,1377,-20
65417537976,65417537976,0,1351,1580,-20
65417658737,65417658722,-15,1551,801,-20
65419247341,65419247345,4,1846,1315,-20
65419840417,65419840434,17,2014,1681,-20
65420200370,65420200374,4,1934,1269,-20
65425022029,65425022033,4,1616,1354,-20
65426130530,65426130535,5,1638,1175,-20
65426305717,65426305719,2,1137,1316,-20
65428398134,65428398138,4,2023,1420,-20
65429151700,65429151702,2,1308,1093,-20
65430989837,65430989839,2,1168,955,-20
65432170695,65432170698,3,2031,1479,-20
65435473466,65435473469,3,1035,1381,-20
65435946437,65435946440,3,2524,1571,-20
65437207567,65437207572,5,1475,1404,-20
65437747038,65437747041,3,1829,1530,-20
65438366710,65438366710,0,1026,720,-20
65440125268,65440125271,3,2061,1217,-20
65441121246,65441121250,4,1480,1378,-20
65442239666,65442239670,4,1765,1658,-20
65443043827,65443043830,3,1569,1773,-20
65446258675,65446258679,4,1721,1066,-20
65448160308,65448160314,6,1514,990,-20
65450788399,65450788402,3,1511,984,-20
65453645491,65453645494,3,1776,1087,-20
65456671129,65456671123,-6,1690,4978,-20
65460875946,65460875950,4,1761,1429,-20
65462302236,65462302240,4,2113,1526,-20
65463191184,65463191178,-6,1392,752,-20
65463418310,65463418313,3,2210,1681,-20
65469766093,65469766095,2,1057,807,-20
65470101578,65470101588,10,4291,3467,-20
65471033993,65471034004,11,9825,44318,-20
65474814330,65474814333,3,2551,1659,-20
65474937413,65474937415,2,1819,1728,-20
65476993394,65476993398,4,1905,1429,-20
65478890546,65478890555,9,15130,26914,-20
65479510410,65479510417,7,2732,1171,-20
65483010196,65483010190,-6,1297,5012,-20
65485719253,65485719258,5,2115,1289,-20
65492789310,65492789314,4,1981,1331,-20
65500958752,65500958756,4,1902,1127,-20
65501696647,65501696650,3,1366,763,-20
65501895525,65501895526,1,1862,2328,-20
65502506494,65502506498,4,2908,1365,-20
65503346565,65503346567,2,1469,1072,-20
65510961041,65510961041,0,904,1661,-20
65513487565,65513487567,2,2133,1531,-20
65518091806,65518091807,1,2683,2182,-20
65518711170,65518711173,3,1985,2464,-20
65521959963,65521959965,2,1980,1188,-20
65522944547,65522944551,4,1531,1191,-20
65524959491,65524959496,5,1753,1320,-20
65526309793,65526309795,2,1723,1492,-20
65527979902,65527979907,5,1904,1488,-20
65531196422,65531196425,3,1718,993,-20
65537574021,65537574023,2,1406,1018,-20
65540386254,65540386255,1,1486,1535,-20
65541628111,65541628114,3,1773,1180,-20
65544731215,65544731219,4,1007,901,-20
65545455704,65545455709,5,1746,1411,-20
65547729193,65547729194,1,1392,1345,-20
65548886349,65548886356,7,3484,1383,-20
65549850101,65549850082,-19,2222,1347,-20
65552067740,65552067744,4,1662,1404,-20
65553975730,65553975735,5,1972,1476,-20
65555192838,65555192841,3,2104,1577,-20
65555453094,65555453098,4,1525,1442,-20
65555537418,65555537422,4,1887,1748,-20
65556809490,65556809495,5,1885,1710,-20
65557316506,65557316509,3,1689,1837,-20
65559096611,65559096614,3,1258,1408,-20
65560176847,65560176851,4,1927,1807,-20
65561752770,65561752752,-18,2462,1971,-20
65566111678,65566111683,5,3731,2374,-20
65567904518,65567904519,1,1958,2044,-20
65571928560,65571928561,1,1167,1212,-20
65572032170,65572032177,7,3387,1115,-20
65578004978,65578004982,4,1119,955,-20
65582255858,65582255863,5,2337,1502,-20
65589612900,65589612895,-5,51,399,-20
65590657489,65590657487,-2,1113,1966,-20
65595515515,65595515519,4,1419,1295,-20
65598655258,65598655262,4,1897,1380,-20
65599307564,65599307566,2,1558,1867,-20
65600937413,65600937414,1,1360,1465,-20
65601547117,65601547120,3,1812,1171,-20
65603765980,65603765983,3,1712,1242,-20
65606226458,65606226462,4,11170,6923,-20
65609236350,65609236371,21,1954,1454,-20
65609383915,65609383899,-16,2095,1508,-20
65611698791,65611698795,4,2127,1564,-20
65612777490,65612777490,0,1578,1494,-20
65613211738,65613211741,3,1980,1386,-20
65614138294,65614138301,7,2095,1259,-20
65616195713,65616195715,2,1401,954,-20
65617756819,65617756823,4,2002,1382,-20
65620231830,65620231835,5,2208,1290,-20
65620964697,65620964698,1,2489,2464,-20
65624687749,65624687752,3,1682,1402,-20
65626469632,65626469636,4,2548,1978,-20
65627655400,65627655402,2,1881,1438,-20
65627763621,65627763625,4,1821,1646,-20
65630006814,65630006819,5,2442,1717,-20
65631352767,65631352771,4,1493,1577,-20
65632353914,65632353911,-3,1115,2119,-20
65637450147,65637450151,4,1836,1302,-20
65639613661,65639613663,2,2359,1517,-20
65644869039,65644869043,4,1942,1582,-20
65645339788,65645339793,5,1417,1539,-20
65645963169,65645963191,22,937,1082,-20
65647235046,65647235050,4,3548,1366,-20
65651452258,65651452262,4,1860,1658,-20
65651697697,65651697700,3,2017,1624,-20
65652769274,65652769277,3,1726,1365,-20
65653684186,65653684189,3,1382,1180,-20
65654216950,65654216953,3,3746,3470,-20
65657472061,65657472065,4,1869,1306,-20
65658253679,65658253682,3,1579,1132,-20
65659105698,65659105699,1,1573,1197,-20
65659952973,65659952976,3,1824,1421,-20
65660998938,65660998938,0,1277,1833,-20
65662244555,65662244559,4,2648,1302,-20
65665060677,65665060677,0,1626,2184,-20
65665439118,65665439127,9,3464,1170,-20
65667184507,65667184511,4,1780,1255,-20
65668104087,65668104090,3,1421,1440,-20
65668215433,65668215434,1,1222,1144,-20
65669306391,65669306393,2,2002,2213,-20
65672640970,65672640974,4,1575,1532,-20
65673938382,65673938387,5,1871,957,-20
65674957163,65674957166,3,1737,1825,-20
65685376742,65685376745,3,2103,1137,-20
65688837326,65688837330,4,2433,1650,-20
65689847005,65689847007,2,2014,1288,-20
65690700258,65690700261,3,1519,1359,-20
65691350622,65691350626,4,2057,1244,-20
65693070187,65693070190,3,2274,1443,-20
65693186001,65693185993,-8,2916,8788,-20
65694137343,65694137347,4,1534,1579,-20
65696755476,65696755480,4,1680,1370,-20
65701863352,65701863355,3,1919,1456,-20
65702385134,65702385135,1,1526,1537,-20
65708121983,65708121986,3,3079,1751,-20
65708641390,65708641393,3,1857,1191,-20
65709388688,65709388676,-12,30631,1454,-20
65710400689,65710400693,4,1470,1556,-20
65710808050,65710808056,6,2232,1465,-20
65710842421,65710842400,-21,2253,1682,-20
65712885920,65712885922,2,2043,1032,-20
65713126254,65713126233,-21,402,277,-20
65714585139,65714585141,2,1545,1193,-20
65714949081,65714949084,3,2083,1586,-20
65720630506,65720630509,3,1800,1724,-20
65721799359,65721799361,2,1865,1227,-20
65729378638,65729378642,4,1888,894,-20
65729914697,65729914701,4,1818,1557,-20
65733693964,65733693969,5,1551,1258,-20
65736106985,65736106989,4,2057,1695,-20
65739642262,65739642267,5,1441,1170,-20
65740444271,65740444275,4,1458,1150,-20
65742836342,65742836345,3,2331,1437,-20
65745304539,65745304542,3,1863,1317,-20
65746326115,65746326117,2,2520,1611,-20
65747249386,65747249388,2,1610,1261,-20
65749070492,65749070499,7,2421,1318,-20
65749413491,65749413494,3,1618,957,-20
65751668398,65751668401,3,2356,1827,-20
65753879087,65753879090,3,1885,1290,-20
65754318047,65754318026,-21,1449,917,-20
65755984201,65755984203,2,1886,1439,-20
65762910233,65762910238,5,1776,1336,-20
65763110358,65763110359,1,1543,1395,-20
65765268805,65765268810,5,1397,711,-20
65766439190,65766439195,5,1381,486,-20
65767834264,65767834267,3,1691,1319,-20
65772889882,65772889887,5,1522,1175,-20
65774961042,65774961046,4,1836,1307,-20
65781193159,65781193137,-22,697,835,-20
65781821153,65781821157,4,1912,1022,-20
65793714979,65793714983,4,1695,1768,-20
65794557838,65794557842,4,1797,1302,-20
65795361021,65795361025,4,1748,1174,-20
65798186366,65798186370,4,2029,1468,-20
65800369847,65800369842,-5,1258,2684,-20
65801880159,65801880162,3,1381,929,-20
65802893107,65802893110,3,900,1222,-20
65804351886,65804351889,3,1932,1627,-20
65805014631,65805014634,3,1809,1465,-20
65810325546,65810325545,-1,3568,4319,-20
65822755945,65822755949,4,1560,1336,-20
65824392158,65824392162,4,2214,1251,-20
65825606045,65825606051,6,2065,885,-20
65828255187,65828255190,3,2195,1522,-20
65828916895,65828916899,4,1419,1271,-20
65829906673,65829906677,4,1586,1223,-20
65837345458,65837345459,1,804,1388,-20
65840119885,65840119889,4,1736,1436,-20
65841186862,65841186865,3,1912,1598,-20
65842697920,65842697923,3,1783,1564,-20
65847284977,65847284981,4,2323,1510,-20
65848295586,65848295591,5,2023,1509,-20
65849106266,65849106270,4,1145,1114,-20
65853738029,65853738033,4,1818,1190,-20
65854667879,65854667886,7,12840,19418,-20
65855360518,65855360521,3,2028,1649,-20
65855554982,65855554987,5,1980,1550,-20
65860116269,65860116271,2,2212,1704,-20
65862814057,65862814060,3,1887,1463,-20
65864040173,65864040176,3,2051,1361,-20
65865271261,65865271263,2,1313,1166,-20
65866889553,65866889558,5,2470,2036,-20
65867821493,65867821495,2,1247,934,-20
65869717807,65869717810,3,1398,754,-20
65873313881,65873313885,4,2751,1736,-20
65876657230,65876657235,5,2000,1120,-20
65878713682,65878713687,5,1686,1580,-20
65878914805,65878914811,6,3544,1587,-20
65880398229,65880398235,6,3246,1278,-20
65882570499,65882570501,2,1846,845,-20
65883198649,65883198650,1,2264,2132,-20
65883705729,65883705734,5,2012,1281,-20
65888353271,65888353274,3,1426,1386,-20
65896853642,65896853647,5,1003,671,-20
65898935744,65898935746,2,1578,1918,-20
65900300200,65900300203,3,1471,1623,-20
65901721292,65901721298,6,2087,849,-20
65903542333,65903542336,3,1699,1456,-20
65906684305,65906684307,2,1414,1530,-20
65908372463,65908372467,4,2619,1391,-20
65908934227,65908934226,-1,2546,3308,-20
65909342098,65909342099,1,1576,1251,-20
65913887428,65913887432,4,2428,1722,-20
65916439410,65916439413,3,2316,2028,-20
65918511463,65918511465,2,2300,1447,-20
65918537041,65918537044,3,2426,2229,-20
65919423337,65919423343,6,1834,1271,-20
65921992462,65921992466,4,1807,1338,-20
65923604339,65923604346,7,1299,1119,-20
65925075286,65925075291,5,997,914,-20
65926368014,65926368018,4,1475,1441,-20
65930629647,65930629650,3,1595,1452,-20
65931407817,65931407804,-13,945,260,-20
65931647660,65931647662,2,1547,1369,-20
65933543555,65933543565,10,19293,55131,-20
65935285662,65935285663,1,1757,1166,-20
65935894368,65935894370,2,1878,1578,-20
65942765245,65942765246,1,1650,1199,-20
65944989781,65944989785,4,2165,1199,-20
65947827459,65947827462,3,1562,1601,-20
65947968092,65947968093,1,1901,2052,-20
65949985623,65949985626,3,1933,1658,-20
65950092432,65950092434,2,1852,1904,-20
65950437956,65950437958,2,1671,1269,-20
65956203853,65956203855,2,1623,1517,-20
65957142953,65957142955,2,1201,1920,-20
65959104785,65959104782,-3,2374,6234,-20
65962962823,65962962831,8,1886,1667,-20
65963408457,65963408459,2,1067,1225,-20
65964834033,65964834038,5,2835,1382,-20
65968598706,65968598710,4,1720,1404,-20
65970918050,65970918053,3,1228,956,-20
65971610152,65971610154,2,1492,1093,-20
65975132721,65975132724,3,1617,1189,-20
65980408275,65980408281,6,2363,1086,-20
65985489810,65985489816,6,1919,1129,-20
65986404670,65986404674,4,1761,1427,-20
65989746994,65989746998,4,1612,1564,-20
65990775513,65990775514,1,1573,1099,-20
65995922551,65995922556,5,2690,1696,-20
65997728499,65997728479,-20,39562,27645,-20
65998547279,65998547283,4,1266,1472,-20
66009195107,66009195110,3,1620,1201,-20
66017014583,66017014590,7,9055,2509,-20
66018045315,66018045319,4,1932,1029,-20
66029894926,66029894929,3,1290,997,-20
66033020662,66033020666,4,2355,1254,-20
66033293231,66033293225,-6,26558,14414,-20
66033643484,66033643488,4,2261,1592,-20
66035137761,66035137764,3,1879,1862,-20
66036664146,66036664149,3,2239,1974,-20
66036968249,66036968253,4,2219,1316,-20
66037732153,66037732157,4,1670,1623,-20
66038296049,66038296053,4,1948,1192,-20
66038660266,66038660279,13,9752,47535,-20
66040329578,66040329581,3,1904,1890,-20
66040501214,66040501212,-2,33357,60226,-20
66041140814,66041140818,4,1334,1284,-20
66042001841,66042001845,4,1211,1327,-20
66042332225,66042332229,4,1595,1096,-20
66045029909,66045029912,3,2169,1704,-20
66045365655,66045365660,5,2504,1527,-20
66047629666,66047629667,1,1653,1373,-20
66053020490,66053020494,4,1905,1519,-20
66054678259,66054678261,2,1435,1369,-20
66055786389,66055786392,3,1845,1249,-20
66055934822,66055934825,3,1728,1305,-20
66056750398,66056750403,5,2034,1441,-20
66057900338,66057900338,0,1986,1445,-20
66059817861,66059817862,1,1497,1068,-20
66061245758,66061245761,3,623,992,-20
66061809174,66061809175,1,628,986,-20
66062533328,66062533334,6,1525,1390,-20
66062857461,66062857466,5,2462,1592,-20
66067178538,66067178541,3,1471,1508,-20
66072765518,66072765521,3,1480,1018,-20
66075229835,66075229840,5,2790,2075,-20
66076700659,66076700663,4,1344,1338,-20
66083412034,66083412039,5,4288,3154,-20
66089817729,66089817731,2,2323,1792,-20
66093429478,66093429478,0,816,1602,-20
66094050175,66094050178,3,2307,2185,-20
66095856569,66095856571,2,1763,823,-20
66096867725,66096867726,1,1499,1768,-20
66099569747,66099569752,5,1229,1200,-20
66100684762,66100684767,5,2355,1521,-20
66101819047,66101819033,-14,1455,1123,-20
66103597617,66103597621,4,2390,2078,-20
66105244073,66105244075,2,1864,1377,-20
66105881861,66105881854,-7,1159,4054,-20
66110230810,66110230813,3,1832,1262,-20
66110286931,66110286945,14,2260,1738,-20
66110655217,66110655221,4,1472,1802,-20
66110850013,66110850024,11,1458,1078,-20
66111886767,66111886770,3,2311,1605,-20
66115143029,66115143033,4,1430,1262,-20
66116238397,66116238401,4,2528,1612,-20
66120709089,66120709093,4,1324,2122,-20
66122755302,66122755306,4,2063,1395,-20
66123204618,66123204620,2,1674,1512,-20
66125235757,66125235759,2,1628,927,-20
66128489022,66128489025,3,1663,1484,-20
66130206262,66130206266,4,1722,1408,-20
66131710498,66131710502,4,1592,1571,-20
66132987188,66132987191,3,1087,1355,-20
66134787547,66134787551,4,1769,2031,-20
66135683657,66135683662,5,1979,1190,-20
66139849071,66139849077,6,1969,1634,-20
66139924745,66139924748,3,729,410,-20
66140760014,66140760017,3,1197,1150,-20
66142075675,66142075676,1,1318,1579,-20
66144211611,66144211614,3,1631,1387,-20
66147715365,66147715368,3,1447,1359,-20
66150096939,66150096934,-5,1403,2299,-20
66152250320,66152250323,3,1624,1535,-20
66152990454,66152990458,4,1155,1715,-20
66153689703,66153689705,2,1277,1322,-20
66156335727,66156335728,1,1665,1655,-20
66160122542,66160122537,-5,1921,5673,-20
66164859721,66164859723,2,2232,1365,-20
66165571822,66165571827,5,1453,1361,-20
66167448274,66167448278,4,2150,866,-20
66170016773,66170016767,-6,1138,3618,-20
66170599430,66170599435,5,2172,1319,-20
66171893862,66171893866,4,2256,1495,-20
66172528665,66172528668,3,2172,1610,-20
66172867351,66172867353,2,1423,1753,-20
66173496973,66173496974,1,1700,1234,-20
66174596457,66174596448,-9,1205,1809,-20
66179430062,66179430065,3,2423,1305,-20
66180640969,66180640950,-19,944,796,-20
66181170303,66181170306,3,1174,1091,-20
66181259940,66181259941,1,1648,1702,-20
66184239074,66184239075,1,1396,1417,-20
66185726269,66185726270,1,1670,2072,-20
66186138597,66186138599,2,1352,991,-20
66187182508,66187182512,4,1997,1594,-20
66190857738,66190857742,4,1734,1351,-20
66192759539,66192759542,3,1384,1395,-20
66194140131,66194140135,4,1861,1340,-20
66195488088,66195488091,3,1291,1403,-20
66197669384,66197669387,3,1932,1136,-20
66200046818,66200046823,5,2290,920,-20
66202470194,66202470196,2,1366,1385,-20
66202722785,66202722788,3,2398,1701,-20
66202801512,66202801515,3,2122,1436,-20
66203695234,66203695239,5,1677,1301,-20
66205580102,66205580106,4,1192,996,-20
66208566370,66208566371,1,1435,1170,-20
66209780304,66209780306,2,2254,1707,-20
66212712738,66212712741,3,1252,1166,-20
66215515947,66215515950,3,2437,1340,-20
66219446757,66219446759,2,2034,1410,-20
66220803038,66220803040,2,1545,1459,-20
66221112994,66221113002,8,1035,1607,-20
66221961202,66221961195,-7,583,3850,-20
66223294476,66223294480,4,1551,1685,-20
66228202529,66228202534,5,1411,1380,-20
66229625940,66229625945,5,1823,1247,-20
66233923688,66233923691,3,1880,1672,-20
66236642559,66236642562,3,1919,1605,-20
66238523597,66238523600,3,2514,1634,-20
66240544564,66240544566,2,1660,1776,-20
66242213478,66242213483,5,1405,1094,-20
66242244962,66242244966,4,1899,1561,-20
66242527686,66242527695,9,12675,32968,-20
66244463028,66244463031,3,1249,1082,-20
66251169163,66251169166,3,1045,585,-20
66253000709,66253000711,2,1381,1150,-20
66254988396,66254988401,5,2046,1510,-20
66255580551,66255580555,4,2451,1648,-20
66256338409,66256338411,2,2325,1600,-20
66258346953,66258346956,3,1865,1485,-20
66258389354,66258389359,5,1489,1335,-20
66265086819,66265086825,6,1964,1314,-20
66266803734,66266803714,-20,863,544,-20
66268272916,66268272921,5,2010,1073,-20
66270661975,66270661976,1,2184,1664,-20
66275826129,66275826145,16,1302,892,-20
66277022502,66277022505,3,1702,1275,-20
66280169584,66280169586,2,1526,1570,-20
66284339328,66284339331,3,2214,1025,-20
66287025508,66287025514,6,2951,1591,-20
66287087010,66287087010,0,1159,958,-20
66288132755,66288132758,3,2280,1718,-20
66288470047,66288470045,-2,1164,2112,-20
66292905562,66292905567,5,2476,1440,-20
66295396379,66295396383,4,2372,1593,-20
66297096237,66297096243,6,2391,1369,-20
66297954359,66297954363,4,1507,1309,-20
66299212297,66299212301,4,1995,1292,-20
66304638419,66304638419,0,1612,1700,-20
66307130147,66307130147,0,1226,2143,-20
66307467743,66307467741,-2,1280,1910,-20
66307890398,66307890403,5,1221,1550,-20
66309466542,66309466538,-4,1012,2473,-20
66309854793,66309854796,3,2078,1545,-20
66310192802,66310192786,-16,1432,750,-20
66310875100,66310875102,2,16925,8677,-20
66312031853,66312031857,4,1829,1870,-20
66312060538,66312060547,9,12839,36244,-20
66312256818,66312256822,4,1856,1362,-20
66316068044,66316068049,5,1226,864,-20
66318742390,66318742395,5,1895,1678,-20
66319402978,66319402979,1,1524,1546,-20
66319850662,66319850665,3,1424,792,-20
66320746946,66320746950,4,1758,1138,-20
66323131834,66323131839,5,1458,1087,-20
66324369915,66324369909,-6,731,3215,-20
66326681634,66326681638,4,1988,1730,-20
66329064384,66329064389,5,2555,1240,-20
66330348109,66330348111,2,1712,2045,-20
66331022545,66331022547,2,2543,2128,-20
66333750561,66333750563,2,1987,1446,-20
66334047321,66334047324,3,1406,1695,-20
66334673047,66334673051,4,2287,1629,-20
66336536570,66336536570,0,1623,996,-20
66336716420,66336716403,-17,2404,1612,-20
66338565626,66338565625,-1,2559,3689,-20
66341362161,66341362165,4,2088,1119,-20
66341861212,66341861194,-18,2523,1637,-20
66343518572,66343518575,3,1544,987,-20
66345203780,66345203782,2,1243,1359,-20
66345630756,66345630756,0,1654,1757,-20
66346229918,66346229922,4,1872,1181,-20
66346482373,66346482378,5,1567,1611,-20
66348823413,66348823416,3,1760,1472,-20
66349556384,66349556399,15,274,2772,-20
66351575777,66351575765,-12,1985,1920,-20
66352395697,66352395701,4,1002,1284,-20
66354736183,66354736186,3,2367,1528,-20
66359555107,66359555110,3,2067,1306,-20
66360265873,66360265875,2,1659,1195,-20
66364712623,66364712625,2,1888,1494,-20
66365491809,66365491829,20,2003,1516,-20
66365568541,66365568555,14,587,61,-20
66366120785,66366120790,5,1600,1636,-20
66366445832,66366445837,5,2389,2270,-20
66368530970,66368530974,4,2841,1410,-20
66368948276,66368948278,2,1575,1361,-20
66371738157,66371738158,1,1997,1887,-20
66372201863,66372201867,4,2090,1734,-20
66372249546,66372249550,4,1303,1085,-20
66372672319,66372672318,-1,1756,2316,-20
66373514486,66373514490,4,2003,1782,-20
66374451114,66374451119,5,1478,1163,-20
66378229299,66378229306,7,2342,1208,-20
66378537500,66378537503,3,551,464,-20
66380461080,66380461083,3,1288,881,-20
66385111991,66385111995,4,2389,1291,-20
66386138095,66386138097,2,2248,1669,-20
66386843147,66386843154,7,1800,1119,-20
66389775981,66389775985,4,2727,986,-20
66390375901,66390375905,4,1852,1481,-20
66391219814,66391219817,3,1405,1561,-20
66391916733,66391916755,22,1664,1232,-20
66394095708,66394095710,2,1270,1605,-20
66395496262,66395496265,3,1375,1714,-20
66400566058,66400566061,3,2163,1817,-20
66401449712,66401449715,3,1996,1667,-20
66401934762,66401934766,4,1785,1372,-20
66403286769,66403286773,4,2248,1239,-20
66403632903,66403632905,2,1179,1046,-20
66404309209,66404309211,2,2612,1295,-20
66405265207,66405265202,-5,1634,5075,-20
66408211066,66408211067,1,2161,2122,-20
66408367477,66408367481,4,1992,1380,-20
66408403735,66408403740,5,1528,1220,-20
66409685356,66409685338,-18,2212,897,-20
66410056428,66410056432,4,31405,34478,-20
66410404480,66410404483,3,2102,1529,-20
66410986023,66410986026,3,1277,1245,-20
66412168594,66412168599,5,1953,1144,-20
66412856231,66412856234,3,2281,1398,-20
66415727376,66415727378,2,2222,1860,-20
66417066843,66417066846,3,1371,1212,-20
66418065750,66418065753,3,2176,1733,-20
66419048510,66419048514,4,1580,1073,-20
66419118660,66419118663,3,1656,1341,-20
66420232319,66420232322,3,1153,1249,-20
66420374630,66420374633,3,1632,1406,-20
66422496125,66422496130,5,1322,1212,-20
66424203889,66424203885,-4,1326,1042,-20
66426327416,66426327423,7,3161,1367,-20
66430523646,66430523651,5,1351,1641,-20
66431514791,66431514794,3,2852,2361,-20
66434606446,66434606451,5,2029,1694,-20
66434892763,66434892763,0,891,787,-20
66435107230,66435107234,4,1816,1409,-20
66438545277,66438545282,5,1766,1708,-20
66438662238,66438662239,1,2561,1407,-20
66440518401,66440518403,2,2094,1753,-20
66443208735,66443208739,4,1744,1527,-20
66445155069,66445155073,4,1639,1440,-20
66445457098,66445457099,1,1346,1528,-20
66446538789,66446538791,2,1143,1040,-20
66449851915,66449851922,7,1586,1140,-20
66452612638,66452612643,5,1617,981,-20
66455192061,66455192065,4,1892,1080,-20
66456203071,66456203073,2,1183,772,-20
66457262505,66457262508,3,1842,1714,-20
66457320877,66457320882,5,1615,1280,-20
66460363375,66460363379,4,1319,1249,-20
66463416906,66463416912,6,1650,1295,-20
66464718222,66464718225,3,2318,1571,-20
66465430694,66465430697,3,1425,2050,-20
66466706122,66466706124,2,1457,1845,-20
66469364863,66469364867,4,1434,1038,-20
66470367870,66470367852,-18,1880,1159,-20
66473969977,66473969979,2,1581,1343,-20
66475362803,66475362816,13,761,259,-20
66477258764,66477258768,4,2489,1733,-20
66481213347,66481213350,3,921,768,-20
66491545752,66491545757,5,1723,1714,-20
66492843139,66492843143,4,1276,1022,-20
66494467242,66494467245,3,1511,2040,-20
66495888381,66495888387,6,1471,1672,-20
66499303586,66499303591,5,1797,790,-20
66500608409,66500608410,1,1986,1272,-20
66501276273,66501276260,-13,20788,16680,-20
66503330418,66503330421,3,2041,1511,-20
66503392382,66503392360,-22,1514,583,-20
66504260153,66504260158,5,1702,1634,-20
66509726918,66509726922,4,2579,1847,-20
66514061501,66514061502,1,2584,2225,-20
66514290315,66514290315,0,1502,1953,-20
66515313993,66515313997,4,1219,1103,-20
66520210287,66520210287,0,1843,2039,-20
66520982106,66520982110,4,1843,1410,-20
66521678024,66521678025,1,1308,1320,-20
66522185918,66522185923,5,2255,1576,-20
66524131727,66524131727,0,1256,1378,-20
66524362813,66524362817,4,1428,1016,-20
66526849211,66526849213,2,1215,1352,-20
66529183278,66529183282,4,1755,1005,-20
66534686639,66534686642,3,2514,1508,-20
66534990212,66534990214,2,1522,1216,-20
66535556085,66535556088,3,1398,1913,-20
66540955126,66540955127,1,2043,1379,-20
66542072231,66542072235,4,2246,1607,-20
66542796897,66542796898,1,1850,1721,-20
66544753181,66544753184,3,1934,1463,-20
66545295989,66545295994,5,1446,1485,-20
66546049495,66546049473,-22,1252,1063,-20
66547713620,66547713623,3,1777,1042,-20
66548319804,66548319811,7,1923,1164,-20
66552532674,66552532678,4,2539,2205,-20
66553128282,66553128286,4,2060,1383,-20
66555259827,66555259833,6,2194,1411,-20
66557062271,66557062272,1,2598,4193,-20
66558979714,66558979718,4,1727,1115,-20
66560053614,66560053617,3,1765,1081,-20
66561014322,66561014325,3,1924,1487,-20
66562073485,66562073487,2,1884,1293,-20
66562332363,66562332346,-17,2149,1432,-20
66562430852,66562430857,5,1588,1432,-20
66570550402,66570550406,4,2041,1254,-20
66574732476,66574732478,2,1381,1181,-20
66574937270,66574937267,-3,706,75,-20
66576165387,66576165391,4,1299,1444,-20
66580449307,66580449312,5,1601,1482,-20
66582745310,66582745310,0,1120,1548,-20
66585298561,66585298566,5,2073,1204,-20
66587099125,66587099129,4,2550,1575,-20
66590858977,66590858980,3,1640,1273,-20
66592774031,66592774035,4,1714,1016,-20
66593081095,66593081114,19,1359,1745,-20
66596740268,66596740269,1,2179,1741,-20
66597275941,66597275942,1,1714,1231,-20
66597401028,66597401049,21,1279,1030,-20
66599121818,66599121821,3,1902,1506,-20
66601930878,66601930885,7,1816,1140,-20
66602077660,66602077642,-18,3852,821,-20
66607645790,66607645796,6,1719,1262,-20
66609965882,66609965887,5,1583,1385,-20
66610911921,66610911921,0,13898,15356,-20
66613115214,66613115218,4,2795,1250,-20
66613342370,66613342375,5,2018,1646,-20
66614143627,66614143626,-1,966,1417,-20
66616844554,66616844561,7,2293,1179,-20
66617168957,66617168961,4,1807,1524,-20
66634335607,66634335612,5,1189,1300,-20
66639746941,66639746945,4,2093,1691,-20
66639843021,66639843023,2,1272,1386,-20
66640276483,66640276485,2,2013,1398,-20
66642020603,66642020607,4,1971,1238,-20
66644122062,66644122065,3,1712,1061,-20
66644475040,66644475045,5,2158,1220,-20
66644852127,66644852130,3,2003,1364,-20
66650691230,66650691233,3,2236,1420,-20
66663410185,66663410191,6,2164,1326,-20
66664732482,66664732486,4,1652,1172,-20
66665010413,66665010416,3,974,1421,-20
66666837735,66666837738,3,1735,1309,-20
66666987026,66666987028,2,1672,1086,-20
66669240014,66669240017,3,1660,1317,-20
66670511580,66670511585,5,1125,1363,-20
66679478446,66679478453,7,3376,1026,-20
66679525662,66679525666,4,1662,1301,-20
66681512838,66681512843,5,1553,1267,-20
66685610058,66685610060,2,2101,1546,-20
66689873922,66689873926,4,1412,1223,-20
66690318023,66690318029,6,1883,1234,-20
66693044410,66693044411,1,868,1190,-20
66695653651,66695653653,2,1523,1333,-20
66697287322,66697287325,3,1133,1276,-20
66697699342,66697699344,2,1645,1669,-20
66701001775,66701001778,3,1018,1178,-20
66701902617,66701902620,3,2704,1883,-20
66704112302,66704112307,5,1657,1315,-20
66715192250,66715192255,5,1470,1231,-20
66715875006,66715875010,4,2437,1531,-20
66717723510,66717723513,3,2056,2085,-20
66719897973,66719897971,-2,1040,1287,-20
66720645992,66720645998,6,3467,959,-20
66721329397,66721329399,2,1618,1017,-20
66727730786,66727730788,2,1851,1543,-20
66736611103,66736611106,3,1650,1293,-20
66737025110,66737025117,7,3342,1571,-20
66737567817,66737567819,2,1502,1162,-20
66738849178,66738849179,1,1716,1197,-20
66740053295,66740053302,7,4141,1451,-20
66741473568,66741473570,2,1871,1397,-20
66741617448,66741617451,3,1602,1423,-20
66745136432,66745136436,4,1383,1079,-20
66747856370,66747856352,-18,1262,1407,-20
66748804641,66748804646,5,1958,1490,-20
66749854476,66749854479,3,1781,1279,-20
66752178922,66752178926,4,2409,1539,-20
66754717137,66754717141,4,2331,2030,-20
66756416401,66756416406,5,2094,1356,-20
66756757901,66756757904,3,1591,1146,-20
66757465346,66757465347,1,2094,1445,-20
66761132177,66761132182,5,1613,1322,-20
66762786045,66762786049,4,1318,1669,-20
66763443448,66763443450,2,1844,1587,-20
66764282366,66764282369,3,2332,1770,-20
66766648375,66766648379,4,2321,1415,-20
66767088169,66767088174,5,1206,1249,-20
66768949446,66768949449,3,2214,1898,-20
66769241729,66769241734,5,1893,1587,-20
66771858023,66771858027,4,1758,1369,-20
66773778538,66773778539,1,1566,1257,-20
66776833010,66776833013,3,1687,1474,-20
66777041609,66777041613,4,2028,1727,-20
66777683988,66777683991,3,3417,1824,-20
66778743474,66778743479,5,1994,1121,-20
66779411035,66779411036,1,1373,1520,-20
66780220717,66780220721,4,1128,1506,-20
66780546940,66780546953,13,1810,847,-20
66781085090,66781085105,15,2095,1273,-20
66784061750,66784061752,2,1435,1812,-20
66785116262,66785116266,4,2236,1301,-20
66786435482,66786435483,1,1697,1761,-20
66787065994,66787066000,6,1066,1060,-20
66789345741,66789345749,8,3349,1390,-20
66790481625,66790481630,5,2633,1554,-20
66790787455,66790787458,3,1594,1002,-20
66794336125,66794336127,2,1184,1275,-20
66795456617,66795456619,2,2548,1438,-20
66797328631,66797328637,6,1148,1110,-20
66798237058,66798237065,7,3458,1597,-20
66798532891,66798532898,7,1851,977,-20
66799772773,66799772775,2,1502,1478,-20
66802352574,66802352579,5,1499,1034,-20
66802959561,66802959561,0,1524,1175,-20
66806015986,66806015989,3,2293,1349,-20
66806132987,66806132990,3,2390,1160,-20
66807326658,66807326662,4,1893,967,-20
66807476449,66807476453,4,2038,1227,-20
66809071681,66809071685,4,2554,1704,-20
66809121114,66809121121,7,952,316,-20
66810249834,66810249840,6,1238,829,-20
66810354118,66810354112,-6,1024,3312,-20
66811359527,66811359530,3,1281,948,-20
66813614376,66813614378,2,1754,909,-20
66815708302,66815708307,5,2408,2070,-20
66815916633,66815916637,4,1871,1482,-20
66815990421,66815990422,1,1430,1003,-20
66816319609,66816319627,18,1722,1118,-20
66820143247,66820143250,3,2046,1674,-20
66823931113,66823931118,5,1599,1639,-20
66827189121,66827189122,1,2066,1912,-20
66832889688,66832889694,6,2039,1571,-20
66834141582,66834141585,3,1508,1140,-20
66841023098,66841023102,4,1626,1362,-20
66845222610,66845222610,0,1521,1742,-20
66845335318,66845335322,4,2154,1981,-20
66845756630,66845756634,4,1815,1524,-20
66846100747,66846100751,4,1615,1024,-20
66850062413,66850062415,2,1359,1143,-20
66852124044,66852124048,4,1437,980,-20
66853183218,66853183220,2,1678,1969,-20
66854676522,66854676525,3,2166,1514,-20
66855312731,66855312735,4,1396,1155,-20
66856015958,66856015962,4,3006,1527,-20
66856419681,66856419678,-3,807,374,-20
66858298958,66858298955,-3,1068,2324,-20
66858442997,66858443002,5,1963,1687,-20
66858942531,66858942533,2,1858,1982,-20
66860483071,66860483074,3,1890,1335,-20
66860751768,66860751772,4,1628,1248,-20
66861705457,66861705458,1,1735,1013,-20
66863919855,66863919859,4,1810,1370,-20
66865059395,66865059399,4,2445,1189,-20
66874192509,66874192511,2,1734,1367,-20
66876115366,66876115371,5,2232,1451,-20
66879217365,66879217371,6,2072,1354,-20
66882324082,66882324084,2,1568,1129,-20
66888193265,66888193271,6,1492,1523,-20
66889075954,66889075953,-1,1095,1930,-20
66892689191,66892689193,2,1908,1777,-20
66894433069,66894433066,-3,2896,5517,-20
66894652294,66894652299,5,1773,1261,-20
66895191828,66895191832,4,1385,1688,-20
66896355120,66896355124,4,1815,1297,-20
66896855406,66896855410,4,1819,1272,-20
66900697660,66900697664,4,1589,1251,-20
66904234898,66904234903,5,1887,1610,-20
66906139810,66906139814,4,1640,1349,-20
66906569434,66906569439,5,1438,1124,-20
66909771702,66909771705,3,1822,1389,-20
66911218023,66911218021,-2,1498,3637,-20
66911529357,66911529360,3,1536,1683,-20
66911984489,66911984490,1,1387,1338,-20
66913075474,66913075474,0,1531,1287,-20
66914866444,66914866442,-2,869,1751,-20
66918706145,66918706148,3,1897,1336,-20
66922185921,66922185925,4,2127,1942,-20
66922905887,66922905892,5,1767,1114,-20
66923091199,66923091203,4,2842,2143,-20
66925461747,66925461750,3,1612,1175,-20
66926080299,66926080300,1,1554,1304,-20
66927088944,66927088948,4,1612,1144,-20
66929401219,66929401235,16,1361,1369,-20
66933741210,66933741215,5,1528,1318,-20
66940173650,66940173655,5,2321,1744,-20
66941664110,66941664111,1,1055,1016,-20
66942562814,66942562819,5,1503,1068,-20
66944423073,66944423075,2,1818,1016,-20
66944517002,66944516987,-15,967,893,-20
66946618526,66946618531,5,1929,1255,-20
66949449806,66949449808,2,1854,1669,-20
66950034106,66950034107,1,2278,2157,-20
66952367470,66952367475,5,2187,1598,-20
66957979747,66957979751,4,742,605,-20
66961181270,66961181289,19,867,1665,-20
66961537642,66961537645,3,1660,915,-20
66961813789,66961813791,2,2236,1152,-20
66968323842,66968323837,-5,905,3844,-20
66972446240,66972446242,2,1577,1702,-20
66975555589,66975555594,5,853,1440,-20
66978454456,66978454451,-5,1462,5008,-20
66981222193,66981222199,6,2218,1058,-20
66982929020,66982929024,4,1526,1671,-20
66983664497,66983664501,4,1431,1794,-20
66984365641,66984365643,2,1428,1490,-20
66986935981,66986935983,2,1803,1506,-20
66987650375,66987650377,2,1484,1046,-20
66988317220,66988317224,4,3387,1508,-20
66997666263,66997666267,4,1874,1348,-20
66999040509,66999040511,2,2127,1824,-20
67000143875,67000143879,4,1744,1264,-20
67000719585,67000719588,3,1485,1306,-20
67002641145,67002641151,6,1686,995,-20
67003094012,67003094015,3,1808,1281,-20
67003211036,67003211038,2,1548,1629,-20
67004753459,67004753462,3,2296,2086,-20
67005169599,67005169602,3,1657,912,-20
67014049189,67014049192,3,1939,1454,-20
67014734759,67014734764,5,2346,1317,-20
67018043088,67018043092,4,10314,24442,-20
67020296103,67020296105,2,1713,1195,-20
67023045222,67023045227,5,2118,1267,-20
67023120573,67023120575,2,2224,1154,-20
67028805982,67028805986,4,934,1104,-20
67030302502,67030302504,2,1807,1222,-20
67031380498,67031380502,4,1794,972,-20
67035543605,67035543610,5,1936,1057,-20
67035870007,67035869986,-21,1641,1493,-20
67037575327,67037575328,1,1504,1092,-20
67038974515,67038974518,3,1965,1161,-20
67040867803,67040867806,3,2117,1695,-20
67045637933,67045637935,2,1793,1932,-20
67046511116,67046511120,4,1242,1304,-20
67046816807,67046816811,4,2327,1918,-20
67047499285,67047499290,5,1066,1050,-20
67051223863,67051223869,6,1836,1430,-20
67053749577,67053749579,2,1328,1310,-20
67054630050,67054630053,3,1859,1716,-20
67055025759,67055025762,3,1887,995,-20
67057108318,67057108322,4,1667,1446,-20
67059665058,67059665061,3,1449,1969,-20
67063126101,67063126105,4,1746,1140,-20
67066675538,67066675542,4,1780,1561,-20
67068035511,67068035514,3,1718,1319,-20
67069163626,67069163629,3,1529,1520,-20
67069851811,67069851816,5,2090,1292,-20
67071754484,67071754487,3,2423,1428,-20
67075722265,67075722267,2,2010,1308,-20
67076699655,67076699664,9,562,217,-20
67079132830,67079132834,4,1881,1177,-20
67081789188,67081789190,2,1479,1328,-20
67086320183,67086320183,0,1474,2468,-20
67086842045,67086842048,3,1490,1295,-20
67087735350,67087735356,6,2318,1285,-20
67088510501,67088510480,-21,1634,1100,-20
67088557385,67088557386,1,1662,1384,-20
67094664071,67094664062,-9,23915,50151,-20
67095205089,67095205093,4,1952,1022,-20
67098061756,67098061759,3,2209,1764,-20
67104318628,67104318631,3,1549,1150,-20
67104469365,67104469366,1,1858,1540,-20
67109839714,67109839716,2,1350,1521,-20
67110686017,67110686019,2,1572,1164,-20
67113734334,67113734339,5,1548,1339,-20
67114395426,67114395430,4,1424,1475,-20
67116676933,67116676938,5,2646,1653,-20
67122640435,67122640438,3,1882,1388,-20
67123132847,67123132851,4,1140,1616,-20
67126645032,67126645038,6,2174,1130,-20
67127019178,67127019182,4,2012,1170,-20
67127257138,67127257141,3,2028,1543,-20
67128328274,67128328277,3,2302,1584,-20
67128901242,67128901246,4,2209,1253,-20
67129570549,67129570553,4,1801,1766,-20
67132154943,67132154947,4,1763,1173,-20
67133759746,67133759746,0,1374,787,-20
67134918729,67134918731,2,1409,335,-20
67135739294,67135739298,4,1710,1482,-20
67136114285,67136114290,5,1698,954,-20
67136303339,67136303342,3,1632,1296,-20
67139699431,67139699434,3,2253,1792,-20
67147080881,67147080885,4,1846,1354,-20
67148283582,67148283586,4,2509,1599,-20
67150385690,67150385706,16,422,1699,-20
67151061694,67151061690,-4,951,1474,-20
67151174358,67151174357,-1,2266,3573,-20
67161980422,67161980425,3,10631,18988,-20
67162199769,67162199775,6,2249,1122,-20
67163578613,67163578597,-16,1488,1245,-20
67164670912,67164670915,3,1365,1437,-20
67165484291,67165484291,0,1705,1757,-20
67166704637,67166704642,5,2149,1381,-20
67167266865,67167266867,2,1272,1440,-20
67169001970,67169001974,4,2599,2165,-20
67170547885,67170547890,5,2046,1426,-20
67174076086,67174076090,4,1895,1274,-20
67178546937,67178546941,4,2215,1138,-20
67181591476,67181591478,2,1661,1579,-20
67181798973,67181798975,2,1686,1767,-20
67182719213,67182719214,1,2878,1846,-20
67184806682,67184806679,-3,1305,3167,-20
67186680685,67186680689,4,2171,2039,-20
67190654625,67190654627,2,2145,1352,-20
67191163225,67191163230,5,1651,1698,-20
67194914479,67194914483,4,1969,1498,-20
67196285750,67196285748,-2,1208,1614,-20
67201554098,67201554104,6,1307,340,-20
67204984601,67204984603,2,740,752,-20
67210173191,67210173197,6,1699,1092,-20
67214374894,67214374897,3,2141,1267,-20
67214411848,67214411854,6,2292,1564,-20
67214967277,67214967281,4,2238,1276,-20
67216479226,67216479231,5,2116,1182,-20
67217190847,67217190850,3,2326,1818,-20
67218364742,67218364745,3,1698,1554,-20
67219227038,67219227042,4,2148,1504,-20
67226438392,67226438396,4,1686,1548,-20
67229635650,67229635654,4,2132,1195,-20
67230448087,67230448090,3,2243,1389,-20
67231194684,67231194706,22,1352,911,-20
67233540422,67233540426,4,1972,979,-20
67234040173,67234040178,5,2395,1421,-20
67237862744,67237862748,4,1728,1571,-20
67238440517,67238440519,2,2570,2038,-20
67239707338,67239707331,-7,1205,2208,-20
67245218618,67245218621,3,1621,1685,-20
67245969994,67245969995,1,1781,1232,-20
67250382569,67250382572,3,2289,1690,-20
67251345713,67251345706,-7,1244,5905,-20
67252330102,67252330105,3,2238,1306,-20
67252898357,67252898359,2,1459,1096,-20
67255392287,67255392295,8,3556,1218,-20
67259232519,67259232521,2,2583,1567,-20
67266476237,67266476239,2,1563,1785,-20
67267546585,67267546587,2,1652,1347,-20
67269682922,67269682926,4,1677,934,-20
67269958581,67269958562,-19,1580,1124,-20
67270954765,67270954767,2,2135,1323,-20
67272699366,67272699371,5,1927,1410,-20
67276261838,67276261841,3,1812,2114,-20
67277097346,67277097350,4,1854,1202,-20
67278778585,67278778591,6,2923,1433,-20
67281253354,67281253356,2,2082,1452,-20
67284111107,67284111111,4,1908,1700,-20
67286207761,67286207763,2,1340,957,-20
67286851278,67286851280,2,1777,1311,-20
67286915537,67286915542,5,2296,1982,-20
67287728726,67287728732,6,1211,1288,-20
67288019717,67288019721,4,1052,823,-20
67293818018,67293818022,4,2176,1480,-20
67296044055,67296044059,4,1032,758,-20
67296971574,67296971578,4,1818,1316,-20
67298290626,67298290629,3,2500,2442,-20
67298325468,67298325473,5,1699,1382,-20
67303873887,67303873893,6,1816,1380,-20
67305464327,67305464331,4,1856,1365,-20
67308769685,67308769687,2,1536,1866,-20
67309558418,67309558422,4,2348,2007,-20
67317357086,67317357092,6,1802,965,-20
67317861843,67317861845,2,32743,32804,-20
67319025504,67319025509,5,1632,1081,-20
67320063391,67320063395,4,1836,1388,-20
67321331056,67321331060,4,1622,1180,-20
67322659667,67322659672,5,1998,1211,-20
67324292406,67324292418,12,1565,1266,-20
67326439805,67326439810,5,2136,1393,-20
67328556126,67328556127,1,1268,1099,-20
67328789047,67328789049,2,1340,1020,-20
67330463970,67330463986,16,11498,50253,-20
67330840651,67330840652,1,2283,1850,-20
67334271578,67334271578,0,1772,1231,-20
67336288913,67336288913,0,1411,1915,-20
67344631923,67344631927,4,1672,1160,-20
67355054739,67355054743,4,2083,1214,-20
67363971689,67363971697,8,2475,1426,-20
67365205528,67365205529,1,897,1106,-20
67375357629,67375357631,2,1321,1512,-20
67376630742,67376630747,5,1877,1451,-20
67377005967,67377005970,3,1194,1466,-20
67378068015,67378068018,3,1794,1129,-20
67379479145,67379479146,1,1418,1440,-20
67379939692,67379939699,7,1968,664,-20
67381830535,67381830517,-18,1112,916,-20
67384532257,67384532259,2,1394,1095,-20
67387056526,67387056530,4,2232,1896,-20
67388874972,67388874970,-2,1360,2589,-20
67389043815,67389043817,2,2164,1469,-20
67390283833,67390283834,1,1734,1610,-20
67391034736,67391034739,3,2159,1509,-20
67392276660,67392276662,2,2076,1830,-20
67392850897,67392850909,12,333,1162,-20
67393961694,67393961697,3,1660,1414,-20
67395858698,67395858702,4,1667,1879,-20
67397729047,67397729049,2,1198,1457,-20
67403498972,67403498978,6,1759,1468,-20
67404549554,67404549557,3,2086,1164,-20
67405214433,67405214438,5,2029,931,-20
67405656317,67405656322,5,1544,942,-20
67408013891,67408013894,3,2381,1409,-20
67408902523,67408902525,2,2186,1723,-20
67410211318,67410211322,4,2691,2111,-20
67411043826,67411043827,1,1899,982,-20
67415308498,67415308502,4,1762,1147,-20
67418228450,67418228451,1,1248,1228,-20
67418857038,67418857043,5,2827,2021,-20
67421792574,67421792576,2,2399,1869,-20
67424508259,67424508263,4,2200,1485,-20
67426061044,67426061047,3,1629,1385,-20
67432400382,67432400383,1,2077,1781,-20
67432966765,67432966770,5,826,735,-20
67433844182,67433844187,5,1228,1105,-20
67434206475,67434206476,1,1570,1348,-20
67436732001,67436732005,4,2782,2612,-20
67439355941,67439355944,3,2124,1648,-20
67440197630,67440197650,20,1521,906,-20
67442757274,67442757275,1,1895,1733,-20
67443816594,67443816598,4,2143,1031,-20
67445662476,67445662478,2,1382,1235,-20
67450178033,67450178036,3,1507,1302,-20
67454152068,67454152071,3,1379,1110,-20
67455803293,67455803299,6,1127,1219,-20
67455889930,67455889935,5,1635,754,-20
67462154290,67462154293,3,1889,1172,-20
67462859273,67462859275,2,2034,1588,-20
67464195015,67464195018,3,2169,1935,-20
67467751023,67467751027,4,1525,973,-20
67475368278,67475368279,1,1197,972,-20
67477300552,67477300555,3,1549,1456,-20
67479155253,67479155254,1,1375,1249,-20
67480818211,67480818215,4,2306,1780,-20
67481666154,67481666157,3,2446,1245,-20
67483937924,67483937925,1,1777,1503,-20
67484874987,67484874990,3,1825,1514,-20
67490588050,67490588048,-2,1890,4919,-20
67493264687,67493264690,3,1742,1735,-20
67493335209,67493335215,6,1332,892,-20
67502208393,67502208399,6,5561,2641,-20
67507802431,67507802434,3,970,1441,-20
67508440434,67508440438,4,1240,1249,-20
67514205558,67514205562,4,1767,1411,-20
67514282537,67514282542,5,1604,705,-20
67521242845,67521242846,1,1887,1416,-20
67524095249,67524095252,3,1201,1160,-20
67525436636,67525436637,1,2059,1634,-20
67534346617,67534346620,3,1831,1373,-20
67535430625,67535430629,4,2370,1818,-20
67539014295,67539014298,3,2062,1579,-20
67541011581,67541011582,1,1210,1271,-20
67541770870,67541770873,3,1291,1627,-20
67543252313,67543252316,3,2150,1858,-20
67545823566,67545823568,2,1874,1490,-20
67546995854,67546995855,1,1962,1478,-20
67548950125,67548950129,4,1545,1547,-20
67549336782,67549336785,3,1538,1553,-20
67550051597,67550051619,22,1850,1859,-20
67550187699,67550187702,3,1668,1404,-20
67552990229,67552990235,6,1742,1263,-20
67554890613,67554890616,3,1724,1833,-20
67555845845,67555845850,5,1868,1238,-20
67561863925,67561863946,21,396,1205,-20
67562331063,67562331064,1,1252,1224,-20
67564116058,67564116060,2,1573,745,-20
67567439629,67567439633,4,1653,1390,-20
67567754750,67567754754,4,1787,1199,-20
67569186580,67569186583,3,2627,1978,-20
67569298973,67569298975,2,2083,1566,-20
67569961319,67569961323,4,1258,1076,-20
67570793274,67570793282,8,1325,1197,-20
67572845984,67572845987,3,1755,1304,-20
67574034736,67574034737,1,1688,1401,-20
67575076995,67575076997,2,1458,1381,-20
67577553830,67577553833,3,1862,1865,-20
67580025826,67580025829,3,1481,1156,-20
67582839623,67582839626,3,1651,1363,-20
67587830607,67587830610,3,1112,1197,-20
67593160366,67593160369,3,1691,1195,-20
67594972281,67594972285,4,2075,1657,-20
67598284146,67598284150,4,2279,1351,-20
67601677254,67601677257,3,5711,25497,-20
67604866626,67604866630,4,1266,1125,-20
67606436985,67606436986,1,1110,959,-20
67607348565,67607348571,6,3371,1472,-20
67608137315,67608137318,3,1341,1591,-20
67611454910,67611454914,4,2282,1909,-20
67612197121,67612197122,1,1566,1225,-20
67613041146,67613041146,0,1368,1375,-20
67616506122,67616506126,4,1893,958,-20
67620697574,67620697578,4,1205,1198,-20
67622678901,67622678906,5,1995,1045,-20
67623394523,67623394517,-6,1038,3906,-20
67627889045,67627889048,3,1361,1241,-20
67629751030,67629751024,-6,53570,26924,-20
67631294106,67631294110,4,1381,1170,-20
67632360922,67632360925,3,1848,1547,-20
67634370839,67634370818,-21,816,285,-20
67638263530,67638263534,4,2363,1551,-20
67639248327,67639248330,3,1920,1421,-20
67646500166,67646500160,-6,1902,9613,-20
67652243271,67652243274,3,2410,1572,-20
67652907191,67652907192,1,1103,2569,-20
67655000763,67655000769,6,4194,2140,-20
67656268134,67656268138,4,2111,1575,-20
67656481148,67656481150,2,1399,1304,-20
67658754709,67658754725,16,13841,51553,-20
67658940003,67658939982,-21,1356,1758,-20
67659337942,67659337945,3,1542,1408,-20
67660028447,67660028450,3,1304,1152,-20
67662019243,67662019247,4,2079,1268,-20
67662182157,67662182179,22,2203,1475,-20
67662609786,67662609787,1,1891,2063,-20
67665784800,67665784795,-5,1842,6505,-20
67666138674,67666138681,7,1853,1168,-20
67666815482,67666815485,3,1613,1663,-20
67667155942,67667155939,-3,1623,3502,-20
67669035241,67669035243,2,1861,1798,-20
67669174150,67669174153,3,1724,1561,-20
67673731213,67673731221,8,1322,1318,-20
67675057575,67675057578,3,1273,1035,-20
67677957675,67677957678,3,2129,1516,-20
67678305941,67678305942,1,1567,748,-20
67679831103,67679831104,1,1556,1377,-20
67682708814,67682708817,3,1996,1728,-20
67683469590,67683469593,3,2517,2220,-20
67685799627,67685799627,0,1411,2669,-20
67686768006,67686768010,4,2076,1578,-20
67688522509,67688522514,5,1943,1220,-20
67693021452,67693021455,3,1841,1745,-20
67693916030,67693916034,4,2220,1728,-20
67694421283,67694421286,3,1033,716,-20
67696029569,67696029573,4,2324,1750,-20
67696390458,67696390461,3,2617,2423,-20
67697764001,67697763998,-3,1351,2266,-20
67698070568,67698070571,3,1600,1754,-20
67698285638,67698285642,4,1687,1282,-20
67698872509,67698872511,2,1737,1362,-20
67705671717,67705671719,2,2134,1117,-20
67706265566,67706265548,-18,1116,840,-20
67713523283,67713523271,-12,24855,17598,-20
67714439791,67714439796,5,1600,1456,-20
67716633350,67716633349,-1,1407,1952,-20
67716881426,67716881432,6,14181,22307,-20
67718146891,67718146893,2,1538,1749,-20
67720193175,67720193177,2,1329,2081,-20
67721184368,67721184373,5,1622,1300,-20
67723430333,67723430333,0,13263,50322,-20
67724613714,67724613717,3,1443,928,-20
67726809689,67726809694,5,1923,1191,-20
67728417023,67728417022,-1,1727,2593,-20
67729387866,67729387867,1,1871,1637,-20
67729720877,67729720882,5,1375,1246,-20
67733981783,67733981790,7,2173,965,-20
67736799934,67736799938,4,1759,1925,-20
67738284779,67738284765,-14,1192,1289,-20
67739832586,67739832589,3,1854,1727,-20
67745287474,67745287475,1,1175,1304,-20
67745717486,67745717488,2,2547,1838,-20
67747518550,67747518554,4,2412,1659,-20
67751783874,67751783874,0,1864,1272,-20
67752862062,67752862065,3,1132,1596,-20
67754218086,67754218087,1,1626,1455,-20
67754265522,67754265526,4,1906,1032,-20
67758790659,67758790662,3,1301,1335,-20
67759529001,67759529007,6,1400,1279,-20
67760083455,67760083459,4,1812,1468,-20
67760903711,67760903714,3,2104,2384,-20
67761092427,67761092430,3,1439,1202,-20
67763781544,67763781549,5,1749,1055,-20
67764971462,67764971467,5,2865,954,-20
67765262674,67765262677,3,2326,1310,-20
67768521870,67768521873,3,1656,1078,-20
67768990263,67768990265,2,807,2006,-20
67770140017,67770140006,-11,1427,985,-20
67778882926,67778882928,2,1115,1368,-20
67779710663,67779710640,-23,1169,966,-20
67783005438,67783005440,2,1325,869,-20
67785433028,67785433030,2,1874,1535,-20
67786421989,67786421993,4,2427,1532,-20
67790522985,67790522986,1,2825,1882,-20
67790886615,67790886609,-6,601,3739,-20
67792002949,67792002954,5,3700,1952,-20
67795965581,67795965584,3,1895,1318,-20
67797706667,67797706670,3,1679,892,-20
67798112834,67798112835,1,1717,2439,-20
67798454018,67798454021,3,2080,1399,-20
67799530663,67799530667,4,2195,1444,-20
67801138462,67801138465,3,1469,1197,-20
67801555626,67801555611,-15,545,282,-20
67802816972,67802816976,4,1981,1635,-20
67803681665,67803681667,2,1629,1138,-20
67804885618,67804885623,5,2441,1959,-20
67807896843,67807896847,4,2357,1578,-20
67807973254,67807973233,-21,728,390,-20
67808847438,67808847440,2,1370,1282,-20
67812491698,67812491702,4,1451,1470,-20
67814377492,67814377494,2,2435,2407,-20
67815514881,67815514884,3,2111,1369,-20
67815547864,67815547867,3,2022,1394,-20
67816244954,67816244958,4,1402,1249,-20
67816706450,67816706453,3,1665,1159,-20
67818099585,67818099587,2,1635,875,-20
67821950933,67821950938,5,1652,1024,-20
67822391608,67822391611,3,1812,1079,-20
67824568504,67824568506,2,1566,857,-20
67827325146,67827325146,0,984,879,-20
67832793240,67832793241,1,1231,1298,-20
67834579805,67834579808,3,1750,1091,-20
67837416049,67837416047,-2,1155,2122,-20
67838745333,67838745335,2,1516,1705,-20
67839673135,67839673139,4,1834,1144,-20
67840214362,67840214366,4,1815,1128,-20
67842547982,67842547986,4,1812,1366,-20
67844699034,67844699041,7,1370,1148,-20
67847650004,67847650006,2,1372,1448,-20
67848518272,67848518275,3,1401,1043,-20
67849648772,67849648775,3,2401,1872,-20
67851766994,67851766997,3,1590,1109,-20
67852460388,67852460394,6,1869,1065,-20
67853655043,67853655046,3,2079,1298,-20
67855784851,67855784854,3,2002,1601,-20
67856256826,67856256830,4,1845,1703,-20
67859574226,67859574231,5,1167,1090,-20
67863394482,67863394485,3,2118,1367,-20
67863814672,67863814675,3,1939,1150,-20
67864612642,67864612643,1,2290,1107,-20
67866209185,67866209182,-3,1008,2812,-20
67867554500,67867554497,-3,2642,7482,-20
67872109881,67872109886,5,2787,2223,-20
67874133226,67874133221,-5,1393,5040,-20
67876341927,67876341929,2,1460,1119,-20
67877667210,67877667213,3,1062,823,-20
67879085858,67879085864,6,5139,2239,-20
67879164643,67879164658,15,685,441,-20
67893071760,67893071763,3,1896,1359,-20
67894136045,67894136050,5,1664,1619,-20
67897989778,67897989781,3,1802,1751,-20
67900243142,67900243147,5,2211,1472,-20
67901621420,67901621423,3,1688,1379,-20
67902242082,67902242085,3,1902,1592,-20
67907934410,67907934413,3,1153,1037,-20
67908025544,67908025546,2,1370,909,-20
67909522403,67909522406,3,1003,1140,-20
67910880534,67910880517,-17,2042,907,-20
67912501650,67912501653,3,2002,1294,-20
67916872996,67916872998,2,1554,2223,-20
67917599241,67917599244,3,1868,1874,-20
67920376086,67920376089,3,1584,1193,-20
67920681769,67920681778,9,1382,1129,-20
67920915530,67920915513,-17,1905,1332,-20
67921692943,67921692945,2,1677,1568,-20
67927332698,67927332703,5,1446,1328,-20
67927627534,67927627535,1,1888,1900,-20
67932029283,67932029285,2,1050,1147,-20
67932305290,67932305296,6,1831,1475,-20
67933165123,67933165126,3,2091,1580,-20
67933861743,67933861746,3,1574,1089,-20
67933946764,67933946766,2,1670,931,-20
67936994307,67936994310,3,1059,1205,-20
67945603913,67945603915,2,2375,1321,-20
67948371270,67948371271,1,1334,1549,-20
67950122241,67950122242,1,1260,1161,-20
67951053369,67951053374,5,1236,1487,-20
67957684351,67957684357,6,2737,1617,-20
67958624442,67958624420,-22,697,221,-20
67959179233,67959179236,3,2035,1510,-20
67960768454,67960768458,4,2699,1474,-20
67965665802,67965665806,4,1889,1311,-20
67966013869,67966013874,5,2690,1934,-20
67966070847,67966070850,3,1598,1400,-20
67966919830,67966919833,3,2315,1475,-20
67967980762,67967980765,3,1653,1513,-20
67970759629,67970759633,4,2606,1687,-20
67970975530,67970975533,3,1791,1513,-20
67972423338,67972423344,6,1994,1577,-20
67972928782,67972928783,1,1508,1266,-20
67973708054,67973708058,4,1958,1546,-20
67975086866,67975086848,-18,1755,1192,-20
67977097398,67977097401,3,1606,1315,-20
67980571211,67980571215,4,2243,1595,-20
67987358453,67987358454,1,2101,1322,-20
67995655465,67995655458,-7,1209,4204,-20
68000305958,68000305963,5,1287,1079,-20
68001643010,68001643012,2,2208,1562,-20
68004646301,68004646301,0,978,1114,-20
68005331227,68005331210,-17,2116,1524,-20
68005823910,68005823904,-6,1281,2972,-20
68010022178,68010022174,-4,811,1885,-20
68011311521,68011311522,1,1200,1127,-20
68014788606,68014788610,4,1303,1339,-20
68014866171,68014866155,-16,3064,1480,-20
68015637841,68015637846,5,2555,1451,-20
68017392060,68017392062,2,2317,1740,-20
68019250693,68019250685,-8,990,4726,-20
68019817860,68019817864,4,1877,1150,-20
68025198153,68025198155,2,1765,983,-20
68029366669,68029366672,3,1535,1049,-20
68029651078,68029651084,6,1461,1445,-20
68031253303,68031253307,4,2002,1517,-20
68031610634,68031610637,3,2593,2585,-20
68032288322,68032288325,3,1673,1886,-20
68033775193,68033775196,3,1584,1385,-20
68034711206,68034711209,3,1204,987,-20
68038048008,68038048012,4,2144,1557,-20
68038127835,68038127833,-2,1493,2754,-20
68039333646,68039333650,4,2304,1894,-20
68039986682,68039986684,2,1538,1395,-20
68042626089,68042626092,3,2244,1641,-20
68045983593,68045983597,4,2213,1651,-20
68048476658,68048476660,2,1628,2217,-20
68051099686,68051099690,4,2194,1114,-20
68051712047,68051712048,1,1654,1385,-20
68052158218,68052158214,-4,22919,14712,-20
68053731213,68053731210,-3,858,2336,-20
68064849302,68064849298,-4,2549,5672,-20
68064924335,68064924338,3,2391,1576,-20
68065250102,68065250107,5,2429,1499,-20
68065905300,68065905303,3,1425,866,-20
68069881206,68069881211,5,2125,1277,-20
68072728786,68072728792,6,1617,1279,-20
68073243390,68073243393,3,2526,1772,-20
68074890862,68074890863,1,1417,822,-20
68076129373,68076129376,3,1838,1795,-20
68077035852,68077035854,2,2710,2016,-20
68077438765,68077438769,4,1675,1472,-20
68077756069,68077756074,5,1592,1152,-20
68079819247,68079819251,4,2987,1535,-20
68080546146,68080546148,2,1611,2252,-20
68080903981,68080903985,4,1780,1173,-20
68081449079,68081449084,5,2124,1558,-20
68081932444,68081932465,21,2224,1355,-20
68084096670,68084096652,-18,1585,682,-20
68086589485,68086589490,5,1375,1330,-20
68086740025,68086740029,4,1709,1566,-20
68087132696,68087132700,4,1549,1568,-20
68089558807,68089558811,4,1313,1227,-20
68090010629,68090010631,2,1220,1734,-20
68095478105,68095478109,4,1549,1084,-20
68096414813,68096414817,4,1777,1346,-20
68096664342,68096664345,3,1742,1259,-20
68097782386,68097782389,3,1756,1568,-20
68099100670,68099100673,3,1816,1331,-20
68099136598,68099136601,3,2790,1745,-20
68103829197,68103829202,5,1633,1197,-20
68107193449,68107193453,4,1260,719,-20
68108339314,68108339322,8,2271,1285,-20
68109526578,68109526579,1,958,946,-20
68110726742,68110726736,-6,2745,7914,-20
68110800017,68110800019,2,1731,1581,-20
68116917211,68116917215,4,1796,1066,-20
68123024944,68123024960,16,15944,28510,-20
68123559219,68123559223,4,1207,811,-20
68126179257,68126179260,3,1475,1148,-20
68126637105,68126637105,0,1546,1494,-20
68127916814,68127916826,12,12820,30883,-20
68141710126,68141710130,4,1612,1395,-20
68147489370,68147489372,2,1664,1332,-20
68147651358,68147651348,-10,1210,252,-20
68150234637,68150234652,15,1736,862,-20
68151302212,68151302196,-16,2253,1580,-20
68152791820,68152791823,3,1561,1336,-20
68153787270,68153787274,4,1470,917,-20
68155324677,68155324681,4,1721,1396,-20
68156500952,68156500954,2,1862,1347,-20
68156973524,68156973522,-2,1751,1037,-20
68159335310,68159335314,4,2337,1932,-20
68162896357,68162896362,5,2168,1517,-20
68163404670,68163404674,4,2771,1489,-20
68165644553,68165644557,4,2259,1660,-20
68166122795,68166122801,6,1650,1472,-20
68167858626,68167858630,4,1664,849,-20
68168927966,68168927972,6,2227,1627,-20
68172259351,68172259353,2,2631,2033,-20
68174288934,68174288938,4,2119,1446,-20
68174923522,68174923526,4,2473,2179,-20
68176839008,68176839010,2,1878,1456,-20
68178297513,68178297515,2,1438,1018,-20
68181146948,68181146952,4,2213,1634,-20
68185038309,68185038313,4,1700,1762,-20
68187518575,68187518554,-21,3036,3063,-20
68188374279,68188374283,4,2099,1570,-20
68191113690,68191113686,-4,2110,4214,-20
68193128245,68193128247,2,2237,1393,-20
68193992712,68193992716,4,1163,1369,-20
68194509166,68194509168,2,1705,1686,-20
68194604768,68194604771,3,2090,1991,-20
68196808655,68196808658,3,1978,1094,-20
68198821926,68198821933,7,4251,1408,-20
68202928285,68202928289,4,1362,1802,-20
68204544942,68204544947,5,1691,1216,-20
68205788189,68205788193,4,2292,1585,-20
68209198475,68209198481,6,2386,1476,-20
68211593504,68211593507,3,2012,1117,-20
68215403873,68215403878,5,2074,1749,-20
68215729298,68215729301,3,2077,2063,-20
68216381901,68216381904,3,1918,1274,-20
68219207516,68219207518,2,1765,1239,-20
68219523401,68219523403,2,1987,1375,-20
68220004906,68220004912,6,2269,1394,-20
68225697203,68225697206,3,2352,1702,-20
68228289949,68228289952,3,2090,1785,-20
68231380802,68231380805,3,2014,1244,-20
68233485379,68233485382,3,1528,1154,-20
68234967166,68234967169,3,1830,2018,-20
68238214082,68238214099,17,976,1758,-20
68239891010,68239891011,1,1781,1475,-20
68240230254,68240230257,3,2151,1697,-20
68243561881,68243561882,1,2196,1610,-20
68244223426,68244223427,1,1419,1211,-20
68245728031,68245728009,-22,1899,1077,-20
68246361587,68246361591,4,2549,1436,-20
68250954827,68250954830,3,1641,1572,-20
68252091178,68252091180,2,1520,1480,-20
68258366838,68258366844,6,2325,1913,-20
68260086914,68260086915,1,1422,1418,-20
68267122522,68267122526,4,1406,1218,-20
68269424235,68269424238,3,2124,1556,-20
68269725927,68269725931,4,1937,1433,-20
68271034162,68271034166,4,1765,1559,-20
68274831206,68274831210,4,1782,1623,-20
68275547607,68275547612,5,1698,1416,-20
68275644888,68275644891,3,3147,2034,-20
68276993592,68276993586,-6,1074,2158,-20
68277494129,68277494135,6,1697,1467,-20
68277717343,68277717345,2,1236,1092,-20
68280417142,68280417145,3,2528,1959,-20
68280726514,68280726524,10,1464,1416,-20
68281256954,68281256958,4,1312,1042,-20
68281765053,68281765059,6,1914,985,-20
68285808115,68285808118,3,1800,1459,-20
68288880866,68288880844,-22,1389,1593,-20
68290532699,68290532703,4,1806,1346,-20
68291937438,68291937443,5,2081,1428,-20
68292877701,68292877702,1,1333,1367,-20
68294943764,68294943767,3,2747,1502,-20
68301906315,68301906319,4,1549,1277,-20
68305455388,68305455390,2,1772,1256,-20
68308209915,68308209918,3,2156,2030,-20
68310210615,68310210618,3,2207,1304,-20
68311949416,68311949410,-6,2098,8201,-20
68314295531,68314295533,2,958,1278,-20
68315045631,68315045635,4,1438,1473,-20
68315606273,68315606275,2,1725,1244,-20
68318209746,68318209748,2,1654,1630,-20
68322439581,68322439586,5,3218,1963,-20
68324607497,68324607503,6,3790,1603,-20
68328826793,68328826792,-1,1503,1790,-20
68329256458,68329256462,4,2023,1298,-20
68330139935,68330139939,4,2274,1795,-20
68333461838,68333461830,-8,34262,13787,-20
68336754825,68336754826,1,1765,1262,-20
68338003318,68338003321,3,1672,1399,-20
68340494792,68340494789,-3,749,1949,-20
68340869283,68340869286,3,1477,1532,-20
68342685235,68342685236,1,1307,1273,-20
68345917265,68345917267,2,1653,1362,-20
68351772394,68351772395,1,2892,3110,-20
68354463120,68354463123,3,2232,1538,-20
68355501124,68355501124,0,1525,1624,-20
68356701533,68356701537,4,2396,1729,-20
68363376433,68363376436,3,1338,797,-20
68364573270,68364573274,4,1869,1440,-20
68365314567,68365314570,3,2008,1592,-20
68366769946,68366769949,3,1685,1384,-20
68367466910,68367466915,5,1149,957,-20
68370320247,68370320254,7,1475,1535,-20
68372484555,68372484558,3,1342,1354,-20
68372656102,68372656083,-19,1872,1535,-20
68380356521,68380356525,4,1615,1555,-20
68380822924,68380822927,3,1545,1649,-20
68382738246,68382738250,4,1361,1373,-20
68382866784,68382866794,10,1648,1266,-20
68384696241,68384696245,4,1493,1405,-20
68385047350,68385047351,1,1246,1282,-20
68386243118,68386243122,4,1428,988,-20
68388548658,68388548659,1,1608,1489,-20
68391163330,68391163334,4,2528,1794,-20
68392305208,68392305211,3,1863,1323,-20
68394116443,68394116446,3,1963,1215,-20
68395714111,68395714116,5,2106,1129,-20
68396071516,68396071518,2,1740,1618,-20
68398167936,68398167939,3,2011,1739,-20
68399505417,68399505421,4,2234,1293,-20
68401026581,68401026585,4,1974,1709,-20
68403336214,68403336219,5,1956,1255,-20
68407817529,68407817533,4,1578,1172,-20
68408754774,68408754779,5,2921,1716,-20
68409560592,68409560585,-7,1128,5907,-20
68412475896,68412475900,4,2050,1610,-20
68413315261,68413315265,4,2072,1624,-20
68413464218,68413464233,15,1531,1529,-20
68414618716,68414618718,2,1645,1306,-20
68417352685,68417352689,4,2103,1782,-20
68421782773,68421782777,4,2090,1293,-20
68423793551,68423793554,3,2441,1364,-20
68424106281,68424106296,15,952,719,-20
68429223470,68429223475,5,1480,1396,-20
68429697286,68429697292,6,1304,1069,-20
68430125641,68430125662,21,99,712,-20
68430806825,68430806827,2,1162,1118,-20
68432995174,68432995179,5,1092,1188,-20
68437232086,68437232091,5,2754,1310,-20
68439915246,68439915253,7,1509,1395,-20
68441596561,68441596563,2,1953,1405,-20
68443945218,68443945221,3,1224,1275,-20
68444140358,68444140362,4,1566,923,-20
68445158475,68445158479,4,1392,1146,-20
68448309429,68448309433,4,1708,1341,-20
68449545898,68449545901,3,2064,1312,-20
68450272756,68450272762,6,2016,1260,-20
68450457019,68450457022,3,2133,1352,-20
68452148934,68452148939,5,2518,1350,-20
68453445031,68453445034,3,1042,954,-20
68455121177,68455121181,4,1823,1492,-20
68455669270,68455669273,3,1903,1149,-20
68456486985,68456486989,4,1891,1440,-20
68458791006,68458791009,3,1270,1159,-20
68459619359,68459619366,7,1653,1082,-20
68462397051,68462397054,3,2366,1477,-20
68463728868,68463728877,9,4034,1387,-20
68464496112,68464496113,1,1353,1397,-20
68468421257,68468421261,4,1867,1301,-20
68470400348,68470400351,3,1544,808,-20
68471789046,68471789053,7,1991,1609,-20
68475192365,68475192367,2,1307,1806,-20
68476272982,68476272984,2,1447,1660,-20
68479031654,68479031658,4,1996,1467,-20
68479278452,68479278455,3,2854,1732,-20
68484101331,68484101334,3,1300,947,-20
68485183586,68485183590,4,2107,1451,-20
68487227374,68487227375,1,1177,1951,-20
68491471034,68491471036,2,2095,1870,-20
68492274075,68492274075,0,1833,1383,-20
68494104221,68494104224,3,2059,1537,-20
68497941565,68497941567,2,1767,1727,-20
68498625494,68498625497,3,2330,1786,-20
68504122020,68504122022,2,1831,1322,-20
68504310409,68504310405,-4,1412,3593,-20
68504774581,68504774585,4,1861,1321,-20
68510479294,68510479300,6,1965,1393,-20
68512484271,68512484283,12,1502,1285,-20
68512691207,68512691185,-22,1244,940,-20
68513621155,68513621159,4,2151,1639,-20
68513939993,68513939996,3,2668,1619,-20
68514148513,68514148517,4,1676,1339,-20
68516677809,68516677810,1,1335,1849,-20
68518512040,68518512042,2,722,831,-20
68518561712,68518561714,2,1674,1152,-20
68520259882,68520259885,3,1929,1340,-20
68522605913,68522605918,5,1958,1638,-20
68523032871,68523032849,-22,1039,158,-20
68523496635,68523496638,3,2199,1306,-20
68525427279,68525427284,5,2506,1993,-20
68528775314,68528775317,3,1256,1371,-20
68532555041,68532555044,3,2021,1324,-20
68534034266,68534034267,1,2034,1390,-20
68535775354,68535775359,5,2044,1424,-20
68537230276,68537230278,2,1864,1540,-20
68538671610,68538671614,4,1812,1568,-20
68540028566,68540028570,4,1910,1111,-20
68543474614,68543474618,4,1711,1004,-20
68543865406,68543865409,3,2043,1548,-20
68547146324,68547146321,-3,1440,2715,-20
68550055342,68550055346,4,1289,1392,-20
68552308270,68552308273,3,1115,584,-20
68553167673,68553167676,3,2261,1522,-20
68558283546,68558283549,3,1991,1500,-20
68563285727,68563285730,3,1698,1426,-20
68563379391,68563379400,9,1623,1322,-20
68567641809,68567641813,4,1969,1201,-20
68569035871,68569035874,3,1622,1600,-20
68569587797,68569587798,1,1674,1858,-20
68570158535,68570158532,-3,1373,3625,-20
68572645026,68572645030,4,1437,1164,-20
68573161352,68573161354,2,1207,1236,-20
68575000947,68575000947,0,1301,662,-20
68581317203,68581317206,3,1527,1170,-20
68584555539,68584555545,6,2597,1523,-20
68585546695,68585546699,4,1651,1835,-20
68589648022,68589648022,0,1963,1785,-20
68598550779,68598550782,3,1541,1435,-20
68599214418,68599214421,3,1474,1358,-20
68601682712,68601682715,3,1227,1112,-20
68601802695,68601802715,20,1633,1556,-20
68601816272,68601816275,3,1,46,-20
68605391202,68605391206,4,1863,1659,-20
68607248269,68607248274,5,899,365,-20
68609980630,68609980636,6,1739,1890,-20
68615420519,68615420514,-5,1069,2550,-20
68615526382,68615526383,1,1515,1535,-20
68615934743,68615934746,3,1453,1376,-20
68616977093,68616977096,3,2334,1531,-20
68618395886,68618395889,3,2154,1371,-20
68619347248,68619347251,3,2264,1389,-20
68622283232,68622283235,3,1343,1140,-20
68622455994,68622455996,2,2169,1991,-20
68622632504,68622632507,3,1900,1002,-20
68623791883,68623791887,4,2748,2063,-20
68624814171,68624814164,-7,1327,5861,-20
68627576390,68627576394,4,2866,1465,-20
68629685517,68629685518,1,1866,1522,-20
68630445509,68630445514,5,2784,1790,-20
68631134429,68631134434,5,2909,1240,-20
68634695813,68634695815,2,1588,1379,-20
68637151445,68637151448,3,1828,1898,-20
68638483179,68638483182,3,1348,871,-20
68639543391,68639543397,6,2383,1230,-20
68640786728,68640786731,3,1852,1290,-20
68643558306,68643558310,4,2077,1156,-20
68643671439,68643671442,3,1482,1229,-20
68645878411,68645878413,2,1679,1340,-20
68646221197,68646221201,4,2550,1499,-20
68646410826,68646410830,4,1702,1691,-20
68656912189,68656912191,2,1203,1077,-20
68657462565,68657462569,4,1619,1607,-20
68657918445,68657918442,-3,20030,14513,-20
68658710817,68658710819,2,2400,1212,-20
68663492607,68663492611,4,1036,692,-20
68666596800,68666596817,17,44,832,-20
68667228384,68667228387,3,1940,1750,-20
68667400334,68667400347,13,1494,1333,-20
68674206272,68674206283,11,987,654,-20
68679950936,68679950939,3,2394,1202,-20
68684285028,68684285031,3,1674,1200,-20
68693135293,68693135297,4,3432,1576,-20
68693248705,68693248707,2,1126,878,-20
68695403458,68695403462,4,1876,1032,-20
68696274859,68696274878,19,799,309,-20
68697407116,68697407123,7,922,1120,-20
68699924269,68699924271,2,1488,1697,-20
68700855857,68700855861,4,1653,1099,-20
68704551960,68704551966,6,2441,1068,-20
68709886473,68709886477,4,1836,1434,-20
68711296821,68711296825,4,2260,1908,-20
68713487801,68713487807,6,5166,1447,-20
68715674061,68715674065,4,1743,946,-20
68717203306,68717203310,4,2536,1635,-20
68718460086,68718460065,-21,952,777,-20
68720785370,68720785375,5,1645,1856,-20
68725175886,68725175889,3,1395,1623,-20
68725574797,68725574801,4,2088,1560,-20
68726689965,68726689967,2,1513,1429,-20
68731075182,68731075188,6,2382,1119,-20
68733207006,68733207010,4,2403,1851,-20
68733538369,68733538369,0,35453,46340,-20
68733780322,68733780323,1,1234,1183,-20
68737749145,68737749147,2,1839,1316,-20
68738845758,68738845759,1,1764,1533,-20
68742851545,68742851547,2,1692,1598,-20
68744361121,68744361125,4,2030,1443,-20
68746846174,68746846175,1,1739,1067,-20
68747418854,68747418856,2,1795,1477,-20
68747512292,68747512297,5,2099,1883,-20
68747645686,68747645690,4,1860,1310,-20
68748551770,68748551775,5,1908,1471,-20
68749745310,68749745313,3,2244,1695,-20
68751045861,68751045863,2,1520,1431,-20
68751834526,68751834530,4,2198,1945,-20
68754064238,68754064242,4,1508,1184,-20
68759985054,68759985057,3,2345,1969,-20
68760697391,68760697390,-1,1277,2296,-20
68761057006,68761057010,4,2128,1909,-20
68768631690,68768631695,5,1597,1403,-20
68773109478,68773109483,5,2275,1784,-20
68775131375,68775131379,4,1880,1195,-20
68775844642,68775844646,4,1936,1742,-20
68777626445,68777626449,4,1970,1215,-20
68779961399,68779961400,1,1383,1641,-20
68780789782,68780789785,3,1637,1505,-20
68781518430,68781518435,5,1420,974,-20
68781634536,68781634534,-2,1663,3223,-20
68785998107,68785998108,1,1784,1882,-20
68787912831,68787912834,3,1933,1725,-20
68792870049,68792870053,4,1325,1210,-20
68793002248,68793002250,2,1876,1491,-20
68799041866,68799041870,4,1349,1073,-20
68799482281,68799482283,2,1299,1242,-20
68800686038,68800686042,4,1237,933,-20
68806777728,68806777731,3,2015,1562,-20
68810772680,68810772687,7,1547,1177,-20
68811236493,68811236498,5,1581,1321,-20
68811443578,68811443582,4,1821,1199,-20
68813446113,68813446115,2,1185,1195,-20
68815922816,68815922819,3,1956,1560,-20
68817833907,68817833911,4,1916,1190,-20
68818270642,68818270645,3,1755,1091,-20
68819501377,68819501380,3,2224,1168,-20
68821455372,68821455375,3,1468,1269,-20
68827919338,68827919346,8,2186,1500,-20
68830517231,68830517235,4,2049,1303,-20
68833472388,68833472390,2,925,1159,-20
68835474837,68835474817,-20,1764,1199,-20
68838420314,68838420318,4,1167,787,-20
68843572883,68843572890,7,2587,973,-20
68845101485,68845101489,4,1641,1522,-20
68846693326,68846693330,4,1359,1477,-20
68847443973,68847443977,4,1894,1340,-20
68848429141,68848429145,4,1985,992,-20
68850814088,68850814091,3,1153,1074,-20
68852251242,68852251245,3,1690,1382,-20
68856941715,68856941719,4,1435,1051,-20
68859006662,68859006666,4,1994,1527,-20
68862759173,68862759175,2,1124,1544,-20
68864174930,68864174935,5,1978,1185,-20
68864636809,68864636808,-1,1109,1759,-20
68864774510,68864774513,3,1599,1548,-20
68875190631,68875190635,4,1811,1458,-20
68876727005,68876727009,4,1727,1225,-20
68877496090,68877496094,4,1893,1614,-20
68879404548,68879404550,2,1662,1717,-20
68879435739,68879435723,-16,1844,1156,-20
68882975225,68882975222,-3,1821,3464,-20
68883723823,68883723826,3,1582,1521,-20
68883798457,68883798459,2,1520,1302,-20
68884681623,68884681626,3,1119,824,-20
68885098166,68885098144,-22,1825,1090,-20
68886032345,68886032338,-7,1623,4429,-20
68886256002,68886256005,3,1957,1350,-20
68887198704,68887198706,2,1517,1209,-20
68890480137,68890480138,1,1966,1032,-20
68890633386,68890633391,5,1862,1194,-20
68892028345,68892028349,4,1635,1386,-20
68892670331,68892670336,5,2102,1805,-20
68893393545,68893393546,1,1277,1252,-20
68903056279,68903056281,2,1776,1141,-20
68903644727,68903644730,3,2638,1562,-20
68906409968,68906409973,5,2622,1511,-20
68907323074,68907323079,5,1694,1475,-20
68909676259,68909676261,2,2043,1312,-20
68910465115,68910465118,3,1397,1625,-20
68916138561,68916138561,0,1686,1794,-20
68918977836,68918977829,-7,943,4536,-20
68921599625,68921599626,1,1111,1152,-20
68922269055,68922269059,4,2119,1472,-20
68922311652,68922311655,3,2355,1805,-20
68922547405,68922547410,5,1826,1432,-20
68923454980,68923454978,-2,17179,15352,-20
68927078317,68927078313,-4,36261,14044,-20
68929905322,68929905326,4,2348,1393,-20
68930920901,68930920905,4,1891,930,-20
68932078276,68932078281,5,2035,1078,-20
68932429349,68932429351,2,1681,1331,-20
68937043490,68937043494,4,1684,2033,-20
68938899363,68938899362,-1,1005,829,-20
68939709901,68939709903,2,1842,1476,-20
68942194299,68942194294,-5,2181,7033,-20
68947487947,68947487950,3,1869,1143,-20
68947819709,68947819712,3,2121,1821,-20
68948395501,68948395502,1,1459,1509,-20
68951889881,68951889883,2,1046,1092,-20
68953107216,68953107219,3,1735,1312,-20
68959938859,68959938862,3,1814,1420,-20
68960767694,68960767699,5,2618,1604,-20
68960898475,68960898478,3,1047,1344,-20
68962652278,68962652280,2,1495,1071,-20
68966433008,68966433014,6,2547,1579,-20
68967633301,68967633303,2,1678,1337,-20
68970057469,68970057471,2,1580,1500,-20
68972460829,68972460816,-13,696,155,-20
68978942630,68978942633,3,2380,1381,-20
68980912062,68980912056,-6,236,1043,-20
68983002031,68983002033,2,1894,1487,-20
68984358950,68984358951,1,1396,1056,-20
68984885537,68984885543,6,1381,993,-20
68986436349,68986436349,0,1463,2294,-20
68989330537,68989330521,-16,1982,876,-20
68990551077,68990551081,4,1251,1414,-20
68992454605,68992454606,1,1764,1187,-20
68994051855,68994051858,3,1105,970,-20
68994722983,68994722987,4,1593,1220,-20
69001136613,69001136615,2,2292,1883,-20
69002603250,69002603253,3,1455,1170,-20
69003439166,69003439171,5,1835,1623,-20
69006008518,69006008520,2,1303,2403,-20
69011636427,69011636431,4,1793,1405,-20
69012805725,69012805730,5,1066,1024,-20
69013913714,69013913719,5,2043,1421,-20
69016569924,69016569930,6,3975,1294,-20
69017439434,69017439437,3,2026,1019,-20
69021752638,69021752643,5,1667,1159,-20
69022135032,69022135035,3,1651,1108,-20
69022274426,69022274430,4,1764,2012,-20
69034240598,69034240601,3,1815,1687,-20
69042645575,69042645577,2,1694,1442,-20
69044098882,69044098882,0,1339,1650,-20
69044580641,69044580643,2,1836,1727,-20
69046041894,69046041897,3,2292,1987,-20
69047223074,69047223078,4,1654,1410,-20
69050582094,69050582098,4,2759,2151,-20
69051268258,69051268266,8,2442,960,-20
69053535058,69053535063,5,2254,1347,-20
69053642915,69053642912,-3,1071,2185,-20
69055202948,69055202951,3,1974,1285,-20
69056497272,69056497274,2,2099,2245,-20
69057293619,69057293623,4,2015,1260,-20
69057964806,69057964824,18,1931,1221,-20
69058017078,69058017081,3,1591,1602,-20
69059521593,69059521595,2,1411,777,-20
69062031106,69062031110,4,1552,830,-20
69062367236,69062367239,3,1175,982,-20
69064307146,69064307150,4,1142,1415,-20
69064483873,69064483879,6,8726,34820,-20
69065139937,69065139941,4,2139,1297,-20
69065491362,69065491371,9,2011,1618,-20
69065865199,69065865201,2,1807,1465,-20
69066747803,69066747805,2,1437,990,-20
69067311261,69067311265,4,2195,1474,-20
69067527934,69067527912,-22,991,743,-20
69068555578,69068555582,4,1864,1925,-20
69069170686,69069170689,3,1716,1443,-20
69072153016,69072153018,2,1587,1237,-20
69075247149,69075247154,5,2117,1567,-20
69075869485,69075869489,4,2408,1539,-20
69077670508,69077670507,-1,1326,2371,-20
69079325848,69079325851,3,1674,1379,-20
69081264686,69081264691,5,2389,1129,-20
69087521967,69087521970,3,2156,1243,-20
69088715298,69088715301,3,1668,1437,-20
69090342927,69090342931,4,1686,1129,-20
69090462446,69090462425,-21,1187,744,-20
69091088626,69091088630,4,1702,1227,-20
69095957513,69095957515,2,1478,1222,-20
69097131390,69097131395,5,1143,1188,-20
69099495003,69099495010,7,3310,1136,-20
69100348555,69100348558,3,1508,1286,-20
69104410664,69104410665,1,1464,1796,-20
69104931592,69104931596,4,2503,1602,-20
69107648602,69107648601,-1,5360,10425,-20
69110580540,69110580542,2,1976,1301,-20
69116857005,69116857007,2,1195,1300,-20
69117645337,69117645341,4,1613,1303,-20
69117957921,69117957923,2,1939,1596,-20
69118318042,69118318046,4,1571,1722,-20
69122045366,69122045371,5,2094,1220,-20
69125341622,69125341626,4,1447,1297,-20
69126220237,69126220241,4,1477,1119,-20
69126997123,69126997123,0,1248,1615,-20
69129007761,69129007765,4,1768,878,-20
69129221647,69129221648,1,1217,1560,-20
69132547319,69132547322,3,2166,1462,-20
69135817438,69135817438,0,1924,1278,-20
69138198134,69138198137,3,1258,1709,-20
69141204950,69141204952,2,2144,2033,-20
69142059530,69142059534,4,1385,1251,-20
69142609070,69142609074,4,1327,1224,-20
69156568039,69156568043,4,1961,1372,-20
69157825686,69157825691,5,2710,1497,-20
69157857538,69157857537,-1,1469,1885,-20
69158062699,69158062703,4,1493,1144,-20
69160660674,69160660678,4,1169,1197,-20
69167533874,69167533878,4,1762,1038,-20
69167809122,69167809128,6,1985,1427,-20
69171994198,69171994202,4,1606,1268,-20
69173738057,69173738061,4,1959,1396,-20
69174485546,69174485549,3,2240,1339,-20
69175811457,69175811459,2,1113,1098,-20
69177847906,69177847912,6,1811,1071,-20
69178744519,69178744523,4,1926,1201,-20
69179560812,69179560814,2,1780,1005,-20
69181763171,69181763173,2,1876,1289,-20
69184527974,69184527977,3,1656,1567,-20
69187225581,69187225585,4,2067,1349,-20
69187322460,69187322465,5,2689,1851,-20
69189390738,69189390742,4,1974,1352,-20
69189926090,69189926084,-6,21015,15163,-20
69191032790,69191032795,5,1568,1397,-20
69195513274,69195513277,3,1831,1696,-20
69195998678,69195998674,-4,1352,2949,-20
69196165486,69196165490,4,1574,1114,-20
69200626538,69200626543,5,2023,1723,-20
69202472798,69202472802,4,2056,1509,-20
69208411927,69208411929,2,2359,1805,-20
69211933526,69211933529,3,1974,1773,-20
69214236474,69214236477,3,1849,1370,-20
69216811771,69216811776,5,2054,1246,-20
69220909899,69220909903,4,1665,1326,-20
69224087371,69224087374,3,1709,1440,-20
69227917787,69227917791,4,3043,1773,-20
69229560775,69229560770,-5,1248,4875,-20
69231914149,69231914139,-10,517,475,-20
69234745583,69234745580,-3,33219,39112,-20
69236137293,69236137298,5,2425,1362,-20
69239330071,69239330076,5,2070,1332,-20
69239758915,69239758917,2,2004,1504,-20
69240608518,69240608521,3,703,810,-20
69240740297,69240740302,5,2493,1424,-20
69242457298,69242457301,3,1586,2073,-20
69243135167,69243135170,3,1744,1587,-20
69248248323,69248248326,3,2238,2184,-20
69248734000,69248734002,2,1778,1265,-20
69250740032,69250740036,4,1327,1315,-20
69251891308,69251891308,0,1582,1519,-20
69252350985,69252350986,1,3340,3140,-20
69253637206,69253637209,3,2085,1403,-20
69257370607,69257370610,3,1676,1343,-20
69259010122,69259010127,5,3169,1572,-20
69260135285,69260135289,4,1339,1361,-20
69260573899,69260573899,0,1768,1760,-20
69264317668,69264317674,6,1777,1003,-20
69267110345,69267110346,1,1416,1022,-20
69268550027,69268550030,3,2176,1657,-20
69268579542,69268579524,-18,1673,1654,-20
69270723578,69270723582,4,1452,1162,-20
69271197442,69271197459,17,1985,1063,-20
69271664525,69271664528,3,1554,1273,-20
69271856183,69271856187,4,1905,1509,-20
69273595488,69273595491,3,2099,1473,-20
69273938215,69273938218,3,1545,1110,-20
69278596293,69278596298,5,1476,912,-20
69278933854,69278933858,4,1833,1301,-20
69280276018,69280276020,2,1577,1310,-20
69288609332,69288609337,5,2148,1555,-20
69299188713,69299188718,5,2267,1785,-20
69304278463,69304278466,3,1964,1506,-20
69305651623,69305651627,4,2553,1126,-20
69307955294,69307955299,5,1712,1193,-20
69308118186,69308118192,6,2453,1353,-20
69309646974,69309646977,3,1482,956,-20
69310863213,69310863215,2,2220,1352,-20
69311984134,69311984138,4,1580,1185,-20
69312677916,69312677914,-2,1682,2826,-20
69317785814,69317785819,5,2246,1108,-20
69319810551,69319810555,4,1568,1396,-20
69321561033,69321561035,2,1984,1105,-20
69324605248,69324605251,3,2165,1409,-20
69325300420,69325300422,2,1821,1646,-20
69327471116,69327471118,2,1205,1152,-20
69328801149,69328801153,4,1724,1388,-20
69334196847,69334196852,5,3103,2029,-20
69337776691,69337776693,2,1398,1342,-20
69339836553,69339836555,2,1008,692,-20
69342363868,69342363860,-8,1192,8100,-20
69345663290,69345663294,4,1547,1266,-20
69346130624,69346130629,5,1423,1387,-20
69346182747,69346182729,-18,2122,1788,-20
69347123345,69347123347,2,1009,1117,-20
69350247462,69350247466,4,2361,1505,-20
69350392455,69350392458,3,1741,1293,-20
69351598612,69351598615,3,2525,1929,-20
69354073653,69354073655,2,1957,1253,-20
69357467986,69357467988,2,1738,1178,-20
69358337170,69358337176,6,3259,1362,-20
69359106146,69359106142,-4,1981,3521,-20
69362895896,69362895898,2,1347,1632,-20
69366345230,69366345234,4,2037,1336,-20
69367239180,69367239162,-18,2767,1921,-20
69367819156,69367819161,5,1691,1189,-20
69369045329,69369045333,4,2368,1509,-20
69374022040,69374022043,3,1658,1549,-20
69380799082,69380799087,5,1519,1586,-20
69385321346,69385321349,3,1690,1779,-20
69387603971,69387603974,3,1191,752,-20
69390014346,69390014349,3,1979,1363,-20
69390489301,69390489284,-17,2977,1396,-20
69394376525,69394376530,5,1821,1175,-20
69395893690,69395893694,4,1381,814,-20
69397586751,69397586755,4,1595,1051,-20
69398061756,69398061736,-20,1449,1533,-20
69400471754,69400471757,3,2098,1451,-20
69402063462,69402063465,3,1503,1298,-20
69409401306,69409401310,4,2138,1262,-20
69415269396,69415269399,3,1643,1137,-20
69417154547,69417154549,2,1766,1269,-20
69418075310,69418075313,3,1521,1296,-20
69418384276,69418384279,3,1670,1063,-20
69419833331,69419833334,3,1709,1699,-20
69420244583,69420244589,6,2435,1673,-20
69430642736,69430642740,4,1552,1266,-20
69436282887,69436282891,4,1660,1006,-20
69439299190,69439299194,4,2145,1211,-20
69439580058,69439580062,4,1849,1285,-20
69440220346,69440220349,3,1446,1624,-20
69440762715,69440762718,3,1773,1534,-20
69443756889,69443756890,1,4086,17723,-20
69444175297,69444175302,5,1501,989,-20
69446299650,69446299654,4,2305,1322,-20
69447595779,69447595782,3,1699,1125,-20
69448030613,69448030632,19,2315,1294,-20
69451485639,69451485642,3,1718,1233,-20
69453811766,69453811771,5,1602,1308,-20
69454464463,69454464440,-23,1264,957,-20
69454699942,69454699945,3,1865,1591,-20
69455302961,69455302962,1,1663,1420,-20
69457458274,69457458279,5,2341,1165,-20
69459059718,69459059721,3,2247,1962,-20
69459115749,69459115753,4,2114,1402,-20
69460238258,69460238261,3,1835,1410,-20
69460449782,69460449769,-13,1472,430,-20
69463623484,69463623484,0,1821,1341,-20
69470767583,69470767585,2,1635,1335,-20
69472278421,69472278422,1,3834,4520,-20
69472613384,69472613386,2,1499,1213,-20
69475054966,69475054969,3,1557,1712,-20
69478456907,69478456911,4,1537,1176,-20
69479707339,69479707337,-2,1564,1559,-20
69479880931,69479880934,3,2134,1346,-20
69480329541,69480329548,7,1759,1766,-20
69483495384,69483495386,2,1514,1284,-20
69486952775,69486952778,3,1502,881,-20
69489711241,69489711245,4,2053,1437,-20
69501041973,69501041975,2,930,1134,-20
69502592542,69502592544,2,2183,1347,-20
69503649235,69503649239,4,1917,929,-20
69503912794,69503912798,4,1572,1518,-20
69505503374,69505503378,4,1743,1536,-20
69509274137,69509274140,3,2170,1553,-20
69510333282,69510333282,0,1537,2053,-20
69513174837,69513174831,-6,702,720,-20
69514480758,69514480762,4,1180,1238,-20
69515292983,69515292987,4,1439,1060,-20
69515332630,69515332612,-18,1329,1365,-20
69520122173,69520122178,5,1733,952,-20
69521640742,69521640744,2,1480,1411,-20
69522424126,69522424126,0,1706,1918,-20
69522781597,69522781602,5,3094,1426,-20
69522938875,69522938877,2,1842,1872,-20
69523882362,69523882367,5,2794,1646,-20
69524393338,69524393339,1,1732,1291,-20
69524628908,69524628913,5,3330,1259,-20
69525581597,69525581599,2,1832,1294,-20
69526796278,69526796282,4,1713,1438,-20
69529286281,69529286283,2,1251,1089,-20
69533493807,69533493813,6,2667,1218,-20
69537113039,69537113042,3,1772,1709,-20
69538228309,69538228312,3,1946,1389,-20
69539780293,69539780296,3,1956,1714,-20
69540170554,69540170554,0,1474,995,-20
69540569827,69540569831,4,2174,1491,-20
69540786683,69540786686,3,1283,1601,-20
69543234365,69543234369,4,1721,1716,-20
69545572439,69545572442,3,2030,1601,-20
69549424206,69549424210,4,2469,1204,-20
69549822778,69549822782,4,1490,1329,-20
69550847719,69550847721,2,1831,1137,-20
69551062709,69551062702,-7,635,2004,-20
69551545668,69551545670,2,1357,1414,-20
69552619851,69552619855,4,1385,1062,-20
69552703738,69552703742,4,2286,1585,-20
69553741497,69553741500,3,856,1189,-20
69557974379,69557974374,-5,1248,3661,-20
69560313081,69560313085,4,2144,1681,-20
69562027638,69562027642,4,1916,1521,-20
69564605665,69564605669,4,2089,1424,-20
69568039617,69568039618,1,1304,1327,-20
69571031724,69571031728,4,2108,1368,-20
69575354445,69575354449,4,2514,1421,-20
69575643785,69575643790,5,1669,1214,-20
69576532286,69576532290,4,1595,1205,-20
69579526691,69579526694,3,1322,1278,-20
69580723062,69580723058,-4,917,1552,-20
69581124040,69581124046,6,4734,1517,-20
69583189955,69583189960,5,1691,1174,-20
69583865481,69583865484,3,1273,885,-20
69584683614,69584683614,0,1618,1144,-20
69585027706,69585027710,4,1819,1728,-20
69589459497,69589459502,5,2136,1252,-20
69590469273,69590469274,1,1577,780,-20
69591985366,69591985360,-6,1329,6688,-20
69592163650,69592163653,3,1426,1295,-20
69593406613,69593406615,2,1212,1141,-20
69595216256,69595216258,2,1599,1547,-20
69596796712,69596796715,3,1818,1764,-20
69598133858,69598133862,4,1265,1237,-20
69599309590,69599309594,4,1813,1599,-20
69600556394,69600556398,4,2117,1519,-20
69606885290,69606885275,-15,2271,814,-20
69607189363,69607189364,1,2589,2204,-20
69608131288,69608131291,3,1668,1097,-20
69608323695,69608323672,-23,805,472,-20
69610194367,69610194370,3,1329,1393,-20
69610805066,69610805070,4,2221,1115,-20
69611247386,69611247389,3,5513,17438,-20
69611688197,69611688192,-5,2186,6423,-20
69616444586,69616444586,0,1430,2023,-20
69617659250,69617659254,4,1534,1537,-20
69619677979,69619677976,-3,894,2096,-20
69619881496,69619881497,1,1920,1735,-20
69620561550,69620561555,5,1457,1587,-20
69621073711,69621073709,-2,928,1804,-20
69626321888,69626321890,2,2021,1413,-20
69627164814,69627164817,3,1148,1394,-20
69631578802,69631578807,5,1982,1141,-20
69633021081,69633021083,2,1007,1198,-20
69633795512,69633795514,2,1854,1502,-20
69634051295,69634051297,2,2026,1260,-20
69634750037,69634750039,2,1490,1428,-20
69636803309,69636803306,-3,1535,4536,-20
69639213688,69639213691,3,1700,1834,-20
69640931859,69640931862,3,1860,1352,-20
69641512520,69641512537,17,2073,8469,-20
69649258731,69649258737,6,1625,1278,-20
69652328470,69652328473,3,1796,1837,-20
69654866922,69654866926,4,1551,1893,-20
69656873757,69656873762,5,1577,1787,-20
69662540385,69662540387,2,2269,1829,-20
69665078843,69665078846,3,1532,1282,-20
69669813886,69669813889,3,1653,1442,-20
69672787651,69672787653,2,1810,1538,-20
69674808017,69674808021,4,1516,1610,-20
69675084928,69675084935,7,2051,1016,-20
69675571055,69675571058,3,1370,844,-20
69675760996,69675761000,4,1858,1241,-20
69681033636,69681033641,5,1535,1128,-20
69682552090,69682552092,2,1515,1497,-20
69685501746,69685501750,4,1857,1219,-20
69691701817,69691701823,6,2017,1401,-20
69692094249,69692094240,-9,674,260,-20
69693350209,69693350214,5,1949,1349,-20
69699226286,69699226289,3,2256,1043,-20
69700984307,69700984310,3,1283,1582,-20
69704177096,69704177098,2,2100,1921,-20
69705386432,69705386438,6,2168,1057,-20
69709381179,69709381182,3,1623,1856,-20
69709853965,69709853971,6,2482,1338,-20
69711302978,69711302976,-2,1565,2400,-20
69713589291,69713589295,4,2433,1847,-20
69713804233,69713804238,5,1887,1369,-20
69715091560,69715091565,5,3043,2151,-20
69717577899,69717577903,4,2125,1296,-20
69717721066,69717721070,4,1377,1602,-20
69719689162,69719689165,3,2354,2071,-20
69721569713,69721569717,4,2450,1618,-20
69722223858,69722223860,2,1564,1757,-20
69724024986,69724024995,9,3401,1061,-20
69726138433,69726138436,3,1642,1144,-20
69727415270,69727415275,5,2832,2120,-20
69728696188,69728696203,15,1565,915,-20
69729652264,69729652266,2,2123,1057,-20
69732280837,69732280841,4,1842,1648,-20
69733947478,69733947480,2,963,1801,-20
69738705525,69738705527,2,2113,1807,-20
69738862026,69738862027,1,1444,941,-20
69743835758,69743835763,5,1272,895,-20
69746929806,69746929811,5,1652,819,-20
69749160114,69749160118,4,1847,952,-20
69749295814,69749295817,3,1436,1170,-20
69750206151,69750206147,-4,988,1142,-20
69753220551,69753220553,2,2064,2419,-20
69753251051,69753251050,-1,1106,1492,-20
69753902154,69753902158,4,2420,1315,-20
69755218315,69755218315,0,6347,8710,-20
69757434785,69757434786,1,1463,1115,-20
69760122660,69760122663,3,1797,1270,-20
69763182194,69763182197,3,1917,1728,-20
69765942154,69765942158,4,2430,1447,-20
69767719950,69767719953,3,1770,1285,-20
69769390445,69769390449,4,1981,1575,-20
69770125998,69770126002,4,1455,1223,-20
69770275409,69770275410,1,1220,1592,-20
69771127012,69771127014,2,2127,1515,-20
69773278179,69773278184,5,1406,1157,-20
69777003082,69777003077,-5,1746,7361,-20
69778540329,69778540332,3,1440,1094,-20
69782333022,69782333027,5,1500,1295,-20
69787076558,69787076557,-1,1144,1525,-20
69788133630,69788133631,1,1508,1108,-20
69791278214,69791278218,4,1716,1578,-20
69794273350,69794273353,3,1811,1444,-20
69795065646,69795065650,4,2298,2416,-20
69797073711,69797073714,3,1805,1609,-20
69797644558,69797644562,4,2077,1103,-20
69799213402,69799213406,4,1555,1601,-20
69800861901,69800861904,3,981,694,-20
69807009293,69807009298,5,1004,1432,-20
69807692662,69807692667,5,1847,1172,-20
69810051897,69810051900,3,1525,1596,-20
69810277026,69810277031,5,2864,1045,-20
69811028044,69811028044,0,1458,2280,-20
69816084755,69816084750,-5,19160,67675,-20
69821011396,69821011398,2,2148,1775,-20
69821976619,69821976622,3,1782,1157,-20
69822951107,69822951110,3,1275,1830,-20
69823664413,69823664406,-7,1135,5401,-20
69825571330,69825571329,-1,1511,1855,-20
69826207754,69826207758,4,978,628,-20
69832135166,69832135170,4,1071,861,-20
69834351052,69834351055,3,2226,1244,-20
69834941743,69834941761,18,1606,1386,-20
69837625142,69837625146,4,1962,1475,-20
69838649587,69838649590,3,1564,1313,-20
69839042049,69839042051,2,1468,1007,-20
69839473874,69839473878,4,1854,1273,-20
69841460012,69841459996,-16,1130,687,-20
69841660688,69841660691,3,1011,939,-20
69842245833,69842245837,4,1697,1181,-20
69842639355,69842639359,4,5859,1125,-20
69844485597,69844485602,5,1698,1661,-20
69845954842,69845954847,5,2805,1949,-20
69846731353,69846731357,4,1607,1280,-20
69851220869,69851220878,9,17149,28842,-20
69851585211,69851585216,5,1573,1298,-20
69855066420,69855066423,3,1564,1007,-20
69855956645,69855956649,4,1465,1266,-20
69857019342,69857019347,5,2063,1289,-20
69857898324,69857898330,6,2101,1372,-20
69859660594,69859660595,1,1270,861,-20
69862119249,69862119253,4,2300,1900,-20
69863426943,69863426947,4,1190,1168,-20
69865053430,69865053434,4,1662,1098,-20
69865255155,69865255158,3,1515,865,-20
69865660787,69865660790,3,2087,1018,-20
69867552526,69867552530,4,1344,1108,-20
69868284698,69868284701,3,1869,1729,-20
69869587480,69869587472,-8,1339,1050,-20
69874278733,69874278737,4,2355,1341,-20
69874368303,69874368280,-23,1206,736,-20
69874723397,69874723400,3,1787,1125,-20
69875190373,69875190378,5,2559,1837,-20
69875469897,69875469900,3,1391,1304,-20
69876464836,69876464819,-17,1952,889,-20
69876885040,69876885042,2,1956,1348,-20
69880283938,69880283943,5,1410,991,-20
69882843784,69882843785,1,1185,992,-20
69883397329,69883397310,-19,1570,1160,-20
69888499965,69888499966,1,1676,1823,-20
69890214879,69890214885,6,1819,1324,-20
69890243851,69890243855,4,1921,1268,-20
69890426278,69890426279,1,1320,1242,-20
69890931031,69890931033,2,1623,1422,-20
69892241508,69892241515,7,2870,1405,-20
69892339260,69892339265,5,2022,1421,-20
69892994264,69892994268,4,2043,1422,-20
69893090751,69893090771,20,1234,1396,-20
69893645998,69893646001,3,1632,1397,-20
69896282129,69896282136,7,1956,1001,-20
69897712933,69897712937,4,1805,1286,-20
69898945526,69898945529,3,796,1164,-20
69906462881,69906462886,5,2686,770,-20
69914575198,69914575200,2,1748,1263,-20
69917366046,69917366051,5,1853,857,-20
69918321469,69918321471,2,1623,1598,-20
69919740930,69919740937,7,1397,974,-20
69920531598,69920531616,18,1527,1414,-20
69923527061,69923527067,6,1956,1149,-20
69923667950,69923667950,0,1152,1019,-20
69924821851,69924821855,4,904,1069,-20
69930080209,69930080212,3,1061,949,-20
69930764474,69930764481,7,2365,1156,-20
69931811351,69931811354,3,2280,1414,-20
69937591175,69937591178,3,1997,1848,-20
69938128245,69938128246,1,2229,860,-20
69941036074,69941036078,4,1302,1139,-20
69945708398,69945708403,5,1990,1446,-20
69950151042,69950151045,3,1513,1395,-20
69952168611,69952168616,5,1923,1558,-20
69952420686,69952420691,5,1323,1088,-20
69954968773,69954968775,2,1603,1452,-20
69956968826,69956968829,3,2294,1952,-20
69959265558,69959265558,0,1508,1261,-20
69960919504,69960919507,3,1776,1320,-20
69961130693,69961130697,4,1732,1137,-20
69966587225,69966587227,2,1478,1264,-20
69968597982,69968597986,4,1808,1305,-20
69969937136,69969937139,3,1846,1704,-20
69974792861,69974792862,1,1994,2232,-20
69974971255,69974971258,3,1872,1414,-20
69976429321,69976429321,0,2196,2663,-20
69979059566,69979059568,2,1991,1393,-20
69983365423,69983365424,1,1708,1687,-20
69987098350,69987098354,4,2052,1763,-20
69988437554,69988437559,5,811,773,-20
69992508814,69992508818,4,2193,1559,-20
69993129510,69993129515,5,1442,943,-20
69994742583,69994742587,4,1775,1255,-20
69994981852,69994981835,-17,1644,1542,-20
69995763673,69995763676,3,1857,1753,-20
69998938855,69998938854,-1,1072,1107,-20
69999615198,69999615202,4,2247,1534,-20
70004959142,70004959145,3,1932,1658,-20
70004985086,70004985090,4,2788,1770,-20
70006585270,70006585274,4,1490,1375,-20
70008299658,70008299659,1,1534,1340,-20
70009138906,70009138906,0,1051,1648,-20
70014618496,70014618501,5,1484,1367,-20
70016194479,70016194481,2,2228,1143,-20
70017564790,70017564789,-1,946,1935,-20
70017714131,70017714134,3,1619,1333,-20
70019659782,70019659785,3,1241,1205,-20
70021284178,70021284182,4,1332,1229,-20
70025150266,70025150270,4,2587,1224,-20
70026836436,70026836439,3,1448,1297,-20
70027849866,70027849870,4,1944,1553,-20
70029902793,70029902796,3,1266,864,-20
70036339496,70036339497,1,1505,1240,-20
70036798541,70036798545,4,2182,1740,-20
70038702374,70038702394,20,1091,1380,-20
70040033336,70040033339,3,2614,1736,-20
70044196945,70044196949,4,2326,1514,-20
70045150397,70045150400,3,2168,1340,-20
70049120557,70049120562,5,2637,1580,-20
70049519026,70049519030,4,2029,1173,-20
70051168133,70051168137,4,1430,1054,-20
70054101307,70054101309,2,1038,1292,-20
70054704640,70054704642,2,1308,1592,-20
70056698835,70056698837,2,1996,1100,-20
70056760602,70056760607,5,2031,1319,-20
70057609659,70057609662,3,1510,1136,-20
70058665692,70058665695,3,2322,1767,-20
70059984266,70059984270,4,1625,1233,-20
70061148342,70061148347,5,2352,1017,-20
70062349225,70062349232,7,1570,780,-20
70062891402,70062891419,17,1529,1193,-20
70066242269,70066242273,4,1971,1575,-20
70066920065,70066920068,3,1318,1233,-20
70067726747,70067726751,4,1639,1265,-20
70070004675,70070004680,5,2497,1898,-20
70079184355,70079184359,4,1557,737,-20
70083917639,70083917640,1,1249,1395,-20
70085295060,70085295062,2,1858,1570,-20
70085481313,70085481316,3,1793,1621,-20
70085601855,70085601858,3,1528,1217,-20
70087135390,70087135395,5,2622,1313,-20
70088274122,70088274124,2,1468,1180,-20
70091136175,70091136177,2,1133,772,-20
70098392215,70098392215,0,2054,949,-20
70103557142,70103557149,7,1805,1504,-20
70103981116,70103981120,4,1550,1602,-20
70105154252,70105154256,4,1898,1375,-20
70106108896,70106108900,4,1851,1368,-20
70106559238,70106559240,2,1313,1255,-20
70107594755,70107594758,3,1745,1843,-20
70111752830,70111752833,3,2084,1503,-20
70112208200,70112208188,-12,1809,568,-20
70114405491,70114405493,2,2056,1675,-20
70114578856,70114578855,-1,1197,573,-20
70115031429,70115031435,6,4346,1551,-20
70116150026,70116150015,-11,791,246,-20
70116597220,70116597222,2,1759,1413,-20
70116900042,70116900046,4,1928,1117,-20
70119777913,70119777916,3,1955,1255,-20
70120140234,70120140242,8,2263,1706,-20
70120404586,70120404600,14,2044,1040,-20
70120955040,70120955042,2,1759,1495,-20
70121649081,70121649086,5,1755,1192,-20
70123513698,70123513701,3,1364,912,-20
70127490049,70127490051,2,1325,1109,-20
70128592421,70128592427,6,2091,1196,-20
70129318398,70129318401,3,2091,1579,-20
70132467571,70132467571,0,1474,1122,-20
70132843753,70132843754,1,1262,1545,-20
70134393554,70134393561,7,2280,1170,-20
70138401074,70138401093,19,1700,1658,-20
70141507057,70141507061,4,2017,1023,-20
70142330804,70142330806,2,2435,2296,-20
70143140959,70143140961,2,1473,841,-20
70149514316,70149514324,8,5865,848,-20
70150054674,70150054677,3,1914,1257,-20
70153475414,70153475417,3,2195,1205,-20
70155036456,70155036454,-2,3160,4797,-20
70156239526,70156239531,5,1747,1383,-20
70161972093,70161972095,2,2771,1821,-20
70165702867,70165702871,4,1636,993,-20
70177245514,70177245519,5,2330,1325,-20
70178094442,70178094445,3,1743,1461,-20
70179753466,70179753469,3,1869,1328,-20
70184262742,70184262745,3,2070,1893,-20
70186992378,70186992373,-5,2059,8024,-20
70187133529,70187133531,2,1424,1565,-20
70189091822,70189091823,1,1667,1574,-20
70190529020,70190529022,2,2277,1298,-20
70191980443,70191980446,3,814,753,-20
70199161628,70199161631,3,1412,1308,-20
70199705186,70199705186,0,1093,859,-20
70201626337,70201626340,3,1713,1138,-20
70202276982,70202277000,18,1986,1234,-20
70202616542,70202616545,3,1993,1308,-20
70207100902,70207100906,4,1394,1841,-20
70208700909,70208700915,6,2383,1885,-20
70208976498,70208976500,2,1848,1612,-20
70209229009,70209229014,5,1897,1164,-20
70210323442,70210323447,5,1975,1123,-20
70211507819,70211507823,4,1566,1279,-20
70213590040,70213590043,3,1841,2026,-20
70215326053,70215326050,-3,1444,2065,-20
70215783358,70215783363,5,2092,1488,-20
70217575937,70217575941,4,1942,1378,-20
70223031007,70223031010,3,2430,1959,-20
70225733190,70225733193,3,1771,1462,-20
70229829526,70229829531,5,1437,1031,-20
70230213306,70230213307,1,1173,1178,-20
70232635851,70232635857,6,1733,1373,-20
70233349256,70233349258,2,1466,1286,-20
70235256985,70235256984,-1,38085,19900,-20
70236507489,70236507493,4,2005,1564,-20
70238958682,70238958686,4,1609,1730,-20
70242810965,70242810986,21,16940,46649,-20
70243965369,70243965362,-7,1374,6212,-20
70246375098,70246375104,6,1583,1302,-20
70250940513,70250940516,3,1161,991,-20
70252762841,70252762848,7,1829,1886,-20
70254587595,70254587599,4,1564,1668,-20
70254623193,70254623198,5,1972,1539,-20
70255029135,70255029153,18,1578,1328,-20
70259770609,70259770613,4,2235,1571,-20
70260152110,70260152089,-21,532,132,-20
70261060763,70261060759,-4,1159,2280,-20
70261419794,70261419798,4,1742,1806,-20
70261557323,70261557327,4,1803,1494,-20
70261913832,70261913835,3,2147,1756,-20
70262348838,70262348835,-3,2426,4531,-20
70265044791,70265044794,3,1025,1029,-20
70268278910,70268278915,5,2124,1512,-20
70269043313,70269043317,4,1471,1681,-20
70271804378,70271804381,3,1435,1113,-20
70280100757,70280100763,6,1635,1066,-20
70280658934,70280658937,3,1729,1530,-20
70284952130,70284952136,6,2404,1737,-20
70285771566,70285771570,4,2453,1396,-20
70286330086,70286330094,8,3047,1279,-20
70286866662,70286866666,4,2020,1401,-20
70288372199,70288372202,3,1069,987,-20
70288434943,70288434963,20,735,1073,-20
70289883336,70289883342,6,13017,6382,-20
70290202038,70290202041,3,1450,1439,-20
70291879890,70291879890,0,1296,1247,-20
70292630867,70292630870,3,1490,1445,-20
70300332982,70300332983,1,1290,1062,-20
70301737243,70301737246,3,1420,1637,-20
70303618961,70303618961,0,1486,1539,-20
70304502594,70304502598,4,2128,1004,-20
70307081042,70307081044,2,1770,1661,-20
70309529024,70309529027,3,1567,1030,-20
70310080623,70310080626,3,1739,1228,-20
70312975446,70312975451,5,2077,1436,-20
70315014961,70315014966,5,1031,862,-20
70316680249,70316680256,7,10082,3518,-20
70317560957,70317560961,4,896,889,-20
70321004630,70321004631,1,1252,1440,-20
70322758313,70322758315,2,1572,1011,-20
70323201805,70323201809,4,1325,1080,-20
70324884941,70324884947,6,1187,1184,-20
70325031377,70325031381,4,1828,1318,-20
70326163222,70326163201,-21,1454,1318,-20
70327867874,70327867879,5,1637,1590,-20
70330075189,70330075182,-7,1065,3472,-20
70336570845,70336570841,-4,2119,5190,-20
70337495895,70337495897,2,1902,1212,-20
70341821873,70341821877,4,1737,1701,-20
70344591941,70344591943,2,758,1220,-20
70345887575,70345887581,6,3311,2377,-20
70346251478,70346251481,3,1897,1834,-20
70351642642,70351642646,4,1175,1289,-20
70351758298,70351758303,5,1596,1265,-20
70358178885,70358178890,5,1796,1133,-20
70359235016,70359235021,5,1430,1138,-20
70359299050,70359299055,5,1634,1220,-20
70359583061,70359583065,4,1662,1108,-20
70362246660,70362246664,4,1853,1527,-20
70362717915,70362717918,3,2303,1507,-20
70364360617,70364360620,3,2936,2022,-20
70366627381,70366627382,1,1835,1556,-20
70368359473,70368359477,4,1633,1619,-20
70369836756,70369836759,3,3313,2191,-20
70370284704,70370284708,4,1925,1157,-20
70370794781,70370794785,4,2240,1504,-20
70370962686,70370962686,0,1494,1405,-20
70371552434,70371552435,1,1347,1446,-20
70372319674,70372319676,2,1726,1191,-20
70373325656,70373325634,-22,1120,629,-20
70375967259,70375967262,3,1646,1474,-20
70376731518,70376731523,5,1514,1405,-20
70380991220,70380991222,2,1471,1187,-20
70383293262,70383293266,4,2094,1879,-20
70385950483,70385950486,3,1592,1283,-20
70387701666,70387701670,4,1601,1076,-20
70388567988,70388567990,2,2049,1122,-20
70390854754,70390854756,2,2020,1624,-20
70391069040,70391069042,2,1143,1514,-20
70393216368,70393216371,3,1474,1490,-20
70394030193,70394030197,4,2158,2475,-20
70396179903,70396179907,4,1714,1904,-20
70398161114,70398161118,4,1272,950,-20
70398887454,70398887461,7,2357,1172,-20
70401013490,70401013471,-19,1969,1670,-20
70401325127,70401325130,3,1750,1274,-20
70404200049,70404200053,4,1858,1748,-20
70406691556,70406691551,-5,1506,1931,-20
70410144435,70410144439,4,1610,1089,-20
70411686058,70411686061,3,1582,1879,-20
70412405069,70412405073,4,2892,1629,-20
70414911273,70414911276,3,1598,1468,-20
70415550686,70415550691,5,1820,770,-20
70416852527,70416852529,2,1984,1096,-20
70419164742,70419164746,4,2062,1181,-20
70420757546,70420757552,6,2387,1252,-20
70421768886,70421768890,4,1752,926,-20
70424944794,70424944796,2,1289,1341,-20
70426009170,70426009148,-22,1472,1080,-20
70426979458,70426979453,-5,2179,5153,-20
70431803269,70431803271,2,1715,1100,-20
70434738088,70434738090,2,2212,1659,-20
70435909395,70435909399,4,2544,1461,-20
70438450023,70438450026,3,1966,1473,-20
70443850621,70443850624,3,1779,1665,-20
70444101857,70444101862,5,2144,1147,-20
70444952722,70444952726,4,1672,870,-20
70446697854,70446697860,6,2037,1406,-20
70447697280,70447697283,3,1532,1689,-20
70448069974,70448069980,6,2620,1356,-20
70448934534,70448934539,5,1462,1479,-20
70452830981,70452830982,1,2157,1439,-20
70456583102,70456583106,4,2251,1842,-20
70457622750,70457622753,3,1827,1457,-20
70462257897,70462257899,2,1746,1766,-20
70462409218,70462409218,0,1972,1529,-20
70465922686,70465922689,3,1053,880,-20
70472956282,70472956287,5,1797,1248,-20
70475382363,70475382367,4,1508,1131,-20
70476638843,70476638846,3,1872,1587,-20
70477227130,70477227135,5,1941,1218,-20
70477614142,70477614150,8,1569,1039,-20
70480010431,70480010434,3,1437,1242,-20
70482309864,70482309867,3,1419,1301,-20
70487533254,70487533257,3,1656,1509,-20
70487587509,70487587501,-8,1432,7557,-20
70490421563,70490421567,4,1962,1580,-20
70490566266,70490566269,3,1783,1009,-20
70492213406,70492213409,3,2012,1808,-20
70494262166,70494262171,5,1953,1598,-20
70495198438,70495198441,3,1286,1659,-20
70496370392,70496370396,4,1605,1177,-20
70497185092,70497185095,3,1651,1807,-20
70498452174,70498452179,5,1871,1569,-20
70502673771,70502673773,2,1127,1453,-20
70503516610,70503516614,4,2009,1266,-20
70504329707,70504329710,3,1130,915,-20
70504992391,70504992369,-22,1693,2265,-20
70507426465,70507426467,2,1313,1163,-20
70516172289,70516172293,4,1737,1704,-20
70517720299,70517720302,3,2511,1550,-20
70518156820,70518156822,2,2353,1848,-20
70518994850,70518994854,4,1608,1336,-20
70521186033,70521186038,5,1231,1371,-20
70522962546,70522962550,4,2294,1259,-20
70524766277,70524766278,1,1125,1660,-20
70527287799,70527287799,0,1342,1528,-20
70527411760,70527411763,3,1953,1279,-20
70532118327,70532118328,1,1500,1567,-20
70537369663,70537369666,3,1908,1346,-20
70540060403,70540060396,-7,2981,9104,-20
70544200196,70544200197,1,2002,1846,-20
70544973774,70544973778,4,1929,1284,-20
70546107126,70546107131,5,1679,1258,-20
70547098326,70547098330,4,1981,1693,-20
70548406655,70548406657,2,1822,1217,-20
70549633714,70549633718,4,2563,2247,-20
70551357534,70551357538,4,1884,1007,-20
70551973462,70551973467,5,2971,2065,-20
70556037694,70556037697,3,1639,1390,-20
70556276088,70556276092,4,1357,1400,-20
70557396266,70557396270,4,1508,816,-20
70559625870,70559625862,-8,1251,1123,-20
70560387917,70560387920,3,1015,1361,-20
70563426867,70563426871,4,2108,1395,-20
70563918429,70563918434,5,1428,1090,-20
70564155094,70564155099,5,1776,1188,-20
70565073175,70565073179,4,1696,1127,-20
70567231538,70567231543,5,784,623,-20
70571074392,70571074394,2,2240,1168,-20
70572062469,70572062450,-19,1770,1107,-20
70578103597,70578103604,7,6109,1693,-20
70583450857,70583450860,3,1686,1592,-20
70586696981,70586696979,-2,754,1608,-20
70587656305,70587656305,0,1659,1424,-20
70589158986,70589158986,0,1178,2027,-20
70592192040,70592192045,5,1867,1822,-20
70592396882,70592396886,4,1377,1089,-20
70593522373,70593522375,2,2430,1635,-20
70595256238,70595256225,-13,792,491,-20
70595839279,70595839281,2,2254,1010,-20
70597263366,70597263370,4,1489,1345,-20
70597751958,70597751954,-4,1151,3021,-20
70603027048,70603027050,2,2306,1600,-20
70604467646,70604467646,0,2135,1544,-20
70607027009,70607027011,2,2790,1512,-20
70609433278,70609433280,2,1835,1682,-20
70609569472,70609569473,1,1845,1532,-20
70612264551,70612264554,3,2058,1721,-20
70614637091,70614637094,3,2092,1924,-20
70616990369,70616990371,2,1540,1392,-20
70618624353,70618624355,2,1899,1431,-20
70621884026,70621884030,4,1503,872,-20
70623694063,70623694063,0,1051,1125,-20
70626218235,70626218241,6,2186,1536,-20
70626664775,70626664778,3,1536,928,-20
70627672626,70627672612,-14,676,93,-20
70628545514,70628545516,2,1468,1442,-20
70630345954,70630345956,2,1712,1346,-20
70631657966,70631657969,3,1610,769,-20
70632571590,70632571595,5,1848,1427,-20
70634416142,70634416144,2,1942,1765,-20
70634586072,70634586074,2,1345,1090,-20
70634787247,70634787250,3,1167,1112,-20
70637550720,70637550724,4,1995,1564,-20
70638014965,70638014967,2,2747,972,-20
70638278549,70638278554,5,1665,1594,-20
70640275919,70640275922,3,1622,1920,-20
70641640668,70641640669,1,1513,1130,-20
70642351990,70642351996,6,2198,1641,-20
70647719767,70647719773,6,1521,1265,-20
70648719985,70648719989,4,2164,1249,-20
70655335563,70655335565,2,952,1609,-20
70656524361,70656524365,4,1740,1170,-20
70656834034,70656834038,4,1811,1198,-20
70657262476,70657262457,-19,1235,482,-20
70657856796,70657856798,2,2572,2285,-20
70658775877,70658775878,1,1634,1104,-20
70659786759,70659786766,7,1779,1479,-20
70661495514,70661495519,5,2217,1384,-20
70661933623,70661933633,10,2140,1395,-20
70669718836,70669718842,6,1830,1270,-20
70670492018,70670492020,2,1680,1287,-20
70671315011,70671315017,6,5393,2045,-20
70671730520,70671730523,3,1528,1012,-20
70672029617,70672029619,2,1663,1768,-20
70672462913,70672462916,3,1943,1578,-20
70674063853,70674063860,7,2460,1469,-20
70674754561,70674754564,3,1376,1261,-20
70675196475,70675196479,4,2011,1379,-20
70678800499,70678800504,5,1253,885,-20
70681371690,70681371695,5,2271,1577,-20
70682047157,70682047161,4,1543,1882,-20
70684153103,70684153106,3,2939,1802,-20
70684691069,70684691074,5,1772,1498,-20
70686085784,70686085786,2,1573,1451,-20
70686584235,70686584218,-17,1071,220,-20
70692237466,70692237467,1,2128,1512,-20
70693213882,70693213885,3,1783,1084,-20
70694468822,70694468827,5,1990,1652,-20
70697138767,70697138771,4,1467,1121,-20
70697939086,70697939087,1,2487,1558,-20
70699746069,70699746073,4,1598,1574,-20
70700806631,70700806635,4,1887,1339,-20
70704020369,70704020374,5,4545,1738,-20
70706343454,70706343455,1,1085,1163,-20
70711183368,70711183370,2,1584,1310,-20
70713464109,70713464115,6,1680,1013,-20
70717161671,70717161674,3,1886,1251,-20
70722580410,70722580413,3,1668,1528,-20
70724752093,70724752098,5,1369,1336,-20
70725748322,70725748326,4,1887,1208,-20
70729093048,70729093050,2,1579,816,-20
70732026796,70732026799,3,350,1098,-20
70732985599,70732985601,2,1893,1405,-20
70733604062,70733604067,5,1269,1045,-20
70738505890,70738505893,3,1838,1808,-20
70739224396,70739224403,7,2086,1055,-20
70740342481,70740342483,2,1516,1220,-20
70743147666,70743147670,4,2163,1683,-20
70744014430,70744014434,4,2602,1376,-20
70747105214,70747105217,3,1061,1412,-20
70750470771,70750470775,4,1519,1352,-20
70755023855,70755023858,3,873,1455,-20
70756616683,70756616686,3,2135,1809,-20
70758901746,70758901750,4,1630,1486,-20
70759526709,70759526729,20,702,176,-20
70761689892,70761689887,-5,1596,1302,-20
70763281701,70763281705,4,921,584,-20
70770049940,70770049943,3,2108,1856,-20
70774796826,70774796829,3,2560,1418,-20
70779068575,70779068579,4,1469,1818,-20
70782779143,70782779146,3,1522,783,-20
70785177502,70785177506,4,1866,1345,-20
70786580403,70786580406,3,2352,1711,-20
70787446477,70787446482,5,3149,1523,-20
70788083155,70788083158,3,2041,1703,-20
70790189433,70790189438,5,2825,2137,-20
70791259011,70791259014,3,1806,1427,-20
70798151918,70798151921,3,1682,1480,-20
70798751102,70798751105,3,1841,1379,-20
70800146924,70800146927,3,1946,1681,-20
70801295746,70801295749,3,1810,1218,-20
70802174721,70802174723,2,1642,1721,-20
70803872323,70803872326,3,1516,1488,-20
70805169686,70805169690,4,1731,951,-20
70808306899,70808306902,3,1729,1227,-20
70808388731,70808388734,3,1660,1163,-20
70811598858,70811598866,8,3281,1245,-20
70811743630,70811743612,-18,1241,718,-20
70813346956,70813346958,2,2212,1390,-20
70814578127,70814578131,4,1948,1540,-20
70820708348,70820708351,3,2135,1140,-20
70822963028,70822963031,3,1662,1892,-20
70824035101,70824035098,-3,2745,5785,-20
70825952517,70825952520,3,2052,1310,-20
70827635283,70827635290,7,3880,1361,-20
70828019229,70828019237,8,5549,2130,-20
70828815908,70828815916,8,12162,31466,-20
70829940414,70829940417,3,1776,1419,-20
70830630365,70830630370,5,1547,1098,-20
70835555521,70835555526,5,1621,1179,-20
70840715417,70840715416,-1,1618,2630,-20
70842436310,70842436315,5,1122,720,-20
70842551031,70842551030,-1,36974,64696,-20
70844553368,70844553371,3,1668,881,-20
70847991670,70847991672,2,1489,1462,-20
70849095886,70849095881,-5,961,4579,-20
70849332900,70849332904,4,2279,1848,-20
70850542558,70850542562,4,2070,1278,-20
70854989599,70854989603,4,1800,1765,-20
70855177094,70855177115,21,887,105,-20
70856641114,70856641115,1,2273,1742,-20
70856728682,70856728684,2,1884,2201,-20
70858927382,70858927386,4,1907,1720,-20
70859180796,70859180800,4,1492,1289,-20
70861457121,70861457119,-2,1236,1822,-20
70863055995,70863055998,3,2050,1900,-20
70864328040,70864328043,3,1956,1688,-20
70866165714,70866165717,3,1805,1811,-20
70868721173,70868721174,1,1704,1552,-20
70872581105,70872581104,-1,1251,1688,-20
70872933249,70872933254,5,1782,1322,-20
70880300570,70880300574,4,2119,1702,-20
70886122422,70886122427,5,2812,1349,-20
70890920509,70890920514,5,2163,1611,-20
70894032625,70894032630,5,3097,1486,-20
70897444891,70897444890,-1,1347,1522,-20
70897701575,70897701578,3,1906,1387,-20
70900075072,70900075075,3,2114,1606,-20
70900224713,70900224718,5,2861,1355,-20
70901029036,70901029038,2,1455,1206,-20
70909476799,70909476803,4,2871,1321,-20
70913148434,70913148438,4,1934,1791,-20
70913339706,70913339688,-18,5108,397,-20
70917571198,70917571194,-4,1126,3446,-20
70919155201,70919155203,2,2264,1451,-20
70919335029,70919335031,2,2666,1524,-20
70926584123,70926584126,3,1990,1380,-20
70930107037,70930107040,3,2532,2443,-20
70930349877,70930349881,4,1487,1103,-20
70932485714,70932485717,3,2201,2112,-20
70932970684,70932970688,4,1583,865,-20
70933179542,70933179545,3,1906,1402,-20
70935394950,70935394951,1,1951,1829,-20
70942608197,70942608202,5,1893,1573,-20
70944153322,70944153322,0,1505,1641,-20
70944503714,70944503722,8,1153,565,-20
70947661641,70947661642,1,2106,1357,-20
70955383558,70955383563,5,2221,1328,-20
70962572279,70962572281,2,1591,1950,-20
70972480299,70972480303,4,1886,1170,-20
70975515254,70975515257,3,2073,1262,-20
70976167147,70976167144,-3,878,2539,-20
70980688665,70980688667,2,1077,1263,-20
70984152062,70984152063,1,1052,597,-20
70984256739,70984256722,-17,1530,1148,-20
70984574706,70984574713,7,1692,1507,-20
70986288477,70986288481,4,1740,995,-20
70988040314,70988040317,3,1854,1282,-20
70988193507,70988193511,4,1805,1618,-20
70990249434,70990249435,1,1625,1106,-20
70993768063,70993768062,-1,1454,1145,-20
70994097184,70994097190,6,1851,1454,-20
70994559370,70994559373,3,2522,1572,-20
70994943566,70994943570,4,1971,1827,-20
70995306409,70995306411,2,1119,1352,-20
71001850005,71001850006,1,1950,1615,-20
71002015926,71002015931,5,1617,1795,-20
71004337305,71004337307,2,2194,1647,-20
71004551742,71004551745,3,1853,1039,-20
71006932860,71006932865,5,2204,1865,-20
71007743105,71007743109,4,1533,1075,-20
71011249479,71011249477,-2,1144,2060,-20
71013972006,71013972012,6,2831,1629,-20
71016521289,71016521291,2,3499,3147,-20
71017310429,71017310432,3,1138,797,-20
71018331406,71018331409,3,2700,1843,-20
71018437270,71018437275,5,1821,1256,-20
71018847045,71018847048,3,1697,1043,-20
71020764110,71020764112,2,2784,1698,-20
71022182557,71022182560,3,1271,1518,-20
71023058354,71023058357,3,1827,1235,-20
71024152003,71024152007,4,1528,1542,-20
71024864502,71024864506,4,3468,56470,-20
71026664878,71026664881,3,2235,1679,-20
71029041590,71029041593,3,915,1113,-20
71030696866,71030696869,3,1886,1411,-20
71032520007,71032520011,4,2243,1980,-20
71032946810,71032946814,4,1274,1481,-20
71034387629,71034387631,2,1832,1130,-20
71041056525,71041056528,3,1754,1686,-20
71042941937,71042941938,1,1439,1260,-20
71049648689,71049648691,2,1855,2083,-20
71050988506,71050988507,1,2523,1495,-20
71053769632,71053769635,3,1614,1177,-20
71055344690,71055344693,3,1117,1163,-20
71057355587,71057355590,3,1825,1477,-20
71057657735,71057657738,3,1705,1447,-20
71060196486,71060196494,8,3637,1149,-20
71061662745,71061662749,4,1762,1393,-20
71066137134,71066137137,3,2311,1474,-20
71066854898,71066854904,6,2429,1576,-20
71068587842,71068587840,-2,1478,1268,-20
71071005102,71071005106,4,1534,1101,-20
71073167329,71073167330,1,1151,938,-20
71075877034,71075877035,1,1912,1682,-20
71075917712,71075917715,3,2222,1263,-20
71076291764,71076291767,3,1760,1371,-20
71077271726,71077271726,0,816,1556,-20
71077323113,71077323117,4,2244,1040,-20
71081065868,71081065866,-2,1050,1908,-20
71083057031,71083057034,3,2331,2107,-20
71088934779,71088934782,3,2431,1932,-20
71089064689,71089064693,4,2357,1158,-20
71089808178,71089808179,1,1295,1309,-20
71091761547,71091761550,3,1984,1277,-20
71096836518,71096836523,5,1884,1364,-20
71098778311,71098778314,3,1628,1150,-20
71098975155,71098975140,-15,1180,959,-20
71101074842,71101074846,4,1305,1435,-20
71107228871,71107228891,20,2704,1885,-20
71108373409,71108373413,4,1619,1935,-20
71110818294,71110818295,1,1499,1579,-20
71115284043,71115284047,4,1061,849,-20
71116599085,71116599088,3,2036,1724,-20
71116657105,71116657109,4,2264,1650,-20
71117962502,71117962503,1,2093,906,-20
71118525507,71118525511,4,2629,2353,-20
71118961072,71118961077,5,2177,1965,-20
71129128774,71129128778,4,2307,1656,-20
71131680783,71131680785,2,572,836,-20
71133172445,71133172447,2,1411,1009,-20
71135426666,71135426671,5,2856,2073,-20
71136051502,71136051506,4,2491,1944,-20
71136809729,71136809735,6,1931,1152,-20
71137946098,71137946105,7,3606,1498,-20
71143931003,71143931009,6,9058,28564,-20
71144535614,71144535618,4,1244,977,-20
71149905622,71149905626,4,1524,1193,-20
71151055082,71151055086,4,811,974,-20
71156025377,71156025382,5,1107,650,-20
71156435082,71156435083,1,1933,1769,-20
71157520278,71157520282,4,1709,1528,-20
71159168681,71159168683,2,1525,1054,-20
71159933622,71159933625,3,1501,1475,-20
71161510913,71161510915,2,1968,1409,-20
71161800401,71161800405,4,1632,1534,-20
71164789446,71164789450,4,1826,1701,-20
71168323166,71168323166,0,610,795,-20
71168691317,71168691313,-4,2018,4656,-20
71170304490,71170304492,2,1421,1625,-20
71172923246,71172923250,4,1759,1414,-20
71173568506,71173568510,4,2916,2580,-20
71180876855,71180876861,6,2445,1548,-20
71180916736,71180916739,3,2493,1374,-20
71183744577,71183744582,5,1694,1825,-20
71184847086,71184847091,5,2328,1591,-20
71186927897,71186927901,4,1146,1664,-20
71194696191,71194696195,4,1579,1562,-20
71195434369,71195434368,-1,985,1912,-20
71196273040,71196273045,5,3637,2340,-20
71196787176,71196787173,-3,1230,962,-20
71197482742,71197482744,2,1346,1340,-20
71201731658,71201731661,3,1194,951,-20
71203191710,71203191711,1,1630,817,-20
71207130125,71207130126,1,2383,2141,-20
71207943067,71207943071,4,1251,957,-20
71210957833,71210957837,4,41260,39641,-20
71211076462,71211076462,0,517,321,-20
71215426410,71215426415,5,319,3923,-20
71221364248,71221364251,3,1878,1070,-20
71222294927,71222294944,17,1270,1062,-20
71222587406,71222587410,4,1909,1125,-20
71222764709,71222764711,2,2042,1315,-20
71223436992,71223436995,3,1974,1128,-20
71223474767,71223474745,-22,1710,1419,-20
71224464850,71224464854,4,2048,1625,-20
71226906724,71226906728,4,1779,1540,-20
71227926393,71227926398,5,1769,1282,-20
71228966670,71228966665,-5,1359,6100,-20
71230273421,71230273425,4,1655,1011,-20
71230396377,71230396381,4,1357,1002,-20
71231882250,71231882253,3,1296,1140,-20
71234260536,71234260539,3,1643,1355,-20
71235419821,71235419825,4,1801,1253,-20
71235696209,71235696211,2,2295,1163,-20
71243708671,71243708667,-4,807,2082,-20
71246160815,71246160818,3,1925,1534,-20
71246715210,71246715209,-1,1280,1882,-20
71250916445,71250916448,3,1243,1068,-20
71257540810,71257540814,4,2487,1882,-20
71257893302,71257893299,-3,1529,2429,-20
71258027444,71258027446,2,1582,1560,-20
71260479501,71260479505,4,1389,1322,-20
71261711279,71261711285,6,2745,1617,-20
71264057262,71264057266,4,2140,2308,-20
71265028094,71265028095,1,1391,2157,-20
71270622104,71270622089,-15,197,853,-20
71271288308,71271288311,3,1922,1046,-20
71273193089,71273193092,3,1046,830,-20
71274484574,71274484575,1,1594,1604,-20
71275605245,71275605247,2,9322,9111,-20
71276932046,71276932049,3,1847,1741,-20
71282186757,71282186761,4,2093,1334,-20
71295824678,71295824682,4,1533,1546,-20
71295949513,71295949513,0,1648,2124,-20
71296860427,71296860430,3,1366,1217,-20
71301831834,71301831835,1,1251,1299,-20
71305562295,71305562299,4,1730,1413,-20
71306806139,71306806140,1,1897,1694,-20
71308235694,71308235697,3,3003,1792,-20
71308310965,71308310967,2,1709,1616,-20
71311740326,71311740330,4,1530,1798,-20
71311773778,71311773764,-14,1659,1505,-20
71313401010,71313401014,4,1158,1478,-20
71314904417,71314904420,3,1671,1521,-20
71316383446,71316383447,1,1210,1209,-20
71319390588,71319390610,22,1249,1078,-20
71320211670,71320211674,4,1652,1231,-20
71322789531,71322789532,1,1414,1018,-20
71324804097,71324804098,1,1614,1791,-20
71341132559,71341132560,1,733,559,-20
71343427566,71343427567,1,1284,1001,-20
71343916263,71343916269,6,2247,1967,-20
71347747710,71347747713,3,1852,1044,-20
71349698705,71349698710,5,1737,1751,-20
71350646223,71350646226,3,2182,1892,-20
71351382931,71351382935,4,1699,1849,-20
71352390773,71352390777,4,1670,942,-20
71353459877,71353459880,3,1577,1705,-20
71354716042,71354716046,4,1522,843,-20
71360010109,71360010113,4,1561,1921,-20
71361633353,71361633354,1,2128,1317,-20
71361889445,71361889459,14,1831,1374,-20
71365508130,71365508134,4,1550,1314,-20
71367133790,71367133795,5,2081,1476,-20
71371630752,71371630757,5,1650,1278,-20
71373386329,71373386330,1,1948,2418,-20
71373465999,71373465994,-5,2531,6506,-20
71373784793,71373784794,1,1297,985,-20
71375660495,71375660498,3,1618,1812,-20
71377296535,71377296539,4,2000,1357,-20
71381215486,71381215490,4,1914,1746,-20
71381817445,71381817450,5,2091,2110,-20
71386418066,71386418071,5,2759,1441,-20
71387127546,71387127548,2,1867,1141,-20
71388781878,71388781879,1,1878,1594,-20
71390278078,71390278081,3,1639,1687,-20
71391303473,71391303476,3,2279,1259,-20
71397122982,71397122989,7,3546,1211,-20
71398774986,71398774991,5,1899,1367,-20
71404089014,71404089019,5,1901,1460,-20
71405192487,71405192490,3,2078,1329,-20
71405428322,71405428337,15,1382,1082,-20
71406395798,71406395801,3,2100,1249,-20
71409415929,71409415933,4,2175,1228,-20
71409484508,71409484514,6,2332,945,-20
71410523538,71410523538,0,1271,2071,-20
71412691245,71412691246,1,914,733,-20
71413278798,71413278810,12,1147,1023,-20
71414056070,71414056075,5,1905,1452,-20
71415164821,71415164825,4,1886,985,-20
71418484587,71418484587,0,1275,1345,-20
71421074400,71421074405,5,2048,1354,-20
71423129948,71423129956,8,2678,1720,-20
71428316889,71428316892,3,2439,1885,-20
71428345797,71428345801,4,2388,1237,-20
71431017958,71431017954,-4,760,1708,-20
71431626426,71431626430,4,1748,1560,-20
71435058749,71435058754,5,6199,27407,-20
71439980114,71439980117,3,1652,1123,-20
71440189631,71440189608,-23,1465,664,-20
71442020903,71442020906,3,1758,1076,-20
71443154202,71443154205,3,2017,1370,-20
71444161468,71444161473,5,2115,1222,-20
71445440623,71445440627,4,1655,1570,-20
71445484018,71445484022,4,2841,1592,-20
71447301631,71447301636,5,2005,1838,-20
71448769644,71448769647,3,1739,1408,-20
71449084203,71449084207,4,1598,1282,-20
71454175289,71454175292,3,1638,1254,-20
71456231015,71456231015,0,1357,2045,-20
71458654488,71458654492,4,2456,1312,-20
71459612040,71459612041,1,1552,1138,-20
71460386584,71460386586,2,2757,1521,-20
71466543006,71466543010,4,2355,946,-20
71468550960,71468550961,1,2039,2052,-20
71469457424,71469457418,-6,1303,9022,-20
71471435774,71471435775,1,1122,1088,-20
71472023479,71472023457,-22,2219,1526,-20
71472305670,71472305673,3,1271,1535,-20
71474334517,71474334522,5,1659,888,-20
71475200929,71475200933,4,1780,1348,-20
71477845938,71477845942,4,2136,1577,-20
71477934709,71477934711,2,1680,1298,-20
71478271361,71478271365,4,1803,1016,-20
71482042625,71482042626,1,1481,1530,-20
71485426327,71485426330,3,1917,1669,-20
71486663689,71486663694,5,1726,1695,-20
71488798114,71488798116,2,1945,2125,-20
71488862131,71488862126,-5,878,1765,-20
71490359074,71490359078,4,1433,1256,-20
71492667762,71492667757,-5,1297,4158,-20
71498302464,71498302467,3,2133,1527,-20
71503055068,71503055072,4,1867,1295,-20
71505061363,71505061366,3,1785,1265,-20
71505957323,71505957305,-18,1891,1019,-20
71508317132,71508317126,-6,1157,1477,-20
71509802791,71509802795,4,1394,1249,-20
71513719755,71513719757,2,1752,1229,-20
71514609398,71514609402,4,1736,1361,-20
71519963282,71519963285,3,1382,1718,-20
71520637859,71520637859,0,833,1205,-20
71523547255,71523547262,7,1791,1109,-20
71524067830,71524067834,4,2091,1614,-20
71524137033,71524137038,5,1407,907,-20
71525029307,71525029310,3,1720,1441,-20
71525458785,71525458788,3,1993,1227,-20
71526623661,71526623662,1,1681,1474,-20
71531467798,71531467802,4,2151,1901,-20
71537369935,71537369939,4,1478,1443,-20
71538102854,71538102859,5,1573,1292,-20
71541683546,71541683547,1,1687,1185,-20
71541714799,71541714816,17,1505,1475,-20
71545092492,71545092496,4,1118,926,-20
71546504539,71546504544,5,2159,1163,-20
71547934254,71547934257,3,2373,1909,-20
71548388170,71548388173,3,1673,1095,-20
71553680297,71553680298,1,1487,1448,-20
71554055811,71554055816,5,2077,1738,-20
71554432077,71554432079,2,1497,1005,-20
71555569700,71555569704,4,2656,1575,-20
71557973716,71557973722,6,2367,1588,-20
71560785047,71560785051,4,1375,1298,-20
71563022458,71563022461,3,2331,2284,-20
71565235418,71565235421,3,1620,1352,-20
71565508410,71565508411,1,1751,1062,-20
71566371974,71566371978,4,2140,1464,-20
71567674150,71567674153,3,2337,1465,-20
71569263648,71569263650,2,1714,874,-20
71570068316,71570068319,3,1934,1396,-20
71572670122,71572670129,7,2782,1296,-20
71578955253,71578955257,4,1921,1250,-20
71579834818,71579834822,4,2128,1853,-20
71581024220,71581024218,-2,1468,2787,-20
71583736797,71583736793,-4,1409,3645,-20
71584707950,71584707945,-5,1072,2337,-20
71585323466,71585323461,-5,1275,5035,-20
71587504458,71587504462,4,2107,1327,-20
71587561678,71587561699,21,2364,1397,-20
71589758013,71589758017,4,1413,1449,-20
71592759895,71592759899,4,2681,1681,-20
71594281774,71594281779,5,1865,1272,-20
71597114854,71597114854,0,1179,871,-20
71601941625,71601941627,2,2017,1610,-20
71602610402,71602610406,4,1886,1637,-20
71607576723,71607576709,-14,1262,1223,-20
71608629777,71608629782,5,1999,1182,-20
71609487311,71609487314,3,2376,1346,-20
71616355806,71616355811,5,2060,1471,-20
71619858878,71619858881,3,1672,1633,-20
71627239130,71627239136,6,1906,1367,-20
71630886897,71630886900,3,2211,1746,-20
71634639315,71634639320,5,3027,1748,-20
71635532133,71635532144,11,2010,928,-20
71636127253,71636127255,2,1164,1459,-20
71637586759,71637586757,-2,1124,1961,-20
71639476243,71639476245,2,1291,1692,-20
71640782343,71640782354,11,13093,27775,-20
71645426386,71645426383,-3,1095,857,-20
71646536002,71646536005,3,2509,1388,-20
71647568051,71647568045,-6,1568,2468,-20
71649178274,71649178279,5,2236,1346,-20
71654317795,71654317799,4,1687,1038,-20
71657284405,71657284406,1,1487,1635,-20
71660700533,71660700538,5,2315,1400,-20
71661138294,71661138298,4,3500,2102,-20
71662674973,71662674975,2,1459,1154,-20
71663462819,71663462822,3,2238,1239,-20
71665213261,71665213264,3,1848,1807,-20
71665336980,71665336986,6,2641,1622,-20
71671476634,71671476637,3,2106,1400,-20
71677954087,71677954085,-2,1102,2090,-20
71678485134,71678485137,3,1915,1440,-20
71680171182,71680171186,4,2664,1721,-20
71680348119,71680348124,5,2469,1521,-20
71681017446,71681017450,4,1478,1053,-20
71683696517,71683696519,2,1876,1200,-20
71684899203,71684899205,2,2307,1762,-20
71685534237,71685534240,3,2004,2567,-20
71685715486,71685715487,1,3056,1839,-20
71685983031,71685983036,5,1707,1473,-20
71686456299,71686456301,2,1581,1820,-20
71687360190,71687360194,4,1106,823,-20
71688448050,71688448053,3,2412,2319,-20
71689987499,71689987503,4,2533,1849,-20
71691093030,71691093036,6,1630,1336,-20
71691583187,71691583192,5,1449,1147,-20
71695257317,71695257319,2,1708,1706,-20
71695988270,71695988274,4,1550,685,-20
71700274627,71700274630,3,1904,1358,-20
71704595621,71704595625,4,1962,1616,-20
71705689141,71705689139,-2,2489,4007,-20
71705797849,71705797853,4,1539,1324,-20
71710311973,71710311973,0,1259,1162,-20
71713696491,71713696495,4,1250,1116,-20
71716828329,71716828331,2,1955,1150,-20
71719976738,71719976740,2,1403,1498,-20
71721925611,71721925614,3,1815,1536,-20
71723407692,71723407694,2,1588,1266,-20
71725077282,71725077276,-6,467,205,-20
71726618958,71726618962,4,1757,1359,-20
71729505305,71729505307,2,1769,1725,-20
71729557928,71729557934,6,1903,1928,-20
71729602786,71729602794,8,1602,1562,-20
71730251586,71730251588,2,1679,1614,-20
71732361262,71732361266,4,1359,1431,-20
71735788824,71735788827,3,1126,1097,-20
71737197417,71737197419,2,2183,1896,-20
71737387721,71737387725,4,1310,1094,-20
71739060094,71739060094,0,1652,899,-20
71743217266,71743217262,-4,1144,4230,-20
71743787195,71743787195,0,1477,999,-20
71744220047,71744220047,0,1974,1629,-20
71750062137,71750062141,4,1813,1235,-20
71752607652,71752607653,1,1568,1775,-20
71754133686,71754133691,5,1203,1326,-20
71758208906,71758208910,4,1510,988,-20
71768645813,71768645818,5,1828,1661,-20
71770101823,71770101828,5,1312,1365,-20
71771175578,71771175582,4,1871,1075,-20
71772710301,71772710303,2,1433,1280,-20
71780996466,71780996471,5,1550,1016,-20
71783503392,71783503398,6,1743,1334,-20
71784150989,71784150992,3,1313,1247,-20
71789494429,71789494431,2,1112,968,-20
71792661494,71792661497,3,1934,1432,-20
71795069363,71795069358,-5,1157,4398,-20
71797735967,71797735967,0,1374,1668,-20
71798212248,71798212250,2,1287,998,-20
71799239052,71799239043,-9,1363,869,-20
71802761162,71802761164,2,1376,1212,-20
71806623166,71806623178,12,1245,1212,-20
71808580718,71808580722,4,1534,1197,-20
71809797390,71809797393,3,2258,1761,-20
71809998885,71809998888,3,2095,1670,-20
71810287259,71810287262,3,1420,1608,-20
71810776630,71810776632,2,36372,49345,-20
71813119152,71813119155,3,1273,1340,-20
71817855261,71817855263,2,2276,1784,-20
71818790939,71818790942,3,1656,1214,-20
71821142606,71821142609,3,1523,1530,-20
71823549845,71823549849,4,2056,1559,-20
71825836421,71825836424,3,2425,1351,-20
71826660050,71826660056,6,3117,2478,-20
71827206316,71827206319,3,1325,1480,-20
71829253329,71829253331,2,2278,1824,-20
71829684679,71829684682,3,1552,1587,-20
71830269103,71830269108,5,2682,1152,-20
71833401337,71833401341,4,1946,1500,-20
71835912422,71835912426,4,2350,1444,-20
71840793467,71840793471,4,2244,1361,-20
71842547027,71842547031,4,1425,836,-20
71843261654,71843261676,22,1577,943,-20
71845447342,71845447344,2,2785,1546,-20
71846574174,71846574178,4,1830,1017,-20
71846683190,71846683210,20,987,900,-20
71847502183,71847502186,3,1848,927,-20
71850186106,71850186109,3,1605,1452,-20
71854041688,71854041691,3,7175,21139,-20
71858087200,71858087203,3,2540,1399,-20
71860000960,71860000966,6,2676,1376,-20
71862913274,71862913270,-4,1262,2911,-20
71864553025,71864553023,-2,775,507,-20
71865872137,71865872141,4,2323,1734,-20
71870550562,71870550566,4,1315,1346,-20
71870765138,71870765146,8,1389,1408,-20
71871241318,71871241323,5,1519,1495,-20
71874762670,71874762673,3,1734,1372,-20
71877766530,71877766532,2,1480,1641,-20
71879500939,71879500941,2,1094,1515,-20
71881502634,71881502636,2,1068,1435,-20
71882162094,71882162098,4,2321,1878,-20
71883342283,71883342286,3,1208,1181,-20
71887432849,71887432850,1,1772,1709,-20
71892194883,71892194886,3,2465,1365,-20
71892224539,71892224524,-15,917,956,-20
71897424979,71897424982,3,2211,1773,-20
71897510992,71897510995,3,2029,995,-20
71900379178,71900379180,2,2000,1629,-20
71901046866,71901046869,3,1956,1147,-20
71901516023,71901516026,3,2031,1812,-20
71901950598,71901950599,1,1836,1060,-20
71902133012,71902133015,3,1690,1522,-20
71905292259,71905292262,3,1409,1077,-20
71905349572,71905349571,-1,2221,3276,-20
71906458067,71906458067,0,1670,1430,-20
71906770549,71906770549,0,1985,2061,-20
71908410852,71908410852,0,1519,1431,-20
71909664091,71909664091,0,2935,4207,-20
71913017461,71913017464,3,1522,1316,-20
71916472629,71916472634,5,990,726,-20
71924991710,71924991713,3,2223,1675,-20
71930588307,71930588311,4,2274,1499,-20
71934700103,71934700109,6,3520,1552,-20
71939023540,71939023543,3,1701,1663,-20
71939263721,71939263721,0,3112,3828,-20
71942562964,71942562969,5,2675,1291,-20
71946021628,71946021634,6,4190,2885,-20
71946143023,71946143026,3,2072,1356,-20
71946506278,71946506278,0,1759,2150,-20
71949274561,71949274564,3,2151,1687,-20
71950766005,71950766004,-1,1444,1442,-20
71954656197,71954656193,-4,718,1536,-20
71955896657,71955896662,5,1900,1400,-20
71956955251,71956955256,5,1927,1633,-20
71961135632,71961135634,2,2346,1357,-20
71965949102,71965949106,4,923,812,-20
71968316601,71968316603,2,1935,1449,-20
71970761259,71970761262,3,2906,2310,-20
71970959659,71970959662,3,1847,1646,-20
71971526617,71971526622,5,1400,1438,-20
71975378086,71975378089,3,2081,1436,-20
71976882766,71976882769,3,2200,1413,-20
71979518875,71979518878,3,1926,2083,-20
71980161934,71980161938,4,1850,1094,-20
71980868218,71980868218,0,1253,1133,-20
71982147002,71982147004,2,1522,1451,-20
71983611716,71983611718,2,1560,1525,-20
71987110774,71987110769,-5,1244,2472,-20
71990423490,71990423485,-5,1347,4290,-20
71992721265,71992721270,5,1737,1601,-20
71994537576,71994537582,6,3998,2358,-20
71994767969,71994767974,5,3342,1725,-20
71999571840,71999571843,3,2657,1368,-20
72004623727,72004623730,3,1746,1263,-20
72005077490,72005077493,3,1250,1027,-20
72005405842,72005405845,3,1769,1495,-20
72008510478,72008510474,-4,1204,1507,-20
72010382757,72010382761,4,1572,1849,-20
72010601013,72010601016,3,1687,1612,-20
72014779369,72014779373,4,2053,1683,-20
72014908342,72014908342,0,1720,2019,-20
72015014778,72015014782,4,1455,1233,-20
72015211669,72015211672,3,1610,1578,-20
72015851833,72015851836,3,2151,2040,-20
72016427819,72016427823,4,2204,1913,-20
72016674338,72016674342,4,1778,1327,-20
72016887057,72016887062,5,1662,1298,-20
72017625835,72017625838,3,1433,1764,-20
72018308195,72018308198,3,1576,1288,-20
72021557327,72021557329,2,1690,1558,-20
72022406246,72022406250,4,1354,1127,-20
72022777625,72022777628,3,2095,1559,-20
72022865274,72022865279,5,1633,1217,-20
72027478930,72027478937,7,3339,1620,-20
72029400934,72029400937,3,1469,1612,-20
72030831322,72030831326,4,1358,1462,-20
72032946713,72032946715,2,1540,1492,-20
72032990914,72032990898,-16,2085,1269,-20
72033701819,72033701822,3,2215,1097,-20
72036482770,72036482751,-19,1244,684,-20
72038279523,72038279527,4,2463,2267,-20
72039460277,72039460283,6,4675,1797,-20
72039674474,72039674478,4,1707,1742,-20
72040273158,72040273160,2,1795,1762,-20
72042223639,72042223641,2,1557,1386,-20
72042880035,72042880038,3,3023,1558,-20
72048091020,72048091022,2,1774,1774,-20
72048927485,72048927487,2,1426,1272,-20
72049507930,72049507935,5,2015,1542,-20
72050623597,72050623606,9,3561,1435,-20
72051387849,72051387836,-13,2262,1124,-20
72052628811,72052628814,3,2140,1350,-20
72054220581,72054220562,-19,1599,1056,-20
72055020562,72055020566,4,2005,1332,-20
72062551982,72062551986,4,2106,1796,-20
72065258088,72065258090,2,2582,1733,-20
72065641834,72065641833,-1,1199,2170,-20
72067221914,72067221917,3,2096,1633,-20
72067408528,72067408530,2,1767,1578,-20
72070420069,72070420073,4,1950,1850,-20
72072523535,72072523539,4,1758,1382,-20
72073323337,72073323339,2,1921,2331,-20
72076066113,72076066116,3,1888,1490,-20
72076691954,72076691959,5,2299,1180,-20
72077125546,72077125549,3,2248,1851,-20
72079861673,72079861679,6,1448,1477,-20
72081080639,72081080644,5,1950,1685,-20
72082239630,72082239633,3,1772,1467,-20
72085136589,72085136600,11,2682,1109,-20
72085467293,72085467297,4,1874,1377,-20
72086354608,72086354609,1,1587,1871,-20
72087623634,72087623638,4,1901,1387,-20
72090074022,72090074025,3,1498,1348,-20
72090468034,72090468041,7,3306,1570,-20
72092617067,72092617071,4,1401,762,-20
72093953558,72093953563,5,1777,1623,-20
72097589155,72097589157,2,1246,824,-20
72099994915,72099994920,5,1214,1141,-20
72101076633,72101076635,2,1732,1236,-20
72101388565,72101388571,6,1118,925,-20
72108254781,72108254786,5,2241,1439,-20
72110469578,72110469581,3,1586,1406,-20
72111021083,72111021088,5,1989,1112,-20
72111804377,72111804379,2,2069,1524,-20
72112050884,72112050886,2,1113,1396,-20
72115326391,72115326394,3,1362,1088,-20
72115386946,72115386950,4,1939,1772,-20
72117926971,72117926974,3,2181,1509,-20
72118379875,72118379880,5,2232,1059,-20
72123791400,72123791405,5,2050,1251,-20
72125164901,72125164899,-2,22504,47832,-20
72126838343,72126838346,3,1421,1224,-20
72126942947,72126942949,2,1753,1560,-20
72127138398,72127138401,3,2326,1439,-20
72129016239,72129016242,3,2632,2059,-20
72129603207,72129603210,3,1993,1808,-20
72129658148,72129658150,2,2418,1439,-20
72130304604,72130304606,2,1971,1528,-20
72133319551,72133319558,7,2239,1223,-20
72133689897,72133689898,1,1599,1220,-20
72135926033,72135926037,4,1860,1586,-20
72138037647,72138037651,4,1669,1103,-20
72138877097,72138877101,4,1824,1056,-20
72140124369,72140124374,5,2637,1208,-20
72140850146,72140850147,1,1767,2033,-20
72143333161,72143333166,5,2058,1631,-20
72143540109,72143540114,5,1061,1594,-20
72143782874,72143782878,4,1868,2070,-20
72144792819,72144792822,3,1736,1394,-20
72145829655,72145829659,4,1447,1424,-20
72148759935,72148759938,3,2589,1326,-20
72149119271,72149119289,18,482,661,-20
72150529099,72150529102,3,2340,1309,-20
72152244816,72152244822,6,2602,1253,-20
72153689848,72153689851,3,1637,1355,-20
72157062665,72157062670,5,4561,2166,-20
72160045031,72160045034,3,1947,1359,-20
72163686467,72163686471,4,2465,1146,-20
72164233944,72164233947,3,2940,1104,-20
72165632405,72165632409,4,2330,1372,-20
72166082814,72166082817,3,1607,1582,-20
72168365052,72168365057,5,1939,1276,-20
72169899166,72169899172,6,1602,1140,-20
72170040276,72170040279,3,1491,1783,-20
72170251820,72170251818,-2,1189,2667,-20
72173618449,72173618445,-4,863,3462,-20
72174655723,72174655727,4,2007,969,-20
72175846152,72175846156,4,1751,1378,-20
72177661543,72177661550,7,1620,1204,-20
72178578600,72178578602,2,1739,1422,-20
72178925322,72178925322,0,1276,2296,-20
72181172230,72181172235,5,3648,1565,-20
72183894918,72183894896,-22,1774,966,-20
72183971018,72183971038,20,596,1222,-20
72186931489,72186931494,5,2363,1274,-20
72187821838,72187821819,-19,1513,1625,-20
72190994747,72190994750,3,2516,2590,-20
72192492523,72192492504,-19,1236,681,-20
72192544946,72192544948,2,1793,1266,-20
72193276905,72193276909,4,1833,1348,-20
72194856914,72194856918,4,2427,1940,-20
72194888067,72194888071,4,2143,1646,-20
72197924583,72197924588,5,2455,1420,-20
72199732383,72199732385,2,1649,1700,-20
72203129181,72203129182,1,1235,1033,-20
72203198246,72203198226,-20,1078,682,-20
72204847075,72204847079,4,1505,1122,-20
72205986472,72205986475,3,1831,1985,-20
72208769443,72208769446,3,1846,1421,-20
72209119078,72209119083,5,1391,951,-20
72211106134,72211106138,4,1075,1007,-20
72211303527,72211303532,5,2466,2079,-20
72214133298,72214133298,0,1138,1471,-20
72214167987,72214167989,2,1745,1421,-20
72215498102,72215498102,0,786,1660,-20
72215932661,72215932665,4,2489,1541,-20
72217289644,72217289624,-20,973,731,-20
72217359763,72217359768,5,1919,1887,-20
72222360637,72222360638,1,1233,800,-20
72228663086,72228663091,5,1484,1318,-20
72231966164,72231966165,1,1371,1561,-20
72233634885,72233634890,5,1662,1164,-20
72235120278,72235120278,0,850,1545,-20
72244634278,72244634281,3,1309,1313,-20
72245187185,72245187190,5,1747,1647,-20
72245264353,72245264357,4,2580,2025,-20
72246629894,72246629898,4,1499,1014,-20
72247811365,72247811370,5,1920,1904,-20
72247885834,72247885835,1,1067,1077,-20
72254147580,72254147584,4,1697,1393,-20
72256095677,72256095680,3,2136,1618,-20
72259849169,72259849174,5,2593,1354,-20
72264907015,72264907017,2,1813,1572,-20
72270879427,72270879431,4,1676,1543,-20
72271798809,72271798812,3,2347,1586,-20
72275369510,72275369510,0,941,1190,-20
72278289150,72278289151,1,2026,2018,-20
72278907982,72278907986,4,2232,1649,-20
72281586755,72281586755,0,924,952,-20
72285629374,72285629378,4,1761,1687,-20
72286638700,72286638702,2,1213,900,-20
72289352577,72289352580,3,1400,1388,-20
72291856698,72291856700,2,1492,875,-20
72292796049,72292796054,5,2386,1646,-20
72295546041,72295546043,2,1474,1513,-20
72296097071,72296097076,5,1950,1424,-20
72300071302,72300071306,4,1480,976,-20
72300123233,72300123219,-14,892,239,-20
72301719545,72301719546,1,1720,1301,-20
72302289495,72302289501,6,3234,1596,-20
72303933679,72303933683,4,1641,1682,-20
72305852990,72305852988,-2,935,1794,-20
72307197968,72307197971,3,1622,1461,-20
72307910130,72307910134,4,2589,1889,-20
72310781902,72310781905,3,2024,1409,-20
72311843149,72311843151,2,1159,842,-20
72313670302,72313670307,5,1880,1394,-20
72316048962,72316048965,3,1450,1500,-20
72316230790,72316230795,5,1762,1033,-20
72319049774,72319049774,0,1808,1232,-20
72322930247,72322930251,4,1557,1694,-20
72327569650,72327569650,0,1153,1733,-20
72328162199,72328162202,3,1630,1308,-20
72334478499,72334478502,3,2582,2041,-20
72335393476,72335393480,4,2128,1274,-20
72336755273,72336755275,2,1347,1135,-20
72337598614,72337598619,5,1213,1358,-20
72339311927,72339311930,3,1747,1309,-20
72340342629,72340342634,5,1527,990,-20
72340613854,72340613860,6,4718,2950,-20
72346337685,72346337688,3,1914,2003,-20
72347192260,72347192262,2,1356,937,-20
72348972834,72348972833,-1,919,1753,-20
72349385205,72349385207,2,1536,1495,-20
72351008565,72351008566,1,2080,1772,-20
72351679697,72351679695,-2,1153,1354,-20
72353238926,72353238930,4,1857,1063,-20
72355386588,72355386591,3,1489,1269,-20
72355788082,72355788090,8,1872,1130,-20
72358399648,72358399651,3,2401,1360,-20
72361717482,72361717484,2,1851,1726,-20
72363067175,72363067177,2,1407,1204,-20
72364691405,72364691410,5,4004,2797,-20
72365695141,72365695144,3,1681,1275,-20
72371391707,72371391710,3,1197,859,-20
72378665271,72378665278,7,3521,985,-20
72379877456,72379877457,1,1307,1711,-20
72380704494,72380704497,3,1888,1320,-20
72381497994,72381497997,3,1804,1405,-20
72382236420,72382236401,-19,1345,968,-20
72387272405,72387272407,2,1841,1648,-20
72394880737,72394880742,5,1764,1438,-20
72395603697,72395603699,2,1527,1245,-20
72397188622,72397188625,3,1791,1509,-20
72397349307,72397349307,0,485,164,-20
72398287266,72398287270,4,1807,1625,-20
72400800121,72400800126,5,1689,1762,-20
72404377694,72404377698,4,2190,1828,-20
72404417063,72404417066,3,1805,1093,-20
72412262537,72412262541,4,2265,1693,-20
72413335806,72413335810,4,1911,1678,-20
72413664566,72413664571,5,2031,1095,-20
72413884927,72413884932,5,1994,1346,-20
72417179939,72417179942,3,1281,1040,-20
72418275410,72418275416,6,2479,1467,-20
72420092494,72420092477,-17,1255,2301,-20
72420670585,72420670590,5,1858,1428,-20
72421349455,72421349456,1,2725,3592,-20
72421637554,72421637557,3,2205,1073,-20
72425801842,72425801845,3,2275,1381,-20
72426290781,72426290784,3,1592,1323,-20
72427526685,72427526683,-2,1177,1225,-20
72428112353,72428112354,1,1992,1101,-20
72429209470,72429209472,2,1294,1100,-20
72430605742,72430605746,4,1510,1462,-20
72434250334,72434250338,4,1256,1513,-20
72437918901,72437918903,2,1510,930,-20
72438048255,72438048259,4,2117,1607,-20
72439911579,72439911581,2,1654,1858,-20
72441628328,72441628334,6,1688,1296,-20
72444924512,72444924513,1,1776,1226,-20
72448205090,72448205095,5,2101,1688,-20
72448493290,72448493293,3,1315,987,-20
72449869473,72449869474,1,1655,1576,-20
72456086552,72456086556,4,2110,1449,-20
72456782521,72456782525,4,2316,1153,-20
72458682882,72458682882,0,1371,1307,-20
72460538244,72460538239,-5,947,2505,-20
72462805554,72462805560,6,1992,1447,-20
72464321710,72464321717,7,3265,1133,-20
72469151693,72469151713,20,1613,1319,-20
72470454882,72470454882,0,1252,1169,-20
72470748457,72470748474,17,3834,1895,-20
72471662061,72471662081,20,1644,1283,-20
72472362497,72472362501,4,1592,2309,-20
72472680569,72472680571,2,1555,1566,-20
72477494969,72477494974,5,2682,1723,-20
72488410565,72488410570,5,1744,1361,-20
72491961910,72491961913,3,1614,1458,-20
72492926886,72492926889,3,1613,1097,-20
72493560040,72493560035,-5,1459,324,-20
72496516213,72496516217,4,1209,1286,-20
72501654768,72501654772,4,1553,1126,-20
72503641509,72503641515,6,3006,1149,-20
72504408968,72504408970,2,1727,848,-20
72505341219,72505341223,4,2101,1615,-20
72505929925,72505929925,0,1743,2109,-20
72507761802,72507761805,3,1145,1188,-20
72510534397,72510534399,2,1741,930,-20
72511284974,72511284979,5,2085,1626,-20
72514386543,72514386548,5,1501,1361,-20
72518371608,72518371605,-3,1325,2391,-20
72520022852,72520022854,2,1834,1062,-20
72522895962,72522895965,3,2711,1569,-20
72527631489,72527631493,4,2218,1132,-20
72528748517,72528748518,1,1745,1099,-20
72530501946,72530501951,5,2783,1475,-20
72530695944,72530695947,3,1955,1571,-20
72533352486,72533352490,4,1763,1098,-20
72537440121,72537440126,5,2639,2212,-20
72537506577,72537506578,1,1911,1598,-20
72537718494,72537718499,5,2478,1455,-20
72543401339,72543401343,4,1833,852,-20
72543439387,72543439390,3,1267,1011,-20
72545435065,72545435069,4,1263,1365,-20
72546489148,72546489153,5,2255,888,-20
72552322423,72552322426,3,1537,920,-20
72553988903,72553988907,4,2244,1683,-20
72554336503,72554336499,-4,738,1952,-20
72555628710,72555628716,6,2191,1689,-20
72556106594,72556106576,-18,2397,1325,-20
72558212481,72558212484,3,1250,1544,-20
72558795237,72558795241,4,1691,1174,-20
72559334248,72559334253,5,2413,1930,-20
72562150582,72562150585,3,2716,1507,-20
72567049224,72567049226,2,1589,1605,-20
72570086986,72570086990,4,1483,1095,-20
72571018423,72571018426,3,1800,1190,-20
72572406515,72572406520,5,1309,1140,-20
72573943017,72573943015,-2,1149,1691,-20
72575619464,72575619467,3,1691,1276,-20
72577126993,72577126996,3,1780,1699,-20
72578310608,72578310611,3,1762,884,-20
72580424880,72580424883,3,1784,1619,-20
72582421058,72582421061,3,2479,1660,-20
72583549806,72583549809,3,1690,1488,-20
72585305657,72585305660,3,2059,1574,-20
72585511197,72585511201,4,1708,1304,-20
72590607398,72590607390,-8,30587,18556,-20
72592677599,72592677603,4,1572,1681,-20
72594441668,72594441671,3,2228,1058,-20
72594834114,72594834115,1,1667,1714,-20
72595864540,72595864543,3,2492,1711,-20
72598270483,72598270486,3,2209,1457,-20
72599614326,72599614328,2,1579,1137,-20
72601691115,72601691119,4,1206,1100,-20
72603767051,72603767054,3,1613,1630,-20
72606383115,72606383113,-2,1960,4717,-20
72614148678,72614148682,4,1669,1596,-20
72614649169,72614649174,5,2235,1198,-20
72618602119,72618602122,3,1895,1381,-20
72621997482,72621997485,3,2183,1618,-20
72625269305,72625269309,4,1351,1043,-20
72626686270,72626686274,4,1911,1795,-20
72627984616,72627984620,4,2183,1386,-20
72630320921,72630320902,-19,1521,1026,-20
72630588690,72630588694,4,1824,1305,-20
72638370676,72638370681,5,2596,1758,-20
72640263123,72640263126,3,1275,1030,-20
72641114286,72641114291,5,1317,1243,-20
72641810663,72641810662,-1,3631,5248,-20
72644364084,72644364087,3,1434,1088,-20
72647093779,72647093783,4,1884,1148,-20
72648477805,72648477804,-1,1095,1565,-20
72650525907,72650525910,3,1656,1276,-20
72652164088,72652164091,3,1010,1018,-20
72652830427,72652830432,5,1425,1199,-20
72656032484,72656032489,5,2515,1616,-20
72656857247,72656857250,3,2653,1442,-20
72656889051,72656889055,4,1865,1241,-20
72658740443,72658740447,4,1507,1654,-20
72660075869,72660075871,2,1756,1680,-20
72663748138,72663748141,3,2455,2111,-20
72667362441,72667362445,4,1540,1252,-20
72671099346,72671099349,3,1706,1211,-20
72676212420,72676212423,3,1731,1297,-20
72680555942,72680555946,4,1872,1744,-20
72680895186,72680895190,4,1443,1403,-20
72685864329,72685864333,4,1940,1404,-20
72688355315,72688355317,2,1239,1600,-20
72689452096,72689452101,5,2112,1522,-20
72690170524,72690170529,5,3083,1602,-20
72693225246,72693225251,5,2272,1464,-20
72695308120,72695308125,5,1723,1094,-20
72696379162,72696379167,5,1813,1303,-20
72696655658,72696655664,6,1954,1336,-20
72698844501,72698844502,1,1333,1279,-20
72700229618,72700229620,2,1062,907,-20
72703151324,72703151327,3,1909,1971,-20
72704004815,72704004819,4,1043,1456,-20
72711884121,72711884123,2,1168,1117,-20
72714268355,72714268360,5,2130,1102,-20
72716589425,72716589413,-12,1624,1330,-20
72717513750,72717513751,1,2026,1580,-20
72718359672,72718359675,3,1359,1002,-20
72719083546,72719083553,7,1383,1106,-20
72719878894,72719878899,5,1816,1198,-20
72720493054,72720493050,-4,2264,4570,-20
72720935002,72720935002,0,1396,2778,-20
72721585451,72721585454,3,2181,1773,-20
72723315573,72723315579,6,1700,778,-20
72724587162,72724587154,-8,1057,5164,-20
72726099003,72726099010,7,1993,1016,-20
72728402891,72728402894,3,163,1064,-20
72730469201,72730469205,4,1808,1325,-20
72734792226,72734792226,0,929,1220,-20
72735222090,72735222093,3,1641,1080,-20
72736328675,72736328679,4,2270,1549,-20
72737216650,72737216635,-15,2269,929,-20
72738567489,72738567491,2,1570,1286,-20
72739890766,72739890769,3,1440,1350,-20
72741044463,72741044465,2,2403,1703,-20
72743818057,72743818060,3,2696,1959,-20
72743953123,72743953127,4,2038,1236,-20
72744342958,72744342961,3,1829,1415,-20
72744661821,72744661822,1,2045,1232,-20
72745074491,72745074499,8,446,388,-20
72745652422,72745652426,4,1835,1276,-20
72749209135,72749209138,3,1386,990,-20
72749453094,72749453101,7,1313,890,-20
72749975917,72749975919,2,1684,1334,-20
72751276592,72751276595,3,1872,914,-20
72752951931,72752951934,3,2368,1407,-20
72753240178,72753240183,5,1733,1179,-20
72753316779,72753316782,3,1718,1512,-20
72753536803,72753536787,-16,412,144,-20
72755515810,72755515814,4,2058,1811,-20
72755801836,72755801839,3,1915,1339,-20
72756718840,72756718845,5,1088,784,-20
72758508558,72758508563,5,21534,39479,-20
72760949001,72760949002,1,946,985,-20
72761413122,72761413117,-5,1403,3323,-20
72761572179,72761572174,-5,1189,3242,-20
72762168541,72762168543,2,1834,1419,-20
72766589193,72766589197,4,1693,1504,-20
72766838046,72766838024,-22,1403,833,-20
72767049331,72767049334,3,1988,1267,-20
72769150642,72769150645,3,1768,1916,-20
72775407165,72775407162,-3,1703,3790,-20
72776593037,72776593038,1,2147,1871,-20
72777418235,72777418237,2,1590,1246,-20
72778226078,72778226079,1,1605,1340,-20
72779749374,72779749378,4,2330,2193,-20
72780102326,72780102330,4,2160,1707,-20
72781081913,72781081919,6,2385,1157,-20
72784348439,72784348446,7,1104,1076,-20
72784481770,72784481774,4,1189,1158,-20
72785944438,72785944439,1,2097,1370,-20
72787706789,72787706792,3,1552,1307,-20
72788646247,72788646250,3,2486,1743,-20
72792864041,72792864043,2,2160,1499,-20
72795474881,72795474885,4,1246,1637,-20
72795662537,72795662517,-20,1215,1949,-20
72797735141,72797735146,5,1535,1306,-20
72798540186,72798540191,5,2554,1363,-20
72799914694,72799914695,1,1386,1738,-20
72801808256,72801808258,2,1696,1142,-20
72804278934,72804278938,4,1665,2025,-20
72806558947,72806558950,3,1134,943,-20
72810284674,72810284671,-3,1494,1505,-20
72811189585,72811189587,2,1794,1140,-20
72813743856,72813743858,2,1881,1457,-20
72815891524,72815891527,3,2374,1878,-20
72816394390,72816394394,4,1770,961,-20
72819906127,72819906122,-5,1831,4906,-20
72826036706,72826036707,1,1145,790,-20
72828911607,72828911609,2,1612,1507,-20
72829414739,72829414738,-1,1002,871,-20
72831742651,72831742656,5,2121,1300,-20
72833302962,72833302969,7,2496,1218,-20
72836264215,72836264220,5,2035,1311,-20
72839277501,72839277503,2,1580,1300,-20
72841491113,72841491115,2,1332,963,-20
72841974018,72841974021,3,2488,1447,-20
72842501871,72842501877,6,1443,800,-20
72843286706,72843286709,3,2090,1759,-20
72847612521,72847612526,5,2886,1024,-20
72849689738,72849689743,5,1759,2048,-20
72851609374,72851609378,4,2234,1692,-20
72851941253,72851941257,4,2053,1352,-20
72852519393,72852519397,4,1315,1096,-20
72858614732,72858614726,-6,1897,7561,-20
72860814362,72860814366,4,4553,2922,-20
72867374522,72867374526,4,2142,1247,-20
72873227423,72873227421,-2,1266,1896,-20
72879412118,72879412123,5,2009,1283,-20
72880343152,72880343154,2,2339,1829,-20
72888124246,72888124249,3,1945,1233,-20
72893476208,72893476211,3,2659,1866,-20
72894279872,72894279874,2,1627,1140,-20
72896106775,72896106777,2,1552,1227,-20
72899453378,72899453382,4,2303,1817,-20
72903534308,72903534311,3,2169,2010,-20
72904377151,72904377153,2,1792,1186,-20
72905199966,72905199945,-21,1591,963,-20
72907007253,72907007256,3,2346,1208,-20
72910053366,72910053366,0,1733,1301,-20
72911480007,72911480010,3,1732,1567,-20
72914518825,72914518827,2,2307,1625,-20
72919275199,72919275203,4,1272,1117,-20
72923784158,72923784158,0,2681,4352,-20
72924065377,72924065380,3,3394,1771,-20
72927214090,72927214096,6,2336,1104,-20
72928221354,72928221359,5,1957,937,-20
72930894691,72930894694,3,1463,1020,-20
72934011727,72934011732,5,2430,1520,-20
72936042354,72936042359,5,3110,1729,-20
72937512758,72937512761,3,1716,1275,-20
72940277809,72940277812,3,1381,2199,-20
72944055495,72944055503,8,2193,1179,-20
72944719202,72944719205,3,2776,1655,-20
72947383693,72947383710,17,1908,1380,-20
72949355951,72949355951,0,1125,1081,-20
72949731603,72949731607,4,1680,1203,-20
72952775439,72952775443,4,2086,2259,-20
72954375462,72954375467,5,1837,1300,-20
72955592928,72955592931,3,2000,1314,-20
72956733642,72956733641,-1,28535,22677,-20
72959958575,72959958577,2,1857,1498,-20
72962096221,72962096223,2,1817,1536,-20
72964508262,72964508255,-7,2419,8130,-20
72966416077,72966416081,4,1079,1015,-20
72970729889,72970729898,9,659,186,-20
72970856166,72970856165,-1,1681,2677,-20
72973428006,72973428009,3,905,1115,-20
72975046047,72975046050,3,1622,1047,-20
72976198106,72976198107,1,2266,1664,-20
72978466442,72978466442,0,1798,1810,-20
72980515174,72980515178,4,2113,1771,-20
72983430631,72983430634,3,1293,1121,-20
72983730582,72983730586,4,1411,1340,-20
72986097244,72986097248,4,1607,1024,-20
72990635477,72990635480,3,2083,1624,-20
72996125325,72996125328,3,1729,1281,-20
72996595232,72996595236,4,1974,1876,-20
73000605801,73000605809,8,35078,5803,-20
73001190206,73001190210,4,2039,1584,-20
73001465390,73001465383,-7,1463,5665,-20
73005228286,73005228291,5,2334,1301,-20
73007526566,73007526567,1,1332,1605,-20
73007640061,73007640061,0,1419,2142,-20
73008645718,73008645721,3,2082,1797,-20
73009728553,73009728557,4,1395,1461,-20
73011870266,73011870271,5,1301,821,-20
73016677285,73016677287,2,1993,1202,-20
73019794251,73019794256,5,2321,978,-20
73021733518,73021733523,5,1825,1025,-20
73022623357,73022623358,1,1986,1757,-20
73022717330,73022717312,-18,1659,1423,-20
73022924051,73022924055,4,2444,1318,-20
73024710057,73024710061,4,2452,1844,-20
73026707410,73026707413,3,1234,1375,-20
73030757666,73030757670,4,2095,1637,-20
73032049782,73032049785,3,1847,1126,-20
73032752001,73032752003,2,1505,2293,-20
73041432976,73041432979,3,1579,1235,-20
73042300975,73042300979,4,1424,1375,-20
73049187606,73049187609,3,1741,1103,-20
73051779861,73051779866,5,2549,1734,-20
73057572933,73057572937,4,2676,1558,-20
73058161189,73058161192,3,1622,1829,-20
73062223807,73062223798,-9,975,2932,-20
73063296667,73063296669,2,1440,1179,-20
73065563960,73065563962,2,1211,896,-20
73069112714,73069112719,5,1527,815,-20
73071517625,73071517628,3,2664,1649,-20
73072319782,73072319786,4,1570,1340,-20
73074220028,73074220032,4,2113,1308,-20
73076191645,73076191647,2,1573,1356,-20
73077525982,73077525986,4,2234,1224,-20
73082519782,73082519786,4,1605,1278,-20
73083406325,73083406328,3,1774,1694,-20
73084395602,73084395609,7,2151,1291,-20
73090551416,73090551419,3,1248,1002,-20
73091083814,73091083820,6,2403,1480,-20
73092647853,73092647855,2,2161,1745,-20
73098349130,73098349134,4,2562,2035,-20
73100788609,73100788610,1,1059,1177,-20
73107119959,73107119962,3,1221,798,-20
73110361465,73110361466,1,1487,1628,-20
73112466374,73112466378,4,2304,2047,-20
73113723869,73113723872,3,1822,1425,-20
73114602626,73114602629,3,948,1154,-20
73116015054,73116015059,5,1642,917,-20
73116212382,73116212364,-18,1088,1177,-20
73123367917,73123367918,1,2083,1535,-20
73124531100,73124531104,4,1335,1398,-20
73128379451,73128379454,3,1850,1344,-20
73128760638,73128760641,3,1582,1140,-20
73137454110,73137454117,7,2139,1569,-20
73138481104,73138481106,2,2201,2132,-20
73139590620,73139590623,3,840,722,-20
73141632113,73141632115,2,1519,892,-20
73142774777,73142774779,2,1120,1440,-20
73143746081,73143746084,3,1691,1291,-20
73144134231,73144134233,2,1585,1221,-20
73144189074,73144189079,5,2312,1562,-20
73145623402,73145623406,4,1517,1479,-20
73147936059,73147936063,4,1202,1024,-20
73149949537,73149949539,2,1542,1026,-20
73150366541,73150366543,2,2065,1634,-20
73155458125,73155458128,3,2110,1583,-20
73158217981,73158217995,14,14502,44535,-20
73158337032,73158337035,3,1234,1125,-20
73158653773,73158653776,3,4286,2857,-20
73159829846,73159829846,0,1085,1273,-20
73161364628,73161364631,3,2539,1610,-20
73164261678,73164261682,4,1895,1535,-20
73165094682,73165094685,3,1806,1239,-20
73175038341,73175038345,4,1582,1485,-20
73179051234,73179051238,4,1832,1230,-20
73180444361,73180444363,2,1845,1451,-20
73182112537,73182112539,2,1332,1102,-20
73186093089,73186093091,2,1318,970,-20
73188653319,73188653321,2,2667,1973,-20
73191405718,73191405722,4,2522,1401,-20
73195621213,73195621216,3,1498,1544,-20
73198749907,73198749910,3,2498,1877,-20
73198852016,73198852018,2,2739,1474,-20
73204178091,73204178096,5,2343,1788,-20
73204974334,73204974329,-5,1898,6047,-20
73206766618,73206766622,4,1922,1356,-20
73207829716,73207829699,-17,2120,1491,-20
73213798783,73213798786,3,1172,840,-20
73215007103,73215007107,4,1910,1509,-20
73216695368,73216695370,2,1794,1516,-20
73218666978,73218666981,3,1115,1588,-20
73222523533,73222523540,7,4895,1499,-20
73225924310,73225924314,4,2314,1718,-20
73228432419,73228432413,-6,2018,5940,-20
73232741518,73232741514,-4,42,895,-20
73234128412,73234128414,2,2001,1990,-20
73234410671,73234410677,6,1819,1413,-20
73234698035,73234698038,3,2095,1642,-20
73235753495,73235753498,3,1747,1360,-20
73236465390,73236465394,4,2392,1485,-20
73237909966,73237909970,4,2713,1603,-20
73239215010,73239215013,3,1705,1592,-20
73239541302,73239541306,4,2201,1365,-20
73242072518,73242072526,8,6418,38519,-20
73243285006,73243285008,2,1607,1244,-20
73243919391,73243919395,4,1463,1269,-20
73245039405,73245039410,5,1928,1235,-20
73246161554,73246161556,2,1907,1760,-20
73246279721,73246279725,4,1872,1063,-20
73247685804,73247685807,3,1775,1433,-20
73252126057,73252126059,2,1276,1125,-20
73253294629,73253294632,3,1891,1378,-20
73254435368,73254435372,4,1859,849,-20
73255831497,73255831499,2,2363,1555,-20
73257696250,73257696251,1,1287,1054,-20
73260234530,73260234535,5,3378,1522,-20
73261119814,73261119814,0,1317,1744,-20
73261277185,73261277189,4,1525,1239,-20
73262420039,73262420043,4,2274,1805,-20
73264869561,73264869563,2,1809,1411,-20
73265844227,73265844230,3,1486,1676,-20
73269148926,73269148931,5,2282,1252,-20
73272096167,73272096171,4,1621,1283,-20
73274538596,73274538597,1,1510,1360,-20
73275190914,73275190917,3,2491,1106,-20
73275418053,73275418075,22,1844,1507,-20
73275671313,73275671318,5,3262,2104,-20
73276193185,73276193186,1,1259,1329,-20
73277133835,73277133839,4,1766,1093,-20
73279596392,73279596393,1,1982,1949,-20
73283409434,73283409437,3,2563,1469,-20
73283477865,73283477862,-3,1325,2168,-20
73287338893,73287338896,3,2227,1376,-20
73288266414,73288266413,-1,23345,40414,-20
73288422401,73288422405,4,1593,939,-20
73296158515,73296158519,4,2439,1700,-20
73296449978,73296449981,3,1920,2125,-20
73302570808,73302570811,3,2046,1445,-20
73303577989,73303577992,3,2769,1848,-20
73308096003,73308095992,-11,1586,1245,-20
73308563586,73308563590,4,1767,1068,-20
73309942601,73309942604,3,1925,1432,-20
73314632075,73314632078,3,2292,1297,-20
73319131348,73319131351,3,1927,1165,-20
73321383043,73321383046,3,1741,1252,-20
73322163717,73322163721,4,1705,1055,-20
73322514022,73322514022,0,1467,1620,-20
73322996891,73322996897,6,1571,1470,-20
73325360602,73325360605,3,1622,1367,-20
73327369330,73327369336,6,1150,1125,-20
73328033278,73328033282,4,2285,1139,-20
73331478420,73331478419,-1,1041,1366,-20
73332472326,73332472328,2,1954,1639,-20
73333744136,73333744138,2,1933,1364,-20
73341816879,73341816881,2,1723,1567,-20
73347097914,73347097916,2,2095,1803,-20
73350282571,73350282574,3,3182,2233,-20
73352996673,73352996678,5,3544,1519,-20
73354940733,73354940736,3,1311,1102,-20
73355433130,73355433133,3,1582,1203,-20
73362368938,73362368942,4,1921,1362,-20
73366138206,73366138209,3,2230,1277,-20
73367234033,73367234036,3,1390,1316,-20
73370466552,73370466555,3,2183,1616,-20
73370621965,73370621970,5,1797,1404,-20
73371838967,73371838970,3,2164,1832,-20
73373532078,73373532082,4,1362,1363,-20
73377716201,73377716203,2,1598,1670,-20
73381252739,73381252736,-3,1724,2297,-20
73382133483,73382133479,-4,797,2382,-20
73382371081,73382371076,-5,555,2404,-20
73382519184,73382519186,2,1597,1388,-20
73382598769,73382598776,7,3952,1649,-20
73386922345,73386922349,4,2281,1439,-20
73390704472,73390704467,-5,2101,4544,-20
73391572364,73391572367,3,1817,1111,-20
73392565284,73392565287,3,2418,1802,-20
73394761889,73394761889,0,1200,1134,-20
73397077029,73397077026,-3,2084,6034,-20
73398132917,73398132920,3,1784,1257,-20
73399612112,73399612114,2,1498,1839,-20
73401285127,73401285130,3,1663,1687,-20
73405421694,73405421697,3,2454,1448,-20
73406392947,73406392951,4,1667,1574,-20
73407189367,73407189373,6,1795,1088,-20
73407825782,73407825787,5,1342,1102,-20
73409662921,73409662925,4,549,641,-20
73410293618,73410293621,3,1867,1726,-20
73410388386,73410388389,3,1334,996,-20
73411418653,73411418658,5,1257,1308,-20
73412684381,73412684386,5,1768,1215,-20
73417146617,73417146611,-6,1870,7866,-20
73418669827,73418669829,2,1904,1222,-20
73419098354,73419098357,3,2163,1062,-20
73420920858,73420920861,3,2329,1756,-20
73422922459,73422922465,6,4423,1314,-20
73422964471,73422964474,3,1597,781,-20
73424138730,73424138734,4,1397,1408,-20
73425498145,73425498147,2,2231,1861,-20
73426553813,73426553817,4,2135,1905,-20
73426779507,73426779489,-18,2006,1113,-20
73428617241,73428617246,5,1466,1489,-20
73429633713,73429633715,2,2737,1692,-20
73430153912,73430153914,2,1695,1487,-20
73430805540,73430805543,3,2120,1628,-20
73432642108,73432642110,2,1591,1672,-20
73434005167,73434005165,-2,1172,962,-20
73436558694,73436558679,-15,602,543,-20
73440871895,73440871898,3,1871,1629,-20
73441319789,73441319795,6,1716,1339,-20
73443126604,73443126606,2,1524,1143,-20
73443955167,73443955174,7,6577,2382,-20
73445184628,73445184632,4,1622,1396,-20
73445429909,73445429890,-19,1519,761,-20
73446197691,73446197695,4,1982,1540,-20
73448796073,73448796077,4,1058,1467,-20
73451244976,73451244978,2,2206,1139,-20
73452632401,73452632408,7,3064,1144,-20
73455171158,73455171163,5,2053,1286,-20
73460428757,73460428761,4,1517,794,-20
73464945086,73464945088,2,2204,1624,-20
73466203570,73466203566,-4,1131,4233,-20
73468922165,73468922169,4,1126,1422,-20
73471620381,73471620385,4,1316,1232,-20
73477643464,73477643469,5,1545,1433,-20
73481410072,73481410075,3,1883,1142,-20
73482154950,73482154952,2,1290,1109,-20
73488354188,73488354191,3,1496,1864,-20
73490430798,73490430800,2,1586,1492,-20
73491337751,73491337754,3,2173,1314,-20
73496023711,73496023714,3,1478,983,-20
73497430070,73497430073,3,2651,1345,-20
73498390920,73498390922,2,2205,1155,-20
73501318337,73501318341,4,2151,1711,-20
73502027322,73502027330,8,2971,1524,-20
73502591925,73502591927,2,1431,1751,-20
73504138258,73504138262,4,2275,2043,-20
73505629498,73505629500,2,1159,1627,-20
73506016947,73506016950,3,1733,1149,-20
73506229313,73506229302,-11,141,564,-20
73509402212,73509402216,4,1409,1169,-20
73510143920,73510143923,3,1945,1165,-20
73512599665,73512599670,5,1400,1131,-20
73513128706,73513128711,5,1386,1179,-20
73520050760,73520050762,2,2033,1457,-20
73520223958,73520223965,7,1792,1260,-20
73521034045,73521034049,4,2235,1391,-20
73521297941,73521297947,6,1857,1129,-20
73523074020,73523074023,3,1901,1170,-20
73528849737,73528849741,4,1986,1985,-20
73530602963,73530602966,3,1844,1729,-20
73531383657,73531383659,2,1528,1300,-20
73531521521,73531521526,5,1839,1895,-20
73533891094,73533891095,1,1622,1386,-20
73534455848,73534455852,4,1038,1055,-20
73536536209,73536536212,3,1447,1557,-20
73537812319,73537812322,3,1490,1423,-20
73538444791,73538444794,3,1642,1526,-20
73543263971,73543263975,4,1469,1231,-20
73544789258,73544789262,4,1503,772,-20
73545737482,73545737487,5,2049,1413,-20
73545955302,73545955307,5,1953,1308,-20
73546451092,73546451095,3,1924,1213,-20
73547233298,73547233290,-8,1133,902,-20
73550971452,73550971456,4,2744,1652,-20
73553337747,73553337739,-8,1409,1590,-20
73559425600,73559425606,6,2036,1090,-20
73559549200,73559549202,2,1854,1142,-20
73564566033,73564566034,1,1351,1001,-20
73566139217,73566139221,4,1982,1466,-20
73569930131,73569930131,0,1531,1359,-20
73570265642,73570265638,-4,1548,4567,-20
73571808957,73571808961,4,1780,1706,-20
73574547943,73574547946,3,1421,1499,-20
73577640294,73577640294,0,1686,1503,-20
73578763431,73578763434,3,1929,1117,-20
73580648045,73580648048,3,2577,1474,-20
73583451090,73583451099,9,2210,1750,-20
73584959287,73584959291,4,2648,2119,-20
73587475841,73587475842,1,2037,1659,-20
73593700454,73593700458,4,2022,1539,-20
73594033677,73594033681,4,1243,792,-20
73598279801,73598279806,5,2404,1285,-20
73600851790,73600851791,1,3559,2781,-20
73602349697,73602349699,2,1877,1868,-20
73603611861,73603611862,1,21700,21545,-20
73609188394,73609188399,5,3408,1289,-20
73609218708,73609218712,4,1890,1619,-20
73615827379,73615827383,4,1558,1089,-20
73618383629,73618383631,2,1269,1058,-20
73621871434,73621871429,-5,1432,3858,-20
73626521849,73626521852,3,1470,1525,-20
73631340414,73631340419,5,1729,1338,-20
73633321518,73633321522,4,1396,1232,-20
73634776910,73634776911,1,1254,1085,-20
73634969338,73634969342,4,1078,851,-20
73636800771,73636800775,4,2061,1513,-20
73641659243,73641659247,4,1925,1580,-20
73642153758,73642153761,3,3490,3592,-20
73644006914,73644006919,5,3624,1599,-20
73644338951,73644338954,3,2009,1489,-20
73645171469,73645171488,19,997,1380,-20
73648813766,73648813769,3,1457,1645,-20
73651002509,73651002508,-1,1436,2480,-20
73652139681,73652139686,5,2120,1251,-20
73653797146,73653797150,4,2110,1702,-20
73654066205,73654066209,4,1991,1247,-20
73655003593,73655003597,4,2013,1325,-20
73655247342,73655247362,20,1527,943,-20
73656611396,73656611399,3,1164,1179,-20
73658015426,73658015405,-21,1972,1477,-20
73658493605,73658493611,6,2322,1822,-20
73659915931,73659915934,3,2260,1679,-20
73661304789,73661304791,2,1414,1822,-20
73663159350,73663159353,3,1722,1645,-20
73666199851,73666199855,4,1300,1511,-20
73666613990,73666613994,4,1666,1012,-20
73668895364,73668895368,4,1834,1288,-20
73669049565,73669049570,5,1689,1130,-20
73672439841,73672439846,5,1348,1105,-20
73672794714,73672794718,4,1037,821,-20
73674279661,73674279666,5,2348,1188,-20
73674674728,73674674730,2,1645,1377,-20
73674728177,73674728179,2,1882,1911,-20
73675608217,73675608218,1,1469,1456,-20
73676295114,73676295115,1,744,526,-20
73680159938,73680159943,5,1181,730,-20
73680601772,73680601754,-18,1850,1105,-20
73681264094,73681264097,3,1813,1067,-20
73682631578,73682631583,5,2133,1468,-20
73685139492,73685139494,2,1404,836,-20
73688917429,73688917436,7,3058,1008,-20
73692394173,73692394175,2,2173,1201,-20
73695408282,73695408284,2,2497,2285,-20
73696336031,73696336035,4,1338,933,-20
73698491706,73698491710,4,915,780,-20
73699317085,73699317089,4,2298,1806,-20
73700310541,73700310542,1,1415,1164,-20
73704802490,73704802494,4,1695,1331,-20
73706626454,73706626460,6,1642,1286,-20
73707059454,73707059462,8,926,746,-20
73709358559,73709358559,0,1157,1250,-20
73713123446,73713123448,2,1526,1376,-20
73716027504,73716027501,-3,2098,4735,-20
73717053330,73717053335,5,2198,1118,-20
73718076133,73718076138,5,2001,1081,-20
73719906961,73719906948,-13,2678,1170,-20
73727167518,73727167521,3,1127,1033,-20
73730325248,73730325252,4,2023,1350,-20
73738832397,73738832399,2,1372,1289,-20
73740308670,73740308673,3,2144,1731,-20
73746465075,73746465079,4,1709,1622,-20
73747430935,73747430938,3,1743,2010,-20
73747886748,73747886746,-2,1958,2861,-20
73748158526,73748158529,3,1755,1622,-20
73754338686,73754338688,2,1708,1846,-20
73754810162,73754810165,3,1349,1423,-20
73756109340,73756109342,2,1359,1304,-20
73759242979,73759242981,2,1461,1303,-20
73761421733,73761421737,4,1077,1092,-20
73764616039,73764616042,3,1171,1209,-20
73764674174,73764674175,1,1443,1459,-20
73766059881,73766059886,5,2326,1104,-20
73769500906,73769500911,5,1850,1857,-20
73769884438,73769884437,-1,1541,1985,-20
73771383931,73771383934,3,2590,1375,-20
73776378295,73776378298,3,1726,1155,-20
73779083706,73779083709,3,2145,1631,-20
73783144510,73783144514,4,1592,1598,-20
73786175418,73786175421,3,1771,1333,-20
73790000949,73790000950,1,1772,1837,-20
73792102724,73792102725,1,1946,1522,-20
73792809804,73792809809,5,2443,1587,-20
73794998171,73794998169,-2,1645,3023,-20
73795869919,73795869922,3,1329,1121,-20
73796499330,73796499333,3,2878,1520,-20
73796918233,73796918251,18,1750,1488,-20
73797727892,73797727895,3,1819,1098,-20
73798821828,73798821830,2,1639,1290,-20
73799604513,73799604523,10,16277,49964,-20
73801839531,73801839526,-5,816,2603,-20
73805832401,73805832402,1,1765,1434,-20
73806665157,73806665161,4,2537,1584,-20
73808033369,73808033370,1,1255,1174,-20
73814319995,73814319999,4,2259,1394,-20
73815107927,73815107929,2,1757,1266,-20
73816049622,73816049626,4,995,1070,-20
73817085385,73817085392,7,2130,2258,-20
73818149650,73818149652,2,653,963,-20
73821802655,73821802658,3,1578,1366,-20
73825031999,73825032003,4,1793,884,-20
73837700514,73837700522,8,3772,1545,-20
73838377815,73838377809,-6,2106,7898,-20
73839383815,73839383820,5,1459,1001,-20
73841435046,73841435049,3,1554,1796,-20
73843425515,73843425518,3,1573,1698,-20
73843552342,73843552346,4,1751,1388,-20
73846417780,73846417781,1,2031,1355,-20
73847253813,73847253818,5,3110,1535,-20
73849983750,73849983751,1,1749,1105,-20
73853575194,73853575197,3,1729,1688,-20
73856382479,73856382483,4,1819,1342,-20
73859260547,73859260550,3,1593,1683,-20
73860800192,73860800197,5,1914,1044,-20
73862205572,73862205575,3,1598,1043,-20
73862465074,73862465079,5,1031,1177,-20
73869196839,73869196842,3,2302,1130,-20
73869681588,73869681571,-17,2289,1438,-20
73877675371,73877675374,3,1285,1100,-20
73878380952,73878380956,4,1828,1625,-20
73881715182,73881715185,3,2133,1476,-20
73882592141,73882592124,-17,1634,911,-20
73884792946,73884792950,4,1331,1250,-20
73886978521,73886978524,3,1994,1664,-20
73887331914,73887331918,4,1355,1024,-20
73890133564,73890133566,2,1611,1512,-20
73893412578,73893412582,4,2333,1757,-20
73896047973,73896047978,5,2868,1494,-20
73897207150,73897207155,5,2715,1041,-20
73899719356,73899719360,4,1797,1660,-20
73901631427,73901631430,3,1827,1170,-20
73902275305,73902275307,2,1373,1178,-20
73904484554,73904484557,3,2267,1549,-20
73904561697,73904561715,18,1090,752,-20
73905843870,73905843875,5,1881,1432,-20
73908005404,73908005409,5,2129,1364,-20
73914095832,73914095834,2,2234,1232,-20
73916400035,73916400047,12,13700,25209,-20
73922226336,73922226339,3,2286,1841,-20
73923574171,73923574175,4,2032,1615,-20
73927910777,73927910782,5,2007,1014,-20
73929526582,73929526586,4,3679,2930,-20
73931558267,73931558271,4,2201,1122,-20
73934651268,73934651279,11,833,758,-20
73934851241,73934851246,5,1855,1526,-20
73935607845,73935607846,1,1504,1204,-20
73936592188,73936592191,3,1459,1082,-20
73938188634,73938188638,4,1742,1301,-20
73938535295,73938535299,4,1918,1452,-20
73939863105,73939863107,2,1553,1341,-20
73940107769,73940107764,-5,1104,3125,-20
73944869522,73944869526,4,1601,1261,-20
73945199449,73945199451,2,1528,1800,-20
73948908485,73948908488,3,1805,1730,-20
73952281126,73952281135,9,3802,1373,-20
73952813947,73952813954,7,2226,1235,-20
73952895884,73952895885,1,1081,1276,-20
73957543031,73957543033,2,2016,1609,-20
73960548977,73960548977,0,24627,26796,-20
73963202787,73963202793,6,1637,1275,-20
73964081607,73964081611,4,2564,1540,-20
73965323789,73965323791,2,1690,928,-20
73966983215,73966983218,3,2485,1563,-20
73967559976,73967559979,3,1476,1196,-20
73969129929,73969129934,5,1306,1406,-20
73970210783,73970210787,4,1201,1039,-20
73976371931,73976371926,-5,804,2255,-20
73976548274,73976548279,5,1852,1235,-20
73981853704,73981853707,3,1113,1291,-20
73982619852,73982619855,3,1584,1181,-20
73983229559,73983229564,5,2024,1690,-20
73983681281,73983681283,2,2154,2436,-20
73985669057,73985669059,2,1942,1420,-20
73986001147,73986001150,3,2435,1726,-20
73987146994,73987146999,5,2374,1160,-20
73988820125,73988820129,4,1868,1341,-20
73989542086,73989542091,5,1387,1043,-20
73992043615,73992043617,2,1742,2015,-20
74000479226,74000479227,1,1220,962,-20
74001734554,74001734557,3,1299,991,-20
74003518614,74003518615,1,2176,1804,-20
74011997388,74011997390,2,2145,1768,-20
74017933785,74017933788,3,2316,2174,-20
74018689572,74018689575,3,1830,1251,-20
74021782861,74021782865,4,1912,1128,-20
74030512590,74030512595,5,1810,1177,-20
74031604044,74031604047,3,1977,1317,-20
74033247178,74033247181,3,1932,1797,-20
74034336231,74034336235,4,1350,1108,-20
74036522902,74036522905,3,2030,1546,-20
74037549666,74037549669,3,2695,2368,-20
74038185704,74038185708,4,2611,1807,-20
74038700644,74038700647,3,1828,1223,-20
74044602763,74044602758,-5,1054,3872,-20
74044975463,74044975468,5,2139,1151,-20
74046586060,74046586063,3,1910,1628,-20
74047880439,74047880447,8,1101,647,-20
74049411958,74049411962,4,2053,1448,-20
74051465659,74051465663,4,1424,1285,-20
74051693980,74051693982,2,2173,1151,-20
74052369367,74052369371,4,1957,1099,-20
74052743566,74052743554,-12,515,194,-20
74061084565,74061084567,2,1358,1500,-20
74061222570,74061222570,0,1249,1609,-20
74061905966,74061905970,4,1663,1395,-20
74067746292,74067746294,2,1499,1642,-20
74067784894,74067784897,3,1773,1329,-20
74068135050,74068135055,5,1815,1104,-20
74068983977,74068983979,2,1996,1338,-20
74070582162,74070582168,6,1209,1250,-20
74072216590,74072216595,5,1405,1358,-20
74076712111,74076712113,2,1908,1452,-20
74077306655,74077306657,2,1822,1066,-20
74078777601,74078777603,2,2096,1513,-20
74081906353,74081906357,4,2046,1894,-20
74082162650,74082162654,4,2799,1255,-20
74087408100,74087408102,2,1866,1508,-20
74093119118,74093119123,5,1942,1612,-20
74098687204,74098687207,3,1556,1162,-20
74100565537,74100565539,2,1844,1953,-20
74102667523,74102667524,1,1471,1404,-20
74104247394,74104247398,4,2067,1492,-20
74105984482,74105984486,4,1937,1403,-20
74107953292,74107953295,3,2309,1464,-20
74109848458,74109848461,3,1828,1416,-20
74110783077,74110783082,5,1838,1039,-20
74111871839,74111871845,6,1381,854,-20
74124075650,74124075649,-1,3099,4742,-20
74126091470,74126091475,5,11729,6311,-20
74132872623,74132872625,2,1974,1938,-20
74134427537,74134427530,-7,2803,7576,-20
74134780383,74134780388,5,2243,1719,-20
74135238869,74135238873,4,1333,1154,-20
74139716506,74139716510,4,1854,1550,-20
74148363322,74148363324,2,1590,1672,-20
74149855797,74149855800,3,1949,1486,-20
74153251255,74153251257,2,1307,1233,-20
74153582997,74153583001,4,1893,1168,-20
74154850018,74154850021,3,1506,1409,-20
74155013200,74155013207,7,5245,2052,-20
74161001806,74161001811,5,2877,1424,-20
74162072334,74162072335,1,1178,1264,-20
74162532683,74162532686,3,2239,1715,-20
74163485706,74163485710,4,1803,1488,-20
74165123137,74165123142,5,2270,1250,-20
74168135429,74168135434,5,1774,1197,-20
74168519657,74168519659,2,1673,1498,-20
74169863113,74169863115,2,1625,1986,-20
74170698962,74170698966,4,1303,1239,-20
74175099880,74175099882,2,1835,1060,-20
74175656911,74175656915,4,1700,1245,-20
74178022330,74178022333,3,2476,1651,-20
74179855466,74179855468,2,1634,1826,-20
74180611261,74180611262,1,2283,1863,-20
74181574006,74181574010,4,1799,1357,-20
74181634279,74181634282,3,1880,1204,-20
74182405254,74182405258,4,1768,1249,-20
74183469499,74183469503,4,1672,1277,-20
74185420489,74185420490,1,1326,1237,-20
74186006046,74186006050,4,1262,1104,-20
74187162835,74187162839,4,1221,1143,-20
74194388698,74194388703,5,1339,1793,-20
74194457656,74194457661,5,1517,1509,-20
74196223638,74196223643,5,1717,999,-20
74200280525,74200280530,5,1623,1130,-20
74202422319,74202422324,5,2966,1744,-20
74209841965,74209841969,4,2661,1569,-20
74211012926,74211012931,5,1938,1218,-20
74212458130,74212458133,3,1299,1612,-20
74213475170,74213475173,3,1339,1395,-20
74220313616,74220313616,0,2456,3564,-20
74224119893,74224119896,3,2117,1325,-20
74225660270,74225660275,5,1122,739,-20
74230440843,74230440838,-5,659,1289,-20
74230523088,74230523085,-3,1324,1188,-20
74237105841,74237105845,4,2256,1664,-20
74240441669,74240441673,4,1029,1150,-20
74242535915,74242535919,4,2514,2099,-20
74246443258,74246443263,5,1936,1349,-20
74248219362,74248219366,4,2132,1553,-20
74248554947,74248554953,6,782,260,-20
74251877867,74251877869,2,1111,1154,-20
74252384382,74252384387,5,1138,880,-20
74252849397,74252849401,4,2292,1465,-20
74253448189,74253448192,3,1376,1525,-20
74256001633,74256001628,-5,618,2365,-20
74257873426,74257873429,3,1170,1065,-20
74258466357,74258466360,3,2145,2060,-20
74259553742,74259553741,-1,1507,2259,-20
74262447581,74262447578,-3,1024,2382,-20
74263921269,74263921274,5,1460,1599,-20
74266096064,74266096067,3,1872,1245,-20
74268780467,74268780471,4,1440,1341,-20
74271538302,74271538306,4,1778,1619,-20
74272145577,74272145579,2,1565,1435,-20
74275163718,74275163722,4,2300,1946,-20
74279122349,74279122354,5,1779,998,-20
74280047000,74280047003,3,1967,1170,-20
74280791655,74280791660,5,1884,1449,-20
74283408787,74283408791,4,1221,857,-20
74283589406,74283589386,-20,590,447,-20
74284176367,74284176371,4,1351,1104,-20
74285584694,74285584699,5,1726,1337,-20
74289384346,74289384351,5,1568,1071,-20
74289552909,74289552912,3,1726,1344,-20
74289722911,74289722914,3,2574,1820,-20
74297499074,74297499079,5,1052,1086,-20
74297557769,74297557773,4,2772,1559,-20
74298184153,74298184154,1,2084,1768,-20
74299144034,74299144017,-17,964,2640,-20
74302176506,74302176511,5,2488,1134,-20
74303391276,74303391281,5,1474,1551,-20
74308769105,74308769103,-2,1466,2131,-20
74311532323,74311532328,5,2164,1820,-20
74312647286,74312647289,3,1750,1538,-20
74312729878,74312729879,1,1515,1479,-20
74313973684,74313973687,3,1775,998,-20
74318633151,74318633154,3,2458,1554,-20
74318988376,74318988376,0,1744,1863,-20
74319747191,74319747194,3,1236,1085,-20
74320875978,74320875981,3,1830,1275,-20
74320981813,74320981814,1,2223,1580,-20
74322176450,74322176453,3,1983,1096,-20
74324292907,74324292911,4,1576,821,-20
74326126716,74326126720,4,2273,1685,-20
74326612799,74326612804,5,1960,1180,-20
74326752279,74326752282,3,2040,1897,-20
74328017185,74328017187,2,1316,1001,-20
74333957904,74333957908,4,1860,1605,-20
74335814786,74335814789,3,2296,1812,-20
74340564910,74340564913,3,1394,1356,-20
74343769144,74343769147,3,1591,1126,-20
74344460834,74344460838,4,2522,1828,-20
74346973654,74346973659,5,1887,1259,-20
74353003076,74353003082,6,2302,1384,-20
74353873358,74353873362,4,1686,1391,-20
74355331218,74355331225,7,5551,2498,-20
74357495510,74357495514,4,1950,1183,-20
74360274065,74360274068,3,1367,1129,-20
74363661159,74363661162,3,2035,1864,-20
74368304734,74368304738,4,1629,1097,-20
74370239255,74370239255,0,764,1135,-20
74372307723,74372307727,4,2432,1921,-20
74372817407,74372817411,4,2473,1119,-20
74374674352,74374674356,4,2261,1833,-20
74378383883,74378383887,4,1644,1018,-20
74381394792,74381394794,2,1744,1184,-20
74382037832,74382037837,5,2261,1634,-20
74382473531,74382473533,2,1649,1791,-20
74384014574,74384014577,3,1736,1318,-20
74388863134,74388863137,3,1876,1259,-20
74389213926,74389213930,4,1336,1194,-20
74393392823,74393392826,3,2818,1481,-20
74394169119,74394169124,5,1861,989,-20
74394498898,74394498907,9,1993,1064,-20
74396381274,74396381275,1,1559,1743,-20
74398088239,74398088242,3,2119,2053,-20
74399115341,74399115345,4,1098,1235,-20
74399147473,74399147480,7,1746,1339,-20
74400353236,74400353239,3,2019,1597,-20
74406361235,74406361235,0,1219,865,-20
74408155898,74408155903,5,2338,1244,-20
74408247117,74408247113,-4,23336,12706,-20
74410352643,74410352648,5,1751,1567,-20
74410707540,74410707542,2,2162,1330,-20
74415952238,74415952242,4,1631,1435,-20
74418048894,74418048899,5,2050,1167,-20
74420813460,74420813464,4,1873,1572,-20
74429147233,74429147236,3,1397,1551,-20
74431115931,74431115935,4,1605,1516,-20
74431293004,74431293008,4,1946,1489,-20
74433195542,74433195546,4,1311,1506,-20
74434500155,74434500158,3,2790,2086,-20
74434817775,74434817782,7,2103,1116,-20
74436275333,74436275335,2,955,1234,-20
74436588029,74436588032,3,1353,1333,-20
74438550272,74438550275,3,2432,1367,-20
74440697014,74440697016,2,2031,1985,-20
74442155807,74442155810,3,1711,1271,-20
74445345399,74445345404,5,2093,1293,-20
74446858866,74446858869,3,1409,1375,-20
74448658101,74448658107,6,2460,1116,-20
74451199497,74451199501,4,1330,1426,-20
74453234272,74453234275,3,1586,1534,-20
74453839926,74453839929,3,1838,991,-20
74454710119,74454710098,-21,1404,1349,-20
74463372676,74463372679,3,1631,1182,-20
74465017919,74465017922,3,1389,1745,-20
74467339123,74467339126,3,1402,971,-20
74471368220,74471368219,-1,30,1991,-20
74475595362,74475595360,-2,2251,3890,-20
74476272557,74476272561,4,1939,1208,-20
74476916650,74476916654,4,1851,1686,-20
74478234252,74478234254,2,2566,1988,-20
74479668514,74479668515,1,1181,1256,-20
74481524187,74481524191,4,1973,1182,-20
74482737938,74482737918,-20,1481,1354,-20
74483442942,74483442962,20,1017,704,-20
74485479261,74485479262,1,1682,1404,-20
74488377294,74488377299,5,2178,942,-20
74488846682,74488846685,3,1329,1088,-20
74489865125,74489865127,2,2026,1636,-20
74490641525,74490641529,4,2124,2256,-20
74491548658,74491548661,3,1507,1100,-20
74491901318,74491901321,3,1716,1817,-20
74492796325,74492796328,3,1549,1525,-20
74494218619,74494218622,3,1602,955,-20
74495376095,74495376104,9,12072,24312,-20
74496733493,74496733497,4,1549,1433,-20
74498606925,74498606929,4,1571,1251,-20
74499741974,74499741974,0,1817,1901,-20
74501043343,74501043349,6,1567,1129,-20
74504213192,74504213194,2,1376,1077,-20
74505007553,74505007553,0,1017,1213,-20
74508805558,74508805562,4,2061,1347,-20
74509222805,74509222807,2,1395,1256,-20
74512762726,74512762729,3,2525,1681,-20
74513142704,74513142707,3,2509,10221,-20
74519762631,74519762635,4,1628,1511,-20
74522113309,74522113305,-4,1561,3291,-20
74524614638,74524614643,5,1673,1437,-20
74527480526,74527480532,6,1958,1433,-20
74530387304,74530387308,4,1134,1172,-20
74531696973,74531696977,4,2003,1323,-20
74531786758,74531786762,4,1945,1249,-20
74537269889,74537269891,2,1210,985,-20
74539382418,74539382421,3,1747,1096,-20
74539680955,74539680958,3,1780,1724,-20
74541173485,74541173483,-2,888,1998,-20
74542045294,74542045297,3,2210,1252,-20
74545402056,74545402058,2,1494,1555,-20
74550306605,74550306609,4,3072,1613,-20
74551634449,74551634450,1,1934,1986,-20
74552113572,74552113575,3,1739,1290,-20
74555104937,74555104941,4,1474,1735,-20
74560174733,74560174737,4,2522,1699,-20
74562660856,74562660859,3,2265,1948,-20
74562932573,74562932574,1,1708,1811,-20
74563300577,74563300582,5,2477,1504,-20
74566755881,74566755888,7,4948,1683,-20
74570670016,74570670019,3,1718,1414,-20
74570934489,74570934472,-17,701,254,-20
74571992967,74571992970,3,2084,1582,-20
74572431325,74572431330,5,2673,1076,-20
74572486862,74572486867,5,2334,1444,-20
74574349934,74574349937,3,2351,1255,-20
74574708688,74574708685,-3,574,1882,-20
74575027884,74575027889,5,1460,1564,-20
74577202100,74577202106,6,1534,1271,-20
74578049621,74578049624,3,2622,1944,-20
74581726055,74581726061,6,2316,1411,-20
74585582353,74585582358,5,1892,1509,-20
74586412720,74586412722,2,2064,1970,-20
74588511630,74588511633,3,2125,1339,-20
74588671140,74588671142,2,1659,1816,-20
74590215960,74590215962,2,2120,1436,-20
74590283874,74590283878,4,2516,1598,-20
74590730149,74590730151,2,2054,1535,-20
74592445455,74592445459,4,2115,1464,-20
74593758294,74593758296,2,1794,1722,-20
74597114591,74597114595,4,1966,1498,-20
74600486090,74600486092,2,1298,1581,-20
74601294358,74601294362,4,1731,1682,-20
74601569478,74601569482,4,1601,578,-20
74604540446,74604540447,1,2103,1930,-20
74612718624,74612718627,3,1993,1476,-20
74617659309,74617659311,2,1739,1854,-20
74617734161,74617734162,1,1783,1475,-20
74618346795,74618346795,0,2031,1382,-20
74618493469,74618493471,2,1936,1502,-20
74622014297,74622014298,1,1929,904,-20
74624191717,74624191721,4,1874,1158,-20
74625866523,74625866526,3,2851,1430,-20
74625999842,74625999845,3,2140,1790,-20
74628452583,74628452588,5,1826,1228,-20
74630274830,74630274834,4,1744,1546,-20
74630567653,74630567659,6,1350,1435,-20
74634056182,74634056186,4,2101,1444,-20
74636043758,74636043762,4,1846,1487,-20
74637049855,74637049860,5,1365,1459,-20
74637563344,74637563359,15,463,772,-20
74638930411,74638930416,5,1824,1404,-20
74639272512,74639272515,3,1697,1177,-20
74639978374,74639978352,-22,2001,1755,-20
74645501031,74645501034,3,2015,1129,-20
74647360106,74647360106,0,2162,1121,-20
74650715842,74650715845,3,2615,1873,-20
74653710029,74653710030,1,1562,2090,-20
74653971363,74653971362,-1,1387,1492,-20
74657665271,74657665274,3,2459,1577,-20
74659659387,74659659390,3,1342,1360,-20
74663303849,74663303853,4,3106,1724,-20
74667471046,74667471049,3,1345,1358,-20
74669706890,74669706894,4,1925,1474,-20
74670712525,74670712529,4,1639,1307,-20
74673106081,74673106087,6,2544,763,-20
74676003001,74676003006,5,993,971,-20
74676522221,74676522222,1,1585,1429,-20
74676981845,74676981850,5,2124,1103,-20
74677367841,74677367845,4,2711,1827,-20
74683054185,74683054187,2,1797,1379,-20
74684120355,74684120359,4,1879,1635,-20
74685779850,74685779854,4,2809,1845,-20
74686154926,74686154927,1,1506,1371,-20
74694080311,74694080314,3,1609,1230,-20
74695264032,74695264034,2,1582,1176,-20
74695622296,74695622292,-4,1377,2749,-20
74696650569,74696650575,6,2036,1252,-20
74697516983,74697516985,2,1221,1518,-20
74697984347,74697984362,15,971,1517,-20
74701974358,74701974362,4,1554,861,-20
74703323393,74703323395,2,2057,1420,-20
74704642837,74704642840,3,1716,1422,-20
74706405621,74706405627,6,2849,1133,-20
74708487823,74708487822,-1,1284,2161,-20
74711259298,74711259301,3,1594,845,-20
74714026746,74714026751,5,2337,901,-20
74715457145,74715457146,1,1578,1388,-20
74717233232,74717233237,5,1668,1362,-20
74718453269,74718453270,1,1496,1515,-20
74720786351,74720786355,4,2585,1656,-20
74723075327,74723075330,3,1426,1479,-20
74724378572,74724378578,6,2736,1346,-20
74728562167,74728562165,-2,2049,6361,-20
74729366516,74729366517,1,2039,1449,-20
74736787981,74736787975,-6,1039,3990,-20
74738335873,74738335875,2,2232,1592,-20
74743211952,74743211955,3,1617,1716,-20
74747716838,74747716841,3,2092,1562,-20
74748640070,74748640075,5,2821,1690,-20
74755974887,74755974890,3,1261,1243,-20
74757834870,74757834870,0,1071,1210,-20
74767292806,74767292811,5,1359,1091,-20
74767749498,74767749505,7,1394,1305,-20
74768464847,74768464827,-20,667,524,-20
74771457097,74771457100,3,1664,1324,-20
74773082166,74773082161,-5,858,95,-20
74774278844,74774278846,2,1491,1251,-20
74779872192,74779872189,-3,1970,4704,-20
74782377759,74782377761,2,1362,1426,-20
74782906733,74782906738,5,1514,923,-20
74786728404,74786728403,-1,1145,1059,-20
74790828115,74790828118,3,1458,1074,-20
74795999741,74795999743,2,1786,1616,-20
74797147362,74797147366,4,2752,2012,-20
74797612591,74797612595,4,1546,1407,-20
74798352382,74798352385,3,40588,29031,-20
74798765912,74798765913,1,1489,1298,-20
74802166520,74802166522,2,2372,1673,-20
74804431242,74804431245,3,1914,1569,-20
74804531115,74804531120,5,1544,1212,-20
74806243573,74806243577,4,1257,1150,-20
74809031006,74809031011,5,2289,846,-20
74809859723,74809859705,-18,1280,539,-20
74812722931,74812722934,3,1453,949,-20
74814493526,74814493531,5,2037,1454,-20
74817054583,74817054585,2,1628,1306,-20
74817691081,74817691086,5,3273,1590,-20
74819170860,74819170856,-4,2026,6221,-20
74821347853,74821347858,5,24559,19602,-20
74822022044,74822022046,2,2603,1275,-20
74823788330,74823788325,-5,843,3288,-20
74824191401,74824191403,2,1405,1037,-20
74830401443,74830401447,4,1963,1494,-20
74834647407,74834647412,5,2217,1548,-20
74837433567,74837433570,3,1495,1464,-20
74838167117,74838167120,3,1904,1286,-20
74840030602,74840030606,4,1625,1570,-20
74840682539,74840682541,2,1697,1545,-20
74844002753,74844002755,2,2800,1795,-20
74846066112,74846066113,1,1833,1795,-20
74846722060,74846722063,3,1461,1357,-20
74850081181,74850081182,1,1659,1787,-20
74850568526,74850568529,3,2041,1759,-20
74851011852,74851011835,-17,3766,3049,-20
74857587360,74857587363,3,1083,960,-20
74859686300,74859686304,4,1862,1812,-20
74863645166,74863645171,5,2947,1873,-20
74864282218,74864282219,1,1087,1024,-20
74864506111,74864506106,-5,1194,4245,-20
74865164831,74865164834,3,1924,1523,-20
74867919007,74867919010,3,1551,1285,-20
74868485571,74868485574,3,1451,1206,-20
74869170910,74869170915,5,2183,2075,-20
74871467710,74871467711,1,946,1029,-20
74879985875,74879985880,5,1875,1170,-20
74881414326,74881414328,2,1650,1401,-20
74882875514,74882875518,4,2232,1547,-20
74888501474,74888501478,4,1505,1512,-20
74888875718,74888875722,4,1298,1227,-20
74890031552,74890031555,3,2032,1213,-20
74891235834,74891235841,7,1347,901,-20
74893105832,74893105835,3,1327,1528,-20
74896371688,74896371691,3,1625,976,-20
74898051998,74898052002,4,2220,1609,-20
74899848164,74899848167,3,1717,1225,-20
74904805023,74904805027,4,2144,797,-20
74905693142,74905693147,5,1855,1767,-20
74907542879,74907542882,3,2084,1945,-20
74909174454,74909174455,1,1111,814,-20
74912405611,74912405614,3,1723,1339,-20
74914897142,74914897145,3,1662,1443,-20
74916272373,74916272378,5,2560,1661,-20
74918508282,74918508286,4,2305,1269,-20
74921327087,74921327090,3,1532,1540,-20
74923722785,74923722789,4,1237,1361,-20
74924033544,74924033560,16,1568,1115,-20
74925603633,74925603635,2,1468,1237,-20
74932652571,74932652578,7,2190,1402,-20
74934046525,74934046520,-5,2696,10401,-20
74934744241,74934744248,7,2159,1504,-20
74935073812,74935073816,4,2091,1687,-20
74936093874,74936093878,4,12124,10903,-20
74936127226,74936127234,8,18126,23111,-20
74943985130,74943985134,4,1320,1578,-20
74948011312,74948011316,4,1434,1455,-20
74949938756,74949938758,2,1250,1893,-20
74950461804,74950461807,3,2139,1571,-20
74951375007,74951375010,3,1312,1231,-20
74954790350,74954790353,3,1669,1786,-20
74955106808,74955106812,4,1666,1251,-20
74956137509,74956137490,-19,1691,1203,-20
74958809515,74958809517,2,837,837,-20
74962468397,74962468398,1,2169,1704,-20
74965089412,74965089415,3,2387,1482,-20
74965313721,74965313724,3,1433,1398,-20
74966424230,74966424235,5,2027,1470,-20
74967715123,74967715126,3,1858,1267,-20
74971183194,74971183197,3,1872,1447,-20
74972439326,74972439333,7,1839,1717,-20
74976155777,74976155781,4,1954,1419,-20
74983494558,74983494562,4,1357,1565,-20
74985077873,74985077874,1,1846,1358,-20
74992509910,74992509916,6,1871,1356,-20
74992619438,74992619428,-10,687,77,-20
75005059798,75005059801,3,2851,1959,-20
75007730393,75007730394,1,1393,1179,-20
75011690546,75011690551,5,2567,1749,-20
75012926743,75012926747,4,1982,1318,-20
75013306066,75013306070,4,2096,1119,-20
75015832909,75015832928,19,2330,1391,-20
75016367634,75016367639,5,2016,1792,-20
75016544842,75016544846,4,1651,1388,-20
75017610347,75017610359,12,500,112,-20
75020984003,75020984013,10,1385,1103,-20
75021087967,75021087952,-15,1493,870,-20
75022263706,75022263708,2,1737,1497,-20
75022476014,75022476016,2,1664,1329,-20
75022513412,75022513415,3,1843,1355,-20
75023471416,75023471422,6,2567,1528,-20
75024661995,75024661998,3,1586,1913,-20
75024989899,75024989902,3,1814,1972,-20
75027673609,75027673628,19,1616,1051,-20
75030501492,75030501495,3,1718,1530,-20
75031762919,75031762922,3,1676,1702,-20
75034311626,75034311629,3,1557,1704,-20
75036171159,75036171165,6,5967,2020,-20
75036482756,75036482759,3,1292,1267,-20
75044967666,75044967669,3,1236,1188,-20
75047224822,75047224825,3,800,767,-20
75048380114,75048380118,4,1815,1639,-20
75053556624,75053556628,4,1963,1536,-20
75053721770,75053721774,4,2692,1574,-20
75054046982,75054046994,12,1667,1277,-20
75055259093,75055259098,5,1875,1256,-20
75057718168,75057718162,-6,1608,1474,-20
75059459016,75059459019,3,2069,1175,-20
75063543082,75063543085,3,1905,1570,-20
75065563673,75065563678,5,1582,924,-20
75066188061,75066188062,1,1332,1195,-20
75066740318,75066740324,6,2014,1444,-20
75068662162,75068662165,3,1627,1189,-20
75069959346,75069959351,5,1787,890,-20
75070191575,75070191579,4,2150,1486,-20
75074149226,75074149229,3,2412,1562,-20
75076784134,75076784151,17,13,1222,-20
75078703762,75078703759,-3,1454,2752,-20
75083875200,75083875203,3,1871,1427,-20
75084028739,75084028743,4,1980,1758,-20
75086925383,75086925374,-9,25335,16882,-20
75088624481,75088624482,1,1637,1397,-20
75089882553,75089882554,1,1607,1659,-20
75092009887,75092009890,3,2148,1764,-20
75092230194,75092230186,-8,965,365,-20
75092880182,75092880187,5,1153,1121,-20
75093242387,75093242389,2,1961,1464,-20
75097364413,75097364416,3,1482,1383,-20
75104552653,75104552657,4,2172,1325,-20
75108432702,75108432702,0,1955,2714,-20
75108678595,75108678598,3,1395,1023,-20
75109022640,75109022644,4,1544,1112,-20
75109423114,75109423129,15,926,1072,-20
75109917263,75109917266,3,2122,1660,-20
75110086489,75110086490,1,1344,1277,-20
75111307794,75111307798,4,1516,1321,-20
75115715453,75115715457,4,1532,1416,-20
75116351072,75116351075,3,980,1259,-20
75121344351,75121344353,2,2256,1590,-20
75121542265,75121542283,18,1667,934,-20
75126251785,75126251790,5,1961,2008,-20
75129519808,75129519807,-1,1114,1638,-20
75133631470,75133631467,-3,2195,4423,-20
75134184597,75134184599,2,1315,1052,-20
75134805133,75134805112,-21,1411,1140,-20
75135419233,75135419235,2,1534,1247,-20
75137966427,75137966430,3,1289,1036,-20
75138369186,75138369192,6,3896,1801,-20
75139812085,75139812087,2,2099,1522,-20
75140180486,75140180489,3,1997,1518,-20
75141075430,75141075433,3,2865,1771,-20
75141639333,75141639335,2,1222,1468,-20
75143336982,75143336980,-2,1464,2316,-20
75144602092,75144602096,4,2611,1666,-20
75149191658,75149191661,3,1286,1241,-20
75152445138,75152445141,3,1222,999,-20
75153877715,75153877716,1,1055,1408,-20
75154499203,75154499185,-18,2394,1398,-20
75157067079,75157067084,5,1561,1170,-20
75159448629,75159448636,7,1683,1502,-20
75160397411,75160397427,16,993,995,-20
75174265243,75174265247,4,1480,1327,-20
75175020354,75175020359,5,1924,1498,-20
75177835277,75177835280,3,1123,1700,-20
75180250604,75180250606,2,1410,1708,-20
75182622779,75182622782,3,1281,1171,-20
75184262610,75184262613,3,1025,890,-20
75184442687,75184442690,3,2560,1493,-20
75184519098,75184519103,5,3139,1476,-20
75184549646,75184549650,4,2555,2404,-20
75184897288,75184897291,3,2804,1643,-20
75185073080,75185073082,2,1639,1686,-20
75185541592,75185541594,2,1566,1364,-20
75188182207,75188182210,3,2323,1408,-20
75188904464,75188904469,5,5516,3076,-20
75190032842,75190032847,5,2501,1932,-20
75190519713,75190519712,-1,1481,2273,-20
75198092607,75198092611,4,1419,1117,-20
75201675320,75201675322,2,2013,1917,-20
75209406957,75209406958,1,1434,1467,-20
75212167677,75212167682,5,1763,1316,-20
75212301737,75212301739,2,1114,1534,-20
75213529823,75213529818,-5,1072,2841,-20
75215449305,75215449309,4,1541,1175,-20
75219574089,75219574092,3,2511,1695,-20
75220149308,75220149314,6,2457,1394,-20
75231433482,75231433486,4,1580,1414,-20
75235724694,75235724689,-5,1023,3775,-20
75237946543,75237946549,6,2440,1499,-20
75245987608,75245987610,2,1982,1375,-20
75246302222,75246302225,3,1863,1639,-20
75248592804,75248592802,-2,1887,2528,-20
75253456130,75253456135,5,1776,1377,-20
75253697613,75253697617,4,2052,1455,-20
75257235409,75257235410,1,2237,1221,-20
75258245257,75258245261,4,1726,1421,-20
75258768081,75258768085,4,2012,1705,-20
75266218265,75266218267,2,2348,1644,-20
75268010931,75268010937,6,2054,1154,-20
75268119694,75268119695,1,1392,1138,-20
75268939207,75268939211,4,1959,1233,-20
75270231468,75270231472,4,2046,1007,-20
75270798422,75270798428,6,2063,1449,-20
75272050387,75272050391,4,1242,902,-20
75272315813,75272315815,2,1379,1511,-20
75277222242,75277222246,4,1320,1434,-20
75278644385,75278644391,6,2238,1278,-20
75280359545,75280359547,2,1638,1951,-20
75281789651,75281789654,3,1500,1008,-20
75283211167,75283211173,6,5020,2077,-20
75283314662,75283314662,0,1174,1450,-20
75283868354,75283868355,1,1418,1933,-20
75284783807,75284783814,7,2068,1049,-20
75285589376,75285589379,3,1673,1435,-20
75289777940,75289777941,1,1406,1653,-20
75295078561,75295078565,4,2379,1698,-20
75298825332,75298825330,-2,795,1881,-20
75300213066,75300213070,4,1198,1035,-20
75301310831,75301310830,-1,1548,1691,-20
75302340125,75302340131,6,2633,1431,-20
75303735846,75303735849,3,2684,1597,-20
75304451707,75304451709,2,2941,3869,-20
75306023617,75306023622,5,1667,1437,-20
75310815439,75310815438,-1,1107,1813,-20
75313577125,75313577126,1,1652,1494,-20
75314972054,75314972058,4,1643,1329,-20
75315401766,75315401769,3,1189,1309,-20
75318754940,75318754946,6,6357,24975,-20
75325476454,75325476459,5,1323,879,-20
75328706326,75328706329,3,1468,1723,-20
75331866606,75331866607,1,2029,1475,-20
75333338315,75333338319,4,1689,1213,-20
75334080431,75334080433,2,1987,1311,-20
75334500574,75334500554,-20,1339,560,-20
75335216774,75335216769,-5,522,2551,-20
75336248906,75336248909,3,1992,1354,-20
75339415181,75339415183,2,2277,1106,-20
75340670978,75340670982,4,2891,2251,-20
75340759502,75340759505,3,1542,1548,-20
75341934581,75341934584,3,1741,1602,-20
75344708425,75344708428,3,1997,1585,-20
75345472089,75345472091,2,2027,1847,-20
75346681343,75346681347,4,1237,1437,-20
75347335097,75347335098,1,2021,1435,-20
75348175093,75348175090,-3,7280,11985,-20
75348269206,75348269209,3,1916,1190,-20
75349307553,75349307557,4,2023,2179,-20
75353054434,75353054440,6,2145,1316,-20
75353778413,75353778417,4,1774,1392,-20
75354474242,75354474244,2,1734,2113,-20
75357306685,75357306689,4,1082,693,-20
75360606900,75360606908,8,10735,30913,-20
75363063157,75363063162,5,1575,1424,-20
75363378305,75363378302,-3,1386,1907,-20
75370171726,75370171731,5,2107,1223,-20
75370568654,75370568667,13,1429,1772,-20
75373751405,75373751406,1,1873,1702,-20
75375891469,75375891473,4,1830,1278,-20
75376527519,75376527523,4,1547,1072,-20
75379511682,75379511685,3,2042,1978,-20
75386166966,75386166969,3,1202,1420,-20
75388925683,75388925687,4,1307,1221,-20
75389072206,75389072206,0,1720,1878,-20
75393366885,75393366887,2,948,953,-20
75400253581,75400253582,1,1862,1022,-20
75401965118,75401965122,4,1513,1340,-20
75403255522,75403255534,12,575,383,-20
75404348630,75404348610,-20,1449,1013,-20
75404770416,75404770419,3,1610,1415,-20
75409950763,75409950766,3,1325,900,-20
75410073405,75410073426,21,1608,1333,-20
75412036601,75412036605,4,1892,1918,-20
75413054191,75413054178,-13,835,422,-20
75418766802,75418766806,4,1566,1115,-20
75421514816,75421514821,5,2178,1011,-20
75427703367,75427703358,-9,654,2462,-20
75429170131,75429170144,13,3101,1214,-20
75429327073,75429327081,8,2022,1730,-20
75429528239,75429528242,3,1221,909,-20
75433683306,75433683311,5,1492,1360,-20
75435902373,75435902377,4,1836,1876,-20
75437386929,75437386929,0,1308,2349,-20
75438123810,75438123816,6,2116,1167,-20
75438494193,75438494198,5,2294,1325,-20
75440068058,75440068063,5,1416,1319,-20
75443904895,75443904894,-1,853,843,-20
75446745635,75446745639,4,1583,1097,-20
75447306548,75447306552,4,1455,1256,-20
75447427482,75447427485,3,1326,1368,-20
75450465416,75450465422,6,4268,1413,-20
75450514059,75450514063,4,2409,1887,-20
75451262653,75451262654,1,1638,1189,-20
75451581022,75451581024,2,1137,1317,-20
75454536694,75454536695,1,2017,1533,-20
75457324625,75457324625,0,1563,1714,-20
75457423562,75457423562,0,1305,1057,-20
75457779358,75457779362,4,1414,1281,-20
75457931795,75457931802,7,2437,736,-20
75461911128,75461911132,4,1092,1189,-20
75462521689,75462521695,6,2184,911,-20
75463357361,75463357365,4,1510,1551,-20
75464084837,75464084840,3,1345,1121,-20
75467167030,75467167030,0,1099,1644,-20
75468205538,75468205542,4,1712,1837,-20
75468422920,75468422921,1,1252,1530,-20
75469964760,75469964762,2,1843,1425,-20
75470448707,75470448722,15,1216,1265,-20
75472941218,75472941223,5,2142,1321,-20
75476228374,75476228381,7,2526,1720,-20
75478815125,75478815125,0,1730,1776,-20
75479321186,75479321191,5,2886,1623,-20
75482919943,75482919949,6,1412,964,-20
75487844010,75487844014,4,1549,1333,-20
75489688536,75489688538,2,1611,1488,-20
75489936263,75489936266,3,1470,1693,-20
75491973491,75491973494,3,3059,1413,-20
75492883755,75492883740,-15,2029,1051,-20
75496534623,75496534625,2,2993,3523,-20
75501165048,75501165053,5,1769,1035,-20
75501651405,75501651405,0,1625,1611,-20
75502750582,75502750586,4,1633,1514,-20
75503510873,75503510877,4,1582,1467,-20
75504239981,75504239985,4,1812,1192,-20
75506454465,75506454467,2,1595,1367,-20
75508011497,75508011499,2,1814,1174,-20
75508183069,75508183074,5,1033,880,-20
75508452192,75508452194,2,1669,940,-20
75508569889,75508569893,4,2001,1289,-20
75509436302,75509436306,4,1698,1223,-20
75510290263,75510290267,4,2005,1687,-20
75512201439,75512201443,4,2700,1561,-20
75512233658,75512233663,5,1828,1131,-20
75512468023,75512468026,3,1950,1476,-20
75518399214,75518399218,4,2218,1475,-20
75518858682,75518858686,4,1678,2005,-20
75519392315,75519392319,4,1850,1031,-20
75519532150,75519532153,3,2041,1636,-20
75521398026,75521398028,2,2767,2283,-20
75522540046,75522540049,3,1492,1037,-20
75524798394,75524798414,20,518,2612,-20
75524860753,75524860756,3,1421,1033,-20
75527156915,75527156919,4,2042,1207,-20
75527806789,75527806794,5,2186,1478,-20
75528670958,75528670963,5,1906,1148,-20
75529624953,75529624956,3,1894,1472,-20
75530256526,75530256527,1,1486,1442,-20
75533167041,75533167043,2,56609,44246,-20
75533323838,75533323841,3,1612,1296,-20
75533415799,75533415803,4,1600,1514,-20
75533493853,75533493855,2,1953,1552,-20
75536553826,75536553830,4,1838,1489,-20
75536980535,75536980524,-11,575,377,-20
75537863824,75537863829,5,2772,1201,-20
75542642915,75542642917,2,2456,2779,-20
75543425921,75543425925,4,1830,2162,-20
75548975947,75548975950,3,2081,1521,-20
75550173918,75550173924,6,2387,1310,-20
75559481610,75559481615,5,984,958,-20
75565411422,75565411419,-3,1468,3021,-20
75565555743,75565555749,6,1968,1112,-20
75568704190,75568704195,5,1461,1351,-20
75569675522,75569675525,3,1494,1549,-20
75570502827,75570502829,2,1311,1498,-20
75576833578,75576833579,1,1720,2386,-20
75577758768,75577758771,3,2005,1252,-20
75581741087,75581741089,2,3033,1902,-20
75587410914,75587410918,4,2015,1411,-20
75589459883,75589459887,4,1541,1304,-20
75591966132,75591966135,3,2163,1431,-20
75597316823,75597316826,3,1780,1271,-20
75597699526,75597699530,4,3335,1874,-20
75597934880,75597934884,4,1542,1102,-20
75599291572,75599291569,-3,17827,14122,-20
75603055193,75603055197,4,1157,816,-20
75603843325,75603843308,-17,664,74,-20
75606913417,75606913415,-2,862,1006,-20
75610461102,75610461105,3,1298,1631,-20
75613202093,75613202097,4,1668,1273,-20
75613935554,75613935550,-4,1702,5481,-20
75619247082,75619247080,-2,1016,2047,-20
75623827842,75623827846,4,1294,1167,-20
75625852527,75625852508,-19,867,713,-20
75627809453,75627809457,4,2194,1554,-20
75633379030,75633379036,6,1624,1296,-20
75636611722,75636611726,4,1547,1514,-20
75640554941,75640554946,5,3164,1830,-20
75644943015,75644943018,3,2749,1797,-20
75645907285,75645907281,-4,2518,5737,-20
75647001651,75647001654,3,1681,1133,-20
75648460941,75648460945,4,1781,1238,-20
75649272272,75649272274,2,1653,1300,-20
75650712465,75650712469,4,1887,1183,-20
75652780466,75652780471,5,1347,823,-20
75659906777,75659906779,2,1661,1211,-20
75660498326,75660498330,4,1533,943,-20
75662547338,75662547341,3,1512,1149,-20
75663267378,75663267382,4,1910,1245,-20
75663888766,75663888770,4,1451,740,-20
75666092768,75666092771,3,2038,1809,-20
75669715161,75669715165,4,2381,1472,-20
75670985137,75670985143,6,2445,1785,-20
75671723878,75671723882,4,1915,2051,-20
75672594583,75672594583,0,1907,1275,-20
75673081193,75673081195,2,2009,1607,-20
75674334455,75674334459,4,1256,1359,-20
75676236218,75676236220,2,2267,2635,-20
75676886352,75676886349,-3,1780,4278,-20
75677884946,75677884948,2,2301,1637,-20
75678064550,75678064553,3,1337,1413,-20
75679092522,75679092526,4,2016,1371,-20
75681104562,75681104566,4,2644,1633,-20
75681444795,75681444798,3,1948,1341,-20
75689649773,75689649775,2,1596,1199,-20
75694374227,75694374230,3,1379,1378,-20
75694602817,75694602819,2,1611,1181,-20
75695782371,75695782374,3,1903,1265,-20
75698330315,75698330317,2,1369,1143,-20
75701403518,75701403521,3,2429,2105,-20
75703120279,75703120283,4,1590,925,-20
75709735610,75709735614,4,2101,1496,-20
75711104606,75711104610,4,1042,1082,-20
75711664979,75711664982,3,1429,1205,-20
75714413762,75714413762,0,2186,1546,-20
75714697769,75714697772,3,1855,1264,-20
75716605294,75716605298,4,1806,1762,-20
75720273656,75720273661,5,2603,1397,-20
75721543555,75721543556,1,1581,1220,-20
75723981878,75723981881,3,1664,1833,-20
75725382085,75725382090,5,1552,1374,-20
75726729145,75726729150,5,2064,1377,-20
75728725657,75728725661,4,1961,1571,-20
75729446067,75729446071,4,2209,1381,-20
75732900527,75732900533,6,1947,1494,-20
75734621906,75734621908,2,2246,1977,-20
75735171931,75735171935,4,1550,877,-20
75738207799,75738207802,3,2374,1843,-20
75742997548,75742997551,3,1777,1615,-20
75744275533,75744275534,1,794,681,-20
75750514210,75750514206,-4,1099,1999,-20
75756412941,75756412943,2,2075,1474,-20
75757649004,75757649007,3,1998,1559,-20
75764332730,75764332732,2,1775,1591,-20
75764952479,75764952483,4,2036,1947,-20
75766088585,75766088589,4,2000,1613,-20
75769736650,75769736653,3,1525,1521,-20
75770390097,75770390098,1,1974,1905,-20
75771026229,75771026231,2,2279,1677,-20
75772748995,75772748998,3,1618,1105,-20
75773911986,75773911990,4,2114,1350,-20
75775069559,75775069562,3,1568,1279,-20
75777551670,75777551673,3,1283,978,-20
75779401092,75779401094,2,1354,1364,-20
75780858581,75780858582,1,1207,1247,-20
75787271417,75787271413,-4,1280,2095,-20
75788330766,75788330769,3,1855,1367,-20
75794112238,75794112239,1,1481,1158,-20
75794944582,75794944585,3,2223,2040,-20
75795686115,75795686119,4,2008,1736,-20
75797700059,75797700063,4,1533,1046,-20
75798611963,75798611967,4,2060,1182,-20
75800963334,75800963313,-21,2484,1179,-20
75804719498,75804719503,5,2134,1602,-20
75806301850,75806301849,-1,1799,2560,-20
75807157066,75807157070,4,1438,1237,-20
75808023738,75808023741,3,1246,1188,-20
75809304030,75809304034,4,1976,1321,-20
75811044583,75811044583,0,1191,1163,-20
75811944905,75811944907,2,1452,1474,-20
75812042185,75812042189,4,1821,1966,-20
75823159895,75823159897,2,1448,1094,-20
75826409671,75826409675,4,2093,1149,-20
75827255752,75827255755,3,1978,1256,-20
75838614810,75838614819,9,2133,1325,-20
75839425051,75839425034,-17,1258,785,-20
75839675618,75839675621,3,1514,1623,-20
75840866219,75840866222,3,1555,1280,-20
75841230777,75841230780,3,1782,1319,-20
75841881420,75841881422,2,1513,1090,-20
75843202126,75843202120,-6,1242,4377,-20
75843515851,75843515854,3,1739,1530,-20
75843736581,75843736586,5,1738,1301,-20
75846066138,75846066141,3,1270,1262,-20
75846327918,75846327921,3,1696,1319,-20
75846586696,75846586698,2,1439,1575,-20
75846778672,75846778658,-14,1457,927,-20
75852664689,75852664689,0,1473,2041,-20
75853562333,75853562337,4,2138,1086,-20
75854711322,75854711323,1,1388,1528,-20
75856502662,75856502664,2,1671,1073,-20
75857727513,75857727517,4,1827,1269,-20
75858199698,75858199702,4,1573,1582,-20
75858326866,75858326869,3,1779,1423,-20
75866607226,75866607230,4,1833,1424,-20
75868268723,75868268727,4,1795,1080,-20
75869180189,75869180198,9,12148,24323,-20
75869465937,75869465941,4,1970,1763,-20
75872033414,75872033420,6,1749,1408,-20
75877527630,75877527646,16,671,2371,-20
75878161562,75878161563,1,1376,1222,-20
75882580308,75882580310,2,2038,1739,-20
75888216130,75888216135,5,2325,1700,-20
75888568074,75888568079,5,2553,1672,-20
75890458763,75890458767,4,1382,1507,-20
75895299785,75895299789,4,1713,1123,-20
75897773875,75897773879,4,1445,1163,-20
75901834598,75901834604,6,1525,1300,-20
75904325558,75904325553,-5,17065,1270,-20
75905589850,75905589851,1,1703,1277,-20
75906406538,75906406543,5,1179,1238,-20
75906758517,75906758500,-17,1100,33,-20
75909890234,75909890238,4,1252,1167,-20
75912056077,75912056081,4,2801,2144,-20
75915255170,75915255171,1,798,553,-20
75922245366,75922245370,4,2544,1751,-20
75926793058,75926793061,3,1452,1433,-20
75927288050,75927288054,4,1749,1397,-20
75931625330,75931625333,3,1973,1635,-20
75932316499,75932316503,4,1930,1475,-20
75933654579,75933654582,3,1818,1891,-20
75936447998,75936447999,1,1872,1322,-20
75937680294,75937680299,5,1914,1258,-20
75938193369,75938193375,6,2126,1780,-20
75938711611,75938711617,6,1825,1442,-20
75940379772,75940379770,-2,984,2029,-20
75942351774,75942351778,4,1603,1414,-20
75945354305,75945354306,1,1306,2040,-20
75947149909,75947149912,3,1508,1146,-20
75954623110,75954623115,5,2404,1307,-20
75955885442,75955885446,4,1944,1235,-20
75958603341,75958603344,3,2296,1670,-20
75959423162,75959423166,4,1467,1391,-20
75960120385,75960120389,4,1579,1388,-20
75960858345,75960858347,2,1832,1446,-20
75963745766,75963745770,4,1625,1628,-20
75967080351,75967080355,4,1824,1118,-20
75970734714,75970734719,5,2116,983,-20
75971712977,75971712978,1,1218,1703,-20
75973772305,75973772307,2,1699,1554,-20
75974282398,75974282399,1,1889,1320,-20
75974720230,75974720232,2,1495,1631,-20
75978050926,75978050929,3,2293,1486,-20
75978833525,75978833530,5,2027,1071,-20
75979855575,75979855582,7,1149,1041,-20
75980748669,75980748689,20,1489,1263,-20
75983749338,75983749343,5,1120,1256,-20
75986966534,75986966537,3,1921,1407,-20
75987182674,75987182675,1,1551,1062,-20
75988259213,75988259216,3,1731,985,-20
75988399125,75988399128,3,2486,1805,-20
75990188520,75990188523,3,1458,1081,-20
75990801541,75990801548,7,1951,1198,-20
75993322597,75993322601,4,1959,1733,-20
75997325702,75997325707,5,1757,1495,-20
75997481403,75997481405,2,1571,1279,-20
75999821571,75999821574,3,1817,1742,-20
76001797272,76001797277,5,1875,1220,-20
76002582828,76002582834,6,2276,1231,-20
76002907278,76002907282,4,1424,1281,-20
76003002495,76003002502,7,2827,1068,-20
76007115742,76007115745,3,2396,1494,-20
76010070318,76010070321,3,1655,1428,-20
76010098062,76010098065,3,1974,1438,-20
76012120182,76012120186,4,1438,1071,-20
76016786004,76016786006,2,2399,1958,-20
76017765513,76017765514,1,1388,1190,-20
76018717030,76018717033,3,1681,1491,-20
76019728354,76019728355,1,1457,1381,-20
76020662571,76020662552,-19,1713,1335,-20
76022357347,76022357350,3,1948,1840,-20
76024734136,76024734142,6,2590,1780,-20
76024775045,76024775057,12,2210,1004,-20
76025474615,76025474619,4,2316,1520,-20
76035413416,76035413419,3,2308,1671,-20
76037005925,76037005929,4,2631,1876,-20
76037272234,76037272237,3,2279,1568,-20
76042384755,76042384758,3,1391,1144,-20
76046661180,76046661182,2,1643,1316,-20
76048624869,76048624874,5,1908,1678,-20
76050337907,76050337910,3,2414,1117,-20
76051494699,76051494702,3,1501,1362,-20
76052193983,76052193986,3,1102,658,-20
76053916069,76053916075,6,1323,1428,-20
76054264700,76054264702,2,1755,1450,-20
76061060078,76061060081,3,2466,1622,-20
76064580517,76064580522,5,2481,1310,-20
76066525154,76066525159,5,1485,1357,-20
76067443760,76067443764,4,2320,1169,-20
76070556195,76070556195,0,1302,1837,-20
76071812843,76071812861,18,14295,50319,-20
76072719933,76072719938,5,1668,1683,-20
76073593374,76073593378,4,2211,1442,-20
76074083098,76074083102,4,1533,1421,-20
76075733425,76075733426,1,1896,1530,-20
76076019158,76076019159,1,2430,1527,-20
76076387334,76076387338,4,2329,1818,-20
76076971683,76076971687,4,1899,1353,-20
76081286653,76081286656,3,2821,1616,-20
76082039030,76082039034,4,1634,1197,-20
76083031615,76083031622,7,3200,1170,-20
76084948594,76084948598,4,1281,994,-20
76086125493,76086125495,2,1429,668,-20
76087536294,76087536297,3,1369,1357,-20
76089197331,76089197334,3,1181,1280,-20
76090016833,76090016836,3,1887,1457,-20
76090431905,76090431915,10,423,200,-20
76091297924,76091297927,3,1847,1289,-20
76091347886,76091347867,-19,1467,1191,-20
76093906182,76093906186,4,1517,1137,-20
76095646446,76095646450,4,1652,1275,-20
76098419105,76098419102,-3,5219,12414,-20
76100220851,76100220854,3,2406,1002,-20
76102438723,76102438726,3,1899,1883,-20
76104682863,76104682855,-8,798,2663,-20
76104924138,76104924141,3,2398,1417,-20
76107842657,76107842662,5,3997,1520,-20
76109423050,76109423054,4,2103,1157,-20
76110360795,76110360798,3,1922,1298,-20
76112467037,76112467041,4,2082,1071,-20
76113341351,76113341354,3,1358,1241,-20
76114705338,76114705344,6,2380,1746,-20
76115397990,76115397996,6,1137,1070,-20
76117414636,76117414639,3,1726,1380,-20
76118937451,76118937454,3,1487,1127,-20
76119078234,76119078238,4,1643,995,-20
76121930453,76121930458,5,1461,1342,-20
76127102938,76127102943,5,2496,1504,-20
76127753378,76127753383,5,2363,2145,-20
76128831077,76128831078,1,2204,1983,-20
76134900302,76134900307,5,2405,1929,-20
76135359830,76135359838,8,5534,1660,-20
76136351196,76136351199,3,1185,1458,-20
76138105025,76138105026,1,1341,640,-20
76138207490,76138207492,2,1310,1063,-20
76138352687,76138352665,-22,6521,2847,-20
76139397284,76139397286,2,1505,2761,-20
76140348042,76140348046,4,2078,1332,-20
76141152330,76141152333,3,1596,1657,-20
76142890428,76142890433,5,1710,1258,-20
76142946046,76142946051,5,1387,926,-20
76149616014,76149616018,4,2090,1651,-20
76152790483,76152790486,3,2570,1916,-20
76153412339,76153412337,-2,1429,2954,-20
76154363813,76154363815,2,1717,1142,-20
76157397601,76157397607,6,2258,1943,-20
76159424431,76159424434,3,2984,1546,-20
76160315864,76160315869,5,1045,1244,-20
76167036074,76167036077,3,1510,1345,-20
76169503573,76169503570,-3,1381,2148,-20
76173539485,76173539486,1,1952,1631,-20
76174482112,76174482118,6,1981,1313,-20
76176981110,76176981114,4,2949,1510,-20
76177340225,76177340229,4,2075,1309,-20
76178940463,76178940463,0,691,1066,-20
76186617401,76186617402,1,1797,1131,-20
76188357590,76188357593,3,2203,1624,-20
76188533823,76188533827,4,1772,1371,-20
76192243094,76192243095,1,1397,1452,-20
76193381935,76193381938,3,1921,1207,-20
76194966415,76194966418,3,1707,1564,-20
76195026786,76195026791,5,2292,1547,-20
76195067538,76195067542,4,2329,1478,-20
76195393666,76195393671,5,2380,1874,-20
76197215349,76197215354,5,15703,9160,-20
76201030264,76201030266,2,1728,1174,-20
76202196453,76202196455,2,1021,1060,-20
76205040258,76205040262,4,1853,1152,-20
76206107865,76206107870,5,2064,1431,-20
76218302088,76218302094,6,1830,957,-20
76219573694,76219573696,2,1425,1565,-20
76220348487,76220348475,-12,1571,1256,-20
76221295753,76221295754,1,1545,1893,-20
76222351006,76222351011,5,2082,1309,-20
76224165654,76224165658,4,1556,1117,-20
76224844756,76224844738,-18,2236,1795,-20
76226737020,76226737022,2,2340,1539,-20
76230477279,76230477279,0,2046,1956,-20
76230842646,76230842651,5,2028,1340,-20
76232817967,76232817971,4,2049,1499,-20
76234227171,76234227169,-2,728,1202,-20
76238910858,76238910862,4,1404,1565,-20
76239321199,76239321202,3,1573,1624,-20
76242912231,76242912234,3,2306,1267,-20
76248239991,76248239993,2,2369,1446,-20
76250176999,76250177004,5,1722,1164,-20
76252648341,76252648343,2,1461,942,-20
76254513234,76254513238,4,1983,1768,-20
76254584753,76254584758,5,2193,992,-20
76254909805,76254909812,7,2895,1218,-20
76257179693,76257179698,5,2035,1234,-20
76257619858,76257619861,3,1910,1335,-20
76259189367,76259189373,6,2548,1453,-20
76259704838,76259704819,-19,633,459,-20
76262372658,76262372661,3,2048,1575,-20
76262931086,76262931094,8,3426,1419,-20
76263529167,76263529169,2,1838,1421,-20
76266601637,76266601638,1,1624,1538,-20
76272880006,76272880010,4,1538,1799,-20
76272924214,76272924217,3,1848,1550,-20
76273474597,76273474602,5,2132,1333,-20
76279317834,76279317839,5,1279,1265,-20
76280597207,76280597211,4,845,1142,-20
76280768665,76280768686,21,368,1703,-20
76283187778,76283187782,4,1986,1707,-20
76284158779,76284158782,3,1396,1203,-20
76285059012,76285059016,4,2406,2096,-20
76286059593,76286059595,2,2483,1457,-20
76287747525,76287747529,4,2116,1322,-20
76287893447,76287893424,-23,1672,1118,-20
76291593514,76291593518,4,1804,1647,-20
76292468129,76292468129,0,992,1336,-20
76296149197,76296149179,-18,1093,1373,-20
76301094918,76301094919,1,1090,952,-20
76303313114,76303313115,1,1536,990,-20
76305399322,76305399327,5,1579,1549,-20
76307559891,76307559894,3,1795,1475,-20
76309140130,76309140132,2,1301,1226,-20
76316379706,76316379707,1,1087,895,-20
76318540535,76318540539,4,2008,1252,-20
76319557351,76319557355,4,1908,1603,-20
76321489407,76321489409,2,981,1259,-20
76323373820,76323373820,0,1952,1311,-20
76326998777,76326998781,4,1705,1155,-20
76328353060,76328353062,2,2305,1621,-20
76329581984,76329581986,2,1709,785,-20
76333310275,76333310275,0,1540,1280,-20
76333875074,76333875075,1,1424,1255,-20
76340389717,76340389722,5,3137,1630,-20
76340547102,76340547107,5,2082,1404,-20
76341516778,76341516779,1,1120,609,-20
76342159336,76342159338,2,1698,1247,-20
76342285613,76342285616,3,1284,1097,-20
76344080523,76344080541,18,4467,12788,-20
76345736013,76345736014,1,1812,2127,-20
76351615763,76351615767,4,2178,1412,-20
76352945385,76352945387,2,1420,1405,-20
76354194909,76354194915,6,990,969,-20
76356879317,76356879318,1,1787,1265,-20
76359757538,76359757542,4,1761,1310,-20
76360710575,76360710556,-19,1909,1622,-20
76366088595,76366088598,3,1436,1182,-20
76371627790,76371627791,1,1561,1180,-20
76379938539,76379938545,6,2256,1166,-20
76379972110,76379972113,3,1606,1534,-20
76380425958,76380425961,3,2266,1563,-20
76380665382,76380665386,4,1595,1029,-20
76382034187,76382034190,3,1828,1120,-20
76383111817,76383111819,2,1624,1075,-20
76385277825,76385277826,1,1152,1056,-20
76386158933,76386158938,5,1554,1562,-20
76387409166,76387409169,3,1292,1578,-20
76387988221,76387988219,-2,1430,3138,-20
76389352909,76389352910,1,1287,1210,-20
76394248359,76394248365,6,1154,1145,-20
76394932760,76394932763,3,1266,800,-20
76395346694,76395346698,4,1588,1380,-20
76397528517,76397528520,3,1914,1174,-20
76400927733,76400927736,3,1937,1338,-20
76401775896,76401775898,2,1802,1448,-20
76403360658,76403360662,4,1799,952,-20
76403505402,76403505405,3,1146,1227,-20
76409023788,76409023791,3,2015,1220,-20
76409764233,76409764236,3,2566,2064,-20
76410564505,76410564507,2,1528,1669,-20
76411672026,76411672031,5,2096,1323,-20
76412124029,76412124030,1,1807,1302,-20
76415991506,76415991507,1,1567,1246,-20
76417856726,76417856730,4,1559,1275,-20
76422580162,76422580171,9,9573,36530,-20
76423129290,76423129294,4,2371,1421,-20
76426754601,76426754610,9,2495,1567,-20
76429294812,76429294809,-3,1705,3157,-20
76431845399,76431845401,2,774,1237,-20
76432064635,76432064639,4,1355,1242,-20
76432556675,76432556678,3,1696,1414,-20
76433647088,76433647090,2,2144,1567,-20
76441023344,76441023352,8,2110,1497,-20
76443817397,76443817398,1,1827,1862,-20
76444963602,76444963602,0,1410,2047,-20
76444997478,76444997483,5,1918,1352,-20
76448085853,76448085855,2,1207,1104,-20
76450185341,76450185345,4,2343,1292,-20
76457336213,76457336215,2,1398,625,-20
76459065352,76459065355,3,1560,1518,-20
76460013312,76460013316,4,2838,1866,-20
76468153492,76468153494,2,1663,1070,-20
76469007325,76469007328,3,1621,946,-20
76471563566,76471563567,1,1440,1186,-20
76472679705,76472679709,4,1665,1180,-20
76476305847,76476305851,4,1644,1424,-20
76478255703,76478255707,4,1263,1090,-20
76483321993,76483321991,-2,1903,2574,-20
76489772553,76489772557,4,1903,1654,-20
76492246265,76492246268,3,1327,1821,-20
76493185357,76493185361,4,1750,1465,-20
76494023525,76494023528,3,2201,1607,-20
76497141663,76497141667,4,1801,1715,-20
76502463056,76502463064,8,673,877,-20
76504349661,76504349665,4,1372,1547,-20
76507266081,76507266081,0,1513,1449,-20
76509040976,76509040978,2,2189,1653,-20
76511925138,76511925145,7,1543,1186,-20
76515464996,76515464999,3,1735,1207,-20
76516266058,76516266061,3,2182,1808,-20
76516705248,76516705251,3,1768,1719,-20
76516911965,76516911969,4,1970,1432,-20
76522925296,76522925299,3,1188,1013,-20
76527772347,76527772350,3,1774,973,-20
76528234647,76528234650,3,1682,1184,-20
76530069269,76530069273,4,1669,1248,-20
76530900237,76530900243,6,1503,858,-20
76533119743,76533119747,4,1715,1558,-20
76534112376,76534112378,2,2119,1241,-20
76534724077,76534724081,4,2523,1755,-20
76536432026,76536432028,2,1898,1842,-20
76538417097,76538417102,5,750,1221,-20
76539897233,76539897235,2,1313,1072,-20
76543605733,76543605736,3,1956,1753,-20
76544749990,76544749993,3,1628,1180,-20
76545200740,76545200742,2,1409,1752,-20
76547436178,76547436181,3,1665,1642,-20
76547563228,76547563210,-18,1672,1086,-20
76547775151,76547775155,4,1471,1023,-20
76548164128,76548164126,-2,1127,2128,-20
76551571131,76551571138,7,9175,25966,-20
76551700304,76551700307,3,2029,1531,-20
76552149942,76552149940,-2,3002,8852,-20
76555301605,76555301609,4,1946,1275,-20
76557658792,76557658795,3,1726,822,-20
76559259488,76559259490,2,1512,1439,-20
76560988476,76560988478,2,1350,855,-20
76562146209,76562146213,4,1516,1122,-20
76564678491,76564678494,3,2597,1635,-20
76564889330,76564889333,3,2459,1517,-20
76566934000,76566934003,3,2233,1108,-20
76566982402,76566982409,7,1446,1111,-20
76568839054,76568839057,3,2357,1769,-20
76569952474,76569952475,1,1297,1508,-20
76573293772,76573293774,2,2048,1285,-20
76573433952,76573433960,8,12704,27896,-20
76573966137,76573966141,4,1820,1573,-20
76576757813,76576757815,2,1005,1372,-20
76580592078,76580592083,5,1964,1533,-20
76583355990,76583355994,4,1633,1050,-20
76590513047,76590513050,3,1650,1332,-20
76594075699,76594075701,2,1106,1207,-20
76595431367,76595431369,2,1648,2260,-20
76598076524,76598076527,3,2507,1316,-20
76600185359,76600185362,3,2531,1648,-20
76601905187,76601905182,-5,1074,3290,-20
76602948838,76602948839,1,1848,1803,-20
76604008289,76604008293,4,1535,1153,-20
76607725753,76607725754,1,1549,1520,-20
76609868286,76609868291,5,1728,1519,-20
76613950972,76613950974,2,1936,1094,-20
76615581765,76615581768,3,1514,1714,-20
76615873257,76615873260,3,1791,1529,-20
76617123666,76617123671,5,1662,1722,-20
76617499322,76617499326,4,1923,1820,-20
76621640231,76621640235,4,1737,1603,-20
76623288039,76623288043,4,1387,1199,-20
76623772010,76623772013,3,1666,1142,-20
76624352576,76624352578,2,1470,1325,-20
76625404302,76625404306,4,2303,1727,-20
76626378161,76626378164,3,2298,1120,-20
76628762343,76628762346,3,1301,1334,-20
76630925110,76630925115,5,999,934,-20
76631795752,76631795756,4,1616,1298,-20
76632241040,76632241039,-1,1770,2121,-20
76637588899,76637588899,0,1639,2215,-20
76638089706,76638089710,4,1521,1471,-20
76641582613,76641582614,1,1736,1536,-20
76644992969,76644992973,4,1458,1054,-20
76645134303,76645134307,4,1640,1176,-20
76648096786,76648096790,4,2598,2158,-20
76649460090,76649460090,0,2057,1573,-20
76653550241,76653550243,2,1667,1455,-20
76661507419,76661507422,3,2032,1595,-20
76662192954,76662192958,4,2465,1592,-20
76662626213,76662626227,14,2100,1291,-20
76664383693,76664383697,4,1437,1215,-20
76665183804,76665183807,3,2104,1212,-20
76666779284,76666779289,5,1894,1585,-20
76667469414,76667469415,1,1820,1153,-20
76668032169,76668032174,5,2708,1380,-20
76668655717,76668655713,-4,1719,5129,-20
76672430982,76672430987,5,1272,1006,-20
76673593217,76673593222,5,3500,1670,-20
76676897286,76676897289,3,2310,1350,-20
76678188590,76678188588,-2,713,2199,-20
76682887437,76682887457,20,1592,842,-20
76687703443,76687703446,3,1504,1228,-20
76693444345,76693444347,2,2179,1309,-20
76698797813,76698797817,4,1823,2250,-20
76702723486,76702723481,-5,2887,10370,-20
76703380739,76703380743,4,1338,1100,-20
76706655037,76706655039,2,1543,1561,-20
76706851162,76706851166,4,1604,1084,-20
76712986475,76712986479,4,1925,1830,-20
76714574813,76714574819,6,1690,1641,-20
76715450045,76715450028,-17,872,982,-20
76717326441,76717326439,-2,2493,5728,-20
76718253455,76718253458,3,853,953,-20
76719512799,76719512801,2,1724,1405,-20
76722529110,76722529110,0,1551,1684,-20
76724017434,76724017430,-4,1097,3501,-20
76731667612,76731667615,3,1787,1768,-20
76732026937,76732026940,3,2107,1302,-20
76736698250,76736698255,5,1399,1133,-20
76737797440,76737797443,3,2158,1542,-20
76738177985,76738177989,4,1719,1328,-20
76738696934,76738696940,6,2603,1680,-20
76739324465,76739324469,4,2263,1731,-20
76740267096,76740267102,6,11281,27259,-20
76745491454,76745491458,4,1689,1329,-20
76749104952,76749104959,7,2346,1383,-20
76754894858,76754894859,1,1307,1194,-20
76756581762,76756581766,4,2045,1585,-20
76759363710,76759363714,4,1946,1074,-20
76764609967,76764609973,6,2222,1924,-20
76766550477,76766550482,5,1769,1399,-20
76773503630,76773503633,3,1706,1105,-20
76775518638,76775518641,3,1190,1432,-20
76775868414,76775868417,3,1460,1489,-20
76777578606,76777578608,2,2064,2251,-20
76778879474,76778879480,6,2163,1477,-20
76783114296,76783114300,4,1391,1092,-20
76783494368,76783494371,3,2204,1361,-20
76783705455,76783705458,3,1624,1307,-20
76784344146,76784344145,-1,1123,1496,-20
76786070288,76786070282,-6,29880,13211,-20
76791420989,76791420990,1,2232,1682,-20
76791914298,76791914301,3,1805,1659,-20
76792631183,76792631186,3,2078,1270,-20
76793767221,76793767224,3,2011,1584,-20
76796691604,76796691607,3,1921,1376,-20
76798303246,76798303250,4,808,927,-20
76801607442,76801607443,1,1189,1211,-20
76806052542,76806052540,-2,940,2074,-20
76806976094,76806976097,3,1772,1698,-20
76808548661,76808548665,4,1928,1263,-20
76809567421,76809567441,20,1586,2095,-20
76809928982,76809928985,3,1979,1567,-20
76811811981,76811811983,2,1710,1377,-20
76814140593,76814140595,2,1253,1044,-20
76816601185,76816601186,1,1867,1694,-20
76820286107,76820286119,12,420,674,-20
76820723111,76820723114,3,1312,869,-20
76821464935,76821464938,3,2073,1275,-20
76823531858,76823531860,2,1557,1214,-20
76826347744,76826347746,2,2668,2601,-20
76826963842,76826963845,3,1160,1225,-20
76829523802,76829523806,4,1305,1648,-20
76831609687,76831609691,4,1391,1300,-20
76832820621,76832820625,4,1900,2056,-20
76834013829,76834013831,2,1815,1534,-20
76839565862,76839565866,4,2027,1684,-20
76842038372,76842038376,4,2302,1369,-20
76844812813,76844812814,1,1741,1461,-20
76852160426,76852160430,4,2409,1574,-20
76853704713,76853704714,1,1915,2046,-20
76858206753,76858206758,5,1914,1466,-20
76858523819,76858523819,0,2070,2397,-20
76863209824,76863209826,2,1524,609,-20
76863889070,76863889073,3,1884,973,-20
76869871295,76869871298,3,2109,1403,-20
76871299733,76871299735,2,1239,1375,-20
76871624386,76871624389,3,1946,1731,-20
76872962297,76872962297,0,30382,33771,-20
76876483017,76876483019,2,1322,1206,-20
76877889863,76877889865,2,1016,1312,-20
76878186136,76878186141,5,1874,1201,-20
76881634988,76881634991,3,2417,1358,-20
76885458602,76885458606,4,1866,1268,-20
76885689162,76885689168,6,2309,1819,-20
76888847336,76888847341,5,1823,1705,-20
76889706142,76889706147,5,1817,1214,-20
76890836377,76890836374,-3,966,2390,-20
76891248122,76891248124,2,1851,2444,-20
76893394394,76893394398,4,2352,1122,-20
76894067507,76894067512,5,1602,1262,-20
76896498984,76896498987,3,2111,1534,-20
76896739961,76896739965,4,2540,1903,-20
76901025862,76901025858,-4,2004,4456,-20
76902811381,76902811385,4,1930,1248,-20
76905621825,76905621827,2,1369,1286,-20
76908256256,76908256259,3,1606,1448,-20
76911552275,76911552279,4,1731,1447,-20
76911594287,76911594286,-1,913,492,-20
76913535866,76913535869,3,1504,1032,-20
76917344759,76917344753,-6,178,656,-20
76919219152,76919219155,3,1466,1609,-20
76921326318,76921326321,3,1481,1578,-20
76922402409,76922402411,2,2483,1837,-20
76929439095,76929439098,3,1992,1707,-20
76929665880,76929665882,2,1972,1091,-20
76932911761,76932911762,1,1217,1602,-20
76933146887,76933146890,3,2013,908,-20
76933474206,76933474209,3,1918,1133,-20
76933628924,76933628936,12,1742,1859,-20
76935200937,76935200939,2,2193,1335,-20
76937816833,76937816834,1,1619,2033,-20
76938534983,76938534986,3,2557,1736,-20
76939555069,76939555074,5,1730,1247,-20
76940254038,76940254041,3,2206,1258,-20
76945000710,76945000688,-22,727,619,-20
76947332072,76947332077,5,2211,1663,-20
76947857793,76947857797,4,1614,1261,-20
76948273697,76948273699,2,1403,1382,-20
76949379572,76949379578,6,1897,1405,-20
76952485799,76952485803,4,1964,1347,-20
76957727880,76957727882,2,1337,1337,-20
76957935271,76957935274,3,1261,1401,-20
76958247833,76958247835,2,2168,2078,-20
76960621417,76960621420,3,1544,1738,-20
76962727283,76962727286,3,1729,1256,-20
76966575940,76966575943,3,1544,1164,-20
76967610246,76967610246,0,1016,1767,-20
76967735016,76967735022,6,276,8897,-20
76969437051,76969437054,3,1737,1926,-20
76970407788,76970407791,3,2310,1208,-20
76973127351,76973127353,2,1533,1240,-20
76977108734,76977108738,4,2188,1210,-20
76981439661,76981439667,6,4034,1439,-20
76981487375,76981487378,3,1572,1204,-20
76985848071,76985848073,2,1780,1347,-20
76986827449,76986827453,4,1286,1124,-20
76988930327,76988930330,3,1579,1267,-20
76995475897,76995475902,5,2006,1685,-20
76998956823,76998956826,3,2243,1719,-20
76999537316,76999537321,5,2329,1144,-20
77007285606,77007285610,4,2425,1719,-20
77011613374,77011613377,3,1679,1773,-20
77012199263,77012199267,4,1615,1387,-20
77012767206,77012767210,4,2375,1720,-20
77013030847,77013030850,3,1378,919,-20
77015292011,77015292014,3,1924,1506,-20
77016486563,77016486566,3,1821,1466,-20
77024909279,77024909283,4,2068,1370,-20
77025639802,77025639806,4,1875,1187,-20
77026250669,77026250672,3,3716,2575,-20
77028587647,77028587658,11,2715,1318,-20
77029090506,77029090510,4,1340,960,-20
77029201951,77029201953,2,2025,1499,-20
77036497558,77036497559,1,1829,1518,-20
77041512699,77041512693,-6,1804,10495,-20
77043066713,77043066717,4,1209,940,-20
77043146230,77043146234,4,1401,1232,-20
77043633337,77043633339,2,1591,1737,-20
77047567657,77047567657,0,1279,1504,-20
77047802377,77047802378,1,1323,1183,-20
77051803854,77051803834,-20,1927,912,-20
77052717299,77052717302,3,1615,1555,-20
77058603789,77058603794,5,2232,1831,-20
77059466232,77059466237,5,1708,1334,-20
77066719059,77066719062,3,1510,1674,-20
77067481411,77067481414,3,2053,1519,-20
77067984658,77067984662,4,2267,1462,-20
77069247903,77069247906,3,1540,992,-20
77070995177,77070995182,5,2343,1673,-20
77071643737,77071643739,2,2103,1411,-20
77071927493,77071927498,5,1587,1129,-20
77074701382,77074701386,4,1549,1264,-20
77076587761,77076587759,-2,1418,2012,-20
77077386674,77077386678,4,2345,1416,-20
77079169749,77079169750,1,2213,1940,-20
77079216793,77079216797,4,1894,1514,-20
77081462743,77081462746,3,3298,2603,-20
77081591370,77081591372,2,965,1218,-20
77086164646,77086164651,5,2278,1601,-20
77090987910,77090987914,4,1074,913,-20
77092783376,77092783379,3,2321,1706,-20
77093923514,77093923518,4,1636,1244,-20
77096916656,77096916660,4,2294,2427,-20
77101613666,77101613670,4,1863,1011,-20
77106096178,77106096170,-8,593,5931,-20
77107635756,77107635761,5,1702,989,-20
77108270756,77108270757,1,1524,1602,-20
77113833863,77113833862,-1,1496,1519,-20
77117418897,77117418905,8,3786,1703,-20
77117718122,77117718126,4,1069,1016,-20
77119263586,77119263590,4,941,1300,-20
77120708177,77120708181,4,2176,1749,-20
77121876902,77121876906,4,1451,1357,-20
77122053678,77122053682,4,2078,1286,-20
77122340801,77122340803,2,1653,999,-20
77123318958,77123318962,4,1989,1580,-20
77124750040,77124750047,7,2187,1437,-20
77125587018,77125587020,2,1955,1208,-20
77126904868,77126904871,3,1545,1592,-20
77127204171,77127204173,2,1477,1297,-20
77128350925,77128350926,1,1488,1368,-20
77129883674,77129883678,4,1622,1348,-20
77135409142,77135409151,9,3054,1211,-20
77136557700,77136557702,2,2072,1366,-20
77137094261,77137094267,6,1575,1015,-20
77137590114,77137590118,4,1545,1489,-20
77141273315,77141273319,4,2060,1477,-20
77145282582,77145282585,3,2396,1480,-20
77152832226,77152832231,5,1699,1428,-20
77153072442,77153072425,-17,1161,1329,-20
77153871630,77153871632,2,1392,1028,-20
77155374279,77155374282,3,1789,1614,-20
77155865042,77155865045,3,1223,1655,-20
77159788430,77159788434,4,1617,734,-20
77160329698,77160329699,1,1207,898,-20
77161646411,77161646413,2,1673,1239,-20
77162506061,77162506066,5,2800,1316,-20
77171890352,77171890356,4,2154,1559,-20
77174070383,77174070387,4,1896,1641,-20
77175102292,77175102293,1,2271,1046,-20
77176830063,77176830063,0,1270,1182,-20
77177534402,77177534402,0,1219,1594,-20
77180417950,77180417955,5,1916,1401,-20
77184847714,77184847715,1,1947,1294,-20
77188108067,77188108070,3,1225,1284,-20
77195617399,77195617405,6,5806,2547,-20
77196914963,77196914967,4,2214,1294,-20
77198118558,77198118567,9,11091,31784,-20
77201470835,77201470830,-5,2190,4945,-20
77201537327,77201537330,3,1739,1468,-20
77202670169,77202670170,1,2082,1338,-20
77208582445,77208582446,1,1364,1180,-20
77213664882,77213664887,5,2560,1280,-20
77214212960,77214212964,4,2215,1407,-20
77215370545,77215370547,2,2087,2027,-20
77217506144,77217506146,2,1810,1156,-20
77219529007,77219529011,4,2215,1336,-20
77220359007,77220359010,3,1102,1215,-20
77222222423,77222222422,-1,1732,2310,-20
77222327108,77222327113,5,2157,1684,-20
77225036014,77225036018,4,898,962,-20
77231537863,77231537863,0,2022,2266,-20
77231699322,77231699326,4,1640,1729,-20
77238098251,77238098253,2,2144,1778,-20
77238680197,77238680199,2,1905,1361,-20
77242148024,77242148029,5,1604,813,-20
77244492954,77244492958,4,1837,1449,-20
77249526621,77249526625,4,1895,1952,-20
77252524812,77252524815,3,2694,1797,-20
77252772905,77252772908,3,1815,1782,-20
77257183150,77257183153,3,1570,1513,-20
77260298577,77260298579,2,1895,998,-20
77260377819,77260377803,-16,1944,1436,-20
77261831015,77261831018,3,1208,1030,-20
77262968151,77262968163,12,1849,1552,-20
77267859030,77267859033,3,1824,1520,-20
77268722371,77268722373,2,1474,1300,-20
77274268879,77274268885,6,2033,1154,-20
77274923591,77274923594,3,2028,1335,-20
77277264022,77277264026,4,1361,1183,-20
77279437244,77279437248,4,2557,1774,-20
77279570886,77279570888,2,1669,1464,-20
77282219770,77282219773,3,1352,875,-20
77285138188,77285138190,2,1594,1747,-20
77290210260,77290210264,4,2493,2331,-20
77292426947,77292426951,4,1052,914,-20
77294152373,77294152354,-19,2136,1235,-20
77295664998,77295665003,5,2173,2030,-20
77295790762,77295790765,3,2381,1979,-20
77299556990,77299556997,7,3016,1217,-20
77302480238,77302480243,5,1824,1569,-20
77302635111,77302635113,2,515,82,-20
77303609486,77303609466,-20,1520,816,-20
77304259020,77304259023,3,2426,2029,-20
77304872445,77304872449,4,2178,1833,-20
77308845354,77308845350,-4,1959,5789,-20
77311937458,77311937461,3,1141,1140,-20
77312410897,77312410898,1,1445,1547,-20
77314139470,77314139473,3,2277,1629,-20
77316470294,77316470297,3,1206,1195,-20
77320170493,77320170497,4,1668,1238,-20
77323819527,77323819531,4,2951,1746,-20
77327138027,77327138030,3,1803,1834,-20
77327328250,77327328255,5,1787,932,-20
77328758888,77328758892,4,1982,1252,-20
77329880775,77329880794,19,1388,1097,-20
77330901621,77330901625,4,1736,1760,-20
77333984800,77333984804,4,1521,863,-20
77334328790,77334328794,4,2378,1545,-20
77335384362,77335384365,3,1785,1450,-20
77336463785,77336463791,6,2522,1306,-20
77337529813,77337529815,2,2282,1365,-20
77337798173,77337798173,0,1319,2474,-20
77339718924,77339718928,4,2962,1533,-20
77342503664,77342503683,19,386,1051,-20
77344342195,77344342198,3,1984,1341,-20
77345889763,77345889767,4,1810,1322,-20
77348222675,77348222670,-5,1418,4552,-20
77348741309,77348741312,3,1567,1061,-20
77349763839,77349763842,3,1460,1909,-20
77351759174,77351759173,-1,1949,1642,-20
77352514929,77352514931,2,1732,1532,-20
77352798010,77352797991,-19,1415,1365,-20
77354535786,77354535790,4,2605,1735,-20
77355257434,77355257438,4,2432,1726,-20
77355459475,77355459477,2,1355,1177,-20
77359578654,77359578660,6,2377,1568,-20
77363832911,77363832913,2,1414,1193,-20
77365523492,77365523495,3,1514,1223,-20
77366083429,77366083433,4,1324,1485,-20
77367657157,77367657159,2,1797,1552,-20
77368483583,77368483582,-1,1311,1879,-20
77368725141,77368725145,4,1482,946,-20
77370905397,77370905399,2,2293,1586,-20
77371140822,77371140826,4,1133,1471,-20
77371829709,77371829707,-2,1261,1873,-20
77371929378,77371929381,3,1782,1756,-20
77373580989,77373580991,2,1848,1715,-20
77376025221,77376025223,2,2046,1468,-20
77376815194,77376815198,4,1692,1374,-20
77378092765,77378092770,5,2221,1274,-20
77378815624,77378815627,3,2516,1360,-20
77379647729,77379647739,10,13640,29868,-20
77381734774,77381734777,3,1876,1471,-20
77382894030,77382894035,5,2348,1575,-20
77383006059,77383006065,6,2423,2037,-20
77383837954,77383837955,1,2308,1668,-20
77384128047,77384128051,4,1327,1635,-20
77385929480,77385929482,2,1736,1131,-20
77386888572,77386888574,2,1798,1647,-20
77387309622,77387309623,1,1870,1301,-20
77388354602,77388354603,1,1420,1526,-20
77388996599,77388996602,3,1465,1031,-20
77391710097,77391710100,3,1613,1816,-20
77392032766,77392032771,5,2275,1109,-20
77394774218,77394774221,3,1735,1219,-20
77396781939,77396781944,5,1379,992,-20
77400290975,77400290980,5,1598,1030,-20
77401864100,77401864105,5,1476,1429,-20
77402156871,77402156875,4,2387,1580,-20
77402487144,77402487147,3,1966,1086,-20
77402679182,77402679187,5,2071,1239,-20
77404055447,77404055450,3,926,855,-20
77405849023,77405849023,0,1820,881,-20
77408216283,77408216286,3,1458,1383,-20
77409287288,77409287291,3,1240,1100,-20
77410101025,77410101027,2,1201,1256,-20
77412944349,77412944347,-2,1355,1643,-20
77415623549,77415623562,13,10807,46855,-20
77419947909,77419947901,-8,1678,9295,-20
77423788412,77423788415,3,1386,890,-20
77425546934,77425546937,3,1074,1122,-20
77427560833,77427560837,4,1323,1034,-20
77428031020,77428031024,4,1941,1595,-20
77428122443,77428122439,-4,1753,1868,-20
77431020814,77431020808,-6,1559,6024,-20
77435203775,77435203779,4,1672,1605,-20
77442306982,77442306987,5,2126,1297,-20
77444847130,77444847148,18,854,2042,-20
77445016755,77445016760,5,1486,1486,-20
77445302500,77445302500,0,1025,1531,-20
77446592295,77446592300,5,2082,1040,-20
77447990549,77447990551,2,1540,1455,-20
77449245522,77449245522,0,1137,1727,-20
77449827641,77449827628,-13,1548,1697,-20
77450525286,77450525292,6,1661,1066,-20
77451039222,77451039203,-19,1835,1084,-20
77452758703,77452758707,4,2392,1411,-20
77457586439,77457586437,-2,3009,5530,-20
77460216697,77460216700,3,1225,1453,-20
77461397706,77461397707,1,2227,1170,-20
77462353754,77462353762,8,3660,1027,-20
77463577614,77463577618,4,2696,2113,-20
77464446163,77464446166,3,1785,924,-20
77465158142,77465158123,-19,2151,783,-20
77466999750,77466999757,7,2166,1399,-20
77470045674,77470045675,1,1806,1610,-20
77471888398,77471888402,4,1654,1394,-20
77473407438,77473407437,-1,1094,1477,-20
77479023955,77479023955,0,1315,869,-20
77480943080,77480943083,3,1433,1012,-20
77481266805,77481266806,1,1588,2302,-20
77482260882,77482260883,1,1874,2061,-20
77486097433,77486097435,2,1444,1780,-20
77486635569,77486635573,4,1941,1510,-20
77488912925,77488912927,2,1997,1626,-20
77489168690,77489168693,3,2368,1462,-20
77491854651,77491854657,6,2048,1117,-20
77491952059,77491952062,3,1722,1905,-20
77492378441,77492378445,4,1671,1561,-20
77492569637,77492569649,12,1755,1187,-20
77492809905,77492809910,5,1886,1546,-20
77493365767,77493365771,4,1680,1330,-20
77496665505,77496665509,4,1986,1318,-20
77497959345,77497959349,4,2012,1738,-20
77499206891,77499206895,4,2576,1747,-20
77499628125,77499628128,3,2030,1243,-20
77502086328,77502086330,2,2573,1975,-20
77502486181,77502486182,1,1581,1185,-20
77505448678,77505448682,4,2616,2010,-20
77506482753,77506482758,5,1458,1096,-20
77508810001,77508810004,3,2461,2037,-20
77514365353,77514365359,6,1290,1247,-20
77515914009,77515914014,5,2142,1074,-20
77517928924,77517928927,3,1669,1454,-20
77518845915,77518845918,3,1460,1183,-20
77519331567,77519331570,3,2469,2199,-20
77520002085,77520002087,2,1959,1495,-20
77520185708,77520185716,8,17980,57862,-20
77521066565,77521066567,2,1088,1060,-20
77521811454,77521811459,5,2449,1232,-20
77527913858,77527913859,1,2279,1505,-20
77528245223,77528245228,5,1949,1020,-20
77529484762,77529484766,4,1678,1021,-20
77530599833,77530599834,1,978,1258,-20
77531453155,77531453157,2,1400,1266,-20
77532990911,77532990914,3,1365,987,-20
77535709764,77535709761,-3,766,1635,-20
77539502519,77539502522,3,1636,1346,-20
77539985293,77539985295,2,1515,1146,-20
77541710868,77541710869,1,2684,1675,-20
77541764593,77541764603,10,1698,1695,-20
77542618991,77542618994,3,1222,922,-20
77546649533,77546649538,5,1649,1418,-20
77547950263,77547950266,3,837,1683,-20
77551900533,77551900537,4,1465,1221,-20
77553358230,77553358233,3,2092,1283,-20
77554045571,77554045577,6,2530,1722,-20
77555903270,77555903275,5,1750,1493,-20
77557066176,77557066182,6,2745,1600,-20
77559662330,77559662334,4,2573,1851,-20
77562148078,77562148087,9,910,262,-20
77565684149,77565684151,2,1525,1388,-20
77566802728,77566802731,3,2245,1120,-20
77571733182,77571733183,1,990,1276,-20
77572567034,77572567035,1,1032,1606,-20
77573091510,77573091514,4,2294,1119,-20
77573787245,77573787250,5,1094,1168,-20
77580068727,77580068730,3,1201,1776,-20
77581068165,77581068168,3,4402,3523,-20
77583468475,77583468478,3,2185,1435,-20
77585391076,77585391078,2,2223,1354,-20
77586222036,77586222024,-12,28871,16153,-20
77587656101,77587656105,4,1917,1449,-20
77589542116,77589542118,2,1412,1199,-20
77590055983,77590055989,6,1750,991,-20
77590217708,77590217722,14,1778,1318,-20
77590986154,77590986157,3,1913,1049,-20
77591520059,77591520065,6,1930,1274,-20
77592159586,77592159590,4,1818,1195,-20
77592468757,77592468759,2,1775,1347,-20
77593301522,77593301525,3,38913,32028,-20
77593495623,77593495621,-2,1434,2068,-20
77597226818,77597226822,4,1950,1487,-20
77603511092,77603511095,3,1727,1189,-20
77604715625,77604715626,1,1531,1518,-20
77607452803,77607452808,5,1825,1359,-20
77607994078,77607994082,4,2424,977,-20
77608765161,77608765162,1,2023,1288,-20
77609635194,77609635197,3,1543,1147,-20
77610385659,77610385662,3,1502,619,-20
77610711651,77610711655,4,1186,953,-20
77611499530,77611499534,4,1882,1098,-20
77617227792,77617227795,3,1571,2008,-20
77621467198,77621467194,-4,3620,9628,-20
77622686757,77622686762,5,1992,1360,-20
77624350296,77624350298,2,2013,1819,-20
77625199854,77625199858,4,1646,1353,-20
77626897219,77626897223,4,1356,1354,-20
77629627882,77629627885,3,1585,1518,-20
77633006004,77633006007,3,1441,1232,-20
77636505954,77636505956,2,2014,1871,-20
77638344283,77638344286,3,2089,1066,-20
77638760163,77638760165,2,2051,1362,-20
77640671958,77640671962,4,884,902,-20
77645848134,77645848139,5,1624,1377,-20
77648528413,77648528419,6,2425,1881,-20
77652589145,77652589149,4,2134,1576,-20
77653911021,77653911023,2,1842,1669,-20
77656616653,77656616659,6,1046,1061,-20
77661809547,77661809548,1,1305,1700,-20
77662397274,77662397281,7,2377,1735,-20
77663264163,77663264169,6,1926,960,-20
77666301485,77666301483,-2,1173,1964,-20
77666671995,77666671999,4,2306,1402,-20
77667331333,77667331339,6,1833,1767,-20
77670704161,77670704154,-7,1865,8272,-20
77673017894,77673017898,4,2536,2091,-20
77674125012,77674125015,3,2482,1485,-20
77674243011,77674243016,5,2063,1410,-20
77674784884,77674784883,-1,1984,3072,-20
77675159349,77675159352,3,1549,1043,-20
77677892838,77677892842,4,1917,1716,-20
77679024842,77679024846,4,2046,1260,-20
77679907194,77679907202,8,1081,983,-20
77686808565,77686808569,4,1777,1901,-20
77691699688,77691699689,1,2596,2135,-20
77692957893,77692957896,3,2772,1780,-20
77699097095,77699097094,-1,902,715,-20
77702077044,77702077049,5,1826,1050,-20
77703119809,77703119813,4,946,1145,-20
77705772919,77705772925,6,2235,1821,-20
77706145122,77706145122,0,1590,1366,-20
77708103338,77708103340,2,1859,998,-20
77710829972,77710829974,2,2436,1487,-20
77711306698,77711306701,3,1195,1359,-20
77712330106,77712330110,4,2395,1527,-20
77712662254,77712662254,0,10531,12416,-20
77712953746,77712953749,3,1420,1135,-20
77715986470,77715986473,3,2556,1453,-20
77717910345,77717910347,2,1687,1140,-20
77718613086,77718613091,5,2166,1027,-20
77719605166,77719605169,3,1607,1594,-20
77720902513,77720902515,2,1304,850,-20
77721660446,77721660449,3,1899,1697,-20
77721761544,77721761562,18,1799,1173,-20
77723151391,77723151393,2,1273,1220,-20
77724667741,77724667745,4,2695,1662,-20
77725320013,77725319994,-19,3085,1541,-20
77725870076,77725870068,-8,852,432,-20
77733423079,77733423082,3,969,1025,-20
77736432955,77736432958,3,1772,1441,-20
77737294409,77737294414,5,798,589,-20
77738156593,77738156598,5,1839,992,-20
77740292863,77740292866,3,2288,1535,-20
77743860699,77743860702,3,1675,1500,-20
77744384368,77744384370,2,2885,1723,-20
77749881980,77749881984,4,2723,2241,-20
77751033549,77751033552,3,1467,1514,-20
77751709197,77751709179,-18,1502,1434,-20
77752298202,77752298206,4,2858,1748,-20
77752458827,77752458830,3,2292,1407,-20
77757530573,77757530577,4,1853,1483,-20
77757662518,77757662515,-3,1147,3067,-20
77765140175,77765140178,3,1732,1852,-20
77767075678,77767075683,5,1564,877,-20
77769973035,77769973039,4,1420,1186,-20
77771556051,77771556055,4,1769,1094,-20
77771982101,77771982103,2,1457,1604,-20
77772259248,77772259251,3,1669,1246,-20
77775856981,77775856985,4,2120,1278,-20
77777690167,77777690169,2,2100,1710,-20
77781646659,77781646662,3,2425,1452,-20
77782907593,77782907595,2,2131,2080,-20
77784209306,77784209309,3,1755,1556,-20
77787977055,77787977060,5,2650,1359,-20
77797152792,77797152795,3,1431,1082,-20
77797315793,77797315796,3,1744,1107,-20
77797614861,77797614865,4,2520,2077,-20
77798426053,77798426057,4,1373,680,-20
77800969989,77800969994,5,1687,1240,-20
77802192529,77802192531,2,1852,1126,-20
77804045554,77804045558,4,2036,1335,-20
77804223094,77804223100,6,2010,925,-20
77814825679,77814825683,4,2222,1049,-20
77815364128,77815364126,-2,1448,2181,-20
77816397118,77816397122,4,2114,1794,-20
77818823045,77818823050,5,1777,1586,-20
77819553558,77819553555,-3,1367,1368,-20
77822871395,77822871400,5,2064,1439,-20
77823133614,77823133618,4,1347,1212,-20
77831142457,77831142462,5,2440,1252,-20
77836554476,77836554479,3,2761,1728,-20
77839701129,77839701133,4,2446,1948,-20
77841487994,77841487997,3,1185,602,-20
77842405041,77842405046,5,2626,1321,-20
77846819081,77846819082,1,2059,1604,-20
77848422815,77848422818,3,1555,1221,-20
77850269800,77850269803,3,1942,1449,-20
77852223340,77852223340,0,486,229,-20
77853854524,77853854527,3,2326,1459,-20
77854009519,77854009521,2,1632,1141,-20
77855992224,77855992227,3,2738,2091,-20
77860068466,77860068467,1,1457,778,-20
77871718909,77871718911,2,1618,1520,-20
77872497515,77872497520,5,1216,1270,-20
77873408088,77873408090,2,1636,1549,-20
77874941853,77874941858,5,2283,1346,-20
77875320826,77875320829,3,1949,1546,-20
77876963601,77876963595,-6,3129,8948,-20
77882217108,77882217111,3,1415,979,-20
77887462757,77887462762,5,1731,998,-20
77888928344,77888928341,-3,767,1818,-20
77894716490,77894716492,2,1090,1357,-20
77899728462,77899728467,5,1965,1050,-20
77899985071,77899985049,-22,2129,1044,-20
77901869190,77901869193,3,1493,1873,-20
77902651820,77902651823,3,2352,1808,-20
77903924237,77903924240,3,1478,1606,-20
77904008507,77904008510,3,1641,1630,-20
77904623647,77904623651,4,1777,1622,-20
77904797623,77904797617,-6,4367,10523,-20
77906666715,77906666698,-17,10226,5991,-20
77908083514,77908083517,3,2485,1657,-20
77912190023,77912190026,3,2300,1738,-20
77913451491,77913451495,4,1550,865,-20
77913854517,77913854521,4,1693,1031,-20
77914723581,77914723583,2,755,1177,-20
77915329941,77915329943,2,1298,1030,-20
77918944971,77918944974,3,1368,1326,-20
77920672821,77920672822,1,1972,1524,-20
77922582518,77922582526,8,4391,1374,-20
77924791394,77924791397,3,2294,1702,-20
77925617012,77925617015,3,2106,1329,-20
77925894796,77925894798,2,1379,823,-20
77927559840,77927559845,5,2472,1736,-20
77928578009,77928578011,2,1680,1465,-20
77928789755,77928789759,4,2543,1544,-20
77929116230,77929116233,3,1868,1412,-20
77934003658,77934003663,5,1967,1133,-20
77934481385,77934481386,1,2404,1630,-20
77936592198,77936592200,2,805,1135,-20
77940840422,77940840426,4,1983,1378,-20
77943097550,77943097555,5,2062,1149,-20
77944268950,77944268953,3,1757,1490,-20
77945507715,77945507719,4,1832,1325,-20
77946099807,77946099810,3,2549,2336,-20
77948749502,77948749506,4,1964,1096,-20
77950647955,77950647959,4,2085,1411,-20
77950927259,77950927242,-17,700,373,-20
77951466708,77951466711,3,1901,1431,-20
77954261098,77954261101,3,1289,1243,-20
77955681763,77955681744,-19,1215,1134,-20
77957069929,77957069934,5,5218,2254,-20
77969304831,77969304834,3,1646,1648,-20
77970164533,77970164535,2,999,582,-20
77970330913,77970330917,4,2093,1546,-20
77971756193,77971756199,6,2114,1463,-20
77973729492,77973729494,2,2081,1202,-20
77974805730,77974805734,4,1769,1091,-20
77976255140,77976255142,2,1368,1068,-20
77976535048,77976535050,2,1337,952,-20
77984520299,77984520303,4,1892,1226,-20
77987256830,77987256833,3,1537,2008,-20
77987362301,77987362314,13,2054,1414,-20
77989809898,77989809898,0,1840,3417,-20
77991875078,77991875083,5,1788,1265,-20
77992641009,77992641012,3,1911,1508,-20
77993445332,77993445336,4,1800,1321,-20
78000461395,78000461394,-1,731,989,-20
78003983235,78003983238,3,2103,1206,-20
78008119046,78008119050,4,1697,1422,-20
78008905548,78008905551,3,1751,1714,-20
78010384776,78010384781,5,3357,2121,-20
78011873862,78011873863,1,1762,1365,-20
78012989655,78012989658,3,1968,1765,-20
78013100167,78013100170,3,1902,1600,-20
78015311710,78015311711,1,1317,1097,-20
78016788869,78016788874,5,2382,1586,-20
78017764584,78017764585,1,2190,2082,-20
78018414214,78018414219,5,2266,1406,-20
78020561250,78020561251,1,1530,1155,-20
78021359038,78021359041,3,1666,1652,-20
78022940841,78022940846,5,3823,1750,-20
78025054287,78025054296,9,12007,34050,-20
78029261719,78029261718,-1,1153,1300,-20
78029523574,78029523579,5,1726,1391,-20
78029667279,78029667283,4,1704,1068,-20
78030002266,78030002250,-16,2775,776,-20
78031889670,78031889673,3,1649,1355,-20
78032524502,78032524505,3,1435,1029,-20
78034797714,78034797718,4,2446,1584,-20
78036483210,78036483215,5,1768,1134,-20
78040664931,78040664933,2,1821,1508,-20
78043692817,78043692820,3,3498,2298,-20
78044286382,78044286387,5,1865,1403,-20
78045307546,78045307550,4,1838,1583,-20
78046094623,78046094626,3,1376,1140,-20
78046722149,78046722151,2,2083,1419,-20
78048396554,78048396561,7,2016,1593,-20
78053046139,78053046142,3,1692,1634,-20
78054112155,78054112161,6,1581,1257,-20
78056372086,78056372089,3,2470,1516,-20
78057636997,78057636999,2,1704,1200,-20
78058754662,78058754657,-5,1092,5823,-20
78062352738,78062352742,4,1087,882,-20
78064568627,78064568630,3,1541,1978,-20
78065460726,78065460729,3,1964,1765,-20
78066937429,78066937432,3,2102,1643,-20
78070378876,78070378878,2,1972,1228,-20
78073652922,78073652928,6,2853,1906,-20
78073887310,78073887313,3,1425,1600,-20
78077134753,78077134755,2,1938,1773,-20
78077195234,78077195238,4,1298,1273,-20
78080664261,78080664263,2,914,1085,-20
78085019911,78085019906,-5,1627,4522,-20
78085730253,78085730252,-1,1409,2030,-20
78086968593,78086968597,4,1516,1166,-20
78087446875,78087446878,3,1705,1605,-20
78089857641,78089857643,2,1031,1219,-20
78091483650,78091483654,4,2619,1732,-20
78092805361,78092805363,2,1361,1173,-20
78098467518,78098467519,1,1209,1479,-20
78099726653,78099726655,2,1736,1418,-20
78100526038,78100526041,3,1391,1792,-20
78102977437,78102977439,2,2018,1814,-20
78103461158,78103461162,4,1589,1462,-20
78104066901,78104066902,1,1552,1188,-20
78105853349,78105853354,5,1859,1400,-20
78109341946,78109341951,5,1045,848,-20
78110779002,78110779007,5,2595,1569,-20
78111439658,78111439661,3,814,804,-20
78112675482,78112675488,6,6471,2424,-20
78116173841,78116173846,5,2210,1148,-20
78117179558,78117179561,3,1843,1529,-20
78122334542,78122334545,3,2179,1922,-20
78123592237,78123592241,4,1820,1537,-20
78124460955,78124460959,4,543,695,-20
78127713821,78127713826,5,1732,1133,-20
78128287895,78128287883,-12,746,347,-20
78128445129,78128445130,1,2006,1633,-20
78130441206,78130441210,4,1991,1699,-20
78135604098,78135604103,5,1890,1440,-20
78143298189,78143298192,3,2177,1805,-20
78148649313,78148649315,2,2349,1336,-20
78149564495,78149564499,4,1624,936,-20
78151399132,78151399140,8,16698,30937,-20
78151640017,78151640020,3,2114,1611,-20
78153906191,78153906193,2,1075,1690,-20
78153983678,78153983682,4,1797,1677,-20
78154282575,78154282578,3,1101,1018,-20
78154991198,78154991176,-22,543,177,-20
78157167686,78157167693,7,1569,1685,-20
78158013447,78158013451,4,1814,1213,-20
78158345246,78158345248,2,2577,1975,-20
78159623230,78159623233,3,1871,1800,-20
78159651434,78159651439,5,947,622,-20
78161909411,78161909415,4,1521,1577,-20
78162090690,78162090693,3,1925,1113,-20
78165744473,78165744475,2,1572,1438,-20
78169030619,78169030616,-3,386,1448,-20
78171488097,78171488101,4,1238,1084,-20
78174220510,78174220508,-2,1278,2516,-20
78174731738,78174731743,5,1648,1313,-20
78177685461,78177685464,3,2023,1802,-20
78179675278,78179675280,2,1869,1696,-20
78180033573,78180033575,2,1917,1668,-20
78180550165,78180550170,5,2082,1326,-20
78183623181,78183623183,2,1935,1304,-20
78185469951,78185469955,4,2142,1777,-20
78188318676,78188318678,2,1773,1351,-20
78189895606,78189895607,1,2381,1614,-20
78191669398,78191669400,2,1037,1309,-20
78194001793,78194001795,2,2041,1164,-20
78200112041,78200112046,5,1911,1334,-20
78202229103,78202229107,4,1785,1154,-20
78204620647,78204620651,4,2018,2059,-20
78208008538,78208008542,4,2520,1189,-20
78208101829,78208101833,4,1714,1679,-20
78208421878,78208421873,-5,1865,8411,-20
78209895917,78209895919,2,1503,1110,-20
78213098535,78213098538,3,1620,1572,-20
78214865458,78214865462,4,1458,1043,-20
78218719702,78218719706,4,2539,1721,-20
78222558408,78222558410,2,1493,1420,-20
78223599766,78223599770,4,1884,1443,-20
78225877868,78225877873,5,2138,1768,-20
78226440313,78226440315,2,1269,1596,-20
78227617905,78227617909,4,2105,1456,-20
78228715995,78228715999,4,2021,1148,-20
78230591842,78230591847,5,2368,1470,-20
78230847525,78230847528,3,1923,1201,-20
78237370785,78237370786,1,1561,965,-20
78241093485,78241093489,4,2186,1399,-20
78241839916,78241839919,3,2272,2050,-20
78242836235,78242836237,2,1426,1023,-20
78243861177,78243861181,4,3069,1932,-20
78244653428,78244653432,4,1851,1384,-20
78245354130,78245354138,8,1970,1174,-20
78246448042,78246448043,1,1775,1594,-20
78251665858,78251665863,5,1515,1430,-20
78257248897,78257248900,3,1551,1270,-20
78260677297,78260677298,1,1466,1409,-20
78261382694,78261382696,2,1735,1244,-20
78264426231,78264426235,4,1738,1568,-20
78264758330,78264758334,4,1942,1658,-20
78266284663,78266284667,4,1410,1663,-20
78269252224,78269252227,3,1655,1629,-20
78269587538,78269587544,6,2997,1424,-20
78269636477,78269636482,5,1734,1012,-20
78270856819,78270856823,4,1427,1169,-20
78270967441,78270967446,5,1866,1433,-20
78271998139,78271998143,4,1590,1360,-20
78279786922,78279786925,3,1975,1885,-20
78282714405,78282714410,5,1666,1153,-20
78283277386,78283277390,4,2038,1307,-20
78285056506,78285056508,2,1219,1149,-20
78286396662,78286396640,-22,1017,736,-20
78287317576,78287317578,2,1956,1242,-20
78289658877,78289658879,2,1340,1260,-20
78290769026,78290769029,3,995,1162,-20
78291190946,78291190950,4,2706,1543,-20
78294466274,78294466278,4,2324,1743,-20
78295478665,78295478668,3,2070,1440,-20
78295881742,78295881747,5,1191,838,-20
78303019343,78303019346,3,2858,1974,-20
78303190968,78303190973,5,3154,1829,-20
78304634922,78304634926,4,1553,1807,-20
78305734674,78305734678,4,2201,1240,-20
78306171178,78306171182,4,1556,1542,-20
78306704314,78306704318,4,2695,1174,-20
78307324034,78307324034,0,908,1457,-20
78315389145,78315389147,2,1683,1599,-20
78315434634,78315434638,4,1400,738,-20
78318281943,78318281946,3,1337,1017,-20
78324053277,78324053282,5,2948,1131,-20
78324470426,78324470430,4,2099,1325,-20
78324772861,78324772851,-10,475,404,-20
78328211679,78328211678,-1,1925,1355,-20
78328553419,78328553423,4,1948,1466,-20
78329022730,78329022731,1,2208,2851,-20
78331946496,78331946498,2,1792,1805,-20
78335164115,78335164113,-2,1504,2662,-20
78340068986,78340068992,6,4576,2265,-20
78340663295,78340663299,4,2229,1003,-20
78340837578,78340837563,-15,507,424,-20
78343191162,78343191164,2,2395,1646,-20
78345029882,78345029882,0,1304,1540,-20
78346953390,78346953390,0,2246,1392,-20
78348789965,78348789969,4,2872,1906,-20
78350462227,78350462234,7,3064,1300,-20
78354918657,78354918665,8,3519,1450,-20
78356717983,78356717985,2,2264,1639,-20
78356822883,78356822889,6,568,682,-20
78358948786,78358948790,4,2250,1725,-20
78359546301,78359546304,3,1813,1950,-20
78359772878,78359772890,12,1446,1257,-20
78361286458,78361286462,4,1492,1346,-20
78366668393,78366668397,4,1741,1664,-20
78367252891,78367252896,5,1951,1193,-20
78368437029,78368437030,1,1579,1100,-20
78369118682,78369118685,3,2471,1371,-20
78371053122,78371053125,3,2401,1575,-20
78375693638,78375693639,1,1079,1331,-20
78381787364,78381787366,2,1076,961,-20
78385238426,78385238430,4,3250,3022,-20
78385813105,78385813109,4,2550,2110,-20
78388128402,78388128405,3,1963,1822,-20
78389322525,78389322529,4,1365,1141,-20
78390904240,78390904240,0,2,1715,-20
78394216900,78394216902,2,1388,1643,-20
78400042714,78400042718,4,2109,1366,-20
78404206823,78404206826,3,1599,1549,-20
78406864560,78406864578,18,568,864,-20
78411011900,78411011903,3,1555,1307,-20
78412897860,78412897864,4,1272,1083,-20
78414449109,78414449108,-1,2901,3277,-20
78415814838,78415814843,5,1009,930,-20
78417135590,78417135597,7,3315,1740,-20
78417369790,78417369794,4,1256,1011,-20
78424210971,78424210966,-5,1902,6581,-20
78425187528,78425187532,4,1838,1342,-20
78426388006,78426388010,4,1499,1007,-20
78427906412,78427906415,3,2031,1681,-20
78432607732,78432607734,2,3237,1797,-20
78433955003,78433955009,6,2209,1484,-20
78434325734,78434325737,3,1499,1397,-20
78436526707,78436526711,4,1691,1298,-20
78437798094,78437798098,4,2756,1719,-20
78439125903,78439125900,-3,1119,2322,-20
78439488294,78439488295,1,1727,834,-20
78445002796,78445002795,-1,1141,1326,-20
78445773571,78445773567,-4,1307,3922,-20
78446727227,78446727232,5,2602,1495,-20
78447298716,78447298719,3,1621,1063,-20
78449688247,78449688250,3,1614,1346,-20
78450843981,78450843985,4,2355,2053,-20
78455519356,78455519358,2,1849,1069,-20
78455694498,78455694500,2,1660,1446,-20
78457515701,78457515704,3,1591,1349,-20
78458321534,78458321539,5,1621,1144,-20
78460597314,78460597318,4,1943,1573,-20
78461807899,78461807902,3,1815,1805,-20
78465844408,78465844411,3,2158,1615,-20
78466854850,78466854850,0,1726,1574,-20
78469664653,78469664658,5,2294,1678,-20
78471208551,78471208554,3,2199,1022,-20
78471645399,78471645377,-22,1208,631,-20
78471745942,78471745947,5,1684,1738,-20
78477855317,78477855322,5,2377,1036,-20
78480961495,78480961497,2,2470,2396,-20
78484910573,78484910578,5,1498,1502,-20
78489164707,78489164710,3,1482,899,-20
78490306357,78490306359,2,1762,1722,-20
78490481153,78490481157,4,1690,2040,-20
78497134945,78497134949,4,1635,1331,-20
78497842241,78497842245,4,1846,1241,-20
78497991189,78497991210,21,640,292,-20
78499825396,78499825376,-20,1588,1987,-20
78501128159,78501128163,4,2095,1825,-20
78511226218,78511226223,5,1167,1074,-20
78511963876,78511963858,-18,1136,1163,-20
78512260970,78512260975,5,2066,1258,-20
78514816146,78514816146,0,1383,1746,-20
78517470687,78517470681,-6,1192,3384,-20
78518428346,78518428351,5,2515,1511,-20
78524481973,78524481977,4,1392,1269,-20
78527237227,78527237230,3,1484,1007,-20
78528307978,78528307957,-21,1755,1529,-20
78532122486,78532122486,0,1359,1424,-20
78532753724,78532753725,1,1198,1331,-20
78535250882,78535250884,2,2220,1552,-20
78535304018,78535304019,1,1415,1090,-20
78539626712,78539626715,3,1925,1610,-20
78540339091,78540339093,2,1834,1554,-20
78543472309,78543472310,1,1027,1075,-20
78543942234,78543942249,15,1527,1361,-20
78544135582,78544135585,3,1973,1366,-20
78546524438,78546524420,-18,3016,1967,-20
78553250654,78553250658,4,1564,1687,-20
78553903042,78553903046,4,2352,1441,-20
78553988504,78553988499,-5,981,3050,-20
78557544661,78557544665,4,1338,1184,-20
78560816010,78560816016,6,1443,1341,-20
78562418844,78562418851,7,2157,1078,-20
78565741653,78565741655,2,1387,1558,-20
78568365297,78568365299,2,1499,1287,-20
78568662307,78568662312,5,1941,1363,-20
78569107966,78569107968,2,2115,1776,-20
78570290980,78570290982,2,1618,1062,-20
78573609246,78573609248,2,2104,1560,-20
78575067079,78575067079,0,1224,1486,-20
78576140908,78576140923,15,34,6484,-20
78576997857,78576997855,-2,1562,1879,-20
78580129466,78580129470,4,1837,1838,-20
78580944286,78580944289,3,1369,1377,-20
78582391754,78582391756,2,1137,1068,-20
78582536030,78582536035,5,1666,1400,-20
78583181418,78583181422,4,2071,1572,-20
78591713607,78591713610,3,1038,1298,-20
78592932218,78592932221,3,2514,1459,-20
78593187942,78593187946,4,2077,1893,-20
78593976997,78593977001,4,1850,1555,-20
78596284518,78596284521,3,2004,1657,-20
78598395074,78598395078,4,1381,1374,-20
78600188051,78600188047,-4,18596,10795,-20
78602703228,78602703233,5,2650,1519,-20
78604958682,78604958685,3,1893,1492,-20
78605696530,78605696527,-3,1971,3597,-20
78608425681,78608425683,2,2252,2134,-20
78610329146,78610329150,4,1738,1321,-20
78610729545,78610729546,1,1986,890,-20
78611463462,78611463465,3,1889,1737,-20
78614287558,78614287563,5,1935,1158,-20
78617275082,78617275083,1,1863,1924,-20
78619547050,78619547054,4,2409,1847,-20
78619740285,78619740289,4,1634,1365,-20
78620556457,78620556462,5,2007,2000,-20
78622080768,78622080770,2,1154,846,-20
78623932630,78623932619,-11,23146,18425,-20
78624737086,78624737090,4,1222,1358,-20
78625607313,78625607316,3,1574,1821,-20
78626783764,78626783767,3,1679,1169,-20
78628895885,78628895888,3,1913,1325,-20
78629110487,78629110489,2,2084,1478,-20
78630518074,78630518058,-16,1057,576,-20
78631755232,78631755235,3,1649,1293,-20
78633149795,78633149799,4,1436,1455,-20
78636213867,78636213872,5,1626,1274,-20
78636254990,78636254993,3,2287,1756,-20
78641155253,78641155255,2,2210,1421,-20
78643748061,78643748062,1,1534,1183,-20
78648411839,78648411843,4,2975,1250,-20
78649860706,78649860697,-9,1500,1812,-20
78652767269,78652767262,-7,1513,1331,-20
78653372103,78653372106,3,1213,933,-20
78655761665,78655761667,2,2058,1491,-20
78663262086,78663262088,2,1274,1466,-20
78666867623,78666867626,3,2174,1163,-20
78668097703,78668097706,3,1767,1626,-20
78669059020,78669059023,3,1390,1449,-20
78673227346,78673227349,3,2496,1277,-20
78682014252,78682014256,4,1759,1625,-20
78682218475,78682218482,7,2172,1417,-20
78690943439,78690943443,4,1683,1156,-20
78690982137,78690982154,17,1411,1050,-20
78697564885,78697564887,2,1501,1528,-20
78700456754,78700456758,4,1694,1624,-20
78703628090,78703628095,5,1874,1070,-20
78709709266,78709709270,4,1983,1194,-20
78712142499,78712142503,4,2386,1344,-20
78712495214,78712495216,2,1459,1454,-20
78713316413,78713316427,14,1595,1404,-20
78714460850,78714460851,1,1429,1300,-20
78714792423,78714792423,0,1206,1136,-20
78716188118,78716188112,-6,1085,5308,-20
78718882001,78718882003,2,1624,1327,-20
78721715854,78721715855,1,1441,1044,-20
78724649134,78724649137,3,2389,1598,-20
78725318377,78725318378,1,2227,1464,-20
78725803582,78725803586,4,1604,1434,-20
78727717233,78727717237,4,1701,1156,-20
78729964491,78729964494,3,2417,1909,-20
78742380853,78742380860,7,1731,1444,-20
78746816790,78746816795,5,2186,1236,-20
78746888672,78746888674,2,1818,964,-20
78747138025,78747138025,0,1127,2183,-20
78748276533,78748276535,2,1813,1764,-20
78748605010,78748605013,3,1707,1497,-20
78750877331,78750877334,3,1350,1562,-20
78755969748,78755969752,4,2666,1534,-20
78760122607,78760122610,3,2823,1659,-20
78763823018,78763823022,4,1885,1271,-20
78764885040,78764885045,5,2741,2167,-20
78767055130,78767055125,-5,550,2262,-20
78771965106,78771965108,2,1573,1507,-20
78774563748,78774563750,2,1817,1651,-20
78780484592,78780484595,3,1696,1577,-20
78780683137,78780683141,4,1645,881,-20
78782320178,78782320182,4,2380,1086,-20
78784134887,78784134890,3,1201,998,-20
78792167735,78792167719,-16,1805,1512,-20
78792521369,78792521376,7,108,1349,-20
78792687675,78792687679,4,1928,1179,-20
78798897072,78798897077,5,1576,1134,-20
78798986710,78798986715,5,1463,1261,-20
78800641130,78800641136,6,4720,2084,-20
78803262579,78803262582,3,1004,787,-20
78804625701,78804625706,5,2169,1118,-20
78805473554,78805473560,6,4227,2075,-20
78808935850,78808935853,3,1652,1650,-20
78809412594,78809412598,4,2347,1292,-20
78812934854,78812934859,5,1580,857,-20
78814763422,78814763425,3,1903,1093,-20
78815980046,78815980050,4,1636,1252,-20
78818980805,78818980809,4,2927,1979,-20
78819531098,78819531101,3,2740,2071,-20
78823239099,78823239102,3,1815,1190,-20
78826905165,78826905170,5,1201,918,-20
78828303650,78828303655,5,2358,2023,-20
78835108459,78835108450,-9,882,1668,-20
78835163504,78835163506,2,1164,1206,-20
78835962728,78835962731,3,1278,858,-20
78840058214,78840058218,4,2547,2041,-20
78841906206,78841906199,-7,1727,1220,-20
78843397491,78843397495,4,2740,1493,-20
78843636046,78843636049,3,6248,15640,-20
78844193208,78844193211,3,1757,1556,-20
78844731998,78844732005,7,1902,1740,-20
78847761547,78847761550,3,1850,1159,-20
78847926028,78847926031,3,1114,1256,-20
78850318558,78850318563,5,1080,851,-20
78851986353,78851986355,2,2711,1566,-20
78852134137,78852134140,3,1731,1564,-20
78852946001,78852946007,6,1985,1465,-20
78857254728,78857254730,2,1460,1352,-20
78859264579,78859264581,2,1847,1828,-20
78860099320,78860099326,6,2389,1466,-20
78860282606,78860282607,1,1403,891,-20
78861997911,78861997906,-5,2066,6505,-20
78863037714,78863037719,5,2211,1199,-20
78864425237,78864425239,2,1507,1141,-20
78867026766,78867026761,-5,1897,6398,-20
78867502467,78867502470,3,1829,1777,-20
78869455177,78869455173,-4,1529,5702,-20
78870301528,78870301531,3,1867,1706,-20
78875432169,78875432172,3,2381,1752,-20
78877417066,78877417070,4,1240,1637,-20
78883497771,78883497774,3,1916,2005,-20
78883742313,78883742317,4,1863,1627,-20
78890051267,78890051269,2,2327,1628,-20
78890453623,78890453625,2,2383,1887,-20
78891033314,78891033321,7,1960,1052,-20
78896276196,78896276199,3,1954,1090,-20
78896385642,78896385646,4,2226,2020,-20
78896803288,78896803289,1,1551,1805,-20
78897894075,78897894079,4,1882,1197,-20
78898329119,78898329122,3,2436,1668,-20
78899822683,78899822686,3,1681,1688,-20
78902481539,78902481544,5,2295,1807,-20
78903890216,78903890219,3,1851,1482,-20
78909805452,78909805456,4,1936,1222,-20
78913911508,78913911510,2,1827,1352,-20
78915845271,78915845276,5,2346,1608,-20
78918869226,78918869225,-1,1645,2197,-20
78920041519,78920041522,3,1735,1112,-20
78922862087,78922862089,2,1689,1390,-20
78923344282,78923344287,5,1318,1159,-20
78924167034,78924167040,6,4446,2359,-20
78927173422,78927173427,5,1668,785,-20
78928856631,78928856634,3,1298,1402,-20
78931041810,78931041813,3,1348,1362,-20
78932496398,78932496401,3,1888,1444,-20
78935603418,78935603421,3,2432,1485,-20
78941368102,78941368106,4,1689,1037,-20
78942601030,78942601032,2,1964,1657,-20
78943434785,78943434789,4,43645,57586,-20
78944150883,78944150886,3,1617,1294,-20
78945431002,78945431004,2,1516,1298,-20
78951652901,78951652903,2,1726,1462,-20
78954061993,78954061998,5,1492,1832,-20
78957272537,78957272540,3,1732,1425,-20
78961137003,78961137005,2,2047,1638,-20
78962765649,78962765654,5,2059,1404,-20
78962858287,78962858290,3,2028,1153,-20
78963657407,78963657418,11,511,280,-20
78964989179,78964989182,3,1752,1100,-20
78965182563,78965182546,-17,1403,639,-20
78965930067,78965930069,2,1463,1080,-20
78967745224,78967745229,5,1887,1246,-20
78970527950,78970527952,2,2018,1129,-20
78973343513,78973343515,2,1316,1203,-20
78974049658,78974049667,9,688,282,-20
78974914528,78974914531,3,1556,1743,-20
78979727190,78979727197,7,1369,1093,-20
78983534640,78983534638,-2,2261,1941,-20
78983926697,78983926699,2,1591,1003,-20
78985118139,78985118142,3,1597,1220,-20
78987577965,78987577969,4,1362,1261,-20
78988722019,78988722027,8,1096,575,-20
78988816327,78988816329,2,2218,1400,-20
78989598398,78989598402,4,2142,1262,-20
78990392074,78990392057,-17,1803,598,-20
78991624320,78991624322,2,2186,2480,-20
78991661555,78991661558,3,1624,1327,-20
78992384748,78992384753,5,1546,1613,-20
78995825984,78995825985,1,2165,1496,-20
78996396645,78996396650,5,2712,1380,-20
78997520882,78997520886,4,1927,1397,-20
79001145591,79001145585,-6,888,1976,-20
79003531112,79003531108,-4,1137,1974,-20
79005412993,79005412988,-5,949,4059,-20
79008202610,79008202609,-1,2017,2556,-20
79009618017,79009618018,1,1603,1360,-20
79010037988,79010037992,4,2227,1382,-20
79010610503,79010610509,6,2087,1772,-20
79010689609,79010689613,4,2534,1624,-20
79014771535,79014771540,5,2284,1349,-20
79016107125,79016107127,2,960,1561,-20
79017379572,79017379591,19,1705,2033,-20
79018018558,79018018562,4,2114,968,-20
79019409970,79019409971,1,1445,916,-20
79020103730,79020103734,4,2076,1334,-20
79020630788,79020630791,3,1913,1476,-20
79021653974,79021653977,3,1563,1377,-20
79024644070,79024644074,4,1434,1182,-20
79027843394,79027843398,4,1111,1308,-20
79028269815,79028269810,-5,1847,2428,-20
79028391085,79028391087,2,1596,1463,-20
79029346274,79029346274,0,1064,1141,-20
79029785434,79029785437,3,2113,1838,-20
79034645915,79034645920,5,1044,1202,-20
79036082830,79036082833,3,1742,1301,-20
79037347886,79037347891,5,1799,1587,-20
79038061219,79038061223,4,2763,1465,-20
79042600910,79042600911,1,2039,2085,-20
79044523812,79044523814,2,2124,1115,-20
79045565051,79045565054,3,1194,1093,-20
79045850308,79045850311,3,1316,1383,-20
79047072983,79047072986,3,1602,1465,-20
79048148576,79048148581,5,1658,1455,-20
79052041585,79052041588,3,2386,1725,-20
79056043029,79056043033,4,1997,1602,-20
79056271691,79056271695,4,2394,2058,-20
79057464295,79057464298,3,943,596,-20
79058907226,79058907229,3,20536,34372,-20
79063066503,79063066507,4,3303,2061,-20
79063236212,79063236214,2,1207,1446,-20
79066450498,79066450503,5,2061,1527,-20
79074420511,79074420513,2,1619,1539,-20
79075377486,79075377492,6,1514,1223,-20
79075507228,79075507233,5,1850,1065,-20
79075856429,79075856429,0,1594,2403,-20
79079436454,79079436457,3,1987,1010,-20
79079772821,79079772822,1,1311,1427,-20
79080591018,79080591022,4,1381,1259,-20
79081606466,79081606473,7,2117,1300,-20
79082214485,79082214478,-7,2912,7876,-20
79084552946,79084552951,5,2086,1309,-20
79085180726,79085180727,1,1861,2245,-20
79087600015,79087600014,-1,1139,1308,-20
79089664861,79089664866,5,2086,1183,-20
79089820767,79089820771,4,2346,1222,-20
79093001938,79093001936,-2,31144,21094,-20
79095209670,79095209674,4,4135,3115,-20
79096483563,79096483562,-1,1254,1046,-20
79100947345,79100947349,4,1978,1224,-20
79101460905,79101460916,11,1678,1521,-20
79108987914,79108987917,3,1486,1740,-20
79109961519,79109961522,3,1819,1327,-20
79116722780,79116722780,0,1609,1245,-20
79120603865,79120603866,1,1233,1151,-20
79121180451,79121180454,3,1661,1512,-20
79121588406,79121588411,5,1774,1271,-20
79121806371,79121806374,3,2142,1567,-20
79125534378,79125534382,4,2154,1655,-20
79127143706,79127143710,4,1678,1360,-20
79133742759,79133742764,5,1396,1320,-20
79135679131,79135679135,4,1901,1086,-20
79137096774,79137096774,0,1459,1545,-20
79137340729,79137340730,1,1924,1293,-20
79137744329,79137744333,4,2586,2310,-20
79140070746,79140070750,4,2046,1470,-20
79140524189,79140524195,6,1970,1308,-20
79140791265,79140791271,6,1969,1350,-20
79142678866,79142678871,5,1961,1194,-20
79146994525,79146994530,5,1861,852,-20
79154708415,79154708420,5,2332,1431,-20
79157631049,79157631053,4,1466,1606,-20
79158107532,79158107534,2,1590,1381,-20
79161718839,79161718842,3,1976,1108,-20
79162445136,79162445141,5,1867,1548,-20
79163598080,79163598085,5,1559,1396,-20
79165444535,79165444541,6,2105,1273,-20
79166570786,79166570791,5,1314,1285,-20
79167316311,79167316313,2,1834,1443,-20
79168369427,79168369430,3,1900,1150,-20
79169237723,79169237727,4,2779,1697,-20
79170356735,79170356730,-5,2065,6651,-20
79170743337,79170743341,4,1301,1266,-20
79173026007,79173026009,2,1157,887,-20
79177544303,79177544307,4,1677,938,-20
79177863394,79177863399,5,2135,309,-20
79180337301,79180337306,5,1716,1068,-20
79185225194,79185225197,3,1475,1305,-20
79189998460,79189998464,4,1553,1792,-20
79190175076,79190175057,-19,1729,1373,-20
79192909092,79192909094,2,2057,1339,-20
79198326660,79198326665,5,1934,1454,-20
79201138029,79201138034,5,2162,1137,-20
79201719697,79201719701,4,1314,1258,-20
79205129398,79205129402,4,2134,1081,-20
79208502701,79208502705,4,1676,1083,-20
79209696204,79209696209,5,1863,1425,-20
79209797858,79209797863,5,1955,1382,-20
79210294363,79210294366,3,1771,1479,-20
79215077703,79215077701,-2,7275,16072,-20
79218564510,79218564517,7,3393,996,-20
79218732303,79218732307,4,2001,1403,-20
79220251375,79220251377,2,1365,1897,-20
79220747414,79220747417,3,1734,1361,-20
79221318515,79221318509,-6,1204,5517,-20
79222207467,79222207470,3,1843,1546,-20
79223102257,79223102257,0,1239,1121,-20
79226093946,79226093949,3,1567,1023,-20
79228382506,79228382510,4,1894,1940,-20
79229308576,79229308579,3,2224,1208,-20
79230156627,79230156631,4,1584,1226,-20
79237640638,79237640639,1,2261,1326,-20
79239065933,79239065938,5,3164,1236,-20
79242906412,79242906409,-3,1421,2219,-20
79244505944,79244505946,2,1319,1002,-20
79245696162,79245696175,13,12391,36784,-20
79246507257,79246507255,-2,1521,2035,-20
79250622860,79250622864,4,1858,1418,-20
79251356044,79251356046,2,1727,1080,-20
79251407438,79251407443,5,1818,1053,-20
79253460624,79253460629,5,2115,1200,-20
79254268032,79254268035,3,1812,1397,-20
79254664700,79254664705,5,2636,1534,-20
79256140332,79256140334,2,2901,1813,-20
79258508709,79258508714,5,1486,1390,-20
79259090635,79259090639,4,2267,1320,-20
79262795232,79262795236,4,2131,1612,-20
79262854693,79262854697,4,1381,883,-20
79262894042,79262894046,4,2218,1527,-20
79266320493,79266320495,2,1804,1545,-20
79268306438,79268306443,5,2907,1187,-20
79268576102,79268576106,4,1871,1837,-20
79268891083,79268891087,4,1967,1029,-20
79270069497,79270069499,2,1498,1595,-20
79270129761,79270129765,4,1887,1410,-20
79274480438,79274480441,3,2105,1991,-20
79275153886,79275153891,5,1272,909,-20
79277119792,79277119794,2,1460,1652,-20
79278583209,79278583206,-3,1318,1974,-20
79279811203,79279811206,3,2066,1816,-20
79279861450,79279861454,4,2345,1580,-20
79283048008,79283048010,2,1815,1110,-20
79283961914,79283961918,4,1278,1080,-20
79284849650,79284849654,4,2026,1526,-20
79287232029,79287232033,4,725,928,-20
79288265370,79288265371,1,1454,836,-20
79289102752,79289102755,3,1245,980,-20
79290561331,79290561334,3,1342,1530,-20
79291427451,79291427449,-2,1384,1730,-20
79293729338,79293729341,3,2313,1846,-20
79295276438,79295276442,4,1377,1369,-20
79301316304,79301316307,3,1619,934,-20
79303647745,79303647746,1,1614,1239,-20
79305550437,79305550441,4,2715,1781,-20
79307110129,79307110132,3,1587,1502,-20
79308234208,79308234195,-13,1143,547,-20
79310067436,79310067435,-1,1273,1177,-20
79311079079,79311079073,-6,576,2063,-20
79312753630,79312753634,4,1407,1749,-20
79315466561,79315466566,5,2364,1530,-20
79319903918,79319903922,4,1490,1060,-20
79320135410,79320135414,4,1427,1291,-20
79323637815,79323637816,1,1343,1302,-20
79326106730,79326106733,3,1121,1430,-20
79327235474,79327235478,4,2252,2033,-20
79328484306,79328484310,4,1771,1691,-20
79331443412,79331443415,3,1441,1338,-20
79336765429,79336765432,3,2338,1952,-20
79337604532,79337604537,5,2346,1558,-20
79341892213,79341892215,2,2297,1177,-20
79343940921,79343940923,2,1314,1007,-20
79347470410,79347470414,4,1900,1243,-20
79349047020,79349047022,2,1619,1672,-20
79353049230,79353049233,3,2362,1627,-20
79356046415,79356046417,2,999,1020,-20
79356556050,79356556057,7,1248,920,-20
79358815510,79358815514,4,1663,1124,-20
79361157491,79361157495,4,1972,1146,-20
79361667393,79361667398,5,1998,1218,-20
79364961239,79364961242,3,2264,1714,-20
79370212032,79370212033,1,1702,1269,-20
79372263114,79372263118,4,1702,1183,-20
79381326564,79381326567,3,1444,1069,-20
79383870256,79383870261,5,2077,1744,-20
79386146973,79386146973,0,1574,2310,-20
79389462265,79389462268,3,1299,717,-20
79392694606,79392694609,3,2600,1520,-20
79392818827,79392818830,3,1725,1254,-20
79400419054,79400419058,4,2205,1214,-20
79400701850,79400701855,5,932,1043,-20
79401673719,79401673722,3,2046,1420,-20
79401879517,79401879520,3,2211,1551,-20
79402474038,79402474044,6,2301,1935,-20
79403389306,79403389311,5,1540,1140,-20
79403541991,79403541990,-1,1006,1598,-20
79406164451,79406164454,3,1766,1474,-20
79406824020,79406824023,3,1404,996,-20
79408014088,79408014094,6,2039,981,-20
79409399041,79409399045,4,1531,1901,-20
79409743488,79409743489,1,2174,1538,-20
79410206615,79410206619,4,657,359,-20
79410935237,79410935238,1,1665,1099,-20
79411091550,79411091551,1,2212,1194,-20
79413059532,79413059534,2,1979,1696,-20
79415141870,79415141874,4,1077,902,-20
79418804240,79418804243,3,1575,1268,-20
79422315688,79422315691,3,973,1279,-20
79422879324,79422879323,-1,1211,1885,-20
79424395347,79424395351,4,1397,1000,-20
79425360805,79425360810,5,1421,1292,-20
79428279382,79428279385,3,1926,1555,-20
79428330544,79428330548,4,2403,2301,-20
79428792837,79428792839,2,2050,1634,-20
79442496372,79442496376,4,1595,1604,-20
79443737290,79443737294,4,1377,1430,-20
79445042036,79445042017,-19,20,2256,-20
79447557362,79447557364,2,2300,1554,-20
79454586882,79454586885,3,2466,1708,-20
79459128611,79459128606,-5,24435,15137,-20
79459745602,79459745606,4,1653,1175,-20
79459934567,79459934571,4,1956,1580,-20
79460116682,79460116685,3,1603,1541,-20
79460318597,79460318601,4,1718,1288,-20
79464900222,79464900223,1,1258,1347,-20
79465950897,79465950900,3,1766,1181,-20
79467576414,79467576416,2,1422,1237,-20
79468632226,79468632227,1,1840,1856,-20
79469992830,79469992834,4,2635,1683,-20
79473440162,79473440166,4,1730,1463,-20
79474715889,79474715891,2,1305,1491,-20
79474965054,79474965054,0,873,1084,-20
79475152959,79475152963,4,1310,1286,-20
79482644164,79482644167,3,2208,987,-20
79484980767,79484980771,4,1041,912,-20
79487350820,79487350823,3,2434,1817,-20
79488994194,79488994198,4,1754,1427,-20
79490290022,79490290027,5,1393,930,-20
79490950026,79490950030,4,1138,944,-20
79493018802,79493018808,6,1925,1516,-20
79497615055,79497615060,5,1740,1339,-20
79500341159,79500341162,3,2203,1769,-20
79501934622,79501934625,3,1669,1384,-20
79504420018,79504420022,4,1357,1593,-20
79505785637,79505785642,5,1926,1141,-20
79506908979,79506908982,3,1791,1095,-20
79509777081,79509777082,1,2070,1494,-20
79513135442,79513135445,3,2042,1635,-20
79515122878,79515122885,7,8611,3518,-20
79515446123,79515446128,5,1730,1081,-20
79516527159,79516527153,-6,1010,5337,-20
79516904106,79516904104,-2,1298,2206,-20
79518502436,79518502441,5,2219,1546,-20
79519368051,79519368055,4,1708,1373,-20
79522210582,79522210586,4,654,779,-20
79522557132,79522557136,4,1411,1643,-20
79524379403,79524379406,3,2341,1495,-20
79525351059,79525351056,-3,1940,3058,-20
79527975731,79527975735,4,1099,1134,-20
79529589384,79529589382,-2,28021,11824,-20
79529614933,79529614937,4,1383,1050,-20
79529628499,79529628499,0,38,35,-20
79533391437,79533391438,1,1350,1660,-20
79536595391,79536595395,4,1758,1386,-20
79538433563,79538433569,6,2815,2017,-20
79538591542,79538591541,-1,2219,5027,-20
79539009294,79539009299,5,2093,1540,-20
79540648066,79540648070,4,4391,3423,-20
79542704630,79542704630,0,1603,2056,-20
79546013583,79546013585,2,2263,1356,-20
79549899476,79549899481,5,1700,1725,-20
79551129672,79551129676,4,1809,1219,-20
79552213162,79552213166,4,2589,1451,-20
79555327769,79555327774,5,2106,1878,-20
79556753135,79556753138,3,2580,1844,-20
79557494544,79557494537,-7,2084,6621,-20
79557753974,79557753971,-3,1285,3365,-20
79559971538,79559971543,5,1531,1380,-20
79560925728,79560925732,4,1916,1583,-20
79563581326,79563581327,1,1646,1002,-20
79563988374,79563988378,4,2319,1642,-20
79565602318,79565602323,5,2672,1502,-20
79566549788,79566549788,0,1334,1799,-20
79567511552,79567511557,5,2641,1687,-20
79568688564,79568688586,22,1837,1483,-20
79568744343,79568744347,4,2060,1208,-20
79569247306,79569247309,3,1714,1181,-20
79569653906,79569653910,4,973,1048,-20
79571147346,79571147350,4,2536,1565,-20
79571254417,79571254419,2,1018,999,-20
79573868993,79573868995,2,1527,1332,-20
79574510860,79574510858,-2,1799,1713,-20
79575243838,79575243838,0,1732,1744,-20
79575449135,79575449143,8,2936,1150,-20
79575652224,79575652229,5,1763,1210,-20
79576585831,79576585836,5,2042,1294,-20
79576947222,79576947223,1,2113,2695,-20
79580400986,79580400990,4,1719,1247,-20
79589389971,79589389974,3,1954,1545,-20
79589545438,79589545416,-22,1638,1549,-20
79590188674,79590188678,4,2175,1715,-20
79590316157,79590316160,3,1710,1529,-20
79593970403,79593970406,3,912,770,-20
79595871239,79595871242,3,2021,1345,-20
79600024139,79600024139,0,2235,1644,-20
79602696326,79602696330,4,1767,1099,-20
79605802823,79605802827,4,1126,1116,-20
79608622445,79608622447,2,2035,1361,-20
79612186807,79612186811,4,2493,1626,-20
79616720379,79616720382,3,1806,1758,-20
79624157178,79624157180,2,2753,1959,-20
79626282395,79626282399,4,2010,1369,-20
79626377780,79626377784,4,2456,1446,-20
79626413148,79626413150,2,1903,1336,-20
79628281301,79628281305,4,1019,782,-20
79630526719,79630526722,3,1665,1425,-20
79631352373,79631352375,2,1751,1534,-20
79633862054,79633862058,4,1184,739,-20
79635743365,79635743369,4,2077,1481,-20
79637192340,79637192345,5,2619,1840,-20
79637922698,79637922702,4,1567,1319,-20
79641923476,79641923479,3,958,1009,-20
79647242527,79647242530,3,1538,1046,-20
79654112142,79654112145,3,2139,1742,-20
79659594596,79659594599,3,1872,1683,-20
79659766618,79659766623,5,2005,1327,-20
79670177711,79670177710,-1,910,1851,-20
79672542803,79672542802,-1,2013,1303,-20
79674603159,79674603162,3,1167,1106,-20
79674650918,79674650921,3,1522,1693,-20
79675057954,79675057955,1,2005,984,-20
79678802254,79678802255,1,1436,1428,-20
79683103573,79683103576,3,1874,1647,-20
79684105435,79684105435,0,1673,1539,-20
79690265261,79690265264,3,2045,1550,-20
79690340373,79690340378,5,1746,1253,-20
79695700485,79695700488,3,1202,1412,-20
79696623901,79696623903,2,1558,1189,-20
79697169951,79697169954,3,1614,1306,-20
79698502294,79698502298,4,2047,2075,-20
79701607158,79701607162,4,2149,1446,-20
79702225095,79702225098,3,2369,1550,-20
79712626857,79712626862,5,1127,917,-20
79713679017,79713679012,-5,969,3575,-20
79714674309,79714674307,-2,1640,2495,-20
79714867533,79714867535,2,1487,1392,-20
79715836924,79715836928,4,1233,1094,-20
79716607206,79716607210,4,2031,1394,-20
79717850270,79717850273,3,2255,1232,-20
79720208761,79720208762,1,1466,1313,-20
79723958170,79723958174,4,857,1190,-20
79724874339,79724874344,5,1873,1548,-20
79726947017,79726947022,5,1920,2050,-20
79730652873,79730652875,2,2167,1873,-20
79732367305,79732367306,1,2429,1892,-20
79733053510,79733053513,3,1948,1517,-20
79740338998,79740339001,3,2229,1772,-20
79741042132,79741042134,2,1837,1521,-20
79741518817,79741518819,2,2085,1313,-20
79745344554,79745344557,3,1620,1226,-20
79751530769,79751530769,0,1060,1250,-20
79757578762,79757578766,4,1779,1687,-20
79763656276,79763656279,3,1824,998,-20
79764776945,79764776946,1,1395,1453,-20
79765221356,79765221340,-16,1855,1094,-20
79765261618,79765261622,4,1984,1308,-20
79765810109,79765810113,4,1911,1104,-20
79766314271,79766314274,3,1851,1197,-20
79767087855,79767087858,3,1707,1218,-20
79767420055,79767420058,3,1745,1068,-20
79769500106,79769500110,4,1337,1253,-20
79769650306,79769650307,1,1801,1313,-20
79771898821,79771898833,12,1221,1067,-20
79772179740,79772179742,2,1343,868,-20
79773350577,79773350581,4,2061,2040,-20
79775253465,79775253467,2,1984,1570,-20
79777948965,79777948969,4,2337,1769,-20
79781966277,79781966278,1,1481,1428,-20
79785256897,79785256902,5,1840,1436,-20
79786310073,79786310075,2,2254,1594,-20
79788986027,79788986030,3,1985,1670,-20
79793019550,79793019554,4,1496,1535,-20
79795231224,79795231229,5,3438,1361,-20
79796299562,79796299566,4,3264,1688,-20
79796393047,79796393051,4,1461,1178,-20
79801336369,79801336374,5,1891,1176,-20
79801755706,79801755709,3,2151,1439,-20
79801817321,79801817327,6,2567,1061,-20
79801883556,79801883540,-16,1594,1576,-20
79804261765,79804261768,3,2470,1379,-20
79806052720,79806052724,4,1369,950,-20
79807415548,79807415552,4,2181,1757,-20
79807843582,79807843585,3,1633,1348,-20
79809037844,79809037847,3,2376,1634,-20
79811516786,79811516790,4,1467,1638,-20
79811783678,79811783682,4,2041,1285,-20
79811815293,79811815296,3,1803,1241,-20
79814886931,79814886933,2,1713,1362,-20
79819243065,79819243067,2,1812,1714,-20
79820070728,79820070730,2,1802,1461,-20
79821154571,79821154575,4,2096,1436,-20
79827182714,79827182717,3,1717,833,-20
79828435722,79828435727,5,1569,1057,-20
79830007042,79830007045,3,1670,1399,-20
79832722589,79832722585,-4,20482,13728,-20
79833553878,79833553881,3,1756,957,-20
79835694069,79835694073,4,1521,1130,-20
79836008218,79836008219,1,1503,1883,-20
79836771819,79836771821,2,2267,1623,-20
79836994885,79836994891,6,2236,1275,-20
79843819308,79843819309,1,1804,1757,-20
79844434695,79844434698,3,1421,1544,-20
79852941988,79852941992,4,2465,990,-20
79857195318,79857195323,5,1505,1032,-20
79861850832,79861850837,5,3041,1465,-20
79862418048,79862418051,3,1898,1176,-20
79863045858,79863045861,3,2321,1444,-20
79864975794,79864975796,2,1643,1306,-20
79867242379,79867242384,5,1026,941,-20
79868054609,79868054605,-4,2634,7014,-20
79868497129,79868497133,4,1813,2058,-20
79868535042,79868535046,4,1187,1076,-20
79869489589,79869489594,5,1470,1253,-20
79869661292,79869661289,-3,1141,2441,-20
79870637559,79870637565,6,2262,1199,-20
79873187204,79873187211,7,1934,1445,-20
79879310734,79879310727,-7,1195,4561,-20
79880272696,79880272702,6,2714,1306,-20
79881043199,79881043203,4,1266,914,-20
79882363919,79882363922,3,1901,1214,-20
79883542820,79883542823,3,2797,1974,-20
79883644396,79883644399,3,1539,937,-20
79884990211,79884990214,3,1167,1952,-20
79896878575,79896878578,3,1966,1690,-20
79898841290,79898841293,3,1680,1493,-20
79899765782,79899765785,3,1514,1438,-20
79901684030,79901684042,12,12943,27524,-20
79904796931,79904796934,3,1221,1249,-20
79908104405,79908104407,2,2170,1486,-20
79909167186,79909167187,1,1623,1507,-20
79909616774,79909616778,4,2688,1930,-20
79911057758,79911057759,1,1522,1061,-20
79912132166,79912132169,3,1890,1815,-20
79912798529,79912798547,18,2635,1661,-20
79913133630,79913133612,-18,1823,1538,-20
79914371898,79914371902,4,1017,765,-20
79916762562,79916762569,7,5483,2348,-20
79921755831,79921755834,3,1254,1137,-20
79923066540,79923066542,2,1546,1096,-20
79923843153,79923843155,2,1364,1292,-20
79926254087,79926254090,3,1577,1924,-20
79928327973,79928327974,1,1939,1337,-20
79928679938,79928679942,4,1389,1274,-20
79931124514,79931124517,3,1126,953,-20
79932784134,79932784134,0,1613,1400,-20
79933751022,79933751027,5,2294,1648,-20
79937418854,79937418855,1,1501,1775,-20
79938186936,79938186939,3,2179,1706,-20
79939203805,79939203809,4,2102,1456,-20
79941630049,79941630053,4,2032,1582,-20
79942931682,79942931686,4,1690,1309,-20
79945872993,79945872997,4,2414,1614,-20
79947743347,79947743350,3,1466,1321,-20
79951637518,79951637521,3,1614,1277,-20
79951667094,79951667098,4,1403,876,-20
79953369234,79953369238,4,1251,1392,-20
79954224225,79954224227,2,1205,1241,-20
79955526061,79955526060,-1,33628,18272,-20
79962490206,79962490207,1,1701,2274,-20
79963948408,79963948409,1,2187,1748,-20
79964005901,79964005906,5,2145,687,-20
79966575735,79966575738,3,1625,1463,-20
79971896529,79971896534,5,1659,962,-20
79972792494,79972792499,5,2365,1739,-20
79972960077,79972960081,4,1577,1564,-20
79975605525,79975605528,3,1249,1364,-20
79977009646,79977009650,4,2087,1471,-20
79978583138,79978583140,2,2321,2010,-20
79979933497,79979933500,3,2026,994,-20
79980129189,79980129190,1,1720,687,-20
79980947066,79980947070,4,3077,2324,-20
79984498246,79984498250,4,1178,854,-20
79986248651,79986248654,3,1736,1231,-20
79990806051,79990806054,3,1310,1255,-20
79993894549,79993894549,0,1942,1623,-20
79996403707,79996403689,-18,1727,1410,-20
79996966304,79996966319,15,1842,1030,-20
79998820430,79998820434,4,2198,1466,-20
79998893454,79998893466,12,2194,1625,-20
79999242161,79999242167,6,1609,1165,-20
79999718930,79999718933,3,2345,2063,-20
80003146848,80003146852,4,1451,1499,-20
80005451853,80005451855,2,2567,1727,-20
80005881975,80005881968,-7,34802,14539,-20
80007982878,80007982882,4,2181,1664,-20
80015597308,80015597310,2,1376,1559,-20
80017648702,80017648707,5,1827,1230,-20
80018239918,80018239922,4,1670,1509,-20
80024087983,80024087964,-19,1685,1173,-20
80024881138,80024881141,3,2101,1373,-20
80025033547,80025033551,4,2321,1538,-20
80027303098,80027303103,5,2491,1793,-20
80028941377,80028941380,3,1335,1459,-20
80029302804,80029302801,-3,2436,7049,-20
80029780239,80029780242,3,1150,1075,-20
80037005722,80037005723,1,1935,1234,-20
80038524734,80038524741,7,14466,23232,-20
80046180481,80046180484,3,1741,2219,-20
80047924095,80047924098,3,1930,1089,-20
80048140542,80048140554,12,2318,1372,-20
80048295878,80048295857,-21,1944,1559,-20
80049530157,80049530154,-3,2945,4157,-20
80056073202,80056073206,4,902,964,-20
80057996709,80057996712,3,1975,1488,-20
80058740499,80058740504,5,1644,1510,-20
80059261758,80059261763,5,1179,1097,-20
80059573786,80059573791,5,1731,1543,-20
80062486645,80062486649,4,1367,1343,-20
80065186979,80065186981,2,1575,1240,-20
80068111417,80068111418,1,3661,3456,-20
80070824039,80070824042,3,2151,1174,-20
80072154384,80072154389,5,1708,832,-20
80075946658,80075946661,3,1953,1527,-20
80079507345,80079507348,3,1632,1210,-20
80080992490,80080992493,3,1520,801,-20
80083620487,80083620467,-20,608,326,-20
80090079429,80090079430,1,1274,1213,-20
80096934794,80096934798,4,2377,1009,-20
80098726855,80098726859,4,2000,1487,-20
80099403594,80099403598,4,1147,870,-20
80099783850,80099783854,4,1439,1159,-20
80100281850,80100281852,2,1782,1352,-20
80103981068,80103981071,3,1372,1546,-20
80104978767,80104978766,-1,1412,1547,-20
80105995471,80105995474,3,1528,1389,-20
80106489468,80106489474,6,1465,1046,-20
80107628215,80107628219,4,1430,850,-20
80108383138,80108383140,2,2112,2114,-20
80109515330,80109515333,3,1230,887,-20
80112324128,80112324131,3,1957,1686,-20
80114109219,80114109222,3,1365,1554,-20
80115137566,80115137562,-4,1202,2600,-20
80121022322,80121022326,4,2028,1346,-20
80122453702,80122453705,3,1521,1479,-20
80122678314,80122678316,2,1226,1783,-20
80123206104,80123206107,3,1908,1564,-20
80124211621,80124211626,5,1859,1254,-20
80124501629,80124501630,1,1576,1774,-20
80124668971,80124668973,2,1665,1328,-20
80125379987,80125379991,4,1714,1344,-20
80127688412,80127688418,6,2143,1310,-20
80128654641,80128654637,-4,1068,3240,-20
80129118914,80129118918,4,1468,792,-20
80131980058,80131980058,0,1601,1511,-20
80134477579,80134477581,2,1844,1338,-20
80135302305,80135302291,-14,2048,204,-20
80139752148,80139752150,2,2305,1376,-20
80149030622,80149030626,4,2046,1511,-20
80149562229,80149562233,4,1279,1051,-20
80152628687,80152628690,3,2686,1478,-20
80154035694,80154035698,4,2728,1669,-20
80154464713,80154464717,4,1783,1829,-20
80156605679,80156605674,-5,1211,3245,-20
80161126919,80161126923,4,2210,1378,-20
80162869673,80162869677,4,1407,1428,-20
80170248230,80170248234,4,1771,1134,-20
80174768806,80174768810,4,1995,1142,-20
80177871946,80177871951,5,1938,1233,-20
80181981511,80181981515,4,2106,1465,-20
80182171156,80182171159,3,2558,1532,-20
80185179438,80185179441,3,2510,1389,-20
80187476269,80187476276,7,1842,1557,-20
80190293919,80190293922,3,1594,1296,-20
80190820006,80190820001,-5,923,2132,-20
80191431560,80191431565,5,2148,1356,-20
80191900703,80191900706,3,1656,1128,-20
80195127798,80195127803,5,2246,1238,-20
80198711175,80198711179,4,1701,1769,-20
80200415789,80200415791,2,2081,1697,-20
80204836931,80204836937,6,3214,1809,-20
80205374318,80205374323,5,1759,1233,-20
80208155324,80208155326,2,1695,1094,-20
80213904591,80213904593,2,1743,1527,-20
80220104602,80220104617,15,1835,1252,-20
80222049790,80222049790,0,1307,1353,-20
80222908426,80222908431,5,1843,1137,-20
80225374891,80225374893,2,1706,1571,-20
80226434678,80226434681,3,1326,1251,-20
80226695850,80226695854,4,2400,1471,-20
80230422469,80230422472,3,2291,1690,-20
80230928919,80230928926,7,1118,1124,-20
80233173702,80233173706,4,1824,1435,-20
80233340237,80233340238,1,1657,1245,-20
80235395474,80235395477,3,1392,1428,-20
80236517081,80236517066,-15,2414,2115,-20
80241155527,80241155530,3,2596,1322,-20
80247204293,80247204294,1,1933,1451,-20
80248781442,80248781446,4,1553,1455,-20
80249501770,80249501754,-16,701,391,-20
80258393877,80258393878,1,1778,1178,-20
80258601876,80258601880,4,2750,2304,-20
80260084813,80260084817,4,1563,1480,-20
80263777938,80263777942,4,1525,1049,-20
80265571255,80265571258,3,2051,1259,-20
80266486250,80266486251,1,1248,831,-20
80268146090,80268146093,3,2444,1348,-20
80268738677,80268738678,1,1678,1013,-20
80272115500,80272115503,3,2044,1105,-20
80272467971,80272467985,14,738,198,-20
80275615345,80275615349,4,1938,1576,-20
80278118442,80278118445,3,2425,1396,-20
80280072933,80280072937,4,1514,1094,-20
80284501578,80284501596,18,1217,944,-20
80291113924,80291113926,2,1557,1288,-20
80291451514,80291451508,-6,1263,7642,-20
80291579295,80291579298,3,2359,1862,-20
80292412634,80292412641,7,1565,743,-20
80295189973,80295189967,-6,4238,14673,-20
80300350656,80300350659,3,2039,1572,-20
80304795013,80304795015,2,2086,1770,-20
80304864013,80304864017,4,1615,1345,-20
80305411926,80305411931,5,1147,900,-20
80307179414,80307179417,3,2598,1795,-20
80308717064,80308717067,3,1383,1225,-20
80309567071,80309567075,4,2034,1140,-20
80314241971,80314241974,3,1833,1244,-20
80314378027,80314378030,3,1780,1860,-20
80316081966,80316081970,4,1415,987,-20
80320543028,80320543030,2,1695,1796,-20
80326009513,80326009514,1,1521,1417,-20
80326483445,80326483447,2,1129,1205,-20
80333483731,80333483731,0,1906,1860,-20
80334140527,80334140530,3,999,931,-20
80336099021,80336099026,5,1466,1234,-20
80338299970,80338299969,-1,802,1761,-20
80339031422,80339031426,4,1713,1295,-20
80342196048,80342196050,2,1794,1724,-20
80346405345,80346405347,2,1629,1226,-20
80350119754,80350119738,-16,2119,1422,-20
80352211345,80352211350,5,1919,891,-20
80356125026,80356125028,2,1638,1129,-20
80358725611,80358725606,-5,3021,8756,-20
80363857980,80363857984,4,1399,1051,-20
80365332069,80365332073,4,2122,1630,-20
80365507352,80365507355,3,1937,1202,-20
80369516655,80369516650,-5,1335,3984,-20
80370472399,80370472401,2,1773,1934,-20
80370749220,80370749222,2,2438,1229,-20
80371839745,80371839749,4,2121,1386,-20
80372946515,80372946519,4,2851,1354,-20
80373736652,80373736652,0,1136,2391,-20
80375777683,80375777685,2,1229,1645,-20
80375966195,80375966201,6,684,391,-20
80377762230,80377762233,3,1846,1628,-20
80377943083,80377943083,0,2121,1391,-20
80379938774,80379938777,3,1691,1582,-20
80380844513,80380844515,2,2205,1662,-20
80381459780,80381459782,2,1865,907,-20
80382343006,80382343010,4,1370,1170,-20
80382740869,80382740871,2,1721,1110,-20
80383277593,80383277598,5,1700,1216,-20
80386750498,80386750507,9,12190,28239,-20
80390142415,80390142419,4,1867,1363,-20
80392242817,80392242838,21,1269,1469,-20
80395353369,80395353348,-21,474,61,-20
80395750226,80395750234,8,1740,1278,-20
80396779576,80396779579,3,1689,1291,-20
80397079552,80397079555,3,2277,1430,-20
80399212701,80399212681,-20,1498,1968,-20
80400659665,80400659668,3,1509,1620,-20
80401525714,80401525710,-4,17023,11682,-20
80404488222,80404488227,5,1795,1156,-20
80405190566,80405190570,4,2288,1740,-20
80409975642,80409975646,4,2055,1098,-20
80411619225,80411619229,4,1689,1978,-20
80413784442,80413784446,4,1616,1100,-20
80413963635,80413963641,6,2364,1568,-20
80414761246,80414761249,3,1996,1623,-20
80417506838,80417506844,6,2961,1413,-20
80420086841,80420086846,5,1450,1047,-20
80421303893,80421303896,3,1919,1297,-20
80422352025,80422352023,-2,1390,3246,-20
80430538674,80430538678,4,2082,1672,-20
80430574737,80430574743,6,2099,799,-20
80431741827,80431741831,4,1564,1436,-20
80432707918,80432707921,3,1915,1108,-20
80434517147,80434517150,3,1709,1236,-20
80436325550,80436325551,1,2094,1684,-20
80444414841,80444414846,5,1885,1324,-20
80447044155,80447044158,3,1974,1380,-20
80448850751,80448850755,4,1495,1158,-20
80448941802,80448941806,4,1533,1381,-20
80452945971,80452945974,3,2069,1164,-20
80454648501,80454648502,1,1823,1301,-20
80455660852,80455660854,2,1953,1097,-20
80458558203,80458558209,6,1937,1258,-20
80461807433,80461807432,-1,1297,2089,-20
80463269148,80463269150,2,2046,1306,-20
80464734683,80464734686,3,1582,1106,-20
80467364913,80467364916,3,2364,1625,-20
80467685126,80467685145,19,1513,1705,-20
80468508250,80468508255,5,1819,1316,-20
80470429760,80470429763,3,1525,1300,-20
80472005330,80472005335,5,1897,1913,-20
80473088444,80473088447,3,2132,1638,-20
80473118907,80473118910,3,1761,1361,-20
80473430402,80473430418,16,826,3110,-20
80475345290,80475345297,7,2464,1167,-20
80476305305,80476305310,5,2338,1429,-20
80477605582,80477605587,5,1351,1040,-20
80479834298,80479834303,5,2529,1254,-20
80483140679,80483140682,3,1894,1082,-20
80487037541,80487037534,-7,1285,2289,-20
80488681429,80488681434,5,1791,1277,-20
80493200365,80493200361,-4,688,1741,-20
80494968077,80494968079,2,1362,1260,-20
80497833492,80497833495,3,1831,1406,-20
80498945588,80498945589,1,1922,2011,-20
80500511976,80500511979,3,2000,1444,-20
80506066182,80506066188,6,1198,508,-20
80507358238,80507358244,6,891,791,-20
80509027257,80509027262,5,2670,1558,-20
80514069658,80514069662,4,1801,1317,-20
80514570150,80514570155,5,1654,1042,-20
80515309885,80515309886,1,1546,1202,-20
80521260534,80521260538,4,1198,798,-20
80521760967,80521760961,-6,1345,3787,-20
80524181338,80524181341,3,1583,1108,-20
80524426076,80524426079,3,2406,1987,-20
80526309158,80526309161,3,1033,461,-20
80527570667,80527570671,4,1601,1178,-20
80528170255,80528170258,3,1952,1409,-20
80528296341,80528296345,4,3086,1634,-20
80530981920,80530981917,-3,1262,1515,-20
80532083602,80532083607,5,1293,747,-20
80532472413,80532472418,5,8948,4717,-20
80534089034,80534089035,1,2141,1483,-20
80537320250,80537320244,-6,2873,12356,-20
80537374542,80537374544,2,1617,1367,-20
80542505160,80542505163,3,1543,1555,-20
80547218401,80547218405,4,2244,1462,-20
80547409167,80547409176,9,604,357,-20
80550361006,80550361009,3,1766,1338,-20
80551199207,80551199210,3,1326,1219,-20
80552444572,80552444577,5,2833,1584,-20
80555143339,80555143344,5,2023,1716,-20
80557280678,80557280681,3,1931,1118,-20
80559591079,80559591082,3,1363,1229,-20
80560717417,80560717419,2,1698,810,-20
80560983013,80560983024,11,1964,1486,-20
80566462630,80566462635,5,1323,832,-20
80567464077,80567464082,5,1943,1137,-20
80567925881,80567925886,5,2358,1619,-20
80569153376,80569153375,-1,1520,2276,-20
80575130766,80575130770,4,2166,1144,-20
80581174947,80581174951,4,2375,1005,-20
80581263178,80581263194,16,1843,1192,-20
80585943746,80585943747,1,1775,2123,-20
80588038470,80588038469,-1,858,1663,-20
80589801300,80589801305,5,2265,1489,-20
80591787643,80591787648,5,2877,1874,-20
80592704353,80592704355,2,1783,1072,-20
80592872085,80592872087,2,1997,1217,-20
80597337003,80597337007,4,1574,1656,-20
80597490231,80597490243,12,424,145,-20
80599307234,80599307238,4,2294,1621,-20
80600432667,80600432668,1,2567,2789,-20
80600768962,80600768976,14,1753,1569,-20
80602162270,80602162273,3,2064,1383,-20
80606562334,80606562339,5,1554,1544,-20
80607653894,80607653899,5,2078,1201,-20
80608493742,80608493746,4,1866,1091,-20
80610399474,80610399479,5,1970,1312,-20
80611559445,80611559447,2,2240,1399,-20
80612201097,80612201099,2,1723,1246,-20
80614736426,80614736429,3,2318,1530,-20
80621709162,80621709163,1,1522,970,-20
80622948527,80622948529,2,1574,1355,-20
80626351365,80626351372,7,1550,1543,-20
80626870097,80626870101,4,1490,1036,-20
80629570290,80629570294,4,2342,1751,-20
80631738204,80631738207,3,1475,1501,-20
80636629888,80636629890,2,3942,4197,-20
80637653237,80637653242,5,1716,1204,-20
80637995340,80637995344,4,2028,1385,-20
80639157468,80639157470,2,2202,1012,-20
80639521970,80639521954,-16,1627,738,-20
80640611598,80640611602,4,1525,1428,-20
80642862263,80642862267,4,2219,930,-20
80643532910,80643532913,3,2321,1366,-20
80651516657,80651516658,1,1497,1658,-20
80653395339,80653395343,4,1600,1334,-20
80656326089,80656326094,5,2471,1522,-20
80657146055,80657146058,3,1609,1101,-20
80657453002,80657453004,2,1705,1343,-20
80661921397,80661921400,3,1168,1041,-20
80667709384,80667709387,3,1875,1558,-20
80667756628,80667756631,3,1918,1346,-20
80668825842,80668825847,5,1731,1451,-20
80669705873,80669705878,5,2170,1734,-20
80673783737,80673783742,5,1482,1246,-20
80674765399,80674765402,3,1851,1443,-20
80674932297,80674932298,1,1675,1462,-20
80676978866,80676978870,4,1713,1117,-20
80677858677,80677858679,2,1563,1112,-20
80680705752,80680705756,4,1721,1692,-20
80680949085,80680949067,-18,850,1097,-20
80682421532,80682421538,6,2022,1482,-20
80682555551,80682555530,-21,542,629,-20
80683494016,80683494013,-3,1867,1880,-20
80684031862,80684031867,5,2027,1661,-20
80685279846,80685279851,5,1711,1335,-20
80685703912,80685703914,2,1222,1345,-20
80691264410,80691264413,3,1401,1120,-20
80691682964,80691682948,-16,1369,852,-20
80691774502,80691774506,4,1476,1451,-20
80693457374,80693457378,4,1174,1582,-20
80696518568,80696518571,3,1950,1539,-20
80696940368,80696940375,7,4250,1393,-20
80702328779,80702328783,4,2234,1404,-20
80702577843,80702577849,6,2687,1480,-20
80703865922,80703865925,3,2209,1550,-20
80709212470,80709212474,4,14482,7609,-20
80709544452,80709544453,1,2041,1876,-20
80712982349,80712982353,4,1877,710,-20
80713194350,80713194351,1,1606,1218,-20
80714172630,80714172635,5,1991,1432,-20
80716663002,80716663005,3,1855,1279,-20
80723447811,80723447814,3,1869,1431,-20
80724567935,80724567939,4,974,867,-20
80725571314,80725571316,2,2916,2160,-20
80728710542,80728710546,4,2488,1275,-20
80730917433,80730917440,7,3839,1951,-20
80731115417,80731115422,5,1680,1455,-20
80734467063,80734467058,-5,965,2815,-20
80735343154,80735343158,4,1841,1448,-20
80736389051,80736389055,4,2227,1556,-20
80738788661,80738788664,3,1448,1343,-20
80739133120,80739133124,4,1576,1371,-20
80739343870,80739343875,5,1443,838,-20
80740637420,80740637423,3,1568,1740,-20
80741554821,80741554823,2,1640,1118,-20
80743963795,80743963799,4,1932,1220,-20
80744521126,80744521128,2,1697,1631,-20
80749227551,80749227553,2,2197,1531,-20
80750121738,80750121742,4,1755,1274,-20
80753512410,80753512413,3,1551,946,-20
80754348461,80754348463,2,1510,1433,-20
80754579435,80754579439,4,976,1119,-20
80755184277,80755184271,-6,1270,5631,-20
80756632406,80756632409,3,924,1267,-20
80758299005,80758299007,2,1423,935,-20
80759668634,80759668638,4,1118,997,-20
80760631323,80760631323,0,1730,2102,-20
80762603331,80762603335,4,2246,1173,-20
80763103358,80763103363,5,1677,1368,-20
80764243859,80764243862,3,993,607,-20
80764650129,80764650132,3,3448,2519,-20
80764941010,80764941013,3,1678,1336,-20
80766061719,80766061710,-9,1435,5858,-20
80770656446,80770656450,4,2247,1751,-20
80771377363,80771377363,0,1931,1770,-20
80771750871,80771750875,4,2244,1132,-20
80771875582,80771875600,18,1422,1130,-20
80774939425,80774939427,2,1909,1699,-20
80775832566,80775832567,1,1327,1059,-20
80777459441,80777459443,2,1278,1088,-20
80778554830,80778554835,5,2257,1548,-20
80779216654,80779216659,5,1295,1005,-20
80781081173,80781081177,4,2216,1424,-20
80782093597,80782093601,4,1933,1432,-20
80785533586,80785533589,3,1844,1427,-20
80786737627,80786737631,4,1192,1331,-20
80786855887,80786855891,4,1861,1708,-20
80787303461,80787303463,2,1361,1839,-20
80788436867,80788436870,3,1364,1233,-20
80790835506,80790835510,4,2248,1182,-20
80791292674,80791292683,9,1723,1225,-20
80794617495,80794617500,5,2958,1452,-20
80798556399,80798556401,2,1071,1105,-20
80801716366,80801716366,0,1602,1578,-20
80803975459,80803975465,6,1830,1141,-20
80805235154,80805235159,5,1812,1273,-20
80805521321,80805521324,3,1425,1097,-20
80805623698,80805623682,-16,1051,612,-20
80806031099,80806031102,3,1634,1424,-20
80806205118,80806205122,4,1154,1011,-20
80808114500,80808114504,4,2227,1666,-20
80808872312,80808872313,1,1493,1410,-20
80812813870,80812813875,5,2617,1669,-20
80813542447,80813542450,3,33803,21984,-20
80817429395,80817429399,4,1564,1097,-20
80820821676,80820821679,3,1476,959,-20
80821713205,80821713207,2,1346,894,-20
80825011003,80825011007,4,2161,1072,-20
80826858863,80826858865,2,1550,1468,-20
80834701123,80834701125,2,2418,1734,-20
80834774012,80834774014,2,2239,1760,-20
80839929129,80839929131,2,2194,1792,-20
80850281170,80850281175,5,1228,1099,-20
80851068744,80851068747,3,2286,1878,-20
80851750578,80851750583,5,2053,1233,-20
80853732255,80853732259,4,1602,1257,-20
80853905335,80853905340,5,1834,1210,-20
80855661911,80855661914,3,1955,1591,-20
80859737427,80859737431,4,1584,1457,-20
80864244022,80864244026,4,2444,1598,-20
80867595863,80867595867,4,1582,1559,-20
80875392930,80875392932,2,2808,2022,-20
80875470409,80875470413,4,1366,1330,-20
80876734651,80876734655,4,1206,1110,-20
80877595858,80877595864,6,14423,7873,-20
80878608950,80878608953,3,1195,1416,-20
80882524014,80882524018,4,2251,1493,-20
80886224222,80886224208,-14,2093,1288,-20
80890321927,80890321931,4,2327,1664,-20
80890566778,80890566781,3,1425,1298,-20
80892923386,80892923390,4,1223,1193,-20
80893666170,80893666174,4,1854,831,-20
80898222883,80898222886,3,1810,1508,-20
80900047667,80900047672,5,1474,1191,-20
80901031817,80901031818,1,1635,1131,-20
80901258578,80901258595,17,1135,766,-20
80903339430,80903339433,3,1593,1401,-20
80912681263,80912681266,3,1609,1211,-20
80913941835,80913941837,2,1829,1416,-20
80914924742,80914924746,4,1093,1085,-20
80917372237,80917372239,2,2211,978,-20
80917670974,80917670976,2,2034,1544,-20
80918243627,80918243604,-23,894,1042,-20
80921035202,80921035201,-1,1544,1222,-20
80923651849,80923651851,2,2334,2213,-20
80924619132,80924619128,-4,1013,1565,-20
80924747344,80924747347,3,2139,1423,-20
80925220422,80925220429,7,3047,1672,-20
80928809006,80928809010,4,1805,1455,-20
80932032562,80932032568,6,2385,2039,-20
80932144998,80932145008,10,2621,1993,-20
80933250501,80933250505,4,2056,1289,-20
80936013595,80936013591,-4,904,2342,-20
80938617723,80938617726,3,1640,1309,-20
80940132289,80940132292,3,1472,1539,-20
80942719384,80942719388,4,1911,1767,-20
80943205546,80943205552,6,2044,1773,-20
80943717891,80943717894,3,2230,1182,-20
80944537702,80944537702,0,9726,11954,-20
80947066049,80947066051,2,1815,1162,-20
80951508036,80951508030,-6,4618,10951,-20
80953052473,80953052476,3,2161,1190,-20
80953615826,80953615827,1,1211,1344,-20
80957557971,80957557976,5,1416,1186,-20
80958577824,80958577826,2,2378,1650,-20
80958742014,80958742018,4,1849,1073,-20
80962022210,80962022210,0,972,1096,-20
80962745844,80962745846,2,1861,1366,-20
80963327635,80963327638,3,1750,1134,-20
80965000605,80965000609,4,2689,1234,-20
80965538951,80965538954,3,1956,1763,-20
80966826046,80966826050,4,944,814,-20
80967613664,80967613666,2,1770,1983,-20
80967647237,80967647235,-2,31994,61543,-20
80968084077,80968084083,6,3235,1388,-20
80970204630,80970204633,3,2447,1688,-20
80971629795,80971629776,-19,1421,788,-20
80973897157,80973897161,4,1727,1433,-20
80974490963,80974490964,1,1563,1398,-20
80974704609,80974704603,-6,735,2822,-20
80976841051,80976841057,6,2139,1156,-20
80977504680,80977504684,4,2375,1406,-20
80980485970,80980485974,4,1879,1281,-20
80982708264,80982708265,1,2039,1729,-20
80985405002,80985405003,1,1700,1492,-20
80986457712,80986457716,4,1416,1186,-20
80986626650,80986626654,4,2192,1118,-20
80989114555,80989114559,4,1824,1217,-20
80990162627,80990162630,3,1387,911,-20
80990873818,80990873823,5,2557,1634,-20
80991784735,80991784739,4,1998,1254,-20
80994500753,80994500755,2,2128,1071,-20
80995645789,80995645793,4,1791,1363,-20
80995993570,80995993577,7,2345,1364,-20
81000704127,81000704131,4,1458,1194,-20
81002598613,81002598613,0,1193,1689,-20
81002979089,81002979092,3,32089,24559,-20
81004706869,81004706871,2,1652,1488,-20
81005692130,81005692138,8,248,1468,-20
81014281103,81014281105,2,2369,1840,-20
81014924286,81014924289,3,1819,1420,-20
81018025009,81018025010,1,2212,1569,-20
81019839366,81019839363,-3,1046,1609,-20
81021896830,81021896834,4,1236,879,-20
81022418999,81022419003,4,1885,1396,-20
81023282456,81023282460,4,1949,1205,-20
81026395138,81026395144,6,1909,1273,-20
81027193257,81027193259,2,1770,1356,-20
81028249829,81028249820,-9,1458,9685,-20
81034127731,81034127728,-3,35992,18373,-20
81035929922,81035929922,0,1255,1888,-20
81036222505,81036222508,3,3540,3598,-20
81037534455,81037534459,4,1849,1212,-20
81038458794,81038458800,6,3687,1404,-20
81039663021,81039663023,2,17851,6664,-20
81042304377,81042304379,2,1884,1171,-20
81046162070,81046162074,4,1465,1192,-20
81047321952,81047321957,5,1789,1346,-20
81048530794,81048530799,5,2242,1878,-20
81053872093,81053872097,4,1882,1180,-20
81059510574,81059510580,6,3152,1826,-20
81060376035,81060376035,0,869,735,-20
81062869017,81062869023,6,2076,1351,-20
81064978620,81064978621,1,1363,1463,-20
81066689805,81066689807,2,2328,1806,-20
81067625981,81067625985,4,1639,1561,-20
81068815269,81068815271,2,1518,1262,-20
81070128330,81070128336,6,1219,1002,-20
81076081996,81076081994,-2,1224,2016,-20
81085389972,81085389968,-4,1460,5220,-20
81087798038,81087798040,2,1996,1880,-20
81089692362,81089692368,6,2513,1396,-20
81091075902,81091075906,4,2029,1317,-20
81091175726,81091175730,4,2307,1921,-20
81100241018,81100241022,4,1927,1165,-20
81100791621,81100791626,5,2576,1431,-20
81102287312,81102287315,3,2446,1616,-20
81105672702,81105672704,2,1315,1624,-20
81107896229,81107896230,1,1190,1014,-20
81109809667,81109809669,2,1250,1134,-20
81111025375,81111025378,3,2135,1524,-20
81111465396,81111465399,3,1935,1052,-20
81112761493,81112761495,2,1815,1407,-20
81113824166,81113824169,3,1735,1192,-20
81118037086,81118037091,5,2039,2129,-20
81121552871,81121552871,0,1504,1452,-20
81123109450,81123109454,4,4905,2731,-20
81123545940,81123545943,3,1929,1198,-20
81128693813,81128693814,1,1097,883,-20
81131483757,81131483759,2,2488,1144,-20
81132605451,81132605454,3,1950,1073,-20
81136530032,81136530034,2,2345,1356,-20
81143910544,81143910545,1,1332,1295,-20
81146924057,81146924060,3,2498,1521,-20
81149744277,81149744270,-7,2205,7994,-20
81151811469,81151811470,1,3506,3247,-20
81155770782,81155770786,4,1180,1005,-20
81157653313,81157653317,4,1915,1678,-20
81157909891,81157909889,-2,3296,5860,-20
81158070434,81158070438,4,1569,1081,-20
81163808334,81163808339,5,2156,1590,-20
81163839511,81163839514,3,1949,1373,-20
81165707497,81165707498,1,1166,1771,-20
81167788030,81167788034,4,1880,1291,-20
81172596246,81172596253,7,2758,1776,-20
81173081110,81173081110,0,1854,1348,-20
81173852906,81173852909,3,1129,968,-20
81174999755,81174999758,3,1403,1066,-20
81176949548,81176949551,3,1865,1673,-20
81178331507,81178331512,5,1327,856,-20
81179752717,81179752723,6,1450,1164,-20
81180128210,81180128215,5,1843,1357,-20
81185032122,81185032119,-3,1651,3655,-20
81186216016,81186216018,2,1533,1456,-20
81187454523,81187454526,3,2087,1947,-20
81188858726,81188858731,5,2212,1340,-20
81189474362,81189474367,5,1695,955,-20
81192830077,81192830079,2,2084,878,-20
81194506829,81194506814,-15,228,1229,-20
81195782966,81195782971,5,1673,1472,-20
81200991129,81200991124,-5,1006,5040,-20
81201915833,81201915837,4,1574,1754,-20
81202933962,81202933967,5,1643,1673,-20
81203591090,81203591090,0,1374,2238,-20
81206638974,81206638977,3,1680,1118,-20
81207952594,81207952596,2,2012,2025,-20
81209047355,81209047361,6,1240,919,-20
81209289813,81209289815,2,1814,1480,-20
81209874347,81209874339,-8,22409,11944,-20
81210240935,81210240939,4,2039,2377,-20
81210994820,81210994823,3,2136,1743,-20
81213028315,81213028319,4,2272,1373,-20
81213851631,81213851650,19,2116,871,-20
81214793918,81214793921,3,1616,1268,-20
81216540598,81216540601,3,1687,1766,-20
81219447115,81219447112,-3,1131,2641,-20
81226768194,81226768200,6,1927,1056,-20
81226808549,81226808552,3,1456,1460,-20
81227238647,81227238656,9,919,1538,-20
81227373123,81227373126,3,1850,1280,-20
81229697063,81229697065,2,640,641,-20
81231856207,81231856209,2,1260,1585,-20
81231995113,81231995115,2,1564,1306,-20
81234120265,81234120268,3,1792,1256,-20
81237566543,81237566545,2,1347,1445,-20
81238082476,81238082482,6,2466,906,-20
81240644409,81240644406,-3,1549,4185,-20
81241037754,81241037757,3,1086,1274,-20
81241407822,81241407824,2,857,1009,-20
81242602169,81242602165,-4,1353,2975,-20
81243882183,81243882185,2,1820,1428,-20
81243970256,81243970258,2,1920,1538,-20
81244667973,81244667979,6,2105,1270,-20
81254610058,81254610062,4,1926,1154,-20
81254778931,81254778946,15,2358,1214,-20
81255173977,81255173961,-16,784,294,-20
81256657378,81256657382,4,2547,1869,-20
81260071898,81260071903,5,1919,1724,-20
81269079805,81269079807,2,1595,1334,-20
81269637150,81269637153,3,1570,1049,-20
81270442046,81270442049,3,2430,1609,-20
81271160597,81271160599,2,1759,1245,-20
81274430270,81274430273,3,1452,1147,-20
81277337232,81277337234,2,1377,1192,-20
81280291847,81280291827,-20,2010,1227,-20
81280488098,81280488101,3,1634,1469,-20
81283774626,81283774629,3,2217,1573,-20
81283962914,81283962917,3,1132,1568,-20
81284975672,81284975676,4,1659,1045,-20
81289022178,81289022178,0,23711,306,-20
81289422965,81289422955,-10,1017,416,-20
81290254178,81290254179,1,2418,1507,-20
81290289740,81290289744,4,1488,805,-20
81292499727,81292499731,4,2123,1349,-20
81293305496,81293305496,0,2419,3073,-20
81293719282,81293719280,-2,1177,1879,-20
81295087607,81295087610,3,2195,991,-20
81298853561,81298853564,3,2139,1189,-20
81299933248,81299933252,4,3334,1484,-20
81300164850,81300164855,5,1755,1270,-20
81301784539,81301784551,12,1219,1242,-20
81302794621,81302794625,4,1620,1364,-20
81303353641,81303353658,17,1744,1854,-20
81303789530,81303789534,4,2499,1260,-20
81308873711,81308873717,6,1507,923,-20
81313943548,81313943547,-1,1629,3271,-20
81318237851,81318237855,4,1293,1219,-20
81319116407,81319116408,1,1120,953,-20
81319548551,81319548530,-21,2187,1187,-20
81322423124,81322423127,3,1914,1611,-20
81322857157,81322857161,4,926,844,-20
81325978421,81325978423,2,1509,1413,-20
81330066814,81330066817,3,1818,1052,-20
81338762149,81338762149,0,1031,1287,-20
81340877101,81340877107,6,1953,1770,-20
81341269890,81341269895,5,2231,1528,-20
81345356290,81345356293,3,1624,991,-20
81346699641,81346699643,2,2287,1319,-20
81347611475,81347611478,3,1890,1375,-20
81347675677,81347675680,3,1904,1493,-20
81349226742,81349226749,7,14767,5906,-20
81349901607,81349901609,2,1864,1164,-20
81351857526,81351857530,4,645,869,-20
81353638867,81353638873,6,1233,1175,-20
81354999984,81354999988,4,1806,1408,-20
81360528422,81360528423,1,1851,1466,-20
81361917608,81361917611,3,2097,1526,-20
81363963546,81363963549,3,1891,1263,-20
81365701560,81365701559,-1,1478,2402,-20
81368716354,81368716356,2,24143,20255,-20
81370125654,81370125657,3,2252,1534,-20
81370403813,81370403817,4,1271,1154,-20
81372504758,81372504761,3,1554,1339,-20
81376661614,81376661614,0,1182,1196,-20
81378421918,81378421919,1,1249,1004,-20
81380839795,81380839799,4,2769,1881,-20
81382332163,81382332167,4,1418,1287,-20
81384434550,81384434553,3,2122,2009,-20
81385308089,81385308090,1,1713,1673,-20
81385903763,81385903767,4,2577,1097,-20
81386941753,81386941755,2,1912,1072,-20
81388203338,81388203342,4,1332,1361,-20
81388663383,81388663385,2,2581,1766,-20
81394321632,81394321637,5,2291,1649,-20
81397086868,81397086873,5,1704,1749,-20
81405202330,81405202333,3,2177,1322,-20
81405918815,81405918818,3,1768,1517,-20
81407896871,81407896875,4,2238,1911,-20
81409014438,81409014441,3,1975,2148,-20
81410697497,81410697501,4,1854,820,-20
81414568076,81414568080,4,2012,1668,-20
81415109662,81415109640,-22,1637,1073,-20
81415705378,81415705376,-2,1155,3206,-20
81416250819,81416250824,5,1872,1232,-20
81419526834,81419526839,5,1530,1054,-20
81423837823,81423837825,2,2249,1722,-20
81424185818,81424185819,1,1119,1142,-20
81424219636,81424219642,6,2572,1278,-20
81425461610,81425461608,-2,19518,15136,-20
81426894933,81426894934,1,1695,1440,-20
81428787580,81428787584,4,1658,1195,-20
81431346811,81431346812,1,1534,2014,-20
81433666282,81433666286,4,1470,1732,-20
81434169145,81434169150,5,806,748,-20
81437694271,81437694274,3,1714,1290,-20
81438029690,81438029692,2,1646,1239,-20
81438374876,81438374881,5,2158,1614,-20
81443080665,81443080669,4,1776,1464,-20
81444171641,81444171644,3,1628,1752,-20
81445310354,81445310357,3,1390,1455,-20
81445695462,81445695463,1,2475,1856,-20
81449605115,81449605117,2,919,970,-20
81450349319,81450349329,10,1529,914,-20
81458998917,81458998920,3,2510,1758,-20
81463382394,81463382397,3,1082,1012,-20
81464145066,81464145069,3,2345,1421,-20
81464956426,81464956423,-3,1309,1175,-20
81467291958,81467291962,4,1672,1594,-20
81468671431,81468671436,5,2407,1542,-20
81470139497,81470139498,1,1363,1320,-20
81473732198,81473732201,3,1517,1599,-20
81477574431,81477574431,0,1559,872,-20
81479750202,81479750208,6,3309,1769,-20
81480849064,81480849067,3,1565,1042,-20
81484523647,81484523652,5,1528,1617,-20
81485014231,81485014236,5,1650,1006,-20
81486654310,81486654315,5,2849,1399,-20
81487080034,81487080034,0,2124,1711,-20
81489729533,81489729537,4,1675,1701,-20
81490175389,81490175393,4,2063,988,-20
81493035461,81493035466,5,886,840,-20
81494996720,81494996723,3,2395,1344,-20
81497600329,81497600330,1,1851,1674,-20
81497643848,81497643850,2,2265,1282,-20
81505207255,81505207253,-2,687,1840,-20
81509949962,81509949967,5,2242,1304,-20
81511443877,81511443882,5,1834,1542,-20
81511537506,81511537510,4,1532,1429,-20
81518546761,81518546764,3,1257,1258,-20
81521456018,81521456022,4,1858,1098,-20
81525501377,81525501381,4,1873,1665,-20
81528188259,81528188259,0,1487,1508,-20
81528622518,81528622537,19,2501,1308,-20
81530754577,81530754578,1,2521,1806,-20
81531256602,81531256605,3,1181,1003,-20
81531948682,81531948686,4,1872,1208,-20
81533254130,81533254133,3,1148,954,-20
81536917094,81536917089,-5,1604,3792,-20
81538034007,81538034005,-2,800,1074,-20
81541453769,81541453771,2,1763,1399,-20
81544727207,81544727208,1,2193,2237,-20
81546931302,81546931297,-5,568,1242,-20
81548996300,81548996302,2,2272,1694,-20
81551457087,81551457090,3,1531,1775,-20
81551522169,81551522171,2,1541,1467,-20
81551971331,81551971309,-22,1393,1203,-20
81552404894,81552404894,0,1879,1218,-20
81555166155,81555166149,-6,3431,10787,-20
81556555735,81556555733,-2,1086,1164,-20
81557378249,81557378254,5,2145,1609,-20
81558192809,81558192814,5,1832,1804,-20
81559915157,81559915158,1,1497,1515,-20
81563765180,81563765182,2,1321,1095,-20
81564099779,81564099785,6,2599,1192,-20
81565073953,81565073956,3,1917,1875,-20
81565307638,81565307632,-6,1030,3922,-20
81567849314,81567849310,-4,742,1968,-20
81571795582,81571795585,3,1629,1449,-20
81572721133,81572721137,4,1692,1489,-20
81572898198,81572898202,4,973,596,-20
81576378449,81576378450,1,1699,1159,-20
81577826904,81577826909,5,2357,1125,-20
81578874350,81578874353,3,1186,947,-20
81581283037,81581283038,1,1673,1226,-20
81586635424,81586635430,6,2439,1074,-20
81591098138,81591098134,-4,2106,5890,-20
81597908598,81597908602,4,2245,1692,-20
81600451627,81600451630,3,1638,1109,-20
81602312570,81602312574,4,1971,1190,-20
81603631508,81603631490,-18,1369,853,-20
81608239958,81608239962,4,2374,1339,-20
81610030729,81610030730,1,2227,1799,-20
81612343170,81612343174,4,2592,1733,-20
81615602588,81615602590,2,1104,983,-20
81617722462,81617722444,-18,679,417,-20
81619417062,81619417067,5,2198,947,-20
81621286608,81621286617,9,16528,25714,-20
81623583098,81623583099,1,1954,2217,-20
81628553831,81628553834,3,1000,986,-20
81629071260,81629071264,4,1725,1275,-20
81630643010,81630643014,4,2099,1481,-20
81631678267,81631678261,-6,1747,4294,-20
81632528135,81632528139,4,1517,1596,-20
81635837670,81635837674,4,1986,1611,-20
81641126372,81641126374,2,2085,1502,-20
81642002673,81642002673,0,1989,1705,-20
81642404784,81642404790,6,2361,1303,-20
81648375438,81648375442,4,2139,1696,-20
81650642041,81650642046,5,4239,2007,-20
81654345170,81654345173,3,1860,1412,-20
81655146637,81655146642,5,2024,1482,-20
81655627040,81655627042,2,1912,1471,-20
81657107179,81657107181,2,1472,1271,-20
81659938427,81659938429,2,1948,1842,-20
81662431566,81662431564,-2,1521,3964,-20
81663230106,81663230109,3,2329,2105,-20
81663461091,81663461095,4,1927,1218,-20
81663928693,81663928696,3,2157,1797,-20
81664927295,81664927299,4,1576,1365,-20
81666980754,81666980758,4,1987,1405,-20
81674787809,81674787812,3,1453,1782,-20
81675681565,81675681567,2,1843,1330,-20
81676061053,81676061075,22,1680,1344,-20
81676362829,81676362829,0,1816,1632,-20
81676780855,81676780861,6,2296,1277,-20
81676887311,81676887311,0,1568,3129,-20
81677662067,81677662066,-1,1271,1823,-20
81680038932,81680038934,2,2344,1301,-20
81680410029,81680410033,4,4115,2393,-20
81683583081,81683583086,5,2027,1325,-20
81688932715,81688932718,3,2044,1336,-20
81690868025,81690868029,4,1305,817,-20
81692710016,81692710019,3,1229,1375,-20
81693284646,81693284645,-1,1047,1822,-20
81693696982,81693696984,2,1248,960,-20
81695763421,81695763423,2,1743,1522,-20
81698023810,81698023815,5,1280,1113,-20
81698648150,81698648151,1,1835,1835,-20
81699520275,81699520279,4,2341,1274,-20
81703916384,81703916387,3,2521,1745,-20
81710480763,81710480767,4,1690,1293,-20
81710531623,81710531626,3,1974,1542,-20
81717256463,81717256466,3,1731,1749,-20
81727198241,81727198242,1,1038,1263,-20
81727881162,81727881165,3,2555,1852,-20
81729812542,81729812543,1,1776,1772,-20
81731607227,81731607230,3,1357,1378,-20
81732300381,81732300383,2,3222,2965,-20
81735366042,81735366044,2,2173,2508,-20
81735516850,81735516853,3,2874,1565,-20
81737868439,81737868442,3,1904,1396,-20
81738029887,81738029892,5,1516,1620,-20
81742563715,81742563718,3,2151,1450,-20
81743133854,81743133833,-21,1867,1150,-20
81744585956,81744585959,3,1410,1420,-20
81749368673,81749368678,5,1928,1186,-20
81750786426,81750786428,2,2119,1565,-20
81753009847,81753009851,4,1248,1047,-20
81753393049,81753393055,6,1336,1043,-20
81757304381,81757304386,5,1787,1338,-20
81757474133,81757474139,6,1546,988,-20
81764317921,81764317924,3,1566,1395,-20
81766067869,81766067873,4,1654,1509,-20
81766700058,81766700062,4,2029,1294,-20
81766813801,81766813805,4,1874,1429,-20
81768141395,81768141397,2,2035,2002,-20
81770844147,81770844149,2,1829,1505,-20
81773701075,81773701079,4,1941,1252,-20
81774823915,81774823918,3,1781,1296,-20
81778040823,81778040821,-2,1206,3078,-20
81778145490,81778145492,2,1807,2013,-20
81781711225,81781711228,3,1846,1262,-20
81785056348,81785056352,4,2236,1718,-20
81786139662,81786139666,4,1955,1245,-20
81790332115,81790332116,1,2355,2790,-20
81792811652,81792811653,1,1176,1099,-20
81795961786,81795961790,4,2320,984,-20
81798736985,81798736981,-4,5021,9707,-20
81802329280,81802329283,3,2327,1526,-20
81803693625,81803693631,6,2248,1109,-20
81804375114,81804375118,4,1503,1171,-20
81806483115,81806483120,5,2698,1235,-20
81807622105,81807622106,1,1412,1037,-20
81810517188,81810517190,2,1159,1285,-20
81814471818,81814471817,-1,1375,2367,-20
81816616006,81816616010,4,1922,1893,-20
81819324852,81819324855,3,1880,1171,-20
81820273862,81820273863,1,1099,959,-20
81823872967,81823872970,3,1803,1458,-20
81824347008,81824347011,3,1774,1137,-20
81825106623,81825106628,5,1264,1637,-20
81825978323,81825978327,4,1198,802,-20
81826946413,81826946398,-15,1691,1178,-20
81830131295,81830131298,3,1552,1327,-20
81835370396,81835370398,2,2252,1637,-20
81835827470,81835827474,4,1796,1281,-20
81839247411,81839247414,3,1532,1593,-20
81839302662,81839302665,3,1156,1523,-20
81840158850,81840158865,15,2146,1241,-20
81841160363,81841160367,4,1850,1666,-20
81842219571,81842219575,4,1747,1115,-20
81842369546,81842369548,2,3761,3458,-20
81845694431,81845694435,4,1112,963,-20
81845729010,81845729014,4,1509,1126,-20
81847712666,81847712667,1,1771,1182,-20
81848666193,81848666201,8,10786,34012,-20
81850094999,81850095003,4,2042,1454,-20
81851541133,81851541135,2,1779,1776,-20
81856060092,81856060095,3,1688,963,-20
81857548351,81857548354,3,2069,1455,-20
81857804951,81857804951,0,1688,1254,-20
81862612558,81862612558,0,1475,1364,-20
81866227473,81866227477,4,1289,1179,-20
81867999282,81867999286,4,1597,1138,-20
81874161813,81874161815,2,1493,1376,-20
81874236730,81874236734,4,1771,1386,-20
81875037583,81875037586,3,1794,1000,-20
81876972178,81876972180,2,1953,1607,-20
81878286831,81878286837,6,2102,1407,-20
81878438786,81878438791,5,2309,1196,-20
81878751882,81878751885,3,2433,1915,-20
81880825756,81880825758,2,1306,796,-20
81885126237,81885126241,4,1810,1700,-20
81885276024,81885276026,2,1648,1204,-20
81887477305,81887477310,5,2024,973,-20
81889812056,81889812060,4,18981,38446,-20
81890186430,81890186433,3,1462,1544,-20
81891185678,81891185674,-4,1343,3136,-20
81893766994,81893766999,5,1313,1055,-20
81894305490,81894305494,4,3512,2439,-20
81894675038,81894675041,3,1912,1636,-20
81902046958,81902046963,5,1804,1931,-20
81902170510,81902170515,5,1791,935,-20
81902630514,81902630516,2,1909,1338,-20
81902961408,81902961413,5,2663,2088,-20
81905917744,81905917740,-4,1598,3002,-20
81907193691,81907193694,3,2127,1372,-20
81907705445,81907705446,1,1473,1299,-20
81914346397,81914346402,5,2067,1458,-20
81916394477,81916394480,3,1067,957,-20
81918569813,81918569817,4,2186,1765,-20
81919104405,81919104407,2,1915,1463,-20
81923353014,81923353017,3,1520,1135,-20
81930418753,81930418756,3,1578,1475,-20
81931997615,81931997594,-21,988,1014,-20
81932933555,81932933558,3,1720,1162,-20
81933836317,81933836313,-4,8214,18464,-20
81936938547,81936938551,4,980,1225,-20
81937268388,81937268389,1,1450,1786,-20
81938362372,81938362375,3,1621,1560,-20
81939263106,81939263111,5,1596,1142,-20
81940507537,81940507539,2,2155,1211,-20
81946315918,81946315922,4,2000,1080,-20
81946876734,81946876738,4,2120,1022,-20
81946931866,81946931871,5,1521,1301,-20
81953076087,81953076090,3,1014,1204,-20
81953109278,81953109282,4,2307,1828,-20
81954186340,81954186338,-2,17136,55681,-20
81958898791,81958898794,3,2627,1741,-20
81959938681,81959938686,5,1427,1500,-20
81963388653,81963388658,5,1657,1246,-20
81967306886,81967306891,5,977,954,-20
81968512023,81968512024,1,1398,1335,-20
81968819774,81968819778,4,1157,1488,-20
81969557084,81969557086,2,1171,1619,-20
81970670903,81970670902,-1,809,1718,-20
81975407181,81975407185,4,1034,1482,-20
81978747239,81978747243,4,2160,1558,-20
81979751026,81979751030,4,1341,1425,-20
81982880231,81982880233,2,1293,1541,-20
81986127770,81986127774,4,1568,1344,-20
81987972003,81987972002,-1,1300,1875,-20
81992363968,81992363969,1,2497,1372,-20
82000442193,82000442195,2,1260,1557,-20
82002445459,82002445462,3,1224,986,-20
82003241668,82003241671,3,1528,911,-20
82007823091,82007823094,3,2105,1092,-20
82013203529,82013203530,1,1011,972,-20
82013595394,82013595398,4,1239,1519,-20
82015622606,82015622612,6,1537,1250,-20
82022738931,82022738936,5,2112,1522,-20
82025238449,82025238454,5,1954,1759,-20
82029255192,82029255194,2,1554,1715,-20
82032087149,82032087152,3,2053,1229,-20
82032482754,82032482757,3,2335,1951,-20
82032831823,82032831825,2,1701,1817,-20
82033927947,82033927928,-19,885,1170,-20
82045836866,82045836869,3,1404,1177,-20
82047150426,82047150431,5,3503,1436,-20
82047773832,82047773836,4,2069,1680,-20
82048429562,82048429565,3,1769,1415,-20
82048853440,82048853442,2,1213,2584,-20
82049127595,82049127598,3,1809,1385,-20
82058137855,82058137859,4,1924,1366,-20
82068262502,82068262506,4,1779,1633,-20
82069154698,82069154703,5,2537,1726,-20
82070771878,82070771881,3,1911,1480,-20
82073800726,82073800731,5,3078,1785,-20
82076211129,82076211134,5,2118,705,-20
82076574190,82076574192,2,2102,1186,-20
82081366010,82081366013,3,2093,1600,-20
82087913438,82087913439,1,1733,1902,-20
82090605843,82090605843,0,1371,1348,-20
82091071593,82091071589,-4,1101,2840,-20
82091337366,82091337377,11,1596,1337,-20
82096182281,82096182282,1,1735,1833,-20
82096685134,82096685139,5,2091,1292,-20
82101228823,82101228826,3,1197,1739,-20
82102837057,82102837058,1,1549,1478,-20
82110202434,82110202437,3,1102,875,-20
82111782970,82111782975,5,1613,1298,-20
82112560116,82112560119,3,1520,1219,-20
82112705385,82112705389,4,1551,1573,-20
82113995834,82113995838,4,1851,1405,-20
82114952342,82114952345,3,1471,1237,-20
82115557042,82115557045,3,1698,1820,-20
82120889362,82120889365,3,1233,1656,-20
82121542060,82121542061,1,1508,1191,-20
82123671934,82123671938,4,1579,1445,-20
82127040722,82127040727,5,2211,1695,-20
82127403685,82127403690,5,2728,1609,-20
82128411697,82128411701,4,1387,1367,-20
82129595373,82129595378,5,1936,1502,-20
82129883602,82129883602,0,1154,1433,-20
82132100955,82132100957,2,2236,1769,-20
82135878284,82135878286,2,1663,1766,-20
82136882171,82136882173,2,1191,920,-20
82139170090,82139170091,1,1360,1636,-20
82140060628,82140060627,-1,40756,20220,-20
82140451516,82140451518,2,1313,1377,-20
82141416482,82141416486,4,1463,1313,-20
82144227091,82144227094,3,2497,1979,-20
82147845750,82147845751,1,2105,1855,-20
82149538277,82149538281,4,1912,1587,-20
82153942202,82153942206,4,2206,1537,-20
82157582345,82157582341,-4,1388,3010,-20
82163313193,82163313212,19,1901,1322,-20
82167972358,82167972362,4,1702,1541,-20
82171096176,82171096170,-6,1327,5491,-20
82172066573,82172066574,1,2667,1493,-20
82172700455,82172700432,-23,2235,1615,-20
82172898763,82172898768,5,2249,1355,-20
82173493807,82173493811,4,818,849,-20
82175082905,82175082907,2,1125,897,-20
82175930987,82175930991,4,1614,1339,-20
82176566838,82176566831,-7,1062,2344,-20
82177176513,82177176518,5,1122,945,-20
82180897807,82180897811,4,2089,1673,-20
82184300397,82184300402,5,1636,1039,-20
82185232339,82185232343,4,1465,1063,-20
82187045542,82187045547,5,1139,1140,-20
82188416265,82188416269,4,2006,1496,-20
82191130798,82191130802,4,2306,1441,-20
82191213166,82191213146,-20,1319,1196,-20
82191717397,82191717402,5,1276,1255,-20
82192272013,82192272018,5,2099,1570,-20
82193809115,82193809122,7,2205,1271,-20
82197330433,82197330437,4,1404,861,-20
82203007666,82203007670,4,1548,1250,-20
82216755656,82216755656,0,1551,1823,-20
82217989814,82217989818,4,1859,1170,-20
82219316006,82219316009,3,1626,1128,-20
82219390674,82219390672,-2,709,320,-20
82222890061,82222890065,4,2266,878,-20
82223717710,82223717714,4,1371,1345,-20
82224426533,82224426537,4,2070,1523,-20
82226270969,82226270974,5,1530,1471,-20
82226528246,82226528224,-22,1777,1197,-20
82227365726,82227365731,5,2178,1567,-20
82227670022,82227670024,2,2178,1702,-20
82232722487,82232722501,14,246,1116,-20
82235852664,82235852666,2,1539,1110,-20
82242938841,82242938838,-3,1367,2275,-20
82246704337,82246704337,0,1427,1821,-20
82248990395,82248990399,4,2229,1578,-20
82250960807,82250960811,4,2316,1922,-20
82255260442,82255260446,4,1471,1405,-20
82258177138,82258177142,4,971,1082,-20
82258848172,82258848175,3,1251,1551,-20
82261063328,82261063331,3,1207,908,-20
82265156175,82265156177,2,1735,1661,-20
82270636247,82270636251,4,2096,1489,-20
82274633893,82274633897,4,1919,1469,-20
82279350716,82279350719,3,1027,985,-20
82280051894,82280051873,-21,1553,919,-20
82280913670,82280913675,5,2847,2030,-20
82282015497,82282015498,1,1071,1486,-20
82282896923,82282896926,3,2009,934,-20
82284051842,82284051846,4,1468,1256,-20
82284668086,82284668091,5,2667,1443,-20
82284838559,82284838562,3,1926,2374,-20
82288604051,82288604029,-22,1825,2092,-20
82290926349,82290926354,5,1645,1184,-20
82291797162,82291797166,4,1602,982,-20
82291904893,82291904897,4,1621,1019,-20
82292781367,82292781372,5,2398,1235,-20
82294924241,82294924242,1,704,696,-20
82298026510,82298026515,5,2291,1121,-20
82302075927,82302075929,2,1805,1143,-20
82303987933,82303987938,5,2268,1351,-20
82304353550,82304353530,-20,1699,1096,-20
82311327834,82311327838,4,1928,1470,-20
82311405359,82311405358,-1,1162,1574,-20
82313128201,82313128201,0,1158,1546,-20
82314840063,82314840066,3,2066,1101,-20
82318379918,82318379922,4,2054,1359,-20
82318722763,82318722766,3,2132,1104,-20
82324378925,82324378929,4,1767,1519,-20
82325060293,82325060292,-1,1367,1704,-20
82328801650,82328801652,2,1778,1575,-20
82331589872,82331589874,2,2974,3364,-20
82331881050,82331881053,3,1501,1495,-20
82332202982,82332202983,1,1320,1214,-20
82335165848,82335165851,3,2519,1887,-20
82341886719,82341886725,6,1135,1184,-20
82345000906,82345000912,6,4798,2575,-20
82345408654,82345408658,4,1517,1639,-20
82345700923,82345700920,-3,2018,3825,-20
82346483242,82346483244,2,1241,1101,-20
82347802904,82347802908,4,2219,1489,-20
82356477463,82356477443,-20,144,523,-20
82357429517,82357429517,0,1430,1646,-20
82358932071,82358932069,-2,1973,5153,-20
82362743542,82362743545,3,1658,1449,-20
82363672808,82363672810,2,2404,1423,-20
82364077626,82364077630,4,2343,1316,-20
82365081411,82365081417,6,54167,25287,-20
82367039191,82367039195,4,2177,1876,-20
82369185663,82369185665,2,846,631,-20
82369923375,82369923356,-19,1008,306,-20
82370832171,82370832173,2,1310,1072,-20
82374426577,82374426576,-1,1399,973,-20
82376338884,82376338885,1,18922,97738,-20
82377493144,82377493148,4,2743,1909,-20
82378337435,82378337440,5,1126,875,-20
82379068803,82379068806,3,1072,1045,-20
82379888844,82379888849,5,1726,1700,-20
82380908631,82380908630,-1,1416,1331,-20
82385494835,82385494836,1,2026,2254,-20
82387113302,82387113305,3,1786,1223,-20
82389954169,82389954170,1,2150,2013,-20
82390759490,82390759495,5,5166,21224,-20
82392266162,82392266166,4,2046,1698,-20
82392710187,82392710191,4,1163,1083,-20
82402355092,82402355095,3,2975,2199,-20
82404022205,82404022206,1,1957,1614,-20
82405866666,82405866669,3,2296,1419,-20
82408481287,82408481286,-1,1953,2598,-20
82411444223,82411444226,3,2150,1844,-20
82411760949,82411760953,4,2154,1629,-20
82414087943,82414087946,3,1909,1765,-20
82414913451,82414913452,1,1198,1864,-20
82415621582,82415621585,3,1251,1320,-20
82416742653,82416742655,2,1535,1024,-20
82417645330,82417645333,3,1578,1633,-20
82419114743,82419114744,1,1782,2257,-20
82421210554,82421210558,4,1955,1586,-20
82422075718,82422075723,5,2308,1307,-20
82422840129,82422840134,5,1619,1196,-20
82424029615,82424029620,5,3134,1782,-20
82424701695,82424701700,5,1473,1350,-20
82427586247,82427586249,2,1881,1710,-20
82430788875,82430788879,4,1882,1322,-20
82432853311,82432853314,3,2189,1370,-20
82442554078,82442554083,5,1921,1288,-20
82448334868,82448334872,4,2725,1726,-20
82448539486,82448539490,4,1717,1202,-20
82449433692,82449433695,3,1301,1136,-20
82454357545,82454357549,4,1825,1333,-20
82457223062,82457223063,1,1385,2026,-20
82460617694,82460617697,3,1404,1826,-20
82464668770,82464668775,5,1552,1262,-20
82465088858,82465088859,1,2303,2070,-20
82468650386,82468650390,4,1415,1181,-20
82471814409,82471814405,-4,1016,1381,-20
82480976778,82480976782,4,1597,1063,-20
82481170977,82481170981,4,2269,1591,-20
82485567189,82485567195,6,2791,1021,-20
82486909717,82486909720,3,2445,1346,-20
82488362301,82488362303,2,2381,2085,-20
82492921434,82492921438,4,1304,1038,-20
82493065114,82493065118,4,882,1036,-20
82493747473,82493747475,2,1553,1289,-20
82494449843,82494449845,2,1995,1353,-20
82494627366,82494627370,4,713,228,-20
82495956757,82495956760,3,1900,1394,-20
82499484653,82499484658,5,1823,1388,-20
82503213178,82503213186,8,6383,2204,-20
82506138337,82506138339,2,1534,1903,-20
82509100613,82509100614,1,1550,1196,-20
82509725485,82509725489,4,2226,1358,-20
82510594829,82510594833,4,1555,1252,-20
82511890993,82511890994,1,930,910,-20
82512793703,82512793707,4,1678,1347,-20
82514274926,82514274930,4,2345,1456,-20
82514349199,82514349200,1,1706,1183,-20
82515548936,82515548939,3,2219,1756,-20
82517374881,82517374883,2,1888,889,-20
82518483690,82518483694,4,1707,1835,-20
82520934166,82520934168,2,2444,1550,-20
82521417946,82521417948,2,1878,1335,-20
82521697769,82521697773,4,1757,1985,-20
82522879189,82522879191,2,1446,1083,-20
82524700121,82524700123,2,1937,1041,-20
82527022334,82527022337,3,2003,1465,-20
82529739257,82529739259,2,1023,1302,-20
82529886699,82529886702,3,2661,1800,-20
82530257691,82530257693,2,1942,1763,-20
82531431350,82531431353,3,2002,1464,-20
82532947510,82532947516,6,1641,1087,-20
82534065417,82534065424,7,2579,1575,-20
82536590063,82536590066,3,1303,1401,-20
82542643930,82542643934,4,1954,1146,-20
82542844758,82542844737,-21,2367,1911,-20
82549402101,82549402103,2,1961,1312,-20
82550457246,82550457249,3,1490,762,-20
82551518726,82551518731,5,1667,1093,-20
82551843257,82551843261,4,2219,1609,-20
82554645047,82554645051,4,2836,1067,-20
82555957535,82555957538,3,1428,1769,-20
82561895194,82561895199,5,1952,1157,-20
82562533629,82562533633,4,2281,1685,-20
82564598721,82564598722,1,2139,1731,-20
82571533532,82571533534,2,2514,1524,-20
82571622024,82571622030,6,2896,1510,-20
82573027442,82573027446,4,2281,1577,-20
82578494297,82578494298,1,1167,1535,-20
82582111844,82582111846,2,1424,1644,-20
82582304901,82582304907,6,2192,784,-20
82583767306,82583767311,5,1792,1291,-20
82583803959,82583803962,3,1762,1286,-20
82585667371,82585667375,4,1560,931,-20
82588475774,82588475776,2,2145,1428,-20
82588513771,82588513774,3,1683,1640,-20
82592097422,82592097424,2,1764,2246,-20
82592635258,82592635261,3,1322,1182,-20
82594676778,82594676781,3,1518,1297,-20
82597940438,82597940442,4,985,876,-20
82599530461,82599530463,2,1769,1429,-20
82601234936,82601234941,5,4280,1755,-20
82602334357,82602334361,4,1733,1421,-20
82604666136,82604666138,2,2230,1747,-20
82604756036,82604756039,3,2712,1405,-20
82604932648,82604932651,3,2111,2117,-20
82606108203,82606108205,2,1292,946,-20
82608093869,82608093872,3,1835,1759,-20
82610176913,82610176914,1,2059,1381,-20
82610378691,82610378694,3,1217,1057,-20
82610972190,82610972194,4,1588,1577,-20
82614823539,82614823544,5,2204,1616,-20
82616933308,82616933312,4,2294,1146,-20
82617601946,82617601950,4,2908,1537,-20
82617942382,82617942380,-2,1732,2601,-20
82622560966,82622560969,3,1485,1685,-20
82627580791,82627580796,5,1817,1380,-20
82631700698,82631700698,0,992,1212,-20
82632089310,82632089316,6,1971,1195,-20
82637068477,82637068482,5,1299,1213,-20
82641855948,82641855950,2,2887,2440,-20
82642742001,82642742005,4,1833,2006,-20
82644139349,82644139351,2,1853,1348,-20
82646003384,82646003384,0,1661,1726,-20
82650681425,82650681426,1,1686,802,-20
82651183109,82651183113,4,1335,1436,-20
82655152106,82655152107,1,1188,1356,-20
82655974743,82655974746,3,1111,1354,-20
82660143339,82660143343,4,1017,979,-20
82661781510,82661781513,3,1628,1354,-20
82662492341,82662492324,-17,1114,908,-20
82662902180,82662902185,5,1638,1239,-20
82664344451,82664344447,-4,778,2562,-20
82665160429,82665160423,-6,1367,1036,-20
82670134634,82670134639,5,1347,1473,-20
82670517152,82670517154,2,2059,1907,-20
82671126776,82671126778,2,1441,1113,-20
82671949636,82671949638,2,2288,1555,-20
82672476377,82672476379,2,2435,1997,-20
82672596443,82672596447,4,1424,1616,-20
82679054246,82679054242,-4,1341,3157,-20
82679256217,82679256218,1,1640,1302,-20
82679534966,82679534947,-19,2176,1785,-20
82680314018,82680314023,5,1827,1029,-20
82680803002,82680803002,0,1483,2009,-20
82681292966,82681292969,3,1802,1479,-20
82682604733,82682604735,2,1821,1383,-20
82685027746,82685027750,4,2067,1403,-20
82686330654,82686330658,4,2407,1924,-20
82687004694,82687004697,3,2532,1390,-20
82690736313,82690736317,4,1766,1283,-20
82694602654,82694602657,3,2139,1329,-20
82695492840,82695492843,3,1403,1125,-20
82695857781,82695857786,5,1027,734,-20
82696242517,82696242519,2,1678,1307,-20
82697631766,82697631768,2,2138,2258,-20
82702691918,82702691920,2,2092,1657,-20
82705087220,82705087223,3,2138,1178,-20
82706180698,82706180701,3,1690,1640,-20
82706765037,82706765040,3,1137,1319,-20
82708089527,82708089531,4,1942,1046,-20
82708116720,82708116722,2,1742,1267,-20
82709212495,82709212497,2,1386,2094,-20
82711196138,82711196143,5,3434,1978,-20
82712232023,82712232018,-5,878,2598,-20
82712332049,82712332054,5,1728,1387,-20
82713200852,82713200854,2,1866,1683,-20
82713832125,82713832130,5,1514,1372,-20
82717483466,82717483469,3,1255,1627,-20
82717692287,82717692295,8,8829,3401,-20
82718093367,82718093371,4,1393,1172,-20
82719075623,82719075626,3,1715,1103,-20
82725572486,82725572490,4,2214,1088,-20
82726520953,82726520955,2,1977,1085,-20
82727166927,82727166930,3,2055,1843,-20
82731728209,82731728210,1,1616,1604,-20
82732258474,82732258479,5,2103,1533,-20
82734015403,82734015406,3,2754,1514,-20
82735928217,82735928218,1,1108,1360,-20
82741986072,82741986073,1,1550,1903,-20
82742399814,82742399820,6,2635,1659,-20
82743338301,82743338306,5,2614,1623,-20
82744191625,82744191629,4,2036,1355,-20
82745300203,82745300187,-16,2069,1225,-20
82745742683,82745742685,2,2127,2722,-20
82748184025,82748184029,4,2022,1266,-20
82751607789,82751607782,-7,1246,5350,-20
82753164380,82753164384,4,2395,1893,-20
82753348683,82753348687,4,1303,1448,-20
82753986264,82753986262,-2,2804,4224,-20
82756106701,82756106703,2,818,1124,-20
82762633235,82762633239,4,1814,1667,-20
82764513896,82764513898,2,1388,968,-20
82764963822,82764963825,3,1783,1345,-20
82767639779,82767639784,5,1898,1327,-20
82776756145,82776756151,6,2510,1027,-20
82777134727,82777134730,3,1643,1121,-20
82782258990,82782258995,5,856,769,-20
82784234022,82784234025,3,1695,1937,-20
82784730296,82784730297,1,2112,2045,-20
82787408765,82787408768,3,1702,1477,-20
82788169461,82788169463,2,1078,808,-20
82789850389,82789850391,2,1970,1514,-20
82790448230,82790448230,0,1185,1233,-20
82790925408,82790925413,5,2177,980,-20
82794447332,82794447335,3,2050,1667,-20
82796052827,82796052832,5,2318,1387,-20
82796183614,82796183609,-5,3140,10330,-20
82796720151,82796720153,2,1409,1737,-20
82796940421,82796940404,-17,1014,567,-20
82799864166,82799864169,3,1950,1215,-20
82801872201,82801872205,4,1932,947,-20
82804864350,82804864348,-2,1046,1975,-20
82811385895,82811385898,3,1165,1497,-20
82813146042,82813146047,5,1980,1434,-20
82819500941,82819500943,2,1440,1619,-20
82824373905,82824373908,3,2447,2165,-20
82825135357,82825135361,4,2277,1803,-20
82825522354,82825522357,3,1769,1438,-20
82827612830,82827612834,4,1712,2016,-20
82828673501,82828673507,6,3678,1010,-20
82830692081,82830692087,6,2854,713,-20
82833164138,82833164127,-11,1430,1244,-20
82837044182,82837044184,2,1622,1552,-20
82840038779,82840038780,1,1525,1929,-20
82840162895,82840162898,3,1234,1425,-20
82840913506,82840913510,4,1399,1502,-20
82843288405,82843288408,3,1727,1448,-20
82846201254,82846201259,5,1316,924,-20
82847483537,82847483542,5,1950,1201,-20
82848712363,82848712368,5,2010,1444,-20
82850136749,82850136751,2,1084,1613,-20
82850970262,82850970266,4,2763,1675,-20
82852197908,82852197910,2,1782,1140,-20
82856653841,82856653845,4,1566,1275,-20
82857521009,82857521004,-5,27527,15179,-20
82860825592,82860825594,2,1880,1719,-20
82861324615,82861324618,3,1626,1437,-20
82865143782,82865143781,-1,1122,1763,-20
82865558357,82865558362,5,1250,1208,-20
82867204559,82867204561,2,1687,1916,-20
82868638425,82868638430,5,2807,1634,-20
82874675731,82874675734,3,1676,1414,-20
82875250850,82875250852,2,1318,1035,-20
82875288043,82875288026,-17,1603,953,-20
82876761728,82876761730,2,1562,1199,-20
82879532075,82879532079,4,1503,1037,-20
82880212206,82880212209,3,1331,1155,-20
82881420441,82881420445,4,1289,1276,-20
82881748305,82881748315,10,262,1265,-20
82882524578,82882524584,6,1729,1534,-20
82891455145,82891455149,4,2102,1145,-20
82891828780,82891828783,3,1837,965,-20
82892579113,82892579113,0,33951,38989,-20
82895991779,82895991781,2,1785,1491,-20
82896869334,82896869333,-1,22455,34289,-20
82899463597,82899463601,4,1866,1372,-20
82899769321,82899769317,-4,20811,15164,-20
82900745033,82900745034,1,15527,2007,-20
82907369066,82907369069,3,1700,1434,-20
82909715349,82909715352,3,1463,1288,-20
82911980857,82911980863,6,818,790,-20
82912924413,82912924417,4,1517,1340,-20
82914568070,82914568073,3,1269,1120,-20
82916419476,82916419481,5,1892,1563,-20
82917657505,82917657507,2,889,893,-20
82918983439,82918983445,6,1254,1210,-20
82920163173,82920163175,2,1513,1705,-20
82921628303,82921628307,4,1983,1661,-20
82926431666,82926431667,1,1921,1586,-20
82927717619,82927717622,3,2109,1564,-20
82929854989,82929854995,6,4250,2414,-20
82934257174,82934257179,5,1773,1328,-20
82934463180,82934463183,3,1547,1273,-20
82934530242,82934530245,3,1932,811,-20
82935126259,82935126261,2,1665,1068,-20
82940909631,82940909632,1,691,638,-20
82941902716,82941902718,2,2031,1487,-20
82942753086,82942753090,4,1992,1226,-20
82943589617,82943589620,3,1733,1439,-20
82945846437,82945846440,3,2491,1501,-20
82949919962,82949919966,4,1734,1764,-20
82955741186,82955741188,2,1802,1154,-20
82957184828,82957184831,3,1691,1628,-20
82960463371,82960463353,-18,6881,4131,-20
82962509757,82962509761,4,1720,1481,-20
82962547431,82962547437,6,2116,1299,-20
82963340745,82963340747,2,1572,1602,-20
82965263042,82965263045,3,2095,1651,-20
82967818875,82967818878,3,1789,1334,-20
82976105322,82976105325,3,1082,1270,-20
82983283303,82983283307,4,2050,1410,-20
82984026025,82984026026,1,2471,1637,-20
82984121554,82984121554,0,1202,1670,-20
82985375853,82985375853,0,1397,1627,-20
82985636141,82985636146,5,1823,784,-20
82986413613,82986413617,4,1733,1678,-20
82988293611,82988293614,3,1159,1174,-20
82988421118,82988421121,3,1890,1299,-20
82990127451,82990127453,2,1834,1761,-20
82991511540,82991511545,5,1265,1043,-20
82991996337,82991996339,2,1549,1499,-20
82992782076,82992782080,4,1967,1506,-20
82993200742,82993200747,5,2245,1624,-20
82994222566,82994222546,-20,1960,1772,-20
82994618532,82994618535,3,1641,1416,-20
83000024727,83000024732,5,2062,1956,-20
83006310086,83006310092,6,887,1139,-20
83007040535,83007040534,-1,1294,1323,-20
83007380495,83007380499,4,1766,1224,-20
83007970226,83007970229,3,1885,1408,-20
83008091727,83008091739,12,1307,1135,-20
83008947734,83008947739,5,1348,1159,-20
83009019089,83009019094,5,1218,1784,-20
83009338566,83009338567,1,1407,1210,-20
83009656034,83009656038,4,1623,889,-20
83011908851,83011908850,-1,1526,1780,-20
83013427203,83013427208,5,2125,968,-20
83013675282,83013675283,1,806,996,-20
83014049703,83014049707,4,1843,1429,-20
83015957174,83015957176,2,1843,1287,-20
83016786778,83016786782,4,2420,1749,-20
83021904554,83021904557,3,2190,1743,-20
83025692650,83025692653,3,2851,1763,-20
83026359489,83026359493,4,1865,1562,-20
83026562965,83026562984,19,1707,714,-20
83028459630,83028459634,4,1607,1343,-20
83030457038,83030457039,1,1804,1216,-20
83030989556,83030989559,3,1337,856,-20
83031201173,83031201178,5,2677,1231,-20
83033394943,83033394946,3,1171,878,-20
83033870618,83033870622,4,1506,1264,-20
83034508602,83034508605,3,1190,1155,-20
83034787126,83034787130,4,1898,1587,-20
83036402802,83036402807,5,3219,1958,-20
83038693958,83038693962,4,1636,1355,-20
83042821391,83042821394,3,1289,1506,-20
83044184798,83044184799,1,1837,1097,-20
83044963893,83044963894,1,1754,1605,-20
83047013456,83047013460,4,2835,2276,-20
83048178881,83048178886,5,2297,1400,-20
83053783022,83053783023,1,1147,1490,-20
83054734184,83054734186,2,1864,1396,-20
83054802206,83054802210,4,1487,1006,-20
83055516115,83055516118,3,2044,1042,-20
83056253397,83056253419,22,2230,1342,-20
83057601818,83057601823,5,1558,1635,-20
83060289955,83060289959,4,1804,1152,-20
83063414822,83063414826,4,2694,1797,-20
83067598166,83067598170,4,2124,1034,-20
83075168455,83075168458,3,1866,1350,-20
83075717734,83075717738,4,2370,1816,-20
83080446637,83080446631,-6,1854,9396,-20
83080490287,83080490285,-2,25155,25730,-20
83082790457,83082790459,2,1889,905,-20
83083874619,83083874621,2,2144,1165,-20
83086350842,83086350840,-2,1826,2391,-20
83090506910,83090506911,1,1916,1686,-20
83090865974,83090865976,2,1622,1885,-20
83092958646,83092958652,6,1926,1477,-20
83094480854,83094480859,5,2272,1857,-20
83094681562,83094681566,4,1145,878,-20
83101745912,83101745911,-1,2001,2624,-20
83105622117,83105622120,3,1793,1186,-20
83106359794,83106359799,5,2493,1630,-20
83106736547,83106736551,4,769,1262,-20
83110314736,83110314738,2,1297,1782,-20
83112045589,83112045592,3,2014,1556,-20
83114648654,83114648659,5,4159,1667,-20
83117131607,83117131605,-2,2526,5697,-20
83117811217,83117811221,4,1670,1237,-20
83118855754,83118855757,3,1781,1176,-20
83119972513,83119972515,2,2564,1399,-20
83121595731,83121595734,3,1135,1108,-20
83125024134,83125024137,3,2770,1741,-20
83125835370,83125835375,5,2597,1655,-20
83128824406,83128824411,5,1873,1415,-20
83129170722,83129170723,1,730,1265,-20
83131908410,83131908408,-2,1245,1810,-20
83133207884,83133207886,2,2365,1538,-20
83133976178,83133976185,7,2207,1478,-20
83137816225,83137816229,4,2233,1521,-20
83139254823,83139254818,-5,869,1881,-20
83140724454,83140724458,4,1960,1127,-20
83141877766,83141877769,3,2275,1841,-20
83143970657,83143970659,2,990,1396,-20
83145039204,83145039209,5,1303,1575,-20
83146519334,83146519337,3,1647,960,-20
83147925472,83147925475,3,1720,1532,-20
83148616874,83148616875,1,1603,1785,-20
83149584145,83149584148,3,2086,1749,-20
83152527233,83152527234,1,1498,1539,-20
83155648906,83155648910,4,1439,1362,-20
83159965566,83159965572,6,2054,1281,-20
83162754110,83162754116,6,2166,1228,-20
83163358512,83163358515,3,1305,1256,-20
83166309425,83166309428,3,2211,2002,-20
83169536469,83169536463,-6,1702,8459,-20
83169875449,83169875452,3,1668,1525,-20
83173347626,83173347630,4,1657,1841,-20
83173996438,83173996439,1,1588,1199,-20
83177785166,83177785170,4,1785,1357,-20
83179338920,83179338910,-10,1196,1316,-20
83185027645,83185027650,5,2400,1528,-20
83186027067,83186027071,4,1853,1472,-20
83190704670,83190704674,4,1602,1323,-20
83195822030,83195822027,-3,1246,2272,-20
83196889006,83196889009,3,2006,1290,-20
83197957815,83197957817,2,1787,1920,-20
83199435445,83199435444,-1,1469,1487,-20
83203815625,83203815630,5,2241,1281,-20
83204843013,83204843018,5,1197,1071,-20
83205857864,83205857859,-5,1370,1068,-20
83206614149,83206614151,2,1611,926,-20
83209427772,83209427774,2,1730,987,-20
83210317851,83210317854,3,1323,878,-20
83215318641,83215318645,4,1497,906,-20
83217339357,83217339358,1,1135,1110,-20
83219329079,83219329083,4,1092,535,-20
83219491141,83219491138,-3,1428,2485,-20
83226625658,83226625659,1,1657,1111,-20
83227441084,83227441086,2,1835,1426,-20
83231175919,83231175921,2,2569,2006,-20
83231891686,83231891688,2,1584,1964,-20
83233611343,83233611348,5,2491,1419,-20
83237725997,83237725998,1,1376,1469,-20
83241881874,83241881877,3,1680,1200,-20
83242174382,83242174361,-21,1178,795,-20
83242948243,83242948246,3,1990,1396,-20
83243764152,83243764164,12,10491,47052,-20
83244517214,83244517215,1,1382,1392,-20
83246072140,83246072143,3,2970,1429,-20
83246699136,83246699140,4,1908,1409,-20
83251372898,83251372893,-5,1221,3368,-20
83254181739,83254181741,2,1498,1806,-20
83255271281,83255271285,4,1818,1192,-20
83255513534,83255513512,-22,1490,768,-20
83256985268,83256985270,2,1283,957,-20
83258612105,83258612106,1,2065,1656,-20
83258814662,83258814641,-21,1794,743,-20
83259593299,83259593304,5,1689,1013,-20
83262142168,83262142171,3,1779,1339,-20
83264363794,83264363772,-22,1579,1056,-20
83265268985,83265268987,2,2067,1237,-20
83267078769,83267078773,4,1626,1558,-20
83267894146,83267894141,-5,43,1689,-20
83270019169,83270019173,4,1891,1464,-20
83270533455,83270533457,2,2381,1354,-20
83271243682,83271243686,4,943,1529,-20
83271704671,83271704677,6,2430,1309,-20
83271871338,83271871341,3,1507,1703,-20
83273160386,83273160390,4,1367,1052,-20
83274913774,83274913773,-1,1416,1788,-20
83277944178,83277944181,3,1553,624,-20
83278226779,83278226783,4,1311,1043,-20
83281079390,83281079393,3,2337,2003,-20
83281948330,83281948331,1,982,784,-20
83287851819,83287851825,6,2736,1646,-20
83290685046,83290685050,4,1031,724,-20
83294824690,83294824693,3,1363,1077,-20
83294929613,83294929592,-21,1843,672,-20
83295457755,83295457758,3,2027,1181,-20
83295612746,83295612749,3,1903,1687,-20
83297286264,83297286267,3,1674,1181,-20
83302086093,83302086094,1,2297,1859,-20
83305738872,83305738874,2,1940,1478,-20
83307926037,83307926042,5,2011,1171,-20
83311069177,83311069174,-3,682,1758,-20
83311672981,83311672982,1,825,1023,-20
83312758330,83312758310,-20,1365,1370,-20
83314939013,83314939018,5,1165,935,-20
83315588658,83315588655,-3,1096,1724,-20
83316143711,83316143714,3,1012,1027,-20
83319047258,83319047262,4,1933,1553,-20
83319878324,83319878327,3,2025,1292,-20
83320367337,83320367342,5,3092,2001,-20
83322257154,83322257156,2,1923,1430,-20
83326879718,83326879724,6,1440,1213,-20
83331574415,83331574417,2,1405,1061,-20
83341539105,83341539106,1,1329,1869,-20
83342512567,83342512569,2,1616,2037,-20
83343292883,83343292886,3,1473,1504,-20
83344193415,83344193417,2,1803,1306,-20
83346205118,83346205121,3,1634,1230,-20
83346238891,83346238895,4,1268,1185,-20
83348457213,83348457217,4,1809,2035,-20
83348844429,83348844435,6,2487,1466,-20
83354897403,83354897407,4,1752,1214,-20
83354946907,83354946913,6,1441,1383,-20
83355717301,83355717302,1,2438,1749,-20
83355971940,83355971939,-1,1767,1706,-20
83357731251,83357731255,4,2202,1627,-20
83359657990,83359657995,5,2081,1411,-20
83359686643,83359686624,-19,438,293,-20
83360784238,83360784242,4,1980,1348,-20
83362223849,83362223853,4,2691,1812,-20
83362772342,83362772345,3,1452,1398,-20
83363533145,83363533149,4,4031,2760,-20
83367633164,83367633167,3,2247,1226,-20
83369789385,83369789389,4,1993,985,-20
83371778634,83371778641,7,2148,1167,-20
83372049282,83372049266,-16,1246,895,-20
83374853369,83374853373,4,2495,1591,-20
83380016299,83380016304,5,1186,1443,-20
83380699652,83380699654,2,1434,1114,-20
83383294561,83383294563,2,1375,1360,-20
83383614616,83383614617,1,1714,1274,-20
83384968621,83384968626,5,1313,1167,-20
83388776700,83388776705,5,2619,1770,-20
83389264077,83389264081,4,1156,1327,-20
83394357499,83394357502,3,2119,1124,-20
83400110622,83400110622,0,1363,997,-20
83400773137,83400773137,0,1755,2167,-20
83403391953,83403391956,3,1813,1240,-20
83405336422,83405336425,3,1760,1345,-20
83407871826,83407871830,4,1408,1195,-20
83409086491,83409086492,1,1625,1247,-20
83410780910,83410780917,7,2612,1480,-20
83411710042,83411710046,4,2134,1705,-20
83413723901,83413723902,1,1415,1563,-20
83415058453,83415058455,2,2219,1403,-20
83417531053,83417531055,2,1319,1126,-20
83417882975,83417882978,3,1798,1436,-20
83419762965,83419762970,5,1755,1122,-20
83422702074,83422702077,3,1347,1741,-20
83424276701,83424276703,2,1061,1513,-20
83429458806,83429458809,3,2623,1426,-20
83438616706,83438616706,0,1542,1792,-20
83440060829,83440060835,6,1942,838,-20
83442994764,83442994761,-3,21338,16960,-20
83446545626,83446545627,1,2057,1406,-20
83448579433,83448579436,3,3721,2621,-20
83449352765,83449352769,4,1373,1260,-20
83451077778,83451077783,5,1867,1161,-20
83454599173,83454599178,5,2511,1440,-20
83455807687,83455807690,3,1984,1417,-20
83457926410,83457926411,1,1071,1240,-20
83458072396,83458072400,4,2106,1517,-20
83462161825,83462161828,3,2074,1389,-20
83464547372,83464547374,2,1681,1748,-20
83465888550,83465888553,3,708,661,-20
83466238411,83466238414,3,2155,1907,-20
83468700941,83468700945,4,1442,1572,-20
83469028479,83469028482,3,1452,1036,-20
83470854853,83470854858,5,1283,924,-20
83472182329,83472182332,3,1801,1172,-20
83472399613,83472399616,3,1071,980,-20
83473155706,83473155710,4,1414,1400,-20
83473849291,83473849294,3,636,597,-20
83475073323,83475073325,2,1244,805,-20
83476717099,83476717101,2,1647,2185,-20
83479186021,83479186026,5,1911,1770,-20
83480367345,83480367348,3,2036,1731,-20
83480945615,83480945619,4,2072,1317,-20
83482199765,83482199770,5,1972,1057,-20
83483853267,83483853248,-19,1055,454,-20
83487617370,83487617374,4,2737,2154,-20
83489822411,83489822413,2,2093,1345,-20
83494114374,83494114377,3,1799,1323,-20
83494231178,83494231187,9,1807,1000,-20
83496090794,83496090797,3,1762,1528,-20
83499765398,83499765402,4,1312,1339,-20
83499852999,83499852978,-21,2000,1033,-20
83500358998,83500359004,6,1955,1179,-20
83501444285,83501444287,2,1330,1299,-20
83502564215,83502564221,6,2759,1142,-20
83503260638,83503260642,4,2565,1972,-20
83504561009,83504561011,2,2062,1864,-20
83507117616,83507117617,1,1642,1139,-20
83507313083,83507313099,16,481,136,-20
83508261193,83508261193,0,1460,1993,-20
83508537679,83508537682,3,1468,1030,-20
83515770037,83515770038,1,1615,999,-20
83518828461,83518828466,5,2756,1629,-20
83519283686,83519283688,2,1820,1589,-20
83524713482,83524713485,3,2765,1918,-20
83524791542,83524791543,1,1899,1581,-20
83529228697,83529228676,-21,1052,556,-20
83532219197,83532219199,2,1683,1942,-20
83533940986,83533940990,4,2511,1622,-20
83535438494,83535438497,3,1632,1535,-20
83540731832,83540731835,3,1809,2013,-20
83546864365,83546864366,1,1618,1164,-20
83547333545,83547333547,2,1453,1300,-20
83548672298,83548672303,5,1552,1654,-20
83549640733,83549640738,5,1083,1082,-20
83551412268,83551412270,2,2753,1520,-20
83552385506,83552385506,0,1056,1243,-20
83561533587,83561533590,3,989,694,-20
83564116187,83564116194,7,2352,1481,-20
83565799743,83565799747,4,2208,1714,-20
83570820449,83570820453,4,1607,1339,-20
83571745126,83571745131,5,1949,1343,-20
83573945718,83573945722,4,1539,1658,-20
83578991278,83578991279,1,1943,1159,-20
83579685639,83579685616,-23,1394,876,-20
83579776579,83579776582,3,2164,1954,-20
83581855618,83581855622,4,1516,1289,-20
83584158361,83584158359,-2,1523,1983,-20
83584209457,83584209451,-6,1288,1246,-20
83587826229,83587826222,-7,1548,4980,-20
83596575813,83596575818,5,1943,1366,-20
83596611622,83596611604,-18,2415,1250,-20
83597324699,83597324702,3,1288,1037,-20
83597505270,83597505250,-20,2068,1173,-20
83597893305,83597893323,18,3271,1281,-20
83602148323,83602148326,3,1796,1195,-20
83604540723,83604540725,2,1049,641,-20
83605507497,83605507499,2,1276,1196,-20
83606735269,83606735274,5,1738,1618,-20
83610267126,83610267128,2,2171,1609,-20
83619595671,83619595670,-1,713,816,-20
83621824146,83621824153,7,11903,22153,-20
83623489689,83623489682,-7,803,3321,-20
83625996143,83625996148,5,2092,1060,-20
83630052707,83630052711,4,1766,1378,-20
83631685859,83631685863,4,1863,1164,-20
83632239201,83632239205,4,876,987,-20
83632476772,83632476774,2,1245,1487,-20
83634547706,83634547711,5,1449,1220,-20
83635798759,83635798761,2,1241,839,-20
83640303244,83640303250,6,2659,1625,-20
83641003858,83641003861,3,1967,1486,-20
83645785911,83645785914,3,2501,1993,-20
83647691306,83647691310,4,1687,1329,-20
83649616561,83649616564,3,2131,1269,-20
83650857401,83650857403,2,1414,986,-20
83653628633,83653628638,5,1766,1323,-20
83654662592,83654662579,-13,45829,13992,-20
83656144967,83656144968,1,2140,1907,-20
83660543647,83660543648,1,1545,1682,-20
83665497273,83665497276,3,2356,1120,-20
83665610637,83665610638,1,1419,1312,-20
83667183226,83667183228,2,1429,1333,-20
83667425969,83667425975,6,2019,1075,-20
83668470312,83668470314,2,1871,1879,-20
83669330735,83669330738,3,1999,2621,-20
83676460880,83676460883,3,2986,1407,-20
83678119261,83678119266,5,1972,1495,-20
83679776131,83679776134,3,2745,2259,-20
83680772275,83680772279,4,1798,2050,-20
83682377701,83682377704,3,1726,1572,-20
83687288594,83687288598,4,1805,1493,-20
83688618702,83688618707,5,1320,793,-20
83692208482,83692208485,3,1827,1676,-20
83692295853,83692295865,12,1482,989,-20
83694044597,83694044602,5,2201,1281,-20
83694419249,83694419253,4,1449,1191,-20
83695018277,83695018281,4,1688,1225,-20
83697602102,83697602107,5,1019,1260,-20
83698354101,83698354107,6,1537,986,-20
83698531504,83698531501,-3,1392,1818,-20
83704365826,83704365831,5,1762,1481,-20
83704484518,83704484523,5,917,1985,-20
83704602035,83704602038,3,2493,1822,-20
83707147566,83707147571,5,1353,1139,-20
83710669755,83710669759,4,1268,837,-20
83717653966,83717653970,4,1926,1532,-20
83719561221,83719561225,4,2309,1266,-20
83722589948,83722589953,5,2353,1834,-20
83723404475,83723404478,3,1436,1255,-20
83726134854,83726134856,2,1690,1279,-20
83727678580,83727678588,8,14272,37042,-20
83728584194,83728584198,4,2112,1764,-20
83728674929,83728674932,3,1314,960,-20
83734491102,83734491106,4,1677,1018,-20
83736333574,83736333578,4,861,886,-20
83737664313,83737664320,7,1285,802,-20
83738347580,83738347582,2,1513,1512,-20
83741467268,83741467271,3,2600,2370,-20
83745387074,83745387078,4,1354,1180,-20
83746363648,83746363652,4,2315,1175,-20
83747335320,83747335322,2,1861,1370,-20
83749320649,83749320652,3,1643,1508,-20
83750844057,83750844058,1,1572,1463,-20
83753308161,83753308163,2,1726,1444,-20
83759172728,83759172724,-4,1442,1609,-20
83762714200,83762714203,3,2181,1293,-20
83767866229,83767866230,1,1891,1865,-20
83774200875,83774200883,8,14127,20797,-20
83776056938,83776056941,3,1842,1549,-20
83776270641,83776270645,4,1799,929,-20
83781540849,83781540865,16,17986,48375,-20
83784258282,83784258284,2,1580,1634,-20
83786119219,83786119222,3,2005,1701,-20
83786348770,83786348770,0,1065,1604,-20
83787723203,83787723207,4,2061,1414,-20
83791449341,83791449343,2,2030,1895,-20
83792163214,83792163218,4,2464,1270,-20
83793011938,83793011942,4,1532,1548,-20
83793457369,83793457373,4,1484,1169,-20
83800328874,83800328877,3,2073,1101,-20
83801766850,83801766857,7,14332,25704,-20
83802459548,83802459553,5,1639,1496,-20
83803351838,83803351843,5,1982,1030,-20
83804482476,83804482479,3,1448,1494,-20
83804814371,83804814353,-18,1589,1330,-20
83810895535,83810895539,4,2496,1492,-20
83811675314,83811675314,0,2296,2212,-20
83812732577,83812732572,-5,2430,6871,-20
83820541065,83820541070,5,1593,1308,-20
83821889901,83821889906,5,2687,1663,-20
83822351078,83822351085,7,1468,1143,-20
83822571915,83822571919,4,1289,1114,-20
83825596464,83825596467,3,1493,1270,-20
83825909389,83825909393,4,2312,1982,-20
83826058570,83826058572,2,1642,1263,-20
83826389758,83826389762,4,1651,1737,-20
83830672892,83830672895,3,1359,1583,-20
83832548864,83832548866,2,1714,2082,-20
83835764098,83835764103,5,1879,1797,-20
83836418225,83836418228,3,1717,1255,-20
83836463559,83836463562,3,1056,1131,-20
83837051839,83837051842,3,1492,1117,-20
83839739456,83839739458,2,1520,1292,-20
83851332717,83851332721,4,1957,1681,-20
83855148733,83855148737,4,2274,1788,-20
83859321146,83859321150,4,2757,1586,-20
83860230551,83860230558,7,3188,851,-20
83862456207,83862456211,4,1838,1542,-20
83867139717,83867139722,5,1339,991,-20
83869570559,83869570565,6,1591,1458,-20
83869999278,83869999284,6,1903,1458,-20
83875442831,83875442831,0,2189,3426,-20
83876296326,83876296330,4,2237,1205,-20
83876930149,83876930159,10,12753,27957,-20
83878063990,83878063993,3,1325,1095,-20
83878927393,83878927393,0,18713,18298,-20
83884806306,83884806309,3,1882,1119,-20
83886515220,83886515222,2,2866,1214,-20
83886721092,83886721097,5,2006,1585,-20
83889057204,83889057208,4,1294,1029,-20
83892537023,83892537028,5,1596,1304,-20
83893722985,83893722987,2,2057,1345,-20
83894813093,83894813097,4,2303,1437,-20
83894889748,83894889728,-20,1786,1254,-20
83895932610,83895932614,4,2368,1581,-20
83896456029,83896456032,3,1633,1359,-20
83900031839,83900031837,-2,1347,1519,-20
83901851208,83901851210,2,1468,1252,-20
83904718240,83904718244,4,2038,1735,-20
83908586210,83908586214,4,1128,1046,-20
83911029384,83911029387,3,939,774,-20
83915830149,83915830157,8,5091,2747,-20
83922093315,83922093315,0,1101,1930,-20
83922384087,83922384090,3,1584,749,-20
83923427263,83923427271,8,6135,31419,-20
83924015229,83924015229,0,1193,793,-20
83926219829,83926219845,16,882,288,-20
83929974618,83929974618,0,2207,1895,-20
83930542227,83930542230,3,1647,1561,-20
83933271755,83933271760,5,2880,1514,-20
83935732257,83935732261,4,1669,1778,-20
83936309286,83936309290,4,2009,1313,-20
83937642957,83937642961,4,2115,1555,-20
83945315165,83945315169,4,1789,1573,-20
83949140190,83949140191,1,1349,1324,-20
83949885295,83949885294,-1,1287,1682,-20
83950260230,83950260233,3,1376,1374,-20
83950987026,83950987030,4,2037,1493,-20
83954811022,83954811026,4,2235,1240,-20
83956081290,83956081293,3,2424,1614,-20
83957972006,83957972009,3,1880,1569,-20
83962000681,83962000685,4,2098,1725,-20
83963562566,83963562569,3,1840,1535,-20
83964776370,83964776374,4,1974,1261,-20
83965432390,83965432391,1,1290,1627,-20
83966609035,83966609014,-21,1702,1933,-20
83969461503,83969461502,-1,1301,1185,-20
83971157544,83971157547,3,1200,936,-20
83973118009,83973118012,3,2348,1647,-20
83979019264,83979019267,3,2282,1938,-20
83980435841,83980435844,3,2015,1430,-20
83982962533,83982962538,5,2379,1121,-20
83984975065,83984975070,5,1699,1743,-20
83985999874,83985999881,7,1999,1027,-20
83989045938,83989045942,4,1084,942,-20
83990029495,83990029498,3,1447,1614,-20
83990421994,83990421998,4,1449,1236,-20
83994778425,83994778430,5,1248,1128,-20
83995787533,83995787537,4,1969,1585,-20
83996670943,83996670947,4,1974,1485,-20
83997400045,83997400047,2,2016,1657,-20
83999498654,83999498658,4,1963,1620,-20
84006604681,84006604685,4,1828,1638,-20
84007847489,84007847494,5,2093,1521,-20
84015674082,84015674085,3,1402,1091,-20
84020325381,84020325385,4,1322,1370,-20
84021072149,84021072151,2,1818,1554,-20
84022699614,84022699618,4,1277,981,-20
84022785346,84022785349,3,1995,1476,-20
84031094170,84031094174,4,1707,1443,-20
84032503617,84032503621,4,1379,1400,-20
84033631320,84033631325,5,1384,1076,-20
84033831760,84033831763,3,2382,1771,-20
84034128286,84034128289,3,1926,2024,-20
84034770641,84034770645,4,1753,1591,-20
84035913457,84035913461,4,1335,1500,-20
84036689238,84036689242,4,2462,1256,-20
84039802562,84039802566,4,2307,1447,-20
84040151578,84040151582,4,1698,1329,-20
84040384369,84040384371,2,2144,1258,-20
84040925449,84040925450,1,1610,1461,-20
84043105278,84043105281,3,2283,1881,-20
84045399673,84045399676,3,2892,1772,-20
84047771028,84047771031,3,39766,23291,-20
84048263970,84048263974,4,2832,1536,-20
84053792801,84053792804,3,2469,1212,-20
84057184380,84057184385,5,2556,1513,-20
84059094929,84059094933,4,1357,1112,-20
84059292189,84059292194,5,1944,1373,-20
84068192590,84068192592,2,1271,1504,-20
84070619252,84070619259,7,4723,1199,-20
84071322993,84071322996,3,1918,1582,-20
84072428647,84072428650,3,1777,1322,-20
84080437106,84080437112,6,2242,1974,-20
84088989446,84088989451,5,1200,997,-20
84089055007,84089055011,4,1695,1722,-20
84092961301,84092961294,-7,2934,8970,-20
84102911437,84102911439,2,1920,1441,-20
84105564970,84105564974,4,2403,1922,-20
84105608488,84105608490,2,2105,1337,-20
84107311086,84107311088,2,2383,1601,-20
84109095011,84109095015,4,878,920,-20
84111108533,84111108542,9,2776,1185,-20
84114270046,84114270050,4,1657,982,-20
84115575815,84115575819,4,1273,1271,-20
84116707984,84116707989,5,1680,785,-20
84117670380,84117670383,3,1725,957,-20
84119912312,84119912315,3,1618,1409,-20
84124168310,84124168311,1,1261,1067,-20
84126242903,84126242906,3,926,1138,-20
84126314705,84126314706,1,1704,1595,-20
84131090998,84131090993,-5,922,3008,-20
84131953243,84131953246,3,1989,1804,-20
84134860410,84134860405,-5,956,4661,-20
84136543061,84136543059,-2,1382,1119,-20
84144029878,84144029882,4,1562,1273,-20
84144269793,84144269796,3,1824,1756,-20
84145550398,84145550400,2,1416,1624,-20
84147914085,84147914089,4,1847,1483,-20
84148010197,84148010199,2,1702,1562,-20
84151201571,84151201573,2,1570,1734,-20
84152115895,84152115900,5,2396,1568,-20
84159247177,84159247181,4,1441,956,-20
84161877549,84161877554,5,1702,825,-20
84165094995,84165094994,-1,664,1078,-20
84166506589,84166506595,6,1311,1147,-20
84170584293,84170584286,-7,699,1839,-20
84173193517,84173193522,5,5157,3061,-20
84174276734,84174276737,3,1066,781,-20
84178078562,84178078560,-2,1414,2010,-20
84180398569,84180398550,-19,898,5142,-20
84184678422,84184678427,5,1991,923,-20
84185242642,84185242646,4,2136,1374,-20
84197508517,84197508522,5,22617,45949,-20
84200272525,84200272527,2,2051,1445,-20
84202383722,84202383725,3,2379,1611,-20
84203204767,84203204769,2,1154,1547,-20
84204085958,84204085962,4,1753,1359,-20
84208008873,84208008876,3,1508,1135,-20
84210541906,84210541912,6,2783,1894,-20
84210680389,84210680369,-20,1704,1294,-20
84213218198,84213218201,3,1772,1329,-20
84218950479,84218950483,4,2564,1958,-20
84219149245,84219149247,2,1835,1570,-20
84220199638,84220199646,8,2748,1136,-20
84220960046,84220960050,4,2209,1866,-20
84223664449,84223664451,2,1482,1605,-20
84224540769,84224540773,4,2413,2068,-20
84230034338,84230034339,1,1423,1303,-20
84231689757,84231689761,4,1726,1390,-20
84235216870,84235216872,2,1740,1025,-20
84235843686,84235843691,5,4085,1671,-20
84236680572,84236680574,2,1503,1382,-20
84237694986,84237694987,1,1172,1502,-20
84239108078,84239108082,4,1957,1364,-20
84245470886,84245470889,3,1810,1202,-20
84248368942,84248368947,5,1242,1105,-20
84254063734,84254063738,4,1703,1120,-20
84255236099,84255236101,2,2098,1388,-20
84255627996,84255627999,3,1867,1222,-20
84257564902,84257564905,3,1432,1344,-20
84259326419,84259326423,4,2982,1960,-20
84265399613,84265399617,4,1790,1609,-20
84270708242,84270708246,4,2885,1266,-20
84271887889,84271887889,0,1589,1403,-20
84277286064,84277286067,3,2147,1488,-20
84279266442,84279266442,0,920,3143,-20
84279967985,84279967989,4,2058,2105,-20
84282436062,84282436067,5,1459,1337,-20
84284279490,84284279493,3,2181,1673,-20
84285749602,84285749598,-4,1211,2408,-20
84288092397,84288092401,4,2004,1472,-20
84290730287,84290730291,4,1962,1611,-20
84292089152,84292089154,2,2119,1921,-20
84292573279,84292573282,3,1201,1943,-20
84294858123,84294858126,3,1063,1221,-20
84295935117,84295935113,-4,2072,4514,-20
84296742274,84296742276,2,1992,1235,-20
84296935254,84296935259,5,1495,1542,-20
84298877075,84298877077,2,1742,1802,-20
84299217078,84299217081,3,1667,1096,-20
84299284463,84299284465,2,1144,1718,-20
84302588963,84302588969,6,1729,1656,-20
84303889587,84303889592,5,1383,1188,-20
84304982181,84304982185,4,2202,1775,-20
84307675709,84307675702,-7,1152,5351,-20
84308217245,84308217249,4,1742,1051,-20
84308574650,84308574653,3,1702,1645,-20
84313048615,84313048617,2,1884,1957,-20
84319202406,84319202408,2,1236,1363,-20
84326561286,84326561288,2,1373,1468,-20
84327122313,84327122320,7,12042,36552,-20
84330363890,84330363895,5,1833,1706,-20
84332353038,84332353042,4,2771,1191,-20
84335796181,84335796183,2,1236,908,-20
84339377489,84339377493,4,1893,1178,-20
84339881520,84339881521,1,1714,2259,-20
84341832042,84341832042,0,2207,1418,-20
84342856758,84342856768,10,1709,1443,-20
84343400992,84343400994,2,1656,1581,-20
84345346965,84345346970,5,1732,1925,-20
84347382406,84347382410,4,1676,1432,-20
84348158278,84348158257,-21,1121,971,-20
84353738295,84353738298,3,2004,1734,-20
84358029884,84358029887,3,1716,1442,-20
84358460190,84358460193,3,2392,2088,-20
84361585047,84361585051,4,1988,1653,-20
84362158994,84362158999,5,1277,1165,-20
84363433991,84363433997,6,2373,1426,-20
84363773369,84363773378,9,1462,938,-20
84366178632,84366178637,5,2576,1141,-20
84367482554,84367482547,-7,1313,5244,-20
84367965984,84367965989,5,1719,1479,-20
84372508541,84372508545,4,1528,990,-20
84379754089,84379754091,2,1670,1567,-20
84380821186,84380821190,4,1381,1186,-20
84381566594,84381566602,8,2205,797,-20
84382170902,84382170895,-7,1641,5273,-20
84385713318,84385713321,3,1108,1216,-20
84390773581,84390773586,5,1606,1822,-20
84390842431,84390842434,3,2000,1339,-20
84392342866,84392342869,3,1609,1203,-20
84394126826,84394126832,6,1428,1141,-20
84405754893,84405754901,8,2208,1435,-20
84411334867,84411334868,1,1839,1767,-20
84412063291,84412063294,3,1982,1398,-20
84412093142,84412093122,-20,1236,733,-20
84413153117,84413153119,2,1930,1332,-20
84414098238,84414098241,3,1253,1189,-20
84417075217,84417075218,1,1856,993,-20
84420458374,84420458377,3,2447,1494,-20
84422774504,84422774507,3,2492,1989,-20
84423815422,84423815425,3,1702,1350,-20
84423984012,84423984015,3,1824,834,-20
84424243638,84424243620,-18,1770,1396,-20
84427201696,84427201699,3,2015,1013,-20
84427850611,84427850613,2,2098,1391,-20
84431711086,84431711087,1,1848,1863,-20
84438911862,84438911867,5,1335,1193,-20
84440409594,84440409598,4,2430,1978,-20
84440670128,84440670131,3,1991,1277,-20
84442220935,84442220939,4,1817,1109,-20
84443663015,84443663019,4,1336,1329,-20
84445866175,84445866171,-4,1612,3232,-20
84447106938,84447106942,4,1742,1505,-20
84447929051,84447929060,9,1841,1404,-20
84453679199,84453679202,3,1528,1668,-20
84458380065,84458380070,5,1993,1346,-20
84459839666,84459839671,5,2810,1584,-20
84460853678,84460853682,4,2545,1755,-20
84461942845,84461942849,4,1221,1053,-20
84464645258,84464645262,4,2492,1081,-20
84464838083,84464838086,3,2042,1958,-20
84466116494,84466116498,4,1580,1399,-20
84467121215,84467121218,3,2048,1433,-20
84467434174,84467434155,-19,1890,1159,-20
84468734102,84468734107,5,1657,1572,-20
84471247442,84471247446,4,2474,1605,-20
84473183074,84473183078,4,2867,1372,-20
84473770446,84473770427,-19,1531,652,-20
84475370806,84475370807,1,1646,2024,-20
84485510319,84485510321,2,1954,1718,-20
84485774829,84485774831,2,1186,1139,-20
84487111747,84487111749,2,1291,2031,-20
84487538906,84487538910,4,1336,1389,-20
84489509862,84489509865,3,1485,1658,-20
84489546667,84489546670,3,2382,1521,-20
84493520214,84493520216,2,1645,1428,-20
84496858903,84496858907,4,1268,1022,-20
84497974329,84497974331,2,1655,1622,-20
84498890856,84498890858,2,1693,1367,-20
84501525454,84501525457,3,2566,1958,-20
84504711925,84504711929,4,5956,2337,-20
84506050030,84506050035,5,1998,1361,-20
84510875077,84510875079,2,2791,1798,-20
84512784192,84512784213,21,2238,1063,-20
84514777298,84514777302,4,1678,1306,-20
84515768177,84515768182,5,2449,1883,-20
84515952030,84515952041,11,1081,952,-20
84522252640,84522252643,3,1871,1334,-20
84524064320,84524064322,2,3269,3840,-20
84525911107,84525911110,3,1363,1657,-20
84527350652,84527350655,3,2408,1528,-20
84531271217,84531271219,2,1596,1708,-20
84534308682,84534308686,4,1542,1443,-20
84536064777,84536064778,1,1432,1621,-20
84537300703,84537300705,2,2470,1881,-20
84539018406,84539018410,4,2005,1283,-20
84542420381,84542420382,1,1719,1480,-20
84543035085,84543035086,1,807,929,-20
84544547771,84544547773,2,1463,1182,-20
84544649552,84544649554,2,638,570,-20
84553862909,84553862913,4,2576,2045,-20
84554247485,84554247486,1,2350,1984,-20
84555716030,84555716034,4,2671,1663,-20
84558209413,84558209417,4,2240,1077,-20
84558853003,84558853005,2,1920,1274,-20
84559671073,84559671076,3,1600,1356,-20
84561089651,84561089653,2,2358,1601,-20
84561795585,84561795587,2,1641,1331,-20
84566505584,84566505587,3,1706,1457,-20
84567403268,84567403262,-6,38600,14956,-20
84568614954,84568614955,1,2051,1239,-20
84568711186,84568711189,3,1387,1064,-20
84569838117,84569838123,6,2017,916,-20
84571079585,84571079586,1,1338,1011,-20
84571308170,84571308169,-1,1355,1568,-20
84571969338,84571969321,-17,2170,1383,-20
84577391754,84577391749,-5,522,3717,-20
84583442728,84583442730,2,2196,1359,-20
84584203963,84584203966,3,1779,1540,-20
84586327609,84586327614,5,2621,1391,-20
84588292154,84588292158,4,1831,1283,-20
84589828278,84589828281,3,1500,1312,-20
84590642166,84590642170,4,2463,1031,-20
84593452481,84593452483,2,1293,1358,-20
84593600173,84593600153,-20,2409,1358,-20
84595947876,84595947878,2,1806,1011,-20
84602505885,84602505889,4,1874,1186,-20
84603687606,84603687609,3,1895,1606,-20
84604223534,84604223554,20,1496,1327,-20
84606805445,84606805449,4,1833,1517,-20
84613326430,84613326433,3,1953,1602,-20
84615885321,84615885324,3,1788,1130,-20
84619143075,84619143079,4,2259,1100,-20
84622098352,84622098357,5,1998,1479,-20
84622690866,84622690871,5,934,1029,-20
84625101847,84625101850,3,1621,1867,-20
84625520934,84625520939,5,1558,1012,-20
84626336346,84626336350,4,1774,1124,-20
84626851393,84626851396,3,2409,1890,-20
84627046577,84627046578,1,2208,1212,-20
84632471817,84632471834,17,1775,1339,-20
84633919253,84633919257,4,2088,1698,-20
84634430552,84634430554,2,1338,900,-20
84635202534,84635202536,2,2018,1381,-20
84637958243,84637958245,2,1220,1249,-20
84639106109,84639106088,-21,1653,1474,-20
84644140661,84644140667,6,1350,1026,-20
84644937309,84644937311,2,2034,1998,-20
84648752277,84648752279,2,1875,1578,-20
84649057431,84649057435,4,1095,1275,-20
84650196982,84650196985,3,1294,1630,-20
84650397022,84650397026,4,3311,1541,-20
84653339200,84653339205,5,1873,1483,-20
84654207397,84654207399,2,1732,1538,-20
84655336854,84655336839,-15,6191,27493,-20
84656717777,84656717778,1,1686,2005,-20
84657488109,84657488110,1,2384,1702,-20
84658647921,84658647925,4,1734,1178,-20
84659258157,84659258162,5,1617,1304,-20
84660470539,84660470542,3,1542,1109,-20
84661508977,84661508978,1,1399,1184,-20
84661536709,84661536714,5,2258,1286,-20
84661767206,84661767187,-19,1678,1621,-20
84662187806,84662187810,4,2140,1555,-20
84662975509,84662975514,5,2734,1481,-20
84663582130,84663582132,2,1574,1456,-20
84664596503,84664596506,3,1786,1289,-20
84665141385,84665141388,3,2547,1675,-20
84666148838,84666148842,4,1603,1190,-20
84670246338,84670246338,0,1263,1660,-20
84670431149,84670431154,5,2256,1263,-20
84671685535,84671685539,4,1995,1496,-20
84676372545,84676372551,6,2365,1107,-20
84676990271,84676990274,3,1026,784,-20
84680426583,84680426587,4,1951,1203,-20
84680580897,84680580898,1,1445,1114,-20
84683353929,84683353932,3,1789,1812,-20
84685928627,84685928629,2,1748,1601,-20
84689380917,84689380918,1,1372,1342,-20
84689840530,84689840535,5,2136,1604,-20
84690161910,84690161913,3,2130,1226,-20
84690685495,84690685475,-20,808,645,-20
84692257986,84692257990,4,1590,1355,-20
84692422373,84692422375,2,1536,1024,-20
84693111335,84693111341,6,2265,1395,-20
84693612324,84693612329,5,1178,1368,-20
84696916899,84696916904,5,1942,1555,-20
84699287157,84699287162,5,1189,1310,-20
84699657461,84699657463,2,1398,2011,-20
84701869032,84701869036,4,1617,1572,-20
84702386400,84702386404,4,2018,1541,-20
84706284803,84706284807,4,2412,1077,-20
84706827343,84706827347,4,1440,1171,-20
84707710254,84707710254,0,1531,979,-20
84711621786,84711621791,5,1420,1297,-20
84713072291,84713072294,3,1500,1096,-20
84713877774,84713877779,5,2262,1193,-20
84716820885,84716820879,-6,102,1368,-20
84718918020,84718918020,0,1952,2328,-20
84721988745,84721988747,2,1364,1055,-20
84722085991,84722085969,-22,1362,852,-20
84727655740,84727655744,4,3978,2717,-20
84727937857,84727937850,-7,1215,4161,-20
84729328670,84729328674,4,3581,1741,-20
84733346570,84733346573,3,1474,1499,-20
84733377461,84733377465,4,2076,1837,-20
84735051365,84735051370,5,2195,1206,-20
84736177502,84736177506,4,2478,1402,-20
84737319465,84737319465,0,3046,3472,-20
84739250855,84739250856,1,1341,1439,-20
84739554270,84739554272,2,1836,1343,-20
84745819733,84745819735,2,966,682,-20
84747197890,84747197893,3,2308,1388,-20
84748780377,84748780380,3,1420,1041,-20
84757837839,84757837841,2,1260,1250,-20
84758212078,84758212083,5,1907,1221,-20
84759024190,84759024194,4,1943,1339,-20
84759938286,84759938288,2,1909,2356,-20
84763262925,84763262929,4,2499,1415,-20
84766906609,84766906606,-3,1285,1995,-20
84770988263,84770988264,1,1297,957,-20
84771739083,84771739085,2,1987,1256,-20
84772444649,84772444651,2,1339,1295,-20
84774434179,84774434182,3,1778,1406,-20
84774754307,84774754306,-1,1560,1460,-20
84776289909,84776289912,3,2477,1659,-20
84779918447,84779918450,3,1585,1526,-20
84781294455,84781294451,-4,2203,4868,-20
84782108859,84782108863,4,2228,1645,-20
84784374268,84784374270,2,1046,894,-20
84787350865,84787350869,4,2519,1875,-20
84793529972,84793529970,-2,1756,2383,-20
84796770966,84796770970,4,2010,1358,-20
84805652002,84805652005,3,2183,1526,-20
84805741643,84805741647,4,2055,1341,-20
84806404497,84806404502,5,3008,1250,-20
84806992777,84806992782,5,1778,1096,-20
84808968545,84808968546,1,1583,1082,-20
84809617415,84809617418,3,1831,1416,-20
84810276553,84810276554,1,1564,1766,-20
84814013310,84814013314,4,1868,1628,-20
84814103044,84814103046,2,1950,1561,-20
84815059530,84815059534,4,1914,1335,-20
84816774579,84816774583,4,2063,1298,-20
84817994906,84817994910,4,2110,1527,-20
84818079959,84818079962,3,1368,1186,-20
84819254148,84819254153,5,2070,1769,-20
84820878533,84820878538,5,2334,1565,-20
84823709963,84823709966,3,2300,1056,-20
84825038158,84825038161,3,1364,1431,-20
84826852013,84826852017,4,36984,30867,-20
84827482431,84827482434,3,5113,24179,-20
84827618322,84827618326,4,1298,1171,-20
84830699238,84830699242,4,1542,1364,-20
84831518256,84831518258,2,2031,2084,-20
84833876897,84833876897,0,1408,1316,-20
84835509098,84835509101,3,1322,1621,-20
84835592100,84835592102,2,1620,1415,-20
84837835161,84837835158,-3,1199,2783,-20
84842230581,84842230587,6,3720,1377,-20
84842388739,84842388724,-15,1010,275,-20
84847660138,84847660143,5,2231,1296,-20
84848549286,84848549290,4,2150,1498,-20
84849348169,84849348171,2,1335,1508,-20
84854207657,84854207659,2,1782,1640,-20
84857654464,84857654457,-7,1150,5266,-20
84863748106,84863748110,4,1874,1516,-20
84865255105,84865255101,-4,1003,2544,-20
84866462669,84866462671,2,1426,1282,-20
84866710809,84866710812,3,2141,2028,-20
84871994279,84871994278,-1,6460,20135,-20
84874203576,84874203579,3,1590,1263,-20
84876361846,84876361849,3,2488,1312,-20
84879497741,84879497742,1,1534,1545,-20
84879786078,84879786082,4,2131,1028,-20
84884077743,84884077750,7,1835,1132,-20
84884489727,84884489705,-22,1132,1266,-20
84887517571,84887517574,3,1147,1146,-20
84888467873,84888467878,5,1999,1708,-20
84890803346,84890803347,1,2714,1616,-20
84894351001,84894351006,5,1262,1229,-20
84897592884,84897592886,2,1841,1285,-20
84898952510,84898952513,3,1456,1368,-20
84901992910,84901992914,4,1868,1669,-20
84906441277,84906441279,2,2493,1694,-20
84906631277,84906631281,4,1565,1310,-20
84906784504,84906784506,2,38020,21835,-20
84908446657,84908446658,1,1865,1614,-20
84911680743,84911680745,2,2017,1424,-20
84913187065,84913187071,6,2335,1293,-20
84913584697,84913584702,5,1484,1000,-20
84915552703,84915552710,7,1615,611,-20
84916096381,84916096384,3,2154,1306,-20
84916600773,84916600777,4,5852,5249,-20
84923943615,84923943618,3,1528,1072,-20
84924574823,84924574826,3,1912,1870,-20
84924719118,84924719121,3,22886,40658,-20
84927017913,84927017914,1,1458,1444,-20
84927226050,84927226059,9,3634,1902,-20
84930880632,84930880634,2,2176,2172,-20
84939920082,84939920085,3,1386,1138,-20
84947413562,84947413564,2,1941,1859,-20
84950218532,84950218535,3,1623,1199,-20
84953780964,84953780967,3,1981,1353,-20
84959751573,84959751578,5,1204,858,-20
84960123887,84960123866,-21,912,859,-20
84964600726,84964600731,5,1824,1189,-20
84968724267,84968724271,4,1523,1088,-20
84968850322,84968850325,3,1627,1369,-20
84970210457,84970210461,4,1474,1581,-20
84970361462,84970361467,5,1511,1193,-20
84973386460,84973386461,1,2032,1792,-20
84975235066,84975235069,3,1051,863,-20
84976212002,84976212005,3,2145,1898,-20
84979401950,84979401954,4,2436,1847,-20
84991660145,84991660147,2,2129,1463,-20
85001846114,85001846119,5,2275,1338,-20
85004451813,85004451818,5,1530,1079,-20
85004801159,85004801162,3,1672,1491,-20
85005451858,85005451874,16,1364,982,-20
85011201080,85011201082,2,28430,86378,-20
85011808930,85011808931,1,1555,2488,-20
85012213320,85012213316,-4,1136,2640,-20
85014395048,85014395046,-2,1644,2170,-20
85014659277,85014659279,2,1654,1278,-20
85017961184,85017961186,2,1987,1232,-20
85018111938,85018111943,5,1941,1556,-20
85023478549,85023478553,4,2632,2018,-20
85031295501,85031295505,4,1604,1285,-20
85032986854,85032986856,2,1641,1248,-20
85033508559,85033508555,-4,1939,1145,-20
85035441412,85035441414,2,1520,1085,-20
85036194773,85036194777,4,2025,1705,-20
85038910824,85038910825,1,1477,2146,-20
85039217441,85039217443,2,1917,1349,-20
85039611443,85039611450,7,1305,1239,-20
85040075127,85040075107,-20,1391,503,-20
85041300846,85041300849,3,2364,1560,-20
85042982015,85042982018,3,1421,1178,-20
85043499115,85043499119,4,1626,1492,-20
85044042455,85044042459,4,2730,1687,-20
85045966117,85045966123,6,1663,1110,-20
85047401140,85047401143,3,1783,1162,-20
85048224972,85048224978,6,1440,874,-20
85049275867,85049275847,-20,901,727,-20
85050239271,85050239267,-4,1405,2687,-20
85051117737,85051117740,3,1712,1660,-20
85051854518,85051854522,4,1749,1280,-20
85059465275,85059465279,4,1786,1443,-20
85060353659,85060353662,3,1805,1669,-20
85060988599,85060988603,4,1862,1372,-20
85061085810,85061085811,1,1808,1310,-20
85063139528,85063139531,3,1820,1426,-20
85071333506,85071333502,-4,940,1938,-20
85072562931,85072562934,3,1599,1590,-20
85074270050,85074270055,5,1177,1161,-20
85075744249,85075744254,5,2404,1425,-20
85076913254,85076913258,4,2511,1419,-20
85078809690,85078809695,5,2256,1275,-20
85079381091,85079381095,4,1933,1237,-20
85084385565,85084385569,4,2200,1261,-20
85084503805,85084503816,11,2050,1632,-20
85087137151,85087137155,4,2431,1372,-20
85090624213,85090624218,5,1560,1354,-20
85091460509,85091460513,4,1464,1644,-20
85096126720,85096126724,4,1427,1228,-20
85101036790,85101036794,4,1402,1402,-20
85108399071,85108399074,3,2509,1994,-20
85110684611,85110684614,3,2834,997,-20
85111204994,85111204998,4,2033,1342,-20
85112970978,85112970981,3,2539,2106,-20
85113399377,85113399380,3,2373,1329,-20
85114775410,85114775410,0,896,538,-20
85116466142,85116466146,4,1901,1644,-20
85117889975,85117889995,20,1729,1290,-20
85118795357,85118795363,6,7330,2790,-20
85119593001,85119593010,9,16360,17641,-20
85121579098,85121579100,2,1416,2029,-20
85122315561,85122315564,3,2171,1903,-20
85122657087,85122657089,2,1354,1477,-20
85127595973,85127595977,4,1549,1359,-20
85132433775,85132433779,4,1702,1457,-20
85132570311,85132570314,3,1383,853,-20
85134409029,85134409033,4,1087,763,-20
85135848541,85135848544,3,1873,1249,-20
85137046359,85137046353,-6,640,3727,-20
85140016923,85140016926,3,1116,1104,-20
85144272023,85144272025,2,1218,1068,-20
85146342994,85146342997,3,1791,1608,-20
85148572531,85148572529,-2,1323,1556,-20
85148823027,85148823031,4,2455,1436,-20
85149443933,85149443933,0,1226,2568,-20
85150397375,85150397379,4,2210,1670,-20
85158800536,85158800539,3,1583,2105,-20
85159107594,85159107595,1,1989,1686,-20
85160932721,85160932723,2,1153,1036,-20
85164536366,85164536370,4,2306,1133,-20
85164735553,85164735552,-1,1360,1710,-20
85165289262,85165289267,5,1309,822,-20
85167888079,85167888083,4,1913,1379,-20
85168144599,85168144603,4,2391,1289,-20
85168706059,85168706062,3,1793,1434,-20
85170648663,85170648667,4,1170,1164,-20
85178013966,85178013971,5,1701,1425,-20
85180395905,85180395906,1,1730,1598,-20
85180770750,85180770753,3,2096,1570,-20
85184585365,85184585367,2,1415,1330,-20
85189458155,85189458158,3,2173,1477,-20
85189780447,85189780450,3,2359,2085,-20
85192160761,85192160763,2,1571,1337,-20
85196136788,85196136792,4,1864,1425,-20
85198298221,85198298223,2,1920,1039,-20
85200093966,85200093970,4,1992,1318,-20
85201744399,85201744401,2,1843,1184,-20
85202866597,85202866601,4,1856,1688,-20
85204432264,85204432267,3,1844,1278,-20
85205205527,85205205530,3,1206,1148,-20
85207620581,85207620584,3,2128,1496,-20
85210347078,85210347082,4,2047,1230,-20
85212381605,85212381609,4,1375,1421,-20
85214043878,85214043879,1,1389,1371,-20
85217645747,85217645751,4,1116,909,-20
85220698082,85220698085,3,2535,1391,-20
85222536746,85222536749,3,1709,1610,-20
85222699089,85222699095,6,2370,1227,-20
85222784846,85222784848,2,1523,1622,-20
85223226392,85223226379,-13,758,733,-20
85223450622,85223450626,4,2211,1225,-20
85226370208,85226370205,-3,1681,1896,-20
85229706086,85229706089,3,2065,1133,-20
85230993564,85230993563,-1,60161,38394,-20
85231501693,85231501694,1,2633,1619,-20
85240808141,85240808145,4,2563,1172,-20
85241997811,85241997818,7,2826,1208,-20
85245150038,85245150041,3,1555,1479,-20
85249005161,85249005159,-2,1597,1798,-20
85249277970,85249277970,0,11062,10976,-20
85254891834,85254891840,6,13397,7449,-20
85255662749,85255662753,4,1453,1295,-20
85258056426,85258056423,-3,1059,1780,-20
85258887757,85258887759,2,1091,1057,-20
85259679907,85259679922,15,1677,1289,-20
85264917651,85264917654,3,1735,1066,-20
85269367277,85269367282,5,1432,1076,-20
85269918805,85269918826,21,1388,1067,-20
85269983701,85269983706,5,1574,1567,-20
85270022878,85270022882,4,1706,1139,-20
85271033276,85271033278,2,1184,1264,-20
85275433458,85275433462,4,2368,1483,-20
85276581163,85276581164,1,1789,1523,-20
85281358698,85281358701,3,1480,1367,-20
85284703519,85284703523,4,1260,725,-20
85285231716,85285231740,24,836,274,-20
85286055236,85286055238,2,1995,1023,-20
85286407119,85286407097,-22,1896,1492,-20
85286924288,85286924291,3,1618,1188,-20
85288302446,85288302449,3,2180,1074,-20
85289188042,85289188025,-17,1175,726,-20
85290327872,85290327875,3,1593,912,-20
85292736751,85292736753,2,1490,1692,-20
85292894732,85292894735,3,2063,1065,-20
85293256600,85293256598,-2,1260,2189,-20
85293464396,85293464401,5,2579,1138,-20
85293741885,85293741864,-21,1245,1291,-20
85294726121,85294726126,5,2668,2238,-20
85295362428,85295362431,3,1927,1074,-20
85296264650,85296264654,4,1915,1047,-20
85296296272,85296296271,-1,1803,1316,-20
85296576954,85296576960,6,2262,1148,-20
85297673628,85297673634,6,16128,6352,-20
85299718549,85299718551,2,2093,1292,-20
85299823149,85299823143,-6,1334,8149,-20
85301568863,85301568867,4,1560,918,-20
85304344073,85304344077,4,1757,1146,-20
85305423822,85305423801,-21,673,392,-20
85306155199,85306155203,4,1412,1604,-20
85307458365,85307458367,2,1866,1777,-20
85314501723,85314501726,3,1002,992,-20
85315340937,85315340941,4,2377,1276,-20
85316362566,85316362548,-18,681,487,-20
85317779455,85317779459,4,1216,1027,-20
85319526398,85319526401,3,1578,1218,-20
85319993090,85319993093,3,2680,1420,-20
85322001470,85322001476,6,1804,1369,-20
85328028651,85328028655,4,1079,1158,-20
85329378660,85329378662,2,2567,1734,-20
85331799045,85331799049,4,1061,1499,-20
85334294828,85334294831,3,1568,1492,-20
85335869539,85335869544,5,1770,1423,-20
85337322742,85337322747,5,2079,1064,-20
85339607109,85339607111,2,2176,1175,-20
85339688170,85339688173,3,1697,1750,-20
85341490654,85341490655,1,1797,1630,-20
85342776423,85342776426,3,1482,920,-20
85344372550,85344372551,1,1576,1486,-20
85345225387,85345225389,2,1928,2142,-20
85346072994,85346072994,0,1337,1646,-20
85349131402,85349131406,4,2271,1280,-20
85353125104,85353125107,3,2210,2135,-20
85354060858,85354060861,3,2158,1500,-20
85354236761,85354236763,2,2180,1453,-20
85355406518,85355406523,5,1297,901,-20
85355752022,85355752023,1,1417,2081,-20
85360336382,85360336399,17,2257,1724,-20
85366377824,85366377806,-18,948,919,-20
85367546115,85367546119,4,1641,1527,-20
85368735297,85368735302,5,1404,1078,-20
85372821667,85372821670,3,1450,1198,-20
85376320330,85376320333,3,1658,761,-20
85384795947,85384795965,18,581,1695,-20
85390777791,85390777795,4,1250,1403,-20
85393196602,85393196602,0,1386,1279,-20
85402141559,85402141562,3,1346,1371,-20
85402958078,85402958074,-4,1443,3725,-20
85403316966,85403316971,5,2150,1365,-20
85404973695,85404973707,12,10951,42575,-20
85405010823,85405010826,3,1611,1438,-20
85406106435,85406106436,1,1351,1389,-20
85406208239,85406208218,-21,790,382,-20
85407440179,85407440182,3,1640,1450,-20
85415480181,85415480187,6,1048,833,-20
85425457239,85425457242,3,1737,1684,-20
85425764436,85425764439,3,2027,1464,-20
85425793101,85425793107,6,2044,1115,-20
85427448310,85427448315,5,2189,1477,-20
85428858283,85428858286,3,1369,1547,-20
85435212663,85435212666,3,1804,1171,-20
85435757113,85435757115,2,1965,1528,-20
85441788112,85441788117,5,2679,1256,-20
85445404762,85445404762,0,929,2006,-20
85450212934,85450212938,4,2984,1434,-20
85450474686,85450474691,5,1668,1372,-20
85450790047,85450790050,3,1859,1656,-20
85451785972,85451785976,4,1887,1358,-20
85453749700,85453749703,3,1876,1354,-20
85459050778,85459050783,5,1703,1327,-20
85459500583,85459500587,4,2097,1387,-20
85460233530,85460233534,4,1626,1266,-20
85460411589,85460411597,8,18844,19111,-20
85462193999,85462194004,5,1872,1006,-20
85463028469,85463028468,-1,1088,1818,-20
85463607826,85463607834,8,3394,1323,-20
85470540607,85470540609,2,2033,1431,-20
85471897543,85471897546,3,2469,1781,-20
85472048325,85472048327,2,2241,1930,-20
85478475524,85478475529,5,1617,1878,-20
85480029676,85480029679,3,1663,1192,-20
85482654419,85482654422,3,1642,1050,-20
85488467274,85488467275,1,2132,1404,-20
85492550926,85492550929,3,2276,1411,-20
85495276225,85495276228,3,1257,1138,-20
85495887508,85495887511,3,1559,1415,-20
85496251569,85496251574,5,1194,1305,-20
85497522554,85497522556,2,2014,1540,-20
85497917693,85497917696,3,1835,1791,-20
85499984650,85499984652,2,1216,1807,-20
85501099326,85501099305,-21,1236,917,-20
85501910191,85501910193,2,1538,1194,-20
85502862026,85502862030,4,2301,1366,-20
85505417293,85505417297,4,2524,1466,-20
85506177642,85506177641,-1,979,918,-20
85508865611,85508865611,0,16757,8683,-20
85510055638,85510055641,3,1114,1307,-20
85513181085,85513181087,2,1400,1545,-20
85516886770,85516886774,4,2054,1227,-20
85519693085,85519693090,5,1491,1355,-20
85521814243,85521814248,5,1731,1181,-20
85524935376,85524935370,-6,2302,11132,-20
85525799510,85525799510,0,1436,1261,-20
85529531101,85529531106,5,1719,1454,-20
85530165055,85530165059,4,1917,1070,-20
85531454523,85531454526,3,1905,1604,-20
85533797139,85533797142,3,1345,1289,-20
85535412002,85535412005,3,1826,1332,-20
85535618831,85535618811,-20,1125,976,-20
85539223990,85539223994,4,1837,1012,-20
85539661944,85539661947,3,1984,1537,-20
85543772558,85543772576,18,1429,1175,-20
85545075183,85545075186,3,1337,1224,-20
85545882876,85545882879,3,1882,1108,-20
85547009270,85547009273,3,1533,1042,-20
85547364931,85547364934,3,2000,1585,-20
85551875770,85551875770,0,1900,2245,-20
85553982012,85553982011,-1,1453,1832,-20
85555989263,85555989266,3,1755,1650,-20
85557095075,85557095079,4,1682,1232,-20
85557741158,85557741162,4,1838,1394,-20
85557858749,85557858752,3,1659,1633,-20
85558870982,85558870983,1,2128,1142,-20
85565886129,85565886130,1,1509,1648,-20
85566044560,85566044554,-6,1424,4459,-20
85566975080,85566975082,2,2570,1997,-20
85569333030,85569333035,5,2584,1484,-20
85569369742,85569369750,8,3266,1445,-20
85570318474,85570318478,4,1451,889,-20
85571151505,85571151507,2,2177,1613,-20
85573080575,85573080580,5,2206,1172,-20
85573595050,85573595053,3,1821,1935,-20
85576145067,85576145071,4,1970,1252,-20
85577112346,85577112340,-6,704,372,-20
85579163373,85579163353,-20,1575,1148,-20
85580627782,85580627786,4,2568,2081,-20
85583978781,85583978774,-7,1173,4221,-20
85584531420,85584531422,2,2488,1735,-20
85584912362,85584912365,3,1920,1231,-20
85586791368,85586791365,-3,1167,2733,-20
85590474987,85590474983,-4,1063,2835,-20
85590737629,85590737635,6,4655,1702,-20
85591231154,85591231160,6,1680,1074,-20
85591910417,85591910418,1,2135,1436,-20
85594177321,85594177325,4,2418,1249,-20
85595450377,85595450378,1,1343,954,-20
85595830297,85595830295,-2,1595,2878,-20
85596454234,85596454237,3,2597,2241,-20
85597322462,85597322465,3,1906,1391,-20
85597531727,85597531730,3,997,1380,-20
85599188951,85599188954,3,1069,813,-20
85599710842,85599710845,3,878,669,-20
85600209516,85600209517,1,1783,1762,-20
85602482293,85602482294,1,1648,1445,-20
85604732815,85604732819,4,1530,1325,-20
85605866161,85605866163,2,2017,1159,-20
85609483631,85609483636,5,1885,1719,-20
85610267353,85610267356,3,1581,1338,-20
85612032277,85612032283,6,7314,2719,-20
85616233050,85616233050,0,1386,1635,-20
85619465525,85619465527,2,1986,1455,-20
85622224991,85622224994,3,1608,1226,-20
85622465933,85622465937,4,1889,1891,-20
85623179338,85623179339,1,1524,1030,-20
85626192928,85626192930,2,928,1025,-20
85627438448,85627438452,4,1702,1326,-20
85628796926,85628796927,1,1364,1398,-20
85629319956,85629319970,14,448,1647,-20
85629485479,85629485483,4,1204,1010,-20
85630417574,85630417577,3,2221,1323,-20
85633721173,85633721174,1,1333,1187,-20
85635660935,85635660937,2,1356,1145,-20
85636477173,85636477177,4,2144,1925,-20
85636796372,85636796376,4,1998,1765,-20
85637274478,85637274483,5,1702,1148,-20
85637854644,85637854646,2,1663,1306,-20
85652840382,85652840386,4,1673,1922,-20
85654276766,85654276770,4,1586,1000,-20
85654873266,85654873266,0,1974,1233,-20
85655242061,85655242064,3,1832,1562,-20
85657557391,85657557395,4,1912,1321,-20
85658756114,85658756118,4,2482,1200,-20
85661239152,85661239153,1,1403,1401,-20
85665442704,85665442707,3,2123,1404,-20
85667782065,85667782064,-1,1384,1707,-20
85671663031,85671663034,3,1217,1404,-20
85673936820,85673936826,6,4207,2750,-20
85675680285,85675680286,1,1574,1261,-20
85676300805,85676300810,5,2351,2029,-20
85678500290,85678500294,4,1467,1505,-20
85679748059,85679748062,3,2368,2084,-20
85680075773,85680075779,6,2348,1110,-20
85681668621,85681668626,5,1795,1369,-20
85681927177,85681927181,4,1861,1267,-20
85683633429,85683633435,6,2221,1341,-20
85684062481,85684062482,1,1726,1680,-20
85685942738,85685942743,5,1999,1416,-20
85686221781,85686221793,12,13,746,-20
85689812067,85689812070,3,1531,1340,-20
85693063946,85693063949,3,2158,1768,-20
85693705783,85693705786,3,1285,1091,-20
85694872916,85694872919,3,1910,1509,-20
85695486353,85695486358,5,1936,1033,-20
85698404932,85698404929,-3,828,2242,-20
85700232493,85700232498,5,1758,1409,-20
85700434525,85700434530,5,1890,1403,-20
85700575618,85700575621,3,1130,1127,-20
85701998857,85701998862,5,1820,916,-20
85705310075,85705310075,0,1923,1879,-20
85706551855,85706551858,3,1825,2044,-20
85706701628,85706701631,3,1992,1402,-20
85708306582,85708306587,5,2139,1488,-20
85711177490,85711177492,2,2171,1673,-20
85711359726,85711359730,4,2572,1842,-20
85711992285,85711992287,2,1973,1180,-20
85712914639,85712914643,4,1046,225,-20
85713443617,85713443622,5,1780,1696,-20
85715878862,85715878863,1,1592,1223,-20
85717786851,85717786855,4,1723,1712,-20
85719526914,85719526918,4,2175,1452,-20
85720033809,85720033813,4,2512,1765,-20
85721641270,85721641274,4,1585,1538,-20
85726622262,85726622266,4,1772,1755,-20
85727130591,85727130595,4,2519,1650,-20
85729659976,85729659981,5,1515,1173,-20
85730870118,85730870119,1,1942,1763,-20
85736499410,85736499413,3,1890,1457,-20
85737338754,85737338759,5,1312,937,-20
85738874358,85738874362,4,1976,1155,-20
85746251834,85746251836,2,1559,1779,-20
85746713514,85746713519,5,1296,958,-20
85749137064,85749137066,2,1759,1445,-20
85752410966,85752410969,3,1786,1561,-20
85753272979,85753272983,4,1676,1263,-20
85759270037,85759270036,-1,1386,1240,-20
85759570537,85759570559,22,318,1385,-20
85760275862,85760275865,3,1219,977,-20
85761674633,85761674636,3,1465,1557,-20
85761788962,85761788946,-16,1802,946,-20
85763463437,85763463441,4,1630,1623,-20
85765285280,85765285286,6,1661,1267,-20
85765490953,85765490940,-13,786,501,-20
85767151172,85767151175,3,1235,1065,-20
85772807586,85772807590,4,1626,1572,-20
85777554002,85777554006,4,2205,1762,-20
85781805869,85781805871,2,1656,1419,-20
85781831137,85781831141,4,4234,2671,-20
85783885710,85783885713,3,2341,1501,-20
85787215210,85787215213,3,1380,1124,-20
85791181280,85791181282,2,1521,1127,-20
85799042314,85799042317,3,1819,1295,-20
85804798997,85804798999,2,1579,1172,-20
85806985816,85806985818,2,1158,1115,-20
85807708762,85807708763,1,1582,1751,-20
85809362506,85809362510,4,1647,1346,-20
85810540158,85810540158,0,1301,897,-20
85814650102,85814650105,3,2360,1491,-20
85815773244,85815773248,4,2027,1961,-20
85823823154,85823823158,4,1665,1450,-20
85828186418,85828186419,1,1622,1572,-20
85829164133,85829164137,4,2190,1164,-20
85829552177,85829552182,5,3009,1281,-20
85831025216,85831025221,5,2465,1580,-20
85832011428,85832011423,-5,775,2327,-20
85834520320,85834520324,4,1952,1202,-20
85835057639,85835057642,3,1139,1353,-20
85835227530,85835227535,5,1963,957,-20
85835383672,85835383676,4,1387,1150,-20
85837520553,85837520556,3,1841,1376,-20
85843588521,85843588526,5,2411,1504,-20
85848146078,85848146082,4,1666,822,-20
85848327623,85848327641,18,2017,981,-20
85849303408,85849303413,5,2453,2025,-20
85850494115,85850494119,4,1758,1289,-20
85851845455,85851845457,2,1375,1086,-20
85853613422,85853613426,4,1793,1481,-20
85854628017,85854628019,2,2133,1840,-20
85856034405,85856034425,20,1523,1022,-20
85860754753,85860754754,1,1214,880,-20
85861549570,85861549571,1,1479,1209,-20
85861869191,85861869194,3,1676,1737,-20
85865791554,85865791556,2,2299,2042,-20
85866415676,85866415694,18,1124,1593,-20
85870301769,85870301770,1,1084,1471,-20
85871840633,85871840632,-1,1187,1480,-20
85875919377,85875919381,4,1744,1447,-20
85878736059,85878736061,2,1889,1983,-20
85879236852,85879236856,4,1716,1259,-20
85883345297,85883345301,4,2348,1734,-20
85884480774,85884480779,5,2058,1332,-20
85890566812,85890566813,1,1357,1661,-20
85897119336,85897119341,5,2279,1622,-20
85906398517,85906398521,4,2195,1365,-20
85907788827,85907788831,4,1818,1816,-20
85911773450,85911773452,2,2130,1570,-20
85915917288,85915917293,5,1989,1835,-20
85917861458,85917861463,5,1873,1565,-20
85918000878,85918000880,2,1868,1623,-20
85921359678,85921359681,3,1874,1361,-20
85923425202,85923425209,7,4563,1306,-20
85924292338,85924292343,5,2180,1498,-20
85927103453,85927103459,6,956,1102,-20
85929853014,85929853019,5,1701,1190,-20
85931033571,85931033576,5,2174,1664,-20
85932400734,85932400737,3,1979,2064,-20
85934507879,85934507886,7,3260,1126,-20
85937632578,85937632581,3,1935,1392,-20
85939503985,85939503985,0,1671,2300,-20
85939662612,85939662618,6,1726,1461,-20
85946691509,85946691514,5,1079,986,-20
85950298177,85950298181,4,1733,1244,-20
85956922114,85956922118,4,2064,1827,-20
85958371072,85958371093,21,456,2575,-20
85962631630,85962631633,3,1819,1435,-20
85967281068,85967281070,2,2360,1898,-20
85968320268,85968320263,-5,1030,3284,-20
85970668341,85970668346,5,2159,1455,-20
85972804514,85972804516,2,1536,1467,-20
85974120861,85974120866,5,1815,1671,-20
85974236685,85974236667,-18,1802,823,-20
85975040778,85975040781,3,1818,1683,-20
85976807821,85976807825,4,1177,1139,-20
85981798979,85981798983,4,1522,892,-20
85982644910,85982644914,4,968,1318,-20
85982991114,85982991115,1,1324,1225,-20
85989370288,85989370292,4,1253,1577,-20
85992252964,85992252969,5,1787,1110,-20
85992789223,85992789226,3,1208,1846,-20
86000793182,86000793186,4,1703,1184,-20
86007345690,86007345693,3,1457,1317,-20
86009966505,86009966507,2,1970,1468,-20
86010957906,86010957907,1,1358,1218,-20
86011498864,86011498867,3,1944,1216,-20
86011720170,86011720174,4,1909,1326,-20
86011984214,86011984218,4,2418,1740,-20
86013373117,86013373120,3,1928,1354,-20
86015106319,86015106319,0,1487,1297,-20
86015554235,86015554238,3,1344,1283,-20
86016469234,86016469235,1,1325,1144,-20
86018588333,86018588337,4,1292,1482,-20
86018922178,86018922180,2,1637,1431,-20
86022908242,86022908243,1,1250,1496,-20
86023790486,86023790490,4,1860,1559,-20
86025108214,86025108217,3,1582,1671,-20
86026300786,86026300789,3,1627,1407,-20
86026489789,86026489789,0,1506,1918,-20
86026760652,86026760656,4,2300,1367,-20
86027333117,86027333121,4,2679,1385,-20
86030309513,86030309517,4,1852,1872,-20
86033154073,86033154073,0,1353,2237,-20
86033294161,86033294165,4,1390,1363,-20
86034024661,86034024662,1,1351,1525,-20
86034893992,86034893995,3,1894,1261,-20
86036171548,86036171550,2,1637,1249,-20
86036756705,86036756707,2,1623,1516,-20
86037006249,86037006251,2,1743,1546,-20
86037640626,86037640628,2,2538,1907,-20
86041056178,86041056180,2,2252,1207,-20
86041889255,86041889258,3,1514,1685,-20
86041951949,86041951951,2,1451,1253,-20
86042854619,86042854622,3,1470,1122,-20
86045254774,86045254777,3,2335,1593,-20
86053400560,86053400563,3,2301,1963,-20
86053542177,86053542179,2,1776,1257,-20
86054420891,86054420895,4,2219,1216,-20
86056467869,86056467873,4,1729,1608,-20
86061652864,86061652867,3,2548,1630,-20
86063951954,86063951949,-5,1674,3794,-20
86064045406,86064045409,3,2172,2063,-20
86065706619,86065706603,-16,626,672,-20
86070647198,86070647202,4,2330,1513,-20
86071333804,86071333806,2,1247,1167,-20
86073990286,86073990295,9,1723,988,-20
86079039289,86079039292,3,1770,1492,-20
86080101046,86080101027,-19,765,561,-20
86082133356,86082133361,5,1866,1117,-20
86083164686,86083164687,1,1829,1315,-20
86083809054,86083809054,0,2200,4681,-20
86084156429,86084156434,5,2065,1380,-20
86086351805,86086351811,6,1336,1295,-20
86086752039,86086752043,4,1603,977,-20
86090092551,86090092554,3,1422,1255,-20
86090229014,86090229018,4,2304,1270,-20
86092701248,86092701251,3,1637,1650,-20
86093240387,86093240391,4,1557,1151,-20
86094134829,86094134842,13,1000,239,-20
86096411855,86096411858,3,1670,1179,-20
86098380374,86098380378,4,2144,1637,-20
86098917382,86098917387,5,1295,1077,-20
86099197939,86099197943,4,1542,1271,-20
86101636197,86101636201,4,2149,943,-20
86101784911,86101784931,20,2046,1414,-20
86101868439,86101868428,-11,290,268,-20
86102826414,86102826417,3,1591,1052,-20
86104384587,86104384591,4,1390,1303,-20
86104681957,86104681954,-3,1516,1706,-20
86106090749,86106090751,2,1739,1170,-20
86109767152,86109767155,3,1639,1311,-20
86109945727,86109945722,-5,1674,7794,-20
86111356314,86111356318,4,2179,1364,-20
86116519285,86116519289,4,1056,1287,-20
86120511407,86120511411,4,1954,1101,-20
86123201123,86123201125,2,2213,1850,-20
86123580222,86123580228,6,1909,1881,-20
86129285215,86129285210,-5,755,3440,-20
86131714614,86131714622,8,2621,981,-20
86133712911,86133712914,3,2197,1501,-20
86138666846,86138666850,4,1964,1008,-20
86138831898,86138831901,3,1866,1098,-20
86144680396,86144680399,3,2385,1770,-20
86150879842,86150879830,-12,11338,39675,-20
86153008813,86153008815,2,1494,923,-20
86154297069,86154297070,1,1321,1712,-20
86158249429,86158249433,4,2474,1434,-20
86161054468,86161054473,5,1376,1144,-20
86162392554,86162392557,3,1282,794,-20
86166358402,86166358404,2,1806,1495,-20
86169381323,86169381326,3,1097,1303,-20
86179008487,86179008490,3,1710,1288,-20
86179371252,86179371258,6,1565,1471,-20
86185829482,86185829486,4,2091,2018,-20
86186748652,86186748655,3,1137,1344,-20
86187233243,86187233246,3,1983,1287,-20
86188835204,86188835206,2,2080,1797,-20
86192871126,86192871130,4,1321,1319,-20
86192965542,86192965546,4,1977,1171,-20
86194323374,86194323377,3,1823,1461,-20
86194714926,86194714931,5,1537,832,-20
86199002123,86199002127,4,1292,1103,-20
86201404299,86201404302,3,1592,1226,-20
86204697331,86204697334,3,1506,1172,-20
86204941758,86204941769,11,1919,1309,-20
86205859519,86205859513,-6,46463,23401,-20
86208627319,86208627327,8,2880,887,-20
86211645003,86211645002,-1,698,1713,-20
86213372291,86213372295,4,3034,2218,-20
86214548974,86214548977,3,1664,1573,-20
86215168519,86215168520,1,1498,2400,-20
86218950763,86218950766,3,1941,1118,-20
86221146555,86221146561,6,1694,1202,-20
86222568595,86222568598,3,1099,1500,-20
86227271309,86227271308,-1,1857,1669,-20
86231596624,86231596627,3,1650,1579,-20
86233089675,86233089679,4,2055,1252,-20
86240821606,86240821607,1,1275,1045,-20
86243522972,86243522974,2,1127,871,-20
86255095277,86255095281,4,3879,2673,-20
86255614240,86255614244,4,2737,1357,-20
86255654965,86255654970,5,1623,975,-20
86256258346,86256258350,4,1195,698,-20
86256561190,86256561194,4,1842,1354,-20
86260429929,86260429930,1,1619,1595,-20
86262014787,86262014791,4,2742,1546,-20
86263974920,86263974922,2,1757,1062,-20
86266032699,86266032701,2,1168,1020,-20
86268106256,86268106254,-2,74,1304,-20
86269563814,86269563817,3,3220,1441,-20
86270804607,86270804611,4,1608,1407,-20
86273843602,86273843606,4,1642,1021,-20
86275916905,86275916907,2,1868,1311,-20
86276017324,86276017345,21,1590,1124,-20
86277059144,86277059147,3,1250,1273,-20
86278778666,86278778667,1,1075,1023,-20
86279267526,86279267530,4,1564,1476,-20
86280281131,86280281134,3,755,747,-20
86281026962,86281026966,4,1912,2009,-20
86285266303,86285266306,3,1582,1246,-20
86286082374,86286082377,3,1329,1269,-20
86292121361,86292121365,4,2512,1801,-20
86293029169,86293029172,3,2091,1318,-20
86299167828,86299167832,4,1827,1315,-20
86299601593,86299601595,2,1521,1113,-20
86299750142,86299750143,1,1208,1718,-20
86301701308,86301701305,-3,861,1746,-20
86305505742,86305505746,4,2135,1533,-20
86305857281,86305857283,2,1198,1356,-20
86306555142,86306555146,4,1186,769,-20
86308983043,86308983047,4,1704,1557,-20
86311300134,86311300129,-5,1477,2845,-20
86311985349,86311985352,3,1812,1916,-20
86317682454,86317682459,5,1827,1299,-20
86319147702,86319147703,1,1279,1524,-20
86319658684,86319658689,5,5724,2864,-20
86320620433,86320620435,2,1782,1478,-20
86320977594,86320977597,3,1235,1040,-20
86321265206,86321265187,-19,1521,1009,-20
86321754127,86321754130,3,2516,41730,-20
86326595671,86326595673,2,1218,1462,-20
86332597387,86332597390,3,2249,1856,-20
86336253279,86336253283,4,1579,1589,-20
86336496607,86336496612,5,2120,1706,-20
86336614139,86336614143,4,1412,1212,-20
86338839074,86338839075,1,1310,916,-20
86341665530,86341665531,1,1772,1065,-20
86345108382,86345108388,6,1846,1869,-20
86345637146,86345637150,4,2150,1357,-20
86345832946,86345832950,4,1102,736,-20
86346629805,86346629809,4,1562,1490,-20
86348541315,86348541319,4,1573,1376,-20
86349234800,86349234799,-1,1659,1512,-20
86349726435,86349726438,3,1668,1739,-20
86351133596,86351133599,3,2478,1435,-20
86352627350,86352627354,4,3166,1982,-20
86352996873,86352996857,-16,1069,628,-20
86357797556,86357797555,-1,43612,21565,-20
86358966409,86358966406,-3,19167,10605,-20
86360737290,86360737295,5,3096,2333,-20
86362718998,86362719001,3,2421,1811,-20
86368876009,86368876010,1,1622,1550,-20
86371974298,86371974302,4,1957,1434,-20
86372184021,86372184022,1,1493,1869,-20
86377923848,86377923850,2,1820,1973,-20
86379492881,86379492885,4,1669,1084,-20
86384049762,86384049763,1,1426,1334,-20
86384126127,86384126105,-22,1857,1109,-20
86384377282,86384377287,5,1939,1630,-20
86387691510,86387691520,10,33957,90904,-20
86388332242,86388332245,3,1691,1597,-20
86388974526,86388974529,3,2264,1683,-20
86391777215,86391777217,2,1376,1559,-20
86391859411,86391859418,7,762,160,-20
86392776338,86392776342,4,3415,1702,-20
86393588488,86393588491,3,1595,1116,-20
86394358388,86394358390,2,1628,1091,-20
86398071744,86398071744,0,1714,1540,-20
86398119153,86398119157,4,2382,1698,-20
86398768915,86398768918,3,1186,1410,-20
86402634255,86402634254,-1,1325,1704,-20
86406486783,86406486785,2,1956,1762,-20
86407827833,86407827838,5,1023,1483,-20
86408411619,86408411623,4,1590,1210,-20
86411934571,86411934574,3,2568,1838,-20
86416061469,86416061471,2,1760,1782,-20
86424234129,86424234131,2,1321,1152,-20
86425339138,86425339139,1,1285,974,-20
86429214420,86429214422,2,1702,1915,-20
86435491881,86435491884,3,1994,1466,-20
86439314058,86439314061,3,1996,1660,-20
86441268562,86441268566,4,1253,1157,-20
86442198074,86442198082,8,474,341,-20
86443629477,86443629481,4,1288,1263,-20
86445190556,86445190574,18,560,739,-20
86445438883,86445438887,4,1688,1181,-20
86451237658,86451237662,4,1544,1079,-20
86451476579,86451476598,19,1416,3521,-20
86452883639,86452883642,3,2579,1987,-20
86453812477,86453812478,1,1312,1494,-20
86457407037,86457407041,4,1235,843,-20
86459600853,86459600859,6,1549,1130,-20
86460935702,86460935702,0,1651,1697,-20
86463549908,86463549911,3,986,561,-20
86467049379,86467049382,3,1361,1380,-20
86468178166,86468178169,3,1508,1432,-20
86468286236,86468286242,6,1295,1079,-20
86468848683,86468848686,3,1342,1470,-20
86471560285,86471560288,3,1669,1178,-20
86472344789,86472344790,1,1219,1287,-20
86476022164,86476022166,2,1648,1108,-20
86476766826,86476766832,6,2043,1750,-20
86478216051,86478216047,-4,356,496,-20
86479421987,86479421991,4,4043,2736,-20
86482982143,86482982146,3,1416,1432,-20
86484065983,86484065990,7,3456,1716,-20
86488287513,86488287515,2,2253,2097,-20
86490622863,86490622867,4,1132,754,-20
86492111790,86492111790,0,1988,1458,-20
86493935816,86493935819,3,2149,1695,-20
86497458125,86497458130,5,1828,1532,-20
86498668169,86498668148,-21,926,617,-20
86503689310,86503689310,0,1022,977,-20
86504259088,86504259091,3,1676,820,-20
86504959677,86504959684,7,3360,1189,-20
86507854526,86507854533,7,2983,1578,-20
86509462419,86509462421,2,1948,1997,-20
86512512566,86512512573,7,3905,1652,-20
86521065504,86521065501,-3,5356,13640,-20
86521773893,86521773896,3,1976,1313,-20
86523885899,86523885902,3,1614,1467,-20
86524212073,86524212076,3,1598,1497,-20
86525574372,86525574369,-3,1136,925,-20
86525964612,86525964614,2,1313,1282,-20
86527206910,86527206914,4,1828,1473,-20
86530188178,86530188181,3,1734,1496,-20
86531430417,86531430420,3,1887,1312,-20
86532803382,86532803386,4,2297,1514,-20
86533143267,86533143271,4,2077,1201,-20
86534101154,86534101158,4,2682,2584,-20
86535216465,86535216466,1,1922,1881,-20
86535711761,86535711765,4,2029,1428,-20
86536872535,86536872539,4,1899,1261,-20
86540693572,86540693575,3,1487,1364,-20
86542573007,86542573009,2,1508,1282,-20
86546243287,86546243291,4,2356,1599,-20
86549787642,86549787642,0,1816,1285,-20
86550604742,86550604741,-1,1532,1761,-20
86552624124,86552624109,-15,1631,8541,-20
86554338426,86554338419,-7,904,5032,-20
86556349086,86556349090,4,2137,1369,-20
86560018802,86560018807,5,1975,1730,-20
86561508282,86561508285,3,1948,1343,-20
86563142182,86563142189,7,2313,1302,-20
86566830889,86566830890,1,1502,1507,-20
86568839211,86568839204,-7,2556,7827,-20
86572728755,86572728759,4,2526,1920,-20
86573196966,86573196969,3,1700,1453,-20
86573435330,86573435325,-5,1033,1985,-20
86575529088,86575529091,3,2683,1708,-20
86581070157,86581070161,4,2161,1639,-20
86586646730,86586646733,3,2174,1104,-20
86587102117,86587102119,2,1940,1414,-20
86588118701,86588118705,4,1548,1663,-20
86588599273,86588599277,4,2015,1493,-20
86590334085,86590334089,4,1416,880,-20
86592590273,86592590279,6,967,1212,-20
86597232449,86597232454,5,1674,1164,-20
86597949401,86597949403,2,1533,1627,-20
86600979575,86600979580,5,1468,1505,-20
86601137910,86601137913,3,1635,1196,-20
86602158703,86602158707,4,1472,1009,-20
86602594813,86602594814,1,2222,2156,-20
86603717726,86603717721,-5,1455,3904,-20
86603980886,86603980886,0,1339,1488,-20
86606285334,86606285334,0,933,1236,-20
86607374913,86607374917,4,1965,927,-20
86612597894,86612597897,3,1926,1196,-20
86613186037,86613186040,3,1494,1596,-20
86622651994,86622651995,1,1587,1449,-20
86629012623,86629012626,3,1709,1435,-20
86632501046,86632501051,5,1606,824,-20
86632879653,86632879655,2,1752,1637,-20
86635895271,86635895274,3,2347,2066,-20
86636087206,86636087210,4,1659,1268,-20
86637680405,86637680409,4,1538,1446,-20
86637784268,86637784271,3,1458,1329,-20
86638036611,86638036614,3,1916,878,-20
86643120502,86643120507,5,2200,1236,-20
86644471023,86644471027,4,1860,1808,-20
86644729105,86644729109,4,1232,1460,-20
86645634093,86645634097,4,1187,976,-20
86648546397,86648546399,2,1609,1119,-20
86652502302,86652502305,3,2033,1641,-20
86652844822,86652844827,5,1847,1155,-20
86654053722,86654053728,6,4322,3180,-20
86654890708,86654890713,5,1536,1686,-20
86655727380,86655727386,6,1840,1603,-20
86656148933,86656148935,2,1988,1863,-20
86657454071,86657454073,2,2140,1714,-20
86660408086,86660408092,6,4321,2744,-20
86661510498,86661510503,5,1443,1268,-20
86668287536,86668287539,3,1816,1248,-20
86668827786,86668827791,5,1325,1228,-20
86669201106,86669201109,3,1640,1309,-20
86670505142,86670505145,3,1847,1684,-20
86674348258,86674348264,6,2548,1169,-20
86679275366,86679275370,4,1502,1535,-20
86680302452,86680302458,6,2679,1460,-20
86681108153,86681108157,4,2593,1393,-20
86681704726,86681704730,4,1720,1208,-20
86683571402,86683571405,3,1332,1269,-20
86686454261,86686454265,4,7593,6079,-20
86688124447,86688124450,3,1408,1370,-20
86689006645,86689006647,2,1065,991,-20
86691797001,86691797003,2,2128,1327,-20
86694130689,86694130689,0,1085,689,-20
86697483850,86697483854,4,2602,2079,-20
86701743938,86701743942,4,1769,1241,-20
86703859666,86703859669,3,1795,1627,-20
86707029466,86707029469,3,18,175,-20
86707664285,86707664289,4,1830,1350,-20
86708650621,86708650623,2,1876,1340,-20
86709274062,86709274065,3,1171,1031,-20
86713729790,86713729783,-7,5636,13998,-20
86715480230,86715480234,4,1103,1178,-20
86718562138,86718562143,5,1374,1228,-20
86723113834,86723113840,6,2692,1431,-20
86730276853,86730276855,2,2068,1874,-20
86733464578,86733464583,5,1753,1194,-20
86736312219,86736312222,3,1444,1537,-20
86738182697,86738182699,2,1154,1148,-20
86739804686,86739804689,3,1338,946,-20
86742126666,86742126667,1,1066,891,-20
86742843927,86742843930,3,1709,1195,-20
86744116630,86744116644,14,1059,3831,-20
86746849838,86746849843,5,2739,1317,-20
86747324619,86747324622,3,1716,1356,-20
86749312723,86749312726,3,2223,1378,-20
86755040327,86755040331,4,1611,900,-20
86756135154,86756135156,2,1698,2286,-20
86756767862,86756767867,5,1550,1077,-20
86766305902,86766305896,-6,809,2937,-20
86772299598,86772299603,5,1547,1314,-20
86773218943,86773218946,3,2178,1701,-20
86776143279,86776143282,3,1456,1810,-20
86776230111,86776230114,3,1271,1313,-20
86778099903,86778099906,3,1917,1588,-20
86783219617,86783219623,6,2001,1039,-20
86784918594,86784918595,1,1395,2044,-20
86789157001,86789157004,3,1795,1646,-20
86791320530,86791320532,2,1864,1364,-20
86792101206,86792101209,3,1277,951,-20
86793002610,86793002611,1,1513,997,-20
86794371273,86794371277,4,2311,1771,-20
86795044717,86795044738,21,2706,1310,-20
86796083582,86796083585,3,1974,1262,-20
86797857781,86797857784,3,1569,1430,-20
86801921119,86801921122,3,2190,1124,-20
86806565792,86806565794,2,1669,1042,-20
86807950456,86807950458,2,1582,1589,-20
86810596862,86810596865,3,1462,1068,-20
86814060961,86814060968,7,2472,1442,-20
86815831697,86815831701,4,1587,1268,-20
86816837067,86816837074,7,3028,1410,-20
86819569686,86819569693,7,3439,960,-20
86823556631,86823556635,4,2936,1594,-20
86824557110,86824557115,5,1775,1595,-20
86825878741,86825878742,1,1072,1339,-20
86826713973,86826713975,2,975,1204,-20
86827687872,86827687874,2,2137,2011,-20
86832063342,86832063348,6,1991,2001,-20
86832129301,86832129305,4,1813,1645,-20
86832184770,86832184774,4,2066,1362,-20
86833759246,86833759251,5,2435,1371,-20
86835576943,86835576945,2,1469,1556,-20
86838034257,86838034258,1,2299,1788,-20
86838507099,86838507102,3,1712,1234,-20
86839185075,86839185078,3,1704,2048,-20
86839477543,86839477542,-1,966,2213,-20
86839986760,86839986763,3,1437,1530,-20
86842744946,86842744949,3,1979,1605,-20
86848890120,86848890123,3,2331,2261,-20
86849368131,86849368135,4,2070,1471,-20
86853761286,86853761290,4,1654,1363,-20
86853825717,86853825731,14,1538,819,-20
86855676789,86855676793,4,2808,1926,-20
86856024056,86856024056,0,1656,1646,-20
86856714347,86856714349,2,1950,1266,-20
86857579110,86857579115,5,1546,947,-20
86864443473,86864443467,-6,1511,8450,-20
86864754959,86864754963,4,1557,1541,-20
86866454148,86866454150,2,1957,1463,-20
86869419126,86869419130,4,1343,1445,-20
86869878870,86869878875,5,1389,995,-20
86870367237,86870367248,11,895,251,-20
86876046772,86876046774,2,2296,1963,-20
86876476170,86876476155,-15,1184,1347,-20
86878339078,86878339082,4,2121,948,-20
86884311409,86884311413,4,2328,1337,-20
86888790136,86888790140,4,1724,1498,-20
86890067002,86890067006,4,3265,1340,-20
86890592389,86890592394,5,1274,1102,-20
86893915041,86893915044,3,2361,1644,-20
86894889255,86894889257,2,2190,1912,-20
86897059455,86897059461,6,6581,2511,-20
86898620930,86898620934,4,1698,1372,-20
86906195315,86906195319,4,2555,2367,-20
86910992870,86910992873,3,1841,1843,-20
86916451474,86916451479,5,1823,1050,-20
86918005086,86918005091,5,1408,1386,-20
86918398222,86918398221,-1,897,1429,-20
86923376880,86923376883,3,2013,1811,-20
86927482618,86927482622,4,1711,1107,-20
86927905772,86927905775,3,2097,1555,-20
86928319453,86928319457,4,1647,1598,-20
86929142233,86929142237,4,1851,1263,-20
86931497607,86931497602,-5,2292,6021,-20
86935800970,86935800961,-9,996,215,-20
86936061105,86936061100,-5,791,3997,-20
86937001274,86937001276,2,1810,1315,-20
86937189088,86937189092,4,1682,1168,-20
86938819841,86938819845,4,1193,1104,-20
86944699722,86944699723,1,2026,1346,-20
86948104031,86948104034,3,1310,1300,-20
86949414847,86949414851,4,1519,1227,-20
86950892194,86950892198,4,2322,2029,-20
86954692002,86954692005,3,2335,1967,-20
86955730278,86955730281,3,2083,1936,-20
86960028876,86960028879,3,1723,1379,-20
86960261790,86960261796,6,10200,35353,-20
86961549312,86961549314,2,1571,1491,-20
86964238410,86964238414,4,1474,1140,-20
86965173383,86965173388,5,1894,1535,-20
86970318918,86970318922,4,1680,1152,-20
86971617584,86971617586,2,1579,1196,-20
86972920098,86972920094,-4,59114,34778,-20
86973250902,86973250907,5,2211,1531,-20
86976365909,86976365914,5,1881,1399,-20
86978668633,86978668636,3,1465,1168,-20
86983634279,86983634282,3,960,864,-20
86986068614,86986068618,4,1780,1445,-20
86988603131,86988603133,2,1752,1446,-20
86990880151,86990880154,3,3456,2351,-20
86992791067,86992791070,3,2269,1878,-20
86995626470,86995626474,4,2145,1988,-20
86996465470,86996465474,4,1643,1407,-20
87001787397,87001787394,-3,1288,1433,-20
87006239561,87006239563,2,1791,1574,-20
87007800207,87007800212,5,2798,1306,-20
87012594886,87012594864,-22,1431,3283,-20
87012899694,87012899695,1,1867,1958,-20
87014829117,87014829118,1,1358,1153,-20
87017749358,87017749357,-1,977,2054,-20
87023087156,87023087159,3,1856,1214,-20
87032036419,87032036420,1,1797,1483,-20
87038536105,87038536110,5,1176,1650,-20
87040231395,87040231399,4,1664,1058,-20
87044527123,87044527127,4,1464,1267,-20
87046823557,87046823563,6,2433,888,-20
87048176923,87048176927,4,1997,955,-20
87048230555,87048230558,3,1623,1465,-20
87048700902,87048700907,5,1422,1175,-20
87050312559,87050312553,-6,2804,7425,-20
87056936263,87056936266,3,2417,2076,-20
87064588807,87064588809,2,1158,1085,-20
87064758726,87064758729,3,2229,1422,-20
87066307517,87066307524,7,1707,1045,-20
87068942878,87068942882,4,1809,1396,-20
87069287579,87069287582,3,700,737,-20
87070750026,87070750033,7,2702,1196,-20
87071574205,87071574210,5,1781,1711,-20
87074371378,87074371381,3,1736,1705,-20
87077324562,87077324565,3,2356,1477,-20
87077641050,87077641053,3,2191,1383,-20
87077912093,87077912096,3,1957,1159,-20
87081782522,87081782526,4,1701,1236,-20
87089649915,87089649917,2,1435,1694,-20
87091075372,87091075377,5,1995,1577,-20
87092487897,87092487901,4,1777,1577,-20
87092569492,87092569474,-18,1677,949,-20
87094054800,87094054799,-1,1654,1998,-20
87094775502,87094775505,3,1962,1040,-20
87096615803,87096615806,3,1531,1033,-20
87098893185,87098893188,3,1573,1422,-20
87103931216,87103931218,2,1514,1512,-20
87107763361,87107763366,5,2086,1104,-20
87108607665,87108607659,-6,2371,7391,-20
87112783138,87112783140,2,1629,1877,-20
87115349892,87115349897,5,1900,1111,-20
87118354380,87118354382,2,1806,1185,-20
87122014687,87122014686,-1,1485,3123,-20
87123827817,87123827818,1,1372,1454,-20
87129456307,87129456310,3,2290,1224,-20
87130368671,87130368676,5,2480,2165,-20
87131098488,87131098491,3,1583,1199,-20
87133757292,87133757296,4,1770,1610,-20
87137020693,87137020696,3,1958,1541,-20
87137249766,87137249759,-7,1833,1096,-20
87138263234,87138263237,3,1907,1739,-20
87141125362,87141125365,3,3224,1846,-20
87145313082,87145313089,7,1522,1332,-20
87150670575,87150670563,-12,1630,1429,-20
87152256993,87152256997,4,1736,1608,-20
87152616279,87152616281,2,1898,1744,-20
87153057439,87153057442,3,2067,2015,-20
87154955409,87154955412,3,1579,1307,-20
87156540146,87156540150,4,2057,1488,-20
87160012856,87160012859,3,2152,1291,-20
87163025010,87163025014,4,1271,802,-20
87167892019,87167892022,3,1900,1574,-20
87168623938,87168623941,3,1309,1356,-20
87171804762,87171804766,4,2727,1458,-20
87171936646,87171936648,2,1532,1361,-20
87175126482,87175126486,4,2014,1931,-20
87178075093,87178075076,-17,996,3787,-20
87178750138,87178750142,4,1748,1755,-20
87180726514,87180726519,5,2066,1351,-20
87182325687,87182325690,3,1867,1907,-20
87184739310,87184739314,4,1403,853,-20
87185134730,87185134735,5,2161,1263,-20
87185783691,87185783695,4,1290,1208,-20
87187296015,87187296019,4,2203,1514,-20
87190412141,87190412142,1,1058,1065,-20
87191943042,87191943047,5,1878,1444,-20
87192809203,87192809204,1,1275,1451,-20
87197016894,87197016896,2,1685,1372,-20
87197636362,87197636367,5,1559,1014,-20
87203694761,87203694763,2,1575,1404,-20
87209159375,87209159379,4,656,557,-20
87211872341,87211872342,1,2814,1851,-20
87212223047,87212223049,2,2607,1762,-20
87213399794,87213399796,2,1275,673,-20
87215328622,87215328626,4,1907,1104,-20
87216743106,87216743112,6,2006,1174,-20
87217306089,87217306090,1,1534,1204,-20
87219115830,87219115834,4,2226,1219,-20
87222191442,87222191446,4,2030,1565,-20
87223508221,87223508225,4,2293,1588,-20
87226664553,87226664555,2,1821,1607,-20
87227528823,87227528824,1,4551,22063,-20
87233504157,87233504158,1,1424,1791,-20
87233757266,87233757269,3,1112,1267,-20
87239317542,87239317547,5,1435,970,-20
87243070818,87243070823,5,918,1270,-20
87243256723,87243256716,-7,50467,22263,-20
87246822065,87246822070,5,1885,1288,-20
87248369664,87248369669,5,2350,1419,-20
87248813057,87248813066,9,1717,1527,-20
87249254362,87249254366,4,1865,1181,-20
87252253527,87252253529,2,952,1462,-20
87252536081,87252536083,2,1468,1319,-20
87253350074,87253350078,4,1789,1026,-20
87254582773,87254582777,4,1594,1141,-20
87264520534,87264520537,3,1959,1814,-20
87266297195,87266297199,4,1751,1212,-20
87268367504,87268367502,-2,1499,1394,-20
87268598504,87268598507,3,1596,1166,-20
87268943721,87268943724,3,1585,1184,-20
87270102809,87270102815,6,1888,1244,-20
87271741134,87271741137,3,1178,1387,-20
87274576426,87274576429,3,2040,1338,-20
87279198361,87279198365,4,3215,1420,-20
87280012294,87280012274,-20,1362,1626,-20
87280334459,87280334455,-4,1432,2200,-20
87281260850,87281260854,4,2166,2004,-20
87281909759,87281909763,4,2067,991,-20
87287718093,87287718096,3,1310,1114,-20
87289143693,87289143698,5,1537,802,-20
87289743113,87289743115,2,1571,1391,-20
87290555640,87290555642,2,2054,1190,-20
87290596525,87290596529,4,2395,1659,-20
87291487002,87291487002,0,1392,2347,-20
87292407098,87292407091,-7,1160,5269,-20
87297455515,87297455518,3,1134,1065,-20
87308078714,87308078717,3,1917,1723,-20
87308622850,87308622854,4,1550,1032,-20
87316550861,87316550866,5,2032,1116,-20
87324817125,87324817130,5,1383,1042,-20
87327974478,87327974479,1,1268,1049,-20
87329352612,87329352608,-4,21721,17494,-20
87330189897,87330189901,4,2182,1713,-20
87331898116,87331898123,7,5026,2241,-20
87336055904,87336055907,3,1889,1410,-20
87337520004,87337520006,2,2059,1579,-20
87339434395,87339434397,2,1218,1842,-20
87339484500,87339484501,1,1012,916,-20
87340610303,87340610306,3,2228,1513,-20
87340788322,87340788314,-8,707,335,-20
87346226946,87346226950,4,1867,1578,-20
87351348703,87351348706,3,2339,1160,-20
87352802042,87352802045,3,1795,1766,-20
87354017724,87354017730,6,1558,1156,-20
87358977670,87358977674,4,2519,1534,-20
87365322013,87365322018,5,1612,899,-20
87365532300,87365532302,2,1766,1528,-20
87367496722,87367496725,3,23494,116296,-20
87371891183,87371891186,3,1363,1367,-20
87372104282,87372104303,21,1672,1786,-20
87375538818,87375538821,3,1511,1403,-20
87376054278,87376054281,3,1604,1513,-20
87376483057,87376483058,1,1590,1165,-20
87378052554,87378052558,4,2600,1798,-20
87378085197,87378085201,4,1796,1823,-20
87378708463,87378708467,4,1679,1350,-20
87378755311,87378755291,-20,1553,1114,-20
87378799511,87378799514,3,2215,1352,-20
87379037954,87379037958,4,2491,1718,-20
87379950237,87379950241,4,2041,1651,-20
87379985220,87379985223,3,2190,1444,-20
87388123048,87388123045,-3,648,1563,-20
87390663361,87390663363,2,2610,2025,-20
87391585431,87391585435,4,1359,999,-20
87397290964,87397290967,3,1525,2002,-20
87397922587,87397922590,3,1367,666,-20
87398554214,87398554218,4,1478,962,-20
87399139558,87399139563,5,1287,919,-20
87399989694,87399989698,4,1318,1112,-20
87403260775,87403260779,4,1951,1539,-20
87403957537,87403957538,1,1584,1361,-20
87405086065,87405086070,5,3263,1767,-20
87405371857,87405371860,3,1356,1563,-20
87405409359,87405409370,11,1099,850,-20
87408320922,87408320925,3,3019,3092,-20
87411433340,87411433342,2,1531,1427,-20
87412473502,87412473505,3,2130,1713,-20
87414356219,87414356223,4,2066,1189,-20
87415502519,87415502522,3,1587,1055,-20
87416615253,87416615235,-18,1492,754,-20
87417972466,87417972465,-1,968,1995,-20
87419827782,87419827783,1,909,1133,-20
87421934134,87421934133,-1,2016,4612,-20
87421965575,87421965578,3,2039,1043,-20
87423106638,87423106641,3,1580,2061,-20
87424298199,87424298202,3,2591,1858,-20
87425241226,87425241230,4,1300,1256,-20
87425493156,87425493161,5,1634,1629,-20
87427578576,87427578579,3,2309,2162,-20
87429341188,87429341190,2,1976,1378,-20
87430221509,87430221510,1,2230,1534,-20
87430541111,87430541113,2,1990,1256,-20
87438018577,87438018581,4,1111,988,-20
87438492323,87438492338,15,1788,1700,-20
87440038846,87440038850,4,968,858,-20
87440466914,87440466916,2,1482,1417,-20
87440813433,87440813438,5,1396,1104,-20
87440936058,87440936064,6,1509,1397,-20
87441855631,87441855635,4,1830,1140,-20
87442882669,87442882671,2,1888,1720,-20
87443541584,87443541587,3,2426,1451,-20
87447233022,87447233026,4,2280,1351,-20
87449270236,87449270237,1,2036,1600,-20
87450938003,87450938005,2,1936,1361,-20
87454838671,87454838674,3,1554,1286,-20
87455117998,87455118002,4,1005,673,-20
87455470572,87455470577,5,2154,1305,-20
87456090319,87456090330,11,1262,1426,-20
87457505829,87457505831,2,1213,2094,-20
87460674260,87460674262,2,1845,1970,-20
87466434318,87466434321,3,1179,1382,-20
87467799791,87467799795,4,1843,1415,-20
87469552461,87469552462,1,1333,1144,-20
87470331445,87470331447,2,1912,1361,-20
87472412196,87472412199,3,1505,1406,-20
87473058299,87473058302,3,2087,1356,-20
87473966078,87473966083,5,2060,1439,-20
87474560465,87474560468,3,2136,1789,-20
87477506330,87477506333,3,1538,1523,-20
87478477154,87478477158,4,1633,1433,-20
87479707299,87479707299,0,1472,1243,-20
87480716497,87480716498,1,1983,1170,-20
87488844376,87488844379,3,1443,1380,-20
87491977539,87491977544,5,2111,1196,-20
87493005411,87493005415,4,1720,1222,-20
87496331281,87496331286,5,1934,1676,-20
87497078826,87497078830,4,1770,1443,-20
87498617485,87498617490,5,1280,1305,-20
87502005741,87502005761,20,997,2415,-20
87505417461,87505417468,7,2612,1365,-20
87508363730,87508363734,4,2023,1568,-20
87511148022,87511148025,3,3055,1789,-20
87511759105,87511759098,-7,1088,3846,-20
87513548137,87513548142,5,2550,1412,-20
87515856525,87515856529,4,1937,1492,-20
87516557006,87516557009,3,1798,1718,-20
87517405236,87517405239,3,2155,1526,-20
87519756950,87519756951,1,1593,1187,-20
87521496309,87521496306,-3,2005,4201,-20
87523895886,87523895886,0,2274,1291,-20
87524925701,87524925706,5,2026,1357,-20
87525461690,87525461690,0,1347,1620,-20
87526338941,87526338945,4,1945,1645,-20
87527619772,87527619774,2,1548,1337,-20
87531641727,87531641718,-9,30458,16183,-20
87536088023,87536088027,4,1583,1137,-20
87539616852,87539616857,5,2698,1192,-20
87540043797,87540043805,8,947,377,-20
87544354341,87544354342,1,2465,2583,-20
87545014975,87545014982,7,81574,38978,-20
87547473326,87547473331,5,1966,1007,-20
87548123190,87548123193,3,3805,2433,-20
87556073990,87556073994,4,1637,1393,-20
87556344798,87556344801,3,1967,1430,-20
87560689385,87560689386,1,2286,1618,-20
87562325484,87562325486,2,2282,1594,-20
87563418693,87563418675,-18,878,437,-20
87566619182,87566619186,4,3253,1528,-20
87567056908,87567056907,-1,1572,1548,-20
87569770282,87569770286,4,1343,1307,-20
87570067393,87570067378,-15,1269,535,-20
87570276505,87570276510,5,1468,1353,-20
87570401626,87570401643,17,17504,32601,-20
87573115298,87573115299,1,1666,1470,-20
87579638904,87579638898,-6,1994,6573,-20
87581161914,87581161916,2,1632,1375,-20
87583213331,87583213334,3,2105,1279,-20
87583395981,87583395983,2,1768,1226,-20
87588226012,87588226015,3,2316,2537,-20
87590053944,87590053948,4,2320,1651,-20
87591774509,87591774513,4,1460,1387,-20
87593258755,87593258759,4,2186,1455,-20
87595965873,87595965878,5,1800,1349,-20
87603350915,87603350918,3,570,882,-20
87607008617,87607008621,4,1484,1144,-20
87607462062,87607462066,4,3107,1649,-20
87608678453,87608678454,1,1652,1352,-20
87608778426,87608778411,-15,2280,1005,-20
87610253949,87610253950,1,1719,1014,-20
87610979882,87610979881,-1,1203,1678,-20
87618403644,87618403646,2,1430,940,-20
87621739223,87621739225,2,1716,1120,-20
87622032892,87622032894,2,1939,1386,-20
87624296089,87624296092,3,3652,3149,-20
87625793003,87625793005,2,1623,970,-20
87626724782,87626724786,4,1950,1261,-20
87628059834,87628059839,5,2324,1772,-20
87628873702,87628873706,4,1961,1766,-20
87630353221,87630353224,3,2422,2163,-20
87633524582,87633524586,4,1874,1566,-20
87633549855,87633549858,3,1515,1579,-20
87635161600,87635161603,3,1755,1194,-20
87636717902,87636717906,4,2110,1663,-20
87638854449,87638854453,4,2328,1791,-20
87641146947,87641146949,2,908,1572,-20
87643071856,87643071862,6,1663,1063,-20
87644694867,87644694869,2,1380,996,-20
87647660998,87647660994,-4,1118,2366,-20
87650085725,87650085730,5,1612,1647,-20
87651245201,87651245203,2,2008,1052,-20
87653543519,87653543523,4,1731,1498,-20
87654689419,87654689424,5,1937,1599,-20
87659375920,87659375922,2,1531,1250,-20
87663353857,87663353859,2,1214,950,-20
87665074059,87665074062,3,1473,1233,-20
87665105809,87665105814,5,1606,1090,-20
87667136566,87667136568,2,1552,1659,-20
87668213338,87668213341,3,1618,1474,-20
87669446746,87669446751,5,2628,1098,-20
87674404945,87674404948,3,1370,899,-20
87674863770,87674863774,4,1827,1457,-20
87678923113,87678923117,4,1731,1415,-20
87679311517,87679311521,4,2136,1598,-20
87680729110,87680729114,4,1346,866,-20
87683240383,87683240370,-13,1962,1326,-20
87685201895,87685201901,6,1106,837,-20
87688772525,87688772527,2,1817,1488,-20
87691983582,87691983586,4,1466,1635,-20
87693777697,87693777705,8,2494,1586,-20
87697725155,87697725162,7,3236,1270,-20
87699143681,87699143684,3,3197,1995,-20
87700883098,87700883102,4,1754,1590,-20
87707224542,87707224546,4,2772,2141,-20
87711974550,87711974551,1,1360,1103,-20
87722761476,87722761480,4,1932,1548,-20
87723115094,87723115096,2,2003,1862,-20
87726235178,87726235179,1,1590,1433,-20
87726735231,87726735235,4,1067,985,-20
87727407006,87727407009,3,1788,1275,-20
87727438532,87727438535,3,2081,1591,-20
87737525085,87737525095,10,1037,414,-20
87740419905,87740419908,3,1504,933,-20
87740741970,87740741966,-4,1005,4938,-20
87741947138,87741947143,5,1745,1356,-20
87743635919,87743635916,-3,1402,4563,-20
87750550031,87750550034,3,1525,1359,-20
87750747859,87750747862,3,1954,1457,-20
87752361035,87752361038,3,2159,1536,-20
87752683106,87752683111,5,2196,1692,-20
87754352491,87754352494,3,1379,1494,-20
87762468522,87762468525,3,962,1094,-20
87764772274,87764772275,1,1682,1741,-20
87770571175,87770571178,3,1492,1224,-20
87771460272,87771460275,3,1445,1308,-20
87774254854,87774254858,4,2068,1318,-20
87775033197,87775033199,2,1569,1273,-20
87776534899,87776534902,3,1217,737,-20
87776710678,87776710697,19,1498,1250,-20
87777181139,87777181137,-2,860,2094,-20
87778507532,87778507536,4,1440,1326,-20
87782239131,87782239134,3,3474,2766,-20
87784750010,87784750011,1,2295,1731,-20
87786066777,87786066781,4,1824,1029,-20
87786173659,87786173651,-8,765,216,-20
87789166769,87789166766,-3,757,2212,-20
87790241306,87790241306,0,1761,1261,-20
87791614475,87791614478,3,1323,1137,-20
87799055209,87799055210,1,2018,1607,-20
87799105432,87799105441,9,1663,980,-20
87799928224,87799928227,3,1710,2303,-20
87803328318,87803328318,0,1019,743,-20
87804250593,87804250595,2,1618,1485,-20
87805051692,87805051685,-7,2654,8627,-20
87811879084,87811879086,2,1104,790,-20
87812984177,87812984179,2,1313,1419,-20
87813520234,87813520238,4,1087,1147,-20
87813912200,87813912201,1,1569,1526,-20
87815531793,87815531795,2,454,272,-20
87817040697,87817040701,4,2066,1481,-20
87820606403,87820606406,3,1543,1050,-20
87821241573,87821241576,3,1351,1159,-20
87821604478,87821604483,5,1955,1175,-20
87824058217,87824058221,4,1465,1268,-20
87827645838,87827645842,4,1827,1547,-20
87829266284,87829266288,4,1593,915,-20
87829616192,87829616194,2,1360,1088,-20
87835387099,87835387103,4,1913,1256,-20
87836839770,87836839776,6,2065,1786,-20
87837273045,87837273050,5,1496,1037,-20
87837320357,87837320358,1,1641,1551,-20
87842758157,87842758163,6,3131,1327,-20
87843148079,87843148083,4,2520,1655,-20
87843317058,87843317062,4,2504,2250,-20
87848612185,87848612188,3,1602,1091,-20
87849250554,87849250559,5,2327,1563,-20
87849443172,87849443174,2,2142,1761,-20
87850605325,87850605326,1,2306,1347,-20
87856828081,87856828083,2,2039,1412,-20
87859734650,87859734654,4,1289,1520,-20
87863721583,87863721586,3,2278,1773,-20
87867009098,87867009090,-8,777,3064,-20
87867600481,87867600475,-6,1804,1031,-20
87872670323,87872670326,3,1608,1520,-20
87875064438,87875064442,4,2287,1834,-20
87876218277,87876218283,6,1828,1266,-20
87877103846,87877103850,4,1367,1163,-20
87879559158,87879559159,1,1513,1170,-20
87882325689,87882325693,4,1324,928,-20
87883012241,87883012244,3,1643,1251,-20
87888121351,87888121356,5,1607,1309,-20
87888302040,87888302043,3,1277,1402,-20
87890832495,87890832499,4,2100,1356,-20
87891174957,87891174960,3,2169,1399,-20
87900725436,87900725436,0,1556,2156,-20
87903291840,87903291847,7,25304,56725,-20
87909478901,87909478903,2,1854,1729,-20
87909627780,87909627783,3,1310,1124,-20
87909723994,87909723993,-1,3057,4118,-20
87910054826,87910054829,3,2312,1503,-20
87910141842,87910141826,-16,1462,809,-20
87911082558,87911082558,0,1586,1546,-20
87912770366,87912770371,5,1670,1617,-20
87914714522,87914714525,3,1644,990,-20
87914889695,87914889699,4,1233,933,-20
87917838470,87917838475,5,2408,1310,-20
87917974443,87917974447,4,1930,1768,-20
87919259647,87919259652,5,948,748,-20
87919946025,87919946027,2,1408,1426,-20
87921132168,87921132176,8,18978,24080,-20
87923457062,87923457067,5,4069,2574,-20
87925526237,87925526240,3,2030,1493,-20
87925691866,87925691865,-1,1945,2735,-20
87927919730,87927919734,4,1922,1532,-20
87933404069,87933404073,4,1251,787,-20
87935892555,87935892559,4,1626,1161,-20
87938415657,87938415654,-3,2115,5686,-20
87939569798,87939569801,3,2036,2344,-20
87941374258,87941374262,4,2956,1304,-20
87943744291,87943744294,3,1056,815,-20
87944406311,87944406328,17,1652,1005,-20
87944869838,87944869840,2,2522,2492,-20
87949046541,87949046545,4,1752,1726,-20
87955509052,87955509046,-6,1524,5918,-20
87956189970,87956189963,-7,1305,6129,-20
87957363490,87957363494,4,2158,2048,-20
87958365294,87958365298,4,1257,1196,-20
87965973595,87965973579,-16,1563,1459,-20
87966647421,87966647442,21,1480,1602,-20
87968012400,87968012403,3,1310,1384,-20
87968988450,87968988451,1,1363,1251,-20
87969073429,87969073432,3,1998,1708,-20
87970187686,87970187691,5,1832,999,-20
87971570009,87971570018,9,911,244,-20
87973137387,87973137391,4,1409,1203,-20
87973308454,87973308433,-21,986,487,-20
87974938958,87974938963,5,1671,959,-20
87975111450,87975111455,5,2129,1643,-20
87977506489,87977506490,1,2163,1981,-20
87979872450,87979872455,5,2013,1188,-20
87987119362,87987119370,8,3654,1217,-20
87987677328,87987677330,2,1247,1328,-20
87989300417,87989300421,4,1502,1236,-20
87994042502,87994042506,4,2343,1444,-20
87994605056,87994605061,5,1378,1186,-20
87995461819,87995461821,2,1922,2272,-20
87998330902,87998330906,4,1271,967,-20
88003595191,88003595195,4,2131,1343,-20
88004816908,88004816911,3,1459,1420,-20
88006499918,88006499918,0,1157,1246,-20
88013123863,88013123866,3,1191,787,-20
88014397815,88014397818,3,1578,1013,-20
88015221878,88015221879,1,1329,1711,-20
88017596575,88017596575,0,926,1231,-20
88018078738,88018078741,3,1776,1824,-20
88018923065,88018923069,4,1945,1716,-20
88019702592,88019702595,3,2057,1289,-20
88025358189,88025358185,-4,1344,3453,-20
88027805145,88027805149,4,2719,1625,-20
88027858193,88027858196,3,1716,897,-20
88028184477,88028184481,4,1333,775,-20
88028822837,88028822843,6,26896,38903,-20
88029516614,88029516619,5,1686,1004,-20
88031236642,88031236645,3,1300,1623,-20
88032053978,88032053981,3,1719,1279,-20
88033364217,88033364221,4,2452,1359,-20
88037616602,88037616606,4,1268,1070,-20
88040923277,88040923281,4,2129,1674,-20
88044940735,88044940737,2,1168,1350,-20
88050473123,88050473128,5,2127,1513,-20
88050786469,88050786470,1,1048,1069,-20
88051435787,88051435789,2,1606,1555,-20
88051562542,88051562547,5,2126,1591,-20
88062058651,88062058654,3,1674,890,-20
88065098660,88065098664,4,1472,1316,-20
88066470113,88066470115,2,2624,1537,-20
88069338606,88069338610,4,1434,1081,-20
88073119677,88073119679,2,1364,1363,-20
88073367918,88073367922,4,2076,1773,-20
88074891346,88074891351,5,2328,1541,-20
88076578618,88076578618,0,1706,1567,-20
88076934680,88076934686,6,2341,871,-20
88077197490,88077197507,17,1744,1507,-20
88080690848,88080690850,2,1410,1292,-20
88086054340,88086054342,2,1197,1149,-20
88092689751,88092689754,3,2243,2119,-20
88093334715,88093334694,-21,1441,953,-20
88095015843,88095015846,3,1843,1472,-20
88101642070,88101642074,4,1996,1616,-20
88103804482,88103804483,1,1505,1471,-20
88104256816,88104256819,3,1924,1805,-20
88104395921,88104395923,2,1174,689,-20
88104660958,88104660961,3,1824,1590,-20
88105516256,88105516260,4,2331,2022,-20
88106262274,88106262282,8,4479,1645,-20
88112543209,88112543211,2,1819,1353,-20
88113791671,88113791675,4,982,1357,-20
88115546018,88115546022,4,1537,1069,-20
88116310139,88116310154,15,1312,1319,-20
88116787506,88116787510,4,1529,1328,-20
88120203743,88120203747,4,2762,1520,-20
88122163613,88122163619,6,2364,1094,-20
88131234354,88131234358,4,1261,1447,-20
88132828335,88132828338,3,649,863,-20
88134914655,88134914656,1,2866,3217,-20
88137344805,88137344807,2,1783,1732,-20
88139130419,88139130417,-2,1622,1788,-20
88139352121,88139352123,2,2025,1493,-20
88145304805,88145304807,2,2169,1862,-20
88147977178,88147977183,5,1474,1337,-20
88148984640,88148984643,3,1840,1497,-20
88152072226,88152072233,7,1132,1007,-20
88154790279,88154790283,4,1543,1431,-20
88156719059,88156719063,4,2552,1432,-20
88161534462,88161534466,4,2386,1491,-20
88162647298,88162647301,3,2130,1409,-20
88164352405,88164352409,4,1791,1427,-20
88166601734,88166601737,3,1908,1487,-20
88168083331,88168083336,5,1731,1342,-20
88169604273,88169604275,2,1754,1596,-20
88178209738,88178209743,5,1415,1201,-20
88178292531,88178292514,-17,334,496,-20
88180786745,88180786750,5,2736,2146,-20
88181224687,88181224690,3,1179,879,-20
88185791278,88185791279,1,1247,991,-20
88186300253,88186300258,5,1858,886,-20
88187276864,88187276868,4,1628,1514,-20
88188608751,88188608748,-3,1153,1639,-20
88189700642,88189700645,3,1688,1469,-20
88189736962,88189736962,0,1461,1146,-20
88190684158,88190684162,4,2902,1641,-20
88191789504,88191789506,2,1473,1323,-20
88192571911,88192571915,4,1582,1791,-20
88192617218,88192617222,4,1427,1355,-20
88193203374,88193203379,5,2096,1213,-20
88194220768,88194220770,2,1695,1311,-20
88194534105,88194534109,4,2399,1272,-20
88199449242,88199449246,4,1686,1171,-20
88200594912,88200594931,19,1991,1333,-20
88204061307,88204061301,-6,3053,12924,-20
88205025996,88205025991,-5,940,2780,-20
88207724200,88207724202,2,2071,2137,-20
88210523133,88210523135,2,2142,1474,-20
88211797297,88211797299,2,519,278,-20
88212486229,88212486230,1,1305,1173,-20
88213377564,88213377569,5,1241,602,-20
88214974000,88214974002,2,1859,1554,-20
88215200117,88215200118,1,1385,1276,-20
88220628786,88220628790,4,1453,911,-20
88221202323,88221202327,4,2171,1271,-20
88222122834,88222122836,2,1803,1825,-20
88222465349,88222465351,2,1143,1174,-20
88223724489,88223724492,3,1900,1701,-20
88226768974,88226768979,5,1913,1661,-20
88228322411,88228322414,3,1469,1449,-20
88228465009,88228465010,1,1639,1118,-20
88236392584,88236392589,5,1214,758,-20
88238213361,88238213365,4,2777,2748,-20
88240576793,88240576797,4,3474,1725,-20
88241223855,88241223861,6,35989,20186,-20
88242298173,88242298175,2,1251,898,-20
88242794251,88242794252,1,1474,1109,-20
88243189447,88243189452,5,1175,1351,-20
88245104457,88245104461,4,568,420,-20
88247601955,88247601960,5,2095,1539,-20
88248254622,88248254623,1,1565,1064,-20
88249572565,88249572569,4,2032,1587,-20
88250604085,88250604067,-18,1660,1514,-20
88252515926,88252515929,3,1844,1498,-20
88256298454,88256298458,4,2076,1416,-20
88256953622,88256953625,3,2150,1423,-20
88258944605,88258944608,3,1747,1452,-20
88259370985,88259370990,5,2159,1401,-20
88265290469,88265290472,3,1474,1162,-20
88267932429,88267932434,5,2397,1438,-20
88268177043,88268177048,5,1401,1750,-20
88269895109,88269895113,4,2432,1092,-20
88270208973,88270208976,3,1893,1409,-20
88275323565,88275323569,4,2861,2156,-20
88283245470,88283245473,3,1469,1528,-20
88285818558,88285818563,5,1479,1132,-20
88289271277,88289271280,3,1810,1432,-20
88291263888,88291263891,3,1474,1277,-20
88291310185,88291310189,4,2159,1239,-20
88293675322,88293675326,4,1780,1630,-20
88294195474,88294195478,4,1662,1298,-20
88294835010,88294835014,4,1606,1553,-20
88295935118,88295935121,3,3914,3441,-20
88300241401,88300241407,6,2055,1221,-20
88300768451,88300768455,4,1923,1405,-20
88301341643,88301341646,3,1654,1377,-20
88301469575,88301469579,4,1851,1208,-20
88307454597,88307454600,3,2191,1684,-20
88309231775,88309231779,4,1585,952,-20
88310065500,88310065502,2,1687,1109,-20
88313438291,88313438294,3,938,957,-20
88316647591,88316647589,-2,1426,1513,-20
88317606770,88317606772,2,1164,1384,-20
88317884154,88317884138,-16,1961,1351,-20
88319722986,88319722990,4,1603,1418,-20
88322422441,88322422442,1,1365,1397,-20
88326185579,88326185582,3,1926,1200,-20
88327970810,88327970811,1,1782,1172,-20
88331445680,88331445684,4,2355,1326,-20
88332470034,88332470037,3,1546,1588,-20
88335251191,88335251189,-2,1782,3644,-20
88335442260,88335442267,7,10170,3027,-20
88341030949,88341030952,3,2261,1330,-20
88341096949,88341096932,-17,1290,1152,-20
88342419630,88342419634,4,2053,1441,-20
88344469784,88344469790,6,1783,1502,-20
88344890881,88344890865,-16,3122,1490,-20
88346719062,88346719065,3,1289,1380,-20
88347705307,88347705309,2,1941,1468,-20
88348131508,88348131512,4,1182,1447,-20
88353552990,88353552993,3,1898,1464,-20
88354528414,88354528418,4,2277,2028,-20
88355953259,88355953262,3,1483,1316,-20
88357820769,88357820771,2,1416,1590,-20
88361296306,88361296305,-1,1373,2711,-20
88363780729,88363780712,-17,1756,1262,-20
88365122406,88365122408,2,1655,1152,-20
88367306838,88367306841,3,2761,1854,-20
88369286791,88369286795,4,2314,1229,-20
88372018956,88372018958,2,1856,1416,-20
88372082226,88372082242,16,667,308,-20
88373473594,88373473587,-7,853,4343,-20
88378640034,88378640038,4,1417,1255,-20
88379711035,88379711039,4,2041,1209,-20
88380845257,88380845261,4,1616,965,-20
88389967258,88389967262,4,1638,1807,-20
88391722350,88391722353,3,1442,1623,-20
88396477122,88396477125,3,1724,1372,-20
88397155250,88397155255,5,2070,1600,-20
88399195422,88399195423,1,1719,1582,-20
88399641456,88399641458,2,2160,1689,-20
88405522622,88405522627,5,2115,1702,-20
88411421205,88411421207,2,2046,1028,-20
88412108773,88412108777,4,2115,1074,-20
88415241984,88415241987,3,2153,1892,-20
88415554365,88415554369,4,1940,2053,-20
88416057553,88416057558,5,1715,1231,-20
88416300402,88416300410,8,1226,1459,-20
88416838630,88416838612,-18,928,906,-20
88420275067,88420275071,4,2314,1877,-20
88420453657,88420453659,2,2062,1565,-20
88421864094,88421864094,0,1287,1921,-20
88423469638,88423469639,1,2001,1255,-20
88426031950,88426031955,5,2298,1848,-20
88426381239,88426381243,4,2146,1234,-20
88426934201,88426934205,4,1407,1593,-20
88427757059,88427757059,0,1352,1670,-20
88433680732,88433680734,2,1983,1527,-20
88436904603,88436904606,3,2281,1652,-20
88440136897,88440136892,-5,891,3688,-20
88442841695,88442841700,5,2093,1278,-20
88444184946,88444184951,5,1705,1330,-20
88446489913,88446489916,3,2079,1770,-20
88454890453,88454890462,9,1913,1720,-20
88456272906,88456272908,2,1493,1189,-20
88458462585,88458462589,4,1936,1447,-20
88458664606,88458664610,4,2078,1869,-20
88459940908,88459940910,2,1685,1243,-20
88468135948,88468135951,3,2301,1453,-20
88471957614,88471957617,3,1705,1824,-20
88472401948,88472401950,2,2348,1991,-20
88477908070,88477908071,1,1810,1714,-20
88480502338,88480502341,3,1553,1086,-20
88482025958,88482025962,4,1872,969,-20
88484531407,88484531411,4,2033,1685,-20
88486632828,88486632830,2,2042,1577,-20
88487332412,88487332414,2,2360,1616,-20
88489056891,88489056894,3,1579,1401,-20
88493619029,88493619031,2,1511,793,-20
88494215069,88494215069,0,1104,1322,-20
88497425639,88497425645,6,1563,1176,-20
88498736224,88498736227,3,1997,1584,-20
88498802851,88498802854,3,2237,1418,-20
88500781437,88500781442,5,2324,1692,-20
88500815209,88500815211,2,1447,1061,-20
88501698570,88501698564,-6,942,3347,-20
88502731589,88502731593,4,1861,1304,-20
88503830510,88503830513,3,1776,1210,-20
88505627716,88505627719,3,1871,1358,-20
88506830598,88506830603,5,1637,1397,-20
88511406874,88511406878,4,1936,1095,-20
88513091971,88513091974,3,1497,876,-20
88514677544,88514677546,2,2626,1946,-20
88515429139,88515429142,3,2691,1579,-20
88522161576,88522161578,2,1700,1211,-20
88523152905,88523152912,7,2930,1270,-20
88523509759,88523509761,2,1724,1498,-20
88524471778,88524471781,3,2247,1505,-20
88524705796,88524705797,1,1786,1348,-20
88524922169,88524922172,3,1742,1158,-20
88529574030,88529574030,0,1748,1301,-20
88530779183,88530779187,4,1373,1507,-20
88531830010,88531830014,4,1698,1385,-20
88531952478,88531952483,5,1586,1106,-20
88534406474,88534406479,5,1550,1025,-20
88538281170,88538281171,1,2537,1470,-20
88538368153,88538368151,-2,1254,1496,-20
88540270690,88540270694,4,1767,1589,-20
88541346354,88541346358,4,2362,1141,-20
88549050850,88549050854,4,1284,945,-20
88549497489,88549497491,2,1611,1101,-20
88550084594,88550084577,-17,3578,1308,-20
88555823342,88555823345,3,1300,1002,-20
88556291847,88556291849,2,1192,1482,-20
88557060398,88557060402,4,2077,1798,-20
88562879114,88562879118,4,2279,1242,-20
88563960095,88563960098,3,1642,1579,-20
88567408117,88567408119,2,2469,1681,-20
88567716654,88567716658,4,1615,1559,-20
88570509966,88570509970,4,2892,1711,-20
88570879845,88570879851,6,2569,925,-20
88575712334,88575712335,1,1536,2208,-20
88576344786,88576344786,0,1528,1890,-20
88576458228,88576458231,3,1476,1521,-20
88577864314,88577864319,5,1408,1400,-20
88578035582,88578035588,6,1934,1329,-20
88585577509,88585577513,4,1793,1569,-20
88588854790,88588854771,-19,1369,1401,-20
88593501244,88593501246,2,2976,1689,-20
88594340523,88594340526,3,1558,1881,-20
88599290076,88599290080,4,1782,1824,-20
88603162115,88603162119,4,1740,1098,-20
88604300062,88604300066,4,2246,1718,-20
88605417210,88605417214,4,1940,1201,-20
88608148704,88608148706,2,1329,1401,-20
88609868329,88609868335,6,3279,1345,-20
88611737730,88611737734,4,1785,1596,-20
88613413252,88613413256,4,1782,1307,-20
88613596730,88613596733,3,2418,1845,-20
88616997359,88616997362,3,1768,1367,-20
88617087104,88617087107,3,1289,1252,-20
88618510048,88618510051,3,1837,1445,-20
88619372890,88619372889,-1,2558,3946,-20
88620588649,88620588654,5,1005,1415,-20
88622121515,88622121518,3,1690,1916,-20
88623688037,88623688039,2,2226,1649,-20
88623792841,88623792845,4,1809,1376,-20
88629673614,88629673619,5,1830,1432,-20
88632420645,88632420647,2,1297,1465,-20
88638261695,88638261690,-5,1519,5235,-20
88639807549,88639807550,1,1648,1374,-20
88640229471,88640229475,4,1308,921,-20
88644185927,88644185930,3,2493,2075,-20
88644233208,88644233212,4,2968,2046,-20
88645780106,88645780110,4,1929,1413,-20
88647317750,88647317755,5,1460,1225,-20
88647893742,88647893740,-2,1091,2394,-20
88649454236,88649454239,3,1441,1565,-20
88653201746,88653201745,-1,1480,2052,-20
88654221510,88654221514,4,1928,2039,-20
88655897255,88655897259,4,1665,978,-20
88655938360,88655938370,10,1957,1505,-20
88656342531,88656342535,4,2155,1751,-20
88656954658,88656954663,5,1818,1496,-20
88657989013,88657989017,4,1641,1192,-20
88660124754,88660124760,6,1808,1023,-20
88660812882,88660812865,-17,512,673,-20
88662999899,88662999903,4,1869,1469,-20
88669086920,88669086922,2,1609,1443,-20
88672377599,88672377602,3,2395,1493,-20
88674681561,88674681565,4,2366,1943,-20
88675230298,88675230304,6,1982,1238,-20
88675336073,88675336078,5,1299,1353,-20
88680014753,88680014758,5,1588,1053,-20
88682196014,88682196018,4,1677,1313,-20
88685041081,88685041089,8,3251,1157,-20
88686206402,88686206413,11,1327,1331,-20
88686553840,88686553834,-6,1444,6428,-20
88689272950,88689272945,-5,2158,6917,-20
88691726170,88691726174,4,2463,1522,-20
88692501471,88692501464,-7,1293,3261,-20
88693685299,88693685300,1,1469,1305,-20
88695113550,88695113554,4,1504,1254,-20
88695241510,88695241515,5,1486,1435,-20
88702205887,88702205887,0,1101,1799,-20
88708420187,88708420190,3,1869,1322,-20
88710277029,88710277041,12,1662,1573,-20
88710487182,88710487162,-20,2141,1293,-20
88711086026,88711086029,3,2049,1613,-20
88713825858,88713825858,0,1239,2151,-20
88717456335,88717456334,-1,1435,2198,-20
88718621766,88718621760,-6,998,3517,-20
88719548033,88719548034,1,1498,1944,-20
88719720637,88719720641,4,1785,1046,-20
88721717313,88721717314,1,1504,1396,-20
88729403629,88729403632,3,1745,852,-20
88729725347,88729725350,3,1674,1215,-20
88732800819,88732800822,3,1914,1230,-20
88734777351,88734777348,-3,1077,2623,-20
88739920437,88739920441,4,1839,1716,-20
88744473671,88744473674,3,2127,1625,-20
88744610890,88744610895,5,1360,792,-20
88747626047,88747626049,2,2591,1579,-20
88749180753,88749180754,1,2264,1701,-20
88750883463,88750883465,2,1699,1795,-20
88751282384,88751282386,2,1552,1375,-20
88752103429,88752103431,2,23553,20774,-20
88753744887,88753744891,4,1701,1387,-20
88753791996,88753792000,4,1866,1460,-20
88754241700,88754241701,1,1451,1421,-20
88755503061,88755503064,3,1666,1434,-20
88758207469,88758207471,2,1839,1449,-20
88759059481,88759059482,1,1805,1429,-20
88760259639,88760259642,3,1895,1376,-20
88763091926,88763091927,1,1542,1634,-20
88763291680,88763291685,5,1634,980,-20
88764382937,88764382940,3,1415,1230,-20
88767135361,88767135364,3,1879,1293,-20
88767229195,88767229177,-18,1263,1081,-20
88767311831,88767311833,2,1381,1224,-20
88768682890,88768682894,4,1882,1391,-20
88769483054,88769483058,4,1740,1274,-20
88770914198,88770914203,5,1775,1591,-20
88770968638,88770968642,4,1178,988,-20
88772721027,88772721029,2,1777,1650,-20
88773338889,88773338893,4,1915,1616,-20
88775292177,88775292178,1,1232,1897,-20
88776384074,88776384078,4,1945,1174,-20
88776665877,88776665859,-18,1720,1110,-20
88778141687,88778141689,2,1726,1230,-20
88788473507,88788473510,3,1767,1439,-20
88789390937,88789390920,-17,106,1428,-20
88795089392,88795089398,6,6158,2861,-20
88795954094,88795954097,3,2079,1227,-20
88796147818,88796147823,5,1841,1445,-20
88799520029,88799520034,5,2133,1138,-20
88800168686,88800168690,4,2634,1530,-20
88801260920,88801260926,6,2070,1324,-20
88802120580,88802120585,5,2135,1970,-20
88802910009,88802910019,10,1704,1634,-20
88804798540,88804798543,3,1904,1557,-20
88806109151,88806109155,4,2626,980,-20
88808964819,88808964823,4,1526,1346,-20
88812034470,88812034475,5,1816,1377,-20
88812503353,88812503355,2,1394,1237,-20
88812701061,88812701043,-18,1626,838,-20
88813431303,88813431308,5,909,1393,-20
88819776586,88819776587,1,2163,1835,-20
88820716951,88820716955,4,2327,1923,-20
88822296709,88822296713,4,2322,1042,-20
88822343180,88822343203,23,2887,1651,-20
88824248593,88824248597,4,2102,1381,-20
88824971409,88824971411,2,2812,1449,-20
88825463870,88825463875,5,1927,1427,-20
88828002949,88828002951,2,1543,1073,-20
88828082859,88828082868,9,12872,37434,-20
88830302252,88830302255,3,1327,1164,-20
88830881128,88830881122,-6,1687,7352,-20
88834323735,88834323739,4,1476,1274,-20
88834994918,88834994922,4,1308,1774,-20
88835212022,88835212023,1,1831,1236,-20
88837212706,88837212710,4,1772,1045,-20
88838017958,88838017963,5,1875,1462,-20
88845299988,88845299995,7,2247,816,-20
88848963068,88848963070,2,1721,1107,-20
88854830797,88854830798,1,1916,1682,-20
88854936169,88854936176,7,2026,1205,-20
88856002229,88856002230,1,1285,1386,-20
88857943833,88857943836,3,1520,1312,-20
88867223954,88867223959,5,2290,1723,-20
88871500550,88871500554,4,2603,1507,-20
88872457056,88872457060,4,1970,1643,-20
88874224751,88874224755,4,1603,1419,-20
88877542359,88877542361,2,25916,82221,-20
88879762181,88879762183,2,1789,1064,-20
88880452666,88880452670,4,1567,1600,-20
88882479285,88882479289,4,1924,1404,-20
88883359743,88883359746,3,1451,1549,-20
88887176371,88887176374,3,1588,1197,-20
88888561638,88888561641,3,1372,1163,-20
88889035959,88889035962,3,2483,1838,-20
88889858362,88889858366,4,1532,1431,-20
88890634663,88890634661,-2,1164,2413,-20
88890770019,88890770000,-19,2012,1347,-20
88891531893,88891531898,5,1508,1154,-20
88893064779,88893064786,7,3383,1482,-20
88894371018,88894371019,1,1378,1570,-20
88899730069,88899730074,5,2151,1390,-20
88899954241,88899954256,15,2279,1245,-20
88905009222,88905009227,5,2382,1456,-20
88906175071,88906175074,3,1675,1308,-20
88906359434,88906359437,3,1382,1405,-20
88907978501,88907978504,3,1541,1656,-20
88908080814,88908080817,3,1725,1479,-20
88909423270,88909423274,4,992,1089,-20
88916839456,88916839458,2,1197,1131,-20
88921859034,88921859028,-6,2150,7045,-20
88922504258,88922504263,5,1939,1009,-20
88924693001,88924693006,5,2449,1871,-20
88928767266,88928767266,0,1788,1440,-20
88932149544,88932149546,2,1586,1557,-20
88932896681,88932896690,9,2605,1562,-20
88933707538,88933707542,4,1295,1484,-20
88934498308,88934498309,1,2112,1149,-20
88934614186,88934614201,15,484,230,-20
88935621938,88935621942,4,1849,1253,-20
88938759040,88938759042,2,1543,1074,-20
88940056568,88940056561,-7,1609,7385,-20
88943444236,88943444239,3,1602,1205,-20
88944037352,88944037355,3,1766,1349,-20
88950429076,88950429079,3,1912,1717,-20
88951263195,88951263198,3,1876,965,-20
88957729630,88957729635,5,2132,1788,-20
88957997236,88957997238,2,1572,1237,-20
88960454106,88960454108,2,1533,1703,-20
88960807113,88960807118,5,2874,1685,-20
88963802931,88963802928,-3,1414,2665,-20
88965360389,88965360394,5,3589,2284,-20
88970945317,88970945321,4,1341,1286,-20
88972612030,88972612030,0,1467,1701,-20
88973238208,88973238212,4,2036,1577,-20
88973465933,88973465934,1,1346,1823,-20
88974025979,88974025983,4,2268,1367,-20
88974196358,88974196362,4,1046,804,-20
88975597906,88975597910,4,1943,1857,-20
88983283420,88983283422,2,1498,1644,-20
88987533487,88987533492,5,1657,1469,-20
88988334550,88988334554,4,1754,2054,-20
88989141099,88989141103,4,1757,1433,-20
88991471003,88991471010,7,2141,1139,-20
88995215760,88995215782,22,1497,1386,-20
88997773782,88997773786,4,1583,1240,-20
89000079157,89000079157,0,1034,1513,-20
89007222311,89007222309,-2,1409,2211,-20
89014381434,89014381439,5,1238,1017,-20
89016115717,89016115722,5,2105,1331,-20
89019516266,89019516270,4,1473,1374,-20
89021963580,89021963583,3,1558,1475,-20
89029698356,89029698348,-8,13,1291,-20
89030183351,89030183355,4,1662,1434,-20
89031251660,89031251650,-10,1156,1679,-20
89033316638,89033316642,4,2498,1518,-20
89034362839,89034362834,-5,3849,9193,-20
89034471779,89034471781,2,1810,1177,-20
89034591806,89034591800,-6,2440,8384,-20
89036345007,89036345010,3,1689,1973,-20
89041353971,89041353977,6,5841,2732,-20
89041694465,89041694467,2,1559,1075,-20
89042618820,89042618825,5,1679,1324,-20
89047820631,89047820634,3,1787,1293,-20
89048450643,89048450646,3,2630,1413,-20
89050855814,89050855817,3,1435,1464,-20
89056933029,89056933032,3,2190,1259,-20
89058896138,89058896141,3,1128,1375,-20
89062712607,89062712610,3,1401,1208,-20
89072053377,89072053371,-6,23394,14601,-20
89077354877,89077354883,6,2060,1260,-20
89086739811,89086739816,5,1750,1478,-20
89094876094,89094876099,5,2766,1409,-20
89097733265,89097733264,-1,1250,1153,-20
89098496608,89098496613,5,1617,1247,-20
89099115354,89099115358,4,1964,1385,-20
89103009435,89103009437,2,1791,1321,-20
89103302830,89103302833,3,2879,2317,-20
89110573377,89110573380,3,1979,1521,-20
89111911241,89111911246,5,2121,1788,-20
89112299783,89112299785,2,1701,1652,-20
89117697207,89117697222,15,1078,920,-20
89118601563,89118601566,3,2175,1206,-20
89119129698,89119129701,3,1632,1279,-20
89119658058,89119658061,3,1959,1262,-20
89121984739,89121984743,4,2897,1940,-20
89125319369,89125319373,4,2511,1822,-20
89125998953,89125998958,5,1099,838,-20
89131199923,89131199927,4,1483,1402,-20
89132269500,89132269484,-16,3447,552,-20
89132726696,89132726697,1,1950,1420,-20
89133666418,89133666424,6,2502,1623,-20
89137024547,89137024551,4,2459,1718,-20
89138464316,89138464318,2,1859,1201,-20
89139545223,89139545218,-5,735,1807,-20
89140076183,89140076185,2,2321,1980,-20
89140881082,89140881083,1,1193,2189,-20
89141015678,89141015685,7,2222,1231,-20
89141193442,89141193447,5,1253,1031,-20
89143299854,89143299858,4,1638,1753,-20
89143643348,89143643351,3,1237,1278,-20
89144162337,89144162342,5,1887,1464,-20
89145744570,89145744574,4,1828,1418,-20
89146049881,89146049882,1,1846,1460,-20
89147417269,89147417269,0,1570,1629,-20
89148123637,89148123641,4,1998,1751,-20
89152366165,89152366169,4,1747,1449,-20
89153858939,89153858944,5,2090,1798,-20
89154327063,89154327066,3,1899,1682,-20
89154628189,89154628192,3,1474,1497,-20
89155458196,89155458198,2,2539,1942,-20
89162000965,89162000968,3,1898,1620,-20
89162654590,89162654596,6,1607,1025,-20
89166066812,89166066814,2,2162,1984,-20
89167003574,89167003578,4,993,1430,-20
89169895706,89169895710,4,1746,1187,-20
89172652909,89172652914,5,1080,1840,-20
89174580435,89174580438,3,4032,3392,-20
89175578312,89175578315,3,1671,1430,-20
89176036183,89176036186,3,1993,1421,-20
89177591475,89177591474,-1,1275,1253,-20
89180023386,89180023387,1,1889,1588,-20
89181803882,89181803889,7,2199,1429,-20
89187783942,89187783947,5,1729,1477,-20
89190358135,89190358140,5,1374,1574,-20
89190395233,89190395236,3,2425,1135,-20
89192072079,89192072082,3,2001,1851,-20
89194282372,89194282375,3,2402,2087,-20
89196283473,89196283475,2,1884,1110,-20
89199606250,89199606252,2,1495,1110,-20
89201759591,89201759586,-5,585,2004,-20
89203030528,89203030531,3,26459,20810,-20
89204508313,89204508316,3,2446,1355,-20
89207398269,89207398272,3,1630,1914,-20
89209625159,89209625161,2,1106,1436,-20
89217298004,89217298003,-1,2449,4411,-20
89218217731,89218217736,5,1668,1159,-20
89219946334,89219946337,3,2702,1674,-20
89222270263,89222270267,4,2342,1512,-20
89225338109,89225338113,4,1558,1162,-20
89228635110,89228635111,1,870,512,-20
89228841418,89228841423,5,2503,1660,-20
89231235586,89231235590,4,1294,1486,-20
89233303052,89233303054,2,2176,1287,-20
89234861024,89234861022,-2,1320,1724,-20
89241467925,89241467926,1,2039,1472,-20
89242566017,89242566019,2,1427,1142,-20
89245882953,89245882955,2,2298,1687,-20
89245956430,89245956428,-2,1015,1379,-20
89248211962,89248211965,3,1933,1670,-20
89248357298,89248357282,-16,1278,1296,-20
89248457970,89248457975,5,2113,1765,-20
89252999462,89252999467,5,2681,1822,-20
89253326319,89253326322,3,1541,1625,-20
89253926915,89253926917,2,1837,1332,-20
89254172020,89254172022,2,1233,1187,-20
89255484689,89255484694,5,1788,1355,-20
89257766952,89257766956,4,2665,1552,-20
89265636689,89265636690,1,1560,1606,-20
89265695394,89265695398,4,1777,1203,-20
89268963970,89268963973,3,2201,1109,-20
89269811939,89269811940,1,2476,3741,-20
89271127302,89271127319,17,1479,1814,-20
89275323358,89275323362,4,1584,1459,-20
89275369335,89275369323,-12,1644,1274,-20
89279634221,89279634223,2,1635,1452,-20
89287223157,89287223159,2,1531,1291,-20
89287673587,89287673590,3,2124,1735,-20
89289309219,89289309223,4,1883,1224,-20
89292977397,89292977401,4,2617,1777,-20
89293134695,89293134699,4,2248,1808,-20
89293856119,89293856122,3,1732,1520,-20
89297351846,89297351852,6,1541,1496,-20
89299127466,89299127471,5,1421,1614,-20
89304105058,89304105061,3,1385,1166,-20
89304751795,89304751799,4,2327,1573,-20
89306132917,89306132921,4,3585,1476,-20
89309068944,89309068946,2,1691,1592,-20
89310825898,89310825902,4,1662,1344,-20
89313801124,89313801126,2,1605,1268,-20
89314474521,89314474526,5,2006,1283,-20
89317341238,89317341238,0,800,1118,-20
89321310086,89321310089,3,1361,1467,-20
89322466391,89322466390,-1,983,1120,-20
89323628285,89323628290,5,1316,1278,-20
89325459443,89325459445,2,1397,1445,-20
89327096124,89327096127,3,1711,1463,-20
89327984895,89327984898,3,1382,1407,-20
89328494485,89328494487,2,1939,1660,-20
89329966548,89329966552,4,2533,2090,-20
89330226546,89330226551,5,2235,1674,-20
89331125138,89331125143,5,2158,945,-20
89332576790,89332576794,4,2326,1629,-20
89332776075,89332776078,3,2086,1368,-20
89339540942,89339540945,3,1896,1443,-20
89340669009,89340669008,-1,9566,15484,-20
89341141210,89341141213,3,2017,1505,-20
89342117803,89342117799,-4,1801,6499,-20
89351058676,89351058679,3,1781,1502,-20
89351138216,89351138219,3,1724,1876,-20
89353942498,89353942502,4,1970,1222,-20
89357716823,89357716827,4,1735,1647,-20
89357961398,89357961398,0,1305,930,-20
89362409011,89362409014,3,1415,656,-20
89365635267,89365635270,3,1351,895,-20
89368120275,89368120275,0,1911,3031,-20
89369745315,89369745315,0,967,1950,-20
89370361495,89370361498,3,1108,1370,-20
89371548894,89371548896,2,1587,1328,-20
89373090466,89373090466,0,1175,1718,-20
89373422009,89373422026,17,2015,1521,-20
89373671760,89373671763,3,1211,1410,-20
89376940341,89376940344,3,1705,1318,-20
89377381232,89377381248,16,883,1196,-20
89378005716,89378005720,4,2220,1437,-20
89379139109,89379139113,4,2231,2254,-20
89383183633,89383183635,2,1254,1125,-20
89383706395,89383706380,-15,1640,1417,-20
89386739065,89386739069,4,1391,1366,-20
89389832122,89389832126,4,1483,1184,-20
89390867022,89390867027,5,1998,1256,-20
89392202509,89392202508,-1,1573,2661,-20
89394998530,89394998534,4,2524,1489,-20
89400793481,89400793483,2,1477,1692,-20
89405530758,89405530762,4,3017,1834,-20
89406163322,89406163315,-7,1116,4282,-20
89406529309,89406529315,6,1512,1616,-20
89407489060,89407489061,1,1864,1926,-20
89408104569,89408104577,8,5131,2223,-20
89413202352,89413202355,3,1644,1294,-20
89413984820,89413984822,2,2463,1855,-20
89415037320,89415037323,3,1640,1510,-20
89417981329,89417981334,5,1846,1225,-20
89422184434,89422184438,4,1456,1483,-20
89423969649,89423969650,1,1336,1818,-20
89426852135,89426852138,3,2158,1815,-20
89429892782,89429892786,4,1152,812,-20
89429947166,89429947144,-22,1701,1243,-20
89430132883,89430132883,0,1170,1264,-20
89431095785,89431095791,6,2919,1312,-20
89431745438,89431745443,5,2715,1756,-20
89440025641,89440025645,4,2088,1949,-20
89441737801,89441737804,3,2022,1633,-20
89449518939,89449518943,4,4427,3355,-20
89449705048,89449705053,5,2388,874,-20
89451951634,89451951637,3,1289,1380,-20
89452825546,89452825550,4,1961,1307,-20
89454439651,89454439654,3,1818,1285,-20
89455222245,89455222250,5,1419,1293,-20
89455897285,89455897289,4,1824,1062,-20
89456595943,89456595945,2,1082,792,-20
89457344816,89457344818,2,2419,1571,-20
89458549998,89458549999,1,2323,1644,-20
89460643429,89460643430,1,1921,1648,-20
89461643591,89461643594,3,1224,1532,-20
89466580270,89466580269,-1,1490,2108,-20
89468499329,89468499332,3,2485,2436,-20
89469166695,89469166698,3,1113,1394,-20
89474826098,89474826101,3,1648,1224,-20
89476454347,89476454341,-6,3247,13155,-20
89479360555,89479360559,4,1717,1473,-20
89480883926,89480883930,4,1840,1750,-20
89484759776,89484759780,4,2193,1718,-20
89487941108,89487941111,3,1910,1274,-20
89488822754,89488822746,-8,1861,7067,-20
89489613430,89489613417,-13,1127,1806,-20
89489986962,89489986966,4,2549,1378,-20
89494793438,89494793441,3,2188,1635,-20
89499061175,89499061179,4,1955,1141,-20
89503705245,89503705245,0,1229,1875,-20
89506939258,89506939261,3,1635,1105,-20
89508004434,89508004436,2,1663,1082,-20
89508253520,89508253527,7,1818,1441,-20
89510477155,89510477157,2,1222,1347,-20
89511950641,89511950643,2,2278,1438,-20
89514350114,89514350119,5,1738,1894,-20
89516171188,89516171192,4,2051,1461,-20
89516690605,89516690605,0,1875,1285,-20
89522140434,89522140438,4,1649,1792,-20
89526850506,89526850509,3,2299,1771,-20
89526960594,89526960596,2,1379,1320,-20
89528419077,89528419082,5,2092,1136,-20
89529226303,89529226302,-1,1370,2517,-20
89529731533,89529731535,2,2218,1714,-20
89534921396,89534921397,1,1850,2347,-20
89535484570,89535484574,4,1740,1601,-20
89535915657,89535915662,5,1866,1813,-20
89542542545,89542542549,4,1797,1063,-20
89544813802,89544813805,3,164,712,-20
89547019941,89547019943,2,2116,1771,-20
89553674835,89553674837,2,1371,1217,-20
89554229893,89554229895,2,2465,1537,-20
89556874217,89556874218,1,1990,1303,-20
89558512338,89558512339,1,2209,1117,-20
89563691302,89563691306,4,2258,1263,-20
89563943737,89563943742,5,1976,1442,-20
89566225592,89566225594,2,1014,1032,-20
89567443324,89567443320,-4,1816,4579,-20
89568055578,89568055581,3,2485,2063,-20
89569058863,89569058867,4,1655,1650,-20
89570480024,89570480025,1,2101,1605,-20
89570946153,89570946155,2,15783,14637,-20
89572385423,89572385427,4,1355,1163,-20
89581674950,89581674970,20,1448,1271,-20
89584051427,89584051431,4,1910,1741,-20
89586235046,89586235046,0,1454,1760,-20
89586502871,89586502874,3,1329,1217,-20
89586947952,89586947954,2,1505,1413,-20
89587709611,89587709615,4,1251,1089,-20
89592130472,89592130474,2,1890,1473,-20
89593990071,89593990072,1,1867,1638,-20
89596331779,89596331757,-22,1607,1265,-20
89597907577,89597907579,2,2322,1786,-20
89598689951,89598689946,-5,29482,5212,-20
89598745599,89598745594,-5,21092,13009,-20
89604118210,89604118213,3,2141,1534,-20
89604624521,89604624524,3,1615,1582,-20
89605470638,89605470642,4,2217,1506,-20
89608051914,89608051919,5,2499,1216,-20
89608108442,89608108446,4,2079,1549,-20
89608510935,89608510939,4,1593,1280,-20
89610327914,89610327914,0,1637,2095,-20
89611850851,89611850855,4,1400,1442,-20
89616596235,89616596239,4,2112,1284,-20
89618675403,89618675409,6,1625,1546,-20
89618712847,89618712827,-20,1365,1029,-20
89622268138,89622268141,3,1462,1177,-20
89622722937,89622722939,2,1391,1308,-20
89623899451,89623899455,4,1646,1306,-20
89625482198,89625482202,4,2069,1350,-20
89626862824,89626862828,4,2386,1930,-20
89629793705,89629793710,5,1607,1493,-20
89630237158,89630237158,0,1612,1481,-20
89635092706,89635092709,3,2354,1708,-20
89637071122,89637071125,3,1008,904,-20
89639461000,89639460986,-14,11,1802,-20
89640048374,89640048378,4,20065,44592,-20
89641118006,89641118011,5,1536,853,-20
89643229792,89643229795,3,1582,1349,-20
89643396196,89643396199,3,2274,1826,-20
89646447496,89646447499,3,1709,1572,-20
89646864690,89646864695,5,2190,1457,-20
89647793725,89647793727,2,1951,1184,-20
89650350090,89650350091,1,1529,1859,-20
89650551947,89650551952,5,2410,1853,-20
89652913910,89652913914,4,1094,832,-20
89653185128,89653185131,3,1968,1497,-20
89660488020,89660487997,-23,1266,1337,-20
89668727314,89668727315,1,1380,1215,-20
89669388077,89669388081,4,1893,1370,-20
89672192683,89672192678,-5,1906,6611,-20
89674081831,89674081834,3,1992,1545,-20
89676317582,89676317567,-15,2058,1369,-20
89676650509,89676650511,2,1585,1571,-20
89677765834,89677765839,5,1697,1119,-20
89684787597,89684787602,5,2054,953,-20
89685333029,89685333051,22,1760,1655,-20
89687444802,89687444807,5,2008,1247,-20
89692500847,89692500851,4,956,668,-20
89694466138,89694466142,4,1917,1331,-20
89703483309,89703483314,5,1481,1398,-20
89706951240,89706951255,15,1791,1072,-20
89713202183,89713202187,4,1742,1460,-20
89715030194,89715030195,1,1205,945,-20
89715413006,89715413010,4,1640,1593,-20
89716016812,89716016816,4,1694,1537,-20
89719074211,89719074214,3,1765,1493,-20
89728483501,89728483504,3,2492,1250,-20
89732902904,89732902897,-7,1280,4757,-20
89738220114,89738220118,4,2435,1278,-20
89739886904,89739886908,4,2284,1006,-20
89740275205,89740275209,4,1906,1427,-20
89744296398,89744296403,5,2230,1148,-20
89744441442,89744441446,4,1985,1528,-20
89744579352,89744579350,-2,1445,1778,-20
89747820890,89747820894,4,1675,1135,-20
89748457933,89748457937,4,2219,1266,-20
89750482095,89750482098,3,1616,1436,-20
89751363414,89751363419,5,1528,1184,-20
89751815671,89751815674,3,2065,1322,-20
89752387733,89752387737,4,1534,1166,-20
89759364137,89759364138,1,2771,2525,-20
89763025225,89763025228,3,1350,1161,-20
89763167839,89763167841,2,1922,2147,-20
89766100655,89766100658,3,1728,1277,-20
89768393995,89768393990,-5,1233,3387,-20
89768583862,89768583866,4,1955,1515,-20
89770221766,89770221770,4,2212,1863,-20
89771766721,89771766724,3,2231,1463,-20
89775430282,89775430286,4,1531,808,-20
89776655626,89776655630,4,1355,1368,-20
89777043565,89777043568,3,2088,1374,-20
89778797088,89778797092,4,1656,1680,-20
89781127024,89781127031,7,2573,952,-20
89784502780,89784502783,3,2052,1848,-20
89785447722,89785447727,5,1620,1421,-20
89786422265,89786422270,5,2554,1680,-20
89789546416,89789546418,2,1614,1441,-20
89791326299,89791326298,-1,1821,1482,-20
89791444262,89791444266,4,1817,1339,-20
89793483409,89793483412,3,2492,1537,-20
89793706141,89793706146,5,1843,1664,-20
89795716082,89795716083,1,1629,1324,-20
89800792563,89800792567,4,2808,1557,-20
89803549389,89803549395,6,1908,1196,-20
89804820176,89804820178,2,1786,1764,-20
89811102020,89811102026,6,1727,1104,-20
89811797208,89811797205,-3,1320,1992,-20
89814764297,89814764301,4,2281,1719,-20
89820392290,89820392291,1,1087,921,-20
89820781200,89820781202,2,1576,1708,-20
89828630274,89828630278,4,1919,1618,-20
89838999037,89838999045,8,3788,1540,-20
89841529338,89841529343,5,1555,1103,-20
89843422267,89843422265,-2,1314,2377,-20
89843539578,89843539581,3,1632,932,-20
89846049914,89846049918,4,1564,1330,-20
89846296314,89846296322,8,1988,1469,-20
89851361142,89851361146,4,1750,1639,-20
89853693649,89853693656,7,2942,1846,-20
89855160882,89855160885,3,1791,2292,-20
89856771152,89856771157,5,1836,2305,-20
89857724590,89857724593,3,2451,1459,-20
89857823050,89857823051,1,1539,1173,-20
89859758086,89859758086,0,1565,1538,-20
89861510213,89861510216,3,1312,1219,-20
89862155724,89862155727,3,2154,1684,-20
89862796687,89862796692,5,1893,1519,-20
89863967409,89863967403,-6,1876,8577,-20
89866287385,89866287387,2,1272,1312,-20
89867653813,89867653806,-7,916,4465,-20
89869035238,89869035241,3,1254,1096,-20
89876432114,89876432117,3,1419,1644,-20
89876683833,89876683835,2,1907,1341,-20
89879429100,89879429100,0,8313,11812,-20
89880697597,89880697601,4,1598,1363,-20
89881028881,89881028873,-8,1016,216,-20
89881867531,89881867534,3,2414,1347,-20
89884814829,89884814830,1,1999,1229,-20
89895410675,89895410676,1,1207,1293,-20
89898273253,89898273259,6,1936,1443,-20
89898857933,89898857935,2,1222,1718,-20
89900912129,89900912125,-4,2415,4864,-20
89902749897,89902749901,4,2075,1096,-20
89905765517,89905765519,2,1820,1536,-20
89907878616,89907878618,2,1970,2078,-20
89909424147,89909424151,4,2115,1725,-20
89910985502,89910985503,1,1255,1182,-20
89918085529,89918085532,3,1631,1437,-20
89921601495,89921601499,4,1766,1709,-20
89924230860,89924230865,5,2330,919,-20
89928580541,89928580546,5,2299,1290,-20
89929820655,89929820658,3,1605,1880,-20
89932778669,89932778671,2,2193,1754,-20
89933945158,89933945163,5,1653,1175,-20
89936239002,89936239003,1,2103,1792,-20
89937360315,89937360319,4,1939,1474,-20
89937463430,89937463431,1,2674,1673,-20
89937822350,89937822354,4,1669,1190,-20
89939428591,89939428595,4,1005,918,-20
89944452902,89944452905,3,1080,709,-20
89945910786,89945910789,3,1038,1341,-20
89950185383,89950185386,3,1876,2123,-20
89951518901,89951518904,3,2173,1809,-20
89951954026,89951954027,1,2067,1336,-20
89952001203,89952001205,2,1982,1753,-20
89958554926,89958554934,8,3793,1429,-20
89958618683,89958618697,14,403,248,-20
89958993808,89958993811,3,2114,1141,-20
89961823011,89961823013,2,1422,1651,-20
89963392075,89963392078,3,1480,1029,-20
89965642573,89965642577,4,2168,1913,-20
89966470458,89966470463,5,1720,1601,-20
89966821897,89966821898,1,1552,1737,-20
89967043942,89967043946,4,1913,1194,-20
89968601788,89968601790,2,1972,1367,-20
89968839558,89968839559,1,2289,1816,-20
89969805701,89969805703,2,2193,1296,-20
89974432244,89974432249,5,1963,1000,-20
89982340774,89982340777,3,2137,2231,-20
89983633212,89983633214,2,1325,1005,-20
89986422542,89986422543,1,1718,1836,-20
89987871467,89987871465,-2,1014,2628,-20
89988056809,89988056815,6,1266,1216,-20
89989001302,89989001306,4,1988,2219,-20
89991308440,89991308438,-2,1176,2171,-20
89993106149,89993106154,5,2249,1462,-20
89995135822,89995135828,6,1458,991,-20
89996112521,89996112523,2,1858,1130,-20
89996282934,89996282936,2,2667,1367,-20
89998582441,89998582444,3,2220,1825,-20
89999075665,89999075670,5,1560,1596,-20
89999453840,89999453842,2,2494,1504,-20
89999773792,89999773794,2,2224,1781,-20
90000990182,90000990186,4,1878,1170,-20
90002066099,90002066102,3,1434,1094,-20
90002835912,90002835916,4,45332,3198,-20
90004145125,90004145129,4,2021,971,-20
90006065915,90006065919,4,2861,1784,-20
90007496610,90007496611,1,1321,1628,-20
90008323789,90008323790,1,1704,1092,-20
90008486071,90008486051,-20,575,302,-20
90010839954,90010839959,5,1912,1400,-20
90012791578,90012791581,3,1130,1374,-20
90013807142,90013807138,-4,42828,22318,-20
90015332212,90015332215,3,1952,1414,-20
90020463922,90020463926,4,1259,1075,-20
90022683097,90022683099,2,1551,1327,-20
90023743453,90023743464,11,1480,1400,-20
90023950320,90023950324,4,2394,1874,-20
90024940394,90024940398,4,2112,1299,-20
90027843143,90027843142,-1,1316,2498,-20
90029423698,90029423694,-4,23744,14354,-20
90029619678,90029619679,1,1346,904,-20
90031043713,90031043715,2,1138,894,-20
90031606942,90031606924,-18,1901,1624,-20
90034616038,90034616042,4,1983,1349,-20
90036440790,90036440793,3,1744,1796,-20
90041328117,90041328121,4,2250,1093,-20
90042599845,90042599850,5,1901,860,-20
90045080910,90045080909,-1,1053,1969,-20
90049755754,90049755758,4,1625,969,-20
90052432198,90052432201,3,2153,1579,-20
90054016238,90054016239,1,2160,2257,-20
90055053314,90055053317,3,1450,1666,-20
90056182204,90056182207,3,2139,1652,-20
90062020877,90062020882,5,2028,1759,-20
90066156502,90066156502,0,1769,1734,-20
90068283764,90068283767,3,1260,1025,-20
90068442544,90068442525,-19,1126,3291,-20
90072298063,90072298066,3,2046,1463,-20
90072952677,90072952682,5,1039,972,-20
90075908507,90075908503,-4,1136,2320,-20
90078186780,90078186783,3,1596,1272,-20
90079414837,90079414838,1,2144,1024,-20
90080838377,90080838379,2,1624,2615,-20
90081673183,90081673185,2,1377,1303,-20
90082090851,90082090855,4,1645,1111,-20
90084848642,90084848643,1,1608,1548,-20
90085721071,90085721075,4,1699,1348,-20
90086504120,90086504122,2,1449,1257,-20
90089404369,90089404374,5,1804,1803,-20
90092560231,90092560235,4,1778,1791,-20
90098472182,90098472190,8,3308,1076,-20
90105687902,90105687906,4,1940,1322,-20
90106902677,90106902681,4,2403,1278,-20
90112080837,90112080842,5,2954,1787,-20
90114271806,90114271808,2,1476,1372,-20
90115944373,90115944375,2,973,833,-20
90116549671,90116549675,4,1783,1328,-20
90117585160,90117585163,3,2002,2170,-20
90119417118,90119417121,3,2287,1554,-20
90122179931,90122179933,2,1495,1459,-20
90122758594,90122758598,4,1200,1605,-20
90124403028,90124403030,2,2155,1850,-20
90127419011,90127419016,5,1851,1296,-20
90132460573,90132460578,5,1775,1720,-20
90132560154,90132560157,3,4194,4189,-20
90135500910,90135500913,3,14288,10889,-20
90138353411,90138353415,4,1895,1762,-20
90139040617,90139040619,2,2245,1749,-20
90140044925,90140044928,3,1660,1295,-20
90141006758,90141006761,3,1664,1621,-20
90143144925,90143144926,1,1823,1826,-20
90143772833,90143772835,2,1245,1753,-20
90146616117,90146616124,7,1309,1339,-20
90148745251,90148745254,3,2229,2074,-20
90154063382,90154063389,7,5592,1382,-20
90156412030,90156412032,2,1417,1259,-20
90160603641,90160603642,1,1636,1791,-20
90160945997,90160945999,2,1625,1166,-20
90161876002,90161876003,1,2031,2337,-20
90162086762,90162086766,4,2214,1230,-20
90165298871,90165298875,4,1821,1248,-20
90167763771,90167763774,3,1978,1623,-20
90167912223,90167912227,4,1683,1167,-20
90168100027,90168100031,4,1843,1103,-20
90168231155,90168231138,-17,1210,686,-20
90171896742,90171896746,4,2193,1618,-20
90175726278,90175726278,0,1148,1299,-20
90175931686,90175931665,-21,1960,1583,-20
90176159128,90176159132,4,2245,1886,-20
90177057041,90177057047,6,4771,2381,-20
90178668266,90178668269,3,1521,1516,-20
90179211278,90179211278,0,2020,2177,-20
90180662091,90180662088,-3,894,1584,-20
90187068338,90187068340,2,1824,1002,-20
90191046437,90191046441,4,1942,1481,-20
90195130583,90195130585,2,1855,1510,-20
90195378384,90195378387,3,1290,1310,-20
90201633218,90201633200,-18,1723,1477,-20
90202272083,90202272086,3,1524,1253,-20
90202378723,90202378726,3,1581,1968,-20
90203783347,90203783351,4,1594,1774,-20
90203936547,90203936550,3,2010,1095,-20
90206690438,90206690441,3,2293,1370,-20
90207427056,90207427058,2,2782,2318,-20
90209494023,90209494027,4,1697,1497,-20
90212115515,90212115518,3,1592,1467,-20
90212269438,90212269442,4,1566,1807,-20
90214488778,90214488782,4,1394,1655,-20
90215601677,90215601685,8,3117,1725,-20
90217984966,90217984970,4,1845,2165,-20
90218573902,90218573905,3,1888,1284,-20
90219676261,90219676262,1,1229,1336,-20
90220948274,90220948274,0,1665,1427,-20
90225335636,90225335639,3,1246,997,-20
90226903576,90226903579,3,1945,1251,-20
90231334688,90231334682,-6,1391,3323,-20
90231450516,90231450519,3,1983,1574,-20
90231628772,90231628775,3,2046,1604,-20
90233766203,90233766208,5,1886,1780,-20
90234399646,90234399649,3,1969,1629,-20
90239193175,90239193177,2,1043,1253,-20
90240206008,90240206010,2,2187,1408,-20
90252872262,90252872266,4,1707,1309,-20
90253467555,90253467558,3,1825,1778,-20
90253526420,90253526423,3,1441,1280,-20
90257242522,90257242526,4,1513,1348,-20
90257528811,90257528814,3,1351,1328,-20
90258843270,90258843275,5,1686,1097,-20
90259859846,90259859847,1,1051,1865,-20
90260693566,90260693571,5,2612,1438,-20
90261073040,90261073045,5,3028,1722,-20
90261184916,90261184909,-7,3147,8840,-20
90263770554,90263770560,6,1769,1303,-20
90268161014,90268161019,5,1209,947,-20
90268284448,90268284452,4,2128,1441,-20
90269811796,90269811798,2,1486,1360,-20
90270559487,90270559491,4,1508,917,-20
90270813179,90270813182,3,1612,1511,-20
90272141055,90272141053,-2,1479,2065,-20
90275561526,90275561530,4,2348,1732,-20
90276255990,90276255971,-19,1608,921,-20
90276477938,90276477941,3,1621,1528,-20
90279671282,90279671286,4,2726,2106,-20
90282043882,90282043886,4,1259,1277,-20
90282227143,90282227123,-20,1747,909,-20
90284313145,90284313151,6,2040,1125,-20
90284820977,90284820978,1,967,1435,-20
90285030004,90285030009,5,1990,1478,-20
90286712480,90286712485,5,2913,1590,-20
90287770878,90287770878,0,1825,1989,-20
90290082596,90290082599,3,1624,1545,-20
90293216434,90293216437,3,1349,1035,-20
90294422995,90294422999,4,1972,1296,-20
90295687843,90295687845,2,1862,1945,-20
90303039478,90303039482,4,2009,1430,-20
90304355170,90304355174,4,1602,1174,-20
90306208044,90306208059,15,341,1405,-20
90308739649,90308739650,1,2061,2199,-20
90308833247,90308833251,4,2013,1774,-20
90311116061,90311116040,-21,929,284,-20
90313128059,90313128063,4,1580,1565,-20
90315532122,90315532125,3,2665,2060,-20
90315896910,90315896911,1,2370,2573,-20
90316132602,90316132606,4,1827,1639,-20
90318085651,90318085655,4,1879,1282,-20
90320284968,90320284969,1,1479,1292,-20
90322236087,90322236090,3,1874,1640,-20
90323018747,90323018751,4,1994,1383,-20
90324065101,90324065102,1,1939,1517,-20
90327563444,90327563448,4,1354,878,-20
90332203251,90332203249,-2,1612,3478,-20
90333730499,90333730503,4,1446,1826,-20
90334683726,90334683731,5,1892,1302,-20
90335926798,90335926798,0,1228,1543,-20
90337618526,90337618529,3,1247,1372,-20
90338651579,90338651583,4,1741,1262,-20
90339181682,90339181686,4,2470,1751,-20
90340501154,90340501157,3,2212,1683,-20
90341768270,90341768275,5,829,975,-20
90344212322,90344212325,3,2302,1893,-20
90344945037,90344945037,0,984,1827,-20
90344975219,90344975223,4,1570,1421,-20
90346204177,90346204180,3,1872,1429,-20
90349407334,90349407335,1,3815,3295,-20
90351175039,90351175042,3,2216,1027,-20
90352039547,90352039541,-6,925,1862,-20
90352170761,90352170764,3,2056,1548,-20
90358694500,90358694506,6,2076,1893,-20
90360768329,90360768335,6,1558,992,-20
90367129198,90367129199,1,1887,1777,-20
90368507872,90368507874,2,1748,1506,-20
90369988187,90369988191,4,2361,1436,-20
90371155533,90371155535,2,2793,1728,-20
90372704757,90372704761,4,1804,1340,-20
90373261217,90373261224,7,2264,2194,-20
90375584916,90375584919,3,1574,994,-20
90375738077,90375738082,5,2300,1785,-20
90377671915,90377671917,2,1167,1234,-20
90377714034,90377714038,4,1767,1603,-20
90377831412,90377831414,2,1449,1164,-20
90378570348,90378570353,5,2801,1996,-20
90378749898,90378749902,4,1717,2012,-20
90380357165,90380357167,2,2239,1592,-20
90380864609,90380864613,4,2300,1442,-20
90384463707,90384463709,2,1089,1159,-20
90385842958,90385842959,1,2076,1289,-20
90386366702,90386366705,3,2041,1691,-20
90387431921,90387431923,2,1483,1434,-20
90387807149,90387807154,5,1517,1270,-20
90388447541,90388447546,5,1326,1298,-20
90389683791,90389683793,2,1634,2322,-20
90390959245,90390959248,3,1652,1373,-20
90392342799,90392342802,3,1191,1163,-20
90392419886,90392419866,-20,1989,1992,-20
90392655296,90392655299,3,2443,1659,-20
90394919330,90394919335,5,2408,1696,-20
90394966875,90394966878,3,1972,1115,-20
90397384944,90397384947,3,1468,1531,-20
90403509882,90403509887,5,2699,1176,-20
90403692513,90403692515,2,1432,1509,-20
90406064829,90406064833,4,1729,1361,-20
90406963875,90406963880,5,2127,1538,-20
90410494393,90410494394,1,2344,1563,-20
90411209419,90411209399,-20,765,2339,-20
90412975643,90412975648,5,1677,1077,-20
90413623062,90413623069,7,1470,888,-20
90414295586,90414295590,4,2167,1519,-20
90418023945,90418023947,2,2231,1808,-20
90422134310,90422134316,6,1818,1224,-20
90422604849,90422604851,2,1456,1277,-20
90431769077,90431769080,3,1567,1345,-20
90434171310,90434171313,3,1429,1165,-20
90436562582,90436562582,0,1310,1024,-20
90439171919,90439171923,4,1513,1622,-20
90439485287,90439485292,5,1679,875,-20
90440420614,90440420625,11,10321,45530,-20
90448735864,90448735867,3,1557,908,-20
90457239903,90457239909,6,3097,919,-20
90458060278,90458060283,5,1848,1061,-20
90461470857,90461470861,4,1880,1010,-20
90462363227,90462363225,-2,6513,13855,-20
90462678474,90462678475,1,1167,1224,-20
90470360924,90470360928,4,1995,1628,-20
90472089065,90472089067,2,1799,1137,-20
90477891506,90477891507,1,932,1186,-20
90480519835,90480519836,1,1568,1659,-20
90482944288,90482944291,3,2101,2124,-20
90484804042,90484804045,3,2320,2250,-20
90489913093,90489913097,4,1618,1277,-20
90490130174,90490130177,3,1543,1306,-20
90492364558,90492364562,4,1419,1458,-20
90496108579,90496108580,1,1764,1803,-20
90497552931,90497552936,5,2347,1690,-20
90498704814,90498704815,1,1403,1245,-20
90499423313,90499423315,2,2144,1600,-20
90502331489,90502331493,4,1360,1125,-20
90503808632,90503808636,4,1545,1185,-20
90504852889,90504852894,5,1411,1017,-20
90505098802,90505098805,3,1645,1048,-20
90507213618,90507213623,5,1631,1325,-20
90507959145,90507959149,4,1993,1433,-20
90510431818,90510431822,4,1957,2086,-20
90511796992,90511796999,7,2198,1468,-20
90515573381,90515573385,4,2645,2377,-20
90518104169,90518104172,3,2072,1514,-20
90519213271,90519213266,-5,745,6070,-20
90521863124,90521863127,3,2668,1512,-20
90523273918,90523273920,2,2415,1974,-20
90525830668,90525830663,-5,1478,3742,-20
90528859345,90528859347,2,1930,1561,-20
90530733507,90530733511,4,1899,1316,-20
90530921074,90530921077,3,1743,1555,-20
90531493816,90531493818,2,2305,1536,-20
90532687765,90532687769,4,1919,1591,-20
90532864661,90532864665,4,3160,1792,-20
90533736209,90533736207,-2,1469,2587,-20
90534603924,90534603926,2,1755,1003,-20
90534994601,90534994602,1,1686,1000,-20
90537317444,90537317448,4,1612,1526,-20
90538098553,90538098558,5,2304,1546,-20
90538835485,90538835489,4,1999,1701,-20
90540037665,90540037668,3,2083,1336,-20
90540243604,90540243595,-9,626,2553,-20
90541188694,90541188696,2,1147,1504,-20
90541905949,90541905955,6,1869,1544,-20
90542809802,90542809801,-1,1377,2698,-20
90545345787,90545345791,4,1180,1458,-20
90547530965,90547530968,3,1558,1143,-20
90547986409,90547986415,6,2803,924,-20
90549903009,90549903004,-5,1850,7713,-20
90553048566,90553048570,4,1690,1512,-20
90553462855,90553462858,3,1578,1441,-20
90554285871,90554285875,4,1527,961,-20
90564427262,90564427266,4,1481,1308,-20
90564854661,90564854681,20,2910,1202,-20
90566550424,90566550427,3,1844,1454,-20
90566734788,90566734792,4,2882,1898,-20
90566771882,90566771886,4,2005,1905,-20
90569180028,90569180032,4,1824,1348,-20
90570363382,90570363387,5,1982,1353,-20
90570962731,90570962726,-5,1155,3470,-20
90574381267,90574381270,3,2476,2142,-20
90579289279,90579289277,-2,1397,2255,-20
90581167642,90581167647,5,3320,1308,-20
90583779734,90583779737,3,2447,1515,-20
90584589388,90584589391,3,6429,894,-20
90585132549,90585132552,3,1858,1287,-20
90586742183,90586742185,2,1604,1657,-20
90587705445,90587705448,3,2278,1820,-20
90587746175,90587746177,2,1734,54,-20
90588225419,90588225415,-4,1189,3839,-20
90590034922,90590034927,5,1373,846,-20
90591414582,90591414586,4,2284,1820,-20
90592563865,90592563869,4,1995,1851,-20
90594824043,90594824050,7,1914,1527,-20
90595463562,90595463566,4,1604,1775,-20
90596706635,90596706638,3,2652,1560,-20
90601978242,90601978243,1,1254,1141,-20
90603218575,90603218578,3,665,658,-20
90607458046,90607458049,3,1741,1549,-20
90612451838,90612451842,4,2196,1749,-20
90612532653,90612532659,6,2029,1094,-20
90612925817,90612925820,3,2474,1763,-20
90612975581,90612975569,-12,666,37,-20
90619967212,90619967215,3,1424,1032,-20
90620264247,90620264253,6,2788,1604,-20
90623381444,90623381445,1,1387,1276,-20
90628909453,90628909457,4,1528,1511,-20
90632433290,90632433291,1,1003,1050,-20
90633932191,90633932194,3,1331,1425,-20
90635712894,90635712897,3,1581,1224,-20
90635993965,90635993966,1,1484,1281,-20
90636252548,90636252552,4,2336,1791,-20
90636677187,90636677190,3,75912,64839,-20
90637606618,90637606622,4,2444,2097,-20
90637678305,90637678308,3,2026,1427,-20
90638567106,90638567109,3,1808,1720,-20
90641087258,90641087263,5,1342,1282,-20
90642294397,90642294399,2,1673,1939,-20
90643270699,90643270701,2,1480,1125,-20
90645551398,90645551401,3,1824,1495,-20
90645727961,90645727962,1,1971,2524,-20
90646657458,90646657463,5,2127,1314,-20
90647076994,90647076999,5,1783,1205,-20
90648794272,90648794277,5,2019,1409,-20
90651368014,90651368012,-2,1117,2016,-20
90652310636,90652310635,-1,1364,1602,-20
90658851091,90658851093,2,1671,1708,-20
90659580946,90659580948,2,1791,1839,-20
90659827451,90659827454,3,1008,871,-20
90662081678,90662081678,0,1911,1363,-20
90663318686,90663318691,5,1598,1251,-20
90664452795,90664452811,16,1975,1239,-20
90670520351,90670520357,6,1934,1390,-20
90672014567,90672014571,4,2622,1650,-20
90672140654,90672140657,3,2172,1710,-20
90673824103,90673824101,-2,2259,2978,-20
90674092690,90674092691,1,1613,1395,-20
90676253618,90676253623,5,1179,905,-20
90680690464,90680690467,3,1841,1038,-20
90681131264,90681131267,3,1835,1239,-20
90682037279,90682037282,3,1763,1424,-20
90684019486,90684019490,4,1783,1117,-20
90692759455,90692759458,3,2225,1220,-20
90695216934,90695216937,3,1404,1069,-20
90695754551,90695754558,7,2772,1095,-20
90702388528,90702388530,2,2115,836,-20
90703797454,90703797457,3,2060,1853,-20
90704182221,90704182202,-19,2323,1661,-20
90709364054,90709364058,4,1338,855,-20
90714140694,90714140681,-13,4629,23299,-20
90715237268,90715237272,4,1871,1249,-20
90717455699,90717455701,2,1091,1189,-20
90726618184,90726618187,3,1201,1345,-20
90727112761,90727112765,4,1552,1430,-20
90729250315,90729250317,2,2310,1707,-20
90734997303,90734997306,3,1980,1492,-20
90737077051,90737077054,3,2093,1292,-20
90739086629,90739086630,1,1529,1218,-20
90747688347,90747688351,4,1381,1097,-20
90748539314,90748539317,3,1697,1380,-20
90749209263,90749209266,3,1056,1068,-20
90750371080,90750371091,11,12564,39885,-20
90750469826,90750469827,1,2002,1629,-20
90752475583,90752475589,6,2133,1341,-20
90755027621,90755027622,1,2400,1824,-20
90757032723,90757032729,6,1501,1655,-20
90761044796,90761044799,3,2355,1986,-20
90761741630,90761741634,4,1554,1625,-20
90762143292,90762143295,3,2573,1642,-20
90764206699,90764206702,3,1220,1085,-20
90766694242,90766694246,4,2060,1605,-20
90768112299,90768112303,4,1764,1244,-20
90771146009,90771146011,2,1590,901,-20
90775976370,90775976375,5,1744,1202,-20
90777817797,90777817797,0,1660,1494,-20
90778158654,90778158656,2,1929,1099,-20
90782504646,90782504648,2,1326,1165,-20
90785956194,90785956198,4,1981,1751,-20
90787238547,90787238550,3,1975,2254,-20
90787535895,90787535893,-2,986,2960,-20
90788226392,90788226385,-7,1135,1807,-20
90789406968,90789406973,5,3078,1909,-20
90790415349,90790415351,2,2012,1393,-20
90790773578,90790773594,16,1609,995,-20
90796334201,90796334203,2,1595,1634,-20
90797084834,90797084837,3,1903,1237,-20
90799483337,90799483340,3,1945,1232,-20
90801758029,90801758034,5,3141,1222,-20
90802410211,90802410213,2,2236,2018,-20
90804388441,90804388443,2,1352,1452,-20
90808958213,90808958215,2,1289,1236,-20
90810738574,90810738576,2,2694,1979,-20
90812116689,90812116693,4,2362,1570,-20
90812155031,90812155018,-13,614,425,-20
90812463662,90812463665,3,1586,1502,-20
90814694814,90814694818,4,1994,1204,-20
90815490280,90815490282,2,1447,1131,-20
90819492141,90819492143,2,1322,1520,-20
90819653157,90819653162,5,2042,1432,-20
90827460598,90827460579,-19,1580,907,-20
90828333496,90828333497,1,1678,1340,-20
90836176969,90836176972,3,1524,1229,-20
90837506795,90837506795,0,1270,1445,-20
90840623940,90840623943,3,1727,1577,-20
90842491403,90842491406,3,1475,1016,-20
90842999819,90842999823,4,2474,1350,-20
90843257098,90843257102,4,1964,2300,-20
90847495985,90847495989,4,2187,1644,-20
90847925890,90847925894,4,1785,1193,-20
90850683958,90850683962,4,2259,1432,-20
90856433322,90856433325,3,1896,1148,-20
90856759141,90856759122,-19,1498,1055,-20
90861028465,90861028471,6,2057,1541,-20
90863491593,90863491595,2,1340,1453,-20
90864604976,90864604978,2,1450,1153,-20
90866042173,90866042176,3,2194,1885,-20
90866590278,90866590278,0,1803,1482,-20
90868166474,90868166476,2,1776,1122,-20
90869052759,90869052769,10,2022,1703,-20
90870553269,90870553275,6,2236,1439,-20
90872908760,90872908762,2,2009,1354,-20
90873542109,90873542110,1,962,1151,-20
90873965930,90873965944,14,2085,1350,-20
90877011854,90877011858,4,1456,920,-20
90878211045,90878211048,3,1159,1007,-20
90879184343,90879184343,0,988,1755,-20
90879682646,90879682650,4,2217,1489,-20
90884427092,90884427094,2,1380,1109,-20
90887057373,90887057378,5,2313,1024,-20
90888215182,90888215162,-20,1581,1158,-20
90888657958,90888657962,4,1748,1687,-20
90889198727,90889198734,7,11039,26199,-20
90891340743,90891340746,3,1154,1176,-20
90893013675,90893013675,0,22431,27967,-20
90893579109,90893579111,2,1975,1214,-20
90893710206,90893710214,8,7815,3030,-20
90895009510,90895009515,5,1377,976,-20
90904718646,90904718650,4,2419,1870,-20
90908817626,90908817631,5,1788,1334,-20
90908897182,90908897186,4,1817,1440,-20
90910353416,90910353419,3,1874,1439,-20
90911071015,90911071015,0,850,1313,-20
90912346561,90912346564,3,1963,1251,-20
90921559695,90921559698,3,1770,1103,-20
90922646542,90922646547,5,1809,1517,-20
90924037181,90924037186,5,2497,1675,-20
90927379297,90927379301,4,2043,1534,-20
90927795819,90927795822,3,1861,1198,-20
90928827303,90928827306,3,2099,2140,-20
90929515789,90929515793,4,1816,2028,-20
90932074302,90932074306,4,2143,2061,-20
90932730732,90932730736,4,1977,1782,-20
90933182030,90933182034,4,1293,1129,-20
90936775889,90936775890,1,1672,1435,-20
90937169339,90937169345,6,2222,1337,-20
90939174882,90939174895,13,87,6036,-20
90940169881,90940169885,4,1760,1758,-20
90945493524,90945493526,2,1708,1722,-20
90950687314,90950687318,4,2318,1551,-20
90954212095,90954212099,4,2195,1788,-20
90954789771,90954789774,3,1127,901,-20
90956340198,90956340201,3,2540,1957,-20
90956997946,90956997951,5,1392,1388,-20
90972848402,90972848407,5,2542,1983,-20
90972986476,90972986482,6,1437,1699,-20
90974012686,90974012691,5,2174,1538,-20
90975521736,90975521739,3,1494,1202,-20
90982512630,90982512612,-18,1748,1395,-20
90983221851,90983221854,3,2530,1434,-20
90983350625,90983350626,1,2099,1832,-20
90983382483,90983382481,-2,988,2577,-20
90986057503,90986057502,-1,1403,1713,-20
90986688934,90986688937,3,1110,1675,-20
90996558955,90996558959,4,2458,1804,-20
90997783378,90997783381,3,2453,1439,-20
90997831937,90997831941,4,1591,1166,-20
90999730245,90999730250,5,1775,1284,-20
91002729411,91002729414,3,2063,976,-20
91005315696,91005315697,1,2105,1870,-20
91005550485,91005550485,0,1718,1945,-20
91011215581,91011215582,1,1648,1310,-20
91011946029,91011946022,-7,1893,9062,-20
91015866123,91015866103,-20,1224,1338,-20
91020021755,91020021758,3,1624,1564,-20
91025813255,91025813259,4,1596,1319,-20
91028546798,91028546802,4,1524,1460,-20
91028964894,91028964898,4,2378,1659,-20
91029598170,91029598174,4,1963,1253,-20
91030037972,91030037965,-7,27234,3107,-20
91036547308,91036547314,6,2028,1495,-20
91040484013,91040484014,1,968,1617,-20
91048068994,91048068998,4,1926,1426,-20
91051664998,91051665003,5,2354,1360,-20
91052244350,91052244355,5,2511,1509,-20
91055479856,91055479858,2,1592,1556,-20
91056866976,91056866979,3,1636,1295,-20
91058890995,91058890999,4,2517,1864,-20
91060410749,91060410753,4,2465,1617,-20
91062492371,91062492374,3,1415,1669,-20
91066706656,91066706659,3,1822,1274,-20
91067843569,91067843571,2,1368,1479,-20
91069162403,91069162407,4,1184,1046,-20
91073407677,91073407681,4,2829,1597,-20
91074933974,91074933973,-1,1935,2285,-20
91078333701,91078333705,4,2645,1498,-20
91078460468,91078460451,-17,1824,1048,-20
91083198920,91083198922,2,1692,1398,-20
91088849356,91088849360,4,1457,988,-20
91089133006,91089133018,12,1042,1082,-20
91089829596,91089829598,2,2417,1094,-20
91091892095,91091892098,3,1010,1077,-20
91095158201,91095158204,3,2121,1230,-20
91101043819,91101043822,3,1836,1582,-20
91101499325,91101499327,2,2402,1400,-20
91105358223,91105358226,3,2200,1850,-20
91107704281,91107704285,4,2102,1614,-20
91108281997,91108281999,2,2132,1940,-20
91109867329,91109867332,3,1601,1601,-20
91114228154,91114228158,4,2388,1543,-20
91114420387,91114420370,-17,1487,1324,-20
91114563535,91114563537,2,2535,1309,-20
91115689609,91115689611,2,2207,1546,-20
91115735966,91115735970,4,2167,1398,-20
91119698911,91119698914,3,1838,1707,-20
91121292170,91121292174,4,1454,1413,-20
91122335307,91122335314,7,1816,1192,-20
91122475574,91122475593,19,1903,1537,-20
91123825277,91123825279,2,1977,1547,-20
91129482211,91129482215,4,2422,1105,-20
91138120754,91138120754,0,1221,2169,-20
91139099388,91139099394,6,2032,1541,-20
91140797367,91140797370,3,866,837,-20
91141766317,91141766319,2,2041,2069,-20
91143089914,91143089918,4,1840,1264,-20
91143572406,91143572409,3,1567,1575,-20
91143816183,91143816188,5,2661,1946,-20
91145472285,91145472288,3,1953,1705,-20
91152543222,91152543226,4,1830,1190,-20
91153184207,91153184211,4,1656,1126,-20
91153457769,91153457787,18,1725,1378,-20
91157120917,91157120921,4,1307,1581,-20
91158939093,91158939097,4,1638,1281,-20
91163274376,91163274379,3,2590,1493,-20
91164699038,91164699042,4,1818,1189,-20
91168338590,91168338594,4,4027,2731,-20
91170457901,91170457905,4,1634,1081,-20
91171693739,91171693742,3,2008,1686,-20
91173848425,91173848426,1,2018,1298,-20
91174912783,91174912783,0,1011,1744,-20
91176230253,91176230257,4,1254,997,-20
91176822201,91176822205,4,1302,1237,-20
91179878848,91179878853,5,1874,1419,-20
91182827201,91182827203,2,1476,1369,-20
91185059665,91185059668,3,1606,1387,-20
91189054106,91189054106,0,14463,18651,-20
91190117647,91190117650,3,1885,1802,-20
91192435208,91192435212,4,1406,1336,-20
91201022666,91201022669,3,1979,1511,-20
91201266308,91201266309,1,1515,1220,-20
91205297555,91205297560,5,1625,1505,-20
91206271305,91206271310,5,1912,1274,-20
91209037394,91209037397,3,1336,1076,-20
91213606211,91213606216,5,1713,1144,-20
91213986218,91213986214,-4,1496,2497,-20
91214684510,91214684513,3,1879,1437,-20
91215302991,91215302993,2,2343,2292,-20
91217223044,91217223049,5,1974,1833,-20
91218356559,91218356561,2,1046,1101,-20
91219723954,91219723956,2,1927,1467,-20
91223601051,91223601055,4,2002,1442,-20
91224946251,91224946252,1,1722,1782,-20
91233092360,91233092363,3,2769,1658,-20
91236518157,91236518160,3,1804,1548,-20
91242184963,91242184965,2,1475,1416,-20
91243257022,91243257022,0,2087,2568,-20
91243438014,91243438017,3,1400,1665,-20
91247647567,91247647571,4,1551,1232,-20
91248361285,91248361286,1,3976,2727,-20
91250494593,91250494574,-19,1445,1385,-20
91252576606,91252576610,4,1278,957,-20
91253187030,91253187033,3,1399,1616,-20
91267363592,91267363594,2,1873,1420,-20
91267646243,91267646256,13,17592,23402,-20
91274633170,91274633173,3,1096,1017,-20
91284224400,91284224406,6,1528,1710,-20
91284260337,91284260345,8,3344,1450,-20
91284309329,91284309329,0,977,989,-20
91291245474,91291245494,20,346,648,-20
91293293621,91293293625,4,1326,1297,-20
91293726395,91293726398,3,1967,1315,-20
91293983664,91293983667,3,1935,1505,-20
91294201190,91294201194,4,1206,715,-20
91297126356,91297126358,2,1314,1197,-20
91299494058,91299494061,3,1892,1734,-20
91300041819,91300041822,3,1796,1392,-20
91300591689,91300591689,0,2337,3337,-20
91304963641,91304963643,2,1780,1382,-20
91306158031,91306158015,-16,1226,935,-20
91308299096,91308299098,2,1439,1345,-20
91309267477,91309267479,2,2869,2171,-20
91310513688,91310513694,6,1861,1522,-20
91313053906,91313053907,1,2650,3374,-20
91319159328,91319159332,4,3337,2004,-20
91322888545,91322888550,5,2394,1427,-20
91323803254,91323803258,4,1396,1362,-20
91323920704,91323920706,2,163,3901,-20
91327960880,91327960887,7,158,1458,-20
91330476438,91330476440,2,1814,1313,-20
91330647158,91330647162,4,1735,1097,-20
91332093627,91332093630,3,2286,1153,-20
91332586085,91332586086,1,1105,1362,-20
91336561598,91336561604,6,1301,1204,-20
91338721042,91338721045,3,1331,1342,-20
91339026814,91339026818,4,1330,1230,-20
91341755365,91341755366,1,2096,1553,-20
91342721883,91342721885,2,3062,2002,-20
91345450505,91345450511,6,1698,1052,-20
91345535498,91345535502,4,1588,998,-20
91348188629,91348188631,2,2048,1339,-20
91349458122,91349458107,-15,1239,936,-20
91357977367,91357977369,2,1342,1091,-20
91359107444,91359107447,3,1829,1825,-20
91362350856,91362350858,2,1545,869,-20
91364331750,91364331748,-2,1657,2916,-20
91364649285,91364649289,4,1880,1148,-20
91364908215,91364908217,2,2170,2038,-20
91368645494,91368645498,4,1684,1399,-20
91369340975,91369340977,2,1723,1550,-20
91370530158,91370530166,8,3617,1971,-20
91379308509,91379308514,5,1569,1068,-20
91379649177,91379649193,16,2355,1554,-20
91380593865,91380593858,-7,1313,333,-20
91380916058,91380916041,-17,1086,717,-20
91384207384,91384207387,3,1842,1040,-20
91386158841,91386158843,2,1936,1919,-20
91386553006,91386553011,5,1865,1293,-20
91387451261,91387451265,4,1611,1460,-20
91388773822,91388773832,10,1546,1651,-20
91389622934,91389622932,-2,588,1415,-20
91390699047,91390699049,2,1260,1225,-20
91391272861,91391272865,4,1599,922,-20
91391841251,91391841256,5,9453,5800,-20
91393042283,91393042284,1,2217,2465,-20
91398051777,91398051778,1,1654,1304,-20
91398583050,91398583053,3,2399,1786,-20
91401743670,91401743674,4,1420,984,-20
91402197274,91402197277,3,2362,1623,-20
91402281190,91402281195,5,1519,1613,-20
91402324493,91402324513,20,1001,310,-20
91403750618,91403750622,4,2014,1823,-20
91409163867,91409163870,3,1313,878,-20
91413104189,91413104194,5,2427,1581,-20
91415136470,91415136475,5,2668,1350,-20
91416947442,91416947447,5,1260,1108,-20
91419102030,91419102031,1,1073,2279,-20
91420757418,91420757422,4,1970,1053,-20
91421420063,91421420068,5,1671,1241,-20
91427962798,91427962800,2,1746,902,-20
91430315892,91430315897,5,1186,858,-20
91432527490,91432527494,4,892,1273,-20
91436301322,91436301327,5,1956,1118,-20
91437212153,91437212153,0,1138,1164,-20
91446069955,91446069957,2,1347,1334,-20
91448809395,91448809389,-6,1222,967,-20
91449507429,91449507411,-18,1449,1252,-20
91450844638,91450844642,4,1320,1226,-20
91452408275,91452408271,-4,1200,3120,-20
91452748321,91452748326,5,1690,1337,-20
91454029066,91454029067,1,1620,991,-20
91457266474,91457266476,2,1258,1394,-20
91457345583,91457345600,17,751,361,-20
91458715923,91458715922,-1,1104,1808,-20
91460759265,91460759268,3,1799,1052,-20
91461944706,91461944710,4,1479,1267,-20
91463947699,91463947703,4,1864,1204,-20
91464149099,91464149093,-6,2303,8817,-20
91465222886,91465222887,1,1313,1213,-20
91471445101,91471445105,4,1764,1655,-20
91474239716,91474239719,3,1478,1244,-20
91475912234,91475912237,3,1954,1738,-20
91481137089,91481137091,2,1640,1271,-20
91482079610,91482079614,4,1482,1378,-20
91482179096,91482179099,3,1382,804,-20
91484901674,91484901678,4,1380,1168,-20
91489428271,91489428275,4,1960,1443,-20
91490335816,91490335821,5,2028,1009,-20
91492010261,91492010259,-2,1934,1391,-20
91493658561,91493658566,5,1600,1112,-20
91494447559,91494447563,4,1709,1217,-20
91496200565,91496200569,4,1673,1212,-20
91497682830,91497682834,4,2548,1247,-20
91502760842,91502760846,4,1472,1112,-20
91505561177,91505561178,1,1528,986,-20
91506064350,91506064351,1,1226,1084,-20
91507823522,91507823526,4,1733,1405,-20
91511933018,91511933023,5,1045,1220,-20
91519228449,91519228451,2,2546,1599,-20
91519763038,91519763041,3,1632,1362,-20
91521853790,91521853794,4,1969,1270,-20
91522083641,91522083645,4,1633,1578,-20
91523136970,91523136970,0,1513,1561,-20
91528069797,91528069798,1,2052,1513,-20
91528388383,91528388363,-20,567,3434,-20
91533382592,91533382595,3,2116,1114,-20
91541256399,91541256403,4,2002,1377,-20
91541363531,91541363514,-17,1731,709,-20
91546456075,91546456078,3,1861,1489,-20
91547417014,91547417017,3,2463,2079,-20
91549863734,91549863734,0,40944,29729,-20
91550270158,91550270162,4,1293,1337,-20
91554742354,91554742359,5,2411,1596,-20
91561914474,91561914478,4,1661,1408,-20
91562058764,91562058784,20,1520,1442,-20
91562099759,91562099761,2,1276,1446,-20
91564483397,91564483401,4,1884,1667,-20
91565054045,91565054067,22,1514,1493,-20
91565911343,91565911351,8,9799,21313,-20
91568032541,91568032542,1,1438,1148,-20
91568159006,91568159010,4,1948,1284,-20
91569894053,91569894054,1,1231,1446,-20
91571035197,91571035198,1,3404,3993,-20
91574258522,91574258525,3,1604,1453,-20
91575092821,91575092824,3,1359,1149,-20
91578715260,91578715265,5,1318,1229,-20
91582452114,91582452118,4,2552,2393,-20
91584285705,91584285706,1,1336,1714,-20
91585863686,91585863690,4,39608,24818,-20
91589412562,91589412565,3,1625,1028,-20
91591705273,91591705275,2,1476,1220,-20
91592644495,91592644498,3,2005,1782,-20
91593164742,91593164746,4,2160,1295,-20
91594953833,91594953815,-18,2287,1563,-20
91597002275,91597002278,3,738,947,-20
91599799969,91599799974,5,1634,1186,-20
91600102608,91600102605,-3,1514,1088,-20
91608119545,91608119547,2,1984,1276,-20
91609202970,91609202974,4,1893,1713,-20
91610397386,91610397385,-1,861,782,-20
91611492561,91611492562,1,968,927,-20
91612150355,91612150359,4,2091,1565,-20
91612650192,91612650193,1,1901,1994,-20
91613268031,91613268032,1,1311,1583,-20
91619450410,91619450413,3,1526,1410,-20
91620264133,91620264153,20,1431,1646,-20
91625616674,91625616678,4,1666,1423,-20
91626865878,91626865874,-4,1122,2989,-20
91628455574,91628455570,-4,1150,2705,-20
91632218474,91632218478,4,2601,1928,-20
91634404337,91634404359,22,1162,1539,-20
91636066429,91636066432,3,1393,1681,-20
91645999151,91645999154,3,570,689,-20
91648328211,91648328214,3,963,1251,-20
91652497839,91652497843,4,1974,1436,-20
91656169399,91656169402,3,1613,1029,-20
91657341033,91657341037,4,1618,1437,-20
91657639310,91657639311,1,2325,1507,-20
91658532645,91658532646,1,1809,1911,-20
91658913367,91658913370,3,1579,1141,-20
91659751405,91659751407,2,1548,1371,-20
91662090588,91662090591,3,1661,1068,-20
91662877934,91662877938,4,2036,1509,-20
91664135334,91664135338,4,1771,1909,-20
91664587200,91664587203,3,2706,1510,-20
91664840290,91664840294,4,2182,1503,-20
91665895394,91665895397,3,1652,1167,-20
91670748794,91670748799,5,3528,1897,-20
91676474078,91676474084,6,2247,1578,-20
91678442363,91678442366,3,2037,1508,-20
91679431957,91679431961,4,1981,1756,-20
91679464635,91679464638,3,1535,1577,-20
91684420362,91684420366,4,1385,1029,-20
91688039795,91688039799,4,1439,1021,-20
91688380963,91688380958,-5,2187,5954,-20
91692172465,91692172468,3,1549,1627,-20
91694397030,91694397033,3,1789,1336,-20
91704902268,91704902271,3,2576,1803,-20
91707296130,91707296136,6,2664,1959,-20
91707628407,91707628416,9,838,120,-20
91711798587,91711798593,6,2480,1744,-20
91715353038,91715353042,4,1824,1686,-20
91718387649,91718387653,4,2765,1553,-20
91718482101,91718482104,3,1969,1390,-20
91718945192,91718945197,5,1678,1484,-20
91719802939,91719802943,4,1430,1118,-20
91720686603,91720686605,2,1884,1890,-20
91720905093,91720905097,4,2522,2031,-20
91733352874,91733352876,2,2138,1722,-20
91739610767,91739610771,4,2011,1521,-20
91741383818,91741383822,4,1578,1466,-20
91744897043,91744897043,0,3479,3670,-20
91748613600,91748613603,3,2044,1706,-20
91750043764,91750043766,2,1337,1392,-20
91751161002,91751161005,3,2413,1000,-20
91752327906,91752327906,0,1183,1270,-20
91752885266,91752885270,4,1778,1436,-20
91753381611,91753381614,3,1790,1815,-20
91754182381,91754182384,3,1052,840,-20
91754580306,91754580307,1,1038,906,-20
91755066147,91755066150,3,1601,774,-20
91764203145,91764203146,1,1936,1297,-20
91764494259,91764494262,3,1233,1027,-20
91768904162,91768904167,5,2543,1231,-20
91772498244,91772498248,4,1199,1263,-20
91777032723,91777032726,3,1669,1312,-20
91778784490,91778784495,5,1823,1362,-20
91779577098,91779577101,3,2222,1194,-20
91780807114,91780807118,4,1230,853,-20
91782811689,91782811691,2,1845,1136,-20
91783157595,91783157600,5,1598,1207,-20
91784310890,91784310892,2,1922,1451,-20
91786857983,91786857989,6,2069,1560,-20
91787477773,91787477777,4,1610,1274,-20
91787835214,91787835218,4,1742,1806,-20
91788243083,91788243086,3,1495,1577,-20
91790693025,91790693027,2,2024,1403,-20
91791146262,91791146266,4,1657,876,-20
91791361919,91791361922,3,2483,1572,-20
91791510758,91791510745,-13,1152,645,-20
91793459489,91793459478,-11,1774,418,-20
91794676578,91794676584,6,2318,1710,-20
91798017428,91798017432,4,2437,1286,-20
91800973244,91800973247,3,1685,771,-20
91801754077,91801754081,4,1985,1833,-20
91802786251,91802786255,4,2248,1028,-20
91806348868,91806348871,3,1627,997,-20
91807520886,91807520890,4,2265,1555,-20
91810168111,91810168114,3,2324,1657,-20
91810209206,91810209210,4,1080,762,-20
91814164409,91814164412,3,1606,1304,-20
91815356398,91815356400,2,1723,1348,-20
91816113264,91816113267,3,2000,1536,-20
91816889042,91816889047,5,1051,1106,-20
91823302316,91823302319,3,1497,1166,-20
91825350523,91825350526,3,1786,1537,-20
91825395616,91825395618,2,2293,1357,-20
91825986335,91825986339,4,1106,966,-20
91826926512,91826926494,-18,1346,1089,-20
91833904607,91833904613,6,908,504,-20
91836128855,91836128858,3,1341,1302,-20
91837559002,91837559019,17,868,156,-20
91840237097,91840237119,22,1031,1362,-20
91841993134,91841993138,4,1880,1080,-20
91844385811,91844385810,-1,1119,1534,-20
91852328222,91852328227,5,2203,1670,-20
91853857245,91853857248,3,2419,1769,-20
91853935817,91853935821,4,1764,1581,-20
91854739014,91854739018,4,1351,1337,-20
91856239834,91856239838,4,1809,1603,-20
91857978273,91857978276,3,1606,1571,-20
91858565325,91858565326,1,1336,1655,-20
91860697785,91860697787,2,1822,1192,-20
91865912847,91865912851,4,1421,973,-20
91866457998,91866457984,-14,1700,1779,-20
91868657875,91868657873,-2,1380,3152,-20
91870085961,91870085966,5,2557,1075,-20
91870651554,91870651558,4,1564,1512,-20
91879168349,91879168352,3,1585,1176,-20
91880251169,91880251151,-18,1226,1063,-20
91882336717,91882336721,4,2302,1276,-20
91886046373,91886046378,5,1666,1307,-20
91887801435,91887801438,3,2299,1140,-20
91894658606,91894658610,4,2651,1770,-20
91895265594,91895265599,5,1144,1318,-20
91906100913,91906100918,5,2293,1204,-20
91909899274,91909899278,4,1684,1536,-20
91911636109,91911636115,6,944,852,-20
91914624038,91914624041,3,2049,1360,-20
91916738509,91916738512,3,1250,1295,-20
91918209492,91918209488,-4,1636,4143,-20
91920216378,91920216383,5,2597,1681,-20
91920977378,91920977384,6,2266,1594,-20
91921948082,91921948087,5,1686,1153,-20
91922526269,91922526271,2,1519,1487,-20
91924322271,91924322268,-3,2461,5773,-20
91925287938,91925287954,16,1177,1421,-20
91931316908,91931316910,2,2127,1310,-20
91931952421,91931952425,4,2245,1834,-20
91938477841,91938477847,6,2990,1462,-20
91944688345,91944688349,4,1442,1157,-20
91953509144,91953509146,2,1675,1146,-20
91958355156,91958355158,2,1720,1376,-20
91958581153,91958581157,4,1790,1696,-20
91959333929,91959333914,-15,2308,1247,-20
91960065102,91960065106,4,1611,745,-20
91960783791,91960783794,3,3318,1864,-20
91966470621,91966470623,2,2032,1342,-20
91968645486,91968645489,3,1863,1373,-20
91973167490,91973167485,-5,1204,3983,-20
91974280441,91974280444,3,2010,1403,-20
91975435573,91975435577,4,2115,1190,-20
91979865076,91979865078,2,1446,810,-20
91980610332,91980610334,2,2009,1212,-20
91981031647,91981031650,3,2164,1283,-20
91981655323,91981655338,15,1413,792,-20
91981980626,91981980611,-15,1877,997,-20
91985549650,91985549653,3,2045,1607,-20
91986195858,91986195862,4,1821,1767,-20
91987904462,91987904463,1,1599,1130,-20
91994501618,91994501623,5,1986,1148,-20
91997605582,91997605585,3,2257,1530,-20
91998294337,91998294339,2,2313,1600,-20
91999236002,91999236006,4,2002,982,-20
92002152720,92002152724,4,2603,1449,-20
92005269343,92005269363,20,1475,1502,-20
92009103052,92009103059,7,2202,1242,-20
92014696226,92014696222,-4,1280,2586,-20
92015036726,92015036729,3,1248,1638,-20
92016170744,92016170747,3,1867,1334,-20
92017003354,92017003357,3,1309,1196,-20
92019580842,92019580846,4,2407,1565,-20
92019751989,92019751991,2,1383,1050,-20
92023138340,92023138341,1,1030,1170,-20
92024360700,92024360703,3,1335,1157,-20
92025681944,92025681946,2,2233,1623,-20
92029330629,92029330632,3,2536,2182,-20
92031416550,92031416559,9,8276,32678,-20
92031736057,92031736061,4,7263,4408,-20
92032682858,92032682861,3,1625,1278,-20
92036370506,92036370510,4,2041,1623,-20
92040252234,92040252237,3,1919,1927,-20
92048572646,92048572650,4,2138,1588,-20
92050714753,92050714751,-2,1769,1459,-20
92051265673,92051265678,5,1996,1142,-20
92051965336,92051965345,9,1774,977,-20
92053312383,92053312392,9,2641,1671,-20
92055891478,92055891477,-1,1739,2314,-20
92060730025,92060730027,2,1435,1411,-20
92064816319,92064816314,-5,709,1324,-20
92064960108,92064960112,4,1519,1564,-20
92068076500,92068076499,-1,1736,1394,-20
92068625731,92068625737,6,4779,1963,-20
92073713903,92073713907,4,1563,1429,-20
92075824953,92075824958,5,2010,1452,-20
92080630049,92080630053,4,1896,1468,-20
92081161155,92081161158,3,791,982,-20
92084669150,92084669153,3,2316,1506,-20
92088329947,92088329950,3,1087,919,-20
92093271047,92093271047,0,387,1086,-20
92095376442,92095376445,3,2092,1684,-20
92095781867,92095781871,4,1794,1266,-20
92100626590,92100626594,4,1630,1573,-20
92100821864,92100821867,3,1246,1466,-20
92101083759,92101083761,2,1541,1006,-20
92105498162,92105498161,-1,1026,1877,-20
92105653215,92105653217,2,1650,1048,-20
92107689255,92107689259,4,1698,1607,-20
92113119102,92113119105,3,1552,1396,-20
92115961931,92115961934,3,2255,1359,-20
92117006957,92117006961,4,1715,1586,-20
92121466295,92121466302,7,6486,2847,-20
92121734985,92121734987,2,1745,1213,-20
92126782381,92126782385,4,1413,968,-20
92134442303,92134442307,4,1813,1354,-20
92141238009,92141238013,4,1944,1384,-20
92142502881,92142502882,1,2031,1179,-20
92143901342,92143901346,4,1555,1678,-20
92144181719,92144181723,4,1780,1816,-20
92145637917,92145637920,3,2023,1697,-20
92147218093,92147218097,4,1943,1634,-20
92147311732,92147311734,2,2109,1476,-20
92153519831,92153519834,3,1855,1606,-20
92154095092,92154095096,4,2410,2045,-20
92156842363,92156842362,-1,1471,1757,-20
92157078438,92157078439,1,1261,1183,-20
92158336586,92158336591,5,2230,1601,-20
92159361809,92159361810,1,1628,769,-20
92160302303,92160302306,3,2133,1586,-20
92161347750,92161347749,-1,1034,2111,-20
92163085025,92163085029,4,1397,1252,-20
92163165589,92163165593,4,995,152,-20
92165919299,92165919303,4,2250,1414,-20
92166413255,92166413259,4,2409,1111,-20
92169781330,92169781333,3,2386,1329,-20
92172101337,92172101341,4,1851,1353,-20
92176023173,92176023170,-3,1483,2491,-20
92177281797,92177281798,1,2468,1449,-20
92180118069,92180118071,2,793,1141,-20
92182370932,92182370935,3,2095,1096,-20
92183577014,92183577016,2,1708,1234,-20
92184850826,92184850830,4,1554,1610,-20
92188611845,92188611846,1,1763,1176,-20
92188918724,92188918728,4,1306,873,-20
92189636035,92189636038,3,1509,982,-20
92190056278,92190056282,4,2173,1334,-20
92193107323,92193107326,3,2006,1609,-20
92193685734,92193685738,4,2426,1948,-20
92194131762,92194131766,4,2313,1418,-20
92194203687,92194203690,3,1824,1345,-20
92197757211,92197757213,2,1986,1494,-20
92202230902,92202230906,4,2523,1910,-20
92209116376,92209116377,1,1402,1825,-20
92210124334,92210124338,4,1784,1195,-20
92212697701,92212697705,4,1786,1730,-20
92214569813,92214569817,4,1976,1389,-20
92215249463,92215249467,4,1613,1490,-20
92215559574,92215559578,4,1495,1202,-20
92217646136,92217646133,-3,1610,2280,-20
92220089030,92220089033,3,1805,1719,-20
92220863994,92220863989,-5,1051,4532,-20
92225309510,92225309490,-20,1258,1953,-20
92225872158,92225872162,4,2383,1608,-20
92226858534,92226858537,3,1569,1668,-20
92232017337,92232017339,2,1610,1516,-20
92233253425,92233253432,7,1957,1177,-20
92235443369,92235443372,3,2305,2212,-20
92238229034,92238229038,4,2270,1628,-20
92244753070,92244753073,3,1174,1081,-20
92250225910,92250225917,7,1080,1039,-20
92250514452,92250514454,2,906,1441,-20
92251352056,92251352061,5,1977,1057,-20
92252725874,92252725878,4,1341,1081,-20
92255638838,92255638842,4,2895,2007,-20
92256497077,92256497081,4,2066,1456,-20
92256722683,92256722689,6,1748,1488,-20
92256937765,92256937766,1,1766,1522,-20
92262822566,92262822569,3,1735,1098,-20
92264444204,92264444209,5,2046,1229,-20
92264795113,92264795115,2,1138,1251,-20
92268827935,92268827937,2,1866,1639,-20
92270348491,92270348470,-21,1492,1411,-20
92277442205,92277442203,-2,1428,2861,-20
92278319430,92278319430,0,1382,1139,-20
92280079944,92280079943,-1,1406,1313,-20
92280531269,92280531275,6,1678,1049,-20
92281677497,92281677498,1,1254,1344,-20
92285924350,92285924351,1,2528,1876,-20
92286289225,92286289226,1,2385,1754,-20
92289544203,92289544207,4,2222,1435,-20
92291308575,92291308572,-3,1024,1502,-20
92295863818,92295863819,1,1594,1559,-20
92299218582,92299218584,2,1342,1627,-20
92300888272,92300888274,2,1702,1486,-20
92302474993,92302474994,1,1639,779,-20
92306220744,92306220745,1,1831,2066,-20
92307542931,92307542931,0,2070,1721,-20
92309509685,92309509689,4,1438,847,-20
92312728505,92312728507,2,1450,1143,-20
92314162934,92314162939,5,2105,1985,-20
92319780678,92319780682,4,2220,1651,-20
92320549033,92320549035,2,1727,1212,-20
92321666651,92321666655,4,1208,1347,-20
92321901089,92321901092,3,1695,1631,-20
92324574107,92324574113,6,1846,813,-20
92327220132,92327220129,-3,1184,2761,-20
92337257883,92337257875,-8,24251,11287,-20
92337447020,92337447026,6,2390,1724,-20
92337528089,92337528075,-14,753,197,-20
92337874988,92337875012,24,1699,1391,-20
92339550886,92339550890,4,2023,1830,-20
92344207359,92344207362,3,1772,1436,-20
92345083992,92345083994,2,1246,1321,-20
92349171802,92349171802,0,1469,1161,-20
92349656057,92349656068,11,12313,49084,-20
92350048085,92350048088,3,2373,1776,-20
92355516951,92355516957,6,1449,1258,-20
92355723778,92355723761,-17,1438,806,-20
92358399793,92358399796,3,1604,1823,-20
92360932991,92360932994,3,1012,1158,-20
92362833918,92362833922,4,1000,781,-20
92363299442,92363299451,9,1620,1575,-20
92363927975,92363927977,2,1449,1512,-20
92365714575,92365714578,3,2155,1213,-20
92369234149,92369234157,8,1613,1421,-20
92370607642,92370607639,-3,2387,2721,-20
92372872245,92372872246,1,2733,2875,-20
92375971526,92375971532,6,1489,1101,-20
92377241083,92377241087,4,1645,1076,-20
92377542763,92377542756,-7,1654,6346,-20
92378899266,92378899270,4,2799,1405,-20
92378987521,92378987526,5,1571,1204,-20
92380240719,92380240722,3,1507,1340,-20
92383111115,92383111114,-1,1118,631,-20
92385494119,92385494122,3,1230,1015,-20
92387081179,92387081184,5,2380,1654,-20
92387991614,92387991617,3,1168,1766,-20
92393067313,92393067316,3,2419,1712,-20
92396928825,92396928830,5,1766,1126,-20
92397535878,92397535883,5,1685,1152,-20
92399773162,92399773167,5,1589,1493,-20
92400226081,92400226085,4,1875,1473,-20
92402054390,92402054394,4,1903,1583,-20
92406521410,92406521413,3,1191,765,-20
92407709427,92407709429,2,1252,1443,-20
92409587211,92409587214,3,2387,1209,-20
92410756876,92410756878,2,2839,2471,-20
92420430789,92420430791,2,2373,1314,-20
92422377186,92422377191,5,1521,1118,-20
92425964189,92425964193,4,1966,1654,-20
92427153494,92427153497,3,3477,2434,-20
92427274704,92427274706,2,1879,2098,-20
92427431578,92427431578,0,1414,1979,-20
92427743950,92427743951,1,1486,1149,-20
92429139739,92429139742,3,2057,2590,-20
92429179429,92429179431,2,1918,935,-20
92435863368,92435863372,4,1773,1376,-20
92439506544,92439506547,3,1404,1386,-20
92447433884,92447433888,4,2445,1541,-20
92450762177,92450762181,4,1227,1151,-20
92465366822,92465366818,-4,1659,6005,-20
92466498315,92466498317,2,2509,1927,-20
92473380617,92473380620,3,1936,1729,-20
92477583153,92477583154,1,1497,1609,-20
92481049982,92481049986,4,1668,1457,-20
92484451193,92484451197,4,1866,1263,-20
92484883223,92484883226,3,1478,1200,-20
92492479277,92492479273,-4,866,2993,-20
92495168611,92495168606,-5,1068,3166,-20
92496034798,92496034804,6,2933,1758,-20
92498778655,92498778658,3,2521,1693,-20
92502237389,92502237390,1,1637,1461,-20
92502913136,92502913138,2,1323,1373,-20
92510598092,92510598089,-3,1331,2545,-20
92511732276,92511732279,3,2030,2153,-20
92513299758,92513299761,3,2242,1125,-20
92513920367,92513920378,11,1729,1393,-20
92518671421,92518671423,2,861,960,-20
92521422826,92521422826,0,1143,2387,-20
92527340209,92527340212,3,1558,963,-20
92529258847,92529258849,2,1400,1507,-20
92530089965,92530089970,5,2162,1460,-20
92534998867,92534998869,2,1426,1463,-20
92535945327,92535945331,4,1774,1491,-20
92537110040,92537110043,3,1355,1074,-20
92540291330,92540291336,6,1469,1336,-20
92540880211,92540880212,1,2115,1978,-20
92541477894,92541477898,4,3535,1026,-20
92541544113,92541544119,6,3293,1245,-20
92546770203,92546770207,4,1183,1059,-20
92547489582,92547489586,4,1225,1003,-20
92548023923,92548023927,4,1704,975,-20
92549383846,92549383850,4,1428,1025,-20
92552382506,92552382510,4,1828,1126,-20
92552968053,92552968058,5,2302,988,-20
92557104958,92557104961,3,1960,1442,-20
92557914548,92557914551,3,1178,988,-20
92559064938,92559064934,-4,18623,67775,-20
92562107339,92562107342,3,1345,1225,-20
92562474467,92562474470,3,1618,1243,-20
92563334475,92563334481,6,1887,1580,-20
92564805485,92564805489,4,2292,1339,-20
92569406005,92569406007,2,1637,1259,-20
92572132599,92572132603,4,2128,1957,-20
92574183947,92574183951,4,1467,1501,-20
92576168887,92576168889,2,1700,1326,-20
92578980185,92578980168,-17,1977,1220,-20
92579931195,92579931198,3,1435,1303,-20
92582463954,92582463936,-18,683,502,-20
92584218278,92584218281,3,1394,1486,-20
92584336482,92584336467,-15,1803,1157,-20
92586199006,92586199008,2,1958,1471,-20
92591783262,92591783262,0,1093,1001,-20
92593157973,92593157975,2,2091,1385,-20
92594047352,92594047357,5,1258,828,-20
92597815210,92597815213,3,2198,1587,-20
92601208984,92601208987,3,2323,1120,-20
92606951584,92606951586,2,2155,1212,-20
92607089739,92607089752,13,1549,1044,-20
92609821222,92609821225,3,1183,1548,-20
92615590975,92615590985,10,245,889,-20
92618053411,92618053414,3,1552,1671,-20
92620425234,92620425237,3,1855,1164,-20
92620809422,92620809425,3,1478,1554,-20
92621454335,92621454339,4,5125,2825,-20
92621976650,92621976655,5,1891,1155,-20
92625273837,92625273842,5,1980,2018,-20
92629320350,92629320355,5,1735,1282,-20
92632559670,92632559672,2,1948,1254,-20
92632851374,92632851379,5,1543,1330,-20
92632947546,92632947550,4,1816,964,-20
92634552333,92634552333,0,1455,1392,-20
92635521089,92635521078,-11,1481,1095,-20
92635621596,92635621599,3,1864,1285,-20
92636354317,92636354319,2,1409,871,-20
92636912330,92636912334,4,1965,895,-20
92638027651,92638027655,4,1647,1470,-20
92641039199,92641039204,5,2433,1191,-20
92643394308,92643394294,-14,841,383,-20
92643760826,92643760810,-16,1394,575,-20
92645778162,92645778164,2,1524,2101,-20
92651045950,92651045954,4,20208,44933,-20
92656250978,92656250980,2,1809,1250,-20
92659444502,92659444505,3,1908,1771,-20
92660420863,92660420866,3,2022,1601,-20
92661436085,92661436089,4,1304,1806,-20
92662921177,92662921180,3,2063,1915,-20
92663728465,92663728469,4,1787,1720,-20
92664301693,92664301707,14,1935,1831,-20
92665254702,92665254705,3,1398,1234,-20
92665643657,92665643674,17,2360,1550,-20
92669069410,92669069416,6,1349,1484,-20
92681061687,92681061693,6,2621,1482,-20
92681996603,92681996603,0,1409,1319,-20
92685047976,92685047969,-7,3044,8183,-20
92687814176,92687814179,3,1580,1042,-20
92689310474,92689310474,0,1159,1848,-20
92689845664,92689845667,3,2991,2919,-20
92690785506,92690785510,4,1219,1131,-20
92693512680,92693512680,0,1133,964,-20
92695777235,92695777238,3,1160,890,-20
92697934062,92697934064,2,2580,1584,-20
92699381528,92699381529,1,1404,1307,-20
92699480977,92699480981,4,1822,1224,-20
92700070729,92700070730,1,1247,896,-20
92703625569,92703625571,2,2375,1328,-20
92703872259,92703872266,7,4007,1276,-20
92710003409,92710003413,4,2375,1604,-20
92710979236,92710979241,5,1760,1360,-20
92713310356,92713310361,5,2249,1613,-20
92715140466,92715140470,4,1899,1304,-20
92722074688,92722074691,3,1790,1269,-20
92722122018,92722122010,-8,867,3141,-20
92726401101,92726401105,4,2232,1466,-20
92729528428,92729528430,2,1265,1081,-20
92731154507,92731154510,3,2143,1559,-20
92742712522,92742712523,1,2183,2017,-20
92744162579,92744162582,3,2033,1147,-20
92744644889,92744644893,4,1564,1453,-20
92746581882,92746581886,4,1299,1397,-20
92746763593,92746763595,2,2447,1738,-20
92748530854,92748530858,4,1659,1438,-20
92756646376,92756646378,2,1796,1162,-20
92756689882,92756689889,7,1466,1156,-20
92757943535,92757943539,4,1934,1184,-20
92758278566,92758278569,3,2301,1110,-20
92759798703,92759798708,5,1620,1142,-20
92759911965,92759911968,3,1089,1126,-20
92761981656,92761981659,3,1959,1424,-20
92762789929,92762789931,2,2177,1440,-20
92763488312,92763488316,4,2182,1333,-20
92764054057,92764054061,4,2457,1439,-20
92765771787,92765771790,3,2597,1847,-20
92766298969,92766298971,2,1595,1419,-20
92767810202,92767810205,3,1995,1369,-20
92772835179,92772835181,2,1782,1495,-20
92773835239,92773835242,3,1175,953,-20
92780690130,92780690134,4,1888,1713,-20
92782011539,92782011543,4,1659,1446,-20
92784535492,92784535486,-6,1162,2905,-20
92785067972,92785067974,2,1955,1587,-20
92787875409,92787875411,2,1931,1667,-20
92790994016,92790994021,5,1841,1618,-20
92795518070,92795518071,1,1983,2211,-20
92797701801,92797701806,5,1644,1044,-20
92801859056,92801859054,-2,878,1338,-20
92802842865,92802842867,2,1449,1016,-20
92804414194,92804414198,4,2002,1164,-20
92807136309,92807136310,1,1783,1668,-20
92808146618,92808146622,4,2296,1266,-20
92810047432,92810047433,1,2649,2641,-20
92810467277,92810467281,4,1928,1830,-20
92811053202,92811053202,0,1485,2308,-20
92811463169,92811463174,5,2239,1160,-20
92811668267,92811668269,2,1686,1728,-20
92814545777,92814545778,1,1409,1016,-20
92815536388,92815536390,2,1493,1577,-20
92816800908,92816800911,3,1715,1375,-20
92816956202,92816956208,6,1630,1656,-20
92819415334,92819415335,1,1618,1383,-20
92820127495,92820127480,-15,1973,878,-20
92820957972,92820957974,2,1560,1115,-20
92821320269,92821320274,5,1866,1008,-20
92822165474,92822165477,3,2100,1948,-20
92822977339,92822977342,3,1370,1181,-20
92825751105,92825751107,2,2119,1545,-20
92828638338,92828638342,4,2099,1410,-20
92831073163,92831073165,2,1497,1763,-20
92832480113,92832480115,2,1619,1043,-20
92833240682,92833240685,3,1528,1236,-20
92834820743,92834820746,3,1365,1618,-20
92837989969,92837989971,2,1147,1340,-20
92838053325,92838053330,5,2048,1216,-20
92839474030,92839474033,3,1262,1172,-20
92841928237,92841928242,5,2575,1401,-20
92844356403,92844356407,4,2491,1276,-20
92849879786,92849879789,3,2205,1936,-20
92850808718,92850808722,4,1824,1896,-20
92851212113,92851212115,2,1540,1429,-20
92851869763,92851869770,7,3882,1531,-20
92853248306,92853248322,16,2400,1148,-20
92853834874,92853834882,8,3134,1233,-20
92854162254,92854162255,1,2526,2215,-20
92861665735,92861665740,5,2382,1875,-20
92862670995,92862670998,3,2273,1846,-20
92865243847,92865243852,5,1113,845,-20
92865554543,92865554547,4,1557,1819,-20
92870722556,92870722557,1,1353,1154,-20
92871621625,92871621631,6,2556,1528,-20
92876911182,92876911186,4,1584,1277,-20
92879464075,92879464081,6,2729,1696,-20
92880116503,92880116500,-3,1342,4337,-20
92881148293,92881148290,-3,932,1896,-20
92882545118,92882545123,5,1685,1385,-20
92882738386,92882738391,5,1656,899,-20
92884415985,92884415989,4,2040,1443,-20
92885711317,92885711321,4,1969,1312,-20
92886425648,92886425651,3,1761,1725,-20
92888969183,92888969185,2,2317,1784,-20
92889249963,92889249965,2,1387,1364,-20
92889526700,92889526703,3,1901,1524,-20
92890191476,92890191478,2,1310,1170,-20
92891959132,92891959135,3,2169,1370,-20
92893241741,92893241739,-2,1227,2141,-20
92894914070,92894914070,0,1750,1145,-20
92898083493,92898083498,5,1877,1230,-20
92898876005,92898876009,4,1494,1719,-20
92899190775,92899190777,2,1698,1434,-20
92899817879,92899817883,4,1560,1457,-20
92901144736,92901144739,3,1056,1391,-20
92902519518,92902519514,-4,1500,3531,-20
92903012629,92903012633,4,1449,1110,-20
92908871142,92908871146,4,1776,1650,-20
92909270251,92909270256,5,1582,1381,-20
92909345223,92909345228,5,1427,863,-20
92911984197,92911984195,-2,1435,2499,-20
92915567348,92915567353,5,1817,1351,-20
92915720022,92915720025,3,2295,1903,-20
92917015423,92917015427,4,2270,1407,-20
92919020638,92919020642,4,2405,1617,-20
92919108969,92919108985,16,1325,1436,-20
92923085460,92923085463,3,1843,1373,-20
92927116523,92927116526,3,1273,1059,-20
92937452913,92937452917,4,1650,1409,-20
92944232009,92944232014,5,2543,1797,-20
92945819262,92945819263,1,1271,1388,-20
92951082482,92951082486,4,1283,1114,-20
92951504314,92951504318,4,2217,2208,-20
92952344932,92952344928,-4,184,243,-20
92953592282,92953592287,5,2235,1726,-20
92956232656,92956232660,4,2454,1866,-20
92957262783,92957262786,3,1299,1107,-20
92959206163,92959206167,4,2299,1344,-20
92959366267,92959366265,-2,376,338,-20
92960299262,92960299266,4,1634,1448,-20
92961533506,92961533509,3,2236,1485,-20
92966492676,92966492681,5,1904,1308,-20
92966587401,92966587402,1,1357,1045,-20
92967424758,92967424762,4,2266,1226,-20
92969017718,92969017723,5,1895,1278,-20
92970522325,92970522330,5,1195,1538,-20
92971940461,92971940463,2,2775,1262,-20
92975389334,92975389334,0,1349,1218,-20
92976615454,92976615457,3,2231,1567,-20
92978234414,92978234415,1,1984,1540,-20
92978734095,92978734098,3,1616,1690,-20
92980761725,92980761729,4,1418,1562,-20
92981292966,92981292974,8,2783,1859,-20
92986449248,92986449252,4,1411,1365,-20
92991327801,92991327806,5,1479,1291,-20
92992762978,92992762985,7,2571,1005,-20
92994995315,92994995321,6,1293,1292,-20
92995373176,92995373179,3,1200,1184,-20
93001952188,93001952190,2,2074,1757,-20
93002023218,93002023200,-18,755,448,-20
93002601386,93002601384,-2,676,1244,-20
93003920000,93003920002,2,2288,1191,-20
93004187502,93004187481,-21,1184,1088,-20
93004237792,93004237796,4,2018,1203,-20
93005660653,93005660632,-21,709,461,-20
93007799530,93007799535,5,2172,1579,-20
93009354238,93009354241,3,2133,1642,-20
93012907236,93012907237,1,1944,1236,-20
93012991847,93012991834,-13,1141,209,-20
93013504076,93013504078,2,1446,1619,-20
93014410918,93014410922,4,1908,961,-20
93017206793,93017206773,-20,1203,643,-20
93017572074,93017572077,3,1561,1673,-20
93020091795,93020091798,3,2042,1570,-20
93022564490,93022564493,3,2476,1563,-20
93023334514,93023334531,17,1109,1179,-20
93028653092,93028653096,4,1672,1238,-20
93030263415,93030263417,2,1670,1815,-20
93030721898,93030721902,4,1732,1256,-20
93031783175,93031783177,2,1223,1187,-20
93036885251,93036885254,3,2395,1091,-20
93043868969,93043868974,5,1594,1208,-20
93047541077,93047541080,3,1662,1337,-20
93056180455,93056180460,5,1192,1122,-20
93058168761,93058168762,1,1546,804,-20
93066684912,93066684913,1,1822,1063,-20
93068437726,93068437730,4,1293,1148,-20
93068715058,93068715062,4,1512,1480,-20
93069350967,93069350969,2,1250,1357,-20
93071328704,93071328710,6,4639,1255,-20
93073961135,93073961138,3,1468,1381,-20
93073992459,93073992461,2,2372,1335,-20
93074132473,93074132475,2,1745,1404,-20
93075375430,93075375434,4,2431,1623,-20
93075571355,93075571358,3,2042,1425,-20
93078004996,93078004998,2,1631,710,-20
93078817982,93078817986,4,1169,1207,-20
93084478293,93084478296,3,1677,776,-20
93088376214,93088376219,5,1590,1514,-20
93088732418,93088732422,4,1050,763,-20
93089823314,93089823318,4,1730,1457,-20
93092268981,93092268982,1,1203,2033,-20
93096402208,93096402212,4,1880,1382,-20
93096576289,93096576293,4,2273,2147,-20
93096618789,93096618791,2,1980,1439,-20
93097009004,93097009009,5,1904,1113,-20
93100527725,93100527726,1,1198,1181,-20
93102780723,93102780727,4,1371,1134,-20
93102820062,93102820065,3,1364,1540,-20
93105132302,93105132307,5,2258,1475,-20
93105301189,93105301190,1,1814,1821,-20
93108514816,93108514817,1,3377,3730,-20
93110458830,93110458831,1,1817,2695,-20
93110793047,93110793049,2,1821,1540,-20
93111248895,93111248895,0,1414,2031,-20
93111474288,93111474292,4,1932,1326,-20
93113342065,93113342068,3,1416,1236,-20
93114761090,93114761094,4,1618,1841,-20
93115903550,93115903553,3,1776,1348,-20
93116298557,93116298559,2,1598,1128,-20
93117194538,93117194541,3,1802,1404,-20
93121777959,93121777962,3,1380,1226,-20
93122414978,93122414983,5,1839,1366,-20
93124701585,93124701589,4,1642,1119,-20
93125691563,93125691565,2,1854,1183,-20
93126020631,93126020635,4,1867,1248,-20
93127125214,93127125210,-4,2565,5814,-20
93129445725,93129445730,5,2140,1771,-20
93134593733,93134593734,1,1273,1232,-20
93143153550,93143153552,2,1283,1888,-20
93147864658,93147864663,5,2092,1231,-20
93153347019,93153347011,-8,1052,1127,-20
93158751463,93158751459,-4,1730,2715,-20
93160808738,93160808739,1,1238,1451,-20
93162164630,93162164635,5,2208,1476,-20
93163483978,93163483982,4,1989,1049,-20
93164866595,93164866590,-5,1429,4853,-20
93165780581,93165780583,2,1134,1118,-20
93166145571,93166145550,-21,22395,40700,-20
93167479600,93167479603,3,1665,1219,-20
93172395862,93172395867,5,1288,1487,-20
93174162849,93174162850,1,1492,1342,-20
93175416494,93175416499,5,1434,1046,-20
93176151196,93176151198,2,1423,1370,-20
93179622109,93179622112,3,1551,1809,-20
93184116691,93184116686,-5,1375,3607,-20
93186047266,93186047270,4,2120,1484,-20
93190088482,93190088486,4,2047,1597,-20
93191642074,93191642076,2,1845,1119,-20
93192335559,93192335563,4,2750,1338,-20
93198409695,93198409701,6,1800,1530,-20
93199049869,93199049866,-3,904,2324,-20
93201698360,93201698362,2,2168,1321,-20
93203922538,93203922542,4,1151,920,-20
93209157209,93209157211,2,1521,1245,-20
93210588494,93210588498,4,1277,1319,-20
93214234336,93214234339,3,2142,1514,-20
93219886343,93219886347,4,1396,1189,-20
93219996651,93219996654,3,2549,1361,-20
93223023489,93223023492,3,3269,1841,-20
93225373677,93225373677,0,1205,2840,-20
93232719295,93232719297,2,1982,1216,-20
93233308126,93233308109,-17,863,957,-20
93234110822,93234110826,4,1604,1454,-20
93234753994,93234753989,-5,2239,10750,-20
93235908246,93235908250,4,2126,1745,-20
93236234574,93236234577,3,1501,1777,-20
93236670684,93236670687,3,2019,1580,-20
93237704918,93237704923,5,1855,1164,-20
93241089898,93241089901,3,1584,1418,-20
93242147932,93242147935,3,2115,1754,-20
93243750610,93243750616,6,938,1041,-20
93246264506,93246264509,3,1184,742,-20
93247465017,93247465020,3,1293,990,-20
93249925500,93249925502,2,1935,1875,-20
93251514298,93251514302,4,1393,888,-20
93252202905,93252202910,5,2069,1376,-20
93254883318,93254883320,2,1280,1262,-20
93255210975,93255210967,-8,1095,4723,-20
93267888006,93267888009,3,2037,1246,-20
93271657546,93271657541,-5,1410,2613,-20
93272307906,93272307909,3,1814,1365,-20
93272717545,93272717548,3,1537,1342,-20
93274748305,93274748309,4,2394,1191,-20
93274909093,93274909097,4,1254,1108,-20
93278563754,93278563757,3,2251,1593,-20
93279612386,93279612391,5,1409,1406,-20
93280124697,93280124701,4,1460,1313,-20
93284606814,93284606816,2,1807,1676,-20
93291111101,93291111105,4,2034,1728,-20
93292331850,93292331854,4,2310,1573,-20
93293319313,93293319317,4,1638,1646,-20
93296297238,93296297241,3,1975,1545,-20
93298435567,93298435563,-4,1330,2812,-20
93299132437,93299132444,7,11865,30574,-20
93299895407,93299895411,4,2668,1781,-20
93301164306,93301164308,2,2365,2241,-20
93308112702,93308112705,3,2480,1738,-20
93312792965,93312792967,2,1438,1132,-20
93314477771,93314477774,3,2054,1591,-20
93315766633,93315766637,4,2136,1130,-20
93316681910,93316681914,4,1559,1526,-20
93317755942,93317755943,1,1458,1478,-20
93318666552,93318666557,5,1785,1139,-20
93319160154,93319160159,5,1286,1700,-20
93322959277,93322959279,2,44855,33558,-20
93323587479,93323587473,-6,26961,11488,-20
93326903598,93326903598,0,1153,1610,-20
93327357800,93327357802,2,1730,1033,-20
93328847477,93328847480,3,860,1527,-20
93330322916,93330322919,3,1513,1360,-20
93332281618,93332281622,4,2609,1599,-20
93333216218,93333216219,1,1473,1622,-20
93334949581,93334949586,5,2646,1632,-20
93338037917,93338037921,4,1438,1381,-20
93339003964,93339003946,-18,1182,1725,-20
93339763371,93339763374,3,2208,1108,-20
93341347054,93341347057,3,1616,1927,-20
93342494306,93342494310,4,2536,1550,-20
93342560485,93342560489,4,2193,1077,-20
93344348704,93344348706,2,1945,1298,-20
93344582357,93344582358,1,1250,1299,-20
93344657645,93344657650,5,2125,1139,-20
93345654953,93345654959,6,1537,1235,-20
93350143937,93350143938,1,1832,1944,-20
93352615910,93352615915,5,1367,1421,-20
93353785029,93353785031,2,2011,1578,-20
93355306295,93355306298,3,2028,1143,-20
93360561030,93360561032,2,1618,1485,-20
93361591843,93361591846,3,1525,862,-20
93365674778,93365674782,4,979,911,-20
93366495081,93366495085,4,2182,1687,-20
93367709740,93367709746,6,2345,1283,-20
93369168170,93369168175,5,2622,1692,-20
93374165846,93374165845,-1,1119,1951,-20
93374928942,93374928945,3,1771,1369,-20
93374976077,93374976056,-21,1728,1560,-20
93375233551,93375233554,3,1565,1204,-20
93377405074,93377405076,2,1347,1051,-20
93381000834,93381000837,3,1408,1584,-20
93384908653,93384908657,4,1561,1389,-20
93388129307,93388129312,5,1501,1384,-20
93391840422,93391840414,-8,913,4001,-20
93393475371,93393475375,4,1715,1419,-20
93397138815,93397138818,3,411,780,-20
93399013469,93399013471,2,1789,1279,-20
93399831111,93399831114,3,1449,1019,-20
93402294049,93402294053,4,2039,1293,-20
93406250643,93406250637,-6,1834,9493,-20
93407374787,93407374791,4,1402,1186,-20
93414788483,93414788488,5,1376,770,-20
93415275090,93415275095,5,2292,1372,-20
93415557254,93415557254,0,1734,1608,-20
93416749175,93416749178,3,1322,1297,-20
93418163994,93418163980,-14,2563,1690,-20
93423644997,93423645001,4,2007,1252,-20
93423733124,93423733135,11,20116,19446,-20
93431760419,93431760429,10,12871,42194,-20
93439564827,93439564830,3,1962,1771,-20
93440430089,93440430090,1,1590,1441,-20
93444345473,93444345477,4,1868,1691,-20
93446331904,93446331906,2,1651,1376,-20
93446773834,93446773837,3,1637,1480,-20
93447586110,93447586115,5,1715,1710,-20
93447722384,93447722388,4,2190,1800,-20
93449638335,93449638338,3,26732,52844,-20
93451138901,93451138905,4,1604,1416,-20
93455649854,93455649858,4,1554,1372,-20
93457830218,93457830221,3,1487,1581,-20
93458263718,93458263722,4,1837,1397,-20
93459654265,93459654267,2,1836,1329,-20
93462020326,93462020331,5,1433,938,-20
93463828345,93463828347,2,1023,1121,-20
93467666944,93467666948,4,1912,1546,-20
93468377706,93468377712,6,2201,1353,-20
93470855133,93470855136,3,1942,1219,-20
93471577122,93471577118,-4,1265,2745,-20
93474318898,93474318903,5,1500,1532,-20
93479717734,93479717745,11,949,630,-20
93480526674,93480526672,-2,9588,49683,-20
93481615541,93481615545,4,2250,1677,-20
93482143876,93482143892,16,1567,961,-20
93483504182,93483504186,4,2070,1428,-20
93487190082,93487190083,1,2270,1124,-20
93487432230,93487432233,3,1346,1273,-20
93492870241,93492870243,2,2247,1442,-20
93495288227,93495288230,3,2426,1553,-20
93496040542,93496040549,7,2590,2164,-20
93497501202,93497501205,3,1818,1255,-20
93498674399,93498674403,4,1697,1371,-20
93499077603,93499077606,3,1186,1027,-20
93500887432,93500887435,3,1254,1029,-20
93501999452,93501999454,2,1731,1853,-20
93502866657,93502866654,-3,1717,3130,-20
93503526259,93503526262,3,1647,1598,-20
93504455251,93504455253,2,2340,1369,-20
93510745927,93510745931,4,1353,1175,-20
93513432066,93513432062,-4,1810,7037,-20
93514000916,93514000918,2,2467,1866,-20
93514638512,93514638515,3,1474,1807,-20
93517158353,93517158358,5,2458,1825,-20
93517603608,93517603611,3,2568,1524,-20
93517686952,93517686956,4,2065,1109,-20
93522593579,93522593583,4,2487,1763,-20
93523460544,93523460546,2,1996,1281,-20
93524258545,93524258547,2,1212,1085,-20
93524532741,93524532745,4,1238,955,-20
93525687105,93525687109,4,2458,2201,-20
93525871993,93525871980,-13,892,952,-20
93528591837,93528591839,2,1359,1138,-20
93531751957,93531751954,-3,1574,3075,-20
93535754285,93535754287,2,1616,1547,-20
93536237827,93536237830,3,1925,1144,-20
93541540777,93541540781,4,1308,1067,-20
93546562866,93546562850,-16,1792,1457,-20
93547348354,93547348361,7,1656,810,-20
93548503906,93548503909,3,2653,1652,-20
93553028130,93553028134,4,2289,1345,-20
93554866796,93554866799,3,1439,968,-20
93557195424,93557195427,3,2173,1662,-20
93562086504,93562086505,1,1177,1389,-20
93565040246,93565040250,4,1392,1217,-20
93566242349,93566242350,1,3398,2339,-20
93568132152,93568132154,2,1783,1518,-20
93569070454,93569070459,5,2327,1611,-20
93573407174,93573407177,3,2437,1556,-20
93576015630,93576015630,0,1457,1556,-20
93578019237,93578019240,3,1577,1796,-20
93578622179,93578622183,4,1784,1064,-20
93579944390,93579944396,6,1323,1138,-20
93581429645,93581429642,-3,1483,4121,-20
93582552589,93582552595,6,1844,1835,-20
93582945293,93582945295,2,1909,1387,-20
93586308342,93586308346,4,1830,1249,-20
93586676599,93586676578,-21,1086,1136,-20
93589567220,93589567222,2,1833,1198,-20
93590429790,93590429795,5,1717,1246,-20
93591508865,93591508887,22,1542,1233,-20
93591822746,93591822749,3,1682,1968,-20
93592506684,93592506688,4,1853,1252,-20
93592825245,93592825247,2,2333,1532,-20
93593260139,93593260143,4,1612,1269,-20
93599263274,93599263269,-5,1241,2137,-20
93602400861,93602400866,5,2198,1818,-20
93602472246,93602472249,3,1690,1355,-20
93603152849,93603152853,4,1354,1620,-20
93603562423,93603562429,6,2419,1562,-20
93607759261,93607759267,6,1969,1357,-20
93608911819,93608911826,7,2270,1403,-20
93609226655,93609226636,-19,871,710,-20
93609990363,93609990367,4,2070,1278,-20
93616328005,93616328009,4,2763,1571,-20
93618423530,93618423533,3,1741,1010,-20
93618705402,93618705410,8,1750,644,-20
93620463259,93620463263,4,1779,1403,-20
93622803110,93622803115,5,1188,1037,-20
93623899738,93623899740,2,2390,1206,-20
93627426205,93627426209,4,1822,1275,-20
93631749739,93631749742,3,2049,1965,-20
93637293094,93637293100,6,2971,1687,-20
93640872022,93640872026,4,2908,1342,-20
93643774457,93643774461,4,1928,1414,-20
93644208003,93644208008,5,1106,1197,-20
93646756770,93646756756,-14,1755,1074,-20
93647403196,93647403198,2,1467,1537,-20
93650720327,93650720332,5,1843,1310,-20
93652482847,93652482852,5,2661,1430,-20
93652550250,93652550265,15,550,250,-20
93654380074,93654380076,2,1607,804,-20
93660275318,93660275322,4,1587,1052,-20
93660502261,93660502242,-19,1691,949,-20
93661198385,93661198380,-5,1301,1296,-20
93661712170,93661712175,5,1767,1223,-20
93664319505,93664319509,4,1324,977,-20
93665851763,93665851760,-3,1918,3391,-20
93670751558,93670751565,7,2798,2319,-20
93672697498,93672697499,1,1650,1837,-20
93676907946,93676907948,2,1049,1344,-20
93683189604,93683189607,3,1498,1388,-20
93684689441,93684689445,4,1705,1490,-20
93686631589,93686631590,1,1398,1022,-20
93690488855,93690488849,-6,24173,13421,-20
93692764766,93692764769,3,1595,1795,-20
93693183125,93693183126,1,1699,946,-20
93695539947,93695539951,4,907,1174,-20
93696837289,93696837293,4,1468,1400,-20
93697347808,93697347811,3,1434,1392,-20
93697788774,93697788776,2,1297,2115,-20
93701810416,93701810417,1,1472,1866,-20
93702490904,93702490908,4,2575,1862,-20
93702644451,93702644458,7,2773,1383,-20
93709064738,93709064744,6,1812,1236,-20
93709947015,93709947019,4,2580,1325,-20
93710033206,93710033210,4,2196,1080,-20
93710969927,93710969929,2,1996,1219,-20
93716626145,93716626150,5,2349,1461,-20
93721287382,93721287387,5,2388,1359,-20
93721992417,93721992419,2,1548,1711,-20
93723362061,93723362065,4,1507,1068,-20
93724390058,93724390063,5,2204,2133,-20
93725620984,93725620986,2,1694,1116,-20
93725917849,93725917852,3,1990,1422,-20
93726454614,93726454614,0,948,1844,-20
93729356463,93729356465,2,1472,1453,-20
93730584925,93730584933,8,2580,1873,-20
93732221715,93732221719,4,1714,1294,-20
93732414101,93732414105,4,3849,3329,-20
93735005033,93735005035,2,1477,1528,-20
93738557662,93738557666,4,2083,866,-20
93739006230,93739006236,6,1837,1276,-20
93739537342,93739537347,5,1118,1107,-20
93740757758,93740757763,5,2305,1215,-20
93744080775,93744080778,3,1847,1352,-20
93745106713,93745106714,1,4615,5235,-20
93750680957,93750680961,4,2083,1719,-20
93751319537,93751319541,4,1397,1302,-20
93752420906,93752420909,3,1457,1661,-20
93752548971,93752548973,2,1223,1452,-20
93754602649,93754602654,5,1519,1094,-20
93755735496,93755735498,2,1925,1015,-20
93756039810,93756039815,5,2291,1303,-20
93759206116,93759206118,2,3421,2058,-20
93761011595,93761011601,6,4196,1547,-20
93762655097,93762655097,0,1361,1799,-20
93762755820,93762755823,3,2200,1204,-20
93765462722,93765462727,5,1986,1905,-20
93765571113,93765571115,2,868,1226,-20
93766310597,93766310598,1,1740,1566,-20
93766797234,93766797240,6,1177,1323,-20
93768437449,93768437449,0,1784,1158,-20
93770646330,93770646333,3,2707,1629,-20
93772508526,93772508530,4,2211,1679,-20
93772626722,93772626726,4,2208,1671,-20
93773687209,93773687211,2,1633,1718,-20
93775526529,93775526533,4,882,1308,-20
93778281078,93778281083,5,1837,1311,-20
93779992634,93779992636,2,1562,1521,-20
93781597803,93781597809,6,4416,1308,-20
93782607064,93782607066,2,1868,1502,-20
93786861445,93786861447,2,1770,1046,-20
93787495629,93787495633,4,1813,1265,-20
93793555689,93793555691,2,1797,1328,-20
93793597335,93793597338,3,1762,1822,-20
93801477101,93801477105,4,1595,1644,-20
93802314436,93802314439,3,2828,1742,-20
93806753638,93806753642,4,1478,1490,-20
93808899405,93808899407,2,1979,1162,-20
93809006122,93809006123,1,918,1283,-20
93809835796,93809835798,2,2240,2003,-20
93813758855,93813758860,5,1407,1255,-20
93814691842,93814691846,4,1921,1792,-20
93817560722,93817560720,-2,1176,2232,-20
93824184438,93824184441,3,2325,1092,-20
93826010595,93826010597,2,1367,1426,-20
93828567810,93828567814,4,2187,1060,-20
93828752174,93828752155,-19,1823,641,-20
93829457839,93829457841,2,1303,1156,-20
93831154329,93831154330,1,1966,1224,-20
93833213749,93833213763,14,389,1006,-20
93833488973,93833488978,5,1275,1274,-20
93834344286,93834344290,4,2174,1792,-20
93834905826,93834905829,3,1323,1381,-20
93837459703,93837459708,5,2344,1319,-20
93842556534,93842556537,3,1700,1482,-20
93844740886,93844740890,4,1758,1109,-20
93845505298,93845505301,3,2496,1533,-20
93849579903,93849579908,5,1481,1450,-20
93851796869,93851796873,4,1333,1174,-20
93852190301,93852190304,3,1778,1249,-20
93853259852,93853259855,3,1495,1314,-20
93865769707,93865769710,3,1432,1325,-20
93866171158,93866171162,4,1202,1202,-20
93867343549,93867343552,3,2244,1562,-20
93869266474,93869266479,5,1260,1493,-20
93872333257,93872333262,5,2370,1070,-20
93873312089,93873312091,2,2451,1781,-20
93877345307,93877345311,4,2245,1061,-20
93877446219,93877446225,6,1595,1730,-20
93877928932,93877928939,7,2336,922,-20
93877997969,93877997984,15,1583,1383,-20
93878251035,93878251038,3,1749,1336,-20
93880095776,93880095779,3,1437,1076,-20
93882016545,93882016551,6,3018,902,-20
93883063528,93883063531,3,1522,974,-20
93884160494,93884160498,4,1928,1138,-20
93886784167,93886784170,3,1696,1298,-20
93890428892,93890428895,3,1874,1476,-20
93891004233,93891004235,2,2593,1494,-20
93891635725,93891635721,-4,1811,4757,-20
93896907901,93896907903,2,2002,1224,-20
93898952390,93898952395,5,1339,1177,-20
93907884482,93907884486,4,1384,983,-20
93908762137,93908762141,4,2258,1339,-20
93912299240,93912299243,3,1793,1290,-20
93913317295,93913317298,3,2019,1386,-20
93914375234,93914375238,4,1891,1404,-20
93917123106,93917123110,4,1817,1272,-20
93920449237,93920449238,1,2072,1552,-20
93921252383,93921252387,4,2085,1422,-20
93921550874,93921550883,9,32292,59558,-20
93922722066,93922722069,3,1488,1764,-20
93924684961,93924684957,-4,891,1936,-20
93930446019,93930446028,9,5851,23558,-20
93930772750,93930772757,7,3449,1492,-20
93931352098,93931352102,4,1972,2256,-20
93931675105,93931675106,1,1415,882,-20
93932345707,93932345710,3,1801,1541,-20
93934222331,93934222333,2,2125,1514,-20
93936701854,93936701856,2,2474,1427,-20
93941544694,93941544697,3,1457,1232,-20
93944962035,93944962040,5,872,1026,-20
93947976862,93947976865,3,1881,1972,-20
93950808547,93950808549,2,1995,1718,-20
93952694424,93952694429,5,1506,1046,-20
93953389306,93953389299,-7,686,1537,-20
93954889776,93954889779,3,1331,1443,-20
93957595825,93957595826,1,1283,1565,-20
93959343876,93959343879,3,1925,1486,-20
93959546729,93959546731,2,1984,1265,-20
93961233671,93961233675,4,2572,1790,-20
93961787892,93961787895,3,1174,1091,-20
93962574983,93962574990,7,1659,1417,-20
93962879101,93962879104,3,1986,1446,-20
93965104730,93965104738,8,2087,1222,-20
93967439157,93967439160,3,1848,1452,-20
93969583175,93969583178,3,1341,1433,-20
93971897987,93971897989,2,649,1046,-20
93975474361,93975474368,7,3040,1290,-20
93975536365,93975536367,2,1981,1304,-20
93978055433,93978055436,3,1441,1643,-20
93979079830,93979079835,5,2905,2056,-20
93981465050,93981465055,5,2340,1699,-20
93985739433,93985739437,4,2111,1691,-20
93995149870,93995149871,1,1709,1438,-20
93998437008,93998437011,3,1098,1415,-20
94002992102,94002992080,-22,640,445,-20
94011852223,94011852226,3,1947,1452,-20
94015246661,94015246664,3,1321,1512,-20
94018976308,94018976310,2,1394,1308,-20
94019100453,94019100458,5,1556,1110,-20
94020136811,94020136811,0,1097,1544,-20
94020395606,94020395603,-3,837,309,-20
94021504950,94021504932,-18,2650,1598,-20
94022921210,94022921211,1,1559,1063,-20
94024228362,94024228366,4,1499,994,-20
94025301875,94025301879,4,1844,1152,-20
94033052305,94033052309,4,1951,1525,-20
94035341915,94035341913,-2,1087,2412,-20
94035728687,94035728691,4,2132,1083,-20
94041151652,94041151653,1,1682,1021,-20
94042942478,94042942480,2,1675,1324,-20
94043340136,94043340135,-1,1417,1128,-20
94044196048,94044196050,2,1502,1658,-20
94044784398,94044784401,3,1601,1309,-20
94044955957,94044955961,4,2159,1763,-20
94045219278,94045219265,-13,653,572,-20
94046066470,94046066471,1,1600,2184,-20
94048535402,94048535406,4,1736,1126,-20
94050295842,94050295838,-4,1669,2010,-20
94055235257,94055235261,4,1718,1415,-20
94056091418,94056091422,4,51658,88687,-20
94056573327,94056573330,3,982,1232,-20
94056735694,94056735698,4,1885,1278,-20
94057603047,94057603049,2,1339,1344,-20
94067017094,94067017098,4,1984,1239,-20
94072857681,94072857687,6,2457,1668,-20
94073778211,94073778214,3,1565,1326,-20
94075871659,94075871662,3,1470,1238,-20
94076181858,94076181861,3,1480,1585,-20
94078194794,94078194797,3,2070,1248,-20
94080979243,94080979247,4,1138,982,-20
94081517449,94081517452,3,2410,1581,-20
94083945913,94083945918,5,2480,1949,-20
94084145770,94084145774,4,1796,1381,-20
94085076677,94085076672,-5,50131,19244,-20
94085773755,94085773759,4,1413,971,-20
94085885298,94085885281,-17,1363,601,-20
94088360766,94088360751,-15,1529,1250,-20
94088484006,94088484009,3,849,1395,-20
94088972566,94088972571,5,2086,1264,-20
94097551886,94097551887,1,1458,906,-20
94098120545,94098120543,-2,1544,1568,-20
94108515919,94108515923,4,2062,1206,-20
94111697417,94111697400,-17,1048,1350,-20
94111754923,94111754921,-2,2156,6140,-20
94112715942,94112715946,4,2034,1372,-20
94114195334,94114195337,3,1774,2071,-20
94114467791,94114467790,-1,1853,1227,-20
94116168863,94116168866,3,2527,2040,-20
94120442447,94120442449,2,1314,1597,-20
94124343955,94124343950,-5,796,2463,-20
94128496173,94128496174,1,1990,1431,-20
94129480221,94129480239,18,1814,1538,-20
94133885545,94133885547,2,2111,1164,-20
94134613245,94134613251,6,1386,997,-20
94137078438,94137078440,2,2015,1739,-20
94138982185,94138982187,2,2029,1065,-20
94139178022,94139178003,-19,1205,1386,-20
94139486506,94139486508,2,2752,1875,-20
94139805240,94139805242,2,1915,1347,-20
94143699442,94143699445,3,8811,11079,-20
94144913098,94144913102,4,2814,1585,-20
94146697662,94146697665,3,1414,1334,-20
94150314387,94150314388,1,1528,1335,-20
94151861598,94151861604,6,2196,1635,-20
94152984839,94152984843,4,2201,1476,-20
94159198323,94159198326,3,1922,1691,-20
94159246002,94159246007,5,2122,1238,-20
94161592516,94161592519,3,1608,1061,-20
94164890806,94164890806,0,579,649,-20
94169147052,94169147055,3,1815,1480,-20
94169573553,94169573555,2,1568,1252,-20
94171242071,94171242074,3,1930,1210,-20
94171601208,94171601212,4,2057,1732,-20
94172195023,94172195027,4,2556,2035,-20
94184192146,94184192143,-3,1104,2869,-20
94185811071,94185811074,3,1358,1208,-20
94188539677,94188539682,5,1622,1221,-20
94191704010,94191704011,1,1696,1105,-20
94192227209,94192227213,4,2974,2471,-20
94193127625,94193127627,2,1709,1425,-20
94195136190,94195136195,5,1806,1622,-20
94195403108,94195403110,2,1509,1259,-20
94196491217,94196491221,4,1463,1636,-20
94198389091,94198389094,3,1091,1104,-20
94199255319,94199255323,4,1569,1642,-20
94203895422,94203895422,0,1005,1246,-20
94207246562,94207246565,3,2074,1797,-20
94208304467,94208304471,4,2103,1893,-20
94210178564,94210178545,-19,1709,1195,-20
94213429129,94213429130,1,1179,1021,-20
94216773624,94216773627,3,1709,1160,-20
94217870366,94217870369,3,1395,1517,-20
94218541561,94218541562,1,2100,1539,-20
94219408336,94219408341,5,1072,1299,-20
94223957398,94223957401,3,2224,1508,-20
94224658150,94224658152,2,915,1520,-20
94225134870,94225134873,3,1614,900,-20
94234260842,94234260846,4,1695,1499,-20
94234414627,94234414612,-15,2406,1409,-20
94236323782,94236323786,4,1762,1066,-20
94236382051,94236382054,3,1314,1140,-20
94238483169,94238483171,2,2534,1767,-20
94239101643,94239101647,4,2038,1756,-20
94241027609,94241027612,3,1226,822,-20
94242518002,94242518006,4,1626,1601,-20
94248950911,94248950915,4,1814,975,-20
94249266324,94249266345,21,2403,1389,-20
94249655455,94249655458,3,2236,1201,-20
94249711532,94249711544,12,1716,837,-20
94251356639,94251356641,2,2130,1274,-20
94252527206,94252527210,4,1918,1073,-20
94252626266,94252626267,1,1565,1468,-20
94255480869,94255480873,4,1573,1568,-20
94256356967,94256356971,4,2133,1965,-20
94259683557,94259683561,4,1569,930,-20
94260524632,94260524634,2,1686,1475,-20
94260904315,94260904322,7,3864,1785,-20
94266062706,94266062713,7,3785,1530,-20
94270345110,94270345115,5,2151,892,-20
94272214078,94272214082,4,1234,1306,-20
94273246234,94273246239,5,2066,1388,-20
94274311359,94274311363,4,1803,1352,-20
94276327105,94276327106,1,1799,1415,-20
94278114339,94278114343,4,1521,1918,-20
94279522858,94279522862,4,1427,1264,-20
94288122024,94288122027,3,1471,1530,-20
94288536501,94288536480,-21,1261,1210,-20
94291249453,94291249454,1,1980,1074,-20
94292774151,94292774157,6,1362,1021,-20
94294947497,94294947499,2,1755,1494,-20
94299529173,94299529175,2,774,1099,-20
94301477769,94301477770,1,1292,1276,-20
94303323261,94303323265,4,1568,769,-20
94304692206,94304692207,1,1895,1544,-20
94306099106,94306099109,3,1515,1379,-20
94310520170,94310520173,3,1826,1706,-20
94311387297,94311387299,2,2216,1551,-20
94314092255,94314092254,-1,1038,1423,-20
94319872388,94319872391,3,1548,1276,-20
94321729640,94321729645,5,2129,2100,-20
94322232017,94322232021,4,2339,1123,-20
94322904211,94322904214,3,1149,836,-20
94323815110,94323815115,5,1740,1615,-20
94325823849,94325823851,2,1711,1042,-20
94327603704,94327603708,4,1830,1330,-20
94328214762,94328214767,5,1940,1513,-20
94328338125,94328338129,4,2051,1486,-20
94330158412,94330158414,2,2138,1279,-20
94333234676,94333234678,2,1848,1065,-20
94334642973,94334642978,5,2432,1155,-20
94336081703,94336081707,4,1722,1020,-20
94344521526,94344521529,3,1935,1899,-20
94346277341,94346277342,1,1368,2104,-20
94349530274,94349530277,3,1789,1642,-20
94353841969,94353841974,5,1811,1619,-20
94353901655,94353901660,5,1471,1181,-20
94355301417,94355301421,4,1727,1295,-20
94357251866,94357251869,3,1926,1639,-20
94358510853,94358510858,5,2243,1748,-20
94358896238,94358896241,3,2081,1349,-20
94361411366,94361411365,-1,1354,2483,-20
94361786062,94361786064,2,1068,1112,-20
94363969254,94363969259,5,1074,1135,-20
94364451042,94364451046,4,2801,1908,-20
94366064938,94366064942,4,1511,1308,-20
94366162555,94366162559,4,2037,1451,-20
94368205603,94368205605,2,1603,1224,-20
94368691081,94368691084,3,2089,2412,-20
94374067649,94374067655,6,1604,996,-20
94379324978,94379324979,1,1257,950,-20
94383465850,94383465849,-1,2616,4659,-20
94384444905,94384444911,6,1341,1132,-20
94385890646,94385890648,2,1046,1480,-20
94387968931,94387968934,3,1289,1472,-20
94391756790,94391756794,4,1629,1489,-20
94394474852,94394474858,6,2272,1320,-20
94397662643,94397662649,6,1321,1197,-20
94397956175,94397956177,2,1347,1130,-20
94398716367,94398716371,4,1420,1268,-20
94399717970,94399717976,6,1794,1278,-20
94400564048,94400564050,2,1202,1079,-20
94402796414,94402796419,5,2309,1295,-20
94406210746,94406210751,5,1639,1378,-20
94409814565,94409814571,6,2026,1073,-20
94412337702,94412337705,3,1079,921,-20
94413128297,94413128302,5,1340,1132,-20
94415212515,94415212517,2,4716,24080,-20
94417816460,94417816443,-17,1403,1461,-20
94418965244,94418965250,6,2020,1402,-20
94421195854,94421195859,5,2368,1188,-20
94422914360,94422914362,2,1843,1874,-20
94437243184,94437243186,2,1106,1911,-20
94437862345,94437862350,5,1869,1726,-20
94441608307,94441608310,3,1963,1333,-20
94445169149,94445169154,5,3333,1296,-20
94451226277,94451226277,0,1414,1740,-20
94455244473,94455244475,2,2562,1662,-20
94455586087,94455586065,-22,3045,1176,-20
94456680083,94456680078,-5,955,3356,-20
94460196195,94460196199,4,1591,1548,-20
94464115253,94464115256,3,2183,1688,-20
94465539778,94465539782,4,2116,1303,-20
94466600930,94466600945,15,1405,986,-20
94471277443,94471277435,-8,865,414,-20
94472864330,94472864334,4,2591,1388,-20
94473798253,94473798254,1,1561,1287,-20
94476285125,94476285126,1,1738,1496,-20
94478167785,94478167791,6,2329,1274,-20
94481601582,94481601582,0,1549,2170,-20
94481898811,94481898816,5,2757,2162,-20
94483658204,94483658207,3,1317,931,-20
94484814766,94484814769,3,2615,1278,-20
94485439831,94485439835,4,2172,1753,-20
94488071298,94488071301,3,2210,1509,-20
94488157586,94488157589,3,2202,1181,-20
94489448705,94489448709,4,1565,1355,-20
94490243645,94490243647,2,1778,1243,-20
94494916827,94494916833,6,2044,1433,-20
94496769401,94496769403,2,1367,1107,-20
94498520697,94498520701,4,1416,719,-20
94500104744,94500104748,4,1824,1405,-20
94501153639,94501153638,-1,1291,2166,-20
94501661183,94501661188,5,1036,734,-20
94504037703,94504037718,15,1432,1875,-20
94508560838,94508560837,-1,1353,909,-20
94510355233,94510355238,5,2886,1718,-20
94511043417,94511043422,5,1349,1118,-20
94512946964,94512946966,2,1112,900,-20
94518012108,94518012110,2,1613,1181,-20
94518818286,94518818288,2,2438,1720,-20
94521114757,94521114738,-19,1679,657,-20
94522388950,94522388953,3,2078,1394,-20
94523373451,94523373445,-6,800,2071,-20
94524537711,94524537718,7,1928,1425,-20
94526578822,94526578826,4,2370,1403,-20
94528217273,94528217277,4,2055,2202,-20
94528746639,94528746638,-1,960,1657,-20
94531902329,94531902331,2,1467,994,-20
94534505216,94534505218,2,2468,1897,-20
94536755523,94536755527,4,1890,907,-20
94538439598,94538439601,3,1643,1692,-20
94541493753,94541493755,2,1251,1419,-20
94541673248,94541673250,2,1307,1291,-20
94541947193,94541947198,5,2525,1653,-20
94542169409,94542169411,2,1447,887,-20
94546556553,94546556546,-7,1074,4387,-20
94548751808,94548751810,2,1972,1345,-20
94549592138,94549592138,0,1249,1915,-20
94551695455,94551695458,3,1571,1117,-20
94553173141,94553173125,-16,1358,1627,-20
94553701702,94553701703,1,1242,1089,-20
94554458766,94554458766,0,1365,872,-20
94559094021,94559094023,2,1825,1617,-20
94561870061,94561870064,3,1935,1526,-20
94564277729,94564277731,2,1679,1075,-20
94567978637,94567978642,5,1419,1401,-20
94568787237,94568787240,3,2089,1745,-20
94569224243,94569224251,8,3831,2027,-20
94570573204,94570573206,2,1498,1138,-20
94576130510,94576130514,4,1524,1116,-20
94576288186,94576288189,3,1744,1808,-20
94578443977,94578443981,4,1725,1339,-20
94582884509,94582884517,8,8618,41905,-20
94585794607,94585794612,5,1450,771,-20
94587884652,94587884654,2,1517,937,-20
94589347171,94589347173,2,2212,1185,-20
94591279538,94591279541,3,1705,1331,-20
94593562790,94593562794,4,2655,2126,-20
94597230991,94597230994,3,1186,1099,-20
94600421996,94600421999,3,1659,1630,-20
94604907030,94604907035,5,2146,1524,-20
94605718120,94605718124,4,2630,1281,-20
94605895910,94605895913,3,2273,1720,-20
94605951926,94605951930,4,2376,1572,-20
94607690250,94607690254,4,1322,1359,-20
94607737619,94607737622,3,1258,1349,-20
94609138211,94609138214,3,2081,1154,-20
94610188136,94610188139,3,2050,1451,-20
94613458064,94613458069,5,1610,1299,-20
94617203610,94617203613,3,1595,1016,-20
94620159637,94620159638,1,1406,923,-20
94620867162,94620867159,-3,1209,1196,-20
94620947072,94620947074,2,1822,1291,-20
94623428058,94623428061,3,1986,1511,-20
94627090722,94627090727,5,1314,1145,-20
94627811092,94627811094,2,1436,1587,-20
94631798178,94631798181,3,1866,1163,-20
94634650512,94634650515,3,1091,983,-20
94635643454,94635643458,4,1714,1084,-20
94635949351,94635949354,3,1457,1004,-20
94637133598,94637133603,5,1772,1116,-20
94638700454,94638700454,0,1982,1335,-20
94640184759,94640184761,2,1414,1727,-20
94640928565,94640928569,4,1481,1603,-20
94646687514,94646687515,1,456,475,-20
94653010774,94653010775,1,1939,1290,-20
94654017021,94654017022,1,1943,1104,-20
94657248637,94657248639,2,2365,1039,-20
94658894700,94658894704,4,1861,1196,-20
94660762505,94660762507,2,1723,1427,-20
94663045861,94663045863,2,2414,1701,-20
94663511452,94663511455,3,1365,1608,-20
94676472958,94676472962,4,1123,1090,-20
94680245700,94680245704,4,1426,1022,-20
94681079557,94681079561,4,1224,1725,-20
94682970103,94682970107,4,2442,1568,-20
94684634017,94684634020,3,2202,1329,-20
94685051802,94685051803,1,959,1137,-20
94685304409,94685304412,3,2092,1302,-20
94688331350,94688331353,3,1524,1203,-20
94688835173,94688835176,3,1816,1490,-20
94690174948,94690174949,1,16864,18366,-20
94690596292,94690596297,5,1991,1353,-20
94692621644,94692621649,5,2114,1524,-20
94694875062,94694875066,4,2021,1226,-20
94696870329,94696870333,4,1437,1074,-20
94700012082,94700012086,4,2340,1460,-20
94700215911,94700215911,0,1575,2436,-20
94703211520,94703211521,1,1389,1053,-20
94705868889,94705868891,2,1423,870,-20
94711851090,94711851093,3,2332,1716,-20
94714083489,94714083486,-3,1759,5180,-20
94718020226,94718020230,4,1735,887,-20
94719145426,94719145431,5,2133,1839,-20
94719387370,94719387373,3,971,753,-20
94720083700,94720083693,-7,2263,9647,-20
94725218748,94725218753,5,2056,1508,-20
94725664426,94725664428,2,1631,1382,-20
94732531521,94732531525,4,2490,1152,-20
94738345126,94738345130,4,1475,642,-20
94738521527,94738521505,-22,2461,1186,-20
94740222706,94740222709,3,1984,1281,-20
94741971274,94741971277,3,2631,1808,-20
94744214191,94744214195,4,1606,1046,-20
94744903528,94744903531,3,1610,1188,-20
94747514401,94747514393,-8,2400,9041,-20
94750773245,94750773247,2,1692,1409,-20
94754315799,94754315802,3,1490,1207,-20
94755040243,94755040244,1,2602,3011,-20
94760432701,94760432703,2,1960,1529,-20
94765591887,94765591891,4,2044,1321,-20
94767584166,94767584160,-6,1974,7996,-20
94768349064,94768349068,4,2217,1304,-20
94770198594,94770198595,1,1744,1694,-20
94775233019,94775233022,3,1869,1670,-20
94780270498,94780270501,3,2021,1193,-20
94780556069,94780556058,-11,1434,1403,-20
94780902286,94780902289,3,2305,1884,-20
94781754677,94781754681,4,1564,1584,-20
94783390563,94783390559,-4,1973,6329,-20
94784365151,94784365155,4,1302,862,-20
94789286789,94789286794,5,3151,1999,-20
94793987929,94793987932,3,2046,947,-20
94798589780,94798589785,5,1862,1038,-20
94799914965,94799914973,8,4218,1354,-20
94801235488,94801235492,4,1977,1197,-20
94805160509,94805160510,1,1655,1535,-20
94808822067,94808822071,4,1948,1130,-20
94810831198,94810831200,2,2060,1729,-20
94815336680,94815336683,3,2536,2246,-20
94818514337,94818514341,4,2843,1818,-20
94820260665,94820260662,-3,1385,1893,-20
94823238966,94823238970,4,1966,1116,-20
94824179435,94824179439,4,1048,1187,-20
94826385811,94826385814,3,1461,1627,-20
94827009812,94827009813,1,1737,1840,-20
94830567891,94830567894,3,1644,757,-20
94833049397,94833049399,2,1450,1261,-20
94834019138,94834019143,5,1851,1349,-20
94834353022,94834353004,-18,749,132,-20
94836352496,94836352501,5,2010,954,-20
94839622469,94839622470,1,1942,1528,-20
94841702159,94841702163,4,2472,1847,-20
94842761346,94842761348,2,1183,918,-20
94848013809,94848013806,-3,1793,5818,-20
94848633625,94848633629,4,2041,1512,-20
94850345036,94850345038,2,1320,1269,-20
94851989873,94851989881,8,4387,1409,-20
94853465992,94853465998,6,1576,1136,-20
94856995080,94856995076,-4,19191,13279,-20
94862354973,94862354974,1,1374,1368,-20
94864584788,94864584791,3,2022,1350,-20
94866952065,94866952068,3,1355,1182,-20
94869457988,94869457991,3,1663,1695,-20
94870969923,94870969923,0,1177,1308,-20
94872256594,94872256598,4,1792,1237,-20
94872855671,94872855673,2,1912,1644,-20
94873217561,94873217565,4,1306,1144,-20
94879257024,94879257027,3,1669,1292,-20
94881268690,94881268692,2,2893,2055,-20
94883623708,94883623713,5,1651,1123,-20
94883846603,94883846608,5,2618,1681,-20
94884797042,94884797045,3,2340,1448,-20
94886341514,94886341515,1,2195,1495,-20
94887287741,94887287745,4,1958,995,-20
94888113834,94888113838,4,1839,1448,-20
94896057532,94896057533,1,1900,1451,-20
94896278706,94896278706,0,1515,1818,-20
94904933129,94904933131,2,2055,1680,-20
94907807281,94907807282,1,1411,1083,-20
94910677288,94910677282,-6,1133,2682,-20
94914856498,94914856500,2,1214,1306,-20
94918109090,94918109086,-4,1273,1911,-20
94919798169,94919798172,3,2341,1331,-20
94920345325,94920345323,-2,694,841,-20
94922169055,94922169059,4,1023,806,-20
94923640794,94923640800,6,3231,1436,-20
94924042882,94924042884,2,1324,1137,-20
94924118323,94924118326,3,2291,1526,-20
94925094649,94925094652,3,1392,1489,-20
94938963898,94938963902,4,1852,1526,-20
94939280327,94939280330,3,2154,1163,-20
94942928875,94942928878,3,1425,1210,-20
94946534206,94946534209,3,2597,2040,-20
94946631181,94946631186,5,1905,1550,-20
94946940331,94946940334,3,1756,1806,-20
94952822885,94952822887,2,1894,1632,-20
94954200004,94954200007,3,970,1116,-20
94960285182,94960285186,4,1502,924,-20
94961281991,94961281997,6,1446,1071,-20
94964105010,94964105010,0,1375,1642,-20
94964507042,94964507047,5,2073,1618,-20
94967348442,94967348437,-5,1144,2814,-20
94968464706,94968464706,0,1299,1388,-20
94969602689,94969602693,4,1992,1452,-20
94970693010,94970693013,3,1695,1651,-20
94971013591,94971013594,3,1467,1137,-20
94972329062,94972329065,3,771,958,-20
94974164618,94974164626,8,5156,2122,-20
94979359529,94979359531,2,2363,1497,-20
94980977008,94980977013,5,2109,1355,-20
94981444366,94981444369,3,1320,1063,-20
94985750338,94985750341,3,1365,1177,-20
94985822215,94985822218,3,2223,2011,-20
94986657200,94986657204,4,22511,33890,-20
94988666373,94988666374,1,1603,1654,-20
94989217605,94989217610,5,2659,2008,-20
94994216458,94994216459,1,1850,1538,-20
94994954922,94994954923,1,1333,1138,-20
94997322888,94997322891,3,1312,1192,-20
94998922566,94998922572,6,1798,853,-20
94999052724,94999052726,2,1381,1051,-20
95003716847,95003716846,-1,1315,2044,-20
95005926765,95005926766,1,1579,1618,-20
95008349448,95008349453,5,1433,1465,-20
95016282749,95016282750,1,1663,1636,-20
95017968850,95017968855,5,1575,1273,-20
95018428330,95018428335,5,1896,1215,-20
95018843742,95018843745,3,1935,1672,-20
95019647130,95019647131,1,1596,839,-20
95020469694,95020469703,9,1576,1156,-20
95024548870,95024548874,4,1249,1233,-20
95025428246,95025428249,3,1581,1494,-20
95025624161,95025624164,3,1817,1640,-20
95028555510,95028555513,3,1616,1782,-20
95029382481,95029382483,2,1545,1217,-20
95030962494,95030962498,4,1824,1700,-20
95031960831,95031960826,-5,1262,2906,-20
95032913468,95032913472,4,2470,2241,-20
95034766966,95034766971,5,2617,1882,-20
95036840350,95036840339,-11,1292,1640,-20
95036989361,95036989370,9,4192,1720,-20
95039246047,95039246050,3,1509,1360,-20
95041463638,95041463640,2,2047,1388,-20
95042586439,95042586441,2,1176,1435,-20
95042983481,95042983483,2,1347,1405,-20
95043395394,95043395398,4,1919,1232,-20
95043685071,95043685075,4,1467,1323,-20
95044201333,95044201334,1,1667,1276,-20
95047309546,95047309548,2,776,1735,-20
95048416509,95048416513,4,1771,1100,-20
95050579391,95050579397,6,3354,1483,-20
95051976161,95051976166,5,2169,1524,-20
95052058698,95052058702,4,1367,1626,-20
95053110758,95053110761,3,2203,1330,-20
95053836518,95053836523,5,1346,1133,-20
95056119465,95056119470,5,2296,1822,-20
95056151825,95056151829,4,1497,1672,-20
95056904647,95056904645,-2,1262,1814,-20
95057416927,95057416927,0,1078,1068,-20
95058598101,95058598110,9,1770,977,-20
95061195159,95061195163,4,1260,1027,-20
95062114210,95062114215,5,1497,1174,-20
95065814245,95065814229,-16,1343,1320,-20
95066088473,95066088477,4,1822,1271,-20
95066210909,95066210911,2,1613,1238,-20
95072331354,95072331354,0,703,1381,-20
95075179995,95075179999,4,1827,1556,-20
95079396196,95079396199,3,1549,1291,-20
95080375565,95080375569,4,2706,1610,-20
95080515619,95080515622,3,1839,1338,-20
95082317263,95082317269,6,2548,1460,-20
95082612069,95082612069,0,1882,1430,-20
95082928758,95082928758,0,1567,1502,-20
95083757337,95083757355,18,2967,1143,-20
95089075169,95089075175,6,2100,1246,-20
95089454247,95089454250,3,2030,1188,-20
95093248921,95093248921,0,1794,1525,-20
95094252754,95094252758,4,1846,1309,-20
95103445086,95103445090,4,1808,1969,-20
95104818576,95104818579,3,1678,1254,-20
95106166234,95106166234,0,900,517,-20
95107622573,95107622577,4,1758,1152,-20
95108484707,95108484701,-6,1381,6977,-20
95110300158,95110300165,7,5215,1697,-20
95110748848,95110748850,2,2224,1333,-20
95114753738,95114753742,4,2094,1318,-20
95114899633,95114899635,2,1610,1348,-20
95115774093,95115774094,1,1622,1249,-20
95119078705,95119078707,2,1312,1483,-20
95120879473,95120879478,5,1049,1112,-20
95121215402,95121215409,7,2419,1405,-20
95124250236,95124250241,5,1918,1449,-20
95124734201,95124734203,2,1464,1206,-20
95129816802,95129816805,3,1464,1660,-20
95130120154,95130120139,-15,1039,1282,-20
95130953902,95130953905,3,2191,1579,-20
95131200634,95131200638,4,1584,1630,-20
95134142468,95134142471,3,1811,1745,-20
95136090714,95136090719,5,1494,1206,-20
95136217139,95136217142,3,1786,1233,-20
95140668319,95140668322,3,2294,1071,-20
95141233372,95141233352,-20,2855,2233,-20
95145636683,95145636682,-1,2341,3700,-20
95146020063,95146020066,3,2037,1236,-20
95146342977,95146342982,5,1639,972,-20
95146952555,95146952559,4,1957,1138,-20
95153130251,95153130251,0,2729,4730,-20
95153171129,95153171130,1,1826,1897,-20
95156222440,95156222443,3,1676,1536,-20
95160035502,95160035502,0,2436,2093,-20
95161640203,95161640206,3,2120,1861,-20
95162908434,95162908434,0,1456,1486,-20
95163951707,95163951708,1,1418,1732,-20
95167426727,95167426730,3,2087,1337,-20
95169286158,95169286161,3,1682,1622,-20
95170820952,95170820950,-2,1186,1159,-20
95170953723,95170953727,4,1100,889,-20
95171082592,95171082594,2,1599,1261,-20
95173274507,95173274510,3,1844,1652,-20
95174402215,95174402221,6,1795,964,-20
95175181886,95175181891,5,1822,1519,-20
95175360026,95175360029,3,1554,1467,-20
95175897412,95175897414,2,10475,10690,-20
95178126107,95178126110,3,1397,1271,-20
95181818331,95181818336,5,1864,1299,-20
95185183354,95185183358,4,2064,1407,-20
95190624199,95190624203,4,1590,1082,-20
95191674786,95191674791,5,2195,1854,-20
95193217938,95193217942,4,1445,980,-20
95194590562,95194590558,-4,947,2260,-20
95194724333,95194724330,-3,1576,3271,-20
95195615568,95195615566,-2,1260,1771,-20
95195672961,95195672965,4,1689,1258,-20
95196363834,95196363835,1,1928,1473,-20
95200229923,95200229909,-14,1485,1724,-20
95202390566,95202390570,4,2392,1731,-20
95208504442,95208504443,1,2322,1729,-20
95209084207,95209084207,0,1576,1877,-20
95212452866,95212452869,3,1852,1569,-20
95212780457,95212780464,7,2275,1259,-20
95212917705,95212917721,16,1397,1116,-20
95214546382,95214546383,1,1624,1550,-20
95218396786,95218396787,1,1443,1650,-20
95219412858,95219412862,4,2141,1946,-20
95221896470,95221896471,1,1682,1505,-20
95221951850,95221951851,1,1544,1189,-20
95225180546,95225180551,5,1915,1265,-20
95227277449,95227277452,3,1513,1376,-20
95227460745,95227460747,2,2197,1236,-20
95228985695,95228985698,3,1775,1084,-20
95230771487,95230771491,4,2210,1192,-20
95232119257,95232119265,8,1803,939,-20
95243046347,95243046354,7,1977,1332,-20
95243364787,95243364790,3,1676,1319,-20
95243541265,95243541271,6,2271,1561,-20
95245098235,95245098237,2,1839,1378,-20
95250610575,95250610579,4,1913,1373,-20
95253471241,95253471245,4,2011,1552,-20
95255648220,95255648219,-1,468,696,-20
95256327332,95256327345,13,1603,1025,-20
95263331527,95263331529,2,705,543,-20
95267737863,95267737866,3,1532,1326,-20
95269950446,95269950451,5,1555,1394,-20
95270899684,95270899685,1,1951,1309,-20
95271351038,95271351041,3,1881,1301,-20
95271453654,95271453659,5,2022,1225,-20
95273558202,95273558205,3,14215,13205,-20
95277902552,95277902555,3,1723,1473,-20
95278866337,95278866340,3,1945,1954,-20
95279071787,95279071791,4,1719,897,-20
95279351568,95279351568,0,1628,1716,-20
95280010590,95280010595,5,2443,1547,-20
95281730578,95281730579,1,2381,1717,-20
95282255554,95282255558,4,1784,1171,-20
95285721356,95285721356,0,1967,2458,-20
95286242553,95286242556,3,1494,1696,-20
95287195413,95287195418,5,1383,1521,-20
95293117931,95293117935,4,2039,1531,-20
95294264697,95294264698,1,1743,1182,-20
95294543893,95294543889,-4,1774,5387,-20
95296370945,95296370948,3,1847,1339,-20
95297281127,95297281133,6,1979,1368,-20
95297351970,95297351971,1,2100,1359,-20
95299158183,95299158187,4,1190,1105,-20
95302509902,95302509907,5,1927,1276,-20
95304241957,95304241958,1,1289,1232,-20
95305295187,95305295191,4,1312,674,-20
95306689510,95306689514,4,2714,1741,-20
95309411423,95309411427,4,1630,971,-20
95309608263,95309608265,2,1000,1520,-20
95318343689,95318343695,6,1657,1317,-20
95319547006,95319547008,2,2089,1599,-20
95321250224,95321250227,3,1831,1374,-20
95326150786,95326150791,5,1945,1456,-20
95327872718,95327872721,3,1947,1570,-20
95328107228,95328107233,5,1974,1275,-20
95333384152,95333384154,2,1593,1469,-20
95336345089,95336345093,4,1895,1733,-20
95338534274,95338534252,-22,2062,1036,-20
95339702245,95339702249,4,3601,2553,-20
95341811427,95341811429,2,1282,1127,-20
95342055915,95342055915,0,1532,1214,-20
95342980846,95342980839,-7,1708,5340,-20
95343213753,95343213756,3,2318,1585,-20
95344419758,95344419753,-5,1293,3338,-20
95349089557,95349089560,3,2861,1478,-20
95349749541,95349749542,1,1351,1269,-20
95355394721,95355394723,2,1660,1376,-20
95360292467,95360292483,16,972,213,-20
95361634689,95361634692,3,2384,1596,-20
95364467954,95364467956,2,1248,1877,-20
95366062529,95366062509,-20,1873,1441,-20
95371303447,95371303446,-1,1207,1912,-20
95376082706,95376082709,3,1391,1497,-20
95378016813,95378016815,2,2042,2219,-20
95379368029,95379368035,6,1719,1106,-20
95385694163,95385694167,4,1900,1257,-20
95388791326,95388791331,5,2160,1854,-20
95391942333,95391942330,-3,1064,2713,-20
95393286859,95393286863,4,2548,2224,-20
95393443734,95393443734,0,1885,1657,-20
95393686118,95393686119,1,2059,1778,-20
95399908065,95399908067,2,2002,1539,-20
95400658977,95400658983,6,1994,1152,-20
95401983028,95401983021,-7,801,2833,-20
95404639838,95404639838,0,1846,2009,-20
95405471936,95405471938,2,1247,1008,-20
95406133083,95406133088,5,2796,2007,-20
95406791963,95406791967,4,1467,1455,-20
95408002881,95408002885,4,1987,1921,-20
95412447624,95412447627,3,1571,1222,-20
95417506994,95417506997,3,2229,1719,-20
95419071450,95419071454,4,1837,1611,-20
95419276333,95419276337,4,2008,1341,-20
95421249581,95421249585,4,2372,1757,-20
95421735310,95421735317,7,3284,1416,-20
95426894157,95426894159,2,1973,1473,-20
95427973323,95427973326,3,1550,1786,-20
95430531666,95430531670,4,2116,1599,-20
95431365590,95431365595,5,2139,1453,-20
95432556594,95432556601,7,2056,1277,-20
95433747650,95433747654,4,1558,1232,-20
95440746269,95440746272,3,2412,1646,-20
95442980633,95442980637,4,2069,1716,-20
95443412894,95443412895,1,2035,1907,-20
95446897479,95446897482,3,1732,1374,-20
95455044715,95455044719,4,1685,1091,-20
95455543051,95455543054,3,1732,1680,-20
95456641436,95456641437,1,1509,1457,-20
95461607135,95461607140,5,1919,1680,-20
95461718731,95461718734,3,2055,1539,-20
95463427918,95463427921,3,1572,1468,-20
95463547570,95463547577,7,5322,1350,-20
95465321052,95465321051,-1,1530,1580,-20
95468943167,95468943179,12,14113,32381,-20
95470678391,95470678395,4,2365,1300,-20
95475550592,95475550594,2,1253,880,-20
95476285951,95476285955,4,1530,992,-20
95477535146,95477535147,1,2122,1790,-20
95477955198,95477955202,4,1304,1473,-20
95478106978,95478106983,5,2463,1474,-20
95480473603,95480473606,3,1579,1211,-20
95480618391,95480618385,-6,2675,7641,-20
95480874563,95480874563,0,23275,16392,-20
95481674113,95481674118,5,2013,1028,-20
95484193371,95484193375,4,2286,1488,-20
95486138932,95486138934,2,1238,1188,-20
95487729974,95487729978,4,1700,965,-20
95491116461,95491116463,2,1674,1441,-20
95495305870,95495305873,3,1444,1375,-20
95495912732,95495912738,6,1970,1251,-20
95499837995,95499837997,2,1777,2094,-20
95503058673,95503058676,3,2129,1241,-20
95504640406,95504640409,3,1651,1388,-20
95508757410,95508757414,4,1524,1247,-20
95511611608,95511611606,-2,2502,3166,-20
95515047490,95515047493,3,1580,1110,-20
95517718741,95517718745,4,2541,2081,-20
95518650858,95518650864,6,2032,1702,-20
95520952940,95520952944,4,1562,1469,-20
95521211645,95521211647,2,2088,1116,-20
95523637893,95523637893,0,1961,2776,-20
95523867026,95523867031,5,2110,1967,-20
95523899309,95523899312,3,1218,1331,-20
95525447238,95525447238,0,1984,1616,-20
95525778487,95525778494,7,1621,731,-20
95525909929,95525909938,9,1851,1276,-20
95526579586,95526579586,0,1162,1004,-20
95527466788,95527466793,5,2175,1423,-20
95528312166,95528312147,-19,749,366,-20
95530219108,95530219111,3,1884,1390,-20
95530754645,95530754646,1,1546,1500,-20
95532246461,95532246464,3,1108,1361,-20
95532812989,95532812993,4,2045,1934,-20
95533985175,95533985178,3,1772,1430,-20
95534722716,95534722717,1,1172,1144,-20
95539077271,95539077274,3,1669,1340,-20
95541517415,95541517422,7,3898,1280,-20
95542383733,95542383735,2,1346,1749,-20
95544857764,95544857769,5,1418,1508,-20
95545844566,95545844570,4,1223,1708,-20
95546799494,95546799488,-6,1650,5453,-20
95547129178,95547129182,4,4168,2820,-20
95549607431,95549607434,3,1756,1338,-20
95550700871,95550700870,-1,1203,1267,-20
95555613997,95555613980,-17,2646,2115,-20
95557146389,95557146391,2,1208,1131,-20
95558754015,95558754019,4,1852,1456,-20
95560980570,95560980575,5,1356,1525,-20
95563419123,95563419126,3,2102,1163,-20
95564647210,95564647214,4,1344,1667,-20
95565868222,95565868226,4,1239,1287,-20
95566519424,95566519425,1,1298,2066,-20
95567325081,95567325086,5,1452,1450,-20
95571515602,95571515603,1,1977,2149,-20
95572662850,95572662854,4,1800,1333,-20
95577674537,95577674542,5,2473,1915,-20
95578641274,95578641277,3,1930,1328,-20
95581058462,95581058467,5,1641,1263,-20
95587605122,95587605125,3,3392,2247,-20
95587783525,95587783529,4,1907,1176,-20
95594142289,95594142291,2,1344,1596,-20
95595406305,95595406306,1,2028,1330,-20
95595662311,95595662313,2,1195,1555,-20
95597111123,95597111129,6,1584,1218,-20
95599221756,95599221758,2,1797,1197,-20
95600064454,95600064459,5,3789,1566,-20
95604965879,95604965882,3,1178,932,-20
95605298431,95605298433,2,1175,1114,-20
95605567114,95605567117,3,1471,1044,-20
95609978293,95609978297,4,1535,1172,-20
95611242383,95611242387,4,1713,1013,-20
95611531537,95611531542,5,2257,1184,-20
95618396127,95618396131,4,1665,1146,-20
95622683567,95622683573,6,3385,1481,-20
95622887131,95622887134,3,2130,1441,-20
95624873046,95624873050,4,1694,1055,-20
95627871982,95627871966,-16,1230,415,-20
95628013798,95628013802,4,1885,1327,-20
95628236079,95628236085,6,4908,2122,-20
95631548481,95631548483,2,2600,1703,-20
95632977689,95632977690,1,1260,1413,-20
95634363646,95634363650,4,1913,1143,-20
95638758534,95638758539,5,2230,1264,-20
95639410782,95639410763,-19,1435,955,-20
95641977955,95641977956,1,1474,1260,-20
95643846191,95643846193,2,990,1503,-20
95645230492,95645230488,-4,608,1688,-20
95647102745,95647102750,5,1818,1849,-20
95651505222,95651505223,1,2086,1329,-20
95652642638,95652642643,5,2124,1139,-20
95653377761,95653377765,4,1997,1632,-20
95656064721,95656064717,-4,1699,4771,-20
95656180106,95656180110,4,1757,1227,-20
95657070264,95657070262,-2,818,1100,-20
95660397106,95660397109,3,1545,1325,-20
95662547850,95662547855,5,2076,1285,-20
95665240688,95665240699,11,14084,22120,-20
95669000838,95669000842,4,1802,1536,-20
95669967663,95669967666,3,804,513,-20
95674799480,95674799483,3,1736,1207,-20
95674977620,95674977618,-2,2852,4091,-20
95676549198,95676549202,4,2216,1241,-20
95676853848,95676853834,-14,1716,839,-20
95681349196,95681349199,3,1935,1703,-20
95686102846,95686102847,1,1334,1177,-20
95688540669,95688540673,4,1363,1568,-20
95690403842,95690403847,5,924,735,-20
95694503926,95694503927,1,2033,1779,-20
95695887654,95695887658,4,2068,1240,-20
95701147907,95701147911,4,2202,1258,-20
95704257474,95704257480,6,1788,645,-20
95705195294,95705195298,4,1853,2009,-20
95707691491,95707691495,4,1714,1587,-20
95711058773,95711058775,2,1272,1242,-20
95711459043,95711459061,18,701,1184,-20
95711700274,95711700279,5,1326,827,-20
95711996730,95711996733,3,1169,933,-20
95713284382,95713284385,3,1696,1323,-20
95717358939,95717358944,5,1988,1490,-20
95719089858,95719089856,-2,3101,8277,-20
95720805900,95720805903,3,1670,1630,-20
95724670944,95724670945,1,1642,1369,-20
95726882891,95726882892,1,871,1782,-20
95727146091,95727146096,5,2810,1498,-20
95731754861,95731754866,5,1698,1453,-20
95733099217,95733099222,5,2090,1176,-20
95735277635,95735277639,4,2235,1349,-20
95735508652,95735508656,4,2722,1445,-20
95735731246,95735731259,13,1285,1194,-20
95736428371,95736428387,16,1262,1103,-20
95737327577,95737327580,3,1585,1359,-20
95738246852,95738246854,2,2670,2079,-20
95744449615,95744449620,5,1270,1128,-20
95748343808,95748343813,5,1781,1362,-20
95750233094,95750233098,4,2576,1329,-20
95751560639,95751560642,3,2402,1610,-20
95751683451,95751683454,3,1041,1038,-20
95755224530,95755224534,4,2181,1659,-20
95757261461,95757261466,5,1679,1151,-20
95757516734,95757516733,-1,1451,2125,-20
95758077445,95758077447,2,1982,1449,-20
95759071249,95759071252,3,1768,1129,-20
95760124899,95760124902,3,2000,1106,-20
95763474204,95763474208,4,1448,1601,-20
95765604804,95765604811,7,2727,1210,-20
95766490819,95766490823,4,1677,1513,-20
95771007114,95771007119,5,1925,1282,-20
95771980512,95771980518,6,1483,1170,-20
95780172543,95780172547,4,2263,1732,-20
95781456117,95781456119,2,1024,1240,-20
95782243690,95782243695,5,1828,1152,-20
95784813763,95784813767,4,1884,1837,-20
95785963841,95785963846,5,1712,995,-20
95788764779,95788764782,3,1323,1924,-20
95788806426,95788806430,4,1501,1256,-20
95795916036,95795916038,2,2535,2038,-20
95797880562,95797880565,3,1745,1308,-20
95797920033,95797920038,5,1363,880,-20
95803114218,95803114222,4,1818,1411,-20
95803709140,95803709144,4,1924,1370,-20
95804034521,95804034520,-1,1419,1394,-20
95805362710,95805362714,4,1500,1393,-20
95809271186,95809271192,6,10487,28708,-20
95813307226,95813307230,4,1670,1311,-20
95813948445,95813948447,2,1185,1559,-20
95817585845,95817585848,3,1474,1390,-20
95818136713,95818136716,3,1847,1673,-20
95820709018,95820709022,4,2171,1525,-20
95821512117,95821512130,13,1496,860,-20
95822198929,95822198933,4,1568,1392,-20
95822465445,95822465448,3,1285,1353,-20
95828845527,95828845531,4,1070,1018,-20
95835306374,95835306378,4,2401,2038,-20
95835462817,95835462818,1,1129,2016,-20
95835957781,95835957782,1,1328,1367,-20
95836113913,95836113917,4,1992,1708,-20
95837738186,95837738190,4,1907,1265,-20
95838108515,95838108519,4,2417,1482,-20
95838302379,95838302378,-1,1108,922,-20
95839339582,95839339583,1,1510,1227,-20
95843698789,95843698791,2,1741,1265,-20
95846966225,95846966230,5,1377,1093,-20
95848081686,95848081689,3,2030,1564,-20
95853390871,95853390877,6,2651,1461,-20
95854987702,95854987705,3,1836,1449,-20
95863955480,95863955482,2,2093,1964,-20
95864024358,95864024352,-6,1083,5537,-20
95867214510,95867214502,-8,1390,6182,-20
95867352291,95867352294,3,2204,1381,-20
95868053424,95868053427,3,1365,1178,-20
95868297440,95868297444,4,1844,1455,-20
95872001651,95872001653,2,1766,1477,-20
95873281916,95873281921,5,2613,1410,-20
95881818759,95881818761,2,1482,1769,-20
95881917350,95881917329,-21,833,406,-20
95884266429,95884266430,1,1391,1129,-20
95887073744,95887073746,2,2321,1433,-20
95895058017,95895058021,4,1463,906,-20
95897377909,95897377911,2,1633,1265,-20
95900169334,95900169339,5,1489,896,-20
95902321450,95902321450,0,983,1082,-20
95906098986,95906099005,19,1629,1802,-20
95907056997,95907057002,5,2563,1809,-20
95907392225,95907392210,-15,2248,1298,-20
95909914034,95909914037,3,1661,1124,-20
95917226386,95917226389,3,2179,1419,-20
95917264359,95917264378,19,635,150,-20
95917905641,95917905644,3,1960,1954,-20
95918913243,95918913247,4,1578,1401,-20
95920370956,95920370959,3,2077,1391,-20
95920998086,95920998090,4,2018,1869,-20
95924321689,95924321691,2,1258,1430,-20
95927919482,95927919488,6,2088,1607,-20
95930851886,95930851868,-18,2620,1779,-20
95932731545,95932731550,5,1472,837,-20
95938162624,95938162625,1,2070,2414,-20
95938861973,95938861974,1,1886,1736,-20
95941048038,95941048020,-18,913,2619,-20
95942481536,95942481539,3,2152,1359,-20
95945714277,95945714278,1,1290,1234,-20
95946401390,95946401394,4,1674,1142,-20
95948282929,95948282930,1,1608,961,-20
95950190496,95950190499,3,2648,1548,-20
95950549959,95950549963,4,1662,1303,-20
95950925040,95950925057,17,780,305,-20
95951162843,95951162846,3,1726,1219,-20
95951586828,95951586848,20,1033,1735,-20
95952648061,95952648064,3,2303,2420,-20
95959972950,95959972954,4,2363,1319,-20
95962407128,95962407130,2,1970,1608,-20
95963559489,95963559491,2,1426,1379,-20
95965124181,95965124183,2,2084,1473,-20
95966240722,95966240724,2,1737,1454,-20
95966327563,95966327568,5,1975,1190,-20
95966617526,95966617512,-14,1026,532,-20
95969010098,95969010102,4,1967,1291,-20
95969713146,95969713130,-16,761,375,-20
95981331953,95981331958,5,1644,1653,-20
95984263245,95984263249,4,2202,1279,-20
95984892654,95984892655,1,2049,1507,-20
95985083289,95985083294,5,1597,1700,-20
95985773926,95985773929,3,1702,879,-20
95987391690,95987391692,2,3552,2763,-20
95988869442,95988869448,6,2425,1139,-20
95991973006,95991973008,2,1331,1291,-20
95993901860,95993901856,-4,890,2298,-20
95995632866,95995632867,1,2067,1520,-20
95997475174,95997475177,3,1293,1659,-20
95999471926,95999471927,1,1388,1664,-20
96000063893,96000063893,0,34785,39757,-20
96003550474,96003550478,4,1761,1275,-20
96006055868,96006055874,6,2495,1690,-20
96006396137,96006396142,5,1852,1726,-20
96007133521,96007133537,16,2368,1183,-20
96008094475,96008094478,3,1491,935,-20
96009361179,96009361181,2,1701,1698,-20
96016056713,96016056714,1,1903,2101,-20
96017162618,96017162622,4,4711,2724,-20
96019329744,96019329747,3,2410,2033,-20
96020442969,96020442971,2,2101,1623,-20
96022605065,96022605071,6,2090,1417,-20
96023067772,96023067794,22,1512,1274,-20
96023374246,96023374250,4,1394,973,-20
96029020303,96029020307,4,1444,1075,-20
96033643909,96033643914,5,1494,1096,-20
96039266973,96039266978,5,1392,1178,-20
96040147421,96040147427,6,1849,1499,-20
96042000165,96042000168,3,1489,1056,-20
96044785610,96044785615,5,1994,1300,-20
96045157259,96045157262,3,1745,1270,-20
96048160570,96048160573,3,1294,1320,-20
96049852122,96049852124,2,1358,1505,-20
96052281703,96052281705,2,1493,1348,-20
96052574641,96052574643,2,1710,1091,-20
96053077957,96053077961,4,1673,1392,-20
96054997386,96054997392,6,2149,1693,-20
96055296330,96055296315,-15,1023,728,-20
96055784316,96055784319,3,1643,1175,-20
96063429032,96063429038,6,3029,886,-20
96065589254,96065589258,4,1286,1330,-20
96067968612,96067968614,2,3369,3449,-20
96068246602,96068246605,3,1506,1201,-20
96072482633,96072482635,2,1559,1494,-20
96077342564,96077342566,2,2475,1526,-20
96083959234,96083959238,4,1878,1388,-20
96088917918,96088917913,-5,1057,2465,-20
96095650298,96095650302,4,1926,1225,-20
96097409266,96097409268,2,1864,1427,-20
96097839198,96097839202,4,2449,1572,-20
96099759385,96099759387,2,1679,1686,-20
96100821294,96100821297,3,1855,1592,-20
96101809234,96101809238,4,2469,1150,-20
96102447877,96102447880,3,1839,1817,-20
96103312193,96103312196,3,37657,36437,-20
96104306981,96104306983,2,1172,1014,-20
96107163951,96107163953,2,2186,2394,-20
96110521945,96110521947,2,1393,2190,-20
96112048858,96112048861,3,1428,1565,-20
96112274537,96112274540,3,1891,1932,-20
96114229593,96114229597,4,2458,1565,-20
96116231581,96116231577,-4,1706,5887,-20
96116916041,96116916044,3,1533,1248,-20
96117639874,96117639878,4,2754,1964,-20
96119483701,96119483705,4,2001,1526,-20
96119955892,96119955897,5,5467,2969,-20
96121580570,96121580574,4,1231,1166,-20
96122553259,96122553264,5,2317,1812,-20
96125913028,96125913030,2,2400,1917,-20
96126509585,96126509590,5,1332,1696,-20
96126829436,96126829439,3,2006,1798,-20
96129408948,96129408952,4,2039,1338,-20
96129961533,96129961554,21,1932,1439,-20
96130143154,96130143157,3,2235,1469,-20
96131087110,96131087115,5,2059,1462,-20
96132054587,96132054590,3,1904,1411,-20
96135269023,96135269026,3,1796,1721,-20
96137697445,96137697446,1,1789,1890,-20
96141037615,96141037618,3,2049,1116,-20
96142445335,96142445352,17,1593,1084,-20
96143534945,96143534950,5,2018,1262,-20
96144224830,96144224835,5,2407,1629,-20
96144588686,96144588690,4,1555,1499,-20
96145930345,96145930347,2,1701,1531,-20
96147619966,96147619970,4,4399,2338,-20
96156183621,96156183623,2,1467,871,-20
96156745574,96156745578,4,2198,1718,-20
96165762262,96165762265,3,2541,1454,-20
96168435442,96168435446,4,1656,1236,-20
96170069370,96170069384,14,1601,837,-20
96170918633,96170918635,2,1233,1209,-20
96174689726,96174689730,4,2206,1430,-20
96175682873,96175682876,3,1743,1262,-20
96178477243,96178477249,6,2271,1498,-20
96179219958,96179219966,8,28072,48765,-20
96179822428,96179822433,5,1871,1668,-20
96185440285,96185440289,4,1873,1408,-20
96187886594,96187886598,4,1525,1047,-20
96189354923,96189354926,3,1862,1498,-20
96189507881,96189507882,1,1776,1489,-20
96190877375,96190877374,-1,1915,3493,-20
96193923650,96193923651,1,1460,1939,-20
96194297886,96194297890,4,1949,1533,-20
96199193784,96199193784,0,1548,1558,-20
96199707155,96199707160,5,2752,1982,-20
96201384700,96201384703,3,1651,1473,-20
96202050589,96202050592,3,2500,1617,-20
96202894957,96202894964,7,3097,1094,-20
96203884790,96203884794,4,2040,1268,-20
96206960559,96206960563,4,1580,1430,-20
96208121833,96208121838,5,1992,1155,-20
96209001778,96209001794,16,1670,1324,-20
96209857162,96209857165,3,1848,1767,-20
96209984367,96209984369,2,1358,1402,-20
96213517135,96213517134,-1,1517,1752,-20
96216903959,96216903961,2,1249,1476,-20
96218759658,96218759662,4,1978,1116,-20
96220708235,96220708238,3,1627,1368,-20
96221639596,96221639602,6,1923,1219,-20
96221822544,96221822554,10,1638,932,-20
96223143326,96223143331,5,1689,984,-20
96223366878,96223366882,4,1841,1364,-20
96227821840,96227821844,4,2363,1170,-20
96230265316,96230265317,1,1898,1521,-20
96231133998,96231134001,3,1424,1294,-20
96232975692,96232975694,2,2025,1155,-20
96234470946,96234470946,0,1775,2088,-20
96234843127,96234843122,-5,1494,5069,-20
96236033586,96236033588,2,2122,1730,-20
96239096241,96239096244,3,1744,1441,-20
96241663125,96241663129,4,1883,1637,-20
96248628426,96248628430,4,2143,1409,-20
96250006378,96250006378,0,1241,963,-20
96263012703,96263012706,3,1585,1347,-20
96265598233,96265598237,4,1700,1604,-20
96265887243,96265887246,3,1689,1141,-20
96267649041,96267649045,4,1601,1161,-20
96272210079,96272210082,3,1744,1365,-20
96272348006,96272348010,4,1810,1883,-20
96272381758,96272381779,21,1869,1484,-20
96278042809,96278042812,3,2211,1426,-20
96279255148,96279255150,2,1960,1439,-20
96282470231,96282470235,4,1041,1013,-20
96286099005,96286098988,-17,1423,1187,-20
96287146894,96287146898,4,1345,1448,-20
96289439925,96289439927,2,2183,1359,-20
96289572182,96289572186,4,2101,1239,-20
96289813417,96289813423,6,3243,1409,-20
96290066931,96290066932,1,773,328,-20
96291169431,96291169434,3,1734,1410,-20
96293485879,96293485883,4,1454,1611,-20
96296780070,96296780075,5,2486,1879,-20
96300429846,96300429849,3,2870,1927,-20
96303190177,96303190179,2,1933,1330,-20
96303372422,96303372409,-13,694,165,-20
96305428795,96305428801,6,2350,1106,-20
96305610714,96305610698,-16,1799,1099,-20
96309882899,96309882903,4,1463,1303,-20
96310027715,96310027718,3,1598,1194,-20
96310099840,96310099834,-6,932,369,-20
96316931408,96316931411,3,1312,1574,-20
96317109518,96317109522,4,2233,1740,-20
96320280029,96320280030,1,7245,19898,-20
96321284413,96321284410,-3,1400,2118,-20
96322619124,96322619129,5,2350,1235,-20
96322948001,96322948001,0,944,935,-20
96324566233,96324566235,2,1726,1141,-20
96326820258,96326820263,5,1993,1299,-20
96327444090,96327444094,4,1867,1063,-20
96328801835,96328801842,7,1358,1171,-20
96329847978,96329847982,4,1396,1303,-20
96332771594,96332771598,4,2763,1241,-20
96334465017,96334465022,5,1226,917,-20
96338483726,96338483729,3,1785,1469,-20
96343921335,96343921338,3,2340,1404,-20
96345003898,96345003902,4,1533,1204,-20
96345528530,96345528533,3,1778,1565,-20
96346988402,96346988406,4,946,1316,-20
96350180632,96350180632,0,28267,18337,-20
96352221117,96352221121,4,1743,917,-20
96354828830,96354828834,4,2090,1459,-20
96356467002,96356467007,5,2737,1732,-20
96360181625,96360181626,1,1559,1448,-20
96362829436,96362829438,2,1906,1560,-20
96368833526,96368833530,4,2450,1154,-20
96370247039,96370247040,1,950,1399,-20
96375785830,96375785833,3,1423,1702,-20
96379968434,96379968438,4,1336,1263,-20
96381873053,96381873056,3,1689,1544,-20
96381950954,96381950956,2,2694,2986,-20
96390750255,96390750257,2,1729,1549,-20
96391233433,96391233436,3,1507,1541,-20
96393492349,96393492353,4,2090,1628,-20
96395528991,96395528995,4,1166,1311,-20
96396110819,96396110823,4,1167,1109,-20
96399314053,96399314057,4,1496,1382,-20
96403795570,96403795570,0,2036,1521,-20
96408247470,96408247473,3,2101,1103,-20
96409107009,96409107011,2,1545,1453,-20
96409993573,96409993577,4,892,1239,-20
96414835474,96414835474,0,1088,1249,-20
96415893174,96415893177,3,1891,1407,-20
96420606535,96420606542,7,1877,1322,-20
96420963456,96420963461,5,2099,1588,-20
96421112578,96421112579,1,1563,1021,-20
96421272104,96421272127,23,844,728,-20
96428400464,96428400466,2,2113,1678,-20
96429752303,96429752306,3,1337,1536,-20
96431401040,96431401045,5,1470,1471,-20
96432702618,96432702622,4,964,1048,-20
96435885300,96435885301,1,1718,1229,-20
96443953342,96443953347,5,1259,1041,-20
96445294238,96445294241,3,1807,1368,-20
96446136387,96446136401,14,11059,49804,-20
96457359867,96457359870,3,1016,1227,-20
96460317190,96460317195,5,1301,907,-20
96462110661,96462110665,4,1749,1226,-20
96462698214,96462698216,2,1397,1233,-20
96466961237,96466961239,2,1456,1485,-20
96469334194,96469334198,4,1972,1026,-20
96470124362,96470124366,4,2009,1532,-20
96482864734,96482864738,4,1929,1349,-20
96484721008,96484721006,-2,1288,1124,-20
96487252455,96487252452,-3,1001,2998,-20
96491961995,96491961998,3,1445,1177,-20
96492260758,96492260758,0,634,781,-20
96493294803,96493294807,4,1974,1500,-20
96494766542,96494766546,4,2117,1874,-20
96500017822,96500017826,4,1777,1590,-20
96500306301,96500306307,6,1400,1114,-20
96502229582,96502229584,2,2265,2655,-20
96506809872,96506809874,2,1917,954,-20
96508409748,96508409751,3,1984,1817,-20
96509271438,96509271441,3,2397,1807,-20
96510622598,96510622601,3,1953,1324,-20
96514038959,96514038964,5,2330,1560,-20
96516209170,96516209173,3,1808,1499,-20
96516530658,96516530659,1,1326,1317,-20
96517524386,96517524390,4,1555,1246,-20
96518452707,96518452711,4,2466,2038,-20
96519868529,96519868532,3,1963,1730,-20
96520114032,96520114030,-2,1021,1940,-20
96520385307,96520385313,6,1976,1066,-20
96520749406,96520749416,10,1930,1546,-20
96522420962,96522420946,-16,2242,1508,-20
96524627518,96524627522,4,1437,1519,-20
96537597822,96537597829,7,9522,23629,-20
96538040079,96538040073,-6,3046,9410,-20
96539531743,96539531748,5,1657,1209,-20
96542697652,96542697656,4,1804,1763,-20
96544797129,96544797131,2,2447,1608,-20
96545809134,96545809137,3,2278,1240,-20
96547074308,96547074310,2,1972,1795,-20
96547581549,96547581552,3,1909,1391,-20
96551744074,96551744076,2,2037,1731,-20
96551958643,96551958657,14,1027,964,-20
96558261098,96558261103,5,2176,1106,-20
96561645758,96561645762,4,1883,1680,-20
96563122849,96563122854,5,2720,1348,-20
96566395154,96566395161,7,1644,1497,-20
96567278341,96567278342,1,2390,3242,-20
96568047996,96568048000,4,2022,1676,-20
96569184335,96569184341,6,2442,1439,-20
96569856216,96569856219,3,1417,1204,-20
96570826250,96570826246,-4,1125,4278,-20
96576568533,96576568535,2,19424,24284,-20
96581177646,96581177652,6,1929,1695,-20
96582047006,96582047013,7,2147,1575,-20
96582971735,96582971740,5,1188,1309,-20
96584400013,96584400018,5,2808,1264,-20
96587230198,96587230202,4,2207,1260,-20
96587513034,96587513043,9,2711,1187,-20
96590866862,96590866867,5,2642,1344,-20
96591883000,96591883003,3,1884,1659,-20
96594852728,96594852730,2,1820,1769,-20
96596320765,96596320767,2,1464,1183,-20
96596605249,96596605252,3,1813,1293,-20
96599135214,96599135216,2,1300,1170,-20
96600336706,96600336708,2,1712,1031,-20
96605296502,96605296506,4,1722,1214,-20
96605754596,96605754598,2,1557,1134,-20
96606506013,96606506015,2,1594,1009,-20
96608340030,96608340033,3,1636,1188,-20
96608878483,96608878487,4,1888,1695,-20
96609838570,96609838574,4,1767,1223,-20
96610421453,96610421458,5,1681,1451,-20
96611980889,96611980894,5,1846,1092,-20
96613821579,96613821582,3,1668,1567,-20
96617587727,96617587729,2,2159,1752,-20
96619543470,96619543471,1,1003,1276,-20
96621956785,96621956786,1,1291,1343,-20
96623238230,96623238229,-1,1137,1025,-20
96624343674,96624343675,1,1292,1629,-20
96624885006,96624885011,5,1764,1244,-20
96631585223,96631585228,5,1862,1344,-20
96633717571,96633717575,4,1881,1058,-20
96635020630,96635020626,-4,40086,19940,-20
96635482438,96635482442,4,2227,1976,-20
96636146102,96636146106,4,1609,1361,-20
96640131136,96640131138,2,1486,1273,-20
96640676472,96640676475,3,2726,2173,-20
96644554582,96644554587,5,2045,1547,-20
96645667925,96645667929,4,2137,1546,-20
96645909651,96645909655,4,2295,1355,-20
96647801845,96647801846,1,1668,1087,-20
96651367765,96651367767,2,2038,1985,-20
96651878302,96651878306,4,2969,1530,-20
96653829626,96653829629,3,1984,1343,-20
96658511759,96658511761,2,1952,1250,-20
96660399182,96660399187,5,1787,1416,-20
96661653711,96661653714,3,1799,1054,-20
96662804667,96662804682,15,729,617,-20
96668038928,96668038931,3,1392,1297,-20
96674701342,96674701338,-4,781,1972,-20
96676146118,96676146122,4,2560,1282,-20
96679278848,96679278851,3,1887,1211,-20
96680654694,96680654698,4,2625,1559,-20
96681543983,96681543986,3,1530,1348,-20
96682819905,96682819905,0,1547,1629,-20
96684808561,96684808565,4,1368,1211,-20
96685706132,96685706135,3,2313,1275,-20
96687554499,96687554502,3,2078,925,-20
96690557754,96690557759,5,1805,1463,-20
96693112873,96693112875,2,1438,1126,-20
96694670793,96694670799,6,2071,1116,-20
96695605373,96695605392,19,77,1868,-20
96696949793,96696949795,2,1517,1964,-20
96700658963,96700658969,6,2093,1279,-20
96705460225,96705460228,3,3083,2725,-20
96706018039,96706018045,6,1837,1780,-20
96710066123,96710066126,3,1501,1078,-20
96711429307,96711429307,0,1360,1500,-20
96713224982,96713224986,4,2904,1609,-20
96716013454,96716013456,2,1783,1829,-20
96719593730,96719593733,3,1993,1326,-20
96719665413,96719665416,3,956,1434,-20
96722718313,96722718315,2,1837,1320,-20
96724802098,96724802101,3,1448,805,-20
96728907063,96728907068,5,2513,1495,-20
96730380598,96730380599,1,1285,1274,-20
96731660450,96731660453,3,916,688,-20
96732790516,96732790518,2,1056,1263,-20
96734961007,96734961025,18,108,1032,-20
96736006473,96736006477,4,1546,1286,-20
96741825067,96741825072,5,1403,1200,-20
96743902410,96743902414,4,1632,1170,-20
96745271991,96745271994,3,1630,1672,-20
96747254281,96747254286,5,1534,1134,-20
96747766609,96747766611,2,1629,1274,-20
96747991637,96747991656,19,1853,1324,-20
96748481422,96748481426,4,1599,1125,-20
96748925668,96748925670,2,2375,1630,-20
96751412412,96751412411,-1,1570,2165,-20
96751474580,96751474583,3,1906,1600,-20
96754915070,96754915073,3,1837,1582,-20
96755727716,96755727720,4,1680,1333,-20
96756470135,96756470139,4,1704,1752,-20
96756732491,96756732495,4,1309,1135,-20
96758480742,96758480746,4,3060,1620,-20
96761340327,96761340331,4,1782,1262,-20
96762283954,96762283957,3,1671,1541,-20
96762600962,96762600969,7,4236,1849,-20
96763148031,96763148033,2,1529,1272,-20
96764545006,96764545010,4,1940,1487,-20
96764887003,96764887007,4,1890,1888,-20
96768798339,96768798342,3,2214,1572,-20
96769338410,96769338414,4,1989,1399,-20
96777017613,96777017617,4,1172,1368,-20
96787529827,96787529829,2,783,1449,-20
96788659728,96788659732,4,1646,1651,-20
96790085396,96790085399,3,1785,1311,-20
96790616737,96790616739,2,1261,1232,-20
96797655244,96797655246,2,1728,1667,-20
96799308205,96799308209,4,1948,1256,-20
96801451158,96801451159,1,1707,1576,-20
96805362967,96805362970,3,1587,1020,-20
96806204712,96806204716,4,1873,1870,-20
96807211505,96807211507,2,1111,1339,-20
96811924713,96811924714,1,1487,1275,-20
96814347096,96814347098,2,1729,1291,-20
96816321902,96816321906,4,1986,1591,-20
96816394215,96816394222,7,1640,1173,-20
96819188350,96819188348,-2,1044,2093,-20
96819909581,96819909583,2,1125,853,-20
96821355661,96821355665,4,2188,1315,-20
96821521884,96821521885,1,1037,1094,-20
96826758824,96826758826,2,1847,1182,-20
96829665104,96829665107,3,1310,1135,-20
96831249339,96831249342,3,1765,1486,-20
96832484142,96832484146,4,1336,1145,-20
96837537825,96837537826,1,2075,1358,-20
96840537984,96840537990,6,3274,1805,-20
96841411197,96841411200,3,1769,1455,-20
96842108758,96842108761,3,1754,1915,-20
96842992001,96842992004,3,1783,1581,-20
96846439660,96846439663,3,2248,1419,-20
96849475465,96849475466,1,2102,1458,-20
96850710339,96850710337,-2,1482,3052,-20
96854464591,96854464596,5,1904,1289,-20
96858938086,96858938091,5,2010,1755,-20
96860972071,96860972074,3,1565,1230,-20
96861078369,96861078373,4,1455,1506,-20
96863630436,96863630438,2,1784,1190,-20
96870616842,96870616845,3,2021,1577,-20
96874384367,96874384372,5,2208,1542,-20
96875437769,96875437771,2,2218,1260,-20
96875721321,96875721329,8,1323,1395,-20
96877097606,96877097606,0,1908,1070,-20
96879640118,96879640122,4,2678,1507,-20
96885926934,96885926939,5,659,235,-20
96887219602,96887219605,3,1836,1299,-20
96887346510,96887346514,4,1040,665,-20
96890330961,96890330966,5,2107,1270,-20
96893166493,96893166495,2,2002,1434,-20
96893393516,96893393515,-1,1212,2168,-20
96893585972,96893585988,16,211,606,-20
96897798390,96897798395,5,1462,1129,-20
96899439294,96899439295,1,1776,1084,-20
96901086519,96901086519,0,1623,1846,-20
96901154693,96901154695,2,1531,1521,-20
96906305400,96906305403,3,2094,1490,-20
96907770058,96907770061,3,2116,1253,-20
96910314402,96910314402,0,1834,2177,-20
96911134599,96911134603,4,2098,1175,-20
96915376971,96915376973,2,2351,1590,-20
96917022249,96917022255,6,5469,1865,-20
96922984163,96922984167,4,1489,1230,-20
96923658179,96923658181,2,1474,1264,-20
96929444469,96929444473,4,2143,1136,-20
96930853608,96930853611,3,1644,1465,-20
96932490561,96932490565,4,2338,1399,-20
96934730469,96934730472,3,1969,1366,-20
96935226226,96935226232,6,2247,1101,-20
96938617633,96938617635,2,1043,1106,-20
96939947426,96939947430,4,1671,1818,-20
96943176383,96943176390,7,2691,1229,-20
96952651146,96952651149,3,1543,1295,-20
96953516259,96953516266,7,3010,1360,-20
96957201610,96957201606,-4,998,1283,-20
96958651230,96958651238,8,3086,1351,-20
96959568777,96959568781,4,1544,1614,-20
96960151975,96960151956,-19,1647,981,-20
96961715097,96961715090,-7,1505,7025,-20
96966518682,96966518686,4,1240,1306,-20
96966733118,96966733121,3,2261,1713,-20
96967706492,96967706496,4,2413,1507,-20
96971019459,96971019460,1,1281,1202,-20
96973568948,96973568952,4,2300,1599,-20
96982548454,96982548457,3,1586,1494,-20
96983548073,96983548078,5,2131,1563,-20
96984202471,96984202464,-7,980,4798,-20
96985063582,96985063579,-3,870,3019,-20
96987755446,96987755450,4,1608,1679,-20
96989866674,96989866680,6,1834,1102,-20
96991906737,96991906741,4,1997,1484,-20
96993885715,96993885718,3,1392,1290,-20
97003488714,97003488716,2,1730,1799,-20
97004134215,97004134218,3,2267,1973,-20
97007394417,97007394419,2,1890,989,-20
97011061730,97011061734,4,1896,1354,-20
97012580705,97012580708,3,1884,1722,-20
97014006938,97014006941,3,1462,1133,-20
97015502985,97015502991,6,2435,1633,-20
97021480398,97021480378,-20,1985,1371,-20
97022483796,97022483798,2,2161,1191,-20
97030210200,97030210203,3,2331,1260,-20
97030824579,97030824582,3,2162,1077,-20
97041316161,97041316166,5,2980,1311,-20
97042263451,97042263455,4,1793,1185,-20
97045509859,97045509863,4,2037,1429,-20
97051947388,97051947392,4,1862,2041,-20
97054974854,97054974858,4,1268,1276,-20
97055774118,97055774122,4,1662,1427,-20
97056365302,97056365302,0,1531,1545,-20
97057002205,97057002207,2,1555,1182,-20
97057901829,97057901833,4,1092,1066,-20
97061517738,97061517741,3,1494,1386,-20
97061699923,97061699926,3,1409,2115,-20
97063419949,97063419953,4,1662,1039,-20
97066194046,97066194052,6,2620,1811,-20
97072011846,97072011851,5,2608,1156,-20
97072397407,97072397411,4,2282,1547,-20
97073232234,97073232235,1,1719,1340,-20
97073347112,97073347114,2,1617,1486,-20
97080975535,97080975538,3,1573,1676,-20
97081254473,97081254474,1,1112,1295,-20
97082306398,97082306402,4,2295,1488,-20
97083095833,97083095837,4,2277,1927,-20
97083967794,97083967797,3,1083,1170,-20
97085262910,97085262915,5,2242,1219,-20
97095431879,97095431882,3,1419,1269,-20
97103520282,97103520287,5,1321,1241,-20
97104220974,97104220977,3,2024,1964,-20
97104830821,97104830822,1,2141,1743,-20
97105667233,97105667236,3,1789,1327,-20
97106187455,97106187458,3,2116,1339,-20
97107604098,97107604102,4,1988,1112,-20
97111866851,97111866854,3,1776,1502,-20
97112007851,97112007847,-4,1634,3587,-20
97113057402,97113057398,-4,1346,4105,-20
97115053918,97115053922,4,1717,1262,-20
97116504294,97116504299,5,1737,739,-20
97119111659,97119111663,4,1816,1273,-20
97119944747,97119944754,7,7688,2083,-20
97120738307,97120738311,4,1193,906,-20
97124083614,97124083614,0,1430,1799,-20
97125281782,97125281786,4,2578,1668,-20
97125340413,97125340415,2,2230,1466,-20
97126606296,97126606298,2,2024,1309,-20
97131369446,97131369446,0,1661,2342,-20
97137614313,97137614317,4,2260,1479,-20
97138012023,97138012027,4,2400,1322,-20
97138147561,97138147564,3,1616,1356,-20
97139384017,97139384022,5,1641,902,-20
97141795861,97141795864,3,1174,1033,-20
97142410158,97142410162,4,1205,1227,-20
97143387453,97143387455,2,1210,1918,-20
97144046954,97144046958,4,2087,1639,-20
97144995323,97144995325,2,1988,1728,-20
97150151985,97150151986,1,1652,1367,-20
97154021292,97154021295,3,2143,1106,-20
97154739763,97154739766,3,2411,1351,-20
97156339288,97156339282,-6,965,1076,-20
97158418590,97158418593,3,1622,1508,-20
97159434310,97159434315,5,1695,1143,-20
97159644486,97159644486,0,1311,1174,-20
97159796331,97159796351,20,804,467,-20
97160273548,97160273552,4,1470,1378,-20
97162563804,97162563809,5,1192,1092,-20
97164554275,97164554281,6,1449,1173,-20
97165293718,97165293721,3,1778,1538,-20
97167504097,97167504099,2,1437,618,-20
97168467866,97168467869,3,2452,2106,-20
97169663000,97169663003,3,1598,1017,-20
97174923499,97174923502,3,1859,1600,-20
97175280994,97175280996,2,2501,1752,-20
97178358716,97178358718,2,1952,1812,-20
97179162062,97179162066,4,1700,1425,-20
97179640102,97179640122,20,1606,1886,-20
97182716374,97182716380,6,3036,1143,-20
97191478513,97191478519,6,1718,1298,-20
97195130425,97195130429,4,1383,1447,-20
97200704918,97200704919,1,1480,1055,-20
97205460319,97205460322,3,1249,1198,-20
97205491858,97205491862,4,2213,1517,-20
97206153785,97206153790,5,2198,1168,-20
97215547273,97215547275,2,1555,1270,-20
97216160990,97216160993,3,1645,1470,-20
97216891615,97216891619,4,1881,1276,-20
97219648854,97219648858,4,2758,1798,-20
97221553220,97221553214,-6,1673,4014,-20
97222287959,97222287962,3,1990,1850,-20
97223374982,97223374979,-3,36322,18644,-20
97224449198,97224449202,4,1499,1292,-20
97227170425,97227170430,5,3261,2205,-20
97227458486,97227458494,8,7329,1924,-20
97233697330,97233697333,3,1749,1452,-20
97237272547,97237272551,4,2137,1489,-20
97239647919,97239647924,5,1100,1124,-20
97239929429,97239929432,3,6063,3983,-20
97240310249,97240310252,3,1393,1240,-20
97240890118,97240890122,4,2228,1240,-20
97242229665,97242229669,4,2022,1068,-20
97244301598,97244301582,-16,1633,1117,-20
97245148382,97245148382,0,1658,1267,-20
97245433597,97245433601,4,1123,1165,-20
97250624352,97250624354,2,3090,1819,-20
97251634211,97251634217,6,4614,2171,-20
97251710303,97251710302,-1,1212,1660,-20
97253981041,97253981044,3,2108,1369,-20
97255388466,97255388471,5,1457,1542,-20
97255729391,97255729395,4,1689,1188,-20
97257957026,97257957028,2,1819,1508,-20
97262936476,97262936480,4,1790,1374,-20
97264358480,97264358483,3,2053,1357,-20
97264693332,97264693332,0,1027,1320,-20
97267701980,97267701982,2,1855,1859,-20
97269133010,97269133014,4,1963,1852,-20
97276978143,97276978146,3,2058,1459,-20
97277080328,97277080332,4,2030,1592,-20
97277685543,97277685547,4,1874,1329,-20
97280323993,97280323999,6,1225,1014,-20
97281245934,97281245938,4,2117,1057,-20
97284971242,97284971247,5,1697,1546,-20
97286140729,97286140731,2,1675,1594,-20
97286632009,97286632013,4,2104,1054,-20
97288571319,97288571323,4,1039,1091,-20
97289856774,97289856777,3,1149,1130,-20
97291173130,97291173134,4,2224,1255,-20
97294073737,97294073743,6,3065,1392,-20
97294623246,97294623251,5,1830,1044,-20
97297786083,97297786078,-5,1213,1759,-20
97298748018,97298748022,4,2140,1624,-20
97301927526,97301927529,3,1336,1383,-20
97303841387,97303841385,-2,973,2110,-20
97305713084,97305713098,14,14975,49225,-20
97305930558,97305930561,3,1545,1449,-20
97309126712,97309126713,1,1399,1243,-20
97310053639,97310053642,3,1943,1042,-20
97311578809,97311578814,5,1364,1012,-20
97313498253,97313498256,3,2273,1694,-20
97314922011,97314922015,4,1668,1186,-20
97316365657,97316365661,4,3034,1809,-20
97318461550,97318461553,3,1523,1192,-20
97319016666,97319016670,4,1685,1126,-20
97322882646,97322882649,3,1867,1082,-20
97324943131,97324943135,4,2152,1512,-20
97325831087,97325831089,2,1850,2003,-20
97326417416,97326417417,1,8656,10232,-20
97330172056,97330172058,2,1908,1000,-20
97330413896,97330413894,-2,1065,2760,-20
97330934798,97330934790,-8,642,3474,-20
97331854994,97331854998,4,2266,1624,-20
97336112931,97336112935,4,1935,1496,-20
97336336677,97336336679,2,1426,1025,-20
97339547044,97339547049,5,2026,2423,-20
97340291291,97340291294,3,1775,1002,-20
97345329249,97345329253,4,2257,1330,-20
97350305650,97350305654,4,2650,1742,-20
97350368349,97350368351,2,2256,2102,-20
97353278030,97353278034,4,1887,1411,-20
97353350829,97353350833,4,1432,986,-20
97357192405,97357192407,2,1500,1335,-20
97357362829,97357362834,5,1770,1594,-20
97357706482,97357706490,8,723,112,-20
97358166386,97358166391,5,2387,1200,-20
97358719090,97358719090,0,1686,2132,-20
97360285330,97360285336,6,1916,1408,-20
97360676865,97360676868,3,895,793,-20
97360782058,97360782055,-3,26929,57778,-20
97362499337,97362499339,2,1658,1376,-20
97363669059,97363669059,0,2069,2238,-20
97365130370,97365130374,4,2210,1683,-20
97365523485,97365523488,3,1994,1468,-20
97367152989,97367152993,4,960,1484,-20
97367981919,97367981905,-14,1952,1227,-20
97370489666,97370489680,14,1012,721,-20
97370682752,97370682757,5,1904,1564,-20
97372066977,97372066979,2,1875,1656,-20
97374636067,97374636070,3,1749,1484,-20
97376945589,97376945593,4,2965,1887,-20
97379638864,97379638866,2,1704,1372,-20
97380130679,97380130681,2,2140,1372,-20
97384194894,97384194897,3,665,948,-20
97385060381,97385060378,-3,1714,3489,-20
97386852810,97386852812,2,1563,1172,-20
97387036697,97387036698,1,1723,1299,-20
97389541176,97389541171,-5,1254,4108,-20
97390263369,97390263365,-4,1886,4078,-20
97391174601,97391174607,6,2055,970,-20
97393931628,97393931633,5,4880,2096,-20
97396750620,97396750625,5,2038,1668,-20
97396963442,97396963447,5,2061,980,-20
97397433639,97397433642,3,2217,2053,-20
97397754347,97397754350,3,1872,1261,-20
97398469448,97398469452,4,2564,1209,-20
97405737606,97405737610,4,1669,1368,-20
97406570214,97406570218,4,2134,2117,-20
97407505497,97407505498,1,1575,1110,-20
97410839081,97410839083,2,1546,1347,-20
97419262121,97419262123,2,1975,1519,-20
97419634963,97419634966,3,1705,1873,-20
97420658471,97420658475,4,2326,1079,-20
97421021339,97421021342,3,2312,2348,-20
97422798351,97422798354,3,2163,1758,-20
97429090257,97429090259,2,1830,1357,-20
97429220858,97429220861,3,1891,1337,-20
97429515375,97429515378,3,1193,659,-20
97433875458,97433875463,5,2202,1479,-20
97435981741,97435981720,-21,1666,962,-20
97436552174,97436552178,4,2066,1367,-20
97439645159,97439645161,2,1385,1778,-20
97442161981,97442161983,2,1567,1513,-20
97442602307,97442602302,-5,2705,8876,-20
97444431945,97444431947,2,1559,1468,-20
97444505537,97444505539,2,1473,1332,-20
97445742301,97445742307,6,1283,728,-20
97448016515,97448016519,4,1724,1363,-20
97449106762,97449106766,4,2073,1903,-20
97451301339,97451301341,2,1907,1094,-20
97457779034,97457779038,4,2080,1275,-20
97465138815,97465138818,3,2063,1184,-20
97465210059,97465210062,3,2231,1410,-20
97467016485,97467016487,2,1780,1902,-20
97469830339,97469830343,4,1528,1464,-20
97470826281,97470826284,3,1437,1366,-20
97475010922,97475010934,12,1313,950,-20
97475398317,97475398319,2,1869,1973,-20
97475550643,97475550647,4,1939,1545,-20
97476408002,97476408005,3,1780,1992,-20
97478704229,97478704233,4,2012,1453,-20
97479179307,97479179310,3,2111,1823,-20
97482873086,97482873091,5,1670,1178,-20
97487199415,97487199418,3,1847,1088,-20
97489374462,97489374464,2,1209,1460,-20
97490933821,97490933822,1,1678,995,-20
97493102323,97493102328,5,1478,1363,-20
97494064876,97494064878,2,1237,1324,-20
97494467975,97494467954,-21,2260,1936,-20
97495649589,97495649592,3,1335,1629,-20
97498532840,97498532834,-6,2119,7752,-20
97501704683,97501704685,2,1415,936,-20
97503912337,97503912342,5,2038,1146,-20
97504233866,97504233870,4,2061,1085,-20
97508238923,97508238929,6,2748,1133,-20
97508885983,97508885982,-1,1215,1430,-20
97510123946,97510123950,4,2264,1679,-20
97511315542,97511315541,-1,1254,2543,-20
97511494538,97511494542,4,1351,1059,-20
97513374326,97513374327,1,2174,1670,-20
97514985470,97514985474,4,1594,1600,-20
97520898280,97520898283,3,1996,1329,-20
97524351704,97524351698,-6,2441,4991,-20
97529001235,97529001237,2,2409,1825,-20
97530051621,97530051615,-6,1284,4004,-20
97531996561,97531996564,3,1363,1374,-20
97535666953,97535666956,3,2161,2245,-20
97536353492,97536353494,2,11174,11929,-20
97537387091,97537387094,3,1590,1136,-20
97540107166,97540107167,1,2473,1981,-20
97541687498,97541687503,5,2134,1255,-20
97549557781,97549557785,4,2051,1587,-20
97550254903,97550254908,5,2471,1869,-20
97553880875,97553880878,3,1396,1350,-20
97553999554,97553999558,4,2653,1459,-20
97555242635,97555242638,3,1306,2092,-20
97557356549,97557356543,-6,1219,3105,-20
97557625747,97557625749,2,1385,1789,-20
97559742917,97559742919,2,2236,1222,-20
97564092948,97564092944,-4,35464,12489,-20
97564314690,97564314697,7,5447,2037,-20
97567025026,97567025029,3,1989,1274,-20
97569701821,97569701823,2,2131,1395,-20
97570378431,97570378437,6,1914,1695,-20
97573039762,97573039766,4,1738,1041,-20
97574998174,97574998178,4,1762,1304,-20
97576675808,97576675812,4,1530,1282,-20
97582997295,97582997298,3,976,798,-20
97583970182,97583970186,4,1859,1435,-20
97585278411,97585278404,-7,1320,4948,-20
97585583693,97585583699,6,3693,1854,-20
97589597911,97589597914,3,1952,1218,-20
97589788663,97589788640,-23,1776,835,-20
97591995986,97591995991,5,2099,1276,-20
97592738510,97592738524,14,1503,1333,-20
97601012287,97601012291,4,1514,1308,-20
97601097348,97601097352,4,1283,1269,-20
97602796878,97602796882,4,1459,1425,-20
97603287527,97603287530,3,1131,960,-20
97605831910,97605831915,5,2408,933,-20
97606406434,97606406439,5,1081,1053,-20
97607773634,97607773639,5,1606,1106,-20
97607959742,97607959756,14,1591,1417,-20
97608667678,97608667681,3,2108,1351,-20
97611161847,97611161850,3,2054,1453,-20
97611840909,97611840910,1,2350,2443,-20
97612815836,97612815840,4,1742,1534,-20
97618383813,97618383818,5,1567,1440,-20
97620034145,97620034145,0,1238,2255,-20
97620511706,97620511710,4,1670,1678,-20
97621251657,97621251661,4,2094,1586,-20
97621739295,97621739299,4,1590,1186,-20
97623694689,97623694690,1,1301,1288,-20
97623729480,97623729478,-2,1467,1742,-20
97624797930,97624797929,-1,1377,2184,-20
97626786835,97626786838,3,2206,1565,-20
97627770077,97627770081,4,2248,1821,-20
97629803561,97629803565,4,2051,1036,-20
97636948127,97636948129,2,1243,1223,-20
97640987189,97640987193,4,12545,20003,-20
97645142556,97645142556,0,1197,1665,-20
97648631713,97648631715,2,1002,872,-20
97654035371,97654035374,3,2018,1257,-20
97658993219,97658993222,3,1393,1361,-20
97666974493,97666974494,1,1156,1622,-20
97667165557,97667165557,0,1194,1184,-20
97667291255,97667291259,4,1694,1202,-20
97667822779,97667822783,4,2364,1271,-20
97669807080,97669807077,-3,1328,1625,-20
97670397814,97670397792,-22,1187,855,-20
97671114600,97671114600,0,1734,1351,-20
97677742974,97677742975,1,1425,1725,-20
97678406150,97678406154,4,1853,952,-20
97679559962,97679559965,3,3215,2115,-20
97683827954,97683827953,-1,1149,2539,-20
97688763864,97688763867,3,3115,1723,-20
97690323466,97690323467,1,1530,1985,-20
97690638466,97690638465,-1,885,260,-20
97691688153,97691688154,1,2461,1742,-20
97694609582,97694609587,5,2132,1464,-20
97695668978,97695668983,5,2237,1775,-20
97698302185,97698302187,2,1093,1377,-20
97699401360,97699401362,2,1681,1710,-20
97704586973,97704586975,2,1691,1432,-20
97704857578,97704857582,4,1485,1335,-20
97707265852,97707265874,22,419,1867,-20
97716759097,97716759099,2,1568,1132,-20
97717083649,97717083649,0,1314,1407,-20
97717109258,97717109257,-1,1986,1807,-20
97719047255,97719047254,-1,1079,1996,-20
97719682928,97719682930,2,2448,1928,-20
97719751446,97719751449,3,1620,1307,-20
97720737361,97720737364,3,1347,1327,-20
97722850411,97722850414,3,2393,1413,-20
97723177230,97723177234,4,2080,979,-20
97724698586,97724698588,2,2145,1326,-20
97724785894,97724785872,-22,1662,847,-20
97731071553,97731071555,2,1685,1263,-20
97740727210,97740727210,0,1849,1718,-20
97744124420,97744124423,3,2090,1368,-20
97745143545,97745143547,2,1481,1363,-20
97755172621,97755172623,2,1468,1476,-20
97755237314,97755237317,3,2449,1900,-20
97756305870,97756305872,2,3531,3353,-20
97756979644,97756979647,3,1427,1174,-20
97757131069,97757131057,-12,1280,652,-20
97758101730,97758101735,5,3078,1768,-20
97758577895,97758577899,4,1485,1026,-20
97759531894,97759531896,2,1352,1249,-20
97768235435,97768235437,2,1123,998,-20
97768390998,97768390979,-19,2028,1515,-20
97771127229,97771127231,2,1684,1184,-20
97771334230,97771334234,4,2079,1614,-20
97774769132,97774769137,5,2842,1746,-20
97775156164,97775156169,5,1879,1539,-20
97777254504,97777254506,2,1938,1717,-20
97779635194,97779635199,5,5808,2946,-20
97783631456,97783631458,2,1548,1701,-20
97785709290,97785709291,1,1435,1240,-20
97789251461,97789251464,3,1384,1348,-20
97793343653,97793343657,4,2141,1448,-20
97793802881,97793802883,2,1360,1246,-20
97796084966,97796084971,5,1652,982,-20
97799026397,97799026401,4,2414,1728,-20
97799442795,97799442779,-16,985,829,-20
97802527932,97802527933,1,1360,1115,-20
97802582439,97802582441,2,1495,1497,-20
97803483610,97803483615,5,2206,1359,-20
97803913852,97803913855,3,2239,1054,-20
97804604171,97804604175,4,2012,1234,-20
97806844143,97806844146,3,2136,1661,-20
97810853755,97810853759,4,3017,1679,-20
97811288239,97811288238,-1,1172,1786,-20
97812165846,97812165847,1,2841,1814,-20
97812655721,97812655726,5,1466,1133,-20
97820716971,97820716973,2,1466,1241,-20
97822903777,97822903782,5,2102,1232,-20
97825054695,97825054697,2,1826,1393,-20
97826323869,97826323874,5,1551,1271,-20
97826612589,97826612594,5,1162,1334,-20
97835019295,97835019298,3,1995,1590,-20
97839206769,97839206773,4,2074,1435,-20
97841571377,97841571381,4,2529,2140,-20
97841798830,97841798833,3,1740,1421,-20
97843735258,97843735262,4,1506,1273,-20
97844327299,97844327308,9,14078,21246,-20
97846248881,97846248886,5,2829,1540,-20
97847225167,97847225171,4,2349,1135,-20
97847776757,97847776759,2,1541,1925,-20
97850712382,97850712386,4,1804,1571,-20
97850994250,97850994253,3,4278,2709,-20
97851517397,97851517401,4,2465,1432,-20
97853742953,97853742955,2,1670,1349,-20
97858726742,97858726746,4,1790,965,-20
97861661639,97861661625,-14,737,453,-20
97862410054,97862410057,3,1417,1171,-20
97863618523,97863618526,3,1906,1622,-20
97864202074,97864202078,4,1500,1023,-20
97866804571,97866804563,-8,1303,993,-20
97869095664,97869095663,-1,1715,2416,-20
97869930786,97869930786,0,1350,1292,-20
97871275173,97871275177,4,2342,2241,-20
97874872949,97874872953,4,1768,1698,-20
97875511070,97875511073,3,1743,1370,-20
97879435063,97879435066,3,1306,1215,-20
97883752280,97883752282,2,1429,1010,-20
97888599005,97888599010,5,2484,1902,-20
97889128750,97889128751,1,1845,1292,-20
97890577483,97890577486,3,1919,1439,-20
97897021341,97897021347,6,2538,1566,-20
97897583278,97897583258,-20,925,1140,-20
97906146698,97906146700,2,1971,1165,-20
97910610758,97910610761,3,2646,1620,-20
97910763058,97910763041,-17,619,408,-20
97911421891,97911421891,0,863,735,-20
97911896814,97911896817,3,1927,1448,-20
97913812141,97913812133,-8,2793,9506,-20
97914162552,97914162551,-1,24909,45536,-20
97915891239,97915891243,4,1088,1041,-20
97918867733,97918867738,5,1492,1261,-20
97919170219,97919170222,3,1131,1129,-20
97920024053,97920024057,4,2946,1362,-20
97926435950,97926435953,3,1618,1394,-20
97926749924,97926749926,2,1868,1491,-20
97928614484,97928614487,3,1296,1340,-20
97930354384,97930354386,2,1659,1631,-20
97935163745,97935163749,4,2313,1532,-20
97935332018,97935332022,4,2193,1684,-20
97935357225,97935357244,19,912,41,-20
97935671517,97935671521,4,1852,1282,-20
97939516306,97939516303,-3,798,2010,-20
97940438829,97940438833,4,2032,1385,-20
97945754805,97945754810,5,1547,1119,-20
97946701550,97946701553,3,1973,1693,-20
97949289020,97949289022,2,1842,1140,-20
97949510479,97949510481,2,1876,1736,-20
97957335300,97957335305,5,1722,1099,-20
97964147611,97964147615,4,1990,1295,-20
97964841584,97964841585,1,2263,1074,-20
97969677366,97969677368,2,1270,911,-20
97970033177,97970033183,6,3868,1685,-20
97970607257,97970607259,2,1832,1190,-20
97971457089,97971457094,5,1843,1100,-20
97974096241,97974096244,3,2405,1852,-20
97974965046,97974965050,4,1713,1465,-20
97975823911,97975823914,3,2190,1476,-20
97977443378,97977443381,3,2385,2213,-20
97978322359,97978322362,3,1853,1471,-20
97979388365,97979388358,-7,1099,4412,-20
97983399135,97983399139,4,1174,1431,-20
97986789435,97986789433,-2,957,1523,-20
97987410017,97987410018,1,1097,1681,-20
97989448786,97989448783,-3,1083,1064,-20
97989769573,97989769577,4,1871,1315,-20
97991217019,97991217007,-12,1487,1066,-20
97993225568,97993225571,3,1708,1115,-20
97994457743,97994457747,4,2417,1970,-20
97994635011,97994635015,4,2222,2167,-20
97994832251,97994832255,4,1987,1320,-20
97995203246,97995203249,3,2066,1296,-20
98004427957,98004427963,6,2250,1574,-20
98014493061,98014493063,2,1628,1329,-20
98018138046,98018138049,3,2360,1802,-20
98020253988,98020253988,0,2182,2048,-20
98023397448,98023397451,3,1490,703,-20
98025356430,98025356434,4,1698,975,-20
98026853414,98026853417,3,2191,1807,-20
98028347529,98028347532,3,1831,1328,-20
98033578946,98033578947,1,1467,1529,-20
98034975607,98034975607,0,1394,1049,-20
98039225255,98039225260,5,1128,1265,-20
98040959137,98040959143,6,3685,1582,-20
98041110113,98041110115,2,1343,1046,-20
98042195945,98042195949,4,1293,1456,-20
98046375262,98046375265,3,1994,1147,-20
98046532020,98046532022,2,1477,1660,-20
98053357203,98053357204,1,1525,1714,-20
98056434955,98056434956,1,970,1682,-20
98058923813,98058923816,3,1986,1416,-20
98064037517,98064037521,4,1952,2026,-20
98065568775,98065568778,3,1864,1348,-20
98067195042,98067195045,3,3006,1817,-20
98068399510,98068399514,4,2046,1507,-20
98069100885,98069100864,-21,1940,1215,-20
98071754622,98071754626,4,1285,1189,-20
98072294232,98072294235,3,996,896,-20
98076003264,98076003267,3,2223,1596,-20
98077376846,98077376850,4,1894,1935,-20
98080006698,98080006701,3,3001,1747,-20
98080289241,98080289243,2,1491,1423,-20
98080724956,98080724960,4,1891,1659,-20
98080803206,98080803212,6,1349,1484,-20
98082998331,98082998335,4,1532,1595,-20
98087557016,98087557017,1,1918,1530,-20
98087590979,98087590983,4,1407,1471,-20
98088524734,98088524739,5,1895,998,-20
98090772994,98090772996,2,2588,1709,-20
98092517190,98092517194,4,1778,1657,-20
98096208785,98096208786,1,985,975,-20
98099313337,98099313341,4,546,663,-20
98101326544,98101326550,6,7635,3329,-20
98104194627,98104194630,3,1912,1185,-20
98108714709,98108714715,6,15961,39608,-20
98108844297,98108844298,1,1269,807,-20
98110232674,98110232672,-2,1256,2312,-20
98111369266,98111369269,3,2221,1434,-20
98112474837,98112474842,5,2009,1227,-20
98119833197,98119833202,5,2318,1491,-20
98121237441,98121237444,3,1603,1663,-20
98122822735,98122822735,0,1034,1170,-20
98126360034,98126360029,-5,771,1865,-20
98129405678,98129405680,2,1973,2040,-20
98131773395,98131773396,1,1945,1472,-20
98132106681,98132106682,1,1112,848,-20
98132825561,98132825566,5,1252,954,-20
98132896169,98132896170,1,1749,2033,-20
98137140789,98137140795,6,1784,1596,-20
98138475842,98138475845,3,1051,852,-20
98139593705,98139593701,-4,30369,15817,-20
98140326154,98140326157,3,1654,1379,-20
98141647121,98141647105,-16,701,377,-20
98146819241,98146819244,3,1960,1610,-20
98147462543,98147462546,3,1575,868,-20
98154125647,98154125649,2,1338,1537,-20
98154785336,98154785339,3,2177,1514,-20
98155472319,98155472323,4,1924,1685,-20
98155866874,98155866877,3,1886,1884,-20
98166793375,98166793379,4,1372,1195,-20
98168458329,98168458333,4,1929,1485,-20
98169935694,98169935699,5,1533,1468,-20
98170607472,98170607472,0,1442,1264,-20
98179703385,98179703390,5,2397,1396,-20
98181194372,98181194375,3,1743,1439,-20
98185794645,98185794649,4,2251,1475,-20
98187487214,98187487219,5,2506,1906,-20
98190750138,98190750143,5,1501,1585,-20
98193041012,98193041005,-7,32113,15336,-20
98198969186,98198969190,4,1335,953,-20
98199217229,98199217233,4,2912,1738,-20
98209713413,98209713415,2,1438,1133,-20
98215919572,98215919577,5,2101,1310,-20
98217343770,98217343774,4,1729,1473,-20
98218863876,98218863879,3,1571,1284,-20
98221900269,98221900269,0,1695,1872,-20
98222550966,98222550969,3,2442,1859,-20
98224572397,98224572399,2,1531,1469,-20
98232731123,98232731127,4,2320,1245,-20
98233591314,98233591320,6,1749,1328,-20
98237938200,98237938202,2,1517,960,-20
98245170445,98245170449,4,1342,913,-20
98246590731,98246590726,-5,617,821,-20
98247658306,98247658310,4,1680,1826,-20
98249654653,98249654657,4,2134,1588,-20
98250454775,98250454779,4,1343,1035,-20
98255441509,98255441514,5,1626,1428,-20
98256855746,98256855748,2,1259,989,-20
98257599151,98257599154,3,1608,1510,-20
98261082197,98261082199,2,1007,1119,-20
98261842072,98261842074,2,1360,1367,-20
98262056370,98262056387,17,1024,1877,-20
98263553602,98263553605,3,2219,1889,-20
98263653482,98263653483,1,1241,1464,-20
98268094399,98268094398,-1,1164,2833,-20
98275118841,98275118843,2,2080,1360,-20
98278558664,98278558668,4,1383,1409,-20
98279995122,98279995125,3,1335,1422,-20
98280193061,98280193063,2,1738,1065,-20
98281813926,98281813930,4,1940,1559,-20
98284060304,98284060306,2,2222,1398,-20
98284137733,98284137755,22,1333,1432,-20
98289620010,98289620010,0,1482,1136,-20
98291279306,98291279307,1,2367,2113,-20
98291706586,98291706592,6,2338,1023,-20
98292245341,98292245323,-18,1590,608,-20
98292604623,98292604635,12,182,1026,-20
98292908138,98292908142,4,9604,8227,-20
98294589413,98294589416,3,1965,1392,-20
98296103046,98296103051,5,3544,1719,-20
98296398289,98296398295,6,2012,1219,-20
98298977777,98298977781,4,2117,1813,-20
98300422977,98300422981,4,2064,1724,-20
98304923328,98304923331,3,1751,1197,-20
98305635686,98305635677,-9,27161,14207,-20
98306038610,98306038615,5,1051,1457,-20
98307677970,98307677974,4,1924,1043,-20
98312038590,98312038592,2,1742,2013,-20
98312934089,98312934093,4,1922,1754,-20
98314744610,98314744614,4,2089,1297,-20
98316670022,98316670026,4,2456,1773,-20
98318998032,98318998037,5,2317,1168,-20
98319993885,98319993888,3,2022,1766,-20
98322201796,98322201798,2,1458,1229,-20
98324229059,98324229077,18,705,292,-20
98324398543,98324398546,3,2133,1390,-20
98325023607,98325023610,3,1961,1351,-20
98335009544,98335009547,3,1970,1835,-20
98336186891,98336186894,3,1909,1792,-20
98341375653,98341375657,4,1523,1641,-20
98347618280,98347618285,5,2160,1496,-20
98351512226,98351512230,4,1689,1236,-20
98352444413,98352444415,2,1807,1086,-20
98354991154,98354991158,4,1674,1299,-20
98355566011,98355566013,2,1563,1472,-20
98360638542,98360638548,6,2636,1856,-20
98366289814,98366289818,4,2282,1882,-20
98367862296,98367862298,2,2112,1026,-20
98368977073,98368977075,2,1842,1536,-20
98370762694,98370762698,4,2607,1705,-20
98372275986,98372275990,4,1021,644,-20
98373625090,98373625093,3,2035,2756,-20
98374328510,98374328513,3,890,1140,-20
98376206946,98376206940,-6,2121,7838,-20
98382453888,98382453893,5,2696,2096,-20
98388278834,98388278835,1,1961,1753,-20
98391152937,98391152939,2,1936,1365,-20
98392075243,98392075246,3,2950,1522,-20
98392140557,98392140559,2,1809,1335,-20
98395815011,98395815015,4,1521,1288,-20
98397265161,98397265165,4,2097,2232,-20
98403165354,98403165358,4,2104,1478,-20
98404545218,98404545222,4,1595,1317,-20
98406742013,98406742016,3,2020,2112,-20
98408819673,98408819678,5,1409,1609,-20
98411756830,98411756834,4,1136,773,-20
98415248785,98415248790,5,2136,1420,-20
98417902907,98417902910,3,1094,1047,-20
98426853118,98426853123,5,2065,1254,-20
98429507959,98429507963,4,1471,982,-20
98434849365,98434849370,5,1678,989,-20
98439025871,98439025874,3,1867,1560,-20
98439156138,98439156142,4,2068,1250,-20
98442235022,98442235030,8,3346,1210,-20
98444401931,98444401936,5,1513,1689,-20
98447900198,98447900202,4,1521,885,-20
98449369493,98449369499,6,1945,1494,-20
98450628516,98450628522,6,1977,1251,-20
98454791882,98454791886,4,1581,1590,-20
98456012742,98456012746,4,2721,1703,-20
98461256914,98461256914,0,1575,1905,-20
98466709510,98466709512,2,7187,21017,-20
98468033422,98468033426,4,1860,1174,-20
98475903037,98475903042,5,1168,1073,-20
98476439991,98476439993,2,2160,1941,-20
98476751878,98476751881,3,1594,1634,-20
98477445638,98477445641,3,1883,1308,-20
98477780480,98477780482,2,1808,1888,-20
98478687553,98478687549,-4,1143,2644,-20
98483430666,98483430666,0,1429,1121,-20
98483571102,98483571102,0,2324,1445,-20
98484569339,98484569345,6,2867,1334,-20
98485923298,98485923300,2,1955,1334,-20
98487632820,98487632823,3,1466,807,-20
98493629963,98493629965,2,1386,884,-20
98493958993,98493958986,-7,371,2393,-20
98495462173,98495462176,3,1808,1141,-20
98496949963,98496949965,2,1740,1482,-20
98498912991,98498912993,2,2252,1925,-20
98504622752,98504622755,3,1550,1400,-20
98506427373,98506427377,4,1999,1771,-20
98507436326,98507436329,3,1644,1110,-20
98507573509,98507573490,-19,981,416,-20
98510651083,98510651087,4,1535,1448,-20
98511751931,98511751936,5,1687,1315,-20
98513122326,98513122330,4,1866,1383,-20
98518080173,98518080173,0,1563,1026,-20
98519436514,98519436518,4,1692,1478,-20
98522981896,98522981898,2,1778,1922,-20
98523801125,98523801130,5,72250,42866,-20
98527050001,98527050005,4,1390,1427,-20
98528177251,98528177254,3,2033,1791,-20
98529341354,98529341359,5,1387,1290,-20
98530864705,98530864707,2,1495,1385,-20
98533570310,98533570314,4,1576,1675,-20
98533653698,98533653713,15,2102,1206,-20
98534895894,98534895899,5,2467,1455,-20
98535346102,98535346107,5,2435,1402,-20
98537785299,98537785302,3,1396,746,-20
98539277019,98539277023,4,1470,1157,-20
98542076373,98542076375,2,1571,1621,-20
98546348820,98546348823,3,2222,1410,-20
98551138602,98551138604,2,1603,1620,-20
98551238586,98551238585,-1,590,124,-20
98553578370,98553578374,4,2311,1960,-20
98554883863,98554883866,3,1964,1281,-20
98557825589,98557825594,5,1172,1252,-20
98559776933,98559776937,4,2293,1384,-20
98562459277,98562459271,-6,1949,1418,-20
98563761680,98563761682,2,1227,1930,-20
98564801487,98564801493,6,1947,1103,-20
98567019389,98567019391,2,1840,1729,-20
98567046393,98567046395,2,2002,1242,-20
98567087108,98567087105,-3,5109,14091,-20
98567828485,98567828489,4,1200,1422,-20
98570394587,98570394591,4,1732,1496,-20
98574566020,98574566023,3,2774,1563,-20
98577848342,98577848345,3,1387,1947,-20
98578284435,98578284438,3,1794,1742,-20
98578745278,98578745256,-22,1481,629,-20
98578784022,98578784027,5,2268,1224,-20
98580525497,98580525499,2,2112,2021,-20
98584587102,98584587105,3,1765,874,-20
98585609942,98585609937,-5,1512,3351,-20
98585666479,98585666482,3,1530,1747,-20
98586056292,98586056299,7,2098,1184,-20
98593356455,98593356458,3,1828,1917,-20
98601152150,98601152154,4,2324,1629,-20
98606760941,98606760945,4,2097,1788,-20
98607199458,98607199461,3,2250,1647,-20
98607414134,98607414139,5,2056,1209,-20
98609054737,98609054740,3,1241,1167,-20
98610241355,98610241372,17,1999,1183,-20
98611829606,98611829609,3,1360,911,-20
98612599774,98612599777,3,1828,1994,-20
98612681995,98612681998,3,1846,1284,-20
98613103669,98613103673,4,1891,1525,-20
98613676420,98613676424,4,1738,1501,-20
98616015973,98616015975,2,1748,1874,-20
98618275127,98618275130,3,2187,1949,-20
98621179711,98621179716,5,1892,1631,-20
98624049519,98624049523,4,1854,1681,-20
98631854726,98631854730,4,2053,1920,-20
98632367413,98632367417,4,2114,1783,-20
98633897868,98633897871,3,1925,1264,-20
98634933130,98634933133,3,2452,1357,-20
98635919439,98635919458,19,1572,1169,-20
98639337443,98639337447,4,1284,1182,-20
98641479474,98641479478,4,1743,1233,-20
98648506478,98648506483,5,2609,1637,-20
98650231538,98650231542,4,995,579,-20
98656268187,98656268193,6,1984,1668,-20
98658332048,98658332051,3,2667,1921,-20
98660486014,98660486018,4,2398,1042,-20
98662782191,98662782196,5,2023,1572,-20
98663881437,98663881439,2,1639,1093,-20
98664194015,98664194016,1,909,1234,-20
98664948561,98664948560,-1,663,1443,-20
98667967490,98667967494,4,1759,1418,-20
98675347761,98675347765,4,2527,1386,-20
98677527110,98677527114,4,1738,1305,-20
98680563330,98680563334,4,1419,1014,-20
98682766110,98682766110,0,899,1061,-20
98683129834,98683129838,4,1911,1262,-20
98683256559,98683256563,4,2406,1943,-20
98683952714,98683952717,3,1403,891,-20
98684647834,98684647836,2,1125,2008,-20
98685760641,98685760643,2,1226,906,-20
98686543446,98686543452,6,1447,1268,-20
98687110843,98687110848,5,1126,1118,-20
98690019603,98690019607,4,2023,1805,-20
98695475664,98695475666,2,2293,1339,-20
98695689922,98695689926,4,1232,1053,-20
98700474146,98700474148,2,2152,2272,-20
98707230959,98707230961,2,2359,1823,-20
98709181502,98709181505,3,1671,1441,-20
98714501892,98714501896,4,2582,1410,-20
98719135898,98719135900,2,2169,1529,-20
98720251269,98720251271,2,1153,1399,-20
98721124002,98721124005,3,1692,1178,-20
98724589623,98724589627,4,1646,1487,-20
98729076654,98729076654,0,1776,1459,-20
98733149453,98733149446,-7,1245,1102,-20
98733992853,98733992854,1,1584,1499,-20
98735685121,98735685124,3,1640,1356,-20
98736886902,98736886906,4,1549,1142,-20
98740662593,98740662595,2,2258,1541,-20
98741302471,98741302475,4,2225,1391,-20
98742693511,98742693516,5,2242,1733,-20
98743050807,98743050809,2,1875,1298,-20
98743138102,98743138106,4,1410,1415,-20
98746159764,98746159768,4,2219,1279,-20
98746806648,98746806651,3,2091,1255,-20
98748340475,98748340480,5,2357,1527,-20
98749401838,98749401843,5,1540,682,-20
98751479722,98751479727,5,2041,1300,-20
98756665717,98756665721,4,2156,1355,-20
98757881587,98757881587,0,2225,1749,-20
98758522825,98758522830,5,1585,814,-20
98760379730,98760379734,4,1185,1125,-20
98761902539,98761902543,4,1584,1254,-20
98762492021,98762492024,3,1209,844,-20
98765356808,98765356811,3,1505,991,-20
98765689947,98765689950,3,2355,1525,-20
98770635051,98770635056,5,2118,1267,-20
98770955133,98770955138,5,4796,2637,-20
98773870514,98773870517,3,1391,1789,-20
98777730967,98777730971,4,2323,1646,-20
98785420912,98785420916,4,2437,1751,-20
98787360738,98787360742,4,2215,1439,-20
98787820954,98787820957,3,1768,1365,-20
98788445761,98788445765,4,1865,1651,-20
98795718909,98795718914,5,14257,8458,-20
98796487868,98796487871,3,2066,1551,-20
98800198683,98800198689,6,1643,1229,-20
98800268694,98800268697,3,1125,1389,-20
98801181333,98801181334,1,2393,2258,-20
98802329984,98802329988,4,2007,1277,-20
98812330250,98812330254,4,2055,1533,-20
98815912397,98815912403,6,1240,1082,-20
98822101940,98822101943,3,1964,1466,-20
98822289031,98822289035,4,1163,970,-20
98823649857,98823649861,4,2306,1488,-20
98824777703,98824777707,4,1292,1186,-20
98825798494,98825798498,4,1762,1268,-20
98830450780,98830450783,3,1519,1070,-20
98831233969,98831233953,-16,83,963,-20
98832974676,98832974679,3,1568,1171,-20
98845437033,98845437037,4,2232,1093,-20
98856995491,98856995495,4,1639,1957,-20
98857983332,98857983333,1,1565,1457,-20
98858417083,98858417086,3,1625,1281,-20
98860769038,98860769042,4,1439,1194,-20
98861142290,98861142285,-5,558,1959,-20
98864060687,98864060693,6,1072,1444,-20
98866228916,98866228920,4,2438,2025,-20
98870550185,98870550187,2,1867,1615,-20
98876168594,98876168598,4,2381,1493,-20
98878344576,98878344581,5,1743,1484,-20
98879124536,98879124534,-2,1250,2640,-20
98881174422,98881174424,2,2439,1586,-20
98884651430,98884651436,6,2265,1364,-20
98885171673,98885171674,1,1457,2212,-20
98886594701,98886594706,5,1990,1048,-20
98886770435,98886770437,2,1774,1713,-20
98887258644,98887258647,3,2147,2211,-20
98887762193,98887762194,1,1268,1036,-20
98889249131,98889249134,3,1330,1556,-20
98890785435,98890785440,5,1654,1330,-20
98892506533,98892506537,4,1693,1419,-20
98893835241,98893835245,4,1871,1420,-20
98893940686,98893940687,1,1797,2097,-20
98894747234,98894747238,4,2110,1591,-20
98894796774,98894796779,5,1323,1301,-20
98897782752,98897782755,3,1597,1101,-20
98898509976,98898509980,4,2133,1174,-20
98899051058,98899051062,4,1279,790,-20
98899555903,98899555905,2,1397,1165,-20
98903222999,98903223002,3,1678,1459,-20
98903736979,98903736960,-19,1266,806,-20
98909348919,98909348923,4,1918,1401,-20
98909574758,98909574736,-22,1350,956,-20
98917246934,98917246930,-4,1262,2117,-20
98917841026,98917841026,0,1053,1373,-20
98922839007,98922839010,3,2678,1596,-20
98927573056,98927573060,4,1251,1323,-20
98929936898,98929936903,5,3227,1670,-20
98931234316,98931234318,2,1810,1831,-20
98931453421,98931453409,-12,905,550,-20
98935289789,98935289795,6,2088,1542,-20
98938816293,98938816296,3,1430,1393,-20
98939676999,98939677002,3,1778,1577,-20
98942098562,98942098563,1,2018,2030,-20
98945296484,98945296490,6,2417,1510,-20
98945450137,98945450141,4,2009,1414,-20
98946631414,98946631415,1,2114,1539,-20
98947452514,98947452521,7,2427,1276,-20
98955387358,98955387359,1,1420,1270,-20
98956049904,98956049907,3,1608,2009,-20
98958400189,98958400190,1,1572,1259,-20
98961083476,98961083478,2,1510,1448,-20
98963947895,98963947899,4,1889,1274,-20
98967805277,98967805283,6,2358,1658,-20
98969849893,98969849895,2,1300,1182,-20
98971649389,98971649392,3,1972,1654,-20
98974027285,98974027287,2,1386,1160,-20
98979146257,98979146258,1,1863,1710,-20
98981199471,98981199476,5,2203,1240,-20
98985700859,98985700853,-6,1203,3713,-20
98992698961,98992698963,2,2073,1292,-20
98993172587,98993172592,5,2573,2104,-20
98995666089,98995666094,5,1794,772,-20
98997128741,98997128721,-20,1451,1843,-20
99002973782,99002973786,4,3701,2056,-20
99004430037,99004430039,2,1575,1484,-20
99011548350,99011548354,4,1685,1556,-20
99014475918,99014475921,3,2056,1640,-20
99014900986,99014900991,5,2024,1440,-20
99015643250,99015643254,4,1439,1053,-20
99018461266,99018461269,3,1836,1873,-20
99019800227,99019800221,-6,1216,1481,-20
99025538567,99025538553,-14,1298,808,-20
99026136908,99026136902,-6,2027,8857,-20
99029367636,99029367638,2,1846,1289,-20
99031606578,99031606582,4,2194,1696,-20
99032921321,99032921327,6,1343,1135,-20
99034589455,99034589459,4,2392,1560,-20
99042216490,99042216493,3,1920,2060,-20
99042734200,99042734202,2,1117,1342,-20
99048166666,99048166661,-5,779,2740,-20
99048776938,99048776936,-2,19323,12881,-20
99050393660,99050393662,2,1884,1738,-20
99051058037,99051058041,4,1855,1090,-20
99053238629,99053238630,1,2255,2279,-20
99054709690,99054709695,5,1769,1132,-20
99055938743,99055938743,0,941,1426,-20
99056299920,99056299923,3,1544,936,-20
99058902685,99058902690,5,1731,1465,-20
99065605923,99065605924,1,1524,1830,-20
99070833776,99070833779,3,2938,1489,-20
99073551715,99073551719,4,2333,1815,-20
99073785808,99073785806,-2,1797,3474,-20
99079823893,99079823897,4,2244,1428,-20
99082024042,99082024046,4,2035,2023,-20
99082600266,99082600269,3,1999,1352,-20
99084926399,99084926398,-1,1052,1685,-20
99085628098,99085628099,1,2129,2962,-20
99085791627,99085791633,6,2197,1254,-20
99089226174,99089226178,4,1644,1050,-20
99089755802,99089755803,1,1514,1457,-20
99092938093,99092938096,3,1999,1314,-20
99096345352,99096345362,10,1749,1143,-20
99099915003,99099915007,4,1055,1256,-20
99102032577,99102032582,5,2038,1367,-20
99106107458,99106107461,3,1071,828,-20
99110152270,99110152273,3,2025,1091,-20
99111797230,99111797234,4,1630,1341,-20
99118046614,99118046615,1,1608,1604,-20
99119789153,99119789156,3,1626,1714,-20
99121811050,99121811055,5,1640,818,-20
99122214340,99122214322,-18,3186,1453,-20
99126349446,99126349451,5,2066,1757,-20
99127509939,99127509931,-8,2087,1571,-20
99129124089,99129124092,3,1577,1411,-20
99132021963,99132021966,3,1905,1513,-20
99132140061,99132140064,3,2098,1631,-20
99133459251,99133459256,5,1352,1358,-20
99133647106,99133647110,4,1387,1528,-20
99135015491,99135015494,3,1639,1370,-20
99135156170,99135156156,-14,766,565,-20
99136551631,99136551630,-1,1308,2812,-20
99139672232,99139672234,2,1491,1346,-20
99147277575,99147277578,3,736,1828,-20
99149144433,99149144439,6,1637,1061,-20
99153293958,99153293962,4,2521,1528,-20
99157514706,99157514713,7,3223,1530,-20
99160780948,99160780950,2,2203,2196,-20
99162275241,99162275247,6,1093,1960,-20
99164535041,99164535038,-3,1644,3419,-20
99164692274,99164692278,4,3013,3218,-20
99165734461,99165734463,2,1693,2107,-20
99172383546,99172383548,2,2325,2035,-20
99172536808,99172536812,4,928,1337,-20
99177967807,99177967811,4,1429,800,-20
99178975677,99178975681,4,2598,1946,-20
99184654604,99184654607,3,2465,1283,-20
99186605070,99186605074,4,1911,1721,-20
99191568583,99191568587,4,1945,1340,-20
99191882570,99191882579,9,2375,1937,-20
99192090004,99192090009,5,2718,1553,-20
99192891973,99192891975,2,1357,1347,-20
99194707898,99194707903,5,1478,1257,-20
99195004203,99195004209,6,2040,1694,-20
99196737496,99196737504,8,943,389,-20
99198138079,99198138083,4,2083,1290,-20
99199764394,99199764399,5,2059,1648,-20
99200534700,99200534701,1,1222,1894,-20
99201908270,99201908273,3,1862,1091,-20
99202505535,99202505537,2,4885,16124,-20
99206557119,99206557123,4,1330,699,-20
99210406461,99210406462,1,1567,2053,-20
99210567827,99210567831,4,1554,1124,-20
99210811178,99210811179,1,1785,1231,-20
99214399840,99214399843,3,10842,8880,-20
99218382170,99218382173,3,1434,1810,-20
99219756477,99219756479,2,1749,1292,-20
99220281008,99220281011,3,2253,1968,-20
99220714920,99220714921,1,2058,1204,-20
99222705478,99222705466,-12,1075,1760,-20
99228489974,99228489975,1,1221,1212,-20
99229152125,99229152104,-21,1461,1173,-20
99229795432,99229795440,8,2003,1067,-20
99232821661,99232821663,2,1896,1711,-20
99239367638,99239367643,5,1056,538,-20
99239946406,99239946403,-3,486,71,-20
99243082072,99243082075,3,1950,1452,-20
99255209340,99255209346,6,3605,1723,-20
99261698989,99261698992,3,1380,1139,-20
99264712749,99264712750,1,1852,2076,-20
99268168117,99268168117,0,1185,1351,-20
99276219818,99276219815,-3,1319,2263,-20
99276877965,99276877967,2,1800,1274,-20
99280874347,99280874349,2,1294,1266,-20
99284241766,99284241769,3,1597,1700,-20
99287468887,99287468891,4,1546,1058,-20
99293096755,99293096759,4,1248,1258,-20
99294075490,99294075495,5,1755,892,-20
99297455511,99297455511,0,825,899,-20
99297796833,99297796838,5,2296,1488,-20
99299917854,99299917858,4,1587,1742,-20
99300017696,99300017700,4,2011,1745,-20
99300508668,99300508670,2,1539,1289,-20
99300636377,99300636379,2,1919,1398,-20
99302685561,99302685564,3,1695,1357,-20
99310241173,99310241175,2,2110,1295,-20
99312951367,99312951364,-3,2950,5300,-20
99315765269,99315765269,0,1411,1229,-20
99315859771,99315859776,5,2018,1825,-20
99316083886,99316083887,1,2353,1713,-20
99316455322,99316455326,4,2973,1760,-20
99316663400,99316663406,6,2128,1317,-20
99319905152,99319905157,5,2438,1533,-20
99321044342,99321044346,4,2065,1465,-20
99323097706,99323097710,4,1514,1448,-20
99325312922,99325312926,4,2461,1828,-20
99325707123,99325707129,6,2077,1044,-20
99327125123,99327125126,3,1324,1154,-20
99330165310,99330165314,4,1723,1109,-20
99330329723,99330329727,4,1016,1150,-20
99331863337,99331863339,2,1908,1419,-20
99336088890,99336088890,0,1282,2096,-20
99340557370,99340557374,4,1807,1729,-20
99341359057,99341359058,1,1504,1244,-20
99347828585,99347828591,6,1763,1486,-20
99355347856,99355347857,1,1834,1671,-20
99357463827,99357463829,2,1985,1692,-20
99363034300,99363034302,2,1527,1946,-20
99363434656,99363434661,5,2462,1744,-20
99364730058,99364730060,2,1832,1718,-20
99367889813,99367889815,2,1318,1526,-20
99376369794,99376369796,2,1397,1371,-20
99377674356,99377674359,3,1960,1962,-20
99382266349,99382266352,3,2196,1158,-20
99383979196,99383979199,3,1891,1610,-20
99384907144,99384907145,1,1786,1673,-20
99385831572,99385831575,3,1383,1017,-20
99393787813,99393787816,3,2239,1891,-20
99394812578,99394812582,4,1849,1565,-20
99400996858,99400996859,1,783,1217,-20
99402237891,99402237894,3,2220,1236,-20
99403740698,99403740699,1,1402,1316,-20
99405804453,99405804456,3,2205,1612,-20
99406910651,99406910653,2,1104,1340,-20
99413551300,99413551303,3,1298,811,-20
99415238098,99415238100,2,2414,1069,-20
99415392453,99415392454,1,2212,1736,-20
99416072188,99416072190,2,1816,1601,-20
99416814454,99416814459,5,1791,1097,-20
99417690526,99417690530,4,1643,1363,-20
99424513667,99424513672,5,1382,1416,-20
99425452210,99425452215,5,2383,1787,-20
99425978878,99425978878,0,1550,1223,-20
99433534218,99433534222,4,2161,1835,-20
99441849344,99441849346,2,1045,1637,-20
99442523912,99442523911,-1,1971,4266,-20
99446724914,99446724917,3,1704,1070,-20
99448377750,99448377754,4,3372,2055,-20
99454133328,99454133332,4,1742,1840,-20
99456738697,99456738702,5,1868,1312,-20
99457501627,99457501634,7,1737,1489,-20
99457865235,99457865238,3,1424,1076,-20
99465711381,99465711381,0,1512,1363,-20
99468263551,99468263553,2,1560,1546,-20
99468385093,99468385095,2,1169,1498,-20
99469425085,99469425086,1,1291,1698,-20
99471755566,99471755573,7,2262,1386,-20
99474326357,99474326361,4,1960,1296,-20
99476311567,99476311571,4,1362,1020,-20
99477242458,99477242458,0,1683,2031,-20
99478251531,99478251537,6,2554,1328,-20
99481359567,99481359570,3,1481,1672,-20
99484346593,99484346597,4,1523,1254,-20
99484701333,99484701337,4,2738,1533,-20
99492217729,99492217734,5,1994,1448,-20
99493313180,99493313183,3,2184,1781,-20
99494778762,99494778766,4,2580,1597,-20
99497887588,99497887590,2,1451,1421,-20
99500128749,99500128750,1,1358,1940,-20
99504889273,99504889282,9,7603,2822,-20
99507015218,99507015222,4,2889,2080,-20
99512640646,99512640654,8,2039,992,-20
99516162191,99516162197,6,1782,1124,-20
99517661122,99517661125,3,1829,1836,-20
99518129890,99518129891,1,1408,1455,-20
99518315878,99518315879,1,1890,1281,-20
99520751701,99520751703,2,1417,1455,-20
99521367558,99521367562,4,1632,1294,-20
99521565289,99521565291,2,1886,1888,-20
99526630286,99526630288,2,1720,1188,-20
99526809362,99526809366,4,2095,1349,-20
99527390598,99527390602,4,1822,1321,-20
99527888398,99527888402,4,1831,1080,-20
99528033551,99528033531,-20,1175,961,-20
99528701519,99528701522,3,1592,1552,-20
99529567053,99529567051,-2,2054,3530,-20
99531234082,99531234085,3,1549,1460,-20
99534259762,99534259767,5,2177,1452,-20
99536027633,99536027634,1,1739,1195,-20
99540441398,99540441404,6,1097,1213,-20
99543810561,99543810564,3,2274,1431,-20
99545384384,99545384386,2,1795,1129,-20
99550411124,99550411126,2,2195,1302,-20
99554061026,99554061031,5,1561,1507,-20
99557098250,99557098253,3,1967,1898,-20
99557259556,99557259559,3,2167,1536,-20
99559575008,99559575012,4,1126,959,-20
99560960485,99560960465,-20,2551,1895,-20
99561895872,99561895874,2,1512,995,-20
99561994461,99561994442,-19,956,589,-20
99564600818,99564600800,-18,1345,1168,-20
99565257758,99565257768,10,1641,1562,-20
99565725349,99565725360,11,2621,1195,-20
99572955576,99572955575,-1,1533,1262,-20
99574286636,99574286642,6,3517,1427,-20
99575816597,99575816602,5,2548,1377,-20
99577863871,99577863873,2,1937,2165,-20
99579359343,99579359345,2,1980,1937,-20
99580794990,99580794993,3,1793,1220,-20
99581477203,99581477205,2,2518,1667,-20
99583470572,99583470576,4,2187,1165,-20
99586732524,99586732528,4,1707,1135,-20
99586827366,99586827369,3,1516,1709,-20
99589915209,99589915215,6,1263,1239,-20
99596796277,99596796280,3,1834,1444,-20
99597226191,99597226195,4,2105,1499,-20
99604185646,99604185653,7,1586,1599,-20
99605174386,99605174391,5,1612,1417,-20
99605236366,99605236371,5,1171,1349,-20
99606416648,99606416650,2,1636,1485,-20
99606997627,99606997630,3,1443,1010,-20
99608102097,99608102100,3,1979,1248,-20
99608274575,99608274587,12,1358,1330,-20
99608576583,99608576587,4,1636,1005,-20
99609441907,99609441910,3,1641,1237,-20
99610224882,99610224884,2,1494,1369,-20
99612085648,99612085653,5,3082,2229,-20
99613012470,99613012473,3,1700,1471,-20
99617062262,99617062267,5,1213,1035,-20
99617917863,99617917867,4,2150,2034,-20
99625973890,99625973894,4,1857,1467,-20
99626573547,99626573551,4,2319,1439,-20
99627476153,99627476149,-4,1821,4728,-20
99630491518,99630491522,4,1990,1487,-20
99631601326,99631601329,3,2009,1488,-20
99632665009,99632665014,5,1852,1284,-20
99635041746,99635041751,5,1867,1244,-20
99636241816,99636241817,1,5740,24775,-20
99637494370,99637494374,4,1650,1280,-20
99638035420,99638035437,17,915,2604,-20
99639771062,99639771066,4,1664,1516,-20
99640060268,99640060274,6,1800,1017,-20
99641220936,99641220940,4,2318,2242,-20
99641306857,99641306861,4,2054,1905,-20
99642092169,99642092166,-3,751,1853,-20
99644624994,99644625007,13,455,3496,-20
99645491766,99645491770,4,1116,839,-20
99646002996,99646003000,4,1644,1145,-20
99649493391,99649493394,3,1487,1539,-20
99654129299,99654129304,5,2223,1741,-20
99655104738,99655104738,0,719,1777,-20
99657007305,99657007302,-3,1008,2360,-20
99657607130,99657607133,3,2015,1643,-20
99660903441,99660903444,3,2028,1644,-20
99661418163,99661418155,-8,2148,1421,-20
99662304738,99662304741,3,1141,1284,-20
99662975845,99662975849,4,1486,1299,-20
99666795326,99666795329,3,1099,1540,-20
99668744393,99668744397,4,1703,1690,-20
99672964726,99672964730,4,2872,1508,-20
99680000664,99680000667,3,1640,1174,-20
99683897285,99683897290,5,1468,1445,-20
99684681350,99684681355,5,2623,1521,-20
99687295959,99687295957,-2,3023,4271,-20
99691707753,99691707755,2,1936,1749,-20
99692030855,99692030845,-10,18258,16449,-20
99694025118,99694025123,5,2155,1298,-20
99699273859,99699273863,4,1379,1295,-20
99700735660,99700735663,3,2092,2384,-20
99706814463,99706814467,4,2217,1421,-20
99715141677,99715141679,2,1619,1483,-20
99715418008,99715418011,3,1413,1291,-20
99715734402,99715734406,4,1948,1887,-20
99716762237,99716762242,5,1783,1577,-20
99717768458,99717768461,3,1465,643,-20
99718752186,99718752189,3,1761,1497,-20
99719077452,99719077457,5,2155,1452,-20
99719646769,99719646771,2,1665,900,-20
99726178011,99726178014,3,2167,1404,-20
99727712349,99727712351,2,1992,1187,-20
99729113627,99729113630,3,2307,1914,-20
99732492818,99732492823,5,1817,1260,-20
99732867556,99732867553,-3,60742,48751,-20
99734848697,99734848677,-20,1363,815,-20
99738461273,99738461276,3,1860,1390,-20
99738640906,99738640908,2,1500,1287,-20
99738784269,99738784272,3,1732,1370,-20
99742318298,99742318305,7,7258,2793,-20
99743003795,99743003798,3,2173,2106,-20
99743141604,99743141607,3,1657,1371,-20
99743332484,99743332487,3,1372,1515,-20
99749619434,99749619432,-2,2579,3742,-20
99753652789,99753652793,4,1719,1135,-20
99758949881,99758949883,2,1577,1442,-20
99762063272,99762063277,5,2633,1342,-20
99762239321,99762239324,3,1728,1188,-20
99765747532,99765747534,2,1670,1643,-20
99766576827,99766576829,2,1914,1760,-20
99767943398,99767943402,4,969,929,-20
99772467536,99772467537,1,1105,1443,-20
99779204867,99779204871,4,2668,1887,-20
99779235781,99779235785,4,1877,1097,-20
99781263211,99781263214,3,994,855,-20
99785341647,99785341651,4,1143,709,-20
99788548773,99788548774,1,1723,951,-20
99788585276,99788585278,2,2050,1900,-20
99790082873,99790082877,4,2207,1929,-20
99801588673,99801588676,3,2176,1397,-20
99801630497,99801630499,2,2728,1795,-20
99803616707,99803616714,7,2874,1488,-20
99805898922,99805898926,4,2116,1371,-20
99806398545,99806398546,1,1970,1591,-20
99810087910,99810087912,2,1503,1156,-20
99817937721,99817937723,2,10781,10196,-20
99818279541,99818279543,2,2038,1548,-20
99820053832,99820053834,2,1403,940,-20
99820401614,99820401617,3,2389,1732,-20
99820817961,99820817948,-13,1388,598,-20
99823341216,99823341219,3,1466,1216,-20
99824284492,99824284494,2,1890,1167,-20
99828240694,99828240696,2,1782,1469,-20
99829122937,99829122941,4,1534,1207,-20
99830633549,99830633555,6,1429,1140,-20
99831553543,99831553546,3,2198,1571,-20
99832157361,99832157366,5,2421,1655,-20
99833953526,99833953530,4,2278,1578,-20
99836917296,99836917298,2,1475,1586,-20
99841395127,99841395130,3,1540,1227,-20
99842022017,99842022019,2,1569,1509,-20
99846167302,99846167306,4,1669,1218,-20
99847703337,99847703338,1,2060,1265,-20
99848730712,99848730718,6,1258,1216,-20
99850309314,99850309315,1,1850,1869,-20
99854725941,99854725946,5,2368,1232,-20
99859718837,99859718838,1,2131,1736,-20
99860069154,99860069158,4,1427,1232,-20
99861235701,99861235702,1,2043,1319,-20
99861509948,99861509950,2,1324,1022,-20
99867481470,99867481475,5,1267,1434,-20
99868944462,99868944467,5,2226,1578,-20
99869421103,99869421080,-23,839,767,-20
99869986816,99869986821,5,1940,1161,-20
99870146034,99870146035,1,1880,1353,-20
99871710365,99871710369,4,1714,1278,-20
99876025616,99876025616,0,1390,2014,-20
99882449091,99882449095,4,1968,1447,-20
99883756396,99883756398,2,1906,1481,-20
99886617727,99886617727,0,1720,2578,-20
99887365245,99887365249,4,2104,1873,-20
99887884484,99887884486,2,2470,1372,-20
99889207521,99889207523,2,1578,2011,-20
99893341923,99893341926,3,2177,1511,-20
99897211957,99897211962,5,1274,957,-20
99897959452,99897959468,16,993,5338,-20
99900343157,99900343162,5,2291,1292,-20
99902321186,99902321188,2,1903,1724,-20
99903049900,99903049904,4,2640,2072,-20
99907738195,99907738199,4,1489,1322,-20
99910832017,99910832019,2,1299,1117,-20
99911917647,99911917650,3,1722,1167,-20
99914015448,99914015451,3,1271,1760,-20
99915368573,99915368578,5,1457,1282,-20
99922222358,99922222362,4,1768,2392,-20
99926714999,99926714998,-1,1361,1535,-20
99928003120,99928003122,2,1388,872,-20
99928810774,99928810775,1,1753,2383,-20
99929585579,99929585579,0,793,1366,-20
99934331583,99934331586,3,2406,1770,-20
99937126904,99937126908,4,2103,1787,-20
99937591250,99937591232,-18,1398,1350,-20
99939431234,99939431239,5,2405,1001,-20
99941432555,99941432571,16,2143,1592,-20
99945963773,99945963777,4,2174,1318,-20
99947139939,99947139943,4,1781,1217,-20
99947617315,99947617315,0,1222,1023,-20
99950377957,99950377959,2,1616,1542,-20
99950924233,99950924236,3,1661,1331,-20
99954307235,99954307238,3,1619,1760,-20
99954684041,99954684040,-1,1631,921,-20
99956934269,99956934272,3,1896,1757,-20
99960298934,99960298930,-4,924,1458,-20
99964301537,99964301547,10,14394,27118,-20
99965401177,99965401185,8,2135,938,-20
99966748490,99966748475,-15,1661,1223,-20
99967329668,99967329671,3,1568,1434,-20
99968969574,99968969576,2,2011,1393,-20
99969209341,99969209360,19,1652,1181,-20
99971474830,99971474835,5,1809,1262,-20
99974168826,99974168830,4,2219,1657,-20
99974307710,99974307714,4,1772,1675,-20
99976793097,99976793098,1,1759,1064,-20
99977400481,99977400474,-7,863,1395,-20
99981104168,99981104171,3,2340,1506,-20
99981168449,99981168465,16,1729,1310,-20
99981720949,99981720968,19,1352,1248,-20
99984628633,99984628630,-3,1144,4477,-20
99991741808,99991741809,1,1811,1325,-20
99993006925,99993006926,1,1555,939,-20
99997983874,99997983878,4,2298,1332,-20
99999153907,99999153909,2,1370,1308,-20
99999477306,99999477310,4,1299,818,-20
100000646890,100000646892,2,2036,1706,-20
100001344130,100001344116,-14,2297,1210,-20
100004065908,100004065927,19,792,1900,-20
100005109583,100005109581,-2,1079,2494,-20
100005792175,100005792179,4,2049,1491,-20
100007695848,100007695850,2,1648,1241,-20
100009823184,100009823187,3,1880,1749,-20
100009849028,100009849030,2,1597,1022,-20
100010234349,100010234355,6,1804,1423,-20
100011204786,100011204790,4,1568,1128,-20
100013663760,100013663763,3,970,1464,-20
100014087518,100014087521,3,1634,1233,-20
100014726416,100014726429,13,338,1222,-20
100017873358,100017873363,5,2630,1814,-20
100021842186,100021842189,3,1982,1522,-20
100022400519,100022400496,-23,1266,513,-20
100023137474,100023137477,3,1988,1780,-20
100025906478,100025906481,3,1658,927,-20
100027503886,100027503882,-4,1321,2374,-20
100029118002,100029118002,0,1046,1568,-20
100035525405,100035525408,3,1259,630,-20
100038823142,100038823147,5,1503,1013,-20
100040614589,100040614590,1,1492,1527,-20
100046519833,100046519837,4,1487,1378,-20
100050829098,100050829101,3,1692,1504,-20
100057581148,100057581140,-8,42175,14682,-20
100058182157,100058182159,2,1657,1304,-20
100062715806,100062715809,3,1863,1428,-20
100066099618,100066099623,5,1674,1286,-20
100066951326,100066951305,-21,1746,918,-20
100067486838,100067486840,2,1297,1505,-20
100070430973,100070430975,2,2307,1553,-20
100072838503,100072838510,7,1356,1108,-20
100073156762,100073156768,6,2535,1628,-20
100076551754,100076551755,1,1458,2068,-20
100077764158,100077764161,3,1349,1286,-20
100083441930,100083441935,5,1282,623,-20
100084202443,100084202446,3,1893,1419,-20
100088366682,100088366687,5,1058,778,-20
100091573146,100091573149,3,1837,1355,-20
100095161194,100095161199,5,722,893,-20
100097801431,100097801435,4,1300,1332,-20
100100105453,100100105456,3,2073,1732,-20
100108645413,100108645414,1,2067,1637,-20
100112294386,100112294391,5,2646,1410,-20
100117154246,100117154249,3,2367,1650,-20
100117339896,100117339900,4,2101,1615,-20
100120458142,100120458143,1,1713,1312,-20
100120589257,100120589258,1,1874,1487,-20
100121642137,100121642141,4,1437,1423,-20
100121675732,100121675714,-18,1513,1094,-20
100123115027,100123115029,2,1777,1381,-20
100123881261,100123881244,-17,186,5763,-20
100124847822,100124847825,3,1744,1564,-20
100129901586,100129901586,0,1914,2372,-20
100130059375,100130059379,4,1342,882,-20
100131367530,100131367534,4,1716,1409,-20
100132441422,100132441426,4,1598,1223,-20
100133840126,100133840131,5,2829,1085,-20
100135418974,100135418978,4,1777,1195,-20
100137433930,100137433933,3,1778,1628,-20
100139301209,100139301212,3,1492,1587,-20
100140870736,100140870741,5,942,1324,-20
100141738847,100141738851,4,1855,1422,-20
100141819123,100141819125,2,946,1511,-20
100142131490,100142131495,5,1426,1037,-20
100144621582,100144621579,-3,1433,2982,-20
100146567894,100146567896,2,2425,1616,-20
100148568754,100148568759,5,2294,1792,-20
100149507009,100149507006,-3,1381,2364,-20
100153057448,100153057451,3,1725,1092,-20
100156875222,100156875227,5,2598,1668,-20
100160206399,100160206402,3,2314,1647,-20
100163918749,100163918750,1,1512,1494,-20
100165423576,100165423578,2,1760,1298,-20
100166111603,100166111606,3,1806,1261,-20
100166220314,100166220317,3,2386,1800,-20
100168745545,100168745550,5,2043,1334,-20
100169710532,100169710534,2,1434,1534,-20
100173832229,100173832234,5,2345,1525,-20
100174110761,100174110763,2,1307,1342,-20
100175667942,100175667947,5,2125,1282,-20
100179670769,100179670759,-10,31074,16495,-20
100180411514,100180411518,4,1696,1455,-20
100181171332,100181171335,3,2081,1521,-20
100181467465,100181467470,5,2063,1262,-20
100182837270,100182837274,4,2895,1807,-20
100184127549,100184127552,3,1475,1393,-20
100187834275,100187834278,3,1491,1486,-20
100192735081,100192735083,2,1196,1369,-20
100192763763,100192763763,0,1653,1329,-20
100193632910,100193632913,3,1481,1320,-20
100197233285,100197233289,4,2011,1641,-20
100198224756,100198224758,2,1394,1123,-20
100198298663,100198298669,6,2973,1771,-20
100200456303,100200456308,5,2240,1416,-20
100201046863,100201046866,3,2269,1304,-20
100202230661,100202230663,2,2613,1318,-20
100204611603,100204611607,4,2005,1727,-20
100206673941,100206673944,3,1547,1125,-20
100207925956,100207925959,3,1730,1419,-20
100209541340,100209541342,2,2377,1365,-20
100209571941,100209571941,0,947,1734,-20
100215950246,100215950250,4,2077,1252,-20
100217294118,100217294119,1,1174,1409,-20
100217783466,100217783469,3,1733,1378,-20
100219971710,100219971713,3,1770,1425,-20
100222710698,100222710703,5,2180,1261,-20
100225042215,100225042221,6,2316,1884,-20
100229284693,100229284697,4,1510,1450,-20
100235290887,100235290890,3,1786,1163,-20
100237011206,100237011208,2,1640,1052,-20
100241913994,100241913999,5,2190,1804,-20
100244457984,100244457985,1,1502,1301,-20
100245231277,100245231280,3,1030,1389,-20
100253636354,100253636358,4,1947,1800,-20
100253674042,100253674047,5,1696,1185,-20
100257483470,100257483474,4,3193,1663,-20
100259964761,100259964762,1,1722,1612,-20
100260145801,100260145802,1,1517,1792,-20
100263793818,100263793818,0,1799,1453,-20
100267587574,100267587577,3,1231,1569,-20
100272257288,100272257291,3,1621,506,-20
100274042874,100274042875,1,1297,997,-20
100274733707,100274733707,0,1497,1308,-20
100278529972,100278529977,5,2138,1492,-20
100280122046,100280122050,4,2094,2028,-20
100282049174,100282049178,4,25673,42186,-20
100284234574,100284234579,5,2087,1139,-20
100284933717,100284933721,4,1442,1133,-20
100291102367,100291102370,3,2322,1551,-20
100291244494,100291244473,-21,1268,1336,-20
100293435593,100293435597,4,1757,1845,-20
100294926810,100294926813,3,2456,1720,-20
100300719509,100300719505,-4,19429,15135,-20
100305249433,100305249438,5,1925,1108,-20
100305437365,100305437376,11,1962,954,-20
100308639847,100308639841,-6,2198,9188,-20
100311107024,100311107008,-16,2053,1553,-20
100311419483,100311419487,4,1687,1651,-20
100312779834,100312779836,2,1989,1090,-20
100317381977,100317381981,4,1469,1411,-20
100318197254,100318197258,4,1882,1253,-20
100318991525,100318991526,1,1013,1940,-20
100319988182,100319988183,1,2029,1452,-20
100320574217,100320574219,2,1849,795,-20
100325899647,100325899652,5,2583,1581,-20
100328506882,100328506886,4,2175,1695,-20
100329196753,100329196755,2,2196,1887,-20
100331833355,100331833359,4,1787,919,-20
100333065080,100333065083,3,2010,1536,-20
100333806177,100333806157,-20,1734,1573,-20
100334364985,100334364969,-16,1562,947,-20
100334639901,100334639907,6,4675,22387,-20
100336025602,100336025603,1,1847,1286,-20
100339641640,100339641640,0,1372,1591,-20
100351090290,100351090294,4,1941,1411,-20
100351532074,100351532077,3,1014,755,-20
100353701649,100353701657,8,1508,1067,-20
100355957478,100355957480,2,1685,1229,-20
100356434642,100356434627,-15,1819,1486,-20
100358743544,100358743547,3,1383,1502,-20
100361556422,100361556429,7,2378,1134,-20
100364342572,100364342575,3,2209,1732,-20
100369486322,100369486325,3,2273,1490,-20
100372582602,100372582605,3,1700,1896,-20
100372967659,100372967662,3,1443,1104,-20
100373234707,100373234707,0,435,146,-20
100373978173,100373978178,5,2056,1109,-20
100380744164,100380744166,2,1815,1647,-20
100380943300,100380943303,3,1959,1288,-20
100387760153,100387760157,4,4447,2704,-20
100387801579,100387801585,6,2161,1497,-20
100394506722,100394506726,4,1890,1368,-20
100395834398,100395834399,1,1333,1881,-20
100397842514,100397842514,0,1333,1558,-20
100400552029,100400552033,4,1690,1309,-20
100400861315,100400861322,7,1588,1440,-20
100402331222,100402331201,-21,2581,1120,-20
100402479646,100402479659,13,1887,1322,-20
100403857343,100403857336,-7,812,3890,-20
100413551018,100413551023,5,1628,1702,-20
100413632925,100413632929,4,1476,1267,-20
100416780290,100416780293,3,2775,1460,-20
100416861735,100416861738,3,2174,1590,-20
100417870347,100417870350,3,1622,1008,-20
100418778543,100418778526,-17,1682,1023,-20
100421387901,100421387904,3,1087,1184,-20
100421774553,100421774555,2,1869,1678,-20
100422076554,100422076557,3,1472,938,-20
100424988887,100424988889,2,1257,1788,-20
100425034153,100425034156,3,1763,1804,-20
100426722147,100426722151,4,1443,1056,-20
100428701269,100428701271,2,1854,1783,-20
100429109531,100429109530,-1,429,718,-20
100432351018,100432351020,2,2524,1811,-20
100433176347,100433176355,8,894,948,-20
100435338751,100435338754,3,1232,1010,-20
100437839787,100437839790,3,2305,1880,-20
100445113071,100445113077,6,2524,1839,-20
100445349046,100445349049,3,1829,2068,-20
100448240954,100448240951,-3,1333,2131,-20
100449009438,100449009442,4,1641,1690,-20
100450151362,100450151366,4,2600,1610,-20
100450458473,100450458474,1,1512,986,-20
100450619583,100450619562,-21,1117,1524,-20
100451182878,100451182883,5,1709,1473,-20
100454234919,100454234923,4,1129,1020,-20
100458059103,100458059106,3,1192,982,-20
100458232521,100458232522,1,2328,1750,-20
100458797513,100458797515,2,1856,1210,-20
100463829790,100463829795,5,1005,863,-20
100465096967,100465096969,2,1873,1307,-20
100466559274,100466559277,3,1897,1570,-20
100467168359,100467168362,3,2560,1560,-20
100469669328,100469669331,3,1824,1862,-20
100480116500,100480116501,1,1585,1408,-20
100485040183,100485040186,3,2105,949,-20
100490803396,100490803399,3,1603,1332,-20
100491528572,100491528578,6,1517,1251,-20
100492367163,100492367167,4,1614,1326,-20
100492510686,100492510687,1,1988,1679,-20
100494350966,100494350969,3,22343,116035,-20
100495272273,100495272266,-7,1011,3377,-20
100496720181,100496720185,4,2845,1452,-20
100498908386,100498908386,0,2148,1691,-20
100500540869,100500540872,3,2284,1621,-20
100500872367,100500872370,3,1523,1629,-20
100506061685,100506061686,1,1267,1025,-20
100506642401,100506642384,-17,2476,1396,-20
100506906569,100506906566,-3,1979,4923,-20
100507427723,100507427726,3,2108,1168,-20
100512897594,100512897595,1,29514,36486,-20
100513125023,100513125027,4,1893,1730,-20
100513363954,100513363958,4,1104,983,-20
100514745534,100514745537,3,1728,1475,-20
100515692346,100515692351,5,1394,1362,-20
100517906801,100517906805,4,1732,1407,-20
100518384288,100518384290,2,1438,768,-20
100520789242,100520789247,5,1758,1246,-20
100521767825,100521767830,5,2127,1306,-20
100524836919,100524836923,4,2050,1259,-20
100525029441,100525029425,-16,2281,1292,-20
100526091899,100526091902,3,1063,1609,-20
100528015126,100528015131,5,1367,810,-20
100528762486,100528762464,-22,1885,1596,-20
100530881670,100530881673,3,1468,1416,-20
100531653113,100531653107,-6,1356,3605,-20
100532249247,100532249250,3,1126,1304,-20
100533156775,100533156777,2,1200,1307,-20
100536490961,100536490965,4,1841,1463,-20
100537261616,100537261619,3,2246,1294,-20
100538756531,100538756535,4,2458,1219,-20
100538807366,100538807365,-1,5670,10355,-20
100538962800,100538962802,2,1749,1371,-20
100540652843,100540652846,3,1765,1876,-20
100541313197,100541313199,2,1264,1516,-20
100542340776,100542340772,-4,1540,3901,-20
100544086426,100544086429,3,1806,1546,-20
100547695767,100547695770,3,755,892,-20
100549886486,100549886489,3,2030,1220,-20
100552551833,100552551834,1,1850,1522,-20
100555586230,100555586234,4,2072,1834,-20
100558417254,100558417259,5,1354,978,-20
100563512077,100563512079,2,995,999,-20
100563786691,100563786685,-6,3726,9800,-20
100566437555,100566437548,-7,777,4292,-20
100567640054,100567640059,5,2689,1663,-20
100568143232,100568143230,-2,1297,1627,-20
100571126118,100571126123,5,1460,1145,-20
100571367905,100571367909,4,1201,724,-20
100573008906,100573008910,4,2438,1651,-20
100574415961,100574415963,2,1937,1352,-20
100577218970,100577218974,4,1449,1213,-20
100577644773,100577644754,-19,1251,1105,-20
100578251989,100578251991,2,1780,1544,-20
100581102093,100581102094,1,1131,1659,-20
100581589694,100581589696,2,1860,1794,-20
100583304857,100583304861,4,1614,1515,-20
100584321092,100584321094,2,1644,1634,-20
100586018607,100586018610,3,1685,1417,-20
100588942381,100588942383,2,1458,1296,-20
100589488409,100589488411,2,6567,17474,-20
100593087877,100593087879,2,1754,1207,-20
100593553898,100593553899,1,1740,968,-20
100605429141,100605429146,5,2944,2063,-20
100610144779,100610144782,3,2271,972,-20
100611166454,100611166455,1,1451,1285,-20
100619176482,100619176486,4,2111,1348,-20
100619252033,100619252035,2,1821,1496,-20
100619795395,100619795392,-3,1043,2897,-20
100624428765,100624428769,4,1625,1799,-20
100626733587,100626733589,2,1878,1192,-20
100632076615,100632076614,-1,1073,2004,-20
100635350945,100635350942,-3,571,2030,-20
100638759515,100638759515,0,1336,821,-20
100640472394,100640472391,-3,1569,2177,-20
100640699875,100640699881,6,1893,1344,-20
100642366060,100642366064,4,1892,1380,-20
100647034389,100647034395,6,3032,1750,-20
100658814185,100658814187,2,1803,1240,-20
100664071117,100664071110,-7,1090,4141,-20
100667230180,100667230181,1,67,1626,-20
100667425012,100667425014,2,1438,1662,-20
100668007519,100668007522,3,1471,1194,-20
100671792884,100671792886,2,1133,961,-20
100676022530,100676022534,4,1614,1171,-20
100676569694,100676569693,-1,1280,1706,-20
100687902042,100687902045,3,1221,1112,-20
100689510243,100689510247,4,1305,744,-20
100689970173,100689970152,-21,3397,1327,-20
100693496981,100693496984,3,2149,2016,-20
100693792960,100693792957,-3,31421,14527,-20
100695505511,100695505514,3,1945,1261,-20
100697419907,100697419911,4,2046,1389,-20
100698423302,100698423308,6,2250,1968,-20
100698504997,100698504979,-18,1635,1490,-20
100709394117,100709394113,-4,1244,2724,-20
100712354382,100712354383,1,2065,1901,-20
100712420429,100712420434,5,2089,1072,-20
100713285578,100713285582,4,1833,1321,-20
100715197676,100715197680,4,1496,1286,-20
100715906431,100715906437,6,2138,1845,-20
100718204408,100718204411,3,1418,1403,-20
100719116918,100719116922,4,1485,1320,-20
100720188325,100720188327,2,1673,1871,-20
100722033842,100722033846,4,1927,1276,-20
100722145544,100722145546,2,2504,1656,-20
100725412794,100725412798,4,2311,1591,-20
100726561571,100726561568,-3,2245,4700,-20
100728001550,100728001557,7,2104,1677,-20
100728658426,100728658408,-18,1586,1133,-20
100729403409,100729403413,4,1707,947,-20
100729799986,100729799987,1,1046,1169,-20
100730680105,100730680090,-15,2463,1845,-20
100731480093,100731480094,1,1734,1324,-20
100738506833,100738506839,6,2140,1000,-20
100739325458,100739325462,4,1233,1036,-20
100739814098,100739814103,5,2215,1713,-20
100742549254,100742549257,3,1815,1382,-20
100749369677,100749369680,3,1557,1007,-20
100750585862,100750585866,4,1411,1153,-20
100752325494,100752325496,2,927,1369,-20
100757843861,100757843863,2,1450,1119,-20
100758540415,100758540410,-5,761,5792,-20
100759670834,100759670836,2,1712,1430,-20
100761559252,100761559255,3,2228,1006,-20
100762693358,100762693360,2,1688,1637,-20
100765264186,100765264192,6,11230,35815,-20
100765910120,100765910126,6,2560,1077,-20
100766381583,100766381586,3,1868,1561,-20
100767301787,100767301770,-17,1131,359,-20
100769621157,100769621159,2,1239,1502,-20
100772071249,100772071254,5,3282,1398,-20
100773906900,100773906903,3,1635,1404,-20
100775797638,100775797641,3,1818,1304,-20
100778796326,100778796327,1,1892,1066,-20
100783219794,100783219799,5,1235,1125,-20
100784181212,100784181215,3,1314,1392,-20
100785105847,100785105850,3,1952,1452,-20
100787905342,100787905345,3,1628,1316,-20
100801171529,100801171533,4,1474,1317,-20
100804241715,100804241714,-1,1459,1181,-20
100805789211,100805789215,4,1184,1264,-20
100805844275,100805844278,3,1793,1079,-20
100808078044,100808078046,2,1356,1095,-20
100808861876,100808861877,1,2178,1663,-20
100809514659,100809514663,4,1978,1426,-20
100809798433,100809798436,3,1522,1017,-20
100810035931,100810035913,-18,1225,59,-20
100810231842,100810231845,3,2636,2023,-20
100813778697,100813778698,1,1820,1460,-20
100819513702,100819513705,3,2689,1832,-20
100826005311,100826005311,0,727,1236,-20
100834693838,100834693850,12,1464,1636,-20
100838035285,100838035290,5,1957,1454,-20
100840226108,100840226111,3,2802,1688,-20
100843747470,100843747473,3,1770,1586,-20
100843817015,100843817019,4,2710,1916,-20
100844645723,100844645725,2,1910,1560,-20
100847042006,100847042008,2,1313,1532,-20
100847272569,100847272570,1,1600,1373,-20
100848974501,100848974504,3,1520,1143,-20
100850687387,100850687389,2,1449,1056,-20
100854054082,100854054083,1,1505,990,-20
100866379575,100866379578,3,1619,1014,-20
100867576470,100867576474,4,1691,1333,-20
100869007135,100869007138,3,1585,1169,-20
100871852374,100871852379,5,1562,1033,-20
100872831962,100872831967,5,1588,913,-20
100873685338,100873685342,4,1848,1512,-20
100875788530,100875788532,2,1349,1514,-20
100877474626,100877474629,3,1156,1028,-20
100877905756,100877905759,3,2324,1408,-20
100878249561,100878249566,5,6440,30787,-20
100881642239,100881642237,-2,1362,2127,-20
100881735673,100881735678,5,2030,1288,-20
100882640637,100882640641,4,1600,1778,-20
100885182967,100885182966,-1,1265,1591,-20
100888435178,100888435182,4,1531,1279,-20
100892620709,100892620715,6,1309,1117,-20
100894164674,100894164679,5,1718,1462,-20
100899210599,100899210603,4,1885,1383,-20
100904547463,100904547465,2,1963,1495,-20
100906074786,100906074781,-5,1904,5328,-20
100907443011,100907443018,7,1807,1348,-20
100908288195,100908288199,4,2118,1168,-20
100909209339,100909209347,8,1401,955,-20
100909443718,100909443723,5,1586,1358,-20
100913750737,100913750738,1,2539,1762,-20
100914002186,100914002188,2,2099,1605,-20
100915286475,100915286478,3,1849,1268,-20
100919283549,100919283552,3,1422,1330,-20
100919396048,100919396043,-5,919,327,-20
100919578151,100919578154,3,2410,1504,-20
100921934289,100921934294,5,1603,1164,-20
100923888313,100923888317,4,1991,1179,-20
100925797343,100925797345,2,1785,1569,-20
100927063229,100927063232,3,1817,1367,-20
100927794365,100927794370,5,2511,2205,-20
100928747853,100928747857,4,2448,1417,-20
100929407466,100929407470,4,2373,1803,-20
100929564127,100929564129,2,1745,1386,-20
100931188535,100931188538,3,1626,1434,-20
100934142018,100934142016,-2,1191,2473,-20
100940261281,100940261286,5,2325,1335,-20
100941022482,100941022479,-3,944,2892,-20
100941434881,100941434882,1,1663,1630,-20
100944786531,100944786535,4,1263,1081,-20
100945328409,100945328411,2,2134,1414,-20
100947965406,100947965410,4,2367,1852,-20
100950977357,100950977362,5,1833,1536,-20
100957008152,100957008157,5,2180,1567,-20
100957220782,100957220785,3,2057,1748,-20
100957538433,100957538435,2,2345,2348,-20
100968535227,100968535231,4,1520,1164,-20
100970589025,100970589028,3,1856,1860,-20
100971526405,100971526407,2,2184,1375,-20
100975841994,100975841998,4,1954,1742,-20
100975978721,100975978724,3,1927,1842,-20
100979273183,100979273184,1,1746,1430,-20
100984077709,100984077713,4,1855,1465,-20
100984188039,100984188042,3,1699,1615,-20
100989023173,100989023177,4,1802,1284,-20
100994603774,100994603778,4,2638,1614,-20
100995101138,100995101143,5,1563,995,-20
100995837970,100995837974,4,1809,1287,-20
101001435875,101001435876,1,2149,2111,-20
101003819890,101003819894,4,4651,2506,-20
101004683632,101004683632,0,1576,1422,-20
101009480608,101009480611,3,1698,1481,-20
101009988278,101009988286,8,934,856,-20
101011886191,101011886194,3,1990,948,-20
101014039071,101014039074,3,2359,1530,-20
101020838771,101020838774,3,1437,1252,-20
101023270161,101023270156,-5,1663,4556,-20
101023651581,101023651583,2,1764,1511,-20
101034843035,101034843038,3,1988,1320,-20
101035133478,101035133481,3,1192,1311,-20
101035608380,101035608383,3,1355,1187,-20
101036151854,101036151856,2,1648,1170,-20
101037457414,101037457417,3,2026,1868,-20
101039158941,101039158943,2,2321,1237,-20
101039264626,101039264612,-14,2316,1529,-20
101039780879,101039780882,3,1432,1460,-20
101041797962,101041797962,0,1097,766,-20
101044938463,101044938465,2,2239,2121,-20
101046339338,101046339343,5,15401,7576,-20
101047002171,101047002169,-2,2621,4516,-20
101051445764,101051445766,2,1288,1116,-20
101052370162,101052370166,4,1487,1006,-20
101055552420,101055552423,3,1663,1481,-20
101062309287,101062309291,4,1079,1247,-20
101065281753,101065281756,3,1737,1998,-20
101067315773,101067315775,2,1768,1513,-20
101067496700,101067496704,4,1434,1199,-20
101068685130,101068685135,5,1733,1514,-20
101071051695,101071051698,3,1475,962,-20
101071099930,101071099916,-14,2152,1513,-20
101071465323,101071465326,3,1516,1040,-20
101073728250,101073728252,2,1618,1207,-20
101074613009,101074613016,7,4291,1793,-20
101075254775,101075254780,5,1978,1385,-20
101075905277,101075905281,4,1360,1199,-20
101082286806,101082286809,3,1898,1799,-20
101083581305,101083581306,1,1487,1466,-20
101091168517,101091168521,4,2748,1854,-20
101091871298,101091871303,5,2055,1413,-20
101094747003,101094747007,4,1711,1204,-20
101094851875,101094851857,-18,1867,1087,-20
101097924426,101097924426,0,2589,1304,-20
101098074466,101098074471,5,1618,1135,-20
101103600002,101103600002,0,2357,1796,-20
101105190517,101105190521,4,2393,1319,-20
101111829487,101111829490,3,1621,1304,-20
101113527134,101113527135,1,2022,2101,-20
101113738858,101113738861,3,2444,1649,-20
101116238662,101116238665,3,2140,1286,-20
101118675398,101118675400,2,1385,1531,-20
101121212657,101121212666,9,15811,19716,-20
101127991893,101127991894,1,2049,2380,-20
101128056742,101128056746,4,1814,1621,-20
101129556908,101129556910,2,2104,1346,-20
101130318753,101130318755,2,1769,1594,-20
101131502472,101131502477,5,1771,1342,-20
101132096634,101132096646,12,10399,51623,-20
101132152046,101132152056,10,1632,1237,-20
101135816426,101135816426,0,2016,1610,-20
101138381363,101138381366,3,2441,1585,-20
101141155855,101141155859,4,1730,1283,-20
101143113744,101143113747,3,2286,1675,-20
101144112854,101144112857,3,1545,1648,-20
101144408294,101144408273,-21,2423,1544,-20
101146126655,101146126658,3,2079,1894,-20
101148222297,101148222300,3,1882,1081,-20
101149540772,101149540774,2,1825,1771,-20
101161689072,101161689077,5,1938,1585,-20
101171263478,101171263481,3,2242,1515,-20
101171641380,101171641382,2,2157,1372,-20
101172810338,101172810343,5,1298,1024,-20
101174154809,101174154814,5,1465,826,-20
101178077781,101178077774,-7,1194,1608,-20
101184217588,101184217595,7,2095,1184,-20
101186152998,101186153001,3,1826,1135,-20
101186496090,101186496091,1,1592,1008,-20
101188361973,101188361975,2,2338,1171,-20
101190082946,101190082950,4,1930,1180,-20
101190666466,101190666470,4,1616,1369,-20
101191367331,101191367338,7,1736,1224,-20
101194086922,101194086925,3,1539,1358,-20
101195718722,101195718724,2,1289,1213,-20
101199364238,101199364243,5,2606,1012,-20
101199912134,101199912137,3,1854,1151,-20
101200606341,101200606344,3,1758,1406,-20
101200692046,101200692049,3,2268,1579,-20
101205529506,101205529510,4,2130,1701,-20
101209298501,101209298503,2,1736,1058,-20
101210983546,101210983547,1,1933,1624,-20
101216691846,101216691852,6,2547,1808,-20
101219259284,101219259286,2,1415,1328,-20
101219741213,101219741218,5,1823,1243,-20
101223046912,101223046916,4,775,635,-20
101224713172,101224713182,10,17473,47534,-20
101225136405,101225136409,4,2096,1013,-20
101225365874,101225365873,-1,914,235,-20
101225673392,101225673395,3,2137,1172,-20
101232264022,101232264025,3,1596,1323,-20
101234193599,101234193602,3,1312,1717,-20
101239470100,101239470103,3,1561,856,-20
101239711446,101239711450,4,1708,1339,-20
101239826907,101239826915,8,1070,671,-20
101242316863,101242316867,4,1688,1391,-20
101242518149,101242518150,1,1387,1089,-20
101245417034,101245417039,5,2078,999,-20
101247680082,101247680085,3,2333,2016,-20
101248289026,101248289033,7,2174,1091,-20
101249589430,101249589436,6,2363,1533,-20
101252428494,101252428488,-6,968,4091,-20
101256037950,101256037954,4,3051,1232,-20
101256384684,101256384688,4,1389,1132,-20
101257947422,101257947426,4,1854,1442,-20
101260028479,101260028483,4,2025,1576,-20
101260973686,101260973689,3,1659,1486,-20
101265180714,101265180718,4,2877,1622,-20
101266062553,101266062555,2,2563,1641,-20
101266300430,101266300431,1,1958,1501,-20
101267249206,101267249210,4,2215,1026,-20
101268561310,101268561314,4,2089,1326,-20
101271460114,101271460116,2,2161,2865,-20
101272416763,101272416766,3,2404,1764,-20
101272458124,101272458126,2,1826,2074,-20
101272675907,101272675910,3,1218,964,-20
101274347698,101274347682,-16,1009,632,-20
101280430854,101280430857,3,1451,1090,-20
101289731881,101289731902,21,2648,1358,-20
101290289528,101290289537,9,1794,1620,-20
101290434178,101290434185,7,1607,1676,-20
101292496675,101292496679,4,2012,1587,-20
101294910319,101294910326,7,2414,975,-20
101296482629,101296482630,1,1761,1617,-20
101303463618,101303463624,6,1185,1070,-20
101304127370,101304127374,4,1630,1102,-20
101307373580,101307373582,2,2018,1602,-20
101309367785,101309367783,-2,1485,2318,-20
101309477155,101309477156,1,2889,3631,-20
101312128674,101312128676,2,1541,1633,-20
101322195030,101322195034,4,3167,1699,-20
101325387512,101325387514,2,1406,1451,-20
101327482862,101327482864,2,1880,1487,-20
101327788710,101327788712,2,2414,1533,-20
101329535207,101329535209,2,2457,1764,-20
101329735113,101329735110,-3,1919,5146,-20
101330400291,101330400295,4,1962,1359,-20
101333397825,101333397818,-7,1968,7589,-20
101334003750,101334003754,4,2048,1111,-20
101334731086,101334731088,2,1666,1791,-20
101337979857,101337979860,3,1890,1492,-20
101338984006,101338984010,4,1231,1408,-20
101340077262,101340077265,3,1985,1920,-20
101342735018,101342735022,4,1523,1275,-20
101344112778,101344112781,3,2053,1491,-20
101344877039,101344877042,3,1917,1582,-20
101350052901,101350052903,2,1517,1130,-20
101354076160,101354076165,5,1942,1290,-20
101362708782,101362708785,3,1821,1400,-20
101363803920,101363803924,4,1412,2040,-20
101368767854,101368767858,4,1443,1437,-20
101369400917,101369400920,3,1605,1558,-20
101375820695,101375820677,-18,39332,16174,-20
101377284801,101377284806,5,1593,1192,-20
101378754523,101378754527,4,2041,1142,-20
101379834390,101379834391,1,1229,971,-20
101380245502,101380245483,-19,1376,1384,-20
101382294409,101382294413,4,2194,1537,-20
101383847548,101383847546,-2,1560,1377,-20
101386390448,101386390451,3,1696,1285,-20
101389447700,101389447706,6,2210,1529,-20
101389692459,101389692465,6,2025,1474,-20
101394016066,101394016068,2,1747,1366,-20
101395685394,101395685394,0,1395,1969,-20
101400607291,101400607294,3,1771,1192,-20
101401958661,101401958666,5,1294,1174,-20
101402017627,101402017634,7,1428,1772,-20
101402107798,101402107802,4,2745,1645,-20
101404700074,101404700071,-3,3345,5592,-20
101409157618,101409157623,5,2254,1199,-20
101417092627,101417092633,6,1470,698,-20
101423805095,101423805087,-8,1170,7248,-20
101424480154,101424480158,4,1927,1558,-20
101426290145,101426290149,4,2074,1550,-20
101426592828,101426592832,4,1956,2035,-20
101428417402,101428417406,4,1959,1410,-20
101429309889,101429309892,3,914,1054,-20
101432235360,101432235342,-18,2017,830,-20
101433080241,101433080245,4,1730,1081,-20
101434835385,101434835389,4,2234,2236,-20
101435547031,101435547034,3,2333,1412,-20
101440943147,101440943151,4,1090,1142,-20
101441354430,101441354426,-4,1264,3229,-20
101444278505,101444278509,4,1826,1162,-20
101446510714,101446510719,5,953,1118,-20
101448222614,101448222615,1,1665,1196,-20
101454887050,101454887052,2,1848,1496,-20
101455960999,101455961002,3,1220,880,-20
101459584972,101459584971,-1,1748,2320,-20
101461086994,101461086994,0,1044,1326,-20
101463521949,101463521957,8,12283,25414,-20
101464299326,101464299329,3,847,1002,-20
101464338456,101464338474,18,2330,1724,-20
101464437349,101464437353,4,1912,1671,-20
101464601750,101464601751,1,1983,1480,-20
101467349731,101467349734,3,2019,1356,-20
101472552276,101472552280,4,1345,933,-20
101473268244,101473268246,2,1515,1225,-20
101474605871,101474605873,2,1467,2427,-20
101476227901,101476227902,1,1812,1654,-20
101481344258,101481344262,4,1629,995,-20
101484588374,101484588373,-1,3554,4117,-20
101487431280,101487431282,2,1386,1475,-20
101489361730,101489361733,3,1913,1847,-20
101494790777,101494790781,4,1379,1235,-20
101495648441,101495648444,3,2095,1314,-20
101498755734,101498755737,3,2785,1735,-20
101498787061,101498787065,4,1860,1192,-20
101507432263,101507432266,3,1003,899,-20
101509616739,101509616747,8,6044,1728,-20
101512040845,101512040849,4,2160,1167,-20
101512105827,101512105830,3,885,1105,-20
101512509182,101512509185,3,1532,1523,-20
101514568033,101514568031,-2,1145,1698,-20
101515659417,101515659419,2,1426,1371,-20
101516160178,101516160180,2,2076,1465,-20
101517641125,101517641130,5,2823,2027,-20
101520554878,101520554883,5,1697,1147,-20
101521494373,101521494378,5,1923,1293,-20
101522744943,101522744948,5,1093,1088,-20
101523362102,101523362106,4,2358,1482,-20
101524335550,101524335554,4,928,996,-20
101524370286,101524370289,3,1419,1450,-20
101525366050,101525366053,3,1437,1398,-20
101527091701,101527091705,4,1785,1432,-20
101528207707,101528207711,4,1196,1036,-20
101528711428,101528711427,-1,919,1348,-20
101532629659,101532629666,7,3132,1510,-20
101535027581,101535027586,5,2324,1447,-20
101535195998,101535196001,3,1641,1482,-20
101535812690,101535812694,4,1912,1654,-20
101537356122,101537356126,4,1910,1528,-20
101538695623,101538695627,4,929,882,-20
101540360205,101540360207,2,1399,654,-20
101542390813,101542390814,1,1119,1459,-20
101542845066,101542845069,3,1302,818,-20
101544641841,101544641843,2,2217,2010,-20
101545418306,101545418310,4,1439,1645,-20
101548346519,101548346522,3,1663,1587,-20
101548846455,101548846459,4,1699,1301,-20
101551818659,101551818660,1,1439,1716,-20
101554238478,101554238479,1,1193,1491,-20
101564691423,101564691426,3,1845,1089,-20
101568797797,101568797803,6,1238,720,-20
101569008988,101569009000,12,872,806,-20
101569283318,101569283320,2,1700,1148,-20
101569809093,101569809097,4,1327,817,-20
101572434204,101572434206,2,1621,2484,-20
101573200598,101573200602,4,2042,1418,-20
101575193869,101575193874,5,1503,1216,-20
101575361071,101575361075,4,1754,1476,-20
101580274398,101580274399,1,1880,1135,-20
101583873002,101583873005,3,1560,1355,-20
101585101158,101585101164,6,4849,1839,-20
101588088758,101588088762,4,1799,1337,-20
101595455427,101595455430,3,1525,1491,-20
101599596669,101599596670,1,1221,1152,-20
101603630818,101603630821,3,2147,1364,-20
101606078166,101606078170,4,1885,1959,-20
101609534043,101609534046,3,1737,1296,-20
101610270919,101610270921,2,1612,2099,-20
101610883606,101610883608,2,1805,1886,-20
101611409039,101611409046,7,1956,1243,-20
101611664415,101611664425,10,1030,1480,-20
101613194758,101613194762,4,1415,1349,-20
101616567992,101616567995,3,1575,1190,-20
101619522013,101619522017,4,2229,1951,-20
101620141522,101620141526,4,2330,1681,-20
101621445345,101621445351,6,2145,1472,-20
101624494298,101624494303,5,1566,1207,-20
101625238501,101625238513,12,1426,1300,-20
101629053541,101629053542,1,1565,1202,-20
101633568064,101633568066,2,1456,1481,-20
101635925209,101635925214,5,1815,1432,-20
101637992903,101637992906,3,1592,1042,-20
101639255700,101639255702,2,1312,1227,-20
101640998170,101640998176,6,4180,1612,-20
101641414954,101641414957,3,1895,1356,-20
101644541915,101644541918,3,2433,1468,-20
101645664638,101645664634,-4,24523,48304,-20
101646436078,101646436082,4,2142,1456,-20
101647256721,101647256726,5,1962,1447,-20
101648723614,101648723618,4,1239,1340,-20
101650519858,101650519863,5,1626,1103,-20
101653617545,101653617547,2,1867,1255,-20
101654293299,101654293302,3,1728,1152,-20
101657717738,101657717740,2,1511,1527,-20
101658425404,101658425406,2,1614,662,-20
101660252945,101660252949,4,1282,1043,-20
101660547179,101660547162,-17,1831,986,-20
101661961858,101661961840,-18,1538,867,-20
101662649625,101662649626,1,1585,1546,-20
101663121267,101663121270,3,2170,1156,-20
101665198686,101665198690,4,1587,1563,-20
101665299616,101665299619,3,942,887,-20
101666174226,101666174229,3,1566,1850,-20
101669237497,101669237499,2,1680,1281,-20
101672936279,101672936281,2,1213,916,-20
101678201478,101678201482,4,1778,1182,-20
101680459868,101680459870,2,1198,991,-20
101683222151,101683222155,4,2126,1816,-20
101689646293,101689646295,2,2974,1859,-20
101690116139,101690116145,6,2156,1959,-20
101691300431,101691300436,5,2051,1362,-20
101691454279,101691454282,3,1468,1906,-20
101692854149,101692854153,4,1678,1250,-20
101693536926,101693536908,-18,1438,932,-20
101694066627,101694066628,1,1548,1442,-20
101697856693,101697856694,1,1673,2033,-20
101706024006,101706024009,3,972,844,-20
101709830507,101709830512,5,1519,1413,-20
101711076911,101711076913,2,2586,1977,-20
101714708181,101714708186,5,1993,1875,-20
101716787360,101716787362,2,1900,1209,-20
101719932820,101719932823,3,1776,1378,-20
101722498109,101722498111,2,1470,1435,-20
101724155650,101724155653,3,2062,1353,-20
101725397626,101725397629,3,2324,1367,-20
101725562398,101725562401,3,1280,994,-20
101725928122,101725928125,3,2025,1396,-20
101726703126,101726703126,0,1356,1273,-20
101726867806,101726867810,4,1580,1732,-20
101733947367,101733947370,3,1726,809,-20
101734117992,101734117994,2,1745,1328,-20
101734511250,101734511251,1,1950,1916,-20
101736216448,101736216454,6,2360,1631,-20
101737446580,101737446582,2,1654,1270,-20
101737799260,101737799267,7,3197,1219,-20
101737940221,101737940223,2,1712,1961,-20
101740818650,101740818653,3,1099,1312,-20
101740984811,101740984815,4,1201,787,-20
101743563254,101743563259,5,1299,1573,-20
101743799093,101743799094,1,1380,910,-20
101745495009,101745495013,4,2323,1485,-20
101745963177,101745963182,5,1742,1332,-20
101749414958,101749414961,3,2118,1428,-20
101750080261,101750080265,4,2135,1720,-20
101753134474,101753134477,3,1199,1241,-20
101754842854,101754842858,4,2058,1263,-20
101759262413,101759262414,1,1505,1579,-20
101761829954,101761829954,0,1489,1023,-20
101763552279,101763552282,3,2125,1181,-20
101764370976,101764370995,19,1300,1071,-20
101765366050,101765366054,4,2035,1591,-20
101766618420,101766618425,5,4615,1949,-20
101767722897,101767722902,5,1300,1245,-20
101768926308,101768926311,3,2404,1570,-20
101769804235,101769804239,4,1515,1376,-20
101771916837,101771916840,3,2234,1372,-20
101776815388,101776815391,3,2075,1645,-20
101787166214,101787166218,4,1989,1331,-20
101787292042,101787292049,7,1657,1708,-20
101793677410,101793677415,5,2035,1727,-20
101797238269,101797238273,4,1382,1460,-20
101797460648,101797460651,3,2319,1676,-20
101797577618,101797577621,3,1712,1594,-20
101802270749,101802270753,4,1821,1311,-20
101808744769,101808744775,6,1955,1213,-20
101809385599,101809385602,3,1926,1400,-20
101809884726,101809884727,1,1506,1759,-20
101815979314,101815979315,1,1470,2294,-20
101820092252,101820092256,4,1416,2057,-20
101820962479,101820962474,-5,1191,3172,-20
101821299974,101821299977,3,2027,2192,-20
101827206759,101827206764,5,2299,1620,-20
101830858260,101830858264,4,2086,1395,-20
101831023536,101831023552,16,2316,1397,-20
101831315588,101831315594,6,1514,697,-20
101838188800,101838188805,5,4055,2853,-20
101838495227,101838495226,-1,2590,4604,-20
101840757875,101840757875,0,1322,1374,-20
101846529722,101846529739,17,14656,43535,-20
101846812277,101846812281,4,1430,1275,-20
101849045454,101849045458,4,1752,1395,-20
101851162486,101851162490,4,1606,1497,-20
101855165575,101855165576,1,7666,9269,-20
101864395033,101864395038,5,1413,1219,-20
101865710678,101865710681,3,3129,1985,-20
101868742039,101868742043,4,1174,726,-20
101869955514,101869955517,3,1800,1270,-20
101870087221,101870087200,-21,2175,1364,-20
101875571502,101875571507,5,1461,936,-20
101875990110,101875990092,-18,1511,1056,-20
101876404050,101876404047,-3,19127,15836,-20
101876774877,101876774879,2,1570,930,-20
101877095917,101877095921,4,1910,1359,-20
101877909791,101877909786,-5,2047,4661,-20
101877939316,101877939319,3,2520,1577,-20
101880798914,101880798912,-2,1144,2327,-20
101885653545,101885653547,2,1545,992,-20
101889680546,101889680546,0,1190,1638,-20
101890859844,101890859848,4,2660,1368,-20
101891010758,101891010739,-19,1145,879,-20
101892096845,101892096838,-7,3470,8161,-20
101903407807,101903407809,2,2065,1625,-20
101904168618,101904168617,-1,736,1283,-20
101907102707,101907102709,2,2599,1706,-20
101910115594,101910115598,4,4199,2480,-20
101910931034,101910931036,2,2434,1625,-20
101912025661,101912025663,2,1806,1621,-20
101917270661,101917270666,5,1884,1873,-20
101920972892,101920972894,2,1073,1392,-20
101923727641,101923727645,4,1525,1273,-20
101928415094,101928415099,5,1514,1331,-20
101932700638,101932700646,8,2571,1447,-20
101933824953,101933824960,7,2762,1586,-20
101934012399,101934012378,-21,510,563,-20
101939500134,101939500138,4,1339,1379,-20
101942111675,101942111675,0,1402,1994,-20
101943493972,101943493977,5,1627,1154,-20
101946028692,101946028690,-2,1529,1650,-20
101955346177,101955346179,2,916,567,-20
101960872513,101960872498,-15,1946,1093,-20
101965473839,101965473839,0,1486,1751,-20
101969214849,101969214849,0,1294,1946,-20
101969863501,101969863506,5,1362,1217,-20
101972078125,101972078126,1,1248,968,-20
101972657388,101972657391,3,2191,1504,-20
101978779281,101978779285,4,1902,988,-20
101980106002,101980106006,4,2178,1508,-20
101981673515,101981673517,2,1679,1187,-20
101986119762,101986119764,2,1652,1530,-20
101991985202,101991985207,5,1533,1239,-20
101992325758,101992325758,0,1580,1555,-20
101997374654,101997374657,3,1742,1127,-20
101997933032,101997933037,5,1887,1561,-20
101998594869,101998594874,5,1961,1301,-20
102000051086,102000051090,4,2117,1191,-20
102002506049,102002506052,3,1355,1073,-20
102004301094,102004301099,5,1629,1348,-20
102006818223,102006818231,8,2097,1398,-20
102007485014,102007485018,4,1550,1175,-20
102010604102,102010604105,3,1849,1364,-20
102011347209,102011347212,3,1694,2016,-20
102015214533,102015214539,6,5748,17484,-20
102017998646,102017998650,4,1440,941,-20
102023678337,102023678342,5,2087,1528,-20
102025235353,102025235357,4,1432,1374,-20
102026326587,102026326592,5,2114,1580,-20
102026429691,102026429693,2,1496,1628,-20
102029815515,102029815519,4,2405,1670,-20
102036219966,102036219971,5,1324,1112,-20
102037643821,102037643825,4,2080,1298,-20
102038733746,102038733749,3,1664,1430,-20
102040656670,102040656651,-19,1362,1038,-20
102042711209,102042711209,0,830,997,-20
102043566989,102043566992,3,1761,1350,-20
102046624285,102046624287,2,1993,1351,-20
102047338661,102047338666,5,1725,1596,-20
102050005746,102050005748,2,1797,1643,-20
102053666407,102053666403,-4,1041,3549,-20
102054177899,102054177903,4,1415,1622,-20
102054786466,102054786470,4,1823,1523,-20
102056409625,102056409630,5,2647,1637,-20
102059364762,102059364766,4,1564,1383,-20
102066396746,102066396750,4,4504,2389,-20
102067418753,102067418755,2,2426,1826,-20
102068203112,102068203118,6,2715,1951,-20
102068453259,102068453262,3,1652,1108,-20
102069540635,102069540638,3,1922,1611,-20
102070944968,102070944972,4,2124,2061,-20
102076953730,102076953734,4,1684,1515,-20
102078520406,102078520406,0,1873,1184,-20
102079534902,102079534907,5,1870,1289,-20
102082474695,102082474690,-5,4145,9922,-20
102084585386,102084585378,-8,1093,708,-20
102086439941,102086439948,7,2350,1808,-20
102088458371,102088458374,3,1789,1806,-20
102093928685,102093928689,4,2165,1443,-20
102094350191,102094350193,2,1180,1164,-20
102096349439,102096349442,3,1834,1437,-20
102096526937,102096526939,2,2357,1589,-20
102096591180,102096591182,2,1457,950,-20
102097234435,102097234439,4,1302,1462,-20
102099114406,102099114410,4,1615,1261,-20
102101490901,102101490903,2,1688,1251,-20
102104185074,102104185078,4,2166,1619,-20
102109967173,102109967177,4,2361,1093,-20
102111203185,102111203189,4,1609,1411,-20
102116016331,102116016334,3,2004,1648,-20
102116879089,102116879106,17,2079,1415,-20
102119767526,102119767528,2,1860,1720,-20
102120244943,102120244947,4,1902,1237,-20
102120752995,102120753001,6,2218,1677,-20
102124938847,102124938850,3,1601,1197,-20
102125678142,102125678147,5,3076,1358,-20
102127739807,102127739810,3,1181,1461,-20
102131803408,102131803411,3,1892,878,-20
102133398618,102133398622,4,1029,1011,-20
102135591918,102135591921,3,2536,1298,-20
102136113327,102136113326,-1,1493,1710,-20
102136236039,102136236041,2,1608,1224,-20
102139165981,102139165984,3,2208,1287,-20
102141651522,102141651523,1,2017,1614,-20
102143170579,102143170582,3,2193,1282,-20
102145598188,102145598183,-5,1099,4284,-20
102146888804,102146888807,3,2064,1293,-20
102146984726,102146984727,1,1980,1198,-20
102149284891,102149284894,3,1501,1768,-20
102155816820,102155816824,4,1721,1599,-20
102155904143,102155904146,3,1350,1711,-20
102157721625,102157721629,4,1967,1387,-20
102158521743,102158521746,3,2627,1189,-20
102160789833,102160789837,4,1541,1371,-20
102161563320,102161563323,3,2264,1837,-20
102167496262,102167496240,-22,1818,1376,-20
102168810417,102168810418,1,2148,1571,-20
102175256001,102175256003,2,1441,1241,-20
102176003953,102176003957,4,1431,1289,-20
102176236597,102176236602,5,2048,915,-20
102179291014,102179291018,4,1854,1526,-20
102179675495,102179675476,-19,1517,1372,-20
102180555521,102180555523,2,1888,1738,-20
102182888880,102182888882,2,1282,1159,-20
102183592035,102183592039,4,1648,1453,-20
102184314199,102184314200,1,1153,1243,-20
102188218877,102188218881,4,2414,1473,-20
102189964433,102189964437,4,997,1206,-20
102191186020,102191186023,3,1332,905,-20
102199272082,102199272087,5,1358,1025,-20
102201662934,102201662937,3,1663,1961,-20
102204797015,102204797017,2,1930,2771,-20
102206422247,102206422253,6,2059,1000,-20
102208335425,102208335429,4,1715,1321,-20
102208925310,102208925311,1,1738,1669,-20
102211220247,102211220252,5,1741,1748,-20
102220568833,102220568838,5,2566,1551,-20
102222298675,102222298677,2,1127,1346,-20
102224306673,102224306676,3,1569,1461,-20
102226384664,102226384666,2,1994,2105,-20
102226487325,102226487327,2,2077,1129,-20
102230575314,102230575322,8,4371,1380,-20
102233780438,102233780443,5,1548,1300,-20
102235510930,102235510933,3,3399,1764,-20
102236627852,102236627857,5,2221,1593,-20
102244803061,102244803065,4,2036,1663,-20
102249420711,102249420715,4,2077,1420,-20
102250264294,102250264298,4,1955,1350,-20
102251025473,102251025475,2,1149,1068,-20
102255316179,102255316183,4,1960,1141,-20
102255718534,102255718537,3,1405,1338,-20
102259367750,102259367749,-1,1851,2922,-20
102262165334,102262165338,4,1342,1209,-20
102263581018,102263581023,5,1968,1595,-20
102264912064,102264912067,3,2332,1998,-20
102265088795,102265088798,3,2251,1831,-20
102268208956,102268208958,2,2251,1197,-20
102268437013,102268437017,4,2269,1810,-20
102268575925,102268575905,-20,569,360,-20
102269970008,102269970012,4,2190,1762,-20
102271145662,102271145662,0,1449,1519,-20
102276680294,102276680297,3,2043,1392,-20
102280189770,102280189770,0,1689,1229,-20
102281226751,102281226753,2,1518,1473,-20
102281798827,102281798831,4,961,1021,-20
102286851253,102286851259,6,3066,1054,-20
102288147284,102288147290,6,2523,1441,-20
102288998573,102288998574,1,1519,1667,-20
102289370548,102289370546,-2,1146,2577,-20
102294182515,102294182518,3,1249,1095,-20
102294867987,102294867990,3,1576,1451,-20
102296847335,102296847338,3,1890,1542,-20
102297339246,102297339228,-18,781,466,-20
102299021178,102299021180,2,1562,1383,-20
102299178026,102299178029,3,1823,2070,-20
102299911232,102299911234,2,1957,1215,-20
102299979424,102299979427,3,2218,1150,-20
102304278393,102304278397,4,1840,1382,-20
102304829458,102304829459,1,18973,90768,-20
102307281656,102307281662,6,2650,927,-20
102307791266,102307791271,5,1719,1011,-20
102310292986,102310292989,3,2298,1178,-20
102314465519,102314465522,3,1180,1416,-20
102314617603,102314617606,3,1568,1467,-20
102321377693,102321377698,5,1873,1256,-20
102324558966,102324558969,3,1926,1580,-20
102328271536,102328271559,23,1202,1455,-20
102329840838,102329840841,3,1770,1495,-20
102330743955,102330743959,4,2002,1345,-20
102334703928,102334703933,5,1917,1541,-20
102335348119,102335348122,3,1814,2019,-20
102336392864,102336392867,3,1360,1612,-20
102338648986,102338648992,6,6457,2449,-20
102339025052,102339025056,4,1235,1685,-20
102340561746,102340561750,4,1595,1301,-20
102340638576,102340638579,3,1459,1000,-20
102345083497,102345083500,3,1939,1392,-20
102347494467,102347494466,-1,1628,1383,-20
102349350586,102349350587,1,1830,1719,-20
102352232182,102352232185,3,1464,1475,-20
102352484150,102352484160,10,1365,977,-20
102354054750,102354054754,4,1412,1236,-20
102357511499,102357511501,2,1461,1199,-20
102357900151,102357900132,-19,1048,633,-20
102358124071,102358124074,3,1885,1486,-20
102361211271,102361211275,4,1860,877,-20
102361401398,102361401378,-20,1382,1336,-20
102362303087,102362303090,3,1430,1505,-20
102368217423,102368217428,5,2147,1918,-20
102368993345,102368993348,3,1291,1564,-20
102370950781,102370950784,3,2360,1818,-20
102371085641,102371085643,2,1287,1794,-20
102371719422,102371719424,2,1697,1325,-20
102373212013,102373212014,1,1179,1100,-20
102374946294,102374946299,5,1807,1378,-20
102378678547,102378678545,-2,858,2674,-20
102382441833,102382441835,2,2790,2079,-20
102386007205,102386007210,5,2047,1240,-20
102389144413,102389144421,8,4038,1637,-20
102397674635,102397674639,4,1695,971,-20
102398411365,102398411369,4,1975,1324,-20
102398917773,102398917779,6,1535,568,-20
102399624545,102399624547,2,1278,1027,-20
102401524248,102401524253,5,2296,1200,-20
102410451865,102410451871,6,2932,1183,-20
102413941729,102413941733,4,3197,1654,-20
102415547422,102415547426,4,1613,1215,-20
102419243865,102419243871,6,1568,792,-20
102420013780,102420013784,4,1463,1634,-20
102420902985,102420902986,1,823,1638,-20
102420954670,102420954673,3,2063,1656,-20
102422200662,102422200680,18,1358,1315,-20
102429625291,102429625297,6,1685,1245,-20
102431170406,102431170409,3,1870,1582,-20
102433188993,102433188995,2,1753,1086,-20
102433876314,102433876318,4,1707,1190,-20
102435137585,102435137591,6,4288,1452,-20
102443147757,102443147761,4,1745,1626,-20
102444533854,102444533835,-19,1433,1433,-20
102451689962,102451689965,3,1599,1630,-20
102453934834,102453934838,4,2145,1360,-20
102454846319,102454846322,3,1407,1827,-20
102455391362,102455391364,2,2423,1561,-20
102456124379,102456124382,3,1818,1227,-20
102456525913,102456525917,4,2061,1499,-20
102458042978,102458042981,3,1415,1724,-20
102459619231,102459619233,2,2112,830,-20
102466877146,102466877147,1,1756,1496,-20
102474003783,102474003786,3,2070,2046,-20
102477887261,102477887262,1,1404,1615,-20
102480482690,102480482692,2,1690,1273,-20
102482754625,102482754629,4,2021,1216,-20
102484587866,102484587870,4,2246,1229,-20
102486037585,102486037588,3,1715,1621,-20
102491310601,102491310603,2,639,507,-20
102493971733,102493971734,1,1275,1508,-20
102495679022,102495679025,3,1702,1885,-20
102497502549,102497502551,2,2203,1228,-20
102498004971,102498004974,3,1921,1368,-20
102499792002,102499792006,4,1850,1586,-20
102501517478,102501517478,0,1732,1237,-20
102515888809,102515888810,1,1385,1763,-20
102518311902,102518311906,4,2026,1411,-20
102520391527,102520391528,1,1378,1782,-20
102522589215,102522589218,3,1591,1013,-20
102524677322,102524677324,2,2569,1947,-20
102526687553,102526687561,8,3301,1347,-20
102527447069,102527447090,21,1845,1670,-20
102527685293,102527685297,4,1895,1090,-20
102528063598,102528063598,0,1255,1966,-20
102528887494,102528887498,4,1657,1290,-20
102529165358,102529165363,5,2695,1290,-20
102530268752,102530268754,2,1669,1109,-20
102532253404,102532253410,6,3777,1836,-20
102536417303,102536417306,3,1329,1322,-20
102537835952,102537835954,2,1372,1327,-20
102538968565,102538968588,23,2117,1009,-20
102541407839,102541407844,5,2021,2225,-20
102541789822,102541789828,6,3043,1353,-20
102543933151,102543933155,4,1015,939,-20
102549829343,102549829346,3,1279,1481,-20
102550482493,102550482496,3,1809,1288,-20
102551817477,102551817464,-13,118,1824,-20
102554756174,102554756180,6,2804,1514,-20
102555524339,102555524347,8,1735,1330,-20
102555895929,102555895939,10,1653,1387,-20
102563462057,102563462058,1,1458,1248,-20
102569220233,102569220239,6,1330,1152,-20
102572893606,102572893609,3,2042,1687,-20
102576456369,102576456371,2,1283,931,-20
102578447111,102578447115,4,1429,1164,-20
102582795433,102582795439,6,3131,1024,-20
102587778930,102587778933,3,1726,1662,-20
102587873290,102587873294,4,1986,1164,-20
102591207200,102591207202,2,1777,1442,-20
102592571340,102592571333,-7,2544,12884,-20
102594771970,102594771970,0,1531,1163,-20
102599315518,102599315520,2,2285,1574,-20
102601044190,102601044191,1,1885,1512,-20
102602256291,102602256294,3,511,524,-20
102603651204,102603651208,4,2909,2502,-20
102605990047,102605990050,3,2230,1474,-20
102606970733,102606970737,4,2802,1866,-20
102611719130,102611719133,3,2857,1843,-20
102612244217,102612244222,5,1606,941,-20
102614785387,102614785391,4,2376,1657,-20
102616344724,102616344727,3,1884,1611,-20
102617146270,102617146273,3,1675,1478,-20
102617521726,102617521707,-19,1713,1100,-20
102617555437,102617555443,6,1409,1406,-20
102618057663,102618057643,-20,1832,1400,-20
102621258297,102621258300,3,1352,1167,-20
102623123148,102623123149,1,1661,1300,-20
102625365765,102625365769,4,2116,1499,-20
102626978512,102626978514,2,1366,1693,-20
102630341024,102630341018,-6,2228,7261,-20
102639734403,102639734401,-2,1356,2721,-20
102642767654,102642767657,3,2150,1547,-20
102647188138,102647188142,4,1647,1016,-20
102650120305,102650120308,3,1396,1733,-20
102660281718,102660281721,3,1875,1307,-20
102663040846,102663040850,4,1566,1473,-20
102663950883,102663950878,-5,1486,4262,-20
102667346816,102667346813,-3,1854,5323,-20
102667869511,102667869498,-13,9291,40089,-20
102669727392,102669727396,4,1608,1650,-20
102672305773,102672305774,1,1920,1529,-20
102675127243,102675127246,3,1622,1031,-20
102676098889,102676098894,5,1734,1448,-20
102677297290,102677297294,4,982,1091,-20
102677946998,102677947001,3,2920,2139,-20
102678987559,102678987561,2,1560,1674,-20
102680742825,102680742826,1,1429,1506,-20
102681672943,102681672946,3,1719,1247,-20
102682137161,102682137177,16,1808,1479,-20
102682751958,102682751959,1,1131,1034,-20
102683755356,102683755358,2,2095,2398,-20
102690500229,102690500231,2,1875,1621,-20
102691448522,102691448523,1,1459,1857,-20
102692317734,102692317736,2,2037,1545,-20
102693145967,102693145966,-1,1352,1269,-20
102698930762,102698930766,4,1785,1545,-20
102703113660,102703113665,5,821,851,-20
102705548847,102705548851,4,2785,1843,-20
102709480337,102709480343,6,3182,1660,-20
102711695341,102711695346,5,1527,1081,-20
102712914391,102712914394,3,2500,1513,-20
102714020880,102714020882,2,1772,1285,-20
102715310611,102715310612,1,1552,2192,-20
102717272721,102717272725,4,1603,1127,-20
102722396751,102722396757,6,1698,1712,-20
102724322958,102724322962,4,2079,1103,-20
102726264969,102726264973,4,2357,1460,-20
102726318217,102726318221,4,1779,1559,-20
102728631106,102728631110,4,1372,1376,-20
102729010789,102729010793,4,1334,1091,-20
102733240278,102733240282,4,1914,1416,-20
102735807498,102735807493,-5,1594,4938,-20
102738576350,102738576351,1,1394,1034,-20
102742244246,102742244250,4,1914,2001,-20
102742409725,102742409729,4,1757,1730,-20
102742657905,102742657912,7,2174,1392,-20
102745143294,102745143298,4,1491,1200,-20
102745353047,102745353051,4,1498,1076,-20
102748791697,102748791699,2,1541,1710,-20
102749154476,102749154481,5,2021,1462,-20
102749454183,102749454185,2,1508,1618,-20
102750180229,102750180212,-17,1134,924,-20
102750697149,102750697154,5,1838,1376,-20
102750798902,102750798906,4,1610,1573,-20
102759044809,102759044814,5,2847,1394,-20
102759747449,102759747453,4,1333,1071,-20
102762470914,102762470918,4,1876,884,-20
102766758969,102766758971,2,1651,987,-20
102769280571,102769280576,5,1560,1158,-20
102772457570,102772457574,4,1525,1165,-20
102781872476,102781872480,4,2208,1132,-20
102790671590,102790671589,-1,1317,1313,-20
102790949962,102790949966,4,1766,1064,-20
102799457451,102799457455,4,1447,1150,-20
102801443387,102801443389,2,1652,1299,-20
102802034248,102802034250,2,1401,1209,-20
102809064894,102809064897,3,2124,1335,-20
102810524762,102810524760,-2,1706,2498,-20
102812198515,102812198497,-18,1395,911,-20
102822655657,102822655659,2,2163,1647,-20
102826255850,102826255854,4,1678,1299,-20
102826685862,102826685864,2,1630,1517,-20
102829019329,102829019331,2,1305,949,-20
102830180824,102830180821,-3,1757,2244,-20
102831877078,102831877082,4,1659,1515,-20
102832657991,102832657994,3,1396,1070,-20
102836594148,102836594150,2,621,1320,-20
102846445015,102846445019,4,1502,821,-20
102848377486,102848377491,5,1409,1408,-20
102854033550,102854033555,5,1456,1106,-20
102856990766,102856990767,1,1720,1603,-20
102857386290,102857386294,4,1802,1410,-20
102858396021,102858396021,0,1593,1531,-20
102858912707,102858912710,3,1872,1391,-20
102862064461,102862064463,2,1674,1648,-20
102865348585,102865348577,-8,800,2925,-20
102867352207,102867352209,2,1556,1084,-20
102868207238,102868207241,3,2328,1492,-20
102869154900,102869154904,4,1442,1169,-20
102870717206,102870717209,3,1671,1250,-20
102871563831,102871563811,-20,1037,1075,-20
102872722061,102872722064,3,2189,1677,-20
102874506439,102874506438,-1,18669,34736,-20
102874605578,102874605582,4,2054,1149,-20
102874744989,102874744994,5,1167,1122,-20
102875708729,102875708729,0,2047,2147,-20
102876064502,102876064506,4,1539,1212,-20
102878014962,102878014966,4,1807,1518,-20
102882031653,102882031652,-1,2725,3998,-20
102885165647,102885165647,0,1098,1538,-20
102885306426,102885306429,3,2363,1721,-20
102888554249,102888554254,5,1726,1291,-20
102889598426,102889598407,-19,1658,1700,-20
102890521998,102890522001,3,1571,1209,-20
102892982987,102892982991,4,1447,2019,-20
102893643405,102893643405,0,974,1416,-20
102894671026,102894671031,5,2472,1465,-20
102899676841,102899676843,2,1521,1306,-20
102900202937,102900202940,3,2442,1550,-20
102904739726,102904739730,4,1755,1829,-20
102909943744,102909943747,3,1198,1301,-20
102912940506,102912940510,4,2253,1580,-20
102916444139,102916444144,5,2001,1685,-20
102926064728,102926064710,-18,1104,1078,-20
102929975956,102929975961,5,1979,1368,-20
102933276112,102933276118,6,2026,1527,-20
102934187190,102934187194,4,2104,1334,-20
102935227123,102935227125,2,1547,1467,-20
102935619839,102935619843,4,1141,1082,-20
102937060375,102937060378,3,1903,1177,-20
102939818761,102939818763,2,1689,1489,-20
102940151570,102940151575,5,1920,1382,-20
102942044805,102942044806,1,1878,2494,-20
102944042070,102944042075,5,1536,1624,-20
102944378950,102944378952,2,1272,1494,-20
102944522714,102944522717,3,2073,1429,-20
102947546577,102947546579,2,1842,1532,-20
102948293907,102948293910,3,1765,1241,-20
102948619101,102948619105,4,2923,2133,-20
102952537098,102952537101,3,2558,1475,-20
102955118221,102955118225,4,1617,1829,-20
102955687610,102955687615,5,1301,1346,-20
102956860306,102956860309,3,2128,1551,-20
102957619275,102957619278,3,2022,1632,-20
102957973703,102957973682,-21,1167,943,-20
102960465220,102960465223,3,1484,1346,-20
102960727806,102960727805,-1,5171,10080,-20
102961943482,102961943486,4,1362,1339,-20
102963265815,102963265819,4,1587,1503,-20
102971884849,102971884854,5,2416,1357,-20
102972024613,102972024617,4,2386,1290,-20
102973439818,102973439825,7,2984,1794,-20
102974340651,102974340648,-3,26734,19068,-20
102974781733,102974781735,2,1948,1281,-20
102978384134,102978384139,5,3135,2008,-20
102981868826,102981868832,6,2341,1195,-20
102983233897,102983233900,3,1652,1549,-20
102986722018,102986722022,4,1238,1302,-20
102988040883,102988040883,0,1922,1142,-20
102993560777,102993560777,0,1157,856,-20
102996735284,102996735286,2,1287,1208,-20
102997710056,102997710059,3,1866,1328,-20
103001840454,103001840458,4,2932,2481,-20
103007266359,103007266360,1,1098,1472,-20
103007393411,103007393396,-15,1530,1077,-20
103007761898,103007761884,-14,1282,1950,-20
103007982112,103007982114,2,1628,1101,-20
103009833687,103009833690,3,1790,1236,-20
103009910210,103009910225,15,2737,1945,-20
103014869949,103014869954,5,2179,1312,-20
103016931775,103016931769,-6,1254,3105,-20
103024569222,103024569226,4,1701,1002,-20
103029954677,103029954680,3,1804,1120,-20
103031767118,103031767123,5,2174,1897,-20
103034089978,103034089982,4,1433,983,-20
103039563766,103039563769,3,1957,1401,-20
103040220853,103040220856,3,2127,1660,-20
103041633251,103041633245,-6,1033,3100,-20
103047974842,103047974846,4,2859,1209,-20
103053518295,103053518297,2,1811,1928,-20
103053806806,103053806809,3,1793,1297,-20
103054017313,103054017313,0,3114,4505,-20
103058329477,103058329481,4,1784,1286,-20
103059138504,103059138509,5,2042,1641,-20
103062546342,103062546346,4,2017,1541,-20
103062717499,103062717502,3,1898,1516,-20
103070730852,103070730840,-12,1184,109,-20
103073436665,103073436668,3,1993,1733,-20
103075357350,103075357334,-16,1691,1221,-20
103075870932,103075870934,2,1155,1146,-20
103076501541,103076501544,3,3366,1752,-20
103078229771,103078229775,4,1186,1057,-20
103079488078,103079488082,4,1472,913,-20
103079927051,103079927054,3,1722,1113,-20
103081997865,103081997861,-4,3578,7993,-20
103082546458,103082546459,1,949,896,-20
103083103975,103083103977,2,1705,2222,-20
103084287278,103084287283,5,1831,1031,-20
103085287615,103085287625,10,1212,1176,-20
103087781557,103087781560,3,1665,1619,-20
103088421261,103088421267,6,3418,1206,-20
103088988410,103088988413,3,1597,1473,-20
103089435074,103089435088,14,483,1419,-20
103092082306,103092082311,5,2085,1548,-20
103093679167,103093679171,4,1963,1928,-20
103094333797,103094333802,5,2228,1429,-20
103097714828,103097714830,2,2750,2449,-20
103100656314,103100656300,-14,1958,1367,-20
103101044943,103101044947,4,1201,992,-20
103101620414,103101620395,-19,577,505,-20
103105837399,103105837400,1,855,1122,-20
103107340215,103107340217,2,1673,1535,-20
103107953935,103107953939,4,1902,1274,-20
103114560749,103114560752,3,1562,1742,-20
103115167622,103115167627,5,1929,1418,-20
103121446898,103121446903,5,1743,1554,-20
103121835253,103121835259,6,2793,1404,-20
103122154758,103122154762,4,1864,1550,-20
103123232589,103123232591,2,1992,1709,-20
103123502863,103123502867,4,1019,837,-20
103124752750,103124752750,0,1722,1489,-20
103126953010,103126953016,6,1653,1298,-20
103127304455,103127304459,4,1801,1182,-20
103127805076,103127805082,6,2872,1677,-20
103131955332,103131955335,3,2503,2005,-20
103134121832,103134121836,4,1494,784,-20
103138381037,103138381040,3,1952,1917,-20
103140282409,103140282413,4,2505,1379,-20
103141823903,103141823905,2,2148,1462,-20
103144355274,103144355275,1,1751,1476,-20
103145378227,103145378232,5,2295,1691,-20
103146446558,103146446562,4,2610,1677,-20
103146761918,103146761898,-20,1096,2208,-20
103148288254,103148288257,3,1522,1455,-20
103153324861,103153324860,-1,31395,62082,-20
103155748938,103155748942,4,2115,1725,-20
103158025874,103158025878,4,1907,1389,-20
103158841393,103158841395,2,2081,1132,-20
103160751454,103160751458,4,1297,838,-20
103162318095,103162318086,-9,1105,913,-20
103163592554,103163592557,3,2303,1994,-20
103165063662,103165063661,-1,1616,2027,-20
103169777267,103169777270,3,1612,990,-20
103170987898,103170987903,5,1438,1289,-20
103171967795,103171967799,4,1327,1687,-20
103173407658,103173407663,5,1531,1370,-20
103175105251,103175105254,3,1574,1215,-20
103175692711,103175692714,3,1433,1324,-20
103175802717,103175802719,2,1716,1139,-20
103177059745,103177059746,1,1845,1863,-20
103184810909,103184810910,1,2127,1893,-20
103186022086,103186022086,0,2224,2176,-20
103187360471,103187360471,0,1965,2203,-20
103190923519,103190923522,3,1506,1052,-20
103191974162,103191974160,-2,1209,2672,-20
103196119910,103196119912,2,1501,1748,-20
103196401366,103196401370,4,1618,1315,-20
103196783479,103196783483,4,1805,1167,-20
103198729982,103198729987,5,1991,1442,-20
103206114802,103206114798,-4,862,1273,-20
103209241318,103209241320,2,1461,1803,-20
103210333305,103210333310,5,1966,866,-20
103211991023,103211991027,4,1333,1667,-20
103219561275,103219561278,3,2158,1741,-20
103223922707,103223922710,3,1477,1320,-20
103225911818,103225911819,1,1145,1359,-20
103229326939,103229326941,2,1973,1354,-20
103230077109,103230077114,5,2284,1534,-20
103230537102,103230537109,7,1969,850,-20
103231446356,103231446349,-7,2809,8472,-20
103237032205,103237032209,4,2252,1710,-20
103242983682,103242983687,5,1291,879,-20
103244032303,103244032307,4,1937,1259,-20
103245184691,103245184695,4,1975,923,-20
103246964307,103246964309,2,1462,1061,-20
103247722390,103247722394,4,1396,1157,-20
103258401396,103258401398,2,1815,1198,-20
103258568342,103258568361,19,1835,1533,-20
103264557319,103264557325,6,2584,1386,-20
103267452097,103267452101,4,2221,1624,-20
103267668341,103267668344,3,988,1359,-20
103270440419,103270440423,4,2391,1695,-20
103271619050,103271619054,4,1638,1259,-20
103271664668,103271664670,2,1484,1443,-20
103272262389,103272262393,4,2168,1613,-20
103273298950,103273298953,3,2600,1789,-20
103275422686,103275422691,5,1571,1420,-20
103275468376,103275468380,4,2298,1401,-20
103276539811,103276539816,5,2541,1250,-20
103279861749,103279861753,4,2396,1469,-20
103281712191,103281712193,2,2287,1585,-20
103281812365,103281812345,-20,2699,1343,-20
103282557105,103282557107,2,1233,1217,-20
103283671578,103283671582,4,2190,1395,-20
103288341963,103288341947,-16,26067,28087,-20
103289685017,103289685019,2,1641,1168,-20
103291298572,103291298575,3,2269,1588,-20
103292393513,103292393521,8,1333,904,-20
103293188335,103293188338,3,1583,1495,-20
103296027533,103296027537,4,1214,1212,-20
103297475727,103297475730,3,1619,1115,-20
103303407525,103303407527,2,1756,1548,-20
103307851667,103307851670,3,1898,1377,-20
103308278290,103308278295,5,2141,1364,-20
103313564893,103313564898,5,1771,1714,-20
103317902592,103317902597,5,3100,1937,-20
103321852566,103321852570,4,2811,1657,-20
103322052478,103322052481,3,1712,1760,-20
103323958605,103323958610,5,1200,1160,-20
103329643621,103329643624,3,2142,1624,-20
103333225434,103333225436,2,1797,1619,-20
103335248718,103335248722,4,996,929,-20
103336939137,103336939139,2,1390,1184,-20
103337006501,103337006505,4,2090,1441,-20
103339699496,103339699499,3,1432,1126,-20
103339731248,103339731251,3,1658,1511,-20
103340783971,103340783975,4,2107,1306,-20
103340919135,103340919114,-21,1545,1252,-20
103342052497,103342052499,2,1854,1462,-20
103342370099,103342370103,4,2003,1497,-20
103345167502,103345167502,0,1694,1444,-20
103346239200,103346239203,3,1951,1808,-20
103346669237,103346669238,1,2110,1675,-20
103347855632,103347855633,1,2006,1821,-20
103351711630,103351711637,7,6917,2856,-20
103357279994,103357279998,4,1750,1660,-20
103360626947,103360626951,4,1404,1012,-20
103365096743,103365096747,4,1743,1362,-20
103366892630,103366892635,5,3187,1666,-20
103368709248,103368709251,3,1086,1053,-20
103368813339,103368813329,-10,1705,1540,-20
103369187941,103369187948,7,2023,1401,-20
103369825981,103369825982,1,2174,1246,-20
103369980069,103369980074,5,1897,1095,-20
103370869406,103370869410,4,2287,1758,-20
103371292169,103371292173,4,1515,1384,-20
103373451413,103373451409,-4,1742,1397,-20
103381514862,103381514866,4,2479,1340,-20
103381595442,103381595443,1,1407,2264,-20
103382653950,103382653954,4,1904,1443,-20
103384199785,103384199789,4,1799,1367,-20
103386638766,103386638770,4,2150,1484,-20
103390243342,103390243340,-2,2007,1572,-20
103394602065,103394602067,2,1686,1522,-20
103399205749,103399205754,5,1573,1413,-20
103405684100,103405684103,3,1328,974,-20
103407045181,103407045185,4,2290,2105,-20
103408976390,103408976394,4,1872,1232,-20
103409612429,103409612431,2,1429,1134,-20
103410708856,103410708859,3,2366,1822,-20
103411566990,103411566995,5,1787,1260,-20
103414072011,103414072005,-6,627,3986,-20
103420202532,103420202535,3,1531,1134,-20
103422522325,103422522330,5,1732,787,-20
103423224126,103423224129,3,1696,1690,-20
103423661764,103423661766,2,1715,1577,-20
103424469086,103424469090,4,1326,776,-20
103431921385,103431921387,2,1170,1771,-20
103434769430,103434769431,1,1177,1176,-20
103435274552,103435274555,3,1457,1408,-20
103435923243,103435923247,4,1516,820,-20
103436053566,103436053566,0,1130,1096,-20
103437822286,103437822288,2,1628,1235,-20
103437950874,103437950879,5,1688,1699,-20
103441507531,103441507535,4,1149,715,-20
103444833456,103444833459,3,1504,1198,-20
103447153250,103447153253,3,1334,1866,-20
103447244966,103447244970,4,2139,1494,-20
103447425394,103447425397,3,44344,31963,-20
103449159287,103449159291,4,2478,1797,-20
103451919516,103451919519,3,1395,1199,-20
103455440635,103455440637,2,2607,2902,-20
103459243384,103459243387,3,1585,1444,-20
103463980598,103463980602,4,1699,1297,-20
103467421928,103467421935,7,3705,1546,-20
103469011445,103469011446,1,1721,1434,-20
103469698292,103469698274,-18,2218,1699,-20
103478596106,103478596111,5,2173,1524,-20
103480802458,103480802465,7,1351,1021,-20
103483532841,103483532842,1,1640,1405,-20
103485355169,103485355171,2,2250,1460,-20
103486059501,103486059506,5,1621,1260,-20
103487655135,103487655139,4,1135,856,-20
103487733773,103487733772,-1,1276,2121,-20
103488184881,103488184886,5,2320,1410,-20
103489642951,103489642954,3,1801,1400,-20
103495289227,103495289221,-6,632,2690,-20
103495448718,103495448722,4,1703,950,-20
103495563999,103495564002,3,1948,1206,-20
103496819917,103496819920,3,2121,1531,-20
103500175647,103500175650,3,1499,953,-20
103504283984,103504283986,2,1408,1435,-20
103505211005,103505211007,2,1480,1226,-20
103507470921,103507470924,3,2041,1790,-20
103507590871,103507590850,-21,752,541,-20
103511634339,103511634346,7,1761,1466,-20
103512744882,103512744886,4,2182,1538,-20
103514318859,103514318862,3,1618,1136,-20
103515352929,103515352944,15,603,245,-20
103517048287,103517048290,3,1662,1347,-20
103517495922,103517495926,4,1661,1522,-20
103518935427,103518935430,3,2304,1191,-20
103520158058,103520158061,3,2447,1744,-20
103520358171,103520358174,3,2920,1508,-20
103521208339,103521208343,4,1272,1571,-20
103522563598,103522563598,0,1152,1242,-20
103523104694,103523104698,4,1319,1770,-20
103528209232,103528209226,-6,1998,8778,-20
103529103812,103529103815,3,1977,1910,-20
103529184587,103529184593,6,2496,1744,-20
103531284349,103531284351,2,1838,928,-20
103536579045,103536579048,3,1785,1764,-20
103537592530,103537592533,3,1977,1705,-20
103537707846,103537707851,5,2556,1657,-20
103541816541,103541816546,5,1610,1395,-20
103543493726,103543493729,3,1952,1864,-20
103546637956,103546637959,3,2025,1626,-20
103546864169,103546864174,5,1415,1006,-20
103546945031,103546945034,3,2711,1834,-20
103548884277,103548884281,4,1440,1141,-20
103549987307,103549987310,3,1809,1131,-20
103550082033,103550082036,3,1296,1441,-20
103565849508,103565849510,2,1160,622,-20
103567312178,103567312182,4,1565,1427,-20
103570633203,103570633206,3,1129,844,-20
103572343936,103572343941,5,2901,1958,-20
103576151029,103576151036,7,7376,2945,-20
103576401245,103576401249,4,1981,962,-20
103577768326,103577768331,5,1784,1356,-20
103579058107,103579058109,2,1654,1331,-20
103579236350,103579236353,3,2280,1696,-20
103579689754,103579689759,5,1873,1907,-20
103583059738,103583059742,4,1269,1379,-20
103589418852,103589418856,4,1607,1113,-20
103601212165,103601212169,4,1576,1079,-20
103601836997,103601836997,0,1553,1859,-20
103602058208,103602058206,-2,1021,1157,-20
103602443134,103602443137,3,2094,1466,-20
103602937342,103602937346,4,1916,994,-20
103604107367,103604107369,2,19148,29961,-20
103604327334,103604327334,0,846,736,-20
103605902729,103605902731,2,2477,1845,-20
103608805115,103608805098,-17,1753,1246,-20
103611845306,103611845309,3,1242,1083,-20
103613087753,103613087755,2,2001,1264,-20
103613219385,103613219392,7,1646,1052,-20
103613424053,103613424057,4,1767,1415,-20
103615711192,103615711211,19,512,1884,-20
103616794614,103616794617,3,2136,1269,-20
103618785687,103618785682,-5,1245,2282,-20
103619561449,103619561453,4,2323,1688,-20
103619932418,103619932421,3,1944,1227,-20
103620209805,103620209786,-19,1473,1037,-20
103623225158,103623225163,5,1617,1206,-20
103623726377,103623726383,6,1553,1438,-20
103625330293,103625330298,5,2279,1551,-20
103629489169,103629489172,3,1313,1407,-20
103632856734,103632856734,0,1654,1184,-20
103634890991,103634890995,4,1714,1404,-20
103635441459,103635441461,2,1682,1912,-20
103638922567,103638922580,13,1594,1489,-20
103643820462,103643820466,4,1767,1240,-20
103644505220,103644505223,3,1306,1175,-20
103649012480,103649012483,3,1781,1221,-20
103649717737,103649717743,6,1498,1087,-20
103653598421,103653598423,2,675,784,-20
103655482793,103655482798,5,1048,916,-20
103659781708,103659781704,-4,782,2963,-20
103659993753,103659993757,4,2785,1471,-20
103664009757,103664009759,2,1747,1396,-20
103664167271,103664167275,4,2043,1307,-20
103664538881,103664538882,1,2111,1577,-20
103667085558,103667085562,4,1807,1293,-20
103668916101,103668916106,5,1237,1203,-20
103670866461,103670866463,2,1656,1568,-20
103673239259,103673239262,3,2397,1213,-20
103678279949,103678279954,5,1525,1336,-20
103681751058,103681751059,1,950,1469,-20
103682492590,103682492591,1,1710,1676,-20
103682675737,103682675743,6,2032,1184,-20
103683157030,103683157035,5,1939,1423,-20
103683674205,103683674215,10,14545,30497,-20
103687133739,103687133743,4,1331,1052,-20
103689995784,103689995786,2,3724,3619,-20
103692384852,103692384851,-1,1581,1002,-20
103692520114,103692520117,3,1331,712,-20
103692792311,103692792298,-13,1098,807,-20
103695283111,103695283114,3,1276,1110,-20
103696096462,103696096467,5,1647,1203,-20
103696407421,103696407425,4,1959,1655,-20
103696974037,103696974040,3,767,357,-20
103697366579,103697366583,4,2063,1191,-20
103698461622,103698461626,4,1567,1531,-20
103699658878,103699658881,3,2144,1773,-20
103701749300,103701749302,2,1804,2053,-20
103703601919,103703601922,3,1782,1397,-20
103703664581,103703664585,4,1531,1206,-20
103708536741,103708536742,1,10608,10273,-20
103709053171,103709053152,-19,569,233,-20
103711012776,103711012781,5,1958,1580,-20
103714113250,103714113252,2,1719,1625,-20
103718378317,103718378319,2,1787,1313,-20
103720955153,103720955155,2,2596,2336,-20
103722852866,103722852873,7,5986,2387,-20
103722963028,103722963031,3,1723,1217,-20
103724522238,103724522241,3,2236,1451,-20
103726660713,103726660715,2,1553,1005,-20
103726897665,103726897667,2,1293,1286,-20
103726994772,103726994793,21,2634,1742,-20
103727370112,103727370131,19,1476,1228,-20
103733567713,103733567713,0,1088,629,-20
103736163681,103736163683,2,850,771,-20
103737843446,103737843451,5,2183,1354,-20
103737883230,103737883232,2,1681,1338,-20
103739165561,103739165563,2,1721,926,-20
103739751867,103739751870,3,1938,1707,-20
103741761971,103741761975,4,1915,1545,-20
103744050256,103744050254,-2,1620,2396,-20
103746759121,103746759122,1,1148,1330,-20
103748002464,103748002469,5,1321,1297,-20
103749755027,103749755033,6,1868,736,-20
103751845090,103751845094,4,1570,1519,-20
103756119562,103756119565,3,1834,1415,-20
103757795852,103757795854,2,2336,2171,-20
103758511090,103758511095,5,2525,1618,-20
103759927342,103759927346,4,1891,1226,-20
103760940152,103760940153,1,1572,1033,-20
103761563289,103761563291,2,1126,885,-20
103764333582,103764333586,4,2173,1127,-20
103769523377,103769523381,4,2189,1656,-20
103770279906,103770279909,3,2173,1549,-20
103770322966,103770322987,21,4538,1231,-20
103771008598,103771008603,5,2133,1336,-20
103771644770,103771644774,4,2118,1518,-20
103772066122,103772066125,3,2172,1816,-20
103775580649,103775580650,1,1918,1788,-20
103781758303,103781758305,2,1940,1544,-20
103783028533,103783028538,5,1877,1553,-20
103784294549,103784294536,-13,1581,1683,-20
103786709010,103786709014,4,1739,1557,-20
103790209530,103790209533,3,1877,1428,-20
103793318347,103793318350,3,1247,1399,-20
103796002955,103796002951,-4,1020,4034,-20
103799980921,103799980923,2,1902,1005,-20
103803379274,103803379282,8,7671,28812,-20
103805454035,103805454026,-9,637,309,-20
103805577277,103805577280,3,2206,1718,-20
103810353041,103810353045,4,1379,1118,-20
103815395085,103815395076,-9,47376,3596,-20
103815559792,103815559794,2,1379,1695,-20
103815606299,103815606301,2,1355,1421,-20
103819399758,103819399763,5,2021,1814,-20
103819716931,103819716929,-2,18739,80131,-20
103826275370,103826275374,4,1317,1154,-20
103835021006,103835021002,-4,1199,2898,-20
103841898499,103841898499,0,707,686,-20
103843474891,103843474898,7,6990,2827,-20
103847491098,103847491101,3,1981,1443,-20
103848854719,103848854724,5,3353,1989,-20
103853738596,103853738601,5,1446,1155,-20
103858691970,103858691971,1,2049,1514,-20
103859062318,103859062322,4,1248,981,-20
103862713345,103862713351,6,2815,1654,-20
103866475358,103866475361,3,950,915,-20
103870251016,103870251009,-7,993,3242,-20
103871012552,103871012555,3,1838,1346,-20
103874715219,103874715222,3,2154,1695,-20
103876483022,103876483027,5,2261,1672,-20
103876566496,103876566499,3,2136,1149,-20
103879081275,103879081279,4,2513,1485,-20
103879141219,103879141221,2,1340,1162,-20
103880664819,103880664821,2,1530,1713,-20
103887922617,103887922618,1,1339,1683,-20
103888982589,103888982591,2,1860,1361,-20
103890977655,103890977657,2,2071,1599,-20
103891238206,103891238207,1,1396,1278,-20
103893142526,103893142530,4,1669,1419,-20
103895157225,103895157227,2,1563,1231,-20
103896401020,103896401023,3,1500,1176,-20
103901623351,103901623357,6,2240,1509,-20
103903218457,103903218462,5,1452,1337,-20
103904514622,103904514627,5,2039,1143,-20
103906928841,103906928845,4,1506,1457,-20
103909516485,103909516487,2,2635,1666,-20
103916012884,103916012887,3,1429,1206,-20
103917257303,103917257304,1,1662,1881,-20
103920974244,103920974238,-6,1497,6312,-20
103922233231,103922233234,3,1735,1539,-20
103929346828,103929346830,2,1825,1331,-20
103932810838,103932810838,0,1354,2288,-20
103933141053,103933141055,2,1461,1642,-20
103936028677,103936028680,3,1648,1614,-20
103936276749,103936276751,2,1546,1293,-20
103936702051,103936702057,6,2292,1933,-20
103942501562,103942501567,5,2445,1677,-20
103943130354,103943130359,5,3306,1467,-20
103944910890,103944910894,4,2309,1603,-20
103946244865,103946244867,2,1616,1304,-20
103946544718,103946544723,5,51615,95002,-20
103947693153,103947693155,2,1807,1779,-20
103950966682,103950966685,3,2153,1200,-20
103954915758,103954915762,4,1707,1204,-20
103957211443,103957211445,2,1426,1311,-20
103957307318,103957307322,4,2024,1356,-20
103960334889,103960334888,-1,2504,4194,-20
103964705849,103964705853,4,2743,1880,-20
103965459714,103965459714,0,1885,1199,-20
103968471458,103968471461,3,2174,1583,-20
103968909970,103968909965,-5,920,2014,-20
103970099211,103970099214,3,1829,1153,-20
103970189008,103970189009,1,1666,1670,-20
103973434778,103973434783,5,1606,1013,-20
103974099735,103974099733,-2,958,2031,-20
103974458417,103974458418,1,1472,1582,-20
103976004105,103976004110,5,2950,1682,-20
103976736869,103976736872,3,1774,1190,-20
103984380725,103984380731,6,2206,1308,-20
103990917694,103990917699,5,1506,1302,-20
103991403743,103991403723,-20,2837,2175,-20
103993165648,103993165650,2,1828,1561,-20
103997051670,103997051673,3,1754,1352,-20
104001861543,104001861545,2,1989,1792,-20
104003932989,104003932990,1,1201,1804,-20
104008030755,104008030771,16,821,2318,-20
104012322690,104012322692,2,810,1060,-20
104013910382,104013910386,4,1700,1076,-20
104017907479,104017907481,2,1345,1669,-20
104019106411,104019106414,3,1507,862,-20
104019758905,104019758909,4,2094,1161,-20
104021454729,104021454732,3,1885,1438,-20
104022352485,104022352470,-15,1714,1514,-20
104023335298,104023335301,3,1787,1500,-20
104024304982,104024304984,2,2049,1002,-20
104027820427,104027820430,3,2047,1456,-20
104029746233,104029746237,4,2360,1540,-20
104031412798,104031412803,5,1229,898,-20
104033194350,104033194353,3,1290,1217,-20
104035923351,104035923355,4,1885,1412,-20
104036874810,104036874813,3,1632,1197,-20
104037670674,104037670663,-11,12361,39354,-20
104038407055,104038407059,4,1376,1298,-20
104038468655,104038468658,3,1664,1672,-20
104042568818,104042568822,4,2514,2128,-20
104046382075,104046382079,4,823,764,-20
104047394669,104047394670,1,1560,1111,-20
104051766993,104051766997,4,2228,1919,-20
104052916301,104052916303,2,1594,1019,-20
104056551106,104056551107,1,1062,629,-20
104057655842,104057655838,-4,1764,5120,-20
104058265935,104058265938,3,1894,1602,-20
104060306261,104060306265,4,1972,1413,-20
104061366670,104061366673,3,1860,1573,-20
104062548758,104062548763,5,2390,1654,-20
104064263614,104064263618,4,1413,966,-20
104067355958,104067355959,1,1875,1331,-20
104071227675,104071227675,0,1577,1789,-20
104081166069,104081166071,2,1845,1480,-20
104085826800,104085826802,2,1500,1288,-20
104086434625,104086434630,5,1958,1325,-20
104086767305,104086767301,-4,772,3856,-20
104089206652,104089206654,2,2475,1942,-20
104090927019,104090927022,3,1215,1204,-20
104092383934,104092383937,3,1641,1626,-20
104092446141,104092446145,4,1994,1825,-20
104092567721,104092567724,3,1789,1542,-20
104098568640,104098568643,3,2040,1672,-20
104099578470,104099578474,4,1636,1397,-20
104100998485,104100998488,3,2663,1865,-20
104104426649,104104426651,2,2060,1251,-20
104105449009,104105449012,3,1051,1239,-20
104106202201,104106202188,-13,137,1703,-20
104107691117,104107691121,4,2409,1426,-20
104118083753,104118083755,2,1867,1379,-20
104118139721,104118139724,3,890,1512,-20
104119000347,104119000350,3,2496,1651,-20
104119468416,104119468417,1,1238,1324,-20
104120905784,104120905787,3,2321,1175,-20
104131677958,104131677961,3,2190,1488,-20
104136746943,104136746946,3,1320,1573,-20
104137899655,104137899658,3,1673,1698,-20
104138026384,104138026387,3,1986,1203,-20
104139327435,104139327439,4,1698,1410,-20
104144655557,104144655561,4,1574,1361,-20
104147843694,104147843699,5,1541,1389,-20
104148245230,104148245234,4,1283,1061,-20
104149948003,104149948008,5,2435,2258,-20
104151511650,104151511653,3,1348,1344,-20
104153740215,104153740219,4,1218,935,-20
104155007379,104155007383,4,1956,1561,-20
104156254970,104156254973,3,1287,1226,-20
104156757764,104156757767,3,1448,1072,-20
104158162306,104158162310,4,1276,836,-20
104159059398,104159059378,-20,1456,1101,-20
104160539998,104160540002,4,2383,1258,-20
104162351341,104162351351,10,17,1286,-20
104163755778,104163755781,3,1936,2085,-20
104165123909,104165123911,2,1372,1227,-20
104168971710,104168971715,5,2086,1447,-20
104181865021,104181865023,2,1149,1031,-20
104182532533,104182532535,2,1551,866,-20
104183207074,104183207078,4,1532,1426,-20
104184381804,104184381806,2,1467,1395,-20
104195382018,104195382021,3,1349,955,-20
104199576670,104199576670,0,1677,1538,-20
104204588694,104204588698,4,1699,1400,-20
104205384548,104205384554,6,1469,1291,-20
104209692902,104209692906,4,1565,1190,-20
104213049922,104213049906,-16,3,1520,-20
104216301090,104216301095,5,1840,1083,-20
104218464993,104218464995,2,1919,1375,-20
104220666090,104220666089,-1,19263,26575,-20
104222343873,104222343878,5,2249,1029,-20
104225297487,104225297483,-4,1021,3354,-20
104230274433,104230274435,2,1075,1235,-20
104230642896,104230642900,4,54041,30467,-20
104231107602,104231107607,5,1942,1764,-20
104231415300,104231415307,7,3619,1253,-20
104231525871,104231525875,4,943,422,-20
104231635766,104231635769,3,2069,1568,-20
104232406069,104232406070,1,2092,2045,-20
104233874880,104233874874,-6,857,4231,-20
104235903111,104235903114,3,1726,1357,-20
104237889469,104237889473,4,593,808,-20
104239111924,104239111930,6,1766,1277,-20
104239305763,104239305777,14,1488,1780,-20
104241181249,104241181250,1,1404,1265,-20
104241829713,104241829716,3,1112,1417,-20
104246460515,104246460518,3,1940,1280,-20
104246873298,104246873302,4,1991,1816,-20
104248579682,104248579687,5,1424,1188,-20
104250868730,104250868733,3,1606,1730,-20
104251269509,104251269514,5,1747,1490,-20
104253849108,104253849110,2,1700,1675,-20
104256321883,104256321887,4,1572,1297,-20
104259531449,104259531453,4,2692,1670,-20
104261720791,104261720794,3,1789,1765,-20
104262790346,104262790348,2,1034,1346,-20
104263494212,104263494216,4,1577,1570,-20
104264029428,104264029439,11,1425,1013,-20
104264068837,104264068838,1,1565,1461,-20
104265969156,104265969159,3,1360,1205,-20
104270850582,104270850585,3,2170,1556,-20
104271383154,104271383154,0,1320,1832,-20
104271999578,104271999582,4,1636,1307,-20
104272940523,104272940526,3,1982,1574,-20
104277217820,104277217823,3,1419,1243,-20
104277817149,104277817154,5,2141,1471,-20
104283026618,104283026624,6,1034,730,-20
104286565226,104286565229,3,1897,1475,-20
104287754720,104287754724,4,1694,1211,-20
104288173001,104288173006,5,2020,1757,-20
104289447640,104289447642,2,1586,1332,-20
104290358406,104290358409,3,2008,1257,-20
104290567178,104290567181,3,1702,2046,-20
104291598534,104291598543,9,4211,2032,-20
104294942463,104294942457,-6,1847,10831,-20
104298407923,104298407922,-1,1582,1280,-20
104310502933,104310502934,1,1526,1426,-20
104314058723,104314058726,3,2532,1678,-20
104317234134,104317234138,4,2115,1973,-20
104317403255,104317403259,4,2081,1249,-20
104319940536,104319940540,4,2019,1530,-20
104327500242,104327500241,-1,1358,2256,-20
104328373488,104328373495,7,3489,1654,-20
104333508757,104333508761,4,1858,1267,-20
104334468373,104334468377,4,2003,1110,-20
104335068817,104335068822,5,2794,1917,-20
104337017122,104337017123,1,1314,1460,-20
104337673194,104337673195,1,1040,906,-20
104338043013,104338043016,3,1875,1876,-20
104339547299,104339547298,-1,883,1178,-20
104340113595,104340113598,3,1560,1310,-20
104341896734,104341896734,0,2278,1630,-20
104343021005,104343021009,4,898,950,-20
104344752382,104344752379,-3,1632,3585,-20
104351452261,104351452267,6,3479,1451,-20
104353731933,104353731936,3,1947,1649,-20
104356373873,104356373873,0,1615,899,-20
104357060481,104357060482,1,1399,858,-20
104359936369,104359936368,-1,22056,8347,-20
104361591065,104361591067,2,1755,902,-20
104369734465,104369734470,5,2566,1660,-20
104373735485,104373735490,5,1651,1226,-20
104373914417,104373914422,5,1711,1784,-20
104378742823,104378742826,3,1535,1404,-20
104380272146,104380272142,-4,956,1797,-20
104381667500,104381667503,3,1249,1495,-20
104382134907,104382134912,5,1989,1422,-20
104384002607,104384002610,3,1789,1390,-20
104384112143,104384112146,3,1654,1366,-20
104384942263,104384942268,5,2263,1507,-20
104386354114,104386354118,4,1860,1973,-20
104391434101,104391434104,3,1671,1023,-20
104396447558,104396447562,4,2307,2050,-20
104397019136,104397019140,4,1981,1017,-20
104400563127,104400563129,2,2282,1709,-20
104400617248,104400617251,3,1557,877,-20
104400823450,104400823454,4,2574,1959,-20
104404217255,104404217259,4,1585,1230,-20
104404469763,104404469767,4,2180,1034,-20
104407570606,104407570593,-13,890,88,-20
104408379545,104408379554,9,4854,1864,-20
104410053195,104410053198,3,2111,1728,-20
104410618271,104410618274,3,1501,1311,-20
104411304179,104411304182,3,1704,1454,-20
104414410034,104414410038,4,1118,1138,-20
104416754581,104416754584,3,1714,1450,-20
104423210232,104423210235,3,1461,945,-20
104424652322,104424652325,3,1600,1505,-20
104426237132,104426237134,2,1869,1545,-20
104426754113,104426754117,4,1507,1691,-20
104431846525,104431846534,9,3787,1571,-20
104434743369,104434743373,4,2169,1485,-20
104435270160,104435270164,4,1522,1597,-20
104437307176,104437307179,3,1817,1539,-20
104437540341,104437540347,6,1639,1129,-20
104442863177,104442863180,3,1544,944,-20
104443102736,104443102724,-12,1159,770,-20
104444705761,104444705757,-4,1464,5371,-20
104447037125,104447037130,5,4066,1252,-20
104447431032,104447431036,4,1742,1827,-20
104448188966,104448188972,6,1806,1733,-20
104450354142,104450354147,5,1845,1563,-20
104451520033,104451520038,5,2275,1583,-20
104451792029,104451792032,3,1459,1494,-20
104452704894,104452704894,0,1119,1615,-20
104453559930,104453559932,2,1411,1624,-20
104453769957,104453769959,2,1584,1134,-20
104456483172,104456483178,6,3170,1504,-20
104457527414,104457527415,1,2505,1831,-20
104458641871,104458641866,-5,1144,3658,-20
104460294982,104460294982,0,1812,1253,-20
104461752464,104461752466,2,1882,1173,-20
104466516123,104466516127,4,2211,1672,-20
104468866210,104468866214,4,2436,1335,-20
104468919021,104468919023,2,1694,1400,-20
104472486844,104472486858,14,420,2861,-20
104473569214,104473569218,4,1842,1352,-20
104477165456,104477165457,1,1767,1363,-20
104478477047,104478477052,5,2430,1821,-20
104479002589,104479002591,2,1542,1109,-20
104479484622,104479484627,5,1492,959,-20
104481246754,104481246758,4,2160,1780,-20
104482477794,104482477798,4,1490,1426,-20
104485113762,104485113766,4,1580,1727,-20
104485273078,104485273083,5,2482,1623,-20
104487599741,104487599743,2,1665,1575,-20
104488376652,104488376656,4,2081,1570,-20
104489330026,104489330030,4,1762,1247,-20
104489551270,104489551277,7,2787,1660,-20
104490648398,104490648403,5,2842,1745,-20
104492480573,104492480575,2,1901,1664,-20
104493386577,104493386579,2,1555,1519,-20
104496323765,104496323768,3,2117,1121,-20
104498253669,104498253674,5,2774,1833,-20
104499834446,104499834450,4,1683,1316,-20
104501287242,104501287245,3,1472,1513,-20
104501623864,104501623868,4,2163,1130,-20
104511620666,104511620670,4,1508,1176,-20
104512977211,104512977207,-4,2440,4306,-20
104513514287,104513514289,2,1620,1783,-20
104515447352,104515447355,3,1738,1553,-20
104516210612,104516210610,-2,1172,2576,-20
104516242699,104516242703,4,1641,1408,-20
104516506341,104516506345,4,1482,1534,-20
104517427214,104517427217,3,1503,1166,-20
104521061930,104521061929,-1,1633,1412,-20
104521249909,104521249922,13,2401,1482,-20
104522438217,104522438222,5,2137,1454,-20
104524993275,104524993278,3,1966,1386,-20
104528719430,104528719433,3,1866,1263,-20
104532131893,104532131896,3,1233,1167,-20
104533292320,104533292326,6,2015,1363,-20
104538191313,104538191317,4,1790,1443,-20
104540803841,104540803845,4,1215,1403,-20
104542405270,104542405264,-6,4226,12833,-20
104543741086,104543741074,-12,43658,15746,-20
104543768055,104543768057,2,1600,1154,-20
104544759973,104544759977,4,1586,1403,-20
104544863933,104544863939,6,3373,1432,-20
104545894521,104545894526,5,2609,1426,-20
104548319313,104548319318,5,2240,1232,-20
104553188923,104553188927,4,1379,782,-20
104556776542,104556776541,-1,1421,1561,-20
104561611506,104561611510,4,1615,1221,-20
104563934744,104563934747,3,2057,1342,-20
104564120887,104564120890,3,1891,1303,-20
104567148394,104567148398,4,2216,1611,-20
104567186298,104567186300,2,1368,1390,-20
104570739915,104570739916,1,10216,10388,-20
104571241351,104571241350,-1,1369,1054,-20
104572071454,104572071458,4,2092,1846,-20
104573142715,104573142720,5,1967,1581,-20
104573954323,104573954328,5,1861,1097,-20
104578400026,104578400031,5,5241,2557,-20
104585012255,104585012258,3,2034,1478,-20
104591492772,104591492775,3,1563,1204,-20
104592832554,104592832558,4,1873,1097,-20
104593015857,104593015860,3,2667,1415,-20
104598954108,104598954111,3,1805,1596,-20
104601103634,104601103631,-3,1146,2109,-20
104603780990,104603780997,7,3071,1532,-20
104604458892,104604458894,2,1574,1409,-20
104607099357,104607099360,3,1711,1191,-20
104610982007,104610982011,4,2227,1594,-20
104612252499,104612252502,3,2320,1232,-20
104618165504,104618165508,4,1675,1220,-20
104620124250,104620124255,5,1426,1659,-20
104621739790,104621739793,3,1553,1418,-20
104624189327,104624189330,3,2397,1723,-20
104625411089,104625411094,5,1398,968,-20
104629069716,104629069720,4,2734,1546,-20
104630554818,104630554821,3,1918,1348,-20
104631790409,104631790411,2,2411,1583,-20
104633133078,104633133074,-4,1376,2549,-20
104644219794,104644219798,4,2370,1338,-20
104645081045,104645081048,3,2052,2007,-20
104646646181,104646646187,6,2491,1213,-20
104652825898,104652825901,3,1943,1352,-20
104653208910,104653208913,3,1738,1315,-20
104654037045,104654037047,2,1590,1108,-20
104654607205,104654607206,1,1283,1044,-20
104654965503,104654965507,4,2421,1878,-20
104658281332,104658281334,2,1527,1722,-20
104660010873,104660010876,3,2210,1594,-20
104668626747,104668626754,7,1624,646,-20
104668839290,104668839272,-18,1881,1097,-20
104671736642,104671736646,4,2550,1468,-20
104672978011,104672978017,6,1438,986,-20
104674288619,104674288623,4,2302,1503,-20
104676206791,104676206790,-1,1621,1826,-20
104678822383,104678822391,8,32152,5445,-20
104681034171,104681034175,4,2345,1368,-20
104682277840,104682277842,2,1662,1468,-20
104684224901,104684224903,2,1181,1161,-20
104684664388,104684664390,2,1188,1246,-20
104688365395,104688365401,6,2873,1532,-20
104690188214,104690188228,14,13580,1627,-20
104692803682,104692803687,5,2107,1400,-20
104695406048,104695406050,2,1775,1402,-20
104695631270,104695631291,21,1332,1134,-20
104698121733,104698121737,4,1635,1090,-20
104699242321,104699242325,4,1749,1365,-20
104699329142,104699329146,4,2190,1441,-20
104700782701,104700782706,5,2399,1534,-20
104705980213,104705980211,-2,943,2404,-20
104708340398,104708340400,2,1244,1642,-20
104712563605,104712563609,4,1799,1353,-20
104717422829,104717422827,-2,3542,5137,-20
104718483564,104718483567,3,2298,1480,-20
104722748574,104722748577,3,1643,1417,-20
104723774171,104723774175,4,2482,1837,-20
104726995064,104726995064,0,1252,1079,-20
104727232216,104727232218,2,2672,1860,-20
104727370933,104727370935,2,1328,1225,-20
104727917532,104727917534,2,1580,1734,-20
104730991659,104730991668,9,4641,2163,-20
104731190397,104731190398,1,1580,1807,-20
104737478423,104737478424,1,1046,1289,-20
104740056762,104740056768,6,1868,1404,-20
104740921127,104740921130,3,1508,934,-20
104741223617,104741223621,4,1506,985,-20
104741846448,104741846448,0,1555,1862,-20
104742513038,104742513048,10,1456,1003,-20
104746539633,104746539637,4,1734,1311,-20
104749114962,104749114966,4,1771,1282,-20
104749728219,104749728223,4,2111,1345,-20
104752315034,104752315038,4,2474,1598,-20
104754190986,104754190990,4,1550,1525,-20
104764995559,104764995563,4,2685,1533,-20
104766625245,104766625249,4,2190,2055,-20
104767009056,104767009061,5,1633,1342,-20
104768293894,104768293895,1,1287,1556,-20
104771801885,104771801890,5,1944,1633,-20
104771992339,104771992339,0,1620,2076,-20
104773683879,104773683885,6,4339,2455,-20
104774554940,104774554944,4,1220,1380,-20
104784767207,104784767211,4,996,1036,-20
104785494705,104785494709,4,1855,1499,-20
104785684106,104785684110,4,1913,1811,-20
104785827190,104785827170,-20,1879,1130,-20
104786319719,104786319722,3,1977,1346,-20
104787922915,104787922919,4,1769,1577,-20
104788557869,104788557872,3,1535,1273,-20
104798927661,104798927665,4,2214,1255,-20
104800318093,104800318095,2,2287,1227,-20
104802382890,104802382893,3,1815,1289,-20
104804996026,104804996027,1,1250,1219,-20
104807317635,104807317638,3,1552,1482,-20
104808986650,104808986651,1,1360,1838,-20
104809334779,104809334785,6,1737,1292,-20
104810962917,104810962919,2,1577,1448,-20
104815328700,104815328705,5,2369,1969,-20
104820698077,104820698083,6,4024,1493,-20
104822689541,104822689545,4,1530,893,-20
104826178247,104826178251,4,1313,1426,-20
104830714024,104830714028,4,1464,1199,-20
104835336538,104835336542,4,1989,1165,-20
104836387177,104836387180,3,1896,1438,-20
104836442701,104836442705,4,2387,1540,-20
104836913385,104836913388,3,1552,2155,-20
104838686316,104838686320,4,1493,1217,-20
104841548806,104841548811,5,1264,765,-20
104845016501,104845016497,-4,1734,5594,-20
104848478216,104848478214,-2,1132,2278,-20
104856251898,104856251901,3,2998,1923,-20
104856810607,104856810593,-14,451,136,-20
104860248089,104860248090,1,980,893,-20
104861198266,104861198268,2,1615,1553,-20
104862059962,104862059965,3,1394,1126,-20
104864550282,104864550287,5,2385,1198,-20
104869083707,104869083710,3,1190,1441,-20
104869206177,104869206182,5,1698,1128,-20
104873182159,104873182163,4,2590,1262,-20
104876870931,104876870935,4,2505,1272,-20
104880669589,104880669593,4,2216,1577,-20
104880862951,104880862955,4,1938,1332,-20
104883137792,104883137795,3,2271,1401,-20
104885387931,104885387934,3,1609,1310,-20
104887103398,104887103399,1,1698,2518,-20
104889292653,104889292658,5,2357,1250,-20
104889738802,104889738808,6,1612,1113,-20
104891384286,104891384290,4,2064,1197,-20
104892420686,104892420690,4,1500,1302,-20
104893599403,104893599405,2,2366,1379,-20
104893996132,104893996134,2,1692,1407,-20
104894057639,104894057642,3,2115,1390,-20
104896871093,104896871094,1,1021,1577,-20
104897262477,104897262457,-20,1334,876,-20
104900368976,104900368999,23,1774,956,-20
104902700031,104902700038,7,3393,1451,-20
104904299197,104904299200,3,2304,1091,-20
104907516490,104907516488,-2,1367,2179,-20
104910543575,104910543579,4,1521,1472,-20
104911212005,104911212007,2,1714,1507,-20
104911616084,104911616086,2,1213,1442,-20
104919884809,104919884814,5,1830,1183,-20
104929803201,104929803202,1,1294,1486,-20
104931059491,104931059497,6,2057,1386,-20
104931279420,104931279425,5,1373,1011,-20
104931589442,104931589443,1,1386,1226,-20
104939550885,104939550888,3,1861,1981,-20
104939982261,104939982258,-3,1499,2674,-20
104942591904,104942591905,1,1593,1710,-20
104943913934,104943913935,1,1311,1281,-20
104944060767,104944060771,4,2729,1708,-20
104944925676,104944925677,1,1803,1414,-20
104946288594,104946288597,3,2376,1666,-20
104947590077,104947590081,4,2518,1730,-20
104952054972,104952054979,7,1086,1221,-20
104954664976,104954664979,3,1536,1977,-20
104955677343,104955677342,-1,1422,2885,-20
104957845882,104957845886,4,2258,1798,-20
104959594965,104959594970,5,1581,1244,-20
104972836251,104972836250,-1,1482,1717,-20
104973319175,104973319179,4,3392,2001,-20
104974276106,104974276111,5,1906,1436,-20
104974848773,104974848771,-2,1968,4014,-20
104978929723,104978929730,7,3142,989,-20
104979723283,104979723288,5,2018,1125,-20
104979972151,104979972154,3,1497,1365,-20
104982012140,104982012152,12,14440,50565,-20
104982505607,104982505611,4,1908,2024,-20
104983410075,104983410078,3,1581,1352,-20
104983587077,104983587083,6,1894,844,-20
104983905590,104983905591,1,787,1140,-20
104987971149,104987971154,5,2276,2053,-20
104989143897,104989143899,2,1466,1551,-20
104990711509,104990711512,3,2169,1202,-20
104992403346,104992403349,3,1588,1223,-20
104993346316,104993346328,12,2081,1064,-20
104995919735,104995919740,5,2398,1485,-20
104997979090,104997979085,-5,833,4274,-20
104999311923,104999311926,3,1418,1233,-20
104999510842,104999510847,5,1349,1179,-20
105000580810,105000580813,3,2256,1917,-20
105001612023,105001612028,5,1823,1569,-20
105001782729,105001782733,4,1472,1794,-20
105002153885,105002153890,5,2227,1633,-20
105005478738,105005478741,3,1563,1813,-20
105007215507,105007215514,7,3016,1508,-20
105012408301,105012408307,6,2391,1533,-20
105018899739,105018899742,3,1725,1808,-20
105021548066,105021548070,4,1514,1072,-20
105023502964,105023502967,3,1935,1361,-20
105024403894,105024403897,3,1838,1271,-20
105025747499,105025747501,2,1544,1682,-20
105031433581,105031433584,3,8930,8085,-20
105031731605,105031731607,2,1865,2095,-20
105031869889,105031869892,3,2123,1426,-20
105032021826,105032021830,4,1554,1444,-20
105036685364,105036685366,2,1833,1388,-20
105038655465,105038655462,-3,841,2304,-20
105041848090,105041848093,3,1579,1117,-20
105049711750,105049711754,4,1566,1101,-20
105053470629,105053470630,1,1411,1490,-20
105060625059,105060625066,7,3757,1934,-20
105065548905,105065548907,2,1325,1410,-20
105065825512,105065825515,3,2338,1529,-20
105065998314,105065998311,-3,1021,2854,-20
105070619021,105070619025,4,1293,1041,-20
105071096297,105071096297,0,454,105,-20
105073832690,105073832693,3,908,568,-20
105074604270,105074604273,3,1912,1393,-20
105077154311,105077154315,4,2040,1854,-20
105079436616,105079436619,3,3015,1749,-20
105084418443,105084418447,4,2459,1177,-20
105084654310,105084654312,2,1429,1485,-20
105085728288,105085728289,1,1329,1301,-20
105085940694,105085940697,3,2094,1532,-20
105086400671,105086400673,2,6550,5291,-20
105089299642,105089299645,3,1982,1354,-20
105091326664,105091326668,4,2338,1259,-20
105098760318,105098760321,3,1937,1997,-20
105100119055,105100119057,2,1259,1325,-20
105100480714,105100480718,4,1919,1545,-20
105101988146,105101988149,3,1587,1080,-20
105103868379,105103868383,4,2169,2037,-20
105105851641,105105851645,4,2014,1939,-20
105109457121,105109457121,0,1208,2034,-20
105113037765,105113037767,2,1263,1140,-20
105113344254,105113344258,4,1879,1036,-20
105120603231,105120603235,4,2165,1677,-20
105121735586,105121735589,3,1760,1421,-20
105122973894,105122973899,5,2104,1259,-20
105123475025,105123475029,4,2159,1640,-20
105124799066,105124799069,3,1198,1622,-20
105132530314,105132530310,-4,1709,3315,-20
105133929378,105133929383,5,2051,1327,-20
105134866770,105134866775,5,1947,1448,-20
105135084282,105135084287,5,5051,2146,-20
105135957089,105135957092,3,2237,1643,-20
105141811147,105141811150,3,1904,1380,-20
105142939917,105142939919,2,1003,1066,-20
105146753565,105146753562,-3,1182,1211,-20
105150701501,105150701502,1,1790,1089,-20
105151913742,105151913746,4,2407,1845,-20
105155045018,105155045021,3,2030,1578,-20
105156809516,105156809518,2,2046,1383,-20
105159009010,105159009008,-2,2571,4801,-20
105159764987,105159764991,4,1855,1464,-20
105161272262,105161272266,4,1617,1211,-20
105161824895,105161824898,3,1705,1589,-20
105163954796,105163954801,5,1974,1563,-20
105164892538,105164892544,6,1772,1302,-20
105176074004,105176074005,1,1680,1440,-20
105176582590,105176582593,3,1660,1693,-20
105181001088,105181001090,2,1982,1287,-20
105188820648,105188820651,3,2147,1574,-20
105188945989,105188945993,4,2016,1939,-20
105192165637,105192165656,19,280,1396,-20
105200131362,105200131365,3,1320,785,-20
105204349238,105204349243,5,1927,1081,-20
105205821432,105205821435,3,1725,1231,-20
105209224710,105209224716,6,2238,1211,-20
105212476834,105212476838,4,2299,1427,-20
105212780357,105212780361,4,1474,990,-20
105215841709,105215841710,1,1798,1561,-20
105222300035,105222300030,-5,1856,4276,-20
105224271248,105224271251,3,1556,1152,-20
105229067711,105229067715,4,1452,1465,-20
105233346068,105233346070,2,2266,1159,-20
105240322377,105240322380,3,1356,1088,-20
105241437617,105241437620,3,2065,1502,-20
105244668314,105244668314,0,1006,638,-20
105250280504,105250280501,-3,776,2986,-20
105253073891,105253073894,3,1675,1362,-20
105253478615,105253478620,5,2292,1199,-20
105254338345,105254338349,4,2164,1744,-20
105255544952,105255544954,2,1902,1574,-20
105256223774,105256223777,3,1629,1200,-20
105259062481,105259062484,3,2128,1316,-20
105261704657,105261704659,2,1610,1597,-20
105263970613,105263970615,2,1567,1572,-20
105265117109,105265117114,5,2523,1094,-20
105266360926,105266360931,5,1935,1233,-20
105266985203,105266985208,5,918,665,-20
105269488817,105269488821,4,1699,1662,-20
105275643713,105275643716,3,1400,1368,-20
105276153811,105276153814,3,1680,1386,-20
105279043494,105279043498,4,2361,1249,-20
105279815378,105279815379,1,1852,1507,-20
105281922099,105281922091,-8,1139,1670,-20
105284990608,105284990611,3,2053,1880,-20
105290650890,105290650891,1,1552,1347,-20
105295016430,105295016451,21,1814,1535,-20
105296705198,105296705201,3,1983,1627,-20
105297660930,105297660931,1,1057,888,-20
105300022970,105300022973,3,1750,1599,-20
105300247227,105300247230,3,2121,1290,-20
105302359351,105302359354,3,2843,1830,-20
105303322072,105303322076,4,2682,1496,-20
105303393919,105303393920,1,1262,1190,-20
105303842109,105303842112,3,2183,1144,-20
105305456894,105305456899,5,1469,1211,-20
105305818278,105305818284,6,1900,1610,-20
105306175354,105306175355,1,1680,1251,-20
105306697534,105306697537,3,1640,1184,-20
105306889550,105306889553,3,2226,1379,-20
105316856032,105316856036,4,2303,2026,-20
105317190205,105317190209,4,1808,1469,-20
105317584752,105317584754,2,1807,1746,-20
105318133830,105318133834,4,1408,606,-20
105318757009,105318757014,5,1585,923,-20
105320250130,105320250134,4,1614,1182,-20
105325047178,105325047181,3,1582,1510,-20
105325878538,105325878540,2,1894,1685,-20
105327501580,105327501582,2,1554,1523,-20
105328874926,105328874931,5,1504,1702,-20
105329572917,105329572922,5,2872,1729,-20
105330398945,105330398950,5,1656,1556,-20
105334663160,105334663165,5,2665,1937,-20
105335553690,105335553695,5,4090,1866,-20
105341189555,105341189558,3,1261,950,-20
105342258945,105342258950,5,13553,6443,-20
105343913113,105343913117,4,1748,1757,-20
105347278649,105347278652,3,15788,13142,-20
105348244133,105348244134,1,1626,1623,-20
105355533348,105355533350,2,2107,1065,-20
105357397626,105357397630,4,1540,1511,-20
105358708634,105358708641,7,2527,1813,-20
105362317250,105362317254,4,1639,1208,-20
105365781610,105365781615,5,1828,1161,-20
105366684326,105366684321,-5,1749,6753,-20
105369897790,105369897809,19,802,274,-20
105370583670,105370583674,4,1723,1327,-20
105373084569,105373084571,2,1520,1935,-20
105374151729,105374151712,-17,1744,1074,-20
105376270394,105376270399,5,1493,989,-20
105380059766,105380059770,4,2339,2100,-20
105380711308,105380711310,2,2251,1569,-20
105382223737,105382223738,1,1810,1150,-20
105385893113,105385893110,-3,1211,2221,-20
105387047738,105387047742,4,1880,1454,-20
105387798126,105387798130,4,2532,1015,-20
105388324997,105388325000,3,2136,1437,-20
105392434487,105392434491,4,2087,1778,-20
105395899574,105395899579,5,1453,872,-20
105396232434,105396232439,5,2447,1471,-20
105398443174,105398443175,1,2323,1333,-20
105404313762,105404313765,3,2273,1831,-20
105405458542,105405458547,5,1621,926,-20
105406203670,105406203673,3,2561,1470,-20
105408185538,105408185539,1,2627,2478,-20
105411889005,105411889007,2,1882,1956,-20
105412527574,105412527573,-1,940,1408,-20
105419023921,105419023925,4,2299,1739,-20
105419828447,105419828451,4,1449,1176,-20
105422452628,105422452631,3,2048,1246,-20
105428643859,105428643862,3,2095,1754,-20
105429969782,105429969786,4,1985,1263,-20
105433927026,105433927029,3,1953,1405,-20
105435622828,105435622831,3,860,1370,-20
105438052818,105438052837,19,213,5028,-20
105440440905,105440440908,3,1965,1611,-20
105445629037,105445629049,12,14694,34570,-20
105447006354,105447006355,1,2240,2518,-20
105447663389,105447663390,1,1755,1854,-20
105449456287,105449456293,6,1379,973,-20
105454212726,105454212731,5,1238,1141,-20
105455125443,105455125447,4,2549,1424,-20
105456395360,105456395368,8,3740,1165,-20
105456875094,105456875090,-4,1358,3371,-20
105457036467,105457036471,4,1587,1351,-20
105458492407,105458492410,3,1583,1207,-20
105469230303,105469230306,3,1953,1278,-20
105471650438,105471650443,5,1565,1595,-20
105478901526,105478901531,5,1872,1732,-20
105485631625,105485631627,2,1701,1155,-20
105489415339,105489415343,4,1375,1466,-20
105492803511,105492803513,2,2412,1367,-20
105494929748,105494929750,2,2313,1636,-20
105500358800,105500358804,4,2827,1866,-20
105503404393,105503404394,1,2687,2073,-20
105505263152,105505263154,2,1279,1541,-20
105506124455,105506124456,1,1233,2181,-20
105506811037,105506811042,5,2384,1131,-20
105509809530,105509809534,4,1596,1035,-20
105521366055,105521366075,20,610,907,-20
105522129050,105522129054,4,1597,1075,-20
105527011451,105527011454,3,1762,1444,-20
105528594069,105528594073,4,2119,1528,-20
105531701887,105531701889,2,1811,1578,-20
105533620294,105533620298,4,2141,1724,-20
105538241320,105538241322,2,1607,1718,-20
105543251506,105543251509,3,1603,1468,-20
105543420623,105543420625,2,2159,1425,-20
105543635533,105543635544,11,2158,1610,-20
105547136681,105547136681,0,1263,1891,-20
105547202241,105547202245,4,2207,1589,-20
105548970567,105548970571,4,1587,1175,-20
105551439042,105551439047,5,1880,1205,-20
105551546840,105551546843,3,1972,1031,-20
105552032465,105552032470,5,1035,1060,-20
105554985569,105554985571,2,1212,1073,-20
105555328365,105555328369,4,2119,1405,-20
105555991475,105555991478,3,1414,1327,-20
105556401784,105556401788,4,1165,1072,-20
105560114671,105560114677,6,2080,1717,-20
105562437687,105562437694,7,2835,1277,-20
105563278101,105563278103,2,2368,1037,-20
105566411621,105566411626,5,2436,1414,-20
105568893438,105568893441,3,1948,1578,-20
105571984825,105571984829,4,2952,1312,-20
105572458253,105572458257,4,59167,37822,-20
105576918178,105576918181,3,2146,1731,-20
105577369186,105577369190,4,1744,1291,-20
105580410147,105580410152,5,1970,1378,-20
105584021542,105584021535,-7,937,3827,-20
105584283470,105584283474,4,1659,1749,-20
105591188489,105591188491,2,966,973,-20
105592826299,105592826302,3,1629,1194,-20
105594595674,105594595677,3,1269,1114,-20
105595735522,105595735527,5,1879,1451,-20
105596993864,105596993867,3,2280,1529,-20
105606606982,105606606987,5,1557,1199,-20
105612289082,105612289085,3,2117,1491,-20
105616086271,105616086275,4,2083,1307,-20
105618068389,105618068382,-7,780,2551,-20
105619633749,105619633751,2,1797,1176,-20
105627345755,105627345760,5,2314,1288,-20
105628919981,105628919984,3,1772,1375,-20
105629915065,105629915067,2,2151,1469,-20
105631552577,105631552580,3,1971,1669,-20
105635200782,105635200787,5,1295,913,-20
105637683100,105637683098,-2,1316,1464,-20
105641070274,105641070277,3,1650,1091,-20
105642320708,105642320714,6,2235,1070,-20
105648581134,105648581138,4,2203,1514,-20
105653751254,105653751252,-2,1277,2726,-20
105654046915,105654046917,2,1414,1141,-20
105659068550,105659068570,20,658,619,-20
105659215294,105659215280,-14,2603,1029,-20
105659538828,105659538831,3,1758,1695,-20
105659941945,105659941951,6,1666,1074,-20
105661447453,105661447454,1,1422,1607,-20
105661551213,105661551214,1,1684,1524,-20
105663919081,105663919083,2,1192,1129,-20
105667081286,105667081290,4,1486,1318,-20
105668217690,105668217694,4,1383,1099,-20
105668503220,105668503224,4,2177,1318,-20
105673393251,105673393255,4,2444,1328,-20
105674513507,105674513511,4,1983,1494,-20
105677197307,105677197310,3,2785,1707,-20
105679514489,105679514488,-1,1839,2675,-20
105679679354,105679679359,5,2181,1876,-20
105681444374,105681444378,4,1535,1240,-20
105681788831,105681788837,6,2620,1524,-20
105683245378,105683245379,1,1437,1169,-20
105687064970,105687064971,1,1321,1404,-20
105691384554,105691384558,4,1154,1004,-20
105692154555,105692154559,4,1262,1069,-20
105695106610,105695106614,4,1798,1676,-20
105696207463,105696207467,4,1693,1536,-20
105699305269,105699305274,5,2012,966,-20
105699384813,105699384832,19,1452,1014,-20
105702476282,105702476285,3,1890,1360,-20
105703022550,105703022559,9,3277,1653,-20
105703694069,105703694069,0,1896,1942,-20
105703742447,105703742450,3,2369,1392,-20
105704015979,105704015982,3,2561,1966,-20
105704611478,105704611481,3,13994,14528,-20
105706464171,105706464174,3,1848,1149,-20
105711654228,105711654228,0,1897,1515,-20
105711891758,105711891762,4,1834,1195,-20
105712246522,105712246504,-18,1843,1321,-20
105712293410,105712293410,0,1126,1178,-20
105717907814,105717907817,3,1936,975,-20
105720777839,105720777841,2,1237,1610,-20
105727440351,105727440354,3,2610,1222,-20
105727698153,105727698154,1,1534,1182,-20
105729211845,105729211847,2,1506,1729,-20
105731802171,105731802175,4,1951,1228,-20
105734648406,105734648413,7,10018,23624,-20
105736341155,105736341159,4,2462,1265,-20
105736683758,105736683762,4,2268,1583,-20
105739524138,105739524142,4,1204,912,-20
105740681909,105740681912,3,1515,1154,-20
105743446361,105743446367,6,2400,937,-20
105743500881,105743500885,4,1728,1437,-20
105743749443,105743749445,2,1496,1226,-20
105746038168,105746038174,6,2636,1380,-20
105746493956,105746493961,5,1995,1130,-20
105748214284,105748214288,4,2497,1326,-20
105750138871,105750138885,14,13315,48519,-20
105756849713,105756849717,4,1455,1166,-20
105758627779,105758627783,4,1990,1442,-20
105760288907,105760288900,-7,21103,16300,-20
105768451237,105768451242,5,1486,1552,-20
105769204531,105769204533,2,1165,1500,-20
105770121696,105770121698,2,1595,1128,-20
105777403482,105777403485,3,1754,1609,-20
105780015315,105780015319,4,1488,1570,-20
105782129369,105782129373,4,1959,1664,-20
105783421089,105783421093,4,1116,1237,-20
105784819552,105784819554,2,1870,1364,-20
105784931022,105784931025,3,1432,1131,-20
105789793600,105789793602,2,987,1408,-20
105792630472,105792630454,-18,161,731,-20
105793418750,105793418749,-1,1687,2178,-20
105794823692,105794823695,3,1674,1557,-20
105796058418,105796058422,4,1382,2119,-20
105796984847,105796984851,4,1364,1653,-20
105799576178,105799576182,4,1578,1175,-20
105801092402,105801092406,4,1705,1866,-20
105805841100,105805841098,-2,1114,2033,-20
105809176703,105809176697,-6,1046,3841,-20
105811995861,105811995865,4,1219,1306,-20
105812608738,105812608741,3,2998,1501,-20
105814050490,105814050493,3,954,1243,-20
105815298281,105815298285,4,1154,779,-20
105816809366,105816809368,2,1624,1454,-20
105820245562,105820245565,3,1713,1292,-20
105822198114,105822198117,3,1619,1373,-20
105824024567,105824024568,1,9039,9841,-20
105824891391,105824891395,4,2182,1510,-20
105826044182,105826044178,-4,1082,1293,-20
105828810145,105828810146,1,1982,1189,-20
105832979525,105832979532,7,7023,2629,-20
105835290720,105835290723,3,1874,1343,-20
105839386611,105839386615,4,1847,1201,-20
105839687831,105839687835,4,1902,858,-20
105840672474,105840672479,5,1695,1372,-20
105850571059,105850571062,3,2190,1263,-20
105851869227,105851869229,2,1435,1347,-20
105853227910,105853227915,5,1609,1098,-20
105854451009,105854451011,2,1371,1653,-20
105855493968,105855493961,-7,2226,10373,-20
105856814025,105856814030,5,2360,1590,-20
105857091026,105857091031,5,1689,1358,-20
105860089370,105860089376,6,1758,1035,-20
105861539385,105861539387,2,1856,1315,-20
105863282054,105863282058,4,2281,1963,-20
105864426783,105864426785,2,1642,992,-20
105867473252,105867473254,2,2614,2357,-20
105867575426,105867575430,4,2013,1653,-20
105869400082,105869400082,0,1455,967,-20
105870143046,105870143028,-18,1602,2208,-20
105876562991,105876562972,-19,890,583,-20
105879315402,105879315407,5,1480,741,-20
105880429122,105880429126,4,1224,1173,-20
105882464087,105882464090,3,1987,1349,-20
105883938995,105883938999,4,1440,648,-20
105885808397,105885808401,4,1376,1237,-20
105886027305,105886027307,2,1597,1322,-20
105886161227,105886161229,2,17931,21545,-20
105887920886,105887920888,2,2092,1215,-20
105889788942,105889788947,5,2102,1699,-20
105890435655,105890435658,3,1563,1765,-20
105891066773,105891066777,4,2785,1674,-20
105892494026,105892494029,3,1891,1320,-20
105894893753,105894893758,5,2020,1918,-20
105895958376,105895958379,3,1203,1482,-20
105896545931,105896545929,-2,1297,2026,-20
105897644635,105897644639,4,1870,1354,-20
105898551869,105898551858,-11,160,976,-20
105904192785,105904192790,5,1713,1330,-20
105914501893,105914501898,5,1517,896,-20
105917850989,105917850992,3,2734,1956,-20
105919255966,105919255969,3,1843,1359,-20
105920975604,105920975606,2,2036,1239,-20
105923009941,105923009945,4,3781,2008,-20
105936795582,105936795585,3,2616,1456,-20
105937497014,105937497016,2,1475,1037,-20
105937536367,105937536370,3,1953,1636,-20
105941208710,105941208710,0,519,1365,-20
105946390030,105946390034,4,1591,857,-20
105947489693,105947489694,1,1326,1345,-20
105948290110,105948290113,3,1824,1523,-20
105948506823,105948506827,4,1116,874,-20
105949179141,105949179134,-7,2936,11417,-20
105950351142,105950351143,1,1300,1309,-20
105954554966,105954554970,4,2041,1202,-20
105955909896,105955909898,2,1759,1208,-20
105956205152,105956205156,4,1429,1273,-20
105969711015,105969711019,4,1769,1470,-20
105970699058,105970699061,3,1939,1508,-20
105970774970,105970774971,1,1573,1704,-20
105975217534,105975217538,4,1025,775,-20
105975836606,105975836611,5,1665,1475,-20
105977382306,105977382310,4,1822,1659,-20
105977417947,105977417947,0,1210,1683,-20
105980140591,105980140594,3,1234,974,-20
105981892798,105981892803,5,1682,1599,-20
105985103938,105985103942,4,2675,1802,-20
105986911898,105986911902,4,1776,1605,-20
105993730317,105993730322,5,2121,1692,-20
105995007733,105995007738,5,3975,2172,-20
105997376667,105997376671,4,1447,1493,-20
106000281487,106000281491,4,1557,1321,-20
106000503233,106000503237,4,1585,1334,-20
106001105049,106001105053,4,1549,1075,-20
106005637233,106005637233,0,2011,1681,-20
106007398971,106007398975,4,1651,1613,-20
106008127014,106008127018,4,2026,1535,-20
106011062264,106011062267,3,1685,2029,-20
106011924477,106011924481,4,2185,1080,-20
106013205001,106013205004,3,1839,1989,-20
106013505717,106013505722,5,2509,1194,-20
106016343112,106016343115,3,2274,1139,-20
106017301821,106017301823,2,1647,1394,-20
106019068433,106019068435,2,998,712,-20
106020117184,106020117186,2,1469,1428,-20
106021861614,106021861593,-21,2558,1209,-20
106022766792,106022766794,2,1202,1137,-20
106023510506,106023510509,3,1893,1459,-20
106024146351,106024146354,3,1599,1127,-20
106024755469,106024755473,4,2084,1015,-20
106026646710,106026646713,3,2089,1644,-20
106028726781,106028726785,4,1703,1466,-20
106031586417,106031586417,0,1253,1167,-20
106032843344,106032843341,-3,1583,1423,-20
106039938172,106039938178,6,2226,1174,-20
106046276734,106046276730,-4,1283,3911,-20
106046471227,106046471228,1,2189,1539,-20
106048792076,106048792075,-1,1735,2701,-20
106051071274,106051071276,2,1308,1360,-20
106052216082,106052216081,-1,1407,2402,-20
106052313193,106052313195,2,3396,2754,-20
106053530940,106053530937,-3,2684,5717,-20
106055003818,106055003824,6,3102,969,-20
106055191450,106055191449,-1,1296,1154,-20
106055346881,106055346882,1,1812,1754,-20
106056163161,106056163162,1,1154,1303,-20
106060485311,106060485313,2,1830,1326,-20
106066367694,106066367690,-4,988,893,-20
106068063970,106068063973,3,1843,1249,-20
106070974988,106070974991,3,1382,1066,-20
106072371407,106072371411,4,1218,1458,-20
106073194734,106073194735,1,1317,714,-20
106074089702,106074089706,4,1464,1915,-20
106077726402,106077726405,3,1898,1331,-20
106079653974,106079653980,6,2624,1773,-20
106081785960,106081785942,-18,1121,1355,-20
106083951864,106083951866,2,1799,1679,-20
106086198082,106086198076,-6,2102,13349,-20
106086918211,106086918215,4,1974,1250,-20
106087325648,106087325652,4,1468,1067,-20
106091224063,106091224064,1,1121,1390,-20
106093815393,106093815397,4,1261,1656,-20
106096675350,106096675354,4,1569,858,-20
106097200789,106097200794,5,1757,1503,-20
106102428554,106102428557,3,2176,1337,-20
106102838527,106102838534,7,2495,1496,-20
106106159264,106106159266,2,2113,1385,-20
106108789800,106108789802,2,1945,1448,-20
106109112721,106109112724,3,2212,1820,-20
106110236984,106110236978,-6,31065,13062,-20
106111501283,106111501285,2,1948,1971,-20
106111722475,106111722477,2,1920,1317,-20
106114118603,106114118606,3,1275,1465,-20
106114746203,106114746207,4,1520,1232,-20
106115614423,106115614421,-2,2289,6105,-20
106118541000,106118541003,3,1396,1242,-20
106119291533,106119291538,5,5329,2689,-20
106121422475,106121422482,7,621,313,-20
106128186422,106128186427,5,2213,1068,-20
106128591245,106128591246,1,1914,1423,-20
106132671346,106132671350,4,2397,1576,-20
106133006790,106133006791,1,1545,1745,-20
106139235886,106139235889,3,1827,1337,-20
106139721522,106139721526,4,2239,1329,-20
106141515609,106141515614,5,1582,1919,-20
106145197621,106145197629,8,3033,1091,-20
106152060639,106152060642,3,2698,1666,-20
106153555815,106153555815,0,894,979,-20
106154191420,106154191423,3,1425,1099,-20
106161984549,106161984555,6,1798,744,-20
106162077189,106162077170,-19,2064,1430,-20
106164105627,106164105612,-15,2598,2030,-20
106165716342,106165716344,2,1416,1240,-20
106171566327,106171566330,3,1819,1533,-20
106172854796,106172854798,2,1804,1376,-20
106173013309,106173013311,2,1386,1513,-20
106173478067,106173478070,3,1565,1810,-20
106174775523,106174775502,-21,665,367,-20
106175433339,106175433341,2,1387,1657,-20
106176421202,106176421205,3,1838,1809,-20
106180253885,106180253891,6,1952,1479,-20
106181324292,106181324299,7,22840,21471,-20
106181383223,106181383226,3,1303,1550,-20
106183883531,106183883534,3,1498,1425,-20
106187879633,106187879616,-17,1548,727,-20
106188953887,106188953890,3,2012,1232,-20
106189590702,106189590684,-18,1834,1811,-20
106198975678,106198975679,1,1458,1150,-20
106201348862,106201348867,5,1964,1386,-20
106202105310,106202105315,5,1221,1181,-20
106204724233,106204724247,14,15092,45185,-20
106205606182,106205606182,0,2718,4410,-20
106208101035,106208101038,3,1961,1195,-20
106208477732,106208477735,3,1879,1165,-20
106209954678,106209954680,2,1149,996,-20
106210553627,106210553629,2,1819,1800,-20
106210871121,106210871123,2,2134,1493,-20
106216342462,106216342463,1,761,1376,-20
106217802180,106217802182,2,1304,1232,-20
106217962388,106217962391,3,1576,1715,-20
106218012641,106218012646,5,2295,1086,-20
106219262090,106219262095,5,1770,1087,-20
106220159809,106220159815,6,2322,931,-20
106221166160,106221166165,5,2357,1671,-20
106221280351,106221280331,-20,1633,1502,-20
106224385314,106224385321,7,2326,1212,-20
106226080379,106226080382,3,1941,1355,-20
106228412958,106228412962,4,1779,1397,-20
106229929932,106229929935,3,1961,1530,-20
106230151869,106230151873,4,2263,1348,-20
106230191228,106230191210,-18,1973,1596,-20
106235951847,106235951854,7,3873,1429,-20
106238010693,106238010698,5,1947,1367,-20
106238097611,106238097605,-6,2268,11837,-20
106242952033,106242952034,1,2116,1921,-20
106245934017,106245934020,3,1537,1645,-20
106249106593,106249106597,4,1391,918,-20
106250532595,106250532599,4,2379,1781,-20
106250978118,106250978122,4,1713,947,-20
106253881262,106253881263,1,2187,1525,-20
106254106160,106254106163,3,1987,1306,-20
106256162746,106256162739,-7,1311,1247,-20
106265744800,106265744802,2,1052,1255,-20
106266344158,106266344163,5,1808,1608,-20
106274040011,106274040014,3,1274,1488,-20
106274803652,106274803650,-2,1536,3642,-20
106276189542,106276189544,2,2009,1314,-20
106276898406,106276898410,4,1906,1422,-20
106277930194,106277930200,6,1762,1325,-20
106283953186,106283953190,4,1858,1399,-20
106286397766,106286397772,6,2791,1442,-20
106295796502,106295796513,11,15938,36405,-20
106304456986,106304456990,4,2231,1759,-20
106305879916,106305879918,2,1666,1291,-20
106310051438,106310051441,3,2585,2287,-20
106310341610,106310341611,1,1453,1441,-20
106313671434,106313671438,4,1286,979,-20
106317644730,106317644733,3,1695,1529,-20
106318006205,106318006207,2,1769,1183,-20
106318293037,106318293040,3,2031,1636,-20
106322257906,106322257911,5,1467,1160,-20
106323061023,106323061026,3,1386,987,-20
106323125121,106323125126,5,2199,1424,-20
106328139477,106328139481,4,1662,1892,-20
106330018755,106330018758,3,1508,1361,-20
106330393569,106330393571,2,1933,1354,-20
106331294742,106331294742,0,1077,2006,-20
106333040822,106333040822,0,1376,1885,-20
106337252974,106337252978,4,2170,1666,-20
106341457049,106341457035,-14,446,1143,-20
106346143649,106346143653,4,1707,2181,-20
106347253169,106347253175,6,4908,2595,-20
106349853287,106349853288,1,1786,1132,-20
106350455046,106350455050,4,2529,1981,-20
106350644005,106350644008,3,1891,1438,-20
106352305029,106352305031,2,1998,922,-20
106352472475,106352472479,4,1247,1387,-20
106355541102,106355541103,1,1205,895,-20
106359933742,106359933745,3,2092,2010,-20
106360418870,106360418871,1,1390,1322,-20
106363207195,106363207198,3,1689,1373,-20
106364934487,106364934491,4,1507,1018,-20
106366407196,106366407199,3,1432,1751,-20
106367131998,106367132003,5,2377,2112,-20
106367224612,106367224614,2,1608,1231,-20
106367635942,106367635946,4,1793,1747,-20
106369661927,106369661930,3,3240,1975,-20
106372355763,106372355766,3,1405,1520,-20
106373312001,106373312003,2,2435,2116,-20
106374742964,106374742967,3,1906,1232,-20
106375674272,106375674275,3,1805,925,-20
106375749285,106375749290,5,1751,1593,-20
106375812277,106375812279,2,722,962,-20
106378138325,106378138327,2,2452,1296,-20
106380564841,106380564845,4,2055,1811,-20
106386947840,106386947843,3,1875,892,-20
106389969149,106389969151,2,1992,1681,-20
106390563467,106390563471,4,1303,1027,-20
106391963017,106391963021,4,1786,1498,-20
106397484071,106397484074,3,1808,1478,-20
106397748770,106397748771,1,1007,937,-20
106403312928,106403312932,4,2158,2211,-20
106403430217,106403430221,4,1260,1287,-20
106403972640,106403972642,2,1588,1223,-20
106412738192,106412738194,2,2418,1437,-20
106413299251,106413299254,3,2309,1448,-20
106413797066,106413797068,2,1763,1740,-20
106415775812,106415775815,3,1970,1663,-20
106421257318,106421257323,5,1589,785,-20
106421846078,106421846081,3,2062,1521,-20
106424078176,106424078182,6,3239,1765,-20
106426646105,106426646108,3,1570,1241,-20
106427763298,106427763302,4,1729,1565,-20
106432107547,106432107551,4,2166,1232,-20
106432493458,106432493442,-16,1569,2029,-20
106437458963,106437458968,5,2136,1944,-20
106441390727,106441390730,3,1792,880,-20
106442684110,106442684113,3,2212,1795,-20
106447332152,106447332157,5,1388,1312,-20
106452605923,106452605923,0,1138,1448,-20
106455246656,106455246660,4,2016,1318,-20
106456405243,106456405247,4,1582,1510,-20
106456685558,106456685536,-22,1695,1208,-20
106458638741,106458638731,-10,233,1869,-20
106460287578,106460287582,4,2060,1250,-20
106461028681,106461028674,-7,1485,5751,-20
106462484566,106462484571,5,1049,1159,-20
106463125808,106463125808,0,55,1582,-20
106478141221,106478141229,8,2860,1425,-20
106478639954,106478639957,3,1886,1348,-20
106480072985,106480072987,2,1757,1329,-20
106480140026,106480140030,4,2146,1311,-20
106483526273,106483526278,5,1897,1454,-20
106483784524,106483784527,3,1701,1519,-20
106484821208,106484821213,5,1875,1706,-20
106485295476,106485295474,-2,2139,4527,-20
106487292891,106487292895,4,2260,1732,-20
106490630170,106490630171,1,1102,1230,-20
106494554874,106494554876,2,2446,1494,-20
106496515794,106496515797,3,1315,1706,-20
106498453042,106498453045,3,1592,1306,-20
106499486511,106499486514,3,2008,1326,-20
106504240075,106504240078,3,1947,1340,-20
106507310015,106507310018,3,1651,1019,-20
106510798746,106510798751,5,1324,975,-20
106518992310,106518992310,0,1425,1812,-20
106520728983,106520728985,2,1523,1101,-20
106522110933,106522110941,8,1985,1555,-20
106522147673,106522147680,7,1354,994,-20
106522536078,106522536080,2,2166,2848,-20
106533005710,106533005713,3,2143,1776,-20
106533162426,106533162426,0,9539,11842,-20
106536128263,106536128266,3,1298,968,-20
106536736426,106536736428,2,1449,1728,-20
106541292223,106541292226,3,1945,2046,-20
106542317279,106542317281,2,1296,1738,-20
106550710644,106550710649,5,2690,1385,-20
106552008110,106552008115,5,1978,1485,-20
106552117872,106552117875,3,1467,1250,-20
106558260427,106558260430,3,930,1496,-20
106558907513,106558907518,5,2434,1561,-20
106560006858,106560006863,5,1833,1552,-20
106562300397,106562300402,5,1725,1199,-20
106564082756,106564082758,2,1465,1052,-20
106566486825,106566486847,22,1389,1278,-20
106568296601,106568296601,0,1243,1237,-20
106571061907,106571061910,3,1487,1772,-20
106573042036,106573042038,2,2190,1104,-20
106575628505,106575628506,1,1408,1167,-20
106577107003,106577107007,4,1963,1654,-20
106577712965,106577712964,-1,1258,1271,-20
106578693289,106578693286,-3,1554,2493,-20
106579129503,106579129507,4,2261,1304,-20
106580661503,106580661500,-3,1573,3335,-20
106581461506,106581461509,3,1705,1711,-20
106582196969,106582196971,2,1760,1366,-20
106584538933,106584538936,3,1623,1180,-20
106584971874,106584971877,3,2425,1650,-20
106585106519,106585106521,2,1398,1401,-20
106589155007,106589155011,4,2273,1725,-20
106589584922,106589584926,4,2258,1492,-20
106592932400,106592932407,7,1650,1248,-20
106593441478,106593441487,9,10639,1229,-20
106596295219,106596295223,4,1901,2040,-20
106596383975,106596383978,3,1696,1430,-20
106599461209,106599461213,4,1350,1532,-20
106601348618,106601348622,4,1815,1749,-20
106605373345,106605373346,1,2087,1363,-20
106606574679,106606574678,-1,1472,2826,-20
106610499929,106610499932,3,2131,1155,-20
106615645658,106615645662,4,2012,1907,-20
106617288825,106617288827,2,2007,1315,-20
106618714355,106618714359,4,2522,1627,-20
106620773363,106620773366,3,1317,944,-20
106622313347,106622313351,4,2150,1550,-20
106633450490,106633450495,5,1450,1398,-20
106637147122,106637147125,3,1764,1519,-20
106643142637,106643142640,3,2479,1982,-20
106643731750,106643731747,-3,732,566,-20
106645142813,106645142818,5,1159,1060,-20
106645841995,106645841999,4,1508,1089,-20
106649334253,106649334255,2,1842,1445,-20
106654115126,106654115128,2,1739,1555,-20
106656528361,106656528365,4,1556,1220,-20
106657945180,106657945181,1,1551,1329,-20
106658113551,106658113555,4,1132,916,-20
106663096042,106663096047,5,1860,1353,-20
106665502885,106665502891,6,2602,1192,-20
106671765009,106671765013,4,2336,1798,-20
106672496916,106672496920,4,2573,1929,-20
106674288240,106674288243,3,1732,1199,-20
106676869734,106676869739,5,1028,984,-20
106680845010,106680845014,4,2155,1357,-20
106681059734,106681059737,3,2238,1604,-20
106681329806,106681329809,3,2889,1508,-20
106682992485,106682992487,2,1676,1169,-20
106686839397,106686839398,1,1658,2060,-20
106690996483,106690996487,4,1928,1618,-20
106692500410,106692500414,4,2090,1793,-20
106692647625,106692647628,3,804,1372,-20
106693905237,106693905225,-12,1024,4779,-20
106695483594,106695483598,4,1708,1634,-20
106695518316,106695518318,2,2254,1222,-20
106695641954,106695641958,4,1605,1719,-20
106697082557,106697082559,2,1960,2253,-20
106698625423,106698625426,3,1088,1053,-20
106698868693,106698868716,23,1856,999,-20
106699028488,106699028490,2,2218,1214,-20
106700463873,106700463874,1,2335,1313,-20
106701330232,106701330235,3,1676,1420,-20
106708256437,106708256440,3,1754,1991,-20
106708806075,106708806079,4,1482,1487,-20
106709250272,106709250276,4,1371,1078,-20
106713409065,106713409067,2,1413,817,-20
106713746070,106713746070,0,1580,1560,-20
106714641192,106714641186,-6,1284,4591,-20
106715052749,106715052752,3,1920,1466,-20
106715399089,106715399092,3,2413,1690,-20
106717487338,106717487339,1,1867,1660,-20
106717808080,106717808082,2,2152,2138,-20
106717888059,106717888058,-1,1809,2358,-20
106719667410,106719667415,5,1538,1045,-20
106728279305,106728279308,3,2661,1759,-20
106729709109,106729709111,2,2171,1165,-20
106730634862,106730634866,4,2155,1978,-20
106730695389,106730695391,2,1571,1306,-20
106732276289,106732276295,6,1922,1102,-20
106733197687,106733197683,-4,31304,17968,-20
106738741664,106738741667,3,1850,1289,-20
106742874163,106742874167,4,1329,1343,-20
106744164842,106744164847,5,1647,1178,-20
106745905189,106745905193,4,992,907,-20
106746288317,106746288315,-2,1111,2343,-20
106752187473,106752187476,3,1568,1388,-20
106755312846,106755312851,5,4969,1619,-20
106769088791,106769088795,4,1853,1206,-20
106770383378,106770383382,4,3708,1489,-20
106770711879,106770711882,3,960,1378,-20
106771864761,106771864763,2,2138,1462,-20
106772924167,106772924171,4,1737,1633,-20
106773685175,106773685178,3,1561,1144,-20
106775609479,106775609482,3,2224,1376,-20
106776019003,106776019006,3,2126,1487,-20
106776293970,106776293974,4,1053,760,-20
106777526988,106777526972,-16,1704,1625,-20
106781532095,106781532095,0,2828,3601,-20
106782835426,106782835431,5,3241,802,-20
106788364420,106788364425,5,1609,1429,-20
106789022973,106789022978,5,2064,1618,-20
106792767391,106792767394,3,2148,1532,-20
106793619230,106793619234,4,1670,1305,-20
106793766779,106793766784,5,1777,1439,-20
106797175859,106797175862,3,1945,1807,-20
106802608365,106802608367,2,1308,1257,-20
106802796491,106802796495,4,1320,1282,-20
106804386858,106804386862,4,1197,1092,-20
106807062538,106807062540,2,1441,1470,-20
106810927201,106810927206,5,1764,1247,-20
106812070892,106812070895,3,1685,1372,-20
106813055157,106813055162,5,2104,1154,-20
106814780844,106814780846,2,1783,1294,-20
106815099985,106815099988,3,1422,1662,-20
106816827933,106816827914,-19,1755,1052,-20
106820208305,106820208309,4,1218,1457,-20
106821448049,106821448051,2,2279,1143,-20
106823469501,106823469505,4,2011,1556,-20
106824130543,106824130547,4,1361,1487,-20
106826190957,106826190958,1,1332,1800,-20
106827934998,106827935001,3,1900,1324,-20
106828790210,106828790213,3,2499,1768,-20
106829188966,106829188969,3,1539,961,-20
106831626389,106831626394,5,2830,1408,-20
106831801499,106831801503,4,1769,1805,-20
106833341538,106833341539,1,1549,1197,-20
106835062234,106835062239,5,2113,1457,-20
106835786870,106835786874,4,2044,1845,-20
106837253637,106837253640,3,1684,1328,-20
106837878348,106837878351,3,2215,1284,-20
106841543030,106841543035,5,2112,1669,-20
106843370665,106843370671,6,2414,1705,-20
106849519609,106849519614,5,2176,1235,-20
106850261955,106850261958,3,2099,1319,-20
106850699028,106850699030,2,1238,1404,-20
106853680388,106853680390,2,2025,1331,-20
106855286293,106855286296,3,1872,1812,-20
106857716639,106857716643,4,2055,1200,-20
106857943004,106857942987,-17,2147,1769,-20
106861099645,106861099639,-6,1790,4641,-20
106863080006,106863080010,4,1514,1308,-20
106864333317,106864333318,1,1503,1657,-20
106867852909,106867852913,4,2086,1432,-20
106867916653,106867916655,2,1982,1824,-20
106868542518,106868542522,4,2109,1340,-20
106868875026,106868875030,4,2046,1203,-20
106868907697,106868907701,4,2341,1870,-20
106871233518,106871233522,4,1547,1424,-20
106873185848,106873185849,1,2177,1872,-20
106874386191,106874386194,3,1650,902,-20
106875852110,106875852090,-20,1698,1724,-20
106876028829,106876028833,4,2139,1552,-20
106877202362,106877202364,2,1542,1641,-20
106878670581,106878670560,-21,1410,987,-20
106883857658,106883857659,1,1816,1401,-20
106885002669,106885002667,-2,1115,1626,-20
106885313827,106885313829,2,99,1389,-20
106892646368,106892646374,6,2955,1355,-20
106896705282,106896705283,1,1034,1207,-20
106897925021,106897925026,5,3086,1129,-20
106901488798,106901488802,4,1044,889,-20
106902689729,106902689733,4,1951,1442,-20
106908996504,106908996507,3,1470,1325,-20
106909432273,106909432278,5,1876,1544,-20
106912607043,106912607046,3,1940,1180,-20
106913050090,106913050093,3,1836,1326,-20
106914823312,106914823317,5,1681,1439,-20
106919096094,106919096098,4,1448,1304,-20
106919255114,106919255096,-18,1017,1167,-20
106921277721,106921277723,2,2288,1737,-20
106922061138,106922061141,3,1296,1269,-20
106922868248,106922868236,-12,829,343,-20
106927348003,106927348006,3,2101,1810,-20
106927373731,106927373733,2,1226,1273,-20
106931758007,106931758010,3,1568,1380,-20
106932462118,106932462121,3,1122,1533,-20
106933602141,106933602144,3,1455,1039,-20
106934248122,106934248125,3,2240,1851,-20
106938350786,106938350789,3,1762,1703,-20
106938699178,106938699165,-13,1316,1298,-20
106946037263,106946037267,4,2206,1234,-20
106947832906,106947832910,4,1754,1305,-20
106951568088,106951568087,-1,1616,1584,-20
106954064650,106954064654,4,3045,1189,-20
106954541897,106954541903,6,3320,1145,-20
106955775122,106955775125,3,2211,1656,-20
106957865578,106957865583,5,1619,1576,-20
106962900057,106962900061,4,1454,1759,-20
106964908152,106964908152,0,1661,1332,-20
106967159914,106967159919,5,1603,1321,-20
106969873666,106969873669,3,1998,1599,-20
106977325296,106977325298,2,1447,1536,-20
106979859442,106979859445,3,1792,2000,-20
106981393622,106981393626,4,1331,1036,-20
106983033056,106983033060,4,1470,1272,-20
106986427857,106986427860,3,1795,1200,-20
106987144286,106987144287,1,1683,1594,-20
106988988893,106988988896,3,2145,1692,-20
107002017757,107002017763,6,1507,1060,-20
107004179377,107004179382,5,1382,1393,-20
107004634430,107004634430,0,1179,1655,-20
107004879881,107004879884,3,1563,1483,-20
107006570844,107006570850,6,5788,2842,-20
107007574570,107007574562,-8,785,3150,-20
107008827252,107008827254,2,2374,2002,-20
107009219984,107009219988,4,2043,2260,-20
107010880564,107010880567,3,2396,1314,-20
107011342994,107011342998,4,1727,1454,-20
107014588982,107014588985,3,2021,2300,-20
107017194495,107017194500,5,1969,1140,-20
107017722523,107017722527,4,2258,1126,-20
107021933237,107021933241,4,1650,1495,-20
107026642146,107026642149,3,1957,1824,-20
107027235559,107027235561,2,1701,1215,-20
107030369177,107030369175,-2,1024,2634,-20
107032710775,107032710779,4,1945,1846,-20
107032758515,107032758518,3,1564,1403,-20
107033549398,107033549402,4,1686,1567,-20
107034557198,107034557199,1,832,889,-20
107035649351,107035649360,9,1820,1311,-20
107036207366,107036207385,19,2176,1599,-20
107038001962,107038001965,3,2018,1628,-20
107039110922,107039110924,2,2119,1886,-20
107043299832,107043299834,2,966,1073,-20
107055812278,107055812283,5,1980,1226,-20
107056809218,107056809221,3,63,1498,-20
107059860035,107059860034,-1,52758,23021,-20
107061216599,107061216618,19,1158,1335,-20
107061485783,107061485784,1,1516,1059,-20
107062259202,107062259206,4,2084,2048,-20
107070301462,107070301466,4,1559,1399,-20
107073432870,107073432875,5,1845,1381,-20
107075557901,107075557903,2,2234,1403,-20
107078094032,107078094036,4,1588,1818,-20
107082657878,107082657882,4,2282,1819,-20
107082843486,107082843489,3,1645,1291,-20
107085982566,107085982567,1,1886,1434,-20
107087813328,107087813334,6,1517,1419,-20
107089271132,107089271118,-14,897,781,-20
107091291973,107091291976,3,3210,1675,-20
107092603072,107092603075,3,1355,1049,-20
107097889668,107097889670,2,1721,1206,-20
107098529795,107098529799,4,1450,1223,-20
107102046508,107102046511,3,1349,1030,-20
107107535527,107107535529,2,1527,1179,-20
107107806237,107107806241,4,1669,1073,-20
107108603271,107108603270,-1,1351,2431,-20
107109789132,107109789134,2,1148,1063,-20
107110918845,107110918850,5,1870,1464,-20
107114111421,107114111422,1,2312,2204,-20
107116164116,107116164118,2,1865,1249,-20
107119441560,107119441563,3,2160,1543,-20
107119916123,107119916124,1,1660,1141,-20
107128433759,107128433754,-5,1103,3267,-20
107130319761,107130319763,2,1496,1172,-20
107131530513,107131530517,4,1811,1125,-20
107132178971,107132178974,3,1635,1873,-20
107132948077,107132948082,5,1564,1261,-20
107135498959,107135498963,4,1382,997,-20
107138330542,107138330546,4,1830,1509,-20
107138633070,107138633074,4,1875,1250,-20
107139679369,107139679374,5,2646,1602,-20
107145316257,107145316260,3,2236,1688,-20
107148695522,107148695527,5,1607,1177,-20
107152894286,107152894290,4,2926,1707,-20
107153014821,107153014823,2,1950,1807,-20
107158892786,107158892790,4,1859,1453,-20
107159937263,107159937243,-20,1139,713,-20
107161400413,107161400415,2,1774,1663,-20
107165275617,107165275622,5,970,965,-20
107165403181,107165403183,2,2129,3061,-20
107165626112,107165626115,3,2220,2135,-20
107172125409,107172125413,4,2151,1746,-20
107172986272,107172986274,2,1470,1689,-20
107175564342,107175564346,4,1700,1487,-20
107180291585,107180291590,5,1870,1479,-20
107183662027,107183662030,3,3071,3088,-20
107189429264,107189429266,2,1206,1363,-20
107191994273,107191994277,4,1990,1916,-20
107192668420,107192668422,2,1745,1471,-20
107196608762,107196608766,4,1763,1488,-20
107197699012,107197699015,3,1557,1069,-20
107198738563,107198738567,4,1698,1253,-20
107206263517,107206263521,4,2062,1437,-20
107206468414,107206468421,7,1470,1955,-20
107212700420,107212700423,3,2398,1801,-20
107216600515,107216600517,2,1711,1200,-20
107218364174,107218364179,5,1274,1388,-20
107219126927,107219126930,3,1500,1555,-20
107223532932,107223532935,3,1381,1204,-20
107225362619,107225362623,4,1734,1656,-20
107227250528,107227250532,4,1868,1435,-20
107227306905,107227306908,3,1826,1549,-20
107227947716,107227947719,3,2351,1468,-20
107228333690,107228333694,4,1546,1104,-20
107232475697,107232475702,5,1844,1287,-20
107234592616,107234592618,2,1481,1707,-20
107238325415,107238325417,2,1876,1652,-20
107238571490,107238571494,4,2077,1600,-20
107239530822,107239530827,5,2733,1496,-20
107241020553,107241020553,0,1550,2356,-20
107241887423,107241887423,0,1834,1905,-20
107243070050,107243070053,3,1324,1145,-20
107243574115,107243574119,4,1289,943,-20
107243687817,107243687803,-14,1514,853,-20
107243903485,107243903486,1,1839,1306,-20
107247218766,107247218769,3,1996,1414,-20
107247395846,107247395847,1,1434,1186,-20
107247475688,107247475674,-14,164,1427,-20
107248920544,107248920546,2,1583,1131,-20
107254202532,107254202534,2,1539,1104,-20
107254832298,107254832302,4,2036,1469,-20
107256003524,107256003526,2,2519,1664,-20
107257716494,107257716490,-4,22988,11934,-20
107260172724,107260172722,-2,1152,1166,-20
107261348815,107261348819,4,1835,1475,-20
107265460927,107265460932,5,3183,2646,-20
107265936621,107265936626,5,2514,1469,-20
107266775085,107266775086,1,1339,1028,-20
107269146498,107269146502,4,1864,1346,-20
107271985727,107271985726,-1,1993,2285,-20
107273810065,107273810069,4,2299,1761,-20
107277350246,107277350247,1,1024,1420,-20
107284539978,107284539980,2,1042,1318,-20
107285024383,107285024384,1,1891,1504,-20
107285217683,107285217685,2,2099,2287,-20
107285879730,107285879732,2,1305,1723,-20
107286089486,107286089487,1,1243,1661,-20
107288097903,107288097907,4,1691,1208,-20
107288372559,107288372538,-21,1199,722,-20
107289607845,107289607846,1,726,627,-20
107291222880,107291222883,3,2365,1936,-20
107293528658,107293528661,3,1748,1252,-20
107296851029,107296851031,2,1400,1124,-20
107296883902,107296883883,-19,1871,1491,-20
107297822633,107297822634,1,1997,1796,-20
107298017506,107298017499,-7,3383,9493,-20
107300569494,107300569497,3,1930,1934,-20
107302368946,107302368949,3,4139,2743,-20
107304108262,107304108267,5,914,874,-20
107305624462,107305624467,5,1662,1180,-20
107308995705,107308995707,2,1193,1002,-20
107312102922,107312102926,4,2739,1421,-20
107313629283,107313629283,0,2227,1631,-20
107314012419,107314012423,4,1541,1223,-20
107314346742,107314346747,5,1481,971,-20
107318809271,107318809274,3,1673,1146,-20
107325964509,107325964514,5,1858,1259,-20
107326130922,107326130925,3,1597,1462,-20
107327527809,107327527815,6,2206,1393,-20
107328229221,107328229222,1,1095,1135,-20
107332413290,107332413285,-5,3566,10010,-20
107335054178,107335054184,6,1775,1536,-20
107336953862,107336953864,2,1610,1984,-20
107341003776,107341003770,-6,823,4111,-20
107342127049,107342127051,2,1433,1057,-20
107342374357,107342374362,5,1330,1080,-20
107347525434,107347525436,2,2160,1409,-20
107348323938,107348323938,0,1893,1525,-20
107353151295,107353151297,2,1577,1387,-20
107355467832,107355467835,3,2176,1035,-20
107370226828,107370226830,2,2747,1842,-20
107370665558,107370665561,3,2243,1439,-20
107371624442,107371624443,1,1401,1731,-20
107376577510,107376577516,6,2177,1503,-20
107380798494,107380798496,2,1594,1309,-20
107383846904,107383846902,-2,1055,2288,-20
107384682460,107384682466,6,4168,1466,-20
107385687254,107385687258,4,2138,1862,-20
107390905303,107390905307,4,2625,1590,-20
107390930417,107390930419,2,1325,1052,-20
107392554938,107392554939,1,1554,1190,-20
107397024427,107397024430,3,2452,1029,-20
107402914429,107402914430,1,1795,1861,-20
107405279123,107405279127,4,1542,1585,-20
107406343054,107406343056,2,2499,1331,-20
107408685506,107408685511,5,719,717,-20
107412272970,107412272974,4,1927,1105,-20
107415189147,107415189151,4,1662,1262,-20
107416769906,107416769910,4,1650,1221,-20
107417374939,107417374941,2,2154,1847,-20
107418077664,107418077666,2,1450,1424,-20
107421171660,107421171663,3,2144,1312,-20
107421891843,107421891845,2,2716,1978,-20
107433417606,107433417607,1,1180,1663,-20
107436742611,107436742614,3,1771,1541,-20
107437859758,107437859759,1,1493,1560,-20
107438067683,107438067687,4,1714,1299,-20
107438999689,107438999692,3,1680,1220,-20
107439593842,107439593845,3,1236,1116,-20
107440013298,107440013302,4,1814,1425,-20
107445145655,107445145657,2,1395,1401,-20
107446085502,107446085498,-4,1159,3500,-20
107448960366,107448960370,4,1740,1832,-20
107449080334,107449080338,4,1344,1171,-20
107451629410,107451629411,1,1308,1400,-20
107452100065,107452100073,8,3392,898,-20
107457807548,107457807551,3,1883,1313,-20
107458779701,107458779704,3,1559,1199,-20
107464365639,107464365645,6,2850,1708,-20
107468033843,107468033847,4,1417,1284,-20
107469677582,107469677584,2,1564,2019,-20
107471492246,107471492250,4,2088,1768,-20
107479978828,107479978833,5,1907,1375,-20
107481638186,107481638190,4,1330,1087,-20
107487455057,107487455062,5,881,748,-20
107489042769,107489042771,2,979,891,-20
107489900589,107489900594,5,2131,1421,-20
107496363490,107496363495,5,1815,1645,-20
107496985854,107496985857,3,1786,2213,-20
107499919777,107499919779,2,1515,1437,-20
107501255099,107501255102,3,2052,1659,-20
107501413617,107501413614,-3,1080,1598,-20
107501505234,107501505237,3,1147,1119,-20
107503695458,107503695461,3,1735,1546,-20
107505768919,107505768936,17,1095,752,-20
107507321945,107507321945,0,2623,3826,-20
107507525706,107507525707,1,1665,1473,-20
107508353212,107508353215,3,1465,1578,-20
107510138479,107510138474,-5,2452,5714,-20
107515399911,107515399914,3,1751,1459,-20
107519216082,107519216086,4,2198,2012,-20
107526485331,107526485334,3,2063,1628,-20
107527091758,107527091760,2,1583,1521,-20
107529599719,107529599726,7,1963,1189,-20
107530570175,107530570178,3,2538,1502,-20
107533876129,107533876125,-4,1394,3607,-20
107535511097,107535511099,2,2828,1785,-20
107539057347,107539057346,-1,41836,18540,-20
107540116993,107540116995,2,1767,1972,-20
107540418911,107540418914,3,1425,1314,-20
107541035962,107541035966,4,1457,1534,-20
107541827063,107541827067,4,1648,1229,-20
107542642984,107542642982,-2,1085,1703,-20
107544127619,107544127622,3,1558,1193,-20
107545081776,107545081770,-6,931,3395,-20
107548602730,107548602732,2,1528,1493,-20
107549019000,107549019000,0,31614,26426,-20
107549891874,107549891877,3,2629,1629,-20
107551471514,107551471518,4,1755,1331,-20
107554552125,107554552128,3,1283,1386,-20
107554921811,107554921814,3,1373,1285,-20
107555179097,107555179100,3,1372,793,-20
107557140439,107557140442,3,1544,1599,-20
107561959239,107561959243,4,1085,1108,-20
107562721634,107562721638,4,3192,2039,-20
107565128476,107565128479,3,1981,1109,-20
107569551184,107569551186,2,1646,1299,-20
107572776146,107572776148,2,1354,1225,-20
107574354158,107574354161,3,2454,1308,-20
107575236544,107575236546,2,1450,1359,-20
107581028996,107581028998,2,1691,1306,-20
107584880647,107584880651,4,1239,1053,-20
107589714204,107589714206,2,1483,1138,-20
107592084810,107592084814,4,2134,1525,-20
107593236266,107593236269,3,1535,888,-20
107593930236,107593930232,-4,1564,4256,-20
107595960244,107595960245,1,1598,2620,-20
107599932479,107599932485,6,1696,1200,-20
107603362322,107603362327,5,1677,1682,-20
107604341659,107604341665,6,3077,1165,-20
107604774522,107604774526,4,1481,1076,-20
107605709407,107605709411,4,1927,1693,-20
107609826757,107609826761,4,1553,1588,-20
107612115729,107612115738,9,13759,30612,-20
107612856511,107612856513,2,1915,1520,-20
107615097223,107615097234,11,355,2068,-20
107615249197,107615249202,5,2529,1266,-20
107616705259,107616705259,0,1010,1278,-20
107619498479,107619498482,3,1570,1205,-20
107621108351,107621108354,3,2450,1682,-20
107624780958,107624780960,2,1889,1534,-20
107625003291,107625003272,-19,1647,1542,-20
107626514646,107626514647,1,1472,1574,-20
107636235984,107636235987,3,1567,1645,-20
107637419141,107637419143,2,1682,837,-20
107645919111,107645919115,4,1948,1153,-20
107647361034,107647361038,4,2081,1437,-20
107649364505,107649364510,5,1852,1331,-20
107650323857,107650323861,4,1915,1488,-20
107652823364,107652823381,17,425,1449,-20
107655087650,107655087653,3,1861,1183,-20
107658816591,107658816594,3,2121,898,-20
107659748168,107659748170,2,2306,1369,-20
107668084134,107668084139,5,1633,1505,-20
107669222400,107669222401,1,1473,1306,-20
107669260605,107669260587,-18,1620,1407,-20
107672972389,107672972393,4,1990,1700,-20
107675159205,107675159206,1,952,765,-20
107677921636,107677921639,3,1494,1067,-20
107678728171,107678728174,3,847,880,-20
107683266641,107683266646,5,1893,1163,-20
107690081778,107690081779,1,1594,1269,-20
107696195862,107696195865,3,2076,1420,-20
107698727604,107698727604,0,1292,1517,-20
107698824965,107698824947,-18,1722,1430,-20
107699714718,107699714721,3,2528,1379,-20
107699959970,107699959979,9,1848,1789,-20
107701251095,107701251107,12,418,105,-20
107702677117,107702677120,3,2426,1835,-20
107704353954,107704353957,3,1359,1245,-20
107704519022,107704519000,-22,1815,1142,-20
107705386653,107705386656,3,1831,2083,-20
107706694211,107706694214,3,1872,1391,-20
107707561690,107707561690,0,951,1766,-20
107711112527,107711112530,3,1714,1530,-20
107713077863,107713077866,3,2050,1471,-20
107717813374,107717813375,1,1270,2062,-20
107718598442,107718598449,7,1250,959,-20
107719398231,107719398232,1,1958,1704,-20
107719727106,107719727109,3,1035,1199,-20
107724566827,107724566831,4,2639,1291,-20
107725233579,107725233583,4,1264,1207,-20
107727371150,107727371147,-3,1916,3759,-20
107728488746,107728488748,2,1432,1275,-20
107728875738,107728875747,9,1033,389,-20
107733380666,107733380670,4,2433,1255,-20
107736501582,107736501585,3,1439,1358,-20
107744911719,107744911722,3,1195,955,-20
107745158442,107745158446,4,1679,1575,-20
107748963294,107748963298,4,1927,1362,-20
107755303955,107755303959,4,2152,1516,-20
107761674782,107761674782,0,79,3533,-20
107772809007,107772809011,4,1191,1371,-20
107776455242,107776455246,4,1347,953,-20
107784339437,107784339442,5,2135,1326,-20
107788531074,107788531077,3,1895,1145,-20
107788605058,107788605064,6,3038,1608,-20
107789731052,107789731053,1,1590,1140,-20
107790211229,107790211235,6,2927,1045,-20
107791109046,107791109048,2,2169,1847,-20
107792969095,107792969098,3,2552,1631,-20
107800730625,107800730626,1,1500,1287,-20
107801928304,107801928306,2,2767,2101,-20
107801996118,107801996121,3,1399,1246,-20
107808375717,107808375720,3,2514,1673,-20
107811846726,107811846730,4,2240,1409,-20
107812893919,107812893923,4,1888,956,-20
107813494777,107813494778,1,1165,1254,-20
107814608130,107814608124,-6,1533,7799,-20
107815527654,107815527657,3,1462,1121,-20
107818126125,107818126129,4,2667,1830,-20
107820068478,107820068481,3,1365,1474,-20
107820194877,107820194881,4,1532,1393,-20
107822658877,107822658880,3,1495,1128,-20
107824999678,107824999678,0,1023,1365,-20
107825379217,107825379219,2,1488,1381,-20
107830199397,107830199397,0,1965,2740,-20
107833342165,107833342170,5,1954,1384,-20
107835498934,107835498940,6,1622,1111,-20
107837567666,107837567669,3,1533,1531,-20
107838564619,107838564639,20,307,1501,-20
107840615940,107840615942,2,1997,1631,-20
107853601771,107853601775,4,1495,1110,-20
107855297971,107855297974,3,2006,1387,-20
107857775511,107857775512,1,1048,961,-20
107858470474,107858470477,3,1578,1213,-20
107859270139,107859270142,3,1920,1075,-20
107860187083,107860187087,4,1319,1113,-20
107864993393,107864993398,5,1197,1029,-20
107865600662,107865600643,-19,2139,2231,-20
107866650981,107866650979,-2,1079,1548,-20
107869492667,107869492670,3,1151,1575,-20
107871035810,107871035814,4,956,656,-20
107874949535,107874949537,2,1390,1215,-20
107876839166,107876839169,3,2188,1410,-20
107878231866,107878231870,4,2448,1642,-20
107882659074,107882659077,3,2138,1441,-20
107884867369,107884867373,4,2688,1704,-20
107889250776,107889250777,1,1985,1843,-20
107889732758,107889732761,3,2687,1834,-20
107891033815,107891033818,3,2001,1476,-20
107891398235,107891398239,4,1028,794,-20
107891483317,107891483319,2,1947,1319,-20
107898013826,107898013830,4,1325,1098,-20
107902701690,107902701694,4,1691,1441,-20
107903544158,107903544162,4,1754,1209,-20
107904125220,107904125222,2,1917,1246,-20
107904921195,107904921193,-2,1171,2653,-20
107905019357,107905019360,3,1224,1203,-20
107907295672,107907295674,2,2241,1528,-20
107907676709,107907676711,2,1915,2158,-20
107908178104,107908178107,3,1606,1157,-20
107908850655,107908850661,6,1188,1066,-20
107911998626,107911998629,3,2550,1758,-20
107913906580,107913906573,-7,2114,11193,-20
107915781406,107915781387,-19,1441,1090,-20
107920359235,107920359238,3,1552,1149,-20
107924758929,107924758932,3,1855,1035,-20
107927244834,107927244838,4,1756,1647,-20
107928761177,107928761179,2,1867,1874,-20
107931023779,107931023783,4,1586,1439,-20
107932397318,107932397322,4,1536,1854,-20
107934062518,107934062521,3,1641,1955,-20
107935254218,107935254223,5,2271,1354,-20
107941394150,107941394153,3,1474,816,-20
107946036382,107946036382,0,1970,1818,-20
107951295615,107951295619,4,1420,1152,-20
107951535120,107951535122,2,2253,1746,-20
107952840022,107952840027,5,1682,1584,-20
107953238883,107953238881,-2,519,494,-20
107961403597,107961403598,1,7413,7134,-20
107962927277,107962927279,2,2139,1336,-20
107964079328,107964079332,4,2086,1429,-20
107968777715,107968777697,-18,38688,18744,-20
107970931939,107970931938,-1,11742,48092,-20
107973981362,107973981365,3,1727,1496,-20
107974373718,107974373721,3,1992,1086,-20
107976230960,107976230963,3,2414,1677,-20
107976464556,107976464560,4,1945,1859,-20
107976588220,107976588235,15,2019,1220,-20
107980558750,107980558754,4,1815,1458,-20
107982816322,107982816322,0,1458,2055,-20
107983858325,107983858327,2,1404,1109,-20
107987185810,107987185814,4,2171,1364,-20
107987874057,107987874058,1,1784,1181,-20
107989663230,107989663234,4,1325,1469,-20
107998945294,107998945297,3,1787,1964,-20
108000176925,108000176930,5,1592,1062,-20
108005706520,108005706523,3,1908,1461,-20
108007386433,108007386433,0,1818,1175,-20
108008057617,108008057619,2,1983,1669,-20
108008527746,108008527748,2,1822,1449,-20
108011308206,108011308198,-8,21298,17995,-20
108013065800,108013065806,6,2556,1168,-20
108013917679,108013917686,7,3242,1578,-20
108014047393,108014047394,1,1265,1154,-20
108014219049,108014219054,5,1197,1169,-20
108018143017,108018143019,2,1137,1151,-20
108021313661,108021313665,4,1531,1435,-20
108027795697,108027795698,1,1944,1270,-20
108031004954,108031004957,3,1668,1722,-20
108032151334,108032151339,5,1545,1354,-20
108032708540,108032708534,-6,2303,8878,-20
108035392142,108035392146,4,1969,1305,-20
108039834038,108039834042,4,1786,1441,-20
108042079494,108042079499,5,1226,1159,-20
108042981609,108042981614,5,1743,1741,-20
108043188865,108043188870,5,1543,825,-20
108043886422,108043886426,4,1765,1238,-20
108048318089,108048318090,1,1395,1378,-20
108050889498,108050889502,4,1419,1108,-20
108051199974,108051199987,13,1650,1213,-20
108051690541,108051690543,2,1447,1153,-20
108052677137,108052677138,1,1726,1515,-20
108062291109,108062291114,5,1280,1332,-20
108065591826,108065591829,3,1317,842,-20
108067847037,108067847041,4,2046,1412,-20
108072287301,108072287306,5,2141,1536,-20
108075124234,108075124238,4,2046,1175,-20
108076861081,108076861083,2,1885,1931,-20
108077848753,108077848755,2,1243,1212,-20
108078581638,108078581642,4,2013,1349,-20
108079916699,108079916705,6,1590,1406,-20
108080834754,108080834759,5,2106,1220,-20
108083632682,108083632683,1,1303,721,-20
108087649489,108087649493,4,1362,1352,-20
108088571400,108088571421,21,425,1818,-20
108088815966,108088815970,4,2151,1729,-20
108088938041,108088938042,1,1620,1897,-20
108092637839,108092637842,3,675,482,-20
108094110319,108094110324,5,1959,1424,-20
108095328511,108095328504,-7,1452,7594,-20
108096531847,108096531853,6,1748,1078,-20
108097275171,108097275153,-18,1555,1125,-20
108099206565,108099206563,-2,1114,2470,-20
108100253866,108100253871,5,2292,1708,-20
108100458470,108100458473,3,1722,1430,-20
108108364426,108108364430,4,1785,1387,-20
108108604900,108108604903,3,2875,1670,-20
108108833976,108108833982,6,1895,1026,-20
108109738537,108109738539,2,1837,1471,-20
108113023565,108113023567,2,2014,1202,-20
108113104519,108113104526,7,1341,1000,-20
108113272549,108113272546,-3,909,1807,-20
108114601793,108114601791,-2,5357,7540,-20
108115782459,108115782463,4,1756,1688,-20
108119833105,108119833111,6,1881,1857,-20
108121535150,108121535154,4,1887,1683,-20
108123232634,108123232643,9,1979,903,-20
108123335368,108123335371,3,1194,924,-20
108124746760,108124746761,1,1926,2379,-20
108125110427,108125110431,4,1683,819,-20
108134775866,108134775871,5,2020,1078,-20
108135022043,108135022045,2,1482,1701,-20
108135279085,108135279089,4,7401,35706,-20
108136067601,108136067605,4,1899,1546,-20
108138376990,108138376993,3,1731,2118,-20
108140235470,108140235476,6,1831,1328,-20
108144146198,108144146202,4,1412,1310,-20
108144774110,108144774112,2,1260,1128,-20
108149612139,108149612143,4,6052,24213,-20
108152833574,108152833580,6,7082,3306,-20
108156507368,108156507369,1,1589,1720,-20
108158416744,108158416741,-3,1943,3065,-20
108158996095,108158996099,4,2588,1813,-20
108164551401,108164551405,4,1561,1281,-20
108165231502,108165231494,-8,1976,10133,-20
108168522920,108168522924,4,1866,1460,-20
108168634734,108168634737,3,1356,1219,-20
108173566517,108173566520,3,2498,1138,-20
108175280978,108175280962,-16,1773,1285,-20
108178731627,108178731631,4,1732,1465,-20
108182373130,108182373133,3,1981,1409,-20
108184501894,108184501895,1,1905,2110,-20
108185457598,108185457602,4,1902,1776,-20
108186478497,108186478502,5,1335,925,-20
108190452705,108190452708,3,1948,1426,-20
108193830284,108193830298,14,2040,1493,-20
108193948564,108193948569,5,1931,1484,-20
108195621626,108195621629,3,1605,1243,-20
108201747515,108201747514,-1,2717,3265,-20
108201856568,108201856570,2,1710,1229,-20
108211169357,108211169361,4,1294,1061,-20
108211994696,108211994698,2,2205,2588,-20
108212038662,108212038663,1,905,1062,-20
108214165794,108214165798,4,1480,1164,-20
108218352583,108218352585,2,1576,1367,-20
108219738747,108219738750,3,1490,1505,-20
108221809491,108221809496,5,2465,1340,-20
108234734658,108234734662,4,2059,1690,-20
108238475977,108238475979,2,1914,1867,-20
108240936491,108240936495,4,1586,1454,-20
108241718389,108241718393,4,2354,1690,-20
108242431309,108242431314,5,1054,95,-20
108243840815,108243840820,5,806,912,-20
108246386726,108246386729,3,1557,1218,-20
108247605953,108247605957,4,1670,1073,-20
108248007223,108248007228,5,1628,1773,-20
108249019843,108249019839,-4,1468,2612,-20
108249144316,108249144319,3,2310,1916,-20
108251460963,108251460968,5,1777,1308,-20
108254285815,108254285818,3,2307,1179,-20
108257005439,108257005441,2,1497,1414,-20
108260195076,108260195079,3,1850,1317,-20
108263749751,108263749754,3,2060,1791,-20
108264053602,108264053606,4,1028,1098,-20
108265182660,108265182662,2,1963,1368,-20
108265548777,108265548779,2,1285,1242,-20
108268672798,108268672802,4,2466,2060,-20
108269720334,108269720338,4,2252,1783,-20
108273287469,108273287474,5,1642,1026,-20
108277921821,108277921826,5,2107,1520,-20
108280998398,108280998399,1,1955,1444,-20
108283842888,108283842892,4,1362,1422,-20
108284710428,108284710433,5,1466,1562,-20
108288914749,108288914755,6,1840,1547,-20
108291168534,108291168538,4,979,1113,-20
108294044930,108294044935,5,2783,1242,-20
108294091945,108294091950,5,829,738,-20
108297741652,108297741657,5,2268,1625,-20
108298558459,108298558450,-9,750,1636,-20
108298902281,108298902282,1,2151,1613,-20
108300656170,108300656173,3,1750,1251,-20
108301706929,108301706931,2,1328,1338,-20
108301880424,108301880426,2,2214,2157,-20
108303549841,108303549839,-2,20562,56816,-20
108305042935,108305042938,3,1586,1728,-20
108307173655,108307173657,2,2432,1626,-20
108308413684,108308413667,-17,2436,1911,-20
108309134089,108309134091,2,1823,1110,-20
108310925490,108310925495,5,2274,1573,-20
108311539974,108311539977,3,1462,1147,-20
108314029347,108314029325,-22,1056,863,-20
108314064425,108314064410,-15,1797,1084,-20
108316102545,108316102548,3,1557,1355,-20
108321722474,108321722478,4,2679,1589,-20
108322111613,108322111615,2,2174,1194,-20
108323461069,108323461073,4,1780,1430,-20
108327268988,108327268983,-5,1186,2910,-20
108328759822,108328759826,4,1894,1514,-20
108330367523,108330367517,-6,1059,2894,-20
108331578620,108331578624,4,2201,1263,-20
108333416477,108333416479,2,1256,1193,-20
108335096156,108335096159,3,1691,1342,-20
108337491493,108337491487,-6,806,1946,-20
108340242827,108340242825,-2,1003,1096,-20
108342275033,108342275038,5,2301,1253,-20
108343799453,108343799455,2,1710,1636,-20
108344488645,108344488649,4,2561,1440,-20
108354870596,108354870599,3,1833,1357,-20
108356545241,108356545244,3,2318,1950,-20
108356878212,108356878195,-17,1769,624,-20
108357636205,108357636208,3,2172,1827,-20
108359370126,108359370131,5,1679,1144,-20
108360801838,108360801841,3,1401,1026,-20
108362238872,108362238877,5,1349,910,-20
108366348431,108366348435,4,1515,1417,-20
108370488589,108370488594,5,1578,1179,-20
108371064993,108371064997,4,1409,1183,-20
108371288596,108371288601,5,1665,1629,-20
108374016495,108374016497,2,1931,1551,-20
108375204415,108375204418,3,2045,1377,-20
108375449780,108375449782,2,1774,1198,-20
108378917713,108378917714,1,1597,1069,-20
108382025347,108382025351,4,1420,1226,-20
108395556838,108395556843,5,1888,1341,-20
108397652146,108397652153,7,2215,1605,-20
108397973028,108397973031,3,2019,1981,-20
108402998330,108402998335,5,1640,1615,-20
108405648706,108405648710,4,9163,5126,-20
108407456385,108407456388,3,1492,1271,-20
108413032396,108413032392,-4,2150,5604,-20
108413833172,108413833174,2,1503,1178,-20
108414966830,108414966833,3,2059,1942,-20
108415388782,108415388786,4,1825,1795,-20
108417728609,108417728611,2,1926,1492,-20
108418983910,108418983913,3,2419,1541,-20
108421172748,108421172751,3,1381,914,-20
108425008237,108425008239,2,1161,625,-20
108427683719,108427683723,4,2649,2038,-20
108437003686,108437003691,5,1826,1308,-20
108440392553,108440392557,4,2267,1571,-20
108441601802,108441601806,4,1637,1467,-20
108445183171,108445183175,4,1235,789,-20
108445504307,108445504311,4,2096,1321,-20
108445600193,108445600188,-5,1163,391,-20
108449969213,108449969215,2,1320,1198,-20
108451600262,108451600266,4,2531,1938,-20
108452262507,108452262509,2,1591,1538,-20
108452384284,108452384284,0,2172,2397,-20
108453387206,108453387209,3,1693,1240,-20
108454619885,108454619893,8,2484,1293,-20
108455052294,108455052299,5,1653,1097,-20
108455830566,108455830570,4,2619,1420,-20
108456855164,108456855166,2,1477,1093,-20
108457401597,108457401619,22,1321,1351,-20
108462124346,108462124352,6,5119,2488,-20
108462941867,108462941869,2,1495,1321,-20
108466487138,108466487141,3,1519,1881,-20
108472671822,108472671829,7,2791,1292,-20
108476236386,108476236392,6,1690,1043,-20
108477372333,108477372335,2,1500,1602,-20
108478565365,108478565369,4,1542,1436,-20
108481190993,108481190998,5,1724,1405,-20
108483449244,108483449248,4,1499,1180,-20
108485924820,108485924822,2,1833,1163,-20
108486330778,108486330778,0,1308,1483,-20
108489211139,108489211139,0,1256,1300,-20
108490027145,108490027149,4,3143,1458,-20
108490300818,108490300813,-5,1126,852,-20
108491799253,108491799254,1,1885,1762,-20
108496589640,108496589641,1,1382,1501,-20
108498584441,108498584443,2,1725,1546,-20
108500669082,108500669087,5,1084,826,-20
108502509673,108502509674,1,2170,1441,-20
108505625198,108505625201,3,2332,1598,-20
108506149238,108506149244,6,2210,1824,-20
108507917454,108507917458,4,2096,1438,-20
108509456263,108509456266,3,1891,1206,-20
108511054726,108511054730,4,1435,1728,-20
108512101005,108512101007,2,1323,1356,-20
108513927914,108513927915,1,1645,1093,-20
108516030856,108516030861,5,1665,1322,-20
108516069769,108516069773,4,2045,1223,-20
108517413801,108517413802,1,1564,1162,-20
108517689670,108517689674,4,1475,1781,-20
108520880110,108520880114,4,1898,1208,-20
108530311312,108530311315,3,1772,1401,-20
108531305330,108531305333,3,1072,769,-20
108535629147,108535629145,-2,1192,2291,-20
108537775987,108537775993,6,2646,1646,-20
108541502307,108541502294,-13,1856,946,-20
108544555358,108544555360,2,1501,1902,-20
108545283938,108545283938,0,1434,1803,-20
108546914071,108546914073,2,1200,1467,-20
108548163655,108548163661,6,1307,1376,-20
108550626718,108550626726,8,1996,1081,-20
108553169522,108553169526,4,2135,1839,-20
108562228454,108562228458,4,2005,2113,-20
108562727642,108562727644,2,1751,1717,-20
108563707842,108563707826,-16,1096,724,-20
108563780384,108563780390,6,2545,1239,-20
108564161053,108564161075,22,306,2176,-20
108566172596,108566172598,2,1970,1118,-20
108566798175,108566798178,3,1881,1018,-20
108574407863,108574407866,3,2151,1422,-20
108580022249,108580022250,1,1400,1169,-20
108581180326,108581180330,4,2188,1286,-20
108584219321,108584219318,-3,981,2040,-20
108584730271,108584730275,4,1285,1029,-20
108586274906,108586274910,4,2167,2107,-20
108587992534,108587992536,2,1260,1005,-20
108592469578,108592469581,3,1941,1157,-20
108597319573,108597319575,2,1781,1226,-20
108598569125,108598569128,3,1948,1384,-20
108600959549,108600959552,3,2122,1214,-20
108604616202,108604616210,8,1577,1130,-20
108606062324,108606062329,5,2130,1803,-20
108608078004,108608078009,5,2015,988,-20
108610407322,108610407325,3,1805,1080,-20
108612092402,108612092406,4,3649,1716,-20
108613279427,108613279429,2,1769,1514,-20
108615902077,108615902080,3,2231,1792,-20
108616834545,108616834554,9,1872,1254,-20
108620262237,108620262242,5,933,757,-20
108620417106,108620417090,-16,1445,1173,-20
108626389154,108626389156,2,847,841,-20
108627280493,108627280497,4,1381,1368,-20
108628121627,108628121630,3,1920,1070,-20
108628602353,108628602357,4,1744,1248,-20
108631968938,108631968942,4,1917,1095,-20
108633118394,108633118397,3,1589,1000,-20
108640057524,108640057526,2,1394,1075,-20
108642134605,108642134607,2,1945,2021,-20
108643111587,108643111591,4,1161,1317,-20
108644897921,108644897922,1,1380,1562,-20
108650315765,108650315767,2,2354,1359,-20
108652525174,108652525178,4,2061,1516,-20
108656473425,108656473426,1,917,1406,-20
108657641639,108657641643,4,3172,1636,-20
108659978942,108659978946,4,1675,1159,-20
108661249070,108661249072,2,2330,2111,-20
108662844214,108662844218,4,1915,1296,-20
108663504654,108663504658,4,2588,1357,-20
108664926497,108664926501,4,1941,1749,-20
108666704326,108666704327,1,1967,1715,-20
108667641875,108667641878,3,2316,2760,-20
108667832335,108667832338,3,626,756,-20
108668170670,108668170675,5,1373,672,-20
108669172070,108669172075,5,1486,1347,-20
108670731414,108670731415,1,1393,910,-20
108672043946,108672043949,3,1720,1582,-20
108673063913,108673063915,2,1776,1286,-20
108674383770,108674383773,3,1775,1482,-20
108674669642,108674669645,3,984,1145,-20
108677404743,108677404747,4,1174,1432,-20
108678050768,108678050770,2,2078,1282,-20
108679344722,108679344726,4,1655,1098,-20
108679950249,108679950254,5,2028,1485,-20
108681621442,108681621446,4,1853,1119,-20
108681731919,108681731922,3,2761,1950,-20
108681969759,108681969762,3,1715,1642,-20
108687149400,108687149414,14,13922,50835,-20
108689874510,108689874515,5,1088,751,-20
108693926166,108693926173,7,1285,632,-20
108695443442,108695443425,-17,866,433,-20
108696949077,108696949082,5,2137,929,-20
108698959656,108698959659,3,1610,1289,-20
108700582998,108700583001,3,1007,1360,-20
108703698929,108703698935,6,2197,1225,-20
108704893605,108704893608,3,1949,1843,-20
108704950917,108704950921,4,1966,1329,-20
108705952687,108705952691,4,2395,1695,-20
108707208049,108707208051,2,1610,1425,-20
108708322162,108708322160,-2,3333,4557,-20
108709453063,108709453066,3,1900,1490,-20
108710181074,108710181079,5,1456,874,-20
108710974839,108710974841,2,1180,1094,-20
108711981396,108711981401,5,2044,1112,-20
108712983158,108712983159,1,1854,1735,-20
108713252924,108713252926,2,2025,1871,-20
108714114744,108714114746,2,1895,1788,-20
108719157893,108719157895,2,2047,1368,-20
108721091845,108721091847,2,1626,1560,-20
108722295817,108722295821,4,2653,1678,-20
108725310390,108725310391,1,1964,1451,-20
108728408002,108728408004,2,1629,1202,-20
108728912417,108728912421,4,1656,1205,-20
108730335247,108730335253,6,2366,1728,-20
108734261315,108734261327,12,1891,1102,-20
108735496149,108735496152,3,1948,1731,-20
108738198648,108738198651,3,1500,1663,-20
108740432840,108740432844,4,1623,1238,-20
108743317690,108743317693,3,1283,1717,-20
108744076032,108744076028,-4,1105,2607,-20
108744894118,108744894124,6,1449,1246,-20
108745279394,108745279395,1,1079,1150,-20
108747783019,108747783023,4,1512,1188,-20
108748754777,108748754778,1,2290,1330,-20
108750078206,108750078210,4,1820,1593,-20
108751246625,108751246630,5,2565,1092,-20
108751730196,108751730193,-3,1889,2563,-20
108752320217,108752320220,3,1688,1460,-20
108758095957,108758095953,-4,1132,2983,-20
108760101723,108760101721,-2,1094,1493,-20
108761339015,108761339019,4,1931,2306,-20
108763569842,108763569847,5,1951,1869,-20
108765771221,108765771222,1,1591,1226,-20
108766110253,108766110256,3,2189,1298,-20
108766197898,108766197881,-17,2168,1187,-20
108766705941,108766705952,11,771,351,-20
108772168913,108772168915,2,1535,1990,-20
108775624391,108775624386,-5,1104,4146,-20
108776847382,108776847387,5,1563,1435,-20
108777199643,108777199650,7,2432,1245,-20
108779095542,108779095544,2,1426,1475,-20
108780597854,108780597855,1,1665,1207,-20
108785212974,108785212977,3,2754,1912,-20
108788415958,108788415959,1,1570,1020,-20
108792779031,108792779025,-6,981,1236,-20
108794408286,108794408289,3,2140,1680,-20
108794513270,108794513273,3,1794,1713,-20
108794883499,108794883502,3,2552,1321,-20
108798588717,108798588718,1,1505,1410,-20
108799478159,108799478161,2,1239,1256,-20
108799867510,108799867513,3,1357,1052,-20
108801619836,108801619841,5,2013,1692,-20
108803927245,108803927248,3,1463,1741,-20
108804712737,108804712745,8,1455,1208,-20
108806896374,108806896374,0,2741,3203,-20
108807820410,108807820417,7,3136,1153,-20
108810844317,108810844319,2,2000,1493,-20
108812813367,108812813361,-6,1484,4675,-20
108813056738,108813056739,1,1785,1396,-20
108814520009,108814520013,4,2723,1329,-20
108815055494,108815055491,-3,19740,7738,-20
108815665450,108815665455,5,1681,1332,-20
108819528108,108819528110,2,1574,1433,-20
108821360922,108821360926,4,1763,1250,-20
108827276367,108827276371,4,2043,1797,-20
108830896466,108830896471,5,3270,1942,-20
108831567215,108831567218,3,1583,1521,-20
108836884590,108836884593,3,1861,1512,-20
108837514060,108837514063,3,1822,2249,-20
108838545866,108838545859,-7,2257,8156,-20
108840213743,108840213749,6,2396,975,-20
108847215671,108847215666,-5,1025,3258,-20
108850162374,108850162375,1,2105,1310,-20
108851018725,108851018729,4,1643,1345,-20
108851139842,108851139829,-13,1571,1264,-20
108852473611,108852473614,3,2371,1638,-20
108858622217,108858622221,4,1719,1090,-20
108860670068,108860670071,3,1113,1262,-20
108861731294,108861731298,4,2196,989,-20
108864891716,108864891718,2,1834,1168,-20
108865600262,108865600265,3,1664,1570,-20
108870289430,108870289432,2,2161,1558,-20
108874604615,108874604618,3,1934,1393,-20
108874684126,108874684129,3,1861,1462,-20
108877168930,108877168949,19,1524,1109,-20
108879700319,108879700322,3,2166,1751,-20
108879896038,108879896041,3,1311,1225,-20
108880487639,108880487640,1,1823,1568,-20
108882023271,108882023273,2,1566,1458,-20
108883004856,108883004859,3,1598,1143,-20
108884724902,108884724906,4,1038,1360,-20
108888366534,108888366542,8,11463,23298,-20
108889120086,108889120090,4,1363,1288,-20
108891539962,108891539966,4,1357,1036,-20
108893185479,108893185483,4,1610,1023,-20
108897621544,108897621546,2,1625,1154,-20
108902581148,108902581148,0,1402,1511,-20
108903004653,108903004658,5,2327,1181,-20
108905437278,108905437283,5,1373,1423,-20
108905544729,108905544731,2,1332,1295,-20
108907153726,108907153731,5,2347,1417,-20
108907242101,108907242103,2,1672,642,-20
108907427313,108907427314,1,35682,37249,-20
108908622437,108908622440,3,2039,1474,-20
108909666505,108909666509,4,1738,1315,-20
108910205462,108910205465,3,1808,1440,-20
108914384354,108914384357,3,1592,1343,-20
108919506979,108919506982,3,1403,1640,-20
108922895594,108922895598,4,1448,1548,-20
108923864942,108923864946,4,1939,1565,-20
108927388796,108927388798,2,929,1613,-20
108930180770,108930180774,4,1656,1350,-20
108930434377,108930434381,4,1919,1479,-20
108931356592,108931356594,2,1085,1382,-20
108932653427,108932653431,4,3059,2295,-20
108935709713,108935709717,4,2262,1539,-20
108937144612,108937144616,4,2007,1574,-20
108942118560,108942118563,3,2190,1658,-20
108945627153,108945627155,2,1492,1657,-20
108946767620,108946767624,4,2337,1780,-20
108948332244,108948332246,2,2199,1680,-20
108952275408,108952275412,4,1861,1060,-20
108955925360,108955925363,3,1776,1187,-20
108958045567,108958045569,2,1065,1317,-20
108958867264,108958867266,2,1796,1749,-20
108960993225,108960993227,2,1698,1872,-20
108961904665,108961904670,5,2318,1630,-20
108961953007,108961953009,2,1568,1639,-20
108963867462,108963867462,0,2820,2996,-20
108964580154,108964580158,4,1779,1499,-20
108964617626,108964617629,3,1402,1380,-20
108965142227,108965142230,3,1777,1279,-20
108969021274,108969021279,5,2328,1326,-20
108969450387,108969450391,4,2318,1559,-20
108972677703,108972677707,4,2133,2342,-20
108973402038,108973402041,3,2434,2008,-20
108973454178,108973454180,2,1603,1509,-20
108973846245,108973846250,5,4770,1815,-20
108974139418,108974139422,4,1986,2150,-20
108974824086,108974824091,5,1318,687,-20
108975867411,108975867414,3,2575,1178,-20
108980566815,108980566818,3,1830,1574,-20
108981055013,108981055015,2,1592,1095,-20
108986074449,108986074453,4,1799,1828,-20
108990548670,108990548671,1,1736,1354,-20
108990617854,108990617858,4,940,1091,-20
108999217580,108999217585,5,2674,1301,-20
109000590650,109000590654,4,1556,1471,-20
109000626409,109000626412,3,1888,1069,-20
109001430880,109001430882,2,1911,1085,-20
109004581492,109004581495,3,1110,1452,-20
109005914514,109005914515,1,1465,754,-20
109008658805,109008658805,0,1594,1738,-20
109013383166,109013383165,-1,860,1159,-20
109014554052,109014554056,4,2442,1891,-20
109018034318,109018034323,5,2258,1424,-20
109021500080,109021500084,4,1410,1397,-20
109022541662,109022541663,1,1654,1180,-20
109027550267,109027550274,7,563,292,-20
109034750496,109034750500,4,1690,1426,-20
109038565536,109038565537,1,1902,2207,-20
109040579317,109040579320,3,1947,2123,-20
109049840583,109049840589,6,2465,1221,-20
109051399815,109051399807,-8,879,4817,-20
109052229330,109052229332,2,1534,1859,-20
109054126059,109054126063,4,1471,1181,-20
109054763615,109054763618,3,1726,1572,-20
109055759431,109055759434,3,2505,2408,-20
109057956078,109057956082,4,1332,1603,-20
109059111833,109059111835,2,1833,1624,-20
109063604365,109063604368,3,1338,1436,-20
109064770193,109064770195,2,1654,1336,-20
109064998855,109064998854,-1,1233,2532,-20
109065263606,109065263609,3,1629,1337,-20
109071511926,109071511929,3,1414,1329,-20
109071723001,109071723004,3,1560,1281,-20
109072720509,109072720513,4,1557,1127,-20
109078801211,109078801215,4,1807,1630,-20
109080562045,109080562048,3,2367,1596,-20
109083167654,109083167655,1,1400,1286,-20
109084633546,109084633547,1,1484,1213,-20
109085591998,109085591999,1,2190,1461,-20
109086650039,109086650042,3,2265,1762,-20
109087323202,109087323202,0,758,1183,-20
109089777242,109089777244,2,2021,1699,-20
109090064939,109090064942,3,1602,1301,-20
109093839959,109093839962,3,1861,1417,-20
109097566422,109097566427,5,1274,947,-20
109102223139,109102223141,2,2209,1713,-20
109107749157,109107749160,3,2295,1596,-20
109112792669,109112792671,2,2118,1343,-20
109114709043,109114709048,5,2347,1932,-20
109115090153,109115090157,4,2372,1273,-20
109116629489,109116629494,5,2734,1481,-20
109118294032,109118294036,4,1945,1724,-20
109120399870,109120399875,5,1838,1389,-20
109125308414,109125308418,4,2315,1837,-20
109126294482,109126294498,16,330,1054,-20
109129757750,109129757754,4,2042,1484,-20
109130998891,109130998894,3,1347,1358,-20
109132457671,109132457673,2,1224,1385,-20
109133588180,109133588182,2,1660,1274,-20
109133709819,109133709823,4,2623,1629,-20
109134293825,109134293831,6,1102,816,-20
109137012438,109137012441,3,1938,1553,-20
109137506360,109137506362,2,1350,1664,-20
109137587553,109137587536,-17,895,1214,-20
109139228194,109139228199,5,2231,2052,-20
109141670637,109141670639,2,1730,1358,-20
109144893103,109144893109,6,3014,1786,-20
109145224582,109145224586,4,1410,1218,-20
109145737054,109145737058,4,1880,1993,-20
109145769119,109145769100,-19,1089,862,-20
109147611474,109147611478,4,1962,1115,-20
109149577626,109149577630,4,2036,1389,-20
109154436370,109154436371,1,1362,1471,-20
109155304041,109155304043,2,1908,1600,-20
109157063159,109157063161,2,1350,1617,-20
109161758136,109161758139,3,1914,1378,-20
109163489522,109163489525,3,872,644,-20
109164627428,109164627433,5,479,205,-20
109166471938,109166471942,4,2105,1315,-20
109169776030,109169776032,2,1469,1205,-20
109177712031,109177712035,4,1745,1262,-20
109177924456,109177924461,5,1535,928,-20
109177980453,109177980448,-5,2859,8152,-20
109179605911,109179605914,3,1608,1208,-20
109184128203,109184128200,-3,953,1855,-20
109186144435,109186144438,3,1458,1241,-20
109187540658,109187540662,4,1972,1520,-20
109188379471,109188379477,6,1532,1416,-20
109190494527,109190494530,3,834,835,-20
109191160854,109191160848,-6,497,1714,-20
109193508203,109193508206,3,1868,1455,-20
109194107457,109194107459,2,1223,1630,-20
109195751567,109195751570,3,1319,1203,-20
109195868550,109195868551,1,1953,1630,-20
109197073700,109197073707,7,1402,1047,-20
109198470858,109198470862,4,2438,1334,-20
109199179214,109199179218,4,1693,1390,-20
109199926196,109199926198,2,3525,3907,-20
109202760355,109202760361,6,2353,1429,-20
109204783410,109204783413,3,2097,1868,-20
109206311939,109206311945,6,2107,1379,-20
109207363902,109207363906,4,3062,1250,-20
109207640512,109207640514,2,1562,1371,-20
109211336037,109211336043,6,1305,832,-20
109211423266,109211423282,16,1642,1288,-20
109214680262,109214680265,3,1365,1327,-20
109215787878,109215787885,7,2216,1303,-20
109219274173,109219274174,1,1344,1043,-20
109220193962,109220193971,9,1419,1252,-20
109221199978,109221199983,5,2612,1584,-20
109221790349,109221790355,6,72652,27652,-20
109222780335,109222780339,4,2074,952,-20
109223571374,109223571352,-22,1840,1705,-20
109229551491,109229551494,3,1468,1521,-20
109232292534,109232292535,1,1352,2433,-20
109240816280,109240816283,3,2078,1660,-20
109241344208,109241344211,3,2069,798,-20
109241937030,109241937031,1,1743,1778,-20
109242200615,109242200615,0,1697,1052,-20
109243640419,109243640423,4,2190,1584,-20
109248827380,109248827383,3,1811,1709,-20
109249811164,109249811166,2,1412,1057,-20
109250508409,109250508410,1,1748,1694,-20
109251020134,109251020122,-12,42359,11808,-20
109254071622,109254071627,5,1292,919,-20
109254944400,109254944401,1,1834,1298,-20
109255934078,109255934082,4,2343,1740,-20
109257509518,109257509524,6,2068,1502,-20
109264676216,109264676222,6,1841,1386,-20
109270355425,109270355426,1,1896,1051,-20
109270400645,109270400649,4,3041,1713,-20
109270572734,109270572755,21,1606,1137,-20
109270712461,109270712466,5,2230,916,-20
109270870745,109270870748,3,2194,1410,-20
109271132268,109271132271,3,2199,1887,-20
109271763121,109271763120,-1,32836,57057,-20
109273197296,109273197301,5,2029,1586,-20
109274587133,109274587138,5,3826,1925,-20
109274711338,109274711343,5,2007,1489,-20
109274971115,109274971111,-4,26462,12906,-20
109275843789,109275843791,2,1784,1394,-20
109277057186,109277057202,16,1151,1021,-20
109283363645,109283363649,4,2019,1634,-20
109293045462,109293045466,4,1661,1080,-20
109294144586,109294144588,2,1274,1540,-20
109294214517,109294214496,-21,1234,651,-20
109295496578,109295496582,4,1581,935,-20
109300576251,109300576255,4,1872,1462,-20
109301610457,109301610461,4,2150,1245,-20
109302385802,109302385806,4,899,1229,-20
109310565277,109310565278,1,2313,3173,-20
109312698059,109312698062,3,1485,968,-20
109315882567,109315882573,6,2110,1133,-20
109317826050,109317826053,3,2549,1782,-20
109318761553,109318761557,4,2227,1712,-20
109321301986,109321301983,-3,825,1962,-20
109325536871,109325536874,3,2628,1711,-20
109328006872,109328006874,2,1068,1142,-20
109329843881,109329843883,2,2195,1159,-20
109331420657,109331420656,-1,1235,1807,-20
109340565557,109340565557,0,4154,4710,-20
109343215505,109343215509,4,2031,1100,-20
109343853514,109343853499,-15,645,389,-20
109344971153,109344971155,2,1355,1342,-20
109345131508,109345131513,5,1170,1267,-20
109346142350,109346142358,8,2572,1282,-20
109355388450,109355388454,4,3563,3406,-20
109356317548,109356317551,3,1790,1804,-20
109359983614,109359983618,4,1198,1120,-20
109360220626,109360220629,3,2164,1123,-20
109360554409,109360554411,2,1225,1617,-20
109360738370,109360738374,4,2535,1363,-20
109362234918,109362234922,4,1212,1720,-20
109363274174,109363274178,4,2117,1191,-20
109368241894,109368241897,3,2153,1473,-20
109368423423,109368423426,3,1786,1518,-20
109369391622,109369391626,4,2125,1366,-20
109372035849,109372035851,2,1687,1234,-20
109372111206,109372111184,-22,2402,1470,-20
109372180892,109372180873,-19,746,397,-20
109379568360,109379568366,6,2957,1688,-20
109383957658,109383957661,3,1857,1343,-20
109384147193,109384147195,2,1299,1283,-20
109390115781,109390115782,1,2198,1411,-20
109390848849,109390848851,2,1240,1498,-20
109392660269,109392660272,3,2281,1822,-20
109392810830,109392810833,3,2089,1220,-20
109394013516,109394013518,2,2342,1288,-20
109394542019,109394542019,0,1430,1848,-20
109395655714,109395655717,3,1506,1592,-20
109397016193,109397016197,4,1208,1264,-20
109397522902,109397522907,5,1604,1182,-20
109400448941,109400448945,4,1578,1215,-20
109408475500,109408475504,4,1525,1192,-20
109411298344,109411298339,-5,1746,5260,-20
109411792245,109411792249,4,2184,1583,-20
109412871217,109412871220,3,2281,1391,-20
109416443450,109416443454,4,2082,1253,-20
109418715638,109418715642,4,1473,1307,-20
109423498410,109423498409,-1,9253,15554,-20
109427260374,109427260376,2,1738,1935,-20
109429498657,109429498660,3,1502,1229,-20
109434102501,109434102504,3,1715,1478,-20
109437371345,109437371346,1,1803,1161,-20
109437925376,109437925378,2,2266,1459,-20
109440309817,109440309821,4,1450,1894,-20
109442101730,109442101730,0,1038,863,-20
109448215706,109448215711,5,903,921,-20
109448830490,109448830495,5,2014,1777,-20
109452090755,109452090759,4,1624,1212,-20
109458456608,109458456609,1,3364,3560,-20
109460057825,109460057828,3,1533,1510,-20
109460925570,109460925573,3,1924,1402,-20
109461671591,109461671595,4,1831,1291,-20
109465202458,109465202464,6,1782,1087,-20
109465899180,109465899162,-18,1478,1021,-20
109467162189,109467162194,5,1542,1320,-20
109468178926,109468178930,4,1661,970,-20
109468752077,109468752082,5,3678,1810,-20
109470042333,109470042336,3,2190,1487,-20
109470366718,109470366721,3,2004,1269,-20
109475233530,109475233534,4,1589,1143,-20
109475782310,109475782313,3,1989,1422,-20
109476569773,109476569776,3,2506,1863,-20
109478080996,109478080992,-4,1185,2981,-20
109479064917,109479064923,6,2440,1398,-20
109480847574,109480847579,5,2048,1417,-20
109481819425,109481819432,7,3420,1413,-20
109483249404,109483249406,2,1364,1209,-20
109492713785,109492713804,19,2112,1279,-20
109493369110,109493369114,4,2482,1815,-20
109494519400,109494519404,4,2107,1619,-20
109497068110,109497068112,2,1252,1400,-20
109497961925,109497961928,3,1528,1218,-20
109498553394,109498553410,16,2264,1122,-20
109504057001,109504057005,4,2360,1386,-20
109504900174,109504900177,3,1813,1220,-20
109507075334,109507075337,3,1636,1200,-20
109507290659,109507290641,-18,805,1083,-20
109514109482,109514109485,3,1849,1460,-20
109514255450,109514255449,-1,2098,1425,-20
109514698096,109514698101,5,2020,1409,-20
109517526041,109517526046,5,2504,1075,-20
109523528309,109523528311,2,1646,956,-20
109528372874,109528372878,4,1743,2231,-20
109531223954,109531223954,0,749,1080,-20
109531931608,109531931613,5,1792,1950,-20
109533015288,109533015282,-6,2152,6965,-20
109534437334,109534437338,4,2484,2041,-20
109536068103,109536068109,6,3023,1527,-20
109537117137,109537117130,-7,929,5239,-20
109540096631,109540096635,4,1638,1530,-20
109544949830,109544949829,-1,995,1798,-20
109549484099,109549484102,3,2230,1696,-20
109550646045,109550646049,4,1815,1168,-20
109559530119,109559530126,7,3042,1769,-20
109562386885,109562386890,5,1246,1193,-20
109564235910,109564235913,3,2431,1867,-20
109566061513,109566061514,1,2103,1611,-20
109566468221,109566468223,2,1689,1252,-20
109568212596,109568212602,6,1680,1015,-20
109568809301,109568809304,3,1399,1323,-20
109569422231,109569422231,0,771,585,-20
109574228550,109574228556,6,1930,1553,-20
109574363373,109574363375,2,1705,1832,-20
109577430313,109577430318,5,1971,1387,-20
109581522295,109581522298,3,1099,782,-20
109589315241,109589315241,0,1088,1229,-20
109597197495,109597197499,4,1923,1281,-20
109600438930,109600438934,4,2124,1558,-20
109602505429,109602505431,2,1579,1326,-20
109608297394,109608297398,4,1900,1601,-20
109610647196,109610647199,3,1580,1612,-20
109611503627,109611503630,3,1983,1560,-20
109612763617,109612763618,1,1948,1382,-20
109616318436,109616318439,3,1760,1181,-20
109623290923,109623290926,3,1641,1539,-20
109625751981,109625751983,2,1563,1222,-20
109629408974,109629408976,2,2136,1227,-20
109629842509,109629842488,-21,2484,1070,-20
109631702071,109631702071,0,1040,826,-20
109634537490,109634537495,5,1713,1430,-20
109637192562,109637192568,6,2165,1632,-20
109638944362,109638944367,5,1952,1395,-20
109639615522,109639615530,8,13683,25175,-20
109639706866,109639706869,3,2066,1812,-20
109640954301,109640954303,2,1958,1406,-20
109642221018,109642221019,1,1369,1420,-20
109643135617,109643135620,3,1327,1311,-20
109649262103,109649262104,1,1770,1578,-20
109656998033,109656998039,6,1896,1762,-20
109657748672,109657748677,5,1798,1053,-20
109661195039,109661195041,2,1724,1358,-20
109663326002,109663326004,2,1807,1594,-20
109663726595,109663726598,3,1702,1725,-20
109665426590,109665426593,3,2026,1361,-20
109671868893,109671868897,4,1736,1092,-20
109672165925,109672165929,4,1378,1667,-20
109679446355,109679446359,4,1671,1333,-20
109680823446,109680823449,3,1575,1376,-20
109682891502,109682891506,4,2145,1277,-20
109685226307,109685226311,4,2072,1725,-20
109688118213,109688118216,3,1755,1208,-20
109695506471,109695506474,3,1174,1398,-20
109698798114,109698798106,-8,498,3341,-20
109702013681,109702013682,1,1835,1568,-20
109703446773,109703446775,2,2060,1941,-20
109706626669,109706626673,4,1291,704,-20
109707641391,109707641394,3,1480,1026,-20
109708348977,109708348978,1,2073,2479,-20
109712391189,109712391192,3,1671,1458,-20
109713009459,109713009463,4,1911,1203,-20
109716204286,109716204291,5,1868,1171,-20
109719572128,109719572131,3,1107,908,-20
109721211267,109721211271,4,2230,756,-20
109723798254,109723798258,4,1688,1247,-20
109724637222,109724637225,3,1590,1174,-20
109727747764,109727747769,5,1980,1292,-20
109733269018,109733269022,4,1693,1504,-20
109734056225,109734056227,2,1805,1873,-20
109736003357,109736003363,6,1998,932,-20
109737412215,109737412218,3,1714,1434,-20
109738371702,109738371705,3,1953,1396,-20
109738431462,109738431461,-1,1470,2775,-20
109742564354,109742564357,3,1066,1320,-20
109744137907,109744137911,4,1500,819,-20
109746482381,109746482385,4,2204,898,-20
109746519531,109746519512,-19,1233,935,-20
109747519893,109747519895,2,1874,1385,-20
109750317115,109750317119,4,1166,1337,-20
109750469479,109750469482,3,1279,1248,-20
109751992170,109751992173,3,1527,1157,-20
109753060173,109753060175,2,1989,1585,-20
109755327777,109755327782,5,1768,1572,-20
109758498765,109758498769,4,1560,1531,-20
109760875493,109760875497,4,2075,1853,-20
109761332661,109761332664,3,1740,1680,-20
109762919070,109762919089,19,1983,1072,-20
109765890879,109765890882,3,1585,1514,-20
109766388924,109766388926,2,1469,1181,-20
109766529677,109766529681,4,1433,1270,-20
109770418910,109770418913,3,1244,1302,-20
109772332861,109772332866,5,1614,1659,-20
109772942557,109772942557,0,2402,1838,-20
109773973869,109773973871,2,1110,1896,-20
109774617184,109774617187,3,2143,1636,-20
109778227151,109778227155,4,681,909,-20
109780002614,109780002621,7,2817,1737,-20
109780332683,109780332688,5,1866,1416,-20
109781596746,109781596751,5,1626,1096,-20
109785545618,109785545622,4,1572,1992,-20
109785744019,109785744022,3,887,1401,-20
109789197406,109789197410,4,2197,1373,-20
109790000453,109790000452,-1,1384,1740,-20
109792897191,109792897194,3,1467,1469,-20
109794308378,109794308382,4,1721,1170,-20
109797755514,109797755515,1,1154,1415,-20
109801917801,109801917806,5,1583,1518,-20
109804457174,109804457177,3,1837,1302,-20
109806403919,109806403922,3,1766,837,-20
109806924017,109806924024,7,1720,1645,-20
109807225285,109807225289,4,1459,1053,-20
109816268140,109816268141,1,1500,1746,-20
109821644394,109821644395,1,1385,1178,-20
109823039265,109823039269,4,2071,1182,-20
109826853879,109826853881,2,2621,1702,-20
109827221058,109827221059,1,1636,1096,-20
109828146913,109828146914,1,1362,1725,-20
109829986218,109829986222,4,1319,1773,-20
109831657190,109831657193,3,1433,1072,-20
109835151263,109835151266,3,1503,1359,-20
109835538855,109835538858,3,1819,954,-20
109836463215,109836463218,3,1933,1433,-20
109836915195,109836915198,3,2275,1516,-20
109839801213,109839801217,4,1757,1214,-20
109841185959,109841185962,3,1284,1113,-20
109842214393,109842214394,1,1149,1204,-20
109843457771,109843457778,7,2837,1552,-20
109844242375,109844242378,3,2434,1868,-20
109844454726,109844454705,-21,1215,1182,-20
109847833337,109847833340,3,2553,1689,-20
109851554746,109851554750,4,1700,1898,-20
109853945215,109853945216,1,1896,1464,-20
109855865374,109855865379,5,2416,1655,-20
109858666056,109858666059,3,2163,1334,-20
109859613305,109859613306,1,1665,1603,-20
109862842330,109862842334,4,1758,1344,-20
109864693120,109864693122,2,1205,1170,-20
109866469585,109866469590,5,1092,1238,-20
109870035238,109870035241,3,2229,1951,-20
109871421213,109871421215,2,1816,1430,-20
109872519223,109872519227,4,2098,1797,-20
109872746221,109872746224,3,1673,810,-20
109874096826,109874096830,4,2093,1451,-20
109874168637,109874168623,-14,61,1497,-20
109874340754,109874340757,3,1345,1243,-20
109876838201,109876838203,2,1980,1887,-20
109877006029,109877006032,3,1357,1535,-20
109877622539,109877622546,7,3137,1298,-20
109878596315,109878596313,-2,2679,3825,-20
109878835902,109878835905,3,2311,1414,-20
109879163177,109879163184,7,12685,20019,-20
109879533111,109879533115,4,771,667,-20
109881512249,109881512248,-1,831,2066,-20
109884072892,109884072879,-13,1550,910,-20
109887218803,109887218806,3,1182,1010,-20
109901620871,109901620864,-7,1257,6578,-20
109903541287,109903541291,4,1320,1533,-20
109906241894,109906241895,1,2378,1530,-20
109906305460,109906305464,4,1892,1447,-20
109909105230,109909105234,4,863,1095,-20
109910437290,109910437294,4,2239,1424,-20
109911311697,109911311701,4,2812,1847,-20
109918287685,109918287689,4,2542,1705,-20
109920108866,109920108873,7,5887,3211,-20
109920829402,109920829406,4,1241,1032,-20
109921750910,109921750912,2,2076,1550,-20
109922783118,109922783121,3,1139,1227,-20
109924071609,109924071611,2,2316,930,-20
109924131843,109924131827,-16,1609,1938,-20
109924451326,109924451333,7,2602,877,-20
109924790427,109924790431,4,1609,1529,-20
109926052243,109926052248,5,1857,1359,-20
109931368810,109931368813,3,1850,2636,-20
109932612134,109932612137,3,2290,2098,-20
109935495809,109935495810,1,1367,2030,-20
109935655791,109935655797,6,2382,1686,-20
109940717090,109940717090,0,2185,2784,-20
109943360931,109943360935,4,2341,1484,-20
109947738470,109947738471,1,1623,1303,-20
109948367278,109948367280,2,1494,1614,-20
109948996848,109948996837,-11,34972,14446,-20
109949453295,109949453301,6,1979,998,-20
109952561208,109952561211,3,1587,1062,-20
109956236295,109956236296,1,1684,1685,-20
109956500722,109956500726,4,984,1000,-20
109959589980,109959589985,5,2625,1829,-20
109961534605,109961534609,4,6552,25683,-20
109968323160,109968323155,-5,32718,13426,-20
109969333617,109969333621,4,1448,1222,-20
109972152469,109972152474,5,1843,1360,-20
109974663374,109974663377,3,2219,1059,-20
109975251931,109975251936,5,1447,1130,-20
109980836890,109980836893,3,1398,1490,-20
109986315152,109986315150,-2,898,1866,-20
109989308686,109989308690,4,2724,1715,-20
109991548851,109991548850,-1,1626,908,-20
109998512775,109998512771,-4,950,2607,-20
109999038009,109999038012,3,1742,1814,-20
109999369159,109999369137,-22,1230,873,-20
110002120813,110002120817,4,2023,1430,-20
110003903751,110003903754,3,2073,1106,-20
110007714753,110007714758,5,974,1192,-20
110007980510,110007980514,4,2702,1671,-20
110011945595,110011945598,3,1933,1445,-20
110016086730,110016086731,1,1031,697,-20
110017469128,110017469129,1,1542,1635,-20
110020020521,110020020525,4,2063,1739,-20
110021567677,110021567681,4,1297,1048,-20
110024013089,110024013095,6,2801,1920,-20
110027695663,110027695667,4,2460,1483,-20
110031216297,110031216298,1,1402,1236,-20
110034116334,110034116338,4,1453,901,-20
110036170055,110036170059,4,1624,1006,-20
110039220194,110039220197,3,1237,1185,-20
110040315615,110040315618,3,1779,1295,-20
110040715181,110040715172,-9,742,932,-20
110041249894,110041249894,0,1526,1405,-20
110042379189,110042379194,5,2306,1123,-20
110042419815,110042419818,3,1745,1755,-20
110042521429,110042521411,-18,1798,1440,-20
110045006865,110045006865,0,1698,1091,-20
110045535579,110045535583,4,1254,1441,-20
110046632425,110046632430,5,1992,1423,-20
110058708745,110058708747,2,1734,1327,-20
110060336269,110060336273,4,2060,1693,-20
110062320078,110062320081,3,1534,1624,-20
110065445458,110065445457,-1,1453,2348,-20
110066134617,110066134627,10,260,1800,-20
110066768490,110066768494,4,1052,1142,-20
110067574673,110067574678,5,1721,925,-20
110071272333,110071272337,4,1713,1565,-20
110072493624,110072493630,6,1793,1356,-20
110077206067,110077206070,3,3024,1930,-20
110078452218,110078452223,5,1399,1140,-20
110079225144,110079225147,3,1888,1046,-20
110079519093,110079519076,-17,1937,1283,-20
110081039910,110081039912,2,1721,1809,-20
110082337359,110082337363,4,2214,1479,-20
110085953358,110085953362,4,1805,1165,-20
110093758294,110093758300,6,1756,906,-20
110101212473,110101212477,4,1700,936,-20
110102587995,110102587998,3,1519,1224,-20
110103531431,110103531435,4,2202,1352,-20
110103861878,110103861881,3,1548,1208,-20
110105541422,110105541426,4,1648,1416,-20
110106928691,110106928697,6,1918,1807,-20
110107829823,110107829827,4,1967,959,-20
110109910476,110109910481,5,2331,1574,-20
110111288357,110111288359,2,1799,1803,-20
110119943955,110119943949,-6,2949,8990,-20
110123866526,110123866530,4,1684,1370,-20
110130929997,110130930001,4,2158,1588,-20
110132149194,110132149176,-18,2108,1445,-20
110133175798,110133175793,-5,613,1995,-20
110133445663,110133445665,2,1140,1501,-20
110139669423,110139669427,4,2260,1238,-20
110141360989,110141360989,0,751,1199,-20
110142759393,110142759394,1,1880,2068,-20
110143938209,110143938210,1,1645,855,-20
110146278164,110146278168,4,1905,1536,-20
110150341662,110150341665,3,1459,1166,-20
110152195782,110152195786,4,1689,1131,-20
110154637198,110154637202,4,1521,1201,-20
110156182690,110156182694,4,2657,1644,-20
110158401263,110158401266,3,1213,1105,-20
110162907087,110162907087,0,1790,1423,-20
110167278394,110167278397,3,2304,2121,-20
110176827241,110176827245,4,1543,1408,-20
110176910883,110176910882,-1,458,198,-20
110177094945,110177094947,2,1807,1597,-20
110179799685,110179799687,2,1783,1883,-20
110180916718,110180916722,4,1852,1254,-20
110182810122,110182810122,0,1770,1470,-20
110187370695,110187370698,3,2369,1865,-20
110187695364,110187695366,2,1389,1349,-20
110189408322,110189408325,3,1466,1299,-20
110189689544,110189689547,3,1608,1040,-20
110190323601,110190323606,5,2454,1667,-20
110190922764,110190922767,3,1678,1501,-20
110195739302,110195739306,4,1544,1124,-20
110196787161,110196787159,-2,1236,1921,-20
110199658162,110199658166,4,2090,1508,-20
110209668221,110209668223,2,1976,1302,-20
110210134574,110210134577,3,1381,898,-20
110211651699,110211651702,3,1423,1323,-20
110212382199,110212382202,3,2628,1204,-20
110215518445,110215518446,1,1738,1241,-20
110215829918,110215829925,7,2154,1314,-20
110215882287,110215882268,-19,1460,1096,-20
110218752882,110218752887,5,2162,1782,-20
110224113065,110224113070,5,1868,1733,-20
110224218107,110224218110,3,1770,1374,-20
110224655021,110224655025,4,1320,1081,-20
110228483395,110228483398,3,1091,1464,-20
110229237893,110229237897,4,1916,2035,-20
110230338635,110230338641,6,1993,1253,-20
110231130953,110231130955,2,2173,1354,-20
110233279447,110233279450,3,1597,1080,-20
110235244401,110235244403,2,1196,1370,-20
110237048516,110237048522,6,7833,2366,-20
110237496623,110237496627,4,2666,1774,-20
110238702058,110238702062,4,1557,1813,-20
110238945070,110238945070,0,1518,1742,-20
110239832700,110239832693,-7,1347,4416,-20
110240886543,110240886546,3,2071,1049,-20
110243913093,110243913094,1,1878,1617,-20
110244053210,110244053227,17,461,125,-20
110246743717,110246743719,2,2396,1851,-20
110248539369,110248539373,4,1695,896,-20
110256839991,110256839994,3,1736,1574,-20
110257827382,110257827386,4,1600,1388,-20
110259405557,110259405559,2,1789,1746,-20
110261270195,110261270199,4,1812,1477,-20
110263144328,110263144331,3,1990,1413,-20
110264605852,110264605855,3,1928,1097,-20
110267500251,110267500252,1,1851,1400,-20
110269330454,110269330458,4,2586,1460,-20
110272200349,110272200349,0,1528,1927,-20
110278025251,110278025255,4,2483,1483,-20
110282386153,110282386158,5,2078,1223,-20
110282781372,110282781373,1,1338,1194,-20
110283673523,110283673529,6,2757,1634,-20
110283875281,110283875284,3,1371,1361,-20
110286773257,110286773258,1,1412,1177,-20
110287489929,110287489934,5,2306,1382,-20
110291412714,110291412716,2,1445,1344,-20
110293512953,110293512955,2,1688,1581,-20
110293667854,110293667856,2,851,1366,-20
110293987792,110293987796,4,1870,1493,-20
110296437739,110296437745,6,170,706,-20
110298215590,110298215593,3,1707,1216,-20
110299319525,110299319523,-2,1220,1812,-20
110299431578,110299431582,4,1224,1243,-20
110302071226,110302071228,2,2029,1392,-20
110307481938,110307481943,5,2495,1435,-20
110310994326,110310994334,8,1420,1264,-20
110312128051,110312128055,4,2303,1372,-20
110313014201,110313014206,5,2241,1617,-20
110313278024,110313278028,4,1821,1555,-20
110313644178,110313644181,3,1371,1507,-20
110314479249,110314479254,5,1342,1601,-20
110314858321,110314858328,7,1949,1565,-20
110315485351,110315485332,-19,1644,1553,-20
110315659649,110315659652,3,2577,1736,-20
110315770233,110315770234,1,1293,1063,-20
110320396554,110320396554,0,2368,2114,-20
110320745075,110320745078,3,2011,1132,-20
110323266422,110323266426,4,1744,1264,-20
110324275498,110324275501,3,1723,1328,-20
110324902741,110324902763,22,2000,1054,-20
110327199442,110327199437,-5,934,3119,-20
110328685288,110328685290,2,1947,1309,-20
110328998521,110328998524,3,1646,2050,-20
110329032213,110329032217,4,1532,1428,-20
110332455666,110332455645,-21,974,815,-20
110341291653,110341291657,4,2016,1307,-20
110345455354,110345455356,2,1673,1578,-20
110349789767,110349789773,6,1949,1280,-20
110349929555,110349929571,16,1877,1637,-20
110351218701,110351218705,4,1840,1301,-20
110354973075,110354973069,-6,2245,9598,-20
110355425158,110355425162,4,2727,1488,-20
110357300002,110357300005,3,1549,1376,-20
110358319047,110358319051,4,1307,1079,-20
110361032758,110361032764,6,1100,791,-20
110363034977,110363034979,2,1637,1128,-20
110366252047,110366252049,2,1694,1760,-20
110370438338,110370438343,5,1916,1165,-20
110370790733,110370790736,3,2048,1667,-20
110371340559,110371340566,7,2899,2135,-20
110379062485,110379062489,4,1674,1588,-20
110381971354,110381971359,5,1175,1344,-20
110382971086,110382971087,1,1656,1739,-20
110384398748,110384398752,4,1997,1218,-20
110387281465,110387281468,3,2194,1154,-20
110388187025,110388187030,5,2077,1409,-20
110390090475,110390090474,-1,1922,1991,-20
110391234429,110391234434,5,2123,1113,-20
110391669408,110391669409,1,5104,5794,-20
110392438831,110392438834,3,1861,1311,-20
110393234959,110393234963,4,1485,1278,-20
110393769249,110393769252,3,2183,1695,-20
110396340282,110396340278,-4,903,3480,-20
110403019772,110403019775,3,1092,1245,-20
110407384842,110407384845,3,1621,1571,-20
110408610063,110408610067,4,2427,1588,-20
110408722241,110408722244,3,912,1141,-20
110411424609,110411424613,4,1377,1266,-20
110416774462,110416774465,3,1808,1837,-20
110417992182,110417992186,4,1562,1321,-20
110419321821,110419321825,4,2839,1559,-20
110423182090,110423182094,4,1836,1041,-20
110426902002,110426902005,3,2568,1970,-20
110427373287,110427373290,3,2154,1638,-20
110428713941,110428713946,5,1356,1197,-20
110428806363,110428806369,6,1921,1572,-20
110430150991,110430150989,-2,2177,5031,-20
110430473042,110430473044,2,1718,1776,-20
110431928213,110431928207,-6,39449,11670,-20
110432117825,110432117828,3,2180,1334,-20
110436816758,110436816763,5,2090,1330,-20
110437001494,110437001498,4,1850,1303,-20
110437303822,110437303827,5,1990,1205,-20
110439482581,110439482584,3,1245,1468,-20
110439642924,110439642927,3,1425,1353,-20
110442113099,110442113102,3,2307,1560,-20
110442995002,110442995006,4,2800,1575,-20
110444009927,110444009932,5,1152,1230,-20
110444095278,110444095281,3,2514,1839,-20
110444609982,110444609987,5,1919,1451,-20
110445352070,110445352074,4,2113,1945,-20
110445869373,110445869371,-2,1556,1702,-20
110447323538,110447323530,-8,585,2217,-20
110447645866,110447645870,4,1781,1325,-20
110448349610,110448349616,6,3071,1475,-20
110450154916,110450154918,2,1800,1433,-20
110454294083,110454294085,2,1937,1389,-20
110454921957,110454921963,6,2197,933,-20
110456674754,110456674762,8,6443,1624,-20
110457355310,110457355313,3,1485,1096,-20
110458968045,110458968049,4,1684,1027,-20
110459868226,110459868230,4,1666,1131,-20
110465227381,110465227383,2,2113,1512,-20
110467596201,110467596203,2,1594,1563,-20
110470690080,110470690083,3,1483,1368,-20
110471131678,110471131681,3,1825,1523,-20
110471818358,110471818362,4,12165,9106,-20
110475496502,110475496506,4,2254,1376,-20
110476093428,110476093408,-20,1651,1035,-20
110476189090,110476189094,4,1707,1358,-20
110477391071,110477391075,4,2037,1262,-20
110478469334,110478469337,3,1110,1228,-20
110482378947,110482378951,4,1049,878,-20
110482433610,110482433614,4,1549,1182,-20
110485566549,110485566551,2,2426,1196,-20
110487394602,110487394605,3,991,1369,-20
110489159830,110489159834,4,2242,1154,-20
110490287894,110490287897,3,1774,1588,-20
110498816454,110498816459,5,1803,1657,-20
110501736829,110501736834,5,1605,1031,-20
110504016503,110504016510,7,2085,1423,-20
110504802390,110504802395,5,2086,1268,-20
110510664934,110510664935,1,1346,1537,-20
110511704282,110511704286,4,1830,1227,-20
110512522606,110512522607,1,1856,1650,-20
110512842469,110512842473,4,1610,1238,-20
110515210075,110515210079,4,1426,1596,-20
110517944328,110517944331,3,985,1019,-20
110518352195,110518352199,4,1738,1050,-20
110518428817,110518428819,2,1616,1202,-20
110521856271,110521856275,4,6523,21546,-20
110522458488,110522458491,3,2257,1404,-20
110524826845,110524826850,5,2512,1200,-20
110525148444,110525148447,3,1676,1145,-20
110525842046,110525842050,4,1455,1831,-20
110526903568,110526903567,-1,1384,1102,-20
110530955393,110530955396,3,1259,1066,-20
110532527953,110532527957,4,1857,1560,-20
110532792458,110532792462,4,2502,1712,-20
110535534944,110535534945,1,1634,1222,-20
110537294964,110537294968,4,1720,1380,-20
110538065725,110538065730,5,2280,1494,-20
110545010991,110545010983,-8,1109,5750,-20
110549266702,110549266707,5,2016,1703,-20
110550758683,110550758687,4,1161,1341,-20
110553246854,110553246854,0,1767,1603,-20
110553573681,110553573685,4,1549,1540,-20
110554610774,110554610776,2,2348,1509,-20
110554690539,110554690543,4,2073,1198,-20
110556108930,110556108931,1,1511,1841,-20
110561484895,110561484898,3,2209,1249,-20
110562013073,110562013077,4,1991,1470,-20
110566234218,110566234223,5,2313,1458,-20
110569526031,110569526034,3,2663,2186,-20
110569825570,110569825573,3,2072,1488,-20
110570265599,110570265602,3,1720,1544,-20
110570891591,110570891595,4,1434,1183,-20
110572167719,110572167721,2,2494,1295,-20
110572766157,110572766160,3,1675,1211,-20
110574263962,110574263941,-21,2308,1460,-20
110576146346,110576146347,1,1688,1410,-20
110576676463,110576676462,-1,29812,22094,-20
110577643924,110577643927,3,2058,1457,-20
110585317033,110585317035,2,1902,1490,-20
110587608841,110587608846,5,1937,1094,-20
110589762260,110589762262,2,1191,2069,-20
110590945902,110590945906,4,1573,1777,-20
110593830344,110593830347,3,2925,2112,-20
110594135256,110594135260,4,1940,1396,-20
110594409886,110594409865,-21,1869,1504,-20
110594654363,110594654368,5,1192,1726,-20
110597206248,110597206250,2,1917,1418,-20
110597624860,110597624863,3,1748,1229,-20
110599543158,110599543163,5,2627,1390,-20
110599957386,110599957390,4,1032,1223,-20
110600570270,110600570274,4,1509,1683,-20
110601756650,110601756655,5,2297,1367,-20
110606807568,110606807572,4,1660,1423,-20
110616994329,110616994333,4,2369,1386,-20
110619282166,110619282169,3,2326,1572,-20
110623533338,110623533339,1,1212,1188,-20
110624139823,110624139813,-10,1129,5213,-20
110625242009,110625242014,5,1831,1544,-20
110631153677,110631153679,2,1543,1526,-20
110632174123,110632174127,4,1582,1006,-20
110633342547,110633342550,3,1715,1472,-20
110635225573,110635225578,5,1814,1561,-20
110637445739,110637445742,3,1247,1086,-20
110638102941,110638102946,5,2365,1529,-20
110639953335,110639953338,3,1271,1043,-20
110641242016,110641242018,2,1528,1422,-20
110643370990,110643370992,2,1494,1190,-20
110646075073,110646075075,2,1472,1867,-20
110646717078,110646717081,3,1861,1663,-20
110646842678,110646842681,3,1797,894,-20
110648171292,110648171294,2,1943,1295,-20
110651061328,110651061330,2,1228,1577,-20
110653135661,110653135682,21,931,2275,-20
110654865753,110654865755,2,1717,1247,-20
110655201252,110655201254,2,2014,1607,-20
110655551217,110655551221,4,2608,1620,-20
110658529226,110658529226,0,1650,2094,-20
110664233174,110664233180,6,1743,1317,-20
110667297823,110667297827,4,1899,1579,-20
110673496706,110673496712,6,1374,949,-20
110679244752,110679244755,3,1485,1077,-20
110681175642,110681175646,4,1982,2179,-20
110684176551,110684176555,4,1420,888,-20
110684583043,110684583048,5,1667,1501,-20
110685268211,110685268216,5,1357,1553,-20
110686821619,110686821623,4,1109,894,-20
110686948990,110686948991,1,1732,1314,-20
110693064313,110693064315,2,1903,1704,-20
110701054210,110701054215,5,1198,956,-20
110701330390,110701330397,7,2169,1752,-20
110701771011,110701771015,4,1783,1013,-20
110702802826,110702802829,3,1924,1539,-20
110703517071,110703517074,3,1627,1412,-20
110707364907,110707364910,3,1272,1262,-20
110707917994,110707917997,3,42752,34866,-20
110711597093,110711597096,3,1786,1347,-20
110712540754,110712540754,0,1432,2491,-20
110712890958,110712890961,3,874,684,-20
110716079725,110716079731,6,1646,888,-20
110719624811,110719624814,3,1156,1319,-20
110727250789,110727250794,5,2515,1881,-20
110727987710,110727987713,3,2315,1208,-20
110736442331,110736442335,4,1995,1435,-20
110742019675,110742019679,4,1943,909,-20
110742225163,110742225162,-1,23606,19876,-20
110744488835,110744488826,-9,855,5305,-20
110745268416,110745268419,3,1562,1768,-20
110747489254,110747489258,4,1828,1292,-20
110749241175,110749241178,3,1486,1406,-20
110749955941,110749955921,-20,1518,971,-20
110750099990,110750099995,5,2131,1502,-20
110751069731,110751069733,2,1649,1299,-20
110753499173,110753499177,4,2338,1813,-20
110756702041,110756702045,4,2559,1916,-20
110757486542,110757486546,4,1533,1586,-20
110760955906,110760955911,5,2593,1293,-20
110761889282,110761889284,2,1844,1877,-20
110762222294,110762222299,5,2284,1659,-20
110764058179,110764058174,-5,1270,4382,-20
110767868230,110767868235,5,1505,1141,-20
110771684512,110771684514,2,2018,1189,-20
110772535435,110772535438,3,1063,785,-20
110774637165,110774637170,5,2024,1140,-20
110774756346,110774756329,-17,1417,1350,-20
110774854906,110774854910,4,1837,1233,-20
110775570094,110775570095,1,1244,1188,-20
110775934271,110775934275,4,1650,1358,-20
110779643862,110779643866,4,1470,1581,-20
110783000077,110783000082,5,1573,1478,-20
110784815834,110784815839,5,1138,1156,-20
110788126503,110788126506,3,2152,1975,-20
110790387189,110790387190,1,1618,1485,-20
110793127797,110793127800,3,1902,1554,-20
110799988275,110799988277,2,2597,2170,-20
110800025247,110800025250,3,1816,1509,-20
110802814360,110802814362,2,1838,1601,-20
110806386823,110806386826,3,2026,2091,-20
110808004598,110808004615,17,1403,1119,-20
110809585345,110809585349,4,1538,1683,-20
110814305094,110814305097,3,1724,1052,-20
110816719180,110816719186,6,1730,1365,-20
110818926135,110818926138,3,1761,1414,-20
110830747538,110830747546,8,2054,1629,-20
110832008657,110832008662,5,2347,1475,-20
110833670149,110833670152,3,1033,1018,-20
110837416326,110837416327,1,2167,1594,-20
110838448363,110838448365,2,1744,1082,-20
110839903543,110839903547,4,1976,1339,-20
110841032630,110841032633,3,1781,1329,-20
110843551572,110843551576,4,1922,1612,-20
110844608075,110844608079,4,1373,1591,-20
110846248981,110846248983,2,1230,1053,-20
110846385209,110846385227,18,1805,1169,-20
110847163833,110847163836,3,1957,1398,-20
110851267564,110851267565,1,1962,1432,-20
110853912997,110853913001,4,1984,1517,-20
110855938785,110855938787,2,713,915,-20
110861693150,110861693154,4,1021,884,-20
110862526869,110862526872,3,2184,1908,-20
110862783981,110862783985,4,2051,1028,-20
110865341135,110865341138,3,2284,1486,-20
110865699767,110865699771,4,1881,1735,-20
110867112421,110867112417,-4,889,2776,-20
110867162706,110867162710,4,1702,1553,-20
110868237189,110868237195,6,2273,1738,-20
110868916130,110868916134,4,1479,1630,-20
110871589758,110871589743,-15,1068,581,-20
110872106805,110872106810,5,2079,1440,-20
110872892753,110872892759,6,3599,1416,-20
110876029351,110876029355,4,1731,923,-20
110877166111,110877166116,5,2510,1591,-20
110878758758,110878758762,4,2339,1584,-20
110882516127,110882516129,2,819,502,-20
110885135922,110885135925,3,1726,1333,-20
110887743053,110887743057,4,1691,1353,-20
110891166678,110891166683,5,2278,1217,-20
110891464279,110891464257,-22,1160,798,-20
110895243461,110895243464,3,2256,1659,-20
110896945193,110896945194,1,1474,1407,-20
110899452952,110899452945,-7,1172,4722,-20
110901357666,110901357669,3,1610,1055,-20
110903221501,110903221506,5,1236,1149,-20
110903722275,110903722279,4,1595,1211,-20
110904465829,110904465832,3,1809,1495,-20
110908217214,110908217217,3,2192,1508,-20
110916444025,110916444026,1,1092,1317,-20
110917485255,110917485258,3,1683,1496,-20
110918376062,110918376065,3,1379,827,-20
110922781434,110922781438,4,2031,1300,-20
110923784870,110923784873,3,1780,1479,-20
110927013728,110927013732,4,1608,1519,-20
110928461456,110928461459,3,1753,1327,-20
110930037274,110930037276,2,1593,1864,-20
110934246414,110934246419,5,1568,1091,-20
110934752810,110934752814,4,1883,1269,-20
110936187685,110936187689,4,2312,2054,-20
110943535318,110943535321,3,1228,1292,-20
110946039234,110946039236,2,2160,1664,-20
110946980225,110946980229,4,2264,1711,-20
110951528813,110951528816,3,1723,983,-20
110952952055,110952952059,4,1780,807,-20
110959903598,110959903601,3,1311,1399,-20
110967647568,110967647571,3,2722,2088,-20
110970501567,110970501570,3,1214,1120,-20
110971603910,110971603913,3,2651,1660,-20
110972918685,110972918687,2,1512,1428,-20
110975426805,110975426809,4,2045,1579,-20
110975593952,110975593951,-1,1392,2290,-20
110976076102,110976076104,2,1673,1480,-20
110977535446,110977535449,3,5612,4809,-20
110978815024,110978815027,3,1563,1215,-20
110983982840,110983982842,2,1859,1311,-20
110987119877,110987119877,0,2196,2919,-20
110987510474,110987510477,3,1568,1717,-20
110988529369,110988529371,2,2026,1452,-20
110989211812,110989211815,3,1845,1176,-20
110989670728,110989670731,3,1949,1938,-20
110990541215,110990541217,2,1252,1582,-20
110992280147,110992280151,4,1997,1244,-20
110994354314,110994354317,3,1591,1300,-20
110998917082,110998917085,3,2278,1470,-20
110999320370,110999320353,-17,962,326,-20
111003814137,111003814139,2,2275,1529,-20
111006349170,111006349174,4,2427,1236,-20
111007826586,111007826588,2,1521,1485,-20
111008292078,111008292081,3,1979,1084,-20
111008732239,111008732236,-3,1912,3634,-20
111008867916,111008867920,4,2640,1711,-20
111010264144,111010264147,3,2118,1352,-20
111010754207,111010754210,3,1358,1295,-20
111011743463,111011743462,-1,35328,50195,-20
111012793178,111012793185,7,6588,2564,-20
111013252635,111013252638,3,1205,1375,-20
111013950837,111013950841,4,2464,1113,-20
111017652359,111017652362,3,1515,1576,-20
111023242671,111023242679,8,6697,23999,-20
111028679260,111028679262,2,1108,1205,-20
111029945422,111029945426,4,1355,1155,-20
111030474899,111030474905,6,990,1071,-20
111033251626,111033251627,1,1220,1455,-20
111033854140,111033854145,5,1837,1367,-20
111035336194,111035336196,2,2300,1426,-20
111040553369,111040553374,5,1733,1463,-20
111048696674,111048696670,-4,3469,7116,-20
111060592970,111060592976,6,3563,2060,-20
111060821026,111060821030,4,1658,1311,-20
111062965127,111062965130,3,1692,1627,-20
111065904282,111065904286,4,2395,1640,-20
111068769046,111068769050,4,1980,1209,-20
111069857653,111069857655,2,2239,1137,-20
111074421694,111074421698,4,1829,1358,-20
111077088041,111077088046,5,2114,1026,-20
111077177178,111077177183,5,1220,704,-20
111078466849,111078466849,0,1490,1276,-20
111079011591,111079011593,2,968,1223,-20
111084585042,111084585046,4,2660,1249,-20
111085388138,111085388142,4,1455,1044,-20
111086207878,111086207884,6,1597,1515,-20
111094410185,111094410191,6,1540,955,-20
111096955570,111096955572,2,1548,1546,-20
111101130823,111101130829,6,1740,1007,-20
111101242998,111101242976,-22,835,486,-20
111102728218,111102728222,4,1418,1287,-20
111103679854,111103679862,8,2203,1094,-20
111105257676,111105257682,6,2070,1464,-20
111108203192,111108203194,2,1267,1469,-20
111108981742,111108981746,4,1716,1453,-20
111109539364,111109539362,-2,1217,1411,-20
111111069974,111111069967,-7,1641,3084,-20
111111608115,111111608113,-2,1149,2146,-20
111113865531,111113865533,2,1966,1632,-20
111115623418,111115623407,-11,1637,879,-20
111116867166,111116867170,4,1536,1302,-20
111117289865,111117289870,5,1743,1327,-20
111118012715,111118012720,5,1752,975,-20
111121680730,111121680733,3,1585,1812,-20
111123268726,111123268734,8,1753,1209,-20
111125597744,111125597747,3,2408,1516,-20
111125912247,111125912265,18,1003,1410,-20
111128234651,111128234653,2,1703,1501,-20
111129935337,111129935338,1,1983,1350,-20
111131324605,111131324610,5,2167,1636,-20
111135542882,111135542898,16,2267,1298,-20
111139807614,111139807614,0,699,879,-20
111140370979,111140370982,3,1629,1500,-20
111141024908,111141024914,6,2031,1426,-20
111142589747,111142589750,3,1716,1446,-20
111143838685,111143838685,0,5179,6981,-20
111143944161,111143944166,5,1794,2084,-20
111144470193,111144470196,3,1732,1204,-20
111146844944,111146844950,6,1769,1316,-20
111147531294,111147531298,4,1425,990,-20
111148074523,111148074527,4,2139,999,-20
111148805580,111148805585,5,1657,1556,-20
111148869947,111148869951,4,2815,924,-20
111151734870,111151734874,4,1691,1444,-20
111156011614,111156011620,6,2263,1723,-20
111161061254,111161061257,3,2020,2428,-20
111161852173,111161852177,4,1136,1336,-20
111163357383,111163357384,1,2428,2933,-20
111164885974,111164885978,4,1314,1048,-20
111169079385,111169079387,2,1718,1382,-20
111172654203,111172654205,2,913,965,-20
111174308812,111174308814,2,1398,1103,-20
111182026979,111182026982,3,1225,1285,-20
111182295417,111182295419,2,1492,1657,-20
111182308976,111182308978,2,134,38,-20
111183224752,111183224754,2,2472,1563,-20
111183699085,111183699089,4,4788,3024,-20
111184024771,111184024771,0,727,902,-20
111187368713,111187368706,-7,1028,6599,-20
111188660600,111188660605,5,1956,1811,-20
111194983182,111194983179,-3,790,2128,-20
111195577050,111195577053,3,1803,1294,-20
111196188711,111196188715,4,1786,1201,-20
111199305417,111199305421,4,2597,2612,-20
111200690555,111200690558,3,1358,1407,-20
111203212934,111203212938,4,410,653,-20
111203769382,111203769386,4,1593,1457,-20
111205018940,111205018943,3,1799,1197,-20
111208555132,111208555121,-11,1138,2593,-20
111210487811,111210487817,6,2084,1834,-20
111214578571,111214578577,6,1837,1378,-20
111215808838,111215808834,-4,1296,2268,-20
111217644343,111217644345,2,1936,1185,-20
111222093590,111222093595,5,1855,1940,-20
111223374579,111223374587,8,9523,34639,-20
111229273500,111229273505,5,1739,1294,-20
111230995569,111230995569,0,1345,1615,-20
111232885329,111232885333,4,6389,28576,-20
111235012980,111235012983,3,1173,888,-20
111239080397,111239080398,1,1840,1598,-20
111239195886,111239195893,7,1802,1538,-20
111243173748,111243173751,3,1910,1482,-20
111243726952,111243726954,2,1168,1289,-20
111244431919,111244431922,3,2370,1143,-20
111245107837,111245107838,1,1217,677,-20
111253670407,111253670409,2,1675,1427,-20
111257528550,111257528531,-19,834,636,-20
111262907162,111262907166,4,1728,1177,-20
111265562211,111265562214,3,1553,1243,-20
111273207533,111273207528,-5,2311,7729,-20
111277763010,111277763013,3,2045,1548,-20
111278308900,111278308902,2,1875,1468,-20
111279436350,111279436354,4,1774,1169,-20
111279814302,111279814284,-18,1632,896,-20
111281166570,111281166570,0,1917,892,-20
111281201736,111281201738,2,2171,2594,-20
111281819859,111281819842,-17,1182,920,-20
111282881394,111282881398,4,1719,1621,-20
111284383959,111284383962,3,1048,1018,-20
111285130782,111285130787,5,1475,1670,-20
111287300149,111287300151,2,1946,1212,-20
111293822630,111293822635,5,1268,1296,-20
111294842738,111294842741,3,1197,919,-20
111297150770,111297150774,4,1569,1296,-20
111297907138,111297907140,2,1371,1182,-20
111300939360,111300939365,5,1551,1252,-20
111306103406,111306103409,3,2184,1727,-20
111309387177,111309387183,6,2232,1708,-20
111310750798,111310750802,4,1868,1268,-20
111315504704,111315504708,4,1766,1499,-20
111318480670,111318480675,5,1304,759,-20
111319773407,111319773411,4,1662,1407,-20
111322282965,111322282970,5,1776,1331,-20
111325091492,111325091497,5,1281,1429,-20
111326295618,111326295622,4,1591,1290,-20
111328365417,111328365418,1,1782,1560,-20
111329555606,111329555611,5,1638,1359,-20
111330558485,111330558479,-6,1860,6125,-20
111331812652,111331812645,-7,2528,8352,-20
111345837094,111345837098,4,1767,1176,-20
111347226551,111347226558,7,2963,1683,-20
111348096726,111348096726,0,922,1616,-20
111355074896,111355074901,5,2690,1416,-20
111355409643,111355409626,-17,1451,842,-20
111356217378,111356217382,4,2135,1552,-20
111360210470,111360210475,5,2677,1586,-20
111364169874,111364169879,5,2068,1275,-20
111372022944,111372022945,1,2387,1824,-20
111373560361,111373560371,10,11226,30313,-20
111374262253,111374262256,3,2538,2127,-20
111375420636,111375420622,-14,951,1417,-20
111375920522,111375920525,3,1550,1814,-20
111379146914,111379146919,5,2170,1832,-20
111379802737,111379802740,3,1564,1775,-20
111380084372,111380084374,2,1831,1615,-20
111380488003,111380488007,4,2016,1393,-20
111380707789,111380707769,-20,2506,1345,-20
111385762563,111385762567,4,675,393,-20
111389907122,111389907125,3,1981,1599,-20
111392600665,111392600666,1,1129,1366,-20
111393153167,111393153170,3,733,240,-20
111394584719,111394584720,1,2092,1151,-20
111398043807,111398043815,8,801,600,-20
111404182026,111404182029,3,1955,1895,-20
111405462109,111405462113,4,2279,1702,-20
111413107827,111413107832,5,1650,1387,-20
111420229977,111420229982,5,1447,1502,-20
111421016384,111421016387,3,2476,1253,-20
111422685182,111422685187,5,1280,1148,-20
111424651599,111424651593,-6,1146,3185,-20
111427482395,111427482398,3,1267,1355,-20
111430248594,111430248594,0,1268,1397,-20
111431179185,111431179186,1,952,1673,-20
111431979136,111431979138,2,1974,1718,-20
111432334490,111432334490,0,1879,1100,-20
111437299799,111437299803,4,1144,916,-20
111439622402,111439622405,3,1725,1089,-20
111441789677,111441789681,4,2905,1743,-20
111445552391,111445552394,3,1442,1758,-20
111449357537,111449357540,3,1622,1846,-20
111450608279,111450608281,2,1368,1045,-20
111453015818,111453015822,4,1926,1555,-20
111457025291,111457025295,4,816,475,-20
111460587632,111460587626,-6,1184,4235,-20
111461490911,111461490917,6,5339,2546,-20
111461830550,111461830568,18,1124,4456,-20
111465283273,111465283275,2,1784,1085,-20
111465510837,111465510819,-18,1957,1715,-20
111467393714,111467393716,2,2412,1287,-20
111471692394,111471692396,2,2002,1365,-20
111473599285,111473599286,1,2528,1592,-20
111475539016,111475539022,6,2469,1329,-20
111477766311,111477766315,4,2376,1848,-20
111480308926,111480308926,0,752,979,-20
111483425433,111483425438,5,3269,1761,-20
111484729158,111484729160,2,1654,1219,-20
111487394638,111487394641,3,2352,1232,-20
111491763172,111491763174,2,1962,1313,-20
111492444513,111492444518,5,1385,1264,-20
111494142597,111494142603,6,1812,1315,-20
111494724852,111494724854,2,1710,1290,-20
111497227162,111497227166,4,2058,1637,-20
111497538902,111497538910,8,2394,975,-20
111497707601,111497707606,5,2188,1414,-20
111497744453,111497744455,2,1869,1236,-20
111498735791,111498735798,7,2996,1627,-20
111504350706,111504350709,3,2032,1298,-20
111507339437,111507339439,2,1273,934,-20
111510320293,111510320297,4,1812,1262,-20
111510772074,111510772077,3,1516,1144,-20
111512127105,111512127107,2,1845,1618,-20
111514890429,111514890431,2,1314,1170,-20
111516101543,111516101547,4,1803,2433,-20
111516868349,111516868351,2,1682,1664,-20
111522545637,111522545642,5,2850,1798,-20
111524373873,111524373859,-14,4046,14559,-20
111531769483,111531769486,3,2015,1544,-20
111531961407,111531961411,4,1437,1401,-20
111532053744,111532053747,3,2771,1265,-20
111535219090,111535219093,3,1347,1141,-20
111541886476,111541886473,-3,2454,3226,-20
111543907534,111543907538,4,2109,1389,-20
111550065080,111550065082,2,2787,2472,-20
111551723612,111551723615,3,1789,1265,-20
111554439862,111554439866,4,1733,1200,-20
111558607102,111558607106,4,1937,1548,-20
111559795973,111559795975,2,2801,1728,-20
111565080057,111565080059,2,2123,1181,-20
111566277461,111566277463,2,1705,1722,-20
111569044520,111569044525,5,2101,1915,-20
111572866344,111572866348,4,1794,1576,-20
111573396334,111573396337,3,1272,811,-20
111573680561,111573680562,1,1701,1683,-20
111574354081,111574354086,5,2267,1182,-20
111576665458,111576665462,4,1966,1026,-20
111576732227,111576732233,6,2816,1845,-20
111576807915,111576807919,4,28891,57586,-20
111582775498,111582775498,0,1847,2163,-20
111584142415,111584142417,2,2168,1458,-20
111585861326,111585861331,5,1877,970,-20
111587469185,111587469188,3,1762,1635,-20
111589572341,111589572343,2,2065,1508,-20
111591927353,111591927356,3,1368,1246,-20
111604912394,111604912398,4,1567,1388,-20
111606031074,111606031079,5,2167,2075,-20
111607636765,111607636767,2,1511,1426,-20
111608387193,111608387195,2,1668,1551,-20
111608797010,111608797011,1,1456,1977,-20
111609568723,111609568724,1,1800,1147,-20
111609836793,111609836795,2,1574,1261,-20
111612447577,111612447578,1,1679,1095,-20
111613846817,111613846819,2,1295,919,-20
111616227782,111616227783,1,1578,1618,-20
111616693348,111616693351,3,1897,1476,-20
111616988812,111616988817,5,4793,2906,-20
111618144258,111618144254,-4,403,688,-20
111618848613,111618848618,5,2785,1674,-20
111624656599,111624656602,3,1508,1283,-20
111625672979,111625672979,0,1187,1595,-20
111625812000,111625812009,9,1347,1106,-20
111627621711,111627621714,3,1122,759,-20
111628272877,111628272857,-20,1558,1340,-20
111631998428,111631998431,3,2023,1746,-20
111636725381,111636725382,1,1307,1101,-20
111638666246,111638666249,3,2240,939,-20
111638759854,111638759872,18,1968,1395,-20
111640111113,111640111115,2,1910,1417,-20
111640603225,111640603231,6,2096,1263,-20
111644486218,111644486224,6,1396,1396,-20
111645032078,111645032057,-21,1168,689,-20
111645068813,111645068817,4,1748,1649,-20
111646592401,111646592397,-4,878,2652,-20
111648811647,111648811640,-7,905,362,-20
111649577342,111649577344,2,1972,1647,-20
111650595774,111650595779,5,1799,1117,-20
111653111871,111653111874,3,2813,1850,-20
111653323966,111653323970,4,1195,945,-20
111654388213,111654388214,1,1882,1280,-20
111655420125,111655420126,1,2056,1849,-20
111666953367,111666953374,7,4948,1485,-20
111667373075,111667373059,-16,2250,1826,-20
111668379102,111668379106,4,5135,23666,-20
111672459320,111672459321,1,1219,1399,-20
111673784555,111673784559,4,1871,1575,-20
111683816933,111683816937,4,2157,1659,-20
111688772144,111688772146,2,1783,1682,-20
111689963565,111689963570,5,5321,1691,-20
111691954690,111691954694,4,2163,1024,-20
111693858137,111693858141,4,1604,1239,-20
111701532303,111701532307,4,1720,927,-20
111702765046,111702765052,6,2236,1360,-20
111705172420,111705172422,2,1730,1075,-20
111705333299,111705333302,3,1581,1057,-20
111705488490,111705488495,5,2348,1818,-20
111708373176,111708373182,6,2346,1682,-20
111709092883,111709092886,3,1587,1385,-20
111709447361,111709447366,5,2449,1423,-20
111710482711,111710482715,4,1749,1143,-20
111710801954,111710801961,7,2094,1108,-20
111717400378,111717400382,4,1695,1081,-20
111721760929,111721760932,3,1799,1407,-20
111726318235,111726318238,3,1721,1464,-20
111729566442,111729566446,4,1109,1154,-20
111731097491,111731097498,7,1229,1496,-20
111732586167,111732586171,4,1742,1514,-20
111735399455,111735399463,8,2816,1764,-20
111737047666,111737047662,-4,843,2472,-20
111740201078,111740201082,4,1846,1336,-20
111746828400,111746828402,2,2022,1402,-20
111747753383,111747753386,3,2742,2121,-20
111748851085,111748851082,-3,1357,2238,-20
111750714577,111750714579,2,1940,1162,-20
111755054734,111755054739,5,1117,1318,-20
111756581701,111756581705,4,1099,976,-20
111760201995,111760201998,3,1001,1548,-20
111761456638,111761456643,5,1922,1109,-20
111763378014,111763378025,11,15074,38073,-20
111763678759,111763678757,-2,44340,19210,-20
111766167458,111766167462,4,2129,1686,-20
111767899406,111767899408,2,1677,1647,-20
111767979563,111767979567,4,1272,1166,-20
111769764985,111769764989,4,2065,1572,-20
111772290677,111772290681,4,2020,1365,-20
111776331586,111776331590,4,1830,1569,-20
111778742829,111778742831,2,1593,1896,-20
111780946914,111780946917,3,3231,1638,-20
111783320062,111783320067,5,2398,1994,-20
111784133017,111784133022,5,3099,1160,-20
111785372008,111785372003,-5,932,1855,-20
111785894813,111785894815,2,1781,1497,-20
111786754853,111786754854,1,1867,1335,-20
111786901007,111786901011,4,1892,1110,-20
111789845439,111789845442,3,1678,1585,-20
111790542366,111790542367,1,1361,933,-20
111792574606,111792574609,3,1583,1526,-20
111793665015,111793665019,4,2037,1733,-20
111793942631,111793942632,1,2016,1524,-20
111796271852,111796271855,3,1673,1556,-20
111796460007,111796459987,-20,892,854,-20
111803822640,111803822644,4,2240,1441,-20
111804462065,111804462065,0,26578,21199,-20
111806162386,111806162383,-3,2189,4934,-20
111815228835,111815228838,3,1708,1333,-20
111817002897,111817002900,3,2474,1746,-20
111819701139,111819701139,0,1036,1227,-20
111820978503,111820978501,-2,1274,2661,-20
111822975186,111822975189,3,2029,1692,-20
111825046641,111825046644,3,1301,1397,-20
111825124811,111825124814,3,1560,1523,-20
111828206731,111828206735,4,1976,1490,-20
111828861464,111828861466,2,1970,1365,-20
111829070171,111829070171,0,1078,1609,-20
111831832554,111831832557,3,1628,1960,-20
111834429898,111834429901,3,1849,1743,-20
111835391906,111835391907,1,1249,950,-20
111836406630,111836406632,2,4257,4230,-20
111837000470,111837000474,4,1347,2012,-20
111838689116,111838689120,4,2017,1295,-20
111839748639,111839748645,6,4634,2224,-20
111843788880,111843788881,1,1437,1138,-20
111844606970,111844606974,4,2074,1893,-20
111849526695,111849526698,3,1915,1313,-20
111849705168,111849705186,18,1735,1100,-20
111850180385,111850180388,3,2073,1925,-20
111852792651,111852792655,4,1942,1275,-20
111853680171,111853680173,2,2032,1824,-20
111854698421,111854698423,2,1250,870,-20
111855600270,111855600275,5,1557,1062,-20
111865043899,111865043903,4,1300,1588,-20
111865531634,111865531637,3,1514,1067,-20
111865853930,111865853935,5,1776,1262,-20
111870823534,111870823535,1,2121,1597,-20
111871325051,111871325053,2,2311,1208,-20
111871814085,111871814091,6,2022,978,-20
111875675190,111875675194,4,1853,1914,-20
111884119462,111884119466,4,2671,1538,-20
111887463363,111887463365,2,1275,1248,-20
111890091268,111890091266,-2,1283,1636,-20
111890879623,111890879626,3,1767,1187,-20
111892064531,111892064535,4,1708,1367,-20
111892240254,111892240233,-21,2166,1468,-20
111892916776,111892916779,3,1312,1381,-20
111892970088,111892970092,4,1955,1692,-20
111895116751,111895116755,4,1641,1380,-20
111895219074,111895219078,4,2818,1571,-20
111895404549,111895404553,4,1992,1663,-20
111897021542,111897021543,1,1773,1880,-20
111898065403,111898065407,4,1558,1217,-20
111898934743,111898934755,12,2025,1253,-20
111899577479,111899577465,-14,2292,1349,-20
111901006230,111901006235,5,1255,608,-20
111902462210,111902462212,2,2654,2007,-20
111905158385,111905158386,1,2056,1398,-20
111906959819,111906959821,2,2156,1511,-20
111909401733,111909401734,1,1749,1022,-20
111911624622,111911624624,2,1812,1757,-20
111912645974,111912645979,5,2190,1308,-20
111920409718,111920409713,-5,2059,7883,-20
111921104687,111921104692,5,1290,1457,-20
111922044082,111922044079,-3,717,947,-20
111923189743,111923189724,-19,1800,868,-20
111923426746,111923426749,3,2321,1548,-20
111925790462,111925790465,3,1225,1411,-20
111926099555,111926099560,5,1963,1774,-20
111926246766,111926246754,-12,720,334,-20
111926964602,111926964607,5,1336,1169,-20
111928133137,111928133133,-4,2852,8906,-20
111929852002,111929851997,-5,1034,5303,-20
111936803346,111936803347,1,1416,1509,-20
111937688633,111937688638,5,3382,1428,-20
111937853806,111937853828,22,1555,963,-20
111940631943,111940631947,4,1480,1617,-20
111943894834,111943894838,4,1291,1801,-20
111945288882,111945288885,3,2112,1183,-20
111946573950,111946573951,1,2373,1805,-20
111950919555,111950919559,4,1478,1052,-20
111951055810,111951055812,2,2077,1205,-20
111952146398,111952146401,3,791,907,-20
111955636847,111955636850,3,950,1036,-20
111955711302,111955711321,19,2034,1355,-20
111957834962,111957834967,5,1206,1378,-20
111957964030,111957964008,-22,2837,1925,-20
111959322482,111959322486,4,2033,1781,-20
111960379655,111960379658,3,1212,1340,-20
111961582850,111961582834,-16,873,954,-20
111962034448,111962034450,2,1524,1527,-20
111963040034,111963040039,5,1981,1392,-20
111963157941,111963157945,4,2606,2007,-20
111965948533,111965948535,2,1825,1183,-20
111966080411,111966080415,4,1410,949,-20
111966402879,111966402883,4,2635,1229,-20
111967952250,111967952252,2,1042,1468,-20
111970369083,111970369078,-5,32650,12636,-20
111971185709,111971185710,1,2334,1566,-20
111971670275,111971670279,4,1847,1141,-20
111971765502,111971765483,-19,1906,1857,-20
111972684390,111972684396,6,1690,1656,-20
111976814579,111976814581,2,1821,1694,-20
111977913424,111977913427,3,1248,1432,-20
111978113485,111978113496,11,725,172,-20
111979914377,111979914378,1,1062,1184,-20
111980093286,111980093290,4,1316,935,-20
111980557753,111980557763,10,2353,1518,-20
111984791936,111984791941,5,2090,1254,-20
111985110453,111985110456,3,1785,1793,-20
111985677106,111985677111,5,1564,1165,-20
111989182040,111989182041,1,1841,1614,-20
111989833971,111989833974,3,1371,1258,-20
111993594642,111993594637,-5,1345,7290,-20
111995749348,111995749350,2,1712,1262,-20
111996132130,111996132134,4,2723,2000,-20
112001352313,112001352311,-2,1089,2416,-20
112002144963,112002144966,3,1418,1246,-20
112005895811,112005895806,-5,2519,11849,-20
112006003523,112006003527,4,1446,1566,-20
112008516847,112008516851,4,1647,842,-20
112009271709,112009271711,2,1286,1280,-20
112011878761,112011878762,1,1314,1233,-20
112012903249,112012903271,22,1073,1217,-20
112013313482,112013313485,3,1727,1869,-20
112014084289,112014084296,7,2182,1290,-20
112015910043,112015910046,3,617,552,-20
112016989308,112016989310,2,1862,1508,-20
112017737793,112017737794,1,1415,1868,-20
112018102706,112018102706,0,1833,1126,-20
112022464112,112022464117,5,2257,1826,-20
112025245168,112025245171,3,1297,1104,-20
112027980674,112027980678,4,1872,1640,-20
112033984468,112033984469,1,1203,1901,-20
112036314029,112036314031,2,1671,1066,-20
112038385187,112038385193,6,1249,863,-20
112043548488,112043548492,4,2060,1633,-20
112048538838,112048538842,4,2468,1380,-20
112052963009,112052963013,4,2274,2348,-20
112053844655,112053844661,6,2550,1505,-20
112058428854,112058428857,3,1231,1337,-20
112065781921,112065781926,5,1754,1399,-20
112066436054,112066436058,4,1697,1283,-20
112068873825,112068873822,-3,1303,2831,-20
112073129326,112073129330,4,1267,1140,-20
112075840490,112075840495,5,1305,1607,-20
112077102869,112077102875,6,995,816,-20
112080481723,112080481726,3,1604,1643,-20
112085014034,112085014038,4,1464,1120,-20
112086361424,112086361427,3,1935,1070,-20
112087390892,112087390896,4,1646,1503,-20
112088058946,112088058950,4,1608,1055,-20
112089013237,112089013241,4,1806,1345,-20
112089906702,112089906706,4,2411,1437,-20
112091014269,112091014270,1,2012,1995,-20
112093036845,112093036849,4,1864,1308,-20
112093332587,112093332602,15,1943,1425,-20
112094089342,112094089346,4,4287,2631,-20
112094715819,112094715814,-5,1479,9701,-20
112099582397,112099582398,1,1955,1941,-20
112100521250,112100521245,-5,1064,2665,-20
112104914290,112104914292,2,1383,1087,-20
112106129990,112106129973,-17,1038,1371,-20
112108514100,112108514082,-18,30,980,-20
112110623866,112110623871,5,1162,1227,-20
112111506775,112111506778,3,2038,1446,-20
112114675894,112114675891,-3,795,2302,-20
112116728595,112116728597,2,1640,2429,-20
112118067095,112118067099,4,2637,2211,-20
112122483166,112122483173,7,2243,1176,-20
112126576923,112126576934,11,10966,44303,-20
112128865820,112128865823,3,1561,1002,-20
112129824778,112129824783,5,1229,1612,-20
112129891762,112129891769,7,232,1574,-20
112131068875,112131068878,3,1897,1561,-20
112134594878,112134594881,3,1819,1060,-20
112135134481,112135134485,4,1684,1095,-20
112138012953,112138012955,2,1775,1587,-20
112138281422,112138281425,3,2048,1355,-20
112139303244,112139303227,-17,2737,1560,-20
112143238247,112143238250,3,1917,1564,-20
112146965638,112146965642,4,1783,1656,-20
112147274602,112147274603,1,627,359,-20
112148451762,112148451765,3,1136,1446,-20
112148740978,112148740981,3,1796,1666,-20
112151501614,112151501616,2,1720,1388,-20
112151799386,112151799391,5,2426,1773,-20
112153264649,112153264653,4,1967,1918,-20
112153661598,112153661601,3,1919,1116,-20
112157402862,112157402866,4,1684,1122,-20
112157803970,112157803973,3,2214,1843,-20
112160522244,112160522250,6,2430,923,-20
112162224305,112162224306,1,1032,1523,-20
112162959361,112162959362,1,1569,1644,-20
112166793510,112166793512,2,2651,1888,-20
112168585523,112168585525,2,1647,1168,-20
112169519514,112169519514,0,1796,2450,-20
112172833393,112172833395,2,1125,1017,-20
112174793452,112174793453,1,1656,1374,-20
112175130321,112175130325,4,1931,1736,-20
112184102981,112184102977,-4,1143,2070,-20
112186768871,112186768876,5,1501,1812,-20
112186846645,112186846656,11,2502,1533,-20
112189342690,112189342691,1,1350,1127,-20
112189602193,112189602196,3,1874,1211,-20
112194590606,112194590610,4,2223,1507,-20
112196773967,112196773970,3,2133,1268,-20
112196869908,112196869914,6,2178,1455,-20
112197101303,112197101307,4,1042,748,-20
112201530255,112201530258,3,1638,1186,-20
112202630562,112202630566,4,1967,1776,-20
112206300255,112206300257,2,2045,1742,-20
112206541554,112206541558,4,1717,831,-20
112208708521,112208708526,5,1211,1313,-20
112210001266,112210001270,4,2365,1700,-20
112212996916,112212996919,3,1622,1310,-20
112214457252,112214457254,2,2894,2456,-20
112215226150,112215226154,4,1739,1317,-20
112216518085,112216518088,3,1303,1198,-20
112218708288,112218708292,4,2905,1498,-20
112220237038,112220237041,3,1564,1719,-20
112221575493,112221575498,5,1387,768,-20
112231376076,112231376078,2,2021,1584,-20
112233061283,112233061286,3,2029,1655,-20
112237643968,112237643966,-2,1199,2813,-20
112238073586,112238073589,3,1796,1136,-20
112239561182,112239561183,1,1252,943,-20
112240043130,112240043135,5,1955,1474,-20
112240451013,112240451017,4,1148,985,-20
112242678678,112242678680,2,1903,1760,-20
112242875675,112242875678,3,2414,1802,-20
112243201163,112243201167,4,2260,1621,-20
112244096120,112244096123,3,2266,1206,-20
112244616291,112244616295,4,2423,1827,-20
112247864885,112247864890,5,2262,1320,-20
112249423680,112249423683,3,1664,911,-20
112249752373,112249752377,4,2054,1738,-20
112252670973,112252670977,4,2074,1144,-20
112259970040,112259970046,6,3173,1512,-20
112264479721,112264479724,3,1348,1486,-20
112265785518,112265785521,3,1830,1833,-20
112268363470,112268363473,3,1712,1207,-20
112268973686,112268973688,2,2260,1551,-20
112273336274,112273336278,4,1998,1278,-20
112275102518,112275102522,4,1134,1137,-20
112276327090,112276327093,3,1414,938,-20
112280052475,112280052479,4,1413,1003,-20
112282674930,112282674933,3,1599,1749,-20
112287969570,112287969575,5,1325,1165,-20
112292525901,112292525904,3,1727,1387,-20
112297816414,112297816418,4,2001,1432,-20
112301803301,112301803306,5,1841,1421,-20
112302720514,112302720520,6,4348,1269,-20
112305141570,112305141563,-7,1017,5364,-20
112305423851,112305423854,3,1615,1308,-20
112305823702,112305823714,12,1595,1283,-20
112313314011,112313314015,4,2158,1956,-20
112315046213,112315046223,10,1472,1689,-20
112316120910,112316120905,-5,1226,2839,-20
112316451978,112316451983,5,2129,1407,-20
112317887303,112317887283,-20,1219,1040,-20
112320157154,112320157157,3,2120,1122,-20
112327104205,112327104210,5,1642,1195,-20
112327915701,112327915707,6,2899,1316,-20
112328915646,112328915650,4,1739,1697,-20
112329214062,112329214066,4,1570,1242,-20
112329686885,112329686889,4,2112,1058,-20
112330935431,112330935425,-6,1711,5776,-20
112331007781,112331007782,1,1870,1117,-20
112331770979,112331770982,3,1389,1826,-20
112334048370,112334048373,3,1750,1365,-20
112334303812,112334303815,3,1440,1100,-20
112335117127,112335117129,2,1425,1285,-20
112337513359,112337513355,-4,43548,6007,-20
112338880698,112338880702,4,2467,1472,-20
112340190785,112340190790,5,2701,1872,-20
112340223847,112340223853,6,2719,1257,-20
112343390015,112343390020,5,545,143,-20
112346484756,112346484759,3,1568,1217,-20
112348541169,112348541174,5,2394,1395,-20
112351555172,112351555174,2,1605,1521,-20
112352531401,112352531405,4,1318,1291,-20
112356166695,112356166695,0,1387,673,-20
112356393773,112356393778,5,1373,999,-20
112357303282,112357303285,3,1766,1560,-20
112363440653,112363440658,5,1062,1173,-20
112367378314,112367378319,5,3326,2084,-20
112367439449,112367439450,1,1418,1347,-20
112368390075,112368390066,-9,1050,5001,-20
112368674627,112368674630,3,1398,1175,-20
112371505730,112371505734,4,1690,1097,-20
112374822160,112374822162,2,2429,1869,-20
112379832982,112379832987,5,1911,1719,-20
112380067094,112380067096,2,2706,2398,-20
112380880490,112380880493,3,2011,1271,-20
112387213486,112387213491,5,1471,1071,-20
112390037392,112390037394,2,1747,1335,-20
112390214468,112390214470,2,1768,1330,-20
112394964913,112394964909,-4,1013,2331,-20
112396891591,112396891595,4,2047,1449,-20
112397448526,112397448530,4,1879,1546,-20
112399923110,112399923114,4,1960,1733,-20
112401084312,112401084316,4,2693,1277,-20
112402870386,112402870391,5,1591,1381,-20
112402936090,112402936072,-18,684,393,-20
112403476919,112403476927,8,1778,1301,-20
112405687828,112405687832,4,1621,1664,-20
112406170794,112406170797,3,3417,2201,-20
112411957069,112411957071,2,1599,1241,-20
112412192211,112412192214,3,1832,1273,-20
112413360524,112413360528,4,2020,1665,-20
112415990031,112415990034,3,1337,1334,-20
112416097461,112416097462,1,1438,1524,-20
112417372246,112417372250,4,1555,1079,-20
112417530291,112417530296,5,1951,1644,-20
112424471431,112424471434,3,1987,1730,-20
112427595739,112427595738,-1,1613,1810,-20
112428837806,112428837807,1,1654,1246,-20
112430449438,112430449442,4,2654,1356,-20
112431707889,112431707893,4,1445,1366,-20
112435442683,112435442680,-3,4791,11478,-20
112437203014,112437203019,5,2527,1841,-20
112438892465,112438892467,2,955,957,-20
112444597755,112444597757,2,1373,1724,-20
112445893034,112445893038,4,1588,1322,-20
112446589885,112446589886,1,1477,1407,-20
112446855654,112446855658,4,2035,1726,-20
112449443275,112449443279,4,1693,1424,-20
112449589671,112449589651,-20,1810,1928,-20
112453046333,112453046335,2,1745,1366,-20
112455498578,112455498572,-6,704,2262,-20
112457372234,112457372237,3,1819,1298,-20
112459102806,112459102809,3,1822,1169,-20
112461943641,112461943644,3,1718,1243,-20
112464781963,112464781968,5,1732,1021,-20
112469303457,112469303459,2,1501,2291,-20
112470833793,112470833796,3,1584,1454,-20
112476509458,112476509454,-4,733,2211,-20
112476813758,112476813761,3,1443,868,-20
112478637742,112478637745,3,1311,939,-20
112479181773,112479181778,5,3688,1460,-20
112479543460,112479543448,-12,30450,15855,-20
112485811210,112485811215,5,1842,1136,-20
112485838129,112485838112,-17,2327,1250,-20
112485904506,112485904491,-15,715,732,-20
112486840328,112486840326,-2,2353,3743,-20
112486950796,112486950798,2,2280,2117,-20
112488008882,112488008882,0,2013,1695,-20
112489920495,112489920498,3,1663,1207,-20
112490566412,112490566415,3,1029,1265,-20
112490950226,112490950229,3,1676,1609,-20
112491766674,112491766677,3,2199,1859,-20
112491824126,112491824119,-7,1564,10258,-20
112492257382,112492257395,13,972,1436,-20
112493655725,112493655727,2,1924,1259,-20
112495982316,112495982319,3,1802,1965,-20
112496668757,112496668763,6,1755,1371,-20
112497940749,112497940752,3,11468,39452,-20
112499882573,112499882577,4,1720,1541,-20
112501250647,112501250628,-19,2142,1125,-20
112504429707,112504429709,2,1266,1431,-20
112509762993,112509762996,3,1716,1101,-20
112515547734,112515547739,5,3266,1435,-20
112515692153,112515692155,2,1922,1654,-20
112515900286,112515900290,4,1469,1065,-20
112516857118,112516857122,4,2067,1719,-20
112518297599,112518297603,4,2391,1584,-20
112519204993,112519204997,4,1647,1235,-20
112519414956,112519414969,13,1881,1264,-20
112522044946,112522044949,3,1852,1980,-20
112522809018,112522809025,7,2608,1400,-20
112523156434,112523156435,1,1517,1824,-20
112523281391,112523281393,2,1100,1500,-20
112524118970,112524118971,1,1586,1596,-20
112527138494,112527138494,0,1907,1454,-20
112529393374,112529393378,4,1717,1117,-20
112533906573,112533906578,5,2617,1499,-20
112534882385,112534882387,2,1104,770,-20
112535656134,112535656124,-10,579,223,-20
112537637723,112537637725,2,1965,1640,-20
112541006674,112541006674,0,2057,1626,-20
112541600503,112541600506,3,2146,1629,-20
112547149955,112547149957,2,1814,1919,-20
112547808310,112547808312,2,1793,1391,-20
112552834861,112552834871,10,2057,1355,-20
112553332134,112553332138,4,1839,1665,-20
112557074516,112557074517,1,1614,1337,-20
112557621402,112557621404,2,2052,1570,-20
112562120134,112562120134,0,1556,1039,-20
112564085442,112564085445,3,1885,1680,-20
112567066362,112567066363,1,710,629,-20
112569759054,112569759057,3,1845,1743,-20
112570420146,112570420150,4,1519,1220,-20
112573088694,112573088698,4,1761,1213,-20
112573761565,112573761569,4,2158,1302,-20
112577630457,112577630462,5,2873,1183,-20
112578852168,112578852171,3,2367,1722,-20
112584142298,112584142301,3,2234,1263,-20
112584508145,112584508149,4,2281,1549,-20
112585590097,112585590102,5,1276,1352,-20
112587430563,112587430566,3,1719,940,-20
112594979045,112594979050,5,2281,1114,-20
112601434183,112601434186,3,2162,1519,-20
112605496386,112605496390,4,2023,1391,-20
112608553178,112608553182,4,1407,1181,-20
112613744154,112613744156,2,1884,1043,-20
112614145884,112614145885,1,1620,1497,-20
112616522221,112616522225,4,1933,1370,-20
112618139601,112618139605,4,2384,1385,-20
112620372414,112620372419,5,2209,1244,-20
112622543079,112622543080,1,1395,935,-20
112623498018,112623498020,2,2054,2162,-20
112627672801,112627672805,4,1956,1694,-20
112629332865,112629332867,2,1619,1079,-20
112629828652,112629828634,-18,823,453,-20
112631215219,112631215225,6,3283,1303,-20
112638647163,112638647169,6,5839,3146,-20
112641221559,112641221565,6,2173,1313,-20
112644176693,112644176695,2,982,597,-20
112648542376,112648542378,2,1701,1973,-20
112649296778,112649296782,4,782,1293,-20
112653038162,112653038166,4,2030,1231,-20
112653576278,112653576278,0,1089,2063,-20
112656515305,112656515308,3,2161,1295,-20
112657346247,112657346250,3,1365,1366,-20
112659565303,112659565307,4,1535,1029,-20
112659812975,112659812979,4,1401,1158,-20
112661051562,112661051566,4,1477,1568,-20
112661518293,112661518294,1,1973,1545,-20
112663839865,112663839869,4,1364,1358,-20
112667353798,112667353802,4,1523,1112,-20
112668474991,112668474997,6,1627,1446,-20
112669294790,112669294794,4,2424,1532,-20
112671268663,112671268666,3,959,1111,-20
112671825270,112671825254,-16,1534,1192,-20
112672400178,112672400182,4,2590,1553,-20
112672875665,112672875668,3,1575,1379,-20
112673641567,112673641570,3,2177,1352,-20
112674623865,112674623877,12,2629,1470,-20
112674850088,112674850091,3,2031,2122,-20
112677403539,112677403543,4,2026,1352,-20
112681612298,112681612302,4,1411,1187,-20
112686063696,112686063699,3,2362,1732,-20
112687129571,112687129571,0,1856,2012,-20
112689209114,112689209118,4,1559,996,-20
112691792678,112691792681,3,1475,1327,-20
112695270410,112695270413,3,1566,1236,-20
112697046422,112697046430,8,5920,2018,-20
112700306306,112700306314,8,3425,640,-20
112700669582,112700669585,3,1178,1009,-20
112709047516,112709047518,2,1427,1534,-20
112709668135,112709668137,2,2050,1488,-20
112712336154,112712336157,3,2021,1462,-20
112720276238,112720276241,3,1753,1538,-20
112721154574,112721154577,3,2497,1682,-20
112721304135,112721304138,3,1525,1036,-20
112722725694,112722725697,3,1625,1124,-20
112724432542,112724432554,12,1908,1148,-20
112728213195,112728213199,4,907,1175,-20
112737236831,112737236835,4,1530,1171,-20
112738637950,112738637954,4,519,540,-20
112740007267,112740007271,4,2300,1397,-20
112741734615,112741734618,3,1820,1887,-20
112742079023,112742079028,5,2299,2024,-20
112744821981,112744821978,-3,2857,7367,-20
112745205842,112745205842,0,1352,1407,-20
112745347184,112745347186,2,1478,1560,-20
112746078979,112746078983,4,1535,1411,-20
112752532235,112752532237,2,1063,1475,-20
112753422098,112753422101,3,1788,1439,-20
112763845737,112763845739,2,1469,1499,-20
112771671187,112771671191,4,2462,1203,-20
112779818077,112779818081,4,2365,1699,-20
112784599730,112784599734,4,1520,1571,-20
112789151491,112789151495,4,1527,1271,-20
112789651657,112789651659,2,1569,1391,-20
112791805238,112791805241,3,1642,1662,-20
112800610194,112800610197,3,1862,1115,-20
112801394162,112801394166,4,1858,1232,-20
112802254023,112802254029,6,1699,1495,-20
112803587123,112803587107,-16,2474,1065,-20
112808307063,112808307067,4,1200,1315,-20
112812528839,112812528842,3,1933,1245,-20
112812575066,112812575070,4,2134,1416,-20
112814087062,112814087066,4,1886,1065,-20
112814716473,112814716475,2,1387,805,-20
112816617501,112816617503,2,1872,1353,-20
112819556733,112819556739,6,1261,792,-20
112820577342,112820577341,-1,1371,1618,-20
112822155198,112822155202,4,1519,1715,-20
112826330771,112826330771,0,1510,1321,-20
112826868317,112826868319,2,1416,1629,-20
112827854627,112827854630,3,1869,1550,-20
112829177286,112829177292,6,2828,1217,-20
112832863243,112832863247,4,1304,1451,-20
112837214069,112837214070,1,2161,1400,-20
112838813094,112838813098,4,1752,1793,-20
112843570165,112843570166,1,2358,2345,-20
112845850441,112845850445,4,1744,1539,-20
112846433669,112846433674,5,2220,1869,-20
112846713288,112846713290,2,1573,1199,-20
112848618543,112848618545,2,1926,1456,-20
112850321970,112850321970,0,1805,1762,-20
112852038099,112852038106,7,2215,1400,-20
112854837718,112854837722,4,3146,1866,-20
112859855018,112859855014,-4,1196,2300,-20
112863103797,112863103801,4,2405,2021,-20
112863246765,112863246766,1,1333,1499,-20
112864668404,112864668407,3,2283,1557,-20
112866233900,112866233894,-6,855,5016,-20
112870273426,112870273430,4,1289,1292,-20
112870355558,112870355577,19,956,359,-20
112871314061,112871314065,4,1304,1056,-20
112872199225,112872199227,2,2036,1266,-20
112873329916,112873329919,3,2600,2578,-20
112877511610,112877511614,4,1860,1577,-20
112878002473,112878002476,3,2004,1361,-20
112882459918,112882459922,4,2441,1224,-20
112891609725,112891609730,5,1580,1252,-20
112898891625,112898891626,1,1853,1947,-20
112903670330,112903670332,2,1784,1645,-20
112903811768,112903811768,0,1135,1789,-20
112905120003,112905120005,2,1808,1491,-20
112906686770,112906686771,1,1406,1333,-20
112908412099,112908412102,3,2094,1292,-20
112908705743,112908705746,3,1829,1321,-20
112911949098,112911949102,4,2468,1949,-20
112912383424,112912383427,3,1116,1100,-20
112917150114,112917150118,4,1733,1276,-20
112920048490,112920048495,5,1446,1324,-20
112922856677,112922856683,6,1894,1266,-20
112924996841,112924996846,5,1585,1410,-20
112925763526,112925763529,3,1838,1268,-20
112929589834,112929589838,4,2093,1601,-20
112935249529,112935249533,4,2184,1559,-20
112935978156,112935978160,4,1409,1298,-20
112939944350,112939944354,4,1674,1615,-20
112940114214,112940114218,4,2465,1813,-20
112941744162,112941744165,3,2266,1656,-20
112942327451,112942327454,3,1404,1423,-20
112945251731,112945251735,4,33670,53198,-20
112946293177,112946293179,2,1684,963,-20
112946539670,112946539673,3,1473,1174,-20
112948161573,112948161576,3,2140,1451,-20
112952725697,112952725697,0,896,1581,-20
112955491520,112955491523,3,1875,1642,-20
112961076318,112961076322,4,1759,1336,-20
112961345786,112961345790,4,1789,1944,-20
112961771344,112961771346,2,1991,1529,-20
112965451964,112965451972,8,1614,1347,-20
112967305070,112967305073,3,2081,1021,-20
112968376841,112968376845,4,1463,1710,-20
112972295116,112972295119,3,2072,1560,-20
112973226449,112973226452,3,1768,1743,-20
112973255657,112973255658,1,1556,1380,-20
112973624535,112973624538,3,1757,1314,-20
112974718190,112974718182,-8,2562,9638,-20
112974922833,112974922837,4,1692,1607,-20
112977721763,112977721762,-1,1267,1785,-20
112978295833,112978295837,4,1818,1456,-20
112978406145,112978406162,17,1901,1671,-20
112981589095,112981589099,4,2265,1376,-20
112986016274,112986016277,3,1830,1454,-20
112987520238,112987520240,2,1600,971,-20
112987836367,112987836348,-19,670,631,-20
112988107834,112988107838,4,1797,1526,-20
112992065515,112992065518,3,16942,51519,-20
112992163420,112992163422,2,1583,1109,-20
112992442184,112992442187,3,2127,1543,-20
112999357892,112999357894,2,2182,1471,-20
113003264809,113003264810,1,2358,1912,-20
113005408885,113005408886,1,2041,1733,-20
113005943811,113005943812,1,1415,1629,-20
113009286366,113009286373,7,2533,1181,-20
113011058719,113011058725,6,2260,1372,-20
113011723140,113011723143,3,1792,1255,-20
113012279355,113012279360,5,2729,1817,-20
113013394010,113013394015,5,1679,1268,-20
113014016964,113014016976,12,1816,1161,-20
113016660070,113016660073,3,1303,882,-20
113016950425,113016950427,2,1119,1442,-20
113017341299,113017341303,4,1353,1454,-20
113017902878,113017902881,3,2067,1608,-20
113020200513,113020200517,4,1840,1640,-20
113025405906,113025405910,4,1531,850,-20
113026238267,113026238271,4,2591,1865,-20
113029961315,113029961317,2,12913,11316,-20
113032005275,113032005278,3,1703,1530,-20
113035314933,113035314934,1,1814,1165,-20
113035522498,113035522501,3,1524,1383,-20
113036448787,113036448791,4,1871,1393,-20
113038357499,113038357504,5,2423,1203,-20
113041056941,113041056943,2,2216,2053,-20
113042127365,113042127369,4,1133,1124,-20
113045749315,113045749317,2,726,798,-20
113046815062,113046815066,4,1437,1582,-20
113048419706,113048419710,4,2119,1374,-20
113053043837,113053043840,3,1876,1682,-20
113053142606,113053142610,4,1584,846,-20
113054247359,113054247363,4,1695,1412,-20
113056135963,113056135966,3,1759,1561,-20
113056202697,113056202699,2,1441,856,-20
113058850893,113058850894,1,1311,1034,-20
113060038734,113060038738,4,4405,3500,-20
113060967681,113060967683,2,1014,1151,-20
113062358942,113062358946,4,929,1276,-20
113071840067,113071840070,3,1810,1615,-20
113072923330,113072923335,5,1108,738,-20
113073143293,113073143296,3,2169,1834,-20
113073724917,113073724919,2,1234,763,-20
113076606603,113076606606,3,1575,1468,-20
113077855890,113077855876,-14,1659,1419,-20
113078542678,113078542683,5,1648,1890,-20
113078902061,113078902065,4,1037,693,-20
113080137022,113080137019,-3,2057,3260,-20
113081353997,113081354002,5,1790,1782,-20
113081702550,113081702551,1,1168,883,-20
113083198813,113083198797,-16,64370,49550,-20
113085361225,113085361226,1,2271,1844,-20
113088986333,113088986331,-2,1633,2343,-20
113099208903,113099208907,4,1681,1062,-20
113099316506,113099316507,1,1241,1444,-20
113108257917,113108257918,1,2660,1337,-20
113109350405,113109350406,1,2332,2229,-20
113111367269,113111367270,1,969,1270,-20
113112939780,113112939785,5,1255,1044,-20
113117402443,113117402447,4,1734,1435,-20
113122624753,113122624758,5,2679,1442,-20
113122726942,113122726943,1,1661,1657,-20
113125121779,113125121781,2,1744,849,-20
113125636316,113125636319,3,1602,1282,-20
113125981599,113125981602,3,2118,1491,-20
113129409636,113129409639,3,2003,1466,-20
113131420967,113131420970,3,1306,1283,-20
113132556047,113132556050,3,1758,1231,-20
113134813790,113134813792,2,2218,1592,-20
113137837625,113137837629,4,2294,1649,-20
113138585654,113138585658,4,1848,1631,-20
113139403890,113139403893,3,1663,1168,-20
113140680243,113140680249,6,1484,863,-20
113142583838,113142583841,3,2223,1495,-20
113143695163,113143695165,2,1417,1144,-20
113146030986,113146030989,3,1764,1165,-20
113149590029,113149590032,3,1128,1016,-20
113152357342,113152357348,6,1916,1444,-20
113154792672,113154792676,4,1976,1592,-20
113155112255,113155112236,-19,2120,999,-20
113158646075,113158646081,6,3030,1653,-20
113160952805,113160952809,4,1784,1395,-20
113161058288,113161058292,4,1918,1511,-20
113163249586,113163249590,4,1984,1426,-20
113164913998,113164914002,4,1924,1875,-20
113165835178,113165835183,5,1843,1443,-20
113167064722,113167064724,2,1562,1535,-20
113169789046,113169789049,3,1716,1156,-20
113173573234,113173573238,4,1929,1377,-20
113181747562,113181747566,4,2085,1507,-20
113182336734,113182336731,-3,2662,5550,-20
113182478693,113182478687,-6,1331,5107,-20
113182749407,113182749401,-6,853,4642,-20
113182803088,113182803086,-2,1286,1764,-20
113184246623,113184246624,1,1642,1398,-20
113189369792,113189369794,2,1575,1105,-20
113189834539,113189834544,5,1951,1398,-20
113198138450,113198138453,3,1495,1280,-20
113198972878,113198972878,0,1171,2353,-20
113202697063,113202697056,-7,724,3183,-20
113204291531,113204291535,4,1309,1079,-20
113205075489,113205075494,5,2278,1560,-20
113205145158,113205145162,4,1765,1530,-20
113212421290,113212421294,4,1958,1901,-20
113214017366,113214017371,5,1823,1086,-20
113215995330,113215995333,3,2233,1485,-20
113216131731,113216131738,7,1210,1121,-20
113220248896,113220248898,2,2233,1701,-20
113224761174,113224761177,3,2034,1650,-20
113226112457,113226112460,3,1896,2066,-20
113226876823,113226876826,3,1883,1419,-20
113226946635,113226946638,3,1849,1965,-20
113227499245,113227499248,3,1861,1675,-20
113229027262,113229027258,-4,1742,3168,-20
113230017051,113230017055,4,2094,1124,-20
113230740690,113230740675,-15,1603,1025,-20
113232124364,113232124368,4,2158,1529,-20
113233768157,113233768161,4,2100,1661,-20
113234128490,113234128494,4,2250,1444,-20
113237614686,113237614686,0,1607,1763,-20
113237802095,113237802099,4,1379,1312,-20
113240210529,113240210531,2,1899,1420,-20
113241034234,113241034238,4,879,1070,-20
113245573754,113245573758,4,1765,1039,-20
113247762614,113247762618,4,2167,2862,-20
113248781855,113248781859,4,1612,1209,-20
113253027837,113253027839,2,1303,1338,-20
113260216036,113260216039,3,2794,2106,-20
113263004876,113263004880,4,2831,1582,-20
113264478942,113264478946,4,1764,1055,-20
113266938393,113266938399,6,1677,1074,-20
113268259085,113268259090,5,1962,1668,-20
113270261462,113270261458,-4,1183,2206,-20
113270523533,113270523527,-6,1751,6822,-20
113270706588,113270706590,2,1727,1448,-20
113272782995,113272782999,4,1603,1071,-20
113273141610,113273141614,4,1077,1308,-20
113273791547,113273791550,3,2018,1971,-20
113274861407,113274861410,3,2240,1259,-20
113277346053,113277346055,2,1700,1732,-20
113287791494,113287791500,6,1984,1959,-20
113289570538,113289570542,4,2477,1768,-20
113292065203,113292065206,3,1929,971,-20
113292527386,113292527389,3,1357,922,-20
113295587394,113295587397,3,1779,1369,-20
113296042614,113296042618,4,1693,1177,-20
113298329676,113298329678,2,1999,1481,-20
113298808975,113298808978,3,1824,1035,-20
113302657846,113302657846,0,2409,2405,-20
113305624870,113305624874,4,1490,1387,-20
113306893069,113306893073,4,2400,1712,-20
113309038078,113309038081,3,1849,1771,-20
113309222782,113309222786,4,1881,1210,-20
113312210965,113312210962,-3,1588,1610,-20
113313070287,113313070270,-17,1851,1053,-20
113314470206,113314470209,3,1099,967,-20
113315773306,113315773309,3,1893,1605,-20
113317238307,113317238310,3,1535,1129,-20
113322263901,113322263903,2,1817,898,-20
113323067671,113323067677,6,2504,1352,-20
113323626246,113323626251,5,2091,1263,-20
113326170195,113326170198,3,1311,1361,-20
113326927773,113326927774,1,1945,1571,-20
113329108405,113329108408,3,1936,1623,-20
113330298269,113330298273,4,2268,1087,-20
113332327587,113332327586,-1,1084,1047,-20
113335692671,113335692674,3,2063,1138,-20
113336695060,113336695064,4,1777,1530,-20
113337587108,113337587110,2,1567,1603,-20
113338176787,113338176791,4,1457,1025,-20
113340183993,113340183994,1,2040,1754,-20
113343990150,113343990151,1,1432,1269,-20
113344911315,113344911318,3,2134,1438,-20
113346162376,113346162379,3,1705,1275,-20
113346655004,113346655005,1,2670,2087,-20
113353331403,113353331407,4,1094,1491,-20
113355473922,113355473925,3,2077,1602,-20
113357862441,113357862442,1,2103,1642,-20
113362442169,113362442175,6,2300,1211,-20
113363664335,113363664326,-9,886,5590,-20
113364308827,113364308831,4,1648,1091,-20
113366632068,113366632064,-4,2765,5142,-20
113367212856,113367212855,-1,2070,2456,-20
113369769185,113369769191,6,3198,1508,-20
113374706354,113374706358,4,2001,1771,-20
113377990578,113377990582,4,1621,1571,-20
113378922262,113378922266,4,3017,1575,-20
113383250135,113383250136,1,1385,1575,-20
113383424523,113383424518,-5,1470,6285,-20
113384469327,113384469329,2,1173,1055,-20
113388507782,113388507787,5,908,850,-20
113389611837,113389611838,1,2017,1373,-20
113389861365,113389861370,5,2286,1108,-20
113397911112,113397911109,-3,1164,2153,-20
113399509650,113399509654,4,2732,1530,-20
113401493527,113401493530,3,839,249,-20
113401822456,113401822459,3,2283,1975,-20
113402467476,113402467477,1,1451,1417,-20
113406220050,113406220050,0,1199,1821,-20
113407051624,113407051611,-13,1728,1368,-20
113413895517,113413895522,5,2402,1262,-20
113418736374,113418736378,4,2081,1599,-20
113421925642,113421925645,3,2262,2534,-20
113425863013,113425863016,3,1873,1811,-20
113426613114,113426613117,3,2854,2079,-20
113428663556,113428663565,9,1821,1362,-20
113430200998,113430201003,5,1639,1079,-20
113435466651,113435466650,-1,1806,2085,-20
113435879606,113435879601,-5,1064,3029,-20
113437556505,113437556508,3,1163,1617,-20
113437731395,113437731407,12,148,1361,-20
113441895914,113441895918,4,1791,1169,-20
113442991172,113442991155,-17,1934,1350,-20
113445393226,113445393230,4,1668,1127,-20
113446541821,113446541826,5,2066,1839,-20
113455230199,113455230203,4,2000,2305,-20
113455457390,113455457397,7,1985,1550,-20
113456355433,113456355438,5,1538,927,-20
113457227160,113457227163,3,2331,1950,-20
113457718714,113457718717,3,1216,861,-20
113460342308,113460342311,3,2323,1719,-20
113460657931,113460657933,2,1611,1151,-20
113460952131,113460952134,3,1893,1236,-20
113462564630,113462564634,4,1927,1723,-20
113469526645,113469526647,2,1643,1222,-20
113473880123,113473880126,3,1283,1356,-20
113474387556,113474387554,-2,1788,1140,-20
113479400622,113479400625,3,1477,1071,-20
113479961406,113479961388,-18,1916,1250,-20
113483829054,113483829050,-4,1238,3350,-20
113484580199,113484580203,4,1348,1277,-20
113484920316,113484920319,3,2035,1610,-20
113485045846,113485045851,5,2538,1695,-20
113487389342,113487389347,5,2410,1421,-20
113490257591,113490257596,5,1592,1682,-20
113491763401,113491763404,3,1326,1466,-20
113493807397,113493807400,3,1873,1777,-20
113494051167,113494051169,2,1840,2185,-20
113495205571,113495205574,3,1904,1454,-20
113503879455,113503879457,2,1741,1628,-20
113510089253,113510089257,4,1693,1121,-20
113517711486,113517711484,-2,843,1093,-20
113518947886,113518947893,7,2164,1476,-20
113520294489,113520294492,3,2375,2395,-20
113522546271,113522546272,1,1090,1035,-20
113524114985,113524114989,4,1181,1387,-20
113524314182,113524314162,-20,1128,413,-20
113524503682,113524503685,3,1166,1375,-20
113525975768,113525975782,14,1552,1567,-20
113526467949,113526467951,2,1820,1110,-20
113527800488,113527800490,2,1298,1114,-20
113531439218,113531439218,0,1511,1879,-20
113535723974,113535723979,5,1926,1740,-20
113536794857,113536794862,5,2248,1481,-20
113540866562,113540866561,-1,1736,1456,-20
113545198079,113545198076,-3,946,1485,-20
113548074921,113548074923,2,1585,1222,-20
113557628221,113557628225,4,1019,609,-20
113559546838,113559546840,2,1301,1288,-20
113560717015,113560717018,3,1714,1687,-20
113566921405,113566921409,4,2321,1658,-20
113572766177,113572766181,4,1539,999,-20
113573297367,113573297370,3,1496,1176,-20
113576699314,113576699316,2,1735,1619,-20
113584993647,113584993646,-1,1567,1436,-20
113586391036,113586391039,3,2335,1022,-20
113588335961,113588335965,4,1803,1502,-20
113589932395,113589932398,3,1732,1482,-20
113591354511,113591354515,4,1432,1426,-20
113593258726,113593258728,2,1820,1496,-20
113593375955,113593375959,4,2342,1205,-20
113594304021,113594304026,5,2218,1405,-20
113595687030,113595687034,4,2441,1599,-20
113600213448,113600213451,3,1781,1669,-20
113603712921,113603712926,5,2319,1462,-20
113608409407,113608409410,3,2103,1193,-20
113610264766,113610264769,3,1901,1222,-20
113610704809,113610704814,5,1318,1411,-20
113611560053,113611560058,5,2244,1691,-20
113613543844,113613543843,-1,2599,3708,-20
113614779093,113614779097,4,1910,1187,-20
113622097105,113622097120,15,1722,1487,-20
113623137509,113623137513,4,1738,880,-20
113624215766,113624215770,4,2489,2012,-20
113624366734,113624366739,5,2370,1221,-20
113624974355,113624974358,3,2161,1268,-20
113625624866,113625624869,3,1701,1445,-20
113627309922,113627309927,5,1721,1108,-20
113630013447,113630013450,3,1626,938,-20
113634777833,113634777839,6,1887,1244,-20
113636008181,113636008182,1,1406,1041,-20
113636136431,113636136433,2,1841,1304,-20
113645567370,113645567372,2,1622,1398,-20
113645597066,113645597070,4,2431,1709,-20
113648784978,113648784982,4,1913,1331,-20
113653277737,113653277741,4,3226,2094,-20
113653885144,113653885146,2,1885,1636,-20
113655253229,113655253251,22,1138,1337,-20
113658636752,113658636755,3,1783,1677,-20
113658991975,113658991978,3,1697,1446,-20
113659260326,113659260329,3,1744,1746,-20
113660435347,113660435351,4,1586,1590,-20
113664416426,113664416427,1,1235,1721,-20
113664867032,113664867036,4,2875,1765,-20
113665330419,113665330402,-17,924,995,-20
113665564378,113665564382,4,1771,1237,-20
113666490670,113666490674,4,2940,1690,-20
113668313592,113668313594,2,1840,1756,-20
113669340245,113669340249,4,2059,2044,-20
113672641974,113672641979,5,1923,718,-20
113673195586,113673195590,4,1381,1107,-20
113674035733,113674035735,2,1812,1516,-20
113674682189,113674682192,3,1547,1191,-20
113675171805,113675171807,2,1315,1251,-20
113677380634,113677380636,2,1416,1487,-20
113678011091,113678011093,2,1718,1903,-20
113680233301,113680233304,3,1337,1283,-20
113680702630,113680702631,1,1543,1130,-20
113681659342,113681659338,-4,1015,1934,-20
113682120814,113682120809,-5,1504,4086,-20
113685209694,113685209698,4,1578,1497,-20
113694239662,113694239665,3,1947,2533,-20
113694282804,113694282806,2,1327,826,-20
113697351670,113697351673,3,1848,1531,-20
113699044034,113699044038,4,1733,1228,-20
113700480060,113700480062,2,2296,1472,-20
113701108688,113701108689,1,1561,1955,-20
113703547518,113703547520,2,1300,1252,-20
113718399250,113718399253,3,1259,1378,-20
113719574221,113719574226,5,1976,1116,-20
113720382988,113720382990,2,2148,2421,-20
113720622746,113720622750,4,2401,1783,-20
113720807525,113720807521,-4,1714,4561,-20
113722451159,113722451162,3,1512,1195,-20
113724943000,113724943007,7,2950,1186,-20
113725191677,113725191678,1,1928,2122,-20
113727430539,113727430542,3,1826,1731,-20
113727503876,113727503877,1,1422,1686,-20
113730385590,113730385593,3,1278,1247,-20
113732201622,113732201627,5,1944,1545,-20
113733058167,113733058169,2,1701,1258,-20
113734134278,113734134281,3,2166,1534,-20
113737358255,113737358263,8,2881,785,-20
113738988341,113738988344,3,1446,1294,-20
113740881035,113740881037,2,1333,1704,-20
113743957629,113743957634,5,1756,1281,-20
113744992396,113744992399,3,1733,1303,-20
113745462209,113745462210,1,1155,1353,-20
113750563564,113750563568,4,1540,833,-20
113751368163,113751368162,-1,975,1660,-20
113754308849,113754308852,3,1566,1743,-20
113755814369,113755814371,2,1857,1632,-20
113755847666,113755847670,4,1768,1565,-20
113757845798,113757845802,4,2306,1347,-20
113758566230,113758566210,-20,912,910,-20
113758659761,113758659760,-1,1449,1580,-20
113761897111,113761897115,4,2083,1251,-20
113762414887,113762414867,-20,1059,1196,-20
113762490370,113762490372,2,1610,1338,-20
113763704741,113763704744,3,2046,1371,-20
113764021841,113764021842,1,1375,1115,-20
113767759595,113767759597,2,1155,906,-20
113770582122,113770582127,5,1774,1118,-20
113771867861,113771867863,2,2195,1862,-20
113774478462,113774478461,-1,1528,1519,-20
113777407834,113777407836,2,1413,1599,-20
113778146790,113778146792,2,1925,1514,-20
113779210390,113779210394,4,1800,1489,-20
113780955616,113780955617,1,2440,1682,-20
113781021320,113781021325,5,2314,1605,-20
113785052216,113785052221,5,2147,1622,-20
113785348315,113785348319,4,1792,1234,-20
113785747273,113785747275,2,1710,1307,-20
113785880469,113785880450,-19,1804,1262,-20
113785997199,113785997179,-20,1220,914,-20
113786033908,113786033910,2,1485,1795,-20
113788418391,113788418395,4,1860,1162,-20
113789388850,113789388854,4,1589,1662,-20
113791652937,113791652938,1,2413,2232,-20
113791758788,113791758791,3,3283,1759,-20
113792943225,113792943229,4,2104,1212,-20
113795235538,113795235542,4,2020,1419,-20
113796958012,113796958015,3,1739,1416,-20
113798465947,113798465951,4,1059,1039,-20
113800835958,113800835961,3,1207,1332,-20
113803258395,113803258400,5,1547,1305,-20
113804162617,113804162622,5,2064,1510,-20
113805855089,113805855093,4,1453,1483,-20
113811344565,113811344567,2,1212,1191,-20
113811374539,113811374518,-21,31,1152,-20
113814642814,113814642818,4,1059,915,-20
113814978302,113814978304,2,3295,3795,-20
113817053735,113817053738,3,1527,917,-20
113817287778,113817287782,4,1622,1072,-20
113817793745,113817793750,5,1209,1615,-20
113820514551,113820514556,5,1591,957,-20
113821249726,113821249730,4,1552,1146,-20
113823893903,113823893907,4,1448,1232,-20
113824266696,113824266718,22,983,5280,-20
113826705861,113826705865,4,1695,1450,-20
113827306510,113827306513,3,1514,1025,-20
113827789875,113827789879,4,1120,1016,-20
113831528649,113831528651,2,1716,1161,-20
113832039693,113832039694,1,2352,1748,-20
113832413199,113832413202,3,1730,1043,-20
113833651032,113833651035,3,1802,1737,-20
113837656617,113837656619,2,1548,1736,-20
113840196450,113840196455,5,1188,1072,-20
113843281595,113843281597,2,2512,1717,-20
113843323838,113843323841,3,1885,1608,-20
113843465582,113843465560,-22,1864,1207,-20
113844774901,113844774904,3,2051,2111,-20
113845783951,113845783950,-1,1137,3060,-20
113849996215,113849996217,2,2096,1203,-20
113852189582,113852189586,4,1156,872,-20
113852836745,113852836750,5,2100,1650,-20
113853726170,113853726172,2,1414,1306,-20
113854747639,113854747642,3,2180,1601,-20
113855014078,113855014091,13,777,741,-20
113855815646,113855815650,4,2319,1468,-20
113856354276,113856354275,-1,1334,1379,-20
113859628403,113859628407,4,1597,1540,-20
113863744672,113863744675,3,2052,1559,-20
113863774438,113863774438,0,1709,1286,-20
113864814778,113864814782,4,1540,1719,-20
113864920829,113864920832,3,1503,1164,-20
113869086809,113869086811,2,1415,941,-20
113875330915,113875330920,5,2115,1792,-20
113877562000,113877562003,3,2654,1657,-20
113877945716,113877945718,2,1593,1473,-20
113878144732,113878144734,2,2205,1937,-20
113878545142,113878545147,5,1495,1138,-20
113879515468,113879515471,3,2125,1895,-20
113886220922,113886220926,4,1130,921,-20
113890181682,113890181687,5,1811,1603,-20
113890749679,113890749685,6,2170,1304,-20
113900424671,113900424674,3,2274,1590,-20
113900457461,113900457464,3,1586,1405,-20
113907863380,113907863385,5,2009,1146,-20
113909463254,113909463254,0,1176,1689,-20
113909682525,113909682527,2,1911,1399,-20
113909903757,113909903761,4,1827,1499,-20
113911334198,113911334204,6,3029,1656,-20
113911625058,113911625055,-3,1194,1353,-20
113912066914,113912066917,3,1438,1482,-20
113920692854,113920692855,1,1977,1322,-20
113921591837,113921591842,5,1822,1445,-20
113923291413,113923291414,1,1331,1038,-20
113926923817,113926923822,5,1412,1260,-20
113929831853,113929831856,3,2455,1438,-20
113930369389,113930369391,2,1547,1617,-20
113930623709,113930623712,3,1735,1522,-20
113934931127,113934931131,4,2914,1596,-20
113935908544,113935908548,4,1715,1887,-20
113939519818,113939519821,3,2060,1519,-20
113940352714,113940352718,4,1566,1731,-20
113941195055,113941195058,3,1577,1047,-20
113946576680,113946576683,3,1974,1269,-20
113953254825,113953254827,2,2371,1529,-20
113956812304,113956812302,-2,1532,2229,-20
113958110494,113958110498,4,2680,1566,-20
113960337910,113960337915,5,1512,1228,-20
113961252925,113961252932,7,3088,1587,-20
113961725515,113961725519,4,1205,1148,-20
113961949198,113961949216,18,1471,1124,-20
113964021234,113964021237,3,1477,1335,-20
113964249686,113964249690,4,2022,2083,-20
113965148995,113965148997,2,1617,1176,-20
113971234900,113971234902,2,1297,1300,-20
113971885966,113971885973,7,2744,1117,-20
113981078784,113981078767,-17,1371,1048,-20
113982530080,113982530083,3,1183,904,-20
113983391292,113983391295,3,1000,1275,-20
113984038046,113984038050,4,2424,1872,-20
113985719910,113985719915,5,1631,1270,-20
113987105730,113987105734,4,2075,1444,-20
113991394032,113991394035,3,1332,2057,-20
113991628538,113991628528,-10,1203,1104,-20
113994989594,113994989595,1,1619,1868,-20
113998134106,113998134108,2,2849,3910,-20
113999843866,113999843865,-1,2773,4189,-20
114001741658,114001741661,3,1406,1214,-20
114002489214,114002489217,3,992,1210,-20
114004268141,114004268143,2,1895,1426,-20
114005736393,114005736396,3,1685,1591,-20
114006209023,114006209027,4,2043,1636,-20
114011078896,114011078898,2,1653,1280,-20
114012044119,114012044122,3,1990,1346,-20
114015857503,114015857508,5,2739,1448,-20
114016423219,114016423214,-5,743,3357,-20
114016615122,114016615126,4,1343,935,-20
114017448561,114017448563,2,2067,1779,-20
114018774045,114018774048,3,2194,1640,-20
114022476751,114022476755,4,1478,907,-20
114023007714,114023007719,5,1677,941,-20
114025148238,114025148241,3,1209,1695,-20
114031211035,114031211039,4,2274,2324,-20
114031387350,114031387353,3,1529,1785,-20
114032058173,114032058179,6,3046,1338,-20
114033124973,114033124952,-21,1419,1361,-20
114033741555,114033741562,7,2716,1232,-20
114036206852,114036206850,-2,1167,2513,-20
114037194394,114037194396,2,1938,965,-20
114039198935,114039198938,3,1667,1428,-20
114040286771,114040286789,18,352,408,-20
114040916177,114040916184,7,1880,1399,-20
114041528159,114041528162,3,1623,1370,-20
114043500913,114043500916,3,1975,1631,-20
114044481481,114044481487,6,803,1242,-20
114048278399,114048278406,7,7975,2726,-20
114052881079,114052881081,2,1855,1413,-20
114054312609,114054312613,4,1379,1436,-20
114057461905,114057461909,4,1949,2073,-20
114058099499,114058099502,3,2055,1615,-20
114063408763,114063408766,3,1618,1361,-20
114065474814,114065474818,4,1388,1291,-20
114066573784,114066573773,-11,114,507,-20
114068260358,114068260362,4,2287,1728,-20
114069770097,114069770098,1,1231,889,-20
114076063707,114076063705,-2,1573,1831,-20
114079647012,114079647015,3,1538,1161,-20
114081166059,114081166063,4,1572,1719,-20
114082865111,114082865114,3,1432,1773,-20
114084769773,114084769777,4,2136,1343,-20
114089911605,114089911596,-9,1565,1742,-20
114090243714,114090243718,4,2473,1725,-20
114090767290,114090767294,4,2185,1578,-20
114091663713,114091663715,2,1551,1270,-20
114094062909,114094062911,2,1251,1293,-20
114094173488,114094173491,3,1668,1197,-20
114094663967,114094663970,3,1485,1208,-20
114100009643,114100009645,2,1653,1194,-20
114100354067,114100354070,3,1471,1473,-20
114101052579,114101052583,4,1074,1456,-20
114102054732,114102054735,3,2048,1161,-20
114106247625,114106247627,2,1032,841,-20
114112593838,114112593840,2,1678,1549,-20
114115228935,114115228938,3,1737,1361,-20
114117456429,114117456431,2,2552,1530,-20
114124582149,114124582152,3,1346,1375,-20
114126032985,114126032990,5,1977,1345,-20
114127824441,114127824446,5,1747,1367,-20
114128098653,114128098656,3,1774,1849,-20
114130037697,114130037699,2,1186,1432,-20
114131268420,114131268425,5,1630,1552,-20
114134296495,114134296497,2,1609,1353,-20
114141162121,114141162122,1,1627,1685,-20
114141481766,114141481773,7,2147,998,-20
114143476624,114143476626,2,1361,816,-20
114145825246,114145825250,4,2325,1768,-20
114146569438,114146569418,-20,1345,1127,-20
114148806837,114148806845,8,1487,1226,-20
114149143875,114149143878,3,3233,2933,-20
114151481530,114151481536,6,1739,1530,-20
114151843582,114151843585,3,1661,1312,-20
114157162431,114157162434,3,2282,1529,-20
114160190383,114160190378,-5,918,4037,-20
114162873633,114162873638,5,1436,1107,-20
114165094797,114165094799,2,1988,2069,-20
114174826672,114174826675,3,2005,1193,-20
114176544817,114176544819,2,1951,1411,-20
114180820626,114180820629,3,1820,1558,-20
114181974849,114181974853,4,2099,1315,-20
114183361321,114183361326,5,1676,1760,-20
114183432790,114183432768,-22,1632,881,-20
114186727981,114186727985,4,1272,596,-20
114190132631,114190132634,3,1813,1373,-20
114193618881,114193618884,3,1713,1367,-20
114195277234,114195277237,3,1896,994,-20
114203882263,114203882266,3,1296,1101,-20
114203934969,114203934972,3,2597,884,-20
114209386299,114209386303,4,1714,1339,-20
114209730633,114209730635,2,1555,1137,-20
114214122989,114214122981,-8,2019,14256,-20
114215142099,114215142101,2,889,1229,-20
114216727510,114216727512,2,1597,1060,-20
114222374408,114222374410,2,1669,1163,-20
114222583698,114222583703,5,5307,3053,-20
114222786547,114222786548,1,1434,1502,-20
114230060055,114230060053,-2,1240,2626,-20
114232810681,114232810684,3,1951,1113,-20
114238229434,114238229438,4,1743,855,-20
114240483977,114240483981,4,1315,1133,-20
114241641666,114241641663,-3,1264,2156,-20
114242441171,114242441177,6,559,766,-20
114249936173,114249936174,1,1753,1304,-20
114250270435,114250270420,-15,1100,576,-20
114253923018,114253923021,3,1400,1454,-20
114256213044,114256213046,2,1687,1036,-20
114263602458,114263602462,4,1791,1415,-20
114263749806,114263749809,3,1940,1754,-20
114264241997,114264241999,2,1704,1912,-20
114264768035,114264768037,2,2005,1301,-20
114266353413,114266353416,3,1651,1129,-20
114269575031,114269575011,-20,1544,1435,-20
114270032806,114270032809,3,1768,956,-20
114274080751,114274080754,3,1048,1255,-20
114275815737,114275815739,2,1632,1555,-20
114279223645,114279223645,0,1513,1631,-20
114279721062,114279721068,6,1924,1507,-20
114281704085,114281704090,5,1734,1393,-20
114282238745,114282238750,5,1172,1052,-20
114283182738,114283182742,4,2760,1981,-20
114287676901,114287676902,1,1154,843,-20
114287886015,114287886018,3,1322,1603,-20
114289339078,114289339082,4,2410,1928,-20
114291498302,114291498306,4,1581,959,-20
114297908698,114297908702,4,1728,1236,-20
114298011329,114298011347,18,391,199,-20
114300234054,114300234056,2,1358,1438,-20
114300993154,114300993161,7,3730,1295,-20
114301240379,114301240382,3,1316,753,-20
114308972209,114308972214,5,2259,1874,-20
114313770956,114313770958,2,1405,966,-20
114314180312,114314180317,5,4520,2138,-20
114317627935,114317627938,3,1713,1322,-20
114330417898,114330417902,4,1363,1419,-20
114335514505,114335514509,4,1988,1616,-20
114336010238,114336010242,4,1504,1188,-20
114336324495,114336324499,4,916,696,-20
114338106763,114338106764,1,1539,1666,-20
114342448828,114342448828,0,19336,6693,-20
114345011019,114345011022,3,1797,1351,-20
114345393221,114345393226,5,1215,999,-20
114346314005,114346314007,2,2294,1473,-20
114347790762,114347790766,4,1797,2282,-20
114348879819,114348879826,7,3817,1280,-20
114350037814,114350037817,3,2593,1545,-20
114352616864,114352616867,3,2784,1397,-20
114353138961,114353138963,2,1957,918,-20
114357446639,114357446638,-1,1610,1364,-20
114358418513,114358418516,3,2497,1920,-20
114362052933,114362052937,4,1518,1685,-20
114364877030,114364877033,3,1638,1374,-20
114365256826,114365256829,3,1714,952,-20
114365544486,114365544467,-19,966,572,-20
114367674796,114367674801,5,2509,945,-20
114368363718,114368363716,-2,1215,1850,-20
114371352682,114371352687,5,1558,1477,-20
114373102212,114373102215,3,1711,1415,-20
114375748205,114375748201,-4,2050,4894,-20
114376525450,114376525457,7,2075,1342,-20
114376730411,114376730415,4,1498,1338,-20
114378655579,114378655582,3,1863,1310,-20
114380110624,114380110628,4,1544,2085,-20
114381098638,114381098641,3,2231,1421,-20
114382156357,114382156359,2,1426,1363,-20
114383896544,114383896542,-2,1566,3083,-20
114387192516,114387192518,2,2071,1356,-20
114388306482,114388306486,4,1679,1366,-20
114392523707,114392523714,7,2291,845,-20
114394067033,114394067033,0,4059,17316,-20
114396204701,114396204703,2,1437,1180,-20
114400941711,114400941714,3,1572,1628,-20
114401543433,114401543419,-14,972,477,-20
114412067021,114412067019,-2,924,3113,-20
114412528270,114412528284,14,36247,10317,-20
114419021122,114419021125,3,2411,1560,-20
114421759983,114421759987,4,2179,1249,-20
114423990306,114423990311,5,1866,1513,-20
114424258654,114424258655,1,21121,30166,-20
114426073165,114426073167,2,1993,1074,-20
114426601154,114426601158,4,1318,1107,-20
114427882198,114427882207,9,2422,845,-20
114430508615,114430508618,3,2132,1921,-20
114431077599,114431077601,2,2320,1479,-20
114431659327,114431659330,3,1922,1385,-20
114432674429,114432674433,4,1641,1640,-20
114435236085,114435236089,4,1289,1275,-20
114436995975,114436995978,3,1284,1088,-20
114441454255,114441454233,-22,1441,1286,-20
114441629369,114441629374,5,1522,1203,-20
114445379938,114445379943,5,2729,1194,-20
114449693566,114449693566,0,1341,1401,-20
114452136265,114452136267,2,2461,1947,-20
114455042969,114455042972,3,1812,1225,-20
114455541391,114455541393,2,1273,951,-20
114455910821,114455910823,2,1701,1411,-20
114457281411,114457281416,5,2483,1504,-20
114460772463,114460772466,3,2058,1299,-20
114461003378,114461003381,3,2322,1511,-20
114461391197,114461391199,2,1600,1388,-20
114462880918,114462880921,3,1797,1482,-20
114465906350,114465906353,3,1393,1180,-20
114466845685,114466845687,2,2070,1483,-20
114468598091,114468598094,3,1207,1568,-20
114469762583,114469762586,3,2498,1308,-20
114473543278,114473543279,1,1419,1413,-20
114474028724,114474028729,5,1740,1688,-20
114476248568,114476248571,3,1311,1751,-20
114477087693,114477087696,3,1545,1300,-20
114479387043,114479387047,4,2417,2337,-20
114479860704,114479860707,3,1501,795,-20
114482646230,114482646234,4,1290,1040,-20
114483613693,114483613694,1,1491,1103,-20
114486490293,114486490298,5,1953,1529,-20
114487280794,114487280796,2,1510,961,-20
114495481215,114495481218,3,1537,1219,-20
114497544580,114497544586,6,2617,1659,-20
114498646762,114498646769,7,1526,1422,-20
114499800143,114499800145,2,1211,1697,-20
114502028675,114502028678,3,2616,2104,-20
114503280566,114503280570,4,1653,1056,-20
114505748587,114505748590,3,2598,1785,-20
114511747802,114511747805,3,1846,1719,-20
114513938331,114513938334,3,1477,1051,-20
114515234511,114515234514,3,1930,2358,-20
114520508634,114520508638,4,1517,1629,-20
114521615989,114521615991,2,1502,1346,-20
114521837634,114521837638,4,1747,1484,-20
114524227590,114524227594,4,1895,1489,-20
114527275087,114527275090,3,1856,1286,-20
114530984220,114530984238,18,1031,3327,-20
114534362554,114534362558,4,1674,1262,-20
114536180249,114536180251,2,1993,1870,-20
114538586077,114538586082,5,1632,1332,-20
114542262686,114542262686,0,1209,1501,-20
114543980578,114543980583,5,1892,944,-20
114546614258,114546614261,3,1849,2045,-20
114546885979,114546885964,-15,2157,1504,-20
114552712329,114552712335,6,1554,1006,-20
114552801877,114552801879,2,1784,1637,-20
114554301853,114554301857,4,1394,1154,-20
114554583890,114554583893,3,1372,842,-20
114555480551,114555480555,4,1436,1034,-20
114559262349,114559262354,5,1449,1070,-20
114565759334,114565759336,2,981,1410,-20
114567365682,114567365687,5,1756,1233,-20
114568661023,114568661026,3,1287,1246,-20
114572185767,114572185769,2,1802,1763,-20
114572849293,114572849298,5,1962,1795,-20
114573101266,114573101270,4,2155,1706,-20
114577440610,114577440615,5,1867,1177,-20
114579237153,114579237155,2,1280,1235,-20
114579797195,114579797199,4,1771,1364,-20
114579992669,114579992673,4,1848,1195,-20
114580823443,114580823446,3,1908,1468,-20
114583481698,114583481702,4,1383,1421,-20
114585071986,114585071989,3,1937,1714,-20
114585547992,114585547994,2,1482,1205,-20
114589693450,114589693451,1,2098,1241,-20
114589937505,114589937509,4,2557,1163,-20
114590538307,114590538307,0,1700,2070,-20
114590811598,114590811603,5,2081,1280,-20
114600879552,114600879557,5,2544,1508,-20
114610009376,114610009378,2,1834,1563,-20
114612978393,114612978393,0,1453,1809,-20
114613395655,114613395656,1,1075,1228,-20
114619876899,114619876904,5,2547,1904,-20
114623475763,114623475765,2,1256,937,-20
114623961537,114623961544,7,1569,1665,-20
114625990719,114625990721,2,1096,850,-20
114627770527,114627770533,6,5743,2272,-20
114630093531,114630093533,2,1399,1130,-20
114633334812,114633334816,4,2026,1470,-20
114635464078,114635464081,3,1540,1303,-20
114640033543,114640033546,3,1744,1375,-20
114640818702,114640818706,4,2293,1431,-20
114643762913,114643762914,1,2085,2247,-20
114655663269,114655663270,1,1378,1198,-20
114657302110,114657302114,4,2082,1352,-20
114657621608,114657621598,-10,1830,891,-20
114658925714,114658925719,5,2331,1079,-20
114661382822,114661382826,4,1875,1299,-20
114665240270,114665240272,2,2014,1148,-20
114666304411,114666304416,5,1735,1962,-20
114666412886,114666412890,4,1951,923,-20
114667036049,114667036051,2,1898,1220,-20
114668699019,114668699023,4,2402,1653,-20
114669103274,114669103280,6,1174,1064,-20
114670393006,114670393011,5,2220,1853,-20
114673224327,114673224331,4,1673,1123,-20
114675906964,114675906970,6,3226,1309,-20
114678007008,114678007014,6,1592,1291,-20
114679028628,114679028631,3,1801,1166,-20
114680527172,114680527173,1,2425,1844,-20
114685693596,114685693598,2,2101,1438,-20
114687706978,114687706970,-8,1816,7140,-20
114687977383,114687977387,4,1554,1687,-20
114688306934,114688306937,3,1392,1458,-20
114688772830,114688772835,5,1692,1407,-20
114689905882,114689905886,4,1629,1662,-20
114690382696,114690382700,4,2060,2008,-20
114691082775,114691082778,3,2245,1590,-20
114693305897,114693305909,12,13892,43055,-20
114693933258,114693933263,5,1787,1598,-20
114696634595,114696634598,3,1267,1523,-20
114701329618,114701329621,3,1468,842,-20
114702205566,114702205571,5,1568,1667,-20
114708238617,114708238618,1,1811,1959,-20
114718992188,114718992190,2,1681,1748,-20
114719851276,114719851276,0,1512,1610,-20
114723306225,114723306230,5,1658,1415,-20
114723427406,114723427411,5,1545,1278,-20
114723949794,114723949796,2,2031,1239,-20
114725319635,114725319638,3,1293,1049,-20
114726768955,114726768954,-1,1304,2142,-20
114734234361,114734234364,3,1796,1801,-20
114734269538,114734269524,-14,2763,1087,-20
114735130538,114735130539,1,1087,364,-20
114736094885,114736094886,1,1687,1892,-20
114741999759,114741999765,6,2097,1370,-20
114744111659,114744111663,4,1601,1054,-20
114745142605,114745142609,4,1531,1297,-20
114745341729,114745341731,2,1358,1289,-20
114750793913,114750793917,4,2066,1601,-20
114753401871,114753401872,1,1197,1366,-20
114757601291,114757601294,3,1972,1326,-20
114762662471,114762662475,4,1935,1078,-20
114763869102,114763869104,2,844,1342,-20
114764461564,114764461580,16,18,1525,-20
114767375680,114767375682,2,1971,1480,-20
114768391388,114768391391,3,1969,1102,-20
114775179343,114775179352,9,2131,1294,-20
114776622265,114776622269,4,2481,1673,-20
114777514373,114777514374,1,1822,1889,-20
114781259968,114781259971,3,2128,2082,-20
114781462245,114781462247,2,2818,2011,-20
114783522105,114783522106,1,1356,1013,-20
114785574477,114785574457,-20,1694,1547,-20
114786130541,114786130545,4,1378,1256,-20
114786786622,114786786625,3,1539,927,-20
114787914778,114787914783,5,1561,1093,-20
114789831739,114789831743,4,2036,1840,-20
114794521433,114794521435,2,2000,1507,-20
114795012514,114795012498,-16,1502,1138,-20
114797252010,114797252015,5,8793,4729,-20
114799454082,114799454086,4,2849,1800,-20
114800779942,114800779946,4,1526,1585,-20
114805790828,114805790831,3,1477,871,-20
114807441169,114807441173,4,1155,1412,-20
114810174593,114810174596,3,2387,1580,-20
114810521038,114810521039,1,1844,1354,-20
114810624862,114810624881,19,1748,1486,-20
114813569706,114813569711,5,1636,1478,-20
114813987013,114813987018,5,1420,20133,-20
114823358191,114823358193,2,1374,1372,-20
114825510137,114825510137,0,1382,1400,-20
114827713265,114827713268,3,1530,1558,-20
114829218162,114829218164,2,2973,1743,-20
114829842626,114829842630,4,1609,1678,-20
114830428607,114830428609,2,2590,1479,-20
114832683324,114832683326,2,1638,1417,-20
114834196395,114834196400,5,2496,1904,-20
114837140341,114837140342,1,1294,1448,-20
114838035657,114838035660,3,2035,1199,-20
114838593311,114838593318,7,1484,1115,-20
114839461146,114839461132,-14,691,711,-20
114840692255,114840692257,2,1833,1563,-20
114841196906,114841196913,7,1912,1250,-20
114848455949,114848455952,3,1821,1029,-20
114849092535,114849092539,4,1928,1471,-20
114852808191,114852808194,3,1897,2100,-20
114853982729,114853982733,4,1913,1445,-20
114855703637,114855703648,11,2766,1334,-20
114857706399,114857706402,3,1618,1090,-20
114860221390,114860221389,-1,1192,2375,-20
114860661697,114860661700,3,1980,1354,-20
114861863741,114861863745,4,2184,1755,-20
114866449168,114866449172,4,3590,2575,-20
114870375683,114870375685,2,1579,1616,-20
114873497443,114873497445,2,1464,1804,-20
114876092813,114876092818,5,1481,957,-20
114877920160,114877920162,2,1957,1745,-20
114881577744,114881577742,-2,2003,2470,-20
114888654453,114888654459,6,1740,1616,-20
114889219609,114889219614,5,1926,1472,-20
114890712897,114890712890,-7,1861,8415,-20
114891285373,114891285374,1,2374,1626,-20
114891687590,114891687594,4,2529,2176,-20
114894451525,114894451530,5,1848,1104,-20
114901709159,114901709162,3,1648,1502,-20
114903910756,114903910752,-4,158,725,-20
114904803697,114904803700,3,1839,1529,-20
114905902193,114905902192,-1,1005,1407,-20
114906593830,114906593834,4,1640,897,-20
114911506085,114911506080,-5,1002,2953,-20
114912169812,114912169815,3,2107,1571,-20
114914530496,114914530500,4,2342,1864,-20
114914787410,114914787413,3,1958,1523,-20
114915696920,114915696915,-5,1369,682,-20
114919220587,114919220590,3,2153,1760,-20
114926661312,114926661313,1,1373,1530,-20
114927761235,114927761240,5,1528,1420,-20
114928380626,114928380608,-18,1565,1093,-20
114928973143,114928973146,3,2096,1577,-20
114931135010,114931135013,3,1245,1387,-20
114933940890,114933940893,3,1340,1406,-20
114934937298,114934937301,3,1896,1603,-20
114935692284,114935692284,0,1438,1507,-20
114938189747,114938189749,2,1838,1287,-20
114938533615,114938533613,-2,1192,1961,-20
114943136289,114943136291,2,2045,1700,-20
114943317471,114943317474,3,1493,1263,-20
114946586803,114946586806,3,1132,933,-20
114947626386,114947626391,5,2524,1548,-20
114948297778,114948297782,4,1713,1621,-20
114948856424,114948856428,4,1630,1552,-20
114950687179,114950687181,2,1652,1183,-20
114953398471,114953398475,4,1736,1220,-20
114953945927,114953945930,3,1396,1336,-20
114954164026,114954164029,3,2291,1458,-20
114954520124,114954520128,4,2813,1518,-20
114957929203,114957929206,3,1727,1613,-20
114959593051,114959593054,3,1284,1503,-20
114960322189,114960322193,4,1651,1035,-20
114962134503,114962134496,-7,1278,5366,-20
114969310185,114969310186,1,1479,1368,-20
114972157397,114972157399,2,1944,1361,-20
114972927144,114972927147,3,1656,1644,-20
114975745696,114975745700,4,1753,1873,-20
114983386296,114983386303,7,996,548,-20
114999415285,114999415289,4,2165,1192,-20
115000399294,115000399287,-7,1470,8066,-20
115000831142,115000831145,3,2016,1134,-20
115002284379,115002284383,4,1590,1277,-20
115002486802,115002486818,16,2419,1438,-20
115004053446,115004053452,6,1349,1491,-20
115007668505,115007668511,6,4241,1517,-20
115009642710,115009642713,3,2318,1664,-20
115010546513,115010546514,1,1712,1528,-20
115012862018,115012862022,4,2013,1459,-20
115014565207,115014565210,3,1512,1403,-20
115014845302,115014845296,-6,12,2501,-20
115020509565,115020509566,1,1710,1405,-20
115021259330,115021259334,4,877,817,-20
115022897424,115022897425,1,1563,1551,-20
115035456511,115035456514,3,1729,1062,-20
115035682443,115035682426,-17,975,598,-20
115036649247,115036649250,3,1641,1464,-20
115040858228,115040858246,18,679,660,-20
115043234741,115043234746,5,2300,1717,-20
115047359187,115047359189,2,1447,1119,-20
115047701463,115047701465,2,1749,1646,-20
115050668362,115050668368,6,4440,2548,-20
115052252630,115052252633,3,1752,1571,-20
115052372425,115052372428,3,2903,2771,-20
115056960243,115056960247,4,2106,1351,-20
115057170100,115057170123,23,1519,1221,-20
115057925507,115057925510,3,2325,1316,-20
115058747394,115058747394,0,1389,1447,-20
115062395304,115062395307,3,2031,1857,-20
115063657656,115063657659,3,1875,1474,-20
115066610277,115066610282,5,3902,1521,-20
115067427646,115067427650,4,1564,1554,-20
115071060247,115071060250,3,1402,1200,-20
115071770787,115071770789,2,1664,1734,-20
115075114440,115075114435,-5,1393,3043,-20
115077996319,115077996321,2,947,1352,-20
115079991137,115079991141,4,2754,2170,-20
115082323969,115082323971,2,1998,1344,-20
115082672437,115082672427,-10,931,280,-20
115082984189,115082984189,0,24636,34903,-20
115083206405,115083206408,3,1464,1144,-20
115083789505,115083789491,-14,1935,1085,-20
115087371395,115087371383,-12,361,2086,-20
115087601032,115087601034,2,1461,1581,-20
115088326752,115088326757,5,2074,1604,-20
115090638033,115090638038,5,1893,1506,-20
115091734342,115091734346,4,2443,1282,-20
115093243094,115093243098,4,3371,1881,-20
115094116145,115094116150,5,4270,2654,-20
115099236246,115099236247,1,1066,1617,-20
115104753422,115104753425,3,855,1191,-20
115108155725,115108155727,2,1256,1130,-20
115111047679,115111047683,4,2199,1757,-20
115115807028,115115807033,5,2457,1776,-20
115116276098,115116276103,5,980,1633,-20
115117520123,115117520127,4,2154,1482,-20
115119090154,115119090153,-1,1411,925,-20
115124236428,115124236430,2,2061,1465,-20
115124767820,115124767825,5,3117,2281,-20
115127076148,115127076153,5,2328,1230,-20
115128641314,115128641318,4,744,650,-20
115129361379,115129361383,4,2204,1363,-20
115129579354,115129579351,-3,1082,2165,-20
115129643484,115129643490,6,3479,953,-20
115133198943,115133198946,3,1060,925,-20
115134342907,115134342911,4,1069,1315,-20
115136576906,115136576908,2,1734,1888,-20
115139949831,115139949834,3,2036,1525,-20
115140229607,115140229609,2,2124,2503,-20
115141017486,115141017487,1,1598,1591,-20
115142023966,115142023967,1,1370,1195,-20
115142219433,115142219443,10,875,1017,-20
115142486674,115142486678,4,3371,1784,-20
115144457874,115144457877,3,1597,1498,-20
115146737412,115146737414,2,1591,1264,-20
115150138798,115150138802,4,1778,1576,-20
115152889445,115152889449,4,1629,1532,-20
115153380354,115153380369,15,1992,1171,-20
115153700766,115153700746,-20,5280,503,-20
115155683764,115155683766,2,2322,1674,-20
115156808446,115156808450,4,2103,1388,-20
115161142778,115161142783,5,2596,1483,-20
115165768865,115165768869,4,2335,990,-20
115167342566,115167342572,6,60721,22731,-20
115167411382,115167411382,0,6896,12020,-20
115168333363,115168333366,3,1725,1483,-20
115169048334,115169048333,-1,1188,1497,-20
115170301623,115170301626,3,2013,1466,-20
115177323883,115177323886,3,1556,2442,-20
115178706046,115178706046,0,1830,1685,-20
115181691371,115181691375,4,2365,1340,-20
115182378425,115182378426,1,1540,1725,-20
115182640130,115182640131,1,875,1768,-20
115186967238,115186967240,2,2412,2345,-20
115190781906,115190781907,1,2055,1219,-20
115192552538,115192552543,5,2410,1504,-20
115194778123,115194778126,3,878,101,-20
115195262560,115195262563,3,1512,1459,-20
115201494812,115201494814,2,2054,1791,-20
115202370963,115202370968,5,2391,1688,-20
115207409034,115207409037,3,1401,1209,-20
115207910103,115207910107,4,1506,1148,-20
115211571785,115211571789,4,1780,1261,-20
115226322966,115226322971,5,1307,1019,-20
115227246329,115227246330,1,1230,1882,-20
115230576736,115230576737,1,1630,1345,-20
115232757477,115232757479,2,2037,1667,-20
115233111138,115233111139,1,1118,1659,-20
115238780787,115238780789,2,1877,1448,-20
115240989662,115240989666,4,1669,1317,-20
115249273193,115249273197,4,1093,1011,-20
115250804837,115250804838,1,1779,1507,-20
115253957461,115253957464,3,2560,1596,-20
115264099298,115264099301,3,2276,1333,-20
115266150940,115266150943,3,1480,1325,-20
115266954325,115266954331,6,2140,1043,-20
115276109688,115276109691,3,2507,2216,-20
115279871670,115279871671,1,1185,1254,-20
115281646189,115281646193,4,2165,1710,-20
115283121722,115283121726,4,1554,1278,-20
115285953191,115285953195,4,1038,1350,-20
115287411590,115287411592,2,1501,1391,-20
115288422197,115288422200,3,1533,1559,-20
115290757401,115290757404,3,1891,1864,-20
115291290498,115291290499,1,1715,1145,-20
115293005446,115293005449,3,1227,942,-20
115293050844,115293050847,3,1968,1465,-20
115293091049,115293091053,4,1723,1550,-20
115293484483,115293484485,2,1882,2097,-20
115293525842,115293525847,5,2323,1677,-20
115294156398,115294156401,3,1511,1094,-20
115295704573,115295704577,4,1784,1454,-20
115295997977,115295997982,5,2084,1114,-20
115296373758,115296373761,3,1508,1187,-20
115297524567,115297524570,3,1068,1293,-20
115300097554,115300097557,3,2148,1534,-20
115302906130,115302906133,3,1382,731,-20
115308680946,115308680947,1,1723,1652,-20
115311792496,115311792497,1,1630,1543,-20
115314582276,115314582275,-1,1225,1974,-20
115316490434,115316490437,3,1635,1628,-20
115317707918,115317707921,3,1841,1361,-20
115319147815,115319147817,2,2023,1381,-20
115322952866,115322952869,3,1756,1565,-20
115325954782,115325954787,5,1602,1510,-20
115329041375,115329041385,10,1749,1067,-20
115332222633,115332222635,2,1626,929,-20
115332544948,115332544954,6,2606,1112,-20
115334949962,115334949964,2,1496,1086,-20
115336252287,115336252288,1,1067,1931,-20
115337593838,115337593841,3,1173,1125,-20
115339619166,115339619171,5,1411,1269,-20
115341654237,115341654240,3,2205,1476,-20
115343575299,115343575302,3,1682,1705,-20
115346549838,115346549842,4,1369,1761,-20
115348354383,115348354382,-1,1661,2880,-20
115348576566,115348576567,1,1472,1311,-20
115349355439,115349355444,5,2133,1651,-20
115350597156,115350597160,4,2123,1268,-20
115355304726,115355304727,1,1307,817,-20
115355967826,115355967830,4,2878,1533,-20
115356976502,115356976504,2,1877,1264,-20
115359302859,115359302864,5,1738,1660,-20
115360654737,115360654739,2,1139,861,-20
115361146376,115361146399,23,1037,906,-20
115363799061,115363799062,1,1579,1523,-20
115364323833,115364323838,5,2805,1858,-20
115365909616,115365909618,2,2333,1478,-20
115366469929,115366469931,2,1279,852,-20
115373736466,115373736470,4,1677,1340,-20
115374615459,115374615466,7,3900,2032,-20
115376213475,115376213479,4,2072,1514,-20
115377214093,115377214094,1,1148,1217,-20
115377641870,115377641872,2,2321,1542,-20
115380378575,115380378577,2,2776,3033,-20
115381758742,115381758743,1,1804,1481,-20
115383180153,115383180156,3,2036,1891,-20
115386051495,115386051498,3,2087,1669,-20
115391303874,115391303877,3,1348,1148,-20
115392734142,115392734145,3,1650,1010,-20
115394464305,115394464310,5,1616,1112,-20
115399603198,115399603205,7,1872,1680,-20
115402531053,115402531039,-14,783,340,-20
115404325491,115404325494,3,1532,1274,-20
115408265189,115408265195,6,7053,23210,-20
115408462382,115408462388,6,1791,1519,-20
115409129730,115409129730,0,1488,1288,-20
115412085650,115412085653,3,1508,1302,-20
115419975277,115419975278,1,927,684,-20
115422221054,115422221057,3,3271,2157,-20
115422284635,115422284642,7,2880,1189,-20
115424195551,115424195554,3,1331,1493,-20
115427045166,115427045172,6,1681,1167,-20
115428338617,115428338619,2,1243,1076,-20
115432668496,115432668499,3,1683,1403,-20
115434541322,115434541328,6,4353,2057,-20
115436757908,115436757909,1,2496,2066,-20
115437620936,115437620939,3,1793,1085,-20
115439528945,115439528947,2,1703,1192,-20
115440362823,115440362827,4,1622,1398,-20
115440566783,115440566787,4,1889,1927,-20
115440656083,115440656085,2,2507,1724,-20
115443681718,115443681721,3,1672,1450,-20
115445848789,115445848790,1,2117,1502,-20
115446381395,115446381395,0,1838,2928,-20
115447313977,115447313981,4,2182,2419,-20
115451699850,115451699852,2,963,1713,-20
115452424289,115452424293,4,1520,1369,-20
115458644401,115458644403,2,1881,1452,-20
115460972810,115460972813,3,1726,1770,-20
115461347878,115461347884,6,1839,964,-20
115461545558,115461545562,4,1649,1084,-20
115464162062,115464162066,4,1460,1557,-20
115465185198,115465185202,4,2001,1151,-20
115467737429,115467737433,4,1766,1122,-20
115468031899,115468031900,1,1889,1655,-20
115472176913,115472176902,-11,16615,39709,-20
115476265026,115476265029,3,1928,1773,-20
115477746314,115477746317,3,1823,1850,-20
115483248397,115483248401,4,1542,1235,-20
115483759226,115483759229,3,1920,1188,-20
115484735354,115484735357,3,1088,1526,-20
115486721040,115486721042,2,1828,1293,-20
115489123260,115489123265,5,1499,999,-20
115489214256,115489214259,3,1613,1084,-20
115491814074,115491814077,3,1800,1439,-20
115492331074,115492331060,-14,1536,1303,-20
115492589831,115492589834,3,1837,1410,-20
115492659873,115492659874,1,1143,1781,-20
115493761405,115493761410,5,1975,1637,-20
115496542707,115496542711,4,1864,1194,-20
115496914729,115496914734,5,2455,1596,-20
115502011229,115502011232,3,1393,1640,-20
115504051941,115504051943,2,2183,1685,-20
115504286557,115504286562,5,1533,1399,-20
115504726849,115504726855,6,1327,815,-20
115504874678,115504874678,0,1088,1457,-20
115506065112,115506065114,2,2249,1812,-20
115510279853,115510279855,2,1013,1252,-20
115513255602,115513255604,2,1140,1205,-20
115514731966,115514731967,1,1524,1658,-20
115517148666,115517148670,4,1283,1143,-20
115517432018,115517432022,4,1838,1625,-20
115520163907,115520163911,4,2196,1418,-20
115525007133,115525007139,6,1690,1240,-20
115526355374,115526355377,3,1342,1263,-20
115528198361,115528198363,2,1773,902,-20
115528684692,115528684690,-2,1271,2122,-20
115529549098,115529549099,1,1986,1289,-20
115531402258,115531402261,3,1462,1143,-20
115532358591,115532358586,-5,884,263,-20
115535122130,115535122130,0,1591,1355,-20
115536127989,115536127986,-3,1810,3997,-20
115537268935,115537268939,4,1314,1684,-20
115538617162,115538617167,5,2269,1630,-20
115539582353,115539582354,1,1830,2546,-20
115540797734,115540797737,3,2250,1861,-20
115540941303,115540941305,2,2296,1831,-20
115541027874,115541027877,3,1159,1247,-20
115542715481,115542715484,3,2527,1890,-20
115545454973,115545454976,3,1456,1389,-20
115549764946,115549764950,4,2372,1761,-20
115550040673,115550040677,4,1714,1199,-20
115550992190,115550992196,6,2790,1718,-20
115551198948,115551198951,3,1682,1659,-20
115551591472,115551591475,3,2246,2144,-20
115552630830,115552630833,3,1917,1557,-20
115554354489,115554354493,4,1799,1308,-20
115556450705,115556450707,2,1133,932,-20
115557429294,115557429296,2,2074,1458,-20
115557481388,115557481391,3,32997,26319,-20
115559192235,115559192239,4,1863,1349,-20
115562880190,115562880192,2,1354,1951,-20
115566351642,115566351647,5,1483,1190,-20
115570249742,115570249745,3,1674,1287,-20
115573671547,115573671547,0,1812,2150,-20
115575111626,115575111626,0,1657,1443,-20
115578591338,115578591342,4,1759,2066,-20
115579692968,115579692970,2,2310,1723,-20
115583837538,115583837545,7,4598,1265,-20
115584687103,115584687107,4,1416,1099,-20
115585259010,115585259013,3,1700,1561,-20
115589002786,115589002790,4,2897,1893,-20
115599964624,115599964626,2,1485,1840,-20
115603831907,115603831903,-4,2023,4552,-20
115607006591,115607006594,3,1765,1362,-20
115609249426,115609249425,-1,2037,3290,-20
115613146664,115613146667,3,1021,1197,-20
115614623987,115614623980,-7,946,2799,-20
115614701372,115614701374,2,1401,1893,-20
115615466069,115615466072,3,1801,1529,-20
115615726789,115615726794,5,1784,1358,-20
115615810391,115615810394,3,1748,2076,-20
115616336949,115616336951,2,1405,1101,-20
115618407354,115618407359,5,1906,1028,-20
115623077664,115623077666,2,1396,1176,-20
115623568441,115623568444,3,1580,1450,-20
115625919623,115625919626,3,1482,1130,-20
115629089374,115629089375,1,1681,967,-20
115633441188,115633441191,3,1781,1290,-20
115634328765,115634328770,5,1313,1350,-20
115635171937,115635171938,1,1614,1307,-20
115635974229,115635974231,2,2808,1589,-20
115636637235,115636637236,1,2730,1780,-20
115636704321,115636704325,4,1995,1088,-20
115638478157,115638478159,2,1958,1566,-20
115639382295,115639382299,4,2634,1339,-20
115639519378,115639519361,-17,646,343,-20
115639859941,115639859945,4,1271,1041,-20
115644834489,115644834496,7,2543,1655,-20
115648223921,115648223923,2,1526,819,-20
115650803157,115650803158,1,1917,1595,-20
115653193751,115653193753,2,2350,1214,-20
115657693183,115657693186,3,2071,1420,-20
115659191879,115659191878,-1,1453,1511,-20
115660844797,115660844803,6,2641,1800,-20
115661263564,115661263567,3,2103,1377,-20
115665176809,115665176812,3,2085,1668,-20
115670973906,115670973910,4,1895,1373,-20
115672005881,115672005884,3,1315,1305,-20
115674727109,115674727112,3,1407,823,-20
115675126611,115675126613,2,1367,1343,-20
115677546450,115677546455,5,2534,950,-20
115677842774,115677842778,4,1459,990,-20
115678392905,115678392907,2,1384,1439,-20
115678878916,115678878919,3,2071,1518,-20
115679936666,115679936669,3,1552,1565,-20
115679984090,115679984095,5,2562,1632,-20
115681218065,115681218069,4,2029,1359,-20
115681716537,115681716522,-15,2397,750,-20
115684230053,115684230057,4,1281,1350,-20
115687816658,115687816661,3,933,1269,-20
115689854463,115689854467,4,1822,1523,-20
115691543530,115691543535,5,2315,1651,-20
115692032197,115692032195,-2,1938,4698,-20
115694188362,115694188366,4,1973,1445,-20
115705767611,115705767610,-1,1088,1331,-20
115710789945,115710789948,3,2167,1341,-20
115716605518,115716605523,5,1787,1623,-20
115720018154,115720018157,3,1804,1213,-20
115722185583,115722185587,4,1749,1042,-20
115722954158,115722954162,4,1113,804,-20
115731378166,115731378173,7,1867,1410,-20
115732500118,115732500096,-22,1515,1386,-20
115734803918,115734803922,4,2324,1526,-20
115738021297,115738021298,1,1934,1614,-20
115738082403,115738082405,2,1652,1145,-20
115739650020,115739650024,4,1996,1391,-20
115740712846,115740712826,-20,2335,1431,-20
115741099010,115741099012,2,1889,1446,-20
115747309112,115747309115,3,2201,1850,-20
115750114008,115750114009,1,1383,1215,-20
115750178753,115750178757,4,1391,1422,-20
115751441134,115751441137,3,1714,1124,-20
115752474657,115752474659,2,2111,1411,-20
115760352314,115760352316,2,2065,1594,-20
115764516210,115764516214,4,3006,1759,-20
115767079014,115767079018,4,1995,1956,-20
115767160082,115767160067,-15,2656,1418,-20
115769141081,115769141082,1,1487,984,-20
115770991530,115770991533,3,2831,2111,-20
115778452315,115778452318,3,853,888,-20
115778934561,115778934566,5,1603,1000,-20
115779724206,115779724209,3,2036,1333,-20
115779831154,115779831158,4,2034,1300,-20
115780328560,115780328563,3,2258,1300,-20
115780711283,115780711285,2,1278,1473,-20
115782025847,115782025850,3,2329,1612,-20
115783170761,115783170764,3,2119,1471,-20
115784821062,115784821066,4,2296,1402,-20
115784979167,115784979168,1,1894,1640,-20
115785618073,115785618074,1,1947,1012,-20
115792113847,115792113850,3,2477,1602,-20
115793003825,115793003830,5,1911,1500,-20
115795838291,115795838295,4,1578,1328,-20
115798428759,115798428765,6,1742,1764,-20
115798957845,115798957846,1,2194,1256,-20
115800831993,115800831997,4,1903,1725,-20
115801689652,115801689658,6,1671,643,-20
115803866386,115803866390,4,1479,1235,-20
115804092142,115804092146,4,1331,1187,-20
115804178470,115804178466,-4,3147,11360,-20
115806120005,115806120009,4,1700,1291,-20
115806731636,115806731639,3,1688,1573,-20
115812613748,115812613751,3,2327,1492,-20
115813463705,115813463698,-7,173,957,-20
115826220255,115826220258,3,1397,1528,-20
115826614251,115826614245,-6,1124,5087,-20
115831872668,115831872673,5,2012,1878,-20
115834318842,115834318846,4,1806,1737,-20
115837133123,115837133130,7,3413,1192,-20
115840067018,115840067022,4,2408,1574,-20
115840322091,115840322094,3,1610,1135,-20
115840515592,115840515601,9,2324,1378,-20
115842670789,115842670794,5,1741,1245,-20
115843961405,115843961408,3,1419,1123,-20
115844162695,115844162699,4,2432,1745,-20
115845428654,115845428654,0,1146,1698,-20
115850100674,115850100677,3,1810,1054,-20
115852382517,115852382520,3,1043,819,-20
115852486795,115852486800,5,1658,984,-20
115854235082,115854235083,1,1487,1245,-20
115856804525,115856804530,5,2063,751,-20
115859587585,115859587578,-7,3052,8735,-20
115860156030,115860156034,4,1869,1395,-20
115861453479,115861453483,4,973,1042,-20
115863086356,115863086359,3,1927,1701,-20
115868050514,115868050518,4,1359,1548,-20
115868171129,115868171131,2,1600,1073,-20
115868631701,115868631705,4,2165,1499,-20
115870083721,115870083725,4,1314,1224,-20
115870140878,115870140881,3,4133,2804,-20
115874411262,115874411267,5,1926,1633,-20
115875091846,115875091850,4,1356,1013,-20
115877390893,115877390897,4,1314,1049,-20
115881271022,115881271024,2,1934,973,-20
115882461217,115882461219,2,1637,1246,-20
115886909925,115886909929,4,3835,2837,-20
115887926842,115887926839,-3,1893,6344,-20
115888910298,115888910303,5,1412,931,-20
115889302766,115889302769,3,1908,1499,-20
115894051582,115894051586,4,1892,1222,-20
115897128422,115897128425,3,2188,1569,-20
115897491079,115897491083,4,1435,1437,-20
115899452257,115899452258,1,1459,2056,-20
115900335937,115900335942,5,2023,837,-20
115901440840,115901440842,2,2281,1446,-20
115901552558,115901552553,-5,4246,7520,-20
115903533490,115903533492,2,1600,1748,-20
115906874682,115906874687,5,2238,1051,-20
115907156922,115907156924,2,1266,1446,-20
115907569111,115907569116,5,2658,2122,-20
115908083147,115908083152,5,1826,1579,-20
115908154426,115908154431,5,1690,1125,-20
115908619750,115908619761,11,1645,1103,-20
115915554531,115915554533,2,1069,1121,-20
115916477342,115916477345,3,1520,892,-20
115917288889,115917288891,2,1192,972,-20
115917997202,115917997206,4,1467,1684,-20
115927867086,115927867090,4,2498,1803,-20
115929747394,115929747400,6,2355,1206,-20
115930889827,115930889830,3,1926,1980,-20
115933220013,115933220018,5,1857,1295,-20
115933440042,115933440028,-14,1904,1090,-20
115934976250,115934976253,3,2418,1648,-20
115938541567,115938541565,-2,958,1791,-20
115942516413,115942516415,2,1286,1060,-20
115943479438,115943479444,6,2684,1931,-20
115944059613,115944059614,1,1140,1800,-20
115944571881,115944571884,3,2004,1496,-20
115944686911,115944686915,4,2160,1490,-20
115948507068,115948507057,-11,1849,1236,-20
115949548970,115949548970,0,2746,1792,-20
115950549231,115950549246,15,1305,1311,-20
115953724081,115953724087,6,2629,1185,-20
115955589021,115955589023,2,1472,1130,-20
115956538225,115956538227,2,1349,1403,-20
115961012079,115961012082,3,1690,1813,-20
115965089726,115965089731,5,2522,1570,-20
115967832296,115967832299,3,1654,1261,-20
115969603247,115969603251,4,1693,1362,-20
115969664575,115969664580,5,2736,1768,-20
115973563523,115973563526,3,2364,1877,-20
115974535465,115974535467,2,1418,1324,-20
115975320680,115975320686,6,2105,1952,-20
115975593998,115975594002,4,1972,1319,-20
115976097081,115976097085,4,1442,1410,-20
115978016323,115978016322,-1,7962,13694,-20
115980426190,115980426197,7,2350,2372,-20
115981284605,115981284606,1,1821,1303,-20
115981824905,115981824910,5,2019,1395,-20
115983748328,115983748331,3,1557,1267,-20
115984715437,115984715445,8,6692,2127,-20
115985210116,115985210119,3,2248,1245,-20
115985808670,115985808669,-1,1262,1856,-20
115987220864,115987220865,1,1590,1491,-20
115988205531,115988205531,0,1081,843,-20
115988302857,115988302860,3,2176,1930,-20
115988427780,115988427785,5,1956,1609,-20
115990647230,115990647233,3,1006,1117,-20
115991134752,115991134755,3,1588,1561,-20
115991816208,115991816212,4,2165,1704,-20
115993109410,115993109414,4,1757,1500,-20
115993591880,115993591883,3,2364,1342,-20
115997219446,115997219447,1,1855,1469,-20
115999163837,115999163841,4,1397,1150,-20
116000770286,116000770268,-18,1279,553,-20
116001431518,116001431521,3,1725,1700,-20
116001497595,116001497602,7,80,470,-20
116004740079,116004740082,3,1299,998,-20
116009291351,116009291354,3,1386,1159,-20
116010740753,116010740755,2,924,1186,-20
116012996978,116012996978,0,1195,1460,-20
116016367318,116016367322,4,2793,1979,-20
116017019358,116017019362,4,1713,1387,-20
116017937134,116017937136,2,2033,1667,-20
116022345859,116022345856,-3,4067,7790,-20
116025008896,116025008898,2,1120,1132,-20
116027973843,116027973848,5,2170,1529,-20
116029801702,116029801708,6,3557,1907,-20
116029852745,116029852750,5,2988,1552,-20
116032304813,116032304817,4,1513,1439,-20
116032451461,116032451483,22,2151,1477,-20
116032678015,116032678018,3,1694,1093,-20
116035583823,116035583827,4,1919,1658,-20
116036903878,116036903883,5,2634,1208,-20
116037309540,116037309545,5,1931,1397,-20
116043920482,116043920483,1,2190,1176,-20
116048517517,116048517520,3,1783,1701,-20
116048872221,116048872224,3,2043,1150,-20
116049180613,116049180609,-4,1712,4053,-20
116049805647,116049805650,3,2352,1419,-20
116051656838,116051656843,5,1915,2203,-20
116060991433,116060991434,1,1553,1620,-20
116061798161,116061798164,3,2377,1701,-20
116064948570,116064948577,7,2183,1302,-20
116066154295,116066154298,3,2301,2565,-20
116070390617,116070390623,6,3038,1500,-20
116070459510,116070459504,-6,2021,8712,-20
116071584768,116071584771,3,3356,1360,-20
116071793269,116071793273,4,2042,1186,-20
116072453938,116072453939,1,2046,1593,-20
116072482916,116072482904,-12,623,264,-20
116074774613,116074774615,2,2184,1854,-20
116075658118,116075658120,2,1601,1536,-20
116076348941,116076348946,5,2231,1525,-20
116079000836,116079000831,-5,55097,28383,-20
116079987047,116079987051,4,2368,1380,-20
116080594430,116080594430,0,1386,1442,-20
116081677988,116081677991,3,2294,1548,-20
116085138302,116085138303,1,645,1261,-20
116088748706,116088748707,1,1385,1027,-20
116089124142,116089124145,3,1713,1053,-20
116093646252,116093646245,-7,1714,12696,-20
116093816197,116093816200,3,1633,1344,-20
116093882269,116093882273,4,2300,1277,-20
116094099298,116094099304,6,1409,1257,-20
116094204172,116094204174,2,2279,1711,-20
116095497794,116095497797,3,1908,1511,-20
116095629894,116095629894,0,1458,846,-20
116096594465,116096594467,2,1385,1253,-20
116097093043,116097093045,2,2123,1842,-20
116097931711,116097931715,4,1406,1757,-20
116100105284,116100105289,5,2294,2018,-20
116101337441,116101337445,4,2096,2167,-20
116102900234,116102900236,2,1710,1296,-20
116107297650,116107297654,4,3004,1701,-20
116109942030,116109942033,3,3030,2563,-20
116111257505,116111257509,4,1177,1393,-20
116111872905,116111872910,5,2290,1429,-20
116116964566,116116964570,4,1653,1353,-20
116117436542,116117436546,4,1701,1605,-20
116117961710,116117961716,6,1555,1690,-20
116120361229,116120361231,2,1842,1200,-20
116125106399,116125106403,4,1558,1653,-20
116126796831,116126796834,3,836,929,-20
116127585910,116127585914,4,1173,1004,-20
116131782282,116131782285,3,2265,1454,-20
116137643923,116137643925,2,3707,2722,-20
116139002718,116139002721,3,1400,1517,-20
116139900413,116139900417,4,1909,1444,-20
116140527073,116140527076,3,1449,1110,-20
116141175118,116141175100,-18,573,482,-20
116142960430,116142960435,5,1362,1604,-20
116149470126,116149470131,5,1837,1356,-20
116150970929,116150970933,4,1613,1207,-20
116154391015,116154391018,3,1668,1335,-20
116156562176,116156562182,6,1974,1518,-20
116158874168,116158874171,3,2361,1536,-20
116160766826,116160766828,2,1646,1737,-20
116162727131,116162727126,-5,735,2350,-20
116167533823,116167533825,2,1932,1380,-20
116170075234,116170075239,5,2090,1648,-20
116173089028,116173089030,2,1601,1585,-20
116179790783,116179790786,3,1030,1037,-20
116182738797,116182738801,4,2404,1373,-20
116183103490,116183103491,1,1229,1382,-20
116183396279,116183396282,3,1707,1654,-20
116184615106,116184615105,-1,41288,23729,-20
116186819121,116186819125,4,1537,1070,-20
116188406087,116188406089,2,1255,1088,-20
116191615333,116191615337,4,1266,1452,-20
116191894510,116191894514,4,2059,1426,-20
116193976679,116193976683,4,1306,1111,-20
116198565017,116198565019,2,1556,1572,-20
116199660031,116199660034,3,1808,1634,-20
116200601618,116200601621,3,1462,1846,-20
116201360956,116201360958,2,1738,1473,-20
116201905220,116201905223,3,1749,972,-20
116202407177,116202407180,3,2515,1291,-20
116204137034,116204137035,1,1314,2127,-20
116205320495,116205320502,7,2538,1024,-20
116214809791,116214809795,4,2206,1276,-20
116215191151,116215191156,5,3335,1627,-20
116215633850,116215633853,3,1796,1162,-20
116219498711,116219498694,-17,1574,979,-20
116219558601,116219558609,8,3930,1678,-20
116220729106,116220729110,4,954,919,-20
116225794069,116225794073,4,2052,1322,-20
116226179123,116226179106,-17,1998,1810,-20
116227423404,116227423408,4,1817,1608,-20
116230702738,116230702741,3,1606,1080,-20
116233249121,116233249122,1,1660,1186,-20
116233850038,116233850056,18,1757,1310,-20
116236454891,116236454894,3,1701,1122,-20
116239275546,116239275550,4,1479,1519,-20
116244707147,116244707151,4,1563,1187,-20
116246136305,116246136307,2,1502,1383,-20
116247706754,116247706762,8,2221,1000,-20
116250466998,116250467001,3,2316,1704,-20
116251435979,116251435982,3,1990,1585,-20
116258579345,116258579347,2,2451,1706,-20
116258692257,116258692258,1,1580,1217,-20
116259536262,116259536264,2,1456,1714,-20
116260199626,116260199622,-4,945,3318,-20
116261592100,116261592105,5,1899,1683,-20
116266628616,116266628622,6,3171,1235,-20
116266958281,116266958282,1,1654,1642,-20
116267361211,116267361216,5,1976,1405,-20
116268203102,116268203114,12,1530,1461,-20
116275462370,116275462375,5,1464,1044,-20
116277460390,116277460395,5,2433,1648,-20
116280111783,116280111791,8,1948,1429,-20
116283424350,116283424354,4,1528,1510,-20
116284091709,116284091712,3,3025,1679,-20
116286428314,116286428318,4,1511,1336,-20
116288507546,116288507550,4,971,1137,-20
116292195985,116292195988,3,1612,1310,-20
116292261698,116292261699,1,1074,1245,-20
116294960020,116294960021,1,1231,1634,-20
116296492734,116296492736,2,857,1291,-20
116300366558,116300366562,4,1343,1093,-20
116302539075,116302539071,-4,1890,4528,-20
116323531807,116323531810,3,1275,1163,-20
116324915706,116324915713,7,380,834,-20
116326772357,116326772361,4,1492,815,-20
116328978957,116328978962,5,2272,1592,-20
116336432810,116336432815,5,2107,1320,-20
116339473922,116339473925,3,1703,1373,-20
116344382831,116344382836,5,1688,1287,-20
116349986714,116349986717,3,2045,1639,-20
116350353441,116350353445,4,1794,1328,-20
116351368404,116351368405,1,1197,939,-20
116353106489,116353106494,5,2856,1228,-20
116355111711,116355111714,3,1302,1621,-20
116357524766,116357524764,-2,1134,1492,-20
116358887251,116358887257,6,2056,1515,-20
116359719872,116359719874,2,1338,1053,-20
116359882177,116359882181,4,2266,1858,-20
116361386408,116361386411,3,1909,1757,-20
116367600862,116367600864,2,1961,1395,-20
116368135762,116368135763,1,1374,1092,-20
116371341787,116371341790,3,1913,1124,-20
116374567302,116374567304,2,1070,1482,-20
116374646297,116374646303,6,4417,2665,-20
116379761169,116379761170,1,1376,1175,-20
116386298337,116386298341,4,2196,1896,-20
116395148289,116395148293,4,2207,1957,-20
116397889323,116397889329,6,5168,2619,-20
116400299948,116400299952,4,1986,1648,-20
116406266408,116406266413,5,1861,1524,-20
116408103270,116408103274,4,2794,1949,-20
116411030954,116411030957,3,1996,1675,-20
116412550299,116412550302,3,1737,1790,-20
116412926177,116412926180,3,2071,1516,-20
116413760098,116413760094,-4,1738,2976,-20
116416016736,116416016739,3,1647,1333,-20
116417410783,116417410787,4,1805,1604,-20
116418127022,116418127025,3,1712,1159,-20
116420669777,116420669780,3,3005,1899,-20
116421084318,116421084321,3,1687,2053,-20
116424173982,116424173982,0,1577,2394,-20
116426259233,116426259237,4,2664,1646,-20
116427628298,116427628303,5,1819,1362,-20
116433105517,116433105521,4,2043,1070,-20
116435025097,116435025098,1,1580,1698,-20
116437928473,116437928475,2,1266,1215,-20
116438161846,116438161825,-21,734,341,-20
116443889498,116443889498,0,2481,3601,-20
116449533353,116449533357,4,1709,1407,-20
116452255204,116452255187,-17,29962,28374,-20
116452595717,116452595723,6,1941,1285,-20
116455620317,116455620320,3,1317,1285,-20
116457138873,116457138876,3,2281,1367,-20
116457828805,116457828808,3,7766,6056,-20
116458184247,116458184252,5,2397,1746,-20
116458514091,116458514084,-7,680,77,-20
116461356557,116461356561,4,1780,1306,-20
116462170090,116462170094,4,1892,1226,-20
116462924154,116462924170,16,1909,1365,-20
116463175740,116463175743,3,1379,1114,-20
116464796079,116464796082,3,1490,1185,-20
116466471155,116466471158,3,1376,2108,-20
116470174026,116470174029,3,2016,1473,-20
116471937875,116471937881,6,1866,1210,-20
116472526817,116472526818,1,872,1443,-20
116475382879,116475382883,4,2127,1470,-20
116475643388,116475643391,3,1657,1435,-20
116481530776,116481530779,3,1326,1217,-20
116483114559,116483114561,2,1766,2072,-20
116483893046,116483893047,1,2202,1656,-20
116485011313,116485011316,3,2703,1694,-20
116487642233,116487642235,2,1870,1315,-20
116488190162,116488190168,6,2347,1114,-20
116488964427,116488964434,7,2228,1452,-20
116489910262,116489910267,5,2365,1490,-20
116491541090,116491541093,3,1543,1236,-20
116492899465,116492899467,2,2295,1468,-20
116494258742,116494258747,5,2035,1333,-20
116496723406,116496723409,3,1445,1616,-20
116501439051,116501439055,4,1606,934,-20
116504404631,116504404636,5,1593,1335,-20
116507501210,116507501207,-3,1581,2828,-20
116513723458,116513723462,4,1101,1242,-20
116516580482,116516580485,3,4065,2483,-20
116521966504,116521966507,3,1806,1380,-20
116523928971,116523928974,3,1413,1023,-20
116525182058,116525182062,4,1922,1448,-20
116527408934,116527408934,0,1598,1377,-20
116530485490,116530485495,5,1804,1649,-20
116534505237,116534505239,2,2500,1838,-20
116536357693,116536357696,3,2444,1243,-20
116536576644,116536576647,3,1993,1240,-20
116538749650,116538749653,3,1535,1513,-20
116542091013,116542091016,3,1894,1682,-20
116547103614,116547103621,7,1542,1465,-20
116548157078,116548157070,-8,2013,6192,-20
116554901302,116554901301,-1,1565,2790,-20
116560503670,116560503677,7,2200,985,-20
116563040481,116563040486,5,1655,1345,-20
116567882007,116567882010,3,2113,1365,-20
116570097429,116570097430,1,1930,1189,-20
116574700291,116574700294,3,1276,1166,-20
116577921911,116577921914,3,1389,1567,-20
116578521369,116578521373,4,2055,1549,-20
116581806945,116581806965,20,2126,1473,-20
116581885526,116581885514,-12,944,603,-20
116584207893,116584207897,4,1910,1800,-20
116584242088,116584242097,9,2533,842,-20
116587158518,116587158521,3,2057,1346,-20
116589017270,116589017274,4,1862,1683,-20
116589674619,116589674622,3,1288,1383,-20
116590509809,116590509814,5,1746,1140,-20
116590709409,116590709420,11,15760,50189,-20
116593084207,116593084213,6,2196,1689,-20
116594171638,116594171643,5,1646,897,-20
116599869713,116599869715,2,1075,1878,-20
116602319337,116602319341,4,2151,1735,-20
116603455196,116603455199,3,1591,1022,-20
116603482155,116603482159,4,1684,1458,-20
116608277431,116608277433,2,1670,1149,-20
116608456610,116608456595,-15,1429,1116,-20
116612469462,116612469466,4,2031,1158,-20
116617275208,116617275213,5,2691,1917,-20
116619596102,116619596106,4,2022,872,-20
116620666308,116620666311,3,2434,1330,-20
116622060447,116622060447,0,1488,1952,-20
116622751265,116622751270,5,2149,1841,-20
116623323815,116623323819,4,1548,1057,-20
116624329059,116624329062,3,2204,1118,-20
116625448994,116625448999,5,2108,1446,-20
116627142929,116627142931,2,1509,1701,-20
116632925982,116632925986,4,1886,1457,-20
116633826984,116633826987,3,1914,2419,-20
116634650598,116634650595,-3,1479,2791,-20
116635261346,116635261350,4,1676,1276,-20
116637452435,116637452438,3,1903,1588,-20
116638117771,116638117774,3,1677,1381,-20
116638912805,116638912791,-14,1458,1091,-20
116639949648,116639949653,5,2121,1051,-20
116640989153,116640989159,6,2026,1548,-20
116646833114,116646833117,3,1357,1039,-20
116649954133,116649954138,5,2358,1737,-20
116651872334,116651872338,4,1353,1035,-20
116653730086,116653730090,4,1874,1536,-20
116657233086,116657233088,2,1736,1414,-20
116657706498,116657706500,2,2044,1146,-20
116657961658,116657961661,3,1338,1086,-20
116660018334,116660018316,-18,1305,693,-20
116663638564,116663638563,-1,1709,1650,-20
116667135998,116667136001,3,1250,1777,-20
116668054677,116668054678,1,2379,1663,-20
116668300683,116668300686,3,1149,1239,-20
116672251419,116672251423,4,1450,1480,-20
116672541358,116672541362,4,1944,1608,-20
116672594908,116672594910,2,1396,943,-20
116673231281,116673231286,5,2019,1417,-20
116673264870,116673264871,1,1510,2389,-20
116676888763,116676888768,5,2177,1833,-20
116677216050,116677216054,4,1340,1359,-20
116678040482,116678040487,5,1733,1556,-20
116678452286,116678452290,4,1588,1008,-20
116678927671,116678927675,4,2073,968,-20
116682928247,116682928249,2,1788,1240,-20
116686361133,116686361136,3,1896,1391,-20
116690029881,116690029874,-7,1629,6669,-20
116690615590,116690615594,4,1666,1205,-20
116693242529,116693242533,4,1596,1549,-20
116694509978,116694509981,3,1778,1808,-20
116695092299,116695092302,3,901,912,-20
116696058140,116696058142,2,1784,1594,-20
116696253032,116696253035,3,1994,1326,-20
116698765165,116698765168,3,2000,1674,-20
116699660416,116699660419,3,2114,1008,-20
116699902150,116699902170,20,1936,1281,-20
116700756025,116700756030,5,1835,1491,-20
116701423806,116701423804,-2,1293,23068,-20
116703750410,116703750414,4,2287,1695,-20
116706032769,116706032769,0,1410,2204,-20
116707698614,116707698618,4,2035,1657,-20
116710864649,116710864650,1,1415,1828,-20
116716173485,116716173485,0,1666,1682,-20
116724664542,116724664547,5,1591,1545,-20
116727002119,116727002122,3,1515,999,-20
116732725815,116732725817,2,37758,32158,-20
116734017834,116734017839,5,1437,1182,-20
116736027322,116736027325,3,1901,1609,-20
116740664932,116740664937,5,2288,1214,-20
116742282037,116742282040,3,2757,1558,-20
116747361474,116747361475,1,1377,1977,-20
116748188330,116748188333,3,1915,1360,-20
116753461087,116753461090,3,1230,1504,-20
116756483042,116756483046,4,1841,1626,-20
116757668659,116757668661,2,2227,1549,-20
116760594007,116760594011,4,1836,1374,-20
116760725990,116760725993,3,1974,1824,-20
116760836539,116760836540,1,1176,2031,-20
116763609211,116763609214,3,1697,1350,-20
116764854524,116764854527,3,2428,1046,-20
116765441468,116765441471,3,1874,1193,-20
116765643108,116765643090,-18,1172,1017,-20
116768192146,116768192149,3,2074,1359,-20
116768310587,116768310590,3,1135,1041,-20
116769674158,116769674162,4,2030,1300,-20
116772124931,116772124933,2,1352,1670,-20
116772400391,116772400395,4,2018,1578,-20
116773753917,116773753921,4,2334,1936,-20
116774756733,116774756737,4,1764,1189,-20
116776526505,116776526506,1,1855,1946,-20
116777676630,116777676634,4,1816,1612,-20
116780219853,116780219858,5,1785,1035,-20
116781678134,116781678149,15,815,2171,-20
116782226035,116782226030,-5,922,2791,-20
116782584662,116782584669,7,1992,1005,-20
116782903821,116782903822,1,1192,1420,-20
116789986853,116789986859,6,2576,1428,-20
116790231313,116790231315,2,2509,2415,-20
116791438559,116791438562,3,2075,1427,-20
116795035651,116795035646,-5,1130,3342,-20
116799664807,116799664810,3,4602,2771,-20
116800971811,116800971814,3,3039,1562,-20
116804825082,116804825085,3,1370,1195,-20
116806225393,116806225398,5,1760,1477,-20
116816303989,116816303993,4,952,935,-20
116818934608,116818934614,6,1259,1272,-20
116822198086,116822198090,4,2121,1013,-20
116823831782,116823831778,-4,1069,2240,-20
116824758773,116824758775,2,1564,1913,-20
116826337542,116826337546,4,2022,1170,-20
116826540634,116826540638,4,2857,1456,-20
116828993663,116828993666,3,1832,1442,-20
116829504090,116829504094,4,1368,1880,-20
116831185282,116831185286,4,1084,1126,-20
116831673623,116831673626,3,2184,1341,-20
116832001907,116832001905,-2,44590,18347,-20
116841914495,116841914498,3,1658,1547,-20
116846476397,116846476401,4,2862,1785,-20
116848372201,116848372204,3,1935,1282,-20
116850401801,116850401803,2,1032,1017,-20
116850846312,116850846314,2,1713,1404,-20
116852958251,116852958255,4,1699,1403,-20
116854845039,116854845043,4,1422,1263,-20
116856532975,116856532982,7,2700,1071,-20
116858572357,116858572358,1,1501,1828,-20
116859824512,116859824515,3,1275,1249,-20
116860020242,116860020243,1,1717,1121,-20
116861781436,116861781437,1,1695,1184,-20
116863631872,116863631870,-2,1649,1397,-20
116868941775,116868941779,4,1604,696,-20
116869330074,116869330078,4,1496,1195,-20
116873335806,116873335809,3,2251,1217,-20
116873660075,116873660076,1,2045,1465,-20
116874872393,116874872397,4,1855,1345,-20
116875186358,116875186363,5,1821,1290,-20
116875306241,116875306247,6,1856,1155,-20
116876508023,116876508026,3,1551,1379,-20
116877174930,116877174934,4,1914,1605,-20
116879597061,116879597064,3,2001,1802,-20
116879711471,116879711476,5,2184,1546,-20
116879813179,116879813161,-18,1932,1755,-20
116880259231,116880259234,3,1452,1401,-20
116883984483,116883984487,4,2755,1077,-20
116889228273,116889228274,1,1184,1647,-20
116892375756,116892375761,5,1875,1480,-20
116895512114,116895512114,0,1072,1524,-20
116897280042,116897280045,3,1414,1214,-20
116900849610,116900849609,-1,1617,2375,-20
116901194562,116901194546,-16,1345,989,-20
116908399739,116908399734,-5,1489,5166,-20
116910123198,116910123201,3,1496,1540,-20
116914242716,116914242713,-3,23494,12954,-20
116916401068,116916401070,2,1465,1266,-20
116918404357,116918404358,1,1129,668,-20
116920946406,116920946408,2,1544,1399,-20
116921132068,116921132073,5,2653,1749,-20
116922001406,116922001407,1,1448,1131,-20
116925503279,116925503263,-16,2116,1384,-20
116930105359,116930105362,3,1861,1619,-20
116933002733,116933002737,4,1465,900,-20
116933566920,116933566925,5,1763,814,-20
116934924727,116934924730,3,2079,769,-20
116935529857,116935529861,4,1831,1235,-20
116942983959,116942983965,6,2858,1281,-20
116943846774,116943846776,2,1679,1499,-20
116944113302,116944113305,3,2018,1295,-20
116944144401,116944144403,2,1779,1102,-20
116949672908,116949672912,4,2389,2234,-20
116949976762,116949976766,4,1858,1253,-20
116953312866,116953312866,0,899,1735,-20
116967758825,116967758827,2,2099,1456,-20
116971241167,116971241173,6,2117,1506,-20
116977119807,116977119810,3,1447,1690,-20
116980604937,116980604940,3,1841,1378,-20
116987086322,116987086311,-11,13900,26777,-20
116990050897,116990050902,5,1520,1094,-20
116992593039,116992593042,3,1663,1145,-20
116994651543,116994651546,3,1634,1625,-20
116998216241,116998216246,5,1862,1975,-20
117000065738,117000065742,4,1608,1320,-20
117001124917,117001124923,6,2517,1443,-20
117001532211,117001532215,4,1756,1608,-20
117003453382,117003453386,4,1412,1186,-20
117004456949,117004456954,5,3340,1517,-20
117006240150,117006240149,-1,1417,1469,-20
117007186149,117007186152,3,2292,2069,-20
117007976621,117007976626,5,2161,1242,-20
117008318237,117008318242,5,1974,1677,-20
117009322256,117009322258,2,1569,1300,-20
117010733257,117010733260,3,1335,1834,-20
117014497073,117014497075,2,1377,960,-20
117016575330,117016575334,4,1557,1027,-20
117017636609,117017636610,1,1162,1397,-20
117018899542,117018899546,4,1337,1184,-20
117019668181,117019668181,0,1966,1299,-20
117020370708,117020370713,5,1477,1015,-20
117020618110,117020618113,3,1811,1423,-20
117022453138,117022453140,2,1304,1146,-20
117026996495,117026996508,13,1291,1137,-20
117028444679,117028444682,3,1124,1618,-20
117029010730,117029010732,2,1376,1328,-20
117030044134,117030044136,2,1614,1546,-20
117030309597,117030309601,4,1827,1428,-20
117038283494,117038283498,4,1460,1415,-20
117038798515,117038798516,1,1678,1350,-20
117039429039,117039429020,-19,1456,2421,-20
117040133431,117040133433,2,1699,1765,-20
117042059858,117042059863,5,2201,1034,-20
117043912021,117043912025,4,1545,1248,-20
117045493346,117045493346,0,865,1784,-20
117047245902,117047245905,3,2129,1440,-20
117047573254,117047573256,2,1691,2176,-20
117048737726,117048737731,5,1381,798,-20
117049269661,117049269641,-20,1630,1300,-20
117054162543,117054162546,3,1144,1483,-20
117055326330,117055326331,1,873,1103,-20
117057886227,117057886233,6,2606,1353,-20
117059398302,117059398306,4,1916,1185,-20
117062625230,117062625234,4,3447,3129,-20
117065713832,117065713834,2,1593,1539,-20
117067937697,117067937700,3,1647,1120,-20
117069836473,117069836472,-1,1173,2293,-20
117074669822,117074669826,4,2038,1864,-20
117078471088,117078471089,1,970,1345,-20
117079389629,117079389631,2,1515,1478,-20
117080174529,117080174534,5,1565,1372,-20
117081652386,117081652388,2,1640,1126,-20
117082388870,117082388874,4,1222,990,-20
117083861627,117083861629,2,1212,1207,-20
117087055257,117087055263,6,2371,1341,-20
117088612169,117088612173,4,1820,1523,-20
117092712813,117092712817,4,1762,846,-20
117092751001,117092751003,2,2006,1260,-20
117093147437,117093147439,2,1399,1044,-20
117093407145,117093407142,-3,5009,9013,-20
117096237926,117096237930,4,2168,965,-20
117099292082,117099292086,4,2110,1272,-20
117099325019,117099325022,3,1914,1374,-20
117099473698,117099473704,6,2785,1327,-20
117104818577,117104818577,0,1447,1184,-20
117105306680,117105306668,-12,1990,865,-20
117106534930,117106534934,4,1281,1077,-20
117111318243,117111318249,6,2393,1118,-20
117112598393,117112598395,2,1606,1106,-20
117113645474,117113645480,6,2319,1734,-20
117115288596,117115288599,3,833,1122,-20
117115900660,117115900665,5,1734,1132,-20
117117485053,117117485050,-3,2100,4103,-20
117120073038,117120073040,2,1616,1477,-20
117121400370,117121400374,4,2118,1098,-20
117124130545,117124130545,0,2662,4626,-20
117126249434,117126249436,2,1252,1568,-20
117128122401,117128122404,3,2027,1450,-20
117129193110,117129193114,4,1580,1558,-20
117130968680,117130968683,3,1684,1632,-20
117133294917,117133294919,2,1272,1367,-20
117135598418,117135598418,0,2165,1709,-20
117145524760,117145524765,5,2415,1217,-20
117145619872,117145619874,2,2215,1531,-20
117147193714,117147193721,7,4978,1798,-20
117151732580,117151732586,6,1784,1180,-20
117151950819,117151950822,3,2807,1758,-20
117153615595,117153615599,4,1745,1095,-20
117154150202,117154150206,4,2265,1619,-20
117156316391,117156316394,3,1778,1875,-20
117156690248,117156690251,3,1314,1401,-20
117156931015,117156931019,4,1243,1363,-20
117160571782,117160571785,3,2426,1249,-20
117161173037,117161173041,4,1650,1698,-20
117161625981,117161625978,-3,3693,6692,-20
117162521075,117162521076,1,2327,2483,-20
117163835449,117163835453,4,1365,1168,-20
117164976588,117164976590,2,1154,1537,-20
117167413578,117167413583,5,2305,1315,-20
117168632372,117168632371,-1,2011,1502,-20
117169688679,117169688682,3,1607,1451,-20
117171581846,117171581852,6,1826,1615,-20
117172529537,117172529541,4,2062,1433,-20
117173782131,117173782134,3,2250,1373,-20
117175182133,117175182138,5,2168,1586,-20
117178208394,117178208394,0,925,1207,-20
117180485532,117180485535,3,1288,1362,-20
117181861218,117181861220,2,1448,1328,-20
117188652381,117188652383,2,1648,1304,-20
117189775300,117189775302,2,1490,1117,-20
117193257995,117193257997,2,1771,1325,-20
117193985126,117193985131,5,2672,1554,-20
117194821538,117194821542,4,1389,1016,-20
117195421009,117195421015,6,2848,1561,-20
117195454225,117195454228,3,1525,1374,-20
117199257722,117199257727,5,2503,1395,-20
117200216207,117200216211,4,1992,1699,-20
117201040989,117201040969,-20,1738,748,-20
117201385191,117201385196,5,2185,1231,-20
117205138705,117205138706,1,1779,1194,-20
117205563370,117205563374,4,1374,1277,-20
117207582170,117207582174,4,1211,859,-20
117210534701,117210534706,5,1885,1011,-20
117215709649,117215709654,5,1333,1269,-20
117217720119,117217720122,3,1293,1420,-20
117219446624,117219446630,6,2769,1372,-20
117223578165,117223578167,2,1545,1881,-20
117223825685,117223825691,6,10373,6042,-20
117235304516,117235304519,3,1567,1112,-20
117238887346,117238887349,3,1774,1169,-20
117239884918,117239884923,5,1627,1097,-20
117242433478,117242433484,6,1543,1397,-20
117243454123,117243454126,3,2751,1583,-20
117245697609,117245697615,6,2356,1275,-20
117246342434,117246342435,1,1029,1125,-20
117251276538,117251276541,3,1537,1155,-20
117253223965,117253223969,4,1956,969,-20
117253560106,117253560090,-16,1461,1228,-20
117254734121,117254734125,4,1417,686,-20
117259293645,117259293649,4,1815,1152,-20
117261803666,117261803666,0,827,1531,-20
117262540605,117262540607,2,1749,1397,-20
117262719783,117262719761,-22,2285,631,-20
117263112614,117263112618,4,1995,1458,-20
117263926101,117263926105,4,2787,1751,-20
117271751615,117271751617,2,2587,1512,-20
117273822534,117273822539,5,2061,1344,-20
117274815205,117274815207,2,1615,1474,-20
117276145960,117276145964,4,1452,1295,-20
117279534483,117279534487,4,1601,1515,-20
117281189409,117281189411,2,1675,1081,-20
117282828807,117282828810,3,1648,1893,-20
117284287019,117284287023,4,1852,1799,-20
117285785210,117285785214,4,2134,1051,-20
117287196869,117287196874,5,1714,1684,-20
117288169914,117288169933,19,841,2504,-20
117290082782,117290082785,3,2057,1164,-20
117290144897,117290144889,-8,3536,10240,-20
117290679468,117290679471,3,2124,1621,-20
117292058756,117292058749,-7,1075,3691,-20
117293724624,117293724627,3,1251,805,-20
117293945736,117293945743,7,1919,1035,-20
117294958370,117294958373,3,1180,1620,-20
117296238049,117296238053,4,1103,1143,-20
117296648330,117296648329,-1,1302,2604,-20
117296971632,117296971624,-8,988,1161,-20
117304214328,117304214331,3,1838,1404,-20
117305097558,117305097562,4,7871,4676,-20
117307914685,117307914684,-1,1745,2132,-20
117313656588,117313656593,5,2498,1796,-20
117314944495,117314944498,3,1521,1021,-20
117315281494,117315281480,-14,1752,757,-20
117316698135,117316698137,2,1851,1526,-20
117319263908,117319263910,2,1881,1117,-20
117321897118,117321897122,4,2145,1018,-20
117322106972,117322106975,3,1973,1420,-20
117329090529,117329090534,5,1000,1099,-20
117329463711,117329463716,5,1962,1721,-20
117330848311,117330848315,4,1886,960,-20
117332818299,117332818302,3,131,342,-20
117337606929,117337606931,2,1585,1104,-20
117339139507,117339139511,4,1776,1200,-20
117346322719,117346322723,4,2138,1340,-20
117346849182,117346849187,5,1383,1437,-20
117350807348,117350807350,2,887,623,-20
117352283800,117352283803,3,1573,1612,-20
117354054668,117354054671,3,1807,1162,-20
117354907131,117354907134,3,2046,1708,-20
117359629382,117359629386,4,1382,1032,-20
117360927604,117360927606,2,1499,1161,-20
117361856398,117361856401,3,1408,864,-20
117363332462,117363332458,-4,1368,5889,-20
117364489078,117364489082,4,1756,892,-20
117364831476,117364831488,12,1330,1447,-20
117365179805,117365179808,3,1948,1774,-20
117366424018,117366424024,6,1664,1481,-20
117369092470,117369092470,0,969,1533,-20
117373316190,117373316194,4,2716,1350,-20
117374612464,117374612466,2,1991,1714,-20
117376581954,117376581957,3,2606,1538,-20
117376847460,117376847463,3,1772,1397,-20
117377389213,117377389215,2,1555,1558,-20
117377854757,117377854759,2,1775,1817,-20
117379193790,117379193792,2,1584,1012,-20
117380587545,117380587547,2,1312,946,-20
117385598249,117385598253,4,1655,1464,-20
117386915366,117386915346,-20,1067,601,-20
117391777257,117391777262,5,2067,1426,-20
117394836070,117394836075,5,2104,1767,-20
117399777857,117399777859,2,1869,1465,-20
117402418478,117402418480,2,1628,1511,-20
117408411306,117408411311,5,2049,1374,-20
117411760194,117411760199,5,1907,1120,-20
117412926775,117412926779,4,1924,1599,-20
117416945014,117416945018,4,1285,944,-20
117419665155,117419665160,5,2497,1413,-20
117421038734,117421038738,4,2701,1276,-20
117422616085,117422616087,2,1358,1166,-20
117423445763,117423445765,2,1815,1515,-20
117424216898,117424216903,5,1224,1150,-20
117433081118,117433081122,4,1792,1578,-20
117433456674,117433456677,3,1274,1371,-20
117436471503,117436471506,3,1907,1507,-20
117436787103,117436787083,-20,1424,1375,-20
117440803451,117440803454,3,1588,1259,-20
117446297477,117446297498,21,1955,1436,-20
117455607769,117455607773,4,1378,1772,-20
117458523884,117458523886,2,1617,1443,-20
117459797469,117459797474,5,1295,903,-20
117463060362,117463060367,5,1198,1484,-20
117463690739,117463690742,3,1667,1873,-20
117465753977,117465753979,2,1883,1237,-20
117467005794,117467005801,7,1813,946,-20
117469067963,117469067966,3,1155,1199,-20
117469458278,117469458284,6,1978,1585,-20
117470472323,117470472318,-5,1601,4527,-20
117471867729,117471867735,6,6793,1579,-20
117473685366,117473685371,5,2065,1021,-20
117475929417,117475929422,5,2504,1064,-20
117475970475,117475970479,4,2193,1481,-20
117477984751,117477984755,4,1718,1339,-20
117478196310,117478196311,1,1521,980,-20
117480744122,117480744127,5,1792,1515,-20
117484187860,117484187863,3,1718,1957,-20
117492396556,117492396561,5,1934,1629,-20
117493019847,117493019851,4,1365,1125,-20
117497439953,117497439955,2,1857,1385,-20
117497755347,117497755353,6,4460,2308,-20
117500730617,117500730620,3,1401,1361,-20
117502762662,117502762664,2,1414,1616,-20
117503214718,117503214722,4,2556,1903,-20
117503320762,117503320765,3,1972,1749,-20
117506524618,117506524622,4,2066,1179,-20
117508348631,117508348634,3,2054,1954,-20
117509436791,117509436794,3,1851,1555,-20
117509532087,117509532096,9,3260,1331,-20
117512521281,117512521283,2,1178,1152,-20
117512950677,117512950670,-7,1813,7311,-20
117519690762,117519690766,4,2294,1066,-20
117520426529,117520426532,3,1790,1362,-20
117521609058,117521609060,2,1117,1126,-20
117523953630,117523953634,4,1418,834,-20
117532914759,117532914761,2,1570,1018,-20
117534724578,117534724578,0,1044,1886,-20
117536026767,117536026771,4,2492,1506,-20
117537692890,117537692892,2,2280,1583,-20
117538250790,117538250794,4,766,803,-20
117539062806,117539062808,2,2216,1240,-20
117541850970,117541850975,5,2452,1227,-20
117544848866,117544848867,1,2020,1245,-20
117547162425,117547162427,2,2263,1321,-20
117550419898,117550419902,4,1610,1485,-20
117551065810,117551065813,3,1086,1532,-20
117551804146,117551804151,5,1415,1085,-20
117552051008,117552051013,5,2279,1222,-20
117554492862,117554492863,1,839,1015,-20
117557747058,117557747061,3,1379,1370,-20
117560514618,117560514622,4,2385,1465,-20
117561941786,117561941789,3,1644,1166,-20
117564743069,117564743071,2,1340,1159,-20
117566573773,117566573775,2,1947,1505,-20
117566948982,117566948985,3,1166,1475,-20
117575466620,117575466625,5,3177,1435,-20
117576447995,117576448001,6,2015,1329,-20
117578216890,117578216890,0,1909,1530,-20
117578327469,117578327471,2,1429,1238,-20
117586185255,117586185256,1,1482,1540,-20
117588025201,117588025205,4,1673,1207,-20
117596870709,117596870714,5,2682,1573,-20
117598813805,117598813807,2,1589,1080,-20
117599021767,117599021771,4,1793,1784,-20
117599374185,117599374182,-3,27882,45274,-20
117600805046,117600805053,7,3336,1265,-20
117601108554,117601108558,4,1214,1090,-20
117602330315,117602330319,4,1808,1325,-20
117602529718,117602529731,13,1821,1904,-20
117604289010,117604289014,4,1047,1202,-20
117605096938,117605096940,2,2181,1585,-20
117605667771,117605667775,4,2352,1452,-20
117615494190,117615494196,6,1763,1253,-20
117615750003,117615750011,8,1411,1046,-20
117616750510,117616750513,3,2313,2200,-20
117617326101,117617326113,12,10209,43465,-20
117618316310,117618316313,3,2367,1852,-20
117618570905,117618570909,4,1975,1462,-20
117619570129,117619570131,2,2072,1514,-20
117624344210,117624344209,-1,1919,1824,-20
117624575452,117624575455,3,2123,1231,-20
117625808863,117625808866,3,1117,1287,-20
117626761145,117626761147,2,1095,1128,-20
117628049444,117628049430,-14,292,746,-20
117635887320,117635887323,3,1348,1131,-20
117636029482,117636029486,4,2046,1404,-20
117637020760,117637020763,3,1952,1161,-20
117639000442,117639000446,4,1919,1085,-20
117641200250,117641200230,-20,6725,2933,-20
117644619724,117644619726,2,1514,1257,-20
117645432526,117645432522,-4,1029,3015,-20
117653049171,117653049171,0,1013,980,-20
117655270663,117655270666,3,1181,979,-20
117656068625,117656068629,4,1254,1317,-20
117656428908,117656428911,3,1230,1121,-20
117656681209,117656681213,4,4714,2475,-20
117657937325,117657937326,1,1770,1114,-20
117659266127,117659266129,2,1470,1635,-20
117667702170,117667702171,1,1004,859,-20
117668948307,117668948311,4,1315,984,-20
117671904942,117671904945,3,2125,1827,-20
117672240290,117672240290,0,1312,1698,-20
117674068309,117674068307,-2,878,1668,-20
117675899524,117675899532,8,12899,42452,-20
117678411201,117678411205,4,1569,1525,-20
117681187270,117681187276,6,2126,1256,-20
117684480448,117684480452,4,2345,1349,-20
117686697384,117686697385,1,1817,1514,-20
117686926412,117686926418,6,3333,1231,-20
117688191897,117688191902,5,2500,1322,-20
117688264563,117688264545,-18,1456,1249,-20
117693221802,117693221805,3,1823,1174,-20
117693633608,117693633616,8,1518,1182,-20
117694080139,117694080142,3,2095,1472,-20
117696018989,117696018994,5,2424,1127,-20
117696310085,117696310091,6,1791,1380,-20
117699884918,117699884922,4,1774,1333,-20
117700819503,117700819506,3,2288,2057,-20
117701242310,117701242314,4,1872,1421,-20
117701448375,117701448374,-1,1311,1062,-20
117702886009,117702886014,5,2059,1460,-20
117703800042,117703800043,1,1870,1401,-20
117703995994,117703995998,4,1396,1510,-20
117708901203,117708901206,3,2634,1414,-20
117710196500,117710196498,-2,952,2185,-20
117710949770,117710949774,4,1435,1036,-20
117711388154,117711388157,3,1507,1543,-20
117711647270,117711647274,4,1652,1415,-20
117714815250,117714815247,-3,1085,1466,-20
117717302234,117717302239,5,1733,1251,-20
117718653929,117718653932,3,1846,1754,-20
117719696639,117719696642,3,1231,1097,-20
117720258525,117720258506,-19,886,406,-20
117720471887,117720471889,2,1549,1264,-20
117721562306,117721562310,4,1683,1021,-20
117724351078,117724351082,4,2104,1130,-20
117725493191,117725493194,3,1919,1201,-20
117727549221,117727549225,4,2084,1267,-20
117736457786,117736457789,3,1179,1237,-20
117738172755,117738172759,4,2019,1247,-20
117739407434,117739407437,3,1564,1570,-20
117739869942,117739869946,4,1786,1241,-20
117741005074,117741005077,3,1561,1493,-20
117741596103,117741596108,5,4838,2594,-20
117743605822,117743605824,2,1852,1638,-20
117745139716,117745139719,3,1971,1329,-20
117745509882,117745509885,3,1682,1664,-20
117749834103,117749834104,1,1450,1329,-20
117752032659,117752032662,3,1590,1366,-20
117753526647,117753526652,5,2075,1396,-20
117753967809,117753967813,4,1538,1372,-20
117758268979,117758268982,3,2079,1504,-20
117759572694,117759572696,2,1728,1508,-20
117765771610,117765771614,4,2928,1614,-20
117770205013,117770205015,2,1916,1534,-20
117770359749,117770359752,3,1337,1550,-20
117771162751,117771162745,-6,1263,6378,-20
117772281085,117772281087,2,1465,1332,-20
117773525062,117773525066,4,2034,1688,-20
117773701764,117773701769,5,1726,1264,-20
117774207953,117774207957,4,2420,1591,-20
117774980769,117774980773,4,2374,1627,-20
117775729195,117775729198,3,887,1109,-20
117776692365,117776692368,3,3029,1848,-20
117776828166,117776828166,0,1400,1592,-20
117777970290,117777970295,5,1245,941,-20
117788912009,117788912011,2,1405,1130,-20
117791732199,117791732203,4,1830,1198,-20
117792519282,117792519284,2,1621,1358,-20
117796466792,117796466794,2,2405,1814,-20
117799239566,117799239569,3,2014,2392,-20
117799817305,117799817308,3,1441,745,-20
117802012619,117802012622,3,1626,1494,-20
117802497901,117802497903,2,2100,1510,-20
117805233709,117805233712,3,2076,1578,-20
117805778651,117805778654,3,1332,1011,-20
117806566250,117806566254,4,2329,1759,-20
117812311105,117812311109,4,1671,1497,-20
117812423085,117812423066,-19,1916,1243,-20
117813014152,117813014133,-19,895,904,-20
117818359039,117818359042,3,1499,1009,-20
117819905847,117819905850,3,1940,865,-20
117825806483,117825806487,4,1916,1308,-20
117831460998,117831461000,2,2038,1898,-20
117832143386,117832143389,3,1958,985,-20
117834563602,117834563605,3,1940,1633,-20
117838732661,117838732663,2,1551,1150,-20
117840440497,117840440477,-20,1090,1169,-20
117846119229,117846119233,4,2100,1782,-20
117846553705,117846553707,2,1481,1101,-20
117849750034,117849750036,2,2190,2060,-20
117850148875,117850148877,2,1934,1100,-20
117854260406,117854260411,5,2052,1332,-20
117854351965,117854351968,3,2609,1886,-20
117854544342,117854544355,13,14043,23657,-20
117855068835,117855068840,5,1581,1111,-20
117858959325,117858959330,5,1461,1246,-20
117859014884,117859014889,5,1699,1321,-20
117860574115,117860574122,7,1583,1334,-20
117863426020,117863426021,1,5023,23873,-20
117867023777,117867023779,2,1978,1415,-20
117869169455,117869169459,4,1513,1321,-20
117870019317,117870019320,3,1376,2013,-20
117871378462,117871378466,4,1964,1496,-20
117872035755,117872035757,2,1604,2368,-20
117872359773,117872359775,2,1964,1314,-20
117873332614,117873332616,2,1894,1457,-20
117875225020,117875225021,1,1314,1363,-20
117876359342,117876359347,5,1914,1183,-20
117878170030,117878170034,4,2154,1725,-20
117878940587,117878940606,19,1368,1230,-20
117880641150,117880641154,4,1372,1004,-20
117881434081,117881434083,2,1422,1444,-20
117882259226,117882259229,3,1566,1306,-20
117883537079,117883537082,3,2197,1294,-20
117885057750,117885057756,6,1347,1351,-20
117886525798,117886525802,4,1727,1326,-20
117886609271,117886609248,-23,784,260,-20
117889316161,117889316164,3,1893,1179,-20
117895200661,117895200664,3,2251,1240,-20
117896795933,117896795936,3,1920,1214,-20
117898315353,117898315357,4,1831,1609,-20
117898565322,117898565324,2,1578,1577,-20
117899827985,117899827987,2,897,1339,-20
117901345150,117901345154,4,1010,832,-20
117901850958,117901850959,1,1819,1045,-20
117902193679,117902193682,3,1140,681,-20
117902904112,117902904116,4,1248,937,-20
117905831626,117905831629,3,2068,1812,-20
117908351979,117908351978,-1,1741,2061,-20
117909472659,117909472662,3,1486,1214,-20
117909890139,117909890139,0,1259,1456,-20
117915308878,117915308883,5,2441,1466,-20
117920032363,117920032367,4,1867,1376,-20
117920552031,117920552035,4,1999,1260,-20
117925719743,117925719747,4,2010,912,-20
117927796927,117927796929,2,1543,1110,-20
117929388296,117929388299,3,2313,1890,-20
117937088845,117937088851,6,2108,1305,-20
117939469792,117939469797,5,2309,1576,-20
117940965428,117940965430,2,1842,1374,-20
117941054834,117941054838,4,763,1088,-20
117941519879,117941519882,3,2032,1231,-20
117945640010,117945640009,-1,1010,1265,-20
117947303086,117947303089,3,2346,2045,-20
117949015686,117949015691,5,2824,2411,-20
117949560054,117949560054,0,1991,1340,-20
117951285930,117951285934,4,1623,1597,-20
117954474873,117954474876,3,1750,1300,-20
117956704278,117956704279,1,2148,1232,-20
117956981357,117956981359,2,1642,1797,-20
117957303145,117957303150,5,1636,1351,-20
117957367317,117957367321,4,2038,1554,-20
117958933752,117958933756,4,1961,1283,-20
117962991846,117962991849,3,1361,1264,-20
117970926211,117970926215,4,1404,1398,-20
117972854659,117972854677,18,1237,1548,-20
117972986483,117972986488,5,1630,1307,-20
117977954214,117977954217,3,1366,1277,-20
117980282573,117980282578,5,2092,1562,-20
117981245155,117981245161,6,2275,1287,-20
117985982538,117985982541,3,1904,1567,-20
117986539569,117986539555,-14,2519,645,-20
117987804793,117987804796,3,2324,1257,-20
117988361474,117988361478,4,1965,1127,-20
117989492609,117989492611,2,875,1202,-20
117993139837,117993139839,2,2099,1512,-20
117993702986,117993702990,4,1755,1170,-20
117994298106,117994298109,3,681,598,-20
117994416247,117994416259,12,1308,1132,-20
117994527119,117994527115,-4,946,312,-20
117997132590,117997132593,3,1846,1668,-20
118001784910,118001784914,4,1410,1401,-20
118002101561,118002101565,4,2027,1293,-20
118012150757,118012150761,4,1979,1596,-20
118012924774,118012924776,2,1049,932,-20
118016441752,118016441751,-1,1304,2103,-20
118016967378,118016967369,-9,1608,1588,-20
118018197848,118018197852,4,2648,1731,-20
118019158115,118019158118,3,1841,1172,-20
118022793685,118022793690,5,1972,1486,-20
118024386674,118024386678,4,1728,1772,-20
118025382594,118025382599,5,2575,1255,-20
118030878297,118030878301,4,1501,1315,-20
118033462705,118033462711,6,2570,1187,-20
118034390467,118034390468,1,1203,1108,-20
118035466349,118035466350,1,2276,1294,-20
118038184754,118038184758,4,2158,1326,-20
118043713156,118043713159,3,1764,1225,-20
118046260827,118046260831,4,1670,1221,-20
118047268874,118047268878,4,2599,1504,-20
118049344895,118049344894,-1,1657,2983,-20
118051418092,118051418095,3,1715,984,-20
118051837526,118051837530,4,1312,1062,-20
118054577389,118054577389,0,1385,2034,-20
118055303766,118055303770,4,2026,1244,-20
118055639670,118055639674,4,2275,1603,-20
118060411544,118060411546,2,2197,1933,-20
118062823667,118062823671,4,1626,1149,-20
118063230826,118063230829,3,1590,1825,-20
118066343522,118066343525,3,2445,2302,-20
118068208550,118068208533,-17,1062,605,-20
118070450602,118070450602,0,765,1185,-20
118073987825,118073987831,6,3382,1768,-20
118074232222,118074232227,5,1679,1129,-20
118074699098,118074699102,4,2051,1748,-20
118075313717,118075313716,-1,34684,21740,-20
118080777622,118080777630,8,1257,487,-20
118082139936,118082139939,3,687,290,-20
118082657657,118082657659,2,1150,1147,-20
118083185816,118083185821,5,1769,1351,-20
118083271147,118083271128,-19,1897,1132,-20
118084617794,118084617798,4,2156,1662,-20
118085081414,118085081420,6,2117,1485,-20
118085395503,118085395509,6,2081,1615,-20
118085766290,118085766294,4,1621,1302,-20
118090054323,118090054323,0,1801,1755,-20
118090760467,118090760470,3,1671,1608,-20
118091537648,118091537653,5,2158,1239,-20
118096267506,118096267506,0,1294,1290,-20
118101906330,118101906334,4,1759,1255,-20
118103330274,118103330278,4,741,1197,-20
118107442417,118107442422,5,3797,1168,-20
118110259012,118110259015,3,2004,1557,-20
118110925182,118110925186,4,1462,1315,-20
118111681410,118111681413,3,1228,1532,-20
118113834846,118113834848,2,2170,1635,-20
118114539854,118114539858,4,1188,1559,-20
118114892877,118114892881,4,2599,1642,-20
118116138599,118116138598,-1,1340,1414,-20
118116753388,118116753390,2,1307,1713,-20
118117023241,118117023260,19,14601,44656,-20
118119693441,118119693446,5,1623,1098,-20
118122861685,118122861686,1,2169,1817,-20
118124788937,118124788942,5,1363,1057,-20
118127752876,118127752881,5,1448,1055,-20
118129344531,118129344534,3,2213,1626,-20
118130380193,118130380198,5,1079,1295,-20
118132138054,118132138059,5,2260,1873,-20
118133782470,118133782474,4,1792,1873,-20
118137239925,118137239929,4,2041,1318,-20
118144613417,118144613420,3,2066,2136,-20
118145636377,118145636381,4,1742,1828,-20
118146784768,118146784769,1,2041,2354,-20
118147916074,118147916077,3,2957,1508,-20
118148011749,118148011742,-7,1370,1177,-20
118148784760,118148784764,4,1517,1139,-20
118150375323,118150375320,-3,1886,2165,-20
118155856382,118155856385,3,1310,1755,-20
118156759841,118156759843,2,1729,1301,-20
118159403820,118159403825,5,1951,931,-20
118161077426,118161077430,4,2026,1454,-20
118162020334,118162020338,4,1634,1234,-20
118162921344,118162921336,-8,1168,1376,-20
118163786658,118163786662,4,1686,1413,-20
118166084953,118166084955,2,2025,1624,-20
118166671071,118166671074,3,2191,1300,-20
118169298392,118169298395,3,1497,1483,-20
118172598027,118172598031,4,1308,996,-20
118173265105,118173265109,4,2617,2145,-20
118184911799,118184911801,2,1260,1243,-20
118189123218,118189123222,4,1612,1014,-20
118189689579,118189689584,5,1171,1188,-20
118189865251,118189865253,2,1540,1752,-20
118191795577,118191795580,3,1954,1320,-20
118196612376,118196612378,2,1390,1364,-20
118198195266,118198195269,3,1426,1470,-20
118201152730,118201152733,3,1819,1300,-20
118204111477,118204111480,3,1777,1297,-20
118211918362,118211918366,4,1676,1377,-20
118214198194,118214198196,2,2501,1605,-20
118216813587,118216813589,2,1208,1333,-20
118224772181,118224772188,7,2224,1718,-20
118232607511,118232607515,4,1338,1470,-20
118234016810,118234016815,5,1182,1090,-20
118236155155,118236155158,3,2124,1299,-20
118241175190,118241175199,9,3220,981,-20
118241425279,118241425283,4,2245,1749,-20
118242686110,118242686115,5,1505,1314,-20
118246473011,118246473015,4,1550,1394,-20
118251915298,118251915303,5,1883,1676,-20
118252461653,118252461655,2,1840,1365,-20
118252769119,118252769122,3,1280,1089,-20
118257361714,118257361717,3,1888,1462,-20
118259938946,118259938951,5,2108,1723,-20
118260916187,118260916191,4,2360,1480,-20
118261702474,118261702478,4,1713,1359,-20
118262483510,118262483505,-5,776,2012,-20
118266236254,118266236258,4,1279,1271,-20
118269904616,118269904618,2,2013,1608,-20
118271366618,118271366622,4,1765,1173,-20
118276039473,118276039479,6,2466,1677,-20
118276148336,118276148340,4,2485,1789,-20
118276343982,118276343988,6,1753,1797,-20
118277513846,118277513848,2,2115,1511,-20
118278389694,118278389695,1,1350,1459,-20
118278619410,118278619394,-16,569,248,-20
118282368102,118282368107,5,1863,1161,-20
118287984846,118287984849,3,3090,1603,-20
118288601427,118288601430,3,1909,1407,-20
118288729316,118288729322,6,1719,1069,-20
118289127575,118289127577,2,1496,2054,-20
118290053847,118290053851,4,1763,1237,-20
118291742888,118291742892,4,2133,1566,-20
118295310389,118295310391,2,1891,1320,-20
118297850460,118297850462,2,1900,1341,-20
118301127276,118301127279,3,1785,1914,-20
118314228330,118314228329,-1,875,1112,-20
118324499823,118324499820,-3,811,1399,-20
118324805515,118324805519,4,1799,1616,-20
118325672792,118325672795,3,1404,1253,-20
118326166714,118326166719,5,1613,973,-20
118327499575,118327499578,3,1506,956,-20
118328128023,118328128026,3,1695,1157,-20
118329186957,118329186956,-1,1260,1441,-20
118330330050,118330330056,6,3160,1243,-20
118330618164,118330618173,9,1779,1970,-20
118334222531,118334222536,5,1861,1319,-20
118335262446,118335262450,4,1058,1289,-20
118336463254,118336463249,-5,1136,6262,-20
118337762153,118337762159,6,1334,785,-20
118338305817,118338305819,2,1413,1332,-20
118339915788,118339915793,5,1761,1542,-20
118343266657,118343266659,2,1710,1515,-20
118343302310,118343302315,5,1467,1138,-20
118344669329,118344669331,2,2372,1355,-20
118349640508,118349640519,11,15503,21221,-20
118350564566,118350564570,4,2068,1754,-20
118351300721,118351300722,1,2186,1702,-20
118351755408,118351755409,1,1625,1339,-20
118352767583,118352767587,4,1752,1671,-20
118355688390,118355688394,4,2757,1554,-20
118356457298,118356457302,4,2369,1309,-20
118363811326,118363811330,4,1499,1252,-20
118364888257,118364888263,6,2406,1429,-20
118366649217,118366649221,4,2026,1745,-20
118369239703,118369239707,4,1517,1350,-20
118372425780,118372425783,3,1593,1464,-20
118375317259,118375317263,4,1309,1311,-20
118379150872,118379150877,5,3040,1673,-20
118389627633,118389627634,1,1597,1571,-20
118390953166,118390953168,2,2223,2072,-20
118395289352,118395289355,3,1938,1500,-20
118395690008,118395690009,1,1655,2178,-20
118396308051,118396308055,4,1797,1201,-20
118402161066,118402161067,1,1023,1330,-20
118407051621,118407051624,3,1227,1240,-20
118408340208,118408340213,5,19597,25534,-20
118408759113,118408759118,5,2088,1494,-20
118410548291,118410548293,2,1775,1858,-20
118413094888,118413094890,2,1123,1284,-20
118413880428,118413880431,3,1924,1079,-20
118417761071,118417761075,4,1736,882,-20
118419372290,118419372295,5,1603,1464,-20
118419845017,118419845020,3,2382,1453,-20
118422694221,118422694225,4,1653,1090,-20
118426985697,118426985702,5,3123,1445,-20
118428756629,118428756631,2,1219,1074,-20
118429412138,118429412143,5,1775,1177,-20
118434972462,118434972466,4,1816,1150,-20
118436172590,118436172595,5,1673,1228,-20
118439446997,118439446998,1,2461,1600,-20
118440126606,118440126609,3,1888,1674,-20
118447618618,118447618621,3,2204,2101,-20
118451121811,118451121815,4,1642,1374,-20
118456181080,118456181083,3,2469,1019,-20
118459569209,118459569214,5,1724,1314,-20
118462672468,118462672470,2,2173,998,-20
118464429713,118464429710,-3,9056,41719,-20
118465059222,118465059226,4,1706,1459,-20
118468879493,118468879495,2,1833,1037,-20
118469290908,118469290914,6,2555,1446,-20
118469436728,118469436731,3,1454,1274,-20
118470102498,118470102503,5,1577,1073,-20
118470226687,118470226691,4,714,580,-20
118470562221,118470562232,11,1756,1615,-20
118471056760,118471056764,4,2907,2125,-20
118471637393,118471637396,3,2493,1908,-20
118479004728,118479004732,4,1331,1239,-20
118479297167,118479297170,3,1713,1723,-20
118482571810,118482571811,1,2295,1339,-20
118482632265,118482632269,4,2355,1323,-20
118482926709,118482926713,4,2004,1222,-20
118484482825,118484482829,4,2316,1238,-20
118488863718,118488863722,4,3003,1798,-20
118493312053,118493312057,4,2016,1484,-20
118497045340,118497045343,3,1930,1523,-20
118497870437,118497870441,4,1696,1200,-20
118501383358,118501383359,1,1654,1128,-20
118503570885,118503570887,2,1713,892,-20
118505453457,118505453462,5,1763,1071,-20
118507161794,118507161795,1,1345,1158,-20
118509124005,118509124007,2,1882,1210,-20
118515796178,118515796183,5,1260,1508,-20
118517698312,118517698317,5,1939,1499,-20
118525716019,118525716022,3,1295,1584,-20
118528811911,118528811914,3,994,1123,-20
118532050346,118532050347,1,1264,2230,-20
118533921534,118533921537,3,1825,1337,-20
118537085014,118537085017,3,1883,1532,-20
118539028617,118539028623,6,2200,2129,-20
118540227846,118540227846,0,1820,2164,-20
118544675052,118544675055,3,2274,1346,-20
118552059679,118552059683,4,3121,2152,-20
118552693957,118552693960,3,1569,1294,-20
118559356138,118559356143,5,1429,1160,-20
118561757039,118561757044,5,2444,1599,-20
118564040946,118564040950,4,1940,1427,-20
118564624467,118564624475,8,1358,616,-20
118565934471,118565934475,4,1685,1037,-20
118567592615,118567592617,2,2050,1832,-20
118570099210,118570099211,1,1436,2026,-20
118572741347,118572741352,5,2118,2125,-20
118573198098,118573198102,4,1189,1724,-20
118574136127,118574136130,3,1775,1262,-20
118575781401,118575781401,0,906,734,-20
118578041558,118578041563,5,1359,2032,-20
118579902087,118579902090,3,1178,795,-20
118580082718,118580082736,18,2247,1532,-20
118584214586,118584214589,3,2104,1419,-20
118586544096,118586544099,3,1655,1415,-20
118588504903,118588504902,-1,1411,2935,-20
118592733127,118592733130,3,1527,1054,-20
118593411300,118593411303,3,1720,1051,-20
118597004374,118597004379,5,1575,1679,-20
118597057195,118597057199,4,1807,1506,-20
118599735003,118599735007,4,1432,1248,-20
118601361384,118601361387,3,1553,1336,-20
118606938652,118606938657,5,1780,1640,-20
118610950147,118610950150,3,2004,1752,-20
118611672838,118611672835,-3,909,1812,-20
118612031290,118612031292,2,1569,1584,-20
118612459204,118612459209,5,1917,1530,-20
118614713242,118614713243,1,1844,1057,-20
118615947636,118615947638,2,1574,1950,-20
118617567279,118617567283,4,1861,1587,-20
118617657501,118617657506,5,2012,1278,-20
118618796806,118618796809,3,2320,2199,-20
118619309894,118619309898,4,1937,1551,-20
118620609934,118620609934,0,2350,2810,-20
118620976229,118620976229,0,1219,1500,-20
118622018479,118622018482,3,1729,1249,-20
118624498290,118624498292,2,1957,1593,-20
118625084717,118625084721,4,1422,1186,-20
118626293620,118626293622,2,1444,1779,-20
118626876090,118626876093,3,2464,1457,-20
118628065642,118628065643,1,1489,1081,-20
118628687612,118628687614,2,2171,1897,-20
118630840117,118630840121,4,1097,1224,-20
118632896302,118632896305,3,1780,1444,-20
118634951921,118634951924,3,2550,1489,-20
118635046090,118635046074,-16,1949,1237,-20
118635511819,118635511823,4,1711,1141,-20
118638860156,118638860157,1,1753,1605,-20
118643746857,118643746860,3,1363,1094,-20
118646125120,118646125122,2,1615,964,-20
118647368929,118647368932,3,1113,1184,-20
118649861838,118649861841,3,1855,1824,-20
118652112818,118652112819,1,2829,2144,-20
118653587333,118653587337,4,1518,1207,-20
118659233656,118659233660,4,2076,1014,-20
118660236075,118660236080,5,2348,1366,-20
118661737074,118661737079,5,1432,1193,-20
118669517740,118669517743,3,1257,898,-20
118675328457,118675328460,3,2281,1872,-20
118675900683,118675900686,3,2076,1246,-20
118676887941,118676887943,2,1429,1173,-20
118677329062,118677329065,3,1614,1298,-20
118681263634,118681263638,4,2246,1082,-20
118686465375,118686465378,3,2248,1410,-20
118692424348,118692424353,5,1757,1285,-20
118695245441,118695245444,3,1769,1647,-20
118696234362,118696234367,5,1698,1236,-20
118701060525,118701060529,4,2005,1148,-20
118706170237,118706170229,-8,1198,5124,-20
118706405810,118706405803,-7,2712,9268,-20
118706652186,118706652191,5,1932,1715,-20
118707282477,118707282483,6,1465,1141,-20
118707480556,118707480561,5,8745,33687,-20
118710727430,118710727431,1,1715,2696,-20
118712205889,118712205891,2,1106,1163,-20
118714099950,118714099954,4,1723,1055,-20
118714894166,118714894171,5,1848,1361,-20
118715201115,118715201119,4,1861,1329,-20
118715429898,118715429901,3,2244,2052,-20
118717617534,118717617539,5,1728,939,-20
118719285074,118719285077,3,1580,1330,-20
118720670173,118720670176,3,2008,2343,-20
118721577713,118721577716,3,1995,1441,-20
118725303565,118725303568,3,1867,1672,-20
118725826605,118725826615,10,12312,29869,-20
118735168709,118735168711,2,1444,1184,-20
118736468594,118736468596,2,1573,1384,-20
118738144386,118738144392,6,10214,7923,-20
118739941030,118739941033,3,692,1034,-20
118742807352,118742807354,2,1887,1498,-20
118746994339,118746994342,3,2120,1606,-20
118748389286,118748389290,4,2043,1299,-20
118749720510,118749720515,5,1416,1000,-20
118750828268,118750828272,4,2285,1358,-20
118751675346,118751675351,5,2394,1085,-20
118753961848,118753961850,2,1340,1109,-20
118755648583,118755648585,2,1236,1499,-20
118762787808,118762787808,0,1317,1428,-20
118765987870,118765987874,4,1088,1230,-20
118769299850,118769299857,7,5745,2369,-20
118769579034,118769579038,4,1768,1235,-20
118772013050,118772013032,-18,714,203,-20
118774859866,118774859871,5,1736,1467,-20
118777949533,118777949541,8,12843,5251,-20
118778095341,118778095345,4,1503,1258,-20
118779751730,118779751732,2,1182,1706,-20
118785506117,118785506121,4,1823,1536,-20
118788635576,118788635579,3,1836,1392,-20
118789828235,118789828238,3,2904,1600,-20
118792566150,118792566152,2,1669,1547,-20
118795125858,118795125859,1,1270,1238,-20
118795729974,118795729978,4,2529,1565,-20
118798863236,118798863238,2,2543,1701,-20
118800422089,118800422091,2,1251,1024,-20
118801713707,118801713710,3,2460,1384,-20
118807290535,118807290539,4,1911,1130,-20
118807947841,118807947844,3,2314,1331,-20
118808208990,118808208993,3,1408,1507,-20
118811884305,118811884307,2,1651,1016,-20
118813047743,118813047746,3,1548,1237,-20
118818619667,118818619668,1,1883,1507,-20
118824089747,118824089748,1,1387,1408,-20
118824396477,118824396479,2,1688,1279,-20
118825698687,118825698689,2,1119,1068,-20
118827333009,118827333014,5,2286,1487,-20
118828341864,118828341866,2,2309,1763,-20
118829470493,118829470497,4,1793,1631,-20
118832194866,118832194870,4,1635,1214,-20
118832766203,118832766205,2,1487,1572,-20
118834498418,118834498401,-17,2701,1294,-20
118839863969,118839863974,5,1786,1582,-20
118840857666,118840857671,5,1776,1256,-20
118842570670,118842570675,5,1054,1249,-20
118846030875,118846030877,2,1334,1283,-20
118847864458,118847864464,6,1994,1538,-20
118847999006,118847998984,-22,1492,951,-20
118849730633,118849730637,4,1518,1565,-20
118850506300,118850506302,2,1537,1440,-20
118854539421,118854539422,1,5271,5462,-20
118855705009,118855705013,4,1671,1235,-20
118856103778,118856103782,4,1077,1067,-20
118861703595,118861703597,2,1046,1268,-20
118862897521,118862897522,1,1976,1445,-20
118864480808,118864480812,4,2368,2316,-20
118867964331,118867964334,3,1994,1640,-20
118869702591,118869702595,4,1603,1337,-20
118870917347,118870917350,3,1442,1280,-20
118873069741,118873069744,3,2021,1521,-20
118873855367,118873855370,3,2078,1550,-20
118874908774,118874908776,2,1289,1213,-20
118875575838,118875575839,1,1832,1383,-20
118876583871,118876583875,4,2144,1498,-20
118878778942,118878778947,5,2567,1750,-20
118881292313,118881292312,-1,987,1256,-20
118882842843,118882842849,6,1782,1548,-20
118885250902,118885250906,4,1103,583,-20
118885761934,118885761936,2,1797,1565,-20
118886015317,118886015322,5,2401,1986,-20
118886755777,118886755782,5,1323,1292,-20
118888329326,118888329328,2,1130,728,-20
118888924813,118888924815,2,1972,1610,-20
118890599783,118890599787,4,2423,1564,-20
118891331295,118891331298,3,2344,1778,-20
118898241055,118898241055,0,1002,881,-20
118898780869,118898780867,-2,926,1186,-20
118899085998,118899086000,2,1121,1212,-20
118901131151,118901131149,-2,838,1095,-20
118901839240,118901839243,3,1545,1670,-20
118902123111,118902123117,6,1945,1436,-20
118902179004,118902179008,4,1411,1025,-20
118906768404,118906768407,3,1459,1156,-20
118907096019,118907096022,3,2162,1158,-20
118908110433,118908110438,5,1425,1246,-20
118908242633,118908242634,1,1605,1095,-20
118908647238,118908647248,10,1400,1196,-20
118910711307,118910711310,3,2402,1481,-20
118911198245,118911198247,2,1965,2123,-20
118911312989,118911312993,4,1766,1363,-20
118913751837,118913751840,3,1229,1159,-20
118917604129,118917604130,1,1202,1469,-20
