fTNear,fTFar,fDelT,fQNear,fQFar,d
119358486031,119358486028,-3,37,28,20
4733118,4733139,21,945,1152,20
7701552,7701549,-3,1069,3275,20
8142120,8142138,18,325,879,20
12768859,12768856,-3,1057,2441,20
13760425,13760426,1,1942,1326,20
20698496,20698499,3,2036,1389,20
26548815,26548810,-5,1113,2928,20
27122281,27122277,-4,1420,3155,20
29150836,29150829,-7,1034,3514,20
32122689,32122690,1,3870,4190,20
34155678,34155675,-3,1555,1528,20
35692507,35692505,-2,967,1943,20
36519525,36519522,-3,1272,2388,20
39410526,39410527,1,1591,1323,20
39681146,39681125,-21,1504,2104,20
41760874,41760870,-4,1037,2270,20
44983215,44983212,-3,1266,1999,20
51402837,51402836,-1,1973,3622,20
52028204,52028205,1,26283,29936,20
55019317,55019312,-5,1200,3160,20
55897908,55897906,-2,1407,2190,20
57979702,57979707,5,6859,15696,20
62899261,62899257,-4,1252,2642,20
63975235,63975231,-4,1202,2673,20
66928198,66928196,-2,1017,2540,20
71606943,71606946,3,1413,1772,20
71916599,71916597,-2,650,1205,20
72869109,72869106,-3,1610,1773,20
79645682,79645684,2,1351,1721,20
86804234,86804235,1,960,1359,20
87938596,87938594,-2,1293,2316,20
89377795,89377794,-1,736,1672,20
89608414,89608414,0,976,1639,20
90337429,90337426,-3,1236,2399,20
92575000,92574998,-2,1279,1812,20
93106851,93106850,-1,1386,2394,20
93245007,93245006,-1,976,3614,20
96114562,96114562,0,813,2306,20
97006069,97006065,-4,605,1855,20
98956476,98956474,-2,1268,1567,20
99395102,99395098,-4,1636,2282,20
99765097,99765094,-3,702,1361,20
100778522,100778519,-3,1105,2772,20
101808666,101808666,0,1619,2623,20
102046674,102046670,-4,1281,3016,20
106167570,106167569,-1,1259,2449,20
106547785,106547794,9,3531,1878,20
108463218,108463215,-3,744,2851,20
108586120,108586103,-17,1023,1546,20
120683971,120683967,-4,934,1976,20
121530434,121530431,-3,1130,1489,20
123762971,123762970,-1,938,1522,20
125977929,125977934,5,3018,1684,20
126880726,126880725,-1,1504,2406,20
132891876,132891871,-5,1022,1964,20
133880090,133880089,-1,1059,2073,20
135258066,135258071,5,2141,986,20
137580951,137580950,-1,984,2213,20
138091977,138091972,-5,1179,1715,20
144088331,144088328,-3,1458,2616,20
147040513,147040511,-2,1328,2347,20
147078837,147078819,-18,292,492,20
151647658,151647656,-2,1320,3309,20
152841974,152841970,-4,992,2961,20
153008032,153008047,15,12338,26744,20
153633405,153633404,-1,617,1927,20
154582591,154582586,-5,994,1829,20
156735667,156735661,-6,1329,3724,20
161297587,161297584,-3,1247,2333,20
162289807,162289794,-13,30015,16382,20
169963981,169963979,-2,777,1780,20
170882778,170882775,-3,929,1903,20
172064175,172064170,-5,1024,1772,20
174621453,174621450,-3,782,1606,20
177335326,177335322,-4,1090,2536,20
177764726,177764724,-2,1156,2460,20
187011706,187011702,-4,778,1001,20
188039995,188039995,0,1052,1398,20
189925582,189925579,-3,1388,2086,20
193487358,193487356,-2,1068,2052,20
202570846,202570851,5,4898,2701,20
202627326,202627322,-4,789,2079,20
204830459,204830458,-1,871,3043,20
208410213,208410209,-4,669,1615,20
208578781,208578781,0,999,2438,20
217427249,217427255,6,2094,1108,20
218243436,218243430,-6,1667,6863,20
218906780,218906776,-4,1020,2100,20
221177896,221177893,-3,1040,2437,20
223723000,223722994,-6,981,3408,20
224864835,224864833,-2,994,2059,20
225171350,225171346,-4,1072,3592,20
226683028,226683026,-2,801,2211,20
226754286,226754301,15,841,2280,20
227322863,227322865,2,2278,3008,20
227900305,227900302,-3,1295,1860,20
227959458,227959462,4,1816,1996,20
232132440,232132435,-5,864,2647,20
232479572,232479577,5,5487,24822,20
241127426,241127424,-2,1503,3108,20
242481314,242481313,-1,1202,1915,20
243625278,243625273,-5,985,2530,20
244727423,244727420,-3,974,2211,20
245812674,245812670,-4,1409,2375,20
247217765,247217761,-4,1035,2622,20
254942211,254942209,-2,1392,3263,20
257500348,257500345,-3,1107,2299,20
259122885,259122885,0,1324,1518,20
261483105,261483102,-3,892,1721,20
265201755,265201753,-2,1287,3164,20
269182039,269182044,5,5810,3128,20
271979809,271979823,14,1604,1902,20
277404449,277404455,6,3007,1554,20
278592393,278592392,-1,757,2044,20
281248714,281248713,-1,1316,2407,20
283091159,283091154,-5,1236,2329,20
285370126,285370123,-3,1223,2137,20
287822666,287822662,-4,1269,2675,20
289983690,289983686,-4,1220,2039,20
293631391,293631389,-2,15509,31482,20
294869804,294869801,-3,1346,1977,20
296076709,296076706,-3,1396,3481,20
306851830,306851827,-3,1030,1495,20
308409750,308409746,-4,1055,2874,20
309346340,309346334,-6,1215,3253,20
314137355,314137349,-6,1544,4369,20
316533853,316533849,-4,989,3035,20
317194475,317194468,-7,1025,3424,20
319960274,319960271,-3,1135,2790,20
327684455,327684452,-3,1198,3977,20
330055943,330055942,-1,1092,1789,20
339235774,339235770,-4,1166,2999,20
339901591,339901571,-20,843,1499,20
343305646,343305642,-4,1328,4160,20
344242436,344242429,-7,1289,1785,20
344847427,344847425,-2,1236,2648,20
349536276,349536273,-3,1008,2463,20
349856174,349856194,20,641,1348,20
350243558,350243554,-4,983,2448,20
350806630,350806626,-4,1025,3303,20
351028421,351028423,2,812,1071,20
355676266,355676262,-4,1141,2403,20
357498118,357498115,-3,950,1702,20
361438386,361438382,-4,1364,2077,20
362640854,362640850,-4,663,1935,20
363328478,363328494,16,1050,2394,20
364214305,364214305,0,1430,1621,20
365023455,365023451,-4,813,2863,20
365159557,365159558,1,1270,1302,20
365785485,365785481,-4,1147,2760,20
368024248,368024247,-1,1034,1352,20
369919345,369919343,-2,582,1779,20
375244419,375244418,-1,974,1714,20
382275795,382275788,-7,1370,2008,20
389860099,389860097,-2,924,2991,20
389987428,389987425,-3,981,2217,20
397072599,397072595,-4,944,2766,20
399798758,399798755,-3,1378,2437,20
401274576,401274574,-2,849,1950,20
402848662,402848658,-4,1008,2484,20
405095046,405095042,-4,954,2093,20
406977517,406977516,-1,1496,2215,20
411477302,411477310,8,4519,1524,20
414905235,414905233,-2,897,1804,20
416363925,416363922,-3,1320,3110,20
416876316,416876313,-3,1433,3037,20
416901964,416901960,-4,1027,2045,20
418921535,418921533,-2,1243,2593,20
422760719,422760717,-2,1340,2405,20
426243106,426243104,-2,1258,3056,20
428789505,428789500,-5,960,2145,20
431267717,431267716,-1,910,2338,20
436958310,436958308,-2,924,2299,20
437345458,437345459,1,15315,2052,20
438823483,438823481,-2,905,1633,20
439712186,439712182,-4,1295,2209,20
439774387,439774386,-1,919,2464,20
444984885,444984882,-3,886,1511,20
445130452,445130460,8,4933,1738,20
445839910,445839906,-4,752,2156,20
447912921,447912915,-6,1301,3466,20
448346570,448346570,0,812,1954,20
451711461,451711458,-3,1373,2552,20
456445687,456445685,-2,1001,1498,20
457371294,457371286,-8,1420,2497,20
460844530,460844529,-1,940,1993,20
461435821,461435817,-4,1586,3573,20
462139963,462139957,-6,1335,4113,20
464247628,464247626,-2,1053,2015,20
470607534,470607531,-3,929,2190,20
472198170,472198177,7,5112,2546,20
472795069,472795069,0,692,1950,20
473102566,473102568,2,1412,1180,20
475775455,475775432,-23,1215,2251,20
479670954,479670953,-1,985,1421,20
482485282,482485286,4,1247,1327,20
487466366,487466363,-3,1160,2357,20
501554565,501554561,-4,1010,1341,20
503632666,503632662,-4,1374,2505,20
505815642,505815640,-2,1242,2910,20
506076122,506076118,-4,1480,3588,20
507297591,507297586,-5,1283,2460,20
510567105,510567100,-5,950,2787,20
515353334,515353329,-5,810,2107,20
516769309,516769331,22,978,1935,20
524772126,524772122,-4,1371,2533,20
525952550,525952549,-1,1183,1529,20
529439179,529439177,-2,763,2127,20
537132427,537132428,1,1275,1874,20
539622695,539622690,-5,747,1398,20
541502798,541502817,19,495,1300,20
548142522,548142518,-4,1316,2138,20
550608738,550608737,-1,992,1758,20
550737013,550737009,-4,1085,3258,20
558435522,558435518,-4,741,1451,20
563312938,563312935,-3,1186,2472,20
564544992,564544995,3,2151,1648,20
566187824,566187821,-3,1113,2290,20
567371390,567371389,-1,827,1765,20
568960182,568960180,-2,1398,2228,20
569260190,569260194,4,1246,1666,20
569695541,569695538,-3,1185,3073,20
570797477,570797475,-2,1081,1635,20
572407470,572407482,12,237,923,20
574284555,574284553,-2,1003,2448,20
574585295,574585292,-3,1046,2995,20
574646805,574646789,-16,25,1504,20
576746451,576746449,-2,1225,1991,20
577668398,577668394,-4,1307,2848,20
578322604,578322603,-1,1146,2203,20
578647114,578647111,-3,917,1688,20
591127201,591127206,5,4157,2612,20
592110654,592110653,-1,1123,2028,20
593413382,593413381,-1,730,1025,20
595807783,595807778,-5,1348,2018,20
596556282,596556281,-1,1611,1932,20
599460950,599460947,-3,1198,2639,20
601437399,601437398,-1,714,3106,20
602314611,602314606,-5,932,2533,20
608457691,608457688,-3,1524,2693,20
609480926,609480923,-3,1254,2626,20
612196109,612196104,-5,1003,2480,20
612255896,612255877,-19,1158,3508,20
614816945,614816946,1,3971,3215,20
615294075,615294070,-5,605,1808,20
616392502,616392499,-3,1369,1845,20
618829133,618829129,-4,1152,2227,20
626571676,626571674,-2,738,2016,20
628661228,628661225,-3,1069,1987,20
630198605,630198608,3,1766,1478,20
630304052,630304050,-2,1461,1202,20
635010014,635010011,-3,979,2106,20
638600370,638600368,-2,965,2288,20
640782498,640782494,-4,1427,3024,20
641136295,641136312,17,747,332,20
642293983,642293980,-3,1270,1862,20
642825556,642825562,6,221,818,20
645843026,645843023,-3,991,2744,20
646560066,646560059,-7,830,3019,20
646636696,646636706,10,158,1205,20
648569972,648569969,-3,1298,2236,20
650101290,650101286,-4,863,2779,20
657537971,657537971,0,1086,2698,20
661130794,661130793,-1,1569,2589,20
661478547,661478543,-4,1139,2042,20
662398722,662398720,-2,1139,3357,20
665967452,665967446,-6,849,2584,20
674759654,674759652,-2,1359,2768,20
676055023,676055021,-2,999,2199,20
676777674,676777672,-2,768,1548,20
679812101,679812097,-4,617,1643,20
680591886,680591884,-2,1208,2946,20
680703126,680703114,-12,527,1060,20
683278709,683278716,7,13032,27283,20
684635057,684635057,0,1381,1896,20
688468617,688468618,1,1917,2192,20
690321817,690321813,-4,875,2293,20
691477322,691477317,-5,770,3091,20
692888059,692888056,-3,1262,2209,20
697138882,697138877,-5,956,2330,20
702725174,702725173,-1,1263,2091,20
703245994,703245990,-4,888,3354,20
705119014,705118995,-19,1334,3080,20
705836195,705836189,-6,592,1924,20
707275405,707275404,-1,1286,1666,20
707462966,707462967,1,1003,1586,20
709654711,709654709,-2,1112,1613,20
723207759,723207758,-1,1252,2447,20
723549796,723549793,-3,1121,2847,20
726197557,726197555,-2,1898,3117,20
730909202,730909199,-3,1404,2345,20
733579125,733579122,-3,891,2251,20
734833750,734833748,-2,943,3587,20
736527693,736527697,4,1535,1467,20
736763258,736763255,-3,1218,1786,20
742105195,742105193,-2,1523,2822,20
742920799,742920795,-4,1043,2468,20
743234615,743234613,-2,1370,2488,20
747976942,747976950,8,3608,752,20
749362198,749362196,-2,1664,1996,20
749688825,749688829,4,1722,1105,20
759359846,759359841,-5,1121,2142,20
760313257,760313253,-4,1185,2276,20
760446806,760446812,6,2525,1238,20
760818637,760818647,10,8586,26469,20
763515367,763515367,0,930,1877,20
765226675,765226669,-6,990,2057,20
767937503,767937501,-2,1037,2626,20
769245680,769245676,-4,1138,2186,20
775483394,775483392,-2,701,1676,20
775761731,775761729,-2,761,1729,20
777330244,777330228,-16,687,2458,20
777371610,777371609,-1,925,1497,20
778914551,778914547,-4,1606,2533,20
786903751,786903749,-2,1678,3488,20
788909839,788909837,-2,1520,2686,20
795044038,795044043,5,1808,893,20
799475310,799475311,1,1308,1612,20
803580875,803580875,0,1118,1267,20
803719153,803719150,-3,931,2527,20
807744174,807744170,-4,1439,2392,20
809121977,809121975,-2,828,1436,20
809451622,809451620,-2,1349,1542,20
810380938,810380938,0,1498,2464,20
811732876,811732871,-5,959,2419,20
814766634,814766630,-4,1098,2366,20
817385751,817385750,-1,4909,7593,20
820340327,820340326,-1,1166,1527,20
822698358,822698354,-4,829,1849,20
825941595,825941594,-1,928,2429,20
827293226,827293226,0,1586,1674,20
831227213,831227209,-4,1160,1721,20
832036032,832036029,-3,1584,2920,20
832390585,832390592,7,999,1439,20
832515701,832515718,17,645,1432,20
843866843,843866845,2,1751,2070,20
846950023,846950018,-5,1383,3763,20
851457615,851457613,-2,1084,1952,20
853605646,853605642,-4,923,2815,20
867204409,867204406,-3,1364,2651,20
869193718,869193717,-1,1561,2319,20
871039319,871039317,-2,1098,1920,20
873683051,873683051,0,2186,2075,20
874989025,874989045,20,1440,2030,20
875616697,875616693,-4,1358,2563,20
876689130,876689129,-1,1109,1714,20
878991443,878991439,-4,804,1578,20
879696755,879696750,-5,1682,4231,20
879970528,879970526,-2,1460,2273,20
885554289,885554286,-3,1340,2636,20
889792662,889792659,-3,1576,2287,20
889832305,889832312,7,9826,33708,20
894937109,894937106,-3,1079,2468,20
895231518,895231539,21,325,638,20
896878546,896878554,8,4275,1262,20
897158779,897158774,-5,1459,2250,20
897950782,897950778,-4,827,2611,20
898006071,898006069,-2,1120,2038,20
900631655,900631653,-2,1613,2646,20
900738910,900738905,-5,947,2606,20
902005878,902005883,5,2166,833,20
904139277,904139272,-5,1243,2694,20
907786817,907786813,-4,1023,2013,20
913102634,913102630,-4,789,2174,20
925666343,925666341,-2,1111,2483,20
928294044,928294041,-3,1478,2129,20
931269387,931269383,-4,1027,3359,20
933769963,933769960,-3,934,2271,20
942748565,942748564,-1,1257,2162,20
942971645,942971629,-16,1335,2386,20
944428541,944428537,-4,1339,2941,20
944611015,944610996,-19,1233,1486,20
947375682,947375681,-1,682,2344,20
949630872,949630870,-2,865,1604,20
951016719,951016716,-3,1073,2382,20
951085882,951085877,-5,817,1855,20
953767074,953767071,-3,1152,2091,20
959728036,959728055,19,1015,2152,20
960856542,960856538,-4,1333,2248,20
964437421,964437417,-4,1167,1468,20
966402374,966402374,0,899,1622,20
976710706,976710702,-4,998,2275,20
982276706,982276702,-4,927,1418,20
983583624,983583621,-3,1113,1678,20
987092785,987092779,-6,284,1319,20
989308863,989308861,-2,1211,2443,20
990949010,990949007,-3,1363,2419,20
992343997,992343993,-4,939,2597,20
992398694,992398691,-3,188,1057,20
993069290,993069286,-4,928,1951,20
993328163,993328161,-2,973,1984,20
994385623,994385638,15,1103,2122,20
1000304411,1000304410,-1,1032,2225,20
1000504699,1000504694,-5,1562,2491,20
1003395914,1003395910,-4,1223,3297,20
1003534937,1003534933,-4,1353,2872,20
1004953674,1004953670,-4,1183,3035,20
1006003782,1006003790,8,2463,904,20
1007850781,1007850779,-2,1537,2720,20
1008518626,1008518625,-1,1139,2664,20
1012248068,1012248065,-3,1147,2259,20
1017550607,1017550605,-2,923,1941,20
1020023051,1020023049,-2,873,1974,20
1020548766,1020548765,-1,848,1427,20
1027157526,1027157522,-4,719,2147,20
1029466030,1029466029,-1,1151,2454,20
1032755458,1032755454,-4,807,1516,20
1033023604,1033023598,-6,913,2662,20
1034340467,1034340465,-2,1180,2424,20
1034497013,1034497011,-2,1155,2263,20
1035877534,1035877531,-3,1137,1337,20
1039779178,1039779178,0,1452,2075,20
1042917711,1042917710,-1,1122,1505,20
1046800993,1046800991,-2,1184,3414,20
1046876567,1046876557,-10,212,660,20
1047718930,1047718926,-4,1437,3145,20
1048406178,1048406175,-3,1286,2613,20
1061001006,1061001000,-6,793,2806,20
1065427227,1065427232,5,4750,2759,20
1066532846,1066532850,4,110,767,20
1068294727,1068294731,4,3754,2969,20
1068971729,1068971725,-4,1205,1621,20
1069149256,1069149272,16,89,463,20
1070823761,1070823759,-2,1613,2777,20
1070917119,1070917117,-2,1524,3013,20
1072089039,1072089035,-4,1221,2223,20
1075036247,1075036241,-6,1020,3215,20
1082877691,1082877686,-5,1503,3363,20
1083808985,1083808981,-4,1540,2073,20
1084839919,1084839914,-5,1149,2118,20
1086900996,1086900999,3,4005,2982,20
1088008097,1088008094,-3,969,1853,20
1088321319,1088321317,-2,971,1616,20
1088953339,1088953338,-1,1318,2310,20
1092303118,1092303114,-4,1236,2715,20
1092528191,1092528171,-20,823,1521,20
1093250990,1093250989,-1,1438,2238,20
1096468853,1096468850,-3,1245,2419,20
1098848238,1098848237,-1,978,1779,20
1099404438,1099404419,-19,662,2315,20
1099605064,1099605061,-3,1036,2894,20
1100885325,1100885325,0,1160,1789,20
1100968055,1100968045,-10,1009,2124,20
1105728038,1105728036,-2,1161,2201,20
1109110302,1109110301,-1,1111,1826,20
1109230333,1109230333,0,1656,2154,20
1112165054,1112165060,6,3203,1897,20
1114613670,1114613668,-2,1147,3252,20
1114664956,1114664977,21,1129,2273,20
1114702222,1114702220,-2,729,2440,20
1115163130,1115163127,-3,1283,2929,20
1116105255,1116105254,-1,987,2168,20
1122397205,1122397201,-4,1099,2219,20
1123610816,1123610813,-3,1382,2790,20
1125309766,1125309762,-4,865,2745,20
1128507223,1128507219,-4,997,2828,20
1129017776,1129017790,14,767,3862,20
1129267055,1129267050,-5,1258,2554,20
1130259719,1130259717,-2,978,2266,20
1134330646,1134330643,-3,1247,2676,20
1136452254,1136452255,1,981,1256,20
1138727347,1138727344,-3,1134,2204,20
1142164915,1142164912,-3,1026,2242,20
1143660909,1143660906,-3,1088,1954,20
1150429348,1150429345,-3,880,2129,20
1151995228,1151995213,-15,976,2408,20
1153244559,1153244555,-4,1744,3262,20
1153300846,1153300842,-4,1122,2020,20
1154936139,1154936134,-5,982,4517,20
1156607149,1156607155,6,21417,28880,20
1159754586,1159754590,4,1238,1259,20
1162145286,1162145289,3,880,1086,20
1167463541,1167463549,8,3882,1150,20
1175897229,1175897226,-3,1059,1994,20
1176345431,1176345432,1,2065,2997,20
1178060922,1178060921,-1,963,2329,20
1180661514,1180661510,-4,1054,2063,20
1180690337,1180690332,-5,1091,3449,20
1184569098,1184569099,1,1466,2324,20
1192723369,1192723365,-4,1189,2482,20
1197344621,1197344620,-1,1281,2500,20
1197719226,1197719228,2,1246,1871,20
1198781117,1198781118,1,2641,3409,20
1199288183,1199288180,-3,858,1706,20
1199434851,1199434849,-2,1264,2292,20
1200790178,1200790175,-3,1192,1722,20
1205993795,1205993791,-4,1018,2802,20
1206278455,1206278446,-9,849,2526,20
1207106845,1207106842,-3,1409,2054,20
1210899989,1210899986,-3,1120,1868,20
1212945167,1212945161,-6,2245,7380,20
1218355102,1218355101,-1,971,2071,20
1220802185,1220802183,-2,837,1574,20
1222087261,1222087257,-4,1332,3569,20
1223260897,1223260894,-3,1109,2924,20
1224639348,1224639346,-2,1144,2109,20
1224997358,1224997379,21,742,1496,20
1227428675,1227428673,-2,1466,2735,20
1229412913,1229412910,-3,1298,2530,20
1230405763,1230405764,1,1629,1912,20
1231850448,1231850445,-3,1051,2280,20
1233405879,1233405877,-2,1184,1778,20
1239151630,1239151626,-4,1469,2139,20
1240079756,1240079752,-4,1126,2463,20
1240660920,1240660910,-10,166,1682,20
1241367936,1241367954,18,653,1238,20
1243106718,1243106714,-4,1436,2127,20
1244252671,1244252667,-4,1409,3280,20
1252085491,1252085489,-2,546,1013,20
1252226340,1252226321,-19,1156,2147,20
1252758737,1252758738,1,1330,1909,20
1255978470,1255978468,-2,1189,2094,20
1256193746,1256193747,1,1512,1760,20
1257014286,1257014283,-3,1046,2456,20
1261182151,1261182146,-5,895,3035,20
1267153585,1267153586,1,4068,3781,20
1268270142,1268270142,0,1364,1865,20
1271947981,1271947978,-3,1126,3197,20
1272039802,1272039801,-1,825,2402,20
1272549199,1272549185,-14,1298,2875,20
1277310887,1277310885,-2,1545,2659,20
1280405330,1280405328,-2,1215,3218,20
1280716022,1280716022,0,864,2435,20
1285719195,1285719193,-2,1345,3125,20
1290035786,1290035785,-1,1319,2387,20
1291962169,1291962172,3,1825,2336,20
1299814798,1299814794,-4,925,2872,20
1301814879,1301814874,-5,1024,2099,20
1302231677,1302231682,5,2796,1440,20
1303530591,1303530587,-4,1388,2601,20
1304603110,1304603106,-4,1228,1932,20
1307103984,1307103999,15,1742,1159,20
1310099031,1310099027,-4,723,1793,20
1312011928,1312011926,-2,1110,2651,20
1319496554,1319496550,-4,1035,3152,20
1321344218,1321344214,-4,1087,3501,20
1329474682,1329474683,1,997,1541,20
1334118609,1334118606,-3,681,1238,20
1337716556,1337716554,-2,1165,2976,20
1338549035,1338549030,-5,1465,2658,20
1341319090,1341319086,-4,1173,2055,20
1347140358,1347140361,3,3799,3431,20
1350632617,1350632613,-4,1274,3033,20
1353038210,1353038206,-4,669,937,20
1362188657,1362188654,-3,1039,2197,20
1365280754,1365280758,4,1739,1151,20
1370982899,1370982901,2,3414,2686,20
1379007943,1379007939,-4,1180,2732,20
1379090384,1379090398,14,770,2808,20
1379917412,1379917433,21,942,2245,20
1382482835,1382482834,-1,1209,1976,20
1383010615,1383010613,-2,875,3022,20
1383147430,1383147428,-2,1295,1717,20
1385771886,1385771891,5,4429,2530,20
1388324682,1388324677,-5,774,2068,20
1389554093,1389554090,-3,924,2394,20
1392016883,1392016878,-5,918,3685,20
1392109736,1392109750,14,128,785,20
1400587505,1400587504,-1,1089,1758,20
1402267165,1402267164,-1,1084,2520,20
1407669677,1407669673,-4,2062,5747,20
1408245645,1408245642,-3,1215,2835,20
1410756643,1410756639,-4,1147,2277,20
1413210798,1413210791,-7,717,3868,20
1413263047,1413263044,-3,79,2018,20
1415476215,1415476218,3,1731,1234,20
1425634737,1425634733,-4,1142,2140,20
1427629950,1427629964,14,848,1357,20
1428422734,1428422754,20,333,1294,20
1428734946,1428734943,-3,912,2248,20
1429189315,1429189313,-2,1157,2168,20
1432269883,1432269881,-2,1548,2496,20
1436339666,1436339665,-1,1345,1953,20
1438712240,1438712237,-3,1438,3744,20
1454341326,1454341322,-4,1014,2931,20
1491106749,1491106745,-4,979,2241,20
1497870078,1497870076,-2,1217,1687,20
1503795363,1503795359,-4,1293,2067,20
1504044601,1504044598,-3,1411,2817,20
1507074345,1507074340,-5,1070,2154,20
1509476965,1509476961,-4,1421,2970,20
1509945518,1509945498,-20,182,1336,20
1511541274,1511541268,-6,1041,1791,20
1516811110,1516811114,4,2612,1267,20
1517707140,1517707137,-3,1023,2215,20
1519575560,1519575557,-3,1344,1924,20
1521544567,1521544564,-3,1113,1900,20
1521987932,1521987925,-7,2832,8028,20
1523173877,1523173875,-2,1023,1834,20
1523525788,1523525782,-6,826,1979,20
1524961245,1524961242,-3,1082,2762,20
1526873963,1526873959,-4,1136,2158,20
1528714079,1528714076,-3,1144,1633,20
1529812482,1529812480,-2,866,2187,20
1530606867,1530606863,-4,889,2408,20
1531524807,1531524803,-4,1025,2839,20
1531654863,1531654850,-13,1172,1558,20
1534888474,1534888474,0,1596,2015,20
1535931853,1535931851,-2,1311,1337,20
1536548907,1536548907,0,1577,1999,20
1539515127,1539515123,-4,910,1670,20
1540456130,1540456127,-3,676,1714,20
1541488983,1541488977,-6,877,1717,20
1543637508,1543637504,-4,1328,2902,20
1548667938,1548667936,-2,1232,2283,20
1550146722,1550146723,1,22516,18438,20
1550898517,1550898514,-3,1370,2665,20
1551303342,1551303342,0,1006,2015,20
1556360403,1556360399,-4,1459,2925,20
1557474934,1557474931,-3,1103,2305,20
1557830707,1557830717,10,965,2014,20
1560260129,1560260125,-4,1418,2725,20
1560676482,1560676477,-5,795,1788,20
1562029794,1562029798,4,1567,1222,20
1563177603,1563177602,-1,1424,2038,20
1564935267,1564935263,-4,1816,3689,20
1575272004,1575272001,-3,2099,2922,20
1576021338,1576021335,-3,651,1394,20
1576695171,1576695170,-1,1278,3022,20
1583710979,1583710973,-6,1243,2620,20
1586752573,1586752570,-3,1246,2342,20
1587534737,1587534734,-3,1110,2128,20
1590037395,1590037393,-2,893,2743,20
1591235695,1591235693,-2,1071,2233,20
1591623841,1591623838,-3,1365,2561,20
1592127344,1592127350,6,14897,20678,20
1596517140,1596517145,5,10862,6558,20
1598525437,1598525434,-3,1194,2633,20
1599066394,1599066392,-2,708,2805,20
1601615488,1601615485,-3,5434,12276,20
1602468835,1602468830,-5,898,2538,20
1602830110,1602830108,-2,1117,2235,20
1603741030,1603741010,-20,1012,1880,20
1603772832,1603772845,13,716,2140,20
1606223961,1606223957,-4,1528,2918,20
1609562913,1609562911,-2,665,1187,20
1616032874,1616032870,-4,1039,2207,20
1616089583,1616089602,19,142,883,20
1621412767,1621412766,-1,1215,2415,20
1622946062,1622946060,-2,987,2178,20
1623512026,1623512025,-1,1448,2963,20
1625014043,1625014040,-3,787,2132,20
1626739378,1626739375,-3,1100,2716,20
1627669886,1627669883,-3,1351,2457,20
1638767199,1638767197,-2,1024,2498,20
1642559614,1642559610,-4,1987,2753,20
1644088274,1644088273,-1,1806,1951,20
1645004177,1645004174,-3,1658,3170,20
1646595474,1646595487,13,17688,23890,20
1651758045,1651758042,-3,1219,2031,20
1653530868,1653530865,-3,1043,2224,20
1655341258,1655341256,-2,1405,3452,20
1657073514,1657073510,-4,1400,2701,20
1658680790,1658680787,-3,1682,2919,20
1659516630,1659516629,-1,1273,2158,20
1661939734,1661939731,-3,1480,1944,20
1665034778,1665034775,-3,1556,2310,20
1669433417,1669433413,-4,641,1622,20
1672029518,1672029514,-4,1205,2519,20
1672510752,1672510749,-3,1127,1758,20
1672892809,1672892802,-7,1021,1692,20
1678071717,1678071719,2,586,1084,20
1682590753,1682590749,-4,1278,2511,20
1683240421,1683240418,-3,1049,2590,20
1685767645,1685767650,5,4053,1723,20
1689671463,1689671459,-4,1339,2861,20
1692625571,1692625570,-1,1248,2212,20
1693808729,1693808726,-3,881,2263,20
1694196014,1694196034,20,992,2284,20
1694838686,1694838683,-3,1026,2540,20
1695001478,1695001499,21,949,2495,20
1706826257,1706826272,15,1169,1687,20
1713178138,1713178136,-2,915,1529,20
1713734769,1713734769,0,50355,20917,20
1716019073,1716019070,-3,996,1988,20
1718424009,1718424007,-2,1340,1481,20
1719626386,1719626387,1,1780,1575,20
1722381127,1722381125,-2,1103,2430,20
1726476105,1726476105,0,993,2425,20
1729049658,1729049654,-4,1321,2268,20
1730011561,1730011557,-4,894,2120,20
1731350685,1731350684,-1,1256,2702,20
1733824874,1733824869,-5,820,2046,20
1741912590,1741912589,-1,870,2308,20
1744595574,1744595581,7,4969,3017,20
1745540033,1745540030,-3,1279,1888,20
1746793524,1746793520,-4,1490,2766,20
1751044130,1751044126,-4,1245,3659,20
1751901241,1751901239,-2,979,2441,20
1752356879,1752356897,18,648,2353,20
1754965656,1754965654,-2,931,1819,20
1756621388,1756621386,-2,1228,1953,20
1762511003,1762510998,-5,1186,3603,20
1767874450,1767874446,-4,1495,1876,20
1768115526,1768115521,-5,76,780,20
1768348654,1768348650,-4,990,2107,20
1771217067,1771217065,-2,1305,2267,20
1783861778,1783861771,-7,1619,4843,20
1784173953,1784173950,-3,1141,2500,20
1787763822,1787763818,-4,1373,2050,20
1788595025,1788595023,-2,1243,1733,20
1792759786,1792759783,-3,1103,1939,20
1793063396,1793063395,-1,1403,3137,20
1793365497,1793365494,-3,1758,2248,20
1793856058,1793856055,-3,1495,2282,20
1806550651,1806550649,-2,926,1579,20
1807286862,1807286860,-2,1718,2516,20
1808215365,1808215364,-1,907,1379,20
1808318829,1808318815,-14,1598,2436,20
1808358120,1808358138,18,877,1830,20
1810242915,1810242910,-5,1344,2929,20
1814092996,1814092993,-3,1379,2852,20
1819610315,1819610310,-5,1168,2366,20
1820738278,1820738274,-4,1051,2050,20
1821542786,1821542783,-3,1676,3171,20
1824601995,1824601993,-2,1021,2052,20
1834860492,1834860489,-3,1259,3614,20
1839914938,1839914945,7,4045,1736,20
1842849673,1842849671,-2,1154,3003,20
1843451252,1843451257,5,2255,1191,20
1844275165,1844275163,-2,851,2407,20
1851633822,1851633818,-4,1219,2600,20
1853495461,1853495458,-3,1310,1985,20
1854980709,1854980707,-2,648,2122,20
1857243315,1857243310,-5,929,1902,20
1861106781,1861106775,-6,1091,2230,20
1862138566,1862138547,-19,838,3033,20
1871542176,1871542174,-2,1080,2435,20
1877681801,1877681797,-4,1233,4067,20
1879877383,1879877381,-2,1277,2785,20
1882059711,1882059709,-2,1058,2566,20
1882316207,1882316202,-5,1144,1767,20
1885916887,1885916885,-2,1137,1975,20
1891643370,1891643369,-1,728,1680,20
1892720786,1892720785,-1,957,1839,20
1903574139,1903574137,-2,1495,3614,20
1919155455,1919155453,-2,634,1667,20
1919874760,1919874775,15,396,762,20
1920627706,1920627703,-3,1249,2217,20
1923685274,1923685271,-3,1193,2651,20
1923759470,1923759468,-2,1125,1902,20
1924421503,1924421503,0,178,1040,20
1927296715,1927296711,-4,1824,2822,20
1933131060,1933131066,6,39787,28016,20
1935730983,1935730979,-4,1056,2727,20
1939397722,1939397715,-7,919,1650,20
1939544628,1939544626,-2,1280,3532,20
1945115482,1945115480,-2,5244,1719,20
1945782265,1945782261,-4,1188,2888,20
1946113487,1946113486,-1,841,2080,20
1949626510,1949626504,-6,866,3033,20
1950477091,1950477086,-5,1153,2299,20
1955194200,1955194181,-19,1457,2753,20
1956543698,1956543697,-1,1269,2364,20
1959110574,1959110573,-1,995,2660,20
1960278503,1960278497,-6,1459,5990,20
1962423869,1962423866,-3,999,2591,20
1962753049,1962753045,-4,1305,4232,20
1964283497,1964283501,4,1279,1532,20
1970377999,1970377997,-2,1308,2663,20
1971808446,1971808452,6,2775,1581,20
1972836669,1972836667,-2,1565,2677,20
1973985791,1973985786,-5,1117,3568,20
1974889018,1974889014,-4,967,2310,20
1979650764,1979650762,-2,1557,2412,20
1981178485,1981178482,-3,968,2512,20
1981535283,1981535276,-7,1171,4094,20
1981859838,1981859844,6,4503,2524,20
1983785831,1983785826,-5,1268,2441,20
1984690095,1984690095,0,2035,1985,20
1984787430,1984787428,-2,905,2100,20
1985540502,1985540500,-2,1053,2032,20
1989376009,1989376004,-5,1294,2838,20
1992386429,1992386426,-3,1064,2020,20
1993254093,1993254087,-6,1049,4824,20
1993722215,1993722198,-17,908,1822,20
1995863482,1995863480,-2,1039,2149,20
1998338272,1998338258,-14,45984,14720,20
2002690534,2002690530,-4,739,1768,20
2004451817,2004451815,-2,1106,2089,20
2004660877,2004660876,-1,1081,2619,20
2005360519,2005360518,-1,1177,1946,20
2007874641,2007874638,-3,1190,2818,20
2008596341,2008596333,-8,401,766,20
2016920330,2016920326,-4,1308,2166,20
2017351533,2017351530,-3,1344,2018,20
2017489446,2017489442,-4,871,2329,20
2019536976,2019536973,-3,1505,2403,20
2021502378,2021502374,-4,1234,2433,20
2022224215,2022224213,-2,1175,1657,20
2027937328,2027937325,-3,1440,2707,20
2029231029,2029231027,-2,786,2002,20
2030480123,2030480118,-5,1094,2980,20
2038082896,2038082902,6,3759,2287,20
2040306351,2040306343,-8,818,2578,20
2040394980,2040394973,-7,1142,2224,20
2040761964,2040761962,-2,896,1540,20
2042798698,2042798697,-1,950,1989,20
2045811574,2045811570,-4,1182,2805,20
2048537618,2048537614,-4,1145,3018,20
2048727861,2048727883,22,889,3122,20
2055316663,2055316658,-5,916,1858,20
2058508725,2058508730,5,2044,1447,20
2060253595,2060253594,-1,1076,1577,20
2060988834,2060988834,0,6647,9258,20
2061062360,2061062362,2,4725,21655,20
2061622746,2061622743,-3,954,1453,20
2064158390,2064158396,6,2679,1233,20
2067343150,2067343145,-5,1317,3194,20
2067405092,2067405113,21,787,1942,20
2069269165,2069269166,1,2372,1847,20
2076730999,2076730994,-5,1242,2032,20
2079817674,2079817672,-2,935,2420,20
2084161950,2084161950,0,997,1563,20
2087730427,2087730423,-4,966,2447,20
2093456556,2093456554,-2,2095,2674,20
2093593209,2093593215,6,6752,2045,20
2095643901,2095643890,-11,1245,413,20
2097378831,2097378828,-3,1047,2900,20
2099539939,2099539935,-4,931,2141,20
2099830226,2099830221,-5,1659,3080,20
2100163380,2100163382,2,1512,2199,20
2101147358,2101147377,19,236,953,20
2104784481,2104784478,-3,829,1891,20
2107317003,2107317002,-1,1393,1947,20
2112425054,2112425052,-2,1027,1746,20
2112670866,2112670862,-4,1174,2035,20
2112956097,2112956093,-4,1270,2345,20
2113819450,2113819448,-2,1166,2441,20
2113927246,2113927245,-1,1321,2389,20
2114229986,2114229983,-3,1012,2792,20
2114646647,2114646642,-5,1305,3549,20
2118561565,2118561570,5,2883,1301,20
2127209654,2127209656,2,1826,2326,20
2128923806,2128923804,-2,942,2420,20
2131837474,2131837473,-1,1263,2228,20
2132406194,2132406190,-4,1252,2518,20
2133020959,2133020964,5,3052,2028,20
2134666919,2134666915,-4,1135,2156,20
2139194298,2139194295,-3,995,2776,20
2142042922,2142042921,-1,1727,1895,20
2142899840,2142899843,3,1672,1681,20
2144521107,2144521106,-1,1032,2594,20
2147755083,2147755081,-2,1219,2540,20
2147916538,2147916534,-4,591,1642,20
2157118984,2157118983,-1,903,1273,20
2159396943,2159396940,-3,1027,2103,20
2159512309,2159512289,-20,256,923,20
2159823856,2159823853,-3,1239,1680,20
2160117409,2160117407,-2,734,1042,20
2161803925,2161803923,-2,1034,2786,20
2168024643,2168024640,-3,1148,3092,20
2169556342,2169556326,-16,1194,2527,20
2172298044,2172298043,-1,1100,1880,20
2176659483,2176659480,-3,1095,1794,20
2179551970,2179551964,-6,1141,2876,20
2179647269,2179647287,18,569,1352,20
2181561800,2181561798,-2,1270,1581,20
2186527475,2186527470,-5,1361,1978,20
2186610105,2186610102,-3,1525,2318,20
2187286621,2187286614,-7,1304,3431,20
2188947082,2188947075,-7,924,2221,20
2189663292,2189663287,-5,1207,2468,20
2195188246,2195188242,-4,1059,2228,20
2197142317,2197142315,-2,1300,2984,20
2200514842,2200514838,-4,1431,2944,20
2202031047,2202031051,4,4515,2986,20
2204594009,2204594006,-3,1218,2843,20
2206572654,2206572652,-2,1147,2372,20
2208381421,2208381421,0,1379,2216,20
2208454261,2208454242,-19,1168,2849,20
2209251050,2209251057,7,2677,1603,20
2209532285,2209532281,-4,1045,1798,20
2212147891,2212147889,-2,744,1727,20
2220167507,2220167506,-1,1263,3042,20
2223387718,2223387722,4,1148,1085,20
2224331986,2224331983,-3,1066,2677,20
2225669140,2225669120,-20,1019,2198,20
2230365414,2230365414,0,1118,1866,20
2231362310,2231362306,-4,884,1986,20
2237906835,2237906831,-4,975,1452,20
2237951015,2237951026,11,410,846,20
2238415296,2238415289,-7,1098,2366,20
2242910152,2242910148,-4,1250,2514,20
2247525862,2247525857,-5,1154,3099,20
2248136778,2248136776,-2,1717,2734,20
2254579115,2254579114,-1,1847,2843,20
2256772458,2256772456,-2,1012,2664,20
2257393471,2257393467,-4,1019,2589,20
2260840563,2260840561,-2,1125,2345,20
2262267927,2262267925,-2,1354,1966,20
2266872728,2266872725,-3,1102,1690,20
2277043955,2277043953,-2,1200,3370,20
2282827806,2282827803,-3,885,2273,20
2286274272,2286274268,-4,1359,2653,20
2287898622,2287898611,-11,3454,14143,20
2293630626,2293630623,-3,1282,2254,20
2300479273,2300479270,-3,1351,2552,20
2303528203,2303528201,-2,848,2048,20
2303834893,2303834910,17,796,1701,20
2313468781,2313468778,-3,1349,1847,20
2315695063,2315695058,-5,1087,2353,20
2317582354,2317582351,-3,977,2396,20
2317712071,2317712068,-3,861,2000,20
2318391483,2318391479,-4,1529,2647,20
2322360011,2322360009,-2,743,1906,20
2322946589,2322946585,-4,1508,2806,20
2323668334,2323668333,-1,1124,1478,20
2330871390,2330871392,2,1662,1923,20
2333369370,2333369366,-4,1150,2349,20
2336177319,2336177314,-5,967,2575,20
2345230486,2345230483,-3,928,2472,20
2350312633,2350312630,-3,1130,2049,20
2355839839,2355839837,-2,1323,2709,20
2358481598,2358481595,-3,1548,3298,20
2366993880,2366993876,-4,1444,2359,20
2370172451,2370172446,-5,1140,3185,20
2371145241,2371145235,-6,19867,12846,20
2375418609,2375418607,-2,1003,2641,20
2377307862,2377307861,-1,993,1712,20
2378723433,2378723431,-2,1293,1918,20
2392109683,2392109679,-4,652,1431,20
2393714344,2393714341,-3,1281,2718,20
2395331634,2395331627,-7,1377,5212,20
2396398352,2396398349,-3,1706,3307,20
2396978567,2396978564,-3,733,2273,20
2398789671,2398789670,-1,1050,1331,20
2399645494,2399645493,-1,1062,1216,20
2400052582,2400052598,16,286,1274,20
2400790618,2400790614,-4,967,1792,20
2400818190,2400818169,-21,1198,3316,20
2401512849,2401512846,-3,1063,2542,20
2411965230,2411965229,-1,933,2296,20
2416092999,2416092994,-5,1363,2723,20
2416856682,2416856678,-4,1025,2280,20
2420098902,2420098900,-2,1124,2873,20
2420979437,2420979434,-3,795,2181,20
2421467366,2421467366,0,1289,1780,20
2422409263,2422409257,-6,942,2204,20
2422957882,2422957881,-1,1124,2005,20
2423509087,2423509082,-5,986,1785,20
2426705611,2426705606,-5,1386,2734,20
2428259601,2428259597,-4,1333,2146,20
2428487537,2428487535,-2,894,1371,20
2428561285,2428561306,21,1213,2771,20
2428657949,2428657970,21,622,1809,20
2429351173,2429351170,-3,1084,2101,20
2432477694,2432477692,-2,1505,3577,20
2437971518,2437971517,-1,1096,2159,20
2438153272,2438153290,18,684,2481,20
2440524011,2440524006,-5,593,1132,20
2443443550,2443443549,-1,933,1888,20
2446582958,2446582955,-3,815,2090,20
2447042917,2447042907,-10,166,738,20
2448738797,2448738796,-1,1107,1845,20
2450861363,2450861362,-1,2189,2710,20
2458485985,2458485982,-3,935,2764,20
2459713886,2459713883,-3,1124,2443,20
2459999838,2459999835,-3,971,2090,20
2468302995,2468302993,-2,1041,1736,20
2474615829,2474615829,0,1178,2142,20
2474970446,2474970445,-1,831,1498,20
2475648258,2475648253,-5,1243,2468,20
2479490949,2479490944,-5,308,1698,20
2480508057,2480508054,-3,1015,1871,20
2480765341,2480765327,-14,45251,15317,20
2489899443,2489899441,-2,1361,2058,20
2495609539,2495609546,7,4260,1659,20
2497319803,2497319801,-2,1202,2809,20
2498286354,2498286350,-4,965,2031,20
2498873943,2498873940,-3,1535,2178,20
2500552141,2500552139,-2,1440,2614,20
2502982697,2502982693,-4,1233,2678,20
2503528495,2503528493,-2,1142,2405,20
2504142293,2504142290,-3,1024,2139,20
2504670895,2504670896,1,220,1079,20
2508735368,2508735365,-3,1409,2541,20
2512236845,2512236842,-3,1373,2433,20
2512870972,2512870970,-2,1200,2076,20
2514330324,2514330323,-1,1034,1414,20
2519132375,2519132353,-22,779,1538,20
2520732288,2520732307,19,496,1097,20
2522900427,2522900423,-4,926,1776,20
2525903022,2525903020,-2,1572,2745,20
2538425034,2538425030,-4,1156,2225,20
2539623131,2539623127,-4,1139,2183,20
2545228939,2545228938,-1,1090,1952,20
2550083045,2550083041,-4,1489,2674,20
2550759087,2550759085,-2,1006,2223,20
2552110498,2552110495,-3,1524,2898,20
2552424289,2552424285,-4,940,2090,20
2559046868,2559046866,-2,1005,1752,20
2561154059,2561154059,0,907,1391,20
2563776343,2563776340,-3,744,1314,20
2565151447,2565151445,-2,1142,2958,20
2566861212,2566861207,-5,870,1597,20
2567858246,2567858238,-8,821,2048,20
2569880349,2569880347,-2,1385,2575,20
2571358431,2571358429,-2,715,1734,20
2571639944,2571639927,-17,1361,691,20
2574087426,2574087422,-4,1108,2836,20
2577921127,2577921125,-2,1201,3302,20
2581821662,2581821661,-1,924,2058,20
2586418354,2586418354,0,1119,2135,20
2589935306,2589935304,-2,1440,2347,20
2591009938,2591009937,-1,1443,2563,20
2591256634,2591256633,-1,949,1760,20
2594390080,2594390078,-2,1284,3276,20
2600978834,2600978830,-4,810,2193,20
2602051899,2602051878,-21,633,1562,20
2602186940,2602186962,22,540,1297,20
2603924302,2603924299,-3,1413,2235,20
2609029821,2609029817,-4,1517,2764,20
2615067926,2615067926,0,1129,1477,20
2615512954,2615512954,0,1091,1777,20
2618957224,2618957221,-3,1180,3086,20
2619282758,2619282765,7,3247,1649,20
2625187558,2625187556,-2,735,3142,20
2625277151,2625277150,-1,817,1379,20
2625786718,2625786718,0,866,1495,20
2631986450,2631986447,-3,1818,3552,20
2633814838,2633814834,-4,1198,1454,20
2633905038,2633905038,0,1080,3089,20
2634440579,2634440576,-3,1105,2774,20
2636704846,2636704842,-4,951,1796,20
2638263830,2638263824,-6,789,2606,20
2646393447,2646393441,-6,1186,2924,20
2646687445,2646687442,-3,1102,2275,20
2648741302,2648741298,-4,765,1874,20
2653148250,2653148247,-3,1300,3103,20
2655274278,2655274272,-6,929,2699,20
2656144516,2656144512,-4,1242,2912,20
2657224923,2657224921,-2,1105,1866,20
2660246175,2660246173,-2,1050,2049,20
2660291983,2660291978,-5,708,2082,20
2662170541,2662170550,9,1366,468,20
2664122796,2664122795,-1,1510,2904,20
2667223897,2667223895,-2,1508,3205,20
2670228931,2670228929,-2,1284,2261,20
2672446936,2672446934,-2,841,1649,20
2672648769,2672648765,-4,1175,1899,20
2672948866,2672948862,-4,1211,2340,20
2675913227,2675913223,-4,1168,2822,20
2676204854,2676204850,-4,1260,2525,20
2676260782,2676260778,-4,1159,2515,20
2677877094,2677877092,-2,1058,1954,20
2678243291,2678243288,-3,951,2287,20
2679232838,2679232834,-4,906,1835,20
2679480918,2679480913,-5,1134,2906,20
2682041654,2682041653,-1,1328,2032,20
2683973071,2683973069,-2,1484,2061,20
2690845264,2690845261,-3,1389,2300,20
2691067546,2691067543,-3,1096,2309,20
2691343718,2691343718,0,1437,2226,20
2697044198,2697044197,-1,1067,1783,20
2702437531,2702437529,-2,1048,2446,20
2702564286,2702564282,-4,1624,4063,20
2720239074,2720239073,-1,1705,2817,20
2722374142,2722374139,-3,1346,2380,20
2723568613,2723568610,-3,1281,2733,20
2724890230,2724890230,0,3446,4632,20
2728156457,2728156453,-4,1553,3609,20
2728667522,2728667517,-5,956,2488,20
2729818464,2729818458,-6,989,1796,20
2734883121,2734883104,-17,1708,1981,20
2735361958,2735361955,-3,1482,3666,20
2735665302,2735665290,-12,4257,13956,20
2739864647,2739864645,-2,481,1467,20
2750189929,2750189926,-3,1085,2337,20
2751951053,2751951049,-4,1228,2371,20
2759359726,2759359724,-2,1178,2098,20
2767102224,2767102225,1,1004,1436,20
2769414243,2769414241,-2,1499,2160,20
2771618954,2771618955,1,1182,1629,20
2772753354,2772753351,-3,819,2299,20
2772847840,2772847841,1,1833,2593,20
2779091488,2779091492,4,46468,3148,20
2781187388,2781187385,-3,1033,2411,20
2782483628,2782483627,-1,1644,2919,20
2787507354,2787507349,-5,1382,3188,20
2787760527,2787760526,-1,726,2256,20
2788680239,2788680236,-3,1149,1836,20
2789065275,2789065273,-2,889,2181,20
2790110879,2790110877,-2,141,570,20
2792464363,2792464363,0,975,2574,20
2794667874,2794667870,-4,793,1831,20
2797026233,2797026229,-4,1470,3136,20
2799867501,2799867498,-3,1347,2683,20
2801038997,2801038997,0,1317,1186,20
2805608326,2805608322,-4,967,3086,20
2806012622,2806012619,-3,814,1493,20
2808661574,2808661572,-2,1120,3129,20
2811005484,2811005489,5,4311,2231,20
2812741678,2812741675,-3,1411,1611,20
2813937157,2813937154,-3,956,2225,20
2814420703,2814420699,-4,1011,2282,20
2816874631,2816874631,0,1594,2489,20
2817515613,2817515611,-2,1079,2116,20
2817990509,2817990502,-7,1437,5064,20
2818100645,2818100662,17,141,696,20
2827109427,2827109425,-2,804,2679,20
2831953493,2831953491,-2,1233,2420,20
2832882202,2832882197,-5,994,2774,20
2837357995,2837357993,-2,956,1662,20
2838000828,2838000815,-13,46,744,20
2842983342,2842983323,-19,1346,1034,20
2845337497,2845337506,9,3290,1000,20
2846676528,2846676526,-2,1151,2896,20
2847060591,2847060589,-2,1260,2473,20
2852738215,2852738216,1,1441,1481,20
2858167057,2858167057,0,1683,2274,20
2870612157,2870612158,1,1022,2013,20
2873818920,2873818919,-1,1199,1833,20
2877106438,2877106435,-3,1782,3102,20
2878520765,2878520762,-3,1302,2708,20
2878843685,2878843679,-6,819,1832,20
2879584891,2879584890,-1,1201,1649,20
2887305042,2887305039,-3,1063,1730,20
2889342911,2889342908,-3,795,2139,20
2890126530,2890126526,-4,1160,2458,20
2893408956,2893408948,-8,1217,4799,20
2897869120,2897869118,-2,1157,2249,20
2899237909,2899237906,-3,991,2377,20
2900789972,2900789991,19,641,960,20
2906145778,2906145776,-2,991,2716,20
2906616740,2906616738,-2,1514,2918,20
2911509510,2911509506,-4,991,2091,20
2912217527,2912217522,-5,1575,6249,20
2913437370,2913437368,-2,1380,3754,20
2917636489,2917636485,-4,1193,3214,20
2918352958,2918352937,-21,1166,2890,20
2918559058,2918559054,-4,1089,2501,20
2918914527,2918914523,-4,1416,2893,20
2919577494,2919577489,-5,837,3126,20
2923993622,2923993620,-2,1202,3038,20
2934218055,2934218051,-4,1153,2161,20
2943775675,2943775673,-2,781,1683,20
2946116142,2946116142,0,1297,2648,20
2946392982,2946392982,0,1308,2404,20
2949477101,2949477099,-2,1286,2051,20
2949511351,2949511362,11,198,1059,20
2949951375,2949951373,-2,1119,2159,20
2951320841,2951320857,16,908,2901,20
2957079403,2957079402,-1,1193,2605,20
2959779642,2959779638,-4,1340,2751,20
2960827726,2960827722,-4,1084,1495,20
2963119850,2963119848,-2,1439,2817,20
2963466596,2963466590,-6,1329,4749,20
2965711534,2965711523,-11,271,1244,20
2966037428,2966037426,-2,1319,2206,20
2967241216,2967241222,6,25348,34634,20
2969677879,2969677877,-2,1218,1382,20
2970726421,2970726418,-3,966,1570,20
2972103058,2972103057,-1,1330,2466,20
2973617623,2973617606,-17,245,911,20
2974091641,2974091638,-3,607,1606,20
2974793710,2974793706,-4,1194,2826,20
2980316663,2980316660,-3,967,2488,20
2980476536,2980476534,-2,937,2289,20
2981686126,2981686121,-5,1039,2470,20
2981828180,2981828201,21,643,2454,20
2984588765,2984588762,-3,1654,3215,20
2984883317,2984883317,0,1309,1457,20
2989386487,2989386485,-2,1415,2361,20
2990098770,2990098766,-4,1775,3071,20
2993737603,2993737601,-2,1946,2943,20
2994382581,2994382586,5,2313,1181,20
2999849660,2999849653,-7,27214,14539,20
3000709977,3000709973,-4,1211,2135,20
3005345797,3005345795,-2,840,2703,20
3005483753,3005483753,0,890,1085,20
3011229319,3011229317,-2,1246,2396,20
3020835663,3020835661,-2,1308,2194,20
3021283130,3021283127,-3,1113,2079,20
3024994610,3024994608,-2,1098,2173,20
3028704963,3028704961,-2,1293,2441,20
3029665086,3029665083,-3,1103,2599,20
3030343012,3030343008,-4,1372,2842,20
3033879046,3033879043,-3,1145,2263,20
3034074805,3034074803,-2,779,2227,20
3034528239,3034528226,-13,966,2284,20
3034981191,3034981182,-9,127,889,20
3035968988,3035968986,-2,1268,2051,20
3037716575,3037716570,-5,1009,2411,20
3038033113,3038033109,-4,1012,2443,20
3040181156,3040181153,-3,907,2474,20
3044519920,3044519918,-2,2806,4676,20
3045047622,3045047631,9,12854,19204,20
3046540405,3046540400,-5,1337,2908,20
3049766993,3049766998,5,3730,1755,20
3065497619,3065497618,-1,939,1624,20
3067653854,3067653852,-2,1458,1735,20
3069238024,3069238018,-6,1345,2571,20
3069365403,3069365400,-3,1241,2561,20
3070988621,3070988620,-1,1001,2326,20
3077655318,3077655317,-1,1009,1516,20
3080005966,3080005966,0,1069,2135,20
3080419355,3080419352,-3,1286,2709,20
3084970676,3084970674,-2,1097,2280,20
3087785546,3087785542,-4,1338,2150,20
3089424350,3089424346,-4,1165,2057,20
3092338716,3092338714,-2,874,1953,20
3093121022,3093121020,-2,1008,1907,20
3093905922,3093905920,-2,1066,1588,20
3097341144,3097341142,-2,875,2133,20
3099249191,3099249190,-1,1090,1856,20
3099835928,3099835924,-4,1511,2014,20
3100141041,3100141039,-2,714,1283,20
3103630358,3103630357,-1,1483,2490,20
3108530178,3108530179,1,1303,1506,20
3111215498,3111215495,-3,1162,2074,20
3111585586,3111585582,-4,732,2271,20
3113812787,3113812785,-2,1168,1898,20
3123401971,3123401968,-3,939,2314,20
3127193061,3127193059,-2,1330,2436,20
3130075111,3130075109,-2,1093,2590,20
3130269202,3130269202,0,1519,2031,20
3131259289,3131259286,-3,1403,2634,20
3131951914,3131951912,-2,914,2675,20
3134916470,3134916466,-4,1323,2205,20
3136573578,3136573575,-3,768,2541,20
3136621070,3136621062,-8,303,867,20
3144938266,3144938263,-3,1220,2638,20
3150772055,3150772052,-3,1269,3251,20
3154006600,3154006595,-5,1151,2167,20
3156029007,3156029004,-3,1185,3359,20
3156364981,3156364973,-8,185,848,20
3158113915,3158113913,-2,959,2411,20
3170078837,3170078833,-4,933,2707,20
3170211643,3170211642,-1,1412,2861,20
3173706338,3173706338,0,1591,2956,20
3177192605,3177192600,-5,1239,2668,20
3180832799,3180832798,-1,1142,1985,20
3184389059,3184389054,-5,900,2675,20
3185975526,3185975524,-2,1085,2143,20
3186505986,3186505985,-1,833,1784,20
3191061379,3191061375,-4,863,1508,20
3191198727,3191198733,6,187,781,20
3193364837,3193364842,5,2959,1094,20
3204867968,3204867966,-2,803,2504,20
3208098658,3208098651,-7,1052,2560,20
3208311799,3208311818,19,1046,2093,20
3208631351,3208631347,-4,1075,2856,20
3208820504,3208820502,-2,1090,2597,20
3214500806,3214500804,-2,1282,2295,20
3215201290,3215201289,-1,1034,2938,20
3216961922,3216961918,-4,1210,2752,20
3220625079,3220625075,-4,1129,2428,20
3228689951,3228689949,-2,1540,2712,20
3228792706,3228792702,-4,1328,1926,20
3229800373,3229800370,-3,1032,1985,20
3230767982,3230767991,9,50,1010,20
3234053129,3234053126,-3,1084,3255,20
3236156445,3236156442,-3,1361,3033,20
3238954981,3238954978,-3,1084,2054,20
3242372742,3242372738,-4,1261,1965,20
3244567378,3244567374,-4,1210,2602,20
3247410421,3247410418,-3,1083,1966,20
3249087414,3249087410,-4,1282,2981,20
3262361233,3262361230,-3,1003,1895,20
3269205676,3269205674,-2,1456,2202,20
3272241505,3272241503,-2,1368,1543,20
3275956249,3275956243,-6,998,3150,20
3276088032,3276088048,16,940,2309,20
3276918667,3276918663,-4,1354,2502,20
3279737003,3279737001,-2,1012,1944,20
3279953599,3279953585,-14,978,2143,20
3282577549,3282577546,-3,996,2657,20
3291404791,3291404789,-2,1034,2162,20
3291885285,3291885283,-2,1038,1134,20
3298199477,3298199482,5,1493,1401,20
3298651215,3298651212,-3,871,1423,20
3300674245,3300674242,-3,1262,2276,20
3305813341,3305813338,-3,862,1821,20
3319285676,3319285674,-2,605,1209,20
3323054871,3323054869,-2,908,2702,20
3323790111,3323790127,16,485,1087,20
3327810078,3327810078,0,3403,3447,20
3334700718,3334700726,8,4049,1200,20
3337025374,3337025371,-3,1029,1452,20
3340805124,3340805118,-6,701,1632,20
3341746590,3341746589,-1,958,2204,20
3344143590,3344143587,-3,1595,2051,20
3344970659,3344970655,-4,856,2001,20
3349296735,3349296731,-4,1109,2694,20
3352816525,3352816527,2,2060,1669,20
3354785494,3354785492,-2,1094,1743,20
3355893872,3355893867,-5,1104,2342,20
3356595271,3356595290,19,580,2713,20
3360790962,3360790959,-3,681,1246,20
3371490314,3371490310,-4,1627,2214,20
3373154379,3373154375,-4,858,2252,20
3375377759,3375377757,-2,1151,2781,20
3375598638,3375598643,5,1684,1067,20
3377197707,3377197704,-3,1265,3646,20
3378446689,3378446686,-3,1272,2457,20
3379385694,3379385700,6,3213,2676,20
3381129326,3381129325,-1,1672,1820,20
3383063518,3383063519,1,848,1739,20
3384234422,3384234419,-3,1274,2008,20
3390596770,3390596766,-4,1155,2443,20
3392444067,3392444081,14,461,998,20
3394382770,3394382767,-3,1070,1980,20
3404265719,3404265718,-1,1048,2372,20
3404541086,3404541085,-1,642,2651,20
3405249129,3405249125,-4,826,2744,20
3410822619,3410822614,-5,942,1464,20
3412066087,3412066096,9,1112,1812,20
3421177602,3421177599,-3,1149,1620,20
3421793517,3421793515,-2,1003,2551,20
3422055332,3422055354,22,814,2363,20
3422104165,3422104162,-3,1225,2178,20
3426126031,3426126028,-3,1155,2244,20
3435482534,3435482535,1,1964,1548,20
3438685899,3438685894,-5,1113,2984,20
3439481262,3439481260,-2,685,1248,20
3441118897,3441118901,4,2678,1640,20
3443403136,3443403134,-2,1277,2235,20
3452103845,3452103846,1,2567,2555,20
3452728641,3452728644,3,1983,1364,20
3456664871,3456664869,-2,1048,2705,20
3465579789,3465579794,5,2886,1645,20
3468089602,3468089599,-3,1301,2348,20
3468988081,3468988079,-2,1073,2346,20
3470579346,3470579342,-4,808,2346,20
3471688522,3471688519,-3,1485,3545,20
3473593045,3473593043,-2,1051,2791,20
3473784670,3473784665,-5,1476,2777,20
3475091742,3475091734,-8,7358,15624,20
3477819704,3477819707,3,992,1124,20
3479968579,3479968578,-1,971,2170,20
3480263039,3480263043,4,1727,1474,20
3481036394,3481036393,-1,1000,1912,20
3484491642,3484491639,-3,1460,2004,20
3484968100,3484968097,-3,1255,1769,20
3491518650,3491518650,0,1890,1746,20
3491782371,3491782366,-5,2000,7683,20
3496628452,3496628448,-4,1284,2520,20
3499897861,3499897857,-4,1040,1724,20
3505310334,3505310333,-1,1367,2930,20
3505504086,3505504075,-11,965,1826,20
3512013988,3512013983,-5,1791,2356,20
3514250811,3514250808,-3,930,2498,20
3514373326,3514373306,-20,1268,2115,20
3517962285,3517962280,-5,885,2837,20
3518313476,3518313466,-10,1269,2392,20
3520668482,3520668486,4,1957,1626,20
3527254622,3527254621,-1,1198,1977,20
3530275018,3530275015,-3,1341,1902,20
3530503939,3530503933,-6,754,1786,20
3531387706,3531387702,-4,1291,5614,20
3537798262,3537798258,-4,1095,2476,20
3541192711,3541192710,-1,896,1903,20
3544277713,3544277736,23,706,2163,20
3545521797,3545521794,-3,1119,2663,20
3545961260,3545961257,-3,99,654,20
3549535746,3549535742,-4,1045,2782,20
3549837214,3549837210,-4,1424,2460,20
3554285490,3554285489,-1,1221,2148,20
3554320739,3554320735,-4,1410,1736,20
3555725364,3555725370,6,3356,1207,20
3558622770,3558622765,-5,1140,2914,20
3559598238,3559598234,-4,1496,2617,20
3560509159,3560509156,-3,1280,2305,20
3560556542,3560556538,-4,830,1583,20
3562584497,3562584494,-3,953,2184,20
3565992248,3565992247,-1,1074,1855,20
3566122658,3566122657,-1,1009,2047,20
3569823538,3569823537,-1,1357,2276,20
3570532235,3570532231,-4,1210,2777,20
3572279561,3572279558,-3,1330,2729,20
3575847861,3575847859,-2,1098,3017,20
3576083454,3576083462,8,7450,2548,20
3576804298,3576804296,-2,1333,1476,20
3582007096,3582007093,-3,1783,4954,20
3584190915,3584190914,-1,1086,2435,20
3591186622,3591186619,-3,1095,2878,20
3593904906,3593904902,-4,1121,2241,20
3594958877,3594958874,-3,863,1508,20
3596161083,3596161078,-5,1569,3179,20
3596333229,3596333218,-11,894,1907,20
3602496211,3602496207,-4,805,1975,20
3606912085,3606912075,-10,1287,3473,20
3606953599,3606953598,-1,1188,2026,20
3607740094,3607740090,-4,1151,1419,20
3607986899,3607986894,-5,1205,3054,20
3609110877,3609110874,-3,1135,1679,20
3610467670,3610467669,-1,1069,2000,20
3611577402,3611577403,1,1580,1787,20
3612270222,3612270218,-4,1059,3250,20
3613010003,3613010001,-2,1277,1879,20
3616880063,3616880062,-1,955,1566,20
3623694430,3623694429,-1,839,2008,20
3627432329,3627432327,-2,1130,2509,20
3630959586,3630959582,-4,905,1980,20
3631804648,3631804634,-14,964,1836,20
3632243974,3632243971,-3,844,1324,20
3635491931,3635491938,7,2928,1722,20
3636559427,3636559425,-2,1551,2503,20
3639670798,3639670797,-1,1139,2250,20
3639874146,3639874143,-3,1528,2120,20
3641113620,3641113617,-3,924,2117,20
3645644267,3645644281,14,699,1630,20
3652690553,3652690550,-3,1415,2286,20
3656969476,3656969474,-2,1464,2446,20
3659742021,3659742022,1,1039,1892,20
3661482030,3661482027,-3,2101,4992,20
3666136862,3666136857,-5,1960,5515,20
3669552126,3669552133,7,1785,1167,20
3670736978,3670736973,-5,513,1690,20
3674776295,3674776293,-2,1357,2937,20
3677050621,3677050617,-4,1083,2567,20
3679009514,3679009512,-2,779,1503,20
3679922557,3679922579,22,1156,1942,20
3681114914,3681114909,-5,1131,4215,20
3681668560,3681668557,-3,1258,1820,20
3684097086,3684097091,5,653,1299,20
3686541047,3686541044,-3,1134,3031,20
3686928663,3686928658,-5,842,1726,20
3691305881,3691305874,-7,1095,6449,20
3696542279,3696542277,-2,980,1898,20
3696770603,3696770609,6,4395,2304,20
3696860309,3696860314,5,2830,1793,20
3701531359,3701531356,-3,690,1823,20
3705164019,3705164018,-1,1209,1680,20
3708163411,3708163409,-2,1277,1833,20
3708523767,3708523767,0,1253,1416,20
3709108551,3709108550,-1,1224,2150,20
3709369641,3709369639,-2,902,1831,20
3709520397,3709520394,-3,1225,2354,20
3711229643,3711229646,3,1540,2096,20
3713204651,3713204650,-1,1006,3290,20
3714127811,3714127807,-4,858,2287,20
3715154006,3715154002,-4,1518,2198,20
3715590379,3715590378,-1,501,1390,20
3717129481,3717129478,-3,1174,2751,20
3720528434,3720528432,-2,1466,2371,20
3721946881,3721946881,0,1132,2241,20
3722759965,3722759961,-4,599,1935,20
3724690251,3724690246,-5,1097,3748,20
3726436712,3726436709,-3,1455,1965,20
3731765915,3731765913,-2,1562,3234,20
3732759110,3732759125,15,596,49,20
3733791878,3733791875,-3,1429,3474,20
3734954517,3734954515,-2,1326,2303,20
3737609554,3737609552,-2,991,2343,20
3742296816,3742296814,-2,952,1911,20
3743257530,3743257531,1,1476,1732,20
3743402332,3743402330,-2,1386,2415,20
3745180422,3745180439,17,1001,2445,20
3749733483,3749733477,-6,952,2972,20
3751459706,3751459705,-1,1518,3244,20
3751605193,3751605193,0,1382,2309,20
3751729262,3751729268,6,2411,1381,20
3762512830,3762512813,-17,188,924,20
3770702318,3770702313,-5,1269,2054,20
3771925767,3771925765,-2,1663,2989,20
3772910960,3772910955,-5,1151,1984,20
3773842507,3773842504,-3,1435,2990,20
3774013499,3774013497,-2,903,2125,20
3774449459,3774449454,-5,817,1485,20
3774929970,3774929966,-4,982,2524,20
3776007839,3776007836,-3,1239,2467,20
3776417122,3776417120,-2,2259,3829,20
3789546345,3789546341,-4,1055,2389,20
3789971982,3789971966,-16,1266,3958,20
3792236549,3792236546,-3,1364,2442,20
3793694106,3793694105,-1,1354,2292,20
3796667559,3796667555,-4,933,1566,20
3800842039,3800842046,7,7710,3008,20
3800869017,3800869013,-4,1275,2652,20
3802857265,3802857270,5,5427,3053,20
3806335768,3806335766,-2,1361,2053,20
3810620539,3810620534,-5,1063,3089,20
3813114453,3813114453,0,864,2096,20
3816770742,3816770739,-3,1419,2289,20
3816911838,3816911830,-8,810,1919,20
3819298255,3819298252,-3,841,1440,20
3826752490,3826752491,1,2990,3763,20
3829156574,3829156572,-2,1198,3093,20
3830967819,3830967815,-4,774,2184,20
3831069759,3831069755,-4,995,2089,20
3832452146,3832452145,-1,782,1834,20
3838347214,3838347210,-4,1528,3004,20
3841625237,3841625236,-1,1420,2875,20
3846074635,3846074633,-2,978,2277,20
3851649410,3851649407,-3,1299,2538,20
3852007586,3852007585,-1,1436,2880,20
3852992685,3852992683,-2,967,2325,20
3853188260,3853188258,-2,1258,2044,20
3860280167,3860280164,-3,931,1970,20
3861210086,3861210081,-5,1159,2351,20
3865537870,3865537869,-1,1179,2394,20
3866436191,3866436187,-4,1059,2681,20
3867720410,3867720406,-4,1449,2842,20
3871307468,3871307464,-4,1009,1736,20
3874290588,3874290586,-2,1218,2398,20
3874986757,3874986776,19,687,1337,20
3875298215,3875298212,-3,1123,2481,20
3876069486,3876069484,-2,1759,2373,20
3876543871,3876543868,-3,962,3073,20
3877574882,3877574879,-3,1147,2429,20
3881228626,3881228624,-2,1267,2370,20
3885013637,3885013635,-2,889,1759,20
3886301753,3886301750,-3,1407,2259,20
3886797827,3886797824,-3,1303,1805,20
3889316370,3889316366,-4,1176,3501,20
3890492979,3890492975,-4,1151,2376,20
3891394679,3891394673,-6,664,1958,20
3903502527,3903502523,-4,1010,2112,20
3904353042,3904353045,3,2839,2534,20
3905250158,3905250158,0,1262,2045,20
3914053278,3914053284,6,3182,1561,20
3915834289,3915834283,-6,1157,2470,20
3919976321,3919976318,-3,1359,3170,20
3922510335,3922510331,-4,719,2269,20
3922666885,3922666871,-14,220,968,20
3924364115,3924364113,-2,1111,1949,20
3924447535,3924447531,-4,729,2966,20
3924987893,3924987911,18,706,1761,20
3925454112,3925454111,-1,964,2183,20
3926945319,3926945318,-1,1019,1927,20
3927349555,3927349555,0,2950,4382,20
3929140726,3929140725,-1,1630,1217,20
3934698650,3934698646,-4,1021,1868,20
3939112679,3939112677,-2,1330,2438,20
3939156973,3939156969,-4,1858,2550,20
3941820190,3941820186,-4,1339,2386,20
3943609187,3943609185,-2,903,2141,20
3954283863,3954283859,-4,950,1556,20
3954741714,3954741712,-2,1864,2792,20
3960620394,3960620390,-4,615,2221,20
3960652627,3960652626,-1,1176,2347,20
3964607866,3964607862,-4,853,2830,20
3966354031,3966354026,-5,1349,2941,20
3969457111,3969457106,-5,709,2253,20
3970926198,3970926194,-4,1165,2520,20
3972915728,3972915725,-3,1117,1892,20
3973782088,3973782083,-5,906,2311,20
3978146834,3978146829,-5,836,2046,20
3978954458,3978954458,0,1046,3152,20
3979812040,3979812037,-3,949,2683,20
3980023116,3980023106,-10,1972,7659,20
3980116271,3980116269,-2,1114,2130,20
3983278026,3983278021,-5,733,2586,20
3986221232,3986221232,0,1522,2412,20
3992314730,3992314734,4,936,821,20
4000530125,4000530121,-4,1364,3403,20
4003167238,4003167250,12,215,1644,20
4003401270,4003401254,-16,1135,2787,20
4004544193,4004544190,-3,1510,3061,20
4017854051,4017854049,-2,783,1868,20
4019300138,4019300135,-3,1074,1953,20
4020540078,4020540074,-4,1369,2580,20
4024018312,4024018310,-2,908,2159,20
4025400053,4025400045,-8,1101,4616,20
4027518966,4027518973,7,7289,3011,20
4028188262,4028188259,-3,1474,2828,20
4029375166,4029375165,-1,1263,2013,20
4029764280,4029764298,18,998,1494,20
4029927787,4029927783,-4,1059,2262,20
4029970239,4029970234,-5,1104,3109,20
4030672811,4030672803,-8,550,6699,20
4031285375,4031285372,-3,1033,2867,20
4031670437,4031670434,-3,1741,2544,20
4031769011,4031769010,-1,1206,2549,20
4033584638,4033584635,-3,902,2384,20
4035408099,4035408104,5,1904,2038,20
4038594505,4038594500,-5,1506,2931,20
4039044475,4039044474,-1,1195,3113,20
4039613436,4039613431,-5,1268,2952,20
4045816437,4045816444,7,3370,1346,20
4047034982,4047034980,-2,950,1163,20
4047657583,4047657581,-2,924,2113,20
4051209606,4051209604,-2,1758,2266,20
4054023264,4054023258,-6,1153,2871,20
4054968787,4054968782,-5,542,1553,20
4055362890,4055362886,-4,1260,2016,20
4056028431,4056028429,-2,1277,2084,20
4057320726,4057320723,-3,948,1665,20
4057788326,4057788322,-4,1189,2613,20
4059366058,4059366057,-1,1098,1756,20
4061822338,4061822335,-3,1729,3025,20
4062546934,4062546931,-3,1103,1746,20
4065108419,4065108413,-6,43509,19009,20
4066682315,4066682314,-1,980,2531,20
4069099455,4069099451,-4,983,2123,20
4069702658,4069702656,-2,1755,3034,20
4075740067,4075740061,-6,1338,4358,20
4076068358,4076068354,-4,995,1455,20
4077617411,4077617410,-1,897,1638,20
4078635682,4078635679,-3,1144,2453,20
4082079750,4082079747,-3,1164,2206,20
4087500894,4087500890,-4,371,1622,20
4087561831,4087561811,-20,252,890,20
4089528461,4089528455,-6,1559,4069,20
4094947017,4094947021,4,1080,1204,20
4099846082,4099846081,-1,1109,1913,20
4100852923,4100852920,-3,1339,2290,20
4102746105,4102746101,-4,907,2206,20
4105958055,4105958053,-2,967,2238,20
4108104417,4108104413,-4,882,2337,20
4111480445,4111480441,-4,1191,2971,20
4112954072,4112954050,-22,37,510,20
4115889785,4115889782,-3,1411,2661,20
4118915211,4118915206,-5,876,2098,20
4120470066,4120470062,-4,1255,1909,20
4121523629,4121523635,6,5289,2017,20
4122158277,4122158273,-4,690,2231,20
4125789586,4125789583,-3,1244,2217,20
4127152661,4127152659,-2,1252,2638,20
4128037800,4128037798,-2,626,1696,20
4128401427,4128401426,-1,742,1320,20
4133187021,4133187018,-3,1261,2637,20
4135050923,4135050921,-2,1681,3083,20
4138074219,4138074216,-3,1053,2520,20
4138150172,4138150190,18,397,1221,20
4144545701,4144545698,-3,794,1927,20
4146165825,4146165822,-3,1065,2405,20
4148046823,4148046818,-5,1135,4043,20
4151326701,4151326702,1,6464,6235,20
4151835154,4151835152,-2,709,1548,20
4158296998,4158296995,-3,984,2973,20
4164599504,4164599503,-1,793,2420,20
4166893372,4166893372,0,1111,1458,20
4167358330,4167358327,-3,958,2923,20
4169067495,4169067499,4,1464,1277,20
4171696027,4171696025,-2,693,1483,20
4181628779,4181628778,-1,882,1753,20
4183683137,4183683132,-5,907,2188,20
4183983829,4183983811,-18,751,1757,20
4192748522,4192748518,-4,819,1559,20
4194869302,4194869297,-5,778,2988,20
4195763580,4195763575,-5,1514,2339,20
4197762499,4197762494,-5,939,2428,20
4201181127,4201181126,-1,866,1557,20
4210920126,4210920126,0,2053,2953,20
4215063740,4215063736,-4,1097,2868,20
4217045242,4217045238,-4,977,2010,20
4219553574,4219553571,-3,773,1878,20
4219625072,4219625090,18,610,1427,20
4220126961,4220126954,-7,1113,6506,20
4221441574,4221441572,-2,1028,1720,20
4223860258,4223860255,-3,1085,2205,20
4224813865,4224813865,0,1626,2082,20
4224873167,4224873185,18,901,2094,20
4229930915,4229930912,-3,935,2522,20
4237629022,4237629021,-1,800,1797,20
4241517014,4241517013,-1,961,2552,20
4249358242,4249358238,-4,1094,2277,20
4255423631,4255423629,-2,1304,2355,20
4257863087,4257863085,-2,1242,2017,20
4262241649,4262241653,4,1975,1871,20
4263137066,4263137063,-3,1028,3012,20
4264370891,4264370886,-5,1021,2434,20
4270697706,4270697702,-4,1753,3522,20
4282515290,4282515289,-1,830,1475,20
4284176723,4284176719,-4,1141,2665,20
4285265678,4285265678,0,1487,1616,20
4288563205,4288563203,-2,1653,2394,20
4289842887,4289842891,4,3691,2714,20
4299282885,4299282883,-2,506,2392,20
4300240866,4300240863,-3,1294,1708,20
4300904678,4300904697,19,903,1921,20
4301576459,4301576456,-3,1180,2940,20
4304008401,4304008396,-5,993,2062,20
4312188848,4312188845,-3,1229,2752,20
4312685554,4312685552,-2,1080,2248,20
4316128437,4316128434,-3,826,1755,20
4317110942,4317110938,-4,1619,2379,20
4325562279,4325562274,-5,1086,2978,20
4327552878,4327552873,-5,867,1577,20
4331833096,4331833093,-3,1703,2699,20
4332341041,4332341040,-1,1383,2488,20
4335621719,4335621714,-5,1210,2106,20
4339054827,4339054822,-5,754,1448,20
4346091678,4346091675,-3,1932,2925,20
4347126674,4347126671,-3,1333,2662,20
4347770280,4347770302,22,596,1769,20
4355818489,4355818485,-4,1073,2583,20
4356935122,4356935121,-1,1122,1417,20
4359121973,4359121969,-4,1461,2249,20
4360876214,4360876213,-1,1494,2518,20
4363997416,4363997431,15,754,1367,20
4365390055,4365390054,-1,952,1808,20
4375723690,4375723689,-1,1125,2037,20
4376027407,4376027402,-5,1436,2519,20
4379890309,4379890306,-3,1052,2636,20
4384708006,4384708007,1,1522,1427,20
4385236251,4385236249,-2,965,2220,20
4389136606,4389136603,-3,1069,2346,20
4395090319,4395090317,-2,1353,1650,20
4395301259,4395301254,-5,753,1154,20
4396354347,4396354344,-3,914,2235,20
4399884535,4399884531,-4,1299,2221,20
4403096402,4403096399,-3,1320,2847,20
4405513235,4405513233,-2,1001,1904,20
4413386558,4413386554,-4,1059,2038,20
4416023838,4416023834,-4,1360,3460,20
4416338381,4416338377,-4,1350,2755,20
4420524854,4420524853,-1,1223,2801,20
4423462127,4423462124,-3,1493,2335,20
4425770335,4425770332,-3,1181,2291,20
4428132594,4428132591,-3,1012,1977,20
4429134198,4429134194,-4,991,2704,20
4431121202,4431121201,-1,1325,2904,20
4432302719,4432302717,-2,1047,2208,20
4435911609,4435911605,-4,1346,2731,20
4438626554,4438626548,-6,898,2509,20
4439576317,4439576311,-6,1235,2982,20
4455518020,4455518017,-3,1603,2828,20
4457082245,4457082242,-3,765,1988,20
4458751888,4458751885,-3,1034,1995,20
4466360885,4466360882,-3,1904,2797,20
4470949646,4470949646,0,1103,1356,20
4472482041,4472482038,-3,1608,1975,20
4473871939,4473871937,-2,1202,2469,20
4474674115,4474674111,-4,1091,2561,20
4475442201,4475442197,-4,1370,3136,20
4476409360,4476409366,6,84,612,20
4477556529,4477556523,-6,1661,3529,20
4480426898,4480426896,-2,952,1767,20
4492078318,4492078315,-3,1234,1679,20
4492263242,4492263237,-5,1666,2760,20
4493868521,4493868518,-3,912,1773,20
4494623109,4494623102,-7,3666,13138,20
4497155663,4497155658,-5,831,3349,20
4497795187,4497795182,-5,1194,2306,20
4498532803,4498532798,-5,1301,2122,20
4498871834,4498871830,-4,1268,2632,20
4501488772,4501488773,1,3266,3953,20
4506144550,4506144549,-1,1440,2605,20
4506822672,4506822681,9,39,1174,20
4507822686,4507822682,-4,1429,3053,20
4509105138,4509105136,-2,1332,3288,20
4514266138,4514266134,-4,1106,3094,20
4516887606,4516887602,-4,1198,2444,20
4524306394,4524306390,-4,1014,1872,20
4524758834,4524758832,-2,1094,1302,20
4529632161,4529632159,-2,1492,2628,20
4531865903,4531865900,-3,1045,2641,20
4532713667,4532713664,-3,649,1457,20
4538032324,4538032320,-4,1370,2570,20
4543391453,4543391450,-3,1058,1970,20
4544049113,4544049111,-2,1622,3036,20
4547363316,4547363314,-2,1265,2132,20
4551192436,4551192438,2,3758,3097,20
4551423564,4551423561,-3,1207,2136,20
4552481846,4552481864,18,1267,3455,20
4553421802,4553421802,0,1047,1659,20
4555388745,4555388742,-3,1083,2478,20
4556718090,4556718088,-2,611,1044,20
4557960571,4557960570,-1,756,2411,20
4560771866,4560771857,-9,348,2140,20
4571269060,4571269060,0,1158,2034,20
4579211746,4579211743,-3,891,3054,20
4583967750,4583967746,-4,1087,1722,20
4590433932,4590433932,0,884,1383,20
4591568830,4591568826,-4,1385,1915,20
4592961963,4592961964,1,4199,3600,20
4593420021,4593420021,0,2085,1706,20
4593811918,4593811915,-3,852,2231,20
4600611582,4600611577,-5,874,1620,20
4601984938,4601984936,-2,1746,2938,20
4603640480,4603640478,-2,997,1925,20
4605269686,4605269685,-1,1162,1784,20
4606118119,4606118127,8,1260,1950,20
4614074466,4614074462,-4,975,2457,20
4615521678,4615521677,-1,1041,2421,20
4625332151,4625332147,-4,914,2995,20
4626104095,4626104094,-1,1299,2629,20
4628607383,4628607382,-1,908,1681,20
4629244111,4629244109,-2,1260,2983,20
4633681635,4633681633,-2,891,2375,20
4636706265,4636706263,-2,1594,2746,20
4637521318,4637521314,-4,1009,2608,20
4639073123,4639073122,-1,947,1784,20
4645442546,4645442541,-5,1508,3656,20
4646168101,4646168097,-4,1086,2500,20
4650641751,4650641752,1,8742,9026,20
4654867711,4654867706,-5,1157,1648,20
4657462899,4657462898,-1,1488,2773,20
4658135304,4658135300,-4,1281,3309,20
4664255742,4664255738,-4,842,1647,20
4664370149,4664370167,18,901,2242,20
4670258839,4670258838,-1,974,959,20
4670737880,4670737877,-3,20003,16167,20
4673520772,4673520769,-3,1201,2996,20
4675899629,4675899625,-4,895,1902,20
4680020963,4680020962,-1,1146,2681,20
4684329582,4684329582,0,1164,1884,20
4684405738,4684405734,-4,1004,1827,20
4685429427,4685429424,-3,1592,5364,20
4690184952,4690184949,-3,852,2086,20
4690592990,4690592995,5,4159,2232,20
4690671992,4690671986,-6,973,3683,20
4691682047,4691682042,-5,863,2913,20
4693698607,4693698607,0,981,1245,20
4696975754,4696975754,0,1218,2252,20
4702127484,4702127482,-2,1061,1917,20
4702945218,4702945214,-4,950,2490,20
4706784069,4706784073,4,2214,1734,20
4707890278,4707890277,-1,1229,1760,20
4709038767,4709038758,-9,769,10166,20
4721263002,4721262999,-3,1383,2150,20
4722663366,4722663365,-1,873,2009,20
4728490316,4728490315,-1,1889,1767,20
4729008175,4729008174,-1,1131,1685,20
4729672858,4729672871,13,11136,33142,20
4743076845,4743076850,5,3284,1635,20
4745041877,4745041875,-2,963,2674,20
4745242218,4745242215,-3,1278,2617,20
4747107867,4747107862,-5,951,2332,20
4747847629,4747847627,-2,1314,2193,20
4748888675,4748888669,-6,1271,3382,20
4751685835,4751685831,-4,1202,2482,20
4756055958,4756055957,-1,995,2106,20
4757534533,4757534538,5,2586,1278,20
4759777706,4759777703,-3,1284,2827,20
4761071477,4761071473,-4,1229,2628,20
4764752022,4764752015,-7,1106,4569,20
4772020361,4772020359,-2,1379,2178,20
4774210560,4774210557,-3,1204,2400,20
4783201671,4783201669,-2,1350,2796,20
4786313210,4786313205,-5,767,2172,20
4788953831,4788953829,-2,1436,3343,20
4790570751,4790570746,-5,1374,2565,20
4790667253,4790667250,-3,1069,1962,20
4790970796,4790970796,0,1688,2067,20
4794808229,4794808227,-2,1023,2526,20
4796913433,4796913433,0,1763,1169,20
4800521267,4800521265,-2,1236,1706,20
4802397350,4802397352,2,1034,1115,20
4802997399,4802997397,-2,900,1985,20
4804571438,4804571436,-2,1600,3114,20
4807884565,4807884570,5,1813,1370,20
4810182804,4810182801,-3,901,1950,20
4820173418,4820173415,-3,1066,3015,20
4820427853,4820427850,-3,1005,2200,20
4826412602,4826412599,-3,1722,2388,20
4829606019,4829606014,-5,1396,3406,20
4832935134,4832935130,-4,932,1380,20
4836276060,4836276058,-2,889,1980,20
4838705110,4838705106,-4,1361,1924,20
4839087095,4839087093,-2,1567,2857,20
4840376699,4840376698,-1,742,1228,20
4845906216,4845906214,-2,521,1228,20
4851047727,4851047724,-3,1229,3201,20
4855653734,4855653731,-3,1042,3661,20
4856573046,4856573051,5,1690,1142,20
4857413763,4857413760,-3,868,2201,20
4858373395,4858373393,-2,1021,2100,20
4859859015,4859859013,-2,1884,4086,20
4860188519,4860188518,-1,606,1587,20
4860287039,4860287036,-3,569,1850,20
4860956918,4860956914,-4,1248,3215,20
4864095903,4864095901,-2,1111,2376,20
4868608350,4868608348,-2,943,2192,20
4869650191,4869650189,-2,1098,2344,20
4870212525,4870212524,-1,863,2204,20
4870580591,4870580598,7,5773,2481,20
4871723584,4871723580,-4,55233,33363,20
4879061503,4879061503,0,1294,2767,20
4881627737,4881627734,-3,1373,2388,20
4883641235,4883641231,-4,849,1449,20
4890845910,4890845908,-2,1089,2480,20
4893467359,4893467354,-5,587,1894,20
4902044343,4902044338,-5,883,1853,20
4904607846,4904607845,-1,1330,1902,20
4904730379,4904730377,-2,942,1844,20
4905353182,4905353179,-3,1310,3168,20
4908876628,4908876625,-3,1375,3397,20
4912304074,4912304092,18,1163,3544,20
4913147394,4913147391,-3,1014,2151,20
4917441422,4917441420,-2,1281,2017,20
4920937718,4920937715,-3,1348,1975,20
4921567749,4921567746,-3,1064,2505,20
4921625969,4921625965,-4,1366,2338,20
4930066654,4930066652,-2,947,1943,20
4930853617,4930853618,1,1805,2013,20
4933660211,4933660210,-1,750,1711,20
4934892230,4934892226,-4,1142,2551,20
4935471803,4935471798,-5,927,2775,20
4936596778,4936596778,0,584,1488,20
4941968673,4941968670,-3,1516,2731,20
4946350970,4946350970,0,1660,2396,20
4951273530,4951273529,-1,955,1587,20
4951428178,4951428174,-4,1316,2784,20
4956342754,4956342750,-4,1158,2688,20
4959796874,4959796869,-5,1344,2869,20
4963792165,4963792164,-1,908,1887,20
4966693627,4966693625,-2,897,1779,20
4970662379,4970662373,-6,901,3852,20
4983105143,4983105142,-1,1176,1276,20
4989253518,4989253514,-4,2236,2603,20
4990390338,4990390336,-2,1174,2321,20
4994637550,4994637547,-3,843,1962,20
4995805245,4995805248,3,24276,16589,20
4998957361,4998957358,-3,815,2414,20
5003077687,5003077685,-2,1145,1795,20
5008908263,5008908261,-2,1066,3068,20
5011903639,5011903635,-4,966,1891,20
5013618478,5013618474,-4,1062,2400,20
5016504669,5016504666,-3,1314,2777,20
5021614540,5021614537,-3,1127,2483,20
5025572523,5025572519,-4,1078,2448,20
5025836314,5025836313,-1,1073,1361,20
5026558829,5026558846,17,925,2636,20
5029260929,5029260926,-3,2019,5558,20
5030701378,5030701377,-1,1080,1762,20
5032667851,5032667849,-2,4358,7044,20
5034760014,5034760018,4,2020,1519,20
5040443385,5040443383,-2,1198,2587,20
5042548599,5042548594,-5,935,1927,20
5045647595,5045647593,-2,1193,2239,20
5054447485,5054447485,0,981,1731,20
5063621980,5063621978,-2,1110,2251,20
5064731274,5064731269,-5,1009,2057,20
5064851485,5064851502,17,882,2485,20
5067813005,5067813001,-4,952,2543,20
5071100863,5071100862,-1,937,2947,20
5075615538,5075615537,-1,1102,1956,20
5075847345,5075847341,-4,1255,3082,20
5076586780,5076586778,-2,1212,2322,20
5088445132,5088445134,2,3678,2653,20
5088611752,5088611764,12,545,732,20
5089074318,5089074314,-4,1356,2141,20
5093687858,5093687855,-3,1317,2437,20
5097410250,5097410247,-3,1083,3592,20
5099445529,5099445526,-3,1102,1484,20
5101240457,5101240455,-2,1013,2711,20
5103406449,5103406446,-3,1140,2175,20
5104476077,5104476074,-3,933,1369,20
5105982533,5105982553,20,1108,2950,20
5108991299,5108991300,1,1085,1706,20
5110648316,5110648312,-4,1244,1532,20
5111141788,5111141786,-2,944,1306,20
5115491665,5115491672,7,3304,1670,20
5118776183,5118776179,-4,1482,3907,20
5118884635,5118884631,-4,830,1842,20
5126150189,5126150190,1,951,1434,20
5129756423,5129756419,-4,992,1306,20
5130046509,5130046506,-3,1193,2368,20
5131772587,5131772583,-4,825,1884,20
5131815567,5131815586,19,1155,2042,20
5134473354,5134473352,-2,1233,2745,20
5138982839,5138982835,-4,1344,3222,20
5140910083,5140910080,-3,1601,3292,20
5142007717,5142007706,-11,306,1084,20
5142294506,5142294503,-3,1099,2563,20
5142417024,5142417022,-2,1145,1664,20
5145367853,5145367850,-3,1026,2834,20
5148386646,5148386642,-4,1025,2311,20
5149681389,5149681385,-4,996,3380,20
5151441950,5151441929,-21,1397,850,20
5153877638,5153877634,-4,1310,2438,20
5158113511,5158113510,-1,1611,2080,20
5160395809,5160395803,-6,1413,5145,20
5161061094,5161061089,-5,1379,5685,20
5168778598,5168778596,-2,1242,2683,20
5173352123,5173352121,-2,832,2442,20
5181876342,5181876339,-3,1073,1818,20
5182215443,5182215442,-1,1323,2154,20
5187438529,5187438526,-3,999,2244,20
5190471233,5190471231,-2,930,2072,20
5190598598,5190598616,18,1228,1898,20
5197526475,5197526473,-2,1562,2613,20
5199890974,5199890967,-7,2946,8694,20
5200813012,5200813010,-2,1800,2322,20
5212197463,5212197462,-1,1088,1705,20
5215414930,5215414930,0,1029,1826,20
5217798605,5217798604,-1,1356,2664,20
5218220666,5218220663,-3,719,2127,20
5223573651,5223573650,-1,1095,1996,20
5223604899,5223604898,-1,1163,1925,20
5223803398,5223803410,12,263,1026,20
5227450046,5227450044,-2,758,2113,20
5229428022,5229428019,-3,1475,2877,20
5232380787,5232380785,-2,1327,2767,20
5234672043,5234672037,-6,881,2406,20
5238198139,5238198140,1,1500,1609,20
5242204374,5242204372,-2,1002,1641,20
5243952121,5243952119,-2,1236,2242,20
5244040033,5244040027,-6,1035,4430,20
5246656781,5246656779,-2,1543,2812,20
5250625458,5250625458,0,1084,1599,20
5253129876,5253129873,-3,930,1651,20
5253367846,5253367844,-2,1033,1951,20
5255104366,5255104365,-1,1258,2130,20
5256269703,5256269699,-4,1057,2616,20
5260244691,5260244689,-2,973,2503,20
5262588086,5262588085,-1,815,1339,20
5268060427,5268060421,-6,1417,2503,20
5269058123,5269058119,-4,627,1519,20
5277470383,5277470382,-1,1050,1779,20
5278254470,5278254473,3,857,1127,20
5279492588,5279492586,-2,1224,2675,20
5280990521,5280990517,-4,1041,2337,20
5284407682,5284407678,-4,733,2302,20
5293175526,5293175525,-1,1194,2036,20
5294961602,5294961602,0,1025,2100,20
5295887582,5295887579,-3,1195,2438,20
5296974428,5296974425,-3,1233,2086,20
5300153477,5300153475,-2,1143,2015,20
5301284765,5301284778,13,217,1213,20
5303745834,5303745832,-2,1711,3232,20
5305904266,5305904269,3,891,1638,20
5307284357,5307284356,-1,1011,2222,20
5310366140,5310366136,-4,997,2510,20
5316271977,5316271972,-5,1262,3335,20
5316748064,5316748083,19,665,1298,20
5329615483,5329615481,-2,1331,2759,20
5333373047,5333373045,-2,1637,3053,20
5333528065,5333528071,6,2196,1101,20
5335032051,5335032050,-1,1020,2224,20
5339893274,5339893272,-2,1394,2480,20
5340685608,5340685606,-2,908,1876,20
5340748893,5340748909,16,647,1711,20
5341630547,5341630542,-5,918,2973,20
5346195364,5346195361,-3,1054,2347,20
5349698791,5349698788,-3,1121,2790,20
5352133495,5352133492,-3,957,2142,20
5352338643,5352338639,-4,1386,2386,20
5352552000,5352551998,-2,979,2025,20
5356362387,5356362383,-4,710,2515,20
5363961677,5363961673,-4,790,2237,20
5365623733,5365623729,-4,696,2247,20
5368496417,5368496413,-4,1279,1824,20
5368657590,5368657588,-2,1126,3044,20
5374296595,5374296593,-2,1209,3180,20
5379801226,5379801231,5,2148,1684,20
5381001665,5381001660,-5,949,2536,20
5381529457,5381529454,-3,663,1373,20
5382151891,5382151890,-1,948,1794,20
5382454901,5382454898,-3,2573,3807,20
5388547173,5388547169,-4,1015,2652,20
5388727291,5388727289,-2,1780,3184,20
5392810752,5392810749,-3,1062,3497,20
5393667766,5393667745,-21,1333,2212,20
5393779630,5393779646,16,300,1084,20
5395384450,5395384446,-4,1118,2913,20
5397154393,5397154389,-4,1471,2840,20
5402021803,5402021802,-1,971,1590,20
5405266584,5405266582,-2,998,1945,20
5414740708,5414740705,-3,1755,3019,20
5415021350,5415021346,-4,865,1340,20
5415453279,5415453278,-1,731,1839,20
5418808118,5418808113,-5,931,3242,20
5420758638,5420758635,-3,1298,3464,20
5422988615,5422988609,-6,1126,3752,20
5424746034,5424746032,-2,1083,2254,20
5426966973,5426966971,-2,801,1404,20
5428040765,5428040760,-5,670,3344,20
5431296257,5431296254,-3,1762,4123,20
5435541431,5435541425,-6,1201,2664,20
5438117965,5438117963,-2,1025,1688,20
5443300674,5443300673,-1,1132,1792,20
5447700569,5447700574,5,4184,3796,20
5451615160,5451615157,-3,1398,2638,20
5451997424,5451997420,-4,1135,3305,20
5452225991,5452225986,-5,1162,3088,20
5468364673,5468364671,-2,1146,3106,20
5469285143,5469285159,16,539,1299,20
5473295974,5473295967,-7,1085,2809,20
5477520557,5477520553,-4,919,2718,20
5478795530,5478795529,-1,1743,2310,20
5479426467,5479426466,-1,763,1666,20
5487032878,5487032875,-3,1122,2617,20
5487516695,5487516714,19,815,1595,20
5487739887,5487739882,-5,950,3302,20
5491237015,5491237014,-1,993,1829,20
5492403266,5492403263,-3,987,2433,20
5496333386,5496333385,-1,969,2297,20
5496781389,5496781387,-2,1043,2160,20
5497606534,5497606527,-7,781,1642,20
5498004919,5498004918,-1,1162,2243,20
5500120111,5500120110,-1,1196,3194,20
5500238511,5500238507,-4,1390,2191,20
5501595031,5501595029,-2,1003,3131,20
5510831306,5510831305,-1,2549,4143,20
5513991097,5513991093,-4,810,2102,20
5516092634,5516092639,5,4326,2220,20
5516159878,5516159875,-3,990,2582,20
5518581105,5518581101,-4,1258,2175,20
5518838294,5518838293,-1,1215,2758,20
5522147871,5522147868,-3,954,2178,20
5527784040,5527784042,2,1946,1850,20
5539014887,5539014885,-2,1471,4152,20
5545674738,5545674734,-4,1317,2139,20
5545733971,5545733968,-3,753,2195,20
5546214902,5546214920,18,346,1171,20
5547078060,5547078059,-1,847,1009,20
5547303305,5547303302,-3,1156,2073,20
5547810532,5547810535,3,2016,1432,20
5552293167,5552293165,-2,2347,3760,20
5553282286,5553282281,-5,1239,2366,20
5554024590,5554024589,-1,879,1314,20
5566774927,5566774925,-2,1207,2634,20
5573550846,5573550845,-1,966,1664,20
5577164875,5577164871,-4,1149,2678,20
5577262593,5577262590,-3,1237,2539,20
5577647063,5577647058,-5,955,2156,20
5579429670,5579429669,-1,1161,1807,20
5580827997,5580827994,-3,1567,3160,20
5582738057,5582738054,-3,1091,2124,20
5584331425,5584331424,-1,1073,1695,20
5586967210,5586967206,-4,1519,2290,20
5590801882,5590801878,-4,1100,2166,20
5591956038,5591956035,-3,1265,2143,20
5593982725,5593982720,-5,918,4141,20
5595587447,5595587443,-4,1139,2709,20
5596808837,5596808841,4,3757,3221,20
5597757514,5597757509,-5,809,2537,20
5602666666,5602666664,-2,1253,1943,20
5604372367,5604372365,-2,1110,2248,20
5610167054,5610167051,-3,792,1749,20
5612847243,5612847242,-1,1112,3166,20
5615621605,5615621604,-1,902,2340,20
5620178887,5620178885,-2,837,2613,20
5620519230,5620519241,11,248,1260,20
5628716403,5628716398,-5,917,2365,20
5630783599,5630783597,-2,515,1554,20
5631196758,5631196737,-21,245,883,20
5632630015,5632630014,-1,663,1111,20
5634763948,5634763945,-3,1518,1928,20
5635782293,5635782290,-3,1317,2803,20
5640603871,5640603869,-2,1271,2666,20
5644596213,5644596209,-4,804,3027,20
5646301020,5646301019,-1,1399,2375,20
5647386046,5647386044,-2,1154,2231,20
5649772323,5649772319,-4,784,2039,20
5652490418,5652490411,-7,1039,2824,20
5653989917,5653989911,-6,1246,3421,20
5655520005,5655520011,6,3401,1116,20
5661623685,5661623684,-1,1177,2480,20
5669159104,5669159103,-1,1108,1499,20
5669483208,5669483206,-2,1228,2905,20
5671016137,5671016135,-2,1020,1770,20
5672478562,5672478567,5,9483,20091,20
5672512162,5672512165,3,2969,1899,20
5676065391,5676065388,-3,989,1883,20
5676548707,5676548702,-5,967,2264,20
5677561242,5677561247,5,3236,1804,20
5677787426,5677787425,-1,1111,2503,20
5680914740,5680914738,-2,1041,2729,20
5682651467,5682651467,0,971,1798,20
5685901504,5685901502,-2,1249,1841,20
5686817551,5686817548,-3,873,2164,20
5687796143,5687796141,-2,1094,1669,20
5692625598,5692625602,4,5419,3039,20
5697630359,5697630354,-5,1005,1997,20
5698188677,5698188673,-4,1224,2191,20
5701359194,5701359190,-4,982,2219,20
5702088532,5702088528,-4,1887,2396,20
5702278382,5702278392,10,1197,216,20
5707796584,5707796580,-4,1006,1607,20
5708593345,5708593341,-4,1217,2355,20
5711684361,5711684357,-4,1091,2099,20
5714931942,5714931939,-3,1146,3147,20
5718045114,5718045110,-4,744,2081,20
5720169846,5720169842,-4,1553,3142,20
5720264073,5720264068,-5,649,2122,20
5722458536,5722458536,0,1159,1886,20
5725787128,5725787125,-3,1035,2877,20
5726724808,5726724803,-5,1226,4075,20
5727797657,5727797663,6,2853,958,20
5728968679,5728968677,-2,845,1639,20
5729628899,5729628897,-2,772,2595,20
5734993206,5734993205,-1,1046,1864,20
5738650350,5738650346,-4,1516,3109,20
5740023798,5740023794,-4,1203,1983,20
5745967833,5745967829,-4,874,2121,20
5747946157,5747946154,-3,1169,3129,20
5748534594,5748534591,-3,983,2969,20
5749279397,5749279394,-3,1279,2699,20
5750006295,5750006294,-1,1034,1242,20
5754585358,5754585348,-10,816,8767,20
5757356301,5757356298,-3,1702,2902,20
5763222337,5763222334,-3,1583,2994,20
5764182493,5764182490,-3,1057,1978,20
5764815802,5764815800,-2,966,1940,20
5765222286,5765222284,-2,1465,2621,20
5774539209,5774539205,-4,1272,2797,20
5777837071,5777837070,-1,1046,1713,20
5778422531,5778422529,-2,902,1573,20
5778490183,5778490167,-16,926,1906,20
5779317583,5779317602,19,1247,2509,20
5780662619,5780662627,8,3513,1049,20
5781383406,5781383402,-4,1159,2369,20
5786071486,5786071484,-2,1664,2457,20
5790461783,5790461779,-4,848,2067,20
5794919399,5794919397,-2,1266,2508,20
5799814426,5799814422,-4,1479,2983,20
5804698290,5804698290,0,1071,1726,20
5806590126,5806590121,-5,1214,3150,20
5813277171,5813277169,-2,1234,2786,20
5818164247,5818164247,0,714,1336,20
5819490558,5819490556,-2,969,3032,20
5824703406,5824703406,0,8695,11816,20
5830149091,5830149086,-5,626,1699,20
5832199099,5832199097,-2,1209,3119,20
5835128267,5835128263,-4,1279,2920,20
5835317360,5835317357,-3,1381,2609,20
5838892426,5838892423,-3,1181,2398,20
5839256595,5839256594,-1,1031,1818,20
5839663343,5839663340,-3,983,1860,20
5841807614,5841807612,-2,998,2548,20
5849484490,5849484489,-1,1670,2631,20
5850892639,5850892621,-18,259,518,20
5853667438,5853667439,1,1177,1648,20
5862318998,5862319005,7,2199,1658,20
5863130558,5863130554,-4,1136,1838,20
5866765413,5866765408,-5,771,1684,20
5870988710,5870988707,-3,1306,2316,20
5871664094,5871664091,-3,1704,2803,20
5879115037,5879115035,-2,1677,2773,20
5882782375,5882782377,2,2227,1794,20
5883077914,5883077913,-1,1013,1922,20
5883678101,5883678102,1,1564,1483,20
5891015314,5891015314,0,688,2166,20
5893744506,5893744503,-3,1234,2191,20
5901012290,5901012286,-4,907,2416,20
5901256402,5901256407,5,2568,1433,20
5903336614,5903336607,-7,799,1856,20
5903937222,5903937218,-4,1126,3004,20
5906934166,5906934162,-4,1383,3238,20
5914381808,5914381802,-6,1412,3090,20
5914875950,5914875946,-4,792,1970,20
5917152635,5917152634,-1,725,1485,20
5920151123,5920151125,2,936,2151,20
5923717164,5923717163,-1,1434,1454,20
5924553205,5924553201,-4,1214,1892,20
5924885238,5924885237,-1,1272,1620,20
5931779199,5931779195,-4,921,2525,20
5932735959,5932735977,18,159,1106,20
5933768074,5933768070,-4,885,2131,20
5934170209,5934170206,-3,1147,2271,20
5936626463,5936626461,-2,1363,1947,20
5937749806,5937749804,-2,1171,2163,20
5941031795,5941031793,-2,1027,2201,20
5941208873,5941208872,-1,1184,2222,20
5944888247,5944888245,-2,1867,3415,20
5956208194,5956208191,-3,1101,2133,20
5963514726,5963514730,4,4721,2651,20
5971319914,5971319909,-5,1278,2938,20
5974871246,5974871245,-1,560,2124,20
5976543487,5976543482,-5,1196,3195,20
5977477706,5977477703,-3,1205,2325,20
5979053010,5979052998,-12,988,1624,20
5979449223,5979449241,18,316,1753,20
5979659543,5979659544,1,1387,1704,20
5980113709,5980113703,-6,746,1338,20
5986345482,5986345489,7,2145,1504,20
5989369239,5989369237,-2,1320,1596,20
5991517494,5991517490,-4,603,1332,20
5993788345,5993788342,-3,1267,2408,20
5993861181,5993861164,-17,703,2012,20
6000590806,6000590804,-2,1168,1749,20
6000786022,6000786018,-4,1247,2387,20
6003382355,6003382350,-5,1116,1845,20
6003833924,6003833920,-4,1301,2031,20
6008682495,6008682494,-1,676,1465,20
6014301526,6014301523,-3,1088,2617,20
6014354448,6014354456,8,4,1805,20
6015875987,6015875991,4,2312,1260,20
6018782475,6018782477,2,1010,1277,20
6025335663,6025335660,-3,970,3248,20
6025761542,6025761560,18,181,687,20
6025907860,6025907859,-1,1338,2266,20
6026339498,6026339495,-3,1303,2358,20
6027071719,6027071719,0,1005,2214,20
6027136920,6027136915,-5,1187,2334,20
6037007950,6037007949,-1,1474,2723,20
6043052038,6043052041,3,4309,3168,20
6045635058,6045635056,-2,905,2066,20
6045797557,6045797553,-4,1398,1398,20
6047902720,6047902717,-3,1566,2356,20
6048634543,6048634541,-2,1042,1616,20
6049847519,6049847516,-3,1068,1571,20
6050591375,6050591372,-3,1305,2292,20
6050923397,6050923383,-14,61405,40910,20
6051762227,6051762222,-5,1172,2930,20
6056944210,6056944207,-3,2338,6244,20
6059762222,6059762222,0,1039,1817,20
6067200770,6067200766,-4,710,2161,20
6072158658,6072158667,9,15252,23477,20
6072246431,6072246427,-4,961,2602,20
6074329731,6074329728,-3,1034,1930,20
6075263344,6075263338,-6,753,2816,20
6076297311,6076297311,0,1054,1768,20
6076498507,6076498504,-3,1012,2050,20
6080158717,6080158713,-4,985,2389,20
6081731932,6081731929,-3,1010,1799,20
6082679715,6082679711,-4,730,1484,20
6086877105,6086877103,-2,3137,4269,20
6089788178,6089788173,-5,1322,2760,20
6093280609,6093280606,-3,1081,2107,20
6095657967,6095657969,2,22926,35652,20
6096895779,6096895775,-4,968,2007,20
6097848118,6097848117,-1,1250,2508,20
6098154788,6098154785,-3,1131,2561,20
6101932842,6101932843,1,805,1412,20
6103895882,6103895879,-3,1312,2743,20
6108618914,6108618907,-7,1012,2780,20
6110779536,6110779533,-3,933,1753,20
6111158382,6111158380,-2,1200,2678,20
6113285061,6113285058,-3,1025,1304,20
6113747593,6113747590,-3,1199,2678,20
6114002977,6114002973,-4,1437,2744,20
6114704344,6114704342,-2,1144,2596,20
6119901119,6119901122,3,1160,1302,20
6120447547,6120447546,-1,1203,1875,20
6125356194,6125356193,-1,1078,1995,20
6126223002,6126222998,-4,842,3362,20
6131578310,6131578306,-4,1350,2766,20
6132033141,6132033136,-5,1248,2921,20
6133891226,6133891222,-4,1087,2615,20
6135430759,6135430756,-3,1779,3082,20
6135729263,6135729261,-2,823,1944,20
6136121625,6136121622,-3,721,1524,20
6137871790,6137871787,-3,1411,2222,20
6143874722,6143874718,-4,649,1533,20
6146577954,6146577957,3,1687,1542,20
6148228970,6148228966,-4,1275,2027,20
6150314431,6150314429,-2,1129,1856,20
6154007697,6154007693,-4,1046,2493,20
6154933194,6154933197,3,1590,1359,20
6169342971,6169342969,-2,1030,1885,20
6169679741,6169679738,-3,682,1468,20
6173872976,6173872974,-2,1140,1989,20
6179937003,6179937001,-2,1070,2048,20
6180708555,6180708555,0,1088,2053,20
6185231224,6185231219,-5,1196,2631,20
6187424217,6187424222,5,3362,1615,20
6187619671,6187619668,-3,901,2866,20
6188554431,6188554430,-1,36988,21304,20
6188624668,6188624666,-2,756,2172,20
6190183043,6190183040,-3,1054,1865,20
6193379782,6193379781,-1,1285,2048,20
6195150351,6195150348,-3,1091,2498,20
6195808497,6195808493,-4,935,1409,20
6196088811,6196088809,-2,695,1405,20
6196936429,6196936426,-3,929,2618,20
6198735252,6198735245,-7,1199,1753,20
6201255979,6201255976,-3,1045,1976,20
6202224431,6202224427,-4,887,2013,20
6204139122,6204139117,-5,845,2545,20
6210015698,6210015694,-4,878,1973,20
6211929035,6211929029,-6,1293,2608,20
6215409759,6215409756,-3,1017,1587,20
6217213867,6217213865,-2,1128,2602,20
6217722067,6217722063,-4,915,1383,20
6217878805,6217878822,17,148,2373,20
6219924426,6219924423,-3,1263,2042,20
6220798770,6220798770,0,1199,2273,20
6221866835,6221866833,-2,1040,2695,20
6230575062,6230575062,0,1191,2636,20
6231359063,6231359067,4,2089,1312,20
6241650674,6241650671,-3,1170,2270,20
6241951738,6241951732,-6,871,2605,20
6242243587,6242243581,-6,51046,36071,20
6250863743,6250863749,6,3652,1670,20
6253684061,6253684069,8,3779,1455,20
6259517059,6259517057,-2,1071,2208,20
6264577709,6264577707,-2,807,1872,20
6265142887,6265142885,-2,1293,2089,20
6267360121,6267360122,1,1381,1713,20
6269245461,6269245468,7,6577,2976,20
6280206387,6280206385,-2,1112,2413,20
6280524081,6280524078,-3,1638,1766,20
6282496147,6282496144,-3,1277,2179,20
6285189477,6285189474,-3,1649,3764,20
6289080062,6289080059,-3,977,2277,20
6291247942,6291247941,-1,1042,2754,20
6293137638,6293137635,-3,748,1345,20
6293902852,6293902848,-4,1095,2964,20
6296746123,6296746120,-3,933,2081,20
6297407789,6297407785,-4,1196,2461,20
6305153312,6305153311,-1,1027,1209,20
6305364774,6305364787,13,292,904,20
6305727218,6305727216,-2,806,2690,20
6306212133,6306212118,-15,655,1871,20
6306476266,6306476261,-5,747,2267,20
6316828903,6316828901,-2,1326,2386,20
6316857159,6316857157,-2,1753,2801,20
6318220133,6318220132,-1,836,2074,20
6320869975,6320869969,-6,770,2238,20
6323089110,6323089106,-4,983,2563,20
6323855530,6323855529,-1,980,2230,20
6326030897,6326030893,-4,654,2756,20
6330770382,6330770380,-2,1261,1890,20
6331512412,6331512410,-2,1298,2282,20
6333374931,6333374928,-3,3193,7267,20
6340673409,6340673410,1,805,1499,20
6340716247,6340716230,-17,1328,3398,20
6343446697,6343446697,0,1217,1365,20
6344833481,6344833477,-4,1099,1930,20
6348523799,6348523794,-5,1040,3170,20
6350506054,6350506053,-1,1130,2352,20
6351195738,6351195720,-18,4308,3590,20
6354272886,6354272884,-2,834,2391,20
6355343490,6355343493,3,1590,1567,20
6359788905,6359788902,-3,1196,1819,20
6362715055,6362715054,-1,1203,2817,20
6364730342,6364730339,-3,1309,2145,20
6365149363,6365149358,-5,952,2377,20
6369160074,6369160070,-4,1036,3096,20
6369558312,6369558309,-3,1098,2628,20
6370469782,6370469782,0,1233,1247,20
6372886611,6372886606,-5,1194,2592,20
6374206589,6374206586,-3,1064,1930,20
6375648030,6375648027,-3,1202,2843,20
6379950661,6379950658,-3,1000,1782,20
6380124734,6380124754,20,551,967,20
6382338254,6382338251,-3,1265,2916,20
6387599370,6387599365,-5,831,2114,20
6388582246,6388582245,-1,1325,1995,20
6389055554,6389055551,-3,1381,2757,20
6390650040,6390650059,19,324,864,20
6392169489,6392169496,7,2436,1759,20
6394163842,6394163839,-3,1281,2704,20
6395091037,6395091034,-3,2426,5006,20
6397598275,6397598273,-2,893,2851,20
6400046306,6400046306,0,961,1145,20
6400318390,6400318394,4,267,1220,20
6400514892,6400514889,-3,1590,2449,20
6401573030,6401573028,-2,923,2387,20
6411768370,6411768372,2,1605,1725,20
6413162459,6413162453,-6,1018,2090,20
6413636778,6413636774,-4,1651,3213,20
6416800466,6416800464,-2,1352,1958,20
6417007601,6417007600,-1,1396,1776,20
6418571229,6418571231,2,3110,1689,20
6419648684,6419648682,-2,1273,3406,20
6423337476,6423337479,3,1619,1169,20
6423554950,6423554947,-3,815,1573,20
6426400739,6426400752,13,1040,1455,20
6428327403,6428327397,-6,2744,8201,20
6437799578,6437799578,0,5648,6873,20
6439590378,6439590374,-4,1574,2517,20
6440396787,6440396783,-4,1029,2563,20
6440637851,6440637849,-2,1616,3454,20
6441577514,6441577511,-3,1024,2516,20
6443042196,6443042202,6,3890,1014,20
6446058665,6446058662,-3,1049,1643,20
6446121426,6446121425,-1,689,1375,20
6447526371,6447526367,-4,878,2184,20
6448711982,6448711984,2,1589,2026,20
6449592463,6449592458,-5,832,3044,20
6451869158,6451869154,-4,1240,2171,20
6452562751,6452562754,3,1677,1552,20
6452995698,6452995695,-3,616,2206,20
6462065389,6462065386,-3,1030,2268,20
6463518614,6463518610,-4,1701,4994,20
6464405196,6464405194,-2,1254,1884,20
6464915704,6464915718,14,568,1544,20
6465602210,6465602208,-2,1041,1862,20
6466397361,6466397370,9,3312,1031,20
6469464374,6469464370,-4,1140,1435,20
6471038762,6471038758,-4,974,2329,20
6471468298,6471468295,-3,889,1192,20
6472560604,6472560623,19,684,1442,20
6475502834,6475502831,-3,1155,2978,20
6477623046,6477623042,-4,1369,3207,20
6480100749,6480100746,-3,941,1423,20
6484549073,6484549075,2,1203,1352,20
6485237427,6485237423,-4,1270,2463,20
6485452107,6485452103,-4,983,3008,20
6488491020,6488491017,-3,1709,3627,20
6490438993,6490438996,3,924,926,20
6492023156,6492023152,-4,1459,3744,20
6495436393,6495436390,-3,1027,2268,20
6500317052,6500317050,-2,1033,1934,20
6500414615,6500414622,7,344,979,20
6502097555,6502097554,-1,1607,1836,20
6505371072,6505371079,7,1798,832,20
6519094873,6519094869,-4,989,2614,20
6519384432,6519384441,9,171,859,20
6521748541,6521748538,-3,1256,1968,20
6524400966,6524400965,-1,1537,1605,20
6525571880,6525571878,-2,1013,1577,20
6525725519,6525725515,-4,550,1255,20
6531080372,6531080370,-2,1530,2766,20
6533865711,6533865707,-4,1063,2537,20
6534222950,6534222945,-5,1092,1862,20
6537663521,6537663518,-3,1286,2596,20
6538152478,6538152475,-3,1396,2082,20
6538803573,6538803577,4,242,1340,20
6543575730,6543575726,-4,801,1802,20
6545538619,6545538614,-5,879,2735,20
6549931030,6549931023,-7,780,2264,20
6550169896,6550169894,-2,1041,2227,20
6550916751,6550916750,-1,970,2158,20
6552422425,6552422422,-3,1122,1979,20
6555479194,6555479193,-1,734,1424,20
6556624058,6556624053,-5,992,2649,20
6557087530,6557087529,-1,820,1620,20
6563603617,6563603613,-4,1488,3181,20
6564238302,6564238298,-4,1103,2324,20
6566169187,6566169183,-4,1651,3958,20
6567843002,6567843009,7,2262,1128,20
6570177366,6570177365,-1,940,1719,20
6570246845,6570246859,14,250,1100,20
6574744022,6574744020,-2,972,2478,20
6575520150,6575520147,-3,1344,1768,20
6579951235,6579951233,-2,1529,1800,20
6581062810,6581062807,-3,871,1652,20
6583399395,6583399401,6,1350,956,20
6591424901,6591424900,-1,1902,2976,20
6591789684,6591789680,-4,835,2453,20
6598804907,6598804904,-3,1722,2627,20
6601515201,6601515198,-3,1129,2484,20
6604933258,6604933255,-3,759,2081,20
6612462066,6612462065,-1,832,2468,20
6617197475,6617197472,-3,1138,2069,20
6617880761,6617880759,-2,1525,2179,20
6627254087,6627254083,-4,1181,2653,20
6627369463,6627369461,-2,1564,3111,20
6627456135,6627456130,-5,485,1678,20
6627969870,6627969867,-3,999,1425,20
6631284611,6631284602,-9,884,2131,20
6633537285,6633537281,-4,1019,2625,20
6635404815,6635404812,-3,1150,3106,20
6635527528,6635527529,1,1758,1939,20
6635656386,6635656385,-1,842,1753,20
6637329521,6637329521,0,1402,2793,20
6639453927,6639453935,8,2592,1397,20
6640710247,6640710242,-5,811,2254,20
6647213454,6647213452,-2,1094,2237,20
6647760034,6647760033,-1,1433,2185,20
6648739850,6648739852,2,1916,1710,20
6648946647,6648946644,-3,920,2951,20
6651207601,6651207599,-2,856,2800,20
6652570303,6652570302,-1,3267,3503,20
6653218714,6653218712,-2,1297,2512,20
6653798015,6653798013,-2,1388,3020,20
6672455818,6672455814,-4,1617,2725,20
6673921909,6673921907,-2,941,2913,20
6677969827,6677969826,-1,1051,2414,20
6681156334,6681156333,-1,918,1754,20
6681808306,6681808302,-4,1165,3429,20
6683423922,6683423920,-2,994,2550,20
6686251402,6686251397,-5,1122,2452,20
6686972649,6686972645,-4,1445,2709,20
6687412982,6687412978,-4,1233,2348,20
6687910359,6687910358,-1,675,1865,20
6691703399,6691703397,-2,1272,2727,20
6693619196,6693619193,-3,1453,2241,20
6695394853,6695394850,-3,1081,3506,20
6696288238,6696288236,-2,1556,2580,20
6697543633,6697543637,4,2026,1924,20
6701775906,6701775904,-2,1360,2692,20
6703008654,6703008651,-3,838,2346,20
6703818786,6703818782,-4,1526,2941,20
6703976442,6703976441,-1,1351,2835,20
6709108019,6709108014,-5,1580,3831,20
6711844415,6711844413,-2,1263,2501,20
6712757370,6712757365,-5,745,2220,20
6712906861,6712906849,-12,46,506,20
6713576992,6713576989,-3,1030,2181,20
6720366218,6720366214,-4,889,1621,20
6721134287,6721134283,-4,715,1988,20
6722572335,6722572332,-3,1388,2040,20
6724923379,6724923375,-4,1302,2708,20
6725284989,6725284996,7,4603,2121,20
6735899075,6735899073,-2,707,2029,20
6740805882,6740805878,-4,1171,2653,20
6742250662,6742250656,-6,1053,2905,20
6742541913,6742541910,-3,1166,2880,20
6751052342,6751052337,-5,985,2726,20
6756125985,6756125986,1,3561,3739,20
6758529338,6758529333,-5,1487,2168,20
6764543502,6764543499,-3,917,1947,20
6770700166,6770700170,4,1259,1036,20
6772593114,6772593112,-2,828,1428,20
6774283483,6774283462,-21,1042,2313,20
6775973799,6775973794,-5,1070,2797,20
6776941238,6776941235,-3,956,1769,20
6778488526,6778488523,-3,1274,3068,20
6780722297,6780722296,-1,1013,1957,20
6780862766,6780862750,-16,901,2841,20
6784067699,6784067697,-2,1136,1986,20
6787053258,6787053254,-4,1419,2295,20
6789352311,6789352310,-1,1120,2301,20
6790086573,6790086574,1,11629,11913,20
6790249753,6790249757,4,2087,664,20
6790622860,6790622858,-2,860,1418,20
6791265079,6791265074,-5,1246,2057,20
6792686749,6792686743,-6,1394,2589,20
6794210935,6794210929,-6,2242,5890,20
6798706146,6798706141,-5,861,2111,20
6800522970,6800522968,-2,1227,2245,20
6802014054,6802014050,-4,1368,2986,20
6802726506,6802726505,-1,1138,2015,20
6804568478,6804568476,-2,1280,2630,20
6806628226,6806628224,-2,1263,2801,20
6806849279,6806849276,-3,1012,2468,20
6808291002,6808291000,-2,1053,2398,20
6808915135,6808915132,-3,974,3074,20
6810711193,6810711188,-5,909,3085,20
6812116281,6812116279,-2,1098,1924,20
6812814930,6812814926,-4,921,2800,20
6813048423,6813048402,-21,355,858,20
6816332949,6816332945,-4,950,2645,20
6818661803,6818661799,-4,1477,2388,20
6822667219,6822667214,-5,1156,2842,20
6822780491,6822780489,-2,805,2390,20
6828981123,6828981121,-2,975,1497,20
6832005115,6832005099,-16,152,1292,20
6833793338,6833793335,-3,1192,2024,20
6835837123,6835837118,-5,971,2457,20
6843608325,6843608325,0,1463,1652,20
6843731682,6843731678,-4,965,1543,20
6847720276,6847720291,15,679,951,20
6848579366,6848579363,-3,1337,2348,20
6850459503,6850459519,16,997,1627,20
6851605822,6851605827,5,3644,1888,20
6857659779,6857659796,17,27159,22464,20
6858544747,6858544745,-2,990,1877,20
6861753515,6861753528,13,976,1723,20
6864725656,6864725666,10,257,650,20
6866489577,6866489575,-2,654,1831,20
6868755185,6868755181,-4,1235,2779,20
6871608462,6871608461,-1,1086,2533,20
6872487863,6872487859,-4,851,2021,20
6877310958,6877310954,-4,919,2019,20
6877745925,6877745930,5,4109,1589,20
6879532498,6879532494,-4,1323,2744,20
6880787071,6880787077,6,2345,1530,20
6883729785,6883729791,6,2464,1188,20
6885605972,6885605969,-3,707,1509,20
6891182028,6891182029,1,1396,1235,20
6894486080,6894486075,-5,882,2527,20
6901021798,6901021794,-4,512,1011,20
6901260223,6901260220,-3,1348,2217,20
6902430175,6902430173,-2,1213,2475,20
6912234119,6912234117,-2,1372,2482,20
6913944071,6913944072,1,1031,2752,20
6918664263,6918664260,-3,1026,2347,20
6924053583,6924053582,-1,1847,1959,20
6926243198,6926243197,-1,906,2454,20
6932238517,6932238513,-4,887,2414,20
6932959962,6932959958,-4,910,1864,20
6933512383,6933512383,0,985,1909,20
6935684726,6935684722,-4,1353,2165,20
6935856754,6935856750,-4,1504,2417,20
6939743132,6939743130,-2,1293,2320,20
6941169180,6941169175,-5,813,1895,20
6941864388,6941864378,-10,944,1954,20
6942563678,6942563695,17,1139,2106,20
6943334313,6943334310,-3,1138,2294,20
6947307278,6947307277,-1,1250,3067,20
6947419056,6947419055,-1,1334,2300,20
6948657240,6948657257,17,799,1891,20
6952183510,6952183508,-2,997,1421,20
6960636141,6960636137,-4,805,1853,20
6967835053,6967835051,-2,1391,1846,20
6970037254,6970037252,-2,1981,339,20
6971904386,6971904385,-1,1508,2628,20
6976278105,6976278103,-2,957,1297,20
6976979340,6976979337,-3,1126,2246,20
6983134826,6983134823,-3,769,1550,20
6985243587,6985243585,-2,754,1570,20
6985287642,6985287641,-1,1241,2299,20
6985447932,6985447949,17,86,786,20
6986741170,6986741167,-3,1170,3029,20
6986948171,6986948169,-2,1110,2059,20
6989535647,6989535652,5,4650,2164,20
6996260729,6996260731,2,1578,1448,20
7001849570,7001849566,-4,1289,2691,20
7006050089,7006050086,-3,1118,2155,20
7016600980,7016600977,-3,1054,3237,20
7019996229,7019996225,-4,807,2152,20
7020305471,7020305466,-5,1159,2100,20
7024963260,7024963257,-3,1385,2964,20
7027635943,7027635941,-2,1482,2744,20
7032613257,7032613260,3,11679,10139,20
7034790786,7034790783,-3,961,1836,20
7038907159,7038907159,0,787,987,20
7042395027,7042395025,-2,859,1563,20
7043420558,7043420554,-4,581,1163,20
7045984654,7045984647,-7,1074,5261,20
7046935947,7046935944,-3,2266,5109,20
7048417618,7048417614,-4,1316,2572,20
7054616779,7054616777,-2,1658,3513,20
7056600305,7056600303,-2,826,2395,20
7065315372,7065315365,-7,997,2815,20
7067009211,7067009213,2,1741,1372,20
7068119219,7068119214,-5,1223,1362,20
7070777538,7070777533,-5,987,2741,20
7072187587,7072187585,-2,1319,1567,20
7076500762,7076500759,-3,1197,3218,20
7082053381,7082053382,1,1399,1954,20
7086808435,7086808434,-1,1267,2509,20
7087117520,7087117516,-4,1402,2561,20
7092965642,7092965639,-3,1034,3221,20
7097742590,7097742593,3,1252,899,20
7098140834,7098140831,-3,827,1356,20
7099230963,7099230961,-2,810,2187,20
7102330369,7102330365,-4,1078,2454,20
7104230955,7104230950,-5,692,2339,20
7104923806,7104923802,-4,933,2998,20
7105515518,7105515517,-1,711,1873,20
7108120967,7108120966,-1,693,1991,20
7112499746,7112499751,5,2902,2307,20
7116471178,7116471177,-1,577,1984,20
7121028919,7121028919,0,915,1435,20
7124627501,7124627497,-4,1085,1869,20
7125926335,7125926332,-3,801,1486,20
7128228903,7128228900,-3,822,1607,20
7128849007,7128849002,-5,1151,2778,20
7133435046,7133435041,-5,1019,1445,20
7133467184,7133467200,16,733,2983,20
7136198318,7136198314,-4,877,2328,20
7138398731,7138398728,-3,1297,2550,20
7138903086,7138903103,17,875,2492,20
7145515630,7145515628,-2,997,1833,20
7151418932,7151418929,-3,1279,2413,20
7159336769,7159336765,-4,1053,2592,20
7159953634,7159953632,-2,1245,2350,20
7160607875,7160607873,-2,1220,2358,20
7160961250,7160961245,-5,1164,1960,20
7164289993,7164290001,8,12753,30157,20
7166759145,7166759143,-2,760,1912,20
7167106177,7167106199,22,1998,1373,20
7168405962,7168405960,-2,839,1312,20
7173871658,7173871656,-2,1104,2432,20
7174355134,7174355153,19,749,1394,20
7176046522,7176046518,-4,1709,1996,20
7178634723,7178634718,-5,687,1725,20
7179455161,7179455158,-3,1041,3300,20
7179531183,7179531178,-5,970,1534,20
7183016128,7183016126,-2,1165,1973,20
7193385842,7193385838,-4,2587,4882,20
7208405671,7208405670,-1,1064,1681,20
7208751150,7208751146,-4,914,1836,20
7209897556,7209897561,5,2488,1481,20
7212409478,7212409485,7,3817,1379,20
7213567399,7213567395,-4,1237,2188,20
7214873024,7214873042,18,853,1843,20
7220398162,7220398153,-9,1165,4165,20
7224198355,7224198353,-2,960,2374,20
7226670183,7226670179,-4,877,2081,20
7227359982,7227359979,-3,1266,1952,20
7228035438,7228035434,-4,920,2234,20
7230743026,7230743024,-2,1102,2703,20
7234654344,7234654342,-2,1538,2411,20
7234844771,7234844765,-6,1295,7358,20
7238473148,7238473144,-4,1142,2241,20
7238905941,7238905924,-17,283,662,20
7239895214,7239895210,-4,1157,3290,20
7240691126,7240691123,-3,1172,2404,20
7245619706,7245619705,-1,993,1571,20
7247624110,7247624106,-4,1254,2818,20
7248002139,7248002136,-3,837,2516,20
7251412642,7251412641,-1,1010,1494,20
7253890523,7253890519,-4,1116,2705,20
7256527906,7256527902,-4,958,2446,20
7260345581,7260345579,-2,993,2359,20
7268529567,7268529563,-4,1143,2273,20
7268959911,7268959897,-14,1111,2603,20
7270367871,7270367873,2,1010,1827,20
7270860229,7270860223,-6,1198,2750,20
7271407014,7271407009,-5,1274,2096,20
7272501246,7272501243,-3,731,2047,20
7274481617,7274481615,-2,1256,3189,20
7277539999,7277539996,-3,1334,2762,20
7278784391,7278784388,-3,969,1581,20
7282066743,7282066749,6,2313,1666,20
7285491948,7285491947,-1,1072,1735,20
7286444307,7286444302,-5,1155,1949,20
7287765310,7287765315,5,18126,42722,20
7289996728,7289996724,-4,1344,2316,20
7293536500,7293536495,-5,1332,2750,20
7294127599,7294127597,-2,1318,3282,20
7295755289,7295755286,-3,956,2420,20
7299204182,7299204179,-3,844,2641,20
7301664406,7301664392,-14,1210,568,20
7306304080,7306304075,-5,1140,1735,20
7306344372,7306344370,-2,193,665,20
7307515335,7307515337,2,34007,42309,20
7311202675,7311202671,-4,1201,2879,20
7312690906,7312690906,0,1010,1916,20
7314314913,7314314909,-4,1235,2235,20
7326089527,7326089525,-2,1263,3047,20
7340444295,7340444294,-1,1126,2236,20
7345482059,7345482057,-2,813,2362,20
7346837151,7346837146,-5,1743,2700,20
7346956220,7346956227,7,3475,1062,20
7348666982,7348666978,-4,1127,2069,20
7349611519,7349611526,7,6820,2112,20
7351556405,7351556404,-1,1001,1470,20
7351815203,7351815189,-14,1768,558,20
7353739137,7353739137,0,796,2024,20
7366561835,7366561845,10,307,1908,20
7367420899,7367420894,-5,853,1926,20
7368433829,7368433827,-2,1558,2482,20
7370031120,7370031113,-7,1287,4754,20
7375161514,7375161521,7,2710,1644,20
7375409292,7375409289,-3,938,2189,20
7392581302,7392581299,-3,1049,2483,20
7394453117,7394453117,0,1330,1454,20
7397485789,7397485786,-3,799,2135,20
7401688171,7401688168,-3,1273,2152,20
7403523420,7403523418,-2,889,2655,20
7406407511,7406407509,-2,1317,2211,20
7407665390,7407665386,-4,1282,2689,20
7407791505,7407791502,-3,1581,3554,20
7413556023,7413556018,-5,887,1524,20
7414715770,7414715767,-3,1201,2307,20
7420554142,7420554139,-3,1083,2581,20
7423044762,7423044757,-5,1185,3234,20
7431623001,7431622998,-3,1121,2754,20
7432343119,7432343118,-1,1187,2205,20
7435176146,7435176141,-5,1472,2372,20
7435230267,7435230264,-3,702,1760,20
7435767549,7435767569,20,724,1807,20
7437920136,7437920142,6,2923,1551,20
7440727785,7440727782,-3,944,2236,20
7454562542,7454562540,-2,1374,2398,20
7457356571,7457356567,-4,1238,2309,20
7460946750,7460946748,-2,987,2227,20
7465283825,7465283822,-3,1280,1836,20
7470655030,7470655027,-3,676,1584,20
7471488128,7471488126,-2,911,2092,20
7478463221,7478463222,1,831,1205,20
7480149871,7480149890,19,704,1978,20
7484841554,7484841552,-2,1409,1676,20
7486993078,7486993075,-3,940,2613,20
7487367531,7487367528,-3,1008,2720,20
7490187470,7490187468,-2,1257,2503,20
7491179187,7491179184,-3,1198,2396,20
7495369582,7495369579,-3,1257,2227,20
7501950250,7501950252,2,924,1210,20
7503243386,7503243382,-4,1538,2914,20
7503628066,7503628079,13,28705,56321,20
7505792497,7505792489,-8,919,2491,20
7506026662,7506026678,16,581,1010,20
7511010416,7511010413,-3,806,2439,20
7512470243,7512470245,2,1706,1816,20
7514223165,7514223161,-4,1102,1531,20
7515304375,7515304372,-3,615,2320,20
7528207869,7528207863,-6,1039,2910,20
7530104255,7530104252,-3,1459,2271,20
7531986033,7531986033,0,2223,2378,20
7535462335,7535462333,-2,1137,2847,20
7538117998,7538117994,-4,757,3088,20
7538388406,7538388410,4,1480,1176,20
7543798199,7543798201,2,1797,1527,20
7545844787,7545844783,-4,928,1871,20
7549309094,7549309089,-5,908,2008,20
7550815153,7550815151,-2,1178,2307,20
7552289046,7552289042,-4,1084,2483,20
7563799275,7563799274,-1,1067,2266,20
7569163259,7569163254,-5,868,2038,20
7571663222,7571663220,-2,1011,2519,20
7572958763,7572958759,-4,604,1623,20
7575693274,7575693268,-6,2435,7635,20
7575768923,7575768919,-4,1011,1995,20
7575830048,7575830063,15,664,1412,20
7580814321,7580814318,-3,1548,2893,20
7581049047,7581049043,-4,528,1677,20
7585421111,7585421110,-1,1204,2260,20
7591358327,7591358325,-2,929,2009,20
7592428361,7592428357,-4,926,2269,20
7592754771,7592754766,-5,1343,2623,20
7600935401,7600935400,-1,667,1630,20
7602078953,7602078956,3,11208,8420,20
7606716449,7606716453,4,4863,3410,20
7607752950,7607752949,-1,681,2035,20
7612869658,7612869657,-1,877,1762,20
7615321327,7615321325,-2,1033,2033,20
7615820538,7615820535,-3,1260,2821,20
7620017769,7620017766,-3,1009,2534,20
7623889478,7623889477,-1,1556,3198,20
7625640282,7625640274,-8,541,2605,20
7627665313,7627665312,-1,1432,1617,20
7628790706,7628790702,-4,1430,2485,20
7632677853,7632677861,8,4505,1518,20
7636772206,7636772208,2,2010,2206,20
7639103940,7639103937,-3,945,1660,20
7644729985,7644729981,-4,1278,1891,20
7645390388,7645390369,-19,152,1982,20
7645840807,7645840802,-5,1529,3046,20
7646101331,7646101324,-7,788,1154,20
7646678893,7646678887,-6,848,3083,20
7647941796,7647941782,-14,1080,1639,20
7650311157,7650311154,-3,922,1916,20
7652578385,7652578382,-3,1657,2799,20
7658592815,7658592810,-5,1542,2561,20
7662980506,7662980510,4,1329,953,20
7668025401,7668025403,2,3295,2938,20
7671225017,7671225015,-2,1171,2182,20
7673667351,7673667349,-2,999,2201,20
7675730045,7675730042,-3,1270,2932,20
7682153296,7682153294,-2,1734,3466,20
7682828727,7682828730,3,1290,1591,20
7683147720,7683147718,-2,1237,2423,20
7686592026,7686592025,-1,738,1424,20
7690929666,7690929662,-4,1074,3161,20
7694608987,7694608985,-2,1862,2462,20
7694670613,7694670609,-4,1110,1549,20
7709848810,7709848806,-4,1067,1831,20
7711592329,7711592351,22,1774,440,20
7713910394,7713910401,7,10085,5360,20
7720323985,7720323981,-4,1394,2514,20
7721307399,7721307394,-5,685,2410,20
7725017954,7725017954,0,904,1966,20
7725852886,7725852906,20,213,950,20
7730349268,7730349265,-3,1470,2325,20
7734503393,7734503387,-6,828,1443,20
7735409820,7735409801,-19,1011,2648,20
7739563019,7739563016,-3,920,1913,20
7740532906,7740532902,-4,961,2283,20
7740834318,7740834315,-3,1300,1967,20
7746691746,7746691741,-5,1179,4093,20
7747489797,7747489794,-3,1256,2264,20
7752530981,7752530977,-4,972,3066,20
7753044847,7753044830,-17,1147,2183,20
7753603736,7753603734,-2,1205,3295,20
7753697771,7753697770,-1,1029,2063,20
7755468066,7755468065,-1,1391,1916,20
7779983319,7779983314,-5,1107,2585,20
7780571598,7780571595,-3,1390,3276,20
7780603445,7780603431,-14,206,685,20
7782752531,7782752528,-3,1336,2775,20
7786873977,7786873974,-3,1108,1931,20
7793532927,7793532925,-2,1085,2244,20
7794561889,7794561886,-3,1152,1600,20
7794728075,7794728077,2,1311,2169,20
7797258694,7797258692,-2,938,1750,20
7805878331,7805878329,-2,1297,2770,20
7806846995,7806846991,-4,1219,2721,20
7811690763,7811690759,-4,998,2839,20
7812456438,7812456435,-3,1537,2769,20
7816443134,7816443130,-4,1008,3194,20
7817292695,7817292692,-3,1213,1615,20
7820089746,7820089741,-5,919,2885,20
7821575042,7821575039,-3,1039,1939,20
7824588619,7824588614,-5,1170,2693,20
7832525006,7832525002,-4,1299,2108,20
7834979833,7834979830,-3,962,2432,20
7836268178,7836268183,5,1437,868,20
7838733591,7838733586,-5,900,1890,20
7846140499,7846140497,-2,1195,1745,20
7847230365,7847230363,-2,919,1614,20
7849129741,7849129745,4,2881,1355,20
7850804377,7850804377,0,1123,1791,20
7854230307,7854230305,-2,1117,2287,20
7856199301,7856199299,-2,1226,2230,20
7858518865,7858518863,-2,1337,1702,20
7860249313,7860249310,-3,925,1935,20
7860743878,7860743875,-3,782,2168,20
7862248729,7862248725,-4,949,1706,20
7863767400,7863767398,-2,1420,1960,20
7863990383,7863990398,15,661,1931,20
7866721478,7866721476,-2,1011,1902,20
7866870447,7866870464,17,521,1659,20
7868045365,7868045359,-6,963,3824,20
7870152130,7870152127,-3,1442,3237,20
7879912758,7879912755,-3,976,2038,20
7880754370,7880754367,-3,899,2578,20
7882586374,7882586361,-13,27644,15191,20
7882765054,7882765048,-6,2089,9320,20
7883407057,7883407055,-2,1058,2189,20
7885967837,7885967834,-3,1119,3070,20
7891401187,7891401182,-5,1139,3303,20
7893801687,7893801687,0,804,2288,20
7897985293,7897985291,-2,821,1491,20
7899953195,7899953193,-2,1340,2336,20
7907646157,7907646153,-4,550,2240,20
7909579322,7909579319,-3,1348,2744,20
7911924420,7911924421,1,2779,3245,20
7912685379,7912685374,-5,1626,3265,20
7914415670,7914415666,-4,1431,1619,20
7915811490,7915811488,-2,1090,2843,20
7917743047,7917743046,-1,1769,1942,20
7917950707,7917950705,-2,1093,1588,20
7926375221,7926375223,2,1384,1290,20
7929633615,7929633611,-4,979,2999,20
7931065984,7931065981,-3,998,2171,20
7931100375,7931100391,16,390,994,20
7931449658,7931449654,-4,1452,1743,20
7934249594,7934249590,-4,1197,2856,20
7938314325,7938314321,-4,631,2179,20
7940536509,7940536506,-3,1147,2252,20
7945924167,7945924166,-1,1026,1854,20
7947551138,7947551146,8,9722,1634,20
7949671290,7949671299,9,9334,37571,20
7954741284,7954741284,0,3010,4818,20
7957744759,7957744755,-4,906,2168,20
7961402246,7961402242,-4,1284,2288,20
7961866635,7961866633,-2,1009,2032,20
7962185324,7962185314,-10,828,2842,20
7963393563,7963393560,-3,1210,2596,20
7966574422,7966574421,-1,812,1794,20
7969534406,7969534406,0,1492,1739,20
7979198343,7979198342,-1,1352,1224,20
7981695149,7981695146,-3,1159,2658,20
7983261210,7983261207,-3,1567,3060,20
7987223157,7987223162,5,3757,2050,20
7988918209,7988918206,-3,1197,2458,20
7993202262,7993202259,-3,1026,2847,20
7993676545,7993676558,13,6928,1282,20
8009597167,8009597165,-2,1020,3523,20
8010861110,8010861110,0,1236,2408,20
8013785071,8013785068,-3,1283,3082,20
8017021198,8017021196,-2,1388,2375,20
8018515246,8018515244,-2,559,1260,20
8018806053,8018806047,-6,746,2978,20
8021976614,8021976609,-5,1396,1741,20
8025061518,8025061514,-4,45738,20075,20
8027288160,8027288159,-1,1373,3345,20
8029593156,8029593155,-1,1121,1470,20
8034335549,8034335543,-6,946,3125,20
8036385667,8036385666,-1,1089,2743,20
8036799372,8036799371,-1,936,2227,20
8041291715,8041291709,-6,962,3790,20
8043745894,8043745886,-8,1135,2525,20
8043904992,8043905011,19,1380,1987,20
8044553547,8044553543,-4,1006,2460,20
8048393130,8048393126,-4,1186,2424,20
8048490960,8048490956,-4,49388,20201,20
8051430609,8051430609,0,1077,1056,20
8059431141,8059431137,-4,1324,2442,20
8064670090,8064670088,-2,1040,1986,20
8068650485,8068650481,-4,1419,3022,20
8069384701,8069384700,-1,480,2116,20
8082147378,8082147373,-5,984,8788,20
8083107559,8083107557,-2,1364,1905,20
8083380847,8083380862,15,1010,2699,20
8084111887,8084111885,-2,1119,2505,20
8097196323,8097196321,-2,928,2513,20
8098483039,8098483035,-4,1398,2035,20
8105971823,8105971818,-5,1071,2203,20
8106538023,8106538021,-2,498,1589,20
8107305319,8107305318,-1,1004,2319,20
8113583457,8113583456,-1,883,2214,20
8121577168,8121577165,-3,2015,3856,20
8123154370,8123154368,-2,490,1480,20
8123418611,8123418609,-2,1442,2372,20
8123548961,8123548969,8,2823,948,20
8127277186,8127277181,-5,1304,2713,20
8133323929,8133323927,-2,1117,3249,20
8138556879,8138556875,-4,957,2586,20
8145325472,8145325470,-2,989,2303,20
8149022818,8149022814,-4,1019,2401,20
8149054516,8149054537,21,1209,3070,20
8151946526,8151946523,-3,848,2364,20
8152922911,8152922909,-2,1677,2232,20
8153895470,8153895469,-1,1270,2098,20
8154364557,8154364554,-3,1165,2400,20
8156995699,8156995694,-5,1058,2403,20
8158276329,8158276325,-4,1104,2933,20
8160313974,8160313973,-1,1567,2898,20
8160568876,8160568897,21,905,2444,20
8164504076,8164504094,18,1086,2707,20
8165526842,8165526839,-3,1228,2971,20
8167252184,8167252199,15,316,887,20
8172359971,8172359966,-5,1008,2087,20
8173904068,8173904067,-1,1250,1770,20
8178056236,8178056231,-5,1015,4348,20
8179879997,8179879996,-1,696,1540,20
8180246867,8180246863,-4,1102,2848,20
8184775628,8184775625,-3,976,2587,20
8185267772,8185267777,5,1891,1036,20
8187007425,8187007422,-3,1134,2387,20
8189744863,8189744861,-2,748,1764,20
8189810555,8189810553,-2,1335,2118,20
8190186724,8190186722,-2,1618,2797,20
8192085142,8192085139,-3,940,1836,20
8205117078,8205117077,-1,1110,1486,20
8208770453,8208770450,-3,813,2037,20
8215082602,8215082602,0,656,1571,20
8215421563,8215421561,-2,1202,2668,20
8215775774,8215775791,17,231,970,20
8216445199,8216445195,-4,933,1975,20
8218649809,8218649807,-2,1295,2815,20
8219525640,8219525637,-3,1431,1738,20
8223820218,8223820214,-4,1568,2667,20
8225081260,8225081259,-1,956,1742,20
8225845826,8225845821,-5,1049,2147,20
8229301237,8229301234,-3,1458,3334,20
8234968266,8234968272,6,4169,1992,20
8236082353,8236082349,-4,975,3076,20
8245141166,8245141163,-3,1147,1799,20
8246538238,8246538242,4,1158,947,20
8246752934,8246752931,-3,1148,1779,20
8248009695,8248009715,20,1303,3701,20
8248189826,8248189823,-3,1020,2542,20
8248380897,8248380891,-6,1403,3773,20
8252902005,8252902003,-2,897,2132,20
8256262043,8256262042,-1,1050,2212,20
8257101846,8257101845,-1,1225,2223,20
8257316778,8257316773,-5,872,2800,20
8261050806,8261050803,-3,1200,2227,20
8261826570,8261826574,4,2682,1147,20
8264652041,8264652037,-4,1086,2681,20
8268348365,8268348362,-3,854,2467,20
8268852390,8268852393,3,1663,1606,20
8269685507,8269685513,6,3182,2396,20
8270080514,8270080512,-2,538,2035,20
8270445960,8270445937,-23,1251,2681,20
8276457885,8276457884,-1,29177,16129,20
8277497738,8277497733,-5,1756,4305,20
8278354331,8278354328,-3,993,2556,20
8280312375,8280312371,-4,1031,2072,20
8294057253,8294057253,0,1296,1793,20
8294329487,8294329504,17,460,1027,20
8294856210,8294856206,-4,798,1833,20
8297647557,8297647557,0,1165,1397,20
8299887743,8299887741,-2,1030,2323,20
8305986811,8305986807,-4,1093,2094,20
8307687201,8307687198,-3,1635,2248,20
8310666814,8310666810,-4,1050,2213,20
8310945944,8310945942,-2,1355,2642,20
8313037897,8313037894,-3,488,910,20
8313899210,8313899205,-5,1435,3732,20
8316687202,8316687198,-4,1030,3796,20
8317102327,8317102327,0,242,981,20
8318986693,8318986690,-3,1171,2181,20
8319525494,8319525491,-3,639,1676,20
8321490782,8321490778,-4,1658,2015,20
8325335131,8325335129,-2,1121,1181,20
8335694040,8335694036,-4,1285,2064,20
8337967209,8337967216,7,6555,2763,20
8338307395,8338307392,-3,1569,2403,20
8338837144,8338837147,3,1840,1452,20
8340238427,8340238423,-4,1371,2499,20
8341312279,8341312281,2,1377,1232,20
8342208545,8342208548,3,19137,14393,20
8344877683,8344877681,-2,1101,2420,20
8348413370,8348413366,-4,1403,2000,20
8350379896,8350379893,-3,1016,1835,20
8353502509,8353502514,5,107,1287,20
8354909234,8354909230,-4,1459,2180,20
8355942017,8355942017,0,1060,1156,20
8359323823,8359323818,-5,1122,2291,20
8360571640,8360571638,-2,1078,2494,20
8365992255,8365992251,-4,1434,3630,20
8367768354,8367768354,0,1223,1556,20
8369026254,8369026251,-3,2699,4075,20
8370985870,8370985867,-3,1032,1314,20
8371808249,8371808245,-4,2011,4380,20
8374603012,8374603009,-3,1334,2830,20
8374646192,8374646208,16,1863,5487,20
8377637587,8377637585,-2,1051,2087,20
8379397979,8379397974,-5,1015,2164,20
8385192569,8385192562,-7,1284,2221,20
8386782604,8386782601,-3,1150,1649,20
8387651497,8387651494,-3,1323,3078,20
8392412108,8392412104,-4,881,1941,20
8393894339,8393894335,-4,1266,2558,20
8405201961,8405201957,-4,1039,2824,20
8405583485,8405583482,-3,896,1767,20
8405614953,8405614950,-3,1083,1274,20
8413580230,8413580226,-4,1521,2283,20
8414621499,8414621517,18,893,1575,20
8415895465,8415895463,-2,1308,1916,20
8416187557,8416187554,-3,1001,2353,20
8416848971,8416848969,-2,1045,1890,20
8417354095,8417354101,6,184,843,20
8417525805,8417525812,7,15057,28113,20
8417853234,8417853230,-4,1066,2517,20
8424093505,8424093504,-1,1241,2438,20
8430709134,8430709131,-3,908,2607,20
8432053081,8432053077,-4,1201,2103,20
8435720191,8435720197,6,2670,1420,20
8439634946,8439634946,0,2372,2112,20
8442209953,8442209950,-3,936,1869,20
8442352342,8442352341,-1,1143,2060,20
8447477409,8447477407,-2,1326,2439,20
8453300831,8453300828,-3,645,2236,20
8458126288,8458126295,7,268,684,20
8463939403,8463939398,-5,2082,3506,20
8465772014,8465772011,-3,949,2128,20
8466123458,8466123454,-4,989,3064,20
8467967696,8467967693,-3,966,2476,20
8469120331,8469120327,-4,1490,3867,20
8474969819,8474969814,-5,1103,3243,20
8476446038,8476446034,-4,1125,2196,20
8477086599,8477086598,-1,586,1440,20
8480379501,8480379497,-4,1346,1696,20
8482475453,8482475450,-3,1098,2500,20
8485808431,8485808427,-4,960,3058,20
8487745410,8487745409,-1,1574,1373,20
8490576889,8490576885,-4,1199,2548,20
8491133046,8491133030,-16,1981,576,20
8491710316,8491710313,-3,1554,2903,20
8495179262,8495179268,6,2211,1565,20
8498063852,8498063849,-3,1372,2669,20
8498674755,8498674750,-5,1047,3276,20
8499015382,8499015400,18,972,2803,20
8499209773,8499209793,20,1255,2523,20
8507710662,8507710661,-1,1498,2705,20
8508823958,8508823955,-3,1245,1725,20
8513731559,8513731558,-1,772,2145,20
8525208036,8525208043,7,7699,2506,20
8526149245,8526149239,-6,1065,2904,20
8528687202,8528687198,-4,1065,2260,20
8536361993,8536361990,-3,840,1648,20
8537033705,8537033709,4,3148,2073,20
8539813611,8539813610,-1,1412,1676,20
8552290295,8552290293,-2,815,1361,20
8554259130,8554259129,-1,911,1963,20
8555655699,8555655695,-4,647,1052,20
8556150322,8556150321,-1,1456,2271,20
8556877833,8556877829,-4,1211,2911,20
8556942567,8556942562,-5,943,2135,20
8563632945,8563632945,0,1310,2490,20
8566767847,8566767844,-3,1219,2515,20
8568600730,8568600726,-4,852,1876,20
8569397548,8569397545,-3,1134,2293,20
8570186644,8570186640,-4,926,1538,20
8571438091,8571438093,2,14226,12162,20
8575694218,8575694221,3,2238,2294,20
8576728563,8576728559,-4,1355,2040,20
8581667527,8581667525,-2,1266,1614,20
8584107668,8584107662,-6,1293,2969,20
8589308709,8589308706,-3,1183,2849,20
8591477566,8591477561,-5,1557,2863,20
8592306411,8592306413,2,895,1099,20
8596027486,8596027482,-4,843,3414,20
8598383157,8598383154,-3,1135,2428,20
8598508748,8598508754,6,107,695,20
8606389656,8606389653,-3,1267,2016,20
8606484477,8606484473,-4,1133,2147,20
8606846202,8606846203,1,1966,1402,20
8609626093,8609626089,-4,1090,1630,20
8610217527,8610217524,-3,1237,2175,20
8613274249,8613274246,-3,1410,3176,20
8613721918,8613721917,-1,857,1740,20
8615323196,8615323190,-6,550,1370,20
8615758798,8615758797,-1,238,1002,20
8619583775,8619583777,2,2099,2968,20
8620015621,8620015619,-2,1755,2900,20
8623898609,8623898606,-3,664,2589,20
8624752855,8624752855,0,1070,1515,20
8625877655,8625877654,-1,1297,2503,20
8632246935,8632246938,3,638,1216,20
8635473457,8635473463,6,3306,1641,20
8636424195,8636424190,-5,855,1838,20
8638356731,8638356729,-2,891,1911,20
8642736701,8642736696,-5,1072,3721,20
8647188366,8647188364,-2,1337,2716,20
8649045599,8649045595,-4,1188,1966,20
8656229321,8656229326,5,3460,1617,20
8658519481,8658519477,-4,1405,1725,20
8658906385,8658906381,-4,833,2013,20
8659157831,8659157809,-22,1272,2870,20
8659230190,8659230211,21,430,1298,20
8663705419,8663705413,-6,703,1965,20
8665894194,8665894188,-6,737,2417,20
8668827369,8668827366,-3,706,1486,20
8670901565,8670901559,-6,1349,3205,20
8673602180,8673602178,-2,1170,2047,20
8680073979,8680073973,-6,319,1738,20
8680931902,8680931899,-3,1081,2389,20
8681817754,8681817751,-3,1028,1730,20
8686096237,8686096234,-3,1288,2563,20
8689685013,8689685010,-3,1254,3244,20
8692848795,8692848791,-4,1764,3118,20
8699874973,8699874969,-4,1553,2750,20
8700268832,8700268826,-6,1342,6950,20
8700665910,8700665905,-5,1034,2559,20
8703534012,8703534006,-6,1060,3310,20
8708178782,8708178778,-4,1089,2720,20
8709088108,8709088104,-4,1065,2309,20
8709298994,8709298990,-4,880,1677,20
8712030715,8712030713,-2,1155,2966,20
8715002816,8715002814,-2,1470,2055,20
8716769791,8716769787,-4,1141,2119,20
8721258445,8721258442,-3,1310,2044,20
8731371943,8731371940,-3,1046,2638,20
8731532383,8731532373,-10,1504,2654,20
8731893796,8731893785,-11,292,972,20
8737699974,8737699971,-3,1414,2437,20
8742974513,8742974511,-2,1908,2538,20
8744120273,8744120271,-2,1552,2426,20
8745604935,8745604954,19,628,1400,20
8748312489,8748312484,-5,1392,2309,20
8752396697,8752396693,-4,1146,2313,20
8762979971,8762979972,1,1349,1520,20
8764734007,8764734004,-3,1589,2729,20
8765200446,8765200442,-4,1434,1943,20
8765539014,8765539014,0,1189,1922,20
8766236405,8766236398,-7,1800,6397,20
8775212842,8775212838,-4,1310,2487,20
8778804962,8778804960,-2,1135,2754,20
8780797581,8780797577,-4,1179,2255,20
8786631006,8786631002,-4,1159,2412,20
8786864165,8786864149,-16,488,1249,20
8790350511,8790350507,-4,1378,2898,20
8790872390,8790872411,21,697,1975,20
8792091011,8792091007,-4,1637,2962,20
8796449345,8796449342,-3,1186,2851,20
8796960568,8796960587,19,244,558,20
8797506471,8797506469,-2,1021,2296,20
8799187337,8799187332,-5,876,1898,20
8802174394,8802174393,-1,939,1917,20
8805146610,8805146611,1,1294,2078,20
8805914285,8805914282,-3,1105,2654,20
8806710230,8806710228,-2,842,1585,20
8808042475,8808042472,-3,929,1731,20
8811458483,8811458481,-2,812,2220,20
8814869088,8814869084,-4,957,1787,20
8816100994,8816100991,-3,1073,2110,20
8816512788,8816512773,-15,511,1515,20
8818633771,8818633752,-19,2114,716,20
8820638625,8820638623,-2,553,1522,20
8820946424,8820946426,2,1772,1332,20
8827343080,8827343077,-3,1009,2237,20
8829779895,8829779892,-3,1152,2793,20
8831261139,8831261138,-1,1151,1597,20
8835572785,8835572782,-3,1677,3372,20
8836244139,8836244139,0,775,1835,20
8836353551,8836353547,-4,963,2667,20
8838325069,8838325065,-4,1606,2785,20
8838390068,8838390066,-2,1438,2315,20
8839879458,8839879454,-4,1572,3519,20
8840167928,8840167923,-5,1199,2599,20
8843751863,8843751859,-4,779,2169,20
8849718895,8849718891,-4,1406,2146,20
8849815885,8849815881,-4,1300,3136,20
8851484887,8851484885,-2,1285,3300,20
8851836891,8851836896,5,3848,2360,20
8858721843,8858721837,-6,773,3365,20
8859475223,8859475238,15,231,789,20
8866087875,8866087874,-1,1073,1875,20
8868199889,8868199882,-7,2600,7405,20
8872384078,8872384075,-3,980,1534,20
8873042747,8873042746,-1,1332,2038,20
8885085651,8885085648,-3,1184,2510,20
8887001291,8887001290,-1,732,1924,20
8888713337,8888713333,-4,936,2780,20
8890011563,8890011562,-1,1057,2909,20
8893371606,8893371604,-2,824,2397,20
8901607423,8901607438,15,12813,51508,20
8902878534,8902878533,-1,1708,3613,20
8912026724,8912026722,-2,1125,2647,20
8913055678,8913055697,19,598,1609,20
8913857894,8913857891,-3,885,2682,20
8917528474,8917528471,-3,960,2416,20
8918511796,8918511793,-3,1154,2661,20
8919508827,8919508823,-4,791,2080,20
8920356931,8920356929,-2,971,1423,20
8923211851,8923211849,-2,1533,2567,20
8923405086,8923405086,0,1397,2359,20
8924409016,8924409013,-3,736,1316,20
8927625255,8927625252,-3,1453,3344,20
8936287534,8936287533,-1,1014,1785,20
8936648136,8936648134,-2,1133,3011,20
8938997650,8938997647,-3,1512,1876,20
8939071485,8939071481,-4,1333,2458,20
8940822519,8940822516,-3,1202,2434,20
8945648515,8945648511,-4,1031,3131,20
8951128542,8951128549,7,1083,1784,20
8951798972,8951798969,-3,1151,2451,20
8952109077,8952109096,19,349,1018,20
8952679092,8952679089,-3,1199,2127,20
8956832181,8956832177,-4,1271,3002,20
8961132195,8961132194,-1,1242,3232,20
8964503252,8964503254,2,1963,2773,20
8965502019,8965502016,-3,873,1416,20
8967818701,8967818698,-3,1433,2654,20
8969058817,8969058823,6,3405,1156,20
8971425818,8971425813,-5,2035,5517,20
8971991821,8971991817,-4,1183,3636,20
8973676797,8973676797,0,1317,2619,20
8975070887,8975070907,20,865,2421,20
8977689605,8977689600,-5,1026,2975,20
8978203358,8978203354,-4,1688,2415,20
8979527129,8979527124,-5,55998,36730,20
8981649219,8981649216,-3,1409,3180,20
8982908969,8982908965,-4,1083,1805,20
8985652313,8985652313,0,965,1967,20
8992776908,8992776906,-2,1228,3302,20
8996269205,8996269201,-4,1073,2632,20
9005439854,9005439851,-3,1312,3056,20
9005681873,9005681871,-2,869,2493,20
9006841534,9006841530,-4,1182,2441,20
9010132115,9010132113,-2,1346,2149,20
9016094941,9016094943,2,2219,2009,20
9016580395,9016580390,-5,1048,2041,20
9019319171,9019319168,-3,1102,2782,20
9021320441,9021320445,4,1380,1166,20
9023642991,9023642987,-4,1375,2284,20
9026716570,9026716568,-2,880,2456,20
9028208793,9028208790,-3,1571,2578,20
9029091532,9029091517,-15,1174,2053,20
9029607846,9029607847,1,2007,1831,20
9030465279,9030465275,-4,619,2457,20
9031047830,9031047822,-8,102,1170,20
9034116057,9034116054,-3,749,1842,20
9037573173,9037573169,-4,1035,2279,20
9038849214,9038849214,0,743,1783,20
9042201959,9042201959,0,2091,2355,20
9043167197,9043167194,-3,672,1886,20
9043214214,9043214210,-4,1063,2619,20
9044476126,9044476127,1,1329,2453,20
9047770190,9047770186,-4,1519,2438,20
9047852998,9047852998,0,1172,2580,20
9052640299,9052640297,-2,986,1498,20
9053085869,9053085855,-14,1109,13139,20
9054855247,9054855245,-2,973,2220,20
9058356723,9058356719,-4,944,1848,20
9063466895,9063466894,-1,1039,1974,20
9072409210,9072409205,-5,865,1478,20
9075551414,9075551411,-3,1139,2491,20
9076113315,9076113313,-2,1188,2050,20
9077705435,9077705433,-2,1133,1922,20
9077982844,9077982843,-1,1564,2122,20
9078188932,9078188943,11,272,975,20
9081810926,9081810935,9,14957,23391,20
9083541794,9083541792,-2,1008,2288,20
9085166735,9085166735,0,875,763,20
9086441421,9086441426,5,2678,1208,20
9091359834,9091359831,-3,1259,2490,20
9095593568,9095593563,-5,1234,2502,20
9098601722,9098601721,-1,1043,2898,20
9099516966,9099516962,-4,1276,2014,20
9100771527,9100771524,-3,1138,2440,20
9104182820,9104182818,-2,812,3684,20
9115148015,9115148013,-2,1094,2003,20
9116230915,9116230913,-2,1205,2496,20
9121334774,9121334790,16,11232,50433,20
9124587055,9124587054,-1,809,1905,20
9124617808,9124617805,-3,1839,3117,20
9125875141,9125875155,14,89,984,20
9133229627,9133229622,-5,924,1762,20
9149473351,9149473351,0,1292,2039,20
9154298300,9154298298,-2,1168,2229,20
9154441754,9154441751,-3,1189,2098,20
9157869063,9157869059,-4,1328,1958,20
9158130214,9158130214,0,1117,2810,20
9161084234,9161084231,-3,1030,2974,20
9161630363,9161630357,-6,1124,4267,20
9165223090,9165223085,-5,1041,3272,20
9166209146,9166209142,-4,1091,1895,20
9174962646,9174962639,-7,1095,3849,20
9175999942,9175999939,-3,1068,2852,20
9178374848,9178374845,-3,1349,2428,20
9182630367,9182630366,-1,870,2463,20
9191894935,9191894930,-5,1038,1515,20
9192692909,9192692929,20,297,1457,20
9194195395,9194195394,-1,1115,2402,20
9195851875,9195851873,-2,1226,2140,20
9196979602,9196979598,-4,1221,2634,20
9197174743,9197174762,19,777,1742,20
9198247495,9198247494,-1,1069,2045,20
9198678683,9198678678,-5,1018,2471,20
9204780303,9204780300,-3,1550,2992,20
9207611487,9207611484,-3,1247,1814,20
9209620602,9209620601,-1,1116,1422,20
9212175770,9212175766,-4,1248,2896,20
9214317115,9214317114,-1,1156,2470,20
9214737219,9214737214,-5,830,1860,20
9215318574,9215318570,-4,933,2697,20
9217776818,9217776816,-2,1368,2839,20
9218765178,9218765174,-4,882,2338,20
9219083743,9219083741,-2,1114,2745,20
9219108967,9219108982,15,881,2120,20
9219865998,9219865994,-4,1126,1791,20
9221324145,9221324142,-3,1413,2128,20
9228060869,9228060866,-3,869,2168,20
9229166962,9229166955,-7,865,4076,20
9231181490,9231181486,-4,1036,2476,20
9234174232,9234174245,13,2554,1671,20
9235098769,9235098766,-3,1061,2015,20
9239114738,9239114734,-4,1205,2377,20
9248594450,9248594448,-2,1335,3102,20
9248954394,9248954392,-2,1146,1811,20
9255406045,9255406046,1,1154,1433,20
9257816666,9257816672,6,17951,45545,20
9261763070,9261763066,-4,1153,3111,20
9262070367,9262070363,-4,997,1492,20
9267163050,9267163049,-1,911,2079,20
9272002326,9272002327,1,1449,1041,20
9277105266,9277105262,-4,1205,2097,20
9278909156,9278909152,-4,957,2526,20
9281926428,9281926427,-1,1303,1742,20
9282586565,9282586561,-4,1337,2625,20
9285200069,9285200066,-3,1188,2562,20
9286041697,9286041690,-7,1909,6792,20
9286515515,9286515509,-6,1429,2272,20
9287723644,9287723663,19,529,2057,20
9289259690,9289259689,-1,1115,1948,20
9289789583,9289789582,-1,1134,1663,20
9308837665,9308837661,-4,913,2222,20
9319266583,9319266578,-5,1484,3169,20
9319600204,9319600201,-3,1247,3179,20
9320449490,9320449488,-2,1665,2897,20
9322089417,9322089414,-3,1378,2838,20
9322513659,9322513656,-3,1135,1926,20
9324908831,9324908837,6,1208,1063,20
9325914469,9325914467,-2,1226,2501,20
9329076707,9329076703,-4,1054,2162,20
9331002036,9331002037,1,1274,1840,20
9332222018,9332222021,3,3340,1912,20
9336372290,9336372288,-2,973,1218,20
9343619435,9343619434,-1,1001,2108,20
9348942642,9348942663,21,811,164,20
9350785513,9350785510,-3,1403,2403,20
9352172466,9352172465,-1,1298,2018,20
9354844469,9354844468,-1,1421,1959,20
9359947152,9359947149,-3,1198,2851,20
9369500991,9369500989,-2,1397,2215,20
9373927046,9373927042,-4,820,2289,20
9379628160,9379628162,2,1417,1798,20
9383950374,9383950369,-5,952,2128,20
9385206965,9385206962,-3,1794,2919,20
9389724621,9389724617,-4,1044,3031,20
9390063957,9390063947,-10,1279,2193,20
9396096942,9396096939,-3,720,1340,20
9398806492,9398806489,-3,3315,6659,20
9400152238,9400152234,-4,1154,2864,20
9402292937,9402292933,-4,1056,2287,20
9411895049,9411895045,-4,1198,3451,20
9412207653,9412207648,-5,1068,2263,20
9414166994,9414167007,13,174,510,20
9414436159,9414436150,-9,38616,15364,20
9414472765,9414472767,2,2118,2431,20
9419158765,9419158764,-1,1227,2714,20
9422036851,9422036849,-2,981,2159,20
9423001903,9423001899,-4,787,1858,20
9423048199,9423048184,-15,1235,3300,20
9423299646,9423299643,-3,622,2524,20
9426611497,9426611501,4,14650,11514,20
9430249429,9430249426,-3,1187,1967,20
9430521952,9430521967,15,49,979,20
9434977183,9434977181,-2,1390,2668,20
9435254374,9435254371,-3,21212,46693,20
9439807423,9439807427,4,1931,1077,20
9440663793,9440663791,-2,1182,2022,20
9447372419,9447372416,-3,758,1128,20
9449023681,9449023675,-6,987,2725,20
9449474902,9449474922,20,984,2094,20
9450325282,9450325279,-3,1065,2180,20
9450528314,9450528313,-1,705,1323,20
9451232419,9451232416,-3,749,2552,20
9453364199,9453364198,-1,1063,2222,20
9456019967,9456019965,-2,581,1607,20
9457886547,9457886549,2,1034,1246,20
9474663727,9474663724,-3,1266,2050,20
9477091889,9477091884,-5,834,1180,20
9478486692,9478486690,-2,1184,2278,20
9481300636,9481300635,-1,1540,2846,20
9486670638,9486670635,-3,1083,1968,20
9487795489,9487795483,-6,823,3388,20
9494197395,9494197392,-3,1258,2720,20
9495018710,9495018704,-6,1222,2807,20
9495467543,9495467540,-3,1448,2435,20
9496757979,9496757978,-1,992,2299,20
9499297846,9499297826,-20,907,268,20
9504389901,9504389897,-4,1233,1736,20
9507998298,9507998294,-4,1126,3198,20
9508386448,9508386427,-21,891,1644,20
9508617788,9508617785,-3,1316,1992,20
9511147330,9511147327,-3,890,1732,20
9516769268,9516769270,2,2049,1761,20
9518143519,9518143516,-3,1070,2121,20
9518199317,9518199334,17,661,1189,20
9518473113,9518473114,1,1224,2007,20
9518634704,9518634722,18,256,863,20
9522669157,9522669153,-4,589,2075,20
9523934547,9523934544,-3,360,2332,20
9524275062,9524275056,-6,1150,2965,20
9527829298,9527829294,-4,1505,3095,20
9530908259,9530908252,-7,710,2730,20
9531746667,9531746661,-6,814,3205,20
9543006981,9543006979,-2,987,1560,20
9550605723,9550605719,-4,1096,2809,20
9551090813,9551090811,-2,1132,2102,20
9551752350,9551752348,-2,1207,2041,20
9556379591,9556379587,-4,911,1228,20
9564006594,9564006613,19,969,2499,20
9564259445,9564259440,-5,1350,2758,20
9566406647,9566406645,-2,1409,2656,20
9568858452,9568858450,-2,1155,3372,20
9571093055,9571093054,-1,608,1644,20
9571148376,9571148383,7,11237,22739,20
9578825016,9578825012,-4,924,1722,20
9587566601,9587566597,-4,1479,2454,20
9587989997,9587989994,-3,1271,2702,20
9588473535,9588473531,-4,1075,2157,20
9592839498,9592839498,0,879,2167,20
9600879849,9600879846,-3,1272,3181,20
9601501366,9601501363,-3,1302,2618,20
9601763790,9601763786,-4,1272,3283,20
9602945179,9602945173,-6,1068,2064,20
9604899896,9604899894,-2,1274,2610,20
9605460798,9605460794,-4,1212,2497,20
9616516522,9616516518,-4,1435,3107,20
9619423680,9619423676,-4,1549,2387,20
9623228971,9623228967,-4,1207,2585,20
9624025551,9624025549,-2,1840,2770,20
9624541735,9624541733,-2,1214,2732,20
9625749196,9625749197,1,1550,1791,20
9628089521,9628089511,-10,15068,27525,20
9631963531,9631963527,-4,1661,2696,20
9637157649,9637157646,-3,1590,2235,20
9639132344,9639132343,-1,953,1498,20
9639751650,9639751647,-3,1187,1840,20
9650584254,9650584253,-1,1159,1468,20
9651691804,9651691790,-14,744,4177,20
9653071258,9653071254,-4,988,2367,20
9653255646,9653255630,-16,152,1341,20
9657846959,9657846958,-1,788,2126,20
9658529414,9658529411,-3,1156,2157,20
9659038485,9659038485,0,1194,1760,20
9661224198,9661224196,-2,1117,2122,20
9661764627,9661764625,-2,1291,2436,20
9661876346,9661876344,-2,1229,3071,20
9663186112,9663186111,-1,973,1490,20
9669265603,9669265601,-2,1334,2441,20
9669894189,9669894186,-3,1135,1944,20
9672093153,9672093149,-4,1051,1459,20
9673958375,9673958372,-3,1146,2089,20
9675186778,9675186775,-3,1168,2661,20
9675893527,9675893511,-16,281,998,20
9676957099,9676957094,-5,1245,1963,20
9678602115,9678602110,-5,1472,2492,20
9683542026,9683542025,-1,1183,2094,20
9685208259,9685208255,-4,1398,2266,20
9686787375,9686787373,-2,1246,1955,20
9687379035,9687379046,11,789,1577,20
9699975446,9699975442,-4,897,1902,20
9701026467,9701026463,-4,1490,2882,20
9707418641,9707418639,-2,988,2017,20
9711936461,9711936457,-4,890,2654,20
9712615014,9712614993,-21,31,4705,20
9716393358,9716393354,-4,933,2663,20
9716558742,9716558726,-16,13,795,20
9722681327,9722681322,-5,610,1651,20
9729624769,9729624768,-1,1068,1573,20
9731231757,9731231754,-3,1487,2120,20
9736253225,9736253223,-2,1219,2543,20
9737753354,9737753352,-2,1465,1811,20
9742235755,9742235750,-5,981,1627,20
9743074062,9743074058,-4,1137,1723,20
9744453021,9744453017,-4,1015,2757,20
9744699528,9744699542,14,378,593,20
9746724591,9746724586,-5,1126,2406,20
9748079489,9748079486,-3,1027,2135,20
9749789764,9749789759,-5,1397,2398,20
9761168115,9761168113,-2,875,2248,20
9762409655,9762409653,-2,1203,1553,20
9765323976,9765323969,-7,2059,6611,20
9767832564,9767832563,-1,987,3120,20
9769399736,9769399742,6,2153,952,20
9772004289,9772004292,3,4385,2715,20
9772114504,9772114511,7,3765,1430,20
9772281867,9772281865,-2,854,1849,20
9772835036,9772835017,-19,1061,2345,20
9775665678,9775665677,-1,1136,2333,20
9782355086,9782355086,0,615,1272,20
9782739431,9782739430,-1,1099,2413,20
9784098118,9784098128,10,3781,1537,20
9785716734,9785716739,5,1520,1074,20
9786353458,9786353456,-2,1185,2050,20
9786915777,9786915774,-3,1296,1932,20
9789133335,9789133330,-5,804,2530,20
9793602499,9793602497,-2,1168,2712,20
9793807219,9793807213,-6,2251,6980,20
9794240759,9794240755,-4,770,2085,20
9794993435,9794993430,-5,1241,1953,20
9795646971,9795646976,5,3489,1752,20
9795810976,9795810973,-3,760,2566,20
9798723731,9798723725,-6,1264,2353,20
9799718211,9799718207,-4,984,2620,20
9800246141,9800246138,-3,1219,2636,20
9801406614,9801406609,-5,1611,2208,20
9805621335,9805621334,-1,1317,2734,20
9806102374,9806102369,-5,1296,2115,20
9809366402,9809366399,-3,881,2494,20
9811091670,9811091668,-2,1022,1926,20
9813057291,9813057290,-1,1172,1711,20
9818426293,9818426290,-3,831,1402,20
9821499436,9821499435,-1,1263,2441,20
9822533221,9822533217,-4,1418,3190,20
9824143370,9824143367,-3,790,2072,20
9826689387,9826689385,-2,1355,2116,20
9828784119,9828784126,7,990,1564,20
9834705773,9834705769,-4,1697,3877,20
9834880345,9834880341,-4,867,2782,20
9835669253,9835669249,-4,1509,2825,20
9836947235,9836947234,-1,1160,1558,20
9840662116,9840662113,-3,1333,2755,20
9843012054,9843012053,-1,984,2715,20
9843930305,9843930302,-3,1037,1807,20
9844695631,9844695629,-2,557,1603,20
9846279823,9846279818,-5,1010,1725,20
9847140752,9847140749,-3,1089,3031,20
9848192918,9848192914,-4,1383,2293,20
9852323098,9852323094,-4,1284,1632,20
9855894898,9855894896,-2,991,1672,20
9862552025,9862552020,-5,793,3297,20
9867051785,9867051783,-2,940,1733,20
9869733731,9869733727,-4,892,1570,20
9870644663,9870644661,-2,1202,2365,20
9883160953,9883160950,-3,831,1517,20
9884228362,9884228366,4,15133,8455,20
9884394574,9884394574,0,959,1055,20
9886039706,9886039702,-4,1057,2213,20
9887292747,9887292746,-1,930,1861,20
9887692029,9887692024,-5,1112,1908,20
9893899718,9893899714,-4,1289,1592,20
9894362172,9894362189,17,405,1598,20
9898950631,9898950630,-1,1249,2661,20
9901197047,9901197044,-3,1138,2396,20
9905017342,9905017338,-4,1259,2177,20
9906773502,9906773508,6,2339,1339,20
9906887331,9906887328,-3,1411,2200,20
9907978237,9907978237,0,1270,1694,20
9909445882,9909445879,-3,851,2595,20
9911594690,9911594698,8,1694,1185,20
9911963659,9911963655,-4,833,1875,20
9913279116,9913279134,18,551,1429,20
9914202054,9914202051,-3,1049,2256,20
9916056813,9916056826,13,916,946,20
9918560693,9918560687,-6,1027,1913,20
9918846572,9918846570,-2,1557,2970,20
9922323587,9922323581,-6,1093,1907,20
9923590869,9923590869,0,979,1126,20
9925851071,9925851069,-2,896,1785,20
9934976667,9934976662,-5,585,1434,20
9937073022,9937073018,-4,1165,2224,20
9942887303,9942887298,-5,1160,2450,20
9943806121,9943806119,-2,1270,2591,20
9944164354,9944164352,-2,1217,2761,20
9948094249,9948094247,-2,985,1944,20
9948801646,9948801643,-3,1286,2511,20
9951061358,9951061356,-2,1452,3075,20
9958944466,9958944461,-5,1038,2040,20
9959208697,9959208693,-4,978,3296,20
9963287690,9963287688,-2,779,2061,20
9968255346,9968255345,-1,1164,2362,20
9974791281,9974791277,-4,1329,3087,20
9980548254,9980548255,1,721,711,20
9981344600,9981344613,13,328,1140,20
9982086729,9982086725,-4,857,2290,20
9986254863,9986254859,-4,930,2916,20
9994530315,9994530311,-4,948,1568,20
9996004124,9996004122,-2,48,682,20
9998797015,9998797013,-2,1089,1632,20
10001615230,10001615224,-6,1301,3380,20
10003145289,10003145287,-2,1009,2324,20
10003451117,10003451099,-18,649,1424,20
10015164865,10015164867,2,4518,3103,20
10016700199,10016700195,-4,1318,2709,20
10017242463,10017242459,-4,940,1892,20
10022961149,10022961149,0,1512,2321,20
10023824811,10023824808,-3,1161,2359,20
10027819582,10027819579,-3,823,2266,20
10028357455,10028357453,-2,777,2264,20
10032092269,10032092267,-2,1354,2461,20
10033152564,10033152555,-9,260,614,20
10037092707,10037092702,-5,1216,1997,20
10040692415,10040692411,-4,933,3146,20
10046895086,10046895081,-5,1075,1853,20
10047023601,10047023598,-3,1005,2595,20
10049770637,10049770637,0,1884,1348,20
10052187334,10052187331,-3,1675,2522,20
10052702042,10052702040,-2,950,1755,20
10052868238,10052868234,-4,1026,2579,20
10055287703,10055287701,-2,1058,1696,20
10057206782,10057206781,-1,1328,2484,20
10057385881,10057385879,-2,1060,2703,20
10058724436,10058724434,-2,1258,1606,20
10063176830,10063176828,-2,1387,2699,20
10065276190,10065276182,-8,1103,2803,20
10065504790,10065504781,-9,1401,2494,20
10065744195,10065744193,-2,958,2427,20
10066624460,10066624457,-3,658,930,20
10068626347,10068626345,-2,1354,3146,20
10074637866,10074637861,-5,1229,3056,20
10075739334,10075739332,-2,1078,2678,20
10076621866,10076621863,-3,1058,2013,20
10078741162,10078741158,-4,1534,3206,20
10083484826,10083484827,1,7266,6884,20
10084569923,10084569921,-2,1098,2378,20
10084997850,10084997847,-3,692,1814,20
10086155183,10086155179,-4,970,2112,20
10087236366,10087236362,-4,1338,2328,20
10089173382,10089173397,15,804,1640,20
10090965553,10090965547,-6,1339,2823,20
10091425673,10091425667,-6,1353,3904,20
10093165938,10093165938,0,1351,1148,20
10093892737,10093892734,-3,932,1822,20
10094070838,10094070857,19,977,1746,20
10094352156,10094352145,-11,1129,1691,20
10095765671,10095765668,-3,740,2527,20
10096643419,10096643415,-4,1080,2118,20
10100428919,10100428917,-2,813,3213,20
10105744122,10105744121,-1,1088,2077,20
10105956170,10105956166,-4,1097,2653,20
10110444411,10110444407,-4,941,1907,20
10111361133,10111361150,17,198,933,20
10113671991,10113671989,-2,957,2448,20
10114409508,10114409510,2,1663,1904,20
10115137339,10115137338,-1,907,2312,20
10122007889,10122007887,-2,1111,1794,20
10130731606,10130731612,6,5741,2340,20
10133221267,10133221269,2,946,820,20
10138608629,10138608626,-3,1429,2363,20
10143903003,10143902998,-5,1203,2290,20
10146193884,10146193906,22,908,1193,20
10149760408,10149760402,-6,981,3574,20
10156478798,10156478794,-4,972,2692,20
10159471991,10159471986,-5,1514,2700,20
10161672877,10161672875,-2,31151,53528,20
10162141905,10162141902,-3,1411,2603,20
10163589954,10163589959,5,3219,1538,20
10168416154,10168416151,-3,1153,1736,20
10169278309,10169278308,-1,1798,2705,20
10172122545,10172122548,3,14776,9970,20
10176761994,10176761990,-4,887,1685,20
10182991873,10182991870,-3,1099,1753,20
10183841466,10183841466,0,1514,2501,20
10184504704,10184504718,14,613,1516,20
10184920143,10184920138,-5,757,1728,20
10187501322,10187501320,-2,1003,2020,20
10194484042,10194484037,-5,1283,2454,20
10196697906,10196697904,-2,1172,1522,20
10207562291,10207562288,-3,1089,2993,20
10208727159,10208727155,-4,911,2265,20
10209746053,10209746050,-3,1369,2929,20
10213019534,10213019530,-4,1318,2367,20
10213459234,10213459229,-5,757,2385,20
10215898735,10215898732,-3,1123,2804,20
10218186362,10218186358,-4,644,1541,20
10221650959,10221650954,-5,1091,2276,20
10226598529,10226598527,-2,1294,2449,20
10230270876,10230270870,-6,1978,5418,20
10230732119,10230732115,-4,1204,2108,20
10230840574,10230840570,-4,1215,1800,20
10232061896,10232061909,13,891,2903,20
10236849691,10236849688,-3,932,2303,20
10237569355,10237569351,-4,1482,2276,20
10243616298,10243616294,-4,1472,1934,20
10244990971,10244990970,-1,1174,2901,20
10245552108,10245552093,-15,697,1671,20
10247253454,10247253451,-3,1105,2387,20
10248771428,10248771409,-19,1400,3012,20
10250100047,10250100046,-1,31,1358,20
10250261831,10250261826,-5,850,2491,20
10253497969,10253497975,6,1608,921,20
10254475287,10254475295,8,7028,2373,20
10259301035,10259301034,-1,3122,5097,20
10261925651,10261925647,-4,1172,3096,20
10263932991,10263932989,-2,1387,2006,20
10271987498,10271987495,-3,840,2179,20
10273381243,10273381241,-2,1038,1641,20
10273815365,10273815362,-3,1411,3076,20
10273959538,10273959537,-1,949,1782,20
10275555846,10275555843,-3,921,1899,20
10275749706,10275749703,-3,1246,3055,20
10276913625,10276913620,-5,789,2286,20
10281954467,10281954465,-2,1056,3547,20
10283452649,10283452659,10,606,1354,20
10283566247,10283566253,6,87,1185,20
10286413541,10286413537,-4,1249,2765,20
10291453913,10291453934,21,945,2247,20
10296124926,10296124923,-3,1381,2756,20
10297772909,10297772915,6,3492,1586,20
10299498698,10299498694,-4,1013,2331,20
10301795754,10301795740,-14,46812,13354,20
10304235745,10304235741,-4,1385,2332,20
10305776502,10305776499,-3,836,805,20
10317925743,10317925737,-6,1107,3335,20
10320404327,10320404322,-5,1156,2618,20
10321721214,10321721209,-5,890,1841,20
10323799926,10323799923,-3,739,2081,20
10324397250,10324397249,-1,1023,1892,20
10325266597,10325266595,-2,120,783,20
10331709905,10331709902,-3,1084,2350,20
10334348670,10334348669,-1,1694,3099,20
10343153435,10343153433,-2,1284,2273,20
10343840730,10343840727,-3,1210,1900,20
10344054465,10344054462,-3,1190,2756,20
10346616044,10346616042,-2,1001,2129,20
10348386583,10348386580,-3,1284,1511,20
10349973517,10349973510,-7,1133,1712,20
10352462022,10352462026,4,2111,1114,20
10354877344,10354877343,-1,3097,5281,20
10356090622,10356090618,-4,1288,2264,20
10361725773,10361725770,-3,809,1606,20
10363204614,10363204614,0,3021,4373,20
10363506374,10363506372,-2,5435,10011,20
10364571855,10364571854,-1,784,1137,20
10368153106,10368153101,-5,1181,2865,20
10368798626,10368798623,-3,1068,2363,20
10380593663,10380593663,0,1172,1624,20
10382726733,10382726729,-4,1333,2737,20
10384369919,10384369917,-2,1113,1930,20
10391749878,10391749874,-4,858,2623,20
10395377823,10395377829,6,3307,2288,20
10397812114,10397812096,-18,1035,5691,20
10399805877,10399805874,-3,1166,2524,20
10403953966,10403953963,-3,1269,1874,20
10404467954,10404467954,0,842,1819,20
10406387654,10406387653,-1,665,1151,20
10407152211,10407152208,-3,1521,2540,20
10413111009,10413111004,-5,1082,3156,20
10413950161,10413950158,-3,1159,3769,20
10415108997,10415109017,20,823,1177,20
10415441870,10415441865,-5,780,1892,20
10416656311,10416656310,-1,1224,1681,20
10418095082,10418095102,20,841,1970,20
10419573558,10419573555,-3,959,2306,20
10426483491,10426483486,-5,1519,2585,20
10430218809,10430218809,0,1155,1258,20
10431811151,10431811152,1,806,1282,20
10433522003,10433521998,-5,768,1720,20
10435590173,10435590175,2,3277,1818,20
10435703858,10435703853,-5,1259,1867,20
10437408158,10437408156,-2,700,1762,20
10447206518,10447206516,-2,1283,1752,20
10447822249,10447822248,-1,1260,2550,20
10448413866,10448413872,6,9783,3443,20
10448838466,10448838463,-3,708,2323,20
10450217230,10450217236,6,10398,33562,20
10451738766,10451738762,-4,1443,2814,20
10463522521,10463522515,-6,1139,2938,20
10469860442,10469860438,-4,1232,1977,20
10472735818,10472735816,-2,1093,2025,20
10473608078,10473608077,-1,1469,1856,20
10474533787,10474533785,-2,1115,2802,20
10474593409,10474593407,-2,685,2242,20
10475479196,10475479194,-2,1242,1706,20
10475838597,10475838592,-5,1077,1908,20
10476353723,10476353728,5,3431,2667,20
10479508338,10479508336,-2,1165,3017,20
10480104850,10480104846,-4,1346,3227,20
10480333104,10480333100,-4,938,2111,20
10482284427,10482284423,-4,1072,1962,20
10484342565,10484342563,-2,1006,2081,20
10485671431,10485671429,-2,1135,2331,20
10488154327,10488154324,-3,1362,2265,20
10491529427,10491529425,-2,1235,2023,20
10495030998,10495030996,-2,827,2214,20
10496291491,10496291486,-5,2993,12337,20
10497047643,10497047637,-6,1274,3663,20
10497097343,10497097336,-7,997,6109,20
10499651399,10499651377,-22,886,2454,20
10501494286,10501494284,-2,1165,1797,20
10506636757,10506636754,-3,1161,2445,20
10507794394,10507794390,-4,1433,3270,20
10508319846,10508319847,1,3579,3656,20
10509848017,10509848016,-1,966,1790,20
10512860276,10512860258,-18,1429,2717,20
10516740874,10516740870,-4,937,2179,20
10517196076,10517196058,-18,937,1634,20
10517659590,10517659579,-11,47,551,20
10519617003,10519617000,-3,1371,3019,20
10521343246,10521343242,-4,1369,3041,20
10521630378,10521630381,3,2834,2546,20
10534091373,10534091370,-3,1397,2218,20
10535724663,10535724658,-5,1224,2154,20
10536095071,10536095067,-4,959,2306,20
10541022455,10541022448,-7,1125,3660,20
10543997482,10543997480,-2,1070,2108,20
10556346095,10556346091,-4,1418,2682,20
10557064086,10557064085,-1,826,1798,20
10558938650,10558938654,4,1861,1360,20
10560460629,10560460629,0,943,1853,20
10562559342,10562559337,-5,1068,2450,20
10563120023,10563120019,-4,926,2322,20
10565520417,10565520415,-2,1477,2329,20
10566400998,10566401010,12,821,3178,20
10569656693,10569656689,-4,957,1960,20
10573790787,10573790783,-4,1147,1959,20
10575431098,10575431094,-4,1465,2722,20
10576919039,10576919036,-3,1397,2979,20
10577788375,10577788372,-3,1653,3759,20
10580672784,10580672778,-6,2358,7029,20
10585857387,10585857387,0,1035,1597,20
10589379312,10589379310,-2,1528,2479,20
10594197322,10594197318,-4,1137,2719,20
10594982516,10594982514,-2,1397,2046,20
10597070686,10597070682,-4,1128,1611,20
10608850783,10608850780,-3,1583,2783,20
10611265816,10611265813,-3,970,1802,20
10614723206,10614723203,-3,1004,1998,20
10625548418,10625548411,-7,1307,3247,20
10634829322,10634829318,-4,698,2040,20
10635412538,10635412538,0,1077,1260,20
10637858651,10637858647,-4,1370,3171,20
10639006834,10639006829,-5,1059,2057,20
10644939129,10644939129,0,1771,2162,20
10645868834,10645868832,-2,1219,2527,20
10646627061,10646627055,-6,1184,2279,20
10648726959,10648726955,-4,1048,2128,20
10650591686,10650591684,-2,992,2247,20
10653003633,10653003630,-3,890,2581,20
10655446199,10655446196,-3,956,1800,20
10657517347,10657517345,-2,1599,3374,20
10661073925,10661073922,-3,765,3865,20
10661875251,10661875248,-3,1049,1962,20
10663403382,10663403383,1,1105,1691,20
10664041855,10664041834,-21,1173,1772,20
10666852691,10666852688,-3,1234,2332,20
10668594006,10668594005,-1,1009,2341,20
10673075439,10673075435,-4,1111,2235,20
10674450329,10674450327,-2,961,1727,20
10678606662,10678606658,-4,889,2876,20
10684689565,10684689564,-1,1448,1502,20
10687154418,10687154419,1,1025,1712,20
10688288190,10688288196,6,4189,1447,20
10688856049,10688856049,0,1522,1928,20
10692937728,10692937725,-3,34269,27703,20
10695051773,10695051771,-2,1130,2833,20
10695130950,10695130942,-8,420,788,20
10695450464,10695450479,15,1293,2696,20
10695969160,10695969159,-1,1164,1720,20
10696504094,10696504087,-7,792,2370,20
10698339338,10698339336,-2,2266,2761,20
10698397041,10698397039,-2,1756,3243,20
10700340361,10700340365,4,2904,1874,20
10701390030,10701390025,-5,981,2125,20
10702270684,10702270681,-3,1264,3014,20
10706504510,10706504507,-3,1098,2838,20
10706663799,10706663786,-13,1237,2938,20
10710301123,10710301117,-6,2061,5856,20
10711195339,10711195337,-2,1097,1845,20
10713621652,10713621648,-4,1143,2088,20
10714890193,10714890192,-1,1430,3011,20
10716577520,10716577537,17,1104,3109,20
10722541490,10722541487,-3,1085,2358,20
10723081233,10723081230,-3,830,2145,20
10723466032,10723466030,-2,1269,2337,20
10724135455,10724135452,-3,912,2424,20
10724757800,10724757817,17,966,2421,20
10726897590,10726897587,-3,946,1620,20
10729430295,10729430293,-2,659,1895,20
10729608007,10729608004,-3,1079,1979,20
10733123065,10733123061,-4,1034,1357,20
10733602343,10733602323,-20,1220,2057,20
10733687711,10733687689,-22,247,816,20
10737871496,10737871492,-4,828,3410,20
10741463045,10741463041,-4,700,2291,20
10753675449,10753675445,-4,1477,2621,20
10758968299,10758968299,0,1017,2064,20
10764121276,10764121274,-2,1341,2374,20
10765443581,10765443583,2,1267,1582,20
10772615719,10772615715,-4,954,2374,20
10777018486,10777018485,-1,1247,2586,20
10777260465,10777260465,0,1057,1496,20
10777443854,10777443851,-3,1179,2910,20
10781184179,10781184175,-4,1020,2273,20
10781942233,10781942233,0,1550,1916,20
10786846014,10786846011,-3,1101,2817,20
10787214677,10787214681,4,102,1071,20
10791002910,10791002915,5,3076,1818,20
10794561871,10794561864,-7,1155,3028,20
10799757365,10799757361,-4,1172,2483,20
10801887653,10801887650,-3,1671,3276,20
10811399183,10811399183,0,887,1616,20
10812783336,10812783353,17,1175,2876,20
10824551685,10824551683,-2,1166,2221,20
10831016137,10831016118,-19,1578,806,20
10832338684,10832338682,-2,1811,2755,20
10833818261,10833818255,-6,1134,2386,20
10837187258,10837187257,-1,2804,4673,20
10837255383,10837255379,-4,1186,2590,20
10837298701,10837298722,21,760,1341,20
10837432479,10837432478,-1,825,1737,20
10840467549,10840467546,-3,1340,2527,20
10841542049,10841542046,-3,1584,2610,20
10842205134,10842205129,-5,1051,2197,20
10847267321,10847267316,-5,1142,1983,20
10848239263,10848239258,-5,738,2360,20
10849348007,10849348003,-4,1367,2933,20
10849980465,10849980462,-3,880,2004,20
10852368987,10852368986,-1,1207,2039,20
10853310663,10853310661,-2,1068,2383,20
10853623114,10853623113,-1,1019,3035,20
10855126071,10855126067,-4,875,2057,20
10863025663,10863025660,-3,1184,2683,20
10864317045,10864317042,-3,1303,2277,20
10865047210,10865047210,0,1258,1342,20
10865689074,10865689070,-4,1413,3249,20
10866265511,10866265509,-2,1465,1766,20
10873400390,10873400390,0,1275,1889,20
10874439673,10874439670,-3,1313,2816,20
10874500709,10874500706,-3,1295,3086,20
10876079412,10876079410,-2,1896,3313,20
10880241537,10880241558,21,799,2865,20
10880969525,10880969523,-2,1180,3019,20
10884762191,10884762188,-3,976,3119,20
10886099888,10886099885,-3,966,2052,20
10886532130,10886532128,-2,869,2703,20
10892466579,10892466577,-2,844,1904,20
10893229076,10893229067,-9,2890,15386,20
10893302514,10893302510,-4,1265,2415,20
10897014762,10897014759,-3,1420,3019,20
10899951390,10899951387,-3,1138,2386,20
10905505298,10905505295,-3,1181,2290,20
10912020323,10912020321,-2,794,2501,20
10915781470,10915781469,-1,1152,2173,20
10916670937,10916670940,3,3628,30092,20
10920200850,10920200849,-1,1012,1407,20
10922420029,10922420022,-7,1209,4287,20
10923923146,10923923142,-4,1573,2563,20
10925216439,10925216437,-2,1084,2604,20
10930507405,10930507402,-3,912,1663,20
10931167120,10931167119,-1,610,1334,20
10932160848,10932160849,1,1085,1442,20
10936208417,10936208426,9,2264,1529,20
10938430595,10938430591,-4,901,2226,20
10940059722,10940059723,1,1789,1789,20
10941553705,10941553701,-4,1319,2453,20
10942308979,10942308977,-2,986,2433,20
10950349133,10950349131,-2,860,2057,20
10951946731,10951946726,-5,1336,3164,20
10953464629,10953464640,11,13095,54777,20
10956527386,10956527383,-3,1416,1954,20
10958820154,10958820158,4,4872,2520,20
10961908849,10961908846,-3,823,2048,20
10963539232,10963539226,-6,1942,10200,20
10963865050,10963865045,-5,770,1653,20
10967236548,10967236545,-3,1267,1984,20
10968761042,10968761039,-3,865,1925,20
10972358253,10972358251,-2,877,1297,20
10972619158,10972619147,-11,911,2930,20
10973080144,10973080142,-2,2276,3687,20
10974859119,10974859113,-6,783,3877,20
10976378426,10976378424,-2,1140,2426,20
10978688511,10978688505,-6,1033,2415,20
10981343078,10981343077,-1,1039,1656,20
10986973266,10986973260,-6,1070,4751,20
10988574794,10988574793,-1,733,2664,20
10994943823,10994943821,-2,1523,2022,20
10996948120,10996948127,7,4205,1919,20
10997543378,10997543375,-3,1026,2556,20
10999005774,10999005770,-4,1329,2590,20
10999962299,10999962296,-3,1101,1435,20
11000356282,11000356279,-3,1207,2319,20
11005486267,11005486264,-3,935,2048,20
11011049282,11011049283,1,1832,2027,20
11011616781,11011616778,-3,1386,1602,20
11014447397,11014447393,-4,777,1815,20
11014485637,11014485635,-2,1142,2375,20
11014881075,11014881073,-2,1255,1765,20
11016630070,11016630066,-4,1167,2445,20
11017488318,11017488322,4,4523,2421,20
11019345647,11019345628,-19,30,778,20
11021396408,11021396403,-5,1807,3259,20
11021432430,11021432412,-18,1010,1987,20
11022574155,11022574157,2,1948,1607,20
11035357666,11035357663,-3,731,1412,20
11036634458,11036634457,-1,1011,2349,20
11037117686,11037117683,-3,1115,2324,20
11039656442,11039656437,-5,1170,2608,20
11052281049,11052281045,-4,1024,2042,20
11052748090,11052748094,4,1294,1229,20
11053215336,11053215330,-6,1358,3268,20
11054014009,11054014005,-4,777,1375,20
11056319545,11056319543,-2,1106,2187,20
11056682802,11056682798,-4,832,2245,20
11059478474,11059478470,-4,862,2718,20
11060255805,11060255801,-4,1045,3263,20
11065239299,11065239297,-2,1076,1805,20
11065843645,11065843644,-1,1333,1694,20
11074726199,11074726196,-3,1524,2786,20
11078092261,11078092272,11,962,1714,20
11081831158,11081831155,-3,1179,2029,20
11086120936,11086120933,-3,1840,2895,20
11086659754,11086659757,3,39756,26123,20
11089111143,11089111142,-1,941,2401,20
11090300506,11090300505,-1,1368,2271,20
11100794474,11100794491,17,164,932,20
11101504167,11101504182,15,756,2029,20
11105946647,11105946642,-5,1613,2544,20
11109985598,11109985596,-2,1376,2717,20
11110990504,11110990501,-3,1446,2668,20
11111059841,11111059839,-2,1096,2400,20
11116045523,11116045521,-2,853,2029,20
11118890875,11118890873,-2,2222,3915,20
11123157026,11123157022,-4,988,2537,20
11124264710,11124264709,-1,1082,2476,20
11129399498,11129399495,-3,1255,1794,20
11130339178,11130339174,-4,1196,2324,20
11138820299,11138820295,-4,1156,3008,20
11139773662,11139773659,-3,1108,2420,20
11144155568,11144155561,-7,739,2196,20
11145214659,11145214657,-2,1573,1822,20
11145697962,11145697958,-4,869,2200,20
11156404725,11156404721,-4,852,2040,20
11157498319,11157498315,-4,992,2480,20
11157530998,11157530994,-4,1323,3670,20
11157679651,11157679650,-1,1089,2559,20
11164802707,11164802701,-6,1143,3643,20
11165488311,11165488307,-4,1294,2099,20
11177716051,11177716048,-3,896,2741,20
11178136454,11178136444,-10,817,2040,20
11178558007,11178558004,-3,1225,2800,20
11182745707,11182745705,-2,811,1620,20
11186661710,11186661706,-4,1383,2825,20
11188110478,11188110477,-1,862,1800,20
11189253125,11189253122,-3,1249,2157,20
11189898720,11189898718,-2,1158,3355,20
11191736649,11191736645,-4,1437,2185,20
11193177464,11193177458,-6,1062,3381,20
11195296851,11195296847,-4,917,2067,20
11197870418,11197870415,-3,696,1562,20
11197935335,11197935352,17,907,2309,20
11199355222,11199355218,-4,965,2451,20
11208076822,11208076823,1,1862,1581,20
11208247351,11208247347,-4,1039,2459,20
11212849485,11212849482,-3,915,2595,20
11212883540,11212883556,16,287,1069,20
11213712244,11213712241,-3,952,2486,20
11215218591,11215218589,-2,1067,2350,20
11217150168,11217150166,-2,1344,2161,20
11221560584,11221560580,-4,1281,2450,20
11225925253,11225925250,-3,965,1970,20
11226031311,11226031292,-19,1037,2342,20
11228491283,11228491281,-2,1304,1904,20
11229430298,11229430298,0,424,1665,20
11233938377,11233938375,-2,1580,2030,20
11234986959,11234986949,-10,978,1788,20
11240210429,11240210427,-2,1494,3074,20
11241290697,11241290699,2,1503,1964,20
11242633451,11242633447,-4,978,2610,20
11243551183,11243551177,-6,693,1471,20
11243957381,11243957400,19,635,1311,20
11248631310,11248631309,-1,1122,2012,20
11249179482,11249179479,-3,1679,2218,20
11250045135,11250045131,-4,1179,1983,20
11254647493,11254647490,-3,1180,2794,20
11254853727,11254853725,-2,1315,2116,20
11257110406,11257110403,-3,1675,2772,20
11257650837,11257650834,-3,1202,1947,20
11262528269,11262528269,0,1020,1923,20
11264413699,11264413696,-3,937,1823,20
11275241016,11275241036,20,1050,2225,20
11279281806,11279281802,-4,1257,2606,20
11281345847,11281345853,6,5091,1912,20
11283584861,11283584858,-3,1188,2089,20
11284039967,11284039965,-2,1213,2721,20
11284485586,11284485581,-5,1312,3880,20
11284754307,11284754302,-5,858,1909,20
11286287781,11286287799,18,803,1363,20
11290852545,11290852542,-3,1338,3108,20
11290883618,11290883618,0,1192,1933,20
11293891655,11293891652,-3,1032,2315,20
11294503178,11294503178,0,1656,1990,20
11295651499,11295651498,-1,1160,2587,20
11295741334,11295741332,-2,770,1695,20
11297300461,11297300468,7,15962,18526,20
11301044214,11301044211,-3,1084,2921,20
11301244734,11301244728,-6,908,2213,20
11301778158,11301778157,-1,809,1956,20
11302028809,11302028803,-6,1087,1493,20
11304442919,11304442916,-3,1209,2057,20
11306768748,11306768745,-3,1262,2319,20
11307035105,11307035110,5,2086,1458,20
11308245716,11308245714,-2,1598,4081,20
11309910412,11309910406,-6,1015,2212,20
11317116611,11317116609,-2,999,3356,20
11319202668,11319202666,-2,963,2447,20
11321152963,11321152960,-3,971,2412,20
11326558350,11326558345,-5,1285,3004,20
11333228267,11333228282,15,920,2549,20
11342367437,11342367439,2,1668,1494,20
11350996152,11350996150,-2,1043,1838,20
11359107325,11359107333,8,6562,3352,20
11361377676,11361377677,1,5904,22030,20
11364716170,11364716170,0,1610,1571,20
11366810643,11366810642,-1,919,1874,20
11367592999,11367592994,-5,811,2035,20
11368300071,11368300069,-2,1255,2619,20
11376371973,11376371970,-3,1141,3290,20
11377645626,11377645623,-3,1164,2424,20
11378327857,11378327843,-14,3292,1609,20
11382053268,11382053265,-3,1296,2469,20
11386724469,11386724471,2,1591,1897,20
11392522359,11392522359,0,968,1534,20
11395734160,11395734162,2,1772,1333,20
11396683877,11396683900,23,1134,672,20
11397713602,11397713602,0,1126,2255,20
11403135570,11403135569,-1,1054,2452,20
11405919319,11405919314,-5,1127,2296,20
11407112003,11407112002,-1,1598,2193,20
11408457623,11408457623,0,1431,1928,20
11408507018,11408507016,-2,1650,2047,20
11409911051,11409911049,-2,854,2106,20
11412561362,11412561359,-3,1357,2504,20
11414228406,11414228402,-4,1577,2784,20
11415158926,11415158923,-3,21924,12313,20
11419540838,11419540834,-4,670,884,20
11430234450,11430234448,-2,655,1642,20
11434806861,11434806858,-3,36918,7552,20
11435550462,11435550463,1,1308,1118,20
11448050049,11448050045,-4,982,2726,20
11454512122,11454512117,-5,1781,5143,20
11456340771,11456340770,-1,831,1782,20
11457046970,11457046969,-1,1229,1958,20
11459233219,11459233215,-4,1370,2662,20
11463164850,11463164849,-1,1037,1300,20
11470731493,11470731492,-1,963,1241,20
11475972027,11475972022,-5,1061,2337,20
11476389826,11476389831,5,1965,1489,20
11478628705,11478628701,-4,1282,2134,20
11482555763,11482555761,-2,923,2315,20
11484096478,11484096477,-1,1445,3151,20
11485481257,11485481254,-3,1124,2479,20
11490872736,11490872732,-4,670,1403,20
11491687226,11491687224,-2,1011,1714,20
11492068615,11492068613,-2,1265,1644,20
11494949865,11494949867,2,881,1998,20
11495005442,11495005439,-3,894,1612,20
11496292470,11496292466,-4,1444,2409,20
11496463694,11496463690,-4,1083,2014,20
11497659939,11497659928,-11,558,354,20
11499911631,11499911628,-3,1142,2247,20
11500166682,11500166676,-6,712,2170,20
11511504147,11511504146,-1,1289,1669,20
11512491386,11512491382,-4,429,2184,20
11517474110,11517474105,-5,824,1344,20
11521333453,11521333449,-4,875,2176,20
11521746747,11521746744,-3,1273,2066,20
11531488581,11531488577,-4,2008,2966,20
11531870594,11531870591,-3,1175,2588,20
11533516358,11533516355,-3,1762,2847,20
11537040959,11537040956,-3,1154,2292,20
11537120198,11537120196,-2,979,2601,20
11537264415,11537264433,18,908,5321,20
11540287544,11540287545,1,1370,2200,20
11543886418,11543886414,-4,1206,1649,20
11545915674,11545915668,-6,1217,5693,20
11548713019,11548713016,-3,793,2382,20
11548876480,11548876497,17,1650,2931,20
11551987603,11551987599,-4,816,2410,20
11552697662,11552697666,4,1525,1245,20
11554937691,11554937689,-2,1246,2023,20
11555896334,11555896332,-2,1382,2313,20
11556816526,11556816525,-1,1084,2548,20
11560976094,11560976093,-1,1154,3237,20
11562379313,11562379309,-4,927,2935,20
11562832171,11562832169,-2,830,1455,20
11567043210,11567043211,1,1681,1778,20
11567555295,11567555298,3,1388,1105,20
11568125987,11568125985,-2,782,2113,20
11568575527,11568575545,18,1036,2595,20
11573918439,11573918437,-2,1705,2532,20
11574281058,11574281054,-4,1314,3092,20
11580900538,11580900554,16,1015,2399,20
11583480091,11583480090,-1,1120,1833,20
11587809650,11587809646,-4,1405,2244,20
11589864340,11589864338,-2,1129,2548,20
11596017879,11596017875,-4,923,1736,20
11601155602,11601155601,-1,1686,2366,20
11606235108,11606235116,8,20377,34360,20
11611845348,11611845343,-5,1371,3148,20
11614564911,11614564909,-2,1409,2081,20
11614822057,11614822054,-3,985,2632,20
11616655557,11616655555,-2,1022,2587,20
11616775124,11616775120,-4,1270,2493,20
11617324190,11617324187,-3,1139,2626,20
11620719617,11620719613,-4,1208,2246,20
11621898745,11621898742,-3,987,2163,20
11625251529,11625251526,-3,1435,2063,20
11625326628,11625326623,-5,1220,2442,20
11625396685,11625396667,-18,1092,1977,20
11625994029,11625994026,-3,964,2590,20
11629609094,11629609098,4,3355,2538,20
11630141268,11630141265,-3,1155,2380,20
11630221942,11630221940,-2,921,2387,20
11630919934,11630919930,-4,1282,1975,20
11632945368,11632945365,-3,790,1760,20
11637446734,11637446729,-5,1335,2382,20
11638393605,11638393604,-1,1181,1891,20
11639373274,11639373273,-1,889,2097,20
11639863562,11639863560,-2,1461,3424,20
11643109384,11643109387,3,1566,1507,20
11643349179,11643349178,-1,1111,2477,20
11648720975,11648720973,-2,1217,2619,20
11650865858,11650865853,-5,762,2675,20
11651828997,11651829017,20,1134,1707,20
11664859067,11664859063,-4,1230,2306,20
11670521046,11670521041,-5,1172,2933,20
11676639863,11676639859,-4,1028,2195,20
11679644334,11679644330,-4,1251,2383,20
11693897992,11693898006,14,615,1081,20
11693986657,11693986654,-3,1103,3640,20
11698401005,11698401007,2,1901,1267,20
11700555613,11700555611,-2,1312,2841,20
11700604891,11700604890,-1,1034,2017,20
11703021191,11703021188,-3,1274,2926,20
11712989982,11712989978,-4,1017,2207,20
11713439431,11713439430,-1,1004,1870,20
11714276217,11714276215,-2,1146,1907,20
11719103465,11719103461,-4,1190,2943,20
11720519350,11720519346,-4,1140,2856,20
11721183033,11721183029,-4,1299,2174,20
11721463322,11721463322,0,1069,2387,20
11721967822,11721967827,5,2189,1414,20
11725309794,11725309774,-20,1160,1580,20
11730618073,11730618072,-1,741,2443,20
11730701765,11730701762,-3,1061,2504,20
11731520727,11731520723,-4,1004,1595,20
11731726192,11731726210,18,778,1722,20
11740508394,11740508389,-5,1417,3411,20
11741784406,11741784402,-4,1530,2360,20
11744240640,11744240637,-3,1242,2516,20
11746730871,11746730867,-4,1350,2848,20
11747732410,11747732407,-3,1892,3284,20
11748836414,11748836414,0,1100,2235,20
11749635511,11749635509,-2,926,2333,20
11749894781,11749894775,-6,1195,3108,20
11750237432,11750237438,6,4704,2146,20
11752789879,11752789877,-2,1108,1598,20
11754439261,11754439258,-3,1064,3100,20
11755216282,11755216280,-2,1042,1920,20
11766762001,11766761998,-3,1253,2871,20
11766881834,11766881832,-2,977,3112,20
11767114850,11767114854,4,1730,1380,20
11768086437,11768086435,-2,1286,2047,20
11776753929,11776753927,-2,986,2014,20
11779232713,11779232709,-4,1285,2835,20
11779702616,11779702613,-3,878,1999,20
11783678444,11783678441,-3,1442,3047,20
11786896645,11786896641,-4,606,2561,20
11788863813,11788863810,-3,818,1823,20
11791705922,11791705921,-1,1900,3919,20
11798838419,11798838416,-3,989,1909,20
11802111133,11802111131,-2,1076,1479,20
11802862527,11802862526,-1,1018,1654,20
11807203133,11807203128,-5,1010,2651,20
11810682376,11810682373,-3,1188,1889,20
11812594153,11812594147,-6,2280,6461,20
11815875635,11815875633,-2,949,2320,20
11817551742,11817551740,-2,932,2801,20
11823533849,11823533845,-4,887,1953,20
11825921298,11825921294,-4,1202,2593,20
11826416053,11826416052,-1,1266,1796,20
11826598425,11826598422,-3,967,2226,20
11828442635,11828442632,-3,1326,3066,20
11829019663,11829019659,-4,821,2009,20
11831243650,11831243647,-3,1012,2300,20
11832453162,11832453158,-4,1836,2444,20
11833588155,11833588150,-5,1302,5509,20
11837665305,11837665302,-3,1496,3297,20
11838679167,11838679162,-5,790,2161,20
11842946519,11842946515,-4,896,1945,20
11846600949,11846600946,-3,1493,3140,20
11850065122,11850065125,3,1094,1301,20
11856697919,11856697915,-4,1061,3402,20
11866638811,11866638807,-4,1192,2422,20
11870331242,11870331239,-3,2293,5572,20
11876294273,11876294270,-3,1529,2549,20
11876350362,11876350360,-2,1400,2911,20
11879871146,11879871144,-2,1271,3175,20
11882322298,11882322296,-2,1329,2242,20
11882412510,11882412526,16,363,797,20
11885160129,11885160125,-4,1466,2911,20
11887288381,11887288377,-4,1210,2953,20
11887830134,11887830117,-17,358,1350,20
11888930807,11888930802,-5,1876,5889,20
11901940191,11901940187,-4,1648,2923,20
11904560940,11904560937,-3,1038,1692,20
11909346270,11909346266,-4,1504,3301,20
11911290617,11911290614,-3,705,1219,20
11912529558,11912529554,-4,1378,1873,20
11917777912,11917777908,-4,1150,1633,20
11919011815,11919011810,-5,943,2725,20
11920229776,11920229774,-2,1171,1889,20
11921030949,11921030946,-3,823,2103,20
11922186107,11922186103,-4,1022,2275,20
11922956414,11922956414,0,1111,1569,20
11924064274,11924064270,-4,990,2464,20
11927857401,11927857402,1,1308,1767,20
11930556914,11930556912,-2,1683,2060,20
11931312085,11931312082,-3,873,1895,20
11936984698,11936984694,-4,1199,2206,20
11938451141,11938451135,-6,1098,4158,20
11942811493,11942811493,0,1337,1940,20
11943681043,11943681042,-1,829,2815,20
11949772095,11949772090,-5,1195,2272,20
11950897313,11950897310,-3,1104,3185,20
11954401566,11954401562,-4,1118,2107,20
11958997741,11958997738,-3,940,2554,20
11963918521,11963918520,-1,1076,1836,20
11964979562,11964979558,-4,1323,3107,20
11966568609,11966568606,-3,1030,2295,20
11970078414,11970078410,-4,1049,2396,20
11978106135,11978106132,-3,727,1672,20
11978850578,11978850577,-1,978,1777,20
11980054264,11980054262,-2,1431,2431,20
11980185892,11980185886,-6,1102,1951,20
11988956589,11988956586,-3,1214,2203,20
11990372495,11990372495,0,481,870,20
11994602539,11994602536,-3,982,2417,20
12001801113,12001801111,-2,1113,2338,20
12003109773,12003109773,0,1163,2055,20
12004061650,12004061648,-2,1587,2454,20
12004195524,12004195520,-4,1481,2738,20
12014437155,12014437153,-2,865,1913,20
12016425906,12016425902,-4,716,1301,20
12024459252,12024459250,-2,1242,3238,20
12031838067,12031838064,-3,990,1849,20
12033923218,12033923215,-3,1301,2764,20
12037037461,12037037464,3,1789,1535,20
12038119049,12038119053,4,2776,1765,20
12039977007,12039977004,-3,1261,2383,20
12041506610,12041506609,-1,1347,2203,20
12046153335,12046153315,-20,1076,2197,20
12049367206,12049367207,1,1011,2241,20
12050594451,12050594449,-2,1370,3163,20
12051968877,12051968872,-5,1364,2495,20
12053775499,12053775497,-2,722,2567,20
12054599414,12054599409,-5,1010,3820,20
12054975118,12054975115,-3,1080,2774,20
12055229894,12055229892,-2,1277,2158,20
12057408798,12057408801,3,1467,1513,20
12064960662,12064960660,-2,2199,4634,20
12067127294,12067127298,4,1786,1178,20
12074291663,12074291657,-6,47256,64812,20
12077652834,12077652830,-4,1554,3099,20
12083169183,12083169182,-1,978,1960,20
12084396928,12084396919,-9,1293,2247,20
12085796313,12085796311,-2,1224,2404,20
12086943791,12086943787,-4,668,962,20
12089976525,12089976523,-2,1152,2813,20
12092379943,12092379940,-3,1316,2822,20
12095954613,12095954617,4,1037,254,20
12097329726,12097329722,-4,906,1554,20
12101061062,12101061059,-3,1099,2070,20
12102515156,12102515145,-11,152,2941,20
12106474050,12106474046,-4,1389,2365,20
12116506213,12116506209,-4,1277,2329,20
12120808793,12120808790,-3,1215,3017,20
12120845239,12120845237,-2,1127,1903,20
12121553613,12121553613,0,1245,1734,20
12122822081,12122822079,-2,1136,3075,20
12124184003,12124184001,-2,1216,1375,20
12126695878,12126695885,7,3147,1474,20
12132549539,12132549534,-5,1328,3259,20
12132681847,12132681844,-3,1160,2512,20
12133318687,12133318682,-5,982,2029,20
12134051016,12134051010,-6,1286,2269,20
12134344743,12134344737,-6,1012,2507,20
12134922950,12134922948,-2,1133,2733,20
12136142504,12136142504,0,1507,1621,20
12137377992,12137377986,-6,986,3691,20
12141638202,12141638199,-3,1355,1869,20
12144080441,12144080438,-3,1351,2882,20
12144964382,12144964386,4,1988,1190,20
12145664205,12145664202,-3,926,1983,20
12146607439,12146607434,-5,1279,3107,20
12147319544,12147319543,-1,980,1586,20
12153356911,12153356905,-6,730,2708,20
12155088919,12155088917,-2,1353,2835,20
12156736562,12156736558,-4,1579,3672,20
12158510462,12158510462,0,1069,2072,20
12161419559,12161419554,-5,812,2436,20
12161514154,12161514153,-1,735,1760,20
12162371742,12162371759,17,333,909,20
12162958538,12162958536,-2,1241,1593,20
12164819138,12164819135,-3,1311,2608,20
12165587774,12165587773,-1,569,1250,20
12167888570,12167888569,-1,1111,2300,20
12170600538,12170600536,-2,1070,2147,20
12173796801,12173796799,-2,1080,2014,20
12175011590,12175011589,-1,1239,2928,20
12175752936,12175752941,5,2023,1216,20
12176397234,12176397229,-5,1586,2418,20
12177031870,12177031871,1,1338,945,20
12183242415,12183242402,-13,1225,1961,20
12184800338,12184800338,0,1033,1265,20
12195032314,12195032323,9,2542,1079,20
12195952398,12195952394,-4,935,2119,20
12204726326,12204726325,-1,2072,2596,20
12205609578,12205609574,-4,1165,3071,20
12207562147,12207562145,-2,757,1438,20
12211474955,12211474953,-2,905,1662,20
12220786630,12220786627,-3,1144,2214,20
12221333496,12221333502,6,3906,1476,20
12228687450,12228687448,-2,1415,2791,20
12232195443,12232195438,-5,1451,2927,20
12233635934,12233635932,-2,1002,2134,20
12233693752,12233693753,1,483,1188,20
12236554946,12236554945,-1,1242,1682,20
12237597751,12237597749,-2,1301,1997,20
12237643518,12237643538,20,393,648,20
12242021447,12242021446,-1,1185,2194,20
12244860374,12244860371,-3,965,2266,20
12253903841,12253903837,-4,1131,3011,20
12254304276,12254304293,17,763,2243,20
12254405079,12254405076,-3,1107,2821,20
12254684185,12254684181,-4,1281,3099,20
12256867045,12256867041,-4,971,2587,20
12257270943,12257270958,15,1168,204,20
12258910663,12258910661,-2,1372,2978,20
12260313347,12260313344,-3,1300,2428,20
12261594468,12261594462,-6,1135,3784,20
12267296830,12267296827,-3,1474,2996,20
12272662642,12272662638,-4,1256,2827,20
12279827177,12279827172,-5,1051,3283,20
12280011557,12280011554,-3,1024,2789,20
12283788355,12283788352,-3,821,1816,20
12284081151,12284081149,-2,1220,2441,20
12286563778,12286563777,-1,1613,2803,20
12293010586,12293010581,-5,807,4234,20
12296433329,12296433326,-3,1142,2470,20
12299222910,12299222913,3,3316,3682,20
12304087404,12304087399,-5,716,1940,20
12304643988,12304643995,7,220,781,20
12306163754,12306163752,-2,979,2045,20
12311836867,12311836865,-2,1041,2507,20
12315214146,12315214144,-2,1635,1959,20
12322854027,12322854025,-2,1344,2367,20
12325889937,12325889942,5,3168,2272,20
12327799551,12327799548,-3,1026,1792,20
12333872797,12333872794,-3,1733,2757,20
12338364101,12338364101,0,1161,2064,20
12344947300,12344947294,-6,968,2952,20
12345261647,12345261637,-10,1201,2210,20
12347899187,12347899185,-2,915,2439,20
12349801133,12349801129,-4,1439,2752,20
12354870381,12354870389,8,11056,37922,20
12357591486,12357591485,-1,1290,1749,20
12357687011,12357687007,-4,1210,2992,20
12359543563,12359543562,-1,1121,2389,20
12360684162,12360684161,-1,599,1146,20
12362799170,12362799168,-2,1071,2880,20
12365473631,12365473629,-2,762,2978,20
12366758854,12366758851,-3,1451,2764,20
12372243938,12372243937,-1,1305,2224,20
12379878478,12379878473,-5,1909,6753,20
12381268203,12381268200,-3,1063,1994,20
12382812150,12382812147,-3,1488,2268,20
12384664635,12384664617,-18,1082,2257,20
12385413781,12385413778,-3,988,1848,20
12389260035,12389260038,3,2032,1924,20
12391292718,12391292714,-4,1117,1628,20
12399691209,12399691206,-3,826,2565,20
12402300816,12402300814,-2,1589,1379,20
12406783862,12406783858,-4,774,2783,20
12407766931,12407766928,-3,1096,1715,20
12408288466,12408288465,-1,1375,2204,20
12409095938,12409095936,-2,1129,2455,20
12411246934,12411246937,3,553,1302,20
12411387794,12411387791,-3,1199,3007,20
12414275499,12414275499,0,1244,2038,20
12419310305,12419310302,-3,1131,2350,20
12420493093,12420493091,-2,1163,2637,20
12423010267,12423010263,-4,500,962,20
12427740210,12427740205,-5,387,294,20
12434613827,12434613824,-3,1269,3412,20
12435255086,12435255084,-2,1205,2261,20
12436586965,12436586961,-4,1199,3035,20
12438390688,12438390686,-2,1034,2458,20
12440356719,12440356717,-2,1068,1780,20
12440473383,12440473379,-4,1242,3058,20
12445785978,12445785973,-5,1570,3156,20
12454096905,12454096902,-3,953,2072,20
12456195895,12456195893,-2,999,3101,20
12456373380,12456373378,-2,2085,3200,20
12456553254,12456553253,-1,812,2583,20
12463040869,12463040873,4,2137,1539,20
12465965622,12465965618,-4,1532,3157,20
12467604290,12467604286,-4,966,2164,20
12467795781,12467795764,-17,901,1313,20
12468286083,12468286081,-2,1653,3623,20
12468384898,12468384896,-2,1569,2668,20
12472902130,12472902127,-3,1074,3056,20
12474034686,12474034683,-3,925,1997,20
12476261765,12476261765,0,970,1348,20
12487144659,12487144674,15,11471,49411,20
12487239485,12487239487,2,1117,1385,20
12498025578,12498025577,-1,546,1728,20
12498359101,12498359098,-3,1167,2057,20
12499315600,12499315596,-4,859,1834,20
12509058802,12509058801,-1,970,2425,20
12509882721,12509882729,8,1547,1379,20
12514780897,12514780893,-4,1336,3258,20
12515104773,12515104791,18,1250,3567,20
12515886310,12515886308,-2,1518,2369,20
12519496539,12519496534,-5,1102,2856,20
12527201754,12527201752,-2,1180,2274,20
12532051647,12532051646,-1,1014,2407,20
12545905571,12545905570,-1,1248,2460,20
12547173474,12547173473,-1,968,1917,20
12547339380,12547339389,9,103,1108,20
12555181294,12555181294,0,1210,1946,20
12561959457,12561959454,-3,1581,1819,20
12562447674,12562447671,-3,1062,2228,20
12563595570,12563595566,-4,1328,2258,20
12564020927,12564020924,-3,1014,3041,20
12570495947,12570495943,-4,1334,4016,20
12577168314,12577168308,-6,827,1889,20
12579663038,12579663035,-3,607,1318,20
12590514267,12590514266,-1,1096,1908,20
12591208598,12591208595,-3,1269,2753,20
12592776031,12592776028,-3,1345,2444,20
12598580742,12598580740,-2,1175,2111,20
12601260393,12601260394,1,2529,2139,20
12605652025,12605652030,5,2576,1481,20
12607549367,12607549366,-1,1127,2269,20
12609213829,12609213826,-3,894,1781,20
12610371497,12610371494,-3,1075,2863,20
12612006269,12612006266,-3,966,2236,20
12617363794,12617363794,0,478,906,20
12626911651,12626911648,-3,920,1535,20
12630553310,12630553307,-3,826,2528,20
12630839777,12630839782,5,23329,36461,20
12631860791,12631860785,-6,2669,7199,20
12631944819,12631944815,-4,841,1688,20
12634581452,12634581444,-8,1108,2091,20
12635169380,12635169395,15,289,728,20
12637217105,12637217101,-4,973,2218,20
12639567194,12639567190,-4,1012,2326,20
12639713569,12639713566,-3,1139,2996,20
12640175987,12640175985,-2,864,1894,20
12648637911,12648637910,-1,1177,1863,20
12649058978,12649058974,-4,975,2388,20
12649813352,12649813352,0,1058,2135,20
12654126654,12654126654,0,1537,2039,20
12654627986,12654627982,-4,914,2275,20
12656269686,12656269691,5,2175,2001,20
12656442691,12656442687,-4,831,1423,20
12657487673,12657487672,-1,1103,2583,20
12657629874,12657629871,-3,1638,2700,20
12663384042,12663384039,-3,1031,1614,20
12663989136,12663989151,15,407,1233,20
12666641513,12666641519,6,2893,1580,20
12672275887,12672275885,-2,734,2010,20
12673408117,12673408113,-4,903,2580,20
12675942560,12675942556,-4,1153,2813,20
12677794475,12677794473,-2,1303,2178,20
12680067684,12680067680,-4,1057,2569,20
12685126747,12685126726,-21,1223,1649,20
12686604066,12686604063,-3,1283,3105,20
12688039602,12688039598,-4,820,1793,20
12694238511,12694238510,-1,1093,2254,20
12695082294,12695082291,-3,1000,3450,20
12695790144,12695790137,-7,40456,14953,20
12706519225,12706519222,-3,913,2253,20
12709721501,12709721490,-11,27864,15577,20
12712058373,12712058369,-4,1000,1976,20
12714269973,12714269990,17,441,1283,20
12715014807,12715014805,-2,1012,2088,20
12716060099,12716060096,-3,1172,2360,20
12717801337,12717801334,-3,776,2129,20
12717964619,12717964614,-5,827,1914,20
12721575670,12721575668,-2,1124,2301,20
12721774532,12721774550,18,347,727,20
12722488936,12722488930,-6,1383,2786,20
12723448774,12723448772,-2,1137,1668,20
12724837321,12724837322,1,1341,1729,20
12726205534,12726205534,0,1128,1638,20
12728128506,12728128506,0,1064,1982,20
12731547890,12731547889,-1,788,1663,20
12738173519,12738173532,13,27109,16325,20
12739593673,12739593669,-4,963,2012,20
12746978151,12746978149,-2,1414,2572,20
12752920036,12752920033,-3,1055,2367,20
12755564287,12755564284,-3,1310,2813,20
12757556937,12757556933,-4,1069,2766,20
12759792342,12759792342,0,1635,1744,20
12762135458,12762135454,-4,1134,2933,20
12765966670,12765966666,-4,1092,2569,20
12772932469,12772932471,2,1388,1645,20
12781046338,12781046337,-1,976,2036,20
12781826101,12781826098,-3,1256,2289,20
12784682678,12784682674,-4,1340,3681,20
12784969982,12784969979,-3,140,682,20
12787555522,12787555521,-1,1049,1928,20
12787918375,12787918393,18,658,1780,20
12795831204,12795831204,0,893,2388,20
12796325439,12796325418,-21,101,722,20
12799027726,12799027724,-2,905,2166,20
12799144197,12799144177,-20,233,1314,20
12800085991,12800085988,-3,928,2279,20
12800511434,12800511433,-1,1381,2384,20
12802375926,12802375923,-3,828,1433,20
12803216415,12803216410,-5,1498,6212,20
12804202210,12804202206,-4,979,2208,20
12813969949,12813969945,-4,1029,2111,20
12819395843,12819395839,-4,778,1637,20
12824711394,12824711390,-4,1194,2032,20
12826818287,12826818282,-5,1225,3463,20
12827834989,12827834986,-3,1310,2046,20
12831168099,12831168101,2,1489,1523,20
12832664099,12832664098,-1,1364,1743,20
12833207187,12833207182,-5,1115,2256,20
12834458432,12834458428,-4,1284,2566,20
12836363891,12836363888,-3,1273,2623,20
12838661753,12838661751,-2,2137,4759,20
12840105808,12840105803,-5,863,1700,20
12841260973,12841260969,-4,1131,3955,20
12846944935,12846944934,-1,1562,3053,20
12851932682,12851932685,3,1751,2123,20
12852490982,12852490980,-2,1133,2046,20
12853377270,12853377274,4,3871,2798,20
12856702219,12856702218,-1,985,1789,20
12857535361,12857535357,-4,1001,2044,20
12859069863,12859069860,-3,1063,2495,20
12870795945,12870795942,-3,1094,2451,20
12870932534,12870932535,1,1451,2881,20
12874115445,12874115442,-3,989,2046,20
12875727196,12875727190,-6,1100,3381,20
12877133635,12877133630,-5,1217,2894,20
12878268499,12878268497,-2,1038,2245,20
12878429580,12878429578,-2,1055,1763,20
12880538002,12880538000,-2,1514,2459,20
12881475121,12881475119,-2,1317,1921,20
12885891271,12885891271,0,1322,1534,20
12886449313,12886449309,-4,1068,1944,20
12892986998,12892986993,-5,1153,2897,20
12893148687,12893148676,-11,1344,2015,20
12895192124,12895192122,-2,1115,1680,20
12899214373,12899214379,6,1903,1200,20
12901120666,12901120662,-4,707,2861,20
12901174386,12901174384,-2,1037,1889,20
12903740452,12903740446,-6,876,1868,20
12909758922,12909758921,-1,773,1652,20
12913746239,12913746237,-2,1383,2287,20
12921754938,12921754933,-5,1063,2867,20
12925111646,12925111643,-3,955,2186,20
12927414007,12927414004,-3,684,1257,20
12928484154,12928484150,-4,935,3202,20
12929967089,12929967094,5,1630,1357,20
12933949922,12933949918,-4,1128,1859,20
12935030371,12935030370,-1,758,2312,20
12938085154,12938085151,-3,1021,1605,20
12940258291,12940258285,-6,3514,13296,20
12940642747,12940642746,-1,1003,1722,20
12942063278,12942063297,19,1208,2410,20
12945744657,12945744661,4,2479,1654,20
12949799161,12949799158,-3,1843,2590,20
12950934083,12950934082,-1,1148,2406,20
12952672638,12952672635,-3,57579,31221,20
12954649695,12954649693,-2,1153,2982,20
12954877241,12954877238,-3,991,2881,20
12955549022,12955549018,-4,722,1511,20
12956268806,12956268826,20,551,2143,20
12957695006,12957695003,-3,1318,2262,20
12958367139,12958367134,-5,868,3613,20
12959075784,12959075799,15,824,2104,20
12960437086,12960437082,-4,838,1812,20
12968605563,12968605562,-1,800,1868,20
12969296973,12969296993,20,1408,3492,20
12977440826,12977440819,-7,1289,4215,20
12978775863,12978775861,-2,1353,2508,20
12980288147,12980288145,-2,1336,2672,20
12982704381,12982704379,-2,1263,2037,20
12985854106,12985854104,-2,435,1807,20
12989224571,12989224570,-1,1043,2537,20
12989936194,12989936188,-6,1429,4184,20
12991687158,12991687138,-20,84,3475,20
12992681222,12992681228,6,6449,2344,20
12998776793,12998776791,-2,826,1905,20
12999952694,12999952692,-2,1158,2859,20
13009146374,13009146371,-3,1034,1878,20
13012163177,13012163173,-4,1195,2533,20
13013494680,13013494678,-2,1057,2460,20
13013870335,13013870332,-3,1168,2518,20
13019078703,13019078702,-1,896,1806,20
13019347629,13019347625,-4,1199,3167,20
13020147854,13020147852,-2,1278,2139,20
13020450407,13020450405,-2,1389,2210,20
13026507825,13026507824,-1,1512,1914,20
13027325462,13027325458,-4,1280,3083,20
13032844841,13032844837,-4,999,2377,20
13038494795,13038494792,-3,1544,2872,20
13040151831,13040151829,-2,838,2029,20
13050876217,13050876221,4,42810,51349,20
13058338043,13058338038,-5,936,1970,20
13066315554,13066315550,-4,1004,2666,20
13069381625,13069381630,5,1263,903,20
13072117228,13072117225,-3,926,2022,20
13075692753,13075692772,19,3268,1484,20
13086392024,13086392021,-3,1127,2944,20
13087644337,13087644341,4,1517,1798,20
13088927985,13088927982,-3,1675,1274,20
13089851379,13089851377,-2,921,2255,20
13096553508,13096553506,-2,1247,2987,20
13097360684,13097360678,-6,1232,4096,20
13099321731,13099321728,-3,1114,2205,20
13101731389,13101731392,3,1872,1535,20
13103849915,13103849913,-2,1528,3634,20
13119964962,13119964957,-5,1113,2189,20
13125796223,13125796218,-5,831,2790,20
13127459110,13127459100,-10,1067,2278,20
13133810279,13133810274,-5,1402,2932,20
13137245265,13137245268,3,2994,2840,20
13138719909,13138719905,-4,1247,2917,20
13147834317,13147834314,-3,1524,2044,20
13154286810,13154286806,-4,1085,3275,20
13155900399,13155900418,19,462,1885,20
13156320810,13156320809,-1,1324,1565,20
13158149638,13158149638,0,1597,2856,20
13160775612,13160775608,-4,952,3175,20
13161833800,13161833818,18,1163,2748,20
13170609186,13170609185,-1,847,1881,20
13174295426,13174295422,-4,1320,2476,20
13180401323,13180401322,-1,877,1526,20
13181033618,13181033613,-5,868,1705,20
13186402403,13186402398,-5,1045,3216,20
13186851254,13186851251,-3,1816,2808,20
13191171265,13191171262,-3,1396,3184,20
13192474795,13192474798,3,2240,1743,20
13196869705,13196869702,-3,1392,2436,20
13202499704,13202499699,-5,1174,2296,20
13211482896,13211482894,-2,1049,1877,20
13216271112,13216271110,-2,1297,2256,20
13216654485,13216654482,-3,893,2305,20
13217157910,13217157906,-4,1142,2946,20
13222528026,13222528022,-4,1061,1708,20
13223758977,13223758975,-2,1077,2779,20
13224396128,13224396125,-3,1094,2366,20
13225365834,13225365832,-2,1083,1903,20
13226722897,13226722894,-3,933,1384,20
13228042554,13228042550,-4,1234,2452,20
13238532186,13238532185,-1,777,1699,20
13240714307,13240714302,-5,1942,5744,20
13243958587,13243958586,-1,1030,2786,20
13245463430,13245463427,-3,1664,2140,20
13248534102,13248534106,4,1446,1366,20
13252154639,13252154636,-3,1071,2047,20
13254166539,13254166539,0,15702,30420,20
13256155506,13256155502,-4,745,1540,20
13256506934,13256506955,21,775,2050,20
13258616470,13258616470,0,1088,1177,20
13259731336,13259731332,-4,1251,2376,20
13260051006,13260051003,-3,1162,2459,20
13264758963,13264758959,-4,625,2343,20
13265443524,13265443521,-3,878,1903,20
13268472795,13268472790,-5,1444,3274,20
13269049676,13269049699,23,632,1345,20
13280767214,13280767211,-3,1466,2895,20
13285885102,13285885098,-4,930,2874,20
13286985667,13286985665,-2,1132,2610,20
13290304873,13290304872,-1,967,1655,20
13294272434,13294272432,-2,1079,1968,20
13296904044,13296904043,-1,855,2489,20
13299129355,13299129351,-4,1162,2542,20
13299269580,13299269589,9,395,1217,20
13303987931,13303987928,-3,1072,2261,20
13305102175,13305102173,-2,1356,2370,20
13305250114,13305250111,-3,990,3387,20
13306591455,13306591450,-5,1166,2204,20
13310918150,13310918149,-1,905,1481,20
13313206223,13313206221,-2,943,1485,20
13321823206,13321823206,0,1133,2608,20
13323325306,13323325302,-4,1171,2390,20
13325642923,13325642921,-2,1068,2845,20
13326288419,13326288414,-5,738,2021,20
13327543614,13327543614,0,1064,1832,20
13329793920,13329793918,-2,1076,2532,20
13333930427,13333930424,-3,1075,2414,20
13335179917,13335179912,-5,1635,3216,20
13337988367,13337988364,-3,1247,2084,20
13338813043,13338813041,-2,1044,2424,20
13343576282,13343576287,5,1665,1320,20
13344207794,13344207791,-3,1195,2701,20
13345449875,13345449869,-6,754,1938,20
13346408914,13346408911,-3,1143,2136,20
13355673139,13355673137,-2,1385,2804,20
13356064822,13356064817,-5,1276,1898,20
13357723045,13357723041,-4,1038,1769,20
13358034154,13358034150,-4,1025,2144,20
13358908495,13358908490,-5,944,2131,20
13361080377,13361080374,-3,1116,1383,20
13366992875,13366992873,-2,712,1567,20
13375138919,13375138918,-1,1326,2556,20
13377463543,13377463544,1,1375,1036,20
13385367526,13385367524,-2,1108,2273,20
13385877742,13385877726,-16,845,2757,20
13389491310,13389491307,-3,1103,2932,20
13389546054,13389546053,-1,902,2225,20
13395154589,13395154586,-3,1213,2286,20
13395544758,13395544746,-12,158,951,20
13396816712,13396816729,17,612,1611,20
13397812550,13397812571,21,1314,3064,20
13399153482,13399153479,-3,1500,2539,20
13401054370,13401054365,-5,1130,2547,20
13402651478,13402651473,-5,1365,2313,20
13403176609,13403176606,-3,1248,2702,20
13403729242,13403729241,-1,805,1586,20
13409582136,13409582134,-2,994,2086,20
13411590879,13411590877,-2,1035,2376,20
13414279409,13414279402,-7,1172,2951,20
13415821587,13415821584,-3,1141,2346,20
13416695706,13416695702,-4,1450,2691,20
13416768926,13416768944,18,971,1360,20
13421285261,13421285258,-3,922,2238,20
13422194692,13422194681,-11,1116,2873,20
13423237363,13423237361,-2,808,2398,20
13426912967,13426912962,-5,951,2754,20
13430677098,13430677095,-3,1304,2040,20
13431642027,13431642025,-2,816,2243,20
13431963210,13431963205,-5,1281,2233,20
13432552680,13432552678,-2,559,1097,20
13437430416,13437430418,2,3647,3137,20
13443312918,13443312934,16,1005,1827,20
13444910701,13444910701,0,1549,1998,20
13445541696,13445541702,6,2807,1171,20
13446530976,13446530972,-4,1369,2861,20
13448771325,13448771322,-3,1376,1802,20
13449744955,13449744953,-2,759,1861,20
13450898059,13450898056,-3,1409,2888,20
13451501143,13451501140,-3,1721,3938,20
13460959982,13460959985,3,1100,1263,20
13462957776,13462957782,6,5568,2725,20
13463119280,13463119298,18,267,1227,20
13465459034,13465459029,-5,1113,2519,20
13468098838,13468098836,-2,938,2346,20
13470908584,13470908582,-2,1620,1777,20
13474472845,13474472843,-2,1271,2299,20
13481003691,13481003690,-1,1001,2000,20
13485777901,13485777898,-3,1217,2293,20
13486005974,13486005993,19,706,1266,20
13495199226,13495199224,-2,1065,1939,20
13497024411,13497024409,-2,841,2794,20
13501575850,13501575846,-4,1065,2430,20
13502264285,13502264266,-19,216,1479,20
13502977574,13502977571,-3,980,1588,20
13503092074,13503092071,-3,1642,2547,20
13507056381,13507056378,-3,1052,1786,20
13509415885,13509415879,-6,1471,2886,20
13511923755,13511923754,-1,1506,2613,20
13513608548,13513608543,-5,1147,2449,20
13517271361,13517271358,-3,963,2818,20
13526904127,13526904125,-2,985,1748,20
13532013346,13532013342,-4,1700,2802,20
13533171736,13533171734,-2,2784,5356,20
13538354881,13538354879,-2,1073,2592,20
13539384416,13539384414,-2,952,2653,20
13540285751,13540285750,-1,1041,1955,20
13551682611,13551682607,-4,1056,2563,20
13552947594,13552947592,-2,1152,1933,20
13553961844,13553961839,-5,807,2411,20
13554016352,13554016342,-10,1038,2743,20
13557216839,13557216835,-4,1172,2655,20
13557337391,13557337394,3,258,1221,20
13560830291,13560830293,2,4695,4076,20
13570083591,13570083591,0,1114,1912,20
13571436494,13571436490,-4,906,3115,20
13573978780,13573978778,-2,1033,1885,20
13575180014,13575180010,-4,890,2634,20
13577315267,13577315263,-4,1008,2828,20
13577458661,13577458654,-7,821,1667,20
13577485863,13577485866,3,1315,972,20
13578165718,13578165714,-4,1630,2705,20
13578561326,13578561324,-2,1336,2365,20
13584008556,13584008553,-3,1221,2456,20
13584727048,13584727052,4,14,2071,20
13585862690,13585862686,-4,1496,2019,20
13586777559,13586777557,-2,860,1879,20
13587182862,13587182860,-2,997,1642,20
13590351411,13590351409,-2,1288,1884,20
13594044773,13594044794,21,863,2034,20
13608876158,13608876156,-2,871,2882,20
13609691829,13609691826,-3,1113,2275,20
13616886666,13616886664,-2,1178,2122,20
13620224597,13620224593,-4,1056,2305,20
13620378193,13620378183,-10,27412,16476,20
13622346557,13622346554,-3,711,1738,20
13623082766,13623082761,-5,3759,9472,20
13627827608,13627827608,0,1776,2016,20
13639687353,13639687350,-3,772,2372,20
13647648106,13647648103,-3,669,3106,20
13649743726,13649743730,4,11248,8196,20
13655246562,13655246557,-5,994,3361,20
13657968170,13657968165,-5,1312,3331,20
13664473675,13664473673,-2,743,1780,20
13666273130,13666273126,-4,957,2495,20
13667238771,13667238769,-2,1242,1947,20
13667362683,13667362680,-3,1049,3195,20
13673467166,13673467174,8,169,925,20
13673750385,13673750385,0,1136,1340,20
13676330061,13676330059,-2,1156,1870,20
13676890978,13676890974,-4,1052,2420,20
13683597710,13683597705,-5,1367,3465,20
13686299831,13686299830,-1,1207,1757,20
13686645788,13686645811,23,734,1744,20
13698562214,13698562213,-1,1103,2132,20
13698777590,13698777587,-3,1026,2653,20
13704217278,13704217273,-5,980,2465,20
13705192370,13705192377,7,8079,37930,20
13708261923,13708261923,0,1347,3243,20
13709603583,13709603590,7,5102,2462,20
13714170281,13714170278,-3,1055,2548,20
13714795314,13714795309,-5,699,3552,20
13720801686,13720801681,-5,1266,2070,20
13720890702,13720890699,-3,136,927,20
13722627601,13722627597,-4,1045,2061,20
13722687295,13722687288,-7,686,1876,20
13725971094,13725971093,-1,743,1232,20
13728638091,13728638086,-5,1016,2617,20
13731425159,13731425157,-2,2499,6079,20
13733673470,13733673468,-2,1110,2825,20
13735695473,13735695469,-4,932,1700,20
13736815898,13736815895,-3,994,2206,20
13738022059,13738022055,-4,1183,2537,20
13747543064,13747543061,-3,1112,3022,20
13752890565,13752890561,-4,766,2642,20
13753186087,13753186082,-5,1141,2072,20
13754706511,13754706495,-16,4670,1759,20
13754891910,13754891908,-2,1194,2347,20
13767594413,13767594410,-3,646,2416,20
13769337254,13769337253,-1,1205,1722,20
13770502002,13770502000,-2,968,1778,20
13772230675,13772230673,-2,1029,1876,20
13772536646,13772536643,-3,989,2117,20
13775195310,13775195308,-2,1128,2640,20
13777615695,13777615689,-6,1207,8275,20
13781977139,13781977135,-4,1671,2637,20
13789260405,13789260398,-7,1196,2075,20
13789447266,13789447262,-4,1163,2567,20
13794887103,13794887109,6,2391,1041,20
13796831190,13796831192,2,4311,4239,20
13807182364,13807182362,-2,950,2131,20
13811775231,13811775229,-2,731,1617,20
13814251066,13814251061,-5,866,3234,20
13814895580,13814895561,-19,213,1223,20
13815217826,13815217829,3,38957,53768,20
13817398897,13817398898,1,29209,19686,20
13818479007,13818479006,-1,872,2363,20
13827478228,13827478225,-3,1343,1874,20
13828221929,13828221925,-4,876,2015,20
13828492574,13828492589,15,594,1468,20
13835364769,13835364766,-3,698,1529,20
13837740582,13837740581,-1,907,1995,20
13843344065,13843344062,-3,1235,1585,20
13843720022,13843720026,4,117,1234,20
13851598366,13851598371,5,3026,1696,20
13860878461,13860878461,0,745,1533,20
13862088512,13862088510,-2,1721,2544,20
13869298910,13869298914,4,1259,1009,20
13872519118,13872519117,-1,1590,2208,20
13872848302,13872848300,-2,1053,1933,20
13874663318,13874663314,-4,1349,2087,20
13875156353,13875156348,-5,1194,2020,20
13875407031,13875407010,-21,246,761,20
13878036045,13878036041,-4,1585,2603,20
13878387882,13878387877,-5,947,3347,20
13879041904,13879041898,-6,1021,2129,20
13880693253,13880693249,-4,736,1457,20
13880845197,13880845217,20,702,1961,20
13883282549,13883282546,-3,1642,2613,20
13883779950,13883779954,4,2347,2081,20
13885641562,13885641565,3,1435,1671,20
13886743427,13886743426,-1,1496,3050,20
13887003020,13887003018,-2,1399,2156,20
13889705678,13889705675,-3,1563,2960,20
13890764174,13890764170,-4,1036,2374,20
13900722791,13900722789,-2,961,2526,20
13901962268,13901962286,18,1058,2725,20
13902679198,13902679196,-2,1076,2374,20
13903653526,13903653546,20,630,1764,20
13904794458,13904794457,-1,883,2260,20
13905136402,13905136398,-4,1312,2374,20
13906745027,13906745025,-2,2921,4976,20
13911479459,13911479451,-8,839,361,20
13917894522,13917894517,-5,1510,2968,20
13920669978,13920669973,-5,975,2217,20
13920817600,13920817594,-6,1317,2926,20
13932127433,13932127429,-4,882,2218,20
13936600252,13936600254,2,2098,1622,20
13937414114,13937414112,-2,1449,2631,20
13944678577,13944678580,3,2234,2123,20
13946318921,13946318919,-2,1111,1646,20
13947775798,13947775795,-3,1103,3114,20
13953007934,13953007933,-1,1077,2052,20
13953066232,13953066249,17,1201,2084,20
13964444487,13964444483,-4,890,3352,20
13965700174,13965700170,-4,1186,2288,20
13969168953,13969168949,-4,981,2253,20
13970597239,13970597236,-3,1269,2819,20
13971051533,13971051538,5,2245,950,20
13972110794,13972110790,-4,1364,3694,20
13980325107,13980325103,-4,1115,2105,20
13980473495,13980473511,16,531,1177,20
13982053446,13982053446,0,1007,2260,20
13984171859,13984171854,-5,1138,4550,20
13987652283,13987652283,0,1202,1803,20
13987774821,13987774818,-3,1182,2223,20
13987977696,13987977714,18,684,2241,20
13993534304,13993534301,-3,1675,2724,20
13993692566,13993692565,-1,1396,2750,20
14001350820,14001350819,-1,182,783,20
14011580843,14011580842,-1,670,2394,20
14011994246,14011994242,-4,1039,2392,20
14022917038,14022917034,-4,1029,2737,20
14024130356,14024130353,-3,1009,2038,20
14025226313,14025226310,-3,1302,2403,20
14026098987,14026098986,-1,1312,2975,20
14026572395,14026572392,-3,1065,2677,20
14030750765,14030750768,3,1514,1146,20
14032893395,14032893394,-1,1414,2261,20
14034801143,14034801142,-1,1120,2710,20
14035921925,14035921920,-5,849,2816,20
14039441650,14039441649,-1,968,2383,20
14039890663,14039890642,-21,285,4138,20
14042329045,14042329041,-4,858,1745,20
14049604305,14049604302,-3,938,2033,20
14049641429,14049641450,21,539,651,20
14050283797,14050283793,-4,802,2441,20
14051658975,14051658973,-2,1209,1962,20
14054442932,14054442922,-10,208,773,20
14055830248,14055830245,-3,1213,2072,20
14063896557,14063896554,-3,1040,2313,20
14070143679,14070143678,-1,1629,3432,20
14070888030,14070888029,-1,1044,2667,20
14071184513,14071184518,5,3104,1258,20
14073706547,14073706547,0,880,2336,20
14082571468,14082571471,3,2133,1836,20
14088761595,14088761593,-2,1271,1925,20
14092297978,14092297975,-3,1417,2517,20
14095046186,14095046182,-4,1185,2354,20
14097536557,14097536557,0,1718,2652,20
14098583514,14098583512,-2,1068,2572,20
14098973294,14098973290,-4,973,3118,20
14100330555,14100330553,-2,1014,2868,20
14102209786,14102209785,-1,1614,2998,20
14109496734,14109496733,-1,736,1434,20
14110922070,14110922083,13,44,580,20
14112953030,14112953029,-1,1477,2400,20
14114316037,14114316030,-7,995,2270,20
14114970987,14114970988,1,1159,1465,20
14115813430,14115813427,-3,1126,2623,20
14116936534,14116936529,-5,1182,2598,20
14118489886,14118489869,-17,1427,787,20
14119574444,14119574440,-4,1275,2634,20
14122987321,14122987324,3,2236,1828,20
14124927228,14124927225,-3,1541,2366,20
14129762797,14129762794,-3,1230,3128,20
14144195486,14144195485,-1,577,1742,20
14145160030,14145160026,-4,1092,2517,20
14149034803,14149034801,-2,1692,1706,20
14152876993,14152876990,-3,1415,2806,20
14159171882,14159171880,-2,1129,1947,20
14161310981,14161310978,-3,1076,2335,20
14162579613,14162579614,1,921,1357,20
14164897680,14164897661,-19,1165,1831,20
14173301883,14173301880,-3,917,2214,20
14175112034,14175112028,-6,877,2215,20
14179748054,14179748053,-1,1045,1294,20
14185813892,14185813906,14,445,639,20
14189495206,14189495205,-1,796,2156,20
14190710745,14190710741,-4,1211,1748,20
14195503411,14195503409,-2,1079,1654,20
14197379604,14197379591,-13,1279,2227,20
14198514567,14198514562,-5,598,1828,20
14200608263,14200608261,-2,1023,1987,20
14201830932,14201830926,-6,2173,7369,20
14201916370,14201916366,-4,1280,2170,20
14203594341,14203594335,-6,1410,2481,20
14203705795,14203705793,-2,1147,3099,20
14205412895,14205412893,-2,1002,1894,20
14211073834,14211073828,-6,1334,5225,20
14211138895,14211138902,7,4175,1744,20
14214844469,14214844473,4,2380,1656,20
14215797345,14215797342,-3,1012,1821,20
14218392271,14218392270,-1,829,2042,20
14223350999,14223350998,-1,499,2329,20
14225192807,14225192808,1,1325,1859,20
14237389124,14237389121,-3,1387,2892,20
14237760002,14237760001,-1,1421,2193,20
14241206307,14241206305,-2,1164,1925,20
14241767615,14241767610,-5,1027,2370,20
14244164278,14244164275,-3,802,2462,20
14245449767,14245449763,-4,1542,2978,20
14247809205,14247809203,-2,721,1876,20
14250094762,14250094761,-1,901,2503,20
14250272915,14250272911,-4,3100,7597,20
14254934731,14254934728,-3,1143,1740,20
14260133985,14260133982,-3,937,2193,20
14263009181,14263009181,0,484,1134,20
14266886163,14266886161,-2,1042,2376,20
14267196183,14267196181,-2,986,1950,20
14268451934,14268451933,-1,938,1732,20
14280019547,14280019541,-6,1205,1808,20
14281503480,14281503477,-3,560,2211,20
14281741827,14281741834,7,3503,1388,20
14284290755,14284290751,-4,1153,2910,20
14288657507,14288657505,-2,1072,2684,20
14292766231,14292766228,-3,853,2130,20
14298564730,14298564730,0,1774,2780,20
14300674628,14300674625,-3,867,1317,20
14301135082,14301135082,0,897,1969,20
14302807583,14302807579,-4,925,1940,20
14303290005,14303289985,-20,800,1720,20
14303445182,14303445179,-3,1215,2116,20
14303880763,14303880762,-1,848,2423,20
14304830894,14304830911,17,587,1248,20
14309022137,14309022133,-4,1215,2840,20
14314260226,14314260222,-4,877,2240,20
14324756214,14324756210,-4,1083,2183,20
14328927511,14328927509,-2,899,1964,20
14330153206,14330153213,7,2622,1212,20
14330593128,14330593126,-2,1397,2300,20
14330620511,14330620496,-15,297,1953,20
14330988837,14330988854,17,770,1502,20
14331387899,14331387897,-2,1207,2273,20
14332362186,14332362182,-4,2031,3373,20
14333641550,14333641546,-4,1051,2773,20
14337771280,14337771278,-2,1075,2345,20
14341586796,14341586806,10,9070,35456,20
14343022898,14343022896,-2,1098,2296,20
14345422855,14345422854,-1,931,1491,20
14346632775,14346632773,-2,1366,2428,20
14348372897,14348372886,-11,4557,15208,20
14350348961,14350348959,-2,1026,1816,20
14350904778,14350904780,2,7304,25888,20
14350950634,14350950630,-4,1230,2026,20
14354432039,14354432034,-5,897,2354,20
14355005296,14355005294,-2,871,2193,20
14364247619,14364247616,-3,1214,2769,20
14368192217,14368192214,-3,754,1543,20
14369525004,14369525003,-1,1527,2492,20
14372063294,14372063291,-3,1720,2824,20
14376329665,14376329664,-1,780,1876,20
14377452037,14377452032,-5,1244,1893,20
14383300925,14383300931,6,8343,30251,20
14385915521,14385915522,1,1515,2174,20
14386166486,14386166502,16,328,1160,20
14386363646,14386363661,15,1234,1773,20
14388340101,14388340099,-2,1353,1888,20
14389192078,14389192077,-1,983,1673,20
14390980476,14390980473,-3,918,2156,20
14397560254,14397560250,-4,1109,1815,20
14397931591,14397931586,-5,1189,2201,20
14399053371,14399053370,-1,605,2461,20
14399689061,14399689059,-2,1125,2074,20
14405443233,14405443228,-5,1423,2854,20
14406856378,14406856371,-7,1333,9360,20
14411626130,14411626131,1,1257,1572,20
14414950458,14414950455,-3,1181,2642,20
14417410232,14417410228,-4,1438,2254,20
14418887175,14418887171,-4,1298,2489,20
14421836729,14421836726,-3,1496,3015,20
14428354631,14428354630,-1,1090,1451,20
14429252666,14429252664,-2,1023,3079,20
14429584750,14429584748,-2,1295,2337,20
14432802629,14432802624,-5,871,3453,20
14436456002,14436456001,-1,651,2070,20
14440741750,14440741747,-3,1030,1825,20
14441326959,14441326955,-4,846,1872,20
14445255773,14445255769,-4,45595,28218,20
14454387763,14454387759,-4,1237,2515,20
14456888538,14456888535,-3,1207,3161,20
14457070525,14457070505,-20,1214,2244,20
14458905069,14458905066,-3,1422,2597,20
14460009507,14460009505,-2,912,1754,20
14460624648,14460624667,19,1243,2523,20
14475149811,14475149807,-4,610,1833,20
14476170478,14476170473,-5,1225,2848,20
14479322423,14479322420,-3,670,2260,20
14479763283,14479763280,-3,1308,1988,20
14480216671,14480216668,-3,838,2492,20
14480279205,14480279211,6,1516,1812,20
14482517863,14482517861,-2,1553,3026,20
14484912338,14484912334,-4,797,2150,20
14485918372,14485918370,-2,939,2166,20
14486648016,14486648014,-2,1045,1836,20
14486841574,14486841590,16,889,2811,20
14489071647,14489071645,-2,1050,2553,20
14492036182,14492036181,-1,1044,1921,20
14493517545,14493517541,-4,1095,2614,20
14494953550,14494953546,-4,909,1875,20
14497873273,14497873271,-2,1031,1997,20
14502385906,14502385906,0,1033,2956,20
14508061425,14508061425,0,980,2603,20
14510100425,14510100423,-2,1272,2023,20
14515139099,14515139095,-4,1080,2776,20
14516327558,14516327555,-3,1028,1826,20
14518734226,14518734225,-1,1182,2023,20
14523282934,14523282930,-4,640,2314,20
14525613815,14525613812,-3,1061,2837,20
14530430321,14530430318,-3,1300,2782,20
14530732174,14530732170,-4,1600,3203,20
14531486304,14531486301,-3,726,2149,20
14532580063,14532580058,-5,1139,2956,20
14534285665,14534285665,0,956,1450,20
14541541773,14541541770,-3,2330,2858,20
14543224275,14543224272,-3,1154,1739,20
14544566899,14544566898,-1,1354,2160,20
14545485166,14545485162,-4,977,2629,20
14546345781,14546345803,22,384,996,20
14548542821,14548542818,-3,1024,2295,20
14550387471,14550387473,2,2116,1818,20
14555915218,14555915217,-1,990,1364,20
14556547326,14556547325,-1,1044,2472,20
14556860637,14556860634,-3,1035,1553,20
14560061052,14560061048,-4,1148,3259,20
14562616235,14562616234,-1,1263,1661,20
14565650367,14565650365,-2,993,1455,20
14568041453,14568041449,-4,1359,2537,20
14569509621,14569509622,1,1720,1574,20
14570113440,14570113434,-6,891,2836,20
14572564814,14572564810,-4,1042,2726,20
14572702935,14572702938,3,340,907,20
14579343134,14579343132,-2,941,1827,20
14580644795,14580644799,4,3404,2287,20
14582688611,14582688610,-1,1337,2715,20
14586066498,14586066496,-2,892,2560,20
14587119815,14587119813,-2,1083,2099,20
14587243631,14587243614,-17,230,751,20
14587986501,14587986499,-2,1355,2463,20
14591833563,14591833562,-1,1359,2474,20
14603477286,14603477281,-5,1692,2606,20
14605462998,14605463002,4,2897,1474,20
14607765830,14607765827,-3,995,1275,20
14607799894,14607799893,-1,1467,2460,20
14609309951,14609309950,-1,1215,1889,20
14616580347,14616580345,-2,1699,2601,20
14619107278,14619107281,3,1220,1739,20
14621859462,14621859460,-2,784,1651,20
14624471074,14624471072,-2,1241,2201,20
14626881711,14626881708,-3,880,2446,20
14627638873,14627638870,-3,990,1712,20
14628214763,14628214759,-4,868,1661,20
14629214605,14629214605,0,2147,2503,20
14635597958,14635597954,-4,876,1841,20
14636529809,14636529808,-1,1515,2844,20
14645546092,14645546089,-3,1538,3272,20
14647131662,14647131658,-4,754,1887,20
14648342791,14648342789,-2,6836,14105,20
14650475509,14650475507,-2,1151,2899,20
14650539327,14650539309,-18,1033,2137,20
14650705446,14650705441,-5,760,1463,20
14652704775,14652704773,-2,1073,2317,20
14655699541,14655699560,19,17780,49287,20
14655983967,14655983968,1,1624,1849,20
14658333134,14658333130,-4,762,1627,20
14658739236,14658739234,-2,303,1350,20
14659272357,14659272352,-5,1049,3475,20
14659397286,14659397282,-4,997,2527,20
14659564540,14659564532,-8,868,1733,20
14660003491,14660003487,-4,586,1412,20
14663252659,14663252655,-4,1047,2355,20
14668842455,14668842450,-5,1341,2479,20
14669184803,14669184798,-5,1223,1504,20
14669594378,14669594375,-3,1072,2030,20
14672164313,14672164311,-2,806,2728,20
14672406163,14672406161,-2,1125,2807,20
14672725284,14672725286,2,429,907,20
14672958376,14672958372,-4,575,2230,20
14674368769,14674368765,-4,1214,2257,20
14679756177,14679756175,-2,1345,2790,20
14679906871,14679906891,20,1430,2219,20
14680492088,14680492086,-2,990,2235,20
14683864841,14683864840,-1,1510,2292,20
14684931222,14684931222,0,1243,2016,20
14687962509,14687962509,0,494,1475,20
14688512119,14688512118,-1,1248,2370,20
14698413639,14698413635,-4,1141,2511,20
14698756287,14698756305,18,1101,2507,20
14700159962,14700159968,6,12944,30375,20
14701855650,14701855646,-4,1733,2889,20
14702685478,14702685473,-5,1258,1730,20
14703820271,14703820271,0,823,2261,20
14704180015,14704180013,-2,1215,2056,20
14705044897,14705044894,-3,1264,1947,20
14708096908,14708096905,-3,986,2850,20
14710501670,14710501668,-2,1344,2609,20
14712605070,14712605068,-2,1113,2021,20
14714257027,14714257025,-2,753,2939,20
14717175230,14717175228,-2,1034,2418,20
14717378819,14717378823,4,1338,1080,20
14718047764,14718047760,-4,1471,3140,20
14718501702,14718501698,-4,1062,2447,20
14720526440,14720526437,-3,1488,3174,20
14722077757,14722077753,-4,1423,2792,20
14722130507,14722130506,-1,505,1155,20
14725161802,14725161801,-1,1252,1833,20
14727405014,14727405011,-3,1224,3603,20
14739848562,14739848560,-2,1047,1627,20
14741663732,14741663735,3,31040,21663,20
14747840149,14747840145,-4,853,2970,20
14749739018,14749739016,-2,1177,3157,20
14752811222,14752811221,-1,1215,2068,20
14754187575,14754187574,-1,1284,1310,20
14754839213,14754839212,-1,707,1783,20
14758974813,14758974808,-5,908,2776,20
14759495252,14759495270,18,788,1230,20
14759616149,14759616142,-7,1093,3585,20
14761180742,14761180747,5,13261,7997,20
14764635835,14764635833,-2,997,1683,20
14765691530,14765691529,-1,1087,2065,20
14770088481,14770088481,0,1847,2299,20
14770640301,14770640301,0,861,2108,20
14775587502,14775587498,-4,831,2376,20
14776505437,14776505434,-3,1480,3072,20
14781222990,14781222982,-8,1156,2072,20
14784890418,14784890415,-3,1560,1971,20
14785791550,14785791550,0,1298,2085,20
14787232817,14787232818,1,1105,1388,20
14797512491,14797512488,-3,1235,3188,20
14797656669,14797656664,-5,1339,3523,20
14798605262,14798605261,-1,620,1273,20
14801719898,14801719896,-2,1226,2144,20
14803414345,14803414327,-18,1481,602,20
14803735021,14803735023,2,1828,1378,20
14811684084,14811684082,-2,1050,2055,20
14815043766,14815043764,-2,612,2365,20
14815302820,14815302816,-4,1582,3920,20
14816666452,14816666449,-3,781,2153,20
14816963600,14816963618,18,609,1310,20
14817002875,14817002873,-2,1159,2227,20
14817220718,14817220715,-3,181,825,20
14817717131,14817717130,-1,1268,1991,20
14822454733,14822454730,-3,1142,2395,20
14831840705,14831840705,0,247,1524,20
14840541189,14840541186,-3,1056,2417,20
14850728982,14850728979,-3,698,2633,20
14852209826,14852209822,-4,831,1772,20
14854673243,14854673239,-4,1052,1681,20
14860278372,14860278370,-2,1010,2420,20
14862033707,14862033703,-4,1252,2809,20
14862330076,14862330087,11,226,1380,20
14863717960,14863717979,19,938,1891,20
14865370440,14865370437,-3,1491,2869,20
14866540869,14866540866,-3,1006,2006,20
14867269582,14867269574,-8,1356,2901,20
14872719670,14872719673,3,997,963,20
14881143633,14881143630,-3,1364,3194,20
14882487631,14882487630,-1,1225,1370,20
14882837177,14882837173,-4,662,1590,20
14885261467,14885261462,-5,1175,2401,20
14887352769,14887352766,-3,744,2676,20
14888176194,14888176191,-3,889,2161,20
14890780811,14890780806,-5,1511,4935,20
14894167030,14894167030,0,1078,2050,20
14896559040,14896559037,-3,1159,2499,20
14897290285,14897290292,7,3942,1566,20
14899832307,14899832310,3,7148,6189,20
14900658274,14900658270,-4,1022,2566,20
14906223916,14906223911,-5,1101,2886,20
14913446814,14913446812,-2,1332,2272,20
14919488602,14919488601,-1,1356,2810,20
14921432919,14921432916,-3,716,1452,20
14923206501,14923206500,-1,1543,2093,20
14925921306,14925921306,0,1155,1929,20
14926304434,14926304430,-4,1053,2594,20
14930200590,14930200589,-1,693,1365,20
14937287125,14937287123,-2,1212,2334,20
14939980774,14939980770,-4,941,2115,20
14941903574,14941903570,-4,1166,2486,20
14944998224,14944998222,-2,1163,2295,20
14947121434,14947121430,-4,1270,2184,20
14948097867,14948097866,-1,631,1406,20
14948617246,14948617230,-16,89,872,20
14953293647,14953293647,0,1092,1416,20
14954340863,14954340865,2,3084,3591,20
14958059743,14958059740,-3,945,1711,20
14958342063,14958342061,-2,998,2105,20
14960618622,14960618619,-3,877,3540,20
14961390521,14961390517,-4,1294,3037,20
14961572687,14961572684,-3,1278,2626,20
14963369494,14963369490,-4,1614,2955,20
14965087698,14965087694,-4,916,2539,20
14974682302,14974682306,4,1989,1434,20
14975371538,14975371538,0,958,1546,20
14978467307,14978467303,-4,892,2630,20
14984143069,14984143065,-4,1066,2157,20
14984255611,14984255609,-2,1109,3193,20
14986164255,14986164250,-5,1140,2336,20
14986706546,14986706545,-1,1309,2313,20
14988366202,14988366198,-4,1043,1301,20
14988861583,14988861601,18,1175,3017,20
14989296986,14989296982,-4,790,2974,20
14989662745,14989662741,-4,1355,2143,20
14992655574,14992655571,-3,1344,2300,20
14994894400,14994894398,-2,788,1885,20
14998642959,14998642954,-5,897,1676,20
14999938067,14999938065,-2,1075,2515,20
15000535857,15000535859,2,1683,1132,20
15005509736,15005509757,21,917,2528,20
15009603903,15009603901,-2,1051,2176,20
15018507194,15018507191,-3,1142,2137,20
15020310887,15020310886,-1,1338,966,20
15025616244,15025616241,-3,1031,1931,20
15025895671,15025895677,6,797,1420,20
15028031849,15028031845,-4,1209,1750,20
15037360185,15037360182,-3,1166,2489,20
15040643010,15040643006,-4,1112,2116,20
15043086240,15043086244,4,3080,3151,20
15044431923,15044431921,-2,1180,1920,20
15048504519,15048504513,-6,826,4965,20
15048670187,15048670186,-1,1445,1214,20
15049499587,15049499584,-3,1191,2037,20
15050280846,15050280849,3,1405,1217,20
15051865162,15051865158,-4,1804,3097,20
15051989521,15051989517,-4,906,2413,20
15060811214,15060811210,-4,1132,2154,20
15065429999,15065429998,-1,806,2584,20
15070560378,15070560373,-5,969,1786,20
15070687795,15070687795,0,558,1980,20
15072068006,15072068020,14,315,992,20
15072298139,15072298134,-5,574,1592,20
15080794002,15080794010,8,3375,1727,20
15081169495,15081169493,-2,1446,2391,20
15083571115,15083571113,-2,1213,3596,20
15086013435,15086013433,-2,1067,2280,20
15088026223,15088026222,-1,1195,1824,20
15089186598,15089186583,-15,969,1876,20
15097123620,15097123618,-2,1313,2335,20
15100844047,15100844046,-1,1371,3795,20
15103216954,15103216951,-3,1066,2945,20
15104683616,15104683613,-3,1324,2655,20
15106981765,15106981764,-1,1517,2083,20
15114531281,15114531279,-2,1435,2521,20
15117213258,15117213256,-2,1169,1930,20
15119676041,15119676043,2,3433,1904,20
15120158745,15120158742,-3,2620,5464,20
15120210634,15120210632,-2,1257,2220,20
15122853381,15122853377,-4,1110,2372,20
15123479295,15123479290,-5,1161,2747,20
15124386533,15124386532,-1,1168,1716,20
15128223155,15128223153,-2,1220,3420,20
15129208569,15129208567,-2,1217,1542,20
15133394098,15133394095,-3,1291,2232,20
15139609657,15139609653,-4,1070,2036,20
15140379691,15140379670,-21,3365,2568,20
15141929338,15141929344,6,2587,1282,20
15143598886,15143598883,-3,996,2286,20
15146825655,15146825646,-9,1062,2647,20
15151008816,15151008810,-6,901,1690,20
15153594373,15153594370,-3,1142,2114,20
15154671775,15154671785,10,371,929,20
15155258919,15155258916,-3,1563,2108,20
15157663247,15157663244,-3,1571,3022,20
15159548010,15159548006,-4,1120,2117,20
15166195007,15166195002,-5,900,2500,20
15169793850,15169793846,-4,1400,2678,20
15170671466,15170671462,-4,948,2142,20
15171365033,15171365030,-3,1082,1735,20
15172587466,15172587462,-4,1136,2739,20
15173003558,15173003555,-3,644,1469,20
15173747871,15173747862,-9,1248,2129,20
15180658854,15180658852,-2,974,2014,20
15181805419,15181805415,-4,622,1767,20
15181953434,15181953430,-4,1007,2908,20
15186508274,15186508273,-1,393,1142,20
15187388179,15187388175,-4,931,1987,20
15191492133,15191492126,-7,1126,1816,20
15193921424,15193921423,-1,990,2284,20
15194869803,15194869801,-2,1140,2376,20
15197810878,15197810885,7,2265,1099,20
15198182576,15198182575,-1,946,1407,20
15198289171,15198289166,-5,1620,2690,20
15198387953,15198387953,0,31657,52222,20
15204332306,15204332303,-3,1103,1888,20
15205001415,15205001411,-4,864,3683,20
15205454866,15205454868,2,15734,11345,20
15209534607,15209534605,-2,1326,2584,20
15211724219,15211724226,7,10365,32011,20
15213387073,15213387073,0,1164,1429,20
15213802569,15213802564,-5,876,3665,20
15215909994,15215909993,-1,979,2816,20
15216638279,15216638276,-3,1217,1963,20
15219563567,15219563562,-5,1167,2798,20
15227057849,15227057845,-4,1005,2217,20
15227334222,15227334221,-1,1360,2291,20
15235224948,15235224945,-3,1163,2056,20
15242124469,15242124467,-2,1371,2045,20
15248834683,15248834681,-2,1577,2409,20
15256646187,15256646184,-3,1460,3484,20
15262269076,15262269081,5,4123,2434,20
15272371459,15272371457,-2,1746,2458,20
15277597552,15277597549,-3,1237,1614,20
15281277777,15281277774,-3,1204,2567,20
15281307367,15281307386,19,986,2329,20
15283582405,15283582403,-2,1583,2857,20
15284603654,15284603658,4,2630,1591,20
15285030869,15285030869,0,1900,1987,20
15288828510,15288828509,-1,1370,2460,20
15289780646,15289780644,-2,1523,2773,20
15297201455,15297201455,0,3056,3572,20
15298319327,15298319325,-2,1082,1824,20
15300951997,15300951997,0,1146,2497,20
15301285823,15301285819,-4,1249,1891,20
15305679748,15305679748,0,1415,2162,20
15306642558,15306642557,-1,2236,2983,20
15307163240,15307163237,-3,907,2072,20
15307594684,15307594688,4,260,836,20
15312240775,15312240773,-2,995,2425,20
15317410466,15317410461,-5,1423,3743,20
15319461327,15319461323,-4,1021,2115,20
15322419429,15322419425,-4,1096,2574,20
15323657721,15323657719,-2,1175,1771,20
15324691874,15324691870,-4,978,3139,20
15326152172,15326152166,-6,1610,3182,20
15328354695,15328354701,6,3866,2070,20
15332787583,15332787566,-17,3096,1737,20
15333042356,15333042354,-2,1268,2762,20
15337623490,15337623486,-4,1133,2254,20
15339621368,15339621365,-3,1340,2521,20
15341476219,15341476217,-2,951,1672,20
15348764503,15348764498,-5,1001,1647,20
15349079027,15349079023,-4,1498,2033,20
15350042775,15350042772,-3,1175,3604,20
15353540078,15353540077,-1,1081,2648,20
15355203003,15355203000,-3,1081,2739,20
15355992927,15355992925,-2,1208,2271,20
15356349331,15356349330,-1,931,2122,20
15357799263,15357799259,-4,1285,3087,20
15358607714,15358607712,-2,1509,2278,20
15359625381,15359625377,-4,1375,2870,20
15360595469,15360595465,-4,1057,2153,20
15365831586,15365831581,-5,2528,7998,20
15367230389,15367230386,-3,1286,2276,20
15368154758,15368154754,-4,967,2233,20
15373258639,15373258637,-2,1587,2578,20
15374582898,15374582897,-1,1085,1857,20
15375626595,15375626592,-3,644,1759,20
15375915254,15375915253,-1,1193,1910,20
15378459287,15378459282,-5,1291,2917,20
15385833273,15385833271,-2,972,2388,20
15386373539,15386373541,2,1787,1690,20
15387246809,15387246807,-2,1278,1949,20
15387794567,15387794562,-5,1062,3169,20
15389920442,15389920459,17,323,3103,20
15390251994,15390251992,-2,6519,11620,20
15390717595,15390717593,-2,1289,1992,20
15394390606,15394390604,-2,1087,2692,20
15397999169,15397999166,-3,1398,2429,20
15399376287,15399376283,-4,1644,1868,20
15401383939,15401383946,7,2530,1264,20
15404281381,15404281376,-5,1125,2362,20
15408521096,15408521093,-3,961,2475,20
15408742636,15408742618,-18,1445,2274,20
15410649642,15410649641,-1,1193,2407,20
15411559670,15411559666,-4,1277,2748,20
15414723875,15414723873,-2,1404,2648,20
15417955794,15417955790,-4,525,1864,20
15421187588,15421187585,-3,1303,2302,20
15423636751,15423636749,-2,1102,1951,20
15424913557,15424913558,1,2615,3319,20
15426819847,15426819845,-2,1479,2172,20
15429686944,15429686942,-2,1815,2863,20
15431865665,15431865662,-3,980,2317,20
15438119756,15438119757,1,1083,2041,20
15444717094,15444717094,0,1066,1617,20
15446020382,15446020386,4,4086,3302,20
15449233820,15449233835,15,393,1005,20
15452588151,15452588150,-1,1458,2146,20
15453034479,15453034475,-4,832,1232,20
15455718684,15455718679,-5,1303,2866,20
15456352168,15456352178,10,30,1078,20
15457873159,15457873157,-2,1141,3056,20
15464650049,15464650046,-3,1333,2962,20
15464884598,15464884596,-2,1219,2802,20
15469453554,15469453552,-2,1382,2191,20
15470851306,15470851305,-1,807,2016,20
15470880845,15470880865,20,918,2771,20
15474659720,15474659714,-6,1352,4537,20
15476432555,15476432550,-5,988,3314,20
15476977235,15476977231,-4,1056,2252,20
15478445190,15478445187,-3,1301,3104,20
15481267823,15481267826,3,1189,1246,20
15484555846,15484555841,-5,1121,3661,20
15487114702,15487114700,-2,1269,2714,20
15490033958,15490033944,-14,748,212,20
15490594655,15490594650,-5,745,2081,20
15493024487,15493024484,-3,1319,2721,20
15500452427,15500452426,-1,1415,2874,20
15504270046,15504270049,3,1805,1287,20
15505825967,15505825966,-1,844,1933,20
15506110303,15506110302,-1,3010,5028,20
15511674544,15511674541,-3,916,1813,20
15514228570,15514228566,-4,958,2468,20
15519613312,15519613309,-3,1263,2597,20
15521337629,15521337627,-2,1177,2135,20
15526644646,15526644643,-3,989,2155,20
15528526326,15528526330,4,1382,1080,20
15529120255,15529120251,-4,1229,2416,20
15532084099,15532084097,-2,696,1882,20
15536449389,15536449388,-1,5469,8769,20
15538540275,15538540274,-1,883,1572,20
15540003662,15540003656,-6,31248,13054,20
15547644042,15547644039,-3,1150,2342,20
15550505397,15550505393,-4,1153,2434,20
15552694902,15552694901,-1,751,1293,20
15559522135,15559522130,-5,764,1924,20
15562537852,15562537849,-3,1056,1914,20
15563538352,15563538348,-4,1442,2236,20
15564362935,15564362931,-4,1383,3140,20
15566352621,15566352620,-1,1170,1872,20
15566475742,15566475738,-4,1479,2486,20
15567216687,15567216685,-2,1105,1872,20
15572931012,15572931009,-3,1221,2172,20
15574371831,15574371829,-2,1062,2214,20
15580152571,15580152566,-5,1014,3577,20
15580273214,15580273234,20,424,985,20
15580953142,15580953140,-2,1313,2138,20
15583049602,15583049610,8,1953,777,20
15585269293,15585269290,-3,965,2513,20
15586810533,15586810530,-3,1462,2280,20
15587737462,15587737458,-4,1130,2353,20
15588447518,15588447517,-1,1007,2339,20
15592153626,15592153622,-4,1115,2152,20
15592240062,15592240061,-1,1554,3431,20
15592678523,15592678520,-3,1061,2229,20
15594605355,15594605354,-1,1012,2209,20
15597668405,15597668404,-1,870,1965,20
15598646895,15598646887,-8,1245,2212,20
15601695289,15601695283,-6,834,3943,20
15601914861,15601914843,-18,166,837,20
15603253505,15603253503,-2,1166,1881,20
15605059058,15605059055,-3,849,1696,20
15607918243,15607918239,-4,1351,2506,20
15609107319,15609107316,-3,1576,2672,20
15609655454,15609655442,-12,167,1169,20
15612458513,15612458509,-4,1207,2380,20
15614287030,15614287028,-2,1186,2821,20
15614481463,15614481463,0,801,1404,20
15628365170,15628365167,-3,956,1824,20
15631867710,15631867707,-3,2106,3746,20
15633013907,15633013905,-2,1148,2613,20
15633528860,15633528857,-3,1242,2076,20
15634190590,15634190585,-5,838,2251,20
15634245163,15634245161,-2,1016,2780,20
15641931738,15641931735,-3,1183,2064,20
15645602870,15645602866,-4,803,2128,20
15645784719,15645784737,18,819,2314,20
15648508551,15648508556,5,305,750,20
15648910322,15648910318,-4,1145,2392,20
15649665478,15649665473,-5,1430,2822,20
15651957338,15651957337,-1,1385,3040,20
15653080300,15653080298,-2,1155,1993,20
15655722086,15655722083,-3,1043,2182,20
15661241255,15661241253,-2,943,2499,20
15661990566,15661990562,-4,805,2857,20
15668889180,15668889195,15,1262,1527,20
15673244067,15673244062,-5,892,3122,20
15677668110,15677668110,0,995,980,20
15681351977,15681351976,-1,1083,411,20
15687356078,15687356079,1,972,1332,20
15689401518,15689401518,0,632,1255,20
15689720404,15689720425,21,816,1956,20
15692412599,15692412597,-2,1524,3381,20
15695328734,15695328733,-1,2532,4594,20
15702047594,15702047591,-3,1006,1745,20
15702178578,15702178577,-1,1494,3298,20
15704529382,15704529377,-5,1273,3036,20
15708358545,15708358541,-4,1024,2100,20
15718064396,15718064393,-3,1125,2373,20
15724038594,15724038591,-3,1360,1804,20
15727866754,15727866750,-4,991,1623,20
15731355052,15731355050,-2,1528,2505,20
15741391486,15741391482,-4,1685,2430,20
15746425271,15746425268,-3,1201,2497,20
15751836806,15751836807,1,1535,1546,20
15757814783,15757814781,-2,1277,2272,20
15759427643,15759427649,6,43382,22846,20
15760166282,15760166281,-1,909,2592,20
15761859943,15761859949,6,1811,1139,20
15764206247,15764206246,-1,1136,1754,20
15767637469,15767637466,-3,1384,3284,20
15775113002,15775113000,-2,1122,1873,20
15776338982,15776338982,0,1479,2036,20
15779433604,15779433597,-7,183,782,20
15786155991,15786155989,-2,666,1533,20
15786828628,15786828629,1,1429,1764,20
15787217854,15787217850,-4,1303,1959,20
15791231797,15791231797,0,1242,1713,20
15792075860,15792075858,-2,1076,2615,20
15792788571,15792788568,-3,1147,2900,20
15793904912,15793904910,-2,1229,2289,20
15799438473,15799438470,-3,1407,2142,20
15801015210,15801015207,-3,923,2589,20
15805122074,15805122072,-2,1000,2070,20
15807027054,15807027061,7,6533,2794,20
15807105519,15807105515,-4,1216,3099,20
15811632995,15811632993,-2,1240,2230,20
15813566043,15813566039,-4,1042,2738,20
15825750911,15825750907,-4,777,2404,20
15827210742,15827210735,-7,1048,3832,20
15830193187,15830193184,-3,1626,2642,20
15832970173,15832970175,2,2301,1977,20
15834059093,15834059095,2,1710,1580,20
15835803106,15835803106,0,915,1036,20
15838177793,15838177790,-3,731,2256,20
15839432138,15839432135,-3,1357,2350,20
15839666530,15839666528,-2,1228,2049,20
15846240987,15846240983,-4,1194,1942,20
15848005087,15848005083,-4,1036,3020,20
15850500328,15850500323,-5,1333,2678,20
15852068319,15852068318,-1,1172,1713,20
15856086622,15856086620,-2,1226,3166,20
15861308838,15861308834,-4,959,2479,20
15861891063,15861891061,-2,1076,3506,20
15869345223,15869345220,-3,1250,2619,20
15873418671,15873418670,-1,1166,1468,20
15876187754,15876187750,-4,1043,2757,20
15880080955,15880080961,6,2450,1369,20
15881540611,15881540605,-6,1160,2264,20
15883097257,15883097260,3,1329,1561,20
15883643663,15883643660,-3,1082,3114,20
15885199496,15885199494,-2,1271,2362,20
15888100686,15888100683,-3,1164,1980,20
15891682480,15891682497,17,749,1231,20
15892684122,15892684119,-3,1132,2703,20
15899526621,15899526622,1,1725,1445,20
15899765852,15899765846,-6,852,2885,20
15900028484,15900028473,-11,938,2100,20
15901554533,15901554530,-3,1724,3119,20
15905436859,15905436857,-2,1361,2941,20
15906835346,15906835346,0,1006,1419,20
15908503744,15908503740,-4,998,2504,20
15910489321,15910489321,0,1179,1999,20
15910752861,15910752846,-15,899,2219,20
15911509751,15911509749,-2,785,1570,20
15912819308,15912819326,18,581,1260,20
15915350225,15915350220,-5,22591,14800,20
15916874994,15916874991,-3,757,2289,20
15922889171,15922889170,-1,1292,1676,20
15923883645,15923883642,-3,834,2233,20
15925149489,15925149486,-3,857,2432,20
15927340065,15927340061,-4,966,2484,20
15932757895,15932757892,-3,1120,2733,20
15936637722,15936637721,-1,1792,2481,20
15938245014,15938245010,-4,1120,2452,20
15941504477,15941504474,-3,1146,1981,20
15944223122,15944223119,-3,1044,2465,20
15945390810,15945390809,-1,959,3299,20
15949055102,15949055098,-4,1019,2139,20
15954063892,15954063890,-2,1342,2375,20
15954176055,15954176061,6,2520,1296,20
15956585446,15956585444,-2,1230,2191,20
15957947045,15957947042,-3,932,1856,20
15962685527,15962685525,-2,1451,1996,20
15963202367,15963202366,-1,1009,1817,20
15969920246,15969920246,0,1002,739,20
15971668289,15971668286,-3,1134,2315,20
15972535210,15972535211,1,1302,1693,20
15974580978,15974580977,-1,969,1825,20
15977193397,15977193395,-2,1200,2147,20
15980132943,15980132946,3,204,755,20
15980690152,15980690171,19,345,1476,20
16002707363,16002707362,-1,950,1069,20
16009019851,16009019848,-3,1262,2305,20
16010092773,16010092770,-3,1315,2204,20
16010259519,16010259517,-2,1228,3092,20
16011996190,16011996187,-3,996,2919,20
16014976915,16014976911,-4,1621,2327,20
16017123759,16017123755,-4,1155,3237,20
16019986204,16019986202,-2,1249,1522,20
16020417903,16020417900,-3,1015,2143,20
16022099065,16022099058,-7,1430,2745,20
16024147795,16024147793,-2,1288,1682,20
16036349528,16036349526,-2,1350,3155,20
16036853703,16036853701,-2,1084,3205,20
16037527074,16037527068,-6,1185,3129,20
16037632890,16037632887,-3,2118,3709,20
16039128830,16039128828,-2,1184,1819,20
16039678696,16039678685,-11,1064,2607,20
16039937494,16039937491,-3,1044,2946,20
16040674373,16040674370,-3,961,2285,20
16041793660,16041793654,-6,96,1259,20
16044081507,16044081511,4,2429,1516,20
16044239858,16044239858,0,1872,2301,20
16048159839,16048159838,-1,1400,3170,20
16049688640,16049688659,19,1610,2327,20
16056090513,16056090510,-3,1271,2089,20
16057974173,16057974173,0,857,1546,20
16059278500,16059278496,-4,1253,2768,20
16064970439,16064970434,-5,1155,1661,20
16066716079,16066716086,7,137,709,20
16066832581,16066832601,20,1578,4095,20
16067936098,16067936095,-3,996,2450,20
16079105924,16079105923,-1,917,1492,20
16079746375,16079746372,-3,1382,3388,20
16085329352,16085329350,-2,1135,2067,20
16085898635,16085898631,-4,1518,2869,20
16086545542,16086545539,-3,1161,2048,20
16087399307,16087399306,-1,1397,2160,20
16088467070,16088467069,-1,984,2455,20
16089281404,16089281398,-6,1909,4161,20
16090632174,16090632174,0,1271,1990,20
16095449395,16095449390,-5,797,1818,20
16098107014,16098107014,0,1502,2264,20
16099050607,16099050602,-5,1917,5557,20
16105633342,16105633339,-3,979,2311,20
16108514338,16108514334,-4,1072,2564,20
16108567208,16108567218,10,123,880,20
16110513758,16110513754,-4,993,2193,20
16112202584,16112202579,-5,1203,2489,20
16112448747,16112448745,-2,1558,3094,20
16112575735,16112575733,-2,840,2054,20
16116042346,16116042341,-5,993,1593,20
16119103251,16119103250,-1,1434,2421,20
16119180230,16119180229,-1,1191,2000,20
16128278071,16128278070,-1,1348,2591,20
16134192005,16134192003,-2,1135,2226,20
16137168130,16137168125,-5,1309,2834,20
16139330345,16139330342,-3,1452,2493,20
16141208031,16141208027,-4,944,2205,20
16142269126,16142269122,-4,632,1760,20
16142767631,16142767615,-16,915,1084,20
16145599285,16145599282,-3,1346,2510,20
16151299713,16151299708,-5,891,2494,20
16153131418,16153131415,-3,1214,2687,20
16154639153,16154639149,-4,1339,3266,20
16160165841,16160165837,-4,1086,3218,20
16166397557,16166397552,-5,1255,2067,20
16166500014,16166500007,-7,907,1822,20
16166862106,16166862110,4,1843,1371,20
16167350679,16167350674,-5,694,2183,20
16167882941,16167882936,-5,1138,4573,20
16168020534,16168020532,-2,1561,2652,20
16174130735,16174130732,-3,1004,1883,20
16175438669,16175438666,-3,1175,2336,20
16179095786,16179095785,-1,1328,2147,20
16179241878,16179241875,-3,961,3217,20
16182435351,16182435347,-4,841,1309,20
16188483227,16188483222,-5,1412,3213,20
16191445234,16191445238,4,4427,2718,20
16192152578,16192152574,-4,1199,2278,20
16192374711,16192374715,4,1293,1292,20
16195066315,16195066308,-7,2016,5891,20
16195333653,16195333650,-3,1352,2380,20
16198366652,16198366645,-7,1263,3306,20
16205713990,16205713989,-1,1007,2388,20
16207580061,16207580062,1,1831,1300,20
16210047319,16210047316,-3,1283,2256,20
16212214017,16212214014,-3,1178,2222,20
16213673716,16213673713,-3,560,1448,20
16216855154,16216855153,-1,627,1435,20
16219186815,16219186810,-5,1083,2660,20
16230853778,16230853775,-3,871,1625,20
16233300001,16233299999,-2,1584,2886,20
16234722486,16234722486,0,1303,1926,20
16239506894,16239506895,1,2027,1596,20
16239622228,16239622225,-3,1497,2266,20
16239854662,16239854658,-4,1187,3052,20
16240482909,16240482891,-18,1439,1944,20
16247457311,16247457309,-2,1608,2534,20
16248086040,16248086037,-3,965,2175,20
16249422811,16249422808,-3,1435,3184,20
16249890698,16249890694,-4,1161,2684,20
16253203574,16253203570,-4,679,2155,20
16256694014,16256694017,3,2632,2089,20
16261471437,16261471434,-3,1000,2111,20
16261501077,16261501099,22,841,2646,20
16261643359,16261643356,-3,1148,2156,20
16261830198,16261830195,-3,1264,1842,20
16262500173,16262500178,5,2862,1179,20
16271546291,16271546289,-2,953,1484,20
16272645364,16272645382,18,999,1935,20
16273200942,16273200939,-3,1099,2744,20
16273436456,16273436471,15,1122,2145,20
16276009399,16276009400,1,584,1859,20
16289446281,16289446278,-3,901,2077,20
16291445937,16291445933,-4,1121,2223,20
16291886552,16291886570,18,374,835,20
16296083222,16296083220,-2,1308,2394,20
16296574447,16296574446,-1,1258,2059,20
16297826042,16297826041,-1,1077,1154,20
16298363943,16298363942,-1,1314,1609,20
16300315166,16300315167,1,1312,1028,20
16304461458,16304461450,-8,830,4297,20
16308235182,16308235180,-2,1711,3366,20
16312321036,16312321031,-5,1001,1872,20
16313985283,16313985271,-12,29849,15849,20
16319256848,16319256853,5,2848,1287,20
16323562638,16323562643,5,2424,1367,20
16326575763,16326575770,7,7148,2449,20
16327327632,16327327630,-2,1496,2307,20
16329412529,16329412526,-3,874,2369,20
16330262734,16330262730,-4,1034,2343,20
16331012690,16331012687,-3,1292,1964,20
16333217659,16333217656,-3,1193,2501,20
16337968870,16337968867,-3,1163,2922,20
16343167341,16343167337,-4,840,1808,20
16346648159,16346648158,-1,1599,2210,20
16347173270,16347173269,-1,894,1853,20
16353599938,16353599935,-3,1062,2714,20
16355656854,16355656874,20,210,1184,20
16355969182,16355969202,20,1005,2799,20
16360805094,16360805090,-4,1400,3094,20
16361347056,16361347053,-3,887,2144,20
16367613810,16367613807,-3,1395,2793,20
16369983070,16369983068,-2,962,2200,20
16371914003,16371913997,-6,1285,3333,20
16374090125,16374090122,-3,1446,1957,20
16377476986,16377476985,-1,1311,3605,20
16382039242,16382039239,-3,21497,12871,20
16383643549,16383643546,-3,1368,2541,20
16386972873,16386972864,-9,1080,2613,20
16387600399,16387600416,17,427,1436,20
16387792616,16387792625,9,304,1016,20
16392191776,16392191772,-4,1146,2433,20
16399534815,16399534812,-3,1312,2244,20
16400075319,16400075314,-5,783,3474,20
16405419204,16405419213,9,11247,40602,20
16406394954,16406394949,-5,938,2213,20
16407219043,16407219038,-5,1081,2257,20
16408938138,16408938136,-2,1386,2298,20
16411618397,16411618398,1,1342,1569,20
16413997162,16413997160,-2,1066,2233,20
16414478002,16414477999,-3,1269,2161,20
16414766968,16414766966,-2,1223,2523,20
16416196162,16416196159,-3,1182,2658,20
16418584088,16418584111,23,746,2063,20
16419065177,16419065175,-2,1592,3040,20
16419240798,16419240795,-3,1368,2615,20
16420303523,16420303521,-2,1017,1727,20
16425442910,16425442909,-1,844,1907,20
16432413954,16432413952,-2,811,2321,20
16433139064,16433139053,-11,877,1390,20
16436121899,16436121898,-1,911,2037,20
16436879685,16436879681,-4,1170,1904,20
16437779927,16437779925,-2,836,2814,20
16440831443,16440831442,-1,1017,1576,20
16446429636,16446429633,-3,986,2438,20
16447526517,16447526513,-4,1203,2663,20
16459619606,16459619615,9,13956,27053,20
16460679403,16460679404,1,748,1253,20
16465875278,16465875275,-3,1260,2638,20
16473141169,16473141174,5,2383,911,20
16475682658,16475682660,2,1972,1508,20
16482786766,16482786765,-1,789,1593,20
16486708927,16486708925,-2,910,2113,20
16487116543,16487116540,-3,1570,3340,20
16489134976,16489134997,21,1106,1705,20
16495072161,16495072157,-4,1024,1607,20
16498105975,16498105973,-2,1160,1923,20
16500903329,16500903324,-5,1223,3388,20
16501625456,16501625450,-6,1138,3732,20
16503197712,16503197708,-4,1069,1953,20
16504254714,16504254712,-2,1409,2567,20
16505640363,16505640361,-2,858,1927,20
16506960655,16506960653,-2,1327,1910,20
16508057957,16508057960,3,17313,11562,20
16508651551,16508651547,-4,1123,1865,20
16515444918,16515444916,-2,1315,2256,20
16523217179,16523217174,-5,773,1988,20
16527336614,16527336612,-2,978,1574,20
16527915419,16527915414,-5,989,2603,20
16528683409,16528683407,-2,893,2296,20
16531690968,16531690966,-2,1180,2256,20
16531789216,16531789213,-3,1191,1404,20
16532940413,16532940409,-4,1142,3119,20
16536919574,16536919573,-1,929,1643,20
16538317948,16538317941,-7,1050,3198,20
16539090550,16539090546,-4,1378,2996,20
16539738014,16539738015,1,1083,1633,20
16539811478,16539811471,-7,346,1214,20
16543784034,16543784031,-3,552,1499,20
16545254969,16545254969,0,3414,2283,20
16546800213,16546800210,-3,977,2231,20
16547936102,16547936101,-1,1287,1612,20
16549632754,16549632753,-1,1084,2426,20
16550822019,16550822017,-2,1212,2142,20
16553710492,16553710488,-4,1205,1924,20
16554296598,16554296586,-12,1312,2777,20
16554629194,16554629194,0,1202,1803,20
16555106205,16555106201,-4,1077,1694,20
16555807539,16555807534,-5,843,2477,20
16556189019,16556189014,-5,1058,2341,20
16565616722,16565616721,-1,1633,2854,20
16567197841,16567197838,-3,822,1465,20
16568139658,16568139655,-3,1175,2865,20
16579482115,16579482110,-5,943,1630,20
16582688507,16582688504,-3,1628,3043,20
16583552378,16583552374,-4,1277,3001,20
16586216442,16586216438,-4,1318,3424,20
16588241791,16588241787,-4,931,2114,20
16588821489,16588821486,-3,649,1460,20
16591473518,16591473516,-2,1270,2647,20
16591743806,16591743806,0,1336,2417,20
16595609254,16595609250,-4,966,1930,20
16597557620,16597557618,-2,1142,2116,20
16601787133,16601787133,0,1115,980,20
16604382414,16604382411,-3,1072,1895,20
16604413877,16604413861,-16,875,2714,20
16605894849,16605894846,-3,1396,1721,20
16623467275,16623467271,-4,968,2192,20
16623503439,16623503422,-17,269,624,20
16623905046,16623905051,5,1345,1023,20
16624644270,16624644254,-16,494,2290,20
16630476845,16630476841,-4,1017,2097,20
16631198117,16631198114,-3,868,2508,20
16631615306,16631615304,-2,867,1927,20
16632351693,16632351684,-9,1619,2359,20
16633721103,16633721098,-5,1257,2426,20
16635756103,16635756101,-2,1632,2916,20
16636460144,16636460141,-3,1417,2032,20
16638264841,16638264837,-4,984,2164,20
16640796458,16640796455,-3,991,2394,20
16644497492,16644497487,-5,1371,2503,20
16644769582,16644769601,19,872,2098,20
16645794653,16645794650,-3,424,873,20
16650308190,16650308188,-2,1386,2711,20
16652997165,16652997163,-2,1147,2562,20
16653696502,16653696522,20,931,2204,20
16655730318,16655730317,-1,1362,1565,20
16656851637,16656851633,-4,1023,2433,20
16657895601,16657895598,-3,1300,2912,20
16664925537,16664925532,-5,1562,3088,20
16669198342,16669198339,-3,1109,1919,20
16671190648,16671190646,-2,1077,2424,20
16677555432,16677555426,-6,1603,3731,20
16682928946,16682928942,-4,1663,3731,20
16683340669,16683340670,1,1530,2007,20
16683732842,16683732838,-4,523,1254,20
16686641378,16686641376,-2,747,2467,20
16689399058,16689399056,-2,1145,2347,20
16690610182,16690610195,13,988,2275,20
16693471791,16693471790,-1,1128,2794,20
16695129650,16695129649,-1,1401,1677,20
16696859526,16696859531,5,4178,2242,20
16714146682,16714146678,-4,897,1994,20
16716159235,16716159235,0,695,986,20
16721851122,16721851122,0,1232,2510,20
16722327775,16722327771,-4,970,2307,20
16724259702,16724259699,-3,831,1493,20
16724624238,16724624257,19,580,2759,20
16726659861,16726659857,-4,1420,2094,20
16727344847,16727344842,-5,1205,2808,20
16728781918,16728781914,-4,1525,2640,20
16735066470,16735066467,-3,1058,2136,20
16740548378,16740548383,5,1682,1850,20
16743293866,16743293865,-1,988,2443,20
16747625735,16747625732,-3,961,2448,20
16749355735,16749355734,-1,1084,1673,20
16754262109,16754262105,-4,1096,1819,20
16755160238,16755160236,-2,1499,2704,20
16760023241,16760023237,-4,838,1262,20
16760349016,16760349034,18,98,1026,20
16762687965,16762687963,-2,984,1549,20
16763147004,16763146996,-8,35467,16420,20
16764060603,16764060605,2,1418,1956,20
16767169496,16767169494,-2,1566,2249,20
16767517470,16767517469,-1,960,2135,20
16771454817,16771454813,-4,980,2423,20
16772228236,16772228233,-3,1062,2553,20
16773608578,16773608562,-16,1227,2162,20
16778548122,16778548122,0,569,1150,20
16785984703,16785984698,-5,973,3219,20
16792296413,16792296410,-3,1122,2878,20
16796821857,16796821854,-3,1052,1833,20
16799146659,16799146674,15,689,2462,20
16799866120,16799866118,-2,1278,1951,20
16801704927,16801704925,-2,2035,2501,20
16805553206,16805553204,-2,948,2221,20
16805590103,16805590098,-5,1141,2446,20
16807275119,16807275119,0,780,1209,20
16807850819,16807850816,-3,1063,2960,20
16824070765,16824070766,1,1161,1146,20
16824658098,16824658118,20,2681,1805,20
16825903687,16825903686,-1,777,1229,20
16828146059,16828146058,-1,1518,2621,20
16833341755,16833341753,-2,1008,2121,20
16838041970,16838041968,-2,1304,1275,20
16838777765,16838777761,-4,1022,3897,20
16838872734,16838872753,19,676,1223,20
16839968805,16839968803,-2,1126,2112,20
16840474175,16840474171,-4,844,1640,20
16841800935,16841800931,-4,1230,1961,20
16842114418,16842114416,-2,1525,2222,20
16843606059,16843606056,-3,1213,3519,20
16848819870,16848819866,-4,1365,3625,20
16855197505,16855197506,1,1616,1348,20
16863107130,16863107125,-5,1075,2828,20
16866737970,16866737966,-4,1131,2420,20
16867590779,16867590763,-16,101,688,20
16868396742,16868396740,-2,1270,2659,20
16869098335,16869098330,-5,903,3170,20
16872776511,16872776505,-6,960,4002,20
16873291347,16873291342,-5,1196,2293,20
16875020066,16875020063,-3,606,2287,20
16875305782,16875305767,-15,1053,1199,20
16876363245,16876363247,2,1110,1011,20
16879155951,16879155948,-3,1126,2176,20
16879697831,16879697829,-2,1330,2281,20
16880750641,16880750643,2,3217,3446,20
16881177259,16881177255,-4,659,1440,20
16892577831,16892577825,-6,2180,8275,20
16896495054,16896495056,2,1608,1832,20
16898616494,16898616489,-5,951,2298,20
16898687610,16898687607,-3,771,1388,20
16899224499,16899224495,-4,1280,2102,20
16901207734,16901207730,-4,982,2077,20
16902578036,16902578034,-2,1003,2205,20
16904928166,16904928162,-4,1052,2716,20
16913529478,16913529477,-1,1223,2134,20
16917851238,16917851236,-2,424,939,20
16919789641,16919789639,-2,1604,3565,20
16922032252,16922032247,-5,741,1631,20
16924516494,16924516490,-4,1518,2550,20
16928027398,16928027399,1,941,1049,20
16929105024,16929105005,-19,1198,1876,20
16929811943,16929811958,15,881,1848,20
16938726836,16938726833,-3,1384,2419,20
16942233278,16942233289,11,14894,40473,20
16942604893,16942604890,-3,1104,2623,20
16944764882,16944764878,-4,1414,2941,20
16945264711,16945264710,-1,831,2333,20
16949495820,16949495818,-2,1438,1769,20
16952266651,16952266659,8,5122,1834,20
16956381531,16956381529,-2,676,1435,20
16958918914,16958918909,-5,1434,4132,20
16959706903,16959706901,-2,1256,2631,20
16960994765,16960994761,-4,1701,2933,20
16962058073,16962058069,-4,925,1825,20
16964358063,16964358060,-3,1032,1466,20
16966373213,16966373210,-3,1306,1788,20
16969931250,16969931245,-5,31739,13078,20
16970249517,16970249513,-4,595,1847,20
16973815434,16973815430,-4,1258,2116,20
16975120687,16975120686,-1,1003,1575,20
16977146615,16977146613,-2,1004,1901,20
16981089545,16981089541,-4,1065,190,20
16983309511,16983309510,-1,1274,2563,20
16984541199,16984541198,-1,1221,2587,20
16986212963,16986212960,-3,1118,2868,20
16986430948,16986430942,-6,215,854,20
16989583411,16989583408,-3,971,2395,20
16990354839,16990354835,-4,1026,2043,20
16992627768,16992627765,-3,827,1934,20
16997437778,16997437776,-2,1312,1966,20
16998207790,16998207790,0,1249,2775,20
17001700429,17001700426,-3,1203,2868,20
17002294961,17002294958,-3,1118,3249,20
17005142291,17005142289,-2,759,2655,20
17005555943,17005555938,-5,1061,2128,20
17007588198,17007588194,-4,1092,2769,20
17009711422,17009711422,0,880,1761,20
17010680262,17010680264,2,3279,2672,20
17018236816,17018236823,7,2825,1302,20
17021505793,17021505791,-2,1531,3422,20
17023753373,17023753370,-3,1004,2179,20
17024797562,17024797559,-3,2583,4825,20
17027762770,17027762767,-3,976,2436,20
17032211602,17032211598,-4,1624,7175,20
17034181221,17034181217,-4,900,2702,20
17034606815,17034606833,18,1228,1778,20
17035258075,17035258071,-4,991,2669,20
17036584285,17036584281,-4,1209,3341,20
17041873934,17041873930,-4,954,2659,20
17042488138,17042488134,-4,879,2901,20
17045129102,17045129100,-2,26327,23939,20
17052955830,17052955827,-3,1028,2633,20
17059334213,17059334209,-4,1364,2125,20
17059675055,17059675053,-2,964,3024,20
17061585575,17061585592,17,929,2498,20
17062728504,17062728502,-2,1154,2306,20
17066403751,17066403747,-4,1070,2191,20
17067049087,17067049087,0,89,732,20
17067982305,17067982302,-3,1513,3038,20
17072410862,17072410861,-1,899,1864,20
17077290989,17077290985,-4,1095,2359,20
17077369475,17077369474,-1,1061,1621,20
17080325427,17080325424,-3,1273,2686,20
17080392028,17080392023,-5,1265,3135,20
17080973206,17080973202,-4,987,2250,20
17081530347,17081530344,-3,25015,21106,20
17082613287,17082613289,2,2769,2382,20
17082998383,17082998380,-3,915,2339,20
17086603427,17086603425,-2,867,2767,20
17088757611,17088757607,-4,1135,2882,20
17089014573,17089014559,-14,35,1172,20
17091791201,17091791203,2,1788,1567,20
17093803382,17093803380,-2,1244,2717,20
17097378902,17097378903,1,1570,2472,20
17100055811,17100055806,-5,916,2464,20
17104385810,17104385806,-4,870,2037,20
17105435309,17105435307,-2,1378,2478,20
17107766733,17107766732,-1,781,2056,20
17109008330,17109008335,5,2376,1194,20
17111465312,17111465317,5,1641,1184,20
17115902673,17115902669,-4,886,1422,20
17117852029,17117852026,-3,1162,2070,20
17119717415,17119717414,-1,768,2546,20
17119928111,17119928090,-21,226,1556,20
17120981819,17120981818,-1,1271,1933,20
17121702559,17121702538,-21,1165,2186,20
17123191601,17123191596,-5,1107,2572,20
17129790550,17129790549,-1,1181,1911,20
17131112411,17131112410,-1,1346,2769,20
17132790604,17132790601,-3,1614,3108,20
17136233542,17136233539,-3,1003,1729,20
17137189779,17137189775,-4,1294,2267,20
17139147451,17139147448,-3,836,2802,20
17139418526,17139418508,-18,1048,1948,20
17141749422,17141749420,-2,964,2537,20
17146907023,17146907022,-1,1166,1948,20
17150414146,17150414142,-4,1201,2796,20
17150694487,17150694505,18,1078,2339,20
17150770076,17150770062,-14,328,1136,20
17151700317,17151700312,-5,1434,2422,20
17153442693,17153442714,21,982,2537,20
17163925561,17163925558,-3,1162,1923,20
17165113684,17165113682,-2,1290,2083,20
17166903727,17166903723,-4,990,2539,20
17169671070,17169671067,-3,1320,3289,20
17174046335,17174046316,-19,1080,2317,20
17176015134,17176015133,-1,1928,2683,20
17176277226,17176277223,-3,1283,2277,20
17182855657,17182855676,19,612,1102,20
17186215529,17186215526,-3,779,1377,20
17187168531,17187168527,-4,994,2859,20
17187439631,17187439630,-1,1219,1653,20
17187750457,17187750455,-2,750,1685,20
17190269945,17190269940,-5,1246,2877,20
17192529242,17192529239,-3,962,2734,20
17194027053,17194027048,-5,1158,2206,20
17194208806,17194208827,21,1231,3096,20
17195230779,17195230776,-3,1330,2279,20
17198229165,17198229172,7,1337,770,20
17198926246,17198926253,7,2144,896,20
17199348438,17199348434,-4,1142,3167,20
17204631099,17204631098,-1,1676,3218,20
17205040227,17205040227,0,3053,4506,20
17207022949,17207022945,-4,1453,4099,20
17216384393,17216384390,-3,1079,2460,20
17218548326,17218548325,-1,912,1678,20
17218938638,17218938658,20,981,2301,20
17219916345,17219916342,-3,1216,3379,20
17219970750,17219970738,-12,560,832,20
17220767722,17220767721,-1,852,2034,20
17221286158,17221286156,-2,1433,2612,20
17225431212,17225431206,-6,988,2353,20
17229222947,17229222942,-5,762,1960,20
17229660151,17229660147,-4,920,2846,20
17241343257,17241343256,-1,1074,2450,20
17246055686,17246055686,0,1200,2127,20
17246339516,17246339513,-3,1006,2293,20
17248063139,17248063137,-2,1157,2339,20
17248283201,17248283197,-4,1298,2040,20
17249303845,17249303863,18,461,1311,20
17251018054,17251018050,-4,1030,2452,20
17251207911,17251207910,-1,1074,2369,20
17252603894,17252603893,-1,859,2036,20
17255148621,17255148618,-3,873,2298,20
17255542122,17255542123,1,1579,1422,20
17262778593,17262778590,-3,1077,2541,20
17263097126,17263097123,-3,1233,2665,20
17266576643,17266576641,-2,1149,2445,20
17268419826,17268419828,2,2127,1924,20
17269647301,17269647299,-2,672,724,20
17274810151,17274810152,1,1485,1376,20
17275057224,17275057221,-3,1095,2457,20
17275336851,17275336849,-2,1029,1833,20
17275673270,17275673267,-3,1077,2031,20
17282626490,17282626476,-14,424,6008,20
17287662055,17287662050,-5,1264,1813,20
17290665495,17290665493,-2,194,1179,20
17291421480,17291421477,-3,999,2383,20
17292963654,17292963649,-5,1238,2762,20
17295969923,17295969921,-2,1248,2572,20
17297300385,17297300381,-4,1167,2720,20
17298104939,17298104933,-6,619,2082,20
17299115847,17299115847,0,647,1930,20
17302556246,17302556245,-1,1246,2140,20
17305716334,17305716342,8,5679,2331,20
17306055077,17306055074,-3,986,1587,20
17309142061,17309142058,-3,1068,2539,20
17310367046,17310367043,-3,917,2241,20
17310412001,17310411997,-4,1108,2525,20
17315028534,17315028530,-4,1292,2372,20
17315705651,17315705648,-3,969,1931,20
17316513548,17316513544,-4,1164,2571,20
17317309510,17317309507,-3,1096,2172,20
17318413022,17318413018,-4,1313,3109,20
17321250386,17321250386,0,828,1290,20
17331074117,17331074114,-3,1035,2484,20
17331599802,17331599799,-3,1309,2332,20
17337470302,17337470297,-5,1016,3133,20
17341919901,17341919901,0,1161,1969,20
17342949504,17342949506,2,1625,2549,20
17348408924,17348408921,-3,1087,2661,20
17351772843,17351772842,-1,972,1638,20
17353054804,17353054797,-7,773,1241,20
17355532763,17355532758,-5,1193,2831,20
17356947874,17356947866,-8,1331,4749,20
17358661850,17358661847,-3,973,2214,20
17359013545,17359013543,-2,1457,2012,20
17359456978,17359456976,-2,1245,1880,20
17360657053,17360657050,-3,1209,2849,20
17362489747,17362489754,7,1168,691,20
17363253058,17363253054,-4,1342,2169,20
17365351802,17365351800,-2,130,928,20
17366165383,17366165394,11,949,2003,20
17367363243,17367363241,-2,1170,2362,20
17371368861,17371368857,-4,852,1957,20
17373012501,17373012493,-8,913,3373,20
17374486688,17374486685,-3,1075,2081,20
17375440618,17375440615,-3,1056,2284,20
17380289084,17380289082,-2,1386,1905,20
17387560090,17387560087,-3,988,1846,20
17387614207,17387614225,18,1286,2488,20
17397194177,17397194174,-3,1580,3385,20
17400886750,17400886745,-5,1102,3049,20
17404609540,17404609534,-6,1256,2156,20
17408561934,17408561932,-2,1130,2782,20
17418322004,17418322005,1,1423,1768,20
17421158915,17421158911,-4,1188,2761,20
17426446614,17426446611,-3,1637,2619,20
17438432586,17438432584,-2,972,2729,20
17440976461,17440976457,-4,591,1413,20
17441852306,17441852302,-4,1141,2575,20
17443293057,17443293052,-5,595,2023,20
17445754162,17445754157,-5,596,3904,20
17449789294,17449789292,-2,1267,2520,20
17453310199,17453310198,-1,1022,1865,20
17454073595,17454073594,-1,1126,1829,20
17455228931,17455228931,0,1496,1457,20
17457597800,17457597797,-3,1323,3120,20
17457785411,17457785393,-18,1089,3294,20
17458702163,17458702168,5,1358,1090,20
17464507059,17464507057,-2,959,1683,20
17465551175,17465551171,-4,615,2227,20
17466158632,17466158638,6,1769,896,20
17468952747,17468952745,-2,1873,2483,20
17471403729,17471403740,11,12184,47031,20
17476225679,17476225677,-2,1008,2044,20
17479950306,17479950305,-1,1337,2504,20
17482214622,17482214621,-1,1680,2340,20
17488094513,17488094502,-11,214,847,20
17488609282,17488609278,-4,1006,2762,20
17488655190,17488655204,14,156,943,20
17492672906,17492672903,-3,1318,2777,20
17494642406,17494642404,-2,1114,1763,20
17499389966,17499389962,-4,1385,2941,20
17499825903,17499825899,-4,926,2741,20
17500911707,17500911707,0,827,1136,20
17504989441,17504989440,-1,1388,2314,20
17507042315,17507042314,-1,947,1504,20
17508218026,17508218024,-2,1033,2496,20
17516051741,17516051737,-4,1048,1791,20
17517617461,17517617458,-3,899,2255,20
17517917134,17517917130,-4,1389,2019,20
17519618470,17519618470,0,1089,1933,20
17522256857,17522256842,-15,1882,556,20
17529599188,17529599183,-5,1713,5491,20
17531446209,17531446208,-1,1526,1744,20
17533023071,17533023066,-5,859,2464,20
17533759898,17533759895,-3,673,836,20
17536268619,17536268617,-2,1150,2355,20
17536680477,17536680478,1,1181,2193,20
17540560875,17540560882,7,7507,2379,20
17540593693,17540593692,-1,1418,2009,20
17546374679,17546374674,-5,878,2803,20
17547137230,17547137227,-3,968,2406,20
17550159618,17550159616,-2,1189,2478,20
17556993481,17556993478,-3,1270,2750,20
17559544484,17559544481,-3,1041,2236,20
17559736037,17559736034,-3,1713,2858,20
17560599493,17560599491,-2,632,1429,20
17560705223,17560705219,-4,1361,2294,20
17567519453,17567519450,-3,1135,2178,20
17570834505,17570834503,-2,1376,2137,20
17570950903,17570950899,-4,1223,3086,20
17573009409,17573009408,-1,1151,1437,20
17573098471,17573098483,12,235,951,20
17575695617,17575695614,-3,1164,2734,20
17576013691,17576013687,-4,771,2375,20
17580099138,17580099134,-4,836,2520,20
17585760729,17585760730,1,1334,945,20
17592897094,17592897094,0,1452,2515,20
17596767774,17596767770,-4,1163,2595,20
17596833948,17596833954,6,2774,862,20
17602489707,17602489707,0,866,1915,20
17603928157,17603928155,-2,1582,2776,20
17606809277,17606809273,-4,1452,2721,20
17608461811,17608461808,-3,1099,3223,20
17612873203,17612873197,-6,836,3896,20
17613543313,17613543310,-3,1266,2004,20
17616372184,17616372182,-2,1061,2248,20
17621033495,17621033493,-2,821,2150,20
17625969218,17625969219,1,640,1390,20
17630692982,17630692988,6,7657,2681,20
17635567465,17635567463,-2,1424,2696,20
17636401261,17636401258,-3,995,2195,20
17636603321,17636603317,-4,793,2022,20
17644251008,17644251005,-3,907,1676,20
17647082679,17647082678,-1,1733,1574,20
17648632835,17648632830,-5,887,1702,20
17653677230,17653677227,-3,1283,2656,20
17658387378,17658387376,-2,1286,2720,20
17659647327,17659647324,-3,803,3030,20
17662431530,17662431526,-4,1002,2203,20
17663868746,17663868742,-4,867,2502,20
17665709178,17665709176,-2,1006,1885,20
17666981043,17666981042,-1,1038,1733,20
17669584823,17669584841,18,565,1456,20
17671501567,17671501560,-7,1448,4133,20
17672960577,17672960576,-1,1158,1662,20
17675215286,17675215284,-2,1055,2145,20
17675911825,17675911822,-3,826,2023,20
17676607077,17676607098,21,1101,1230,20
17678917277,17678917274,-3,1310,2535,20
17678991365,17678991383,18,955,1274,20
17679038265,17679038261,-4,1435,2981,20
17685296617,17685296616,-1,985,2051,20
17686427803,17686427798,-5,910,1949,20
17688760911,17688760910,-1,1227,1888,20
17689271112,17689271115,3,6017,21520,20
17690255178,17690255176,-2,1388,1984,20
17690316915,17690316911,-4,1049,2651,20
17691001710,17691001706,-4,1143,2226,20
17693355519,17693355518,-1,1488,2273,20
17696372485,17696372482,-3,1105,2076,20
17696695413,17696695410,-3,1248,3039,20
17699148074,17699148069,-5,1286,3029,20
17699612303,17699612300,-3,1366,2226,20
17702604449,17702604445,-4,730,2080,20
17703449758,17703449755,-3,972,2730,20
17705470029,17705470026,-3,1348,2984,20
17705977158,17705977162,4,1570,1650,20
17713576035,17713576034,-1,1114,1544,20
17714277906,17714277901,-5,1547,2719,20
17715616030,17715616027,-3,1132,2900,20
17717660869,17717660865,-4,1219,2043,20
17720831327,17720831324,-3,1330,2952,20
17720876135,17720876155,20,1047,1479,20
17722049887,17722049885,-2,816,1845,20
17722971554,17722971550,-4,895,1996,20
17728897698,17728897695,-3,1209,2849,20
17729525031,17729525029,-2,1069,1564,20
17730649757,17730649760,3,1751,967,20
17730800831,17730800829,-2,443,1869,20
17733373106,17733373110,4,2420,1811,20
17733426143,17733426135,-8,5730,23635,20
17739112329,17739112325,-4,1117,2968,20
17744464855,17744464850,-5,1555,3210,20
17750060693,17750060689,-4,45996,19360,20
17752320451,17752320447,-4,994,1951,20
17755761518,17755761514,-4,1247,1840,20
17757883022,17757883020,-2,1139,2342,20
17758844315,17758844313,-2,1109,1867,20
17759134837,17759134837,0,1303,2066,20
17765860797,17765860793,-4,1099,2401,20
17768374222,17768374225,3,1341,1639,20
17768802570,17768802566,-4,1328,2915,20
17769835558,17769835555,-3,1103,2323,20
17770223672,17770223669,-3,934,2165,20
17779323352,17779323349,-3,970,2611,20
17781103102,17781103101,-1,1101,2597,20
17783514086,17783514081,-5,1026,3116,20
17785357122,17785357119,-3,1379,2160,20
17791464494,17791464493,-1,884,1461,20
17793897183,17793897188,5,1745,1561,20
17796079257,17796079251,-6,497,2775,20
17802773141,17802773137,-4,1134,2430,20
17804236799,17804236803,4,1458,1328,20
17806470879,17806470875,-4,945,2158,20
17806828814,17806828811,-3,1087,2095,20
17809602555,17809602551,-4,1067,2259,20
17810719590,17810719598,8,6869,2874,20
17813022294,17813022290,-4,1353,3464,20
17813868705,17813868702,-3,1045,2278,20
17817448426,17817448422,-4,1529,2841,20
17818115378,17818115377,-1,2533,3983,20
17820018381,17820018382,1,1368,1689,20
17823728379,17823728375,-4,1187,2933,20
17825500145,17825500143,-2,1094,2123,20
17828245025,17828245021,-4,1027,3208,20
17829761830,17829761828,-2,1345,2561,20
17835970655,17835970652,-3,1066,3463,20
17836742725,17836742723,-2,1377,2657,20
17837110263,17837110261,-2,972,1606,20
17844620107,17844620105,-2,1124,2278,20
17852285145,17852285143,-2,1163,2761,20
17857257714,17857257707,-7,1604,6431,20
17859310777,17859310774,-3,663,1230,20
17866920633,17866920633,0,1977,1665,20
17867910919,17867910916,-3,1182,2627,20
17875560175,17875560173,-2,944,2859,20
17878334939,17878334938,-1,1115,2299,20
17881997626,17881997623,-3,1166,2752,20
17883733513,17883733510,-3,1033,2332,20
17884439711,17884439692,-19,1108,1739,20
17892301554,17892301550,-4,1298,1969,20
17892859895,17892859893,-2,1124,2256,20
17895738250,17895738236,-14,1365,2544,20
17895818923,17895818917,-6,1184,2868,20
17896574453,17896574466,13,11114,47625,20
17898113082,17898113078,-4,1090,2289,20
17900019946,17900019942,-4,1011,2132,20
17905023873,17905023870,-3,1504,3092,20
17905898086,17905898083,-3,966,2575,20
17915025258,17915025254,-4,659,1040,20
17921006359,17921006356,-3,872,2604,20
17922681580,17922681579,-1,1628,2435,20
17932397528,17932397525,-3,1296,2366,20
17932434362,17932434359,-3,1274,2374,20
17934445757,17934445754,-3,779,1383,20
17936999990,17936999986,-4,1112,2616,20
17937304437,17937304437,0,1081,1793,20
17940011617,17940011614,-3,970,2188,20
17945263503,17945263503,0,966,1289,20
17946667411,17946667408,-3,1035,2043,20
17951068143,17951068137,-6,3625,10761,20
17952729044,17952729043,-1,59,702,20
17953842354,17953842350,-4,1353,2498,20
17954257871,17954257870,-1,839,1861,20
17954758071,17954758068,-3,1124,1774,20
17955977141,17955977138,-3,1088,2342,20
17961234486,17961234483,-3,1085,1944,20
17961293840,17961293858,18,656,1460,20
17961888795,17961888797,2,2188,1875,20
17967110660,17967110658,-2,1482,2511,20
17967584590,17967584610,20,906,2516,20
17968244852,17968244853,1,2814,3339,20
17969895856,17969895856,0,824,1415,20
17970032442,17970032449,7,5280,2186,20
17970168351,17970168350,-1,740,1598,20
17971190891,17971190886,-5,1035,1349,20
17976112727,17976112725,-2,1101,1396,20
17978936113,17978936110,-3,1058,2223,20
17982982066,17982982061,-5,946,2738,20
17991757038,17991757034,-4,1206,3034,20
17999648764,17999648756,-8,828,3118,20
18000116734,18000116730,-4,772,2521,20
18003385031,18003385029,-2,1180,2360,20
18005651238,18005651241,3,5744,23924,20
18020149175,18020149174,-1,703,966,20
18022148062,18022148054,-8,1520,5893,20
18022984192,18022984190,-2,1090,2882,20
18025509659,18025509658,-1,999,2009,20
18028371786,18028371782,-4,1093,1833,20
18035503099,18035503097,-2,976,2886,20
18036162031,18036162030,-1,1312,2040,20
18036517522,18036517522,0,1371,2464,20
18038449765,18038449762,-3,1568,3259,20
18045931518,18045931515,-3,1215,2019,20
18049310426,18049310422,-4,1140,2019,20
18051650613,18051650610,-3,1170,2763,20
18053648377,18053648373,-4,818,2996,20
18058174603,18058174599,-4,1068,2293,20
18059090937,18059090934,-3,767,1797,20
18061954549,18061954547,-2,1640,2452,20
18062189659,18062189657,-2,1078,2675,20
18065443185,18065443181,-4,1126,2631,20
18066496619,18066496619,0,1216,1739,20
18068779138,18068779136,-2,1378,2364,20
18070371311,18070371309,-2,580,948,20
18072945979,18072945976,-3,1496,2590,20
18073332781,18073332779,-2,1060,1898,20
18075633575,18075633570,-5,912,2452,20
18079831229,18079831231,2,1293,1107,20
18084112541,18084112538,-3,1803,3009,20
18085054919,18085054917,-2,923,2612,20
18085454299,18085454295,-4,1292,2784,20
18085862821,18085862822,1,2011,1705,20
18086385590,18086385591,1,1478,1818,20
18086555935,18086555934,-1,650,2091,20
18088011167,18088011164,-3,1487,3019,20
18088053629,18088053626,-3,1025,1484,20
18105139641,18105139643,2,1468,1324,20
18105874407,18105874404,-3,799,2191,20
18107068811,18107068807,-4,927,2361,20
18113200128,18113200129,1,1479,1235,20
18118432515,18118432530,15,1240,1632,20
18123725313,18123725312,-1,796,3017,20
18127819235,18127819232,-3,817,3270,20
18129200728,18129200721,-7,1008,4612,20
18132109586,18132109585,-1,1013,2683,20
18139297656,18139297657,1,1376,2021,20
18139439470,18139439469,-1,225,2061,20
18145256878,18145256883,5,1545,954,20
18147980153,18147980151,-2,1035,1348,20
18148728850,18148728855,5,4913,2930,20
18150424017,18150424010,-7,854,4011,20
18155751182,18155751181,-1,1042,1780,20
18157992064,18157992062,-2,1114,1995,20
18158731739,18158731735,-4,694,2035,20
18159038960,18159038977,17,1161,1717,20
18159879387,18159879386,-1,1270,2002,20
18162993785,18162993782,-3,604,1950,20
18164595723,18164595719,-4,1053,1207,20
18166422133,18166422130,-3,1014,1841,20
18166996958,18166996970,12,67,1540,20
18168653532,18168653530,-2,1367,1979,20
18170602385,18170602379,-6,845,3732,20
18171840319,18171840315,-4,1621,3279,20
18174507306,18174507302,-4,1237,2317,20
18175067985,18175067990,5,1705,982,20
18176854637,18176854635,-2,1081,2047,20
18178096329,18178096328,-1,1158,2602,20
18183884472,18183884471,-1,1033,2027,20
18185736254,18185736250,-4,947,2374,20
18186407462,18186407458,-4,1122,2800,20
18191488804,18191488807,3,1448,1381,20
18192142558,18192142555,-3,1694,2311,20
18195146458,18195146456,-2,769,1710,20
18197827102,18197827098,-4,1492,3018,20
18200175475,18200175473,-2,1275,2066,20
18206089001,18206088998,-3,1423,2568,20
18206624410,18206624408,-2,1644,2588,20
18214568576,18214568573,-3,1615,2751,20
18223314969,18223314965,-4,1320,2351,20
18223361311,18223361326,15,693,2515,20
18224767563,18224767561,-2,1010,1953,20
18228030261,18228030258,-3,842,2205,20
18231753795,18231753788,-7,969,4033,20
18232700258,18232700254,-4,746,1630,20
18233787985,18233787982,-3,961,1899,20
18234737736,18234737755,19,232,986,20
18236245085,18236245082,-3,1445,2540,20
18242511564,18242511558,-6,1132,2008,20
18247721528,18247721526,-2,1197,3117,20
18253088022,18253088020,-2,1008,1810,20
18254152350,18254152350,0,1200,1545,20
18254518411,18254518407,-4,1040,2439,20
18257681297,18257681294,-3,989,2128,20
18261791867,18261791864,-3,773,2864,20
18262101167,18262101164,-3,943,2404,20
18262624214,18262624214,0,776,1661,20
18263525198,18263525193,-5,1052,2756,20
18263587337,18263587335,-2,469,2626,20
18265851598,18265851597,-1,1238,2030,20
18286450478,18286450472,-6,1460,5210,20
18287627770,18287627769,-1,1377,1526,20
18293769284,18293769281,-3,1345,2442,20
18294708261,18294708262,1,1455,1522,20
18296389683,18296389681,-2,1154,2688,20
18300764310,18300764304,-6,2173,6269,20
18303169294,18303169289,-5,1117,2401,20
18303410906,18303410903,-3,1038,2097,20
18309411533,18309411530,-3,1044,1831,20
18311983441,18311983438,-3,937,2644,20
18314835974,18314835973,-1,970,2603,20
18315441083,18315441081,-2,1301,2715,20
18315975687,18315975683,-4,1583,2587,20
18318238367,18318238364,-3,1545,2546,20
18318692712,18318692709,-3,1026,2451,20
18322167045,18322167045,0,1005,1632,20
18322743729,18322743730,1,1293,1985,20
18323064055,18323064042,-13,1618,2731,20
18324926499,18324926497,-2,972,2287,20
18337577150,18337577148,-2,913,2267,20
18338559013,18338559034,21,134,685,20
18342642894,18342642893,-1,488,1515,20
18342727110,18342727106,-4,1579,2771,20
18347006682,18347006681,-1,1174,2611,20
18348232525,18348232522,-3,901,1284,20
18350737517,18350737514,-3,927,2075,20
18352143751,18352143750,-1,1271,1942,20
18353001294,18353001303,9,83,966,20
18354668121,18354668118,-3,2169,3072,20
18358721241,18358721241,0,1100,2033,20
18359035709,18359035688,-21,1586,3052,20
18359724030,18359724028,-2,1117,2755,20
18366170662,18366170657,-5,896,2197,20
18367107031,18367107027,-4,1135,2478,20
18368747097,18368747095,-2,1178,2224,20
18369207342,18369207338,-4,204,1045,20
18376690632,18376690629,-3,1125,2386,20
18378664870,18378664868,-2,1778,2424,20
18382593411,18382593410,-1,1270,1869,20
18383682575,18383682571,-4,997,2590,20
18384441134,18384441130,-4,1361,2992,20
18385095897,18385095894,-3,823,1890,20
18385647437,18385647417,-20,852,1695,20
18386239894,18386239888,-6,1233,4333,20
18391337485,18391337490,5,1673,833,20
18393158964,18393158981,17,443,1360,20
18394201375,18394201371,-4,1679,3253,20
18396222930,18396222930,0,2816,2909,20
18400165123,18400165129,6,2819,1264,20
18400514272,18400514278,6,3438,2070,20
18400755630,18400755628,-2,930,1795,20
18405968477,18405968485,8,11396,27540,20
18406541217,18406541214,-3,790,1854,20
18406876377,18406876374,-3,902,2120,20
18413919391,18413919388,-3,1153,2024,20
18417189537,18417189534,-3,999,2482,20
18419139388,18419139385,-3,1317,2498,20
18419487501,18419487498,-3,1075,2355,20
18420075881,18420075878,-3,683,1470,20
18421678698,18421678693,-5,845,2254,20
18422828949,18422828947,-2,937,1126,20
18434565605,18434565602,-3,1139,2141,20
18441491619,18441491618,-1,1093,2546,20
18444236008,18444236006,-2,1078,1791,20
18446844554,18446844548,-6,677,2824,20
18448189705,18448189704,-1,1147,1479,20
18450336286,18450336293,7,330,897,20
18451909933,18451909931,-2,1429,2676,20
18454353239,18454353237,-2,800,1980,20
18454509548,18454509571,23,818,2500,20
18454947962,18454947959,-3,1021,3086,20
18465339410,18465339410,0,1167,2211,20
18467115383,18467115381,-2,1254,2155,20
18468245494,18468245490,-4,893,2353,20
18469396224,18469396241,17,701,1755,20
18471133618,18471133618,0,1215,1671,20
18471666275,18471666272,-3,535,751,20
18472846367,18472846365,-2,1287,2872,20
18478944851,18478944863,12,1360,2593,20
18479826490,18479826486,-4,1141,2392,20
18483360818,18483360814,-4,1268,3206,20
18485492031,18485492028,-3,1561,3061,20
18491253674,18491253671,-3,1192,2542,20
18496460702,18496460699,-3,934,2190,20
18496952683,18496952678,-5,1012,3343,20
18498735233,18498735229,-4,1812,2333,20
18499530084,18499530103,19,721,2273,20
18500290866,18500290862,-4,853,1742,20
18500827932,18500827929,-3,932,1746,20
18501037882,18501037881,-1,1164,1690,20
18505751992,18505751990,-2,1831,1837,20
18510731298,18510731299,1,2259,2481,20
18511793986,18511793982,-4,977,2022,20
18512680034,18512680030,-4,504,1083,20
18514699931,18514699926,-5,800,2915,20
18516049243,18516049238,-5,1051,3225,20
18516490323,18516490321,-2,1319,1643,20
18518337006,18518337011,5,1916,1150,20
18522247771,18522247770,-1,992,2205,20
18524413225,18524413222,-3,984,2186,20
18527752863,18527752861,-2,1334,2491,20
18528377961,18528377959,-2,1742,2328,20
18528658121,18528658124,3,2359,1807,20
18531171708,18531171703,-5,1193,2540,20
18534011835,18534011831,-4,1445,2782,20
18537182951,18537182950,-1,769,1770,20
18537625123,18537625116,-7,1114,4598,20
18540821387,18540821387,0,1503,1705,20
18543631667,18543631665,-2,1637,2742,20
18545951294,18545951291,-3,674,1599,20
18547628736,18547628733,-3,1119,2626,20
18548319823,18548319819,-4,809,1693,20
18551528806,18551528810,4,1342,1245,20
18555623521,18555623517,-4,1191,2306,20
18557794782,18557794780,-2,1398,1561,20
18558421371,18558421369,-2,902,2099,20
18559314839,18559314835,-4,845,2648,20
18561011250,18561011247,-3,1428,2582,20
18568873126,18568873122,-4,1097,1848,20
18569293290,18569293286,-4,1255,2005,20
18575971551,18575971550,-1,1425,3475,20
18580604831,18580604829,-2,1240,2162,20
18582471181,18582471178,-3,1175,2570,20
18584948355,18584948353,-2,1153,2312,20
18594708514,18594708510,-4,1212,2797,20
18594841257,18594841254,-3,879,1837,20
18595768214,18595768212,-2,938,2393,20
18596302850,18596302849,-1,819,1678,20
18597926132,18597926154,22,960,2026,20
18608704830,18608704826,-4,918,1913,20
18608805606,18608805591,-15,1072,2452,20
18615879617,18615879613,-4,1672,2916,20
18622853719,18622853715,-4,1212,1711,20
18624448138,18624448142,4,6682,30258,20
18625731924,18625731922,-2,1824,2599,20
18626427617,18626427614,-3,1311,2244,20
18626537526,18626537525,-1,576,1300,20
18641862194,18641862190,-4,738,1763,20
18642339573,18642339590,17,1227,3067,20
18650664674,18650664670,-4,867,1621,20
18654143294,18654143289,-5,880,2615,20
18654483549,18654483556,7,4025,1344,20
18655834506,18655834503,-3,1146,2009,20
18658097610,18658097608,-2,1082,2361,20
18660779687,18660779686,-1,975,2536,20
18662133453,18662133450,-3,1094,1425,20
18664038458,18664038457,-1,825,2255,20
18669037925,18669037918,-7,1293,2692,20
18669543680,18669543677,-3,1393,2439,20
18671971711,18671971708,-3,1367,2778,20
18673653691,18673653689,-2,1130,1835,20
18674687763,18674687760,-3,1359,1594,20
18678940513,18678940509,-4,1253,2457,20
18682987054,18682987052,-2,1561,2929,20
18686413843,18686413841,-2,640,1557,20
18688931702,18688931694,-8,1530,5074,20
18690997295,18690997289,-6,1060,2427,20
18691755114,18691755110,-4,1084,1958,20
18699330285,18699330282,-3,562,1274,20
18701128210,18701128205,-5,1149,1991,20
18706805203,18706805197,-6,1056,2206,20
18707399857,18707399854,-3,931,2224,20
18713461751,18713461750,-1,3192,3542,20
18714174362,18714174358,-4,755,1648,20
18714292365,18714292355,-10,1186,2771,20
18719312158,18719312155,-3,1217,2911,20
18719509223,18719509221,-2,1261,2446,20
18725172038,18725172038,0,611,1733,20
18726727482,18726727479,-3,941,1779,20
18728086842,18728086842,0,804,1880,20
18730624801,18730624797,-4,1137,2827,20
18730765223,18730765226,3,368,1342,20
18738231334,18738231330,-4,899,2050,20
18738932828,18738932809,-19,1608,2398,20
18739411174,18739411190,16,1073,3027,20
18740628382,18740628381,-1,989,1411,20
18740661111,18740661108,-3,1151,2977,20
18743000375,18743000374,-1,1057,1992,20
18744983063,18744983060,-3,508,1930,20
18748168710,18748168706,-4,790,1397,20
18750177051,18750177049,-2,448,1403,20
18752460522,18752460520,-2,1055,2026,20
18756106986,18756106984,-2,1605,2024,20
18759979295,18759979293,-2,1429,2798,20
18760700158,18760700154,-4,837,1829,20
18766897624,18766897620,-4,1185,4848,20
18767422997,18767422994,-3,1113,2011,20
18768098048,18768098066,18,283,1018,20
18773185478,18773185482,4,4109,2660,20
18773747877,18773747873,-4,1091,1878,20
18773842414,18773842432,18,638,2049,20
18780286730,18780286729,-1,948,2311,20
18787803810,18787803806,-4,1393,2415,20
18792680487,18792680485,-2,851,1796,20
18795320847,18795320842,-5,1008,4052,20
18795551014,18795551013,-1,1480,2784,20
18808948215,18808948213,-2,1067,2471,20
18811117537,18811117534,-3,1281,1721,20
18818145186,18818145184,-2,1154,2576,20
18821792917,18821792913,-4,1440,3485,20
18822685252,18822685253,1,1269,1096,20
18827857146,18827857142,-4,732,2442,20
18828015661,18828015681,20,1470,3273,20
18828679861,18828679857,-4,767,1206,20
18837765138,18837765145,7,6332,2104,20
18838211815,18838211832,17,1531,1262,20
18840387420,18840387437,17,784,1683,20
18840433318,18840433313,-5,997,1769,20
18843191839,18843191837,-2,1027,2895,20
18845443471,18845443467,-4,1283,1832,20
18845954465,18845954463,-2,1651,2841,20
18846282968,18846282965,-3,1007,2076,20
18856523926,18856523923,-3,790,1631,20
18858376866,18858376858,-8,1018,4132,20
18861670485,18861670484,-1,864,1983,20
18862243725,18862243721,-4,1020,2170,20
18865394872,18865394867,-5,2243,6880,20
18869779391,18869779394,3,1753,1164,20
18872931931,18872931926,-5,939,3298,20
18877581463,18877581461,-2,1176,1646,20
18879070557,18879070551,-6,1106,2958,20
18881130191,18881130189,-2,667,1506,20
18885045929,18885045925,-4,1013,2362,20
18886700798,18886700797,-1,1280,2479,20
18888516355,18888516353,-2,1083,2851,20
18888897709,18888897708,-1,837,2343,20
18890075031,18890075009,-22,368,8276,20
18890923729,18890923724,-5,1171,4009,20
18891644740,18891644733,-7,33506,15370,20
18893449542,18893449540,-2,978,2434,20
18902855246,18902855250,4,1886,1425,20
18905141667,18905141664,-3,1142,2966,20
18905844481,18905844479,-2,1516,2887,20
18909314551,18909314546,-5,1206,1933,20
18909469028,18909469023,-5,1614,3594,20
18909750938,18909750947,9,20684,52329,20
18913142258,18913142254,-4,619,1481,20
18914506406,18914506403,-3,1493,2969,20
18918250684,18918250682,-2,1380,3647,20
18921472918,18921472916,-2,880,1971,20
18921671657,18921671651,-6,1083,2844,20
18922264959,18922264953,-6,635,3106,20
18922530037,18922530058,21,769,2349,20
18923147763,18923147761,-2,1069,3168,20
18926734255,18926734233,-22,842,1299,20
18927056940,18927056936,-4,1374,2660,20
18931753431,18931753430,-1,1068,1109,20
18933341190,18933341190,0,948,1837,20
18933808893,18933808892,-1,779,2669,20
18939286043,18939286045,2,2075,2192,20
18939567670,18939567669,-1,1568,2779,20
18941233994,18941233991,-3,1164,2482,20
18942333302,18942333299,-3,1028,1884,20
18942613614,18942613611,-3,1217,3185,20
18945699442,18945699438,-4,1550,2418,20
18951465164,18951465162,-2,1459,2739,20
18953481795,18953481788,-7,1024,5127,20
18960328066,18960328067,1,1376,1880,20
18960392836,18960392859,23,197,911,20
18961594865,18961594862,-3,1017,1916,20
18963798379,18963798377,-2,832,2058,20
18972135202,18972135202,0,2378,3378,20
18973997934,18973997931,-3,1262,2933,20
18976630938,18976630937,-1,1147,1238,20
18982977356,18982977352,-4,1018,2498,20
18983079912,18983079930,18,713,4385,20
18987542830,18987542829,-1,1286,2672,20
18987991087,18987991085,-2,985,2006,20
18991359691,18991359689,-2,1099,1742,20
18993909595,18993909592,-3,1303,3414,20
18993962718,18993962714,-4,996,1681,20
18994300293,18994300289,-4,957,1758,20
18996664949,18996664947,-2,1232,1351,20
18999767446,18999767444,-2,1102,2116,20
19000827523,19000827519,-4,1117,1675,20
19008503692,19008503689,-3,1289,1921,20
19010124279,19010124276,-3,1233,2715,20
19012458843,19012458838,-5,745,2090,20
19016421830,19016421827,-3,782,3169,20
19016575548,19016575542,-6,980,1992,20
19019977639,19019977645,6,2689,1261,20
19021734219,19021734218,-1,735,1663,20
19030658754,19030658751,-3,701,2153,20
19032015143,19032015142,-1,1287,2324,20
19035315473,19035315470,-3,999,2342,20
19038250037,19038250031,-6,977,2483,20
19041988798,19041988795,-3,1035,2768,20
19043126042,19043126039,-3,1516,2651,20
19045375883,19045375880,-3,844,1995,20
19046120791,19046120809,18,968,2299,20
19048099643,19048099645,2,1996,1547,20
19048601081,19048601078,-3,1309,2848,20
19052925354,19052925350,-4,1377,2495,20
19055407791,19055407802,11,82,994,20
19060400385,19060400382,-3,1015,2284,20
19061839388,19061839382,-6,1076,1897,20
19062347156,19062347175,19,845,2435,20
19064592646,19064592642,-4,1391,2375,20
19065671254,19065671254,0,694,1122,20
19074074660,19074074653,-7,1213,5303,20
19074940673,19074940670,-3,1691,2605,20
19076800639,19076800637,-2,1175,2454,20
19077228477,19077228479,2,3734,2984,20
19082492774,19082492772,-2,698,2318,20
19084592854,19084592851,-3,908,2436,20
19086608980,19086608977,-3,1567,2501,20
19090052146,19090052142,-4,949,2357,20
19091463459,19091463455,-4,936,2470,20
19091813057,19091813053,-4,900,2335,20
19093464127,19093464122,-5,705,1020,20
19099260591,19099260589,-2,789,1950,20
19106012621,19106012620,-1,1157,1569,20
19107930034,19107930034,0,647,686,20
19120890052,19120890042,-10,1316,2218,20
19124606495,19124606491,-4,1019,2312,20
19124680638,19124680634,-4,877,2820,20
19125285506,19125285511,5,9194,22199,20
19133252638,19133252637,-1,1381,2372,20
19133848338,19133848343,5,4736,2147,20
19136326726,19136326722,-4,1228,2069,20
19139260846,19139260842,-4,1011,2233,20
19141128712,19141128709,-3,1365,1682,20
19141182734,19141182730,-4,1267,2839,20
19141329263,19141329263,0,1815,2900,20
19141461885,19141461886,1,6282,8487,20
19145630555,19145630553,-2,1140,2448,20
19152300710,19152300707,-3,1044,2417,20
19154033750,19154033749,-1,1109,1947,20
19158369851,19158369857,6,4559,1047,20
19159898774,19159898769,-5,1392,3108,20
19161527089,19161527085,-4,1368,2501,20
19164368381,19164368378,-3,1218,2272,20
19172983646,19172983641,-5,1066,3668,20
19174174077,19174174073,-4,1144,2545,20
19176032506,19176032504,-2,1116,2556,20
19176342000,19176341997,-3,1083,2446,20
19176929683,19176929679,-4,886,2538,20
19177453199,19177453194,-5,1227,2485,20
19177848693,19177848691,-2,1256,1621,20
19179192079,19179192073,-6,1264,6113,20
19186904423,19186904421,-2,1241,1726,20
19187920173,19187920158,-15,1044,1788,20
19189395586,19189395584,-2,1086,2163,20
19190123533,19190123530,-3,1308,2888,20
19196262089,19196262086,-3,1054,2418,20
19199156294,19199156291,-3,2004,3231,20
19201151511,19201151510,-1,1000,2272,20
19202056975,19202056971,-4,1049,2990,20
19206557553,19206557553,0,1793,2965,20
19210092167,19210092165,-2,1694,3324,20
19210588646,19210588642,-4,1159,1964,20
19212431920,19212431938,18,516,1843,20
19212480674,19212480673,-1,1126,2129,20
19212932037,19212932058,21,446,704,20
19215068126,19215068105,-21,836,1335,20
19215662735,19215662731,-4,1069,2482,20
19219964885,19219964885,0,1025,1506,20
19220159166,19220159182,16,794,2025,20
19226390567,19226390562,-5,1295,2126,20
19226873727,19226873725,-2,805,2243,20
19229089628,19229089625,-3,583,2109,20
19230322436,19230322454,18,909,1526,20
19233947975,19233947974,-1,601,2179,20
19234555102,19234555098,-4,1210,2874,20
19235061715,19235061714,-1,1696,2777,20
19239761402,19239761402,0,1270,2104,20
19243689738,19243689735,-3,1220,2372,20
19245797488,19245797484,-4,1450,2169,20
19245829652,19245829646,-6,1584,6256,20
19248091709,19248091714,5,3665,1445,20
19252631390,19252631386,-4,588,1970,20
19258670090,19258670087,-3,983,2697,20
19267238961,19267238958,-3,1297,3073,20
19268942856,19268942854,-2,1538,1256,20
19273133606,19273133605,-1,934,1846,20
19275203863,19275203859,-4,853,2074,20
19275510917,19275510909,-8,23912,15795,20
19275793523,19275793521,-2,1183,2843,20
19276615205,19276615186,-19,169,984,20
19278476116,19278476112,-4,957,2223,20
19279155320,19279155317,-3,1495,2495,20
19279200751,19279200747,-4,961,1876,20
19280155401,19280155399,-2,1457,2554,20
19282020354,19282020351,-3,1004,2039,20
19283782557,19283782554,-3,1327,2863,20
19287162673,19287162674,1,1145,1202,20
19287234079,19287234076,-3,1058,3036,20
19287296663,19287296659,-4,1158,2737,20
19291148391,19291148386,-5,1239,2433,20
19295738262,19295738267,5,2083,1107,20
19297140514,19297140513,-1,2956,5785,20
19298141488,19298141482,-6,1335,2248,20
19298394661,19298394659,-2,264,965,20
19299167199,19299167198,-1,571,930,20
19299509038,19299509033,-5,994,1647,20
19301584748,19301584748,0,41503,20789,20
19303062743,19303062742,-1,1306,1860,20
19303366943,19303366959,16,592,1365,20
19309337234,19309337227,-7,1615,10265,20
19311524694,19311524690,-4,1088,1313,20
19316599533,19316599530,-3,1241,2012,20
19319871402,19319871402,0,1065,2291,20
19320498099,19320498096,-3,742,1715,20
19321119469,19321119465,-4,1118,2710,20
19324835815,19324835815,0,1583,1945,20
19325125510,19325125507,-3,1278,2118,20
19325785074,19325785070,-4,1112,2218,20
19325923451,19325923448,-3,1228,2587,20
19327031913,19327031910,-3,765,2110,20
19329804342,19329804339,-3,1502,3123,20
19331509602,19331509597,-5,1284,2442,20
19336625630,19336625637,7,2203,1208,20
19337464330,19337464327,-3,946,2465,20
19340575242,19340575239,-3,1274,2197,20
19342772449,19342772445,-4,1247,3069,20
19343400113,19343400110,-3,1213,3152,20
19344225950,19344225948,-2,1387,2467,20
19345963142,19345963137,-5,947,1990,20
19350545029,19350545030,1,2520,2638,20
19351958647,19351958647,0,832,1191,20
19368224535,19368224536,1,1768,2372,20
19368544462,19368544461,-1,1416,2518,20
19368761952,19368761950,-2,1039,2791,20
19369296107,19369296107,0,1310,2467,20
19372081596,19372081593,-3,1458,2497,20
19372284662,19372284682,20,1493,2490,20
19374343639,19374343642,3,1677,1737,20
19374947351,19374947348,-3,1332,2216,20
19376053139,19376053136,-3,908,1652,20
19378035210,19378035208,-2,1345,1686,20
19378441725,19378441731,6,2289,1109,20
19384220545,19384220547,2,1569,858,20
19384540331,19384540326,-5,1209,2296,20
19385383786,19385383785,-1,866,1294,20
19389350867,19389350867,0,1961,2646,20
19389998517,19389998521,4,2433,2522,20
19394109973,19394109970,-3,1229,2059,20
19395288152,19395288150,-2,1496,2046,20
19399303615,19399303605,-10,38894,17198,20
19401681428,19401681422,-6,1463,3788,20
19406374933,19406374931,-2,2386,4506,20
19412594882,19412594877,-5,1226,2775,20
19413082979,19413082977,-2,1529,1770,20
19414295927,19414295924,-3,1367,2440,20
19415969046,19415969045,-1,868,2004,20
19416971454,19416971458,4,221,643,20
19417048793,19417048789,-4,1568,3275,20
19428031718,19428031714,-4,1767,3558,20
19430958804,19430958798,-6,1035,2337,20
19431016815,19431016835,20,1138,3262,20
19434811530,19434811525,-5,1145,2645,20
19437776774,19437776772,-2,985,2634,20
19450164774,19450164773,-1,980,1918,20
19451926702,19451926698,-4,1204,2330,20
19453917644,19453917640,-4,876,2380,20
19462951942,19462951941,-1,1090,1953,20
19464253954,19464253950,-4,1431,3333,20
19470829170,19470829169,-1,1209,2151,20
19475291746,19475291742,-4,1066,2814,20
19475690323,19475690318,-5,1035,1554,20
19478987406,19478987402,-4,555,1292,20
19483365898,19483365894,-4,1534,2203,20
19488569953,19488569948,-5,905,2629,20
19489839983,19489839981,-2,1125,2079,20
19491933651,19491933649,-2,1041,2246,20
19493062019,19493062018,-1,922,2045,20
19493614820,19493614818,-2,1243,1662,20
19495563130,19495563128,-2,883,2593,20
19498187963,19498187958,-5,961,2349,20
19500308119,19500308116,-3,881,1794,20
19504789382,19504789379,-3,1324,2503,20
19505680340,19505680337,-3,1335,2398,20
19507912867,19507912862,-5,1704,3023,20
19521356737,19521356724,-13,1689,502,20
19521884681,19521884682,1,1579,2059,20
19524988099,19524988096,-3,871,1673,20
19527695980,19527695977,-3,1509,2870,20
19529838910,19529838905,-5,938,2909,20
19531410421,19531410418,-3,1061,1956,20
19533325736,19533325741,5,7258,31841,20
19541556769,19541556766,-3,1352,2620,20
19547242403,19547242400,-3,1092,2394,20
19552297354,19552297353,-1,960,1452,20
19553245943,19553245942,-1,1150,2155,20
19558932230,19558932226,-4,1642,2580,20
19562453880,19562453878,-2,1705,3421,20
19563388878,19563388873,-5,1262,2346,20
19563575094,19563575114,20,1181,2879,20
19563659807,19563659822,15,110,930,20
19566038683,19566038679,-4,952,2171,20
19566727319,19566727317,-2,1020,3220,20
19567000256,19567000253,-3,1336,2888,20
19569486030,19569486026,-4,1110,2090,20
19572331207,19572331205,-2,967,1963,20
19573241564,19573241560,-4,1522,2915,20
19576834043,19576834042,-1,1431,2489,20
19579966213,19579966209,-4,880,2494,20
19580053550,19580053568,18,295,910,20
19582115432,19582115437,5,2155,1023,20
19583320386,19583320385,-1,553,2088,20
19585219144,19585219139,-5,95,1386,20
19587502087,19587502084,-3,941,2056,20
19589503067,19589503064,-3,1143,2433,20
19592462010,19592462007,-3,953,1484,20
19601608842,19601608838,-4,942,1679,20
19602173132,19602173137,5,2600,1997,20
19604637894,19604637894,0,1220,1468,20
19608479579,19608479578,-1,1289,2285,20
19608515022,19608515005,-17,1556,2408,20
19608845511,19608845510,-1,989,1954,20
19612917010,19612917006,-4,976,1880,20
19616553623,19616553624,1,1289,2085,20
19616674719,19616674716,-3,1466,2453,20
19622406268,19622406265,-3,1040,2532,20
19623492062,19623492059,-3,681,1290,20
19625205486,19625205481,-5,776,1835,20
19626422465,19626422462,-3,1399,2421,20
19631327661,19631327658,-3,892,1473,20
19633015329,19633015325,-4,1286,2845,20
19633361637,19633361631,-6,831,2702,20
19633855018,19633855014,-4,3958,9511,20
19639146750,19639146746,-4,834,2106,20
19640122300,19640122297,-3,1408,2677,20
19644036464,19644036462,-2,1091,1866,20
19644931826,19644931822,-4,1045,2166,20
19647337634,19647337631,-3,1267,2390,20
19652116469,19652116466,-3,1138,1957,20
19652464125,19652464125,0,3602,3322,20
19657177057,19657177053,-4,1262,2641,20
19661652323,19661652319,-4,1334,2248,20
19662473017,19662473014,-3,1557,3149,20
19671607951,19671607949,-2,1027,2000,20
19671783027,19671783027,0,1335,2042,20
19671963047,19671963047,0,191,800,20
19674280602,19674280599,-3,1501,3076,20
19674934246,19674934246,0,1062,1741,20
19682051211,19682051207,-4,1463,4085,20
19685008162,19685008162,0,904,1472,20
19687711910,19687711906,-4,1425,2852,20
19688020319,19688020318,-1,1042,2703,20
19689661246,19689661242,-4,856,1642,20
19691492896,19691492893,-3,1044,1197,20
19694601966,19694601962,-4,1230,2212,20
19696508770,19696508769,-1,999,2012,20
19696682194,19696682198,4,2048,1490,20
19700319453,19700319453,0,626,1672,20
19700743841,19700743841,0,496,1342,20
19710653629,19710653627,-2,1072,1879,20
19711588787,19711588794,7,3224,1366,20
19716859532,19716859527,-5,1012,2792,20
19726102685,19726102682,-3,1646,2251,20
19729684537,19729684543,6,2671,1410,20
19730733175,19730733171,-4,1185,2551,20
19735187077,19735187075,-2,1238,2678,20
19736936451,19736936447,-4,1172,2032,20
19739216909,19739216906,-3,1096,2738,20
19739837944,19739837941,-3,1008,2361,20
19740801705,19740801702,-3,1152,1180,20
19746490063,19746490062,-1,891,2037,20
19747246515,19747246511,-4,1064,2021,20
19752907699,19752907695,-4,1225,2124,20
19754761643,19754761642,-1,1488,2810,20
19757817023,19757817022,-1,1017,1234,20
19759099615,19759099611,-4,1310,2284,20
19762505480,19762505477,-3,1283,2829,20
19762574902,19762574898,-4,1090,1796,20
19763735951,19763735949,-2,825,3055,20
19764530387,19764530385,-2,1164,3816,20
19769649218,19769649225,7,2706,1282,20
19777206149,19777206148,-1,953,1651,20
19777343950,19777343945,-5,1133,3198,20
19778617281,19778617277,-4,1532,1882,20
19779269499,19779269495,-4,1699,2859,20
19779307282,19779307278,-4,1356,1947,20
19780990049,19780990046,-3,751,1903,20
19782502519,19782502514,-5,806,1604,20
19784567534,19784567531,-3,1443,3200,20
19787728125,19787728130,5,5067,2798,20
19791857038,19791857058,20,811,2223,20
19794085366,19794085367,1,1373,1600,20
19796615182,19796615179,-3,1251,2363,20
19803415271,19803415267,-4,1320,2679,20
19805305922,19805305915,-7,1072,2880,20
19807223263,19807223262,-1,1275,2333,20
19809066222,19809066218,-4,998,1784,20
19810326170,19810326165,-5,1375,2415,20
19813722718,19813722714,-4,1031,2192,20
19824739422,19824739417,-5,1852,3948,20
19825920187,19825920185,-2,1435,2400,20
19827637324,19827637323,-1,1195,2014,20
19827952894,19827952890,-4,920,2339,20
19829316683,19829316679,-4,683,2412,20
19836476633,19836476629,-4,1289,2732,20
19836899766,19836899764,-2,1427,2292,20
19837213139,19837213137,-2,1448,3822,20
19841110366,19841110362,-4,985,2324,20
19841260773,19841260765,-8,810,1160,20
19842812023,19842812020,-3,727,2090,20
19843772178,19843772186,8,5696,1800,20
19844007578,19844007574,-4,968,2562,20
19844095781,19844095778,-3,1117,2015,20
19853030427,19853030421,-6,712,1569,20
19854503801,19854503803,2,2335,2144,20
19856600745,19856600738,-7,837,1145,20
19859407786,19859407782,-4,883,2048,20
19859506323,19859506321,-2,702,2380,20
19862624034,19862624032,-2,1489,2049,20
19862921374,19862921372,-2,1310,2170,20
19873192336,19873192334,-2,952,1834,20
19874920923,19874920921,-2,1648,2295,20
19878811014,19878811009,-5,943,1895,20
19880672030,19880672028,-2,1343,2091,20
19882839193,19882839190,-3,1068,1883,20
19889584906,19889584899,-7,1013,3142,20
19891385915,19891385913,-2,1037,3036,20
19891489085,19891489076,-9,1111,2033,20
19893121229,19893121225,-4,721,2075,20
19894444287,19894444286,-1,2207,3876,20
19895081509,19895081507,-2,1428,2223,20
19897835699,19897835696,-3,1026,2037,20
19898519019,19898518999,-20,1371,1341,20
19905632458,19905632455,-3,959,2054,20
19906284286,19906284282,-4,1296,2879,20
19909535790,19909535787,-3,1029,2037,20
19909835530,19909835528,-2,1660,3534,20
19913080449,19913080447,-2,1516,1932,20
19922628177,19922628173,-4,892,2459,20
19924240339,19924240358,19,519,2124,20
19924873807,19924873802,-5,1018,2793,20
19926883921,19926883919,-2,1306,2751,20
19927522605,19927522601,-4,1564,1859,20
19933419418,19933419414,-4,1080,2785,20
19934360107,19934360105,-2,909,1004,20
19936125610,19936125607,-3,1513,2877,20
19939303450,19939303447,-3,1511,1969,20
19939529904,19939529902,-2,1381,2032,20
19944866378,19944866374,-4,1430,2214,20
19947977715,19947977713,-2,1018,2605,20
19948017538,19948017534,-4,1301,2787,20
19948437176,19948437190,14,653,1799,20
19950140462,19950140458,-4,1268,3181,20
19964725891,19964725889,-2,1987,2237,20
19966340580,19966340578,-2,718,1705,20
19968924684,19968924682,-2,1461,1965,20
19974378510,19974378506,-4,1208,2643,20
19974625588,19974625599,11,235,945,20
19975686003,19975686000,-3,689,2014,20
19977321837,19977321834,-3,1286,2680,20
19980583351,19980583349,-2,1070,1889,20
19982471002,19982470998,-4,1464,2357,20
19982829368,19982829365,-3,1179,2132,20
19983146065,19983146062,-3,1196,2533,20
19989361025,19989361022,-3,1479,1595,20
19989994952,19989994949,-3,1089,2926,20
19991078205,19991078199,-6,730,1523,20
19993904887,19993904886,-1,931,1560,20
19999841886,19999841883,-3,1108,2351,20
20001974944,20001974940,-4,1237,2482,20
20002274138,20002274135,-3,1232,3225,20
20006176393,20006176398,5,2647,1658,20
20008700333,20008700331,-2,1169,2933,20
20018924035,20018924031,-4,1006,2443,20
20019249451,20019249449,-2,902,2004,20
20020516902,20020516897,-5,1491,3398,20
20022791611,20022791617,6,2393,1359,20
20023096563,20023096561,-2,1066,2528,20
20023641080,20023641077,-3,1150,1494,20
20025418831,20025418829,-2,1488,2856,20
20030911389,20030911389,0,1257,2100,20
20031333447,20031333443,-4,1495,2885,20
20031450537,20031450536,-1,947,1840,20
20032763090,20032763087,-3,1285,2420,20
20033881339,20033881335,-4,638,1802,20
20034264793,20034264793,0,8359,21242,20
20035626498,20035626494,-4,1591,3494,20
20036105953,20036105952,-1,1270,2718,20
20039841069,20039841065,-4,1606,2538,20
20043133570,20043133567,-3,1128,2432,20
20046149135,20046149131,-4,744,1642,20
20054076933,20054076933,0,2093,2179,20
20056498470,20056498468,-2,1376,3496,20
20057771520,20057771515,-5,1432,1787,20
20062426454,20062426451,-3,512,1224,20
20067826162,20067826159,-3,1407,2430,20
20073387191,20073387189,-2,911,1487,20
20078422399,20078422396,-3,1337,3027,20
20083078439,20083078435,-4,1453,3020,20
20084910530,20084910526,-4,1222,1575,20
20087265131,20087265138,7,2591,1122,20
20088053677,20088053674,-3,887,1742,20
20091779590,20091779587,-3,792,1891,20
20092389103,20092389100,-3,1200,2533,20
20097846904,20097846902,-2,772,1119,20
20103118241,20103118246,5,4991,1545,20
20108735352,20108735349,-3,1384,2243,20
20113252773,20113252773,0,1039,2052,20
20113640484,20113640479,-5,1114,2515,20
20115071622,20115071621,-1,1491,1902,20
20115855383,20115855380,-3,832,2168,20
20116501015,20116501014,-1,1041,1424,20
20122232486,20122232483,-3,1836,4303,20
20123032950,20123032946,-4,1096,2349,20
20125190478,20125190475,-3,1226,2730,20
20125510482,20125510478,-4,933,2208,20
20129841354,20129841350,-4,732,2878,20
20130443414,20130443411,-3,1107,3303,20
20132665546,20132665553,7,2270,976,20
20139850393,20139850390,-3,1272,3064,20
20141281703,20141281702,-1,959,2356,20
20142225842,20142225836,-6,949,1851,20
20142538792,20142538790,-2,1284,1851,20
20150056451,20150056449,-2,1465,3073,20
20151736090,20151736086,-4,1086,1834,20
20153171138,20153171134,-4,1333,2908,20
20153708183,20153708182,-1,821,2006,20
20156623417,20156623415,-2,1215,2683,20
20161571194,20161571190,-4,1209,2321,20
20162850109,20162850106,-3,1557,1935,20
20163039781,20163039778,-3,1361,2749,20
20163449793,20163449791,-2,1194,2122,20
20164571557,20164571556,-1,1833,2825,20
20165192878,20165192875,-3,941,1844,20
20169848617,20169848613,-4,1363,4060,20
20175875443,20175875441,-2,1048,2115,20
20180717052,20180717048,-4,1259,2492,20
20181189061,20181189081,20,738,2965,20
20182086578,20182086575,-3,1588,3651,20
20182675597,20182675594,-3,1216,1824,20
20182969003,20182968999,-4,1122,1858,20
20190114017,20190114010,-7,1582,6881,20
20190612234,20190612233,-1,1015,2576,20
20193371703,20193371701,-2,714,2233,20
20194400366,20194400385,19,504,1234,20
20194678721,20194678726,5,1192,863,20
20206335163,20206335164,1,1461,1802,20
20207985353,20207985350,-3,1351,2161,20
20209230998,20209230995,-3,1158,2517,20
20211298982,20211298978,-4,1033,2563,20
20213093123,20213093122,-1,1033,1680,20
20215572877,20215572875,-2,1137,2454,20
20216328820,20216328815,-5,1264,1948,20
20223446806,20223446801,-5,2889,5892,20
20224776589,20224776585,-4,1007,1917,20
20234110042,20234110038,-4,1035,2316,20
20234629997,20234629985,-12,1260,1909,20
20234876695,20234876691,-4,727,1373,20
20235964658,20235964657,-1,1301,2042,20
20237318267,20237318263,-4,839,1200,20
20239264444,20239264441,-3,1234,2497,20
20239783282,20239783279,-3,1098,2589,20
20245193374,20245193373,-1,1167,2502,20
20246716974,20246716970,-4,1112,2661,20
20247271016,20247271033,17,1234,2393,20
20250259099,20250259097,-2,1015,2187,20
20257185647,20257185643,-4,1294,2271,20
20258607981,20258607981,0,1478,2402,20
20259186475,20259186474,-1,1483,2780,20
20259855985,20259855984,-1,1360,1636,20
20262544135,20262544134,-1,1080,1984,20
20263490711,20263490709,-2,1073,2216,20
20266845163,20266845159,-4,713,1593,20
20269370703,20269370701,-2,1233,2769,20
20270750242,20270750240,-2,1211,1894,20
20271665273,20271665275,2,771,919,20
20272266302,20272266299,-3,955,2351,20
20272455494,20272455506,12,312,1099,20
20273908219,20273908225,6,2053,1155,20
20275495141,20275495139,-2,938,2291,20
20278003208,20278003205,-3,1359,1955,20
20293990663,20293990660,-3,1302,2953,20
20294654631,20294654629,-2,1654,2678,20
20297555612,20297555605,-7,1090,2551,20
20299608506,20299608504,-2,1609,2770,20
20302891963,20302891956,-7,850,2854,20
20303934314,20303934310,-4,1471,3724,20
20308950347,20308950343,-4,1289,1769,20
20310843071,20310843069,-2,1386,2569,20
20313757823,20313757822,-1,1135,2411,20
20314482321,20314482326,5,3958,1771,20
20318257791,20318257787,-4,765,1527,20
20325493960,20325493947,-13,78,378,20
20329950998,20329950995,-3,997,2388,20
20330952080,20330952080,0,1547,1616,20
20340933439,20340933434,-5,1284,3923,20
20343916216,20343916213,-3,2021,3022,20
20344763034,20344763030,-4,887,2983,20
20346059263,20346059259,-4,1161,2211,20
20347864891,20347864888,-3,1061,1727,20
20351285971,20351285969,-2,1427,2106,20
20351627670,20351627665,-5,1138,2437,20
20354064691,20354064689,-2,1135,2413,20
20356804667,20356804665,-2,944,1719,20
20357118847,20357118827,-20,1063,1563,20
20361571438,20361571434,-4,1059,3211,20
20367672261,20367672260,-1,1539,2258,20
20368290202,20368290194,-8,1913,8629,20
20370182882,20370182878,-4,1323,2150,20
20370633816,20370633813,-3,1191,2629,20
20372341122,20372341118,-4,989,2173,20
20375360343,20375360340,-3,997,1993,20
20378463798,20378463797,-1,1087,1519,20
20385538809,20385538803,-6,1001,2840,20
20387041580,20387041577,-3,1243,2213,20
20388264269,20388264265,-4,1228,2854,20
20395929226,20395929222,-4,1227,2160,20
20397261402,20397261397,-5,1215,3226,20
20399066070,20399066067,-3,1402,2807,20
20400939886,20400939882,-4,1203,2965,20
20403842161,20403842163,2,2130,1536,20
20404359825,20404359822,-3,1205,1717,20
20416709670,20416709668,-2,931,1708,20
20418416542,20418416539,-3,1099,2357,20
20424932894,20424932892,-2,1010,1550,20
20427018323,20427018319,-4,1243,2666,20
20431217047,20431217042,-5,1168,2711,20
20431709504,20431709502,-2,1096,1690,20
20433522318,20433522314,-4,1112,2288,20
20434050389,20434050386,-3,1467,3591,20
20437004698,20437004696,-2,832,1901,20
20438694275,20438694273,-2,1022,2097,20
20439549318,20439549333,15,197,914,20
20441017867,20441017865,-2,1575,2868,20
20442661059,20442661057,-2,1031,2594,20
20442825450,20442825447,-3,1120,2500,20
20452892799,20452892794,-5,1493,3283,20
20454334133,20454334133,0,1031,1857,20
20454635741,20454635731,-10,1188,3904,20
20456204909,20456204902,-7,1268,4220,20
20459345957,20459345954,-3,1045,3290,20
20463587030,20463587028,-2,979,1718,20
20463983631,20463983611,-20,218,719,20
20466229457,20466229454,-3,770,1796,20
20474153130,20474153129,-1,1529,2824,20
20477195243,20477195239,-4,630,1338,20
20479875659,20479875654,-5,1361,3060,20
20479980820,20479980821,1,827,2187,20
20483247451,20483247448,-3,1166,2346,20
20485835521,20485835518,-3,1408,2674,20
20489118890,20489118889,-1,465,1276,20
20489177948,20489177966,18,1396,3365,20
20496586786,20496586782,-4,1025,1873,20
20497789741,20497789742,1,3547,3065,20
20504768583,20504768581,-2,1562,2655,20
20510151630,20510151627,-3,1406,3126,20
20510469316,20510469338,22,727,1884,20
20519321747,20519321746,-1,1256,1867,20
20519947907,20519947902,-5,864,2013,20
20520159671,20520159669,-2,960,2486,20
20525246421,20525246426,5,1523,947,20
20527153965,20527153962,-3,103,733,20
20531345449,20531345445,-4,1295,3175,20
20532614441,20532614440,-1,1011,2455,20
20535921933,20535921930,-3,1283,2970,20
20536371095,20536371090,-5,1196,6023,20
20537407791,20537407788,-3,1306,2535,20
20543942885,20543942881,-4,1410,2193,20
20546617948,20546617945,-3,1524,2587,20
20547106506,20547106509,3,840,607,20
20547933189,20547933184,-5,1055,2956,20
20549189822,20549189820,-2,960,2308,20
20553359308,20553359328,20,1060,1991,20
20555181855,20555181851,-4,832,2114,20
20556783926,20556783938,12,633,1640,20
20556976255,20556976250,-5,1003,2397,20
20560441504,20560441502,-2,1175,3125,20
20563596548,20563596547,-1,1039,2230,20
20572442603,20572442600,-3,936,2707,20
20572768375,20572768373,-2,1071,2589,20
20574244502,20574244504,2,1130,1544,20
20577302570,20577302566,-4,1181,2433,20
20577498265,20577498261,-4,970,2131,20
20582208764,20582208763,-1,859,1489,20
20589370655,20589370651,-4,917,1597,20
20596756234,20596756241,7,2828,1354,20
20597155399,20597155397,-2,1107,2780,20
20602959375,20602959370,-5,1229,3586,20
20603612091,20603612086,-5,1126,2379,20
20603923152,20603923166,14,978,2837,20
20605048773,20605048770,-3,764,1813,20
20605370007,20605370004,-3,1099,2073,20
20606737197,20606737198,1,1115,1815,20
20607154071,20607154067,-4,1029,2396,20
20613168611,20613168609,-2,1110,2007,20
20616346629,20616346625,-4,925,1115,20
20616542987,20616542982,-5,855,1634,20
20619179697,20619179695,-2,831,2363,20
20619946807,20619946826,19,1091,1940,20
20631108942,20631108939,-3,954,1861,20
20635886557,20635886557,0,1502,2487,20
20638516276,20638516271,-5,953,2015,20
20651173790,20651173789,-1,1160,2665,20
20652249210,20652249207,-3,947,1904,20
20656719555,20656719552,-3,964,2277,20
20657471955,20657471952,-3,1189,2217,20
20660263980,20660263980,0,1770,2051,20
20660577185,20660577181,-4,1173,1695,20
20662421997,20662421993,-4,1255,2004,20
20663633519,20663633517,-2,1088,2160,20
20668315629,20668315629,0,908,1202,20
20670974539,20670974537,-2,1338,1938,20
20671988988,20671988986,-2,1082,2001,20
20678828627,20678828633,6,6686,2737,20
20679566930,20679566935,5,2328,1176,20
20697555143,20697555139,-4,1185,3437,20
20697733761,20697733758,-3,616,2161,20
20699822442,20699822442,0,825,1515,20
20700406023,20700406021,-2,936,2551,20
20701008254,20701008270,16,1067,2089,20
20701492915,20701492913,-2,1056,2029,20
20706577462,20706577462,0,673,1977,20
20709537427,20709537422,-5,1249,3800,20
20710354024,20710354023,-1,1764,2390,20
20710848970,20710848969,-1,1595,2052,20
20712465184,20712465180,-4,1509,2889,20
20719147641,20719147642,1,1429,1558,20
20719366637,20719366627,-10,1047,1899,20
20719850138,20719850133,-5,1207,2969,20
20722168045,20722168042,-3,1340,3306,20
20727583378,20727583374,-4,1143,2437,20
20729762010,20729762006,-4,1566,1353,20
20731694118,20731694112,-6,945,1726,20
20735378230,20735378226,-4,1382,2590,20
20736464736,20736464734,-2,1872,2813,20
20739875213,20739875206,-7,827,3077,20
20749801778,20749801776,-2,885,2236,20
20749903568,20749903567,-1,1155,2316,20
20750172101,20750172121,20,809,1394,20
20750503308,20750503305,-3,1366,2807,20
20751077976,20751077974,-2,1270,2145,20
20753434398,20753434398,0,1374,1920,20
20754483699,20754483695,-4,1456,2420,20
20754717418,20754717414,-4,1097,2681,20
20760575954,20760575951,-3,1206,2512,20
20760693860,20760693859,-1,1115,2309,20
20762480442,20762480438,-4,1282,2288,20
20763176638,20763176637,-1,1579,3237,20
20764303058,20764303057,-1,1488,1456,20
20765356006,20765356001,-5,1091,2109,20
20766930258,20766930255,-3,780,2640,20
20767181698,20767181696,-2,879,2034,20
20768068171,20768068168,-3,1136,1909,20
20769305677,20769305674,-3,1096,2522,20
20769375444,20769375425,-19,1025,1900,20
20770752571,20770752568,-3,726,1328,20
20771204910,20771204905,-5,3604,10063,20
20776042243,20776042241,-2,1232,2070,20
20776455448,20776455465,17,1256,2509,20
20779027635,20779027632,-3,1250,2966,20
20781663334,20781663329,-5,1259,4013,20
20784888762,20784888758,-4,1550,3131,20
20786535111,20786535109,-2,1120,2042,20
20786865640,20786865631,-9,178,1046,20
20786984239,20786984243,4,1891,30729,20
20787242162,20787242158,-4,902,4000,20
20787480157,20787480152,-5,1171,2749,20
20789819606,20789819606,0,861,2007,20
20795969952,20795969960,8,2851,1056,20
20796233113,20796233110,-3,1261,1777,20
20797455264,20797455266,2,1750,1751,20
20800736619,20800736611,-8,1202,4446,20
20809021679,20809021676,-3,992,2322,20
20818120627,20818120623,-4,979,1759,20
20820135638,20820135635,-3,668,1613,20
20824362399,20824362394,-5,1358,2228,20
20829075875,20829075872,-3,783,1836,20
20831130347,20831130346,-1,1140,2004,20
20831674797,20831674791,-6,1298,3621,20
20837875102,20837875099,-3,854,1828,20
20838514738,20838514736,-2,974,1669,20
20841193599,20841193596,-3,1392,2064,20
20845988598,20845988595,-3,1219,3082,20
20850181518,20850181514,-4,1219,2523,20
20850890409,20850890406,-3,1254,2326,20
20857014562,20857014564,2,3266,3606,20
20859632084,20859632081,-3,1082,2316,20
20863409671,20863409669,-2,1389,3607,20
20864410674,20864410673,-1,1376,1495,20
20865064221,20865064218,-3,1145,2714,20
20865660375,20865660374,-1,1204,2566,20
20866220748,20866220746,-2,1226,2722,20
20869542743,20869542749,6,9778,24343,20
20876494509,20876494505,-4,1180,3011,20
20880355545,20880355543,-2,1136,2833,20
20882941712,20882941710,-2,1293,3383,20
20889209715,20889209712,-3,959,2156,20
20894809171,20894809167,-4,1505,2231,20
20894902591,20894902587,-4,801,1211,20
20901527339,20901527341,2,2252,1898,20
20902553766,20902553763,-3,1031,1836,20
20908341412,20908341409,-3,1251,2766,20
20908772004,20908772001,-3,1105,2313,20
20909626044,20909626064,20,722,2343,20
20911136970,20911136965,-5,1369,2758,20
20913716461,20913716461,0,929,1934,20
20916413480,20916413476,-4,961,1749,20
20918945441,20918945438,-3,1218,2373,20
20926908986,20926908981,-5,1502,3845,20
20928263036,20928263033,-3,973,2182,20
20933442547,20933442545,-2,1257,3074,20
20935337125,20935337130,5,2430,1027,20
20935968734,20935968739,5,5301,3403,20
20944042882,20944042881,-1,885,2395,20
20946928449,20946928446,-3,1412,2227,20
20951805203,20951805202,-1,1008,2803,20
20953504934,20953504930,-4,588,1981,20
20955199773,20955199769,-4,1054,2182,20
20956278726,20956278725,-1,1108,2158,20
20957315433,20957315433,0,1086,1926,20
20958659011,20958659007,-4,1384,3519,20
20959656194,20959656190,-4,1485,2282,20
20959976286,20959976282,-4,48816,2749,20
20961296727,20961296725,-2,1244,2596,20
20966862359,20966862353,-6,647,1793,20
20967084812,20967084800,-12,96,1335,20
20968559507,20968559504,-3,800,1996,20
20969679231,20969679227,-4,691,1947,20
20970592475,20970592473,-2,1390,1695,20
20973001083,20973001081,-2,1628,3144,20
20977127147,20977127145,-2,1510,2564,20
20984825531,20984825526,-5,1160,2763,20
20991279889,20991279888,-1,1417,2108,20
20996040302,20996040299,-3,310,853,20
20996721641,20996721637,-4,923,2395,20
20997499581,20997499581,0,3646,3282,20
20998492556,20998492555,-1,1043,1737,20
20999550529,20999550526,-3,1178,2346,20
21002545049,21002545046,-3,1281,2932,20
21005922138,21005922136,-2,613,2421,20
21008077773,21008077769,-4,1095,2579,20
21015141042,21015141040,-2,892,2350,20
21016574343,21016574361,18,467,1455,20
21018689902,21018689901,-1,1139,3175,20
21020546609,21020546606,-3,1018,2215,20
21021454022,21021454015,-7,1390,5362,20
21022361389,21022361411,22,333,1060,20
21024945597,21024945596,-1,1535,3640,20
21025768773,21025768770,-3,1429,2606,20
21028604570,21028604566,-4,1127,2649,20
21029856202,21029856201,-1,918,1480,20
21030198126,21030198145,19,274,4764,20
21036341302,21036341300,-2,1053,1931,20
21040944590,21040944590,0,1166,1775,20
21041412026,21041412029,3,1761,1649,20
21042668735,21042668733,-2,676,1688,20
21043762218,21043762218,0,2157,3166,20
21047918235,21047918234,-1,1368,2521,20
21049131059,21049131055,-4,1102,2421,20
21049416101,21049416098,-3,935,1398,20
21056270250,21056270246,-4,863,2489,20
21058202470,21058202467,-3,1367,2221,20
21061993742,21061993739,-3,1595,3685,20
21063145845,21063145843,-2,1014,1913,20
21066021822,21066021839,17,1442,2332,20
21072000410,21072000407,-3,1211,1912,20
21072602111,21072602109,-2,955,1804,20
21073948869,21073948851,-18,40,1717,20
21076125958,21076125956,-2,678,1330,20
21081931914,21081931913,-1,1177,2553,20
21084280050,21084280049,-1,1108,2253,20
21086305176,21086305173,-3,880,2488,20
21092011413,21092011416,3,1419,1443,20
21103736294,21103736290,-4,1427,3203,20
21104187797,21104187793,-4,1213,3645,20
21105242737,21105242734,-3,900,1090,20
21108918322,21108918318,-4,1307,2809,20
21114719982,21114719978,-4,806,1595,20
21123382250,21123382247,-3,1281,2789,20
21124294763,21124294761,-2,1005,2353,20
21126244020,21126244017,-3,1565,3180,20
21127968444,21127968440,-4,1212,2527,20
21130246610,21130246605,-5,1348,4619,20
21130568181,21130568201,20,414,804,20
21133587951,21133587950,-1,996,1719,20
21136524969,21136524967,-2,1154,2358,20
21142114971,21142114968,-3,1446,3394,20
21145712082,21145712077,-5,727,1919,20
21148765751,21148765757,6,2740,1504,20
21149604890,21149604887,-3,1625,2826,20
21156418646,21156418644,-2,961,1849,20
21156884726,21156884746,20,516,1611,20
21164400188,21164400186,-2,1063,2807,20
21168628516,21168628514,-2,1353,3185,20
21168658975,21168658970,-5,1157,5442,20
21169015323,21169015319,-4,1012,2672,20
21171231948,21171231959,11,14709,33255,20
21172205145,21172205142,-3,1319,2823,20
21176853165,21176853163,-2,1333,1711,20
21178430262,21178430259,-3,1139,2832,20
21184701630,21184701626,-4,1288,2393,20
21185689975,21185689970,-5,1056,1961,20
21186246618,21186246615,-3,789,1878,20
21190323523,21190323521,-2,1084,2206,20
21191457636,21191457633,-3,803,1853,20
21193972449,21193972446,-3,1237,2581,20
21201922711,21201922710,-1,584,1033,20
21203288042,21203288039,-3,1656,2770,20
21205546564,21205546559,-5,1398,2889,20
21206048047,21206048025,-22,639,2037,20
21206712271,21206712265,-6,1338,2783,20
21209157495,21209157494,-1,986,1241,20
21214297910,21214297907,-3,639,2120,20
21215120169,21215120164,-5,927,2960,20
21216861192,21216861185,-7,1553,5438,20
21218259038,21218259034,-4,1592,2266,20
21219805507,21219805501,-6,1119,3625,20
21221352167,21221352163,-4,825,2389,20
21221441231,21221441247,16,135,2927,20
21226524410,21226524407,-3,1297,2831,20
21228123214,21228123212,-2,1002,1745,20
21233037132,21233037129,-3,2291,4900,20
21233611929,21233611927,-2,1233,2668,20
21234159805,21234159799,-6,1481,2862,20
21237502259,21237502257,-2,1304,3427,20
21246636870,21246636868,-2,1427,2563,20
21248268291,21248268286,-5,949,2520,20
21248366567,21248366545,-22,376,1215,20
21248703071,21248703069,-2,1054,1651,20
21250441989,21250441986,-3,1239,2022,20
21251819247,21251819245,-2,1131,2510,20
21255539595,21255539594,-1,1525,2746,20
21256104249,21256104253,4,25928,18896,20
21257401490,21257401486,-4,1244,2562,20
21257910970,21257910965,-5,769,1812,20
21259771135,21259771131,-4,1201,2728,20
21260539083,21260539078,-5,1134,3091,20
21260572063,21260572059,-4,1028,1470,20
21266334261,21266334257,-4,1538,3464,20
21274819323,21274819310,-13,1167,2077,20
21286459767,21286459762,-5,751,2040,20
21288648470,21288648467,-3,1281,2378,20
21289565736,21289565733,-3,1583,2207,20
21289696999,21289696994,-5,1270,3307,20
21293142463,21293142460,-3,1435,3448,20
21294159141,21294159135,-6,1355,3432,20
21296357104,21296357101,-3,863,2429,20
21300160668,21300160666,-2,1156,2307,20
21303213715,21303213710,-5,1256,2889,20
21303342620,21303342622,2,2756,2483,20
21304946159,21304946146,-13,50175,13301,20
21306279030,21306279026,-4,1556,2980,20
21316027608,21316027606,-2,814,2020,20
21318068148,21318068146,-2,804,1931,20
21319731236,21319731239,3,1284,1122,20
21322733540,21322733549,9,14620,27389,20
21325191797,21325191795,-2,991,2841,20
21327742782,21327742778,-4,561,1956,20
21330539758,21330539754,-4,685,1762,20
21332048938,21332048934,-4,1373,2483,20
21333565133,21333565130,-3,1617,2958,20
21344888358,21344888354,-4,945,1902,20
21353212950,21353212949,-1,1077,2419,20
21353445613,21353445610,-3,1083,2977,20
21355078505,21355078502,-3,1476,2841,20
21358244234,21358244233,-1,1224,2066,20
21359516950,21359516947,-3,1241,2514,20
21362273822,21362273821,-1,1169,2113,20
21368230315,21368230319,4,2060,1479,20
21372094257,21372094255,-2,886,3112,20
21373049102,21373049101,-1,1189,1285,20
21376382450,21376382447,-3,1189,2564,20
21379344999,21379344995,-4,823,2942,20
21382509543,21382509540,-3,1609,3042,20
21385875182,21385875180,-2,1048,2111,20
21386926167,21386926183,16,886,2471,20
21387386672,21387386687,15,565,2732,20
21387570132,21387570129,-3,1109,2022,20
21389693911,21389693906,-5,755,2262,20
21391503950,21391503946,-4,509,971,20
21395502479,21395502477,-2,1285,2228,20
21396292553,21396292549,-4,1309,2151,20
21398158134,21398158127,-7,1533,7921,20
21401718202,21401718198,-4,1005,1652,20
21404971092,21404971088,-4,1111,1852,20
21408583898,21408583895,-3,1373,2518,20
21408883469,21408883461,-8,1212,4836,20
21412686439,21412686438,-1,8567,10403,20
21415324584,21415324582,-2,996,2544,20
21415821339,21415821351,12,1735,1345,20
21418145647,21418145643,-4,1497,2884,20
21422724958,21422724956,-2,1135,1938,20
21422859471,21422859469,-2,950,2013,20
21422926101,21422926103,2,2679,1916,20
21430158767,21430158762,-5,900,1776,20
21436102934,21436102940,6,3329,1338,20
21438925047,21438925046,-1,1568,3212,20
21443261834,21443261830,-4,866,2339,20
21443748490,21443748486,-4,1252,2917,20
21446229426,21446229423,-3,450,1949,20
21446381269,21446381290,21,913,1532,20
21448377262,21448377258,-4,1335,2688,20
21448756858,21448756855,-3,1810,5342,20
21454839285,21454839282,-3,1089,2902,20
21458664736,21458664733,-3,1394,3325,20
21458696389,21458696369,-20,1016,3442,20
21458894710,21458894709,-1,1005,2049,20
21460169120,21460169117,-3,1260,3232,20
21460573042,21460573034,-8,1348,9143,20
21463925517,21463925523,6,1565,1239,20
21468257466,21468257467,1,1482,1477,20
21469402866,21469402863,-3,1071,2328,20
21481212319,21481212318,-1,945,2022,20
21490917410,21490917418,8,10146,2163,20
21492748775,21492748774,-1,599,1638,20
21493228750,21493228769,19,364,1085,20
21496304631,21496304630,-1,1194,1813,20
21499965062,21499965050,-12,46035,13655,20
21500356059,21500356053,-6,1026,2262,20
21503315406,21503315404,-2,624,2072,20
21504828311,21504828307,-4,2867,5432,20
21504945910,21504945895,-15,1934,12976,20
21505367042,21505367037,-5,1200,3525,20
21506903741,21506903739,-2,1002,2031,20
21507676157,21507676158,1,1406,1411,20
21509658794,21509658789,-5,1421,2947,20
21510811336,21510811333,-3,842,1911,20
21511189742,21511189739,-3,1314,2660,20
21512318526,21512318523,-3,990,2158,20
21515464248,21515464245,-3,929,1725,20
21517360890,21517360888,-2,1322,2871,20
21519935155,21519935154,-1,1260,2040,20
21521305582,21521305581,-1,1437,3240,20
21522767334,21522767342,8,16439,56372,20
21527501258,21527501254,-4,1427,2667,20
21529887665,21529887669,4,3792,2904,20
21535926427,21535926424,-3,1309,2824,20
21543169369,21543169370,1,1093,1652,20
21544579163,21544579161,-2,1638,2568,20
21544878563,21544878558,-5,1021,1784,20
21547615629,21547615626,-3,871,2071,20
21553054662,21553054661,-1,1441,1912,20
21554594318,21554594309,-9,631,1523,20
21556256362,21556256366,4,4310,3050,20
21558772680,21558772678,-2,1274,2778,20
21560336514,21560336510,-4,1639,2080,20
21562267557,21562267555,-2,771,1480,20
21564875258,21564875254,-4,1445,3009,20
21570193203,21570193205,2,694,1674,20
21571439286,21571439282,-4,887,2177,20
21574866290,21574866287,-3,1646,2971,20
21587467077,21587467073,-4,946,2547,20
21588707858,21588707858,0,1016,1433,20
21590978328,21590978326,-2,1176,2102,20
21591773806,21591773824,18,980,1933,20
21594977413,21594977410,-3,1179,2375,20
21595398342,21595398338,-4,1178,2069,20
21598753471,21598753471,0,1230,1414,20
21605959238,21605959235,-3,841,2130,20
21610516679,21610516676,-3,926,3387,20
21610718876,21610718890,14,151,815,20
21616313248,21616313250,2,1691,1770,20
21619711463,21619711462,-1,1302,2412,20
21620376823,21620376822,-1,1297,1341,20
21621266751,21621266745,-6,940,5097,20
21626726630,21626726627,-3,1581,3415,20
21627353690,21627353689,-1,1030,1984,20
21629037390,21629037389,-1,844,2830,20
21631577630,21631577630,0,363,333,20
21634629619,21634629614,-5,1010,2446,20
21635907203,21635907198,-5,1134,2060,20
21636129075,21636129074,-1,790,2171,20
21636602767,21636602763,-4,1479,2761,20
21641935122,21641935119,-3,1003,1667,20
21642853880,21642853876,-4,941,2194,20
21642939374,21642939372,-2,1487,2847,20
21643994131,21643994129,-2,1185,3685,20
21645325355,21645325353,-2,1110,2340,20
21646078951,21646078957,6,2672,1667,20
21646376378,21646376374,-4,1015,2006,20
21650698796,21650698797,1,7584,9764,20
21650820051,21650820048,-3,1037,1673,20
21651866973,21651866971,-2,964,2402,20
21652079121,21652079118,-3,1414,2648,20
21652980603,21652980602,-1,1253,2371,20
21653363528,21653363529,1,1579,2436,20
21654128413,21654128408,-5,921,2719,20
21657941311,21657941310,-1,926,2780,20
21658488653,21658488650,-3,1449,2284,20
21659480531,21659480530,-1,1729,2442,20
21660866635,21660866633,-2,787,3361,20
21663055142,21663055150,8,3035,1066,20
21663381791,21663381787,-4,858,2077,20
21669874582,21669874581,-1,1414,2759,20
21670088815,21670088813,-2,1101,2561,20
21670493646,21670493641,-5,1282,2239,20
21673205127,21673205125,-2,827,2377,20
21673906572,21673906585,13,100,1090,20
21680037480,21680037478,-2,1156,2847,20
21683120034,21683120032,-2,1179,2059,20
21685077544,21685077543,-1,1326,2613,20
21686795768,21686795762,-6,770,2022,20
21688756669,21688756668,-1,1108,2760,20
21691777349,21691777346,-3,1344,2224,20
21692894266,21692894266,0,802,1682,20
21693253326,21693253323,-3,1239,2981,20
21696460686,21696460685,-1,619,1602,20
21699451359,21699451356,-3,930,2334,20
21699789150,21699789148,-2,1014,2135,20
21701142987,21701142982,-5,998,1730,20
21702510363,21702510358,-5,1257,2144,20
21705624245,21705624229,-16,422,995,20
21711178078,21711178073,-5,968,2081,20
21711812082,21711812081,-1,31075,19472,20
21713957931,21713957928,-3,1105,2227,20
21715210756,21715210770,14,17662,43783,20
21721102063,21721102062,-1,1093,1989,20
21722246658,21722246654,-4,920,1294,20
21723138779,21723138776,-3,1144,1898,20
21723898006,21723898004,-2,993,1858,20
21732020945,21732020944,-1,1064,2580,20
21735849719,21735849715,-4,1133,2270,20
21740206338,21740206335,-3,1664,2874,20
21740491539,21740491536,-3,1111,2617,20
21747668489,21747668487,-2,1427,2872,20
21748907942,21748907938,-4,1528,2397,20
21749182355,21749182351,-4,1132,2425,20
21749459984,21749459983,-1,1140,2800,20
21750570599,21750570597,-2,1528,2989,20
21754582666,21754582664,-2,1262,2292,20
21759923779,21759923775,-4,1117,2737,20
21765325201,21765325197,-4,1035,2681,20
21765552619,21765552615,-4,766,2035,20
21769673707,21769673703,-4,1160,3807,20
21770943554,21770943551,-3,880,1920,20
21773632062,21773632059,-3,971,1608,20
21776659746,21776659753,7,4678,1689,20
21778641031,21778641026,-5,1044,1763,20
21778680943,21778680960,17,718,2514,20
21787546693,21787546690,-3,1346,2451,20
21788601586,21788601585,-1,1784,2308,20
21792493071,21792493068,-3,1068,2273,20
21797487461,21797487458,-3,1369,2203,20
21799550026,21799550026,0,1847,1952,20
21802836551,21802836549,-2,2025,3047,20
21806317325,21806317322,-3,974,2813,20
21806474035,21806474032,-3,938,2693,20
21807694519,21807694518,-1,1161,2126,20
21807725935,21807725951,16,1461,2914,20
21808165755,21808165749,-6,1046,2627,20
21811338918,21811338914,-4,815,2396,20
21813655778,21813655773,-5,1109,2582,20
21814519823,21814519821,-2,999,1810,20
21815750746,21815750745,-1,1300,2584,20
21818651969,21818651972,3,2116,1563,20
21821336983,21821336983,0,989,2698,20
21821910046,21821910056,10,22053,58114,20
21822393190,21822393195,5,2632,1282,20
21836900395,21836900410,15,26733,13019,20
21837519651,21837519646,-5,1025,2095,20
21839164480,21839164477,-3,1295,2324,20
21840124177,21840124174,-3,792,1910,20
21843681082,21843681078,-4,843,1492,20
21852236926,21852236922,-4,1090,1832,20
21852451759,21852451753,-6,842,2010,20
21856857542,21856857542,0,1196,1698,20
21857531397,21857531394,-3,1134,2385,20
21858574114,21858574110,-4,587,1157,20
21859244477,21859244475,-2,1329,2636,20
21869590163,21869590142,-21,1216,2231,20
21875355895,21875355892,-3,938,2204,20
21875418273,21875418277,4,2366,2077,20
21878286510,21878286506,-4,844,1991,20
21884742244,21884742238,-6,694,2125,20
21885773638,21885773635,-3,1034,2391,20
21887758181,21887758182,1,1022,1918,20
21888016876,21888016895,19,515,917,20
21893029926,21893029922,-4,1246,3007,20
21894724082,21894724081,-1,1558,1964,20
21896072211,21896072209,-2,1255,1931,20
21905517918,21905517920,2,1174,1547,20
21905839709,21905839706,-3,1152,2124,20
21906215705,21906215702,-3,1252,1802,20
21913623731,21913623730,-1,1107,2178,20
21914840004,21914839998,-6,991,1994,20
21915683014,21915683017,3,2509,1961,20
21916721201,21916721198,-3,1475,1780,20
21918315583,21918315579,-4,1277,3149,20
21919696327,21919696325,-2,1103,1443,20
21920644118,21920644125,7,3424,1877,20
21922418947,21922418928,-19,700,474,20
21922646686,21922646682,-4,1574,3352,20
21931004553,21931004551,-2,927,2090,20
21934880086,21934880084,-2,1147,2166,20
21936094773,21936094770,-3,1328,3290,20
21941158671,21941158669,-2,911,1599,20
21941597426,21941597425,-1,1625,2874,20
21948261058,21948261055,-3,782,2655,20
21950283714,21950283712,-2,1535,2709,20
21950724654,21950724653,-1,1087,2854,20
21952086756,21952086753,-3,1039,2318,20
21957839466,21957839464,-2,1009,2261,20
21960037215,21960037211,-4,1692,2040,20
21961735703,21961735701,-2,870,1808,20
21965475131,21965475127,-4,686,2672,20
21966534415,21966534419,4,2122,1262,20
21968003974,21968003981,7,3101,1460,20
21972053897,21972053917,20,827,1954,20
21972759687,21972759684,-3,928,1427,20
21974997330,21974997327,-3,1144,2578,20
21977788215,21977788212,-3,967,2968,20
21982724541,21982724537,-4,1742,3219,20
21984784011,21984784009,-2,1106,2263,20
21985157615,21985157610,-5,1194,2894,20
21986812981,21986812982,1,3001,3420,20
21992338144,21992338137,-7,1243,8840,20
21993590825,21993590819,-6,1060,2522,20
21994148702,21994148699,-3,968,2424,20
21994260226,21994260229,3,1624,1517,20
22000528742,22000528738,-4,1026,1992,20
22001453382,22001453379,-3,863,1552,20
22002354942,22002354957,15,986,2273,20
22003705810,22003705807,-3,1540,3429,20
22004002107,22004002107,0,1303,1709,20
22005014663,22005014662,-1,1638,2885,20
22005565905,22005565901,-4,1183,2433,20
22008518757,22008518762,5,5951,2935,20
22010879656,22010879654,-2,1030,2791,20
22016466986,22016466986,0,1026,2003,20
22017868909,22017868904,-5,1475,1850,20
22020939146,22020939143,-3,976,2561,20
22022458322,22022458318,-4,766,1649,20
22023222933,22023222939,6,4241,1217,20
22026214661,22026214683,22,483,1168,20
22028421933,22028421931,-2,1035,1523,20
22028745346,22028745342,-4,1090,2144,20
22029174213,22029174218,5,3054,1718,20
22033569304,22033569301,-3,1089,1666,20
22034686262,22034686281,19,876,2316,20
22034813781,22034813781,0,2079,2365,20
22037428812,22037428809,-3,1460,2275,20
22049789998,22049789996,-2,1350,2414,20
22054412821,22054412822,1,1097,1519,20
22067141854,22067141850,-4,1339,1864,20
22071325866,22071325865,-1,1102,3144,20
22071630015,22071630014,-1,1123,1887,20
22078147341,22078147338,-3,1560,1641,20
22080010020,22080010015,-5,1250,2586,20
22084560721,22084560719,-2,1063,1642,20
22085411218,22085411221,3,2697,1976,20
22087627692,22087627706,14,12821,52221,20
22091714102,22091714101,-1,1399,1687,20
22092238780,22092238785,5,2411,1250,20
22093928271,22093928268,-3,1466,2614,20
22099321429,22099321421,-8,2015,6851,20
22114637163,22114637161,-2,751,2025,20
22118923354,22118923352,-2,1182,1816,20
22121557077,22121557071,-6,1419,3411,20
22122746931,22122746930,-1,1211,1934,20
22123012157,22123012154,-3,1389,2300,20
22133314822,22133314818,-4,1159,1641,20
22134324517,22134324516,-1,1532,1940,20
22136540684,22136540681,-3,1452,2706,20
22138675890,22138675887,-3,1329,2254,20
22139305222,22139305221,-1,1329,2239,20
22139598071,22139598070,-1,1279,2650,20
22144866927,22144866925,-2,790,2194,20
22146816421,22146816411,-10,769,2413,20
22148731281,22148731278,-3,893,2270,20
22149911097,22149911098,1,1036,1718,20
22150503944,22150503942,-2,1575,2238,20
22150800744,22150800739,-5,1027,2025,20
22151282435,22151282432,-3,1259,2350,20
22152221310,22152221289,-21,903,2142,20
22152861614,22152861615,1,1375,1243,20
22153959725,22153959726,1,756,1701,20
22154230771,22154230769,-2,1138,2104,20
22154335130,22154335125,-5,1020,1137,20
22154941817,22154941814,-3,937,2268,20
22158012414,22158012411,-3,1344,2944,20
22158816955,22158816953,-2,1187,2352,20
22167753504,22167753501,-3,1414,2156,20
22168701049,22168701049,0,1369,2024,20
22170004346,22170004343,-3,1122,2159,20
22175314227,22175314209,-18,1016,307,20
22176528115,22176528112,-3,957,1754,20
22178798431,22178798438,7,10633,8589,20
22181282006,22181282002,-4,1257,1574,20
22182085261,22182085257,-4,274,1035,20
22183868898,22183868896,-2,977,1189,20
22186108734,22186108734,0,1277,1561,20
22194214810,22194214808,-2,1211,2606,20
22196628053,22196628050,-3,976,2497,20
22198988082,22198988079,-3,1167,2395,20
22202071095,22202071095,0,1124,1405,20
22203013719,22203013718,-1,665,1592,20
22204865491,22204865490,-1,1078,1946,20
22205079507,22205079505,-2,995,1985,20
22205230062,22205230057,-5,1143,2208,20
22205408517,22205408513,-4,1303,3662,20
22206658240,22206658236,-4,467,2801,20
22210901333,22210901327,-6,1027,2644,20
22211803735,22211803732,-3,1498,2714,20
22213447965,22213447962,-3,1044,2548,20
22214455808,22214455806,-2,1082,1727,20
22215902350,22215902345,-5,1337,2772,20
22217505431,22217505431,0,827,1551,20
22221714314,22221714312,-2,1189,2278,20
22223003178,22223003175,-3,909,1449,20
22224148573,22224148569,-4,1078,2259,20
22224777786,22224777787,1,994,2657,20
22227832049,22227832053,4,2336,2236,20
22228488506,22228488504,-2,922,1986,20
22229592142,22229592137,-5,1191,3249,20
22231789352,22231789349,-3,1167,2228,20
22232311951,22232311930,-21,841,1889,20
22233662627,22233662625,-2,1045,2684,20
22241651052,22241651049,-3,1046,2598,20
22243381558,22243381557,-1,1201,942,20
22245223194,22245223191,-3,1149,1807,20
22245979997,22245979995,-2,1293,2473,20
22248235170,22248235167,-3,1371,2129,20
22248266207,22248266202,-5,623,1778,20
22248365493,22248365477,-16,154,1107,20
22255448581,22255448578,-3,1973,5069,20
22257852560,22257852567,7,3078,1379,20
22258364742,22258364741,-1,1027,1738,20
22260173610,22260173612,2,1097,1125,20
22273451808,22273451802,-6,1133,2348,20
22273899513,22273899510,-3,1132,2944,20
22277500226,22277500222,-4,1036,2455,20
22280250943,22280250941,-2,1034,2484,20
22281041218,22281041215,-3,1107,1337,20
22283162585,22283162591,6,5622,1622,20
22286191155,22286191153,-2,2062,3518,20
22287101171,22287101173,2,1058,1318,20
22287780057,22287780055,-2,770,1281,20
22289050009,22289050007,-2,1074,3257,20
22301144394,22301144389,-5,922,2102,20
22306226361,22306226358,-3,1336,1808,20
22306490630,22306490627,-3,1113,2122,20
22306612307,22306612290,-17,1472,662,20
22307507013,22307507010,-3,1218,2018,20
22310701643,22310701641,-2,1046,1684,20
22316848953,22316848950,-3,1085,2631,20
22317535703,22317535700,-3,1332,2966,20
22319761514,22319761513,-1,1843,2718,20
22326144014,22326144011,-3,1516,3063,20
22332346961,22332346956,-5,1437,3465,20
22338756719,22338756716,-3,1167,2629,20
22340983702,22340983701,-1,1321,2263,20
22341577868,22341577863,-5,887,2669,20
22345749101,22345749098,-3,1683,3438,20
22352465706,22352465702,-4,1323,1960,20
22354171582,22354171578,-4,1165,2267,20
22355079803,22355079801,-2,1102,2334,20
22356515518,22356515518,0,1636,1755,20
22364296497,22364296496,-1,1131,2420,20
22365382013,22365382013,0,1324,1631,20
22367051583,22367051580,-3,638,2084,20
22368409320,22368409317,-3,944,1360,20
22369927234,22369927231,-3,1492,3802,20
22373434212,22373434209,-3,1104,3051,20
22379152463,22379152460,-3,1380,2569,20
22381218939,22381218938,-1,1239,2379,20
22385741390,22385741389,-1,894,2716,20
22391854672,22391854675,3,3519,3424,20
22396381861,22396381858,-3,1093,2372,20
22397852538,22397852534,-4,1096,2282,20
22400916581,22400916577,-4,1941,2544,20
22404283903,22404283900,-3,1067,2383,20
22411376414,22411376414,0,2622,3266,20
22412680288,22412680283,-5,1088,2815,20
22413144941,22413144938,-3,975,1879,20
22418532988,22418532982,-6,1143,2529,20
22424908592,22424908589,-3,1132,2943,20
22427548457,22427548464,7,2047,1347,20
22428129982,22428129980,-2,919,2290,20
22432758161,22432758158,-3,801,1817,20
22434634429,22434634425,-4,876,1577,20
22436058413,22436058410,-3,1896,2137,20
22436242075,22436242072,-3,842,2643,20
22438688663,22438688661,-2,1585,3619,20
22441759968,22441759967,-1,1123,1429,20
22446328577,22446328573,-4,1341,2456,20
22446374383,22446374382,-1,1085,2057,20
22446441509,22446441502,-7,241,1131,20
22451020984,22451020986,2,2041,2305,20
22453885409,22453885406,-3,1233,2808,20
22456098542,22456098541,-1,1337,2188,20
22461405318,22461405314,-4,1222,2697,20
22467551737,22467551734,-3,1099,1759,20
22470659707,22470659705,-2,1217,2461,20
22471770302,22471770298,-4,887,1974,20
22474780195,22474780191,-4,1359,3260,20
22475733401,22475733397,-4,1061,2575,20
22479481099,22479481098,-1,1342,1717,20
22481375151,22481375148,-3,884,2256,20
22482982546,22482982542,-4,1444,2886,20
22485940071,22485940068,-3,1204,2574,20
22488306123,22488306121,-2,1139,2290,20
22488568413,22488568408,-5,8,605,20
22489440387,22489440384,-3,979,1923,20
22492198311,22492198308,-3,776,2603,20
22493039003,22493039001,-2,1198,2600,20
22493987389,22493987386,-3,979,2986,20
22496808260,22496808256,-4,1325,3550,20
22499073980,22499073974,-6,1394,3103,20
22508866005,22508866002,-3,1850,2652,20
22509796951,22509796946,-5,766,1439,20
22511874401,22511874397,-4,1088,2106,20
22516311185,22516311182,-3,21978,12595,20
22521145248,22521145246,-2,1264,2461,20
22521415460,22521415473,13,259,647,20
22523715283,22523715279,-4,1343,3254,20
22524466310,22524466331,21,275,789,20
22525166415,22525166411,-4,709,1763,20
22526231095,22526231091,-4,1265,3220,20
22526560470,22526560470,0,2823,4229,20
22528794021,22528794020,-1,720,1364,20
22529758673,22529758669,-4,729,1679,20
22530733525,22530733512,-13,786,2065,20
22532128817,22532128813,-4,1026,2245,20
22537557646,22537557651,5,1382,454,20
22550972741,22550972737,-4,1209,2883,20
22551071850,22551071848,-2,1232,2059,20
22553646211,22553646207,-4,931,2322,20
22558217608,22558217603,-5,1464,2778,20
22558509106,22558509102,-4,919,2681,20
22565325521,22565325519,-2,1397,2689,20
22568865005,22568865005,0,1343,1799,20
22569552353,22569552350,-3,1040,1907,20
22572434867,22572434865,-2,1044,2739,20
22573574914,22573574911,-3,956,2774,20
22576541248,22576541246,-2,904,2342,20
22578999817,22578999817,0,1456,2557,20
22581828784,22581828807,23,672,2451,20
22583286074,22583286067,-7,885,5096,20
22583966205,22583966192,-13,187,896,20
22593355283,22593355281,-2,1232,2427,20
22595526289,22595526289,0,2957,3663,20
22595763982,22595763980,-2,1146,2265,20
22595952119,22595952134,15,798,2501,20
22597629827,22597629826,-1,1225,2566,20
22602679763,22602679761,-2,1638,2724,20
22605362800,22605362798,-2,907,2278,20
22608450252,22608450249,-3,1424,2433,20
22611464413,22611464410,-3,1186,2880,20
22612676739,22612676737,-2,882,2294,20
22618394066,22618394065,-1,1170,2333,20
22619140850,22619140847,-3,919,2599,20
22620744967,22620744962,-5,1270,2916,20
22621703983,22621703980,-3,983,2521,20
22624439282,22624439285,3,1402,1374,20
22624656699,22624656695,-4,946,2927,20
22629440003,22629439998,-5,657,2616,20
22632978734,22632978731,-3,1072,2094,20
22637216287,22637216286,-1,1991,2153,20
22637389129,22637389126,-3,1395,2716,20
22640390181,22640390176,-5,1375,2885,20
22640830029,22640830050,21,217,679,20
22641266511,22641266490,-21,746,1963,20
22641446869,22641446861,-8,853,1500,20
22641601405,22641601400,-5,1307,2252,20
22643632423,22643632416,-7,1137,2919,20
22643880014,22643880007,-7,1069,3880,20
22644686376,22644686374,-2,1142,1867,20
22647526959,22647526961,2,1443,1107,20
22651589576,22651589575,-1,1235,2743,20
22651731752,22651731745,-7,946,3176,20
22653791202,22653791198,-4,898,2035,20
22656942431,22656942429,-2,634,1487,20
22657130517,22657130502,-15,1118,2239,20
22659840918,22659840917,-1,1481,1786,20
22660103417,22660103412,-5,1228,2170,20
22661703759,22661703755,-4,149,2046,20
22661938597,22661938619,22,780,2313,20
22663063638,22663063638,0,904,1361,20
22664832518,22664832514,-4,976,2003,20
22665910479,22665910484,5,3790,2120,20
22666430967,22666430965,-2,1129,2291,20
22669335496,22669335492,-4,852,3823,20
22669782574,22669782573,-1,1680,2625,20
22676251597,22676251594,-3,1132,2030,20
22676986709,22676986705,-4,1187,2671,20
22681159836,22681159834,-2,994,2178,20
22682263854,22682263852,-2,1179,2646,20
22688610418,22688610415,-3,1165,1768,20
22703456450,22703456446,-4,1065,1343,20
22704739774,22704739772,-2,1486,2507,20
22707319128,22707319126,-2,598,1130,20
22708636151,22708636149,-2,1045,3093,20
22708718543,22708718546,3,226,1159,20
22710329009,22710329006,-3,1112,3008,20
22719681918,22719681917,-1,1175,2305,20
22720783126,22720783125,-1,1056,2182,20
22723863607,22723863612,5,2607,1406,20
22728367690,22728367686,-4,1433,4103,20
22731787920,22731787917,-3,1077,2120,20
22735739975,22735739970,-5,1071,2391,20
22735970391,22735970398,7,1557,845,20
22738179814,22738179810,-4,1201,2674,20
22739849319,22739849313,-6,1120,2982,20
22742854962,22742854960,-2,959,2076,20
22751006815,22751006812,-3,1114,1787,20
22756893371,22756893367,-4,1128,2454,20
22759136475,22759136470,-5,930,2895,20
22765336637,22765336634,-3,1061,2608,20
22767136771,22767136766,-5,996,3574,20
22767824215,22767824215,0,591,617,20
22768693793,22768693790,-3,1027,2392,20
22776151949,22776151945,-4,1505,3115,20
22776204054,22776204073,19,1388,2222,20
22776431419,22776431415,-4,695,2727,20
22776596583,22776596580,-3,1095,2927,20
22780568383,22780568379,-4,1428,2485,20
22782118516,22782118520,4,2477,1891,20
22783280904,22783280900,-4,753,2394,20
22783857692,22783857692,0,20250,12118,20
22786982219,22786982214,-5,988,2695,20
22787076997,22787076995,-2,1354,1935,20
22788863182,22788863180,-2,1186,2332,20
22791152099,22791152094,-5,1087,2058,20
22794520451,22794520447,-4,1189,2696,20
22796156034,22796156029,-5,1772,4100,20
22797907185,22797907180,-5,1374,2545,20
22798170293,22798170295,2,185,798,20
22799098162,22799098163,1,855,1408,20
22801655235,22801655235,0,1048,1503,20
22805074599,22805074595,-4,803,1742,20
22805719516,22805719513,-3,1135,2374,20
22807802418,22807802415,-3,995,2736,20
22824325759,22824325758,-1,1302,3108,20
22827449588,22827449586,-2,764,1160,20
22831274751,22831274748,-3,850,1635,20
22834060942,22834060941,-1,1330,2854,20
22843282340,22843282338,-2,1138,1579,20
22847541830,22847541825,-5,1101,2562,20
22848401034,22848401031,-3,1127,1733,20
22850809015,22850809012,-3,1314,3488,20
22859558494,22859558499,5,4735,2108,20
22864093642,22864093640,-2,1178,3016,20
22865731554,22865731549,-5,1308,3015,20
22866289891,22866289887,-4,1099,3823,20
22872073038,22872073038,0,1033,2023,20
22876404600,22876404597,-3,835,2367,20
22877555748,22877555746,-2,1152,2288,20
22879169215,22879169211,-4,1320,2899,20
22879580769,22879580767,-2,1321,1785,20
22879815962,22879815958,-4,931,2482,20
22880959103,22880959123,20,771,2289,20
22881623524,22881623522,-2,1487,3048,20
22884417533,22884417533,0,1351,2139,20
22885721105,22885721102,-3,891,2118,20
22887924172,22887924169,-3,1274,2601,20
22890301891,22890301889,-2,1171,2436,20
22892084945,22892084942,-3,1573,3697,20
22895475150,22895475146,-4,1221,1570,20
22898394364,22898394364,0,1823,2480,20
22899280834,22899280839,5,33002,126131,20
22904472034,22904472027,-7,693,1705,20
22905361029,22905361031,2,3083,2539,20
22905650087,22905650081,-6,993,4585,20
22908707771,22908707767,-4,1317,1852,20
22908884421,22908884417,-4,615,2165,20
22910363966,22910363965,-1,872,2391,20
22914618026,22914618027,1,1845,1671,20
22918220222,22918220216,-6,956,1990,20
22918905588,22918905611,23,1320,4231,20
22927390136,22927390129,-7,1688,5895,20
22929021513,22929021510,-3,875,1135,20
22931098426,22931098422,-4,1449,3416,20
22931656986,22931656985,-1,1290,1364,20
22936598419,22936598414,-5,988,3351,20
22937514067,22937514064,-3,1303,2299,20
22939050458,22939050456,-2,457,524,20
22943943155,22943943151,-4,894,2770,20
22944242924,22944242919,-5,1374,2220,20
22946673206,22946673211,5,13861,8388,20
22947659506,22947659506,0,939,1349,20
22950462045,22950462042,-3,609,1458,20
22954057903,22954057902,-1,999,2665,20
22954107797,22954107778,-19,1060,2562,20
22958066263,22958066259,-4,1165,2694,20
22962751622,22962751618,-4,1012,2925,20
22963476218,22963476215,-3,1282,2392,20
22966417320,22966417323,3,1804,1408,20
22967086575,22967086573,-2,1357,2397,20
22978977927,22978977925,-2,1571,2486,20
22983742797,22983742790,-7,1191,4937,20
22983915238,22983915231,-7,308,938,20
22993413329,22993413327,-2,1333,2504,20
22994146649,22994146649,0,796,2059,20
22994226425,22994226421,-4,1073,2195,20
23001011044,23001011040,-4,1118,1955,20
23006870823,23006870827,4,2360,1637,20
23007964814,23007964812,-2,1234,1955,20
23018099834,23018099831,-3,1709,2950,20
23029215403,23029215402,-1,1134,3460,20
23030958270,23030958273,3,2451,1532,20
23031958439,23031958436,-3,1414,2693,20
23034148574,23034148566,-8,1893,12270,20
23034784046,23034784043,-3,993,3051,20
23034914212,23034914210,-2,1367,2628,20
23035815561,23035815558,-3,1155,2249,20
23039170083,23039170081,-2,799,2417,20
23048120942,23048120937,-5,1049,1940,20
23049635687,23049635685,-2,1132,2759,20
23050485827,23050485824,-3,790,1799,20
23055690001,23055689997,-4,844,2261,20
23060010583,23060010581,-2,1856,2456,20
23062448198,23062448195,-3,929,1722,20
23069783694,23069783690,-4,1204,3783,20
23070175507,23070175505,-2,963,1441,20
23073741164,23073741162,-2,1204,1893,20
23074464098,23074464098,0,4964,6812,20
23075740416,23075740409,-7,1092,2728,20
23077185919,23077185918,-1,896,1622,20
23080590963,23080590961,-2,750,1282,20
23081215187,23081215186,-1,1002,2037,20
23082144595,23082144593,-2,830,2127,20
23082519416,23082519414,-2,1334,2005,20
23082696719,23082696721,2,1401,2052,20
23088099567,23088099562,-5,1547,3440,20
23092211258,23092211255,-3,1069,1639,20
23092388111,23092388129,18,792,2355,20
23095780262,23095780262,0,1322,3010,20
23097843235,23097843234,-1,1455,1762,20
23099242440,23099242438,-2,1077,1410,20
23101901747,23101901745,-2,1485,2466,20
23105061637,23105061637,0,1842,2869,20
23111431061,23111431058,-3,1543,2511,20
23112082874,23112082873,-1,570,1939,20
23113383611,23113383607,-4,1225,1749,20
23117295956,23117295962,6,4879,1499,20
23117673770,23117673766,-4,1029,1926,20
23123534086,23123534083,-3,1056,1910,20
23134840938,23134840934,-4,919,2659,20
23136525106,23136525101,-5,916,2143,20
23144710120,23144710138,18,387,700,20
23144965714,23144965711,-3,950,2445,20
23145081605,23145081590,-15,772,1975,20
23145305023,23145305041,18,1086,1456,20
23155612830,23155612826,-4,1278,2719,20
23157975582,23157975582,0,2072,2039,20
23158285926,23158285904,-22,834,1939,20
23160269051,23160269049,-2,1156,1811,20
23166027526,23166027522,-4,1386,2556,20
23166871614,23166871611,-3,1532,2625,20
23166919875,23166919869,-6,897,2200,20
23168898270,23168898276,6,2855,1225,20
23173747722,23173747723,1,1290,1373,20
23177822078,23177822076,-2,934,1806,20
23179253077,23179253074,-3,810,1600,20
23181442352,23181442351,-1,1700,1860,20
23181862977,23181862975,-2,1127,2042,20
23183597567,23183597563,-4,1067,2749,20
23186271356,23186271350,-6,1253,2947,20
23186413893,23186413915,22,900,2127,20
23190945234,23190945230,-4,914,3177,20
23193512265,23193512262,-3,968,2255,20
23193771102,23193771099,-3,615,1897,20
23197711074,23197711080,6,4981,2634,20
23199508606,23199508604,-2,1211,2495,20
23199586328,23199586329,1,1174,1785,20
23201061941,23201061937,-4,1250,1981,20
23202429726,23202429746,20,848,1628,20
23205592942,23205592941,-1,1359,2572,20
23209125052,23209125051,-1,1540,2753,20
23209808426,23209808424,-2,1264,2422,20
23209957934,23209957933,-1,908,2822,20
23213336281,23213336277,-4,1287,1933,20
23214189406,23214189404,-2,874,2105,20
23221237013,23221237006,-7,936,4519,20
23223271641,23223271639,-2,1405,2638,20
23226227075,23226227073,-2,1458,2160,20
23227565759,23227565756,-3,806,2114,20
23228439979,23228439976,-3,1466,3380,20
23230462974,23230462971,-3,1256,2527,20
23230981195,23230981192,-3,1041,2155,20
23234913798,23234913800,2,1404,1561,20
23235409150,23235409148,-2,1182,2226,20
23235725602,23235725600,-2,1236,2159,20
23236995722,23236995720,-2,1120,2163,20
23238767486,23238767491,5,1179,2081,20
23241406333,23241406331,-2,1241,1733,20
23241845760,23241845757,-3,1077,2219,20
23243060975,23243060971,-4,1573,2198,20
23244603559,23244603555,-4,1500,2904,20
23245230235,23245230231,-4,849,2245,20
23248689978,23248689975,-3,861,2583,20
23248980253,23248980237,-16,269,867,20
23254348345,23254348338,-7,996,3022,20
23261085123,23261085116,-7,1017,2465,20
23262180386,23262180385,-1,1246,3248,20
23264222451,23264222448,-3,1215,2324,20
23267145191,23267145189,-2,784,1730,20
23268066358,23268066358,0,1044,1575,20
23269501426,23269501422,-4,822,2734,20
23269807795,23269807791,-4,981,2359,20
23271117387,23271117385,-2,937,1961,20
23271780764,23271780753,-11,136,762,20
23276068498,23276068490,-8,1020,4258,20
23280829142,23280829142,0,2316,2251,20
23285325413,23285325409,-4,1004,1940,20
23288924076,23288924072,-4,987,2267,20
23289411977,23289411974,-3,1178,2303,20
23294283274,23294283279,5,2026,984,20
23302395065,23302395063,-2,1210,2528,20
23314547964,23314547961,-3,1201,2884,20
23316937542,23316937541,-1,761,1603,20
23318673351,23318673350,-1,1011,1867,20
23320394158,23320394162,4,1565,967,20
23324735371,23324735366,-5,1327,1723,20
23329954203,23329954209,6,2365,1777,20
23330484991,23330484998,7,3236,1300,20
23331561930,23331561928,-2,1352,1825,20
23334945845,23334945842,-3,736,1846,20
23336036548,23336036546,-2,656,1581,20
23341291308,23341291311,3,1817,2294,20
23343700896,23343700895,-1,1277,1223,20
23348950148,23348950145,-3,1051,2446,20
23351318503,23351318498,-5,1037,2567,20
23353650251,23353650247,-4,1309,2242,20
23357123108,23357123106,-2,1526,3073,20
23357259933,23357259951,18,69,1673,20
23359238395,23359238395,0,991,1195,20
23360197702,23360197707,5,2012,1393,20
23361849281,23361849278,-3,751,3045,20
23362314303,23362314301,-2,1223,2434,20
23365602263,23365602260,-3,922,2469,20
23369808742,23369808738,-4,908,2352,20
23370322721,23370322718,-3,1218,1817,20
23372890111,23372890111,0,1857,1437,20
23374204992,23374204989,-3,981,2094,20
23375589457,23375589452,-5,755,3123,20
23379043978,23379043975,-3,1101,1922,20
23380864434,23380864433,-1,1277,2103,20
23381458007,23381458002,-5,1354,2197,20
23382523102,23382523097,-5,1451,2631,20
23385407983,23385407982,-1,960,1975,20
23388441462,23388441458,-4,1082,2278,20
23391702583,23391702579,-4,966,1883,20
23392498090,23392498095,5,1698,1005,20
23393330990,23393330989,-1,1236,3059,20
23395456054,23395456049,-5,962,2289,20
23397964673,23397964673,0,1140,1358,20
23399427168,23399427166,-2,1606,2610,20
23400396491,23400396488,-3,1339,2236,20
23401380325,23401380322,-3,986,2134,20
23404341677,23404341674,-3,922,2267,20
23404488343,23404488329,-14,1439,2974,20
23404613648,23404613665,17,860,2584,20
23405751234,23405751233,-1,1067,1955,20
23406547954,23406547951,-3,1643,2302,20
23406737718,23406737697,-21,815,2270,20
23406816800,23406816817,17,1128,2026,20
23407830315,23407830312,-3,906,2166,20
23408780927,23408780925,-2,938,2346,20
23409307997,23409307994,-3,1407,2626,20
23410387346,23410387345,-1,1366,2599,20
23419662522,23419662521,-1,1520,3063,20
23419960975,23419960973,-2,1205,2397,20
23421870711,23421870709,-2,1438,2868,20
23422301365,23422301363,-2,1088,2188,20
23422949414,23422949409,-5,1150,4948,20
23426159819,23426159814,-5,1476,3038,20
23428255118,23428255114,-4,1193,2674,20
23428357246,23428357244,-2,1295,2806,20
23428956038,23428956035,-3,1135,2080,20
23431430294,23431430293,-1,1401,3092,20
23432145182,23432145174,-8,1694,8133,20
23432374732,23432374717,-15,1211,2492,20
23435510581,23435510589,8,7943,38321,20
23437312395,23437312393,-2,785,1613,20
23439574007,23439574002,-5,1059,2425,20
23441537369,23441537366,-3,1213,3107,20
23442673212,23442673198,-14,1327,2310,20
23442958695,23442958710,15,626,1293,20
23444199738,23444199738,0,3296,3286,20
23451641363,23451641361,-2,1081,2228,20
23455998150,23455998146,-4,1051,2382,20
23456638625,23456638622,-3,1155,1995,20
23458238116,23458238117,1,3667,4878,20
23460031094,23460031094,0,1489,2605,20
23463579701,23463579697,-4,1359,2286,20
23468294476,23468294475,-1,1284,3116,20
23469587221,23469587218,-3,1092,2405,20
23469784192,23469784208,16,902,2621,20
23470405080,23470405077,-3,1392,2854,20
23473797082,23473797081,-1,829,2057,20
23475528804,23475528798,-6,946,2745,20
23476169148,23476169145,-3,1123,2040,20
23476932375,23476932354,-21,1002,2270,20
23480784703,23480784698,-5,1081,2098,20
23480920714,23480920713,-1,1398,2381,20
23493754972,23493754969,-3,824,2459,20
23500119363,23500119362,-1,1018,2431,20
23502166311,23502166307,-4,1159,2410,20
23504485445,23504485444,-1,1452,1649,20
23510646907,23510646904,-3,1807,3088,20
23513965322,23513965321,-1,1385,2389,20
23518173254,23518173249,-5,1113,2341,20
23519615736,23519615732,-4,1359,2504,20
23528825101,23528825100,-1,1277,1962,20
23529162083,23529162082,-1,1342,2349,20
23530524873,23530524874,1,2422,3754,20
23535173499,23535173497,-2,1001,2002,20
23536964803,23536964802,-1,769,2124,20
23537623599,23537623597,-2,18452,6636,20
23538488394,23538488391,-3,1101,2193,20
23540071443,23540071442,-1,1128,1521,20
23549157385,23549157384,-1,1362,2236,20
23549955198,23549955195,-3,941,1305,20
23550460110,23550460107,-3,830,2209,20
23561131407,23561131404,-3,1762,2807,20
23566714243,23566714241,-2,943,2333,20
23567147989,23567147982,-7,1351,2400,20
23568976987,23568976985,-2,1073,2427,20
23573885038,23573885034,-4,1131,3185,20
23574049961,23574049961,0,2101,3274,20
23581404882,23581404881,-1,1309,2212,20
23581583178,23581583177,-1,897,2279,20
23582513949,23582513955,6,1962,2158,20
23586571617,23586571617,0,1225,1751,20
23588688011,23588688011,0,969,1707,20
23594311367,23594311366,-1,1470,1882,20
23603614719,23603614718,-1,1257,3028,20
23605469043,23605469039,-4,1125,2235,20
23608851978,23608851978,0,1178,2083,20
23612414707,23612414706,-1,1202,2438,20
23617985679,23617985675,-4,906,2166,20
23619642948,23619642940,-8,783,2077,20
23620425948,23620425970,22,439,2205,20
23623200069,23623200067,-2,1299,2090,20
23627392554,23627392551,-3,1005,1694,20
23629482508,23629482505,-3,897,2602,20
23630279095,23630279087,-8,1274,1010,20
23634437950,23634437965,15,16075,22635,20
23636380835,23636380830,-5,1059,2823,20
23636880576,23636880583,7,2634,1406,20
23651489871,23651489868,-3,1057,2553,20
23653060219,23653060218,-1,693,2170,20
23653886165,23653886163,-2,988,2286,20
23657697709,23657697712,3,21115,18391,20
23658632218,23658632219,1,6168,7331,20
23660469125,23660469122,-3,1122,1820,20
23663759554,23663759551,-3,1021,2605,20
23664293159,23664293157,-2,1274,1443,20
23669219943,23669219939,-4,2376,6121,20
23670205687,23670205682,-5,1130,2602,20
23675786982,23675786979,-3,1172,2387,20
23677245576,23677245574,-2,1318,2453,20
23677598798,23677598794,-4,1273,2622,20
23678289942,23678289938,-4,1125,3046,20
23681312757,23681312756,-1,807,849,20
23682531355,23682531350,-5,1360,2464,20
23685331118,23685331114,-4,842,2085,20
23686858637,23686858631,-6,890,3344,20
23690697077,23690697074,-3,1216,2473,20
23691530942,23691530943,1,1278,1787,20
23691835598,23691835595,-3,1136,2531,20
23692833114,23692833110,-4,1218,2292,20
23699067977,23699067974,-3,1361,2522,20
23700149295,23700149277,-18,925,2755,20
23701931035,23701931034,-1,724,2256,20
23707931343,23707931340,-3,1930,3150,20
23713367803,23713367799,-4,841,2012,20
23715774533,23715774530,-3,1108,2294,20
23716033834,23716033830,-4,1276,2890,20
23717416122,23717416121,-1,1229,2449,20
23718259058,23718259054,-4,668,1306,20
23724430885,23724430882,-3,935,2415,20
23725594643,23725594642,-1,1262,2436,20
23726337086,23726337084,-2,765,2112,20
23728655103,23728655100,-3,1477,2491,20
23732788305,23732788303,-2,1278,2224,20
23733686357,23733686374,17,88,948,20
23734864818,23734864816,-2,1309,3008,20
23736736933,23736736930,-3,1129,1978,20
23737515016,23737515014,-2,1115,2366,20
23743811109,23743811106,-3,1250,2117,20
23745758179,23745758179,0,3348,4055,20
23746063795,23746063791,-4,974,1728,20
23754202854,23754202851,-3,1325,3071,20
23755391391,23755391387,-4,999,1877,20
23756067970,23756067970,0,1214,1675,20
23757527439,23757527437,-2,1253,2264,20
23758258447,23758258443,-4,1214,2913,20
23758305469,23758305466,-3,833,2318,20
23759491563,23759491559,-4,1379,2456,20
23762063538,23762063529,-9,1040,2441,20
23762196093,23762196090,-3,1176,3523,20
23764185610,23764185606,-4,1296,2810,20
23764215738,23764215734,-4,850,1575,20
23765585811,23765585809,-2,1150,2675,20
23773657406,23773657418,12,1316,2032,20
23775481431,23775481429,-2,859,2484,20
23776116924,23776116920,-4,1247,2533,20
23783952130,23783952126,-4,1379,3483,20
23784602358,23784602354,-4,1107,2550,20
23786931841,23786931835,-6,807,2531,20
23787793222,23787793218,-4,869,1561,20
23793157605,23793157623,18,1401,1308,20
23794163701,23794163721,20,76,6266,20
23798045230,23798045228,-2,959,1799,20
23798819774,23798819770,-4,849,1511,20
23802890892,23802890891,-1,1434,1361,20
23804294919,23804294915,-4,1039,2525,20
23813319522,23813319518,-4,1009,1193,20
23814015735,23814015751,16,297,587,20
23814458846,23814458845,-1,861,1756,20
23816080978,23816080982,4,2384,1176,20
23817723881,23817723884,3,4635,20401,20
23822665935,23822665934,-1,1044,2314,20
23828681758,23828681754,-4,1514,2220,20
23830711422,23830711419,-3,1530,2440,20
23832474178,23832474175,-3,1061,2303,20
23832632795,23832632792,-3,900,1874,20
23842304755,23842304750,-5,1058,2859,20
23853722279,23853722276,-3,660,1541,20
23854956530,23854956529,-1,956,2444,20
23856161886,23856161883,-3,1285,4015,20
23861821395,23861821390,-5,1174,2266,20
23865365098,23865365094,-4,917,2320,20
23865452866,23865452863,-3,1156,1919,20
23865698358,23865698377,19,739,1704,20
23866917142,23866917140,-2,1022,2923,20
23868825851,23868825850,-1,2670,4167,20
23872469786,23872469784,-2,939,2503,20
23873787782,23873787786,4,1674,1280,20
23875886281,23875886278,-3,1246,2198,20
23878967535,23878967531,-4,1497,2293,20
23879957163,23879957158,-5,21486,10094,20
23881810925,23881810927,2,2114,2014,20
23887733467,23887733464,-3,1386,2261,20
23887767614,23887767633,19,1013,2746,20
23888943122,23888943119,-3,1074,2185,20
23891496205,23891496204,-1,1302,1787,20
23891568471,23891568451,-20,238,772,20
23897032298,23897032291,-7,534,2385,20
23897448283,23897448280,-3,1440,2777,20
23898209022,23898209020,-2,958,2336,20
23902513615,23902513614,-1,1189,2355,20
23903610580,23903610576,-4,1786,3296,20
23903726826,23903726825,-1,488,1903,20
23911831742,23911831738,-4,919,2302,20
23922681717,23922681713,-4,1274,2900,20
23925463731,23925463728,-3,1107,1736,20
23930898474,23930898473,-1,1333,2297,20
23933529713,23933529711,-2,1405,2281,20
23934337697,23934337698,1,1428,2374,20
23934647464,23934647446,-18,298,1371,20
23941485937,23941485938,1,1195,1624,20
23944212138,23944212135,-3,1008,2569,20
23944500590,23944500568,-22,1376,2105,20
23944590662,23944590660,-2,293,669,20
23957348616,23957348613,-3,1008,2173,20
23957416127,23957416129,2,359,990,20
23959677415,23959677410,-5,817,1236,20
23961106524,23961106518,-6,1191,2297,20
23962912333,23962912329,-4,818,1936,20
23963259207,23963259193,-14,837,2541,20
23963805423,23963805410,-13,1068,1900,20
23967968545,23967968538,-7,1319,12725,20
23969178998,23969178994,-4,972,2520,20
23970936201,23970936198,-3,1002,2405,20
23971058536,23971058542,6,15037,5203,20
23973717863,23973717859,-4,879,2523,20
23979212790,23979212786,-4,1739,3131,20
23979424433,23979424431,-2,1225,1532,20
23980244363,23980244359,-4,1210,2969,20
23980393230,23980393215,-15,993,2972,20
23981953837,23981953839,2,2125,1688,20
23986381162,23986381158,-4,1230,2502,20
23987030383,23987030365,-18,879,2010,20
23987573107,23987573115,8,3768,1173,20
23988818535,23988818539,4,1966,1219,20
23994344608,23994344603,-5,932,2179,20
23997875158,23997875155,-3,1071,1928,20
24014478096,24014478094,-2,1460,2080,20
24017636646,24017636649,3,3612,2733,20
24018551730,24018551729,-1,1482,2301,20
24021773666,24021773664,-2,1227,2366,20
24025590178,24025590175,-3,620,1287,20
24028761411,24028761407,-4,884,1908,20
24032169083,24032169082,-1,931,1349,20
24036649458,24036649457,-1,999,2235,20
24039946116,24039946110,-6,1314,1921,20
24040053036,24040053031,-5,911,2249,20
24050348438,24050348436,-2,1099,2155,20
24051829367,24051829365,-2,1256,3677,20
24058376328,24058376325,-3,1049,2751,20
24059051667,24059051663,-4,877,2652,20
24062288465,24062288461,-4,857,2011,20
24064110342,24064110338,-4,1109,2729,20
24064912061,24064912079,18,466,2489,20
24069676955,24069676953,-2,909,2140,20
24073801967,24073801966,-1,997,2909,20
24074799442,24074799438,-4,1068,2402,20
24076510244,24076510241,-3,1230,3364,20
24086435625,24086435621,-4,1061,2467,20
24086788109,24086788090,-19,71,780,20
24088093207,24088093201,-6,1121,5160,20
24088459606,24088459612,6,928,1088,20
24089412367,24089412365,-2,1279,2469,20
24090065953,24090065952,-1,941,2097,20
24092729582,24092729579,-3,1590,2307,20
24098133010,24098133009,-1,1406,2854,20
24099343890,24099343889,-1,928,1126,20
24101288130,24101288127,-3,974,1568,20
24101370313,24101370315,2,2111,1621,20
24105070570,24105070569,-1,1345,2262,20
24107917955,24107917953,-2,1347,2400,20
24109763691,24109763689,-2,1384,2317,20
24113524371,24113524366,-5,1343,2869,20
24115986822,24115986820,-2,1020,1871,20
24119020454,24119020450,-4,907,2266,20
24122588698,24122588694,-4,1002,2729,20
24123615736,24123615735,-1,6556,10672,20
24124698573,24124698570,-3,1494,2107,20
24130786326,24130786324,-2,840,2233,20
24137586939,24137586935,-4,1056,2135,20
24142415270,24142415266,-4,991,2177,20
24144774389,24144774389,0,1186,2173,20
24145295268,24145295266,-2,711,2329,20
24147058950,24147058952,2,1223,2569,20
24149837475,24149837471,-4,693,1744,20
24150557883,24150557880,-3,1004,2893,20
24154444314,24154444312,-2,1025,1809,20
24156192960,24156192959,-1,1145,1631,20
24156353540,24156353563,23,199,709,20
24158566917,24158566915,-2,832,2297,20
24159291281,24159291282,1,2545,1544,20
24162369299,24162369297,-2,1164,1822,20
24163998206,24163998209,3,1625,2056,20
24164180890,24164180889,-1,893,1934,20
24164958179,24164958176,-3,1332,2428,20
24167990404,24167990401,-3,1439,3051,20
24170767354,24170767350,-4,1406,2589,20
24173631503,24173631501,-2,866,2849,20
24173828279,24173828294,15,658,1526,20
24174059968,24174059986,18,1579,3466,20
24177121983,24177121980,-3,1419,2193,20
24177361722,24177361720,-2,1449,2893,20
24177519899,24177519900,1,1368,1875,20
24192338937,24192338933,-4,1257,2470,20
24194124539,24194124537,-2,1156,1811,20
24196188454,24196188451,-3,1125,2982,20
24196256543,24196256546,3,298,1246,20
24197204661,24197204656,-5,1159,1955,20
24200248557,24200248555,-2,929,1845,20
24205728590,24205728588,-2,1114,2166,20
24207500262,24207500259,-3,1405,2888,20
24208886866,24208886863,-3,908,2008,20
24211617569,24211617565,-4,708,1587,20
24220724481,24220724477,-4,1397,3127,20
24221714263,24221714242,-21,1204,2336,20
24221754318,24221754299,-19,90,703,20
24222562991,24222562989,-2,1125,2148,20
24224004527,24224004522,-5,898,2136,20
24225251091,24225251089,-2,1182,2016,20
24225963257,24225963238,-19,2333,2685,20
24227872157,24227872151,-6,1176,3616,20
24229405446,24229405445,-1,1236,2059,20
24233029666,24233029666,0,975,1307,20
24234267326,24234267324,-2,1132,1784,20
24235134049,24235134049,0,2436,3969,20
24236133301,24236133307,6,2454,1448,20
24239421280,24239421278,-2,2068,3461,20
24239963466,24239963462,-4,1444,3681,20
24249769165,24249769161,-4,1097,2712,20
24250040007,24250040017,10,315,957,20
24250425491,24250425487,-4,1152,2238,20
24252145890,24252145888,-2,1036,2488,20
24254902657,24254902663,6,3062,381,20
24255499890,24255499886,-4,942,2044,20
24262588253,24262588247,-6,1117,4034,20
24263007808,24263007807,-1,1068,1239,20
24264459138,24264459134,-4,1159,3366,20
24264715286,24264715279,-7,203,493,20
24266510195,24266510193,-2,1395,2701,20
24266742723,24266742721,-2,1026,2220,20
24268465155,24268465153,-2,974,2281,20
24270607753,24270607749,-4,1377,2278,20
24271451687,24271451682,-5,1100,2443,20
24276976608,24276976605,-3,1262,2923,20
24282383367,24282383360,-7,951,3813,20
24286208901,24286208898,-3,1054,2972,20
24291713013,24291713018,5,12362,25047,20
24291860350,24291860350,0,1197,2345,20
24292311771,24292311769,-2,1174,2665,20
24293297307,24293297305,-2,1202,2409,20
24294798308,24294798305,-3,1337,3308,20
24295847045,24295847042,-3,1438,2850,20
24297080541,24297080534,-7,1926,9260,20
24306028125,24306028122,-3,841,2703,20
24309687187,24309687185,-2,929,1962,20
24312810111,24312810110,-1,1294,1250,20
24313645664,24313645667,3,1549,1551,20
24314856449,24314856448,-1,1559,2222,20
24317879074,24317879070,-4,1223,2029,20
24323349225,24323349222,-3,855,2855,20
24323526758,24323526753,-5,1276,2947,20
24327805576,24327805575,-1,819,1205,20
24328690283,24328690280,-3,1291,2935,20
24334432313,24334432310,-3,1189,2773,20
24334964214,24334964210,-4,1684,3468,20
24346950399,24346950394,-5,1279,2602,20
24358109670,24358109669,-1,1231,2234,20
24358912071,24358912067,-4,985,3344,20
24366698278,24366698276,-2,1047,1720,20
24367564460,24367564460,0,313,1234,20
24369290146,24369290143,-3,1697,3213,20
24369868642,24369868641,-1,1027,2127,20
24371230758,24371230760,2,1548,1229,20
24373354425,24373354422,-3,1258,2214,20
24375661912,24375661909,-3,1021,2324,20
24375880696,24375880693,-3,857,2191,20
24376905267,24376905265,-2,1511,3365,20
24378146690,24378146684,-6,48525,16393,20
24378355889,24378355886,-3,1136,1571,20
24383613428,24383613435,7,6985,2935,20
24392446458,24392446454,-4,1343,2607,20
24394122834,24394122835,1,1379,1819,20
24394659245,24394659246,1,1677,1776,20
24395755158,24395755179,21,331,830,20
24398781936,24398781933,-3,1148,2189,20
24403422306,24403422305,-1,1095,2658,20
24414182060,24414182056,-4,1094,2176,20
24421761531,24421761526,-5,1138,2194,20
24423788914,24423788909,-5,1038,2768,20
24424294959,24424294958,-1,1157,3103,20
24431281506,24431281506,0,1315,1950,20
24434471650,24434471646,-4,1239,2180,20
24440825881,24440825877,-4,1419,2068,20
24442399692,24442399690,-2,1315,2484,20
24442679703,24442679693,-10,1677,2762,20
24443446743,24443446737,-6,1163,5827,20
24445555097,24445555099,2,1352,2115,20
24445972237,24445972256,19,846,2253,20
24451304242,24451304238,-4,613,1490,20
24461830319,24461830315,-4,1576,3749,20
24462199111,24462199106,-5,515,2639,20
24462826886,24462826883,-3,981,1895,20
24467005726,24467005723,-3,1405,2745,20
24468980428,24468980424,-4,1552,2657,20
24472643683,24472643681,-2,1469,2672,20
24475216875,24475216872,-3,964,1863,20
24477959567,24477959563,-4,643,1160,20
24481678923,24481678918,-5,1037,2406,20
24485428253,24485428246,-7,1659,9241,20
24485717877,24485717874,-3,1027,3480,20
24489588111,24489588107,-4,806,1914,20
24492504586,24492504581,-5,980,2790,20
24493624556,24493624552,-4,1258,2162,20
24497589855,24497589852,-3,1229,3338,20
24498093974,24498093971,-3,1059,2372,20
24499072922,24499072926,4,1338,1068,20
24499904601,24499904601,0,1224,1875,20
24501811378,24501811374,-4,1327,2263,20
24507863966,24507863963,-3,1009,2227,20
24508294031,24508294030,-1,699,1630,20
24510055540,24510055538,-2,1418,1832,20
24510346376,24510346379,3,3854,3295,20
24512286290,24512286289,-1,1352,2370,20
24514209847,24514209845,-2,879,1808,20
24517867575,24517867579,4,1506,829,20
24519510687,24519510683,-4,1139,2319,20
24520310889,24520310886,-3,1585,2691,20
24526278238,24526278236,-2,1099,2399,20
24536910083,24536910081,-2,1439,2339,20
24544805430,24544805427,-3,974,1666,20
24545579168,24545579171,3,1496,884,20
24545703897,24545703894,-3,966,2783,20
24553765446,24553765442,-4,1168,2893,20
24555340642,24555340639,-3,1086,1735,20
24557132452,24557132446,-6,985,2267,20
24559891659,24559891658,-1,1262,2297,20
24561119186,24561119185,-1,730,1336,20
24561415034,24561415032,-2,1248,2223,20
24561544892,24561544878,-14,171,1027,20
24563581310,24563581306,-4,899,2038,20
24567117367,24567117370,3,2107,3381,20
24568109907,24568109902,-5,950,2285,20
24569614314,24569614313,-1,854,1738,20
24571798792,24571798786,-6,882,2334,20
24575122133,24575122138,5,2878,1751,20
24577766459,24577766457,-2,814,2926,20
24577838525,24577838546,21,902,1655,20
24580912844,24580912840,-4,694,634,20
24587781638,24587781635,-3,1080,2462,20
24589346764,24589346761,-3,1264,3505,20
24592821673,24592821669,-4,1086,2184,20
24594032573,24594032570,-3,689,2153,20
24594854166,24594854145,-21,1044,4067,20
24595707983,24595707982,-1,959,2303,20
24599737621,24599737618,-3,1397,3541,20
24603353321,24603353318,-3,776,1194,20
24604008151,24604008147,-4,953,2361,20
24608430325,24608430321,-4,1085,2230,20
24609237458,24609237454,-4,1378,2044,20
24612519754,24612519749,-5,1181,2591,20
24612846432,24612846430,-2,1100,1506,20
24613388746,24613388742,-4,1615,1898,20
24613916483,24613916482,-1,1532,2172,20
24616358173,24616358170,-3,1053,2318,20
24624325447,24624325443,-4,1186,3597,20
24626848229,24626848226,-3,711,2386,20
24631122351,24631122348,-3,1362,2199,20
24635175839,24635175837,-2,1202,2264,20
24635412442,24635412443,1,1689,2642,20
24639197290,24639197286,-4,1017,1605,20
24642014972,24642014968,-4,1384,3030,20
24642048453,24642048474,21,648,1621,20
24649517055,24649517053,-2,817,1846,20
24650360048,24650360036,-12,9025,939,20
24651592582,24651592578,-4,1430,2543,20
24652373226,24652373227,1,1930,1679,20
24655982282,24655982278,-4,1134,2422,20
24657849721,24657849719,-2,741,1623,20
24659572228,24659572222,-6,1345,3204,20
24662705623,24662705637,14,975,1212,20
24671719439,24671719433,-6,1327,4740,20
24673570922,24673570919,-3,1097,2125,20
24673698207,24673698206,-1,3185,4443,20
24676459791,24676459786,-5,1424,3402,20
24677589535,24677589532,-3,1302,3180,20
24678047980,24678047977,-3,1573,3330,20
24680257983,24680257978,-5,963,2494,20
24681210133,24681210135,2,1401,1473,20
24682962327,24682962326,-1,691,1700,20
24689299076,24689299073,-3,1555,2179,20
24696563351,24696563349,-2,1362,2218,20
24705677953,24705677958,5,4064,1698,20
24705716359,24705716355,-4,1078,1932,20
24706408659,24706408656,-3,1291,3141,20
24707456743,24707456738,-5,1162,3021,20
24709067144,24709067141,-3,1292,2133,20
24710488770,24710488768,-2,1803,4027,20
24711455440,24711455437,-3,846,2348,20
24717511434,24717511429,-5,1306,3876,20
24719557737,24719557733,-4,1427,2166,20
24724396543,24724396534,-9,985,4415,20
24725720355,24725720353,-2,1610,2116,20
24726873134,24726873132,-2,1142,2320,20
24728291171,24728291170,-1,1036,2398,20
24731267453,24731267457,4,1375,707,20
24732426771,24732426768,-3,1382,2599,20
24732798613,24732798609,-4,791,1983,20
24735199603,24735199602,-1,1032,1729,20
24736212723,24736212719,-4,1324,2423,20
24737709878,24737709876,-2,888,2354,20
24739663593,24739663589,-4,1030,2237,20
24742591893,24742591895,2,2314,1469,20
24743037538,24743037537,-1,1145,2286,20
24745328994,24745328994,0,1671,2021,20
24748389144,24748389163,19,484,1295,20
24748777737,24748777735,-2,1527,2625,20
24753122061,24753122057,-4,1102,2326,20
24753792589,24753792585,-4,1175,2047,20
24757046170,24757046169,-1,972,1992,20
24757245727,24757245724,-3,1088,2516,20
24761279477,24761279473,-4,1116,2540,20
24767039989,24767039987,-2,1124,1866,20
24774160422,24774160420,-2,627,1393,20
24778596519,24778596513,-6,1084,4000,20
24779066188,24779066185,-3,1152,2554,20
24779576070,24779576066,-4,732,2556,20
24780435738,24780435735,-3,1595,2423,20
24783463718,24783463704,-14,1802,573,20
24783668401,24783668397,-4,1010,2205,20
24784794789,24784794786,-3,1084,3014,20
24784924028,24784924010,-18,705,2678,20
24793525755,24793525752,-3,1160,3578,20
24794840054,24794840054,0,1204,1963,20
24799325394,24799325393,-1,795,1478,20
24803738108,24803738105,-3,1257,2245,20
24806629619,24806629617,-2,716,2649,20
24808524728,24808524744,16,1112,3473,20
24810758937,24810758934,-3,1472,2137,20
24813518467,24813518465,-2,1403,2030,20
24817237607,24817237606,-1,948,1967,20
24820606426,24820606430,4,2505,1630,20
24821678986,24821678982,-4,894,2172,20
24822773567,24822773565,-2,1005,1984,20
24828599690,24828599689,-1,938,1429,20
24829535491,24829535490,-1,921,2810,20
24832114337,24832114332,-5,1019,3351,20
24832931464,24832931462,-2,1713,3291,20
24833389214,24833389200,-14,801,1657,20
24833868235,24833868232,-3,908,2863,20
24836690561,24836690558,-3,1642,2291,20
24837638291,24837638287,-4,1289,2007,20
24841794874,24841794874,0,1037,1737,20
24850277710,24850277706,-4,1101,3113,20
24862265614,24862265617,3,1701,1310,20
24865571064,24865571063,-1,1051,2313,20
24873262050,24873262050,0,1562,1897,20
24884320456,24884320454,-2,990,1928,20
24886038776,24886038771,-5,1324,2656,20
24886100097,24886100095,-2,1181,2671,20
24889916712,24889916711,-1,1764,3259,20
24893337979,24893337974,-5,1159,2713,20
24896102569,24896102565,-4,1199,2156,20
24898678845,24898678843,-2,1585,2553,20
24901137638,24901137634,-4,1058,2155,20
24905358277,24905358273,-4,1125,2417,20
24908174399,24908174398,-1,1051,2015,20
24909214843,24909214841,-2,1004,2376,20
24912409715,24912409711,-4,1014,1799,20
24913748498,24913748498,0,1297,1685,20
24913816717,24913816713,-4,1197,2208,20
24916969486,24916969481,-5,1279,3274,20
24917160962,24917160962,0,1903,2058,20
24931535684,24931535682,-2,1406,2571,20
24932608346,24932608344,-2,929,2614,20
24936663790,24936663787,-3,875,1661,20
24936943302,24936943294,-8,2374,6641,20
24937442306,24937442303,-3,1088,2341,20
24944225467,24944225462,-5,1010,2690,20
24951123699,24951123697,-2,863,3064,20
24951736535,24951736555,20,428,1118,20
24954090678,24954090680,2,1493,1944,20
24956561427,24956561425,-2,1683,1763,20
24958121489,24958121482,-7,1200,1723,20
24961960795,24961960778,-17,765,1692,20
24963272714,24963272711,-3,699,1969,20
24963838345,24963838345,0,872,2249,20
24967287347,24967287346,-1,1225,1523,20
24968375629,24968375625,-4,1557,2376,20
24970649913,24970649911,-2,1060,1672,20
24971957806,24971957803,-3,1501,2469,20
24975171899,24975171896,-3,1256,2028,20
24976852495,24976852493,-2,1293,2075,20
24977120199,24977120197,-2,1195,2093,20
24978190332,24978190330,-2,1070,2054,20
24980494653,24980494661,8,13271,24485,20
24981747895,24981747892,-3,1523,2438,20
24985284769,24985284766,-3,1075,1702,20
24986634203,24986634196,-7,1149,3272,20
24988531667,24988531663,-4,1072,2618,20
24992142433,24992142440,7,14717,25111,20
24992782079,24992782099,20,1030,1619,20
24993847287,24993847284,-3,1061,2183,20
24995504931,24995504929,-2,891,2878,20
24995804949,24995804928,-21,1062,1865,20
24996426843,24996426840,-3,832,1676,20
24999638382,24999638382,0,2427,4760,20
25000158685,25000158686,1,1264,1403,20
25001565973,25001565970,-3,960,2293,20
25004293359,25004293356,-3,928,1766,20
25007430360,25007430363,3,1835,1573,20
25016131147,25016131148,1,1119,1183,20
25025993992,25025993990,-2,1208,2571,20
25030270242,25030270241,-1,1081,1613,20
25031808921,25031808916,-5,529,1909,20
25034677734,25034677729,-5,1212,3520,20
25037989958,25037989957,-1,936,1985,20
25039759325,25039759322,-3,1193,2174,20
25041655226,25041655224,-2,1275,2470,20
25041725809,25041725809,0,2827,5023,20
25046399638,25046399635,-3,1119,2370,20
25047745070,25047745070,0,1607,2062,20
25048752343,25048752340,-3,1677,2765,20
25050565213,25050565210,-3,673,1648,20
25053610261,25053610254,-7,916,3700,20
25055631744,25055631741,-3,1056,2576,20
25056629724,25056629721,-3,1994,2536,20
25063960022,25063960022,0,1357,2140,20
25064919279,25064919294,15,814,1717,20
25067850352,25067850349,-3,816,3153,20
25069368582,25069368578,-4,1417,2658,20
25069400686,25069400682,-4,1300,2993,20
25072046530,25072046526,-4,1574,2919,20
25075388267,25075388265,-2,1090,1764,20
25077282510,25077282507,-3,455,1160,20
25083561196,25083561194,-2,1876,2835,20
25083986081,25083986078,-3,1209,3343,20
25084679491,25084679489,-2,912,2409,20
25085078581,25085078577,-4,1456,3448,20
25085677305,25085677301,-4,970,1599,20
25086058354,25086058350,-4,1032,1659,20
25091401466,25091401462,-4,1081,2703,20
25094092646,25094092643,-3,1183,1969,20
25094418027,25094418025,-2,1120,2356,20
25099921142,25099921141,-1,1203,2681,20
25109392218,25109392216,-2,983,2381,20
25109928096,25109928093,-3,611,709,20
25114287482,25114287481,-1,911,2609,20
25115250143,25115250134,-9,938,1706,20
25118287392,25118287394,2,1840,1464,20
25118542779,25118542778,-1,815,1964,20
25119654286,25119654285,-1,1478,2021,20
25124681387,25124681385,-2,1148,1905,20
25125711379,25125711374,-5,1021,2294,20
25125794055,25125794066,11,386,1929,20
25126186075,25126186072,-3,968,2288,20
25129617043,25129617042,-1,1031,1783,20
25129891575,25129891595,20,262,955,20
25130310848,25130310847,-1,1118,2169,20
25131483078,25131483099,21,419,1429,20
25134080579,25134080578,-1,1515,1694,20
25135496547,25135496546,-1,1439,2550,20
25135830408,25135830403,-5,1131,2017,20
25135911647,25135911643,-4,722,2583,20
25140127577,25140127579,2,2125,2565,20
25142864847,25142864844,-3,876,2042,20
25153083598,25153083595,-3,983,1380,20
25154653539,25154653535,-4,1088,2153,20
25156266046,25156266041,-5,1100,2063,20
25156313447,25156313438,-9,771,1993,20
25160145369,25160145366,-3,1246,1864,20
25161051494,25161051491,-3,1126,1981,20
25163607706,25163607701,-5,1133,2814,20
25166265667,25166265675,8,8177,2257,20
25174200566,25174200573,7,3358,1707,20
25175367842,25175367842,0,1165,1442,20
25176747991,25176747988,-3,748,1797,20
25182366639,25182366638,-1,1008,2678,20
25183140305,25183140301,-4,945,2032,20
25186876963,25186876960,-3,864,2321,20
25187739976,25187739994,18,599,1647,20
25187798124,25187798124,0,2568,3845,20
25197273954,25197273950,-4,1011,3305,20
25203455027,25203455023,-4,1153,2636,20
25205069761,25205069763,2,934,3047,20
25205209415,25205209410,-5,1166,2702,20
25210203497,25210203493,-4,1485,2091,20
25210538366,25210538382,16,1145,2486,20
25217668886,25217668885,-1,1105,2605,20
25218565580,25218565577,-3,1249,2960,20
25221107218,25221107214,-4,1365,1934,20
25223768485,25223768481,-4,856,2682,20
25224564924,25224564943,19,1023,2442,20
25225401453,25225401449,-4,1154,2896,20
25225952903,25225952919,16,95,967,20
25230633590,25230633588,-2,1453,1915,20
25230814811,25230814807,-4,1119,2748,20
25231314641,25231314636,-5,1573,3096,20
25234254834,25234254829,-5,725,2337,20
25235440321,25235440321,0,1608,2343,20
25243907817,25243907815,-2,887,2678,20
25244338202,25244338198,-4,1468,2369,20
25246354493,25246354497,4,2067,1224,20
25248274374,25248274370,-4,1326,3924,20
25248432709,25248432706,-3,1120,1845,20
25253013495,25253013493,-2,1282,1773,20
25256934901,25256934898,-3,1481,2431,20
25260638351,25260638346,-5,921,2588,20
25264610447,25264610445,-2,1206,2578,20
25268362878,25268362874,-4,987,1607,20
25272081370,25272081366,-4,1535,3144,20
25272486882,25272486881,-1,1284,2282,20
25278560141,25278560150,9,2951,1302,20
25279228306,25279228305,-1,1121,2756,20
25282006223,25282006220,-3,1472,3072,20
25283181873,25283181871,-2,1371,2572,20
25284233470,25284233473,3,2035,1645,20
25287544888,25287544885,-3,1990,2719,20
25289568542,25289568540,-2,1336,2626,20
25296187855,25296187851,-4,1252,2293,20
25296922582,25296922578,-4,908,3186,20
25302071099,25302071101,2,2081,1692,20
25306294947,25306294937,-10,5952,13795,20
25306332638,25306332636,-2,1031,2330,20
25313048517,25313048514,-3,1133,2642,20
25315396951,25315396948,-3,902,1854,20
25316691048,25316691044,-4,853,2033,20
25317601990,25317601987,-3,1388,3234,20
25322986534,25322986533,-1,1117,2201,20
25323887722,25323887718,-4,1370,2559,20
25324571080,25324571082,2,1383,1729,20
25337118133,25337118129,-4,1310,3000,20
25337515840,25337515840,0,1634,1815,20
25338650893,25338650914,21,503,3082,20
25339719698,25339719694,-4,1487,3099,20
25340448056,25340448053,-3,1127,2441,20
25342186694,25342186692,-2,1204,2079,20
25346759614,25346759612,-2,635,2045,20
25350549074,25350549070,-4,1139,1637,20
25351721485,25351721487,2,1836,1893,20
25358101194,25358101196,2,1468,1385,20
25359385063,25359385063,0,657,1930,20
25360752255,25360752254,-1,1073,1450,20
25361542378,25361542373,-5,1133,2160,20
25362200442,25362200441,-1,1074,2227,20
25364297406,25364297403,-3,1270,2344,20
25372998127,25372998121,-6,1230,2524,20
25375129511,25375129504,-7,818,3649,20
25375534047,25375534042,-5,613,905,20
25381123450,25381123445,-5,905,1603,20
25381464126,25381464121,-5,1265,2048,20
25387332986,25387332982,-4,894,2420,20
25397181377,25397181378,1,1736,1933,20
25400110123,25400110123,0,951,1662,20
25402960933,25402960928,-5,2347,7149,20
25406018162,25406018158,-4,1051,2949,20
25410598072,25410598070,-2,1306,1902,20
25413368498,25413368495,-3,879,2486,20
25413450406,25413450425,19,804,2323,20
25417731953,25417731950,-3,908,1449,20
25422750823,25422750820,-3,1229,3689,20
25438959948,25438959946,-2,1023,2654,20
25443773854,25443773850,-4,1229,2302,20
25444374906,25444374902,-4,781,1101,20
25448477474,25448477473,-1,1148,3227,20
25449119529,25449119529,0,1114,1762,20
25452157906,25452157903,-3,948,1699,20
25452914564,25452914563,-1,924,1543,20
25455172157,25455172155,-2,657,3051,20
25458152277,25458152274,-3,1013,2790,20
25458999586,25458999589,3,1865,940,20
25460973499,25460973494,-5,1384,2630,20
25461396889,25461396895,6,4185,1284,20
25463403363,25463403361,-2,1201,2091,20
25466775129,25466775126,-3,900,2225,20
25467048514,25467048511,-3,1519,2869,20
25467415843,25467415842,-1,1180,1987,20
25473915846,25473915849,3,2297,1119,20
25477849641,25477849645,4,1894,1065,20
25478384727,25478384730,3,2777,1734,20
25480461005,25480461002,-3,1419,3378,20
25481384216,25481384214,-2,38108,16794,20
25485309214,25485309211,-3,1303,2277,20
25490811114,25490811111,-3,1188,2069,20
25493335290,25493335286,-4,911,1577,20
25493954490,25493954489,-1,1259,2057,20
25500748128,25500748123,-5,730,2645,20
25507878991,25507878987,-4,1336,2605,20
25510018646,25510018641,-5,1335,2830,20
25512215902,25512215901,-1,1215,1854,20
25512241803,25512241797,-6,1115,4334,20
25512494876,25512494858,-18,1161,2615,20
25516170172,25516170171,-1,1413,1837,20
25517046074,25517046070,-4,750,1879,20
25521692909,25521692906,-3,870,2246,20
25528017750,25528017749,-1,1329,1735,20
25528490079,25528490076,-3,1106,1877,20
25539909665,25539909662,-3,1215,1941,20
25544060460,25544060457,-3,970,1220,20
25547354613,25547354616,3,3276,2216,20
25548214050,25548214047,-3,858,2375,20
25550589976,25550589975,-1,1215,2630,20
25552382343,25552382341,-2,1303,2879,20
25557433257,25557433253,-4,1635,3536,20
25560331929,25560331927,-2,1248,2388,20
25561740898,25561740896,-2,1638,2417,20
25562166871,25562166852,-19,1281,2485,20
25563216178,25563216177,-1,1602,1953,20
25563756421,25563756416,-5,1020,2746,20
25567161260,25567161257,-3,1405,2761,20
25568286408,25568286405,-3,1071,2388,20
25578856707,25578856702,-5,1400,2470,20
25580733314,25580733313,-1,909,1460,20
25592862157,25592862153,-4,1436,2997,20
25596048186,25596048183,-3,967,2120,20
25596241362,25596241358,-4,854,2373,20
25602601568,25602601566,-2,954,1960,20
25603835388,25603835386,-2,804,1561,20
25605695598,25605695593,-5,1060,2680,20
25613413055,25613413054,-1,1166,2169,20
25616751158,25616751155,-3,664,1663,20
25622728042,25622728040,-2,1675,2787,20
25626178143,25626178141,-2,1232,2033,20
25626312871,25626312866,-5,885,1702,20
25632358669,25632358666,-3,842,1169,20
25633381150,25633381150,0,1429,2174,20
25633476213,25633476204,-9,1262,2288,20
25635025470,25635025467,-3,1240,2335,20
25637655779,25637655776,-3,1135,2656,20
25644891928,25644891924,-4,1188,2706,20
25645867431,25645867426,-5,25857,13039,20
25653067884,25653067881,-3,1733,2955,20
25654240891,25654240889,-2,1253,2630,20
25656623546,25656623555,9,12659,23701,20
25657025790,25657025787,-3,983,1762,20
25660581426,25660581425,-1,1395,1553,20
25662158994,25662158993,-1,1068,2306,20
25665141275,25665141270,-5,1120,2237,20
25665818590,25665818587,-3,663,2586,20
25666907218,25666907213,-5,1207,1561,20
25667613824,25667613842,18,453,1227,20
25677061697,25677061700,3,2620,1735,20
25677296204,25677296207,3,1129,2074,20
25678876361,25678876358,-3,1236,3139,20
25679753582,25679753601,19,970,1743,20
25680041507,25680041506,-1,615,2292,20
25680697660,25680697657,-3,1215,2412,20
25683777157,25683777155,-2,892,3685,20
25687094266,25687094264,-2,1079,2536,20
25689334053,25689334051,-2,1521,1842,20
25690046410,25690046408,-2,1280,2689,20
25693455342,25693455341,-1,1067,2068,20
25694161371,25694161365,-6,917,1980,20
25696522585,25696522583,-2,1229,2408,20
25703074731,25703074730,-1,1659,1325,20
25703839195,25703839190,-5,736,2812,20
25704825112,25704825122,10,14407,35790,20
25704935586,25704935581,-5,1236,2882,20
25715739914,25715739914,0,1454,2336,20
25716399942,25716399943,1,779,1098,20
25718865189,25718865195,6,4386,1071,20
25723386941,25723386937,-4,1216,2792,20
25723764092,25723764098,6,4563,2323,20
25724497938,25724497934,-4,1574,3961,20
25728678712,25728678709,-3,972,2517,20
25732472770,25732472767,-3,1139,2209,20
25733004789,25733004786,-3,1408,2738,20
25734982043,25734982040,-3,825,1698,20
25741775265,25741775264,-1,1281,2285,20
25744449803,25744449801,-2,1251,2235,20
25744966867,25744966865,-2,920,1421,20
25749074426,25749074422,-4,743,3071,20
25751062626,25751062623,-3,1369,2513,20
25755162342,25755162340,-2,1068,1689,20
25755604675,25755604671,-4,727,2032,20
25755840660,25755840667,7,251,785,20
25757232021,25757232025,4,1902,1507,20
25761413055,25761413051,-4,1053,2754,20
25765113739,25765113737,-2,1068,1375,20
25772757494,25772757504,10,14345,36294,20
25775909905,25775909901,-4,1355,3142,20
25784931883,25784931881,-2,1025,2107,20
25785450282,25785450277,-5,909,2152,20
25787456857,25787456854,-3,1035,2777,20
25788564375,25788564374,-1,714,2626,20
25788751610,25788751606,-4,1028,2148,20
25791229721,25791229716,-5,947,4208,20
25792133689,25792133690,1,1189,1677,20
25793879482,25793879480,-2,1874,2665,20
25797987146,25797987143,-3,1243,3085,20
25798648755,25798648752,-3,1120,2347,20
25802286422,25802286442,20,303,1937,20
25806779667,25806779665,-2,551,1771,20
25810570517,25810570514,-3,1053,2801,20
25811265562,25811265560,-2,1229,1810,20
25819705820,25819705814,-6,1215,3391,20
25821865637,25821865626,-11,55,414,20
25823921470,25823921468,-2,993,1628,20
25824470835,25824470832,-3,980,2468,20
25826101274,25826101281,7,4052,2363,20
25828847594,25828847590,-4,995,2674,20
25829069623,25829069619,-4,876,2160,20
25837184587,25837184582,-5,873,1994,20
25837839632,25837839626,-6,858,3368,20
25839890733,25839890730,-3,1182,2118,20
25846231664,25846231666,2,1647,1752,20
25846491332,25846491330,-2,1368,1281,20
25847811046,25847811043,-3,837,2746,20
25849148510,25849148508,-2,1241,1968,20
25849571947,25849571945,-2,1066,1804,20
25852941593,25852941601,8,8983,2114,20
25853720326,25853720343,17,442,913,20
25856880693,25856880691,-2,784,2050,20
25859209386,25859209385,-1,1001,1726,20
25859732509,25859732502,-7,1959,7091,20
25860201411,25860201409,-2,1114,1660,20
25865385349,25865385346,-3,1658,2475,20
25874188835,25874188835,0,761,1645,20
25877619764,25877619770,6,4022,1473,20
25878275877,25878275872,-5,1728,8918,20
25879690843,25879690839,-4,1340,2757,20
25882635155,25882635150,-5,1091,2901,20
25884267298,25884267297,-1,764,1224,20
25885150410,25885150412,2,1868,1603,20
25889579667,25889579662,-5,1089,3133,20
25892359418,25892359415,-3,726,2454,20
25896700131,25896700128,-3,706,2259,20
25898493827,25898493824,-3,1395,3201,20
25903295080,25903295078,-2,1285,2868,20
25906753642,25906753640,-2,1039,2273,20
25908056081,25908056080,-1,1019,1706,20
25909921412,25909921402,-10,25918,16064,20
25911357257,25911357253,-4,1334,1971,20
25912288796,25912288794,-2,1340,2148,20
25912779419,25912779417,-2,5176,10831,20
25913150900,25913150896,-4,842,1648,20
25915907506,25915907503,-3,1072,2007,20
25917594131,25917594129,-2,1231,2803,20
25923919214,25923919212,-2,1027,1952,20
25932799455,25932799459,4,3289,2156,20
25932998231,25932998229,-2,809,1826,20
25942557967,25942557965,-2,911,1975,20
25946072281,25946072277,-4,1387,2551,20
25946273529,25946273526,-3,1276,2828,20
25946897742,25946897734,-8,898,1738,20
25947753614,25947753609,-5,803,2175,20
25949633913,25949633911,-2,656,1651,20
25951846796,25951846794,-2,1099,1891,20
25954608279,25954608277,-2,995,2991,20
25955864855,25955864853,-2,1340,2105,20
25964078150,25964078147,-3,2222,5170,20
25965239047,25965239041,-6,1071,2668,20
25972442130,25972442126,-4,1056,2549,20
25972758176,25972758175,-1,1313,3396,20
25974321172,25974321169,-3,1085,3141,20
25976221054,25976221049,-5,901,2616,20
25977111482,25977111481,-1,889,1855,20
25979263405,25979263401,-4,1237,1600,20
25983207812,25983207810,-2,1355,1761,20
25984007518,25984007538,20,757,2673,20
25984460810,25984460807,-3,998,1989,20
25991288390,25991288386,-4,1235,2971,20
25992148466,25992148465,-1,1150,1695,20
25992210452,25992210470,18,1514,3312,20
25992620334,25992620333,-1,712,2538,20
25994036590,25994036586,-4,1076,2485,20
25995025989,25995025985,-4,1645,2486,20
25996561190,25996561188,-2,1106,1916,20
25998525986,25998525983,-3,759,1962,20
25999022180,25999022173,-7,1165,2742,20
26001522442,26001522438,-4,1033,2090,20
26001750622,26001750618,-4,1236,1561,20
26004486856,26004486850,-6,1359,3491,20
26004915510,26004915509,-1,1351,1796,20
26008836629,26008836627,-2,1755,3901,20
26015517869,26015517865,-4,932,2422,20
26020391201,26020391194,-7,1112,4121,20
26024052406,26024052402,-4,1230,2077,20
26026159030,26026159027,-3,1433,2561,20
26027403539,26027403535,-4,1099,2013,20
26028412823,26028412818,-5,1016,1792,20
26031397118,26031397118,0,1086,1850,20
26035307568,26035307565,-3,1285,3308,20
26035884936,26035884955,19,597,2982,20
26039708426,26039708423,-3,1207,1807,20
26040116336,26040116332,-4,1278,3510,20
26042950959,26042950950,-9,836,2436,20
26044829882,26044829881,-1,993,2804,20
26045868912,26045868907,-5,1069,3128,20
26046844015,26046844010,-5,865,3086,20
26047811724,26047811721,-3,1166,2406,20
26053871151,26053871153,2,850,2171,20
26054180958,26054180964,6,3345,1411,20
26054647454,26054647453,-1,1284,2088,20
26055114158,26055114156,-2,799,1669,20
26062439918,26062439915,-3,1243,3129,20
26064406887,26064406907,20,1401,1348,20
26065313073,26065313070,-3,1347,2408,20
26069742061,26069742055,-6,1130,2420,20
26071399493,26071399482,-11,26648,18028,20
26072962474,26072962471,-3,1008,1837,20
26076700371,26076700370,-1,1143,2388,20
26077370252,26077370250,-2,1142,1822,20
26078319142,26078319149,7,356,1504,20
26088275659,26088275656,-3,1107,2219,20
26090593944,26090593939,-5,1245,2582,20
26103054776,26103054772,-4,1368,3393,20
26104903899,26104903897,-2,1023,2864,20
26108246990,26108246990,0,1028,1556,20
26110156865,26110156871,6,2219,2230,20
26114366321,26114366320,-1,886,2090,20
26116080530,26116080527,-3,1029,1946,20
26116176213,26116176200,-13,1116,2172,20
26121334829,26121334825,-4,665,2775,20
26132678705,26132678700,-5,794,2072,20
26132888198,26132888218,20,1245,2212,20
26134202206,26134202206,0,1145,2448,20
26143145013,26143145010,-3,1067,2231,20
26144245790,26144245793,3,3466,2209,20
26144901528,26144901528,0,1813,1642,20
26148911562,26148911559,-3,942,2195,20
26150829455,26150829454,-1,1375,1765,20
26152521642,26152521640,-2,1445,1801,20
26155184630,26155184626,-4,1339,2974,20
26155871902,26155871898,-4,1006,2159,20
26156152966,26156152966,0,1130,1892,20
26158304986,26158304986,0,1146,1720,20
26161494292,26161494290,-2,1164,2487,20
26164734321,26164734326,5,2882,1553,20
26164974450,26164974447,-3,1087,2057,20
26166182704,26166182701,-3,1154,2206,20
26168566114,26168566108,-6,1152,2862,20
26172798956,26172798950,-6,1163,3087,20
26181810099,26181810098,-1,1051,1850,20
26182073906,26182073904,-2,1201,2561,20
26182343831,26182343848,17,920,2019,20
26187229476,26187229472,-4,1228,3313,20
26190961423,26190961422,-1,621,1120,20
26191243802,26191243799,-3,991,2777,20
26194322277,26194322275,-2,1027,1833,20
26196202838,26196202834,-4,927,2027,20
26201310614,26201310611,-3,789,2241,20
26204885268,26204885264,-4,1012,2993,20
26205348886,26205348883,-3,1080,2445,20
26206640830,26206640830,0,990,1894,20
26208263746,26208263740,-6,2436,7866,20
26210587293,26210587286,-7,1352,2509,20
26215539982,26215539984,2,1372,1847,20
26216292720,26216292721,1,6667,6681,20
26220828421,26220828417,-4,1317,2969,20
26225009927,26225009924,-3,1491,2714,20
26228211927,26228211922,-5,1041,2204,20
26231881586,26231881585,-1,922,2493,20
26234754843,26234754841,-2,1211,2510,20
26236996101,26236996107,6,4717,1247,20
26241585234,26241585232,-2,1137,1858,20
26251535410,26251535406,-4,1357,2349,20
26254353273,26254353269,-4,831,1496,20
26257798855,26257798853,-2,1465,2003,20
26258823881,26258823877,-4,1126,3170,20
26262413562,26262413559,-3,990,1858,20
26266856667,26266856664,-3,922,1568,20
26270332618,26270332617,-1,906,2312,20
26270931698,26270931699,1,1176,1513,20
26272627871,26272627868,-3,805,2085,20
26273408738,26273408738,0,960,1601,20
26275370651,26275370649,-2,607,1490,20
26277253806,26277253805,-1,1045,2144,20
26283951232,26283951227,-5,1464,3840,20
26286763363,26286763361,-2,1196,2756,20
26287275275,26287275271,-4,1056,2038,20
26288272369,26288272365,-4,2117,4543,20
26289456993,26289456990,-3,1221,2740,20
26289970101,26289970098,-3,939,2440,20
26292032326,26292032330,4,2838,1727,20
26292495325,26292495310,-15,790,2045,20
26295876576,26295876572,-4,982,2220,20
26298134999,26298134996,-3,1128,1558,20
26307912621,26307912626,5,1794,1444,20
26308798822,26308798818,-4,2844,8244,20
26308948003,26308948001,-2,936,2273,20
26309165559,26309165579,20,375,1065,20
26311195659,26311195657,-2,988,2579,20
26314613494,26314613491,-3,1721,3237,20
26314765593,26314765592,-1,990,1454,20
26316448755,26316448754,-1,1306,2720,20
26316781423,26316781419,-4,1069,2396,20
26320007551,26320007549,-2,1096,2054,20
26320319872,26320319869,-3,887,2764,20
26323158402,26323158397,-5,1475,7594,20
26324885399,26324885396,-3,1201,2899,20
26326182256,26326182241,-15,3212,1013,20
26326832090,26326832095,5,2886,1416,20
26331017707,26331017702,-5,1018,2183,20
26333421075,26333421076,1,1777,1496,20
26338009651,26338009655,4,1676,1001,20
26342214829,26342214826,-3,499,1522,20
26346309743,26346309741,-2,1103,1963,20
26349172974,26349172970,-4,819,3912,20
26351385672,26351385671,-1,1079,2035,20
26351973934,26351973929,-5,950,2201,20
26356117513,26356117509,-4,1073,2419,20
26356878929,26356878927,-2,1198,1856,20
26359524509,26359524505,-4,842,2040,20
26360504565,26360504562,-3,676,1758,20
26361311600,26361311597,-3,1353,2568,20
26362174187,26362174186,-1,2504,4691,20
26362954419,26362954418,-1,1120,1477,20
26364764257,26364764253,-4,896,1949,20
26367289162,26367289160,-2,1165,1753,20
26369184510,26369184506,-4,1405,3076,20
26373300778,26373300774,-4,604,1666,20
26375423349,26375423345,-4,1382,4201,20
26376975818,26376975800,-18,1891,355,20
26385462454,26385462452,-2,1215,2618,20
26391166607,26391166605,-2,1172,3753,20
26391762693,26391762681,-12,926,1887,20
26392351251,26392351248,-3,966,2090,20
26392614741,26392614723,-18,141,456,20
26399339679,26399339676,-3,1127,2776,20
26399729821,26399729825,4,1971,1386,20
26399966247,26399966245,-2,1086,2263,20
26400706962,26400706961,-1,1170,2495,20
26401928054,26401928061,7,5985,2740,20
26403755351,26403755346,-5,973,1575,20
26403999022,26403999042,20,1104,2574,20
26404844197,26404844194,-3,1559,2580,20
26405335593,26405335590,-3,770,2322,20
26410771999,26410771998,-1,1248,2476,20
26412874121,26412874127,6,2203,1146,20
26413540467,26413540463,-4,1033,2302,20
26415036478,26415036475,-3,1613,3319,20
26415854516,26415854512,-4,1151,3042,20
26419697814,26419697810,-4,1114,2271,20
26422292665,26422292666,1,1827,2410,20
26422735730,26422735730,0,1163,2082,20
26423092475,26423092470,-5,1489,3865,20
26423842765,26423842763,-2,680,1703,20
26424742181,26424742177,-4,1262,2892,20
26425231314,26425231314,0,1431,1681,20
26429614538,26429614543,5,1364,843,20
26440454587,26440454586,-1,788,2178,20
26443717475,26443717471,-4,1089,1780,20
26445380418,26445380415,-3,1014,3121,20
26449208105,26449208102,-3,818,1989,20
26450177866,26450177865,-1,1492,3480,20
26450665566,26450665545,-21,1317,2426,20
26451821959,26451821939,-20,938,3364,20
26452130622,26452130614,-8,903,2429,20
26454682050,26454682046,-4,1226,2981,20
26459877454,26459877453,-1,1021,2116,20
26460266405,26460266403,-2,769,2098,20
26478111899,26478111898,-1,1305,2299,20
26484761103,26484761102,-1,985,2516,20
26486294242,26486294240,-2,1211,2663,20
26491199499,26491199498,-1,1084,2511,20
26494859216,26494859213,-3,1014,2196,20
26498613466,26498613462,-4,1261,1850,20
26502915187,26502915184,-3,1502,1953,20
26503191314,26503191310,-4,1361,2553,20
26507385151,26507385152,1,2261,1893,20
26507680591,26507680589,-2,1763,2740,20
26508531818,26508531814,-4,1246,3189,20
26510533718,26510533714,-4,717,1012,20
26510882449,26510882446,-3,1262,2058,20
26511550971,26511550969,-2,827,1145,20
26513395302,26513395301,-1,787,1982,20
26514264743,26514264739,-4,971,2297,20
26514306956,26514306978,22,1582,2920,20
26514493799,26514493797,-2,1384,2274,20
26517454882,26517454878,-4,867,2440,20
26517680216,26517680219,3,217,751,20
26521061059,26521061055,-4,1402,2533,20
26525239215,26525239215,0,894,2164,20
26529731449,26529731446,-3,1091,2210,20
26532509322,26532509318,-4,989,1800,20
26532796719,26532796715,-4,1228,2114,20
26535105923,26535105918,-5,922,2230,20
26535197159,26535197166,7,7059,2888,20
26536443166,26536443177,11,13697,21816,20
26536551680,26536551673,-7,876,2825,20
26539334162,26539334166,4,2540,2145,20
26540925915,26540925911,-4,1050,2438,20
26541172046,26541172045,-1,829,1439,20
26542083782,26542083778,-4,890,3080,20
26544117917,26544117915,-2,1114,1592,20
26547494577,26547494576,-1,1215,2402,20
26549067707,26549067705,-2,1016,2107,20
26550462443,26550462443,0,1153,2089,20
26551101387,26551101384,-3,1318,4018,20
26552777417,26552777414,-3,1361,3274,20
26553445834,26553445831,-3,851,2047,20
26553768560,26553768578,18,296,3283,20
26558430781,26558430781,0,2105,2046,20
26562581565,26562581564,-1,918,1562,20
26563045997,26563045995,-2,1499,2682,20
26563476341,26563476337,-4,1528,2863,20
26565637382,26565637379,-3,980,1581,20
26566105069,26566105066,-3,1360,2099,20
26567183862,26567183859,-3,1594,2066,20
26569238639,26569238635,-4,1080,2386,20
26571354670,26571354665,-5,1348,2140,20
26574520303,26574520303,0,1088,1642,20
26576456545,26576456540,-5,1902,3243,20
26578969108,26578969105,-3,1149,2297,20
26585483810,26585483806,-4,1557,2922,20
26586494851,26586494850,-1,1345,1866,20
26589116257,26589116256,-1,11544,50460,20
26598804585,26598804582,-3,1145,2071,20
26599742342,26599742338,-4,1404,3227,20
26602527225,26602527222,-3,893,3024,20
26603246731,26603246727,-4,797,2302,20
26610010410,26610010406,-4,1137,2191,20
26613584083,26613584078,-5,620,1761,20
26616020609,26616020602,-7,1090,3051,20
26617100456,26617100453,-3,1694,2865,20
26623788474,26623788476,2,849,1113,20
26624218493,26624218489,-4,1054,1920,20
26625065762,26625065759,-3,891,2227,20
26628539889,26628539886,-3,1626,2951,20
26630165919,26630165915,-4,659,1480,20
26635272939,26635272934,-5,1418,2959,20
26643965653,26643965649,-4,1204,2545,20
26649538611,26649538609,-2,1460,2894,20
26650895022,26650895016,-6,1379,5305,20
26652261082,26652261078,-4,1313,2014,20
26656805649,26656805646,-3,1276,2541,20
26663356599,26663356594,-5,1170,3292,20
26663639726,26663639718,-8,1330,2175,20
26664525606,26664525602,-4,815,1728,20
26666702918,26666702915,-3,1011,1839,20
26670123824,26670123822,-2,1199,1951,20
26675526863,26675526859,-4,1065,2489,20
26676493283,26676493281,-2,916,1989,20
26677546527,26677546523,-4,743,1892,20
26678087752,26678087750,-2,1227,2378,20
26678448251,26678448250,-1,1228,1166,20
26687734314,26687734316,2,2355,2701,20
26688369862,26688369861,-1,1442,2569,20
26688625479,26688625471,-8,1369,2268,20
26690461062,26690461061,-1,1376,2109,20
26691213670,26691213677,7,2449,2220,20
26694558446,26694558441,-5,612,2472,20
26701232056,26701232054,-2,1163,2916,20
26702424489,26702424491,2,1240,931,20
26709875670,26709875669,-1,1135,2167,20
26710690939,26710690935,-4,938,2017,20
26712945874,26712945882,8,38636,2176,20
26715142108,26715142106,-2,1302,2100,20
26715515150,26715515149,-1,1579,2656,20
26717033403,26717033398,-5,1020,1989,20
26719540886,26719540883,-3,1332,1662,20
26723161672,26723161669,-3,1099,1889,20
26727292289,26727292285,-4,1194,1759,20
26728143430,26728143427,-3,925,2134,20
26729815359,26729815359,0,1235,2081,20
26739108304,26739108302,-2,1097,1461,20
26741406056,26741406057,1,2545,1492,20
26744130469,26744130469,0,1479,1663,20
26748403599,26748403597,-2,684,1983,20
26749158763,26749158760,-3,949,2282,20
26749831638,26749831637,-1,1301,1851,20
26749974438,26749974455,17,969,2089,20
26750681804,26750681802,-2,1086,2335,20
26760770061,26760770058,-3,1187,3296,20
26761309417,26761309422,5,1949,1407,20
26771058453,26771058449,-4,991,2323,20
26773326779,26773326774,-5,981,2879,20
26773366398,26773366415,17,437,1184,20
26774773082,26774773079,-3,796,2249,20
26776012578,26776012581,3,2982,3053,20
26778224287,26778224283,-4,814,1953,20
26780421167,26780421162,-5,930,2457,20
26781562542,26781562537,-5,938,5005,20
26784398697,26784398694,-3,1502,2681,20
26784427474,26784427470,-4,1288,2119,20
26784631207,26784631227,20,770,2168,20
26785072846,26785072843,-3,801,1502,20
26788396859,26788396866,7,4461,1956,20
26794895969,26794895966,-3,1109,3269,20
26801404749,26801404749,0,9698,12182,20
26801740584,26801740578,-6,807,2332,20
26803266558,26803266555,-3,879,2271,20
26805003918,26805003914,-4,780,2139,20
26807122713,26807122710,-3,1148,2302,20
26810222106,26810222104,-2,1167,2388,20
26811607658,26811607657,-1,1157,2547,20
26812738814,26812738812,-2,829,1545,20
26813196303,26813196297,-6,1023,2020,20
26818892774,26818892770,-4,1204,1798,20
26819315486,26819315507,21,1106,1806,20
26819800819,26819800818,-1,1423,3194,20
26820193943,26820193941,-2,1054,3231,20
26822710009,26822709994,-15,376,7261,20
26823618864,26823618870,6,2539,1619,20
26830876037,26830876033,-4,1356,2387,20
26831883431,26831883430,-1,1129,2281,20
26835497365,26835497358,-7,2475,5672,20
26843082923,26843082920,-3,935,2711,20
26844016382,26844016379,-3,1143,2000,20
26847127623,26847127621,-2,1161,1594,20
26851452867,26851452863,-4,937,3104,20
26854639784,26854639778,-6,1568,3288,20
26856776718,26856776719,1,1510,1591,20
26857790058,26857790055,-3,794,1419,20
26858001660,26858001652,-8,843,1473,20
26859451376,26859451372,-4,674,1477,20
26859848152,26859848150,-2,888,1608,20
26861193818,26861193816,-2,787,2338,20
26866493195,26866493191,-4,1280,2766,20
26869007122,26869007121,-1,1308,2088,20
26871230202,26871230194,-8,843,5021,20
26873476438,26873476434,-4,1142,2758,20
26874192438,26874192434,-4,1049,2740,20
26878622637,26878622634,-3,1290,3287,20
26879381284,26879381282,-2,837,1630,20
26880273152,26880273165,13,739,3039,20
26882409210,26882409207,-3,671,2365,20
26883997552,26883997570,18,1097,2784,20
26885204458,26885204457,-1,1300,1455,20
26888486898,26888486892,-6,1253,3926,20
26890923298,26890923293,-5,1917,5346,20
26892339896,26892339894,-2,1039,1443,20
26893192526,26893192522,-4,1109,2412,20
26898250721,26898250719,-2,698,2137,20
26904373438,26904373437,-1,934,2234,20
26905499182,26905499179,-3,1422,3139,20
26911116075,26911116073,-2,1751,1784,20
26913213175,26913213171,-4,963,1731,20
26918613718,26918613715,-3,855,2991,20
26920896019,26920896018,-1,867,1896,20
26923999623,26923999621,-2,792,2413,20
26926368614,26926368609,-5,774,1881,20
26933668795,26933668791,-4,1311,3213,20
26952286597,26952286595,-2,848,1498,20
26955299143,26955299138,-5,1217,2332,20
26958359951,26958359950,-1,1120,2453,20
26961709302,26961709297,-5,1223,3130,20
26962140035,26962140033,-2,899,2520,20
26963497346,26963497344,-2,1102,1425,20
26963998251,26963998251,0,1203,1818,20
26965788771,26965788766,-5,1132,2079,20
26967235606,26967235603,-3,1129,2160,20
26970683998,26970683996,-2,930,2168,20
26971390628,26971390618,-10,1076,2063,20
26971608894,26971608887,-7,1754,8683,20
26973666293,26973666290,-3,1340,2849,20
26982703493,26982703491,-2,856,1715,20
26983373749,26983373742,-7,1071,2760,20
26983802800,26983802819,19,855,1874,20
26985194186,26985194183,-3,1186,3140,20
26988531310,26988531309,-1,919,2466,20
26993453281,26993453274,-7,1090,2529,20
26993489501,26993489498,-3,1378,2198,20
26993588987,26993588981,-6,1751,4349,20
26994200978,26994200977,-1,1050,1408,20
26995116956,26995116953,-3,993,2667,20
26997535132,26997535128,-4,982,1954,20
26998542544,26998542551,7,4063,780,20
27000409105,27000409107,2,2035,1872,20
27002462859,27002462857,-2,1237,2734,20
27004229010,27004229006,-4,1628,2476,20
27004999775,27004999774,-1,1015,2295,20
27006077802,27006077799,-3,921,1813,20
27013591377,27013591375,-2,1432,2698,20
27016029553,27016029551,-2,1268,2204,20
27016083832,27016083830,-2,1011,1957,20
27023222797,27023222795,-2,1206,2409,20
27024970095,27024970091,-4,1052,2317,20
27026941340,27026941338,-2,1010,1855,20
27028567525,27028567523,-2,1202,2475,20
27038620502,27038620501,-1,1110,1369,20
27039655899,27039655895,-4,1226,2765,20
27040510445,27040510441,-4,1088,3057,20
27047546368,27047546367,-1,1171,1776,20
27052046619,27052046617,-2,1287,2593,20
27056904405,27056904401,-4,1398,1906,20
27060693953,27060693947,-6,1189,3295,20
27067486157,27067486155,-2,1045,2964,20
27070251373,27070251371,-2,1466,2522,20
27073513717,27073513717,0,1391,1109,20
27083737902,27083737901,-1,1124,1978,20
27084936002,27084935998,-4,1136,2518,20
27085610958,27085610954,-4,1404,3263,20
27092684552,27092684549,-3,1180,1987,20
27093024045,27093024041,-4,1232,2138,20
27094211290,27094211286,-4,1319,2485,20
27098945710,27098945709,-1,1074,2477,20
27099506467,27099506474,7,3677,1519,20
27099541249,27099541245,-4,960,2171,20
27101712815,27101712810,-5,958,1663,20
27103456430,27103456429,-1,1271,2033,20
27104128333,27104128331,-2,730,1364,20
27104822725,27104822744,19,327,970,20
27105895702,27105895699,-3,1175,2483,20
27108657411,27108657412,1,1175,2343,20
27115629655,27115629653,-2,1004,2268,20
27122676355,27122676351,-4,922,1793,20
27124787199,27124787194,-5,789,2448,20
27127349302,27127349298,-4,957,2418,20
27139110752,27139110748,-4,1144,2073,20
27139145640,27139145637,-3,924,1392,20
27147263187,27147263183,-4,1561,2767,20
27149712938,27149712935,-3,1262,2122,20
27150902694,27150902689,-5,936,2437,20
27157205531,27157205528,-3,1473,2907,20
27158662419,27158662415,-4,888,2901,20
27159893066,27159893062,-4,1137,2077,20
27165692229,27165692226,-3,1230,2076,20
27169530436,27169530441,5,26188,27010,20
27171595856,27171595856,0,486,1378,20
27172106648,27172106666,18,345,1491,20
27172457343,27172457339,-4,1026,2240,20
27179360786,27179360783,-3,1311,3042,20
27179794933,27179794929,-4,1215,2492,20
27180223161,27180223160,-1,865,2311,20
27186625050,27186625048,-2,1114,2075,20
27187235362,27187235361,-1,1041,1717,20
27188248438,27188248435,-3,988,1706,20
27192840655,27192840650,-5,1449,3473,20
27193498482,27193498479,-3,1174,2893,20
27195880721,27195880724,3,3361,1924,20
27202857208,27202857205,-3,1442,1853,20
27205662490,27205662485,-5,982,2563,20
27208130886,27208130885,-1,1018,3123,20
27213278691,27213278689,-2,735,1913,20
27215910583,27215910582,-1,1287,2571,20
27223234174,27223234171,-3,1089,2001,20
27224394056,27224394054,-2,820,1659,20
27225036599,27225036598,-1,1057,2395,20
27226378210,27226378206,-4,1247,2709,20
27229233642,27229233638,-4,1140,3191,20
27235803714,27235803710,-4,954,1757,20
27241622408,27241622403,-5,867,2211,20
27244954977,27244954974,-3,1234,2104,20
27246404439,27246404437,-2,1347,2799,20
27246581488,27246581483,-5,974,2390,20
27247043946,27247043942,-4,1508,2557,20
27249812085,27249812082,-3,784,2163,20
27250808402,27250808399,-3,21609,52559,20
27252657666,27252657666,0,1234,2350,20
27253276064,27253276061,-3,1106,2347,20
27257086814,27257086812,-2,1509,2656,20
27258609410,27258609406,-4,1245,2777,20
27262018756,27262018754,-2,1463,1808,20
27262902449,27262902446,-3,975,2450,20
27268360950,27268360945,-5,1424,4355,20
27269377417,27269377415,-2,1007,1750,20
27270538475,27270538473,-2,1171,2245,20
27278133575,27278133573,-2,1382,2625,20
27278304075,27278304070,-5,1243,1993,20
27279085782,27279085778,-4,990,2968,20
27279327978,27279327977,-1,855,2140,20
27281631139,27281631136,-3,1291,1847,20
27283293470,27283293471,1,2712,2576,20
27292563763,27292563760,-3,1383,3199,20
27297075136,27297075153,17,1142,2060,20
27297739506,27297739505,-1,1241,2311,20
27298621295,27298621294,-1,1204,2388,20
27299733598,27299733603,5,2555,1264,20
27302383008,27302383003,-5,911,2760,20
27302853662,27302853658,-4,2588,5169,20
27310092208,27310092206,-2,1037,2049,20
27311477388,27311477384,-4,1136,2658,20
27313732153,27313732147,-6,1297,2135,20
27315757847,27315757843,-4,802,2616,20
27315785902,27315785919,17,813,1897,20
27317840470,27317840450,-20,1551,1855,20
27318224135,27318224131,-4,915,2887,20
27318806182,27318806183,1,1029,1805,20
27320818407,27320818405,-2,873,2582,20
27325627874,27325627871,-3,960,1793,20
27326799509,27326799509,0,1279,1782,20
27330339940,27330339938,-2,1157,2172,20
27331631164,27331631183,19,156,1381,20
27335535859,27335535853,-6,1667,2649,20
27344637564,27344637561,-3,1546,2951,20
27352342166,27352342168,2,614,1124,20
27355147623,27355147621,-2,1602,3010,20
27355965441,27355965438,-3,754,2058,20
27357523061,27357523054,-7,859,2297,20
27365870970,27365870970,0,1246,1949,20
27367156955,27367156953,-2,898,2571,20
27377308262,27377308258,-4,1479,2087,20
27378197659,27378197659,0,1302,1905,20
27378896938,27378896934,-4,1628,2742,20
27382659587,27382659586,-1,911,1818,20
27384490505,27384490503,-2,1152,2534,20
27384971686,27384971685,-1,1025,1836,20
27385096478,27385096474,-4,1089,1593,20
27398659205,27398659203,-2,911,2333,20
27399837982,27399837981,-1,1517,2268,20
27403345814,27403345811,-3,1640,2368,20
27403830216,27403830214,-2,1088,2078,20
27410271039,27410271033,-6,1447,1887,20
27414711261,27414711258,-3,1419,2687,20
27415563393,27415563388,-5,1380,1932,20
27415841908,27415841893,-15,195,983,20
27417001537,27417001533,-4,1330,2601,20
27417168129,27417168125,-4,828,1684,20
27418901004,27418901001,-3,1398,2658,20
27418998844,27418998842,-2,707,2381,20
27422582897,27422582893,-4,1550,2567,20
27422696779,27422696773,-6,589,1904,20
27424534618,27424534618,0,1611,2461,20
27425060865,27425060862,-3,1107,2402,20
27435453323,27435453316,-7,1241,5057,20
27436304718,27436304716,-2,898,1923,20
27440300659,27440300654,-5,785,2273,20
27441667402,27441667402,0,1078,2541,20
27441942940,27441942962,22,221,1714,20
27444181322,27444181318,-4,1233,2567,20
27444567053,27444567049,-4,736,2626,20
27444918872,27444918886,14,1105,2145,20
27450005221,27450005218,-3,1697,2991,20
27450753504,27450753499,-5,1325,2607,20
27456615905,27456615902,-3,1366,2444,20
27459466185,27459466182,-3,1715,3093,20
27464810964,27464810962,-2,1572,2583,20
27480519251,27480519249,-2,1489,2422,20
27481476815,27481476813,-2,874,2044,20
27482129109,27482129131,22,623,1813,20
27482892351,27482892354,3,2028,1035,20
27483301874,27483301871,-3,859,1788,20
27490982947,27490982944,-3,1570,2610,20
27492607089,27492607086,-3,1338,2226,20
27501456736,27501456730,-6,1294,2524,20
27506161766,27506161763,-3,943,1675,20
27508534855,27508534851,-4,1152,2576,20
27512938138,27512938128,-10,1419,326,20
27512977663,27512977671,8,108,801,20
27514083643,27514083641,-2,1261,2345,20
27518737530,27518737526,-4,1194,2696,20
27520322932,27520322929,-3,1058,3137,20
27526738412,27526738409,-3,1069,2389,20
27528815078,27528815077,-1,1750,2825,20
27529640008,27529640002,-6,929,3395,20
27530658926,27530658910,-16,1278,2607,20
27532256160,27532256158,-2,1109,2637,20
27532642645,27532642643,-2,1465,2123,20
27550965209,27550965205,-4,1028,2702,20
27554122230,27554122225,-5,755,1971,20
27567243701,27567243697,-4,1367,3332,20
27570798231,27570798229,-2,979,1959,20
27571177826,27571177822,-4,862,2135,20
27573593674,27573593671,-3,1264,1643,20
27573631135,27573631141,6,2,3095,20
27578398793,27578398786,-7,919,5963,20
27578539389,27578539384,-5,1254,3509,20
27583524426,27583524421,-5,961,2739,20
27588002766,27588002763,-3,1010,2337,20
27589561981,27589561978,-3,638,1890,20
27594402581,27594402578,-3,1164,3156,20
27594824890,27594824886,-4,945,1201,20
27596929469,27596929466,-3,1155,3374,20
27597287199,27597287201,2,1300,1586,20
27598649948,27598649945,-3,1437,1694,20
27600881089,27600881089,0,1758,2065,20
27601848543,27601848543,0,1210,1801,20
27602060392,27602060408,16,1021,2363,20
27603279283,27603279278,-5,1911,4933,20
27603956061,27603956068,7,4115,852,20
27606789375,27606789374,-1,1370,1856,20
27607788798,27607788796,-2,1186,1970,20
27608383668,27608383666,-2,965,2661,20
27609975419,27609975415,-4,934,2543,20
27614714441,27614714439,-2,658,1851,20
27617025119,27617025117,-2,1561,2334,20
27620770102,27620770099,-3,1249,2640,20
27621405405,27621405407,2,1826,1332,20
27623409685,27623409687,2,1953,1672,20
27625057405,27625057399,-6,1166,2376,20
27627394331,27627394327,-4,1150,2274,20
27627554239,27627554225,-14,1176,2484,20
27629853902,27629853902,0,1328,1661,20
27637674914,27637674922,8,3213,1164,20
27637986059,27637986057,-2,1324,3108,20
27638129749,27638129769,20,749,3021,20
27640815113,27640815107,-6,1060,3521,20
27641010459,27641010457,-2,1442,1519,20
27641264721,27641264719,-2,1266,1936,20
27641462599,27641462586,-13,1444,2763,20
27641622610,27641622616,6,6471,2743,20
27642404600,27642404598,-2,1122,3008,20
27645185933,27645185930,-3,701,1441,20
27645318335,27645318330,-5,1566,4104,20
27652846871,27652846867,-4,1086,2065,20
27653443495,27653443490,-5,928,2801,20
27658683583,27658683578,-5,732,2760,20
27665032884,27665032882,-2,1824,2508,20
27668697131,27668697128,-3,828,2239,20
27670787303,27670787301,-2,744,3297,20
27680375670,27680375670,0,1274,2485,20
27685568840,27685568845,5,2202,1495,20
27686223598,27686223594,-4,1041,3540,20
27686818126,27686818124,-2,1404,2264,20
27692429875,27692429871,-4,1141,3505,20
27693558157,27693558153,-4,1138,2179,20
27694111381,27694111361,-20,706,598,20
27696397792,27696397790,-2,726,1842,20
27696440101,27696440115,14,231,842,20
27698069937,27698069942,5,2662,1631,20
27702136896,27702136899,3,2686,1716,20
27702457018,27702457017,-1,1202,2352,20
27703686190,27703686187,-3,750,1277,20
27705421253,27705421248,-5,1354,2530,20
27705477199,27705477214,15,353,933,20
27708998377,27708998373,-4,1050,2286,20
27712377503,27712377502,-1,1659,2736,20
27723489123,27723489118,-5,1219,2249,20
27726403154,27726403152,-2,1313,1373,20
27728896496,27728896494,-2,986,2463,20
27729266075,27729266073,-2,836,1781,20
27731850563,27731850560,-3,693,1842,20
27736820595,27736820593,-2,972,3010,20
27740917498,27740917498,0,616,1087,20
27741846474,27741846472,-2,1116,2202,20
27743463697,27743463702,5,57703,26751,20
27743952298,27743952294,-4,1075,2160,20
27746305010,27746305006,-4,833,1077,20
27748873707,27748873714,7,8452,4005,20
27748954155,27748954153,-2,837,1918,20
27760509118,27760509114,-4,1045,1638,20
27761452118,27761452114,-4,1317,2564,20
27763975346,27763975339,-7,2597,6646,20
27766356591,27766356586,-5,1225,3005,20
27767975762,27767975760,-2,1164,2880,20
27769851659,27769851657,-2,1428,2946,20
27771074566,27771074566,0,1656,1492,20
27777697903,27777697899,-4,1370,2844,20
27777859614,27777859610,-4,899,1559,20
27779528436,27779528434,-2,1181,2651,20
27784009170,27784009167,-3,1105,1792,20
27785071734,27785071731,-3,1500,2638,20
27789340823,27789340833,10,14805,24915,20
27790345797,27790345794,-3,1398,2578,20
27793018515,27793018515,0,1558,3221,20
27794653111,27794653112,1,2241,2233,20
27794766618,27794766623,5,12943,20956,20
27796227664,27796227683,19,1439,2886,20
27796706458,27796706455,-3,729,1973,20
27797729807,27797729811,4,2129,1371,20
27800505051,27800505047,-4,1332,2654,20
27800824237,27800824238,1,1348,1802,20
27801259084,27801259082,-2,1917,2847,20
27801817644,27801817641,-3,884,2767,20
27806805647,27806805645,-2,1080,1928,20
27808633536,27808633527,-9,255,1118,20
27810246805,27810246802,-3,1523,1592,20
27813765077,27813765074,-3,881,2000,20
27814717325,27814717347,22,988,1672,20
27823202305,27823202304,-1,943,1335,20
27823792070,27823792076,6,4603,2239,20
27825261738,27825261743,5,1858,1394,20
27827136509,27827136508,-1,1922,2721,20
27829911353,27829911350,-3,1009,2213,20
27832469326,27832469322,-4,1655,3493,20
27834682254,27834682258,4,10984,8134,20
27841987858,27841987854,-4,1167,2416,20
27849822918,27849822918,0,1287,2138,20
27850810542,27850810558,16,1112,2273,20
27851236499,27851236495,-4,1220,2682,20
27856027371,27856027369,-2,1151,3338,20
27857602532,27857602531,-1,1144,2317,20
27860790414,27860790410,-4,1169,2383,20
27861052738,27861052734,-4,1020,3193,20
27861559337,27861559334,-3,1149,2007,20
27864263194,27864263187,-7,1031,2288,20
27864497553,27864497550,-3,1202,2327,20
27865204565,27865204579,14,67,495,20
27869251674,27869251668,-6,1184,2285,20
27871766131,27871766129,-2,1058,2261,20
27874008943,27874008941,-2,1371,3829,20
27876282123,27876282122,-1,784,1945,20
27876760162,27876760160,-2,563,1604,20
27877949682,27877949675,-7,906,2205,20
27888010646,27888010652,6,2274,1692,20
27888166505,27888166509,4,1811,1502,20
27888616664,27888616661,-3,1602,2673,20
27889482385,27889482383,-2,1313,2396,20
27897323677,27897323683,6,2261,1260,20
27902941727,27902941724,-3,1245,2560,20
27909294375,27909294371,-4,1149,1939,20
27912038083,27912038078,-5,1313,3114,20
27914832729,27914832727,-2,1262,2004,20
27920477695,27920477693,-2,804,1616,20
27921037646,27921037632,-14,3316,1277,20
27921892829,27921892825,-4,789,2049,20
27924643353,27924643350,-3,924,1324,20
27927954870,27927954867,-3,1127,2127,20
27931009155,27931009151,-4,1408,1974,20
27937580527,27937580526,-1,955,1894,20
27941391934,27941391936,2,1516,1524,20
27942244747,27942244742,-5,811,3129,20
27945737123,27945737119,-4,1096,2667,20
27947716757,27947716753,-4,493,1268,20
27948782814,27948782812,-2,1295,2375,20
27949502218,27949502214,-4,989,1704,20
27950467419,27950467413,-6,916,3347,20
27951135884,27951135882,-2,1059,3301,20
27954213490,27954213487,-3,780,3004,20
27954525154,27954525150,-4,1367,3278,20
27955867260,27955867280,20,1078,3098,20
27959949026,27959949030,4,744,1399,20
27962305141,27962305138,-3,1050,1793,20
27964495807,27964495805,-2,1493,2319,20
27964588262,27964588262,0,1427,1908,20
27967077322,27967077328,6,17290,29106,20
27970736021,27970736018,-3,814,1362,20
27981136558,27981136553,-5,972,2296,20
27983057716,27983057713,-3,1230,2712,20
27993838625,27993838623,-2,988,2026,20
27996516137,27996516135,-2,1323,2525,20
27998865919,27998865917,-2,724,1241,20
27999632075,27999632071,-4,1253,2944,20
27999857037,27999857034,-3,1359,2565,20
28000690105,28000690101,-4,1154,2817,20
28002035138,28002035135,-3,1722,4551,20
28002745810,28002745806,-4,1041,2912,20
28014956942,28014956937,-5,776,2200,20
28015758663,28015758641,-22,1112,3440,20
28016434814,28016434807,-7,153,899,20
28017058149,28017058148,-1,1025,2353,20
28018326253,28018326249,-4,1105,2821,20
28018796862,28018796861,-1,1200,2047,20
28027909037,28027909034,-3,979,2108,20
28046130157,28046130154,-3,1204,2640,20
28049179058,28049179054,-4,1908,6193,20
28049469081,28049469077,-4,1894,6477,20
28053893410,28053893408,-2,1221,1900,20
28054556028,28054556025,-3,840,2023,20
28064711947,28064711944,-3,1470,2808,20
28067591405,28067591402,-3,1344,3354,20
28067854451,28067854450,-1,848,1349,20
28070508705,28070508703,-2,1180,2921,20
28073854007,28073854002,-5,1475,2235,20
28075393183,28075393181,-2,2976,4963,20
28076627739,28076627738,-1,1134,1994,20
28079055049,28079055046,-3,767,1703,20
28079735861,28079735861,0,2489,3906,20
28082794167,28082794165,-2,1291,2381,20
28086490752,28086490749,-3,787,2702,20
28089071373,28089071370,-3,1041,2305,20
28089531214,28089531210,-4,1127,1866,20
28090425543,28090425538,-5,1269,2916,20
28090500734,28090500750,16,635,1546,20
28091079307,28091079305,-2,1074,2546,20
28091204110,28091204110,0,845,1594,20
28092094592,28092094587,-5,1081,2667,20
28093901478,28093901474,-4,837,1355,20
28095175122,28095175121,-1,1579,2681,20
28099565632,28099565631,-1,931,1597,20
28117407925,28117407922,-3,919,1667,20
28117711572,28117711571,-1,251,1302,20
28118812907,28118812906,-1,1330,2783,20
28120133280,28120133276,-4,952,2880,20
28127225410,28127225416,6,3741,1557,20
28129510345,28129510342,-3,1281,2509,20
28134281429,28134281427,-2,984,2202,20
28135843986,28135843982,-4,1045,1947,20
28136810045,28136810046,1,2419,3182,20
28136841195,28136841193,-2,1294,2370,20
28137866622,28137866619,-3,1359,2134,20
28146813294,28146813290,-4,804,1749,20
28147085188,28147085190,2,2862,2008,20
28147358609,28147358610,1,1295,1089,20
28150124499,28150124497,-2,684,2280,20
28157912355,28157912353,-2,1343,3901,20
28162547095,28162547091,-4,1487,3374,20
28178863650,28178863646,-4,1034,2559,20
28179834980,28179834974,-6,918,1892,20
28183505010,28183505007,-3,1586,2436,20
28193468470,28193468467,-3,1327,2459,20
28200318845,28200318843,-2,1401,2440,20
28202642016,28202642014,-2,1299,2454,20
28203016224,28203016217,-7,1411,4366,20
28204336110,28204336106,-4,1343,2218,20
28207716542,28207716539,-3,1118,2411,20
28208991442,28208991441,-1,872,2118,20
28210902878,28210902876,-2,957,1589,20
28214734859,28214734853,-6,972,4360,20
28215273743,28215273741,-2,1145,2563,20
28215691797,28215691799,2,241,994,20
28216914754,28216914750,-4,842,2867,20
28217385510,28217385490,-20,761,1648,20
28225368238,28225368236,-2,1039,1955,20
28225753254,28225753251,-3,1115,2574,20
28225897147,28225897146,-1,1229,2046,20
28231001630,28231001626,-4,1270,2460,20
28231130713,28231130711,-2,1273,1974,20
28232633219,28232633218,-1,911,1812,20
28235369579,28235369578,-1,520,1080,20
28237186517,28237186515,-2,1651,2774,20
28237289289,28237289286,-3,1181,2574,20
28237318746,28237318742,-4,1312,3824,20
28244014990,28244014988,-2,920,2360,20
28244467357,28244467356,-1,923,2714,20
28251133535,28251133531,-4,617,1685,20
28251834095,28251834092,-3,1059,2423,20
28252570579,28252570577,-2,1437,2708,20
28257592244,28257592239,-5,1339,3277,20
28259712982,28259712988,6,1804,998,20
28265900478,28265900475,-3,961,1904,20
28266376554,28266376552,-2,1605,2856,20
28273220942,28273220941,-1,1221,2701,20
28276873687,28276873682,-5,1282,2798,20
28277058702,28277058721,19,1054,2132,20
28277306059,28277306055,-4,1313,2497,20
28284988052,28284988050,-2,1295,2641,20
28285407110,28285407105,-5,467,2275,20
28286560949,28286560950,1,1891,2695,20
28291925827,28291925824,-3,1252,2884,20
28298082250,28298082246,-4,1449,2078,20
28312213951,28312213948,-3,1217,1538,20
28312579938,28312579935,-3,1546,2621,20
28322313201,28322313201,0,2163,1894,20
28322675826,28322675822,-4,1236,2406,20
28322974727,28322974726,-1,970,1428,20
28327810526,28327810524,-2,1184,2206,20
28329090579,28329090576,-3,1146,2772,20
28335253842,28335253842,0,1268,1996,20
28336642076,28336642077,1,2480,3452,20
28338083672,28338083666,-6,1549,4055,20
28338679341,28338679338,-3,1387,3312,20
28342555676,28342555673,-3,1165,1802,20
28344783643,28344783638,-5,978,2268,20
28352411646,28352411644,-2,1710,2534,20
28352734485,28352734483,-2,1125,2636,20
28358851451,28358851461,10,15301,23790,20
28359539633,28359539631,-2,694,2037,20
28368534398,28368534394,-4,999,1893,20
28370004832,28370004815,-17,367,1254,20
28370590598,28370590619,21,1491,2822,20
28372453883,28372453882,-1,1478,2654,20
28372810552,28372810556,4,10165,8507,20
28374770838,28374770834,-4,1255,2286,20
28376629977,28376629971,-6,1317,2629,20
28378425602,28378425602,0,1739,1641,20
28381027022,28381027022,0,1072,1675,20
28381299186,28381299183,-3,1231,2234,20
28381859656,28381859653,-3,852,2265,20
28386430656,28386430654,-2,1295,3228,20
28387875618,28387875617,-1,1026,2104,20
28388552142,28388552139,-3,1141,2014,20
28388587253,28388587259,6,5260,2253,20
28395562459,28395562458,-1,958,2138,20
28397064425,28397064424,-1,1171,1698,20
28400483685,28400483683,-2,650,1253,20
28403760600,28403760597,-3,1019,2445,20
28407404469,28407404466,-3,1039,2095,20
28408439298,28408439294,-4,4894,13218,20
28409677948,28409677945,-3,1182,1714,20
28409769216,28409769214,-2,1195,2931,20
28416523662,28416523659,-3,1061,1969,20
28418254902,28418254897,-5,1356,3755,20
28420017671,28420017669,-2,1553,2176,20
28422705397,28422705395,-2,1536,2326,20
28427375238,28427375238,0,1141,1248,20
28428719081,28428719078,-3,845,3664,20
28430491757,28430491754,-3,968,2715,20
28432781978,28432781974,-4,1105,2484,20
28433769325,28433769323,-2,864,1711,20
28436921251,28436921248,-3,1259,3388,20
28437832576,28437832578,2,1183,1538,20
28440827018,28440827015,-3,1381,3096,20
28447148651,28447148649,-2,919,1766,20
28449277319,28449277316,-3,935,2136,20
28451947802,28451947801,-1,1025,1895,20
28452430284,28452430283,-1,1439,2655,20
28463105166,28463105164,-2,978,1846,20
28465220936,28465220934,-2,765,1982,20
28466631961,28466631958,-3,1086,2615,20
28470408182,28470408179,-3,1257,2337,20
28471116736,28471116753,17,1703,2016,20
28472581091,28472581090,-1,1075,1824,20
28474871518,28474871513,-5,964,2324,20
28475208071,28475208066,-5,1064,3340,20
28476351612,28476351608,-4,1217,2380,20
28478217684,28478217694,10,164,511,20
28481612556,28481612552,-4,1086,2133,20
28485664712,28485664709,-3,1231,2796,20
28486786108,28486786111,3,237,962,20
28493804956,28493804950,-6,1253,1733,20
28495638261,28495638257,-4,1201,3119,20
28499022349,28499022347,-2,1409,2421,20
28503285275,28503285273,-2,723,1127,20
28506304714,28506304710,-4,1196,2879,20
28515505391,28515505389,-2,1139,2547,20
28519235411,28519235410,-1,1247,2220,20
28525915541,28525915537,-4,1383,2037,20
28526480194,28526480191,-3,1639,2307,20
28530571235,28530571231,-4,635,1912,20
28536616423,28536616421,-2,1024,1369,20
28542338179,28542338177,-2,942,2522,20
28543209734,28543209733,-1,940,1568,20
28544670294,28544670291,-3,1096,1650,20
28546967154,28546967151,-3,875,1400,20
28547513434,28547513433,-1,1077,2059,20
28549982134,28549982131,-3,999,2073,20
28550497384,28550497379,-5,1286,2359,20
28551042827,28551042824,-3,894,1779,20
28556838754,28556838750,-4,907,2595,20
28558593179,28558593177,-2,1648,2973,20
28560237333,28560237330,-3,1087,2200,20
28562456094,28562456089,-5,1111,1419,20
28563990335,28563990332,-3,1266,3140,20
28564718497,28564718505,8,4775,1650,20
28566214564,28566214561,-3,1084,2726,20
28569304282,28569304280,-2,1355,1600,20
28570096670,28570096667,-3,1294,2699,20
28570343143,28570343141,-2,1424,1952,20
28571516807,28571516806,-1,1144,1984,20
28574011598,28574011593,-5,2417,6483,20
28581086064,28581086062,-2,1049,1442,20
28582384095,28582384091,-4,1129,2178,20
28586558261,28586558257,-4,893,3074,20
28586891054,28586891052,-2,860,2359,20
28590544242,28590544240,-2,673,1454,20
28603857420,28603857418,-2,1479,2429,20
28604284678,28604284674,-4,1186,2791,20
28604859143,28604859141,-2,820,2018,20
28605281782,28605281779,-3,1116,2580,20
28612641625,28612641621,-4,750,2318,20
28617458061,28617458058,-3,1161,2433,20
28618440950,28618440957,7,14263,22190,20
28620413954,28620413950,-4,1207,2425,20
28621470210,28621470207,-3,933,2039,20
28621969334,28621969350,16,1099,2305,20
28622378863,28622378860,-3,1280,2332,20
28629537834,28629537832,-2,831,2526,20
28630765065,28630765061,-4,1356,2755,20
28631284005,28631284002,-3,1274,2020,20
28632038176,28632038172,-4,1308,2747,20
28632654387,28632654386,-1,880,1631,20
28634047271,28634047269,-2,1185,2043,20
28637498282,28637498278,-4,2358,4775,20
28639926218,28639926216,-2,1490,2609,20
28645966342,28645966349,7,9479,36017,20
28649472956,28649472952,-4,978,2840,20
28649667984,28649667981,-3,1867,3967,20
28658385019,28658385022,3,39967,34756,20
28660029813,28660029815,2,1473,1088,20
28664175441,28664175437,-4,1413,2906,20
28671173255,28671173254,-1,1016,2371,20
28671620157,28671620154,-3,1414,2560,20
28672220686,28672220684,-2,1154,2479,20
28675040426,28675040423,-3,1113,2502,20
28679834766,28679834762,-4,963,2125,20
28680499422,28680499423,1,1548,1258,20
28681173437,28681173434,-3,1273,2083,20
28682537618,28682537614,-4,1317,2430,20
28682653268,28682653251,-17,1068,2153,20
28683625769,28683625765,-4,1400,2583,20
28683996982,28683996980,-2,1482,3126,20
28685830465,28685830462,-3,1600,3732,20
28686290615,28686290592,-23,997,2742,20
28687814843,28687814839,-4,1019,2660,20
28690228500,28690228498,-2,1263,2653,20
28691598745,28691598757,12,12599,48179,20
28694262506,28694262505,-1,1403,2219,20
28695248908,28695248905,-3,1196,3567,20
28699389538,28699389534,-4,1331,2219,20
28701748657,28701748659,2,3021,3121,20
28702791185,28702791185,0,1006,1695,20
28702881032,28702881029,-3,1103,2685,20
28703186063,28703186059,-4,1225,2691,20
28704094970,28704094974,4,2128,1826,20
28704933180,28704933183,3,2056,1220,20
28706303510,28706303506,-4,881,1582,20
28707792641,28707792638,-3,867,2493,20
28709895394,28709895386,-8,810,6710,20
28710912555,28710912553,-2,1256,2496,20
28712374409,28712374407,-2,848,2139,20
28714081460,28714081463,3,2737,1868,20
28715057674,28715057671,-3,1183,2891,20
28716461986,28716461983,-3,1125,1960,20
28725084278,28725084274,-4,1010,2458,20
28735028458,28735028461,3,1183,1153,20
28735599305,28735599326,21,483,1106,20
28738047453,28738047450,-3,1179,3158,20
28741669947,28741669948,1,2422,3139,20
28746480590,28746480588,-2,1023,2790,20
28747665163,28747665163,0,964,1611,20
28750131405,28750131403,-2,844,1691,20
28751143126,28751143146,20,1108,1680,20
28751585710,28751585714,4,1600,1802,20
28766498891,28766498887,-4,1154,2419,20
28768957631,28768957623,-8,1166,7653,20
28772929255,28772929253,-2,1112,2725,20
28775403774,28775403772,-2,1114,2423,20
28781339767,28781339745,-22,1151,456,20
28781950395,28781950394,-1,1228,2302,20
28784690830,28784690824,-6,1220,2966,20
28786386135,28786386132,-3,1042,2571,20
28794574644,28794574641,-3,1086,2052,20
28795635650,28795635647,-3,1419,2193,20
28797903816,28797903811,-5,815,2368,20
28798011118,28798011138,20,1100,1662,20
28798880445,28798880438,-7,2324,6809,20
28800610440,28800610437,-3,1176,2149,20
28805497323,28805497320,-3,1162,2850,20
28807165757,28807165755,-2,1457,2694,20
28811872971,28811872967,-4,1347,3032,20
28814708199,28814708206,7,1197,525,20
28816222131,28816222127,-4,1080,3146,20
28827161562,28827161561,-1,1480,3476,20
28845133109,28845133105,-4,741,2148,20
28848046859,28848046856,-3,776,2563,20
28848592781,28848592778,-3,257,798,20
28852263127,28852263125,-2,924,2897,20
28853159785,28853159781,-4,1255,3488,20
28853201998,28853202017,19,878,2199,20
28854596991,28854596989,-2,830,2525,20
28856032022,28856032041,19,769,2513,20
28859502209,28859502207,-2,886,1669,20
28865842827,28865842821,-6,1622,4233,20
28866336124,28866336120,-4,37501,13650,20
28866820566,28866820562,-4,1027,2252,20
28870187519,28870187517,-2,1279,2344,20
28871066356,28871066354,-2,1298,1988,20
28872633476,28872633474,-2,1261,2242,20
28873782522,28873782517,-5,1490,4519,20
28875092831,28875092828,-3,1091,2250,20
28875958915,28875958913,-2,1812,2900,20
28878455630,28878455634,4,1294,1020,20
28879881875,28879881874,-1,1166,1702,20
28880679842,28880679837,-5,1182,3962,20
28881630064,28881630049,-15,7859,44236,20
28883557638,28883557638,0,1017,1891,20
28883929900,28883929888,-12,957,3021,20
28887152338,28887152333,-5,1023,2435,20
28889632254,28889632251,-3,1282,1999,20
28890655114,28890655111,-3,1353,2305,20
28905209258,28905209255,-3,1323,1967,20
28913732762,28913732757,-5,1089,1905,20
28915937350,28915937348,-2,883,1373,20
28920371267,28920371249,-18,2694,2077,20
28926873883,28926873882,-1,1176,2629,20
28929927770,28929927769,-1,1284,2026,20
28931159258,28931159255,-3,914,2489,20
28934770999,28934770997,-2,1097,1695,20
28936418801,28936418799,-2,2055,2438,20
28936856650,28936856646,-4,801,2003,20
28937011513,28937011519,6,956,1917,20
28939827087,28939827083,-4,1159,3875,20
28942167316,28942167314,-2,1186,2541,20
28942686989,28942686984,-5,897,1979,20
28948633947,28948633943,-4,1160,1882,20
28950618528,28950618527,-1,1686,2060,20
28951693896,28951693914,18,1256,2781,20
28956033129,28956033129,0,1843,1910,20
28960786335,28960786333,-2,964,1906,20
28961102774,28961102793,19,605,1521,20
28962779299,28962779298,-1,912,2509,20
28963763514,28963763510,-4,1118,2422,20
28964393182,28964393179,-3,1519,2371,20
28966777023,28966777022,-1,1369,2865,20
28967109100,28967109093,-7,1522,4661,20
28981005185,28981005182,-3,1240,1719,20
28981173223,28981173224,1,1142,1310,20
28987089038,28987089036,-2,803,2473,20
28987226535,28987226514,-21,1027,1988,20
28987618368,28987618367,-1,918,1627,20
28989266528,28989266525,-3,1259,2162,20
28991624050,28991624048,-2,1277,1912,20
28994963826,28994963825,-1,1121,2468,20
29001489290,29001489285,-5,1118,2103,20
29003528658,29003528654,-4,1263,2530,20
29003649183,29003649180,-3,1007,2376,20
29004022606,29004022602,-4,1508,2690,20
29005857866,29005857864,-2,1225,1882,20
29006417614,29006417600,-14,874,2250,20
29009024905,29009024900,-5,1495,2233,20
29011068630,29011068627,-3,1308,2603,20
29015567807,29015567804,-3,832,1590,20
29017959259,29017959258,-1,1379,2453,20
29018578804,29018578802,-2,961,1944,20
29021339156,29021339157,1,902,1840,20
29025227237,29025227235,-2,1011,1303,20
29025438989,29025438998,9,91,1423,20
29028186344,29028186343,-1,1370,2472,20
29029305307,29029305306,-1,1023,2070,20
29034874227,29034874225,-2,786,2289,20
29053714273,29053714274,1,1258,2052,20
29054018037,29054018057,20,719,2797,20
29056573534,29056573531,-3,1183,2758,20
29058734527,29058734524,-3,1062,1591,20
29061964263,29061964260,-3,1265,2578,20
29064477183,29064477181,-2,836,1646,20
29068138734,29068138732,-2,1064,2762,20
29070815649,29070815646,-3,1095,2376,20
29071832634,29071832632,-2,1016,2502,20
29073163165,29073163185,20,182,796,20
29074128021,29074128030,9,1302,1063,20
29075026390,29075026389,-1,871,2097,20
29075484081,29075484080,-1,1298,1837,20
29076039508,29076039494,-14,1155,2686,20
29076359356,29076359362,6,2770,1095,20
29078859771,29078859770,-1,1195,2665,20
29079744238,29079744234,-4,889,2032,20
29083229106,29083229103,-3,1065,1556,20
29084601416,29084601414,-2,1670,2628,20
29084844454,29084844452,-2,908,2169,20
29096919655,29096919650,-5,1014,3065,20
29102746730,29102746729,-1,1572,2266,20
29107004281,29107004281,0,1424,1767,20
29107770147,29107770145,-2,687,2119,20
29113928539,29113928537,-2,1317,2876,20
29122574041,29122574041,0,857,1475,20
29123098057,29123098053,-4,781,2020,20
29127467281,29127467278,-3,1290,2485,20
29129837618,29129837617,-1,886,2339,20
29132659368,29132659366,-2,1127,1696,20
29133904518,29133904516,-2,798,2343,20
29137027974,29137027970,-4,1067,2380,20
29139876689,29139876689,0,1340,2459,20
29145514298,29145514296,-2,918,2055,20
29147593727,29147593724,-3,1054,2335,20
29147734149,29147734170,21,1249,2471,20
29149203783,29149203782,-1,1522,2477,20
29152456588,29152456586,-2,1414,2190,20
29153744846,29153744853,7,16362,19813,20
29159838216,29159838214,-2,1770,2096,20
29160335138,29160335137,-1,1058,1660,20
29161701542,29161701539,-3,1270,2286,20
29162048543,29162048541,-2,753,1929,20
29162345518,29162345502,-16,964,4051,20
29163736678,29163736676,-2,1288,2204,20
29164308032,29164308029,-3,1513,2735,20
29166375250,29166375246,-4,1330,3385,20
29169148501,29169148503,2,1827,1963,20
29173368728,29173368736,8,3205,1251,20
29176673467,29176673462,-5,1081,1965,20
29177525158,29177525156,-2,1110,2092,20
29181224966,29181224962,-4,726,1565,20
29183967761,29183967757,-4,1515,2387,20
29188501753,29188501749,-4,1204,2465,20
29200523507,29200523502,-5,1130,2378,20
29202662282,29202662280,-2,1302,2003,20
29207502698,29207502709,11,12471,40750,20
29209636517,29209636513,-4,1252,1607,20
29214513139,29214513118,-21,929,2405,20
29216997913,29216997915,2,2141,1669,20
29217188634,29217188630,-4,684,2089,20
29218532663,29218532658,-5,819,1454,20
29223008686,29223008682,-4,1118,1829,20
29223149346,29223149354,8,3444,1507,20
29224990902,29224990898,-4,992,2349,20
29225642737,29225642736,-1,1537,2716,20
29227246060,29227246057,-3,1157,2479,20
29230676359,29230676357,-2,931,2562,20
29234860143,29234860143,0,1276,2808,20
29237051386,29237051383,-3,1034,2779,20
29237448796,29237448803,7,210,773,20
29238119718,29238119718,0,311,1316,20
29238236381,29238236403,22,927,1966,20
29239723005,29239723002,-3,1515,2223,20
29243359632,29243359630,-2,2399,5348,20
29243755463,29243755459,-4,945,2449,20
29245078941,29245078935,-6,1470,6142,20
29246351354,29246351351,-3,1570,2691,20
29248610220,29248610222,2,15577,15373,20
29251588519,29251588516,-3,1443,2658,20
29253961309,29253961306,-3,973,1931,20
29255629334,29255629330,-4,1269,3243,20
29257641593,29257641593,0,1750,2495,20
29258600867,29258600865,-2,1066,1996,20
29260533896,29260533891,-5,1506,2279,20
29261338389,29261338388,-1,1566,2561,20
29262407805,29262407802,-3,2346,5917,20
29262689123,29262689122,-1,2589,2951,20
29273606986,29273606982,-4,1077,2783,20
29275053283,29275053280,-3,1226,2045,20
29275431735,29275431751,16,252,1493,20
29285187498,29285187501,3,3329,2679,20
29290105036,29290105038,2,1420,1012,20
29293494354,29293494339,-15,394,567,20
29298471322,29298471317,-5,1157,2019,20
29300693649,29300693656,7,2539,1147,20
29301490470,29301490466,-4,1008,1832,20
29305647282,29305647279,-3,1151,1827,20
29306550013,29306550011,-2,783,1492,20
29313356697,29313356694,-3,1459,2521,20
29317465818,29317465814,-4,1251,2653,20
29320010635,29320010631,-4,1268,2210,20
29320372446,29320372443,-3,1280,2288,20
29320972234,29320972234,0,1295,1808,20
29327462742,29327462741,-1,987,2468,20
29331174191,29331174189,-2,1846,2672,20
29333787734,29333787729,-5,5144,14771,20
29334271122,29334271118,-4,1377,3079,20
29334338549,29334338545,-4,1138,1796,20
29340591651,29340591647,-4,884,2537,20
29342147443,29342147441,-2,979,1846,20
29345502625,29345502622,-3,1063,2668,20
29348316254,29348316249,-5,1320,2164,20
29349690640,29349690654,14,9503,1063,20
29351021677,29351021674,-3,1270,2670,20
29353632826,29353632823,-3,1296,2840,20
29355093141,29355093144,3,1781,1576,20
29356376778,29356376777,-1,840,980,20
29357516178,29357516177,-1,1176,2050,20
29359087875,29359087871,-4,559,1212,20
29359515178,29359515173,-5,914,1857,20
29362542423,29362542421,-2,456,1662,20
29362993511,29362993507,-4,989,2005,20
29363102493,29363102472,-21,1023,1676,20
29365835165,29365835161,-4,1777,5898,20
29371187002,29371187002,0,555,1076,20
29373555506,29373555507,1,2726,3835,20
29376764350,29376764348,-2,1133,2184,20
29377300007,29377300026,19,1471,2464,20
29379286222,29379286221,-1,1087,2052,20
29379540359,29379540356,-3,980,2243,20
29380075442,29380075440,-2,942,2021,20
29382128755,29382128753,-2,999,2375,20
29392043918,29392043915,-3,1120,2649,20
29393764818,29393764814,-4,1416,2713,20
29399995653,29399995651,-2,900,2080,20
29400736605,29400736622,17,370,1079,20
29404205874,29404205874,0,964,1450,20
29405487975,29405487971,-4,1049,3257,20
29406920448,29406920444,-4,954,2158,20
29408596900,29408596896,-4,841,1984,20
29411981203,29411981201,-2,1112,2413,20
29413241155,29413241153,-2,1232,2593,20
29414250681,29414250678,-3,1320,2858,20
29417478569,29417478565,-4,1354,2352,20
29423484283,29423484282,-1,2122,3795,20
29424098329,29424098329,0,885,2168,20
29424778321,29424778327,6,2827,1409,20
29433823145,29433823141,-4,1561,2724,20
29448475639,29448475634,-5,1395,2919,20
29450024291,29450024290,-1,1172,2335,20
29453219955,29453219953,-2,897,2125,20
29453566535,29453566529,-6,1743,2326,20
29454150299,29454150294,-5,2102,5944,20
29459008949,29459008947,-2,1385,2622,20
29459201591,29459201589,-2,1498,2530,20
29461881210,29461881215,5,4071,1722,20
29462097062,29462097058,-4,754,2380,20
29462878617,29462878614,-3,1064,1908,20
29465561515,29465561512,-3,1249,2615,20
29466619510,29466619509,-1,1100,2113,20
29466854810,29466854806,-4,1096,1725,20
29470099325,29470099322,-3,1370,2978,20
29474609606,29474609606,0,1776,2413,20
29481426352,29481426348,-4,758,2540,20
29485241643,29485241641,-2,1032,2373,20
29487504798,29487504796,-2,1086,1711,20
29489449035,29489449035,0,983,1468,20
29491498511,29491498518,7,3379,1364,20
29491647550,29491647547,-3,1394,2352,20
29501799593,29501799590,-3,1609,2124,20
29503151786,29503151782,-4,1354,3064,20
29504983824,29504983822,-2,878,2364,20
29505811078,29505811093,15,1157,2876,20
29506598955,29506598953,-2,678,1575,20
29510877405,29510877402,-3,1252,2534,20
29511275638,29511275621,-17,315,714,20
29527776276,29527776273,-3,1118,2360,20
29529135170,29529135165,-5,1484,2251,20
29530101880,29530101878,-2,714,2502,20
29534169761,29534169758,-3,1328,2045,20
29534649647,29534649644,-3,1523,2838,20
29541132985,29541132982,-3,1022,3015,20
29542426125,29542426142,17,860,1895,20
29542761231,29542761231,0,2156,2015,20
29543179107,29543179102,-5,1219,2672,20
29555089910,29555089906,-4,776,2394,20
29556891086,29556891102,16,840,1658,20
29558960187,29558960182,-5,1217,2006,20
29560799420,29560799414,-6,257,859,20
29561550323,29561550320,-3,1136,2220,20
29562866886,29562866882,-4,1240,2357,20
29564263646,29564263644,-2,1218,3541,20
29574876820,29574876823,3,2179,1207,20
29576016097,29576016098,1,2706,3903,20
29578937356,29578937353,-3,1505,2438,20
29580939990,29580939988,-2,1571,3557,20
29584571036,29584571038,2,1349,1460,20
29597449711,29597449711,0,1159,1308,20
29599286949,29599286947,-2,1001,2112,20
29602198759,29602198757,-2,1254,2844,20
29604059298,29604059302,4,1026,2290,20
29605919582,29605919579,-3,802,2248,20
29606892418,29606892417,-1,1429,1960,20
29607501691,29607501686,-5,923,1946,20
29608245492,29608245498,6,2141,1787,20
29609501690,29609501687,-3,1345,1958,20
29611058553,29611058554,1,4793,7306,20
29613303701,29613303698,-3,1470,1897,20
29613603939,29613603936,-3,1250,1996,20
29615673923,29615673921,-2,1293,3276,20
29618561754,29618561745,-9,355,884,20
29620251140,29620251137,-3,1292,1527,20
29624263986,29624263982,-4,736,2833,20
29626315470,29626315465,-5,1038,5412,20
29632349287,29632349285,-2,802,2274,20
29632670032,29632670026,-6,2182,8603,20
29634721838,29634721836,-2,992,2303,20
29635616539,29635616535,-4,1010,2484,20
29636064033,29636064030,-3,1388,3012,20
29636213621,29636213642,21,1519,6383,20
29636377008,29636377025,17,920,2757,20
29640182055,29640182053,-2,1018,2963,20
29640478627,29640478626,-1,621,1711,20
29642702371,29642702369,-2,1282,2615,20
29643946718,29643946714,-4,886,2045,20
29645031811,29645031809,-2,1437,2772,20
29646945895,29646945894,-1,916,1892,20
29649550863,29649550858,-5,892,2339,20
29650015478,29650015498,20,439,1920,20
29655392403,29655392399,-4,1322,3018,20
29657021380,29657021377,-3,872,2355,20
29662059567,29662059570,3,4390,3033,20
29663058643,29663058641,-2,1034,1848,20
29665987489,29665987493,4,5221,2977,20
29666957790,29666957788,-2,1388,2270,20
29671581701,29671581696,-5,1174,1443,20
29677765643,29677765641,-2,1647,2288,20
29687569490,29687569486,-4,796,2015,20
29690110014,29690110002,-12,1431,2594,20
29690644185,29690644183,-2,981,2226,20
29690891746,29690891742,-4,1003,2192,20
29691589541,29691589545,4,15700,12863,20
29695018877,29695018877,0,1489,1851,20
29696313846,29696313862,16,88,676,20
29700686611,29700686609,-2,1156,2411,20
29702406907,29702406905,-2,1011,2638,20
29703870060,29703870058,-2,1425,2991,20
29706599433,29706599430,-3,2236,4169,20
29710389521,29710389517,-4,1114,1820,20
29713745207,29713745201,-6,1048,2099,20
29726319876,29726319872,-4,993,2083,20
29726986651,29726986649,-2,1347,2672,20
29731773990,29731773985,-5,801,1297,20
29733639239,29733639235,-4,815,2258,20
29737200368,29737200365,-3,1367,2799,20
29743566733,29743566731,-2,838,2289,20
29746201170,29746201170,0,1562,2104,20
29759530721,29759530718,-3,1384,2302,20
29759881185,29759881186,1,1051,1973,20
29764679607,29764679606,-1,890,2038,20
29765763614,29765763613,-1,1075,1729,20
29767109934,29767109932,-2,1348,2415,20
29767837227,29767837225,-2,1153,2654,20
29768161233,29768161229,-4,1164,2696,20
29771377143,29771377156,13,14503,28215,20
29781704451,29781704447,-4,1276,3608,20
29783060713,29783060710,-3,1408,2498,20
29785282425,29785282425,0,1132,2168,20
29795691822,29795691818,-4,783,2063,20
29802233711,29802233712,1,778,1350,20
29803028906,29803028902,-4,1263,3566,20
29803793202,29803793207,5,1805,1269,20
29814432671,29814432670,-1,1114,2002,20
29814924309,29814924327,18,505,1303,20
29818031466,29818031463,-3,1194,1669,20
29821680322,29821680319,-3,1048,2375,20
29824441496,29824441491,-5,1067,3181,20
29825311783,29825311778,-5,1129,3093,20
29826465734,29826465731,-3,1125,2356,20
29829306440,29829306437,-3,1463,3880,20
29829814125,29829814121,-4,599,1471,20
29831290558,29831290559,1,1208,1507,20
29831321762,29831321758,-4,1017,2442,20
29833219702,29833219700,-2,640,2087,20
29833640925,29833640923,-2,1054,1733,20
29834165156,29834165177,21,844,2122,20
29835142623,29835142620,-3,998,2794,20
29837804035,29837804030,-5,937,2474,20
29846630763,29846630761,-2,1543,2874,20
29849729454,29849729451,-3,771,1993,20
29850463789,29850463786,-3,1689,2328,20
29853193304,29853193302,-2,1270,3181,20
29856829400,29856829405,5,12331,7087,20
29859021901,29859021899,-2,1078,1460,20
29863671522,29863671519,-3,1109,3192,20
29865063991,29865063987,-4,1051,2634,20
29871931495,29871931495,0,1177,2697,20
29878962403,29878962402,-1,2124,2158,20
29880688127,29880688126,-1,1104,1509,20
29880750666,29880750665,-1,789,2449,20
29884554807,29884554802,-5,465,1399,20
29889192382,29889192380,-2,1111,1949,20
29892937799,29892937795,-4,1000,2248,20
29895621425,29895621417,-8,2577,7828,20
29895771426,29895771424,-2,1080,2559,20
29898403867,29898403865,-2,1215,2664,20
29901126684,29901126682,-2,1010,1853,20
29906084845,29906084843,-2,1534,2175,20
29906256058,29906256060,2,7278,8317,20
29911181497,29911181491,-6,153,920,20
29913855110,29913855106,-4,1137,3339,20
29917715320,29917715318,-2,1090,2040,20
29919862050,29919862047,-3,1093,1643,20
29920479926,29920479926,0,136,1018,20
29923698719,29923698715,-4,677,1700,20
29924307706,29924307701,-5,808,1710,20
29924425126,29924425122,-4,824,2460,20
29924641012,29924641009,-3,1260,2192,20
29926418129,29926418130,1,997,1633,20
29930471470,29930471466,-4,1189,2534,20
29933258809,29933258806,-3,1392,1770,20
29935469857,29935469854,-3,1297,2029,20
29946794079,29946794077,-2,673,1576,20
29951340935,29951340931,-4,1314,2299,20
29953609342,29953609338,-4,1334,3088,20
29954220498,29954220493,-5,1058,3548,20
29956111002,29956110998,-4,1140,2287,20
29966853215,29966853213,-2,1130,2026,20
29971184711,29971184710,-1,1261,3530,20
29972853534,29972853531,-3,930,2234,20
29972955423,29972955427,4,3187,1508,20
29973436645,29973436643,-2,1654,3019,20
29975136845,29975136841,-4,1273,2515,20
29985258285,29985258282,-3,1071,2711,20
29986432384,29986432381,-3,1431,3250,20
29993083130,29993083131,1,3000,3838,20
29993703991,29993703989,-2,652,1247,20
29998908242,29998908240,-2,1619,1822,20
30000181657,30000181655,-2,898,1448,20
30006124842,30006124838,-4,935,2406,20
30008318659,30008318658,-1,891,1922,20
30011781536,30011781532,-4,1981,2917,20
30012638370,30012638367,-3,955,3021,20
30017084845,30017084853,8,3329,1236,20
30019052545,30019052543,-2,1031,1746,20
30025570999,30025570998,-1,39005,22612,20
30025915444,30025915441,-3,1197,2268,20
30032387305,30032387302,-3,1042,1964,20
30032837455,30032837466,11,10984,29230,20
30034055534,30034055530,-4,1232,3189,20
30040277210,30040277206,-4,1108,2481,20
30042671693,30042671692,-1,886,2934,20
30042894497,30042894495,-2,1309,2784,20
30044215793,30044215789,-4,870,2500,20
30047967231,30047967233,2,1972,2041,20
30048231254,30048231249,-5,1135,2742,20
30055511635,30055511640,5,4918,2907,20
30058918153,30058918147,-6,760,1440,20
30069318762,30069318758,-4,865,1700,20
30070675357,30070675342,-15,1067,2166,20
30071895405,30071895402,-3,907,2079,20
30072605939,30072605935,-4,1196,2868,20
30073067955,30073067950,-5,1118,2738,20
30075500970,30075500969,-1,1483,1649,20
30082593207,30082593206,-1,743,1546,20
30092020751,30092020750,-1,1682,3108,20
30093645926,30093645926,0,1280,2164,20
30094144671,30094144687,16,986,2277,20
30095266784,30095266782,-2,994,2291,20
30096041070,30096041066,-4,1270,2551,20
30097176881,30097176878,-3,950,2101,20
30098945414,30098945434,20,911,1740,20
30099168986,30099168982,-4,1077,2665,20
30102965054,30102965051,-3,727,1568,20
30106997202,30106997198,-4,905,3410,20
30107384382,30107384378,-4,778,2418,20
30109544862,30109544858,-4,1238,3608,20
30110295790,30110295787,-3,767,2625,20
30111698500,30111698498,-2,1120,1784,20
30115668130,30115668114,-16,2339,1015,20
30118467249,30118467254,5,2769,1128,20
30128349774,30128349770,-4,1245,3091,20
30128871418,30128871417,-1,1070,2861,20
30130173946,30130173943,-3,1205,2759,20
30132742508,30132742506,-2,1101,2780,20
30132783671,30132783669,-2,1302,2331,20
30136136972,30136136968,-4,1456,2624,20
30138611887,30138611893,6,1249,1689,20
30140679577,30140679582,5,6671,2720,20
30147328532,30147328530,-2,1147,2307,20
30147639950,30147639953,3,2223,1816,20
30147733602,30147733601,-1,1355,1839,20
30150320563,30150320561,-2,1114,2214,20
30154144686,30154144684,-2,1252,2430,20
30154253763,30154253762,-1,1733,2390,20
30155670314,30155670324,10,846,2100,20
30169618166,30169618161,-5,1514,3584,20
30169772798,30169772796,-2,1247,2415,20
30180622322,30180622318,-4,1329,2983,20
30181878971,30181878968,-3,680,1296,20
30183876260,30183876257,-3,1095,2078,20
30188971555,30188971553,-2,1187,2897,20
30189191620,30189191618,-2,1172,2239,20
30197174219,30197174214,-5,1571,3077,20
30203190389,30203190392,3,35826,28547,20
30212764943,30212764942,-1,934,1503,20
30213357214,30213357210,-4,934,3146,20
30214003225,30214003222,-3,1462,2741,20
30214134569,30214134566,-3,1051,2642,20
30218492664,30218492660,-4,900,2382,20
30225385963,30225385963,0,1394,1458,20
30229619501,30229619499,-2,688,1738,20
30229751623,30229751619,-4,912,1887,20
30229827198,30229827219,21,551,1251,20
30230504426,30230504422,-4,1101,2341,20
30231808449,30231808445,-4,1759,2578,20
30232224721,30232224719,-2,989,2259,20
30233641126,30233641146,20,546,2009,20
30234246318,30234246315,-3,1236,2611,20
30235944628,30235944625,-3,889,2603,20
30236616607,30236616603,-4,900,1983,20
30242147450,30242147448,-2,922,2361,20
30242595145,30242595142,-3,1100,2324,20
30244834126,30244834122,-4,1222,3593,20
30245735406,30245735405,-1,1489,2643,20
30247079606,30247079605,-1,945,2225,20
30253892357,30253892354,-3,937,1444,20
30256216112,30256216106,-6,1271,3710,20
30262755354,30262755352,-2,1020,2434,20
30266091229,30266091225,-4,1160,3096,20
30269476761,30269476758,-3,1210,2866,20
30275459675,30275459678,3,2118,1451,20
30276035130,30276035129,-1,762,2534,20
30277188614,30277188611,-3,1291,2524,20
30278998738,30278998733,-5,1011,2294,20
30283517423,30283517419,-4,1261,3655,20
30283993117,30283993104,-13,47346,15200,20
30293388982,30293388980,-2,1429,2525,20
30293610669,30293610670,1,67,542,20
30301205704,30301205701,-3,1047,2202,20
30303996474,30303996473,-1,1249,2366,20
30311129785,30311129782,-3,1576,2365,20
30313375046,30313375045,-1,1992,1586,20
30320158938,30320158934,-4,721,2404,20
30320647875,30320647869,-6,1062,2024,20
30321697195,30321697191,-4,1222,2041,20
30328607519,30328607517,-2,1409,2597,20
30329123951,30329123949,-2,1085,2289,20
30329847679,30329847677,-2,1073,2744,20
30332951301,30332951301,0,1068,1890,20
30335262021,30335262019,-2,1020,1278,20
30343322356,30343322354,-2,1123,2518,20
30350968287,30350968285,-2,1025,2395,20
30352135162,30352135161,-1,1334,2288,20
30353282336,30353282334,-2,1378,1834,20
30354120152,30354120150,-2,1455,2529,20
30356104961,30356104959,-2,1570,2830,20
30363470589,30363470586,-3,1701,3688,20
30364341266,30364341264,-2,901,2059,20
30365085768,30365085785,17,1321,1837,20
30365181595,30365181597,2,1771,1750,20
30367945239,30367945234,-5,824,2470,20
30370896250,30370896246,-4,1203,2976,20
30371950491,30371950490,-1,1023,2543,20
30372498222,30372498220,-2,1029,2387,20
30378408138,30378408135,-3,1121,2521,20
30379785537,30379785558,21,681,1460,20
30387423831,30387423827,-4,1073,2319,20
30388894705,30388894702,-3,598,1996,20
30393985393,30393985388,-5,1272,2540,20
30398713150,30398713149,-1,1584,2190,20
30399830010,30399830007,-3,1173,3682,20
30401211296,30401211294,-2,1768,1939,20
30401358548,30401358545,-3,1320,2793,20
30401725776,30401725789,13,410,1174,20
30406693053,30406693049,-4,1093,3048,20
30407391718,30407391738,20,361,655,20
30407472458,30407472462,4,2001,1490,20
30407536115,30407536112,-3,1226,2234,20
30411718735,30411718733,-2,965,2031,20
30412032974,30412032972,-2,1300,2407,20
30412193283,30412193277,-6,1143,3262,20
30413107479,30413107477,-2,1413,2451,20
30414180826,30414180822,-4,1158,1733,20
30414681007,30414681023,16,649,1532,20
30417541513,30417541510,-3,1249,2263,20
30422382959,30422382954,-5,1066,2221,20
30428598912,30428598908,-4,982,2096,20
30429304178,30429304182,4,3163,1601,20
30431685585,30431685581,-4,1292,3725,20
30431754474,30431754471,-3,1242,2738,20
30434254797,30434254794,-3,1002,1682,20
30435187132,30435187125,-7,1202,5669,20
30438824626,30438824622,-4,1273,1726,20
30441924251,30441924262,11,10532,35805,20
30442902179,30442902177,-2,1149,3627,20
30442946704,30442946702,-2,795,2859,20
30443277086,30443277082,-4,799,1650,20
30443537781,30443537782,1,1508,1506,20
30445757525,30445757526,1,933,1830,20
30446407075,30446407073,-2,1334,2372,20
30448324683,30448324678,-5,925,2465,20
30449815867,30449815865,-2,1396,2643,20
30458435566,30458435566,0,942,1011,20
30458773041,30458773037,-4,1036,2042,20
30459853299,30459853279,-20,753,759,20
30462886385,30462886382,-3,933,2001,20
30467357954,30467357953,-1,932,1452,20
30468908096,30468908094,-2,1171,2173,20
30469599177,30469599174,-3,1242,2698,20
30472846486,30472846483,-3,1329,1750,20
30473675374,30473675369,-5,1059,2236,20
30473855125,30473855122,-3,667,1880,20
30475672521,30475672520,-1,918,1762,20
30476054177,30476054178,1,2173,2115,20
30477758126,30477758121,-5,869,2609,20
30480647205,30480647202,-3,1642,2084,20
30482830957,30482830954,-3,1172,2495,20
30483029769,30483029766,-3,1324,3401,20
30486947623,30486947622,-1,1295,1785,20
30487945261,30487945264,3,4033,3040,20
30488595365,30488595364,-1,1254,2376,20
30488968175,30488968173,-2,1339,2150,20
30489232166,30489232169,3,1722,1476,20
30490096497,30490096493,-4,1144,1595,20
30495379589,30495379587,-2,1398,2732,20
30496377375,30496377372,-3,909,1187,20
30505063059,30505063064,5,5054,3854,20
30505377195,30505377190,-5,824,1970,20
30506062291,30506062288,-3,1250,2996,20
30507849860,30507849859,-1,935,1296,20
30509203533,30509203530,-3,1180,2027,20
30509537467,30509537463,-4,918,3010,20
30510873426,30510873424,-2,1429,2851,20
30516476099,30516476097,-2,1197,2035,20
30521885187,30521885182,-5,1204,3272,20
30522184104,30522184122,18,842,2732,20
30522788749,30522788751,2,2042,2087,20
30525436217,30525436213,-4,1704,3292,20
30529462795,30529462794,-1,1559,2899,20
30530034016,30530034014,-2,1377,2931,20
30533402330,30533402327,-3,1316,2895,20
30540058980,30540058979,-1,1272,2673,20
30546000707,30546000703,-4,1077,2377,20
30546508231,30546508230,-1,111,637,20
30548361621,30548361619,-2,1509,2523,20
30548497532,30548497551,19,1176,2217,20
30548626447,30548626444,-3,1180,2647,20
30552650849,30552650857,8,11929,31568,20
30552939847,30552939846,-1,835,1860,20
30558852715,30558852711,-4,880,2251,20
30563382813,30563382807,-6,750,3795,20
30570931723,30570931722,-1,1191,1890,20
30579143123,30579143117,-6,1447,2322,20
30582373698,30582373701,3,4452,3419,20
30585537345,30585537338,-7,1609,3938,20
30586575246,30586575245,-1,922,1494,20
30586687205,30586687196,-9,1474,1724,20
30594209150,30594209148,-2,878,1835,20
30597337274,30597337273,-1,665,2149,20
30600570730,30600570727,-3,1175,3236,20
30601522374,30601522370,-4,1082,2396,20
30604467493,30604467497,4,8688,24579,20
30605188286,30605188283,-3,1203,1753,20
30605256852,30605256853,1,236,1268,20
30611250783,30611250780,-3,968,1879,20
30615083374,30615083382,8,2165,1478,20
30615417606,30615417602,-4,2460,5751,20
30618333818,30618333816,-2,955,2142,20
30620719567,30620719565,-2,1086,2897,20
30623292896,30623292895,-1,1114,1425,20
30631012835,30631012833,-2,1102,2749,20
30631663831,30631663833,2,256,717,20
30633525469,30633525465,-4,1383,3205,20
30635544078,30635544079,1,1730,1653,20
30638598081,30638598077,-4,1195,2355,20
30640503033,30640503030,-3,1281,2152,20
30646754485,30646754482,-3,1124,2801,20
30650484613,30650484609,-4,371,1980,20
30650892783,30650892786,3,28921,110030,20
30653070726,30653070723,-3,1539,3070,20
30653625486,30653625491,5,2640,1578,20
30654379210,30654379206,-4,952,2116,20
30655725400,30655725397,-3,1958,3027,20
30658350721,30658350717,-4,944,3043,20
30659565091,30659565086,-5,1003,1945,20
30672305234,30672305229,-5,1076,1531,20
30672341973,30672341967,-6,1376,2576,20
30672836722,30672836721,-1,978,1635,20
30675805343,30675805341,-2,1426,1861,20
30676220090,30676220088,-2,957,2024,20
30677119353,30677119349,-4,1088,2086,20
30678788132,30678788128,-4,1383,2003,20
30681148014,30681148034,20,929,2604,20
30683992002,30683992001,-1,1447,2908,20
30684386197,30684386193,-4,815,2551,20
30686628293,30686628289,-4,1076,1965,20
30688783747,30688783743,-4,688,2595,20
30701529449,30701529445,-4,1746,3257,20
30704453279,30704453274,-5,914,2288,20
30704933318,30704933314,-4,1208,2348,20
30706554640,30706554642,2,47,826,20
30718233633,30718233630,-3,797,2248,20
30719118659,30719118655,-4,1555,3400,20
30719990838,30719990830,-8,1814,1573,20
30721862693,30721862691,-2,1629,2250,20
30722647962,30722647962,0,1355,1943,20
30722676167,30722676165,-2,1095,2660,20
30725318188,30725318185,-3,1283,2152,20
30727850040,30727850036,-4,694,1575,20
30732895250,30732895249,-1,955,1617,20
30735535252,30735535251,-1,1651,2207,20
30737486978,30737486977,-1,991,2397,20
30740141931,30740141930,-1,960,1967,20
30743705219,30743705212,-7,1331,2363,20
30745058595,30745058594,-1,837,1646,20
30745492501,30745492497,-4,1521,3313,20
30746525044,30746525051,7,1402,870,20
30746684374,30746684374,0,939,1748,20
30747966262,30747966257,-5,911,2185,20
30752965985,30752965990,5,1769,1010,20
30755420953,30755420950,-3,668,1409,20
30758484582,30758484581,-1,1215,2898,20
30758981981,30758981979,-2,1310,1978,20
30761214930,30761214929,-1,993,2184,20
30762799495,30762799490,-5,1181,1912,20
30763798463,30763798458,-5,1012,3363,20
30764001639,30764001636,-3,1252,2131,20
30764611696,30764611715,19,1246,2744,20
30764826492,30764826487,-5,1030,2452,20
30765031430,30765031450,20,1137,3053,20
30765440465,30765440463,-2,1160,2092,20
30768493635,30768493636,1,1332,961,20
30772616558,30772616557,-1,888,1011,20
30773863934,30773863931,-3,1062,1907,20
30779665121,30779665119,-2,1083,2475,20
30780610333,30780610328,-5,890,3053,20
30781686306,30781686302,-4,1292,2046,20
30792848075,30792848073,-2,1065,3228,20
30799838657,30799838655,-2,930,1697,20
30800417470,30800417467,-3,1277,2498,20
30800454877,30800454892,15,15231,55603,20
30802918799,30802918798,-1,1313,2717,20
30803581570,30803581567,-3,737,2702,20
30808031019,30808031014,-5,917,1982,20
30809300503,30809300500,-3,941,2366,20
30812534617,30812534613,-4,1323,2430,20
30812926417,30812926414,-3,1383,2377,20
30816627366,30816627361,-5,1098,2086,20
30817181329,30817181325,-4,1314,2781,20
30818730880,30818730887,7,3121,1105,20
30819266722,30819266718,-4,2104,3292,20
30826046490,30826046488,-2,1026,1865,20
30826074564,30826074562,-2,1040,1837,20
30832546583,30832546577,-6,1150,4510,20
30837325441,30837325433,-8,921,3933,20
30841610226,30841610225,-1,1745,3209,20
30842208567,30842208573,6,103,626,20
30847384303,30847384301,-2,1345,2788,20
30848611496,30848611492,-4,941,2254,20
30849748723,30849748721,-2,1148,2023,20
30851228231,30851228228,-3,917,2069,20
30851655717,30851655734,17,497,1171,20
30853565541,30853565541,0,1153,3115,20
30856770264,30856770259,-5,1247,2539,20
30863173013,30863173011,-2,1155,2355,20
30863526319,30863526300,-19,1064,2129,20
30867243478,30867243474,-4,1904,3027,20
30868011293,30868011286,-7,1270,4872,20
30868323759,30868323757,-2,1097,2966,20
30870936752,30870936774,22,998,1643,20
30875045943,30875045941,-2,1159,2770,20
30876244931,30876244929,-2,1293,2192,20
30877727699,30877727697,-2,1088,2694,20
30878095699,30878095699,0,893,1305,20
30878899902,30878899898,-4,1086,2622,20
30879392390,30879392388,-2,1121,2001,20
30885099246,30885099241,-5,1023,2504,20
30887247358,30887247352,-6,1751,5739,20
30887394388,30887394392,4,2689,1721,20
30888396162,30888396158,-4,1135,3582,20
30895441313,30895441317,4,865,966,20
30897427951,30897427949,-2,809,2278,20
30901068613,30901068610,-3,1175,2066,20
30902256613,30902256606,-7,1097,3125,20
30905710082,30905710081,-1,1280,2782,20
30906857747,30906857745,-2,1425,1991,20
30907634575,30907634573,-2,959,2301,20
30908060731,30908060730,-1,872,2109,20
30915703279,30915703276,-3,822,2486,20
30921033122,30921033122,0,1347,2507,20
30921991356,30921991353,-3,1185,2588,20
30923513874,30923513871,-3,963,2323,20
30924629550,30924629548,-2,1054,2030,20
30925559490,30925559486,-4,813,2683,20
30931405666,30931405664,-2,984,1674,20
30937371914,30937371911,-3,913,2193,20
30940583621,30940583614,-7,2333,6265,20
30943180499,30943180497,-2,1363,2712,20
30943221662,30943221661,-1,950,2636,20
30949186654,30949186651,-3,840,2486,20
30951544479,30951544483,4,2768,1306,20
30954151867,30954151864,-3,954,2579,20
30955746715,30955746709,-6,935,2518,20
30958997372,30958997369,-3,625,1853,20
30961081831,30961081826,-5,1325,2243,20
30962525356,30962525351,-5,1231,2271,20
30964134177,30964134174,-3,1432,3678,20
30965457894,30965457894,0,1217,2017,20
30966747859,30966747857,-2,1171,2399,20
30981150994,30981150990,-4,1234,3344,20
30981801383,30981801380,-3,1615,2390,20
30985477560,30985477558,-2,1424,2519,20
30988338834,30988338830,-4,1062,2022,20
30991674654,30991674649,-5,890,2469,20
30993276407,30993276402,-5,1077,2181,20
30995744765,30995744760,-5,1114,2971,20
30996415293,30996415291,-2,1443,2561,20
30996946822,30996946842,20,215,921,20
31000551694,31000551689,-5,941,1689,20
31001466534,31001466531,-3,763,2193,20
31004679898,31004679890,-8,798,3124,20
31017595151,31017595149,-2,1422,1877,20
31021819943,31021819939,-4,893,2220,20
31022590198,31022590198,0,1147,2093,20
31025062319,31025062315,-4,1659,3120,20
31026926028,31026926027,-1,1019,1955,20
31029852037,31029852033,-4,819,1821,20
31033848194,31033848191,-3,1072,1548,20
31039151383,31039151379,-4,1577,2989,20
31039429519,31039429537,18,851,2387,20
31047938559,31047938555,-4,1114,2043,20
31051221565,31051221563,-2,1656,2609,20
31054659395,31054659391,-4,891,2736,20
31055785858,31055785855,-3,1053,1861,20
31057130813,31057130810,-3,867,2096,20
31058210103,31058210098,-5,741,2051,20
31060530184,31060530187,3,1612,1716,20
31063285753,31063285751,-2,964,1778,20
31063694785,31063694783,-2,1000,1536,20
31064730921,31064730918,-3,1293,2620,20
31065612765,31065612761,-4,944,1850,20
31070038553,31070038549,-4,1289,3230,20
31070534462,31070534455,-7,1262,2330,20
31071824339,31071824334,-5,1153,2333,20
31072452189,31072452186,-3,979,2650,20
31074944791,31074944789,-2,388,1815,20
31077242457,31077242456,-1,1625,2252,20
31078473779,31078473778,-1,898,2093,20
31079438263,31079438257,-6,1476,2931,20
31087664487,31087664486,-1,1045,2299,20
31090026599,31090026599,0,810,2064,20
31093133846,31093133843,-3,1132,2537,20
31099335078,31099335076,-2,1003,2200,20
31104012373,31104012378,5,3485,1876,20
31106451699,31106451696,-3,686,1392,20
31109407245,31109407242,-3,1201,2203,20
31111307274,31111307271,-3,1140,2238,20
31116325678,31116325676,-2,1090,2315,20
31117633951,31117633948,-3,1004,2475,20
31124758080,31124758076,-4,1151,2476,20
31132969916,31132969914,-2,1399,2074,20
31135456480,31135456477,-3,1329,2511,20
31137370328,31137370325,-3,1044,2470,20
31139794513,31139794512,-1,1700,2456,20
31140968247,31140968245,-2,1438,2046,20
31141713730,31141713726,-4,863,1743,20
31143857350,31143857359,9,3787,848,20
31147784816,31147784813,-3,1531,3042,20
31149775951,31149775946,-5,1292,2766,20
31151319862,31151319857,-5,915,2307,20
31153534429,31153534426,-3,1185,2768,20
31155286652,31155286653,1,857,1442,20
31156958358,31156958354,-4,1317,2234,20
31157356462,31157356458,-4,1180,2413,20
31159980995,31159980993,-2,1338,2027,20
31163071531,31163071530,-1,1517,2984,20
31163988162,31163988159,-3,647,1461,20
31164211623,31164211602,-21,1066,2322,20
31164783148,31164783146,-2,1444,1868,20
31168483905,31168483900,-5,1092,2123,20
31168709381,31168709400,19,1115,2295,20
31170172852,31170172846,-6,1090,3038,20
31170368633,31170368632,-1,815,1991,20
31174682789,31174682798,9,11044,37737,20
31183785497,31183785493,-4,1195,4017,20
31184684433,31184684430,-3,943,2368,20
31186740550,31186740550,0,1079,2618,20
31188249210,31188249207,-3,1297,2115,20
31189511918,31189511918,0,1016,1835,20
31190505590,31190505588,-2,1334,2140,20
31191676885,31191676882,-3,1297,2796,20
31193425389,31193425383,-6,1374,2556,20
31197747811,31197747807,-4,701,1444,20
31201770554,31201770550,-4,1380,2145,20
31210008607,31210008605,-2,1183,2184,20
31210381426,31210381424,-2,911,1764,20
31214857318,31214857314,-4,1245,3354,20
31215011351,31215011354,3,2442,3199,20
31219119557,31219119557,0,1054,1885,20
31220010277,31220010275,-2,1327,2495,20
31222596397,31222596395,-2,1021,1944,20
31223008586,31223008585,-1,1468,1996,20
31235521482,31235521481,-1,1101,2506,20
31236756446,31236756437,-9,1523,6918,20
31236816182,31236816201,19,526,864,20
31238484234,31238484231,-3,1387,2698,20
31238511586,31238511587,1,907,1920,20
31245702890,31245702886,-4,738,2165,20
31245877405,31245877402,-3,968,1543,20
31246163909,31246163906,-3,1139,2259,20
31248738494,31248738493,-1,979,2150,20
31250904334,31250904332,-2,1253,2663,20
31258199307,31258199303,-4,1312,2724,20
31261023991,31261023988,-3,1771,3046,20
31264141685,31264141682,-3,1455,1507,20
31266001416,31266001414,-2,992,2279,20
31266324863,31266324865,2,461,2513,20
31266634844,31266634842,-2,1265,2201,20
31266857487,31266857485,-2,1093,2193,20
31272259194,31272259190,-4,973,2764,20
31276823771,31276823769,-2,1267,2652,20
31278521790,31278521790,0,1211,1409,20
31280783546,31280783545,-1,1245,1715,20
31282660452,31282660449,-3,1704,3006,20
31289968794,31289968794,0,1366,1620,20
31290094814,31290094833,19,973,1742,20
31292185752,31292185755,3,1247,1281,20
31293008263,31293008265,2,1462,1379,20
31296183039,31296183038,-1,1326,2063,20
31296663231,31296663227,-4,916,2977,20
31297040488,31297040486,-2,1108,2146,20
31298720106,31298720104,-2,1065,2038,20
31299275931,31299275926,-5,1455,4430,20
31308475530,31308475526,-4,2002,3303,20
31309283048,31309283046,-2,1217,1802,20
31313173690,31313173687,-3,1448,2954,20
31316098913,31316098913,0,2750,3776,20
31317836010,31317836009,-1,992,1359,20
31322835084,31322835081,-3,846,1641,20
31324159126,31324159125,-1,741,1881,20
31325340052,31325340047,-5,1226,2376,20
31328061377,31328061373,-4,1374,2746,20
31328943603,31328943597,-6,1695,6381,20
31335185214,31335185209,-5,1255,2800,20
31335456031,31335456027,-4,1176,2105,20
31336283719,31336283733,14,487,1568,20
31337110321,31337110319,-2,1411,2761,20
31337456086,31337456078,-8,952,2217,20
31337526637,31337526643,6,3074,1463,20
31338375959,31338375954,-5,794,2474,20
31338874844,31338874855,11,318,1074,20
31340027607,31340027605,-2,862,1994,20
31342905425,31342905422,-3,829,2589,20
31343557203,31343557200,-3,781,2453,20
31344258971,31344258969,-2,1118,2213,20
31347490080,31347490077,-3,1100,2096,20
31357723211,31357723206,-5,1302,2006,20
31358972197,31358972199,2,1744,1468,20
31360208235,31360208233,-2,749,2042,20
31362736808,31362736802,-6,1515,3017,20
31363455435,31363455433,-2,980,2210,20
31363925565,31363925562,-3,1068,1517,20
31365582867,31365582863,-4,934,3479,20
31367976028,31367976025,-3,1318,1618,20
31368200716,31368200723,7,2560,951,20
31372772563,31372772557,-6,895,2475,20
31375523022,31375523029,7,3120,1426,20
31377155710,31377155709,-1,860,1266,20
31386963747,31386963745,-2,1135,2611,20
31390649639,31390649634,-5,976,2500,20
31391981198,31391981195,-3,19475,12372,20
31392048753,31392048757,4,12785,18853,20
31392183023,31392183019,-4,1140,2132,20
31392218715,31392218713,-2,827,1769,20
31395165799,31395165795,-4,1165,2353,20
31399791321,31399791317,-4,1403,2010,20
31400487410,31400487406,-4,780,1751,20
31401977446,31401977443,-3,1123,2080,20
31403922917,31403922911,-6,758,1763,20
31404988603,31404988600,-3,1314,2245,20
31406444175,31406444173,-2,916,1719,20
31408645993,31408645990,-3,1448,1772,20
31410435622,31410435618,-4,800,2448,20
31411192602,31411192597,-5,1468,3052,20
31411246513,31411246511,-2,1282,2008,20
31413408709,31413408710,1,1220,2233,20
31413601500,31413601522,22,1163,2427,20
31415035775,31415035773,-2,1026,2881,20
31419860291,31419860291,0,993,2115,20
31424437061,31424437055,-6,2919,11712,20
31424968399,31424968394,-5,989,2193,20
31425782680,31425782686,6,17090,29241,20
31432903146,31432903146,0,879,2429,20
31434139595,31434139594,-1,933,905,20
31435291019,31435291017,-2,973,2302,20
31438793878,31438793875,-3,1195,2738,20
31449408670,31449408669,-1,800,1858,20
31452063495,31452063494,-1,1029,2428,20
31463642447,31463642444,-3,1287,2313,20
31473292853,31473292849,-4,903,2671,20
31475266278,31475266279,1,1651,2022,20
31478564099,31478564094,-5,1190,2635,20
31481106866,31481106864,-2,1358,2914,20
31481692007,31481692010,3,5740,6231,20
31482598350,31482598347,-3,769,2148,20
31488099191,31488099190,-1,957,2117,20
31489391082,31489391079,-3,732,2094,20
31491514715,31491514705,-10,7666,20741,20
31495003266,31495003264,-2,1089,2055,20
31495978694,31495978673,-21,998,1524,20
31499861306,31499861305,-1,760,1734,20
31502939258,31502939256,-2,2315,2878,20
31504016570,31504016573,3,3482,3034,20
31508273670,31508273666,-4,929,2597,20
31513148674,31513148670,-4,687,1632,20
31513230595,31513230591,-4,897,2070,20
31519147437,31519147433,-4,1375,3113,20
31519187478,31519187474,-4,1542,3655,20
31520463914,31520463911,-3,1301,1469,20
31520661721,31520661719,-2,956,2406,20
31527583532,31527583527,-5,2206,7949,20
31527857478,31527857474,-4,1166,2770,20
31532196292,31532196313,21,820,1971,20
31535063113,31535063134,21,466,1048,20
31539095503,31539095501,-2,961,1756,20
31539708399,31539708398,-1,1250,2033,20
31546889046,31546889043,-3,1344,1933,20
31550548998,31550548996,-2,1298,2918,20
31552178919,31552178918,-1,1075,3340,20
31552830413,31552830410,-3,1413,2565,20
31557300361,31557300356,-5,911,2675,20
31557643743,31557643741,-2,1102,1902,20
31559678976,31559678973,-3,1639,2584,20
31560311130,31560311124,-6,726,2779,20
31561540282,31561540280,-2,1188,1801,20
31562690444,31562690439,-5,1183,2747,20
31565120616,31565120609,-7,2199,10047,20
31569792464,31569792461,-3,1148,2172,20
31570484094,31570484090,-4,27168,10111,20
31573028965,31573028964,-1,1933,2636,20
31577331682,31577331679,-3,1482,3026,20
31578922106,31578922106,0,1392,3053,20
31583231374,31583231373,-1,836,2315,20
31588010435,31588010432,-3,1009,2137,20
31590094853,31590094854,1,1017,1617,20
31590798546,31590798543,-3,1007,2206,20
31595139647,31595139643,-4,1437,3778,20
31595575060,31595575054,-6,789,1969,20
31595847776,31595847791,15,842,1815,20
31598712999,31598712994,-5,1011,2788,20
31605281870,31605281864,-6,1312,4773,20
31607181735,31607181735,0,1889,1784,20
31608046612,31608046606,-6,1606,2707,20
31609753965,31609753962,-3,1322,2211,20
31618286674,31618286670,-4,1051,3169,20
31618738534,31618738533,-1,1318,2602,20
31623684332,31623684330,-2,972,2898,20
31625626570,31625626584,14,732,263,20
31626090623,31626090617,-6,932,2267,20
31629849330,31629849329,-1,1129,1623,20
31630053061,31630053053,-8,1466,3105,20
31630800789,31630800784,-5,1817,3675,20
31631201541,31631201538,-3,1011,2447,20
31634979395,31634979392,-3,1145,2422,20
31637400096,31637400093,-3,873,1351,20
31638469353,31638469359,6,5203,2106,20
31639465414,31639465410,-4,943,1688,20
31640629706,31640629703,-3,1040,2525,20
31641441962,31641441950,-12,290,963,20
31651542366,31651542365,-1,1504,2359,20
31654595390,31654595388,-2,935,2623,20
31655836126,31655836122,-4,1088,2102,20
31657990365,31657990361,-4,1067,2316,20
31658937779,31658937777,-2,1153,2438,20
31665172883,31665172881,-2,1174,2000,20
31669785997,31669785993,-4,1372,2694,20
31674073818,31674073817,-1,1163,2979,20
31675025338,31675025334,-4,921,1671,20
31679199179,31679199178,-1,570,1914,20
31679791633,31679791630,-3,1096,1966,20
31685322791,31685322788,-3,954,1658,20
31690127547,31690127553,6,3735,1269,20
31690959479,31690959476,-3,1017,2680,20
31696808979,31696808979,0,1210,2062,20
31704085941,31704085938,-3,1054,2087,20
31707900877,31707900873,-4,1169,1914,20
31708476765,31708476767,2,2917,3558,20
31709619568,31709619562,-6,1074,4122,20
31713022235,31713022233,-2,1407,1899,20
31715850336,31715850333,-3,965,2380,20
31717091838,31717091834,-4,1287,3823,20
31717359126,31717359142,16,736,1250,20
31717728915,31717728922,7,3031,992,20
31720414859,31720414857,-2,941,2055,20
31729587518,31729587518,0,1121,2300,20
31735123166,31735123167,1,1425,2305,20
31736143475,31736143474,-1,1281,1790,20
31742459654,31742459661,7,7708,38605,20
31748555371,31748555365,-6,1087,2821,20
31749215978,31749215974,-4,26639,8234,20
31750292153,31750292148,-5,1871,6505,20
31750728807,31750728802,-5,662,1518,20
31752655766,31752655764,-2,781,2167,20
31754590513,31754590512,-1,1275,2402,20
31762053488,31762053484,-4,1057,3208,20
31765056631,31765056638,7,2210,1573,20
31766537258,31766537253,-5,799,1812,20
31770144191,31770144188,-3,661,949,20
31773667707,31773667706,-1,1477,2675,20
31779945205,31779945202,-3,1165,2417,20
31782594114,31782594110,-4,867,2370,20
31783788740,31783788737,-3,1333,2487,20
31787062213,31787062205,-8,44794,14819,20
31792650422,31792650420,-2,1004,1951,20
31799032421,31799032421,0,1076,1415,20
31799229280,31799229278,-2,1161,2686,20
31801874418,31801874415,-3,1088,1938,20
31802110023,31802110029,6,261,1395,20
31804563611,31804563611,0,718,989,20
31804943142,31804943133,-9,904,2393,20
31805530782,31805530798,16,975,2027,20
31809578894,31809578897,3,2480,1497,20
31813729622,31813729618,-4,1537,2516,20
31816918458,31816918454,-4,1545,4591,20
31820148017,31820148014,-3,1586,2507,20
31820606858,31820606856,-2,1025,2492,20
31824545434,31824545433,-1,969,2270,20
31826543360,31826543354,-6,931,2276,20
31826576940,31826576939,-1,2681,4134,20
31830799692,31830799689,-3,1100,2248,20
31838995660,31838995657,-3,1181,2634,20
31841134925,31841134922,-3,797,1801,20
31851781266,31851781265,-1,1286,2848,20
31853820210,31853820209,-1,1044,2032,20
31857360493,31857360489,-4,1978,3331,20
31863279570,31863279567,-3,1090,1739,20
31865217961,31865217957,-4,973,2083,20
31867841814,31867841812,-2,1203,2662,20
31870114198,31870114196,-2,663,2729,20
31870223791,31870223786,-5,1003,2584,20
31870406230,31870406234,4,3346,1833,20
31872246057,31872246055,-2,1184,1816,20
31872818605,31872818601,-4,1323,2278,20
31874568083,31874568085,2,1850,1546,20
31874622191,31874622186,-5,1053,2258,20
31875241454,31875241452,-2,1055,2247,20
31878576051,31878576046,-5,924,2677,20
31878941206,31878941220,14,700,1620,20
31880228331,31880228329,-2,1092,2485,20
31881590066,31881590063,-3,867,2002,20
31882024739,31882024738,-1,1139,2262,20
31886562274,31886562270,-4,1007,2775,20
31889933678,31889933676,-2,1311,1938,20
31891777320,31891777318,-2,1347,2303,20
31891942895,31891942914,19,548,1248,20
31895878626,31895878625,-1,1341,2513,20
31896137048,31896137047,-1,1088,1755,20
31900840833,31900840829,-4,1125,2472,20
31901417335,31901417312,-23,1144,2593,20
31902159818,31902159812,-6,1234,3498,20
31909118727,31909118724,-3,906,1863,20
31915341277,31915341278,1,975,2349,20
31915902414,31915902410,-4,1216,1746,20
31917677072,31917677075,3,1331,940,20
31920965702,31920965699,-3,1305,2808,20
31921018586,31921018584,-2,802,1900,20
31923430259,31923430255,-4,874,2006,20
31924119666,31924119665,-1,606,1120,20
31926433921,31926433917,-4,1139,3378,20
31928683105,31928683102,-3,1276,2388,20
31930804331,31930804329,-2,700,2314,20
31933666022,31933666017,-5,1336,3589,20
31936760417,31936760412,-5,1466,2538,20
31938839573,31938839579,6,3251,1500,20
31946054586,31946054587,1,1461,1382,20
31947970683,31947970681,-2,1556,2319,20
31959795621,31959795626,5,2379,673,20
31964655778,31964655777,-1,1080,1549,20
31966057755,31966057752,-3,1601,3059,20
31967451178,31967451175,-3,1341,2645,20
31973257074,31973257070,-4,1349,2848,20
31977477312,31977477310,-2,987,1762,20
31978234266,31978234259,-7,2658,7804,20
31981700614,31981700612,-2,1114,1696,20
31982847686,31982847685,-1,757,1202,20
31983905711,31983905707,-4,1076,1626,20
31986495077,31986495073,-4,1102,2342,20
31988188281,31988188278,-3,1263,2235,20
31989638586,31989638589,3,8865,16131,20
31989704245,31989704243,-2,1120,2254,20
31992385006,31992385005,-1,941,2065,20
31994871623,31994871619,-4,1187,2923,20
31996600027,31996600025,-2,1389,2306,20
32002551237,32002551235,-2,1229,1106,20
32005175007,32005175007,0,1225,1972,20
32009316371,32009316370,-1,1087,2324,20
32012201996,32012201993,-3,1221,2049,20
32015343516,32015343515,-1,1266,1806,20
32018150326,32018150323,-3,872,1788,20
32024726200,32024726202,2,1840,1201,20
32024827971,32024827969,-2,1564,2741,20
32025094759,32025094755,-4,983,2401,20
32033534460,32033534458,-2,1894,2713,20
32036560991,32036560990,-1,924,2110,20
32038907445,32038907443,-2,1181,2080,20
32039282736,32039282731,-5,1487,2486,20
32044507106,32044507103,-3,981,1984,20
32046985431,32046985429,-2,952,2217,20
32047117300,32047117294,-6,912,1669,20
32047281830,32047281828,-2,865,2371,20
32051961754,32051961749,-5,1407,2523,20
32057136741,32057136738,-3,1037,1910,20
32063440559,32063440557,-2,1136,2317,20
32063827598,32063827594,-4,1071,2263,20
32065721659,32065721657,-2,1055,2384,20
32066653565,32066653572,7,9512,35511,20
32070055019,32070055013,-6,1137,1952,20
32070838171,32070838166,-5,1344,2090,20
32071714096,32071714094,-2,1262,2031,20
32071741213,32071741207,-6,1488,2374,20
32076740405,32076740402,-3,1111,2792,20
32080585171,32080585170,-1,634,1347,20
32080860377,32080860373,-4,1023,3027,20
32081674439,32081674434,-5,1102,2351,20
32089128697,32089128692,-5,1141,1978,20
32090339656,32090339658,2,3126,2778,20
32090575544,32090575542,-2,846,1662,20
32093840024,32093840021,-3,967,1910,20
32094140624,32094140642,18,521,871,20
32095789723,32095789722,-1,1285,1797,20
32096787047,32096787044,-3,1039,2070,20
32097221750,32097221747,-3,918,1120,20
32100548745,32100548741,-4,997,1877,20
32100863000,32100862998,-2,1194,2122,20
32101037165,32101037159,-6,803,1805,20
32101273686,32101273681,-5,266,1305,20
32102368902,32102368898,-4,1201,2276,20
32109021754,32109021751,-3,1355,2388,20
32110291902,32110291900,-2,2044,3115,20
32110376437,32110376434,-3,1223,3026,20
32112026201,32112026201,0,1024,1352,20
32116198194,32116198190,-4,1267,2295,20
32116400491,32116400493,2,979,1332,20
32117833426,32117833431,5,6326,3365,20
32119589039,32119589034,-5,900,2353,20
32120096866,32120096869,3,1296,1104,20
32121241273,32121241270,-3,1030,2794,20
32121395968,32121395965,-3,1942,4271,20
32122931054,32122931050,-4,1175,2375,20
32124021815,32124021813,-2,1250,2785,20
32132223138,32132223134,-4,1646,2561,20
32136133923,32136133918,-5,764,2380,20
32136370454,32136370450,-4,940,1740,20
32139126402,32139126399,-3,1255,2355,20
32142456374,32142456366,-8,1020,3065,20
32143860690,32143860687,-3,1081,2297,20
32144924366,32144924362,-4,1255,3386,20
32151925358,32151925353,-5,1295,2572,20
32153274376,32153274373,-3,950,2717,20
32153554428,32153554414,-14,1025,1855,20
32156259930,32156259928,-2,1198,2670,20
32156341417,32156341414,-3,997,2257,20
32156386035,32156386033,-2,1228,2141,20
32157254218,32157254215,-3,489,2049,20
32163592597,32163592593,-4,1125,2380,20
32165185420,32165185434,14,578,1754,20
32166376275,32166376272,-3,1569,2521,20
32169750225,32169750222,-3,1138,3194,20
32173437495,32173437509,14,25419,13093,20
32174062902,32174062902,0,926,1675,20
32175525086,32175525082,-4,1405,2592,20
32176170661,32176170657,-4,728,1305,20
32181703379,32181703376,-3,552,1185,20
32182493791,32182493808,17,1553,2484,20
32189928242,32189928238,-4,1596,4147,20
32190355646,32190355646,0,1825,2150,20
32192773523,32192773522,-1,464,1237,20
32193234438,32193234455,17,676,2427,20
32194285014,32194285012,-2,1097,2687,20
32199497962,32199497960,-2,938,2040,20
32199797019,32199797016,-3,100,91,20
32204439086,32204439085,-1,847,2094,20
32205833041,32205833038,-3,1390,2739,20
32206828847,32206828843,-4,909,2741,20
32208234373,32208234370,-3,574,1573,20
32208283271,32208283270,-1,1127,2473,20
32211376714,32211376710,-4,1302,2019,20
32212125590,32212125587,-3,1150,1264,20
32214595990,32214595986,-4,1028,2671,20
32219536882,32219536877,-5,1430,2777,20
32220786553,32220786540,-13,4151,1187,20
32226674135,32226674133,-2,1258,2791,20
32229587103,32229587097,-6,869,1644,20
32237133913,32237133910,-3,834,2473,20
32238930018,32238930016,-2,1122,3124,20
32240951547,32240951545,-2,1059,2163,20
32241039407,32241039390,-17,1188,2223,20
32245634110,32245634107,-3,1397,2505,20
32250678390,32250678394,4,3117,1549,20
32251151519,32251151513,-6,1077,3092,20
32251505019,32251505016,-3,1105,2952,20
32254510569,32254510569,0,877,1599,20
32256065387,32256065385,-2,755,1984,20
32256397373,32256397390,17,167,485,20
32263800342,32263800338,-4,1465,2552,20
32265720049,32265720046,-3,807,2019,20
32269374486,32269374486,0,1058,1955,20
32270622527,32270622525,-2,1163,2020,20
32274856742,32274856746,4,2118,1300,20
32279399742,32279399740,-2,1366,2466,20
32294254774,32294254769,-5,971,2491,20
32297764695,32297764694,-1,1672,2181,20
32299174859,32299174858,-1,1050,2083,20
32299494530,32299494527,-3,1113,2607,20
32301263034,32301263030,-4,1130,2652,20
32303357093,32303357094,1,1798,1903,20
32304938784,32304938782,-2,1204,2626,20
32311318593,32311318590,-3,1492,2866,20
32318541140,32318541142,2,1633,1709,20
32329036572,32329036569,-3,103105,59032,20
32329749639,32329749635,-4,952,1749,20
32330729779,32330729778,-1,825,2986,20
32334217886,32334217882,-4,1422,3332,20
32338840416,32338840397,-19,334,1323,20
32348722266,32348722265,-1,979,1900,20
32348790157,32348790173,16,601,1263,20
32350142599,32350142596,-3,918,1697,20
32351439178,32351439173,-5,1800,2796,20
32353578900,32353578894,-6,1010,3646,20
32357621242,32357621238,-4,860,2335,20
32364723046,32364723042,-4,1040,2404,20
32367375529,32367375527,-2,1163,1942,20
32369802588,32369802584,-4,1229,2124,20
32373204754,32373204750,-4,845,2506,20
32373870142,32373870139,-3,1249,2146,20
32374178583,32374178581,-2,1548,3079,20
32375479811,32375479809,-2,1294,3000,20
32376895750,32376895754,4,1667,1975,20
32378082874,32378082870,-4,1564,3062,20
32379408902,32379408898,-4,1331,1842,20
32381390587,32381390583,-4,1381,2881,20
32382274467,32382274465,-2,1495,1884,20
32388970942,32388970938,-4,767,1337,20
32389263594,32389263599,5,1239,780,20
32393034258,32393034254,-4,1017,2339,20
32393166204,32393166198,-6,1222,2759,20
32397092886,32397092888,2,1810,1670,20
32400074881,32400074877,-4,1096,2859,20
32405658122,32405658118,-4,1336,2402,20
32406929467,32406929447,-20,1181,2901,20
32406999084,32406999103,19,911,1634,20
32407521359,32407521358,-1,1418,2725,20
32422935633,32422935629,-4,880,1620,20
32423714349,32423714345,-4,1075,2662,20
32424170911,32424170909,-2,829,2692,20
32431325960,32431325967,7,2973,1206,20
32431661191,32431661188,-3,1154,2557,20
32432743450,32432743445,-5,1408,3019,20
32434482174,32434482170,-4,1347,3239,20
32435711235,32435711232,-3,1296,1833,20
32436232203,32436232204,1,1232,1797,20
32438252373,32438252370,-3,1074,1213,20
32440057930,32440057927,-3,911,1837,20
32442084982,32442084979,-3,1121,2007,20
32442664069,32442664067,-2,1746,2425,20
32443722215,32443722214,-1,1182,1878,20
32452304673,32452304670,-3,899,2148,20
32453882914,32453882911,-3,1226,2150,20
32458684618,32458684615,-3,1040,2456,20
32462403650,32462403646,-4,1079,2572,20
32463879647,32463879643,-4,1287,2544,20
32465788395,32465788391,-4,770,2205,20
32471412982,32471412979,-3,1305,2976,20
32473280134,32473280130,-4,908,1713,20
32474023121,32474023117,-4,696,1387,20
32479723242,32479723253,11,216,671,20
32482866675,32482866669,-6,1452,6985,20
32483295526,32483295525,-1,1457,2589,20
32491939034,32491939047,13,405,1283,20
32492829830,32492829830,0,1498,2067,20
32493647713,32493647715,2,2145,2137,20
32494146989,32494146995,6,3679,1530,20
32499191603,32499191600,-3,1147,2470,20
32499455197,32499455193,-4,1224,3309,20
32500981438,32500981435,-3,907,1683,20
32501334287,32501334286,-1,1493,2520,20
32511233030,32511233027,-3,3024,4630,20
32513353475,32513353485,10,12092,36144,20
32515080027,32515080024,-3,1028,2093,20
32518360714,32518360722,8,4172,1735,20
32519138324,32519138324,0,1440,2233,20
32529276022,32529276026,4,1198,1249,20
32540964249,32540964246,-3,1290,2232,20
32540992975,32540992953,-22,1045,2474,20
32543671677,32543671675,-2,1426,1790,20
32544404452,32544404448,-4,1377,2337,20
32544595007,32544595004,-3,1265,1629,20
32544957953,32544957950,-3,674,2595,20
32545227337,32545227335,-2,1300,1949,20
32546759159,32546759154,-5,1019,2454,20
32549854420,32549854439,19,619,1060,20
32551645084,32551645077,-7,1240,2931,20
32554446649,32554446645,-4,1101,2037,20
32561665229,32561665232,3,1857,1901,20
32562076442,32562076440,-2,957,1984,20
32564615889,32564615891,2,36671,36909,20
32568809323,32568809318,-5,897,1858,20
32570815430,32570815426,-4,1297,2922,20
32571768005,32571768001,-4,1071,1924,20
32578887374,32578887370,-4,935,2068,20
32579597474,32579597471,-3,1222,1858,20
32583635231,32583635228,-3,1442,3681,20
32586732926,32586732926,0,10985,15272,20
32586976353,32586976350,-3,1391,2432,20
32595642293,32595642290,-3,1389,1766,20
32607697941,32607697937,-4,1566,3195,20
32607946527,32607946523,-4,1474,3498,20
32614286850,32614286855,5,2448,1352,20
32615424556,32615424553,-3,934,1516,20
32620426278,32620426275,-3,907,2653,20
32623602209,32623602203,-6,861,3848,20
32626623934,32626623932,-2,922,2378,20
32627260389,32627260387,-2,1308,2536,20
32627349091,32627349089,-2,478,1284,20
32628393834,32628393831,-3,811,2282,20
32631330385,32631330380,-5,2515,5346,20
32631668206,32631668205,-1,1730,3045,20
32632031390,32632031389,-1,1102,2017,20
32634398245,32634398242,-3,1310,2870,20
32635863043,32635863040,-3,1208,2619,20
32636219332,32636219330,-2,945,2061,20
32638933194,32638933190,-4,907,3484,20
32639776109,32639776131,22,682,2042,20
32640403713,32640403711,-2,641,1807,20
32641136125,32641136122,-3,740,1698,20
32644459026,32644459023,-3,1024,3244,20
32645067543,32645067540,-3,974,1924,20
32645646540,32645646558,18,893,2019,20
32646075845,32646075835,-10,292,897,20
32646534713,32646534711,-2,1584,2885,20
32646566788,32646566786,-2,1594,2621,20
32649808065,32649808063,-2,1214,2867,20
32659016547,32659016541,-6,456,2411,20
32660327115,32660327109,-6,1313,2485,20
32660752783,32660752779,-4,939,2042,20
32661174980,32661174975,-5,983,2613,20
32665760751,32665760751,0,4345,7929,20
32667647734,32667647731,-3,1032,2139,20
32667881471,32667881469,-2,334,788,20
32669793362,32669793359,-3,1494,3006,20
32671907108,32671907092,-16,982,2421,20
32678785493,32678785490,-3,927,1690,20
32682623114,32682623111,-3,915,2683,20
32684948372,32684948371,-1,1304,2547,20
32693173653,32693173651,-2,914,1224,20
32697834231,32697834227,-4,1116,2445,20
32698722465,32698722462,-3,1234,2923,20
32704938154,32704938154,0,1287,1578,20
32710947710,32710947709,-1,1199,1890,20
32715462949,32715462946,-3,955,2244,20
32718170858,32718170855,-3,1131,2047,20
32720155011,32720155006,-5,909,1501,20
32720969319,32720969316,-3,1250,2052,20
32724734346,32724734344,-2,1139,2301,20
32726377012,32726377009,-3,1324,2029,20
32728070574,32728070572,-2,1409,2486,20
32728339548,32728339539,-9,1053,3563,20
32731217834,32731217831,-3,893,1568,20
32731300027,32731300022,-5,1360,3910,20
32731618190,32731618207,17,765,2017,20
32731950662,32731950660,-2,1557,3134,20
32736082955,32736082951,-4,1379,1792,20
32738124628,32738124629,1,31753,31832,20
32739325803,32739325802,-1,1252,1761,20
32739882830,32739882826,-4,982,2795,20
32740513929,32740513929,0,2039,3097,20
32745957629,32745957635,6,3567,1242,20
32746596454,32746596449,-5,1007,2653,20
32748838838,32748838837,-1,1225,1679,20
32749335996,32749335981,-15,84,3445,20
32754502735,32754502726,-9,1819,7393,20
32760380223,32760380221,-2,1063,2314,20
32761853523,32761853522,-1,908,1874,20
32761993703,32761993723,20,2024,3086,20
32765930145,32765930142,-3,783,2365,20
32766558298,32766558298,0,1583,1184,20
32766864845,32766864841,-4,984,2335,20
32771965564,32771965552,-12,976,1813,20
32776531194,32776531190,-4,1629,3430,20
32778708386,32778708382,-4,1333,2986,20
32780283262,32780283261,-1,911,2057,20
32785246725,32785246722,-3,5821,11987,20
32785499694,32785499700,6,5648,2790,20
32787358019,32787358018,-1,1002,2593,20
32788409836,32788409834,-2,1133,2541,20
32794089055,32794089055,0,1200,2203,20
32798992878,32798992878,0,996,1514,20
32800253870,32800253865,-5,1149,2142,20
32800749427,32800749423,-4,978,2253,20
32801317288,32801317302,14,455,1662,20
32802065817,32802065816,-1,1153,1822,20
32806566009,32806566011,2,1411,1599,20
32806860558,32806860577,19,1648,2871,20
32808027724,32808027725,1,1055,1795,20
32808058959,32808058957,-2,1171,1670,20
32809803539,32809803537,-2,1240,2777,20
32809887653,32809887675,22,1184,2100,20
32810970462,32810970460,-2,1291,3048,20
32811399278,32811399282,4,1917,1061,20
32813616202,32813616199,-3,1148,2373,20
32817073335,32817073331,-4,745,2065,20
32822453239,32822453236,-3,1095,3087,20
32824909491,32824909487,-4,581,1316,20
32828962412,32828962410,-2,1387,2090,20
32830078801,32830078798,-3,965,2256,20
32834673770,32834673769,-1,1400,2395,20
32842624561,32842624558,-3,1373,3222,20
32843861218,32843861215,-3,863,2853,20
32850730787,32850730781,-6,1148,3111,20
32852629804,32852629801,-3,1293,3102,20
32852761549,32852761546,-3,1287,2421,20
32854936468,32854936473,5,2874,1398,20
32864975721,32864975717,-4,1349,3582,20
32876644088,32876644084,-4,1295,2067,20
32876770111,32876770107,-4,1806,3374,20
32878637075,32878637073,-2,913,2235,20
32879190467,32879190464,-3,1189,2162,20
32883240261,32883240257,-4,1422,3068,20
32884483200,32884483190,-10,235,878,20
32884774598,32884774594,-4,1278,2877,20
32888262661,32888262657,-4,1749,2472,20
32889975526,32889975521,-5,1195,3315,20
32891612722,32891612722,0,2136,1923,20
32896749782,32896749778,-4,734,1727,20
32896877781,32896877778,-3,853,1740,20
32898175234,32898175229,-5,743,1949,20
32899465834,32899465832,-2,1167,3843,20
32904942604,32904942602,-2,1384,2077,20
32907576443,32907576440,-3,1372,2827,20
32907993193,32907993188,-5,933,2218,20
32911845228,32911845222,-6,1156,2937,20
32912935283,32912935279,-4,1090,2001,20
32913138007,32913138004,-3,953,1926,20
32913655151,32913655147,-4,1154,3595,20
32915001473,32915001471,-2,1488,2646,20
32919376922,32919376920,-2,1140,1779,20
32920507934,32920507930,-4,1465,2311,20
32920710018,32920710026,8,2856,1107,20
32921360100,32921360097,-3,963,3174,20
32925090972,32925090969,-3,1219,2065,20
32940592746,32940592742,-4,1285,3257,20
32941729638,32941729634,-4,1412,2862,20
32943777301,32943777298,-3,958,2175,20
32944572206,32944572184,-22,945,1971,20
32948956686,32948956684,-2,1534,2931,20
32949024347,32949024342,-5,1074,2581,20
32949471580,32949471583,3,4038,3355,20
32951326064,32951326063,-1,1024,2139,20
32956079170,32956079166,-4,1075,2812,20
32963065377,32963065373,-4,1176,2358,20
32970167963,32970167959,-4,1225,3049,20
32971903265,32971903262,-3,1659,3174,20
32973922957,32973922958,1,1217,1651,20
32974881446,32974881445,-1,1635,2821,20
32975808692,32975808689,-3,1029,2353,20
32984235697,32984235695,-2,978,2669,20
32985369622,32985369639,17,828,2443,20
32985614674,32985614670,-4,1020,1937,20
32986792271,32986792269,-2,1202,1835,20
32990244469,32990244466,-3,1144,1838,20
32991812435,32991812431,-4,1290,2318,20
32993086351,32993086348,-3,1215,3574,20
32993573232,32993573230,-2,1110,1718,20
32993915533,32993915529,-4,826,2135,20
32996683604,32996683601,-3,1243,2619,20
33000195925,33000195906,-19,167,877,20
33007183663,33007183661,-2,1093,2336,20
33008106407,33008106405,-2,1124,1268,20
33009957806,33009957800,-6,6760,29339,20
33010798631,33010798627,-4,1369,2188,20
33013892970,33013892966,-4,1611,2814,20
33014110318,33014110315,-3,863,1111,20
33020325625,33020325622,-3,943,2024,20
33023219550,33023219546,-4,795,2122,20
33034086893,33034086889,-4,1119,2684,20
33040487577,33040487573,-4,844,1866,20
33041547614,33041547622,8,2315,1266,20
33042958283,33042958302,19,1345,3006,20
33047495151,33047495148,-3,1185,2182,20
33047821913,33047821910,-3,1387,2655,20
33049799863,33049799856,-7,390,2195,20
33054299094,33054299094,0,1546,2003,20
33058024268,33058024265,-3,657,2620,20
33062322350,33062322347,-3,967,2930,20
33063167555,33063167553,-2,1365,2461,20
33066051045,33066051046,1,1027,1495,20
33068338888,33068338885,-3,877,2578,20
33070515401,33070515398,-3,1252,2087,20
33071524192,33071524189,-3,1246,2502,20
33080514983,33080514978,-5,1083,2808,20
33082923768,33082923764,-4,601,2522,20
33086643641,33086643638,-3,1148,2201,20
33087586160,33087586157,-3,652,2080,20
33090293200,33090293199,-1,2193,3486,20
33090326409,33090326407,-2,467,1183,20
33096646742,33096646739,-3,1453,2878,20
33099045750,33099045748,-2,811,1777,20
33102987946,33102987943,-3,1052,2599,20
33103877802,33103877799,-3,1041,1945,20
33103954569,33103954565,-4,1062,2882,20
33105533482,33105533481,-1,1448,1686,20
33108860247,33108860244,-3,1003,3285,20
33109486922,33109486918,-4,798,2330,20
33111867458,33111867454,-4,794,2203,20
33112499127,33112499128,1,1108,2097,20
33115337667,33115337662,-5,1328,2991,20
33119019455,33119019454,-1,1783,2462,20
33126841377,33126841377,0,1942,2870,20
33129869854,33129869850,-4,785,1843,20
33132763835,33132763831,-4,819,1533,20
33134495213,33134495198,-15,1148,864,20
33134820169,33134820166,-3,1223,2707,20
33137821163,33137821171,8,1061,1380,20
33138207954,33138207953,-1,1221,1987,20
33148378126,33148378123,-3,1193,3052,20
33149543759,33149543753,-6,1088,2217,20
33158665745,33158665741,-4,990,2573,20
33159956447,33159956446,-1,926,1932,20
33160250663,33160250658,-5,701,2500,20
33170608930,33170608931,1,579,739,20
33171588516,33171588513,-3,1025,2397,20
33172724798,33172724817,19,492,1568,20
33176334901,33176334898,-3,1229,2203,20
33177089726,33177089707,-19,848,2142,20
33180458983,33180458980,-3,803,2226,20
33181024204,33181024227,23,1247,2577,20
33181491082,33181491081,-1,702,2286,20
33183721007,33183721006,-1,1232,2356,20
33183747191,33183747198,7,39,1038,20
33188019810,33188019806,-4,1068,2997,20
33188556566,33188556552,-14,1478,2672,20
33190410613,33190410610,-3,971,1601,20
33192063601,33192063598,-3,1556,2444,20
33192630302,33192630304,2,1797,1974,20
33195925925,33195925922,-3,1190,1883,20
33203259406,33203259402,-4,952,1859,20
33207510590,33207510586,-4,1042,2963,20
33210873870,33210873868,-2,1240,1850,20
33211667490,33211667493,3,632,1185,20
33214067065,33214067062,-3,1324,2446,20
33215457726,33215457722,-4,771,1230,20
33215751594,33215751590,-4,1414,2699,20
33216469442,33216469438,-4,1023,2409,20
33218099198,33218099194,-4,931,2645,20
33218884260,33218884283,23,539,1032,20
33220744846,33220744846,0,1304,2821,20
33222511030,33222511032,2,3238,3414,20
33222979051,33222979046,-5,1464,4228,20
33223123339,33223123338,-1,679,1888,20
33224015871,33224015890,19,797,1321,20
33226026072,33226026070,-2,1148,2254,20
33226283107,33226283111,4,2184,862,20
33229072616,33229072622,6,2398,1279,20
33230432574,33230432575,1,24756,17413,20
33231822627,33231822622,-5,1571,2687,20
33234850962,33234850958,-4,704,1978,20
33234882758,33234882742,-16,1447,3091,20
33236399558,33236399555,-3,1589,2452,20
33237311803,33237311802,-1,1048,2335,20
33237492973,33237492995,22,1058,2081,20
33241666635,33241666634,-1,1505,2974,20
33243076243,33243076241,-2,1627,3564,20
33243814011,33243814008,-3,1101,2234,20
33245672577,33245672574,-3,1366,3028,20
33246988191,33246988189,-2,1165,2125,20
33247475135,33247475134,-1,1289,2478,20
33248563010,33248563007,-3,1357,1729,20
33252942502,33252942501,-1,937,2333,20
33255998698,33255998697,-1,1067,2117,20
33263791321,33263791317,-4,1059,2214,20
33270907130,33270907127,-3,1456,2092,20
33275736289,33275736293,4,2079,1934,20
33284246063,33284246057,-6,1034,2276,20
33285907778,33285907777,-1,1193,1592,20
33289659159,33289659157,-2,1062,2112,20
33291091314,33291091311,-3,1187,3096,20
33291506582,33291506590,8,3694,1427,20
33300781346,33300781346,0,1320,2899,20
33302786170,33302786169,-1,1122,2876,20
33303225403,33303225401,-2,1012,2868,20
33305329702,33305329700,-2,1056,1656,20
33308887622,33308887623,1,1032,1321,20
33312490765,33312490762,-3,879,2396,20
33313950142,33313950138,-4,1321,3192,20
33315652446,33315652441,-5,1121,2911,20
33316911797,33316911818,21,1281,1866,20
33321025644,33321025642,-2,1420,1707,20
33322004254,33322004251,-3,1080,2182,20
33323123061,33323123055,-6,336,896,20
33323884785,33323884783,-2,1211,2189,20
33327602807,33327602801,-6,955,1870,20
33327986062,33327986051,-11,907,1599,20
33329798723,33329798721,-2,1069,2367,20
33330399122,33330399121,-1,1272,1905,20
33332407152,33332407149,-3,1226,1972,20
33335776668,33335776662,-6,1226,2744,20
33341259070,33341259076,6,3338,1419,20
33346219546,33346219542,-4,1018,3111,20
33352365198,33352365193,-5,517,1283,20
33355344241,33355344243,2,2228,1936,20
33356097154,33356097154,0,1050,1640,20
33361404586,33361404584,-2,1112,1861,20
33361829454,33361829471,17,666,1948,20
33363346548,33363346546,-2,46238,21294,20
33372038559,33372038557,-2,1138,1764,20
33378431375,33378431374,-1,1595,2771,20
33381908365,33381908370,5,2751,1771,20
33385477464,33385477464,0,954,1565,20
33387734467,33387734465,-2,1123,2974,20
33389121114,33389121111,-3,1530,2464,20
33390368445,33390368442,-3,1512,2575,20
33397205198,33397205198,0,1443,2032,20
33400200354,33400200352,-2,1590,2854,20
33400491452,33400491449,-3,1731,2276,20
33401184051,33401184050,-1,1471,2064,20
33401505363,33401505360,-3,1173,1682,20
33405297043,33405297039,-4,1134,3298,20
33410190229,33410190237,8,17488,20666,20
33420748259,33420748238,-21,1228,2045,20
33438412557,33438412554,-3,1718,3190,20
33449010310,33449010309,-1,1418,1902,20
33449069325,33449069338,13,117,680,20
33454359526,33454359525,-1,1714,3365,20
33455714562,33455714561,-1,882,2033,20
33457746782,33457746777,-5,1127,2518,20
33458980055,33458980050,-5,1120,1937,20
33463292743,33463292741,-2,1184,3004,20
33477130974,33477130971,-3,978,1840,20
33478265905,33478265901,-4,861,1352,20
33480055718,33480055714,-4,1122,3000,20
33485809626,33485809618,-8,1142,2710,20
33488745055,33488745052,-3,1549,2841,20
33489511642,33489511638,-4,1021,2454,20
33493815594,33493815590,-4,1046,1878,20
33496485155,33496485153,-2,936,1986,20
33497135029,33497135026,-3,1261,1976,20
33499350139,33499350137,-2,1048,2363,20
33505898766,33505898762,-4,730,1795,20
33507328142,33507328141,-1,1416,2685,20
33510525335,33510525332,-3,1160,3821,20
33511359206,33511359206,0,1070,2410,20
33512430347,33512430345,-2,1022,3286,20
33515440652,33515440647,-5,1266,2688,20
33516159174,33516159172,-2,852,1577,20
33522736182,33522736181,-1,1062,1949,20
33523103557,33523103553,-4,1255,2341,20
33527409716,33527409703,-13,8191,38782,20
33527812035,33527812033,-2,988,2190,20
33530597306,33530597303,-3,983,2224,20
33534503683,33534503678,-5,946,2528,20
33535259518,33535259514,-4,844,2504,20
33536404822,33536404811,-11,929,2278,20
33537943805,33537943803,-2,1000,2793,20
33549805850,33549805846,-4,1111,2439,20
33551014488,33551014493,5,2644,1611,20
33553538239,33553538236,-3,1020,2126,20
33557732731,33557732729,-2,1542,5064,20
33557843671,33557843668,-3,1093,2112,20
33558373182,33558373201,19,1056,1930,20
33564384438,33564384437,-1,1324,2986,20
33565355525,33565355520,-5,1383,3857,20
33565532915,33565532913,-2,1293,2491,20
33574690430,33574690428,-2,1107,2155,20
33577913082,33577913077,-5,689,2450,20
33580088665,33580088665,0,1093,2478,20
33580914223,33580914221,-2,1045,2405,20
33582948431,33582948428,-3,1176,3046,20
33584503707,33584503702,-5,1078,2890,20
33584890174,33584890164,-10,281,1246,20
33585394130,33585394125,-5,877,2939,20
33595510767,33595510765,-2,778,2060,20
33598910877,33598910872,-5,1155,2623,20
33599219615,33599219614,-1,1111,2128,20
33603779030,33603779026,-4,1066,2407,20
33606130157,33606130153,-4,905,1560,20
33610093393,33610093389,-4,979,2260,20
33611826355,33611826351,-4,785,1537,20
33612156710,33612156727,17,862,1958,20
33615957882,33615957880,-2,1339,2346,20
33621504013,33621504009,-4,1229,2072,20
33634836436,33634836436,0,918,1062,20
33636305133,33636305129,-4,1052,2224,20
33641454616,33641454613,-3,956,3142,20
33649851294,33649851293,-1,836,1838,20
33650643090,33650643088,-2,1269,2506,20
33654879870,33654879869,-1,1596,2626,20
33659247855,33659247853,-2,977,1913,20
33665245806,33665245802,-4,865,2146,20
33677561287,33677561286,-1,1312,3032,20
33682621226,33682621224,-2,936,2617,20
33684149237,33684149238,1,1575,2391,20
33694765298,33694765297,-1,1037,2073,20
33696040649,33696040646,-3,1327,2097,20
33701272867,33701272865,-2,768,1975,20
33701864278,33701864273,-5,1097,4270,20
33704067738,33704067735,-3,1428,2117,20
33706242901,33706242901,0,1108,2403,20
33711454358,33711454355,-3,794,2246,20
33713722959,33713722957,-2,1061,1675,20
33725069342,33725069336,-6,955,6321,20
33726199674,33726199672,-2,1106,2543,20
33727910482,33727910481,-1,835,2415,20
33729571958,33729571959,1,974,1699,20
33736535214,33736535214,0,1105,1368,20
33736705446,33736705465,19,1676,2411,20
33737931360,33737931356,-4,1311,2610,20
33747112759,33747112757,-2,1345,2692,20
33750300217,33750300218,1,1344,1382,20
33757113934,33757113930,-4,1240,2862,20
33757359527,33757359530,3,185,959,20
33759243036,33759243033,-3,1163,1953,20
33759637263,33759637258,-5,1394,2841,20
33761910819,33761910814,-5,997,4897,20
33765497851,33765497849,-2,1262,3260,20
33766046518,33766046515,-3,1922,3633,20
33767645421,33767645418,-3,1102,2777,20
33768913895,33768913895,0,1727,2831,20
33772591546,33772591545,-1,819,2407,20
33773355048,33773355053,5,1818,1034,20
33774310649,33774310645,-4,1327,2421,20
33776417722,33776417719,-3,831,1335,20
33777140751,33777140749,-2,971,1769,20
33780095052,33780095047,-5,606,2390,20
33780949830,33780949829,-1,985,1614,20
33785253423,33785253426,3,1497,652,20
33786883911,33786883910,-1,1161,2183,20
33787880777,33787880774,-3,951,1925,20
33792590094,33792590094,0,1295,2014,20
33792753892,33792753881,-11,1038,1612,20
33795329350,33795329349,-1,1555,1654,20
33804185817,33804185816,-1,1837,2748,20
33808094483,33808094478,-5,868,2310,20
33810844938,33810844938,0,1555,1648,20
33812320120,33812320119,-1,1066,1080,20
33821000210,33821000206,-4,1229,2982,20
33821055332,33821055322,-10,1040,3079,20
33821328539,33821328542,3,1050,1018,20
33823212994,33823212991,-3,1079,2600,20
33824349368,33824349380,12,1160,2474,20
33824484066,33824484062,-4,1285,2868,20
33836844938,33836844935,-3,1844,4864,20
33845699753,33845699750,-3,1147,2963,20
33850248762,33850248763,1,2979,3210,20
33854770431,33854770435,4,4087,2565,20
33857692966,33857692964,-2,1139,1994,20
33859500826,33859500822,-4,1229,2743,20
33862707655,33862707651,-4,1062,2094,20
33868347883,33868347879,-4,1709,2550,20
33876652610,33876652606,-4,1458,3027,20
33878253212,33878253210,-2,1437,3922,20
33882648313,33882648311,-2,1102,2734,20
33889172297,33889172298,1,3517,3819,20
33890688211,33890688207,-4,1006,2459,20
33893453706,33893453708,2,1392,1370,20
33893637205,33893637202,-3,919,2897,20
33894871318,33894871313,-5,1499,4308,20
33895817315,33895817313,-2,431,1590,20
33901471944,33901471941,-3,1258,2739,20
33902750061,33902750062,1,1659,1391,20
33903126028,33903126024,-4,1119,2208,20
33908141253,33908141249,-4,1141,4059,20
33908352675,33908352673,-2,1257,2544,20
33909317279,33909317276,-3,1293,2156,20
33913514745,33913514743,-2,1772,2628,20
33922750443,33922750440,-3,810,2161,20
33924169477,33924169482,5,3089,2030,20
33926992483,33926992489,6,21183,37925,20
33927786278,33927786272,-6,951,2283,20
33933038994,33933038992,-2,1042,2372,20
33934016834,33934016831,-3,1200,2539,20
33936099500,33936099497,-3,1189,2541,20
33936875967,33936875966,-1,1040,1939,20
33944089391,33944089389,-2,1517,2892,20
33945791037,33945791033,-4,1371,2589,20
33946907942,33946907939,-3,1060,2152,20
33947243203,33947243201,-2,819,2902,20
33949442586,33949442582,-4,863,3266,20
33954122842,33954122838,-4,1039,2579,20
33966446314,33966446310,-4,718,1879,20
33969351878,33969351873,-5,1095,1929,20
33971236171,33971236170,-1,1474,2095,20
33976605491,33976605488,-3,1146,2029,20
33978338223,33978338220,-3,1273,2591,20
33980842722,33980842719,-3,896,1513,20
33982088366,33982088363,-3,894,2887,20
33984561858,33984561855,-3,1083,2020,20
33986266414,33986266412,-2,1146,2482,20
33992021199,33992021206,7,12245,4618,20
33992840553,33992840549,-4,755,2764,20
33997319339,33997319338,-1,1443,2192,20
33999461027,33999461025,-2,838,1887,20
34006977794,34006977792,-2,782,1785,20
34007036050,34007036046,-4,1245,1716,20
34009373646,34009373642,-4,1222,2001,20
34010775853,34010775851,-2,1210,2139,20
34016289581,34016289583,2,8002,6528,20
34016650982,34016650978,-4,1194,2349,20
34016894366,34016894360,-6,1316,3174,20
34019416262,34019416260,-2,905,2172,20
34020744372,34020744368,-4,712,1412,20
34020983652,34020983648,-4,1194,2216,20
34027000302,34027000296,-6,1118,1991,20
34029172654,34029172653,-1,748,1695,20
34033469923,34033469920,-3,894,2598,20
34034794286,34034794285,-1,1022,1630,20
34034925849,34034925848,-1,1511,2307,20
34035613012,34035613010,-2,1236,2465,20
34036017872,34036017890,18,782,1943,20
34040671417,34040671434,17,842,2015,20
34043202537,34043202559,22,673,1405,20
34043602124,34043602115,-9,941,2431,20
34049254884,34049254883,-1,947,1480,20
34051178582,34051178580,-2,25696,6890,20
34053576894,34053576892,-2,914,1819,20
34059472022,34059472023,1,1662,1540,20
34061498370,34061498366,-4,1095,3831,20
34062299622,34062299618,-4,1327,2439,20
34063480121,34063480118,-3,1188,2305,20
34064642319,34064642316,-3,929,1416,20
34065607566,34065607563,-3,855,1721,20
34072594946,34072594943,-3,968,2306,20
34073564771,34073564769,-2,1400,2332,20
34075571970,34075571967,-3,1315,2572,20
34077437935,34077437932,-3,1262,2188,20
34077876838,34077876834,-4,922,2250,20
34080794497,34080794503,6,4666,1539,20
34088694005,34088694001,-4,1261,3410,20
34090610429,34090610431,2,1752,2180,20
34091150463,34091150461,-2,1069,2639,20
34093819231,34093819230,-1,627,1420,20
34094280292,34094280297,5,153,821,20
34096046595,34096046591,-4,962,2867,20
34100154991,34100154989,-2,1184,2222,20
34101241871,34101241868,-3,973,2230,20
34103519391,34103519389,-2,2896,3680,20
34103574209,34103574206,-3,1600,2577,20
34104358791,34104358787,-4,1347,2838,20
34107129722,34107129721,-1,914,1516,20
34109460663,34109460661,-2,972,2238,20
34109949907,34109949899,-8,1921,10530,20
34112940787,34112940799,12,2444,6162,20
34114339698,34114339696,-2,925,2184,20
34117390326,34117390325,-1,1103,1743,20
34119577013,34119577010,-3,841,2181,20
34120236146,34120236144,-2,816,1940,20
34122446986,34122446976,-10,993,2435,20
34126855691,34126855693,2,2878,2145,20
34128404474,34128404473,-1,1130,1863,20
34129865642,34129865638,-4,1226,2675,20
34130758283,34130758285,2,2468,3595,20
34135041654,34135041651,-3,1004,2465,20
34136289994,34136289992,-2,1084,1892,20
34136931139,34136931137,-2,1291,2344,20
34138961971,34138961966,-5,999,2297,20
34146382930,34146382927,-3,1102,2597,20
34155257894,34155257891,-3,1747,3159,20
34157493354,34157493351,-3,1161,1774,20
34158717271,34158717269,-2,1244,2731,20
34160501740,34160501736,-4,1209,2781,20
34165779717,34165779715,-2,1099,1972,20
34167257591,34167257589,-2,1308,2762,20
34169222269,34169222266,-3,1433,2132,20
34170958576,34170958574,-2,1459,3461,20
34173302278,34173302273,-5,697,2707,20
34173627197,34173627195,-2,1215,2614,20
34180359518,34180359514,-4,1351,2330,20
34180997036,34180997032,-4,1420,3897,20
34181308205,34181308203,-2,1217,1776,20
34185153646,34185153643,-3,1232,3010,20
34186418798,34186418794,-4,1115,2346,20
34187726830,34187726825,-5,977,2267,20
34188952399,34188952393,-6,1066,3006,20
34190170600,34190170595,-5,838,1738,20
34193858123,34193858121,-2,1146,1991,20
34194196348,34194196353,5,176,1362,20
34196689174,34196689172,-2,797,1750,20
34199511039,34199511034,-5,1306,2432,20
34200357088,34200357110,22,878,3492,20
34205471702,34205471700,-2,1212,3166,20
34211729374,34211729372,-2,1047,2725,20
34219137492,34219137486,-6,749,2587,20
34219260212,34219260209,-3,1286,2063,20
34226465743,34226465739,-4,1484,1784,20
34229678344,34229678347,3,1873,1436,20
34243687946,34243687945,-1,916,1615,20
34245795295,34245795293,-2,1495,3129,20
34246495627,34246495625,-2,1146,2750,20
34246574890,34246574888,-2,1290,1989,20
34249121302,34249121299,-3,1481,2073,20
34249716938,34249716959,21,14870,49314,20
34255422109,34255422106,-3,1392,3077,20
34265584283,34265584279,-4,1188,2197,20
34268174194,34268174190,-4,1751,5522,20
34269280046,34269280045,-1,730,1880,20
34269751459,34269751457,-2,716,2297,20
34270004532,34270004517,-15,1858,2825,20
34270421419,34270421416,-3,1156,2486,20
34271721350,34271721356,6,7914,30022,20
34277258985,34277258982,-3,975,2658,20
34278342619,34278342618,-1,992,2620,20
34282224855,34282224853,-2,1045,1807,20
34282621345,34282621342,-3,943,1702,20
34287132329,34287132326,-3,1000,2200,20
34287546061,34287546057,-4,1181,2591,20
34289523434,34289523433,-1,761,1889,20
34294314693,34294314690,-3,1089,1491,20
34295595698,34295595696,-2,1393,2332,20
34301208286,34301208280,-6,885,3223,20
34302352454,34302352451,-3,1877,2961,20
34302455362,34302455359,-3,654,1207,20
34303498787,34303498783,-4,1744,2359,20
34303827378,34303827375,-3,1021,1898,20
34307081478,34307081483,5,2996,1459,20
34309773615,34309773611,-4,1143,2778,20
34310086740,34310086721,-19,1053,1743,20
34314453299,34314453296,-3,795,1519,20
34316337113,34316337108,-5,1465,3387,20
34316734275,34316734273,-2,601,1556,20
34317933062,34317933055,-7,1919,7327,20
34320058273,34320058269,-4,1105,3091,20
34324403757,34324403754,-3,1291,3293,20
34327707901,34327707899,-2,1082,2316,20
34327970676,34327970695,19,152,443,20
34336472466,34336472463,-3,1194,2526,20
34337411658,34337411657,-1,1100,2531,20
34339443135,34339443117,-18,1331,4386,20
34340888125,34340888123,-2,3011,4962,20
34343044279,34343044279,0,927,1469,20
34347036691,34347036686,-5,870,2218,20
34347223623,34347223610,-13,8,850,20
34349962258,34349962257,-1,896,2408,20
34357123802,34357123801,-1,1412,2308,20
34366468322,34366468319,-3,859,1667,20
34366646661,34366646679,18,570,2085,20
34367028540,34367028537,-3,669,2037,20
34367806669,34367806666,-3,1014,2333,20
34370143059,34370143057,-2,954,2271,20
34374257814,34374257815,1,1644,1409,20
34374454667,34374454669,2,24247,18422,20
34378129521,34378129515,-6,804,2294,20
34379631429,34379631426,-3,1088,2288,20
34382062279,34382062274,-5,52227,35565,20
34382302669,34382302669,0,1379,1707,20
34384941154,34384941151,-3,858,1490,20
34395262551,34395262547,-4,982,2745,20
34401758725,34401758721,-4,1097,2659,20
34403115374,34403115370,-4,889,2475,20
34403711366,34403711365,-1,1241,1863,20
34403921959,34403921958,-1,29319,55391,20
34404225439,34404225435,-4,1074,2274,20
34407606578,34407606574,-4,1258,2576,20
34407786674,34407786672,-2,1405,2387,20
34409169782,34409169782,0,1033,1838,20
34415020918,34415020914,-4,1009,2210,20
34418073975,34418073972,-3,1033,2543,20
34418462078,34418462094,16,735,2704,20
34426645576,34426645573,-3,1616,2528,20
34432471763,34432471761,-2,1569,2556,20
34432497660,34432497657,-3,1336,2787,20
34434340097,34434340093,-4,1297,2850,20
34438289423,34438289421,-2,1558,2048,20
34439020488,34439020505,17,307,964,20
34441924130,34441924130,0,1536,1751,20
34442708886,34442708890,4,1695,1159,20
34445687242,34445687242,0,969,1424,20
34452624455,34452624452,-3,651,1947,20
34453411034,34453411033,-1,956,2177,20
34454174798,34454174794,-4,1481,2952,20
34455021987,34455021984,-3,1310,2392,20
34455489023,34455489019,-4,924,2026,20
34455923206,34455923203,-3,918,2750,20
34457161993,34457161990,-3,1185,2282,20
34459829596,34459829593,-3,1233,2871,20
34460372802,34460372797,-5,996,1911,20
34464450320,34464450314,-6,1213,4960,20
34465054045,34465054040,-5,926,2681,20
34465878850,34465878850,0,1156,2294,20
34467273467,34467273465,-2,1007,1905,20
34469884907,34469884893,-14,1300,1394,20
34471371033,34471371030,-3,1255,2195,20
34473787474,34473787471,-3,1057,2596,20
34474613767,34474613782,15,1367,2484,20
34474765629,34474765610,-19,918,2340,20
34475522471,34475522451,-20,1212,2082,20
34477649474,34477649473,-1,933,2062,20
34479369521,34479369519,-2,670,1786,20
34482448127,34482448125,-2,1426,3216,20
34486507301,34486507299,-2,1158,2431,20
34489474285,34489474282,-3,995,3481,20
34491894262,34491894262,0,1038,2280,20
34503604658,34503604654,-4,874,2621,20
34505451866,34505451865,-1,1357,1723,20
34506859356,34506859353,-3,973,2868,20
34507873810,34507873809,-1,1123,2718,20
34512789378,34512789377,-1,747,2004,20
34513468571,34513468569,-2,1165,2414,20
34517726819,34517726815,-4,1215,2142,20
34518085866,34518085865,-1,1768,2474,20
34519160323,34519160320,-3,1136,2689,20
34523418001,34523417998,-3,1023,1709,20
34523872391,34523872411,20,31,951,20
34524609342,34524609339,-3,1290,3181,20
34529658827,34529658829,2,2292,2090,20
34529971567,34529971564,-3,1334,2672,20
34538084891,34538084887,-4,1129,2547,20
34542906201,34542906208,7,2451,1281,20
34553113855,34553113849,-6,1311,1974,20
34555720811,34555720810,-1,1350,2458,20
34562337335,34562337334,-1,915,2165,20
34562789486,34562789494,8,24617,56509,20
34573524267,34573524263,-4,1566,1974,20
34574094806,34574094802,-4,993,1773,20
34576044261,34576044258,-3,1734,1818,20
34582549943,34582549939,-4,938,2341,20
34584020970,34584020966,-4,1267,2950,20
34584622419,34584622416,-3,1032,3256,20
34584713253,34584713245,-8,1222,1716,20
34584786826,34584786823,-3,1090,2176,20
34586884059,34586884057,-2,1298,2303,20
34593281382,34593281378,-4,1109,2352,20
34603194097,34603194094,-3,1198,2906,20
34603464427,34603464422,-5,1288,2530,20
34604848806,34604848806,0,3270,3113,20
34611642845,34611642841,-4,1276,3069,20
34616855127,34616855123,-4,890,1468,20
34617617533,34617617515,-18,193,758,20
34620746524,34620746520,-4,1222,2491,20
34621411562,34621411559,-3,1190,2401,20
34624920309,34624920308,-1,1265,2322,20
34631624891,34631624890,-1,980,2015,20
34633769475,34633769473,-2,1597,1678,20
34633903387,34633903384,-3,1004,2321,20
34634282881,34634282881,0,1331,2081,20
34634907582,34634907581,-1,965,2365,20
34642022377,34642022374,-3,1244,2314,20
34642407215,34642407219,4,282,833,20
34646710217,34646710213,-4,1309,3651,20
34653320241,34653320234,-7,1410,7689,20
34662045605,34662045590,-15,238,621,20
34662869521,34662869519,-2,1545,3242,20
34664104841,34664104835,-6,728,2808,20
34674746131,34674746127,-4,857,1389,20
34677518726,34677518724,-2,809,1880,20
34678297094,34678297093,-1,698,1579,20
34687184979,34687184976,-3,1277,1959,20
34689003663,34689003669,6,3812,1404,20
34690118081,34690118077,-4,1196,2430,20
34691703359,34691703356,-3,632,1481,20
34692146308,34692146317,9,13628,26009,20
34709590207,34709590202,-5,986,2896,20
34709851923,34709851921,-2,1180,1614,20
34713725194,34713725193,-1,1797,3880,20
34715205702,34715205701,-1,1098,3057,20
34718334074,34718334078,4,2226,1716,20
34720299554,34720299550,-4,936,2066,20
34721829111,34721829107,-4,1932,2448,20
34722166793,34722166790,-3,1328,2410,20
34732730496,34732730494,-2,1885,2402,20
34733367554,34733367548,-6,1140,3330,20
34733993512,34733993507,-5,1117,2579,20
34738579882,34738579885,3,2211,2135,20
34750890010,34750890006,-4,1237,2240,20
34751196041,34751196038,-3,1150,2436,20
34753036272,34753036269,-3,1804,3441,20
34757637977,34757637978,1,2094,1544,20
34758017175,34758017174,-1,1006,2773,20
34759089841,34759089838,-3,1227,1823,20
34761631440,34761631436,-4,1313,2675,20
34763106295,34763106293,-2,1039,1683,20
34766002021,34766002021,0,1512,2586,20
34768098895,34768098894,-1,1314,2576,20
34768771306,34768771305,-1,1371,1952,20
34772264864,34772264862,-2,1022,2654,20
34774633063,34774633060,-3,906,2738,20
34778230491,34778230489,-2,1348,1752,20
34779574035,34779574033,-2,972,2148,20
34782719579,34782719577,-2,1612,2020,20
34787746896,34787746899,3,1806,1314,20
34790678037,34790678034,-3,1151,1927,20
34791992574,34791992573,-1,792,1405,20
34794204758,34794204765,7,2386,1183,20
34794604686,34794604684,-2,1199,1880,20
34795516567,34795516585,18,674,2525,20
34797004203,34797004202,-1,1188,2088,20
34797099726,34797099729,3,32390,96895,20
34800466936,34800466934,-2,1032,1906,20
34804407146,34804407141,-5,1049,2386,20
34805096878,34805096858,-20,247,970,20
34807649503,34807649501,-2,1396,3161,20
34815315734,34815315731,-3,1527,2859,20
34817551362,34817551359,-3,1410,2560,20
34818312992,34818312989,-3,1085,2860,20
34820171711,34820171715,4,2089,1224,20
34831292246,34831292239,-7,1163,2783,20
34840800390,34840800387,-3,1166,2277,20
34841850797,34841850793,-4,1473,2717,20
34843945956,34843945954,-2,1583,2737,20
34844031188,34844031185,-3,1173,2611,20
34846068434,34846068433,-1,1114,1811,20
34847713789,34847713786,-3,1370,1992,20
34849582758,34849582753,-5,880,2052,20
34852151085,34852151081,-4,787,2144,20
34852949447,34852949430,-17,243,570,20
34854422126,34854422123,-3,762,2282,20
34859105270,34859105267,-3,1020,3143,20
34859694793,34859694790,-3,586,1339,20
34861840273,34861840273,0,733,1457,20
34863605650,34863605646,-4,1311,2350,20
34863913014,34863913006,-8,1323,2653,20
34864906204,34864906201,-3,1192,1878,20
34865081226,34865081222,-4,945,2883,20
34865237052,34865237038,-14,1261,2120,20
34868078603,34868078597,-6,1348,2551,20
34872349092,34872349090,-2,1054,2128,20
34873084256,34873084253,-3,1246,2762,20
34873581174,34873581170,-4,1174,2276,20
34873796528,34873796523,-5,1054,2181,20
34880040495,34880040491,-4,1122,1831,20
34880674408,34880674423,15,838,1545,20
34882055826,34882055823,-3,937,2541,20
34882930299,34882930295,-4,979,3396,20
34887039263,34887039263,0,1608,2720,20
34887109838,34887109835,-3,769,2050,20
34888225729,34888225725,-4,1590,3062,20
34889770503,34889770498,-5,1448,2906,20
34892559799,34892559799,0,1548,1729,20
34893369997,34893369995,-2,896,2172,20
34893643527,34893643543,16,579,2204,20
34894000021,34894000019,-2,692,1998,20
34895726494,34895726497,3,1699,1256,20
34898697352,34898697349,-3,940,2418,20
34900648865,34900648861,-4,1185,2244,20
34907100718,34907100707,-11,1647,2948,20
34907669527,34907669525,-2,969,2483,20
34908159775,34908159773,-2,1192,1839,20
34913917746,34913917743,-3,940,1943,20
34916025525,34916025522,-3,1263,2647,20
34917747379,34917747374,-5,1297,3155,20
34918709902,34918709900,-2,987,1800,20
34926275834,34926275831,-3,844,2344,20
34928147273,34928147269,-4,1303,2326,20
34928419954,34928419949,-5,851,1868,20
34933826883,34933826881,-2,1166,1865,20
34934305652,34934305646,-6,1323,2900,20
34936576838,34936576834,-4,918,2320,20
34939643215,34939643222,7,8581,3803,20
34943975863,34943975858,-5,1040,1613,20
34949076301,34949076298,-3,1348,2228,20
34949883830,34949883832,2,1502,2218,20
34951105913,34951105918,5,5117,2695,20
34955430835,34955430832,-3,1520,3299,20
34956242082,34956242079,-3,890,2315,20
34961505440,34961505437,-3,1092,1776,20
34962019473,34962019470,-3,1200,1878,20
34969845014,34969845014,0,1629,1926,20
34974988149,34974988146,-3,1191,2129,20
34975977181,34975977178,-3,827,1820,20
34978952059,34978952059,0,1481,2535,20
34983250160,34983250179,19,801,1676,20
34987161447,34987161444,-3,784,2795,20
34987348765,34987348746,-19,890,1268,20
34994916174,34994916177,3,1154,1049,20
34995945471,34995945467,-4,972,1899,20
34996954102,34996954083,-19,759,394,20
35001951893,35001951892,-1,1307,2618,20
35010276635,35010276631,-4,1344,2564,20
35014784748,35014784744,-4,730,2198,20
35018258839,35018258835,-4,931,1629,20
35018664366,35018664357,-9,941,1882,20
35021810302,35021810300,-2,658,1949,20
35023761433,35023761445,12,1152,1101,20
35026296203,35026296199,-4,1207,2973,20
35028377397,35028377393,-4,1204,2832,20
35029534059,35029534057,-2,1547,2862,20
35031113955,35031113950,-5,1221,2936,20
35033966515,35033966513,-2,1372,1853,20
35043169521,35043169520,-1,1436,3262,20
35043786298,35043786292,-6,1417,4665,20
35046431297,35046431302,5,4025,1464,20
35047290651,35047290650,-1,1755,1637,20
35051570084,35051570084,0,841,2229,20
35064826482,35064826498,16,779,3666,20
35069932162,35069932160,-2,1201,1973,20
35070056538,35070056534,-4,1189,2835,20
35071794171,35071794168,-3,646,1545,20
35074887709,35074887706,-3,1395,2572,20
35076606651,35076606646,-5,1370,2975,20
35079154668,35079154664,-4,751,3039,20
35083661606,35083661603,-3,1404,2867,20
35085288017,35085288014,-3,1693,2950,20
35085653490,35085653487,-3,857,2724,20
35085945399,35085945418,19,1001,2065,20
35091373069,35091373069,0,1951,2110,20
35093688007,35093688004,-3,845,2602,20
35102009134,35102009133,-1,1341,1943,20
35104935173,35104935170,-3,1319,3436,20
35107851483,35107851474,-9,1121,10809,20
35111020720,35111020717,-3,1652,3301,20
35112121481,35112121479,-2,1205,1595,20
35120205145,35120205142,-3,681,2379,20
35121754651,35121754648,-3,1095,2974,20
35122888918,35122888915,-3,1191,3509,20
35125997799,35125997797,-2,992,1813,20
35126529500,35126529506,6,3917,1773,20
35128662781,35128662803,22,729,2226,20
35130259109,35130259106,-3,1142,2107,20
35130584765,35130584763,-2,1298,1944,20
35134431887,35134431885,-2,920,2254,20
35135764037,35135764033,-4,1141,2959,20
35135940605,35135940602,-3,765,2327,20
35143394934,35143394942,8,9735,26282,20
35144463182,35144463178,-4,1626,3346,20
35150105443,35150105441,-2,1174,2497,20
35151056049,35151056042,-7,2362,7142,20
35154219477,35154219489,12,12474,46105,20
35154306516,35154306513,-3,1033,3186,20
35155388537,35155388533,-4,1608,3327,20
35158147386,35158147385,-1,957,2095,20
35164774913,35164774911,-2,1473,2941,20
35165518923,35165518927,4,2184,1365,20
35166519635,35166519631,-4,928,1615,20
35172152653,35172152650,-3,789,2290,20
35178904979,35178904987,8,5509,1217,20
35182259595,35182259593,-2,739,3167,20
35182314332,35182314350,18,434,1323,20
35182780790,35182780790,0,1431,2264,20
35186731114,35186731110,-4,1330,2536,20
35187153229,35187153226,-3,1051,2534,20
35187969012,35187969032,20,766,1050,20
35193477362,35193477358,-4,1156,3230,20
35195096534,35195096530,-4,661,1572,20
35200266018,35200266017,-1,1115,2417,20
35204657122,35204657119,-3,1062,2445,20
35207493609,35207493605,-4,1322,3601,20
35209167218,35209167215,-3,1083,1826,20
35209706544,35209706547,3,1678,1541,20
35216245964,35216245961,-3,959,1994,20
35217435618,35217435615,-3,751,2208,20
35220319095,35220319092,-3,1071,2961,20
35222648603,35222648602,-1,506,1700,20
35225821861,35225821869,8,11843,25158,20
35226128734,35226128730,-4,916,1656,20
35226898762,35226898757,-5,924,3504,20
35228200687,35228200698,11,340,1021,20
35228332863,35228332860,-3,1335,2856,20
35228426295,35228426288,-7,1040,2422,20
35232443014,35232443014,0,1172,1780,20
35233142855,35233142852,-3,1130,2505,20
35240453229,35240453225,-4,1145,3415,20
35240489726,35240489723,-3,1159,2603,20
35242830822,35242830822,0,728,1703,20
35245606374,35245606370,-4,764,1908,20
35247204551,35247204552,1,1867,2208,20
35247559445,35247559442,-3,1222,2457,20
35255182087,35255182086,-1,1102,2178,20
35264384746,35264384746,0,1065,1978,20
35265991398,35265991397,-1,1110,2127,20
35266390795,35266390793,-2,1064,2138,20
35277037366,35277037363,-3,1247,2173,20
35278737043,35278737039,-4,800,2124,20
35282116570,35282116570,0,1373,1702,20
35286429344,35286429343,-1,42600,5126,20
35286497247,35286497245,-2,917,1908,20
35289353034,35289353030,-4,615,2072,20
35290043252,35290043248,-4,1197,2595,20
35291474919,35291474917,-2,1292,2477,20
35292856899,35292856896,-3,1727,2771,20
35297325404,35297325421,17,307,2235,20
35298720239,35298720238,-1,1196,2397,20
35299098987,35299098984,-3,1227,1684,20
35300913231,35300913227,-4,798,1550,20
35304644618,35304644614,-4,1123,2741,20
35306429952,35306429931,-21,100,643,20
35309609164,35309609162,-2,1303,2375,20
35314073370,35314073370,0,1569,1412,20
35315355719,35315355714,-5,1036,1757,20
35317164615,35317164612,-3,673,1631,20
35326274363,35326274360,-3,1245,2847,20
35327176588,35327176571,-17,820,1630,20
35328682358,35328682354,-4,943,1659,20
35333708919,35333708917,-2,1261,2262,20
35335408218,35335408217,-1,1197,2541,20
35338872438,35338872437,-1,1859,2219,20
35344156246,35344156244,-2,744,1575,20
35346842403,35346842401,-2,1038,3190,20
35350498866,35350498862,-4,1521,2722,20
35352721002,35352720998,-4,1202,2758,20
35353860237,35353860244,7,3555,1198,20
35359055583,35359055588,5,1319,1261,20
35362002346,35362002341,-5,433,1549,20
35363134491,35363134489,-2,1065,2585,20
35365236538,35365236555,17,1111,1936,20
35366171236,35366171234,-2,1253,2502,20
35367363484,35367363464,-20,789,2092,20
35369236331,35369236326,-5,1077,2424,20
35370421463,35370421461,-2,1695,2115,20
35377256975,35377256973,-2,1297,2009,20
35379245753,35379245750,-3,1279,2753,20
35380162104,35380162100,-4,1192,3763,20
35384487530,35384487529,-1,995,1229,20
35385274871,35385274866,-5,685,2149,20
35388580154,35388580151,-3,1556,2601,20
35391397835,35391397830,-5,2097,4939,20
35392329058,35392329057,-1,876,1386,20
35393407456,35393407454,-2,1259,2934,20
35397824085,35397824083,-2,1294,2161,20
35398625818,35398625821,3,2172,1923,20
35403950310,35403950303,-7,1121,4348,20
35404247790,35404247800,10,145,957,20
35410397077,35410397073,-4,1019,2548,20
35411078373,35411078374,1,16734,17939,20
35419460176,35419460176,0,1056,2154,20
35423141607,35423141604,-3,1393,2560,20
35424171355,35424171351,-4,1729,2600,20
35425832178,35425832177,-1,1129,2243,20
35426407146,35426407141,-5,1275,2005,20
35427931779,35427931775,-4,1056,2280,20
35428309077,35428309095,18,684,1155,20
35433583722,35433583717,-5,868,1651,20
35438720543,35438720539,-4,1007,3279,20
35441854237,35441854243,6,2052,1059,20
35444502010,35444502005,-5,1026,2543,20
35453337470,35453337466,-4,1141,2386,20
35457451363,35457451361,-2,1151,1778,20
35458845739,35458845735,-4,1237,2887,20
35461857878,35461857874,-4,1356,2883,20
35462276912,35462276908,-4,1140,1762,20
35468249993,35468249989,-4,1405,3108,20
35471537312,35471537310,-2,1449,2343,20
35474402203,35474402199,-4,1212,2899,20
35474431502,35474431518,16,106,816,20
35475487519,35475487514,-5,1611,5336,20
35479625174,35479625170,-4,1225,3077,20
35482130536,35482130533,-3,971,2864,20
35486848571,35486848569,-2,1489,2907,20
35489777063,35489777058,-5,1037,1750,20
35489953967,35489953983,16,435,919,20
35491305671,35491305668,-3,752,1710,20
35493657171,35493657169,-2,1517,2701,20
35494292106,35494292104,-2,2087,3528,20
35494406009,35494406014,5,4597,3271,20
35494544724,35494544721,-3,1240,2194,20
35502334101,35502334097,-4,1630,3011,20
35505354135,35505354131,-4,1047,1642,20
35509561787,35509561784,-3,1401,3488,20
35511551357,35511551356,-1,1290,2593,20
35512939822,35512939819,-3,1015,2625,20
35513242787,35513242785,-2,1234,3143,20
35513724086,35513724082,-4,1173,2705,20
35515578272,35515578268,-4,1057,3390,20
35521329530,35521329529,-1,1184,2581,20
35521683647,35521683650,3,1971,1986,20
35521860869,35521860866,-3,1209,2413,20
35536712001,35536711999,-2,1031,2184,20
35538114218,35538114216,-2,1080,2534,20
35544530568,35544530566,-2,1239,2496,20
35545142132,35545142118,-14,867,1802,20
35549953283,35549953282,-1,1000,2380,20
35554869000,35554869002,2,1789,1960,20
35556405757,35556405753,-4,1850,2672,20
35557059543,35557059543,0,1169,1347,20
35558244987,35558244983,-4,995,2400,20
35559668061,35559668081,20,756,1802,20
35560443879,35560443881,2,2573,1850,20
35567319255,35567319253,-2,953,2387,20
35567489205,35567489204,-1,827,2698,20
35572937337,35572937335,-2,753,879,20
35577907187,35577907185,-2,1304,2654,20
35578473655,35578473645,-10,262,1064,20
35578969737,35578969735,-2,1055,1515,20
35580266882,35580266886,4,3392,2309,20
35580313173,35580313171,-2,1521,2219,20
35580356467,35580356465,-2,1170,2631,20
35584101230,35584101228,-2,1229,2197,20
35584658224,35584658221,-3,918,2716,20
35589036966,35589036964,-2,951,2918,20
35595500698,35595500694,-4,1008,1672,20
35595908870,35595908878,8,3549,1140,20
35596452331,35596452311,-20,1425,659,20
35597880483,35597880478,-5,871,2059,20
35599290216,35599290233,17,813,2158,20
35602235774,35602235773,-1,1474,2526,20
35607509319,35607509300,-19,1028,1331,20
35609090146,35609090141,-5,856,2815,20
35609232248,35609232263,15,1262,2997,20
35609267019,35609267017,-2,999,1830,20
35610822830,35610822829,-1,1046,2017,20
35611282491,35611282488,-3,967,2039,20
35613843095,35613843093,-2,1158,2119,20
35615460035,35615460030,-5,976,2534,20
35620496168,35620496166,-2,1006,1762,20
35621072622,35621072618,-4,1023,2073,20
35628975588,35628975589,1,1178,1786,20
35633070138,35633070135,-3,1071,1620,20
35635463972,35635463970,-2,977,2286,20
35638079331,35638079328,-3,1126,2710,20
35639195275,35639195276,1,1789,1652,20
35641484275,35641484275,0,1067,2295,20
35646074776,35646074773,-3,1401,2031,20
35647304890,35647304888,-2,956,2989,20
35647785522,35647785518,-4,1191,2819,20
35655477293,35655477290,-3,1383,3061,20
35657245700,35657245698,-2,1058,2133,20
35658054763,35658054761,-2,993,1797,20
35663263783,35663263783,0,970,2076,20
35673959187,35673959185,-2,1435,3650,20
35675210237,35675210233,-4,1654,3115,20
35677756933,35677756937,4,2528,1849,20
35678164230,35678164225,-5,1414,2154,20
35681096444,35681096443,-1,1212,1171,20
35687433391,35687433387,-4,1016,2046,20
35689150031,35689150023,-8,29086,12735,20
35690923936,35690923952,16,1420,2893,20
35691005381,35691005402,21,1041,2828,20
35699346923,35699346918,-5,1066,2970,20
35700408696,35700408695,-1,1661,2706,20
35700750542,35700750542,0,1500,1498,20
35705095462,35705095455,-7,1422,4873,20
35710389339,35710389335,-4,945,1716,20
35715928471,35715928467,-4,695,2445,20
35716473223,35716473220,-3,1257,2218,20
35720997533,35720997531,-2,1207,2826,20
35722665137,35722665134,-3,978,2268,20
35724865650,35724865649,-1,1148,2068,20
35726220071,35726220066,-5,1544,2700,20
35727708253,35727708252,-1,1117,1808,20
35734565610,35734565606,-4,1052,2002,20
35735331132,35735331129,-3,1265,3012,20
35735528736,35735528734,-2,1279,2074,20
35739397331,35739397326,-5,1398,3089,20
35739503160,35739503157,-3,1452,2638,20
35741443587,35741443585,-2,1027,2395,20
35747494441,35747494438,-3,1348,2340,20
35749906989,35749906985,-4,937,2233,20
35750631338,35750631335,-3,1507,2458,20
35750900530,35750900527,-3,1132,2468,20
35754796032,35754796029,-3,929,1915,20
35756916305,35756916311,6,61732,26100,20
35757265935,35757265934,-1,1061,2398,20
35757961526,35757961522,-4,895,2135,20
35764343678,35764343675,-3,1086,2266,20
35767296128,35767296126,-2,1231,2692,20
35771214035,35771214029,-6,1316,3706,20
35771324072,35771324090,18,1456,2916,20
35777408882,35777408881,-1,1066,1120,20
35784894659,35784894653,-6,889,2206,20
35787281738,35787281733,-5,834,1925,20
35787982754,35787982751,-3,995,1903,20
35788278167,35788278155,-12,182,822,20
35799802690,35799802685,-5,813,3001,20
35800139423,35800139422,-1,2027,1966,20
35813611270,35813611267,-3,1040,2160,20
35819492794,35819492791,-3,1056,2167,20
35821436331,35821436327,-4,1485,2293,20
35822687178,35822687178,0,1363,1500,20
35823655269,35823655273,4,1876,1680,20
35826287514,35826287512,-2,1251,2926,20
35829209554,35829209551,-3,1417,2218,20
35834266213,35834266210,-3,1352,3666,20
35834776622,35834776630,8,3030,1201,20
35834898196,35834898191,-5,793,1970,20
35839885904,35839885922,18,24912,34876,20
35841659250,35841659245,-5,808,1821,20
35846093394,35846093391,-3,953,1893,20
35846655329,35846655329,0,34737,62496,20
35848292822,35848292817,-5,1287,3695,20
35849707103,35849707101,-2,1347,2717,20
35850730253,35850730249,-4,1184,2293,20
35865318402,35865318398,-4,861,2487,20
35868575918,35868575925,7,1832,1151,20
35870318930,35870318938,8,4751,39843,20
35870447592,35870447589,-3,1044,2615,20
35880288851,35880288849,-2,1007,2286,20
35880573814,35880573810,-4,1043,2251,20
35890975678,35890975678,0,942,2142,20
35892662171,35892662167,-4,1434,3250,20
35903422475,35903422472,-3,1432,2842,20
35903451127,35903451125,-2,913,2476,20
35903615740,35903615763,23,669,1370,20
35904233085,35904233083,-2,926,2374,20
35910197519,35910197517,-2,4730,7833,20
35912180797,35912180793,-4,1073,2413,20
35913677463,35913677463,0,1116,2204,20
35915703675,35915703670,-5,1299,3472,20
35917338825,35917338821,-4,847,2071,20
35920670382,35920670363,-19,98,620,20
35926729623,35926729621,-2,1431,2175,20
35930394227,35930394224,-3,1128,2292,20
35931548024,35931548021,-3,1234,2552,20
35935850749,35935850746,-3,1238,2739,20
35938338466,35938338464,-2,1433,2323,20
35939791570,35939791566,-4,916,3404,20
35940030391,35940030374,-17,849,2080,20
35943672574,35943672571,-3,1208,2925,20
35944165607,35944165586,-21,836,3292,20
35946222559,35946222557,-2,1016,1572,20
35947945970,35947945966,-4,952,2329,20
35948009542,35948009562,20,795,2324,20
35950551364,35950551363,-1,1186,1777,20
35951144221,35951144219,-2,614,2334,20
35954880498,35954880497,-1,1377,2620,20
35955838030,35955838029,-1,931,2050,20
35956982219,35956982217,-2,1499,2753,20
35960044488,35960044484,-4,1088,2606,20
35960393086,35960393103,17,369,781,20
35961169790,35961169786,-4,1230,2283,20
35962136243,35962136239,-4,686,2080,20
35966709330,35966709327,-3,728,1604,20
35968872006,35968871999,-7,748,2156,20
35973818482,35973818480,-2,695,1853,20
35977051061,35977051058,-3,1093,2198,20
35979336048,35979336044,-4,735,1482,20
35980301502,35980301498,-4,1105,2196,20
35983155769,35983155765,-4,1366,1414,20
35984267347,35984267343,-4,1630,3163,20
35986208222,35986208219,-3,987,1834,20
35998796708,35998796703,-5,1105,1969,20
35999371215,35999371213,-2,1205,1850,20
36000259574,36000259569,-5,693,3142,20
36002852947,36002852945,-2,1659,2427,20
36009352431,36009352446,15,918,1696,20
36012511099,36012511097,-2,673,1799,20
36012616684,36012616678,-6,1021,2395,20
36013419590,36013419585,-5,1267,3096,20
36014374638,36014374638,0,15976,8246,20
36014443675,36014443670,-5,1321,3293,20
36015025308,36015025327,19,652,1438,20
36021896401,36021896397,-4,1408,2804,20
36035424185,36035424181,-4,1404,2142,20
36037361951,36037361945,-6,973,3049,20
36038818895,36038818894,-1,1068,1908,20
36040404599,36040404598,-1,1008,3157,20
36042158457,36042158454,-3,1005,1711,20
36045746886,36045746882,-4,1367,2727,20
36046932850,36046932847,-3,1470,2991,20
36048205623,36048205621,-2,1200,2113,20
36048354510,36048354507,-3,1277,2259,20
36048709411,36048709406,-5,1214,2993,20
36056065211,36056065207,-4,1167,2125,20
36056498419,36056498416,-3,920,2103,20
36057689474,36057689479,5,1648,908,20
36066657753,36066657759,6,4004,1419,20
36067160438,36067160436,-2,1311,2406,20
36067225527,36067225524,-3,609,1795,20
36071548827,36071548823,-4,973,2884,20
36073365927,36073365923,-4,1081,2625,20
36074043343,36074043340,-3,813,1754,20
36075712394,36075712393,-1,1557,2316,20
36076857778,36076857775,-3,1078,1946,20
36076908244,36076908240,-4,1128,2048,20
36078742828,36078742846,18,872,2142,20
36078801918,36078801914,-4,24216,11120,20
36081513786,36081513784,-2,1153,3252,20
36082195478,36082195483,5,3509,1298,20
36084143419,36084143414,-5,788,2274,20
36090540014,36090540011,-3,1205,3295,20
36097804242,36097804236,-6,779,3722,20
36098123403,36098123400,-3,16,757,20
36099903973,36099903970,-3,1254,1708,20
36100633310,36100633307,-3,530,1156,20
36103867726,36103867726,0,1127,2098,20
36104706074,36104706070,-4,1693,3039,20
36105571484,36105571481,-3,1470,2557,20
36105694990,36105694989,-1,1043,2302,20
36106163636,36106163657,21,1037,2405,20
36111443320,36111443319,-1,1655,2087,20
36111885561,36111885557,-4,1288,1911,20
36115525694,36115525690,-4,825,2561,20
36115799693,36115799714,21,461,1313,20
36119058375,36119058382,7,2978,1284,20
36121638837,36121638834,-3,1259,2348,20
36131651181,36131651177,-4,1047,2207,20
36134376394,36134376391,-3,1898,2723,20
36134459035,36134459030,-5,688,2811,20
36135047722,36135047719,-3,989,1994,20
36135382315,36135382313,-2,1368,2703,20
36138866514,36138866510,-4,1157,2366,20
36139850146,36139850146,0,1360,2802,20
36142146245,36142146242,-3,915,1700,20
36143968833,36143968829,-4,896,2202,20
36144956309,36144956296,-13,764,6845,20
36146067894,36146067891,-3,970,2044,20
36146730763,36146730762,-1,1393,2253,20
36147026809,36147026816,7,2463,1335,20
36149215425,36149215443,18,759,2526,20
36152581015,36152581014,-1,544,1974,20
36157147950,36157147953,3,1727,1551,20
36160314208,36160314211,3,3908,2626,20
36172185785,36172185782,-3,1320,2959,20
36182078079,36182078076,-3,1104,2099,20
36182332500,36182332496,-4,812,2406,20
36183863231,36183863226,-5,846,2207,20
36185172555,36185172555,0,1066,1698,20
36187255999,36187255995,-4,883,2349,20
36187689115,36187689113,-2,1053,2297,20
36193734145,36193734141,-4,1130,2458,20
36199092802,36199092798,-4,1136,2397,20
36199348080,36199348081,1,2861,16206,20
36202999950,36202999949,-1,991,2413,20
36204239037,36204239034,-3,1147,1839,20
36210563223,36210563226,3,4824,2498,20
36211351637,36211351634,-3,1409,2558,20
36223888301,36223888299,-2,1008,2334,20
36223992692,36223992690,-2,1265,2117,20
36225234718,36225234716,-2,1592,3684,20
36226192652,36226192649,-3,1628,2031,20
36231409381,36231409378,-3,1513,2143,20
36236174156,36236174153,-3,984,2611,20
36237538837,36237538833,-4,1840,2632,20
36241874374,36241874370,-4,1358,1827,20
36248307141,36248307137,-4,1052,1865,20
36249310621,36249310614,-7,1236,4904,20
36253761246,36253761242,-4,1310,2852,20
36256989756,36256989753,-3,1601,2723,20
36257110695,36257110715,20,421,1238,20
36257470671,36257470667,-4,640,1719,20
36269400219,36269400214,-5,1444,3759,20
36272589950,36272589946,-4,1153,1600,20
36275626669,36275626665,-4,1063,2051,20
36277169180,36277169176,-4,1076,2312,20
36282266405,36282266400,-5,1271,3055,20
36293193272,36293193270,-2,1582,1873,20
36297068447,36297068442,-5,746,2252,20
36297099048,36297099064,16,793,1985,20
36308427330,36308427326,-4,1032,1873,20
36316889479,36316889476,-3,1311,3679,20
36317615249,36317615245,-4,1307,2231,20
36318496278,36318496276,-2,1135,2337,20
36318714238,36318714235,-3,925,3002,20
36319478324,36319478347,23,1133,2120,20
36327169456,36327169452,-4,1100,2106,20
36327550027,36327550026,-1,987,1428,20
36328497483,36328497501,18,648,1566,20
36334572699,36334572699,0,828,1038,20
36336083447,36336083442,-5,1386,3000,20
36336639982,36336640000,18,546,874,20
36337994482,36337994480,-2,892,2611,20
36340294678,36340294674,-4,1285,2330,20
36343119261,36343119254,-7,837,2224,20
36343629306,36343629307,1,1352,2775,20
36343654486,36343654485,-1,982,2653,20
36344023334,36344023334,0,1064,1531,20
36345609508,36345609510,2,3793,3797,20
36345694785,36345694782,-3,1338,2037,20
36351311817,36351311814,-3,1405,2656,20
36355352277,36355352275,-2,1259,2513,20
36359013146,36359013140,-6,1282,2285,20
36360875911,36360875906,-5,1026,2249,20
36362636809,36362636806,-3,1698,2880,20
36373431166,36373431167,1,1524,1435,20
36376314884,36376314882,-2,1138,2093,20
36376349470,36376349491,21,37,1078,20
36380033581,36380033598,17,583,1555,20
36382426731,36382426727,-4,1312,1769,20
36383201001,36383200996,-5,1049,3623,20
36383270161,36383270160,-1,1646,2302,20
36384933035,36384933031,-4,1240,1884,20
36385363948,36385363967,19,532,947,20
36386051954,36386051951,-3,1008,2459,20
36388467042,36388467038,-4,1074,2983,20
36388527282,36388527278,-4,894,1998,20
36388732272,36388732271,-1,1387,1894,20
36391323609,36391323605,-4,872,2386,20
36392724754,36392724753,-1,904,1651,20
36393377380,36393377366,-14,406,2037,20
36399924810,36399924806,-4,1437,3034,20
36400190176,36400190174,-2,1240,1942,20
36403616990,36403616987,-3,1119,2191,20
36407929710,36407929707,-3,1103,2059,20
36408361939,36408361934,-5,894,3730,20
36408495637,36408495639,2,266,1086,20
36412626518,36412626519,1,2063,2280,20
36412931812,36412931810,-2,992,2764,20
36414620010,36414620009,-1,1361,2145,20
36419114690,36419114686,-4,1250,2104,20
36419532696,36419532713,17,875,2023,20
36421009282,36421009277,-5,360,2152,20
36435366823,36435366819,-4,461,1645,20
36438924001,36438923998,-3,1116,2069,20
36439973047,36439973043,-4,934,2668,20
36440194792,36440194788,-4,1328,2569,20
36442412678,36442412675,-3,1148,1876,20
36451147090,36451147086,-4,1366,2781,20
36453897635,36453897633,-2,1106,3216,20
36454887278,36454887275,-3,986,2584,20
36455426388,36455426391,3,253,622,20
36458832760,36458832758,-2,1417,2386,20
36459041002,36459041002,0,1324,1889,20
36459199246,36459199243,-3,1430,3302,20
36459930886,36459930889,3,2090,2330,20
36461059702,36461059721,19,1202,1375,20
36463808039,36463808037,-2,929,1706,20
36466769437,36466769434,-3,1075,2016,20
36466864022,36466864041,19,770,2553,20
36470405558,36470405553,-5,1198,2547,20
36489081409,36489081426,17,230,679,20
36496924042,36496924036,-6,1794,9944,20
36505409674,36505409671,-3,977,2576,20
36506058095,36506058093,-2,1091,2656,20
36511160960,36511160957,-3,884,1955,20
36513003700,36513003697,-3,1431,2789,20
36520569558,36520569553,-5,1219,3269,20
36524071835,36524071832,-3,1026,2509,20
36525148626,36525148625,-1,973,2212,20
36528251738,36528251734,-4,1223,3414,20
36529773785,36529773779,-6,1434,4456,20
36532453450,36532453449,-1,1161,2097,20
36535164623,36535164619,-4,1451,2892,20
36536204019,36536204015,-4,1207,1752,20
36536527662,36536527661,-1,1539,2264,20
36537296217,36537296218,1,1542,1551,20
36539541687,36539541683,-4,1761,3186,20
36540175181,36540175179,-2,986,3232,20
36542816302,36542816301,-1,713,1539,20
36545336726,36545336727,1,764,2121,20
36550822157,36550822151,-6,739,4121,20
36559843806,36559843799,-7,1403,8231,20
36560258467,36560258475,8,1255,791,20
36560558638,36560558626,-12,123,966,20
36562761199,36562761197,-2,662,1784,20
36565185176,36565185172,-4,934,2094,20
36565506269,36565506287,18,1520,4661,20
36566212630,36566212618,-12,20,860,20
36568999945,36568999941,-4,1273,2835,20
36571291575,36571291572,-3,876,1545,20
36592442370,36592442366,-4,1129,1799,20
36599034813,36599034810,-3,1186,2423,20
36599093312,36599093309,-3,1306,2535,20
36600191972,36600191978,6,3672,1046,20
36606247632,36606247629,-3,1089,3031,20
36614617820,36614617826,6,3487,1256,20
36618998746,36618998741,-5,1036,1928,20
36626663282,36626663278,-4,1048,2400,20
36630408659,36630408656,-3,1271,1484,20
36631013427,36631013426,-1,909,1124,20
36632098239,36632098238,-1,844,2055,20
36640826142,36640826139,-3,862,1492,20
36642061516,36642061513,-3,1378,2979,20
36643715941,36643715938,-3,1370,2069,20
36647003850,36647003847,-3,1508,2796,20
36647335933,36647335913,-20,255,869,20
36650346521,36650346519,-2,1605,3270,20
36650765343,36650765339,-4,1028,2796,20
36650951653,36650951632,-21,133,1544,20
36653970237,36653970237,0,1320,1502,20
36655061992,36655061988,-4,844,1750,20
36655207999,36655207997,-2,870,2336,20
36656495285,36656495284,-1,1642,1972,20
36657270949,36657270954,5,2111,1537,20
36658271077,36658271075,-2,899,2245,20
36659462910,36659462905,-5,1217,2532,20
36660071574,36660071582,8,63,1716,20
36662721951,36662721944,-7,784,2675,20
36664516069,36664516066,-3,1081,2445,20
36666300356,36666300353,-3,1751,2864,20
36668754495,36668754487,-8,1104,3408,20
36669055766,36669055765,-1,315,815,20
36672665289,36672665285,-4,982,2051,20
36674129974,36674129970,-4,932,2858,20
36674967153,36674967150,-3,1540,3270,20
36680462890,36680462887,-3,1494,1985,20
36682838175,36682838173,-2,1190,2370,20
36684638146,36684638143,-3,1163,2099,20
36685796943,36685796939,-4,1069,2874,20
36685935060,36685935082,22,622,955,20
36689028775,36689028771,-4,929,1269,20
36693228474,36693228472,-2,1008,2550,20
36699148358,36699148377,19,1113,2080,20
36702094346,36702094352,6,2147,1202,20
36703133550,36703133548,-2,1248,2494,20
36709324734,36709324731,-3,1156,2383,20
36709628083,36709628103,20,647,1539,20
36713937309,36713937306,-3,1126,2161,20
36714735410,36714735408,-2,629,2379,20
36719666144,36719666154,10,185,880,20
36726381325,36726381321,-4,810,3261,20
36729116406,36729116408,2,3870,30096,20
36729754081,36729754078,-3,818,1970,20
36730254458,36730254457,-1,1202,2745,20
36736692295,36736692291,-4,1084,2701,20
36738524535,36738524531,-4,1339,3184,20
36745338562,36745338558,-4,911,2231,20
36746449605,36746449600,-5,1169,3002,20
36747206032,36747206030,-2,1089,2059,20
36748240270,36748240264,-6,1047,1911,20
36749001839,36749001837,-2,938,1703,20
36754178197,36754178194,-3,1076,2050,20
36755261727,36755261737,10,12683,42659,20
36760480747,36760480743,-4,1442,2435,20
36763842319,36763842316,-3,1155,2675,20
36765949430,36765949429,-1,1544,2752,20
36766263222,36766263221,-1,1139,2401,20
36766954523,36766954517,-6,1155,2504,20
36769403971,36769403967,-4,1075,2240,20
36771409761,36771409758,-3,1238,2574,20
36775961346,36775961342,-4,856,1655,20
36776971994,36776971990,-4,769,2748,20
36783628174,36783628172,-2,946,2514,20
36784804783,36784804781,-2,1131,1460,20
36786202120,36786202114,-6,908,1500,20
36786515335,36786515333,-2,1137,2664,20
36789676966,36789676963,-3,1154,2126,20
36795155086,36795155085,-1,2146,2313,20
36796210726,36796210746,20,1240,2608,20
36796335565,36796335563,-2,1137,1694,20
36799293000,36799292996,-4,882,1726,20
36803288586,36803288583,-3,1253,1277,20
36806483573,36806483571,-2,1032,1760,20
36807198823,36807198823,0,754,2482,20
36807342511,36807342510,-1,38650,32547,20
36815009753,36815009751,-2,1417,2340,20
36815120991,36815121010,19,1276,3409,20
36816232991,36816232986,-5,568,1348,20
36818909568,36818909566,-2,1369,3197,20
36825215642,36825215642,0,912,1941,20
36825328320,36825328334,14,810,829,20
36826099502,36826099501,-1,1233,2199,20
36826167351,36826167369,18,1052,2507,20
36828253902,36828253900,-2,1183,2488,20
36830546750,36830546755,5,41728,27611,20
36831903371,36831903370,-1,664,1521,20
36835383534,36835383533,-1,1043,2558,20
36837334627,36837334625,-2,1214,1993,20
36837621186,36837621179,-7,2961,9208,20
36841963974,36841963970,-4,1091,3045,20
36843870402,36843870399,-3,612,1263,20
36844830760,36844830777,17,370,862,20
36845452943,36845452942,-1,973,1253,20
36848676810,36848676810,0,658,1351,20
36852424740,36852424743,3,1886,1381,20
36857613697,36857613693,-4,1214,2613,20
36858409112,36858409107,-5,984,1762,20
36859833538,36859833542,4,1857,1350,20
36862754833,36862754830,-3,1001,1789,20
36862895535,36862895531,-4,1267,3147,20
36875997037,36875997033,-4,1180,2477,20
36877707638,36877707635,-3,1165,2220,20
36889255323,36889255319,-4,1024,2900,20
36889584382,36889584382,0,268,1258,20
36899696692,36899696689,-3,929,2154,20
36902804147,36902804145,-2,1159,2953,20
36906162151,36906162149,-2,869,2108,20
36906962446,36906962444,-2,1031,1981,20
36914908918,36914908917,-1,913,2629,20
36915379250,36915379246,-4,1193,3017,20
36915504358,36915504352,-6,1069,1641,20
36916526088,36916526084,-4,1332,2675,20
36928823434,36928823430,-4,1056,2613,20
36929604721,36929604718,-3,914,2731,20
36930117494,36930117494,0,1527,1761,20
36930401889,36930401886,-3,899,2397,20
36932296915,36932296917,2,1200,1296,20
36937915307,36937915303,-4,972,2585,20
36938241383,36938241382,-1,978,2428,20
36939411120,36939411138,18,572,1162,20
36939856273,36939856270,-3,803,2233,20
36941731242,36941731247,5,3589,2140,20
36945512094,36945512097,3,1145,1466,20
36946811461,36946811458,-3,1464,2030,20
36954093842,36954093841,-1,1091,2613,20
36954959038,36954959035,-3,907,1689,20
36955318973,36955318971,-2,981,1999,20
36960237186,36960237182,-4,1739,2529,20
36962547705,36962547707,2,2099,1714,20
36963146510,36963146506,-4,1104,1863,20
36966154514,36966154524,10,16941,31654,20
36966402317,36966402314,-3,1418,3306,20
36971751045,36971751042,-3,1191,2391,20
36972208961,36972208959,-2,1184,2567,20
36974605981,36974605977,-4,998,2232,20
36975137110,36975137106,-4,965,2141,20
36976298984,36976298980,-4,1322,1789,20
36977950713,36977950710,-3,802,1843,20
36979315001,36979315000,-1,1027,2501,20
36981039302,36981039298,-4,1041,2119,20
36982643730,36982643728,-2,753,2318,20
36982762116,36982762113,-3,1276,2323,20
36982806016,36982806035,19,681,1334,20
36984897670,36984897665,-5,1023,2949,20
36986036375,36986036373,-2,1093,2226,20
36986380367,36986380381,14,621,2380,20
36988111602,36988111598,-4,1460,2643,20
36988295704,36988295722,18,1075,3380,20
36988914081,36988914078,-3,1404,3190,20
36998437756,36998437751,-5,1321,2436,20
36999475463,36999475460,-3,1312,2694,20
37001366538,37001366545,7,5530,2831,20
37002542871,37002542879,8,1191,594,20
37004197257,37004197253,-4,1274,2829,20
37006284380,37006284383,3,1373,1121,20
37007818670,37007818666,-4,1332,1820,20
37012456423,37012456420,-3,1060,2085,20
37017234799,37017234794,-5,1164,3872,20
37017585215,37017585213,-2,1361,1574,20
37021465883,37021465878,-5,1026,2063,20
37022495215,37022495202,-13,1028,1255,20
37029497696,37029497692,-4,653,1104,20
37034776009,37034776014,5,7410,29735,20
37036439515,37036439510,-5,644,1646,20
37041001906,37041001904,-2,1432,2313,20
37041104723,37041104721,-2,728,1955,20
37044849220,37044849217,-3,1407,2908,20
37051507229,37051507234,5,3082,1837,20
37063261107,37063261102,-5,1060,1918,20
37063963061,37063963061,0,1090,1294,20
37070874875,37070874864,-11,2115,669,20
37071004647,37071004645,-2,866,2100,20
37072990707,37072990726,19,175,870,20
37075256859,37075256856,-3,851,1741,20
37076711953,37076711950,-3,1333,2041,20
37080802446,37080802439,-7,844,1825,20
37081769238,37081769237,-1,956,2017,20
37084704925,37084704922,-3,1125,2616,20
37090748100,37090748097,-3,1135,2028,20
37093337136,37093337150,14,243,732,20
37095692110,37095692107,-3,1230,2965,20
37097222854,37097222852,-2,1131,2612,20
37102421846,37102421842,-4,1142,2612,20
37102704125,37102704122,-3,961,1811,20
37103832159,37103832158,-1,1030,1914,20
37104487481,37104487478,-3,1127,1271,20
37105195020,37105195013,-7,2373,8548,20
37108024190,37108024194,4,3062,1091,20
37112658447,37112658444,-3,874,1823,20
37113922331,37113922329,-2,1269,2810,20
37115820763,37115820761,-2,1026,2274,20
37116684119,37116684117,-2,1500,1840,20
37117678342,37117678339,-3,958,2145,20
37118067815,37118067813,-2,1202,2176,20
37119926782,37119926781,-1,1229,1633,20
37120836425,37120836422,-3,1272,2906,20
37121881114,37121881114,0,1012,1179,20
37122673569,37122673565,-4,1164,1779,20
37123182343,37123182358,15,300,688,20
37127145115,37127145113,-2,812,1754,20
37128614651,37128614648,-3,1266,2525,20
37128888942,37128888942,0,952,2437,20
37130948387,37130948382,-5,1408,2656,20
37132741103,37132741101,-2,897,2529,20
37132772135,37132772117,-18,196,765,20
37140498048,37140498046,-2,954,2706,20
37141765462,37141765458,-4,860,1692,20
37142034239,37142034258,19,1270,3253,20
37144730003,37144729997,-6,609,2698,20
37145681302,37145681305,3,1672,1316,20
37146859309,37146859305,-4,1063,2558,20
37149266135,37149266140,5,2172,1275,20
37157232359,37157232356,-3,1048,2361,20
37161963519,37161963519,0,2525,3073,20
37162208053,37162208050,-3,1057,2441,20
37162986003,37162986012,9,756,1685,20
37175211978,37175211972,-6,986,2621,20
37176577345,37176577341,-4,1143,2048,20
37178111859,37178111853,-6,1048,2360,20
37181344837,37181344832,-5,1091,2696,20
37181911778,37181911775,-3,1135,2313,20
37182165301,37182165297,-4,1097,1978,20
37183039887,37183039887,0,169,619,20
37184196630,37184196628,-2,643,2429,20
37184437230,37184437251,21,64,1245,20
37185674830,37185674833,3,232,858,20
37194917172,37194917169,-3,2387,2454,20
37195151346,37195151346,0,962,1572,20
37201054974,37201054971,-3,1267,2348,20
37201760299,37201760296,-3,874,1897,20
37202207251,37202207249,-2,1107,2666,20
37205571319,37205571318,-1,1218,1890,20
37206784220,37206784213,-7,986,2257,20
37211638563,37211638561,-2,852,2130,20
37211671138,37211671132,-6,1077,2434,20
37213929159,37213929157,-2,821,2382,20
37215391159,37215391161,2,1405,1707,20
37220903530,37220903529,-1,1557,2016,20
37222115663,37222115661,-2,970,2078,20
37224976811,37224976809,-2,1270,2504,20
37225679113,37225679109,-4,1529,3366,20
37227094590,37227094595,5,4286,2410,20
37232148070,37232148073,3,1754,1077,20
37233329607,37233329602,-5,847,2987,20
37240265306,37240265302,-4,732,1404,20
37242574186,37242574183,-3,1033,2154,20
37246239361,37246239360,-1,1200,2767,20
37247759287,37247759285,-2,1244,2252,20
37249038851,37249038857,6,2918,1539,20
37252381164,37252381163,-1,1811,2519,20
37252583322,37252583328,6,2732,1061,20
37258742105,37258742105,0,1740,2314,20
37261520817,37261520813,-4,1076,1368,20
37272194310,37272194306,-4,4130,8418,20
37276184097,37276184091,-6,1369,3281,20
37279782938,37279782935,-3,1167,2393,20
37284368450,37284368448,-2,1207,1778,20
37287711260,37287711256,-4,1538,2918,20
37289237051,37289237054,3,1664,1172,20
37290920198,37290920192,-6,2224,6950,20
37293836666,37293836661,-5,1031,2865,20
37303353420,37303353416,-4,2083,2524,20
37303720792,37303720802,10,354,2092,20
37303893258,37303893255,-3,835,1571,20
37304066270,37304066260,-10,1128,2269,20
37306348667,37306348666,-1,1597,2214,20
37309780890,37309780892,2,1723,2349,20
37313701732,37313701726,-6,1026,1835,20
37319313241,37319313247,6,2528,1502,20
37321686674,37321686674,0,642,1323,20
37322607795,37322607790,-5,1335,3076,20
37325865609,37325865598,-11,630,4054,20
37326061722,37326061718,-4,1249,2150,20
37327123494,37327123494,0,1185,2459,20
37328815637,37328815637,0,2625,3320,20
37330817619,37330817616,-3,756,1569,20
37331044462,37331044458,-4,1256,2102,20
37331165963,37331165962,-1,1507,2586,20
37338045465,37338045462,-3,1111,2177,20
37341169156,37341169151,-5,1187,3101,20
37350658963,37350658960,-3,1167,2103,20
37352166062,37352166059,-3,1110,2646,20
37353061886,37353061886,0,1219,2043,20
37357563710,37357563709,-1,1344,1503,20
37357634244,37357634242,-2,1431,1727,20
37358281134,37358281133,-1,1307,2393,20
37364251938,37364251936,-2,995,1574,20
37365235559,37365235557,-2,1331,2015,20
37368788852,37368788855,3,1748,1755,20
37369476538,37369476534,-4,1081,2940,20
37371590304,37371590301,-3,868,1598,20
37381681258,37381681257,-1,1002,1148,20
37383896694,37383896694,0,8517,15538,20
37384387526,37384387525,-1,1368,2214,20
37386375097,37386375095,-2,749,2081,20
37386562442,37386562439,-3,986,2508,20
37389675532,37389675526,-6,1141,1910,20
37389853286,37389853279,-7,26300,12488,20
37394470211,37394470213,2,6781,6526,20
37396732829,37396732827,-2,982,2304,20
37399099962,37399099959,-3,1066,1932,20
37405272938,37405272937,-1,900,2533,20
37408849895,37408849891,-4,1407,3041,20
37411732022,37411732018,-4,1063,3307,20
37415374427,37415374425,-2,1367,2032,20
37418440805,37418440801,-4,607,1497,20
37418728959,37418728961,2,1507,1659,20
37419073668,37419073658,-10,40,1075,20
37420869306,37420869303,-3,1022,2332,20
37423798686,37423798682,-4,1496,2111,20
37431187991,37431187988,-3,1161,3409,20
37433392607,37433392610,3,1379,1658,20
37433747974,37433747962,-12,792,1597,20
37435515477,37435515473,-4,578,1151,20
37438560815,37438560811,-4,1120,2053,20
37442389434,37442389444,10,13735,45602,20
37446490126,37446490123,-3,873,1750,20
37447176244,37447176241,-3,1376,2981,20
37451851246,37451851248,2,2311,1433,20
37453968046,37453968044,-2,917,1834,20
37458347623,37458347618,-5,1034,2086,20
37463346371,37463346369,-2,910,2524,20
37466588197,37466588193,-4,1269,2921,20
37466974797,37466974796,-1,12064,17943,20
37469366243,37469366240,-3,1133,2607,20
37469789627,37469789625,-2,1017,2227,20
37470631359,37470631355,-4,837,2233,20
37479151509,37479151506,-3,1203,2807,20
37480214165,37480214161,-4,941,2279,20
37480560319,37480560301,-18,266,1170,20
37482609691,37482609689,-2,1222,1846,20
37482890103,37482890098,-5,1059,2781,20
37486142006,37486142004,-2,1221,2476,20
37487743097,37487743090,-7,602,1669,20
37491697559,37491697556,-3,1067,2114,20
37496893050,37496893047,-3,1211,1588,20
37497101391,37497101411,20,823,1622,20
37501009307,37501009309,2,1443,1868,20
37502874210,37502874207,-3,1057,2427,20
37506995496,37506995492,-4,1314,2443,20
37510629478,37510629476,-2,1545,2729,20
37511411434,37511411431,-3,1613,2416,20
37513545900,37513545896,-4,1083,2645,20
37513729054,37513729054,0,1208,2282,20
37514264126,37514264125,-1,1110,2060,20
37517423851,37517423849,-2,1140,2065,20
37517527158,37517527154,-4,1162,3467,20
37519695792,37519695790,-2,1851,2676,20
37527600883,37527600878,-5,1275,2941,20
37529640278,37529640275,-3,1095,2016,20
37534009099,37534009097,-2,917,1917,20
37534369095,37534369094,-1,113,1692,20
37534805375,37534805371,-4,1367,2863,20
37539440010,37539440006,-4,889,1962,20
37543682338,37543682334,-4,886,1880,20
37546311490,37546311485,-5,824,2013,20
37547497938,37547497935,-3,1090,2106,20
37547764974,37547764972,-2,984,1609,20
37548189741,37548189741,0,916,1821,20
37548328499,37548328493,-6,949,1675,20
37549321918,37549321916,-2,1290,1796,20
37552215348,37552215344,-4,1142,1996,20
37552667842,37552667838,-4,1139,2263,20
37555142828,37555142828,0,1238,1423,20
37558738514,37558738511,-3,815,2321,20
37559876013,37559876009,-4,1354,2887,20
37560986186,37560986182,-4,1269,3591,20
37561546268,37561546289,21,488,1310,20
37563300529,37563300529,0,2737,3478,20
37564592322,37564592318,-4,1546,2201,20
37566498222,37566498221,-1,1395,1847,20
37567995447,37567995445,-2,970,1962,20
37573067287,37573067283,-4,1071,1712,20
37575661927,37575661925,-2,1204,2980,20
37576226142,37576226129,-13,1049,1105,20
37581685026,37581685025,-1,1518,2067,20
37581990162,37581990159,-3,1144,2669,20
37584605379,37584605375,-4,1202,1972,20
37585614883,37585614878,-5,1124,2804,20
37585647636,37585647658,22,1401,1707,20
37586118460,37586118453,-7,895,3457,20
37587509566,37587509570,4,1465,815,20
37589113268,37589113261,-7,236,1055,20
37590070356,37590070354,-2,1248,2036,20
37590382271,37590382267,-4,1261,2807,20
37592317077,37592317080,3,2050,1643,20
37593311230,37593311226,-4,846,2376,20
37595650718,37595650714,-4,1017,2544,20
37596265572,37596265590,18,576,1501,20
37599158809,37599158807,-2,1325,2222,20
37602437339,37602437336,-3,1272,2419,20
37605578820,37605578817,-3,1104,3039,20
37610211639,37610211634,-5,630,1921,20
37610625458,37610625455,-3,1333,2235,20
37618061237,37618061234,-3,1630,3035,20
37619523739,37619523732,-7,2959,8183,20
37619592174,37619592171,-3,994,1618,20
37626226286,37626226282,-4,808,2190,20
37627741225,37627741221,-4,1169,2225,20
37633390060,37633390057,-3,1544,2335,20
37634008228,37634008250,22,227,1195,20
37634668313,37634668309,-4,1326,2178,20
37642640531,37642640535,4,2432,1310,20
37644106596,37644106598,2,22373,3489,20
37647201818,37647201814,-4,1035,1903,20
37647230957,37647230957,0,754,1207,20
37650480860,37650480855,-5,1185,2840,20
37651278657,37651278658,1,34056,19691,20
37654019603,37654019598,-5,888,2771,20
37654593414,37654593409,-5,1334,1789,20
37655293626,37655293624,-2,1160,2198,20
37665493245,37665493242,-3,1582,2469,20
37665880231,37665880226,-5,1256,2159,20
37666059679,37666059696,17,625,1316,20
37666529898,37666529898,0,2934,4197,20
37672366246,37672366243,-3,1038,2079,20
37681667387,37681667385,-2,1182,2246,20
37682827848,37682827845,-3,1095,2559,20
37683963916,37683963939,23,397,1109,20
37689426453,37689426450,-3,1311,2950,20
37689758294,37689758292,-2,1406,2244,20
37690670015,37690670018,3,1540,1453,20
37692835697,37692835693,-4,1019,2213,20
37693422730,37693422725,-5,1218,2777,20
37693755485,37693755489,4,276,910,20
37696677478,37696677477,-1,1582,2910,20
37703972477,37703972472,-5,1453,3384,20
37721276966,37721276963,-3,917,1558,20
37723453116,37723453119,3,38362,21734,20
37724163470,37724163468,-2,1276,2325,20
37726904438,37726904435,-3,894,2314,20
37727094252,37727094250,-2,1292,2141,20
37733402508,37733402504,-4,1597,3008,20
37735268101,37735268099,-2,868,1563,20
37738171701,37738171695,-6,969,3404,20
37740612077,37740612074,-3,1048,3149,20
37740869095,37740869113,18,989,2495,20
37744146879,37744146877,-2,944,2702,20
37744617571,37744617569,-2,1019,2147,20
37744956290,37744956286,-4,872,2959,20
37748648683,37748648681,-2,1025,2263,20
37749330735,37749330714,-21,712,1743,20
37752687201,37752687200,-1,1182,2578,20
37758148466,37758148463,-3,774,2093,20
37761674799,37761674792,-7,1400,4014,20
37762358439,37762358453,14,802,1637,20
37768209790,37768209789,-1,871,2376,20
37771786079,37771786078,-1,1283,2512,20
37775307487,37775307484,-3,642,1686,20
37775570562,37775570559,-3,499,1330,20
37783717158,37783717155,-3,1333,1896,20
37787217042,37787217039,-3,1231,2938,20
37788187021,37788187018,-3,1143,2450,20
37789927963,37789927963,0,1611,1549,20
37792800821,37792800818,-3,969,1833,20
37794867226,37794867239,13,984,8664,20
37795547818,37795547813,-5,1311,2192,20
37795857757,37795857752,-5,1399,2572,20
37807582369,37807582367,-2,554,1351,20
37811862871,37811862869,-2,658,1541,20
37813631226,37813631226,0,627,861,20
37826600797,37826600793,-4,1183,2628,20
37830330323,37830330317,-6,1496,2423,20
37836867664,37836867661,-3,1337,2757,20
37837935202,37837935199,-3,883,3013,20
37839329935,37839329931,-4,1366,3473,20
37841615914,37841615910,-4,1070,2370,20
37853391982,37853391989,7,3011,1456,20
37857890398,37857890396,-2,1424,1970,20
37862229129,37862229125,-4,904,1465,20
37863517712,37863517730,18,1200,2610,20
37863827898,37863827895,-3,1343,2082,20
37863911502,37863911498,-4,740,1403,20
37863950020,37863950021,1,1622,2177,20
37866191900,37866191905,5,2255,1840,20
37867569667,37867569665,-2,1302,1807,20
37873633622,37873633619,-3,1498,2785,20
37875970831,37875970828,-3,764,3499,20
37877208163,37877208160,-3,1652,3049,20
37878014969,37878014966,-3,1133,3245,20
37879590517,37879590513,-4,1387,2785,20
37880464989,37880464986,-3,1042,1700,20
37884996546,37884996541,-5,1284,1759,20
37885641348,37885641370,22,1315,2453,20
37886012415,37886012411,-4,1370,3903,20
37886141031,37886141029,-2,842,2075,20
37887288397,37887288395,-2,1185,1751,20
37890918038,37890918033,-5,1119,2121,20
37896295289,37896295296,7,1791,1897,20
37900489179,37900489175,-4,880,2390,20
37901303366,37901303361,-5,570,2176,20
37901474053,37901474042,-11,154,1042,20
37909460743,37909460741,-2,1451,2052,20
37909510806,37909510802,-4,1023,2964,20
37918062165,37918062166,1,718,1110,20
37919381835,37919381831,-4,987,2898,20
37919664102,37919664101,-1,1117,2429,20
37926544176,37926544174,-2,1309,3112,20
37929869390,37929869389,-1,943,2680,20
37932457377,37932457374,-3,1211,2173,20
37933826819,37933826817,-2,1273,2203,20
37947180391,37947180389,-2,895,2141,20
37949985805,37949985802,-3,963,2538,20
37952440702,37952440698,-4,1385,3747,20
37955926363,37955926358,-5,1538,1934,20
37956167925,37956167922,-3,1241,1849,20
37958989997,37958989995,-2,1168,1900,20
37960687421,37960687417,-4,1312,2091,20
37963558138,37963558134,-4,1005,2266,20
37965152712,37965152710,-2,1276,2261,20
37965711530,37965711527,-3,1390,3347,20
37965911854,37965911870,16,880,2245,20
37966994501,37966994497,-4,1177,1806,20
37969296719,37969296715,-4,1239,2794,20
37971301312,37971301307,-5,1278,2545,20
37971847126,37971847125,-1,1212,1959,20
37972138172,37972138195,23,1055,1422,20
37975488842,37975488841,-1,1164,1432,20
37978862648,37978862646,-2,841,2279,20
37979972092,37979972088,-4,1772,3549,20
37980507558,37980507553,-5,1114,2272,20
37981824123,37981824122,-1,933,2382,20
37983963152,37983963158,6,5645,3010,20
37984603854,37984603852,-2,976,2382,20
37992710879,37992710875,-4,1466,2431,20
37993126682,37993126682,0,1083,2178,20
37994055406,37994055402,-4,1689,3043,20
37994267267,37994267265,-2,1465,2082,20
37994654479,37994654477,-2,809,1811,20
37997843405,37997843403,-2,1362,2223,20
37998284407,37998284424,17,683,2264,20
37999794581,37999794579,-2,1252,2552,20
38005208587,38005208583,-4,1245,2210,20
38006195670,38006195668,-2,803,2231,20
38007517431,38007517430,-1,1042,2139,20
38008331869,38008331876,7,94,1244,20
38009310285,38009310285,0,1311,1907,20
38022442160,38022442157,-3,1590,2974,20
38025616819,38025616815,-4,1175,2243,20
38026111053,38026111049,-4,1088,2241,20
38027122838,38027122834,-4,855,1596,20
38030171450,38030171448,-2,1076,2767,20
38036440439,38036440443,4,2263,1407,20
38040069377,38040069374,-3,931,1468,20
38040673902,38040673901,-1,1025,2788,20
38041600748,38041600742,-6,815,3493,20
38044338778,38044338775,-3,1128,2264,20
38048000955,38048000952,-3,907,2524,20
38048703025,38048703021,-4,1115,2336,20
38052874562,38052874559,-3,1309,1973,20
38053897820,38053897814,-6,1855,8475,20
38055831922,38055831918,-4,1045,2428,20
38057979163,38057979161,-2,1208,2484,20
38063999428,38063999424,-4,989,2137,20
38064360719,38064360715,-4,25603,12065,20
38073950478,38073950476,-2,708,1827,20
38074849201,38074849213,12,15582,38393,20
38075960566,38075960567,1,1859,1456,20
38077416786,38077416789,3,1754,1714,20
38078785741,38078785737,-4,1068,2410,20
38082492794,38082492795,1,1211,1857,20
38083607057,38083607054,-3,1141,3278,20
38083797903,38083797900,-3,1734,3539,20
38084658735,38084658731,-4,771,2011,20
38087189284,38087189286,2,1169,901,20
38089046323,38089046319,-4,1064,1819,20
38091770157,38091770153,-4,957,2538,20
38099028259,38099028258,-1,1252,2414,20
38099384007,38099384003,-4,986,2142,20
38100526997,38100526993,-4,1208,3029,20
38100917749,38100917746,-3,814,1153,20
38103703643,38103703644,1,2252,2427,20
38104626326,38104626323,-3,885,2541,20
38105091666,38105091661,-5,1022,2127,20
38106900529,38106900526,-3,1279,3502,20
38107434494,38107434492,-2,1436,2429,20
38109636786,38109636787,1,1097,705,20
38110594553,38110594554,1,1333,1721,20
38111272278,38111272277,-1,1119,2603,20
38112760314,38112760313,-1,1031,1803,20
38115150837,38115150833,-4,1222,2274,20
38121670967,38121670964,-3,1180,1898,20
38123062947,38123062943,-4,1420,2252,20
38127133925,38127133922,-3,1182,2849,20
38137581255,38137581253,-2,1145,2237,20
38139266131,38139266128,-3,1187,1821,20
38139329477,38139329474,-3,1339,2955,20
38145428490,38145428486,-4,1072,2046,20
38147176481,38147176478,-3,1264,2154,20
38149011174,38149011173,-1,1163,2267,20
38150931715,38150931715,0,1032,2042,20
38152610178,38152610174,-4,1025,2666,20
38155916962,38155916958,-4,1171,2518,20
38156375912,38156375926,14,229,523,20
38163564287,38163564285,-2,1724,3983,20
38163775660,38163775654,-6,957,2416,20
38164986362,38164986372,10,1037,1233,20
38166149286,38166149284,-2,958,1953,20
38170043743,38170043741,-2,1260,2809,20
38172296013,38172296013,0,1126,1653,20
38184966983,38184966978,-5,1096,2411,20
38185440717,38185440737,20,869,1652,20
38186565907,38186565906,-1,1553,3152,20
38195201933,38195201930,-3,1029,2456,20
38196370689,38196370685,-4,1157,2505,20
38200209410,38200209409,-1,957,1622,20
38208052799,38208052805,6,6075,3179,20
38209252113,38209252108,-5,1141,2460,20
38209402917,38209402917,0,1099,1994,20
38212062082,38212062079,-3,731,1788,20
38219575697,38219575690,-7,1332,3604,20
38223147763,38223147760,-3,1201,2023,20
38228654227,38228654225,-2,1036,1785,20
38228827331,38228827327,-4,1270,2717,20
38233078354,38233078352,-2,830,1512,20
38235606990,38235606988,-2,969,1230,20
38236225398,38236225418,20,910,2704,20
38239584491,38239584497,6,31905,57993,20
38246056270,38246056268,-2,1173,1795,20
38250193391,38250193389,-2,668,1579,20
38253042910,38253042917,7,9920,26634,20
38253729134,38253729131,-3,1289,2329,20
38256333414,38256333412,-2,1512,3149,20
38259479821,38259479819,-2,1206,2044,20
38261176362,38261176360,-2,1345,2958,20
38268678501,38268678497,-4,1627,2743,20
38270091052,38270091050,-2,794,1444,20
38272592543,38272592541,-2,1162,1785,20
38272986693,38272986692,-1,1982,3120,20
38275416345,38275416341,-4,1096,4192,20
38277408383,38277408381,-2,829,2178,20
38277971490,38277971489,-1,1404,2159,20
38279270670,38279270666,-4,1096,1594,20
38283017480,38283017477,-3,730,1684,20
38283071552,38283071547,-5,1345,2674,20
38286707182,38286707177,-5,1114,2687,20
38289908918,38289908919,1,1870,1790,20
38292627201,38292627197,-4,2163,6532,20
38298455524,38298455521,-3,1474,2357,20
38300510855,38300510855,0,1151,1542,20
38303900659,38303900657,-2,1756,2268,20
38311133366,38311133361,-5,1093,2820,20
38311675633,38311675631,-2,1412,2322,20
38312313718,38312313698,-20,312,933,20
38312591100,38312591084,-16,1658,1081,20
38315210738,38315210732,-6,3325,10661,20
38317638278,38317638275,-3,925,1994,20
38324102115,38324102113,-2,1002,1784,20
38325644754,38325644752,-2,1419,2262,20
38335110019,38335110016,-3,804,2056,20
38335167444,38335167430,-14,263,459,20
38335957528,38335957539,11,107,1239,20
38341011249,38341011247,-2,578,1674,20
38341156661,38341156677,16,287,1360,20
38341611761,38341611762,1,540,1375,20
38342985618,38342985613,-5,1272,2570,20
38343161964,38343161959,-5,1773,3082,20
38343196938,38343196933,-5,1481,2516,20
38343416624,38343416620,-4,984,2283,20
38354794922,38354794921,-1,876,1704,20
38355320404,38355320399,-5,1154,2121,20
38358992640,38358992637,-3,1879,3659,20
38361937237,38361937258,21,440,861,20
38366973662,38366973661,-1,1534,2440,20
38369040834,38369040833,-1,1566,3362,20
38370676862,38370676858,-4,1348,2442,20
38371128232,38371128249,17,527,1632,20
38371917698,38371917695,-3,1016,2527,20
38372754707,38372754705,-2,1145,2560,20
38376670974,38376670970,-4,882,1577,20
38380980810,38380980806,-4,1392,3042,20
38381892674,38381892678,4,1921,1631,20
38385355726,38385355722,-4,965,2527,20
38386068685,38386068701,16,1077,1344,20
38389241750,38389241746,-4,1163,3200,20
38392708138,38392708141,3,6103,4627,20
38393932697,38393932698,1,35666,19489,20
38395542807,38395542806,-1,976,2179,20
38396018454,38396018450,-4,1254,3080,20
38402996446,38402996443,-3,1080,3160,20
38408740978,38408740979,1,1550,1802,20
38409586123,38409586119,-4,36654,16120,20
38412587338,38412587334,-4,1527,2398,20
38414563418,38414563415,-3,1221,2036,20
38414732493,38414732514,21,1355,2508,20
38414826678,38414826677,-1,1073,2401,20
38425432178,38425432174,-4,1479,2576,20
38426182916,38426182914,-2,1295,1237,20
38433020294,38433020290,-4,1178,2815,20
38433249807,38433249822,15,792,2758,20
38433508948,38433508945,-3,1340,2058,20
38434469743,38434469742,-1,1046,1967,20
38438953674,38438953671,-3,1414,2160,20
38439347680,38439347678,-2,24,1717,20
38440566489,38440566482,-7,1288,5423,20
38441369680,38441369676,-4,1381,2500,20
38448216661,38448216658,-3,1164,2409,20
38452553272,38452553274,2,1577,1187,20
38456531473,38456531470,-3,818,2263,20
38458117158,38458117157,-1,1351,2516,20
38460079997,38460079994,-3,1371,2820,20
38461940198,38461940192,-6,1098,2324,20
38465623677,38465623674,-3,1025,1718,20
38465929033,38465929030,-3,913,2057,20
38467838671,38467838669,-2,965,1603,20
38468929042,38468929041,-1,732,2606,20
38470031086,38470031083,-3,1191,2070,20
38471439943,38471439942,-1,1075,1571,20
38473132859,38473132856,-3,1149,2723,20
38480448230,38480448225,-5,952,2137,20
38481782862,38481782859,-3,962,1565,20
38482840673,38482840670,-3,782,1432,20
38484375841,38484375838,-3,1640,2036,20
38484761877,38484761891,14,318,719,20
38486251097,38486251095,-2,993,1817,20
38488176447,38488176442,-5,1049,2577,20
38494659142,38494659138,-4,1187,2611,20
38502607352,38502607348,-4,1542,3030,20
38505627044,38505627040,-4,1108,1884,20
38508630085,38508630092,7,3975,1643,20
38510307571,38510307567,-4,1770,3696,20
38515240829,38515240826,-3,1283,2277,20
38522122716,38522122714,-2,1272,2101,20
38524371450,38524371457,7,3694,1550,20
38525956329,38525956330,1,2484,2527,20
38526384476,38526384472,-4,1339,2836,20
38528546541,38528546538,-3,988,2075,20
38529786501,38529786499,-2,1105,2641,20
38533342621,38533342618,-3,1428,1858,20
38534048966,38534048986,20,257,1182,20
38536816449,38536816453,4,1750,1774,20
38539640185,38539640185,0,1249,2384,20
38542683847,38542683840,-7,899,1868,20
38543047276,38543047258,-18,172,984,20
38543960965,38543960962,-3,984,2861,20
38545692091,38545692089,-2,1374,3527,20
38548663689,38548663686,-3,1262,1984,20
38552176335,38552176334,-1,1386,1636,20
38552286855,38552286846,-9,1709,3739,20
38552733129,38552733127,-2,1028,1872,20
38553167453,38553167434,-19,159,992,20
38558342847,38558342846,-1,1009,2170,20
38558396087,38558396086,-1,1235,1804,20
38560028051,38560028042,-9,31093,12786,20
38560243514,38560243513,-1,1411,1872,20
38561576765,38561576762,-3,1116,3382,20
38566571218,38566571216,-2,1155,2150,20
38568338405,38568338402,-3,1538,3661,20
38570639543,38570639538,-5,883,2358,20
38573766953,38573766950,-3,808,2444,20
38576208333,38576208341,8,2883,1158,20
38580115722,38580115719,-3,1303,2730,20
38583908935,38583908934,-1,1825,2615,20
38592741675,38592741672,-3,912,2612,20
38594443669,38594443662,-7,1694,3902,20
38594865183,38594865169,-14,1158,2340,20
38597602878,38597602890,12,858,2168,20
38597857052,38597857051,-1,1382,1852,20
38600197755,38600197753,-2,906,2073,20
38601526770,38601526769,-1,1046,2085,20
38603801234,38603801231,-3,1207,2229,20
38604703190,38604703188,-2,832,2065,20
38606911185,38606911184,-1,1316,2059,20
38610004555,38610004552,-3,1317,3176,20
38614451036,38614451041,5,23047,26490,20
38616706947,38616706949,2,1662,2297,20
38616894215,38616894213,-2,997,2230,20
38620893438,38620893436,-2,1315,1598,20
38623654529,38623654525,-4,981,1622,20
38629333595,38629333595,0,935,1500,20
38634731083,38634731079,-4,1142,2619,20
38639961241,38639961239,-2,1137,2078,20
38640514365,38640514348,-17,1100,2850,20
38644427318,38644427314,-4,1246,3115,20
38645020947,38645020945,-2,976,2125,20
38647298797,38647298812,15,1303,1418,20
38647473469,38647473468,-1,1872,2632,20
38649211379,38649211374,-5,915,2259,20
38652399222,38652399222,0,1019,2164,20
38653743507,38653743499,-8,1029,5104,20
38657039874,38657039871,-3,1208,1692,20
38658507999,38658507997,-2,1186,1482,20
38663280237,38663280231,-6,1118,2110,20
38666820178,38666820177,-1,983,1921,20
38675136548,38675136543,-5,1219,2556,20
38675261470,38675261491,21,1224,4898,20
38677280175,38677280173,-2,45157,17351,20
38679490954,38679490953,-1,737,1148,20
38686533407,38686533405,-2,1249,2649,20
38686573236,38686573232,-4,1154,3124,20
38691942317,38691942315,-2,1116,2532,20
38693333394,38693333390,-4,1139,3059,20
38693384823,38693384840,17,346,1566,20
38694350274,38694350273,-1,1078,1693,20
38695197306,38695197303,-3,1292,2159,20
38699181935,38699181932,-3,1012,1875,20
38700465707,38700465714,7,2124,1401,20
38703029361,38703029356,-5,662,1849,20
38705053557,38705053555,-2,1073,2291,20
38706060150,38706060146,-4,671,2171,20
38706593315,38706593313,-2,1168,2439,20
38710562126,38710562123,-3,1185,2400,20
38710920325,38710920326,1,343,1066,20
38712025499,38712025495,-4,1458,2780,20
38716499721,38716499722,1,1955,2288,20
38716642595,38716642591,-4,1064,2091,20
38720072181,38720072178,-3,836,1503,20
38722378959,38722378955,-4,1321,2045,20
38724347350,38724347346,-4,1479,2752,20
38728683094,38728683090,-4,1366,2570,20
38737555946,38737555945,-1,1071,2139,20
38740962438,38740962437,-1,1025,1798,20
38745542417,38745542417,0,1796,2416,20
38745627111,38745627108,-3,962,2480,20
38745888540,38745888545,5,435,1184,20
38753022293,38753022294,1,1947,1947,20
38755405410,38755405406,-4,1474,2982,20
38767019534,38767019531,-3,1480,5763,20
38774911210,38774911206,-4,1258,2159,20
38775365698,38775365695,-3,1350,1930,20
38775889891,38775889889,-2,916,1359,20
38782791720,38782791703,-17,1952,1592,20
38783780243,38783780241,-2,1155,2426,20
38788142741,38788142743,2,1462,1530,20
38788649457,38788649453,-4,616,2172,20
38796428754,38796428754,0,1039,2353,20
38799253159,38799253158,-1,1597,2700,20
38810348269,38810348266,-3,1477,2088,20
38810490943,38810490939,-4,795,2982,20
38811882014,38811882014,0,853,1227,20
38812765396,38812765394,-2,1475,2463,20
38813010030,38813010013,-17,39,976,20
38813865345,38813865343,-2,992,2788,20
38814361492,38814361477,-15,921,1810,20
38816210669,38816210667,-2,935,1754,20
38816536730,38816536727,-3,1185,2601,20
38816690282,38816690276,-6,1000,2560,20
38817232202,38817232207,5,3752,2456,20
38817426812,38817426810,-2,1188,2642,20
38817888034,38817888030,-4,1449,2974,20
38821821834,38821821833,-1,856,1729,20
38823654555,38823654553,-2,1003,2773,20
38824884522,38824884518,-4,988,2752,20
38824939358,38824939376,18,1139,2231,20
38827683984,38827683980,-4,1274,3349,20
38827956311,38827956330,19,1063,2487,20
38832133292,38832133290,-2,1380,2454,20
38833093530,38833093525,-5,651,2849,20
38838037070,38838037066,-4,1703,2343,20
38841420738,38841420733,-5,1157,2286,20
38842247645,38842247645,0,1404,2247,20
38846604594,38846604593,-1,997,2038,20
38849114050,38849114046,-4,1315,2688,20
38849295690,38849295687,-3,1085,2883,20
38850693433,38850693429,-4,1139,3215,20
38852852907,38852852904,-3,925,2523,20
38853374091,38853374087,-4,1065,2650,20
38859061787,38859061785,-2,1237,2415,20
38860381230,38860381233,3,1707,1254,20
38864623482,38864623480,-2,1359,3058,20
38867659465,38867659463,-2,1318,2346,20
38874265026,38874265022,-4,1203,2181,20
38875754569,38875754565,-4,1496,3109,20
38878387803,38878387801,-2,1339,2156,20
38879607910,38879607926,16,277,874,20
38881566245,38881566241,-4,1051,2438,20
38886684363,38886684361,-2,1396,2792,20
38887009252,38887009257,5,3455,2307,20
38890965483,38890965490,7,274,600,20
38892318483,38892318481,-2,947,3105,20
38895477886,38895477882,-4,1245,2547,20
38896987938,38896987934,-4,1570,3550,20
38908622854,38908622851,-3,832,2289,20
38908889855,38908889866,11,601,2072,20
38916743210,38916743206,-4,575,1820,20
38918934195,38918934193,-2,1175,2111,20
38922411643,38922411647,4,7672,7002,20
38923382970,38923382967,-3,1137,2871,20
38923792091,38923792089,-2,966,2235,20
38930536788,38930536787,-1,1020,2043,20
38931633302,38931633303,1,2563,2278,20
38932446803,38932446802,-1,1103,1590,20
38938100889,38938100889,0,1374,2221,20
38938162419,38938162418,-1,1488,3108,20
38939596840,38939596838,-2,1366,2652,20
38939723689,38939723688,-1,1130,2975,20
38945036234,38945036233,-1,989,2987,20
38948073009,38948073013,4,1597,1089,20
38948294783,38948294781,-2,942,1937,20
38948871113,38948871109,-4,897,2312,20
38957602222,38957602217,-5,853,3123,20
38959624895,38959624894,-1,929,2446,20
38959832187,38959832185,-2,1053,2415,20
38964818239,38964818238,-1,1177,2611,20
38965892396,38965892392,-4,1505,3606,20
38967611288,38967611301,13,1010,2488,20
38969104310,38969104307,-3,1455,2498,20
38970918334,38970918330,-4,777,2457,20
38972391941,38972391943,2,1245,2469,20
38973365466,38973365464,-2,1647,2895,20
38974378146,38974378143,-3,986,2168,20
38975912799,38975912798,-1,770,1707,20
38977694979,38977694978,-1,807,1053,20
38978953918,38978953919,1,3032,3234,20
38981063343,38981063346,3,1470,1365,20
38981605245,38981605244,-1,1292,1870,20
38987263782,38987263789,7,2202,1401,20
38988114246,38988114241,-5,1027,2237,20
38989782455,38989782453,-2,1266,3325,20
38991009878,38991009877,-1,1234,1875,20
38997515398,38997515394,-4,1094,2634,20
38998024030,38998024011,-19,1300,2709,20
39001669725,39001669722,-3,760,1591,20
39011637857,39011637855,-2,884,2288,20
39020363673,39020363677,4,2577,1739,20
39026939107,39026939104,-3,1331,2502,20
39036552354,39036552351,-3,872,2098,20
39042178599,39042178601,2,8655,7007,20
39044848090,39044848089,-1,1839,1867,20
39046092409,39046092410,1,1331,1732,20
39048655130,39048655127,-3,900,1932,20
39050174392,39050174388,-4,739,2133,20
39050800263,39050800262,-1,1078,1934,20
39055781606,39055781603,-3,760,1181,20
39065124330,39065124329,-1,986,1518,20
39067410393,39067410397,4,2550,1552,20
39069291643,39069291641,-2,990,1863,20
39071400042,39071400038,-4,24792,12770,20
39071454483,39071454480,-3,774,1769,20
39072443392,39072443390,-2,973,1758,20
39073340822,39073340839,17,867,2004,20
39074026631,39074026630,-1,1114,2106,20
39076012342,39076012338,-4,852,2901,20
39076837897,39076837893,-4,1367,2499,20
39076882879,39076882877,-2,1118,2496,20
39080350443,39080350441,-2,1211,2395,20
39082173454,39082173451,-3,1240,2135,20
39083615753,39083615750,-3,1283,2037,20
39085953551,39085953547,-4,677,1770,20
39087598646,39087598645,-1,1009,2414,20
39090002097,39090002093,-4,840,1867,20
39090429049,39090429056,7,3026,1393,20
39091439023,39091439022,-1,1431,2628,20
39094170769,39094170767,-2,1133,2368,20
39098336951,39098336945,-6,788,5230,20
39102442545,39102442543,-2,1128,1834,20
39111890683,39111890680,-3,875,1967,20
39113251072,39113251070,-2,1349,2044,20
39113644023,39113644019,-4,1187,1945,20
39117258950,39117258950,0,932,1066,20
39119994539,39119994534,-5,976,2218,20
39124590463,39124590461,-2,1063,2472,20
39127259555,39127259551,-4,865,2622,20
39128627025,39128627022,-3,1085,2583,20
39129517075,39129517073,-2,1087,1970,20
39131436783,39131436781,-2,1175,1928,20
39135087526,39135087523,-3,1202,2364,20
39136253771,39136253769,-2,1283,3401,20
39137175910,39137175910,0,1287,2272,20
39137251581,39137251599,18,977,1487,20
39138089659,39138089657,-2,1083,3273,20
39146735092,39146735086,-6,1305,2931,20
39152666217,39152666216,-1,1408,2600,20
39155864834,39155864834,0,1106,1958,20
39160501982,39160501981,-1,1641,2931,20
39164331970,39164331970,0,860,1657,20
39172455865,39172455862,-3,1353,2436,20
39173629824,39173629822,-2,859,2239,20
39178142454,39178142456,2,1826,1630,20
39179499457,39179499456,-1,1165,2478,20
39184864871,39184864871,0,1259,1470,20
39185729642,39185729641,-1,1091,2206,20
39186144092,39186144081,-11,1107,2330,20
39189445249,39189445245,-4,1040,2327,20
39191459186,39191459185,-1,1431,2603,20
39198610199,39198610195,-4,1033,2030,20
39203605410,39203605409,-1,1310,2250,20
39204337866,39204337862,-4,1347,2363,20
39204380186,39204380186,0,1537,1649,20
39208379284,39208379281,-3,918,1900,20
39210883743,39210883738,-5,919,1647,20
39211599223,39211599220,-3,995,1466,20
39216080109,39216080106,-3,979,3152,20
39221004450,39221004447,-3,640,1757,20
39224296648,39224296645,-3,1097,2253,20
39224667566,39224667570,4,3931,3065,20
39225941893,39225941896,3,1358,1043,20
39227233902,39227233898,-4,1101,4073,20
39229451355,39229451353,-2,1107,2549,20
39232393120,39232393117,-3,1019,2855,20
39232625078,39232625093,15,469,1499,20
39240667751,39240667747,-4,1530,3062,20
39245136352,39245136354,2,1521,1296,20
39247486747,39247486745,-2,1232,2002,20
39252038406,39252038403,-3,1353,2239,20
39252677838,39252677855,17,1815,3470,20
39258407850,39258407850,0,1723,2547,20
39261680203,39261680204,1,1276,1366,20
39263432644,39263432655,11,11399,33347,20
39265365575,39265365573,-2,1156,3008,20
39269772942,39269772939,-3,1067,2323,20
39271343436,39271343431,-5,1044,2866,20
39272871173,39272871173,0,1021,2095,20
39273757520,39273757536,16,1055,1794,20
39274240022,39274240021,-1,1038,2423,20
39275302663,39275302663,0,1242,1925,20
39275378877,39275378874,-3,1248,2971,20
39275451861,39275451882,21,1203,2386,20
39277325394,39277325393,-1,987,2383,20
39277914390,39277914387,-3,724,1465,20
39279814464,39279814444,-20,222,692,20
39290253235,39290253232,-3,1211,2270,20
39298329838,39298329833,-5,1072,3038,20
39298415252,39298415270,18,1803,2641,20
39299863632,39299863634,2,8936,7435,20
39300130621,39300130618,-3,1145,1981,20
39301133774,39301133773,-1,944,2217,20
39301415971,39301415968,-3,1370,2674,20
39306667150,39306667146,-4,498,2756,20
39313533372,39313533372,0,739,2166,20
39316153026,39316153022,-4,964,1874,20
39325843737,39325843734,-3,1237,2593,20
39329220763,39329220761,-2,852,2112,20
39335512272,39335512268,-4,1052,1833,20
39343485057,39343485054,-3,978,2550,20
39344534325,39344534323,-2,1184,2215,20
39344575198,39344575195,-3,1213,3485,20
39346737949,39346737946,-3,973,2276,20
39347019684,39347019705,21,1865,2818,20
39348787845,39348787839,-6,802,2993,20
39351329751,39351329748,-3,1140,2502,20
39362916486,39362916490,4,1000,1111,20
39364873728,39364873725,-3,1479,2305,20
39370351426,39370351423,-3,998,2273,20
39373083443,39373083438,-5,1058,1245,20
39388728394,39388728394,0,917,1909,20
39390045786,39390045785,-1,1261,3008,20
39391367042,39391367035,-7,1075,2136,20
39394429503,39394429501,-2,898,1912,20
39405517009,39405517007,-2,1061,1961,20
39405661412,39405661433,21,515,1126,20
39411088694,39411088689,-5,976,2791,20
39413936803,39413936802,-1,1042,1982,20
39423890994,39423890992,-2,1006,2213,20
39425075254,39425075249,-5,1159,1378,20
39425775656,39425775657,1,1971,2408,20
39428789097,39428789094,-3,1139,2051,20
39429378851,39429378847,-4,872,1863,20
39438181582,39438181580,-2,961,2632,20
39438919025,39438919019,-6,766,2046,20
39439229700,39439229706,6,341,880,20
39440312678,39440312663,-15,246,673,20
39441094112,39441094109,-3,1309,3465,20
39447403609,39447403615,6,3548,2337,20
39451071430,39451071426,-4,1161,2285,20
39452058732,39452058729,-3,1428,2624,20
39452916175,39452916171,-4,1169,2577,20
39456533411,39456533407,-4,1168,2232,20
39456827531,39456827526,-5,1451,2390,20
39458907751,39458907750,-1,1600,2625,20
39463831425,39463831432,7,1052,1483,20
39466488382,39466488381,-1,824,2223,20
39466554068,39466554059,-9,268,1873,20
39467317527,39467317525,-2,2099,3723,20
39469022333,39469022331,-2,1043,2593,20
39469984232,39469984250,18,1317,2599,20
39470290279,39470290274,-5,1548,3036,20
39470709593,39470709591,-2,788,2097,20
39471247390,39471247386,-4,1291,2480,20
39471478919,39471478912,-7,208,947,20
39474515403,39474515402,-1,935,2287,20
39477092526,39477092522,-4,1275,2248,20
39478033784,39478033798,14,561,996,20
39481932818,39481932816,-2,1407,2322,20
39482993129,39482993126,-3,847,2473,20
39493469474,39493469468,-6,1131,5237,20
39498259083,39498259078,-5,1669,2976,20
39498348431,39498348427,-4,1131,2128,20
39504812783,39504812781,-2,1028,2377,20
39505141342,39505141337,-5,1059,2339,20
39506431242,39506431242,0,1123,2643,20
39509196929,39509196910,-19,1382,924,20
39509781099,39509781094,-5,1110,1864,20
39512342854,39512342851,-3,1546,3168,20
39512759517,39512759509,-8,767,2471,20
39515216414,39515216411,-3,1410,2474,20
39516131781,39516131777,-4,1296,2923,20
39518777530,39518777525,-5,1325,1928,20
39522820559,39522820557,-2,907,2172,20
39526182117,39526182116,-1,1253,1966,20
39529278690,39529278686,-4,851,2152,20
39529453966,39529453962,-4,926,2984,20
39532373000,39532372998,-2,1116,2635,20
39533820378,39533820374,-4,1737,3312,20
39535051435,39535051433,-2,1387,2471,20
39539628256,39539628275,19,343,1205,20
39542678914,39542678910,-4,1090,2699,20
39544152621,39544152620,-1,1514,2164,20
39544539342,39544539337,-5,1972,5247,20
39545837826,39545837825,-1,1229,2452,20
39548593421,39548593420,-1,1163,1746,20
39556485106,39556485102,-4,1389,2743,20
39559873702,39559873698,-4,624,1634,20
39561048481,39561048478,-3,1500,2856,20
39566613360,39566613357,-3,1110,2961,20
39573643783,39573643779,-4,927,2102,20
39582665483,39582665477,-6,788,2319,20
39584780235,39584780233,-2,1116,1619,20
39585583702,39585583723,21,1047,2576,20
39587200889,39587200891,2,2660,2533,20
39587291082,39587291081,-1,1300,1722,20
39596730641,39596730642,1,1426,2075,20
39600274423,39600274423,0,277,1109,20
39600550160,39600550155,-5,1362,2622,20
39602268287,39602268292,5,4639,2089,20
39602359810,39602359814,4,990,876,20
39607146018,39607146039,21,38255,23133,20
39616193445,39616193440,-5,792,2156,20
39617864491,39617864487,-4,1217,2545,20
39620243635,39620243629,-6,1040,3212,20
39623573286,39623573284,-2,1791,2420,20
39623963566,39623963561,-5,2389,9567,20
39627516678,39627516677,-1,1124,1563,20
39632088219,39632088217,-2,1022,2211,20
39633671102,39633671098,-4,1045,1720,20
39634267812,39634267835,23,676,1902,20
39634473910,39634473908,-2,1338,2385,20
39635507742,39635507741,-1,1118,2128,20
39636402158,39636402154,-4,751,2641,20
39640324158,39640324155,-3,1253,2598,20
39643100682,39643100678,-4,1397,2152,20
39646440488,39646440494,6,7645,2650,20
39649068466,39649068466,0,941,2178,20
39650272535,39650272531,-4,1259,2436,20
39651652594,39651652598,4,3865,2544,20
39652443322,39652443319,-3,1303,2248,20
39657647087,39657647086,-1,861,1492,20
39658116701,39658116699,-2,698,1562,20
39658691047,39658691062,15,544,1016,20
39660972686,39660972682,-4,762,1585,20
39661875992,39661875989,-3,1062,2189,20
39662520807,39662520805,-2,1464,2838,20
39665286091,39665286089,-2,1682,3217,20
39668976161,39668976157,-4,1081,2909,20
39670494703,39670494701,-2,1295,2942,20
39679309047,39679309042,-5,1174,2585,20
39685800300,39685800315,15,998,1858,20
39688126950,39688126948,-2,594,1726,20
39693313397,39693313394,-3,939,2315,20
39693970101,39693970099,-2,908,2418,20
39701442104,39701442107,3,3776,2428,20
39701624157,39701624153,-4,1208,4182,20
39705691127,39705691125,-2,1207,2596,20
39708229872,39708229866,-6,977,3128,20
39710472150,39710472145,-5,1172,2453,20
39711565915,39711565912,-3,1075,2278,20
39713366337,39713366332,-5,1020,4116,20
39713454374,39713454372,-2,895,1932,20
39714187902,39714187900,-2,824,1600,20
39715021714,39715021713,-1,1465,2993,20
39716616715,39716616713,-2,671,2111,20
39717932918,39717932915,-3,1272,2026,20
39718073347,39718073343,-4,1025,1966,20
39721385406,39721385411,5,2166,1786,20
39721663986,39721663983,-3,1522,2664,20
39724639072,39724639069,-3,1423,3423,20
39730699134,39730699131,-3,1199,2243,20
39730773467,39730773465,-2,1166,2034,20
39730916201,39730916200,-1,1126,2642,20
39735925151,39735925150,-1,1310,2234,20
39738309194,39738309191,-3,1175,2798,20
39755035183,39755035179,-4,1129,1885,20
39757682794,39757682793,-1,1390,2390,20
39758516417,39758516413,-4,1101,2802,20
39758851679,39758851677,-2,1389,2884,20
39759378565,39759378582,17,871,1665,20
39760334687,39760334689,2,1756,2325,20
39762862594,39762862595,1,1244,1638,20
39767713165,39767713164,-1,816,1440,20
39782584551,39782584547,-4,998,1913,20
39789855458,39789855456,-2,1037,1563,20
39793424694,39793424690,-4,1288,2649,20
39800918944,39800918942,-2,1183,2529,20
39803814342,39803814342,0,1025,1940,20
39803936425,39803936422,-3,709,946,20
39806486314,39806486315,1,1771,1931,20
39806952415,39806952409,-6,1576,5813,20
39822506422,39822506421,-1,1151,2105,20
39831462731,39831462725,-6,1036,1866,20
39834188975,39834188971,-4,1455,2232,20
39837573834,39837573832,-2,1093,1902,20
39839322741,39839322735,-6,1020,2809,20
39839390882,39839390877,-5,1018,2265,20
39844180429,39844180426,-3,955,1489,20
39849989727,39849989722,-5,1367,3379,20
39854585451,39854585470,19,814,4828,20
39857191531,39857191528,-3,1040,2447,20
39858768767,39858768765,-2,1339,2384,20
39860025471,39860025469,-2,1274,2064,20
39862087883,39862087878,-5,1083,2523,20
39862447991,39862447987,-4,909,2098,20
39866657516,39866657516,0,292,1572,20
39867716317,39867716302,-15,248,1034,20
39868268114,39868268111,-3,1460,3289,20
39868666312,39868666308,-4,1695,2997,20
39871160241,39871160237,-4,1206,3252,20
39876634309,39876634306,-3,1136,2474,20
39881851718,39881851714,-4,1478,2581,20
39886802437,39886802434,-3,1409,1612,20
39891898318,39891898312,-6,1001,3655,20
39893450040,39893450036,-4,1399,2643,20
39894376829,39894376827,-2,596,1884,20
39896276946,39896276945,-1,1205,2209,20
39896464741,39896464742,1,168,1091,20
39900809111,39900809106,-5,895,2714,20
39901861002,39901861002,0,899,1915,20
39905609838,39905609834,-4,1211,2039,20
39906046287,39906046281,-6,2229,6601,20
39907923960,39907923957,-3,1560,3189,20
39909108163,39909108159,-4,891,2525,20
39914015218,39914015217,-1,1030,2344,20
39915536072,39915536068,-4,1011,2364,20
39926315108,39926315113,5,3263,860,20
39930337430,39930337433,3,1168,1788,20
39931587610,39931587606,-4,2264,5108,20
39933366177,39933366175,-2,948,1050,20
39943812190,39943812184,-6,1494,5685,20
39944633220,39944633214,-6,423,1637,20
39947817265,39947817262,-3,1485,3357,20
39948649806,39948649803,-3,1381,1547,20
39953536438,39953536434,-4,1391,1754,20
39954075415,39954075419,4,1013,1039,20
39955094647,39955094641,-6,1313,3470,20
39956124574,39956124574,0,1150,2197,20
39958060125,39958060122,-3,1268,2969,20
39958872991,39958872987,-4,1337,2048,20
39961113621,39961113614,-7,1764,9301,20
39961596352,39961596349,-3,1401,2791,20
39964978086,39964978085,-1,1264,1549,20
39965811335,39965811331,-4,989,2483,20
39967767036,39967767033,-3,1521,1840,20
39968386076,39968386079,3,1348,1685,20
39969691233,39969691215,-18,6575,33200,20
39971283569,39971283566,-3,1313,2333,20
39972310682,39972310698,16,33,755,20
39974524271,39974524267,-4,834,2124,20
39980430564,39980430566,2,33271,34181,20
39980716954,39980716949,-5,1663,5455,20
39981545654,39981545659,5,4163,2110,20
39984638481,39984638489,8,1249,866,20
39986364079,39986364085,6,1243,887,20
39990286805,39990286807,2,1444,1455,20
39991084357,39991084358,1,1466,1499,20
39991540889,39991540885,-4,1372,3261,20
39995331983,39995331980,-3,916,2205,20
39999524121,39999524117,-4,891,4059,20
40001988421,40001988418,-3,921,1533,20
40005529743,40005529742,-1,12019,15994,20
40007184678,40007184674,-4,1033,2977,20
40010428702,40010428700,-2,1157,1827,20
40013393666,40013393663,-3,1074,2103,20
40021418561,40021418566,5,2326,1438,20
40025535172,40025535169,-3,1366,1709,20
40027820470,40027820473,3,2178,1706,20
40030081010,40030081006,-4,1228,2335,20
40030361445,40030361463,18,904,2821,20
40033016377,40033016374,-3,1628,2640,20
40035597570,40035597566,-4,1159,2042,20
40036700005,40036699985,-20,137,818,20
40040066177,40040066174,-3,1892,3091,20
40041600297,40041600293,-4,927,2418,20
40042791429,40042791430,1,1734,2127,20
40045627823,40045627819,-4,1137,2461,20
40047257250,40047257247,-3,1021,2076,20
40048161255,40048161244,-11,1020,7591,20
40048675214,40048675229,15,1248,3016,20
40049275263,40049275240,-23,253,1078,20
40051806142,40051806142,0,804,1970,20
40052682675,40052682673,-2,1056,2187,20
40053042077,40053042072,-5,1250,87,20
40055827165,40055827168,3,1024,1380,20
40057841699,40057841696,-3,822,1784,20
40058945739,40058945738,-1,938,1824,20
40062786387,40062786372,-15,611,1413,20
40063518590,40063518588,-2,1476,2824,20
40063884135,40063884150,15,725,2058,20
40064529102,40064529099,-3,1603,2713,20
40072904247,40072904263,16,1009,2010,20
40078513353,40078513347,-6,915,2269,20
40079034954,40079034948,-6,683,1446,20
40081125947,40081125944,-3,1169,2409,20
40089714269,40089714264,-5,1590,3247,20
40094579108,40094579106,-2,935,1714,20
40094753295,40094753291,-4,1259,2109,20
40095420233,40095420229,-4,1008,2582,20
40095519118,40095519117,-1,7139,9709,20
40096301610,40096301605,-5,1021,2740,20
40099334875,40099334873,-2,825,2051,20
40112641194,40112641192,-2,1944,2831,20
40121144535,40121144533,-2,957,2216,20
40127641642,40127641641,-1,946,1578,20
40129271930,40129271926,-4,907,2551,20
40133738541,40133738537,-4,1228,2370,20
40134152547,40134152544,-3,1298,2704,20
40134331464,40134331477,13,869,2345,20
40134778734,40134778730,-4,1309,2822,20
40134805851,40134805848,-3,1030,2313,20
40136748531,40136748529,-2,1544,2256,20
40138301915,40138301910,-5,1068,2018,20
40138998671,40138998671,0,1430,1764,20
40141160773,40141160775,2,1057,1444,20
40142565930,40142565929,-1,1134,2424,20
40145134308,40145134305,-3,1289,1574,20
40145645006,40145645005,-1,725,1095,20
40149593926,40149593922,-4,1131,1729,20
40154658673,40154658669,-4,1266,2239,20
40156199207,40156199204,-3,1199,2446,20
40158664899,40158664895,-4,1060,1795,20
40166368451,40166368447,-4,887,2718,20
40166593753,40166593748,-5,949,2565,20
40167113758,40167113778,20,991,1978,20
40167335989,40167335986,-3,1030,2710,20
40167771286,40167771291,5,980,1822,20
40171183305,40171183299,-6,1710,3941,20
40171982848,40171982845,-3,2320,5405,20
40174942561,40174942560,-1,862,1879,20
40179201394,40179201391,-3,1451,2162,20
40179471290,40179471286,-4,974,3008,20
40180177970,40180177966,-4,1419,2388,20
40181504469,40181504466,-3,1663,2810,20
40182949376,40182949374,-2,1574,2827,20
40184308131,40184308129,-2,929,2403,20
40185825431,40185825429,-2,1284,2488,20
40187605651,40187605658,7,2927,1363,20
40188413061,40188413058,-3,1450,3117,20
40188894314,40188894311,-3,948,2593,20
40190868456,40190868451,-5,1486,2610,20
40192266959,40192266957,-2,975,2049,20
40197111109,40197111107,-2,1095,1867,20
40202472778,40202472785,7,6459,1785,20
40215976213,40215976210,-3,1434,3098,20
40216398414,40216398412,-2,1528,2071,20
40216739734,40216739732,-2,759,2160,20
40217523427,40217523424,-3,1025,1933,20
40218971787,40218971787,0,2747,3843,20
40220361762,40220361763,1,1592,1259,20
40223623028,40223623023,-5,896,1836,20
40228164358,40228164354,-4,1494,3072,20
40229127355,40229127350,-5,848,3218,20
40229778783,40229778786,3,154,781,20
40233698684,40233698682,-2,1439,2711,20
40243116494,40243116489,-5,837,1681,20
40246213619,40246213614,-5,856,2621,20
40248972738,40248972737,-1,1400,2281,20
40250314057,40250314054,-3,1143,2557,20
40253235530,40253235527,-3,1101,2975,20
40256150557,40256150554,-3,921,2139,20
40257964122,40257964120,-2,1620,2400,20
40264570045,40264570042,-3,1164,2188,20
40272629886,40272629885,-1,907,1385,20
40273765918,40273765922,4,2360,1556,20
40274033754,40274033750,-4,1094,1986,20
40274567102,40274567118,16,670,2638,20
40274787898,40274787894,-4,1044,2555,20
40276267990,40276267987,-3,1406,2286,20
40277566218,40277566216,-2,1018,2289,20
40278104540,40278104540,0,1118,1825,20
40282169471,40282169468,-3,998,2372,20
40290364893,40290364889,-4,873,1777,20
40295258567,40295258566,-1,1290,2539,20
40296185123,40296185119,-4,1032,3024,20
40296385916,40296385925,9,12715,47114,20
40297650602,40297650600,-2,1035,1903,20
40300587986,40300587981,-5,1035,2501,20
40301854094,40301854090,-4,560,2109,20
40302180546,40302180562,16,498,1101,20
40302527638,40302527639,1,1175,2120,20
40303154779,40303154775,-4,879,1897,20
40303983982,40303983980,-2,1216,1868,20
40313596382,40313596380,-2,1127,2515,20
40316816279,40316816278,-1,667,1847,20
40320532122,40320532118,-4,1105,1452,20
40324472459,40324472457,-2,991,2461,20
40326410347,40326410345,-2,952,2239,20
40331427827,40331427825,-2,1086,1845,20
40332212741,40332212721,-20,528,1485,20
40333457692,40333457676,-16,939,2214,20
40333776966,40333776974,8,182,527,20
40335794938,40335794937,-1,1216,2062,20
40342834001,40342833997,-4,868,2032,20
40346833900,40346833897,-3,894,2434,20
40358712986,40358712983,-3,1225,2101,20
40359020351,40359020359,8,171,716,20
40359531533,40359531555,22,700,1819,20
40362615597,40362615603,6,4951,3038,20
40363611759,40363611755,-4,964,1880,20
40365126791,40365126789,-2,882,2237,20
40367472178,40367472177,-1,1028,2611,20
40367945551,40367945546,-5,856,1929,20
40374021538,40374021535,-3,936,1666,20
40378696594,40378696590,-4,1397,3044,20
40380797327,40380797328,1,1514,1260,20
40381915588,40381915587,-1,26196,77723,20
40382925835,40382925840,5,1554,1587,20
40384770914,40384770912,-2,1470,2258,20
40385718942,40385718938,-4,1161,2528,20
40386546443,40386546448,5,3074,1521,20
40387302541,40387302543,2,1610,1140,20
40387505417,40387505418,1,1618,2061,20
40391929765,40391929763,-2,800,1326,20
40394198805,40394198802,-3,879,2229,20
40396844853,40396844850,-3,855,2105,20
40403069257,40403069254,-3,1291,2385,20
40408981746,40408981744,-2,761,2160,20
40409386270,40409386268,-2,1160,2429,20
40412824823,40412824820,-3,1133,2595,20
40414696784,40414696780,-4,1534,2772,20
40415429279,40415429275,-4,1317,2425,20
40418745350,40418745347,-3,852,1662,20
40424885586,40424885584,-2,1581,3029,20
40425882173,40425882170,-3,771,1965,20
40425953813,40425953835,22,447,1474,20
40426576089,40426576087,-2,1083,2187,20
40427234658,40427234649,-9,661,2115,20
40428173762,40428173760,-2,1318,2089,20
40432571797,40432571793,-4,1515,2937,20
40432710176,40432710173,-3,1490,3138,20
40433512532,40433512526,-6,944,2105,20
40436585704,40436585698,-6,1044,1925,20
40437901540,40437901538,-2,1850,2900,20
40443211426,40443211429,3,1413,821,20
40446399182,40446399178,-4,1022,2686,20
40450447511,40450447510,-1,1176,2056,20
40455218298,40455218303,5,1714,1617,20
40459701545,40459701542,-3,1559,3045,20
40460176766,40460176783,17,635,1240,20
40463537070,40463537066,-4,1423,2512,20
40469650038,40469650034,-4,1679,2904,20
40469754070,40469754068,-2,1642,2455,20
40473305948,40473305945,-3,1173,1253,20
40474946782,40474946773,-9,973,2468,20
40475041665,40475041661,-4,1086,2158,20
40475928914,40475928911,-3,1059,2136,20
40476179190,40476179190,0,1271,1944,20
40477955143,40477955137,-6,1114,3363,20
40487008675,40487008672,-3,1097,2328,20
40489932745,40489932741,-4,1224,3535,20
40493699451,40493699466,15,839,3763,20
40494901949,40494901945,-4,1649,2522,20
40496512678,40496512676,-2,851,1547,20
40500978877,40500978879,2,2578,1292,20
40506476709,40506476707,-2,1320,2619,20
40517931960,40517931955,-5,860,2290,20
40518798299,40518798298,-1,1645,2462,20
40527903014,40527903011,-3,1254,2712,20
40534027979,40534027975,-4,1259,2919,20
40539525149,40539525145,-4,919,2675,20
40541787758,40541787758,0,1110,1563,20
40544425926,40544425914,-12,38408,15034,20
40544684165,40544684166,1,2167,1511,20
40544985331,40544985329,-2,1496,2554,20
40545131046,40545131044,-2,1305,1275,20
40547803068,40547803082,14,1006,2152,20
40550043371,40550043368,-3,1353,2237,20
40550495783,40550495778,-5,1503,2992,20
40550799245,40550799240,-5,995,3142,20
40570121982,40570121980,-2,672,1972,20
40580219937,40580219934,-3,979,1799,20
40584363324,40584363326,2,5472,5653,20
40587806441,40587806438,-3,1548,2862,20
40592822443,40592822439,-4,1347,1877,20
40595378798,40595378795,-3,1098,1831,20
40595811183,40595811178,-5,1103,2330,20
40607871304,40607871299,-5,707,2049,20
40608967214,40608967213,-1,1710,2060,20
40611005551,40611005547,-4,1339,2836,20
40611846122,40611846118,-4,1163,1831,20
40616035782,40616035783,1,696,1106,20
40619151546,40619151542,-4,1053,1828,20
40623952938,40623952936,-2,1091,3094,20
40624723174,40624723172,-2,1410,1473,20
40626430252,40626430249,-3,1263,3302,20
40632998855,40632998853,-2,1163,2014,20
40640159983,40640159979,-4,1465,3234,20
40641350881,40641350897,16,455,2808,20
40644579886,40644579883,-3,1185,2069,20
40645438386,40645438382,-4,1685,2239,20
40646328550,40646328548,-2,1325,2554,20
40646931179,40646931177,-2,1346,2233,20
40648182486,40648182494,8,11175,24727,20
40648708059,40648708058,-1,1138,1740,20
40653407814,40653407819,5,6985,3180,20
40662982491,40662982488,-3,1595,1637,20
40663143941,40663143938,-3,1310,1608,20
40665455611,40665455605,-6,1012,3031,20
40671748160,40671748158,-2,1182,2298,20
40673904878,40673904876,-2,1556,3019,20
40676194820,40676194818,-2,1094,2047,20
40682022473,40682022475,2,899,962,20
40688129570,40688129569,-1,1068,2874,20
40691897709,40691897705,-4,1231,2208,20
40695513199,40695513196,-3,1199,2794,20
40702973059,40702973058,-1,1130,1432,20
40704470279,40704470298,19,529,1619,20
40707667897,40707667888,-9,22668,15183,20
40708002512,40708002508,-4,1095,2590,20
40712847181,40712847178,-3,1069,2009,20
40713017642,40713017639,-3,898,2661,20
40718431703,40718431698,-5,844,3089,20
40720632737,40720632734,-3,1212,2551,20
40724201567,40724201561,-6,1076,2658,20
40724817624,40724817639,15,1011,2375,20
40729313115,40729313109,-6,3207,11129,20
40729433200,40729433205,5,2362,1662,20
40736146470,40736146458,-12,2508,775,20
40741857926,40741857925,-1,1021,2074,20
40742473698,40742473693,-5,1407,2317,20
40744698981,40744698978,-3,1007,2015,20
40745192588,40745192573,-15,122,819,20
40748331649,40748331650,1,1310,1733,20
40749847025,40749847021,-4,1169,2600,20
40752323614,40752323614,0,808,1520,20
40759778079,40759778077,-2,828,1328,20
40764242618,40764242617,-1,2112,3967,20
40765661765,40765661761,-4,1184,3310,20
40766163232,40766163242,10,9242,40188,20
40766734462,40766734459,-3,762,2423,20
40769207655,40769207656,1,1603,1641,20
40770521722,40770521717,-5,1214,2432,20
40772620155,40772620152,-3,1161,2294,20
40773342102,40773342098,-4,1137,2963,20
40776289277,40776289274,-3,1179,3393,20
40779435479,40779435473,-6,879,3151,20
40782687025,40782687022,-3,1137,2250,20
40786911186,40786911185,-1,1055,2535,20
40787485363,40787485362,-1,1324,2486,20
40792824183,40792824181,-2,2232,3879,20
40798770723,40798770719,-4,1229,2133,20
40799768061,40799768064,3,3806,2506,20
40800174387,40800174382,-5,800,1635,20
40801603074,40801603070,-4,1224,2394,20
40803733497,40803733493,-4,1715,2413,20
40804044082,40804044081,-1,1318,2425,20
40806662877,40806662878,1,31587,28616,20
40807068345,40807068341,-4,802,1540,20
40807267711,40807267728,17,373,1364,20
40807922293,40807922295,2,1672,1373,20
40813613038,40813613035,-3,1064,2934,20
40821473914,40821473910,-4,1077,2773,20
40822935783,40822935778,-5,900,1295,20
40827148139,40827148137,-2,934,2570,20
40833180714,40833180712,-2,949,1947,20
40834081407,40834081405,-2,1067,1947,20
40836257938,40836257942,4,1148,825,20
40842561338,40842561335,-3,1337,3166,20
40847386230,40847386228,-2,870,2379,20
40849597721,40849597719,-2,1455,2130,20
40850328938,40850328941,3,1360,1352,20
40857133115,40857133112,-3,1114,2568,20
40857938969,40857938966,-3,1250,2309,20
40858926785,40858926782,-3,1226,3276,20
40871993445,40871993447,2,1738,1592,20
40873463309,40873463307,-2,890,1515,20
40879793399,40879793398,-1,1125,1590,20
40880640937,40880640933,-4,1129,2031,20
40881519896,40881519893,-3,1354,2443,20
40884926822,40884926821,-1,1136,2585,20
40886375757,40886375753,-4,986,2578,20
40887329811,40887329809,-2,1049,2384,20
40889897630,40889897628,-2,1618,2210,20
40890903488,40890903485,-3,564,1346,20
40898931531,40898931529,-2,1354,3471,20
40902289047,40902289044,-3,894,1633,20
40902552038,40902552057,19,1170,2480,20
40904518336,40904518333,-3,1120,2012,20
40905973411,40905973409,-2,1220,2265,20
40912372445,40912372451,6,3324,1043,20
40912866942,40912866940,-2,975,1607,20
40927726943,40927726942,-1,1065,2528,20
40932276459,40932276456,-3,1491,3582,20
40935585183,40935585178,-5,1083,2519,20
40938039814,40938039811,-3,1322,2196,20
40938900564,40938900562,-2,1279,2053,20
40939356061,40939356081,20,199,760,20
40947848501,40947848497,-4,1270,2663,20
40949182300,40949182296,-4,1452,2563,20
40950142994,40950142994,0,1120,2506,20
40952288763,40952288761,-2,1235,2169,20
40953954174,40953954170,-4,1161,3203,20
40956265018,40956265017,-1,1110,2096,20
40957009474,40957009470,-4,1165,2744,20
40962017310,40962017307,-3,954,2385,20
40963655458,40963655455,-3,1318,2494,20
40965819854,40965819849,-5,41675,21003,20
40970006182,40970006179,-3,569,1417,20
40971863795,40971863789,-6,1120,3520,20
40980599358,40980599354,-4,879,1792,20
40984514950,40984514945,-5,3404,11654,20
40984684558,40984684559,1,2892,2888,20
40986367025,40986367021,-4,1277,2147,20
40986822571,40986822566,-5,729,1688,20
40991339463,40991339459,-4,985,2319,20
40991683927,40991683922,-5,1526,2606,20
40992198354,40992198351,-3,710,1632,20
40993354375,40993354371,-4,1216,2053,20
40993481725,40993481722,-3,1271,2632,20
40996551282,40996551285,3,4458,3232,20
40996670015,40996670012,-3,825,2253,20
41003012976,41003012977,1,1537,2134,20
41013506947,41013506943,-4,1336,1968,20
41022100280,41022100278,-2,1571,2261,20
41029466651,41029466645,-6,2016,5974,20
41031289599,41031289597,-2,1085,2443,20
41042769192,41042769197,5,2623,1281,20
41044350119,41044350117,-2,1276,2620,20
41044798505,41044798502,-3,1448,2967,20
41045415991,41045415987,-4,755,1737,20
41047318985,41047318981,-4,1106,3183,20
41048374974,41048374970,-4,2015,3975,20
41050422344,41050422342,-2,1138,2110,20
41051824880,41051824877,-3,1367,2496,20
41060980733,41060980730,-3,1213,3366,20
41062537348,41062537367,19,589,1368,20
41073905340,41073905336,-4,1035,1981,20
41077632794,41077632790,-4,1233,2767,20
41081182325,41081182322,-3,952,1865,20
41088512054,41088512050,-4,889,2162,20
41092348619,41092348613,-6,991,2421,20
41093601307,41093601302,-5,954,3561,20
41107684367,41107684366,-1,1141,1544,20
41113257798,41113257799,1,2018,2174,20
41119708230,41119708229,-1,1075,2409,20
41122265318,41122265318,0,1559,2524,20
41124220703,41124220698,-5,913,2775,20
41124399870,41124399869,-1,1150,2291,20
41125337947,41125337943,-4,1071,2304,20
41128261365,41128261370,5,1818,1197,20
41129612476,41129612474,-2,882,1273,20
41131929189,41131929187,-2,1380,2302,20
41133635662,41133635658,-4,1092,2286,20
41136267978,41136267978,0,1123,1893,20
41138512570,41138512567,-3,766,1393,20
41141305142,41141305138,-4,1630,3081,20
41142022997,41142022993,-4,996,2689,20
41145936317,41145936313,-4,1256,3491,20
41149511931,41149511927,-4,1179,2335,20
41150764971,41150764968,-3,1845,3077,20
41152661640,41152661642,2,1173,1115,20
41153387419,41153387419,0,1714,2786,20
41153829712,41153829710,-2,1185,2553,20
41156072063,41156072069,6,3740,1950,20
41161170270,41161170268,-2,1954,2484,20
41163772813,41163772815,2,1499,1476,20
41165661382,41165661374,-8,2261,13247,20
41170847894,41170847892,-2,1465,1506,20
41171419497,41171419480,-17,1459,1658,20
41176023023,41176023022,-1,1038,2536,20
41177162877,41177162874,-3,1155,2211,20
41177661334,41177661333,-1,1417,3255,20
41179354563,41179354560,-3,1271,2181,20
41186260291,41186260285,-6,1048,4569,20
41190854750,41190854747,-3,1377,1786,20
41192407723,41192407717,-6,1274,3091,20
41193258503,41193258501,-2,1471,2561,20
41193790999,41193790994,-5,991,4261,20
41197263502,41197263501,-1,1077,2037,20
41197351559,41197351557,-2,1297,3035,20
41203699098,41203699097,-1,1708,3074,20
41203742989,41203742970,-19,688,2171,20
41207012190,41207012187,-3,1362,1718,20
41211872188,41211872186,-2,1021,2936,20
41214813319,41214813318,-1,840,2508,20
41214875839,41214875857,18,703,1376,20
41215418410,41215418406,-4,938,2363,20
41221350285,41221350284,-1,1206,2084,20
41221398023,41221398026,3,190,1223,20
41223684521,41223684518,-3,847,2631,20
41223793548,41223793568,20,948,1706,20
41227512126,41227512124,-2,1285,1913,20
41229398954,41229398951,-3,1225,3147,20
41230153471,41230153475,4,2063,1467,20
41231505233,41231505231,-2,995,1716,20
41234543757,41234543752,-5,1314,4115,20
41236802529,41236802525,-4,912,1941,20
41238726199,41238726198,-1,1181,1677,20
41240524881,41240524877,-4,1049,1825,20
41244244073,41244244069,-4,1341,3114,20
41248809095,41248809094,-1,1233,2309,20
41249618575,41249618581,6,4942,2026,20
41254241462,41254241461,-1,914,1730,20
41255274733,41255274755,22,140,821,20
41258935414,41258935411,-3,994,2547,20
41259972103,41259972099,-4,1135,2488,20
41262662418,41262662414,-4,1326,2556,20
41262910550,41262910547,-3,1135,2089,20
41265632451,41265632450,-1,1217,2343,20
41267317558,41267317558,0,1858,2546,20
41269844779,41269844775,-4,1484,3434,20
41270403014,41270403010,-4,1007,2089,20
41271939055,41271939052,-3,1008,2526,20
41272152354,41272152357,3,1235,1275,20
41273810932,41273810930,-2,1086,2087,20
41282325470,41282325470,0,978,2256,20
41282727550,41282727546,-4,866,2835,20
41283868480,41283868477,-3,861,1891,20
41292025807,41292025807,0,814,1420,20
41296983274,41296983271,-3,1018,2607,20
41297637534,41297637555,21,749,1809,20
41299944066,41299944053,-13,797,403,20
41310390299,41310390298,-1,699,1195,20
41310964063,41310964071,8,208,1255,20
41313278586,41313278582,-4,1284,2098,20
41324879886,41324879901,15,903,2573,20
41325941927,41325941929,2,2315,1611,20
41326918894,41326918889,-5,1212,2304,20
41326992551,41326992534,-17,755,1251,20
41328132225,41328132233,8,3005,1449,20
41328277852,41328277849,-3,957,1867,20
41335973360,41335973357,-3,1184,2573,20
41336438695,41336438694,-1,1020,1831,20
41338123741,41338123736,-5,1272,2410,20
41345677043,41345677040,-3,1204,1668,20
41351997568,41351997564,-4,1488,3086,20
41353730606,41353730601,-5,1264,4013,20
41361426910,41361426906,-4,989,2319,20
41362052854,41362052851,-3,2142,4826,20
41362997688,41362997695,7,20540,31310,20
41363785398,41363785396,-2,2614,3285,20
41366822954,41366822949,-5,1261,1901,20
41368449707,41368449705,-2,831,1327,20
41370868346,41370868342,-4,1333,2536,20
41375994718,41375994715,-3,848,1163,20
41379751058,41379751056,-2,1723,2904,20
41383154472,41383154470,-2,1240,1582,20
41383929266,41383929263,-3,1303,2752,20
41384191621,41384191618,-3,1156,3095,20
41385520137,41385520133,-4,1177,2429,20
41391983519,41391983518,-1,1491,3055,20
41393848721,41393848727,6,4584,1895,20
41398448770,41398448770,0,900,1791,20
41399123175,41399123171,-4,1319,3147,20
41405763773,41405763788,15,1074,1832,20
41415672941,41415672938,-3,1051,2579,20
41415997264,41415997262,-2,1329,2248,20
41421007959,41421007953,-6,778,2427,20
41421076720,41421076736,16,755,1884,20
41423348601,41423348597,-4,945,1825,20
41423532224,41423532231,7,30671,21957,20
41423657570,41423657566,-4,874,2444,20
41424094971,41424094966,-5,853,2289,20
41424187533,41424187541,8,15373,29328,20
41424620499,41424620496,-3,1190,2201,20
41426538635,41426538634,-1,891,1439,20
41427683046,41427683045,-1,1420,2761,20
41432969752,41432969774,22,857,2147,20
41437540937,41437540928,-9,796,1420,20
41437642814,41437642823,9,201,709,20
41439578728,41439578723,-5,1408,2240,20
41439731599,41439731595,-4,1078,2414,20
41441253262,41441253262,0,1114,2234,20
41446293246,41446293251,5,3575,2188,20
41446586085,41446586081,-4,985,2915,20
41447154031,41447154029,-2,935,2561,20
41451465606,41451465602,-4,763,1403,20
41454357394,41454357395,1,1014,1565,20
41455162319,41455162317,-2,746,1777,20
41460495464,41460495463,-1,1381,1781,20
41462612487,41462612485,-2,974,1569,20
41463004254,41463004252,-2,1503,2404,20
41464911749,41464911745,-4,1208,1963,20
41465136478,41465136476,-2,1483,2460,20
41465754417,41465754414,-3,778,1917,20
41465935591,41465935572,-19,1118,2006,20
41468202445,41468202442,-3,1181,2615,20
41468525844,41468525842,-2,1569,2956,20
41472481065,41472481066,1,1348,1583,20
41474271485,41474271482,-3,623,1248,20
41474753395,41474753389,-6,1101,2358,20
41486411979,41486411973,-6,1275,2673,20
41486935932,41486935929,-3,928,2230,20
41492505282,41492505280,-2,778,1847,20
41494194339,41494194337,-2,1130,2790,20
41500706466,41500706463,-3,1069,2882,20
41517161363,41517161359,-4,1084,1357,20
41518741710,41518741711,1,3947,17927,20
41520439988,41520439986,-2,640,1489,20
41521508409,41521508406,-3,1148,2242,20
41525420392,41525420391,-1,1843,2725,20
41525542682,41525542676,-6,1964,6809,20
41527748410,41527748401,-9,832,1644,20
41530388540,41530388537,-3,1125,2583,20
41532641938,41532641937,-1,1152,1933,20
41535601542,41535601537,-5,1099,4561,20
41535970737,41535970733,-4,815,1714,20
41541149458,41541149457,-1,1555,3011,20
41543358697,41543358696,-1,1344,2514,20
41543415790,41543415786,-4,1758,5545,20
41544502322,41544502320,-2,753,2021,20
41546098995,41546098991,-4,1617,3688,20
41547129323,41547129322,-1,737,1970,20
41549536069,41549536066,-3,1994,3654,20
41550153161,41550153157,-4,1251,2119,20
41554443987,41554443983,-4,983,1914,20
41560310618,41560310623,5,1041,1494,20
41561880447,41561880441,-6,984,2341,20
41562368100,41562368123,23,146,808,20
41564035533,41564035530,-3,1469,2963,20
41566533808,41566533805,-3,738,1516,20
41571469054,41571469057,3,4419,3381,20
41571904462,41571904455,-7,1165,2198,20
41575813026,41575813012,-14,1260,240,20
41579093018,41579093017,-1,1422,1953,20
41582878949,41582878946,-3,1534,2652,20
41583433511,41583433510,-1,1043,2054,20
41599287021,41599287018,-3,720,2101,20
41600488464,41600488461,-3,1279,2239,20
41601182348,41601182354,6,21653,18620,20
41608967458,41608967458,0,1024,1606,20
41611241471,41611241469,-2,1287,2629,20
41611828933,41611828930,-3,1240,1663,20
41613839117,41613839125,8,3330,1026,20
41618808180,41618808176,-4,1041,2286,20
41621053010,41621053011,1,1095,1558,20
41628944824,41628944818,-6,1165,2271,20
41629548996,41629548991,-5,1349,2182,20
41634187976,41634187974,-2,990,1528,20
41635722595,41635722591,-4,1246,2899,20
41635865751,41635865766,15,1296,2325,20
41636191925,41636191922,-3,2055,2791,20
41636247340,41636247343,3,2045,1589,20
41638040478,41638040477,-1,1028,2128,20
41639341543,41639341540,-3,624,2715,20
41640177182,41640177179,-3,1213,1935,20
41649087052,41649087057,5,2570,2317,20
41651557895,41651557891,-4,1321,1705,20
41655823254,41655823250,-4,704,1089,20
41662297505,41662297510,5,1820,1171,20
41671940955,41671940951,-4,1203,2947,20
41677042058,41677042061,3,2104,2157,20
41679094183,41679094181,-2,1065,2239,20
41679582251,41679582249,-2,1179,2340,20
41680981945,41680981942,-3,1168,2424,20
41682777016,41682777013,-3,1302,1913,20
41687997665,41687997662,-3,1291,3005,20
41692146834,41692146838,4,3501,2382,20
41699156927,41699156925,-2,1055,1888,20
41708223631,41708223628,-3,989,2158,20
41715679249,41715679246,-3,993,3012,20
41717085570,41717085570,0,925,1716,20
41723765326,41723765325,-1,1023,1455,20
41727903894,41727903892,-2,901,1979,20
41728720012,41728720010,-2,1658,3383,20
41730649106,41730649102,-4,1397,3022,20
41730820763,41730820762,-1,1484,2001,20
41736045817,41736045816,-1,1194,3007,20
41737188979,41737188978,-1,1047,2125,20
41738805781,41738805781,0,1173,1751,20
41740364525,41740364520,-5,1117,1789,20
41740874706,41740874702,-4,1498,2447,20
41744034190,41744034188,-2,1128,1895,20
41744815844,41744815863,19,379,2022,20
41748103537,41748103531,-6,1045,2678,20
41748169940,41748169935,-5,969,1731,20
41748467904,41748467918,14,567,1005,20
41749825417,41749825414,-3,1147,3987,20
41751599595,41751599589,-6,992,2100,20
41752776425,41752776424,-1,637,2353,20
41756787686,41756787682,-4,882,2095,20
41757342686,41757342701,15,510,1786,20
41757724292,41757724290,-2,941,2290,20
41759775087,41759775085,-2,1294,1665,20
41766007147,41766007143,-4,1311,2607,20
41769912084,41769912080,-4,1316,2268,20
41770432179,41770432178,-1,1042,2360,20
41773854110,41773854106,-4,1295,2583,20
41775157412,41775157410,-2,978,2140,20
41779088255,41779088250,-5,680,1918,20
41779126389,41779126411,22,347,840,20
41781281074,41781281070,-4,1315,2707,20
41782008019,41782008018,-1,826,1341,20
41783091396,41783091380,-16,1014,1796,20
41784817654,41784817652,-2,1047,2116,20
41785522318,41785522313,-5,1117,2457,20
41787198598,41787198597,-1,1359,2199,20
41789326262,41789326258,-4,1024,2752,20
41794938076,41794938073,-3,931,1956,20
41795555450,41795555448,-2,860,1992,20
41797337868,41797337870,2,24695,18767,20
41805439097,41805439102,5,4062,1833,20
41813061386,41813061379,-7,948,5297,20
41815157395,41815157393,-2,1197,2458,20
41821176711,41821176710,-1,744,1565,20
41823904921,41823904916,-5,1200,3287,20
41827631309,41827631307,-2,1140,2898,20
41827671985,41827671982,-3,1751,2780,20
41836950360,41836950355,-5,891,1377,20
41838059645,41838059641,-4,1100,1965,20
41842865173,41842865173,0,979,1235,20
41848849528,41848849525,-3,1259,2115,20
41850370865,41850370862,-3,1472,2810,20
41853320606,41853320602,-4,820,2810,20
41854245454,41854245450,-4,1314,3355,20
41859282243,41859282244,1,1563,1767,20
41861637667,41861637659,-8,28458,13016,20
41862095377,41862095374,-3,1442,2888,20
41863996222,41863996218,-4,1093,3165,20
41864537734,41864537713,-21,903,1794,20
41866201471,41866201468,-3,1583,4199,20
41868081479,41868081477,-2,1328,2293,20
41868870517,41868870513,-4,1373,2906,20
41876801290,41876801288,-2,1041,2099,20
41883127572,41883127570,-2,1224,2064,20
41887729547,41887729545,-2,1252,2778,20
41892258759,41892258754,-5,1047,2615,20
41892301840,41892301854,14,584,1596,20
41893670917,41893670913,-4,1573,8486,20
41896712262,41896712258,-4,1169,2793,20
41900126635,41900126630,-5,634,1554,20
41904877406,41904877410,4,1811,1369,20
41905225297,41905225294,-3,699,1557,20
41907766208,41907766205,-3,1201,2049,20
41911665266,41911665265,-1,1339,2088,20
41912760590,41912760586,-4,1832,3813,20
41914910342,41914910335,-7,3309,10435,20
41922840454,41922840452,-2,1744,2580,20
41924336366,41924336362,-4,1393,2227,20
41926256638,41926256635,-3,944,1933,20
41926934614,41926934604,-10,1160,3010,20
41929682143,41929682134,-9,498,2797,20
41931135938,41931135934,-4,1785,1998,20
41931386822,41931386818,-4,990,1707,20
41932676074,41932676074,0,1049,1760,20
41942026914,41942026913,-1,1321,1909,20
41948904039,41948904017,-22,632,1348,20
41949208636,41949208635,-1,1477,2060,20
41956270205,41956270203,-2,1151,2070,20
41956574606,41956574606,0,1827,1640,20
41965379869,41965379869,0,1231,1763,20
41978354085,41978354081,-4,3110,12595,20
41979043714,41979043711,-3,1705,3352,20
41979295149,41979295145,-4,845,2291,20
41984957643,41984957638,-5,935,2358,20
41986646395,41986646393,-2,846,1687,20
41986891315,41986891312,-3,1035,2505,20
41988823934,41988823934,0,1249,1069,20
41993416178,41993416175,-3,1058,3149,20
42000280915,42000280914,-1,1473,3311,20
42004773314,42004773310,-4,1753,3489,20
42006699614,42006699611,-3,804,2252,20
42008998650,42008998646,-4,1423,2005,20
42014245487,42014245483,-4,1237,2834,20
42014802874,42014802877,3,2034,1721,20
42016990383,42016990378,-5,1542,2277,20
42019409085,42019409082,-3,978,1953,20
42019637774,42019637777,3,1940,1814,20
42019879021,42019879018,-3,1481,1990,20
42020271797,42020271793,-4,984,1871,20
42020892299,42020892295,-4,1160,2921,20
42021430851,42021430849,-2,930,2095,20
42021873932,42021873931,-1,1541,2017,20
42023642755,42023642752,-3,1595,2751,20
42025573058,42025573065,7,2902,1457,20
42027110704,42027110699,-5,1251,2471,20
42027833526,42027833523,-3,1588,2908,20
42030452272,42030452266,-6,965,3027,20
42033746215,42033746211,-4,1253,3040,20
42042265386,42042265382,-4,1093,1689,20
42042495605,42042495600,-5,1096,2953,20
42046295107,42046295107,0,934,1437,20
42046501236,42046501239,3,353,1260,20
42046568439,42046568459,20,460,1258,20
42048094579,42048094575,-4,874,1083,20
42054173542,42054173540,-2,1155,1982,20
42063086762,42063086760,-2,1301,2378,20
42073420127,42073420124,-3,1005,1937,20
42073629823,42073629821,-2,1068,1907,20
42078943347,42078943342,-5,1257,2121,20
42079800950,42079800947,-3,1464,2301,20
42080790055,42080790061,6,4214,2217,20
42080978391,42080978390,-1,1098,1752,20
42083184503,42083184502,-1,1251,2875,20
42083965702,42083965699,-3,1429,2186,20
42087590886,42087590885,-1,1300,2373,20
42087732410,42087732407,-3,1396,2126,20
42088487170,42088487169,-1,899,1876,20
42089676323,42089676320,-3,951,2325,20
42090184322,42090184321,-1,1606,2328,20
42092225175,42092225191,16,450,2021,20
42093590385,42093590382,-3,1252,2059,20
42094528855,42094528849,-6,917,3075,20
42095209454,42095209454,0,1742,1869,20
42095379051,42095379046,-5,930,3016,20
42097629387,42097629385,-2,1087,2411,20
42097952609,42097952606,-3,1378,1982,20
42100355338,42100355334,-4,1328,2119,20
42109915323,42109915321,-2,655,1660,20
42115979123,42115979119,-4,1227,2692,20
42117435974,42117435973,-1,1013,2408,20
42120948987,42120948983,-4,988,3306,20
42120990243,42120990257,14,13067,50881,20
42121065688,42121065683,-5,1347,2259,20
42123667929,42123667934,5,2425,1228,20
42126007497,42126007495,-2,911,1872,20
42127502292,42127502296,4,1801,1374,20
42134768269,42134768266,-3,1095,2392,20
42138533990,42138533986,-4,1337,2756,20
42141535274,42141535269,-5,1492,2253,20
42152442558,42152442553,-5,1398,2515,20
42152548133,42152548153,20,655,1539,20
42157181387,42157181386,-1,1397,2139,20
42162873206,42162873205,-1,1354,2800,20
42164688013,42164688010,-3,1027,1638,20
42167614729,42167614725,-4,1512,3218,20
42168518686,42168518683,-3,849,2703,20
42181291752,42181291749,-3,1101,1894,20
42184207839,42184207834,-5,1196,1959,20
42189111644,42189111651,7,2795,1209,20
42189888254,42189888251,-3,838,2637,20
42191324777,42191324777,0,948,1852,20
42200814814,42200814818,4,2099,1840,20
42202349457,42202349454,-3,836,2813,20
42203118469,42203118467,-2,916,1679,20
42206691691,42206691690,-1,619,2652,20
42209762317,42209762317,0,888,1825,20
42211714663,42211714663,0,1538,1754,20
42215253891,42215253885,-6,903,2433,20
42218125970,42218125968,-2,1325,3570,20
42218225142,42218225138,-4,902,2522,20
42219708818,42219708822,4,1292,1203,20
42221112452,42221112464,12,260,1759,20
42228741786,42228741783,-3,1409,2363,20
42230705098,42230705097,-1,1331,3157,20
42231615794,42231615791,-3,1006,1627,20
42232861138,42232861133,-5,1241,3792,20
42237635419,42237635419,0,1520,2101,20
42242310515,42242310509,-6,1010,2568,20
42245938179,42245938186,7,3134,1134,20
42249547746,42249547744,-2,841,1947,20
42256571011,42256571008,-3,792,1536,20
42259121670,42259121666,-4,1840,3697,20
42263080310,42263080305,-5,649,1806,20
42267428258,42267428259,1,1288,1857,20
42269003087,42269003084,-3,1739,2758,20
42274037489,42274037485,-4,1371,2671,20
42276756260,42276756255,-5,1296,2281,20
42284829066,42284829061,-5,1217,2675,20
42285908772,42285908774,2,1459,1709,20
42286588261,42286588258,-3,1005,1837,20
42290087822,42290087819,-3,933,2119,20
42293106742,42293106741,-1,1164,1964,20
42296431232,42296431229,-3,1300,2629,20
42296893022,42296893019,-3,1287,2321,20
42297173227,42297173226,-1,808,1336,20
42298919274,42298919274,0,1071,1157,20
42299702789,42299702787,-2,1169,2092,20
42299845133,42299845134,1,347,762,20
42301541082,42301541079,-3,1027,2636,20
42303057265,42303057262,-3,1138,2033,20
42306916753,42306916750,-3,1158,2641,20
42307322132,42307322122,-10,165,879,20
42316849078,42316849075,-3,930,2588,20
42317424296,42317424293,-3,1310,2910,20
42320397329,42320397326,-3,1546,3248,20
42321233726,42321233723,-3,1227,2567,20
42322207942,42322207940,-2,1322,2779,20
42324437019,42324437016,-3,1474,4390,20
42325298746,42325298744,-2,918,2428,20
42325931617,42325931614,-3,1634,2735,20
42332441731,42332441726,-5,816,4449,20
42333835266,42333835262,-4,963,2383,20
42336445771,42336445768,-3,1348,3118,20
42337508112,42337508110,-2,757,1752,20
42342615998,42342616004,6,3567,2175,20
42342647151,42342647149,-2,1695,2182,20
42345328662,42345328657,-5,1362,2241,20
42346790977,42346790975,-2,1032,2093,20
42348022436,42348022433,-3,1171,1989,20
42348505987,42348505984,-3,1528,2556,20
42352477516,42352477523,7,22287,16254,20
42356180439,42356180443,4,1394,943,20
42358529785,42358529782,-3,1305,2481,20
42358821678,42358821678,0,1238,1557,20
42361223333,42361223330,-3,928,1650,20
42369988176,42369988173,-3,1280,3927,20
42374250398,42374250394,-4,1118,2533,20
42376221457,42376221450,-7,29293,13736,20
42376664202,42376664198,-4,1015,1963,20
42376844029,42376844047,18,365,1135,20
42378652951,42378652950,-1,884,1181,20
42380333562,42380333558,-4,1451,2092,20
42381579930,42381579937,7,2390,1580,20
42385158170,42385158166,-4,1769,2352,20
42385407462,42385407461,-1,1123,2109,20
42385635631,42385635629,-2,444,1220,20
42391756375,42391756373,-2,1483,2797,20
42393037767,42393037762,-5,1110,1627,20
42393161456,42393161454,-2,1049,1535,20
42395965822,42395965817,-5,871,3778,20
42398230239,42398230237,-2,750,1935,20
42406553114,42406553113,-1,867,2862,20
42410738703,42410738698,-5,1021,2677,20
42413652652,42413652647,-5,25372,10313,20
42414362769,42414362754,-15,587,273,20
42415164294,42415164273,-21,224,1080,20
42418748958,42418748962,4,910,1437,20
42419852089,42419852085,-4,1054,1903,20
42420896160,42420896178,18,423,1478,20
42423224499,42423224488,-11,3614,1406,20
42423883105,42423883106,1,1803,1696,20
42429227195,42429227193,-2,917,2006,20
42430563270,42430563266,-4,1678,3595,20
42432916559,42432916559,0,1129,2034,20
42435023409,42435023411,2,18183,28615,20
42436503435,42436503433,-2,1227,2679,20
42437414210,42437414207,-3,1134,1798,20
42438244642,42438244638,-4,1064,1889,20
42441505853,42441505849,-4,1039,2330,20
42453444366,42453444362,-4,1124,2873,20
42454540942,42454540939,-3,1211,2484,20
42455994277,42455994274,-3,1476,2912,20
42456341105,42456341101,-4,740,1998,20
42456752748,42456752747,-1,49,372,20
42463115608,42463115606,-2,1328,2426,20
42467419939,42467419936,-3,1321,3603,20
42472909866,42472909864,-2,1574,2269,20
42477017797,42477017794,-3,1526,2525,20
42478690420,42478690414,-6,1563,4473,20
42481046795,42481046793,-2,1141,1990,20
42481272849,42481272840,-9,889,213,20
42482222166,42482222180,14,203,866,20
42484609422,42484609418,-4,793,1893,20
42484740587,42484740584,-3,1150,2273,20
42485593790,42485593793,3,3003,1539,20
42486514201,42486514198,-3,1017,1978,20
42487985429,42487985427,-2,1202,1523,20
42488888402,42488888398,-4,1432,2137,20
42490345178,42490345177,-1,930,1383,20
42491658053,42491658048,-5,1178,2730,20
42493569999,42493569997,-2,920,2018,20
42498295225,42498295221,-4,686,1809,20
42501351296,42501351297,1,1358,1173,20
42502188093,42502188092,-1,957,1837,20
42504232314,42504232311,-3,1268,3043,20
42508020002,42508019999,-3,1411,2580,20
42508777539,42508777534,-5,1145,2174,20
42509348383,42509348377,-6,1420,3971,20
42509617925,42509617913,-12,991,2560,20
42510267102,42510267085,-17,187,810,20
42510684375,42510684370,-5,750,1363,20
42511438617,42511438615,-2,27128,77565,20
42511675815,42511675813,-2,629,1874,20
42514200703,42514200706,3,1544,1445,20
42520568862,42520568859,-3,833,2196,20
42520628469,42520628468,-1,1269,1557,20
42525001329,42525001326,-3,1476,3802,20
42533266098,42533266098,0,787,1181,20
42538711595,42538711592,-3,1035,2391,20
42540103766,42540103773,7,3787,1583,20
42545130385,42545130385,0,1444,2090,20
42545479014,42545479008,-6,676,3413,20
42551683717,42551683717,0,1171,2996,20
42553832107,42553832089,-18,831,1693,20
42557790535,42557790532,-3,945,2272,20
42559601337,42559601336,-1,1583,2536,20
42560633221,42560633218,-3,1189,2576,20
42567533899,42567533897,-2,867,1443,20
42567681060,42567681057,-3,1806,2863,20
42571043402,42571043399,-3,1645,2452,20
42573879977,42573879979,2,1333,1528,20
42575517144,42575517141,-3,1297,3168,20
42577571215,42577571212,-3,1079,2658,20
42577691717,42577691705,-12,1059,2247,20
42583005750,42583005747,-3,927,2776,20
42585237235,42585237233,-2,1440,3313,20
42587018101,42587018098,-3,815,1434,20
42587540269,42587540265,-4,1176,2222,20
42589249852,42589249853,1,1466,1328,20
42592845211,42592845209,-2,965,3101,20
42594882548,42594882545,-3,1023,2493,20
42597535274,42597535271,-3,1066,1971,20
42599611177,42599611174,-3,1265,1971,20
42601010431,42601010430,-1,996,2508,20
42601851211,42601851209,-2,1407,2630,20
42602363090,42602363091,1,2684,3303,20
42603515873,42603515875,2,2437,2128,20
42603637000,42603636997,-3,1341,2783,20
42615908247,42615908245,-2,1083,1599,20
42626213466,42626213463,-3,1080,3661,20
42628054956,42628054974,18,1008,1967,20
42630098930,42630098926,-4,1332,4254,20
42631486839,42631486839,0,786,1651,20
42631783147,42631783146,-1,1071,2101,20
42634730519,42634730515,-4,700,1525,20
42639195936,42639195933,-3,974,1587,20
42641658441,42641658438,-3,1157,2484,20
42663302745,42663302759,14,444,995,20
42663826720,42663826718,-2,780,1815,20
42664703056,42664703054,-2,949,1774,20
42671697331,42671697331,0,1097,2070,20
42673667738,42673667738,0,781,1783,20
42673958400,42673958397,-3,903,2407,20
42676937387,42676937384,-3,1146,1804,20
42678212258,42678212255,-3,1202,1492,20
42681028506,42681028509,3,1602,1473,20
42681941410,42681941409,-1,1369,2530,20
42681980986,42681980986,0,1127,2758,20
42682702589,42682702576,-13,1175,1994,20
42685742898,42685742894,-4,996,1996,20
42692228359,42692228354,-5,1315,2025,20
42693617170,42693617166,-4,945,2090,20
42693827673,42693827670,-3,1109,1905,20
42694645183,42694645183,0,22,466,20
42700966511,42700966510,-1,1070,2095,20
42701666673,42701666667,-6,1164,2262,20
42703396708,42703396705,-3,1028,1998,20
42707990558,42707990563,5,1685,1267,20
42709240481,42709240478,-3,2681,4249,20
42710746934,42710746929,-5,981,3747,20
42711103887,42711103874,-13,1322,3090,20
42712101810,42712101806,-4,1398,3271,20
42714145283,42714145280,-3,740,1897,20
42717322026,42717322024,-2,1323,3289,20
42718376618,42718376615,-3,1313,2239,20
42722569854,42722569853,-1,757,1869,20
42725771687,42725771684,-3,1077,2477,20
42726773643,42726773637,-6,1524,2489,20
42727740564,42727740560,-4,1575,2729,20
42734849025,42734849021,-4,1380,2313,20
42735517939,42735517936,-3,1349,2572,20
42735605656,42735605673,17,710,1333,20
42736069046,42736069041,-5,1016,1904,20
42741670531,42741670527,-4,690,1464,20
42741741789,42741741786,-3,1232,2762,20
42746775447,42746775444,-3,1215,3035,20
42748420533,42748420536,3,7809,19310,20
42752413654,42752413652,-2,1235,2154,20
42755872712,42755872709,-3,1712,2641,20
42756482085,42756482082,-3,27544,70986,20
42759741792,42759741789,-3,1135,2693,20
42759913941,42759913934,-7,735,1964,20
42764417271,42764417267,-4,1501,1990,20
42767626473,42767626469,-4,1500,2669,20
42769798653,42769798650,-3,1097,2269,20
42772487125,42772487121,-4,1132,2584,20
42774180922,42774180918,-4,1298,2619,20
42776977511,42776977507,-4,949,2889,20
42777368873,42777368870,-3,1429,2397,20
42780199713,42780199710,-3,418,717,20
42784104327,42784104325,-2,634,1340,20
42785679184,42785679181,-3,866,2306,20
42785789511,42785789490,-21,1559,2675,20
42786545455,42786545453,-2,1273,2169,20
42790715686,42790715682,-4,761,2360,20
42793168789,42793168781,-8,701,1513,20
42801801828,42801801825,-3,1241,1538,20
42802107462,42802107458,-4,1284,2903,20
42806434646,42806434631,-15,1279,479,20
42807949339,42807949336,-3,1018,1672,20
42815844123,42815844122,-1,1044,1819,20
42817573810,42817573807,-3,1125,2224,20
42820058591,42820058589,-2,1370,2047,20
42825212995,42825212993,-2,1368,1612,20
42830833510,42830833509,-1,1040,1879,20
42834356491,42834356487,-4,739,1700,20
42834804109,42834804097,-12,1135,3862,20
42835521001,42835521002,1,1310,1285,20
42838554445,42838554441,-4,1438,3455,20
42839735174,42839735162,-12,310,1425,20
42840142058,42840142057,-1,13691,18025,20
42840688568,42840688571,3,2711,2187,20
42843308991,42843308986,-5,884,1635,20
42843873557,42843873573,16,11582,50485,20
42844046790,42844046787,-3,1606,2920,20
42853192229,42853192227,-2,1364,1860,20
42856118679,42856118674,-5,1095,2615,20
42860821001,42860821000,-1,718,1889,20
42861629790,42861629793,3,2658,1966,20
42862595495,42862595493,-2,1110,2653,20
42868295099,42868295098,-1,975,2323,20
42868487401,42868487399,-2,1040,2133,20
42868927247,42868927237,-10,246,855,20
42870748107,42870748104,-3,645,866,20
42872439607,42872439602,-5,1178,5194,20
42873194140,42873194139,-1,1330,1762,20
42873949257,42873949253,-4,1352,2365,20
42874685932,42874685927,-5,1122,3164,20
42876352151,42876352146,-5,1267,2764,20
42882927324,42882927320,-4,1218,2138,20
42884633983,42884633976,-7,1269,4692,20
42887584934,42887584930,-4,1051,1777,20
42891433961,42891433957,-4,1368,2731,20
42892308398,42892308395,-3,1225,2723,20
42894915894,42894915902,8,4852,1904,20
42897365126,42897365125,-1,1629,2722,20
42899536314,42899536311,-3,1212,2454,20
42905554372,42905554375,3,1208,1140,20
42912371735,42912371730,-5,1036,2520,20
42915048213,42915048210,-3,821,2418,20
42918517693,42918517692,-1,890,2556,20
42919070738,42919070734,-4,913,1640,20
42923596507,42923596501,-6,1572,4011,20
42926693582,42926693560,-22,300,1403,20
42927382022,42927382020,-2,1412,2067,20
42928853702,42928853699,-3,1411,2641,20
42936253150,42936253146,-4,794,2306,20
42937030487,42937030499,12,141,713,20
42944446205,42944446201,-4,1129,2515,20
42946577863,42946577861,-2,1122,3339,20
42949940674,42949940674,0,1213,2033,20
42955864079,42955864075,-4,1066,2506,20
42959307039,42959307036,-3,1136,3411,20
42962341894,42962341881,-13,1105,3631,20
42964371974,42964371967,-7,23781,10567,20
42965273361,42965273358,-3,922,2267,20
42966084727,42966084746,19,232,966,20
42969852113,42969852110,-3,890,2206,20
42970739714,42970739713,-1,1584,2953,20
42972093406,42972093404,-2,1073,1757,20
42973130885,42973130882,-3,1125,2482,20
42974622914,42974622911,-3,1214,2332,20
42975136464,42975136462,-2,1847,3553,20
42975350506,42975350504,-2,993,2648,20
42980718910,42980718906,-4,1468,3282,20
42982625097,42982625093,-4,892,1652,20
42983196013,42983196015,2,3341,3545,20
42984800060,42984800056,-4,1118,2407,20
42987650643,42987650641,-2,1352,2859,20
42988568114,42988568109,-5,1462,2858,20
42988713202,42988713199,-3,778,1623,20
42991368399,42991368394,-5,894,2846,20
42993251526,42993251522,-4,1269,2275,20
42993510366,42993510362,-4,219,1306,20
42995113516,42995113513,-3,1258,2253,20
43002709680,43002709662,-18,2839,1330,20
43003082431,43003082426,-5,1299,3300,20
43003527333,43003527330,-3,1241,2350,20
43004470862,43004470855,-7,889,1952,20
43005707998,43005707993,-5,1108,1867,20
43006996120,43006996116,-4,997,2287,20
43010814467,43010814463,-4,1094,2685,20
43013914091,43013914089,-2,924,1865,20
43014990043,43014990040,-3,1041,2633,20
43016807489,43016807486,-3,1086,2358,20
43017070925,43017070945,20,305,1276,20
43017832646,43017832644,-2,1196,2289,20
43021581410,43021581407,-3,821,2220,20
43022001528,43022001519,-9,33,754,20
43029241189,43029241187,-2,3293,5487,20
43031277992,43031277998,6,10053,5587,20
43032302537,43032302531,-6,1083,2802,20
43045710482,43045710481,-1,1352,1845,20
43047161970,43047161967,-3,178,1626,20
43049731638,43049731637,-1,1311,1854,20
43050387178,43050387181,3,2439,1755,20
43053108938,43053108934,-4,948,2052,20
43061697434,43061697431,-3,1709,2236,20
43061969778,43061969777,-1,985,3160,20
43066016511,43066016503,-8,1669,35313,20
43068899765,43068899764,-1,895,1583,20
43074200937,43074200935,-2,1504,2006,20
43079454378,43079454374,-4,2169,4542,20
43085439250,43085439248,-2,932,1696,20
43086811443,43086811441,-2,1004,1637,20
43087751828,43087751825,-3,1058,3121,20
43088469358,43088469364,6,529,5730,20
43089624318,43089624313,-5,1460,1544,20
43091603365,43091603362,-3,1229,2969,20
43093305501,43093305506,5,2055,1388,20
43093706972,43093706967,-5,1201,1892,20
43097839481,43097839477,-4,975,2396,20
43098236704,43098236698,-6,2134,8240,20
43099961949,43099961946,-3,1267,2293,20
43104288930,43104288926,-4,1242,2118,20
43105540090,43105540089,-1,872,2535,20
43107709647,43107709645,-2,1307,2441,20
43109225054,43109225051,-3,900,2091,20
43111586170,43111586168,-2,1273,1276,20
43116649153,43116649149,-4,735,1791,20
43121716799,43121716798,-1,1366,2179,20
43124788086,43124788082,-4,949,2291,20
43129549651,43129549647,-4,837,3078,20
43129700451,43129700448,-3,1144,1972,20
43130144442,43130144438,-4,1585,2850,20
43135824525,43135824522,-3,777,1554,20
43139402475,43139402470,-5,1169,2585,20
43139749227,43139749225,-2,661,1711,20
43150372966,43150372963,-3,1232,2624,20
43150459426,43150459421,-5,711,2096,20
43154865033,43154865038,5,3008,1092,20
43167903318,43167903314,-4,1573,2522,20
43172058406,43172058402,-4,1013,3741,20
43174576487,43174576483,-4,1202,1846,20
43175618591,43175618591,0,331,764,20
43176169346,43176169342,-4,782,2640,20
43177033529,43177033526,-3,1049,2662,20
43185742895,43185742893,-2,897,1816,20
43195295867,43195295862,-5,748,2297,20
43196660824,43196660831,7,3342,1473,20
43198555356,43198555370,14,15416,7051,20
43198944887,43198944882,-5,918,1538,20
43201928193,43201928190,-3,1125,1839,20
43206460741,43206460741,0,856,1598,20
43207627362,43207627360,-2,1177,2184,20
43214141845,43214141843,-2,1166,1733,20
43215778709,43215778712,3,20028,32934,20
43216150722,43216150719,-3,1727,2808,20
43221945414,43221945413,-1,1080,1907,20
43226557530,43226557526,-4,1596,3750,20
43226773789,43226773803,14,572,1544,20
43226965234,43226965230,-4,1054,2290,20
43229787854,43229787850,-4,722,1752,20
43229915863,43229915858,-5,1326,2476,20
43231968438,43231968442,4,4138,2572,20
43242157692,43242157688,-4,1024,2790,20
43243749378,43243749370,-8,1389,4169,20
43245336274,43245336271,-3,1024,3137,20
43251745966,43251745963,-3,808,2188,20
43252885455,43252885452,-3,1068,2062,20
43253893536,43253893532,-4,1142,1823,20
43258103976,43258103972,-4,1040,2671,20
43258690326,43258690323,-3,1149,1729,20
43259203038,43259203022,-16,946,2748,20
43264894648,43264894647,-1,1271,2503,20
43267555593,43267555589,-4,1079,1920,20
43270606936,43270606933,-3,1262,2934,20
43272178929,43272178926,-3,723,2604,20
43272743672,43272743688,16,295,1402,20
43273598501,43273598508,7,3857,1407,20
43279063147,43279063143,-4,1867,2962,20
43282131247,43282131245,-2,958,1705,20
43283404749,43283404745,-4,2017,4532,20
43289355347,43289355345,-2,1174,2699,20
43293052714,43293052713,-1,1289,2425,20
43297866589,43297866590,1,1095,1807,20
43306726369,43306726366,-3,1166,2551,20
43307595044,43307595066,22,855,1490,20
43309480110,43309480111,1,1445,1981,20
43312272481,43312272487,6,4061,2051,20
43313555151,43313555148,-3,992,2082,20
43318834028,43318834031,3,1371,1065,20
43320676638,43320676638,0,908,2524,20
43329041738,43329041743,5,2185,929,20
43334457873,43334457870,-3,1151,1952,20
43334907815,43334907811,-4,903,1715,20
43338105675,43338105672,-3,952,2235,20
43338371229,43338371208,-21,797,1888,20
43342157064,43342157061,-3,1147,2229,20
43343589935,43343589933,-2,1535,2634,20
43344574334,43344574330,-4,1394,2599,20
43348495803,43348495806,3,2283,1808,20
43352813378,43352813378,0,1074,1987,20
43353960311,43353960310,-1,641,2221,20
43356089749,43356089746,-3,19700,15184,20
43369406942,43369406941,-1,1496,2456,20
43369796581,43369796579,-2,1058,2131,20
43372910973,43372910974,1,2371,3348,20
43373254669,43373254674,5,2865,1425,20
43377341611,43377341606,-5,870,1459,20
43381507089,43381507085,-4,741,2101,20
43385672031,43385672026,-5,1216,3802,20
43390980458,43390980456,-2,1013,2546,20
43397387382,43397387381,-1,1289,2424,20
43401570074,43401570071,-3,1380,3591,20
43402112881,43402112877,-4,966,2877,20
43409067314,43409067310,-4,1052,1725,20
43409223236,43409223234,-2,1019,1648,20
43409423423,43409423412,-11,796,3063,20
43411885116,43411885114,-2,1065,2536,20
43414799999,43414799997,-2,874,2291,20
43415568933,43415568918,-15,1299,3153,20
43422043015,43422043009,-6,925,3740,20
43423859234,43423859230,-4,975,1814,20
43427693114,43427693110,-4,988,2074,20
43427776904,43427776900,-4,1555,2241,20
43428093004,43428092997,-7,1078,2168,20
43428188807,43428188803,-4,876,2299,20
43430051334,43430051332,-2,664,1745,20
43436246358,43436246358,0,883,1664,20
43436459790,43436459784,-6,1085,2195,20
43439970443,43439970439,-4,1053,2392,20
43440907122,43440907122,0,1197,1722,20
43446043582,43446043578,-4,1223,3274,20
43448697914,43448697912,-2,1189,3146,20
43451139009,43451139006,-3,1134,1753,20
43451858346,43451858342,-4,1079,2900,20
43451893874,43451893871,-3,909,2158,20
43452148773,43452148770,-3,1206,2104,20
43453022321,43453022318,-3,1446,3507,20
43453383034,43453383034,0,1089,1975,20
43456059473,43456059486,13,169,7305,20
43456259189,43456259208,19,1193,2155,20
43458006420,43458006417,-3,1168,2968,20
43460993278,43460993271,-7,752,2635,20
43461105011,43461104988,-23,534,1137,20
43464792414,43464792411,-3,1383,2562,20
43466344809,43466344812,3,1120,1789,20
43468882082,43468882093,11,265,910,20
43471996012,43471996010,-2,1010,2095,20
43474252166,43474252166,0,1309,1996,20
43480249510,43480249507,-3,1436,1904,20
43493772717,43493772715,-2,787,2204,20
43493840085,43493840069,-16,1210,2589,20
43495638202,43495638199,-3,1047,2246,20
43496244801,43496244798,-3,927,2164,20
43496285143,43496285130,-13,1061,1582,20
43497727707,43497727705,-2,1706,2509,20
43498238174,43498238172,-2,1186,1850,20
43498547162,43498547160,-2,601,1316,20
43502332483,43502332480,-3,684,1826,20
43507481171,43507481168,-3,834,2306,20
43510963667,43510963668,1,1148,1733,20
43516289966,43516289966,0,32597,39540,20
43530748335,43530748333,-2,894,1375,20
43533929827,43533929824,-3,1021,2708,20
43535420778,43535420774,-4,1175,2556,20
43535698574,43535698573,-1,1123,2307,20
43542524411,43542524411,0,1829,2760,20
43545085486,43545085479,-7,1509,6808,20
43545588491,43545588486,-5,2722,5960,20
43553360329,43553360327,-2,1110,2754,20
43553681248,43553681244,-4,1106,2342,20
43556525041,43556525039,-2,1423,2988,20
43559331040,43559331042,2,2343,1996,20
43559619515,43559619510,-5,1227,2697,20
43565348954,43565348953,-1,948,1444,20
43568722298,43568722294,-4,1163,3013,20
43572214170,43572214166,-4,1198,2397,20
43575842141,43575842137,-4,1139,2069,20
43578144880,43578144878,-2,1172,2074,20
43586091183,43586091179,-4,1158,2532,20
43588482322,43588482321,-1,1338,2885,20
43594292111,43594292107,-4,1378,2734,20
43597328915,43597328913,-2,784,1088,20
43599824251,43599824248,-3,1371,1859,20
43600518206,43600518202,-4,1758,2829,20
43601592962,43601592960,-2,1282,3188,20
43603506883,43603506878,-5,1489,3352,20
43611920496,43611920494,-2,1400,2615,20
43619553282,43619553288,6,4478,2443,20
43623676884,43623676898,14,328,855,20
43623938277,43623938287,10,479,2662,20
43626946097,43626946097,0,1236,1449,20
43628518316,43628518311,-5,1401,2286,20
43630214380,43630214385,5,2309,1333,20
43630810925,43630810924,-1,1462,2875,20
43638254458,43638254454,-4,859,1503,20
43638456818,43638456813,-5,1405,2692,20
43639236177,43639236177,0,1203,1849,20
43642059610,43642059607,-3,1244,2399,20
43642355214,43642355193,-21,1238,3333,20
43642772357,43642772350,-7,9,1069,20
43647733773,43647733769,-4,1189,3002,20
43649978417,43649978413,-4,1239,2743,20
43652839324,43652839319,-5,1619,2572,20
43661168625,43661168623,-2,1115,1820,20
43661904723,43661904719,-4,1303,3434,20
43666928838,43666928835,-3,1427,2797,20
43674529163,43674529161,-2,1061,1587,20
43677808955,43677808951,-4,837,2556,20
43685819771,43685819769,-2,1258,1817,20
43686440876,43686440873,-3,1776,2359,20
43687866015,43687866013,-2,1187,2341,20
43691223130,43691223127,-3,1408,3129,20
43691684974,43691684970,-4,715,1404,20
43691956126,43691956126,0,1270,2749,20
43693287175,43693287173,-2,1841,2385,20
43694140273,43694140270,-3,801,1571,20
43694190884,43694190881,-3,196,683,20
43698490139,43698490143,4,1917,1480,20
43699368188,43699368186,-2,925,2102,20
43703389525,43703389523,-2,968,1699,20
43705565771,43705565771,0,1405,2851,20
43710152667,43710152663,-4,1551,2702,20
43710676166,43710676165,-1,1526,1607,20
43714772955,43714772949,-6,1130,3651,20
43715235133,43715235137,4,5436,3137,20
43715682199,43715682194,-5,1082,2314,20
43722251173,43722251171,-2,1166,2505,20
43722889508,43722889502,-6,1190,1864,20
43723929869,43723929868,-1,819,2368,20
43724894571,43724894569,-2,1340,3003,20
43730450514,43730450514,0,1035,2140,20
43731898051,43731898050,-1,1264,3054,20
43734359854,43734359851,-3,1237,2357,20
43737966379,43737966374,-5,1142,2436,20
43741610799,43741610802,3,2476,1689,20
43741958290,43741958289,-1,1344,1853,20
43742527658,43742527658,0,1560,2136,20
43743150542,43743150542,0,1146,1926,20
43746987817,43746987814,-3,1166,2400,20
43749568259,43749568262,3,1657,1266,20
43749695269,43749695265,-4,1103,2717,20
43751528154,43751528150,-4,978,1940,20
43755293639,43755293634,-5,850,1780,20
43760324546,43760324541,-5,965,1641,20
43761206831,43761206830,-1,940,1903,20
43762030695,43762030692,-3,975,2710,20
43764422371,43764422387,16,899,1020,20
43764655854,43764655850,-4,1130,2711,20
43767344692,43767344689,-3,1409,2793,20
43773422992,43773422989,-3,1289,1763,20
43773510378,43773510376,-2,1570,2374,20
43774685915,43774685911,-4,1019,2637,20
43775613971,43775613967,-4,1361,2960,20
43779547297,43779547295,-2,594,1518,20
43787093827,43787093821,-6,1447,3275,20
43790421773,43790421769,-4,1094,1804,20
43790566515,43790566512,-3,1140,2237,20
43792474161,43792474158,-3,839,1854,20
43797363368,43797363365,-3,1743,6158,20
43803796170,43803796170,0,770,2453,20
43805314731,43805314726,-5,1214,3098,20
43806133961,43806133958,-3,1290,3107,20
43812688799,43812688796,-3,1272,1979,20
43818871421,43818871416,-5,1028,2385,20
43819674767,43819674766,-1,320,1249,20
43822989461,43822989458,-3,725,1950,20
43825316560,43825316557,-3,1388,2692,20
43825576647,43825576631,-16,1158,2694,20
43826163166,43826163171,5,2860,1884,20
43828877066,43828877068,2,1562,1823,20
43829310020,43829310014,-6,1898,3537,20
43832043377,43832043375,-2,1006,2704,20
43833485106,43833485102,-4,1251,1952,20
43836512335,43836512331,-4,1087,1243,20
43838397789,43838397785,-4,758,2113,20
43841123559,43841123557,-2,1411,2308,20
43842036314,43842036312,-2,992,2455,20
43843654842,43843654837,-5,1018,2882,20
43843792066,43843792065,-1,738,1383,20
43849806689,43849806687,-2,1343,3093,20
43851142822,43851142818,-4,1872,2469,20
43853395046,43853395045,-1,1194,2321,20
43855382085,43855382082,-3,994,2235,20
43855655335,43855655333,-2,1315,2911,20
43857015106,43857015102,-4,1493,2822,20
43858928462,43858928461,-1,1175,2682,20
43860583726,43860583722,-4,1107,1442,20
43861000726,43861000713,-13,1306,2451,20
43869407434,43869407431,-3,1178,2474,20
43875054625,43875054623,-2,948,2259,20
43877486647,43877486642,-5,1009,1706,20
43878599129,43878599126,-3,1183,2193,20
43878671678,43878671697,19,939,2130,20
43881729833,43881729829,-4,758,1974,20
43883125173,43883125169,-4,1384,2042,20
43883945498,43883945494,-4,1204,2290,20
43889839814,43889839813,-1,706,1714,20
43893450315,43893450313,-2,1298,2676,20
43894691230,43894691227,-3,1231,2836,20
43895392006,43895392005,-1,2450,4640,20
43896424637,43896424634,-3,1006,2222,20
43897120566,43897120550,-16,862,2246,20
43897801088,43897801106,18,362,975,20
43898881253,43898881253,0,1320,1904,20
43905636018,43905636014,-4,1139,2045,20
43906919850,43906919846,-4,975,2940,20
43912802931,43912802928,-3,1087,2469,20
43913652595,43913652592,-3,911,2171,20
43915928734,43915928730,-4,1433,2329,20
43917242242,43917242238,-4,1438,3113,20
43918327891,43918327890,-1,1491,2172,20
43919721002,43919721007,5,3536,2345,20
43922476881,43922476872,-9,1170,2216,20
43929106702,43929106700,-2,938,1655,20
43930784854,43930784871,17,1251,2585,20
43935968435,43935968430,-5,687,2863,20
43940912375,43940912375,0,1461,1647,20
43941298289,43941298286,-3,1022,2219,20
43942350438,43942350435,-3,1026,1951,20
43942740245,43942740239,-6,1081,3079,20
43943061004,43943061015,11,224,621,20
43944682645,43944682642,-3,1103,2055,20
43945881182,43945881181,-1,1044,1713,20
43951076127,43951076125,-2,1224,2280,20
43955484395,43955484397,2,1459,1399,20
43955697357,43955697354,-3,1566,3072,20
43958605534,43958605529,-5,1087,1788,20
43960444298,43960444297,-1,964,972,20
43962290418,43962290414,-4,951,1623,20
43963298967,43963298955,-12,648,1807,20
43963828737,43963828734,-3,1005,2622,20
43964480596,43964480615,19,263,684,20
43966377930,43966377926,-4,948,2117,20
43966449469,43966449486,17,1059,2374,20
43969030422,43969030421,-1,1280,2271,20
43970535738,43970535736,-2,942,1801,20
43970927820,43970927808,-12,918,1554,20
43973937525,43973937521,-4,1220,2050,20
43975412158,43975412179,21,414,1562,20
43986530050,43986530054,4,1792,1420,20
43987553150,43987553149,-1,1029,1819,20
43988219414,43988219410,-4,178,767,20
43989375099,43989375101,2,735,1668,20
43994345733,43994345729,-4,1153,2057,20
43995079406,43995079402,-4,1251,2626,20
44005979099,44005979097,-2,1453,2711,20
44007488191,44007488186,-5,1162,2059,20
44007605319,44007605319,0,1290,3191,20
44007645077,44007645075,-2,1129,3296,20
44009474790,44009474786,-4,1011,3609,20
44012068418,44012068414,-4,858,1860,20
44012489157,44012489175,18,456,722,20
44012707590,44012707597,7,830,948,20
44016006267,44016006263,-4,645,1498,20
44021051156,44021051153,-3,940,2413,20
44021774950,44021774949,-1,926,1655,20
44022476914,44022476912,-2,1374,1749,20
44027884782,44027884781,-1,1744,2660,20
44030410183,44030410181,-2,1305,2135,20
44035755751,44035755749,-2,1049,2132,20
44039068219,44039068214,-5,1290,3259,20
44042082146,44042082141,-5,691,1851,20
44045436379,44045436392,13,827,1544,20
44045772625,44045772622,-3,981,2282,20
44046142772,44046142766,-6,1531,3142,20
44055422058,44055422064,6,12130,26450,20
44058993893,44058993889,-4,1321,3503,20
44061413985,44061413981,-4,1041,2678,20
44065033744,44065033741,-3,1204,3283,20
44066286820,44066286816,-4,1156,2358,20
44070777191,44070777194,3,1030,1039,20
44075218061,44075218057,-4,1054,3132,20
44077709107,44077709105,-2,999,1993,20
44077975671,44077975691,20,45,696,20
44084206293,44084206290,-3,917,2647,20
44093174741,44093174738,-3,875,2490,20
44097732837,44097732830,-7,1289,2653,20
44101162914,44101162931,17,409,569,20
44101475139,44101475136,-3,910,2048,20
44106357590,44106357585,-5,1699,3252,20
44107010309,44107010305,-4,1164,2439,20
44115798839,44115798838,-1,940,1961,20
44116878563,44116878560,-3,1182,2587,20
44117047246,44117047248,2,1357,1547,20
44120101549,44120101545,-4,1414,2804,20
44121434002,44121434001,-1,965,2040,20
44123344374,44123344391,17,1158,2122,20
44123508645,44123508642,-3,1797,2682,20
44124263726,44124263721,-5,956,1957,20
44131193155,44131193153,-2,1106,3211,20
44131941086,44131941106,20,805,1308,20
44133443633,44133443633,0,1250,2085,20
44142048487,44142048483,-4,609,1053,20
44143656138,44143656137,-1,1077,2203,20
44146046607,44146046606,-1,944,2550,20
44146582270,44146582265,-5,1388,2336,20
44164762114,44164762113,-1,1372,1672,20
44169814105,44169814102,-3,1398,2222,20
44173504194,44173504193,-1,1366,2330,20
44180548054,44180548066,12,304,676,20
44181885439,44181885437,-2,1080,2004,20
44182172761,44182172757,-4,1184,2300,20
44184192376,44184192373,-3,967,2329,20
44187118631,44187118627,-4,1222,3015,20
44192594443,44192594441,-2,1113,2537,20
44192663096,44192663092,-4,891,2377,20
44194714950,44194714945,-5,1316,2441,20
44200288185,44200288182,-3,791,2985,20
44204538723,44204538720,-3,852,1805,20
44206352538,44206352538,0,1482,3429,20
44206486228,44206486230,2,1475,1070,20
44207112625,44207112622,-3,694,1549,20
44207572867,44207572866,-1,874,1711,20
44209702454,44209702450,-4,1513,2785,20
44209876726,44209876722,-4,1260,2890,20
44213820738,44213820734,-4,1242,2465,20
44214196840,44214196855,15,187,749,20
44215733223,44215733221,-2,669,1653,20
44220933363,44220933359,-4,1094,1792,20
44221034437,44221034432,-5,955,2607,20
44224147446,44224147440,-6,2345,7926,20
44225150162,44225150160,-2,1501,1683,20
44228907462,44228907458,-4,855,1727,20
44230500235,44230500232,-3,1379,1992,20
44231211540,44231211538,-2,1494,2880,20
44243297321,44243297317,-4,1432,3208,20
44244324073,44244324070,-3,816,2480,20
44246049398,44246049397,-1,1374,2610,20
44246136014,44246136004,-10,1126,2265,20
44249003098,44249003099,1,1166,1869,20
44250844839,44250844835,-4,711,2025,20
44253051052,44253051048,-4,1262,2407,20
44254882826,44254882824,-2,1557,2854,20
44255627275,44255627272,-3,1107,1862,20
44256036799,44256036797,-2,1464,2532,20
44257333974,44257333963,-11,380,786,20
44262966994,44262966989,-5,970,2785,20
44265767088,44265767082,-6,1334,4635,20
44270636893,44270636888,-5,1074,2362,20
44273044432,44273044433,1,1579,1680,20
44274138286,44274138283,-3,1450,3060,20
44278192142,44278192138,-4,1440,2850,20
44279368630,44279368628,-2,1016,1533,20
44282755031,44282755027,-4,907,2719,20
44282987254,44282987251,-3,1095,2686,20
44286147510,44286147508,-2,1192,1946,20
44286841698,44286841695,-3,1516,2404,20
44288407631,44288407630,-1,839,1796,20
44291457911,44291457908,-3,789,1873,20
44292741959,44292741958,-1,1074,2118,20
44293845333,44293845329,-4,1096,3329,20
44297903662,44297903658,-4,1016,1999,20
44299589126,44299589124,-2,943,2235,20
44307920730,44307920734,4,2113,1592,20
44309329210,44309329212,2,1747,2268,20
44309896241,44309896236,-5,1326,2088,20
44313800343,44313800339,-4,892,2207,20
44314724618,44314724617,-1,1446,1967,20
44318655858,44318655856,-2,444,1635,20
44319592995,44319592997,2,2349,1992,20
44321463573,44321463567,-6,1167,3717,20
44323719979,44323719977,-2,1081,2075,20
44323870190,44323870191,1,148,711,20
44325137118,44325137116,-2,1332,2156,20
44326725831,44326725835,4,2477,2319,20
44327862129,44327862125,-4,702,1384,20
44329576470,44329576467,-3,1094,2480,20
44338980832,44338980829,-3,839,2275,20
44339618018,44339618016,-2,945,1730,20
44346287942,44346287938,-4,1063,1880,20
44348488983,44348488980,-3,1511,2720,20
44354948281,44354948278,-3,1080,2421,20
44354992764,44354992770,6,2376,1127,20
44355229486,44355229483,-3,908,2175,20
44355964534,44355964554,20,160,930,20
44357374797,44357374794,-3,1299,2242,20
44360599561,44360599559,-2,869,1357,20
44362145580,44362145575,-5,1042,2346,20
44363744343,44363744328,-15,1073,3265,20
44363949372,44363949356,-16,1006,2748,20
44369206011,44369206009,-2,698,1633,20
44369267374,44369267371,-3,905,1386,20
44369640687,44369640683,-4,1118,2056,20
44372693926,44372693924,-2,1160,1906,20
44377015149,44377015146,-3,1164,2589,20
44377682306,44377682301,-5,1037,3731,20
44382397045,44382397046,1,1516,1645,20
44382758430,44382758427,-3,1334,2242,20
44382963125,44382963109,-16,868,4511,20
44384796369,44384796356,-13,2945,693,20
44401143248,44401143243,-5,1252,2340,20
44401370283,44401370278,-5,1053,2800,20
44401646711,44401646708,-3,770,1772,20
44402995752,44402995753,1,1938,2208,20
44404725541,44404725538,-3,1016,2496,20
44408129146,44408129151,5,2736,1507,20
44409528210,44409528206,-4,1253,3120,20
44409647703,44409647705,2,1324,1933,20
44409981097,44409981094,-3,954,2027,20
44414468877,44414468873,-4,977,1492,20
44415272619,44415272618,-1,1172,2063,20
44415560319,44415560317,-2,942,2608,20
44416576478,44416576474,-4,1094,2470,20
44420408039,44420408035,-4,1568,2552,20
44422377463,44422377459,-4,1426,2738,20
44426936661,44426936662,1,924,1706,20
44436987622,44436987618,-4,1324,1798,20
44449281528,44449281526,-2,1236,2293,20
44450260487,44450260485,-2,733,2059,20
44451815064,44451815059,-5,1027,1729,20
44452988610,44452988609,-1,1490,2313,20
44455258269,44455258275,6,5039,1576,20
44460575815,44460575811,-4,1266,1937,20
44469092402,44469092400,-2,990,1153,20
44474385971,44474385967,-4,1213,2384,20
44476257669,44476257666,-3,803,2497,20
44477719423,44477719423,0,1516,1221,20
44479279337,44479279334,-3,1149,2323,20
44485261767,44485261761,-6,1680,6340,20
44492065765,44492065763,-2,1120,2100,20
44492156386,44492156382,-4,1175,2809,20
44496364369,44496364368,-1,1018,1887,20
44499451857,44499451858,1,1055,2395,20
44499608422,44499608418,-4,1302,2957,20
44506826050,44506826030,-20,4663,444,20
44509203780,44509203778,-2,1225,2087,20
44514058911,44514058906,-5,1223,3294,20
44515599855,44515599853,-2,1357,2050,20
44524158315,44524158311,-4,1734,2639,20
44526293187,44526293185,-2,852,2102,20
44526534116,44526534097,-19,864,2848,20
44528768161,44528768159,-2,1499,2200,20
44529086425,44529086423,-2,1216,2629,20
44535426044,44535426042,-2,1132,2394,20
44535979339,44535979337,-2,933,2153,20
44541032643,44541032641,-2,906,2088,20
44542655894,44542655890,-4,1440,2360,20
44545354155,44545354152,-3,794,2195,20
44549644110,44549644118,8,5976,2628,20
44551011767,44551011764,-3,1212,2305,20
44551735058,44551735058,0,1438,2240,20
44554290635,44554290632,-3,1263,2775,20
44555436522,44555436521,-1,850,2180,20
44561445343,44561445339,-4,1385,2228,20
44562557189,44562557184,-5,849,2789,20
44563207134,44563207130,-4,860,2486,20
44564492966,44564492962,-4,1061,2268,20
44565361030,44565361028,-2,1376,2492,20
44565568342,44565568341,-1,1160,2425,20
44576941001,44576941003,2,1012,1444,20
44577340203,44577340195,-8,25315,13436,20
44580995582,44580995581,-1,1003,2522,20
44581245147,44581245142,-5,900,1391,20
44585247387,44585247384,-3,1286,2033,20
44586631406,44586631405,-1,1426,2603,20
44586918275,44586918275,0,1192,3018,20
44597393438,44597393438,0,1103,2035,20
44603910896,44603910892,-4,1187,2779,20
44608883010,44608883009,-1,1108,2514,20
44611580631,44611580629,-2,923,2097,20
44612345114,44612345108,-6,1564,4734,20
44615329295,44615329294,-1,1049,2024,20
44615872706,44615872712,6,2728,1389,20
44619138834,44619138832,-2,1161,2908,20
44619536775,44619536794,19,885,2091,20
44620529010,44620529007,-3,862,1694,20
44622693750,44622693747,-3,857,1733,20
44623314922,44623314921,-1,1469,2918,20
44626691368,44626691362,-6,809,2170,20
44626755038,44626755021,-17,624,2709,20
44634172239,44634172237,-2,1464,3248,20
44637902179,44637902175,-4,891,2733,20
44641681754,44641681758,4,1276,748,20
44642290011,44642290010,-1,895,1648,20
44642945951,44642945938,-13,157,449,20
44648204405,44648204399,-6,1222,2259,20
44651600582,44651600578,-4,1137,2984,20
44659461362,44659461361,-1,1128,2208,20
44660150518,44660150503,-15,1151,2213,20
44660922839,44660922836,-3,894,1926,20
44661926831,44661926829,-2,1366,2533,20
44670123336,44670123333,-3,1115,2312,20
44670489560,44670489559,-1,1103,2291,20
44674226938,44674226916,-22,3624,2835,20
44678830533,44678830530,-3,1093,2007,20
44681429057,44681429058,1,1443,2013,20
44684877703,44684877700,-3,1166,3028,20
44686441828,44686441825,-3,1209,1848,20
44687767006,44687767003,-3,1645,2942,20
44688307178,44688307175,-3,989,3033,20
44689970330,44689970325,-5,1371,2751,20
44692040771,44692040770,-1,697,2327,20
44692968308,44692968306,-2,1618,2860,20
44693033232,44693033248,16,241,874,20
44695409258,44695409256,-2,1522,2698,20
44696436496,44696436493,-3,1624,3115,20
44703080029,44703080026,-3,769,1897,20
44704037455,44704037454,-1,906,2007,20
44704892315,44704892313,-2,735,1891,20
44705924053,44705924050,-3,1097,1433,20
44706001229,44706001226,-3,1123,2452,20
44708196050,44708196054,4,1199,1532,20
44710716812,44710716809,-3,1171,2417,20
44715868060,44715868056,-4,962,2302,20
44719447689,44719447683,-6,1119,4223,20
44720157343,44720157342,-1,421,1139,20
44723532014,44723532012,-2,1221,2283,20
44723709157,44723709151,-6,1799,3602,20
44730932246,44730932242,-4,987,2005,20
44731516573,44731516595,22,800,1583,20
44735015086,44735015080,-6,897,2310,20
44735547397,44735547394,-3,1412,2764,20
44736744870,44736744869,-1,1097,1834,20
44746026012,44746026008,-4,1244,2340,20
44748999535,44748999535,0,854,1417,20
44750072621,44750072619,-2,1253,2473,20
44753158337,44753158333,-4,1536,2272,20
44753990130,44753990122,-8,1165,2916,20
44754029903,44754029901,-2,1097,3115,20
44754425111,44754425106,-5,1107,1878,20
44755301731,44755301731,0,1138,1664,20
44757383005,44757383002,-3,1149,1779,20
44763145334,44763145329,-5,991,4485,20
44763336206,44763336223,17,548,1382,20
44763657927,44763657923,-4,998,2522,20
44765225016,44765225023,7,6119,2080,20
44767193564,44767193559,-5,1137,1906,20
44767431767,44767431768,1,146,3684,20
44768017005,44768017000,-5,981,2305,20
44769161507,44769161503,-4,1216,3088,20
44770964803,44770964799,-4,785,2048,20
44775355776,44775355774,-2,914,2242,20
44783232530,44783232528,-2,728,1713,20
44785031255,44785031251,-4,1221,2884,20
44787026258,44787026255,-3,1290,2974,20
44788300138,44788300135,-3,915,2015,20
44794179062,44794179062,0,1187,1306,20
44795364282,44795364278,-4,1094,3324,20
44797470959,44797470962,3,4580,2616,20
44798196149,44798196145,-4,1183,2757,20
44798502035,44798502038,3,2866,1781,20
44799708840,44799708838,-2,931,1497,20
44799914350,44799914369,19,923,2530,20
44800743250,44800743245,-5,939,3112,20
44814545602,44814545601,-1,1087,2260,20
44815248579,44815248574,-5,1224,2033,20
44815425558,44815425555,-3,1332,2417,20
44816200446,44816200427,-19,294,669,20
44818106934,44818106929,-5,738,2179,20
44818236094,44818236090,-4,1213,4353,20
44819031007,44819031005,-2,1238,2717,20
44821767528,44821767525,-3,1182,3483,20
44824493592,44824493589,-3,1086,2112,20
44837041113,44837041110,-3,1179,2622,20
44837454476,44837454472,-4,898,1652,20
44838159216,44838159213,-3,1196,2205,20
44839245689,44839245693,4,1641,1098,20
44842396826,44842396822,-4,1163,2136,20
44850063949,44850063948,-1,1716,4415,20
44850299045,44850299042,-3,891,1870,20
44851760942,44851760941,-1,723,2266,20
44852357250,44852357246,-4,985,2547,20
44852463403,44852463402,-1,1096,2345,20
44857463405,44857463401,-4,1112,2145,20
44859607481,44859607478,-3,1113,2262,20
44863977346,44863977342,-4,1601,2862,20
44864112602,44864112597,-5,837,2882,20
44869667175,44869667171,-4,1147,3321,20
44871841848,44871841844,-4,1378,2946,20
44873321974,44873321970,-4,1504,3470,20
44874522591,44874522587,-4,1089,2142,20
44877207272,44877207269,-3,867,1780,20
44880375471,44880375470,-1,1475,2573,20
44882116926,44882116923,-3,1025,2056,20
44882824823,44882824820,-3,1450,3146,20
44883632286,44883632283,-3,1459,2785,20
44885147125,44885147121,-4,1411,3519,20
44887293415,44887293410,-5,1344,2352,20
44892492045,44892492044,-1,4915,19367,20
44893584301,44893584300,-1,1276,2194,20
44893811606,44893811604,-2,1198,1958,20
44896998137,44896998135,-2,1148,2436,20
44897507100,44897507092,-8,1077,2205,20
44914557049,44914557042,-7,2316,11023,20
44918923606,44918923605,-1,858,1536,20
44920481363,44920481361,-2,1265,2162,20
44928982181,44928982178,-3,2320,4181,20
44932463774,44932463773,-1,1632,2534,20
44933955694,44933955691,-3,1487,2421,20
44934687786,44934687785,-1,817,1840,20
44939094571,44939094570,-1,1679,2123,20
44940296193,44940296186,-7,1509,3383,20
44944051001,44944051022,21,854,2662,20
44944521071,44944521067,-4,1451,2443,20
44949636766,44949636769,3,1370,1790,20
44954369655,44954369653,-2,1103,1869,20
44955004358,44955004359,1,1330,2941,20
44955563207,44955563205,-2,1064,2292,20
44956013411,44956013407,-4,869,3402,20
44964795721,44964795718,-3,1059,2385,20
44971326571,44971326569,-2,1109,1572,20
44976105231,44976105229,-2,1093,2120,20
44976608967,44976608970,3,279,1171,20
44980393814,44980393810,-4,1203,3306,20
44987110102,44987110098,-4,831,1130,20
44992895820,44992895817,-3,1095,2761,20
44993588238,44993588235,-3,772,1779,20
44998308432,44998308430,-2,2645,4873,20
45004744907,45004744905,-2,1607,2759,20
45005692191,45005692191,0,1215,1713,20
45007092161,45007092158,-3,1037,2002,20
45009968831,45009968828,-3,1207,2478,20
45010989526,45010989524,-2,1193,1969,20
45011567232,45011567247,15,559,1611,20
45015058621,45015058618,-3,916,2519,20
45017791545,45017791550,5,2302,1937,20
45022244049,45022244046,-3,1511,2388,20
45029671967,45029671965,-2,1195,3203,20
45032825665,45032825665,0,33991,44663,20
45033842488,45033842494,6,2781,1719,20
45034102788,45034102784,-4,1344,2902,20
45034196372,45034196372,0,1212,2548,20
45034882750,45034882768,18,1184,2337,20
45037767521,45037767522,1,1110,1588,20
45038093702,45038093723,21,184,649,20
45042170434,45042170440,6,3859,1393,20
45045513365,45045513362,-3,832,2282,20
45045640450,45045640450,0,934,1926,20
45046599927,45046599925,-2,1301,2689,20
45059066856,45059066861,5,1899,1060,20
45063365586,45063365584,-2,1196,1977,20
45064725899,45064725896,-3,769,1665,20
45066376783,45066376781,-2,1248,2240,20
45069357458,45069357455,-3,1527,1820,20
45070756760,45070756757,-3,1163,1790,20
45076965656,45076965665,9,14724,23826,20
45081441527,45081441525,-2,981,1710,20
45081929633,45081929631,-2,1260,2301,20
45082411219,45082411218,-1,986,2024,20
45082463333,45082463328,-5,757,2240,20
45084483905,45084483902,-3,1520,3007,20
45086960117,45086960121,4,3324,3118,20
45090585178,45090585177,-1,1204,1734,20
45090794975,45090794975,0,1626,1417,20
45094175718,45094175713,-5,1071,1417,20
45095943181,45095943178,-3,1129,1563,20
45096552522,45096552522,0,1381,2176,20
45097178275,45097178274,-1,1915,1846,20
45098178322,45098178320,-2,1359,2815,20
45099036867,45099036863,-4,793,1302,20
45103768102,45103768102,0,1044,1525,20
45104016829,45104016825,-4,1274,3089,20
45104060968,45104060982,14,404,1716,20
45108305680,45108305677,-3,983,1868,20
45109348399,45109348396,-3,1404,2064,20
45111374833,45111374830,-3,1043,1511,20
45112422992,45112422988,-4,1293,2793,20
45112457257,45112457254,-3,1619,3351,20
45115653918,45115653917,-1,886,2636,20
45116646294,45116646313,19,64,1001,20
45117619678,45117619677,-1,1197,2546,20
45120079335,45120079333,-2,604,1721,20
45121321839,45121321823,-16,948,2382,20
45124043554,45124043550,-4,1367,2763,20
45126129410,45126129408,-2,984,1875,20
45127499902,45127499891,-11,1304,1876,20
45127789955,45127789954,-1,2093,1496,20
45130287638,45130287642,4,2241,1936,20
45131850382,45131850378,-4,1491,1836,20
45135756905,45135756910,5,2552,1966,20
45140796277,45140796275,-2,1354,2674,20
45151982694,45151982690,-4,1862,2911,20
45160041476,45160041470,-6,1111,2108,20
45163620685,45163620687,2,1152,863,20
45166479193,45166479196,3,1448,1948,20
45167638354,45167638349,-5,1036,1812,20
45169063171,45169063168,-3,1275,2205,20
45169623518,45169623515,-3,1286,1911,20
45169903414,45169903412,-2,1404,2935,20
45171012094,45171012086,-8,993,2674,20
45171779130,45171779126,-4,1198,3361,20
45173288321,45173288317,-4,1137,3700,20
45176788245,45176788242,-3,1037,2301,20
45179461153,45179461152,-1,1327,2208,20
45182417624,45182417621,-3,1053,2554,20
45183785761,45183785766,5,3345,1136,20
45192985279,45192985276,-3,1183,2364,20
45199419429,45199419418,-11,100,575,20
45203419953,45203419950,-3,947,1934,20
45203565087,45203565084,-3,1451,2583,20
45205853036,45205853034,-2,1263,2382,20
45206369303,45206369299,-4,1469,4399,20
45215080166,45215080164,-2,910,1894,20
45215367947,45215367942,-5,912,2812,20
45218887074,45218887070,-4,906,1959,20
45219865239,45219865237,-2,907,2334,20
45220657282,45220657281,-1,1111,1920,20
45224161518,45224161516,-2,1578,2281,20
45224986121,45224986118,-3,1457,2013,20
45232371388,45232371385,-3,1109,1978,20
45234233692,45234233680,-12,2061,734,20
45236059362,45236059357,-5,1132,2428,20
45236768317,45236768323,6,1684,1241,20
45237730313,45237730312,-1,418,1599,20
45241441031,45241441038,7,2695,1327,20
45243522181,45243522178,-3,1183,2521,20
45245461791,45245461787,-4,1187,2608,20
45246034834,45246034831,-3,913,2197,20
45251609211,45251609210,-1,1368,1902,20
45257105701,45257105695,-6,821,2453,20
45259169303,45259169302,-1,1182,2742,20
45265700986,45265700984,-2,915,2040,20
45268424711,45268424714,3,2577,1508,20
45268688299,45268688281,-18,1184,2287,20
45269901638,45269901634,-4,978,2007,20
45270801336,45270801333,-3,1542,3008,20
45273232285,45273232284,-1,1396,2815,20
45275221110,45275221106,-4,1060,2191,20
45275544414,45275544433,19,512,2154,20
45281400967,45281400966,-1,1002,2035,20
45282936251,45282936248,-3,34752,23466,20
45285382777,45285382778,1,2540,3050,20
45286822917,45286822914,-3,1283,1686,20
45287656970,45287656966,-4,813,1042,20
45297346454,45297346452,-2,1346,2430,20
45298878804,45298878799,-5,793,1596,20
45306053034,45306053033,-1,845,1741,20
45306586390,45306586386,-4,1105,2122,20
45309013802,45309013801,-1,1379,2707,20
45322036804,45322036802,-2,1228,1657,20
45322115601,45322115601,0,1148,1204,20
45323242042,45323242038,-4,847,2412,20
45323318480,45323318495,15,309,1590,20
45324302069,45324302066,-3,1119,2586,20
45324812719,45324812737,18,415,871,20
45325348787,45325348785,-2,1265,3178,20
45326126715,45326126715,0,1005,1643,20
45330153323,45330153319,-4,721,1280,20
45331949209,45331949198,-11,14778,42881,20
45332300478,45332300475,-3,1685,2817,20
45339092842,45339092837,-5,1227,2764,20
45340179338,45340179334,-4,1713,2676,20
45344627014,45344627013,-1,1016,2122,20
45349651294,45349651289,-5,783,1687,20
45349938704,45349938710,6,4788,3027,20
45351660722,45351660719,-3,1076,2045,20
45352693406,45352693410,4,4384,3423,20
45353302489,45353302486,-3,671,1808,20
45358836445,45358836439,-6,1470,3408,20
45368524009,45368524005,-4,990,2323,20
45371681105,45371681102,-3,1208,1793,20
45371896222,45371896222,0,1047,1811,20
45375349666,45375349663,-3,1156,2188,20
45378219093,45378219098,5,2633,1523,20
45379897667,45379897665,-2,1649,2451,20
45381193885,45381193883,-2,1164,2358,20
45384100929,45384100927,-2,641,1720,20
45386778445,45386778453,8,3901,1367,20
45389939465,45389939465,0,10736,11922,20
45392832708,45392832705,-3,1133,1484,20
45392966416,45392966412,-4,1008,2094,20
45397147953,45397147934,-19,1441,1982,20
45399439679,45399439675,-4,924,1556,20
45401641782,45401641778,-4,1004,3789,20
45402205424,45402205443,19,325,1385,20
45409607412,45409607406,-6,2374,8413,20
45412651638,45412651635,-3,1225,2719,20
45413239249,45413239245,-4,864,1618,20
45413708803,45413708801,-2,889,1444,20
45414361393,45414361399,6,2837,1004,20
45414439699,45414439698,-1,1226,2630,20
45418165478,45418165477,-1,838,2235,20
45418672471,45418672470,-1,1342,2304,20
45418810987,45418810985,-2,643,2468,20
45429625961,45429625958,-3,1636,2633,20
45430990048,45430990045,-3,1354,2703,20
45433560158,45433560156,-2,1226,2897,20
45437875727,45437875725,-2,1038,2690,20
45441940415,45441940415,0,1286,2243,20
45445651422,45445651415,-7,2097,10232,20
45449941154,45449941148,-6,1430,3360,20
45453254292,45453254289,-3,1164,1906,20
45454494191,45454494190,-1,891,2300,20
45459190238,45459190236,-2,948,3254,20
45460947081,45460947078,-3,983,2642,20
45461066878,45461066875,-3,1113,2725,20
45463616412,45463616410,-2,848,2434,20
45467168515,45467168513,-2,1107,2235,20
45469017351,45469017348,-3,867,1850,20
45470836641,45470836638,-3,819,1551,20
45472133165,45472133162,-3,867,2123,20
45473421339,45473421335,-4,1082,2530,20
45476631355,45476631353,-2,1263,1622,20
45477019878,45477019876,-2,1139,2426,20
45478163170,45478163186,16,768,2607,20
45480481758,45480481754,-4,1051,2099,20
45483671015,45483671010,-5,916,2772,20
45486784844,45486784839,-5,1150,2462,20
45488745363,45488745360,-3,876,1511,20
45489045438,45489045438,0,914,1943,20
45490186903,45490186899,-4,752,2877,20
45493541162,45493541157,-5,1056,1908,20
45494607986,45494607983,-3,1231,1769,20
45507480418,45507480415,-3,1104,2071,20
45508342098,45508342094,-4,1168,1784,20
45509094084,45509094105,21,1443,2707,20
45509756904,45509756901,-3,886,2762,20
45511097810,45511097806,-4,1143,1982,20
45520138648,45520138644,-4,1057,2946,20
45521406074,45521406072,-2,1158,2608,20
45529687494,45529687490,-4,1114,3632,20
45530438627,45530438625,-2,1236,2136,20
45532170431,45532170429,-2,852,3279,20
45534493539,45534493536,-3,994,2531,20
45535223638,45535223635,-3,1259,2791,20
45543025280,45543025279,-1,1428,1976,20
45545156314,45545156309,-5,930,2522,20
45545893517,45545893497,-20,752,2260,20
45546155387,45546155389,2,1435,2151,20
45546232770,45546232766,-4,1323,2846,20
45559713306,45559713304,-2,1164,2082,20
45563616178,45563616175,-3,1197,3148,20
45564132932,45564132930,-2,2114,3070,20
45565160590,45565160587,-3,774,2131,20
45566732189,45566732185,-4,1371,3519,20
45566897290,45566897286,-4,1293,1827,20
45569181451,45569181446,-5,923,3420,20
45571329806,45571329802,-4,1843,3241,20
45575989882,45575989879,-3,1299,2439,20
45576301708,45576301729,21,220,511,20
45578956671,45578956668,-3,729,2409,20
45581597080,45581597078,-2,1355,1886,20
45587377855,45587377858,3,1660,1535,20
45587489674,45587489673,-1,1267,1771,20
45594692063,45594692059,-4,1244,2753,20
45596927897,45596927901,4,2307,1101,20
45599619441,45599619438,-3,1175,2375,20
45603942834,45603942834,0,1387,3073,20
45605414194,45605414192,-2,1428,2852,20
45606159703,45606159699,-4,1554,2253,20
45612787319,45612787317,-2,1276,2958,20
45617282343,45617282339,-4,1191,2451,20
45618312858,45618312853,-5,30736,14742,20
45624753677,45624753674,-3,1767,2184,20
45626305258,45626305257,-1,1594,1829,20
45632070285,45632070281,-4,1031,2968,20
45632647823,45632647821,-2,1109,1339,20
45638882018,45638882018,0,968,2484,20
45639335730,45639335728,-2,965,1866,20
45643927461,45643927457,-4,932,1927,20
45644548479,45644548475,-4,713,2469,20
45651000238,45651000237,-1,1413,1805,20
45652782535,45652782533,-2,1073,1970,20
45655118411,45655118406,-5,1335,2618,20
45656911617,45656911613,-4,1031,2742,20
45656991030,45656991049,19,300,1483,20
45660611582,45660611579,-3,1624,1961,20
45662428051,45662428049,-2,1070,2051,20
45667441043,45667441041,-2,1189,2585,20
45670076031,45670076030,-1,922,2033,20
45670103703,45670103715,12,40,1623,20
45670400058,45670400057,-1,950,2481,20
45671006693,45671006689,-4,1098,2433,20
45672276332,45672276328,-4,1472,1632,20
45673162098,45673162094,-4,614,2066,20
45679085457,45679085467,10,11018,26744,20
45679222141,45679222155,14,340,1080,20
45679920398,45679920395,-3,1413,2777,20
45682188603,45682188602,-1,1233,1770,20
45683878081,45683878079,-2,1166,2202,20
45691553675,45691553671,-4,1306,1582,20
45691776901,45691776899,-2,950,2929,20
45693244121,45693244117,-4,1284,3295,20
45694523513,45694523509,-4,23752,12916,20
45695448753,45695448750,-3,902,1880,20
45698375861,45698375862,1,1345,1217,20
45698690881,45698690878,-3,1299,2582,20
45703665038,45703665036,-2,1519,2064,20
45704507151,45704507149,-2,1265,1899,20
45705502734,45705502730,-4,1152,1928,20
45705853885,45705853881,-4,815,1914,20
45707064107,45707064104,-3,844,1547,20
45707532374,45707532373,-1,914,1941,20
45709450390,45709450389,-1,1202,2561,20
45714064256,45714064250,-6,1249,2359,20
45715872165,45715872161,-4,1390,2483,20
45718174957,45718174954,-3,1345,3531,20
45718572024,45718572022,-2,1170,2022,20
45719714509,45719714506,-3,1463,2411,20
45731087887,45731087881,-6,877,2872,20
45734470627,45734470625,-2,46041,19939,20
45739884810,45739884808,-2,1149,1809,20
45742422059,45742422062,3,1755,1867,20
45744976263,45744976260,-3,21053,7718,20
45748954867,45748954866,-1,999,2180,20
45752173710,45752173708,-2,1113,2347,20
45753812993,45753813004,11,441,935,20
45754627828,45754627830,2,301,890,20
45756452491,45756452487,-4,1376,2803,20
45762298773,45762298774,1,1464,2206,20
45762760054,45762760053,-1,675,1822,20
45763979504,45763979508,4,2378,1513,20
45764563217,45764563214,-3,3389,8898,20
45767493978,45767493988,10,16631,38808,20
45785254391,45785254390,-1,1165,2317,20
45794001645,45794001643,-2,887,1420,20
45802520787,45802520786,-1,1078,1200,20
45804315283,45804315278,-5,1310,3486,20
45806473910,45806473909,-1,1507,2079,20
45809841658,45809841654,-4,1119,3382,20
45812262958,45812262954,-4,1252,2237,20
45815606715,45815606711,-4,830,2223,20
45818250115,45818250113,-2,1047,2324,20
45821127905,45821127902,-3,1110,2485,20
45825113425,45825113422,-3,1194,3333,20
45828387090,45828387089,-1,762,2282,20
45836768546,45836768542,-4,1323,2461,20
45837965185,45837965185,0,1315,3020,20
45838840851,45838840846,-5,1547,2776,20
45844907663,45844907660,-3,1183,2393,20
45850336062,45850336060,-2,1093,2221,20
45850917510,45850917499,-11,572,1649,20
45852218311,45852218306,-5,696,2562,20
45853592415,45853592411,-4,943,2208,20
45854089447,45854089445,-2,1148,1952,20
45855310204,45855310227,23,668,1056,20
45857596447,45857596443,-4,1295,3235,20
45863300522,45863300522,0,1040,1290,20
45871111947,45871111946,-1,1568,3389,20
45874714887,45874714885,-2,1325,1639,20
45877628468,45877628466,-2,1397,3316,20
45887844321,45887844319,-2,1295,2014,20
45890565679,45890565674,-5,1173,1625,20
45893837767,45893837764,-3,1532,2766,20
45898980419,45898980417,-2,1049,2098,20
45906753908,45906753904,-4,729,2502,20
45907629306,45907629302,-4,1309,2645,20
45911567078,45911567091,13,17736,35598,20
45914464182,45914464181,-1,774,1953,20
45920768243,45920768238,-5,1182,2092,20
45923024450,45923024451,1,1297,1333,20
45928101164,45928101165,1,1580,1260,20
45934631167,45934631166,-1,903,1538,20
45936092854,45936092850,-4,1609,2630,20
45942247401,45942247395,-6,739,1222,20
45944465865,45944465862,-3,1187,2196,20
45946733224,45946733222,-2,1331,2750,20
45948479670,45948479669,-1,1035,1579,20
45948674793,45948674790,-3,1154,1657,20
45951010702,45951010702,0,1779,2015,20
45965128487,45965128484,-3,1036,2515,20
45965607922,45965607933,11,1528,1107,20
45968600598,45968600594,-4,1275,2084,20
45974901432,45974901430,-2,863,1901,20
45977879542,45977879538,-4,872,1820,20
45978308695,45978308691,-4,729,1033,20
45979910975,45979910972,-3,844,1989,20
45991490780,45991490779,-1,918,1565,20
45993274523,45993274519,-4,1145,2640,20
45993634344,45993634344,0,9363,9284,20
45995895276,45995895273,-3,1208,2482,20
45997783115,45997783113,-2,978,2429,20
45998636572,45998636568,-4,984,1865,20
45998805763,45998805769,6,3620,1329,20
46003104773,46003104766,-7,1164,2318,20
46005456758,46005456765,7,2440,1317,20
46010681352,46010681350,-2,884,2462,20
46011417933,46011417926,-7,836,2942,20
46013763144,46013763142,-2,23821,42820,20
46014258211,46014258209,-2,1443,2579,20
46014517330,46014517327,-3,1158,3110,20
46018400117,46018400115,-2,1007,2942,20
46021741882,46021741878,-4,987,2414,20
46027768331,46027768327,-4,921,1934,20
46029337025,46029337023,-2,1831,3247,20
46031748875,46031748871,-4,836,1672,20
46031780685,46031780683,-2,1446,2747,20
46039452419,46039452415,-4,988,1615,20
46040912002,46040912003,1,882,1341,20
46050744521,46050744518,-3,1819,3338,20
46052111179,46052111177,-2,1254,2745,20
46053205121,46053205128,7,13390,25696,20
46054484398,46054484402,4,3396,2866,20
46055180831,46055180828,-3,781,2156,20
46055893366,46055893363,-3,1155,3246,20
46058080901,46058080898,-3,915,2223,20
46061274642,46061274637,-5,1297,2457,20
46062385661,46062385659,-2,1136,2512,20
46063667891,46063667887,-4,1329,2766,20
46064163922,46064163919,-3,1176,2294,20
46076785221,46076785214,-7,973,1655,20
46078145166,46078145161,-5,1258,2571,20
46079509882,46079509879,-3,1637,2428,20
46079633522,46079633527,5,2148,1661,20
46080536407,46080536404,-3,1188,2804,20
46084423440,46084423437,-3,1594,2440,20
46090144944,46090144938,-6,883,2550,20
46093728134,46093728130,-4,776,1988,20
46095676117,46095676113,-4,1183,1941,20
46096673294,46096673292,-2,1240,2441,20
46104365418,46104365414,-4,979,2781,20
46111537979,46111537978,-1,1431,2237,20
46112813533,46112813528,-5,1047,2805,20
46116013885,46116013882,-3,1072,1658,20
46127361322,46127361321,-1,757,1595,20
46129406525,46129406523,-2,1525,1969,20
46133571246,46133571243,-3,1331,2772,20
46134098774,46134098771,-3,1348,2883,20
46137276792,46137276799,7,7448,2402,20
46137793894,46137793890,-4,1074,1953,20
46138059804,46138059800,-4,939,3482,20
46138694346,46138694342,-4,1118,2789,20
46139311215,46139311214,-1,1800,2648,20
46141187747,46141187745,-2,1074,3113,20
46144513176,46144513175,-1,1455,2042,20
46148451451,46148451447,-4,1042,2631,20
46154038123,46154038130,7,11718,20937,20
46154232025,46154232021,-4,1507,2746,20
46155314631,46155314634,3,26668,35950,20
46155880781,46155880778,-3,1418,2347,20
46156066853,46156066870,17,1017,2765,20
46156717257,46156717257,0,1428,2857,20
46160076206,46160076201,-5,1674,5026,20
46167302459,46167302456,-3,1243,2869,20
46168752671,46168752669,-2,1058,2615,20
46169550709,46169550706,-3,2604,5299,20
46172630895,46172630890,-5,1243,2214,20
46179846555,46179846551,-4,765,3099,20
46182175673,46182175669,-4,1215,3078,20
46187400338,46187400333,-5,1400,2618,20
46190122283,46190122278,-5,936,2342,20
46190878253,46190878250,-3,872,2526,20
46191317286,46191317285,-1,971,2263,20
46191536249,46191536247,-2,1238,2491,20
46195653086,46195653081,-5,892,2913,20
46195803685,46195803670,-15,1140,2434,20
46196370795,46196370793,-2,912,2183,20
46198388515,46198388519,4,1315,1440,20
46199400814,46199400815,1,1380,2196,20
46200817406,46200817402,-4,1212,2922,20
46201839871,46201839866,-5,1258,2081,20
46202331903,46202331908,5,21482,59421,20
46202922586,46202922583,-3,1054,2128,20
46205999430,46205999425,-5,1342,2878,20
46208789071,46208789067,-4,1338,2997,20
46215741078,46215741074,-4,1433,3063,20
46217682514,46217682506,-8,2372,12160,20
46221046282,46221046279,-3,1310,2281,20
46222049501,46222049495,-6,30408,9709,20
46225777602,46225777598,-4,1021,1768,20
46226137581,46226137578,-3,1079,1674,20
46227696405,46227696399,-6,1107,2579,20
46229650708,46229650723,15,785,2428,20
46229997381,46229997377,-4,1317,2006,20
46232168053,46232168054,1,1382,2070,20
46232413497,46232413493,-4,927,2493,20
46241021214,46241021210,-4,1100,2800,20
46241072645,46241072635,-10,1204,1959,20
46241433054,46241433050,-4,273,1066,20
46241782136,46241782143,7,264,1176,20
46242568186,46242568183,-3,1615,2530,20
46247469147,46247469141,-6,488,3018,20
46257108635,46257108633,-2,915,1459,20
46262675637,46262675637,0,823,1941,20
46263237997,46263237994,-3,1087,2184,20
46265679602,46265679599,-3,1025,1810,20
46267685799,46267685797,-2,901,1514,20
46272228508,46272228506,-2,1807,2942,20
46272661983,46272661979,-4,1181,2749,20
46273219366,46273219365,-1,648,1528,20
46275095446,46275095444,-2,1040,2444,20
46275236187,46275236191,4,3206,3745,20
46278006771,46278006766,-5,906,2454,20
46280451815,46280451813,-2,773,2164,20
46280773869,46280773888,19,1106,3086,20
46283173631,46283173628,-3,865,1601,20
46284428197,46284428193,-4,1089,3800,20
46285944290,46285944287,-3,1223,1884,20
46288219036,46288219031,-5,848,2849,20
46290091601,46290091596,-5,1064,1873,20
46291989697,46291989695,-2,3096,4518,20
46302213201,46302213194,-7,1265,2158,20
46302966293,46302966311,18,753,2639,20
46304893615,46304893621,6,1282,1496,20
46307962393,46307962389,-4,955,1723,20
46309814380,46309814377,-3,980,2083,20
46312460141,46312460139,-2,1734,2042,20
46313954714,46313954710,-4,1887,2860,20
46314448655,46314448639,-16,265,631,20
46315816167,46315816165,-2,1646,2839,20
46316094537,46316094534,-3,1125,2637,20
46317408599,46317408599,0,983,1732,20
46317570114,46317570112,-2,1095,2090,20
46317986841,46317986839,-2,1471,1619,20
46318897895,46318897895,0,1024,1550,20
46320233051,46320233046,-5,1205,2113,20
46320510651,46320510646,-5,1062,2009,20
46323390272,46323390267,-5,989,2447,20
46324434407,46324434405,-2,1184,2029,20
46326965261,46326965258,-3,929,2303,20
46327314583,46327314578,-5,1127,3088,20
46328700357,46328700354,-3,1267,2250,20
46339872587,46339872585,-2,1242,1136,20
46341372441,46341372439,-2,803,1765,20
46346081716,46346081713,-3,1005,1799,20
46347067942,46347067939,-3,774,1894,20
46347672774,46347672769,-5,797,1887,20
46347825774,46347825790,16,285,974,20
46351030554,46351030551,-3,1077,1811,20
46356765503,46356765502,-1,1750,1664,20
46357452693,46357452691,-2,1347,2324,20
46358370657,46358370653,-4,1214,2509,20
46363617830,46363617832,2,2529,1967,20
46365191114,46365191110,-4,1061,2302,20
46365278798,46365278796,-2,1281,2793,20
46368001685,46368001682,-3,1307,2433,20
46386769814,46386769810,-4,1229,2504,20
46389737310,46389737308,-2,950,2230,20
46391770871,46391770868,-3,1029,1947,20
46397782358,46397782355,-3,973,1371,20
46404061848,46404061845,-3,1101,2097,20
46411084621,46411084626,5,2870,1835,20
46412758451,46412758450,-1,902,1656,20
46412925704,46412925703,-1,117,790,20
46414662842,46414662840,-2,856,1614,20
46418036728,46418036726,-2,832,1805,20
46418079181,46418079202,21,954,1688,20
46420508456,46420508454,-2,1151,2993,20
46422287743,46422287739,-4,918,2215,20
46423403777,46423403782,5,11472,21244,20
46434239014,46434239009,-5,1123,6210,20
46434397004,46434397024,20,902,2223,20
46436173110,46436173115,5,3985,1778,20
46436798417,46436798413,-4,1274,2484,20
46437877698,46437877697,-1,1263,2325,20
46438542174,46438542170,-4,971,2266,20
46439363478,46439363478,0,383,907,20
46440940875,46440940879,4,2253,1244,20
46442013769,46442013763,-6,1024,2050,20
46442838971,46442838972,1,1104,1656,20
46444081379,46444081383,4,1519,1271,20
46447053011,46447053010,-1,1016,1675,20
46449550729,46449550725,-4,1163,1888,20
46451128182,46451128183,1,5793,4384,20
46451793065,46451793062,-3,860,2305,20
46459218178,46459218177,-1,1588,2846,20
46465139265,46465139261,-4,1430,3075,20
46470963683,46470963679,-4,1108,2122,20
46472266891,46472266887,-4,877,2207,20
46480052319,46480052317,-2,1168,2426,20
46480154679,46480154698,19,627,1795,20
46480801915,46480801911,-4,1019,2622,20
46481807362,46481807358,-4,1045,2545,20
46482517070,46482517069,-1,1047,1515,20
46485703451,46485703452,1,13424,14806,20
46485907385,46485907382,-3,823,1835,20
46486646774,46486646773,-1,1521,1619,20
46487070015,46487070010,-5,1248,2150,20
46491396259,46491396279,20,1304,2114,20
46499752359,46499752354,-5,1004,1763,20
46502943185,46502943180,-5,1323,5142,20
46504835149,46504835149,0,1805,2004,20
46505976749,46505976751,2,1986,1114,20
46507804565,46507804562,-3,1144,3220,20
46512291523,46512291519,-4,1673,3501,20
46513122828,46513122826,-2,1228,1692,20
46515521343,46515521340,-3,916,2483,20
46517930592,46517930588,-4,1341,3139,20
46527295649,46527295646,-3,1153,1928,20
46530628218,46530628213,-5,1005,3290,20
46531053162,46531053156,-6,1139,2477,20
46534382668,46534382665,-3,1795,3368,20
46534533898,46534533893,-5,1423,3808,20
46536694773,46536694770,-3,1269,1935,20
46538044585,46538044581,-4,1038,2553,20
46540873545,46540873542,-3,1218,1942,20
46542626233,46542626228,-5,835,1764,20
46542832819,46542832818,-1,955,1989,20
46543294843,46543294841,-2,697,1755,20
46548195263,46548195255,-8,5888,23036,20
46548461331,46548461326,-5,839,3345,20
46548548949,46548548951,2,1892,1937,20
46548645050,46548645049,-1,1065,2671,20
46554765186,46554765185,-1,1074,2969,20
46561715448,46561715445,-3,1540,4492,20
46563089275,46563089274,-1,1140,1133,20
46565556814,46565556809,-5,1008,3855,20
46574992613,46574992609,-4,414,1081,20
46580966740,46580966737,-3,1519,2328,20
46583325070,46583325075,5,2398,1271,20
46589515126,46589515122,-4,868,2489,20
46591365952,46591365949,-3,1113,2063,20
46597438429,46597438424,-5,3007,8975,20
46600288359,46600288361,2,1337,1590,20
46605591542,46605591541,-1,1767,2443,20
46607773050,46607773047,-3,1340,2347,20
46608070624,46608070636,12,661,2219,20
46611454848,46611454846,-2,1047,1939,20
46611556148,46611556150,2,233,1293,20
46616173896,46616173892,-4,1369,2567,20
46618163814,46618163813,-1,1363,1834,20
46619857030,46619857028,-2,925,1633,20
46624525879,46624525877,-2,1007,2064,20
46627845600,46627845595,-5,945,1941,20
46629790155,46629790167,12,11111,26790,20
46631595792,46631595790,-2,1526,2675,20
46632263157,46632263157,0,1160,2555,20
46632778223,46632778222,-1,1510,2871,20
46634450416,46634450415,-1,1486,2946,20
46634510315,46634510311,-4,833,964,20
46637529383,46637529378,-5,1925,3814,20
46638699226,46638699227,1,2401,3272,20
46640841730,46640841738,8,1833,966,20
46641169686,46641169680,-6,2010,7515,20
46642559122,46642559118,-4,1046,2757,20
46645572945,46645572942,-3,1458,2412,20
46652532951,46652532949,-2,1416,3256,20
46654797348,46654797343,-5,869,2751,20
46655872409,46655872407,-2,1344,2713,20
46657824404,46657824402,-2,974,1972,20
46665722571,46665722569,-2,1000,2155,20
46672689204,46672689198,-6,805,1093,20
46676699554,46676699550,-4,1219,2131,20
46679219525,46679219522,-3,999,2317,20
46681618931,46681618928,-3,1365,2508,20
46681797646,46681797643,-3,1051,2577,20
46681854310,46681854308,-2,979,1794,20
46683348495,46683348491,-4,1202,3023,20
46684848357,46684848354,-3,1457,3054,20
46690608147,46690608143,-4,1349,1899,20
46691383755,46691383754,-1,1160,2039,20
46694578271,46694578266,-5,1124,2212,20
46695348205,46695348205,0,913,1361,20
46695529197,46695529196,-1,612,1870,20
46697761044,46697761038,-6,956,2346,20
46704238662,46704238661,-1,999,3061,20
46707823264,46707823263,-1,1024,2383,20
46710274814,46710274812,-2,870,1387,20
46711428889,46711428889,0,906,2592,20
46712202349,46712202346,-3,1336,2375,20
46715315919,46715315917,-2,1058,2036,20
46717585319,46717585317,-2,1097,3466,20
46720478946,46720478946,0,1326,1541,20
46721035409,46721035406,-3,1182,2794,20
46721433919,46721433916,-3,1050,2543,20
46726546420,46726546418,-2,460,1791,20
46729116836,46729116842,6,718,1368,20
46729741123,46729741120,-3,1155,2672,20
46732050691,46732050688,-3,1031,2048,20
46732393778,46732393777,-1,1170,1633,20
46733021655,46733021651,-4,1011,1731,20
46733541181,46733541201,20,683,2054,20
46736357234,46736357233,-1,1756,1715,20
46736481668,46736481665,-3,1396,2636,20
46740656323,46740656321,-2,1069,1719,20
46758698099,46758698094,-5,1067,2057,20
46762915095,46762915094,-1,795,1475,20
46764450482,46764450477,-5,1192,2816,20
46779552379,46779552377,-2,1215,1806,20
46781641877,46781641874,-3,948,1811,20
46789108737,46789108733,-4,1169,2407,20
46792697108,46792697101,-7,1656,3465,20
46793037356,46793037379,23,555,1930,20
46797852930,46797852926,-4,1337,2562,20
46801294474,46801294472,-2,1687,1664,20
46802988467,46802988475,8,8292,21837,20
46805712854,46805712851,-3,926,2691,20
46806858062,46806858050,-12,1120,1784,20
46809635547,46809635544,-3,1261,2857,20
46812211900,46812211897,-3,1647,2227,20
46824735690,46824735687,-3,1299,2134,20
46825905759,46825905742,-17,673,2293,20
46828715654,46828715649,-5,738,4996,20
46831714135,46831714130,-5,1307,2824,20
46834518095,46834518092,-3,786,2565,20
46834951109,46834951105,-4,1133,2838,20
46835038001,46835037998,-3,1249,2521,20
46836388543,46836388539,-4,912,2115,20
46838075931,46838075929,-2,1753,2520,20
46840471483,46840471481,-2,1215,2471,20
46840804959,46840804956,-3,810,1942,20
46841023942,46841023938,-4,1073,1165,20
46843849127,46843849126,-1,663,2242,20
46845352733,46845352728,-5,1643,2967,20
46846448719,46846448715,-4,1329,3079,20
46852983755,46852983758,3,1875,1515,20
46853988480,46853988484,4,244,1464,20
46857728442,46857728441,-1,1713,2582,20
46858476271,46858476269,-2,1086,1886,20
46863043255,46863043250,-5,1390,2627,20
46863640643,46863640641,-2,1626,3225,20
46863953802,46863953795,-7,734,3967,20
46864044349,46864044346,-3,1537,2521,20
46864363875,46864363872,-3,959,2107,20
46864959970,46864959968,-2,977,1994,20
46865017399,46865017418,19,987,2823,20
46866190179,46866190174,-5,1224,2459,20
46866856818,46866856817,-1,1056,2119,20
46871335338,46871335337,-1,1165,2278,20
46871379141,46871379141,0,959,2353,20
46873083999,46873083996,-3,1085,1804,20
46873163519,46873163518,-1,1086,1076,20
46878633778,46878633774,-4,1061,2493,20
46879636729,46879636726,-3,1106,2871,20
46879701399,46879701392,-7,1191,2710,20
46884494386,46884494392,6,2374,1669,20
46884630318,46884630321,3,24367,38799,20
46885215978,46885215974,-4,1140,2556,20
46885840942,46885840938,-4,1004,2787,20
46887660701,46887660697,-4,1011,2231,20
46888563467,46888563467,0,1109,2475,20
46888756827,46888756829,2,1919,1852,20
46889881329,46889881326,-3,603,952,20
46893205056,46893205054,-2,1422,2183,20
46894182237,46894182234,-3,1163,3505,20
46897108479,46897108478,-1,628,1249,20
46897651322,46897651318,-4,733,1506,20
46899286768,46899286765,-3,1540,3263,20
46904910895,46904910892,-3,1095,2307,20
46906336655,46906336654,-1,767,1287,20
46912595912,46912595922,10,559,1993,20
46916198733,46916198731,-2,1230,2169,20
46918677498,46918677494,-4,1582,3140,20
46920126647,46920126646,-1,1577,2406,20
46926422970,46926422969,-1,1243,1262,20
46928067780,46928067779,-1,2043,3045,20
46930084923,46930084921,-2,1441,3818,20
46932008657,46932008654,-3,1190,1623,20
46935274570,46935274567,-3,1349,3304,20
46935531967,46935531951,-16,1046,3068,20
46945622238,46945622232,-6,1476,3986,20
46955269555,46955269553,-2,1228,2447,20
46956002997,46956002993,-4,951,1680,20
46959034529,46959034526,-3,1151,2231,20
46960494508,46960494506,-2,1172,2291,20
46962582226,46962582226,0,1479,2358,20
46962609558,46962609555,-3,1348,2442,20
46965165706,46965165703,-3,1077,1834,20
46969533702,46969533705,3,756,1099,20
46970271106,46970271105,-1,919,1962,20
46972619137,46972619134,-3,881,2031,20
46973874221,46973874219,-2,1520,1930,20
46977691708,46977691702,-6,1052,3525,20
46986569858,46986569853,-5,1215,2641,20
46986716567,46986716582,15,605,1700,20
46988928830,46988928829,-1,1068,1891,20
46992063824,46992063823,-1,1603,1995,20
46994703467,46994703465,-2,1459,2233,20
46998351798,46998351797,-1,1179,1243,20
47002212737,47002212735,-2,1099,2224,20
47005822991,47005822988,-3,1330,2496,20
47010735381,47010735376,-5,2459,7556,20
47011133156,47011133147,-9,11957,406,20
47015016380,47015016378,-2,1323,1973,20
47017655246,47017655245,-1,1190,2228,20
47025705033,47025705031,-2,1259,2146,20
47033125122,47033125118,-4,1353,2435,20
47044150370,47044150367,-3,784,1860,20
47045115979,47045115976,-3,1339,2101,20
47051073335,47051073333,-2,1373,2455,20
47053354901,47053354896,-5,904,1511,20
47055314595,47055314592,-3,1232,2827,20
47055500898,47055500894,-4,1012,3412,20
47060562764,47060562758,-6,1813,5679,20
47060827928,47060827927,-1,1361,2483,20
47066331987,47066331986,-1,1230,2344,20
47068904566,47068904561,-5,1080,2486,20
47076356065,47076356061,-4,961,1600,20
47077730203,47077730202,-1,593,1239,20
47078186368,47078186382,14,1112,2204,20
47078456276,47078456272,-4,1184,2907,20
47084178576,47084178573,-3,893,2704,20
47085384779,47085384777,-2,1426,2421,20
47086192564,47086192561,-3,1130,2600,20
47087769938,47087769934,-4,967,2426,20
47091287750,47091287748,-2,855,2358,20
47093490049,47093490046,-3,961,2710,20
47095859834,47095859831,-3,1245,2177,20
47103054174,47103054169,-5,1101,1999,20
47103631779,47103631778,-1,973,2030,20
47104667427,47104667422,-5,906,2206,20
47105672076,47105672073,-3,1557,2472,20
47112560041,47112560038,-3,1010,2511,20
47113582980,47113582974,-6,27732,14802,20
47114811675,47114811673,-2,1544,2016,20
47119906677,47119906682,5,927,2092,20
47123395635,47123395634,-1,835,1874,20
47124277400,47124277397,-3,981,2827,20
47126922350,47126922347,-3,1053,3182,20
47128165429,47128165428,-1,159,677,20
47129929330,47129929326,-4,1271,2230,20
47131951215,47131951211,-4,2058,4907,20
47140052727,47140052724,-3,1134,1839,20
47148059736,47148059733,-3,1837,2637,20
47148915275,47148915278,3,1572,1674,20
47152062253,47152062250,-3,1173,2039,20
47153288811,47153288811,0,1352,1823,20
47161718597,47161718595,-2,1313,1729,20
47162552195,47162552194,-1,1218,2207,20
47165440398,47165440394,-4,1057,2846,20
47166232829,47166232826,-3,925,1622,20
47166928374,47166928389,15,316,1217,20
47174968734,47174968730,-4,1006,1802,20
47181743972,47181743972,0,1527,1619,20
47183728390,47183728383,-7,940,1940,20
47198001885,47198001878,-7,1460,12817,20
47199816601,47199816599,-2,1664,2566,20
47201801691,47201801688,-3,1507,2976,20
47202250571,47202250569,-2,1109,2448,20
47202776861,47202776849,-12,149,908,20
47203267590,47203267589,-1,617,1889,20
47204660812,47204660798,-14,1061,2043,20
47208421998,47208421998,0,1424,2491,20
47210657529,47210657527,-2,1524,2528,20
47212141275,47212141265,-10,812,2339,20
47217426947,47217426945,-2,1257,2349,20
47217531163,47217531158,-5,896,3090,20
47218536931,47218536929,-2,18141,31511,20
47224456769,47224456766,-3,1234,2621,20
47229623414,47229623413,-1,859,1944,20
47230601670,47230601666,-4,1235,2937,20
47236215018,47236215020,2,3017,2505,20
47239604902,47239604898,-4,1147,2315,20
47240802623,47240802622,-1,1171,3024,20
47246102190,47246102191,1,1570,1729,20
47246742694,47246742691,-3,735,1526,20
47249569470,47249569476,6,6871,2434,20
47250056771,47250056769,-2,1083,2077,20
47250973966,47250973963,-3,1222,2679,20
47255005811,47255005807,-4,996,1837,20
47264636431,47264636429,-2,691,2630,20
47269131716,47269131722,6,3330,1310,20
47269436782,47269436781,-1,958,2039,20
47272722990,47272722987,-3,1405,2959,20
47272794579,47272794583,4,2342,1340,20
47276340021,47276340019,-2,1176,2633,20
47276885328,47276885342,14,196,835,20
47277740250,47277740248,-2,1225,2240,20
47279878764,47279878761,-3,913,2130,20
47280907719,47280907716,-3,1076,2097,20
47292198019,47292198016,-3,881,1626,20
47293010814,47293010810,-4,1156,1955,20
47295545598,47295545605,7,8268,21760,20
47301880729,47301880750,21,1300,2287,20
47302893109,47302893105,-4,1298,3108,20
47303054862,47303054858,-4,1461,2575,20
47311956268,47311956263,-5,1232,2143,20
47315105520,47315105516,-4,1260,2637,20
47315354997,47315355014,17,697,1459,20
47318087294,47318087293,-1,774,1619,20
47324925582,47324925581,-1,1279,2225,20
47325277927,47325277911,-16,783,1376,20
47329440666,47329440662,-4,948,2601,20
47332642449,47332642438,-11,537,2779,20
47332834423,47332834440,17,634,1614,20
47333677126,47333677125,-1,812,1825,20
47336694344,47336694342,-2,1131,1568,20
47336966912,47336966930,18,1191,2435,20
47338348766,47338348764,-2,1034,2378,20
47342488850,47342488849,-1,1207,1981,20
47344307250,47344307247,-3,871,2081,20
47344902134,47344902138,4,435,866,20
47351935138,47351935134,-4,1122,1979,20
47354837239,47354837237,-2,890,3083,20
47358853383,47358853384,1,1496,1833,20
47363165886,47363165890,4,2701,1860,20
47363819925,47363819922,-3,1319,2716,20
47364544684,47364544675,-9,43899,11981,20
47364779590,47364779591,1,828,191,20
47371243099,47371243099,0,653,1643,20
47371850559,47371850558,-1,722,1736,20
47374063413,47374063412,-1,1159,2678,20
47378120423,47378120421,-2,1327,1943,20
47379482898,47379482895,-3,898,1426,20
47380672478,47380672474,-4,1256,1978,20
47381268756,47381268736,-20,1180,2392,20
47388066280,47388066277,-3,1132,2103,20
47390923404,47390923400,-4,1007,2379,20
47396576627,47396576621,-6,1073,2492,20
47401967924,47401967923,-1,793,2632,20
47404230292,47404230299,7,21121,50692,20
47411937338,47411937334,-4,1482,3169,20
47414433205,47414433202,-3,1412,2721,20
47415546138,47415546135,-3,1153,2097,20
47418047451,47418047457,6,3307,1608,20
47420125294,47420125290,-4,1636,3648,20
47421481445,47421481443,-2,859,2454,20
47423501778,47423501777,-1,809,2360,20
47426817751,47426817751,0,1146,1624,20
47427796924,47427796926,2,304,868,20
47429424266,47429424264,-2,814,1736,20
47429854239,47429854237,-2,1283,3043,20
47431301453,47431301451,-2,946,1941,20
47431959366,47431959359,-7,1115,2049,20
47432288472,47432288470,-2,1273,1668,20
47443528866,47443528865,-1,735,2092,20
47452914707,47452914719,12,15182,34974,20
47454521645,47454521640,-5,596,2118,20
47457711694,47457711689,-5,1321,4562,20
47472353642,47472353639,-3,989,2131,20
47475412646,47475412647,1,947,1270,20
47475501312,47475501310,-2,2173,3445,20
47479878749,47479878747,-2,1285,2607,20
47483673482,47483673479,-3,1202,2416,20
47491602097,47491602096,-1,1470,2361,20
47495997037,47495997019,-18,150,1128,20
47499202902,47499202902,0,746,1836,20
47499699535,47499699513,-22,1219,2092,20
47499745306,47499745305,-1,1100,2915,20
47500101514,47500101510,-4,1321,2496,20
47500237862,47500237861,-1,1110,2723,20
47500537927,47500537914,-13,25219,16354,20
47506634877,47506634875,-2,876,2074,20
47508957327,47508957323,-4,1783,2463,20
47510346746,47510346745,-1,1584,3265,20
47514395447,47514395445,-2,1226,1755,20
47514777477,47514777474,-3,1042,3630,20
47515875203,47515875198,-5,1301,2638,20
47516988647,47516988642,-5,983,2296,20
47521104196,47521104193,-3,1388,2158,20
47522074745,47522074743,-2,1170,2492,20
47522752867,47522752865,-2,935,1742,20
47525719653,47525719651,-2,1235,2019,20
47526406391,47526406391,0,1509,1915,20
47530302619,47530302617,-2,837,1399,20
47530770365,47530770361,-4,1040,2103,20
47533898122,47533898119,-3,747,2552,20
47535396450,47535396435,-15,736,1593,20
47535961930,47535961927,-3,736,2037,20
47541064554,47541064549,-5,2107,7813,20
47545290637,47545290634,-3,917,2586,20
47548151277,47548151282,5,2976,1203,20
47549155746,47549155745,-1,889,1717,20
47564583358,47564583355,-3,1412,2222,20
47565055124,47565055125,1,225,876,20
47566348085,47566348083,-2,1554,3361,20
47570945419,47570945416,-3,1097,2814,20
47572897389,47572897386,-3,1197,2532,20
47573168775,47573168773,-2,1114,3122,20
47580932110,47580932106,-4,1086,2035,20
47582870946,47582870943,-3,1482,2585,20
47584547551,47584547542,-9,2196,10403,20
47585978880,47585978879,-1,1241,2706,20
47590155285,47590155282,-3,1037,2049,20
47591882591,47591882590,-1,1156,2166,20
47600784463,47600784462,-1,928,2327,20
47600884469,47600884487,18,300,879,20
47604047057,47604047054,-3,1201,1744,20
47615918787,47615918781,-6,865,5013,20
47617310490,47617310487,-3,646,2239,20
47621558390,47621558386,-4,1104,2953,20
47622422211,47622422207,-4,1116,1934,20
47625042133,47625042129,-4,1257,2036,20
47626423490,47626423489,-1,624,1258,20
47628646844,47628646848,4,2647,252,20
47629889010,47629889009,-1,1584,2215,20
47632093310,47632093306,-4,1198,1988,20
47632695389,47632695385,-4,963,2226,20
47634126551,47634126550,-1,822,2119,20
47636135005,47636135002,-3,788,2247,20
47637490190,47637490186,-4,988,1891,20
47637606698,47637606695,-3,1708,3369,20
47638925241,47638925244,3,1850,1047,20
47644148111,47644148107,-4,1215,2352,20
47645729433,47645729429,-4,982,2433,20
47653876573,47653876570,-3,1155,2389,20
47654333334,47654333330,-4,941,1941,20
47655204155,47655204153,-2,865,2790,20
47658940696,47658940693,-3,874,1982,20
47665160241,47665160237,-4,1225,2370,20
47667361294,47667361290,-4,1123,2782,20
47670172450,47670172447,-3,1214,2330,20
47672836049,47672836045,-4,938,3070,20
47673205882,47673205887,5,2092,991,20
47675774337,47675774338,1,2156,2477,20
47678681771,47678681769,-2,1271,2562,20
47690170259,47690170259,0,1259,1730,20
47692021831,47692021821,-10,1451,2369,20
47693370176,47693370191,15,270,1750,20
47702037742,47702037755,13,11480,45785,20
47702154252,47702154250,-2,1190,2283,20
47707920606,47707920609,3,826,1729,20
47709160043,47709160037,-6,1786,4090,20
47714474303,47714474299,-4,965,3020,20
47716019190,47716019188,-2,783,1903,20
47717682571,47717682569,-2,824,1507,20
47718178575,47718178571,-4,855,2094,20
47722633969,47722633962,-7,2647,7490,20
47724250998,47724251016,18,705,1901,20
47727084882,47727084878,-4,1497,2706,20
47734875300,47734875295,-5,868,2202,20
47737948665,47737948662,-3,1028,2424,20
47738103102,47738103102,0,956,2545,20
47743614045,47743614044,-1,789,2171,20
47746176212,47746176211,-1,1490,2553,20
47747257273,47747257273,0,527,2029,20
47750370629,47750370627,-2,1504,2239,20
47753914985,47753914982,-3,1203,2642,20
47776223538,47776223535,-3,1290,1583,20
47777972254,47777972251,-3,28299,59124,20
47779721466,47779721469,3,1546,1483,20
47783781323,47783781321,-2,1102,2034,20
47786638173,47786638167,-6,793,4097,20
47787374746,47787374747,1,1019,1611,20
47787966267,47787966264,-3,818,1820,20
47789834261,47789834257,-4,1034,2143,20
47794325808,47794325805,-3,1324,3021,20
47798485146,47798485144,-2,783,2677,20
47802354773,47802354770,-3,925,2133,20
47805590702,47805590699,-3,1070,2191,20
47806550775,47806550773,-2,1237,2463,20
47809617679,47809617677,-2,1019,2238,20
47811821573,47811821570,-3,1442,3002,20
47830555422,47830555419,-3,1284,1756,20
47833793422,47833793419,-3,855,2184,20
47841584342,47841584338,-4,1041,1943,20
47848883170,47848883168,-2,818,2220,20
47849734965,47849734973,8,6137,1860,20
47851562580,47851562578,-2,1187,1779,20
47851703249,47851703246,-3,1333,2164,20
47857639850,47857639857,7,3958,1357,20
47857736483,47857736487,4,1944,1443,20
47861530682,47861530685,3,3209,3711,20
47861677519,47861677517,-2,1187,3081,20
47863029206,47863029203,-3,1872,2343,20
47863267290,47863267289,-1,713,1730,20
47868302435,47868302432,-3,915,2107,20
47869337610,47869337607,-3,641,1532,20
47872440017,47872440015,-2,918,1621,20
47877193694,47877193687,-7,739,2112,20
47877473511,47877473507,-4,1088,2774,20
47878213762,47878213761,-1,1492,1470,20
47879225771,47879225766,-5,1105,2030,20
47889342879,47889342874,-5,759,1367,20
47890036062,47890036061,-1,835,1647,20
47900977901,47900977897,-4,956,2032,20
47901449020,47901449018,-2,781,1832,20
47901558318,47901558312,-6,290,1120,20
47902426578,47902426584,6,12516,18899,20
47906441910,47906441907,-3,1181,2156,20
47911474074,47911474077,3,1324,1766,20
47913894830,47913894828,-2,668,1700,20
47915961469,47915961466,-3,1272,2653,20
47919143832,47919143832,0,1410,2080,20
47920975689,47920975687,-2,1313,2713,20
47921024159,47921024154,-5,1324,3030,20
47925035993,47925035989,-4,1064,2536,20
47925748076,47925748073,-3,1497,2970,20
47926558905,47926558901,-4,1164,3128,20
47928783813,47928783810,-3,981,1657,20
47929173598,47929173585,-13,1532,2485,20
47934773011,47934773006,-5,691,2069,20
47938161306,47938161302,-4,1347,3032,20
47939338887,47939338885,-2,902,1946,20
47943549930,47943549926,-4,834,2152,20
47947197094,47947197090,-4,1274,2874,20
47947490515,47947490513,-2,1175,1833,20
47955696873,47955696870,-3,1546,3670,20
47957409231,47957409228,-3,1383,2031,20
47957596792,47957596810,18,828,1594,20
47963802350,47963802346,-4,1205,3767,20
47965587650,47965587649,-1,593,964,20
47967815242,47967815240,-2,759,2882,20
47968366824,47968366821,-3,949,1914,20
47968524740,47968524734,-6,1331,1999,20
47970778987,47970778985,-2,1298,1513,20
47972742370,47972742366,-4,974,2902,20
47973631594,47973631590,-4,1421,3052,20
47975350510,47975350510,0,13605,15044,20
47976009058,47976009056,-2,1721,2428,20
47980216711,47980216707,-4,1347,3526,20
47980770170,47980770167,-3,647,1267,20
47981329172,47981329169,-3,1530,2424,20
47981798331,47981798325,-6,947,2369,20
47981831759,47981831756,-3,109,1134,20
47983156590,47983156587,-3,887,1390,20
47985066441,47985066438,-3,679,1403,20
47990449895,47990449893,-2,1254,2620,20
47990775701,47990775701,0,1317,1969,20
47993949282,47993949266,-16,1141,2999,20
47999017966,47999017958,-8,1279,4780,20
48004338505,48004338499,-6,1004,1996,20
48004428062,48004428059,-3,1358,2266,20
48010699555,48010699555,0,1166,1882,20
48012132630,48012132627,-3,753,1653,20
48013090497,48013090494,-3,962,2227,20
48019080210,48019080205,-5,987,3017,20
48019411430,48019411427,-3,462,882,20
48021764493,48021764486,-7,3423,9714,20
48024886465,48024886460,-5,769,2015,20
48025268566,48025268559,-7,987,2655,20
48026009959,48026009955,-4,1212,2451,20
48028350755,48028350751,-4,1122,2341,20
48030629753,48030629750,-3,888,1901,20
48030888318,48030888314,-4,1227,3171,20
48034608826,48034608824,-2,1039,2113,20
48041462246,48041462245,-1,1484,2825,20
48045495654,48045495651,-3,1649,3509,20
48047716110,48047716118,8,3528,1447,20
48051173765,48051173762,-3,1127,3664,20
48060622294,48060622298,4,3522,2755,20
48063731962,48063731960,-2,1098,2013,20
48066991749,48066991746,-3,695,1905,20
48068804659,48068804654,-5,1453,2982,20
48070373797,48070373796,-1,1163,2517,20
48071378154,48071378152,-2,965,1947,20
48072162562,48072162559,-3,849,2177,20
48075168322,48075168321,-1,1298,2718,20
48077400350,48077400355,5,2717,1192,20
48077694846,48077694843,-3,1059,2047,20
48082226908,48082226904,-4,711,2687,20
48095756546,48095756544,-2,1082,1822,20
48099135065,48099135063,-2,1014,2215,20
48099618311,48099618306,-5,827,1860,20
48103680454,48103680451,-3,1355,2503,20
48115609342,48115609341,-1,1083,2148,20
48116240517,48116240516,-1,1455,2071,20
48116591277,48116591257,-20,956,2857,20
48118553272,48118553269,-3,1531,3074,20
48125285358,48125285355,-3,1173,3534,20
48125559419,48125559426,7,4070,2302,20
48127926345,48127926341,-4,1142,2357,20
48129259195,48129259201,6,3080,1384,20
48129869846,48129869843,-3,1450,2127,20
48132210360,48132210358,-2,1177,2343,20
48133242720,48133242734,14,316,2541,20
48133714966,48133714961,-5,1258,5010,20
48133843150,48133843134,-16,200,768,20
48136639924,48136639922,-2,970,1762,20
48138950289,48138950288,-1,1122,2068,20
48140459603,48140459599,-4,972,1717,20
48141897971,48141897970,-1,712,1454,20
48145585166,48145585162,-4,1267,2517,20
48145807635,48145807630,-5,1718,6086,20
48148796658,48148796656,-2,1390,2149,20
48151523806,48151523804,-2,1207,2352,20
48152002309,48152002305,-4,1075,2619,20
48154115778,48154115775,-3,1765,2837,20
48155901323,48155901321,-2,1069,2551,20
48156081100,48156081094,-6,973,1615,20
48156386318,48156386322,4,3749,2407,20
48157726134,48157726130,-4,1018,2746,20
48160147519,48160147515,-4,1143,2685,20
48160489497,48160489494,-3,960,3324,20
48163197957,48163197951,-6,998,2296,20
48165249585,48165249579,-6,623,1330,20
48166443924,48166443922,-2,1022,2415,20
48167439817,48167439814,-3,1218,2236,20
48171303300,48171303295,-5,1089,2025,20
48171853249,48171853248,-1,956,1475,20
48174311242,48174311238,-4,997,1966,20
48178344176,48178344171,-5,967,2774,20
48178437463,48178437480,17,539,1247,20
48183125575,48183125572,-3,1389,2777,20
48183379133,48183379129,-4,1070,1923,20
48183586864,48183586860,-4,1197,3191,20
48188308044,48188308041,-3,1160,2175,20
48188922430,48188922427,-3,732,1479,20
48193869242,48193869238,-4,1015,2763,20
48199343932,48199343932,0,1835,1978,20
48200404307,48200404303,-4,809,1605,20
48200523704,48200523714,10,194,1311,20
48201072049,48201072046,-3,1164,2480,20
48207552018,48207552023,5,1385,885,20
48210823187,48210823185,-2,954,2567,20
48210951064,48210951061,-3,1492,1874,20
48211767101,48211767102,1,1036,1649,20
48218037892,48218037889,-3,844,2808,20
48218178429,48218178434,5,2316,1378,20
48219348154,48219348151,-3,1339,1949,20
48219848455,48219848452,-3,930,2104,20
48221077461,48221077458,-3,1252,2551,20
48223930715,48223930710,-5,962,2842,20
48236509203,48236509199,-4,1018,1826,20
48246088930,48246088927,-3,1026,2100,20
48250152660,48250152658,-2,1541,2504,20
48256855261,48256855258,-3,1644,4010,20
48261809699,48261809702,3,13403,10661,20
48264835168,48264835164,-4,1543,2330,20
48267059967,48267059965,-2,1121,1656,20
48268206690,48268206685,-5,1736,3085,20
48271449115,48271449113,-2,837,1351,20
48276404537,48276404531,-6,337,862,20
48276837228,48276837247,19,1045,1772,20
48279362978,48279362983,5,2438,1029,20
48281752638,48281752635,-3,1257,1701,20
48282961894,48282961892,-2,1304,2541,20
48283406023,48283406015,-8,1127,2384,20
48285032567,48285032562,-5,558,2320,20
48286750473,48286750470,-3,1031,2169,20
48287417663,48287417659,-4,1324,2921,20
48288067995,48288067994,-1,931,1530,20
48289015264,48289015259,-5,1280,1845,20
48291042687,48291042683,-4,1098,2748,20
48295048512,48295048506,-6,1624,5546,20
48306013901,48306013897,-4,1438,3179,20
48310287430,48310287430,0,1249,2098,20
48313638771,48313638767,-4,975,1536,20
48316217023,48316217021,-2,719,2051,20
48317622447,48317622443,-4,1173,2289,20
48318614243,48318614241,-2,1394,2385,20
48328289029,48328289026,-3,1059,2333,20
48331165543,48331165541,-2,705,1109,20
48331701655,48331701655,0,2960,3347,20
48335103659,48335103655,-4,1352,2729,20
48335139101,48335139118,17,814,2120,20
48347531846,48347531844,-2,1307,2257,20
48350038147,48350038144,-3,1326,3233,20
48353076078,48353076062,-16,1298,1120,20
48355244034,48355244032,-2,1832,4574,20
48372815629,48372815626,-3,1235,2675,20
48373655990,48373656004,14,295,834,20
48374600485,48374600482,-3,1613,3336,20
48379445768,48379445763,-5,1141,2451,20
48379600930,48379600930,0,2183,2823,20
48381007754,48381007748,-6,869,4529,20
48383314590,48383314589,-1,1009,1479,20
48388540958,48388540953,-5,1098,2218,20
48388609389,48388609391,2,22485,22618,20
48389250631,48389250629,-2,1441,2849,20
48389709534,48389709553,19,1092,3178,20
48390959563,48390959560,-3,1378,2380,20
48391603069,48391603086,17,1073,2965,20
48392449749,48392449745,-4,1164,3347,20
48394288365,48394288362,-3,1075,2760,20
48400122307,48400122303,-4,1153,2127,20
48403005302,48403005301,-1,1346,2449,20
48406333682,48406333679,-3,988,3040,20
48419002749,48419002747,-2,863,2697,20
48421383140,48421383146,6,2681,1566,20
48422211894,48422211892,-2,953,1590,20
48441995206,48441995204,-2,1486,3253,20
48451493066,48451493062,-4,1018,1718,20
48454177818,48454177814,-4,120,707,20
48454497502,48454497500,-2,1007,2124,20
48463595557,48463595564,7,13614,32000,20
48466439494,48466439494,0,915,2288,20
48468147177,48468147182,5,1809,792,20
48471466731,48471466727,-4,1203,2866,20
48475464375,48475464370,-5,1144,2140,20
48477029822,48477029821,-1,1126,1984,20
48478176535,48478176541,6,2954,1704,20
48481861353,48481861349,-4,1485,2035,20
48482656414,48482656410,-4,822,2104,20
48483714267,48483714265,-2,1035,2096,20
48484765883,48484765870,-13,971,578,20
48487887252,48487887249,-3,826,1492,20
48490498594,48490498590,-4,2598,8255,20
48495279666,48495279667,1,1223,1028,20
48501366484,48501366480,-4,1181,3096,20
48509511159,48509511156,-3,931,1843,20
48510735322,48510735320,-2,1136,2441,20
48519096970,48519096965,-5,1060,2154,20
48520852755,48520852753,-2,1330,3405,20
48521462190,48521462201,11,91,4590,20
48527158974,48527158969,-5,1173,2136,20
48535883250,48535883245,-5,1399,3314,20
48536816730,48536816726,-4,1322,2980,20
48540097633,48540097630,-3,1050,2103,20
48540585765,48540585763,-2,720,2156,20
48540744236,48540744231,-5,836,2293,20
48542849198,48542849194,-4,1077,2685,20
48553280378,48553280376,-2,835,2182,20
48553770108,48553770106,-2,793,1059,20
48555645639,48555645638,-1,1432,2160,20
48557215473,48557215470,-3,1091,2554,20
48557280066,48557280059,-7,1191,3615,20
48559477729,48559477729,0,955,1598,20
48564536105,48564536102,-3,1376,2902,20
48569762238,48569762236,-2,897,2479,20
48572489481,48572489479,-2,1027,1527,20
48573208686,48573208685,-1,846,1757,20
48573543224,48573543241,17,704,1593,20
48576171951,48576171949,-2,1318,1946,20
48579073922,48579073918,-4,1022,3266,20
48587876287,48587876281,-6,754,2554,20
48589509361,48589509358,-3,1399,3171,20
48595567493,48595567492,-1,1206,1966,20
48595614011,48595614010,-1,1348,2416,20
48597376074,48597376092,18,899,2069,20
48598468020,48598468017,-3,81,673,20
48598617808,48598617805,-3,1279,2799,20
48599348872,48599348890,18,1086,2106,20
48601091038,48601091036,-2,1341,2999,20
48610942358,48610942356,-2,823,1953,20
48613390241,48613390263,22,932,1680,20
48615585234,48615585232,-2,1292,2623,20
48620407318,48620407314,-4,1311,3085,20
48621593764,48621593759,-5,1113,1453,20
48621719550,48621719535,-15,1347,2211,20
48622132823,48622132819,-4,809,1552,20
48625251697,48625251693,-4,1251,2975,20
48627396038,48627396036,-2,1391,2520,20
48627889898,48627889896,-2,749,2763,20
48632421799,48632421796,-3,1380,2839,20
48638390320,48638390338,18,1035,2228,20
48638507195,48638507191,-4,896,2707,20
48639538059,48639538055,-4,1122,2253,20
48639933551,48639933550,-1,950,2131,20
48640628102,48640628107,5,1570,1223,20
48641666630,48641666626,-4,841,2237,20
48642493789,48642493807,18,104,614,20
48648156844,48648156841,-3,1259,1747,20
48650073167,48650073167,0,860,1392,20
48653270361,48653270358,-3,949,3019,20
48656733650,48656733647,-3,1809,2702,20
48657166460,48657166462,2,2631,2644,20
48658644342,48658644341,-1,882,2180,20
48662529292,48662529289,-3,1275,2400,20
48663408669,48663408664,-5,1412,8456,20
48665394298,48665394293,-5,847,1741,20
48674616011,48674616008,-3,1175,2971,20
48674715107,48674715102,-5,797,2353,20
48675091322,48675091320,-2,1135,2433,20
48679195501,48679195498,-3,1024,1534,20
48679729609,48679729607,-2,1318,2006,20
48679901783,48679901778,-5,1057,2776,20
48681167021,48681167028,7,6154,2478,20
48688724735,48688724732,-3,1233,2470,20
48689377832,48689377830,-2,1004,2375,20
48709634744,48709634766,22,255,738,20
48711648881,48711648879,-2,1301,2099,20
48714062685,48714062680,-5,797,2570,20
48714317112,48714317129,17,165,1058,20
48717121469,48717121466,-3,1269,1994,20
48720026142,48720026143,1,986,1101,20
48721440073,48721440070,-3,1454,2710,20
48721473035,48721473035,0,811,1141,20
48721894860,48721894858,-2,777,1633,20
48722951463,48722951467,4,145,772,20
48725051746,48725051742,-4,1194,2397,20
48733299631,48733299627,-4,804,2375,20
48733776954,48733776952,-2,620,1837,20
48737344038,48737344036,-2,869,1339,20
48741305493,48741305495,2,1847,1595,20
48743739529,48743739525,-4,1294,3074,20
48751044499,48751044497,-2,1032,1807,20
48751848038,48751848035,-3,928,2343,20
48757750691,48757750690,-1,665,2014,20
48759044106,48759044101,-5,1378,1972,20
48763865885,48763865881,-4,1106,2300,20
48766294566,48766294561,-5,1298,3682,20
48768493775,48768493773,-2,1096,2695,20
48768967533,48768967538,5,4744,2075,20
48769385718,48769385717,-1,1122,1624,20
48771414685,48771414703,18,341,625,20
48776186290,48776186286,-4,1491,2959,20
48776229285,48776229281,-4,1140,2035,20
48776514238,48776514224,-14,1046,2191,20
48782970818,48782970815,-3,970,2269,20
48784848442,48784848438,-4,1118,2709,20
48786573050,48786573046,-4,1302,2235,20
48798098894,48798098892,-2,1103,2214,20
48800102702,48800102701,-1,1178,1983,20
48805036125,48805036121,-4,1164,2207,20
48813591373,48813591370,-3,1202,3197,20
48813665035,48813665031,-4,1042,2654,20
48818289541,48818289540,-1,1933,2289,20
48819779273,48819779266,-7,693,1789,20
48822969775,48822969769,-6,2365,7208,20
48823203933,48823203926,-7,759,2115,20
48826739833,48826739833,0,918,1650,20
48826777433,48826777432,-1,1219,1846,20
48827601735,48827601734,-1,1247,2191,20
48827702035,48827702032,-3,1100,3580,20
48829663946,48829663943,-3,1148,2101,20
48836556813,48836556812,-1,2667,3406,20
48840877734,48840877728,-6,1067,2260,20
48843068390,48843068387,-3,1034,2630,20
48845170050,48845170050,0,1302,1851,20
48848349086,48848349090,4,4607,2985,20
48854621805,48854621803,-2,673,1653,20
48855375025,48855375023,-2,1085,2593,20
48858535342,48858535342,0,1164,1892,20
48864915441,48864915437,-4,2433,5969,20
48865308253,48865308250,-3,766,1277,20
48869961879,48869961880,1,1138,1193,20
48876232105,48876232101,-4,1137,2401,20
48879656810,48879656809,-1,804,2026,20
48880280732,48880280713,-19,640,1273,20
48881132975,48881132969,-6,881,2599,20
48882099135,48882099132,-3,1348,3724,20
48882400898,48882400895,-3,825,2366,20
48886061418,48886061418,0,1022,1585,20
48887457714,48887457715,1,1161,2160,20
48892198270,48892198268,-2,1435,2324,20
48892872210,48892872207,-3,971,1446,20
48893731771,48893731768,-3,1062,2327,20
48895985297,48895985294,-3,1171,2157,20
48915590302,48915590299,-3,1416,1357,20
48922434866,48922434862,-4,1289,2832,20
48923967452,48923967448,-4,1262,2170,20
48924905711,48924905705,-6,1206,3245,20
48925818751,48925818745,-6,935,2205,20
48926135779,48926135777,-2,1715,1973,20
48930882399,48930882396,-3,652,1249,20
48931075196,48931075193,-3,1477,2965,20
48932466148,48932466150,2,1724,1888,20
48932599411,48932599408,-3,962,2904,20
48933393531,48933393522,-9,876,3191,20
48933880703,48933880696,-7,1110,2622,20
48934203703,48934203702,-1,819,2012,20
48934677966,48934677963,-3,1294,3820,20
48945343916,48945343913,-3,1119,2081,20
48946969244,48946969249,5,5302,2923,20
48947672662,48947672659,-3,1195,1255,20
48948588315,48948588312,-3,787,1506,20
48953329846,48953329844,-2,1371,2607,20
48954380827,48954380826,-1,1184,2279,20
48959006013,48959006009,-4,1124,2647,20
48963831942,48963831941,-1,1750,3109,20
48964104249,48964104246,-3,1860,2718,20
48966286106,48966286098,-8,645,7383,20
48969853594,48969853592,-2,1062,1904,20
48971233091,48971233097,6,2268,1282,20
48975263853,48975263849,-4,889,2653,20
48975439857,48975439853,-4,1284,2610,20
48977978941,48977978943,2,1614,1828,20
48978676151,48978676146,-5,1036,2286,20
48979781379,48979781377,-2,1219,2722,20
48980633482,48980633478,-4,1052,2418,20
48994418523,48994418519,-4,1082,2365,20
48995229071,48995229057,-14,217,990,20
48996893758,48996893754,-4,1348,2810,20
48997455930,48997455929,-1,877,2386,20
49000117275,49000117272,-3,1095,2191,20
49001067417,49001067413,-4,1084,2728,20
49008402990,49008402986,-4,1314,2826,20
49014242978,49014242977,-1,1301,3299,20
49015766173,49015766170,-3,1107,2076,20
49018550868,49018550889,21,309,1219,20
49019740923,49019740918,-5,1515,4318,20
49024061658,49024061656,-2,1022,2429,20
49026651994,49026651990,-4,1664,3563,20
49029091676,49029091672,-4,1217,2406,20
49033638494,49033638490,-4,1198,2832,20
49034134081,49034134078,-3,976,2396,20
49034418313,49034418318,5,7761,5311,20
49034657045,49034657030,-15,2206,23,20
49037170451,49037170450,-1,1188,2100,20
49040365566,49040365563,-3,1358,2873,20
49044099999,49044099994,-5,912,2116,20
49048895477,49048895474,-3,1088,3117,20
49054004431,49054004429,-2,966,2217,20
49055556230,49055556226,-4,990,2093,20
49060463390,49060463400,10,13048,47889,20
49063923547,49063923545,-2,1522,2605,20
49066613315,49066613311,-4,1347,2194,20
49067330502,49067330503,1,929,1338,20
49069306476,49069306473,-3,1365,2705,20
49070831159,49070831157,-2,1385,1815,20
49073478137,49073478134,-3,1439,2792,20
49073580815,49073580818,3,2168,1304,20
49074256761,49074256758,-3,1375,2250,20
49080243509,49080243506,-3,842,2066,20
49081111851,49081111848,-3,1151,2434,20
49082577147,49082577146,-1,1166,1741,20
49083765339,49083765337,-2,913,2525,20
49085040097,49085040093,-4,1102,2372,20
49086833628,49086833624,-4,2311,3243,20
49087857238,49087857236,-2,873,1809,20
49088416983,49088416976,-7,791,3608,20
49090327941,49090327937,-4,1148,2561,20
49093971829,49093971825,-4,955,2227,20
49094955891,49094955886,-5,1038,2354,20
49095980554,49095980550,-4,927,1623,20
49099047689,49099047689,0,1154,2370,20
49099239949,49099239942,-7,1040,1473,20
49100458658,49100458657,-1,764,1655,20
49100603507,49100603504,-3,703,2459,20
49100629830,49100629815,-15,194,704,20
49106713099,49106713098,-1,950,2377,20
49111734274,49111734269,-5,883,2463,20
49115011149,49115011134,-15,1138,2259,20
49115125367,49115125348,-19,1077,3217,20
49115322798,49115322793,-5,898,1700,20
49119141613,49119141608,-5,1540,2826,20
49120688641,49120688638,-3,949,2490,20
49122014043,49122014048,5,2390,1767,20
49124675519,49124675518,-1,1412,2597,20
49124857034,49124857034,0,1031,1648,20
49126918066,49126918062,-4,1245,2405,20
49127545174,49127545169,-5,833,2915,20
49128623815,49128623816,1,943,1814,20
49128929886,49128929881,-5,1039,2687,20
49129050917,49129050931,14,109,4344,20
49133738307,49133738304,-3,1226,3132,20
49138127686,49138127693,7,3313,1166,20
49139207744,49139207728,-16,1221,2289,20
49142562781,49142562777,-4,1366,2621,20
49145060987,49145060986,-1,753,1559,20
49146917638,49146917636,-2,1613,2409,20
49148125877,49148125874,-3,1105,2453,20
49151994265,49151994263,-2,1545,1704,20
49156234646,49156234638,-8,724,1720,20
49158341057,49158341056,-1,1530,2726,20
49158861127,49158861122,-5,1244,1850,20
49163699040,49163699038,-2,846,2192,20
49164910710,49164910710,0,1255,1743,20
49165042935,49165042933,-2,937,2538,20
49165619174,49165619169,-5,1143,2728,20
49169225073,49169225070,-3,1137,2886,20
49169834213,49169834212,-1,52,914,20
49171800562,49171800561,-1,1188,2277,20
49177876515,49177876514,-1,1711,2603,20
49187796778,49187796779,1,1050,1466,20
49189886207,49189886202,-5,1268,2059,20
49190685952,49190685952,0,1246,2149,20
49191216579,49191216574,-5,946,2753,20
49191610823,49191610843,20,1153,3376,20
49193280507,49193280505,-2,982,2037,20
49195007881,49195007877,-4,1343,2389,20
49198130815,49198130811,-4,989,2137,20
49198935298,49198935297,-1,1306,2264,20
49202123080,49202123078,-2,1374,2378,20
49202314343,49202314342,-1,1035,1227,20
49203468231,49203468229,-2,1055,2053,20
49203897080,49203897087,7,3058,1929,20
49205073936,49205073942,6,4510,2511,20
49211759140,49211759145,5,1883,1613,20
49213022079,49213022076,-3,986,2313,20
49213256439,49213256430,-9,899,3937,20
49215495793,49215495787,-6,1074,2788,20
49218061189,49218061186,-3,1208,2464,20
49219441136,49219441134,-2,1185,1960,20
49222678078,49222678074,-4,913,2237,20
49223724730,49223724725,-5,1149,2100,20
49229942406,49229942405,-1,2167,3340,20
49235087338,49235087334,-4,1220,2739,20
49235998354,49235998350,-4,1361,2102,20
49236204710,49236204706,-4,1277,2425,20
49236476829,49236476826,-3,1020,1730,20
49242270237,49242270233,-4,1159,2882,20
49246801600,49246801596,-4,1168,3565,20
49248174838,49248174834,-4,989,2669,20
49252338328,49252338325,-3,1510,2776,20
49255810664,49255810663,-1,1274,1990,20
49256520345,49256520342,-3,906,1996,20
49257412606,49257412602,-4,1140,3265,20
49258044839,49258044830,-9,179,710,20
49260548376,49260548373,-3,930,1850,20
49266175559,49266175558,-1,894,2364,20
49272229943,49272229942,-1,459,1238,20
49275208926,49275208935,9,36435,61200,20
49275544298,49275544306,8,13379,21515,20
49280816129,49280816133,4,4494,2409,20
49283826549,49283826545,-4,734,2384,20
49289189178,49289189175,-3,914,1786,20
49294749682,49294749678,-4,1198,3480,20
49294951494,49294951514,20,998,1915,20
49295602815,49295602810,-5,3627,9817,20
49296805655,49296805654,-1,916,2206,20
49297435225,49297435223,-2,988,2163,20
49301124927,49301124923,-4,1478,2617,20
49302389826,49302389821,-5,768,2024,20
49304088286,49304088292,6,3774,1697,20
49306425135,49306425133,-2,1846,1969,20
49308198270,49308198268,-2,955,2480,20
49309988683,49309988681,-2,1264,2041,20
49311284793,49311284788,-5,1173,2535,20
49315044881,49315044878,-3,1119,2690,20
49326674557,49326674553,-4,1112,1831,20
49327084831,49327084828,-3,1125,2206,20
49329189513,49329189510,-3,858,2495,20
49329403518,49329403510,-8,1143,2204,20
49333110099,49333110098,-1,1040,1340,20
49334457874,49334457869,-5,1313,2572,20
49339685476,49339685471,-5,1312,2222,20
49339969181,49339969182,1,1744,1977,20
49340293281,49340293281,0,1191,1981,20
49341415924,49341415945,21,115,968,20
49341510785,49341510778,-7,1021,2115,20
49345197286,49345197283,-3,488,1490,20
49346861443,49346861441,-2,941,2015,20
49349390630,49349390625,-5,1118,2723,20
49354299459,49354299456,-3,1475,2154,20
49354614302,49354614298,-4,1121,2186,20
49356968180,49356968176,-4,1875,2971,20
49361717758,49361717758,0,1623,2145,20
49362249205,49362249197,-8,700,3448,20
49362835503,49362835489,-14,472,719,20
49363147346,49363147345,-1,1413,2365,20
49364855202,49364855206,4,2927,1202,20
49364886943,49364886938,-5,1428,2442,20
49365504928,49365504925,-3,1211,3211,20
49365608981,49365608974,-7,704,1163,20
49367790674,49367790670,-4,514,2254,20
49374756514,49374756514,0,1175,2355,20
49378000709,49378000704,-5,1220,2828,20
49379342628,49379342633,5,9750,5563,20
49380761111,49380761109,-2,1120,2386,20
49385125451,49385125446,-5,733,2518,20
49386586314,49386586314,0,2572,2647,20
49389629719,49389629718,-1,1034,1792,20
49391812035,49391812033,-2,960,2035,20
49392108120,49392108138,18,461,669,20
49398023488,49398023486,-2,1425,2514,20
49402798866,49402798846,-20,1301,2702,20
49406274517,49406274514,-3,1268,2391,20
49406498077,49406498094,17,623,1719,20
49408035951,49408035946,-5,1188,2339,20
49409300295,49409300315,20,1070,1480,20
49411362585,49411362585,0,1855,2812,20
49417722157,49417722158,1,2415,2080,20
49421370634,49421370633,-1,2209,2518,20
49423561557,49423561554,-3,634,1298,20
49430405139,49430405138,-1,1383,2343,20
49431894725,49431894725,0,1189,2288,20
49432676808,49432676804,-4,1186,2266,20
49434154126,49434154113,-13,40,1086,20
49439121585,49439121581,-4,973,2270,20
49442623530,49442623526,-4,906,2150,20
49443152895,49443152908,13,876,1276,20
49444969189,49444969186,-3,1058,1988,20
49446489866,49446489863,-3,1140,2030,20
49450873327,49450873323,-4,1120,1532,20
49451431685,49451431667,-18,1312,2047,20
49458274311,49458274304,-7,903,1905,20
49459050227,49459050226,-1,787,2020,20
49459690901,49459690923,22,165,762,20
49462222447,49462222446,-1,1588,2258,20
49466586321,49466586319,-2,691,1636,20
49469029190,49469029187,-3,997,2961,20
49471921560,49471921557,-3,1363,2803,20
49472179871,49472179887,16,482,696,20
49473196027,49473196024,-3,1419,3094,20
49473376581,49473376579,-2,1224,2385,20
49480485399,49480485397,-2,504,1986,20
49483906118,49483906115,-3,1560,2158,20
49486621318,49486621315,-3,689,2384,20
49488182638,49488182637,-1,1091,2404,20
49495038050,49495038046,-4,1281,3253,20
49498467206,49498467205,-1,1193,2292,20
49500487424,49500487423,-1,1091,1774,20
49503868572,49503868568,-4,1032,2292,20
49504442058,49504442059,1,1282,1233,20
49506334535,49506334535,0,2083,2322,20
49506858383,49506858383,0,710,917,20
49507321419,49507321416,-3,587,1205,20
49508702717,49508702713,-4,1008,1921,20
49509088738,49509088746,8,1354,782,20
49510060674,49510060670,-4,884,2797,20
49511020546,49511020543,-3,1288,2139,20
49513004683,49513004681,-2,897,2687,20
49513617806,49513617820,14,803,5490,20
49517355614,49517355610,-4,817,2364,20
49519216605,49519216602,-3,27694,10231,20
49519938109,49519938105,-4,1308,2994,20
49522802799,49522802795,-4,848,2313,20
49526703325,49526703322,-3,3248,4759,20
49530208097,49530208094,-3,1059,2030,20
49530682977,49530682974,-3,1181,2187,20
49538531495,49538531494,-1,864,1991,20
49540359918,49540359915,-3,773,1530,20
49544245350,49544245346,-4,1164,2349,20
49553698343,49553698341,-2,1011,2082,20
49554059574,49554059568,-6,876,3570,20
49555424574,49555424573,-1,1229,2550,20
49561313115,49561313109,-6,612,787,20
49562642801,49562642807,6,1048,819,20
49565205003,49565205000,-3,1530,2696,20
49565695473,49565695472,-1,1308,2658,20
49566648817,49566648814,-3,1196,1921,20
49568531127,49568531124,-3,1464,3441,20
49569480597,49569480618,21,1224,2998,20
49570684171,49570684168,-3,1170,2476,20
49571526550,49571526547,-3,1144,2998,20
49571647629,49571647616,-13,109,1153,20
49582398696,49582398692,-4,850,2370,20
49583852056,49583852053,-3,1412,1942,20
49590826974,49590826974,0,1380,1854,20
49593439813,49593439812,-1,1148,2501,20
49595515169,49595515166,-3,1474,3012,20
49595739831,49595739820,-11,1154,2432,20
49596533886,49596533885,-1,18037,31917,20
49596755862,49596755855,-7,1226,2508,20
49601312051,49601312048,-3,1392,2496,20
49613427256,49613427253,-3,18993,14660,20
49617055674,49617055672,-2,1356,2869,20
49618847394,49618847390,-4,1640,3854,20
49619360142,49619360138,-4,1547,2195,20
49620907378,49620907373,-5,1309,3282,20
49625591373,49625591379,6,1843,1210,20
49626772885,49626772881,-4,966,2252,20
49627079967,49627079986,19,456,1232,20
49627209105,49627209101,-4,1204,2831,20
49627578767,49627578763,-4,842,1423,20
49627685493,49627685474,-19,255,593,20
49629229105,49629229104,-1,785,2369,20
49632257076,49632257073,-3,1736,2569,20
49638666107,49638666105,-2,976,2437,20
49639270638,49639270625,-13,249,595,20
49640871303,49640871301,-2,968,3335,20
49641442919,49641442917,-2,1308,1991,20
49646108258,49646108255,-3,941,2069,20
49648629838,49648629837,-1,1321,2134,20
49654816190,49654816190,0,1629,1402,20
49657895039,49657895037,-2,1177,2283,20
49659505149,49659505147,-2,1157,2400,20
49662066128,49662066124,-4,28983,12305,20
49671533162,49671533165,3,2140,1950,20
49673022839,49673022834,-5,1720,3079,20
49674366634,49674366632,-2,960,1438,20
49678336270,49678336267,-3,1367,2288,20
49687838797,49687838794,-3,1553,2670,20
49691509374,49691509373,-1,1310,2472,20
49691564096,49691564094,-2,1193,2073,20
49692690038,49692690037,-1,1288,1468,20
49694370018,49694370013,-5,1065,3101,20
49694752006,49694752003,-3,1082,2190,20
49694999266,49694999265,-1,5274,17164,20
49697131411,49697131411,0,1099,921,20
49699920802,49699920801,-1,998,1957,20
49704715234,49704715234,0,1149,2788,20
49707185163,49707185160,-3,1533,3529,20
49710492344,49710492342,-2,1510,2028,20
49712002892,49712002888,-4,1403,2797,20
49712155010,49712155007,-3,886,1992,20
49725685241,49725685246,5,6945,2790,20
49729597338,49729597334,-4,796,1597,20
49729783833,49729783830,-3,1334,2758,20
49730404265,49730404261,-4,1114,1859,20
49732869321,49732869319,-2,1337,2421,20
49733824129,49733824126,-3,756,1869,20
49735894147,49735894142,-5,847,1664,20
49738454530,49738454526,-4,811,2326,20
49745734503,49745734504,1,370,873,20
49745998795,49745998799,4,1816,1408,20
49749615986,49749615983,-3,884,2444,20
49755183703,49755183701,-2,1353,2579,20
49757792793,49757792789,-4,1003,2435,20
49757968061,49757968048,-13,833,1680,20
49762851812,49762851809,-3,1324,2884,20
49766528395,49766528393,-2,741,2829,20
49771066033,49771066030,-3,1357,2834,20
49771461938,49771461935,-3,1114,4030,20
49771651077,49771651075,-2,1102,2249,20
49771780334,49771780330,-4,1131,2643,20
49772378201,49772378199,-2,1302,3129,20
49775334015,49775334013,-2,1195,2077,20
49779676356,49779676357,1,1205,2010,20
49783543826,49783543829,3,1942,1528,20
49785315122,49785315121,-1,1041,2224,20
49785866070,49785866066,-4,920,1926,20
49785995405,49785995393,-12,807,1544,20
49788098762,49788098766,4,1821,1721,20
49788360865,49788360872,7,2192,1081,20
49788887750,49788887749,-1,1127,2275,20
49789505641,49789505637,-4,1182,2590,20
49789810078,49789810065,-13,845,2547,20
49790092022,49790092021,-1,1040,1902,20
49791377805,49791377801,-4,1235,2269,20
49795496827,49795496824,-3,1253,2075,20
49800731687,49800731684,-3,919,1484,20
49800907921,49800907919,-2,1013,2044,20
49803056025,49803056025,0,1081,1848,20
49806526149,49806526145,-4,1400,3560,20
49811771846,49811771847,1,2080,1819,20
49815078700,49815078695,-5,1365,2739,20
49815149947,49815149945,-2,1102,2454,20
49820587979,49820587978,-1,1246,1779,20
49821284365,49821284371,6,20524,18603,20
49823316770,49823316778,8,7956,1981,20
49828918783,49828918781,-2,1564,3320,20
49838144125,49838144122,-3,1275,2341,20
49840067964,49840067960,-4,659,1557,20
49840594064,49840594060,-4,1028,2237,20
49845204144,49845204144,0,793,1485,20
49847815783,49847815781,-2,1110,2217,20
49850444014,49850444017,3,1218,1716,20
49851205465,49851205462,-3,1117,2701,20
49854511870,49854511867,-3,1366,2117,20
49854773143,49854773139,-4,762,1651,20
49858477076,49858477073,-3,1702,2329,20
49862742705,49862742702,-3,1400,1666,20
49864219718,49864219717,-1,1092,944,20
49867269549,49867269545,-4,1663,3651,20
49867896490,49867896489,-1,821,1284,20
49877258651,49877258649,-2,1391,2559,20
49877638403,49877638402,-1,1290,1893,20
49881763265,49881763261,-4,1036,1880,20
49885047414,49885047409,-5,1075,3069,20
49892747150,49892747147,-3,802,1863,20
49894416895,49894416886,-9,1177,354,20
49897320510,49897320508,-2,1108,1770,20
49899831197,49899831195,-2,725,1210,20
49902170494,49902170490,-4,1142,1881,20
49906140236,49906140232,-4,914,2339,20
49913043895,49913043892,-3,1101,2253,20
49913331745,49913331750,5,1827,1046,20
49914326187,49914326183,-4,859,1908,20
49915587926,49915587927,1,1178,956,20
49922301534,49922301534,0,1063,2120,20
49924154991,49924154987,-4,1491,2307,20
49925112410,49925112407,-3,1204,1595,20
49927686201,49927686198,-3,755,1985,20
49935421170,49935421166,-4,978,3035,20
49936748334,49936748331,-3,991,3333,20
49937024120,49937024139,19,1403,2225,20
49938629604,49938629597,-7,2597,7466,20
49944786850,49944786845,-5,1049,3159,20
49945983357,49945983354,-3,806,1354,20
49951008471,49951008468,-3,1044,2625,20
49965838382,49965838379,-3,933,2764,20
49966245212,49966245209,-3,884,2147,20
49968962121,49968962118,-3,1472,2712,20
49973087736,49973087733,-3,1074,2672,20
49974618108,49974618105,-3,1527,3407,20
49976356601,49976356598,-3,1065,1952,20
49976482573,49976482578,5,315,932,20
49976730046,49976730045,-1,891,1988,20
49987520142,49987520139,-3,1239,2177,20
49989976844,49989976840,-4,1213,3156,20
49993269535,49993269532,-3,1118,2348,20
50007582439,50007582438,-1,1490,2938,20
50009004029,50009004026,-3,1501,2305,20
50010180293,50010180296,3,4408,2815,20
50010560227,50010560225,-2,1209,2829,20
50015016055,50015016054,-1,815,1333,20
50020317562,50020317560,-2,976,2831,20
50021078334,50021078352,18,936,2831,20
50022135831,50022135826,-5,1183,2498,20
50022217214,50022217213,-1,1360,1898,20
50023307411,50023307410,-1,1118,2156,20
50031340479,50031340475,-4,1131,3552,20
50031621425,50031621424,-1,871,1901,20
50036319555,50036319553,-2,7096,11091,20
50037540055,50037540052,-3,915,2080,20
50048703200,50048703187,-13,1066,2090,20
50054719626,50054719623,-3,1211,2322,20
50056583686,50056583682,-4,1392,2854,20
50058835582,50058835581,-1,1594,2505,20
50061683743,50061683739,-4,1103,1596,20
50062336410,50062336407,-3,1181,2429,20
50064385395,50064385388,-7,650,3685,20
50075267303,50075267298,-5,959,2405,20
50076541139,50076541133,-6,1062,2929,20
50077489254,50077489244,-10,1196,3440,20
50077681951,50077681970,19,356,1123,20
50081394315,50081394314,-1,743,1876,20
50083656438,50083656437,-1,832,1850,20
50088548019,50088548016,-3,1057,1206,20
50089640898,50089640895,-3,803,1543,20
50091954487,50091954486,-1,1048,1595,20
50092955034,50092955031,-3,1425,1828,20
50098827488,50098827486,-2,945,2325,20
50102809114,50102809110,-4,1080,1923,20
50103973460,50103973457,-3,758,2141,20
50105591663,50105591661,-2,871,2744,20
50110141397,50110141396,-1,1287,1929,20
50110745516,50110745515,-1,1036,1525,20
50125794758,50125794756,-2,991,2063,20
50126843295,50126843315,20,920,2434,20
50127329063,50127329059,-4,1453,3347,20
50131505181,50131505174,-7,843,2264,20
50132105965,50132105962,-3,958,2224,20
50132319865,50132319862,-3,839,1257,20
50135990936,50135990934,-2,1246,2007,20
50143199718,50143199720,2,1002,1121,20
50147194501,50147194497,-4,1746,2763,20
50148828982,50148828978,-4,1289,2657,20
50150989930,50150989931,1,1446,1780,20
50154551112,50154551110,-2,1394,2228,20
50155079800,50155079794,-6,2209,9649,20
50155213690,50155213688,-2,1080,2514,20
50155276688,50155276666,-22,441,580,20
50160290519,50160290515,-4,1082,1801,20
50161597339,50161597338,-1,1249,2237,20
50170495067,50170495062,-5,861,2234,20
50172416813,50172416809,-4,1519,4107,20
50175075226,50175075222,-4,1095,3164,20
50176659758,50176659755,-3,961,1809,20
50184594434,50184594427,-7,980,2140,20
50188459299,50188459296,-3,1222,2516,20
50189032375,50189032370,-5,1094,2179,20
50193774509,50193774509,0,1540,2612,20
50196338933,50196338925,-8,1320,1840,20
50203401446,50203401441,-5,1350,2920,20
50205143196,50205143193,-3,1493,3097,20
50207761350,50207761346,-4,1496,3427,20
50212869490,50212869489,-1,1050,2902,20
50213703391,50213703386,-5,758,2144,20
50219212350,50219212343,-7,536,1503,20
50219686218,50219686213,-5,1312,3216,20
50220705421,50220705423,2,284,972,20
50221023445,50221023438,-7,1185,2191,20
50223059221,50223059214,-7,1448,8311,20
50228221212,50228221213,1,10347,12281,20
50228426966,50228426962,-4,1094,2105,20
50230341589,50230341585,-4,1136,2969,20
50230926838,50230926834,-4,915,1500,20
50232215761,50232215760,-1,1435,1583,20
50233778171,50233778166,-5,1021,2333,20
50234694654,50234694654,0,1365,1702,20
50235732238,50235732237,-1,1170,1907,20
50236234106,50236234106,0,1124,2281,20
50239994718,50239994723,5,3885,2472,20
50241041356,50241041353,-3,1132,2605,20
50244491130,50244491127,-3,947,1484,20
50246436789,50246436798,9,6375,1645,20
50246994274,50246994270,-4,1038,2666,20
50250509658,50250509654,-4,1277,2346,20
50251481810,50251481809,-1,1157,2568,20
50253548002,50253548000,-2,606,1603,20
50253973470,50253973468,-2,890,2016,20
50257072213,50257072208,-5,941,2458,20
50257275468,50257275466,-2,1381,3146,20
50261323723,50261323721,-2,1632,2919,20
50262828913,50262828908,-5,864,3062,20
50266347689,50266347686,-3,1130,2565,20
50266472139,50266472133,-6,695,2320,20
50268573799,50268573796,-3,1394,1705,20
50271368971,50271368969,-2,1198,2857,20
50275462010,50275461989,-21,1053,1858,20
50276729153,50276729150,-3,1567,2291,20
50291192623,50291192621,-2,1156,2885,20
50293140282,50293140278,-4,1120,1887,20
50293289730,50293289727,-3,872,2396,20
50296102983,50296102978,-5,517,2639,20
50298128833,50298128828,-5,869,2217,20
50298605104,50298605100,-4,1037,2450,20
50302967259,50302967254,-5,1372,2234,20
50303140095,50303140093,-2,914,1350,20
50304108532,50304108529,-3,1067,2370,20
50305194768,50305194765,-3,992,2701,20
50305292853,50305292847,-6,131,525,20
50310358335,50310358333,-2,1423,2451,20
50310598523,50310598521,-2,1114,2356,20
50311880544,50311880541,-3,1271,2315,20
50313692934,50313692930,-4,1154,2810,20
50314972589,50314972586,-3,931,1890,20
50318342586,50318342583,-3,1782,2502,20
50320222247,50320222245,-2,686,1234,20
50320340864,50320340870,6,2500,1392,20
50325339220,50325339218,-2,1287,1734,20
50327931475,50327931473,-2,1035,3157,20
50335139199,50335139198,-1,1336,2344,20
50336753413,50336753412,-1,1262,2058,20
50337743997,50337743995,-2,1929,3168,20
50348520731,50348520729,-2,1106,1946,20
50349344954,50349344953,-1,1423,1817,20
50351323663,50351323661,-2,1076,1611,20
50354702230,50354702226,-4,858,1903,20
50358206934,50358206930,-4,1322,3522,20
50363498647,50363498644,-3,674,2064,20
50364527358,50364527354,-4,1427,1941,20
50370670365,50370670362,-3,1185,2049,20
50371332260,50371332282,22,960,1773,20
50374703436,50374703433,-3,940,2097,20
50376407318,50376407311,-7,2319,6173,20
50376829947,50376829943,-4,1202,2419,20
50377819389,50377819386,-3,1046,2128,20
50379092273,50379092279,6,2599,1161,20
50381453204,50381453201,-3,951,1764,20
50394549115,50394549113,-2,1146,2635,20
50401343163,50401343159,-4,1576,2921,20
50407529016,50407529013,-3,1198,2387,20
50408832170,50408832166,-4,862,1737,20
50411882299,50411882298,-1,551,1335,20
50419805227,50419805225,-2,1694,2521,20
50424705222,50424705218,-4,1100,2497,20
50425153343,50425153343,0,1604,1246,20
50431319445,50431319442,-3,1113,1766,20
50433947650,50433947646,-4,1096,2400,20
50435473974,50435473976,2,9306,10919,20
50436918433,50436918429,-4,1142,2405,20
50436967608,50436967622,14,544,1481,20
50442015483,50442015481,-2,970,2055,20
50443096125,50443096142,17,1102,2972,20
50443494343,50443494338,-5,1330,3426,20
50444667233,50444667229,-4,1152,1740,20
50446081781,50446081778,-3,1581,2888,20
50446476102,50446476102,0,704,1644,20
50449754520,50449754517,-3,1298,2677,20
50456081119,50456081114,-5,1122,1932,20
50456374229,50456374246,17,294,1021,20
50458621486,50458621484,-2,1335,2419,20
50459095708,50459095706,-2,985,2009,20
50461488926,50461488914,-12,960,1166,20
50463932946,50463932945,-1,1344,2620,20
50464786389,50464786381,-8,2718,11958,20
50465775487,50465775482,-5,1012,2332,20
50465901080,50465901090,10,255,541,20
50467534694,50467534693,-1,1268,2674,20
50467729374,50467729369,-5,1675,3223,20
50470813334,50470813332,-2,1223,2527,20
50472792439,50472792436,-3,1081,1919,20
50473124635,50473124634,-1,1327,2386,20
50476723911,50476723907,-4,1226,2410,20
50478813110,50478813109,-1,1065,1848,20
50479681951,50479681947,-4,1298,2399,20
50492270285,50492270283,-2,1048,2075,20
50493445418,50493445413,-5,1411,2658,20
50505885266,50505885262,-4,977,2488,20
50509832407,50509832406,-1,1198,2853,20
50511126443,50511126441,-2,970,2410,20
50512021666,50512021665,-1,858,2484,20
50512986769,50512986765,-4,1238,3470,20
50513120063,50513120061,-2,1486,1709,20
50513381330,50513381327,-3,1798,3048,20
50517395467,50517395470,3,1893,1502,20
50519351949,50519351945,-4,1423,3061,20
50520092158,50520092157,-1,984,1677,20
50528215802,50528215805,3,1243,1262,20
50533699151,50533699148,-3,647,2132,20
50537199354,50537199352,-2,1348,2750,20
50539123761,50539123758,-3,960,1923,20
50543983750,50543983746,-4,1135,2492,20
50545916136,50545916133,-3,1000,2666,20
50546068940,50546068922,-18,273,1285,20
50546588721,50546588717,-4,1062,1662,20
50548155737,50548155732,-5,970,3181,20
50549338132,50549338129,-3,1032,2503,20
50551845847,50551845843,-4,802,2091,20
50553097521,50553097518,-3,1484,2803,20
50556816411,50556816409,-2,1185,2389,20
50560120922,50560120918,-4,1583,2827,20
50561377374,50561377370,-4,1785,3614,20
50567820026,50567820025,-1,1126,2424,20
50573880396,50573880403,7,37398,43914,20
50574292878,50574292874,-4,811,2288,20
50574600294,50574600287,-7,1190,2554,20
50576941980,50576941978,-2,1219,1901,20
50579990511,50579990509,-2,650,1728,20
50581107547,50581107545,-2,1269,3128,20
50582220675,50582220672,-3,860,1815,20
50584028267,50584028262,-5,1160,2549,20
50589048287,50589048285,-2,1097,2231,20
50590508522,50590508520,-2,959,1712,20
50591784208,50591784207,-1,1425,2150,20
50593029108,50593029104,-4,1074,2657,20
50594054186,50594054189,3,13631,11284,20
50594335261,50594335256,-5,15072,15772,20
50595345250,50595345248,-2,1112,1979,20
50597291970,50597291965,-5,835,2181,20
50603406052,50603406050,-2,1506,2809,20
50604812443,50604812440,-3,833,1832,20
50609396143,50609396138,-5,775,2140,20
50615091430,50615091429,-1,1054,1930,20
50616041939,50616041934,-5,1171,2532,20
50616697675,50616697671,-4,1124,2304,20
50618847958,50618847954,-4,851,1725,20
50620236398,50620236394,-4,1752,3151,20
50621998575,50621998573,-2,1006,1453,20
50624722059,50624722057,-2,1700,2598,20
50625056143,50625056141,-2,933,1985,20
50627127486,50627127484,-2,1387,2599,20
50630805447,50630805446,-1,1285,1833,20
50637778256,50637778254,-2,1708,2231,20
50637869225,50637869227,2,1961,15593,20
50639457943,50639457940,-3,1105,2460,20
50645777674,50645777671,-3,875,2287,20
50653022177,50653022171,-6,619,1638,20
50653070058,50653070055,-3,1266,2477,20
50653492354,50653492350,-4,953,1856,20
50655119238,50655119237,-1,1385,3069,20
50659982485,50659982480,-5,1570,3101,20
50661961319,50661961317,-2,1445,2236,20
50666443400,50666443398,-2,1254,2404,20
50667321765,50667321764,-1,790,1856,20
50668240659,50668240657,-2,1041,2033,20
50668451653,50668451650,-3,1156,2300,20
50669360954,50669360949,-5,776,1570,20
50673083967,50673083964,-3,1769,3217,20
50676583201,50676583197,-4,538,1786,20
50677262677,50677262674,-3,1086,1656,20
50680837792,50680837790,-2,954,2361,20
50683305554,50683305558,4,1972,969,20
50685470511,50685470508,-3,882,2670,20
50695907811,50695907807,-4,1411,2265,20
50701059083,50701059102,19,1050,2716,20
50705499809,50705499790,-19,1235,2548,20
50711579658,50711579656,-2,1735,2795,20
50715657091,50715657087,-4,829,2419,20
50715840708,50715840728,20,347,911,20
50716857094,50716857089,-5,1760,3925,20
50717384796,50717384793,-3,1287,3593,20
50724473543,50724473539,-4,1476,3356,20
50724553221,50724553219,-2,1274,1788,20
50726766114,50726766113,-1,1373,3063,20
50730332394,50730332394,0,2139,1881,20
50731783682,50731783678,-4,1147,2087,20
50732285460,50732285458,-2,985,2091,20
50737948154,50737948151,-3,1083,2193,20
50738089995,50738089993,-2,891,1424,20
50738966308,50738966302,-6,1347,2840,20
50740933553,50740933549,-4,1191,1751,20
50743353338,50743353334,-4,1009,2548,20
50744788953,50744788961,8,1850,2195,20
50746595259,50746595257,-2,820,1501,20
50750883747,50750883743,-4,1137,2095,20
50750980297,50750980293,-4,1476,2963,20
50752802655,50752802650,-5,1520,2644,20
50754472191,50754472189,-2,909,1876,20
50760480399,50760480395,-4,1089,3180,20
50762089425,50762089422,-3,1364,2750,20
50767745777,50767745774,-3,979,2837,20
50769079724,50769079722,-2,1244,1655,20
50769182374,50769182370,-4,1041,2942,20
50771535902,50771535900,-2,1188,2944,20
50776125547,50776125545,-2,1817,1908,20
50777300050,50777300047,-3,1661,2583,20
50778996314,50778996312,-2,1046,2681,20
50779110769,50779110767,-2,1041,2141,20
50781567214,50781567207,-7,475,1579,20
50782360605,50782360606,1,1428,1548,20
50784387485,50784387482,-3,1225,2330,20
50787128802,50787128799,-3,698,2087,20
50791034093,50791034091,-2,2581,3663,20
50793215366,50793215364,-2,928,2394,20
50794802159,50794802158,-1,1168,1432,20
50799269501,50799269499,-2,1257,2867,20
50799996011,50799996008,-3,1304,2526,20
50800264760,50800264757,-3,1264,2161,20
50801472367,50801472363,-4,731,2739,20
50802173586,50802173582,-4,1264,2410,20
50808354591,50808354589,-2,1396,2228,20
50815795926,50815795923,-3,1167,2377,20
50815922192,50815922170,-22,128,1733,20
50817481613,50817481621,8,1796,1193,20
50819432024,50819432019,-5,1253,3792,20
50826369331,50826369327,-4,849,2458,20
50836817570,50836817566,-4,1331,2827,20
50838496827,50838496841,14,1057,1629,20
50841255102,50841255101,-1,1044,3030,20
50843315531,50843315528,-3,710,1386,20
50848147937,50848147938,1,1148,1694,20
50854238471,50854238468,-3,1087,2321,20
50854757496,50854757507,11,5297,1139,20
50858599288,50858599284,-4,2305,7067,20
50860513426,50860513421,-5,1107,2661,20
50866336317,50866336317,0,1389,2010,20
50867489191,50867489187,-4,1321,2501,20
50869946531,50869946529,-2,610,2217,20
50871052891,50871052887,-4,1171,2257,20
50871329215,50871329211,-4,899,2997,20
50871438583,50871438604,21,1208,2295,20
50873110464,50873110462,-2,1755,3460,20
50873416630,50873416627,-3,765,1350,20
50881441380,50881441375,-5,1206,2628,20
50881690590,50881690590,0,821,1184,20
50882404774,50882404779,5,1523,1596,20
50884099960,50884099957,-3,731,2245,20
50884232096,50884232101,5,5011,1870,20
50886707799,50886707797,-2,1340,1911,20
50887296391,50887296386,-5,1019,2302,20
50898539111,50898539108,-3,1256,2042,20
50900951653,50900951649,-4,950,2471,20
50901504399,50901504402,3,169,786,20
50901745551,50901745549,-2,1073,1607,20
50902688414,50902688407,-7,1183,2117,20
50902800085,50902800087,2,2079,1520,20
50903074990,50903074988,-2,909,2908,20
50905191313,50905191310,-3,1375,2858,20
50905630343,50905630340,-3,1002,2239,20
50910654526,50910654523,-3,832,2187,20
50916741485,50916741491,6,3012,1423,20
50920693023,50920693021,-2,958,1996,20
50926250029,50926250030,1,1337,1462,20
50926790797,50926790794,-3,1054,2437,20
50927491262,50927491259,-3,1027,2409,20
50928358243,50928358239,-4,756,2418,20
50929913428,50929913424,-4,994,2066,20
50930026064,50930026079,15,815,1582,20
50932598265,50932598262,-3,1052,2446,20
50932671330,50932671330,0,694,2110,20
50932871318,50932871334,16,1191,1713,20
50933632322,50933632318,-4,818,1530,20
50933687029,50933687027,-2,630,1916,20
50939723974,50939723969,-5,1155,2473,20
50943017735,50943017733,-2,1081,1966,20
50947346637,50947346629,-8,1374,5192,20
50953289056,50953289053,-3,1840,3627,20
50958664925,50958664921,-4,1177,2620,20
50959931991,50959931990,-1,1221,1263,20
50960634715,50960634713,-2,952,1482,20
50960826537,50960826534,-3,1771,2566,20
50964581539,50964581538,-1,882,2685,20
50965029937,50965029937,0,1140,1683,20
50968564118,50968564115,-3,1380,2679,20
50968656950,50968656946,-4,749,1304,20
50970018819,50970018816,-3,1563,2930,20
50970339722,50970339719,-3,911,1763,20
50974368519,50974368526,7,8147,2790,20
50974845570,50974845569,-1,1744,2651,20
50986205411,50986205408,-3,1179,2994,20
50990748114,50990748110,-4,1471,1641,20
50992083890,50992083886,-4,798,1996,20
50992537942,50992537923,-19,284,1114,20
50999306470,50999306466,-4,1137,2371,20
50999366514,50999366511,-3,1556,2218,20
51009175309,51009175304,-5,1164,3350,20
51014026024,51014026022,-2,1407,2066,20
51016140425,51016140421,-4,1505,3563,20
51021958147,51021958145,-2,1298,2153,20
51024164246,51024164242,-4,1488,3046,20
51025586558,51025586573,15,1089,2288,20
51026058104,51026058101,-3,1442,6134,20
51029057528,51029057525,-3,1354,2790,20
51029268652,51029268671,19,55,1217,20
51031353703,51031353699,-4,970,1312,20
51032502787,51032502782,-5,950,3161,20
51039465889,51039465885,-4,1058,1987,20
51039699812,51039699804,-8,208,859,20
51040772780,51040772766,-14,993,2227,20
51041202979,51041202974,-5,1211,3529,20
51041882271,51041882267,-4,1410,2002,20
51042042761,51042042758,-3,809,2201,20
51042394194,51042394190,-4,990,2386,20
51043970997,51043971017,20,1553,2709,20
51048553347,51048553340,-7,710,2709,20
51048612635,51048612640,5,51784,33773,20
51048668868,51048668863,-5,1113,3892,20
51049362879,51049362876,-3,1190,2343,20
51050253344,51050253342,-2,1085,1483,20
51054240403,51054240401,-2,906,1850,20
51054740785,51054740783,-2,1149,2432,20
51057048270,51057048266,-4,1002,2222,20
51061811011,51061811007,-4,1214,2033,20
51065446431,51065446429,-2,983,1215,20
51072160496,51072160495,-1,844,1631,20
51073978175,51073978173,-2,939,1209,20
51075334557,51075334553,-4,1346,2641,20
51077999385,51077999382,-3,1126,1890,20
51078498878,51078498874,-4,963,1898,20
51079715926,51079715925,-1,1533,2871,20
51080974757,51080974754,-3,1228,2579,20
51081986331,51081986330,-1,1329,2975,20
51083556406,51083556406,0,1174,2260,20
51087286403,51087286401,-2,1142,2427,20
51087573690,51087573686,-4,1341,2416,20
51089726715,51089726710,-5,676,958,20
51094483406,51094483403,-3,789,2103,20
51098647054,51098647050,-4,1135,2162,20
51101624443,51101624441,-2,635,1173,20
51104072026,51104072025,-1,1068,1950,20
51107466695,51107466691,-4,1142,3110,20
51108343377,51108343374,-3,1182,1889,20
51108681743,51108681742,-1,1052,2100,20
51110082662,51110082659,-3,1917,2539,20
51113125634,51113125631,-3,809,2716,20
51121059070,51121059067,-3,1115,2621,20
51121116242,51121116238,-4,818,2115,20
51122253239,51122253221,-18,186,683,20
51122715421,51122715417,-4,1060,2088,20
51123347655,51123347674,19,1675,2251,20
51123890539,51123890538,-1,925,1176,20
51125694830,51125694825,-5,1133,2266,20
51126848009,51126848005,-4,996,1523,20
51133987855,51133987851,-4,1466,2354,20
51136710134,51136710130,-4,1143,2018,20
51138903915,51138903912,-3,987,2170,20
51139354359,51139354358,-1,1870,1634,20
51139845203,51139845207,4,3700,1316,20
51142679166,51142679161,-5,1380,2631,20
51144145791,51144145797,6,3063,1442,20
51149198645,51149198643,-2,1275,1791,20
51153184054,51153184050,-4,1100,2382,20
51157234763,51157234760,-3,2162,4709,20
51157841996,51157841994,-2,1239,2115,20
51163684961,51163684956,-5,918,1651,20
51165229775,51165229772,-3,1128,2730,20
51165929397,51165929384,-13,1134,2014,20
51168967421,51168967415,-6,2943,8646,20
51172156697,51172156694,-3,1497,3217,20
51172183910,51172183905,-5,986,2174,20
51172467712,51172467731,19,972,2120,20
51174100298,51174100295,-3,1420,2978,20
51184659709,51184659707,-2,890,1670,20
51186644028,51186644026,-2,1249,2026,20
51192579467,51192579465,-2,1026,2192,20
51192757136,51192757118,-18,124,3021,20
51192903125,51192903109,-16,1375,2149,20
51198720772,51198720768,-4,5457,13216,20
51204475832,51204475829,-3,1220,1904,20
51205541545,51205541539,-6,985,4218,20
51211208307,51211208305,-2,675,1731,20
51218876798,51218876797,-1,1008,1999,20
51220966959,51220966958,-1,1090,1716,20
51225416647,51225416645,-2,1327,2258,20
51233572070,51233572066,-4,1387,3330,20
51235068405,51235068401,-4,829,1953,20
51236458258,51236458254,-4,1009,2377,20
51238533558,51238533574,16,110,617,20
51242111050,51242111045,-5,1149,3873,20
51245758320,51245758322,2,1376,1262,20
51246792229,51246792227,-2,1464,3217,20
51247583247,51247583243,-4,761,1489,20
51247966757,51247966754,-3,1393,2012,20
51250822606,51250822605,-1,905,1952,20
51253260131,51253260137,6,3441,1432,20
51261872586,51261872582,-4,1599,2962,20
51263068497,51263068492,-5,966,2104,20
51264216850,51264216843,-7,1017,4040,20
51265978846,51265978847,1,2079,2235,20
51267988449,51267988446,-3,890,2795,20
51268367014,51268367011,-3,1295,1860,20
51269774730,51269774726,-4,1283,3467,20
51270600078,51270600075,-3,1229,2263,20
51273271790,51273271787,-3,1276,2653,20
51274298275,51274298270,-5,899,3016,20
51281922599,51281922597,-2,937,2709,20
51282763024,51282763042,18,798,2100,20
51282824039,51282824036,-3,1376,2566,20
51285666027,51285666025,-2,1223,2247,20
51286099935,51286099931,-4,1305,3562,20
51286557213,51286557220,7,4158,1800,20
51287215055,51287215054,-1,1197,2862,20
51288491630,51288491627,-3,897,2508,20
51289043634,51289043629,-5,1031,2044,20
51296906709,51296906706,-3,1034,1675,20
51299296886,51299296886,0,1065,1792,20
51300044871,51300044869,-2,593,1524,20
51301347005,51301347002,-3,1153,3006,20
51304267024,51304267022,-2,1122,2748,20
51304435977,51304435973,-4,2392,6031,20
51310648671,51310648667,-4,1484,2947,20
51313001197,51313001194,-3,1052,2015,20
51313510934,51313510930,-4,1070,3164,20
51317658275,51317658274,-1,1077,2168,20
51318661409,51318661407,-2,1020,1800,20
51321297656,51321297651,-5,1138,2435,20
51322508585,51322508590,5,2414,1602,20
51324295244,51324295242,-2,1118,2610,20
51325568713,51325568701,-12,3818,22698,20
51327553726,51327553722,-4,1074,2954,20
51327728531,51327728529,-2,1350,2851,20
51329377038,51329377038,0,1682,1921,20
51329827498,51329827497,-1,811,1208,20
51331182391,51331182385,-6,913,1205,20
51337231964,51337231944,-20,1606,1471,20
51347628859,51347628854,-5,1037,1654,20
51349212914,51349212914,0,1343,1402,20
51349864139,51349864136,-3,971,1661,20
51352010081,51352010078,-3,981,2288,20
51353166579,51353166576,-3,1468,2392,20
51353848938,51353848937,-1,1020,2910,20
51363742783,51363742780,-3,812,2573,20
51371186942,51371186939,-3,886,1499,20
51372848095,51372848093,-2,975,1733,20
51378028130,51378028127,-3,1216,2348,20
51378336887,51378336885,-2,1091,2147,20
51379293583,51379293580,-3,1245,2367,20
51380564235,51380564234,-1,1138,1859,20
51382088434,51382088432,-2,1026,2049,20
51384456967,51384456964,-3,996,1575,20
51386112913,51386112911,-2,14248,20922,20
51386861419,51386861417,-2,1005,2113,20
51389007791,51389007787,-4,1236,2368,20
51389984650,51389984649,-1,741,2072,20
51393326940,51393326937,-3,1112,3136,20
51397672919,51397672915,-4,1101,1959,20
51403542037,51403542034,-3,1351,2903,20
51403981788,51403981776,-12,1125,1550,20
51404794693,51404794712,19,795,2619,20
51405489300,51405489301,1,1348,1386,20
51406628175,51406628195,20,868,1200,20
51406746136,51406746141,5,1949,1841,20
51408806873,51408806877,4,10945,35830,20
51411821733,51411821730,-3,1519,2481,20
51414013598,51414013596,-2,998,2000,20
51418006828,51418006822,-6,1461,6783,20
51428065630,51428065628,-2,1235,2639,20
51429600907,51429600901,-6,1165,3682,20
51430124229,51430124229,0,971,1086,20
51430985119,51430985118,-1,1582,3345,20
51431186001,51431186000,-1,1139,2418,20
51434462783,51434462778,-5,1227,2625,20
51435072043,51435072042,-1,955,1912,20
51435907853,51435907850,-3,1462,2633,20
51436690180,51436690172,-8,801,1544,20
51438592259,51438592257,-2,1195,2594,20
51440577812,51440577806,-6,30417,12556,20
51440894219,51440894213,-6,804,2903,20
51451173947,51451173946,-1,1081,2174,20
51458421063,51458421060,-3,1039,2852,20
51463446854,51463446851,-3,687,1382,20
51470628327,51470628320,-7,848,2296,20
51471224158,51471224153,-5,1020,2182,20
51471361796,51471361793,-3,1089,782,20
51474137627,51474137623,-4,965,2099,20
51474770499,51474770498,-1,1619,2012,20
51478952658,51478952656,-2,1331,2247,20
51481338513,51481338508,-5,1862,3384,20
51482274205,51482274202,-3,1332,2302,20
51485576479,51485576478,-1,1483,2284,20
51490725697,51490725695,-2,1014,2001,20
51491630350,51491630346,-4,963,1676,20
51491863345,51491863354,9,15180,13142,20
51495120042,51495120040,-2,1544,2168,20
51495369070,51495369066,-4,1120,1759,20
51498774302,51498774300,-2,1124,1535,20
51501597511,51501597509,-2,1194,1928,20
51508836832,51508836834,2,1612,1603,20
51512321923,51512321917,-6,938,4334,20
51516711228,51516711225,-3,1275,2966,20
51519635749,51519635746,-3,797,2450,20
51521331455,51521331434,-21,462,424,20
51526439043,51526439040,-3,1051,2315,20
51526522513,51526522510,-3,1079,2082,20
51534041722,51534041718,-4,1128,2832,20
51536149421,51536149440,19,869,2111,20
51537719850,51537719847,-3,1173,3088,20
51538631555,51538631554,-1,1240,1842,20
51540305503,51540305497,-6,1127,3905,20
51541112523,51541112520,-3,1080,2787,20
51541261497,51541261495,-2,1028,2474,20
51547022511,51547022509,-2,1222,1960,20
51547948710,51547948707,-3,1842,2468,20
51548763071,51548763077,6,2741,1573,20
51550996987,51550996985,-2,1190,2981,20
51567301049,51567301051,2,1640,1146,20
51573069529,51573069526,-3,1129,2943,20
51574640154,51574640150,-4,981,1635,20
51576230611,51576230608,-3,926,2171,20
51576608389,51576608378,-11,1067,2595,20
51577485014,51577485018,4,1702,1532,20
51581242930,51581242923,-7,999,3933,20
51584453333,51584453330,-3,932,2552,20
51589425465,51589425462,-3,1797,2803,20
51597222854,51597222853,-1,1364,1592,20
51597711964,51597711961,-3,1882,3337,20
51597779695,51597779694,-1,1252,1826,20
51605903567,51605903563,-4,838,2438,20
51610739089,51610739086,-3,1582,3064,20
51619628875,51619628870,-5,1163,2574,20
51629605270,51629605266,-4,1610,2669,20
51630052282,51630052279,-3,1485,3062,20
51630148942,51630148938,-4,965,3165,20
51630282310,51630282289,-21,507,798,20
51633037363,51633037360,-3,931,3034,20
51636242955,51636242951,-4,1341,3023,20
51639153238,51639153235,-3,1422,2347,20
51640382464,51640382470,6,1437,583,20
51646557807,51646557802,-5,1121,2140,20
51648183711,51648183709,-2,1122,2494,20
51649107686,51649107683,-3,1370,3564,20
51652996374,51652996373,-1,1708,2749,20
51657034414,51657034414,0,24479,26288,20
51661376658,51661376654,-4,1057,2147,20
51662723404,51662723402,-2,1081,2449,20
51665292490,51665292486,-4,1371,2180,20
51668907067,51668907062,-5,1027,2654,20
51669043599,51669043595,-4,1111,2953,20
51669132299,51669132297,-2,1364,2860,20
51676455777,51676455787,10,7648,35521,20
51682915587,51682915585,-2,806,2547,20
51683409062,51683409060,-2,1029,2249,20
51683858507,51683858504,-3,884,2249,20
51687004086,51687004082,-4,1143,2578,20
51695506349,51695506347,-2,955,2425,20
51698798652,51698798655,3,1634,1653,20
51709973899,51709973898,-1,1121,1633,20
51710259100,51710259094,-6,815,1749,20
51710674423,51710674438,15,440,2456,20
51711612331,51711612330,-1,1264,1882,20
51718096887,51718096886,-1,1345,2366,20
51718229063,51718229066,3,1170,993,20
51721440082,51721440082,0,1415,2242,20
51722914499,51722914499,0,1641,2223,20
51723550110,51723550098,-12,32538,14346,20
51724527882,51724527881,-1,1199,2400,20
51725930009,51725930007,-2,1342,2042,20
51728372550,51728372547,-3,1031,1730,20
51733947213,51733947210,-3,1311,2071,20
51742210439,51742210434,-5,1121,2745,20
51743191870,51743191869,-1,1137,1300,20
51748377372,51748377370,-2,1177,2258,20
51750462159,51750462156,-3,1326,2547,20
51750731922,51750731919,-3,1099,2136,20
51755103667,51755103665,-2,1098,1767,20
51758343936,51758343934,-2,1161,2626,20
51758554577,51758554573,-4,1273,1589,20
51762690826,51762690824,-2,1566,1823,20
51763356424,51763356423,-1,1212,1997,20
51763748030,51763748045,15,336,968,20
51764007815,51764007813,-2,1095,2969,20
51764688874,51764688871,-3,1183,2257,20
51767182131,51767182129,-2,2768,14639,20
51768287825,51768287822,-3,1102,2938,20
51770327235,51770327234,-1,1108,1974,20
51772019378,51772019374,-4,904,2123,20
51774296470,51774296466,-4,923,1984,20
51775057849,51775057849,0,1271,2121,20
51776755118,51776755114,-4,1042,2803,20
51777227514,51777227510,-4,1086,1845,20
51778234675,51778234672,-3,920,1552,20
51778431027,51778431031,4,1634,24335,20
51787612553,51787612551,-2,584,1186,20
51787914175,51787914172,-3,1098,2116,20
51788039188,51788039185,-3,1095,2230,20
51790828165,51790828162,-3,1470,2930,20
51795861851,51795861851,0,1356,2169,20
51797704243,51797704241,-2,910,1725,20
51799570395,51799570393,-2,1192,2171,20
51812740254,51812740250,-4,1288,2426,20
51812851640,51812851659,19,1045,1904,20
51814813977,51814813973,-4,541,1150,20
51815498830,51815498830,0,992,1675,20
51818824946,51818824941,-5,905,2421,20
51823751307,51823751298,-9,853,3180,20
51826439587,51826439582,-5,787,2137,20
51835724923,51835724922,-1,887,1610,20
51838351088,51838351086,-2,1658,3162,20
51840376781,51840376762,-19,938,997,20
51841508993,51841508993,0,1484,2070,20
51844390413,51844390414,1,1160,1561,20
51851360942,51851360939,-3,1131,2171,20
51853162759,51853162767,8,3655,1190,20
51857405245,51857405242,-3,1118,3123,20
51859151526,51859151522,-4,1202,3234,20
51860014530,51860014532,2,4193,19876,20
51860699295,51860699294,-1,1986,1498,20
51861603747,51861603743,-4,1126,2545,20
51862273625,51862273622,-3,1061,3705,20
51864133191,51864133191,0,1538,865,20
51867444680,51867444677,-3,1477,2807,20
51867839437,51867839434,-3,1332,3624,20
51876906702,51876906701,-1,1185,2060,20
51877537051,51877537048,-3,966,2074,20
51877917428,51877917424,-4,1672,3463,20
51878093027,51878093023,-4,941,1439,20
51878790009,51878790007,-2,1323,3144,20
51881456719,51881456721,2,2043,1465,20
51891483930,51891483933,3,2246,1470,20
51892466054,51892466050,-4,1345,2389,20
51892846595,51892846590,-5,994,3014,20
51899281739,51899281736,-3,844,2491,20
51899555892,51899555890,-2,1123,1722,20
51900422138,51900422142,4,1465,1431,20
51910466511,51910466509,-2,1135,2251,20
51910561098,51910561094,-4,580,621,20
51912332959,51912332956,-3,1448,4143,20
51913450238,51913450235,-3,1067,1710,20
51923949075,51923949071,-4,841,2720,20
51924970413,51924970411,-2,855,1377,20
51929806687,51929806686,-1,1307,1731,20
51934530671,51934530667,-4,851,2181,20
51934753323,51934753321,-2,1047,2176,20
51935603965,51935603962,-3,1258,2480,20
51940592798,51940592803,5,3691,2051,20
51948055250,51948055248,-2,988,1969,20
51953594402,51953594407,5,2043,1351,20
51955316464,51955316461,-3,1157,2186,20
51957183252,51957183248,-4,1290,1969,20
51958243258,51958243254,-4,953,1571,20
51960573417,51960573413,-4,566,2052,20
51962023820,51962023815,-5,1423,2999,20
51964151535,51964151533,-2,707,1669,20
51974616244,51974616240,-4,1211,1868,20
51975858707,51975858702,-5,977,3748,20
51982348643,51982348638,-5,1188,2161,20
51983311245,51983311245,0,547,1942,20
51986073902,51986073900,-2,1218,1729,20
51987239120,51987239118,-2,1247,2124,20
51988534422,51988534421,-1,911,2283,20
51989201834,51989201830,-4,1162,1875,20
51995596132,51995596130,-2,1751,2286,20
51995742701,51995742695,-6,1512,3142,20
51995880299,51995880295,-4,951,2286,20
52000115651,52000115645,-6,1057,3146,20
52002919549,52002919545,-4,1195,2099,20
52003285099,52003285096,-3,1101,2259,20
52003745121,52003745122,1,945,1690,20
52007980151,52007980148,-3,1450,1664,20
52010509086,52010509084,-2,1125,2357,20
52010667176,52010667172,-4,1100,2409,20
52011349720,52011349718,-2,884,1864,20
52011864828,52011864809,-19,1279,2370,20
52013577358,52013577354,-4,1185,2059,20
52014836858,52014836854,-4,776,1762,20
52021439514,52021439511,-3,1469,3183,20
52025040385,52025040395,10,12231,38902,20
52030390397,52030390394,-3,1324,2402,20
52035734346,52035734342,-4,1223,2084,20
52044640256,52044640249,-7,1969,8183,20
52046803085,52046803085,0,1350,2024,20
52049591051,52049591049,-2,1126,2046,20
52052290980,52052290976,-4,756,1959,20
52059055017,52059055022,5,3609,1364,20
52060196675,52060196671,-4,844,2030,20
52063310091,52063310087,-4,1415,2769,20
52064106858,52064106854,-4,842,1361,20
52066658330,52066658327,-3,967,1635,20
52067413126,52067413123,-3,974,1845,20
52070380858,52070380857,-1,1710,1745,20
52070457546,52070457542,-4,1105,1965,20
52071449831,52071449830,-1,988,1697,20
52073433745,52073433750,5,1867,660,20
52077029772,52077029770,-2,1326,2463,20
52077068518,52077068517,-1,1086,2543,20
52077228242,52077228240,-2,1111,2918,20
52084810957,52084810954,-3,1437,3023,20
52085735846,52085735842,-4,1310,3566,20
52085858874,52085858878,4,1971,1203,20
52089872327,52089872323,-4,1224,1982,20
52090288137,52090288134,-3,868,3251,20
52093772473,52093772468,-5,956,3571,20
52094188942,52094188939,-3,1087,1497,20
52099988597,52099988594,-3,1243,2197,20
52103966794,52103966792,-2,2042,1743,20
52106307105,52106307098,-7,1055,4636,20
52109948570,52109948567,-3,1312,1921,20
52110698770,52110698766,-4,1040,2863,20
52111662919,52111662910,-9,906,2924,20
52112795068,52112795056,-12,1078,2842,20
52113858102,52113858097,-5,1164,3319,20
52114025261,52114025247,-14,1306,2146,20
52115959754,52115959750,-4,935,2030,20
52119309679,52119309687,8,871,1472,20
52120678859,52120678854,-5,1801,2529,20
52120735737,52120735737,0,850,1040,20
52124426145,52124426141,-4,762,1540,20
52126407271,52126407269,-2,1380,2866,20
52126890622,52126890628,6,3014,1278,20
52128202146,52128202143,-3,1186,1918,20
52141568019,52141568017,-2,1049,1965,20
52142430034,52142430033,-1,515,1064,20
52143740887,52143740895,8,2217,963,20
52143965801,52143965794,-7,1312,2307,20
52146088387,52146088382,-5,879,2048,20
52147031270,52147031269,-1,772,1168,20
52150426263,52150426257,-6,790,1992,20
52150902108,52150902105,-3,85,1078,20
52152892264,52152892259,-5,1799,5953,20
52156232407,52156232407,0,765,1361,20
52156281677,52156281667,-10,973,1314,20
52159541105,52159541099,-6,709,2562,20
52162145137,52162145133,-4,1135,2062,20
52174913712,52174913709,-3,879,2441,20
52178919402,52178919398,-4,1027,2389,20
52180712843,52180712840,-3,1286,4102,20
52185212342,52185212339,-3,1841,3441,20
52185321115,52185321111,-4,1414,3198,20
52185666376,52185666376,0,2996,3069,20
52190078236,52190078234,-2,1265,2400,20
52193903947,52193903941,-6,877,2195,20
52195490529,52195490526,-3,1325,2367,20
52195596055,52195596033,-22,1124,2449,20
52197669784,52197669778,-6,1064,3772,20
52203855885,52203855883,-2,1447,1894,20
52205897502,52205897498,-4,1035,2583,20
52217044922,52217044918,-4,1360,2404,20
52219750993,52219750990,-3,1084,1405,20
52220532645,52220532643,-2,1020,2143,20
52230370181,52230370177,-4,1416,2344,20
52234272147,52234272155,8,5654,1826,20
52239236647,52239236645,-2,1146,2041,20
52240160968,52240160965,-3,1514,2608,20
52240394318,52240394314,-4,914,2415,20
52244052131,52244052129,-2,1419,2751,20
52245329270,52245329266,-4,1559,1540,20
52245984417,52245984421,4,1083,845,20
52250424151,52250424151,0,823,1948,20
52253770256,52253770273,17,1138,3141,20
52254286631,52254286625,-6,147,724,20
52258271437,52258271434,-3,838,1479,20
52263349224,52263349226,2,2213,997,20
52263999796,52263999790,-6,1235,2506,20
52264299004,52264299021,17,579,2684,20
52268321506,52268321502,-4,1153,1499,20
52277605306,52277605302,-4,1044,2859,20
52279066783,52279066782,-1,1209,3180,20
52280892667,52280892663,-4,1059,2309,20
52281107098,52281107103,5,2560,1692,20
52283593860,52283593858,-2,1168,2553,20
52284097295,52284097295,0,950,1724,20
52287355661,52287355658,-3,1172,1821,20
52288086944,52288086941,-3,995,1398,20
52288302354,52288302349,-5,1158,2488,20
52288578343,52288578342,-1,2305,3229,20
52299422798,52299422795,-3,967,1053,20
52304828750,52304828747,-3,1375,1687,20
52306084830,52306084830,0,1010,2012,20
52314593790,52314593784,-6,891,1648,20
52315943289,52315943286,-3,825,1422,20
52316785568,52316785587,19,1052,2951,20
52319819463,52319819462,-1,855,2157,20
52323701233,52323701229,-4,1318,2129,20
52325125459,52325125453,-6,934,4652,20
52325332854,52325332851,-3,1499,3207,20
52328868294,52328868293,-1,1055,2265,20
52331251975,52331251973,-2,698,910,20
52333530731,52333530722,-9,6332,17100,20
52334295122,52334295117,-5,1373,2026,20
52338367090,52338367085,-5,1425,2661,20
52341307698,52341307695,-3,986,2380,20
52343165445,52343165444,-1,625,2108,20
52345870399,52345870402,3,4310,2392,20
52346522154,52346522152,-2,1827,2306,20
52350244690,52350244686,-4,901,1599,20
52353757920,52353757917,-3,826,1703,20
52357250607,52357250609,2,1957,1852,20
52364030378,52364030376,-2,1005,1971,20
52364904423,52364904420,-3,1199,2612,20
52365858017,52365858014,-3,1156,2222,20
52368045493,52368045490,-3,1360,3192,20
52369663746,52369663743,-3,1081,2198,20
52371538557,52371538554,-3,663,1548,20
52379400667,52379400668,1,1083,2232,20
52386961001,52386960998,-3,1056,2475,20
52387502178,52387502174,-4,711,1172,20
52392232723,52392232725,2,2006,1218,20
52393037990,52393037987,-3,1081,2767,20
52394541982,52394542002,20,1226,2671,20
52395873794,52395873790,-4,888,2242,20
52397038391,52397038409,18,112,944,20
52397707387,52397707385,-2,1546,3097,20
52398442239,52398442237,-2,1161,2771,20
52399481565,52399481566,1,877,1302,20
52399983540,52399983545,5,6135,26706,20
52400204730,52400204728,-2,1668,2429,20
52400270529,52400270525,-4,789,2736,20
52401287744,52401287741,-3,1462,2115,20
52402081716,52402081711,-5,1576,2759,20
52402116590,52402116609,19,887,2278,20
52403511815,52403511812,-3,1349,2755,20
52403979283,52403979281,-2,1466,2522,20
52405434067,52405434064,-3,1422,2710,20
52405514878,52405514877,-1,1127,1704,20
52405584942,52405584937,-5,949,2051,20
52408771115,52408771115,0,1620,1918,20
52414855451,52414855449,-2,1031,1812,20
52420629651,52420629650,-1,933,1843,20
52422588498,52422588499,1,897,2258,20
52422919311,52422919308,-3,1506,2260,20
52424497211,52424497208,-3,1436,3171,20
52432009914,52432009911,-3,959,2442,20
52433544254,52433544251,-3,880,2119,20
52434670159,52434670158,-1,1258,2037,20
52437994150,52437994149,-1,1193,2150,20
52438599910,52438599911,1,1021,952,20
52444563639,52444563636,-3,1612,1873,20
52445093269,52445093262,-7,1476,6043,20
52447381938,52447381949,11,14586,52486,20
52448087645,52448087642,-3,862,1932,20
52454411335,52454411333,-2,1102,2114,20
52456819259,52456819259,0,1234,2118,20
52457675648,52457675645,-3,1053,2082,20
52458808242,52458808239,-3,679,1255,20
52467045486,52467045482,-4,1253,2229,20
52468072552,52468072547,-5,1357,2340,20
52468110110,52468110131,21,1388,1930,20
52469401968,52469401966,-2,1160,2599,20
52469738372,52469738365,-7,308,1004,20
52470908710,52470908707,-3,1228,2607,20
52472344356,52472344374,18,427,1346,20
52472527089,52472527089,0,1385,1652,20
52474121760,52474121756,-4,1526,3213,20
52477017119,52477017117,-2,1051,3024,20
52480453629,52480453627,-2,979,2044,20
52486282419,52486282415,-4,957,2051,20
52488881547,52488881545,-2,1434,1923,20
52489445985,52489445981,-4,1210,2372,20
52493069775,52493069771,-4,1124,1941,20
52498623483,52498623483,0,1204,1315,20
52498823242,52498823236,-6,1019,2654,20
52498870791,52498870790,-1,1167,1230,20
52499301850,52499301868,18,1044,2589,20
52500260566,52500260563,-3,1008,1837,20
52500624381,52500624369,-12,1182,2903,20
52503624147,52503624146,-1,920,2025,20
52507804339,52507804336,-3,1145,2463,20
52508654311,52508654307,-4,886,1899,20
52512090409,52512090405,-4,1032,2885,20
52512843293,52512843290,-3,1036,1734,20
52514712809,52514712805,-4,1006,3050,20
52516465809,52516465805,-4,1503,3129,20
52529223667,52529223665,-2,1580,1991,20
52532209824,52532209820,-4,1192,2052,20
52540891379,52540891374,-5,784,2514,20
52541041138,52541041135,-3,1079,2507,20
52541572218,52541572215,-3,1270,1877,20
52549038919,52549038917,-2,1766,2464,20
52551867756,52551867752,-4,1258,2767,20
52556180063,52556180059,-4,1079,2192,20
52556753832,52556753846,14,1324,2903,20
52559810283,52559810289,6,2470,1377,20
52568270702,52568270701,-1,17250,20019,20
52568956121,52568956122,1,1374,1323,20
52570475918,52570475921,3,3841,3089,20
52572906033,52572906034,1,1474,2258,20
52573913379,52573913375,-4,651,1593,20
52576074332,52576074328,-4,1071,2030,20
52577119175,52577119159,-16,849,1343,20
52581633024,52581633022,-2,1345,2034,20
52586309338,52586309336,-2,1045,2821,20
52587350891,52587350890,-1,3023,4129,20
52589313315,52589313312,-3,833,2014,20
52592342357,52592342362,5,2481,1286,20
52593028965,52593028963,-2,987,909,20
52597233122,52597233119,-3,1004,2478,20
52600655629,52600655627,-2,1695,2380,20
52603517902,52603517898,-4,857,1823,20
52604986068,52604986064,-4,1074,1626,20
52605775995,52605775993,-2,4866,7947,20
52606583798,52606583795,-3,1379,1945,20
52607082051,52607082046,-5,1047,2535,20
52608479670,52608479675,5,1501,1096,20
52612462815,52612462810,-5,1150,3824,20
52626017230,52626017226,-4,1206,2099,20
52629105629,52629105630,1,1166,2498,20
52629476591,52629476590,-1,940,1261,20
52630432726,52630432724,-2,1441,3343,20
52630728663,52630728659,-4,1191,2526,20
52631044683,52631044677,-6,548,1621,20
52635317245,52635317242,-3,1328,3079,20
52635916942,52635916941,-1,1048,2351,20
52638145866,52638145865,-1,694,2251,20
52639718628,52639718625,-3,1826,3707,20
52648975871,52648975867,-4,15867,28127,20
52651195968,52651195966,-2,1359,2637,20
52654217683,52654217680,-3,1066,2575,20
52655233430,52655233425,-5,1143,2702,20
52662054150,52662054146,-4,1181,2925,20
52662788634,52662788630,-4,1198,2208,20
52670564916,52670564912,-4,1234,3133,20
52672399485,52672399482,-3,1322,3085,20
52674753205,52674753209,4,1406,1043,20
52676095227,52676095222,-5,809,1271,20
52677987966,52677987964,-2,1190,1792,20
52682220091,52682220087,-4,798,2518,20
52686864585,52686864582,-3,1163,3357,20
52695223743,52695223741,-2,715,2422,20
52695253005,52695253001,-4,1080,2200,20
52696521166,52696521163,-3,1204,2822,20
52698343430,52698343427,-3,991,2139,20
52699478218,52699478217,-1,873,1619,20
52702066771,52702066768,-3,1258,1910,20
52710609865,52710609865,0,1186,972,20
52712077641,52712077638,-3,1132,2988,20
52724216958,52724216962,4,1393,1178,20
52725593269,52725593261,-8,983,2070,20
52726057400,52726057398,-2,820,1964,20
52727323121,52727323121,0,1415,2188,20
52727923229,52727923226,-3,841,2777,20
52728261249,52728261246,-3,966,2581,20
52729603142,52729603141,-1,1312,1511,20
52730448175,52730448172,-3,1307,2053,20
52730857171,52730857167,-4,1516,3496,20
52731462688,52731462693,5,92,569,20
52734679007,52734679005,-2,631,1077,20
52736625378,52736625374,-4,1027,2336,20
52737173464,52737173468,4,80,415,20
52739764721,52739764718,-3,581,1230,20
52740100767,52740100765,-2,1121,1980,20
52741270857,52741270853,-4,1189,1971,20
52747251363,52747251359,-4,1342,2264,20
52754801698,52754801691,-7,534,1362,20
52755431272,52755431269,-3,874,2339,20
52756118643,52756118639,-4,1530,3195,20
52756948432,52756948429,-3,924,1374,20
52757201702,52757201701,-1,1099,1832,20
52757242764,52757242787,23,585,1047,20
52760873454,52760873451,-3,1108,2274,20
52761201750,52761201738,-12,229,746,20
52762805406,52762805403,-3,775,1967,20
52769733529,52769733525,-4,836,1807,20
52774277447,52774277442,-5,1082,3230,20
52778250739,52778250733,-6,739,3572,20
52778367573,52778367569,-4,1519,3024,20
52784224559,52784224558,-1,1064,1813,20
52784763974,52784763969,-5,1239,1919,20
52785077163,52785077162,-1,1705,2665,20
52790265786,52790265784,-2,1135,3705,20
52791042588,52791042609,21,398,1286,20
52791928938,52791928935,-3,772,1544,20
52792873681,52792873679,-2,1146,2842,20
52793217589,52793217586,-3,884,3187,20
52793960073,52793960066,-7,996,2307,20
52794621294,52794621286,-8,1134,2712,20
52795793199,52795793198,-1,1008,1579,20
52797019303,52797019296,-7,1085,2651,20
52801043738,52801043735,-3,804,1770,20
52801208046,52801208045,-1,1249,2548,20
52802063269,52802063267,-2,827,1182,20
52802247745,52802247747,2,1807,2003,20
52807714661,52807714660,-1,901,1956,20
52810665179,52810665174,-5,1272,2851,20
52810918289,52810918285,-4,1461,3251,20
52812646485,52812646487,2,1455,846,20
52813823802,52813823794,-8,1078,8736,20
52821139537,52821139534,-3,849,1617,20
52821422516,52821422501,-15,1620,1624,20
52825229815,52825229811,-4,846,1525,20
52825622230,52825622229,-1,1135,1781,20
52827446979,52827446977,-2,1359,2062,20
52828930681,52828930679,-2,1250,2487,20
52829845241,52829845236,-5,1568,2991,20
52831327722,52831327719,-3,1073,2709,20
52831690870,52831690865,-5,1447,3040,20
52833132662,52833132662,0,1406,2275,20
52834060182,52834060179,-3,818,2127,20
52837622154,52837622156,2,3313,2842,20
52841706335,52841706338,3,10359,7508,20
52842294326,52842294323,-3,1084,1914,20
52844185436,52844185452,16,1122,2158,20
52855239776,52855239777,1,17300,17085,20
52858729746,52858729742,-4,752,3089,20
52859421688,52859421678,-10,1360,2500,20
52862061162,52862061159,-3,1332,2083,20
52866402611,52866402609,-2,1085,1942,20
52867309614,52867309612,-2,1127,2739,20
52870855853,52870855850,-3,1169,1977,20
52872413166,52872413163,-3,1326,2492,20
52872998754,52872998751,-3,1629,2806,20
52875262559,52875262556,-3,1625,2676,20
52877306739,52877306738,-1,1056,1245,20
52878829459,52878829454,-5,944,2472,20
52881014523,52881014519,-4,1127,2339,20
52887796673,52887796670,-3,1124,2134,20
52888237091,52888237089,-2,979,1991,20
52889845223,52889845221,-2,2069,3614,20
52890894024,52890894022,-2,1014,2381,20
52895166923,52895166919,-4,1076,2404,20
52896912737,52896912754,17,1021,48,20
52900156571,52900156568,-3,1025,3405,20
52901209135,52901209131,-4,1076,2048,20
52902259637,52902259625,-12,1277,2234,20
52908245705,52908245710,5,6860,2710,20
52912656821,52912656817,-4,897,1987,20
52914393140,52914393133,-7,1183,5010,20
52914639596,52914639581,-15,194,1074,20
52918911002,52918910998,-4,1438,2876,20
52921867043,52921867039,-4,1044,2416,20
52922067135,52922067131,-4,1099,3028,20
52926788968,52926788966,-2,2852,3999,20
52927323193,52927323193,0,1014,2331,20
52931922566,52931922567,1,1213,1550,20
52935760139,52935760136,-3,867,2655,20
52942687271,52942687270,-1,1066,1652,20
52943034209,52943034208,-1,1985,2391,20
52944997849,52944997845,-4,1226,2513,20
52947733058,52947733056,-2,790,2265,20
52947864116,52947864132,16,293,1405,20
52953726183,52953726183,0,1209,1646,20
52954799795,52954799794,-1,1208,2397,20
52958487778,52958487785,7,6164,2042,20
52959620005,52959619998,-7,591,2450,20
52961119866,52961119865,-1,706,2165,20
52966902974,52966902973,-1,1007,2619,20
52970202884,52970202878,-6,3415,11257,20
52973817396,52973817390,-6,556,1323,20
52976403947,52976403945,-2,688,2733,20
52976485482,52976485489,7,1812,1185,20
52980159659,52980159660,1,2569,2646,20
52988075639,52988075638,-1,915,1116,20
52988884379,52988884386,7,1739,813,20
52995414069,52995414066,-3,1329,2984,20
53000149642,53000149641,-1,809,1752,20
53003072396,53003072404,8,2037,1036,20
53003890782,53003890783,1,1742,1762,20
53004529477,53004529477,0,1849,2082,20
53005982996,53005982994,-2,1203,2134,20
53008973882,53008973878,-4,948,2093,20
53014883177,53014883175,-2,1046,2275,20
53015476379,53015476376,-3,1486,3228,20
53021122143,53021122141,-2,767,1610,20
53022822131,53022822129,-2,1211,1906,20
53026724426,53026724424,-2,1436,2561,20
53026804110,53026804107,-3,966,1925,20
53033369894,53033369892,-2,1182,1727,20
53033799854,53033799852,-2,1487,2353,20
53034045352,53034045370,18,231,801,20
53040425526,53040425525,-1,916,1824,20
53046542599,53046542597,-2,928,1541,20
53052317407,53052317401,-6,1233,3500,20
53052542186,53052542192,6,13412,21634,20
53056441576,53056441583,7,10593,28144,20
53056771899,53056771895,-4,1081,2505,20
53057371651,53057371649,-2,1325,2414,20
53060187441,53060187443,2,1543,1650,20
53060704919,53060704917,-2,1307,2465,20
53064798646,53064798643,-3,762,1914,20
53065021248,53065021245,-3,1153,2810,20
53068610546,53068610541,-5,1182,3259,20
53068834474,53068834479,5,985,1042,20
53075690821,53075690817,-4,1381,3462,20
53076856673,53076856673,0,1280,2211,20
53077057581,53077057578,-3,1071,2415,20
53077981590,53077981585,-5,1301,2615,20
53078274266,53078274261,-5,1242,2956,20
53078818831,53078818828,-3,1059,2386,20
53080381464,53080381462,-2,1303,1983,20
53081121165,53081121185,20,548,1793,20
53083390501,53083390499,-2,626,1746,20
53089153702,53089153702,0,1348,1762,20
53090830180,53090830177,-3,1308,3547,20
53092209441,53092209449,8,6999,1728,20
53098568130,53098568127,-3,1174,2046,20
53100235618,53100235621,3,1775,1100,20
53104921572,53104921569,-3,1649,3191,20
53108313746,53108313742,-4,877,1937,20
53110048940,53110048934,-6,1184,2904,20
53111103406,53111103406,0,645,836,20
53114136993,53114136990,-3,1211,1901,20
53124256146,53124256141,-5,1380,4279,20
53124557268,53124557249,-19,992,2180,20
53128917530,53128917522,-8,488,1335,20
53129004286,53129004279,-7,1285,1560,20
53129433317,53129433321,4,1655,1033,20
53131165310,53131165307,-3,1219,2070,20
53131995916,53131995911,-5,884,2014,20
53132165910,53132165893,-17,171,910,20
53133083206,53133083203,-3,710,2274,20
53135276251,53135276246,-5,1133,2352,20
53144716751,53144716749,-2,317,1556,20
53145601678,53145601673,-5,426,937,20
53148271538,53148271536,-2,1422,2177,20
53148923959,53148923957,-2,1093,3480,20
53150723749,53150723745,-4,1427,1676,20
53151496138,53151496136,-2,905,2008,20
53151578062,53151578058,-4,1006,1997,20
53152655362,53152655358,-4,1170,1814,20
53153421674,53153421669,-5,791,3482,20
53158923826,53158923824,-2,1022,2300,20
53161413305,53161413301,-4,1315,2390,20
53167146170,53167146165,-5,1048,1814,20
53167273056,53167273054,-2,1125,2484,20
53167587352,53167587349,-3,1132,2698,20
53170048937,53170048934,-3,2241,6618,20
53172262802,53172262798,-4,657,1942,20
53172338996,53172338990,-6,118,959,20
53172771192,53172771190,-2,824,1500,20
53173068332,53173068337,5,1607,736,20
53192941763,53192941765,2,1166,1021,20
53197727833,53197727839,6,3575,1240,20
53200854585,53200854582,-3,942,1767,20
53202980955,53202980960,5,3214,1562,20
53210208750,53210208745,-5,1304,2257,20
53212016379,53212016376,-3,853,2012,20
53212292228,53212292251,23,1339,3161,20
53215654315,53215654310,-5,1448,2562,20
53215684463,53215684458,-5,1278,4304,20
53217737634,53217737631,-3,1213,2897,20
53217991841,53217991838,-3,1235,2726,20
53218764414,53218764413,-1,1007,3419,20
53226044810,53226044809,-1,967,2404,20
53228559013,53228559014,1,2210,1784,20
53229669269,53229669265,-4,1348,2800,20
53230839748,53230839745,-3,905,2103,20
53233452145,53233452143,-2,1278,2666,20
53237988550,53237988546,-4,1369,1990,20
53239722283,53239722281,-2,1393,2004,20
53240176811,53240176811,0,2240,3776,20
53241260479,53241260476,-3,1030,1777,20
53241605019,53241605017,-2,1312,2448,20
53245635309,53245635314,5,2627,1368,20
53247657873,53247657871,-2,1205,2499,20
53248033115,53248033110,-5,604,1166,20
53248758424,53248758439,15,1479,1828,20
53251068063,53251068059,-4,1109,3157,20
53252016627,53252016623,-4,845,2869,20
53257832594,53257832589,-5,1270,2015,20
53258335195,53258335194,-1,971,1822,20
53258871151,53258871149,-2,1211,2067,20
53270743090,53270743089,-1,1620,1939,20
53272490915,53272490911,-4,945,1921,20
53274697309,53274697306,-3,954,2117,20
53276235262,53276235259,-3,1048,1942,20
53280746685,53280746683,-2,932,2354,20
53283391862,53283391858,-4,785,1567,20
53283680175,53283680158,-17,1059,3213,20
53285286555,53285286552,-3,936,2527,20
53292263210,53292263206,-4,1139,2554,20
53293261561,53293261558,-3,1160,2240,20
53297703272,53297703270,-2,1264,2249,20
53300400367,53300400362,-5,1341,2930,20
53303445142,53303445138,-4,1017,2915,20
53307289361,53307289357,-4,565,1326,20
53308582097,53308582089,-8,920,2601,20
53310100825,53310100821,-4,1047,2562,20
53311603632,53311603648,16,988,2163,20
53320555229,53320555225,-4,1127,2643,20
53322527177,53322527175,-2,1002,1985,20
53326472300,53326472299,-1,1504,1827,20
53327740682,53327740678,-4,1100,2070,20
53328496350,53328496348,-2,825,1817,20
53330627129,53330627126,-3,1483,2858,20
53342189699,53342189695,-4,1205,2512,20
53342671221,53342671217,-4,1195,1817,20
53346576327,53346576326,-1,1027,2016,20
53349850994,53349850998,4,2317,918,20
53353290607,53353290607,0,1064,2436,20
53353954567,53353954545,-22,875,3246,20
53359146807,53359146805,-2,1094,2033,20
53359211296,53359211309,13,346,1092,20
53359636934,53359636929,-5,1343,3531,20
53360736316,53360736312,-4,1590,3730,20
53361197382,53361197403,21,1206,2346,20
53361547099,53361547096,-3,1330,3176,20
53363560437,53363560435,-2,1237,2334,20
53363614022,53363614021,-1,1024,1880,20
53364538310,53364538310,0,1012,1524,20
53368751716,53368751707,-9,6,695,20
53372279351,53372279344,-7,834,3719,20
53379500396,53379500390,-6,815,2585,20
53379624120,53379624138,18,519,1722,20
53380475777,53380475774,-3,958,2390,20
53382150871,53382150867,-4,832,1587,20
53383367493,53383367489,-4,628,2172,20
53383769684,53383769672,-12,22974,17620,20
53386560837,53386560833,-4,986,2499,20
53390588890,53390588889,-1,925,1559,20
53392528505,53392528510,5,2376,1545,20
53400709758,53400709754,-4,905,2410,20
53401415634,53401415630,-4,930,2173,20
53404225302,53404225300,-2,1199,1949,20
53404472294,53404472291,-3,1732,3443,20
53406123357,53406123359,2,1312,1924,20
53406245110,53406245102,-8,964,1715,20
53406332749,53406332744,-5,1159,2884,20
53408660871,53408660852,-19,816,1809,20
53409558671,53409558666,-5,1300,2488,20
53413044741,53413044737,-4,1316,3740,20
53414820164,53414820163,-1,2194,2430,20
53415500773,53415500779,6,2613,1741,20
53416474699,53416474692,-7,1096,2926,20
53416529544,53416529542,-2,1520,2144,20
53419638737,53419638735,-2,1347,1316,20
53425593306,53425593303,-3,905,2067,20
53428275376,53428275395,19,435,1100,20
53434298607,53434298604,-3,1062,2333,20
53434389586,53434389592,6,3262,1608,20
53439816360,53439816357,-3,1420,2565,20
53443242699,53443242693,-6,1018,2835,20
53443734801,53443734801,0,1141,2246,20
53445955318,53445955316,-2,393,1177,20
53452409607,53452409605,-2,982,2140,20
53454181407,53454181426,19,392,1394,20
53455111539,53455111536,-3,916,2657,20
53457110979,53457110976,-3,1091,2094,20
53457434325,53457434333,8,16373,27265,20
53458357866,53458357863,-3,1160,1331,20
53459933306,53459933313,7,4857,2004,20
53460617264,53460617261,-3,1104,2943,20
53460731431,53460731425,-6,1060,1943,20
53462752423,53462752418,-5,1260,2610,20
53465865738,53465865734,-4,830,1283,20
53469176558,53469176564,6,2197,752,20
53478285506,53478285510,4,1536,936,20
53482651522,53482651523,1,1229,2339,20
53487097642,53487097638,-4,614,869,20
53487655603,53487655599,-4,639,1593,20
53489867215,53489867213,-2,891,2099,20
53490543378,53490543375,-3,1349,3203,20
53492772219,53492772217,-2,1057,2062,20
53494448521,53494448520,-1,1095,1685,20
53500430643,53500430641,-2,1228,2506,20
53502477908,53502477904,-4,1213,1992,20
53505119656,53505119652,-4,1523,3650,20
53505899962,53505899958,-4,1409,2271,20
53507950559,53507950556,-3,1145,1775,20
53517771110,53517771108,-2,1072,2368,20
53518351755,53518351753,-2,1228,3576,20
53522802130,53522802129,-1,822,2065,20
53524573879,53524573882,3,1321,1698,20
53528042112,53528042110,-2,935,1435,20
53530878126,53530878125,-1,1275,2125,20
53533440500,53533440498,-2,1019,2410,20
53535356208,53535356212,4,1436,615,20
53535919855,53535919871,16,1008,2336,20
53537772443,53537772441,-2,925,1769,20
53543567522,53543567517,-5,1266,2771,20
53554792130,53554792127,-3,1066,2378,20
53555432916,53555432913,-3,1472,3065,20
53556410013,53556410015,2,1659,1300,20
53556449074,53556449072,-2,1451,3776,20
53556619681,53556619679,-2,861,1915,20
53557125292,53557125290,-2,1196,1880,20
53558695522,53558695522,0,1152,2273,20
53561439405,53561439402,-3,1630,2557,20
53564488666,53564488674,8,1353,1478,20
53564686250,53564686245,-5,914,2204,20
53565614926,53565614904,-22,1174,2548,20
53566261914,53566261922,8,15926,23295,20
53566522677,53566522678,1,2008,2457,20
53569539325,53569539321,-4,1693,5665,20
53574701143,53574701140,-3,1086,2070,20
53574987198,53574987188,-10,461,2320,20
53580073842,53580073842,0,1525,2285,20
53583565667,53583565666,-1,1389,2602,20
53589514604,53589514602,-2,1019,1528,20
53594817438,53594817437,-1,972,2660,20
53599531319,53599531325,6,144,716,20
53600875626,53600875626,0,985,1968,20
53601390899,53601390897,-2,1264,2677,20
53611633131,53611633127,-4,1723,5307,20
53619038381,53619038377,-4,1092,2532,20
53621009817,53621009813,-4,860,2529,20
53622982611,53622982610,-1,1009,1866,20
53628106967,53628106965,-2,1215,2188,20
53628147263,53628147258,-5,1231,2757,20
53632377646,53632377643,-3,1029,1795,20
53632812790,53632812810,20,1142,3570,20
53634410181,53634410174,-7,2028,9640,20
53635561858,53635561857,-1,1814,2499,20
53638076859,53638076855,-4,1224,3221,20
53642535458,53642535457,-1,910,2302,20
53643945942,53643945939,-3,968,1690,20
53649355087,53649355087,0,1547,2340,20
53649520059,53649520054,-5,827,1831,20
53649696574,53649696594,20,1019,2549,20
53654087967,53654087963,-4,1001,1837,20
53663615549,53663615547,-2,1246,2251,20
53664799835,53664799832,-3,1006,2134,20
53670114866,53670114865,-1,911,1936,20
53670497720,53670497738,18,924,2346,20
53671075752,53671075748,-4,1295,2235,20
53672034045,53672034043,-2,141,2690,20
53674651377,53674651382,5,2202,1577,20
53675678493,53675678490,-3,834,2237,20
53677114885,53677114883,-2,1299,2346,20
53682637314,53682637326,12,12201,37636,20
53684155546,53684155551,5,2607,1075,20
53684324192,53684324198,6,6572,1853,20
53684845117,53684845114,-3,1083,2930,20
53685100835,53685100834,-1,1338,2616,20
53685756756,53685756753,-3,1154,2290,20
53686639657,53686639652,-5,4035,7776,20
53687762522,53687762517,-5,1063,3327,20
53688286893,53688286890,-3,805,2400,20
53690261061,53690261059,-2,1596,2665,20
53691137979,53691137982,3,1406,1599,20
53697648841,53697648833,-8,942,4636,20
53707645095,53707645093,-2,868,1738,20
53708680018,53708680015,-3,827,2018,20
53710311570,53710311567,-3,1189,2258,20
53711010373,53711010360,-13,1010,2038,20
53731559172,53731559170,-2,1313,3111,20
53732441223,53732441221,-2,891,2604,20
53734785390,53734785386,-4,1219,2801,20
53737445093,53737445095,2,1755,968,20
53738223256,53738223251,-5,1683,5879,20
53743109849,53743109848,-1,2923,5479,20
53746346386,53746346383,-3,972,2761,20
53746437271,53746437268,-3,20,1356,20
53748647397,53748647394,-3,1176,2804,20
53753229803,53753229801,-2,1309,2653,20
53753807503,53753807483,-20,1271,2353,20
53757298069,53757298066,-3,927,2131,20
53763882737,53763882735,-2,996,3309,20
53770483975,53770483971,-4,873,2181,20
53779431596,53779431594,-2,1301,2216,20
53780421506,53780421502,-4,805,2903,20
53790459044,53790459045,1,938,1470,20
53792536455,53792536453,-2,1304,2500,20
53793687489,53793687485,-4,1005,1866,20
53795626505,53795626502,-3,920,1400,20
53795695610,53795695606,-4,627,966,20
53799786834,53799786832,-2,1306,2619,20
53803492955,53803492953,-2,1099,2769,20
53810749808,53810749813,5,2097,1227,20
53812206859,53812206857,-2,1008,1590,20
53813110115,53813110113,-2,1575,2243,20
53814597462,53814597459,-3,752,1711,20
53819861574,53819861573,-1,1206,1444,20
53825010378,53825010374,-4,1176,2761,20
53826968876,53826968882,6,3155,1576,20
53827128442,53827128439,-3,1084,2361,20
53827374343,53827374342,-1,634,1910,20
53829481919,53829481917,-2,1362,1693,20
53836694294,53836694290,-4,1181,3087,20
53838128105,53838128098,-7,2354,9107,20
53840587006,53840587008,2,1038,1192,20
53843727862,53843727854,-8,1153,7411,20
53846610547,53846610542,-5,839,1281,20
53847505145,53847505142,-3,1312,2397,20
53849822362,53849822375,13,830,1512,20
53853565510,53853565507,-3,1272,2554,20
53856591599,53856591598,-1,823,2001,20
53858510610,53858510607,-3,1274,2646,20
53859307203,53859307197,-6,858,2351,20
53859419506,53859419503,-3,1227,1919,20
53860867084,53860867082,-2,1261,2177,20
53865389654,53865389653,-1,946,2216,20
53867339255,53867339252,-3,777,1494,20
53869498026,53869498022,-4,1085,2563,20
53880259511,53880259510,-1,1429,2080,20
53884654785,53884654782,-3,1151,2223,20
53885972770,53885972777,7,2688,1159,20
53886165201,53886165198,-3,907,2264,20
53886807870,53886807866,-4,1063,2479,20
53897325348,53897325346,-2,1330,2075,20
53905873603,53905873600,-3,679,886,20
53906508579,53906508577,-2,1009,1922,20
53907094274,53907094273,-1,1275,1778,20
53908887482,53908887478,-4,1115,2629,20
53912520364,53912520362,-2,664,2337,20
53915948627,53915948626,-1,1292,1956,20
53916560634,53916560630,-4,1150,2744,20
53920289942,53920289940,-2,1468,1550,20
53922686424,53922686420,-4,1522,2585,20
53923581709,53923581706,-3,1063,2817,20
53936033282,53936033278,-4,1633,2514,20
53938150053,53938150062,9,12306,22310,20
53939011430,53939011429,-1,1175,2159,20
53939288511,53939288529,18,1217,1807,20
53943197873,53943197869,-4,1306,2432,20
53947478702,53947478697,-5,1076,2105,20
53947585382,53947585360,-22,1040,2386,20
53947944830,53947944845,15,709,2272,20
53951872289,53951872284,-5,1142,1759,20
53957408154,53957408150,-4,1153,3249,20
53961272996,53961272991,-5,800,2822,20
53971497987,53971497983,-4,1100,3342,20
53973790343,53973790339,-4,913,2243,20
53974101693,53974101680,-13,1396,2543,20
53974590123,53974590120,-3,798,2166,20
53978167474,53978167471,-3,1082,2684,20
53978330801,53978330806,5,6185,3107,20
53983277282,53983277278,-4,1005,2011,20
53986563236,53986563233,-3,1749,2151,20
53987046238,53987046234,-4,583,1187,20
53987334922,53987334926,4,8123,6518,20
53992184860,53992184860,0,9169,11911,20
53993443784,53993443780,-4,1096,3533,20
53998093846,53998093842,-4,1247,2810,20
53999190563,53999190561,-2,1039,2514,20
54003062243,54003062238,-5,1121,2615,20
54003734245,54003734243,-2,996,1627,20
54006664862,54006664858,-4,1493,2646,20
54008464226,54008464222,-4,1007,2022,20
54009478737,54009478736,-1,1238,2019,20
54009948746,54009948743,-3,976,2188,20
54014145994,54014145989,-5,1124,2085,20
54017987374,54017987373,-1,1285,2140,20
54020645139,54020645133,-6,633,3052,20
54022939654,54022939651,-3,2134,4865,20
54023986237,54023986234,-3,1515,2628,20
54024397275,54024397274,-1,927,1978,20
54024558964,54024558961,-3,1834,2838,20
54032741034,54032741033,-1,1686,2354,20
54035424980,54035424978,-2,1710,3057,20
54035948505,54035948502,-3,1369,1891,20
54045139288,54045139284,-4,878,2266,20
54048161899,54048161898,-1,879,2283,20
54057692010,54057692005,-5,1151,2869,20
54060239511,54060239508,-3,1454,2945,20
54064925339,54064925338,-1,1200,2547,20
54070447231,54070447223,-8,1218,4808,20
54070616991,54070616995,4,5120,2892,20
54075001910,54075001908,-2,866,1761,20
54078097707,54078097699,-8,28410,11682,20
54084512830,54084512827,-3,1099,2229,20
54086107065,54086107062,-3,1799,2580,20
54086826385,54086826381,-4,975,2357,20
54089479771,54089479769,-2,1254,3005,20
54090738882,54090738880,-2,1134,2525,20
54092714835,54092714834,-1,1356,1763,20
54098046919,54098046918,-1,1199,2360,20
54101715458,54101715455,-3,1035,2975,20
54102463955,54102463950,-5,1309,1940,20
54104606521,54104606525,4,4238,1846,20
54105901199,54105901197,-2,843,1701,20
54107210655,54107210660,5,2383,1602,20
54108026650,54108026646,-4,894,2286,20
54112721386,54112721383,-3,935,2902,20
54118578898,54118578896,-2,4507,7420,20
54120564862,54120564863,1,1084,1328,20
54126394266,54126394279,13,13303,40785,20
54128964830,54128964829,-1,1232,2639,20
54130345528,54130345523,-5,1604,3026,20
54132015043,54132015041,-2,771,2242,20
54132803656,54132803647,-9,963,2149,20
54134619481,54134619478,-3,1027,2147,20
54135566812,54135566809,-3,818,1852,20
54137030242,54137030237,-5,1205,2460,20
54137547429,54137547429,0,1491,1174,20
54138658409,54138658406,-3,1342,2416,20
54141402991,54141402989,-2,1050,1964,20
54142846902,54142846901,-1,1175,2209,20
54146588477,54146588473,-4,1070,2367,20
54155627043,54155627041,-2,1678,3010,20
54155815531,54155815525,-6,907,2126,20
54156073539,54156073534,-5,941,1902,20
54158284030,54158284026,-4,623,1131,20
54160924347,54160924343,-4,1149,2267,20
54166730496,54166730494,-2,1234,2297,20
54170809074,54170809072,-2,1208,2885,20
54175027504,54175027499,-5,1053,2027,20
54181268449,54181268446,-3,1064,2525,20
54181790127,54181790122,-5,801,2609,20
54182813459,54182813456,-3,886,2249,20
54196833103,54196833101,-2,1021,2945,20
54197117257,54197117254,-3,1203,2066,20
54199598782,54199598780,-2,1052,1972,20
54202537313,54202537312,-1,1077,2483,20
54204843006,54204843003,-3,1459,2835,20
54205476130,54205476128,-2,1124,2306,20
54208189714,54208189714,0,1012,1586,20
54208370965,54208370959,-6,909,2623,20
54211289452,54211289450,-2,1360,2106,20
54212335733,54212335727,-6,1593,4167,20
54214129719,54214129717,-2,1305,2849,20
54218366726,54218366721,-5,1177,1516,20
54224132862,54224132857,-5,1279,2726,20
54224579607,54224579602,-5,964,1863,20
54226840622,54226840618,-4,1160,3371,20
54231610421,54231610418,-3,933,2533,20
54232855575,54232855572,-3,1015,2276,20
54234990195,54234990190,-5,814,2687,20
54239424705,54239424701,-4,1329,1955,20
54239760574,54239760569,-5,1066,2584,20
54240897841,54240897838,-3,1394,3125,20
54241675782,54241675778,-4,1196,2499,20
54244198746,54244198743,-3,848,2387,20
54245695626,54245695622,-4,1521,2130,20
54247092733,54247092731,-2,884,1808,20
54247434619,54247434614,-5,938,3921,20
54250656265,54250656262,-3,1624,2551,20
54253947712,54253947711,-1,1491,2410,20
54254566451,54254566445,-6,1464,6873,20
54257945835,54257945832,-3,1281,2690,20
54259564113,54259564110,-3,1125,2397,20
54261134938,54261134934,-4,1279,2738,20
54267232735,54267232734,-1,1180,1413,20
54272696877,54272696876,-1,1120,2131,20
54274272959,54274272957,-2,1217,2631,20
54274394663,54274394679,16,600,1179,20
54274551722,54274551718,-4,1203,2605,20
54274862219,54274862218,-1,1193,2954,20
54276613162,54276613163,1,1042,1766,20
54278486031,54278486025,-6,933,2805,20
54281560124,54281560121,-3,1440,3830,20
54283251179,54283251177,-2,1339,3510,20
54284961919,54284961915,-4,1007,2072,20
54285256315,54285256314,-1,885,1806,20
54293297255,54293297254,-1,1178,2818,20
54302690675,54302690673,-2,640,1635,20
54302924744,54302924762,18,802,1286,20
54305099803,54305099823,20,1395,2966,20
54306605759,54306605758,-1,1241,2298,20
54307010834,54307010834,0,1392,2352,20
54309893928,54309893924,-4,1085,2190,20
54317002013,54317002014,1,1612,1967,20
54317403101,54317403104,3,1803,1649,20
54318491611,54318491607,-4,1261,2679,20
54318733269,54318733266,-3,1455,2859,20
54324062094,54324062097,3,1006,1835,20
54329261966,54329261965,-1,948,1400,20
54330563041,54330563041,0,2639,4855,20
54331055150,54331055149,-1,978,1782,20
54331113714,54331113711,-3,1303,2700,20
54331740516,54331740519,3,1478,974,20
54333486397,54333486398,1,1227,1836,20
54333870322,54333870318,-4,992,1931,20
54336503322,54336503321,-1,955,2579,20
54338881656,54338881652,-4,1332,3016,20
54340288211,54340288209,-2,1588,2123,20
54345784206,54345784206,0,1416,1866,20
54349623574,54349623572,-2,1247,2174,20
54354570778,54354570778,0,1187,2250,20
54355399443,54355399442,-1,1342,2902,20
54357981357,54357981355,-2,2397,4219,20
54360082582,54360082582,0,10109,14139,20
54360641526,54360641525,-1,1225,1729,20
54360901762,54360901758,-4,776,3069,20
54361378423,54361378441,18,932,2172,20
54361967375,54361967372,-3,991,2283,20
54363582886,54363582884,-2,1187,2335,20
54363700382,54363700385,3,1520,1356,20
54366581966,54366581964,-2,1912,3066,20
54369522247,54369522245,-2,908,1963,20
54377273782,54377273778,-4,679,1414,20
54377337406,54377337387,-19,1460,1715,20
54378437121,54378437118,-3,1223,2674,20
54379235918,54379235914,-4,1355,2209,20
54379774030,54379774034,4,1927,1355,20
54380719100,54380719097,-3,1097,2394,20
54383010567,54383010564,-3,1295,2323,20
54386287536,54386287537,1,1123,1729,20
54392798774,54392798773,-1,1027,1376,20
54393068470,54393068467,-3,1073,2587,20
54394781075,54394781082,7,2706,952,20
54396188454,54396188450,-4,900,2258,20
54400396471,54400396469,-2,1232,3104,20
54401095257,54401095254,-3,1118,2089,20
54402578794,54402578790,-4,927,2312,20
54404278742,54404278739,-3,1220,2337,20
54404614188,54404614186,-2,126,754,20
54409764761,54409764763,2,1755,1998,20
54410087532,54410087545,13,22,960,20
54423074427,54423074426,-1,1160,1306,20
54432141189,54432141187,-2,1185,1939,20
54436859551,54436859548,-3,1188,3200,20
54437675095,54437675102,7,378,988,20
54441089153,54441089157,4,1938,990,20
54441480066,54441480063,-3,1577,2953,20
54451386310,54451386308,-2,1760,2848,20
54452356783,54452356790,7,756,1863,20
54453988323,54453988322,-1,1527,2500,20
54455415897,54455415893,-4,1347,3942,20
54457787178,54457787174,-4,1019,2521,20
54466586424,54466586419,-5,1799,2390,20
54473083162,54473083159,-3,1086,2583,20
54476101683,54476101680,-3,1103,1795,20
54478020551,54478020549,-2,952,2064,20
54478606618,54478606618,0,905,1893,20
54486010371,54486010369,-2,818,1445,20
54486932098,54486932094,-4,1272,2247,20
54487452726,54487452732,6,183,882,20
54489425736,54489425735,-1,495,1227,20
54495068098,54495068096,-2,1374,2295,20
54495508610,54495508607,-3,812,994,20
54496467465,54496467470,5,1219,771,20
54498231514,54498231514,0,1131,2609,20
54499078517,54499078514,-3,1205,1845,20
54502146706,54502146704,-2,990,2147,20
54505792518,54505792514,-4,1075,2817,20
54507010949,54507010946,-3,1317,3078,20
54507651846,54507651843,-3,1030,1826,20
54508197588,54508197582,-6,1124,2484,20
54508393834,54508393830,-4,23268,69003,20
54509642369,54509642366,-3,1008,1733,20
54510015076,54510015072,-4,1187,2417,20
54512087094,54512087102,8,14233,22462,20
54513563659,54513563654,-5,1085,2777,20
54514908636,54514908630,-6,988,2417,20
54519645738,54519645734,-4,1558,2590,20
54520768648,54520768651,3,1078,1118,20
54522013869,54522013873,4,2332,1345,20
54525137837,54525137834,-3,1166,3296,20
54526565307,54526565302,-5,1097,1967,20
54527294736,54527294750,14,464,953,20
54527925736,54527925737,1,9220,10318,20
54535117327,54535117328,1,1038,2144,20
54537820697,54537820695,-2,1153,1903,20
54538627867,54538627863,-4,851,1698,20
54539266703,54539266698,-5,1336,3090,20
54539348760,54539348758,-2,1581,1998,20
54541723758,54541723758,0,1387,967,20
54551010228,54551010222,-6,723,2255,20
54556093957,54556093950,-7,893,2240,20
54556497330,54556497325,-5,1027,2485,20
54559193641,54559193639,-2,1888,2019,20
54561660530,54561660533,3,2813,1981,20
54568644422,54568644419,-3,1292,2569,20
54569640147,54569640146,-1,1303,2287,20
54570608636,54570608643,7,24156,34784,20
54571443430,54571443426,-4,1089,3924,20
54572345803,54572345800,-3,936,2013,20
54579005710,54579005709,-1,2595,3863,20
54581470154,54581470149,-5,1225,1916,20
54581672685,54581672701,16,925,2841,20
54586247799,54586247797,-2,969,2036,20
54591270726,54591270723,-3,1445,2816,20
54600482033,54600482027,-6,1130,3369,20
54601986403,54601986398,-5,1396,2973,20
54606967139,54606967136,-3,698,2202,20
54607470782,54607470779,-3,985,1390,20
54609952075,54609952073,-2,31184,20887,20
54611626170,54611626166,-4,826,1900,20
54611916351,54611916355,4,272,695,20
54613284073,54613284070,-3,53116,30018,20
54616066574,54616066571,-3,888,1216,20
54616409657,54616409662,5,3372,1608,20
54620068603,54620068601,-2,825,1622,20
54621105125,54621105146,21,1146,2411,20
54622327113,54622327111,-2,1125,2451,20
54623722882,54623722880,-2,1362,2130,20
54624046033,54624046030,-3,1415,2246,20
54627064043,54627064034,-9,948,4466,20
54627493009,54627493004,-5,1269,1961,20
54630227779,54630227774,-5,1116,2586,20
54633719111,54633719108,-3,1009,1629,20
54635337267,54635337261,-6,779,2468,20
54638448970,54638448966,-4,1370,3327,20
54641141015,54641141013,-2,1150,2160,20
54641833150,54641833134,-16,316,1013,20
54646414927,54646414925,-2,2014,5397,20
54646672737,54646672733,-4,1141,2435,20
54651070659,54651070653,-6,1004,4695,20
54652307267,54652307266,-1,762,1526,20
54653582793,54653582814,21,430,947,20
54655053494,54655053490,-4,1133,3345,20
54655897354,54655897350,-4,958,1603,20
54658057346,54658057342,-4,1029,2289,20
54659427716,54659427710,-6,662,1549,20
54661300202,54661300200,-2,882,2110,20
54662035783,54662035780,-3,978,2740,20
54663796513,54663796510,-3,949,1966,20
54664703300,54664703323,23,731,2099,20
54666774421,54666774418,-3,1109,2537,20
54667590890,54667590886,-4,710,1708,20
54669347806,54669347806,0,1516,2001,20
54670953519,54670953515,-4,935,2253,20
54671745560,54671745580,20,884,1854,20
54672447369,54672447366,-3,926,2490,20
54672764573,54672764589,16,1041,2550,20
54673277719,54673277718,-1,1228,1288,20
54675661894,54675661893,-1,1067,1722,20
54676710301,54676710293,-8,654,2248,20
54678652290,54678652287,-3,957,2995,20
54680892157,54680892155,-2,1137,3076,20
54682664070,54682664069,-1,870,1740,20
54688788798,54688788805,7,8643,39268,20
54689218091,54689218088,-3,1094,3077,20
54689840206,54689840207,1,1425,1774,20
54693746901,54693746900,-1,988,2165,20
54693893814,54693893816,2,1215,1996,20
54693953557,54693953563,6,2917,1164,20
54696505743,54696505741,-2,877,2045,20
54697301771,54697301769,-2,2382,2397,20
54702185750,54702185747,-3,1120,2523,20
54702371837,54702371837,0,1841,2500,20
54706294727,54706294721,-6,1129,2843,20
54709057143,54709057141,-2,853,2018,20
54711508288,54711508286,-2,1714,3425,20
54711557434,54711557430,-4,1303,2437,20
54713306574,54713306571,-3,2225,4509,20
54714073989,54714073986,-3,1186,3589,20
54714462215,54714462221,6,2987,1405,20
54717528439,54717528443,4,3357,1721,20
54720796767,54720796766,-1,1484,3157,20
54721392646,54721392646,0,752,1635,20
54722696722,54722696719,-3,973,2910,20
54729215497,54729215493,-4,1557,2719,20
54731495506,54731495502,-4,1431,2719,20
54731590478,54731590484,6,1921,1592,20
54736881531,54736881531,0,876,1954,20
54742123885,54742123881,-4,1308,2443,20
54746941150,54746941147,-3,1211,2563,20
54749047207,54749047202,-5,1287,1630,20
54756030805,54756030807,2,2321,1427,20
54757014013,54757014010,-3,1144,1907,20
54758655026,54758655023,-3,837,1203,20
54763153034,54763153033,-1,657,1417,20
54764083279,54764083274,-5,1202,2286,20
54765431460,54765431457,-3,1212,2440,20
54780504859,54780504855,-4,1366,3172,20
54783529715,54783529713,-2,1334,2585,20
54783999782,54783999779,-3,1221,2282,20
54786042836,54786042840,4,3887,3054,20
54788168403,54788168410,7,112,664,20
54789564744,54789564742,-2,1460,2116,20
54791217923,54791217922,-1,1040,1964,20
54797819075,54797819073,-2,947,1963,20
54800056032,54800056029,-3,961,1782,20
54806454071,54806454074,3,113,1364,20
54808649390,54808649387,-3,1440,2870,20
54814796201,54814796198,-3,1299,2600,20
54814915390,54814915390,0,1222,1429,20
54823596992,54823596990,-2,1427,4310,20
54824200150,54824200148,-2,971,1697,20
54827160999,54827160996,-3,1060,2549,20
54827735156,54827735153,-3,1044,2585,20
54828267987,54828267984,-3,1114,1695,20
54832913962,54832913960,-2,721,1290,20
54834857559,54834857555,-4,899,1309,20
54835412351,54835412348,-3,661,1287,20
54843643226,54843643221,-5,1363,2266,20
54843768096,54843768082,-14,19,1488,20
54845689614,54845689616,2,1861,2149,20
54846879243,54846879239,-4,953,2457,20
54851191179,54851191178,-1,954,2194,20
54851319408,54851319427,19,831,3434,20
54853259271,54853259268,-3,1186,2275,20
54854136734,54854136734,0,882,1928,20
54864894943,54864894941,-2,1342,2976,20
54868246894,54868246891,-3,1171,2187,20
54870095167,54870095167,0,1050,1457,20
54871282486,54871282482,-4,925,1757,20
54874717524,54874717522,-2,1030,1431,20
54875212105,54875212105,0,1005,2200,20
54875483272,54875483270,-2,1261,2940,20
54878091316,54878091322,6,1231,581,20
54881086424,54881086419,-5,1284,2375,20
54889028153,54889028150,-3,1736,3527,20
54895509331,54895509329,-2,960,1905,20
54897386217,54897386217,0,1435,2326,20
54898474040,54898474032,-8,2094,4147,20
54901980150,54901980146,-4,966,3325,20
54903778634,54903778627,-7,1096,2105,20
54905199475,54905199473,-2,1167,2076,20
54915353066,54915353064,-2,1664,2114,20
54924560364,54924560361,-3,1087,2256,20
54925011550,54925011550,0,1406,2607,20
54927316753,54927316748,-5,1578,5098,20
54928552539,54928552537,-2,1404,2819,20
54933195886,54933195884,-2,922,1479,20
54933815775,54933815757,-18,1343,1909,20
54940735035,54940735032,-3,1295,3541,20
54943612394,54943612391,-3,1077,1945,20
54944155707,54944155706,-1,713,2032,20
54947521930,54947521930,0,1062,1870,20
54948571983,54948571982,-1,991,1922,20
54948851793,54948851790,-3,1177,2887,20
54951990986,54951990982,-4,925,1702,20
54953788385,54953788385,0,1667,1155,20
54955692159,54955692157,-2,885,1280,20
54955969588,54955969585,-3,988,2207,20
54958494493,54958494490,-3,1368,3482,20
54958602406,54958602404,-2,774,2051,20
54958714318,54958714336,18,1143,3049,20
54959620387,54959620385,-2,997,2029,20
54961709484,54961709482,-2,857,1004,20
54962924011,54962924008,-3,1137,1954,20
54963798605,54963798605,0,2040,1733,20
54963892282,54963892281,-1,1336,2795,20
54969414263,54969414258,-5,925,2105,20
54971841967,54971841964,-3,1512,2252,20
54972601445,54972601465,20,380,803,20
54972639165,54972639184,19,920,2237,20
54975299965,54975299962,-3,1226,2361,20
54979950271,54979950268,-3,1097,1565,20
54981228787,54981228783,-4,893,1506,20
54981407755,54981407750,-5,1379,2242,20
54981725441,54981725434,-7,1644,5423,20
54981910394,54981910390,-4,1174,2104,20
54994047051,54994047048,-3,1298,2453,20
54994500383,54994500377,-6,779,1796,20
54997405325,54997405322,-3,1584,2883,20
55000346560,55000346557,-3,893,2620,20
55000400312,55000400309,-3,1578,2653,20
55001144665,55001144661,-4,1248,2897,20
55003081790,55003081787,-3,892,2356,20
55003753476,55003753498,22,703,1235,20
55005910004,55005910006,2,2127,1890,20
55006644443,55006644441,-2,1074,2038,20
55008752815,55008752813,-2,1524,3088,20
55009145643,55009145639,-4,1261,2489,20
55009805643,55009805639,-4,783,3305,20
55017567539,55017567538,-1,7816,13140,20
55026959283,55026959279,-4,792,1481,20
55027037603,55027037600,-3,911,2114,20
55033914974,55033914973,-1,1172,2178,20
55034634721,55034634719,-2,1032,2533,20
55037385319,55037385315,-4,1099,2268,20
55037536221,55037536225,4,13300,8479,20
55040778494,55040778495,1,2314,3667,20
55057038426,55057038423,-3,987,1930,20
55057093262,55057093275,13,21,922,20
55062382559,55062382556,-3,1306,2849,20
55064226766,55064226763,-3,1173,3220,20
55065087382,55065087401,19,1168,2555,20
55066205896,55066205892,-4,793,3067,20
55071642994,55071642997,3,1807,1251,20
55074305548,55074305545,-3,989,1420,20
55079416730,55079416728,-2,1404,3378,20
55084850487,55084850483,-4,1043,3531,20
55087653566,55087653564,-2,1181,2522,20
55088324155,55088324150,-5,1724,2873,20
55089473078,55089473074,-4,1008,1630,20
55090403951,55090403950,-1,840,1377,20
55092971394,55092971391,-3,660,1951,20
55094398790,55094398808,18,1395,2189,20
55095121307,55095121305,-2,1059,2295,20
55097270618,55097270614,-4,1242,1768,20
55100717283,55100717282,-1,953,2393,20
55102478366,55102478361,-5,1016,3683,20
55104464343,55104464339,-4,954,2003,20
55107326871,55107326867,-4,1193,2346,20
55107966483,55107966478,-5,1142,1634,20
55112514913,55112514910,-3,1089,2220,20
55115647392,55115647391,-1,1289,1949,20
55119664858,55119664856,-2,1275,3087,20
55119855515,55119855521,6,1144,1797,20
55122745705,55122745702,-3,1281,2029,20
55123191647,55123191641,-6,1063,2901,20
55124006233,55124006234,1,865,2060,20
55124839683,55124839681,-2,1155,1847,20
55129478931,55129478929,-2,922,2033,20
55131355211,55131355210,-1,685,1705,20
55133983533,55133983534,1,1793,2095,20
55136955650,55136955647,-3,1049,2318,20
55140571561,55140571557,-4,1066,2416,20
55147616155,55147616149,-6,705,1630,20
55154356352,55154356352,0,4689,16711,20
55154656803,55154656799,-4,1450,2562,20
55157829140,55157829136,-4,1261,2633,20
55158539591,55158539587,-4,1141,1954,20
55162264468,55162264466,-2,1070,1887,20
55163759949,55163759949,0,906,2165,20
55163975318,55163975316,-2,861,1974,20
55170510161,55170510157,-4,1461,3347,20
55171040859,55171040859,0,1070,1538,20
55179214935,55179214933,-2,1326,2908,20
55182657329,55182657327,-2,829,1940,20
55184242817,55184242816,-1,971,2185,20
55185270517,55185270520,3,4348,2369,20
55186293663,55186293658,-5,1246,2466,20
55186766751,55186766749,-2,1378,3875,20
55188034762,55188034765,3,2423,2124,20
55191143941,55191143938,-3,1086,2316,20
55192887774,55192887773,-1,1253,2077,20
55196634071,55196634067,-4,1277,3172,20
55197252530,55197252526,-4,1208,3349,20
55199244067,55199244065,-2,1057,2416,20
55199412183,55199412202,19,127,1114,20
55199662351,55199662367,16,337,1871,20
55206251310,55206251309,-1,952,1760,20
55208752312,55208752309,-3,1085,2267,20
55211053320,55211053318,-2,1279,1356,20
55211301225,55211301221,-4,1577,3421,20
55212838130,55212838130,0,1038,1801,20
55214179239,55214179234,-5,1203,2182,20
55223746794,55223746806,12,726,1307,20
55233054958,55233054954,-4,934,1950,20
55234429086,55234429084,-2,1298,1895,20
55234935814,55234935813,-1,765,3191,20
55238069247,55238069244,-3,957,2844,20
55238771580,55238771577,-3,1432,2859,20
55241763243,55241763240,-3,1315,2535,20
55243653506,55243653502,-4,1205,2191,20
55243883038,55243883034,-4,1151,2169,20
55247576467,55247576463,-4,1321,2432,20
55248134294,55248134290,-4,1283,2604,20
55253414559,55253414557,-2,1117,2076,20
55257505373,55257505374,1,1410,1270,20
55263468904,55263468901,-3,851,2491,20
55265827295,55265827293,-2,1525,2003,20
55266942649,55266942646,-3,1301,2117,20
55275839997,55275840003,6,2924,1217,20
55278952974,55278952971,-3,1694,2416,20
55280150998,55280150996,-2,977,2140,20
55283512498,55283512497,-1,1156,3746,20
55283956276,55283956285,9,312,2502,20
55285209635,55285209631,-4,974,2297,20
55285573015,55285573030,15,644,3155,20
55292261198,55292261196,-2,1296,2412,20
55301803983,55301803981,-2,1011,2013,20
55303081627,55303081621,-6,1069,2507,20
55304402606,55304402603,-3,513,834,20
55306331509,55306331506,-3,1781,3846,20
55309069614,55309069619,5,12345,3839,20
55313336613,55313336607,-6,1428,3307,20
55314061426,55314061422,-4,1343,2738,20
55314455935,55314455929,-6,893,2709,20
55317070794,55317070790,-4,1129,1754,20
55317794343,55317794339,-4,1038,2849,20
55322292911,55322292910,-1,1666,2107,20
55324279049,55324279054,5,2990,1514,20
55324685965,55324685962,-3,982,2624,20
55327873990,55327873986,-4,900,2328,20
55328797207,55328797205,-2,1601,2538,20
55332944743,55332944750,7,3531,1374,20
55335308288,55335308285,-3,809,1693,20
55336058943,55336058939,-4,1097,3158,20
55339700274,55339700274,0,362,1087,20
55342619374,55342619369,-5,1568,2621,20
55342658183,55342658203,20,527,1169,20
55344177163,55344177161,-2,1025,2397,20
55345314628,55345314622,-6,1245,2772,20
55347597250,55347597246,-4,1187,3133,20
55347840488,55347840502,14,547,1649,20
55350862148,55350862143,-5,867,2426,20
55354657585,55354657588,3,3726,2663,20
55360608384,55360608381,-3,1051,1843,20
55362587570,55362587566,-4,1051,2896,20
55363386915,55363386913,-2,1316,2388,20
55370291773,55370291769,-4,1009,2044,20
55371242327,55371242322,-5,945,1779,20
55375555613,55375555620,7,6251,2120,20
55375609718,55375609721,3,650,918,20
55376418690,55376418683,-7,1137,2811,20
55377512529,55377512526,-3,1053,2366,20
55377729414,55377729430,16,315,1095,20
55378968532,55378968530,-2,1281,2332,20
55379493739,55379493738,-1,1156,1895,20
55380122097,55380122096,-1,1887,2324,20
55389878564,55389878564,0,1655,2346,20
55392158918,55392158916,-2,1203,2632,20
55393814866,55393814864,-2,1126,1685,20
55394975434,55394975432,-2,594,1063,20
55397141505,55397141501,-4,1282,1954,20
55398343762,55398343764,2,2179,2227,20
55400283773,55400283766,-7,1468,7085,20
55404016614,55404016612,-2,1415,2732,20
55410650746,55410650743,-3,845,1872,20
55411882409,55411882404,-5,785,1275,20
55416449710,55416449710,0,884,2180,20
55417883716,55417883715,-1,1207,2073,20
55418512886,55418512882,-4,816,2927,20
55418775437,55418775433,-4,1067,2240,20
55419902248,55419902245,-3,1008,2935,20
55420613581,55420613569,-12,1259,1998,20
55423320743,55423320741,-2,953,1923,20
55424192630,55424192627,-3,1252,2340,20
55424632535,55424632537,2,1545,1522,20
55426137462,55426137458,-4,1167,2578,20
55426845684,55426845680,-4,1211,2836,20
55432599181,55432599180,-1,1157,2254,20
55435973395,55435973393,-2,1407,1945,20
55437571077,55437571079,2,2730,2284,20
55443574039,55443574036,-3,700,1613,20
55444013330,55444013326,-4,1085,3170,20
55445315755,55445315754,-1,2188,3153,20
55447588307,55447588306,-1,1071,2150,20
55449037263,55449037259,-4,1081,2487,20
55450135357,55450135354,-3,845,3156,20
55452050529,55452050525,-4,705,1620,20
55453683466,55453683459,-7,537,1089,20
55454983191,55454983187,-4,1267,2970,20
55455179971,55455179970,-1,1210,2306,20
55458032485,55458032481,-4,937,2211,20
55460330724,55460330722,-2,1621,3300,20
55462038699,55462038695,-4,1054,3053,20
55463298647,55463298644,-3,1012,2045,20
55472738030,55472738029,-1,972,2418,20
55473736582,55473736585,3,2650,2625,20
55480865194,55480865190,-4,1619,2390,20
55481943760,55481943754,-6,1163,3094,20
55496070840,55496070837,-3,1355,2434,20
55498359430,55498359427,-3,1389,2591,20
55498532941,55498532934,-7,1033,3945,20
55499330623,55499330619,-4,979,2471,20
55502129882,55502129880,-2,1715,2758,20
55504253483,55504253485,2,24319,28359,20
55505094733,55505094729,-4,1683,3111,20
55509301415,55509301410,-5,1171,3384,20
55514924365,55514924362,-3,1258,2278,20
55515303127,55515303126,-1,785,2003,20
55516166414,55516166413,-1,597,2050,20
55528158335,55528158333,-2,1169,2649,20
55530136166,55530136165,-1,965,2487,20
55530209631,55530209628,-3,1061,1960,20
55537529854,55537529854,0,27833,35388,20
55539096664,55539096662,-2,1633,2609,20
55539467421,55539467420,-1,1391,1864,20
55542581498,55542581494,-4,1167,1956,20
55543904250,55543904250,0,1467,2326,20
55547849551,55547849542,-9,780,3899,20
55550691369,55550691370,1,1641,1052,20
55550836174,55550836173,-1,1065,2307,20
55551456629,55551456628,-1,20206,20592,20
55553120026,55553120022,-4,1489,3026,20
55555741710,55555741706,-4,1055,2971,20
55559271425,55559271430,5,1585,738,20
55562227079,55562227079,0,854,1153,20
55563107341,55563107338,-3,1019,3173,20
55566226373,55566226369,-4,1432,3162,20
55570231233,55570231228,-5,1005,3625,20
55570686650,55570686650,0,1262,3302,20
55573889105,55573889103,-2,1248,1991,20
55575634591,55575634588,-3,1333,2551,20
55576979732,55576979729,-3,951,2288,20
55578423210,55578423206,-4,1152,1479,20
55580266187,55580266182,-5,1844,8024,20
55583464517,55583464513,-4,1162,2667,20
55592442346,55592442350,4,1805,2104,20
55593442831,55593442827,-4,804,2679,20
55600623529,55600623526,-3,890,2894,20
55607197658,55607197656,-2,1152,1515,20
55607731987,55607731984,-3,999,2382,20
55609290617,55609290614,-3,1439,3042,20
55610329685,55610329682,-3,631,1405,20
55610814694,55610814691,-3,1324,2184,20
55612137333,55612137330,-3,851,2613,20
55615387539,55615387535,-4,1133,2252,20
55617089582,55617089578,-4,1148,2564,20
55617821956,55617821952,-4,686,2707,20
55629441023,55629441019,-4,1611,2550,20
55629654123,55629654119,-4,1336,2108,20
55630785375,55630785374,-1,1562,2509,20
55631835106,55631835105,-1,1724,2335,20
55632148236,55632148241,5,14149,6108,20
55635230090,55635230087,-3,566,2438,20
55636028426,55636028421,-5,1324,4529,20
55647602867,55647602863,-4,1237,2984,20
55651112770,55651112769,-1,1579,3001,20
55658291787,55658291786,-1,1099,2359,20
55659585708,55659585709,1,1341,1754,20
55659728994,55659728990,-4,956,2545,20
55669366934,55669366931,-3,1229,2593,20
55670118610,55670118606,-4,1599,1966,20
55670324421,55670324419,-2,753,1597,20
55670362655,55670362665,10,343,825,20
55675324269,55675324266,-3,1117,1968,20
55675626214,55675626203,-11,1143,2570,20
55675759438,55675759430,-8,1305,5298,20
55676277094,55676277095,1,27000,17742,20
55677109052,55677109049,-3,1106,2599,20
55678887149,55678887145,-4,810,1559,20
55682251627,55682251622,-5,1249,2733,20
55690529538,55690529534,-4,1264,3379,20
55690933279,55690933283,4,1084,1148,20
55695548327,55695548323,-4,1204,2506,20
55696346782,55696346799,17,1125,1962,20
55696604295,55696604282,-13,1153,2074,20
55697970706,55697970709,3,2519,1991,20
55698313242,55698313239,-3,1146,2480,20
55701133677,55701133674,-3,1026,1951,20
55701577719,55701577717,-2,1041,1623,20
55703075893,55703075890,-3,1073,2462,20
55703646845,55703646853,8,1779,1000,20
55704747369,55704747368,-1,1359,2188,20
55707750561,55707750561,0,1814,2337,20
55716235934,55716235930,-4,972,2129,20
55720955410,55720955410,0,865,1294,20
55721086806,55721086825,19,587,2797,20
55722703726,55722703726,0,1626,1936,20
55724454003,55724454000,-3,1161,2107,20
55732458146,55732458143,-3,888,2770,20
55734093092,55734093093,1,1413,1416,20
55734934849,55734934846,-3,1513,2643,20
55737430874,55737430853,-21,537,319,20
55740424871,55740424848,-23,913,2217,20
55742338511,55742338509,-2,1226,1894,20
55747133466,55747133463,-3,1075,2596,20
55748133346,55748133344,-2,864,2415,20
55753518431,55753518425,-6,969,1648,20
55753591320,55753591339,19,509,1581,20
55754807148,55754807145,-3,836,1658,20
55760450623,55760450621,-2,1061,2512,20
55763172366,55763172365,-1,1063,2202,20
55764760541,55764760539,-2,1433,2309,20
55767186141,55767186138,-3,1117,2118,20
55775127887,55775127883,-4,930,2019,20
55780117419,55780117417,-2,1080,2207,20
55781505711,55781505708,-3,1269,1881,20
55783185754,55783185754,0,1375,1649,20
55784607779,55784607773,-6,990,1743,20
55786552970,55786552966,-4,797,2332,20
55790306813,55790306820,7,13014,1700,20
55794483756,55794483770,14,392,1697,20
55794679254,55794679251,-3,829,1461,20
55799439436,55799439431,-5,858,2957,20
55800963878,55800963874,-4,966,2711,20
55802278202,55802278201,-1,1227,1749,20
55804625977,55804625973,-4,789,2242,20
55808123607,55808123611,4,3201,2584,20
55811528015,55811528018,3,1557,2135,20
55821401495,55821401491,-4,755,2994,20
55824519015,55824519010,-5,1079,1800,20
55824863537,55824863536,-1,943,2557,20
55827949830,55827949827,-3,1170,2675,20
55828591671,55828591669,-2,808,1959,20
55833857126,55833857122,-4,928,2348,20
55837024229,55837024222,-7,523,1577,20
55844681366,55844681363,-3,1271,2847,20
55846513152,55846513150,-2,1674,2459,20
55855235176,55855235181,5,4163,1225,20
55857442567,55857442562,-5,1026,2545,20
55861149791,55861149788,-3,1016,1978,20
55862499571,55862499569,-2,1545,3869,20
55863601997,55863602002,5,2245,2254,20
55878033959,55878033954,-5,1553,5609,20
55880778374,55880778373,-1,1142,1970,20
55881923250,55881923247,-3,1172,1807,20
55882633046,55882633060,14,778,1753,20
55889735096,55889735094,-2,1514,2573,20
55892969970,55892969967,-3,1059,1895,20
55896185255,55896185253,-2,1287,3709,20
55898239934,55898239929,-5,929,3304,20
55903324433,55903324431,-2,1276,2109,20
55909453006,55909453002,-4,1987,3383,20
55909498919,55909498917,-2,1273,2565,20
55911478404,55911478401,-3,1007,2203,20
55914556346,55914556342,-4,1327,2360,20
55915827769,55915827764,-5,750,2122,20
55916800677,55916800674,-3,1234,2292,20
55918993109,55918993103,-6,1029,1890,20
55919210629,55919210626,-3,737,1954,20
55923468251,55923468248,-3,1172,2612,20
55929143265,55929143262,-3,1212,3299,20
55931237746,55931237742,-4,1224,3482,20
55932335183,55932335178,-5,963,2870,20
55932943627,55932943622,-5,1092,2374,20
55934016754,55934016754,0,1283,2010,20
55936938821,55936938818,-3,1494,3034,20
55937308939,55937308943,4,2118,1478,20
55940224150,55940224145,-5,713,2723,20
55947229399,55947229394,-5,862,2317,20
55950177797,55950177794,-3,1221,2478,20
55951341097,55951341093,-4,1323,3055,20
55953171471,55953171477,6,2871,1793,20
55956447899,55956447894,-5,921,1549,20
55956848511,55956848510,-1,1145,2182,20
55960705073,55960705074,1,1410,1453,20
55960849879,55960849876,-3,1565,2770,20
55973005530,55973005540,10,15561,21619,20
55973820122,55973820116,-6,1355,4169,20
55976972931,55976972930,-1,906,1619,20
55985035722,55985035719,-3,705,2152,20
55985082209,55985082208,-1,1350,1869,20
55990207265,55990207262,-3,1566,3140,20
55991852238,55991852234,-4,763,1574,20
55992476310,55992476315,5,171,942,20
55993803926,55993803924,-2,1339,3864,20
56001298575,56001298570,-5,1243,2399,20
56001685286,56001685274,-12,219,1004,20
56003454243,56003454239,-4,1419,2785,20
56004586207,56004586202,-5,1227,2723,20
56006762603,56006762603,0,974,1237,20
56006805926,56006805922,-4,741,1606,20
56011507975,56011507973,-2,830,1294,20
56012846570,56012846568,-2,669,1489,20
56022059763,56022059759,-4,1083,1614,20
56022201479,56022201499,20,165,979,20
56026767483,56026767480,-3,1431,2472,20
56031546309,56031546308,-1,1238,2036,20
56033783246,56033783263,17,3929,1486,20
56034838123,56034838118,-5,1103,5067,20
56035312725,56035312723,-2,1106,2342,20
56036475674,56036475682,8,3233,1260,20
56043140034,56043140033,-1,1097,2515,20
56043462186,56043462183,-3,1437,2436,20
56050601551,56050601544,-7,1184,4492,20
56051161362,56051161358,-4,924,1944,20
56051374930,56051374925,-5,1027,1799,20
56052630296,56052630311,15,238,1420,20
56052737324,56052737317,-7,220,800,20
56053189179,56053189175,-4,467,829,20
56054788230,56054788227,-3,1077,2102,20
56061093074,56061093072,-2,1469,2436,20
56061150829,56061150834,5,2718,2013,20
56062944864,56062944878,14,183,669,20
56063895969,56063895965,-4,595,1787,20
56066728546,56066728545,-1,1719,1708,20
56067069867,56067069865,-2,1022,1259,20
56072399475,56072399473,-2,1193,2027,20
56072782738,56072782734,-4,1806,2560,20
56073190422,56073190442,20,517,1787,20
56075251683,56075251682,-1,1499,2335,20
56075858018,56075858018,0,1367,2296,20
56079458667,56079458665,-2,995,2356,20
56080545127,56080545124,-3,1590,2727,20
56083467080,56083467078,-2,1111,2627,20
56085854553,56085854559,6,9088,5219,20
56085982893,56085982898,5,1473,689,20
56092356446,56092356442,-4,919,2277,20
56098802691,56098802689,-2,1270,1391,20
56106003915,56106003910,-5,1143,2576,20
56106781818,56106781815,-3,1084,2670,20
56110584806,56110584804,-2,1080,2958,20
56110659626,56110659625,-1,1075,2012,20
56114847222,56114847221,-1,1486,2433,20
56120496786,56120496785,-1,1670,2196,20
56121242838,56121242833,-5,1173,2230,20
56122424807,56122424803,-4,1468,2949,20
56125726330,56125726335,5,1755,805,20
56128064019,56128064018,-1,1555,2712,20
56132985715,56132985717,2,22569,52326,20
56133811549,56133811548,-1,888,1407,20
56135000186,56135000182,-4,1228,2748,20
56139918122,56139918120,-2,1618,2232,20
56142380613,56142380610,-3,1041,2362,20
56144223623,56144223621,-2,1489,1911,20
56151776426,56151776423,-3,923,1982,20
56152500024,56152500020,-4,1424,2577,20
56153484159,56153484159,0,2335,2976,20
56154264863,56154264861,-2,1094,2318,20
56158687618,56158687620,2,15318,17677,20
56159371451,56159371447,-4,1352,2749,20
56162939734,56162939733,-1,989,2140,20
56164012482,56164012475,-7,1101,1654,20
56164765076,56164765073,-3,838,1549,20
56165221945,56165221941,-4,758,2452,20
56167896010,56167896007,-3,1398,1557,20
56169849950,56169849947,-3,1221,2631,20
56171501227,56171501225,-2,1397,2559,20
56172164085,56172164082,-3,1186,2264,20
56172525600,56172525616,16,695,2058,20
56174706399,56174706398,-1,1233,3123,20
56174792582,56174792569,-13,950,1919,20
56176568884,56176568880,-4,1113,2558,20
56177256526,56177256523,-3,1183,2619,20
56177989158,56177989156,-2,1196,1374,20
56178265902,56178265905,3,354,1023,20
56180610074,56180610070,-4,725,1813,20
56182416783,56182416778,-5,1299,2914,20
56183936514,56183936512,-2,1168,2372,20
56186588163,56186588161,-2,1069,1856,20
56188304356,56188304351,-5,502,947,20
56189024242,56189024241,-1,1186,2468,20
56190530538,56190530543,5,2801,1454,20
56197899262,56197899258,-4,1563,3489,20
56199431303,56199431300,-3,948,2443,20
56200945571,56200945583,12,10833,47352,20
56202294109,56202294103,-6,1110,2669,20
56210511185,56210511182,-3,1323,2073,20
56211902576,56211902571,-5,1015,4182,20
56214095903,56214095902,-1,869,2194,20
56215284838,56215284853,15,332,625,20
56217746431,56217746430,-1,963,1957,20
56218524225,56218524243,18,1211,2685,20
56219419693,56219419690,-3,1365,2080,20
56220081420,56220081419,-1,1417,1410,20
56223981907,56223981909,2,1200,1503,20
56224335933,56224335935,2,270,518,20
56225228324,56225228345,21,374,1217,20
56227928009,56227928006,-3,1170,1978,20
56228652976,56228652992,16,457,2131,20
56232635911,56232635915,4,1234,1581,20
56233199818,56233199834,16,571,1768,20
56235396751,56235396746,-5,744,2502,20
56236279404,56236279400,-4,1141,2586,20
56238443036,56238443034,-2,1306,3182,20
56239611185,56239611182,-3,1173,2101,20
56248571245,56248571252,7,4586,2026,20
56250733509,56250733506,-3,1745,3338,20
56250803048,56250803045,-3,1106,2339,20
56252462333,56252462333,0,923,1465,20
56256247281,56256247277,-4,1625,2094,20
56257544518,56257544517,-1,15399,6583,20
56258425775,56258425770,-5,826,3852,20
56258718290,56258718289,-1,1026,2376,20
56260187478,56260187474,-4,1193,2204,20
56260452082,56260452078,-4,952,3574,20
56262821284,56262821283,-1,1472,1591,20
56264423023,56264423019,-4,1274,2464,20
56264567134,56264567129,-5,946,3646,20
56266496814,56266496812,-2,1305,2939,20
56266552181,56266552185,4,242,802,20
56275487559,56275487557,-2,1255,2966,20
56284334383,56284334383,0,1114,1871,20
56286465287,56286465284,-3,920,1884,20
56286935987,56286935982,-5,618,1653,20
56288189670,56288189678,8,300,1127,20
56289265429,56289265412,-17,966,2737,20
56296689382,56296689378,-4,1099,2012,20
56299196089,56299196084,-5,1053,3091,20
56300147973,56300147970,-3,1142,2236,20
56306736790,56306736790,0,595,1685,20
56308455415,56308455412,-3,914,2038,20
56311419891,56311419890,-1,847,1140,20
56317628333,56317628330,-3,1017,2082,20
56318106004,56318105997,-7,896,4255,20
56318198918,56318198918,0,1199,1146,20
56319786674,56319786669,-5,1129,2718,20
56319949224,56319949241,17,749,2505,20
56321002390,56321002387,-3,1003,2320,20
56324984468,56324984462,-6,896,4080,20
56325813107,56325813115,8,2410,829,20
56326581085,56326581069,-16,858,924,20
56327652814,56327652809,-5,801,1603,20
56327695371,56327695367,-4,781,2434,20
56328719897,56328719890,-7,1114,2604,20
56329765020,56329765005,-15,1246,2206,20
56335407049,56335407046,-3,1720,2403,20
56342583507,56342583486,-21,214,636,20
56343725198,56343725197,-1,1220,2416,20
56346433237,56346433234,-3,1353,2097,20
56346786016,56346786034,18,1107,2727,20
56353197411,56353197402,-9,1270,1919,20
56353891530,56353891528,-2,1755,1918,20
56356171207,56356171204,-3,1552,2641,20
56356356452,56356356447,-5,1215,3298,20
56356977517,56356977516,-1,738,1566,20
56359882782,56359882780,-2,704,1771,20
56364238307,56364238304,-3,836,2350,20
56364678270,56364678269,-1,1240,2727,20
56365009190,56365009187,-3,567,1649,20
56365140186,56365140184,-2,1028,1634,20
56370086423,56370086421,-2,901,1829,20
56371185148,56371185143,-5,1115,2089,20
56371455914,56371455910,-4,1512,3605,20
56371866050,56371866046,-4,1634,2912,20
56373211869,56373211866,-3,1408,2577,20
56374693546,56374693542,-4,893,2227,20
56375765134,56375765129,-5,1154,3439,20
56385223734,56385223733,-1,1495,2141,20
56386270832,56386270838,6,115,991,20
56386872035,56386872031,-4,1348,2987,20
56387818810,56387818811,1,1163,1443,20
56388518050,56388518049,-1,1363,1715,20
56388983734,56388983735,1,1302,1474,20
56391206679,56391206678,-1,914,2017,20
56392229398,56392229412,14,849,350,20
56393820474,56393820470,-4,1057,2761,20
56394136687,56394136684,-3,863,1991,20
56395493573,56395493570,-3,1298,2936,20
56399396457,56399396457,0,1280,1454,20
56403616173,56403616174,1,1148,1192,20
56411493481,56411493481,0,1035,1850,20
56415015647,56415015645,-2,1178,1978,20
56415618795,56415618790,-5,936,3206,20
56417085987,56417085984,-3,829,1425,20
56417255353,56417255350,-3,973,2826,20
56421975098,56421975096,-2,1081,1797,20
56422324049,56422324046,-3,1216,2584,20
56425207756,56425207766,10,2172,1513,20
56429422046,56429422044,-2,1026,2018,20
56432339246,56432339243,-3,1429,2131,20
56434152929,56434152927,-2,996,2256,20
56434621622,56434621607,-15,1289,2751,20
56435931406,56435931403,-3,1268,2345,20
56436322182,56436322186,4,1857,1402,20
56436439095,56436439093,-2,847,1994,20
56439608619,56439608617,-2,1510,2688,20
56440800529,56440800525,-4,1155,2429,20
56442891889,56442891886,-3,1304,2159,20
56447100494,56447100491,-3,652,1421,20
56454188370,56454188368,-2,645,1125,20
56455591265,56455591262,-3,880,2329,20
56465031021,56465031021,0,1626,1416,20
56466049802,56466049800,-2,1641,3577,20
56466454669,56466454665,-4,1578,2426,20
56468610164,56468610163,-1,1635,2528,20
56469112141,56469112138,-3,1157,1962,20
56469459449,56469459445,-4,1251,2303,20
56469922140,56469922125,-15,1034,2492,20
56470744207,56470744206,-1,1489,2474,20
56472365956,56472365954,-2,1366,2779,20
56474892437,56474892434,-3,1144,2093,20
56477203033,56477203024,-9,890,3051,20
56484528223,56484528222,-1,1424,3113,20
56488948701,56488948699,-2,1511,3072,20
56490713435,56490713431,-4,1290,5114,20
56492190329,56492190327,-2,845,2405,20
56492595039,56492595059,20,1191,2466,20
56495593451,56495593447,-4,1434,2273,20
56498685190,56498685188,-2,1531,2858,20
56499121054,56499121071,17,911,2190,20
56500329855,56500329851,-4,697,1364,20
56503839090,56503839089,-1,1062,2439,20
56505993452,56505993445,-7,600,2754,20
56511622075,56511622071,-4,931,1713,20
56512502722,56512502719,-3,957,2530,20
56512691334,56512691315,-19,83,1242,20
56525221337,56525221330,-7,2883,8739,20
56525537504,56525537501,-3,1587,2860,20
56529569717,56529569714,-3,920,1194,20
56534272768,56534272767,-1,237,1460,20
56537250390,56537250386,-4,1190,2265,20
56539038309,56539038310,1,721,998,20
56539826075,56539826069,-6,1015,5565,20
56542929418,56542929417,-1,1021,1561,20
56546575896,56546575893,-3,1016,2438,20
56547325403,56547325398,-5,876,2551,20
56547461617,56547461617,0,2809,4250,20
56549506059,56549506057,-2,794,1918,20
56555644703,56555644701,-2,1645,2940,20
56558209166,56558209163,-3,1785,2603,20
56560993863,56560993861,-2,1351,1347,20
56562524758,56562524755,-3,828,1391,20
56566570574,56566570572,-2,1032,2330,20
56568073454,56568073451,-3,840,3459,20
56571574913,56571574918,5,4087,2865,20
56573212663,56573212659,-4,1198,2825,20
56574544174,56574544172,-2,759,1175,20
56579828271,56579828269,-2,1049,1977,20
56582499305,56582499300,-5,833,1956,20
56585194496,56585194495,-1,861,1393,20
56588342418,56588342414,-4,925,1938,20
56588834670,56588834666,-4,1221,3299,20
56589507686,56589507684,-2,846,1673,20
56593250099,56593250096,-3,1161,2823,20
56593484886,56593484883,-3,1316,2660,20
56596079849,56596079848,-1,1303,2934,20
56596250557,56596250578,21,545,1178,20
56597821106,56597821104,-2,1061,1817,20
56598325597,56598325593,-4,1475,2330,20
56601593360,56601593363,3,25197,29650,20
56602132371,56602132366,-5,1038,2335,20
56603818888,56603818884,-4,916,1964,20
56605230392,56605230393,1,2877,3292,20
56610608809,56610608806,-3,990,1428,20
56614900662,56614900658,-4,1059,1968,20
56615411744,56615411744,0,1077,1730,20
56617044691,56617044686,-5,1283,3003,20
56617478166,56617478163,-3,1447,2728,20
56617512229,56617512227,-2,1131,2400,20
56618933752,56618933749,-3,1046,1921,20
56625747325,56625747321,-4,1158,1953,20
56628583090,56628583086,-4,1059,1933,20
56629378126,56629378123,-3,744,2172,20
56629968744,56629968763,19,607,2242,20
56634071994,56634071997,3,968,1143,20
56638474082,56638474085,3,1330,1483,20
56649030110,56649030110,0,1602,2131,20
56650891746,56650891742,-4,1554,2916,20
56653242342,56653242339,-3,1135,2277,20
56654050815,56654050809,-6,1141,2044,20
56663827301,56663827298,-3,1315,2221,20
56664549423,56664549418,-5,1594,2754,20
56665346323,56665346322,-1,942,1224,20
56665889700,56665889688,-12,130,607,20
56666455814,56666455812,-2,1059,1823,20
56670575651,56670575653,2,767,894,20
56673682038,56673682034,-4,1562,2798,20
56675622367,56675622366,-1,1413,2794,20
56684769208,56684769206,-2,1655,3499,20
56687426455,56687426460,5,2028,1608,20
56689394671,56689394666,-5,1184,3819,20
56689549483,56689549478,-5,800,4629,20
56689621070,56689621052,-18,1336,2760,20
56691026592,56691026588,-4,1153,2655,20
56692792410,56692792404,-6,755,2607,20
56697239954,56697239950,-4,1746,3267,20
56697981353,56697981353,0,757,1511,20
56698194634,56698194636,2,687,1375,20
56701060244,56701060242,-2,826,1965,20
56708055531,56708055526,-5,855,2259,20
56711167463,56711167449,-14,2262,12411,20
56712446458,56712446456,-2,780,2296,20
56715784846,56715784845,-1,1064,1913,20
56719369176,56719369174,-2,1431,2084,20
56720272449,56720272442,-7,1533,5565,20
56721771582,56721771582,0,1116,1699,20
56730687186,56730687183,-3,1175,2261,20
56730979094,56730979093,-1,1297,1841,20
56731664335,56731664331,-4,1067,3067,20
56736899550,56736899550,0,1577,2205,20
56737927322,56737927324,2,1932,2692,20
56740230657,56740230651,-6,726,1849,20
56741970337,56741970334,-3,1065,1148,20
56752829884,56752829881,-3,1036,2375,20
56756815022,56756815014,-8,979,6670,20
56758577123,56758577120,-3,1079,1731,20
56760597085,56760597083,-2,1309,2663,20
56762295371,56762295369,-2,1090,2040,20
56766200122,56766200121,-1,1151,2397,20
56766299692,56766299673,-19,254,1012,20
56767661225,56767661222,-3,1075,1582,20
56769272767,56769272765,-2,882,2569,20
56771447019,56771447023,4,2124,1294,20
56775668974,56775668973,-1,1278,2278,20
56777785502,56777785500,-2,797,2196,20
56779062422,56779062419,-3,935,2501,20
56780123323,56780123321,-2,1107,2092,20
56780855199,56780855217,18,1394,2165,20
56785313034,56785313032,-2,1419,2328,20
56788340927,56788340926,-1,958,1856,20
56792426244,56792426243,-1,968,2788,20
56796071853,56796071859,6,1758,1388,20
56802016308,56802016305,-3,897,1824,20
56804580411,56804580407,-4,944,2419,20
56806348984,56806348981,-3,1325,1833,20
56808536859,56808536857,-2,1373,2828,20
56811761769,56811761768,-1,1672,3046,20
56814199067,56814199064,-3,1340,3043,20
56816310250,56816310248,-2,1120,2389,20
56816603363,56816603359,-4,1655,3220,20
56816761958,56816761955,-3,1273,3040,20
56816809634,56816809633,-1,456,1095,20
56822549206,56822549205,-1,1046,2050,20
56824979142,56824979141,-1,974,2554,20
56825646518,56825646515,-3,1116,2680,20
56834089826,56834089822,-4,1275,1699,20
56839797052,56839797046,-6,1420,1779,20
56839885744,56839885739,-5,1389,2457,20
56841455685,56841455682,-3,1321,2174,20
56845412171,56845412169,-2,1142,1932,20
56850315826,56850315822,-4,1397,2652,20
56853534737,56853534734,-3,1316,1829,20
56856470707,56856470705,-2,1144,2199,20
56856856034,56856856030,-4,986,1880,20
56857399991,56857399988,-3,1251,3249,20
56861313191,56861313211,20,1195,2063,20
56863907049,56863907046,-3,1464,3412,20
56873450482,56873450479,-3,847,1831,20
56873744790,56873744810,20,892,3583,20
56874910498,56874910495,-3,991,2007,20
56875419245,56875419242,-3,1166,2452,20
56879281708,56879281706,-2,1201,2429,20
56882457432,56882457430,-2,872,2032,20
56886327238,56886327234,-4,1097,1486,20
56886792075,56886792074,-1,1241,2883,20
56890847770,56890847766,-4,1090,2572,20
56891688414,56891688412,-2,894,2168,20
56895424911,56895424908,-3,843,1870,20
56896278481,56896278478,-3,1366,2202,20
56896597778,56896597771,-7,823,2263,20
56901702714,56901702713,-1,1218,2678,20
56903949318,56903949339,21,471,1249,20
56907024330,56907024326,-4,983,1828,20
56907290990,56907291007,17,1189,3523,20
56911666870,56911666870,0,1186,1951,20
56912769051,56912769048,-3,1233,2702,20
56913400969,56913400962,-7,788,3120,20
56914602541,56914602538,-3,2317,5026,20
56919337619,56919337618,-1,1263,2570,20
56921463596,56921463591,-5,1403,3367,20
56923254154,56923254153,-1,1105,1686,20
56923509154,56923509152,-2,955,1786,20
56924517166,56924517163,-3,1363,3444,20
56926000977,56926000974,-3,1269,2897,20
56929086222,56929086218,-4,1294,1953,20
56929396040,56929396059,19,725,1006,20
56932788398,56932788398,0,1414,2944,20
56935456070,56935456066,-4,1015,2895,20
56937346155,56937346151,-4,1298,2425,20
56940083844,56940083843,-1,1067,2291,20
56941177152,56941177169,17,1344,1109,20
56942643116,56942643118,2,16438,12716,20
56944224487,56944224485,-2,918,1785,20
56947959957,56947959951,-6,786,2196,20
56948169462,56948169461,-1,573,1517,20
56950037511,56950037509,-2,1372,3336,20
56950374285,56950374286,1,1718,2290,20
56953087082,56953087079,-3,1024,1864,20
56953376993,56953376992,-1,1711,1559,20
56957004203,56957004201,-2,1204,2100,20
56958618034,56958618030,-4,1432,2318,20
56959097590,56959097587,-3,793,2393,20
56961136378,56961136378,0,715,1355,20
56962705239,56962705235,-4,636,1214,20
56964456687,56964456685,-2,1067,2734,20
56964620484,56964620484,0,2957,3508,20
56975593642,56975593638,-4,1355,2451,20
56977629830,56977629839,9,19760,49438,20
56980737527,56980737525,-2,633,1437,20
56983935724,56983935721,-3,1073,1803,20
56985798478,56985798471,-7,947,3280,20
56986784428,56986784425,-3,1064,1994,20
56990600398,56990600395,-3,1351,2810,20
56993304930,56993304928,-2,1392,2018,20
56996625798,56996625794,-4,1074,2149,20
57001761833,57001761831,-2,1529,2176,20
57004829605,57004829610,5,2329,1111,20
57009970199,57009970204,5,1210,1021,20
57011256019,57011256018,-1,794,1540,20
57015357513,57015357512,-1,1189,2184,20
57021966497,57021966494,-3,873,2711,20
57022752789,57022752788,-1,1192,1915,20
57022899744,57022899762,18,378,835,20
57027840942,57027840938,-4,1048,2070,20
57030400861,57030400858,-3,1131,1927,20
57032742346,57032742344,-2,1017,2554,20
57033723755,57033723752,-3,1321,3053,20
57034102405,57034102398,-7,1218,3242,20
57037084290,57037084290,0,905,2367,20
57037792949,57037792946,-3,1176,2508,20
57039781962,57039781958,-4,1584,2407,20
57041964900,57041964897,-3,2119,4794,20
57044637740,57044637746,6,3445,1422,20
57048411255,57048411253,-2,1329,2102,20
57050028019,57050028014,-5,938,1698,20
57050632599,57050632597,-2,1144,2399,20
57053794776,57053794770,-6,1332,1880,20
57056242614,57056242613,-1,1112,1522,20
57056685066,57056685059,-7,834,2108,20
57059410653,57059410650,-3,1222,2381,20
57061527335,57061527335,0,1193,1785,20
57063776085,57063776082,-3,1540,2905,20
57067316781,57067316786,5,8197,32303,20
57073216798,57073216794,-4,1108,2338,20
57073382487,57073382485,-2,1041,1899,20
57075670014,57075670012,-2,1131,2042,20
57082109530,57082109530,0,1378,1880,20
57085226322,57085226320,-2,966,2583,20
57088225694,57088225694,0,901,1503,20
57091111620,57091111615,-5,1205,2633,20
57093715343,57093715340,-3,1229,2853,20
57093795794,57093795794,0,874,1787,20
57095429673,57095429669,-4,1081,2408,20
57096691905,57096691901,-4,860,2417,20
57107555849,57107555845,-4,1075,2044,20
57108732809,57108732806,-3,1111,1909,20
57109685830,57109685827,-3,1299,1779,20
57111259267,57111259262,-5,1184,1815,20
57113330858,57113330857,-1,945,1400,20
57113988011,57113988005,-6,961,2436,20
57114088843,57114088841,-2,992,2297,20
57114547646,57114547645,-1,1467,2059,20
57115294198,57115294196,-2,1388,3080,20
57115666863,57115666861,-2,1113,2436,20
57116246748,57116246745,-3,1428,2474,20
57119780459,57119780457,-2,1198,2453,20
57121256142,57121256139,-3,1093,1887,20
57123208414,57123208415,1,1049,1085,20
57124991341,57124991339,-2,1157,2076,20
57126967313,57126967310,-3,727,2244,20
57130869690,57130869687,-3,792,1822,20
57131069294,57131069314,20,1550,2706,20
57132069189,57132069186,-3,969,2537,20
57140831142,57140831139,-3,876,1644,20
57146432868,57146432866,-2,1284,1869,20
57149617193,57149617192,-1,1308,1505,20
57150023996,57150023995,-1,1233,2275,20
57152070914,57152070911,-3,1220,2217,20
57152367719,57152367735,16,513,1207,20
57153435347,57153435351,4,16,968,20
57154234130,57154234128,-2,1089,1916,20
57157230344,57157230341,-3,1173,2357,20
57160291881,57160291878,-3,1309,2502,20
57167572585,57167572581,-4,994,2625,20
57170080242,57170080241,-1,866,2159,20
57172298361,57172298361,0,882,1680,20
57180402824,57180402818,-6,911,2047,20
57181764223,57181764242,19,1115,2343,20
57182466724,57182466722,-2,843,1922,20
57183237629,57183237631,2,1742,1490,20
57183633847,57183633846,-1,210,1039,20
57186024733,57186024730,-3,741,2709,20
57186270374,57186270370,-4,1107,2374,20
57188961482,57188961479,-3,780,1806,20
57189412235,57189412233,-2,1158,2568,20
57194057618,57194057615,-3,757,2160,20
57194643542,57194643540,-2,1254,1882,20
57196493139,57196493133,-6,881,2379,20
57199309007,57199309003,-4,1038,1184,20
57202053297,57202053291,-6,1191,2523,20
57202340701,57202340698,-3,1414,3439,20
57210784487,57210784483,-4,1425,3331,20
57212922827,57212922822,-5,846,1799,20
57214489458,57214489453,-5,1060,2261,20
57215537203,57215537201,-2,1471,2456,20
57216061614,57216061610,-4,866,1967,20
57216273623,57216273620,-3,1209,2514,20
57218568404,57218568399,-5,1268,2680,20
57221047906,57221047902,-4,1085,2000,20
57224404867,57224404863,-4,1113,2383,20
57226064461,57226064457,-4,1376,2403,20
57226995348,57226995346,-2,1374,2853,20
57227516909,57227516906,-3,1097,2314,20
57230574239,57230574237,-2,1014,1611,20
57230796891,57230796887,-4,932,2856,20
57232195725,57232195739,14,314,1172,20
57233140358,57233140357,-1,1322,2131,20
57238704197,57238704193,-4,1676,3194,20
57239014255,57239014251,-4,652,2123,20
57242255794,57242255791,-3,791,2396,20
57242528212,57242528232,20,1204,3106,20
57243732694,57243732695,1,19701,37238,20
57244628179,57244628176,-3,1014,1392,20
57245903761,57245903759,-2,1298,1898,20
57251290188,57251290182,-6,1346,2317,20
57253206239,57253206234,-5,1223,2698,20
57253668683,57253668678,-5,1130,2632,20
57254170731,57254170729,-2,1138,3014,20
57254265886,57254265882,-4,858,1202,20
57255139763,57255139760,-3,1074,1930,20
57255254501,57255254498,-3,965,2527,20
57257072571,57257072570,-1,1019,2203,20
57259124686,57259124683,-3,939,2160,20
57259810126,57259810122,-4,1479,4103,20
57261318810,57261318808,-2,953,1923,20
57265649685,57265649682,-3,683,1219,20
57267989431,57267989427,-4,905,2392,20
57272755304,57272755321,17,331,740,20
57275970757,57275970755,-2,1619,2621,20
57279254953,57279254959,6,1507,1087,20
57281486736,57281486734,-2,1246,2271,20
57283496840,57283496836,-4,1092,1661,20
57285188483,57285188480,-3,921,2430,20
57288939576,57288939572,-4,979,1949,20
57289009341,57289009338,-3,108,1345,20
57300778869,57300778874,5,9667,5302,20
57303642877,57303642873,-4,1434,3043,20
57307457615,57307457610,-5,896,1913,20
57308244499,57308244495,-4,764,1986,20
57309676558,57309676556,-2,1167,2481,20
57313112036,57313112033,-3,1040,2517,20
57314021614,57314021611,-3,656,1090,20
57314487303,57314487302,-1,1380,1945,20
57316671409,57316671404,-5,883,3217,20
57316756186,57316756182,-4,1138,2985,20
57317957017,57317957015,-2,808,1405,20
57319649935,57319649934,-1,882,2050,20
57329942414,57329942422,8,984,1216,20
57333704167,57333704165,-2,1040,2180,20
57334474271,57334474269,-2,1135,2341,20
57337737720,57337737718,-2,1361,2848,20
57345735087,57345735087,0,1331,2362,20
57348878466,57348878465,-1,1066,2961,20
57350392293,57350392289,-4,933,2300,20
57367044375,57367044382,7,3813,1368,20
57374463993,57374463990,-3,962,2386,20
57377752025,57377752023,-2,1314,2315,20
57379722880,57379722875,-5,1156,3369,20
57382550898,57382550894,-4,5357,10783,20
57384477231,57384477231,0,1185,1751,20
57388359338,57388359335,-3,1190,1965,20
57391005361,57391005352,-9,866,10067,20
57391882714,57391882712,-2,1207,1930,20
57394124428,57394124427,-1,809,2104,20
57395562567,57395562565,-2,1219,1751,20
57401581077,57401581079,2,2593,2562,20
57402832682,57402832678,-4,1123,2024,20
57403836933,57403836930,-3,1076,2570,20
57412573166,57412573160,-6,1079,3655,20
57413511640,57413511638,-2,1103,1403,20
57414381858,57414381851,-7,736,1360,20
57415174357,57415174354,-3,1064,1404,20
57417158248,57417158246,-2,810,2000,20
57417505703,57417505698,-5,830,2870,20
57423407134,57423407132,-2,2709,5067,20
57425192661,57425192658,-3,940,3042,20
57430804786,57430804781,-5,1188,2565,20
57432402995,57432402992,-3,1725,3038,20
57438710513,57438710522,9,4888,1256,20
57440885042,57440885039,-3,1367,2519,20
57441824682,57441824681,-1,1229,2466,20
57445501123,57445501122,-1,1202,2301,20
57446263194,57446263194,0,1092,2245,20
57449857262,57449857258,-4,1265,2607,20
57450122306,57450122311,5,2883,1616,20
57450474518,57450474517,-1,1378,2168,20
57450548234,57450548235,1,1630,1419,20
57450667535,57450667534,-1,31814,22371,20
57455090581,57455090582,1,1830,1745,20
57458553407,57458553405,-2,785,2325,20
57459640196,57459640217,21,915,2089,20
57460065313,57460065310,-3,890,1712,20
57460739671,57460739667,-4,932,2337,20
57461370970,57461370967,-3,1023,3003,20
57462935405,57462935407,2,1551,1911,20
57470368331,57470368327,-4,985,1990,20
57474152845,57474152847,2,1630,771,20
57477990589,57477990584,-5,48274,23640,20
57481928598,57481928597,-1,840,1902,20
57484586297,57484586295,-2,1136,2206,20
57488075711,57488075708,-3,1142,2664,20
57490324974,57490324970,-4,1006,1844,20
57490419134,57490419131,-3,998,2480,20
57494374942,57494374938,-4,1027,1686,20
57497063422,57497063421,-1,1148,1265,20
57499032685,57499032681,-4,1123,2301,20
57499107173,57499107169,-4,831,1493,20
57500986630,57500986628,-2,1452,2356,20
57501830208,57501830225,17,772,2194,20
57501998542,57501998540,-2,1246,1900,20
57502109515,57502109513,-2,971,1430,20
57502810291,57502810289,-2,969,1807,20
57505314011,57505314008,-3,1137,1956,20
57508148433,57508148440,7,5593,3025,20
57509397225,57509397223,-2,788,1949,20
57512267373,57512267371,-2,1440,2050,20
57512524631,57512524648,17,1043,2606,20
57514466067,57514466065,-2,1276,2461,20
57514949560,57514949558,-2,1132,2256,20
57519819128,57519819126,-2,1434,2674,20
57520269906,57520269902,-4,1088,2446,20
57521423735,57521423734,-1,1009,2194,20
57521705595,57521705592,-3,900,2131,20
57523643818,57523643813,-5,762,2701,20
57525541215,57525541210,-5,863,2171,20
57534934869,57534934866,-3,1056,2560,20
57535954464,57535954454,-10,259,1163,20
57539884767,57539884768,1,11698,14283,20
57541966538,57541966536,-2,966,1771,20
57543921364,57543921358,-6,1226,4934,20
57544841667,57544841666,-1,1049,2412,20
57545567351,57545567354,3,112,564,20
57546116679,57546116677,-2,934,2249,20
57548118005,57548118001,-4,1206,2738,20
57548163886,57548163883,-3,745,1615,20
57549164963,57549164959,-4,767,2049,20
57549438971,57549438967,-4,748,1066,20
57549609250,57549609246,-4,1263,2453,20
57557317810,57557317807,-3,710,2168,20
57558412383,57558412383,0,1102,2426,20
57563735224,57563735218,-6,1369,3620,20
57563908901,57563908899,-2,1228,1765,20
57564363825,57564363822,-3,840,2678,20
57565186808,57565186826,18,481,871,20
57571503594,57571503591,-3,1194,2285,20
57572476353,57572476349,-4,1033,2761,20
57580056137,57580056134,-3,1032,1610,20
57580921957,57580921977,20,1249,1801,20
57581370566,57581370563,-3,1209,2560,20
57585118098,57585118094,-4,1195,1817,20
57586720393,57586720399,6,35131,34672,20
57586787062,57586787058,-4,1213,2919,20
57587724970,57587724967,-3,728,1645,20
57600485549,57600485545,-4,1251,2136,20
57601362515,57601362514,-1,1255,2247,20
57605249651,57605249649,-2,1301,2304,20
57606029014,57606029013,-1,1188,2225,20
57606624377,57606624374,-3,1072,2597,20
57609839839,57609839837,-2,1299,2445,20
57611806727,57611806726,-1,1239,2884,20
57614900722,57614900721,-1,783,1984,20
57617695542,57617695539,-3,1321,2831,20
57619389441,57619389442,1,2831,2632,20
57619562515,57619562509,-6,1043,2133,20
57630008795,57630008793,-2,1115,2159,20
57632010491,57632010489,-2,1271,1704,20
57633535533,57633535533,0,1220,2552,20
57637288004,57637288002,-2,933,2191,20
57638334477,57638334457,-20,807,4009,20
57648824298,57648824293,-5,1304,2802,20
57654392111,57654392106,-5,828,1862,20
57655333090,57655333088,-2,1135,2105,20
57656513747,57656513746,-1,1173,2365,20
57660554221,57660554218,-3,489,1419,20
57662277798,57662277794,-4,823,2485,20
57665117383,57665117379,-4,847,1211,20
57667747558,57667747553,-5,1420,3823,20
57670989107,57670989108,1,47543,45218,20
57672703211,57672703209,-2,1071,2061,20
57673806608,57673806626,18,1347,2055,20
57674033905,57674033901,-4,1460,3266,20
57679257221,57679257218,-3,975,1960,20
57691223352,57691223350,-2,835,1538,20
57692709143,57692709142,-1,1715,2255,20
57695238599,57695238599,0,1283,2103,20
57698665099,57698665096,-3,1031,2296,20
57699340310,57699340307,-3,1104,1690,20
57703321834,57703321830,-4,1757,3561,20
57703500077,57703500073,-4,1332,1753,20
57705242299,57705242298,-1,1166,2190,20
57707153714,57707153710,-4,525,1375,20
57710815906,57710815913,7,3047,1180,20
57711094110,57711094106,-4,1236,2566,20
57711205356,57711205356,0,1572,2445,20
57718070759,57718070753,-6,1104,2833,20
57720459088,57720459086,-2,189,1236,20
57724854380,57724854378,-2,1065,2730,20
57729357441,57729357437,-4,1223,2083,20
57730358192,57730358188,-4,1460,2668,20
57730450845,57730450840,-5,17238,17005,20
57733577756,57733577754,-2,324,691,20
57739361429,57739361425,-4,1137,1991,20
57747912541,57747912547,6,3100,1785,20
57753074967,57753074964,-3,1234,2508,20
57756845226,57756845238,12,15373,23910,20
57759775235,57759775231,-4,805,2647,20
57761776014,57761776012,-2,1087,2928,20
57764742899,57764742893,-6,1496,3419,20
57766687323,57766687321,-2,1252,2257,20
57767781430,57767781426,-4,1112,2727,20
57770853706,57770853704,-2,879,2157,20
57774407746,57774407744,-2,969,2173,20
57779940529,57779940526,-3,1073,2763,20
57781982705,57781982704,-1,1615,2319,20
57782231463,57782231458,-5,1189,2247,20
57782423106,57782423105,-1,775,2766,20
57786948419,57786948426,7,1278,789,20
57788319681,57788319678,-3,1082,2329,20
57789219009,57789219007,-2,723,1942,20
57789522534,57789522522,-12,1210,2280,20
57791118002,57791118001,-1,1096,1556,20
57792095491,57792095497,6,2753,1709,20
57793263746,57793263743,-3,941,2048,20
57801006151,57801006148,-3,907,2177,20
57803304969,57803304966,-3,1372,2427,20
57803658225,57803658221,-4,733,1510,20
57804228773,57804228792,19,851,2566,20
57816493381,57816493377,-4,963,2664,20
57820321069,57820321063,-6,2350,8360,20
57822480186,57822480179,-7,941,6006,20
57822516590,57822516584,-6,1315,2564,20
57822968055,57822968050,-5,918,2306,20
57823511694,57823511693,-1,697,1963,20
57824247739,57824247737,-2,1221,2247,20
57830702226,57830702228,2,8807,7918,20
57833054794,57833054790,-4,1035,2155,20
57833323415,57833323414,-1,902,2194,20
57850292095,57850292089,-6,753,3386,20
57850694455,57850694432,-23,1034,2224,20
57851788343,57851788341,-2,1171,2159,20
57852196605,57852196621,16,778,1259,20
57852674823,57852674821,-2,963,2063,20
57854519118,57854519113,-5,1216,2523,20
57856382527,57856382525,-2,887,3514,20
57857875743,57857875750,7,152,700,20
57859174844,57859174838,-6,724,5786,20
57863839207,57863839204,-3,561,1549,20
57870099743,57870099744,1,1434,1608,20
57870373083,57870373078,-5,1631,3539,20
57877226363,57877226361,-2,929,2542,20
57880094102,57880094106,4,2368,1282,20
57880471775,57880471771,-4,1124,2333,20
57881080439,57881080437,-2,1206,2136,20
57883989595,57883989591,-4,670,1549,20
57890186502,57890186500,-2,1255,2438,20
57890240395,57890240393,-2,1409,2612,20
57893188561,57893188568,7,18081,16981,20
57893275631,57893275628,-3,1194,1840,20
57894379251,57894379246,-5,1220,2288,20
57898841945,57898841941,-4,965,2034,20
57906455836,57906455834,-2,1464,2546,20
57907394736,57907394730,-6,1284,3605,20
57907811030,57907811027,-3,1452,3030,20
57908800007,57908800004,-3,1039,2528,20
57915848697,57915848694,-3,1151,1751,20
57916438492,57916438510,18,633,2564,20
57917386441,57917386443,2,3957,3419,20
57917444263,57917444269,6,3440,1407,20
57919397602,57919397599,-3,1422,2977,20
57920263655,57920263651,-4,797,2395,20
57925802324,57925802320,-4,843,2085,20
57933253450,57933253447,-3,1075,2246,20
57933821837,57933821854,17,74,1022,20
57939037763,57939037759,-4,865,2799,20
57940028746,57940028743,-3,1051,2760,20
57941527431,57941527429,-2,1281,2955,20
57946532558,57946532555,-3,804,2210,20
57947017923,57947017919,-4,1041,2174,20
57947089176,57947089195,19,739,1575,20
57947981628,57947981626,-2,1139,1784,20
57950694223,57950694221,-2,947,2422,20
57951869446,57951869446,0,917,2064,20
57954515121,57954515118,-3,1229,2314,20
57954680790,57954680777,-13,273,704,20
57956212114,57956212111,-3,996,2419,20
57956371208,57956371226,18,375,1403,20
57956797794,57956797793,-1,1476,2373,20
57958124314,57958124315,1,1082,1380,20
57970388113,57970388109,-4,1210,2154,20
57975046218,57975046219,1,1051,1367,20
57976182266,57976182264,-2,1292,2670,20
57976237199,57976237217,18,1272,2926,20
57979534477,57979534475,-2,1728,3029,20
57980099947,57980099945,-2,1019,2180,20
57980154849,57980154845,-4,1409,3369,20
57984014602,57984014598,-4,879,1249,20
57986739113,57986739112,-1,1617,2374,20
57987282253,57987282235,-18,1103,3003,20
57987339848,57987339845,-3,1106,2258,20
57987789249,57987789250,1,1284,1021,20
57991096338,57991096337,-1,948,1958,20
57994960622,57994960619,-3,1387,2374,20
57996900236,57996900234,-2,1795,2663,20
57999501827,57999501823,-4,1634,2940,20
58000864216,58000864211,-5,968,1952,20
58009029895,58009029897,2,1110,1469,20
58012027102,58012027102,0,934,2410,20
58012358767,58012358762,-5,1198,1522,20
58014063117,58014063113,-4,1064,2301,20
58017472030,58017472027,-3,1447,2830,20
58027443541,58027443537,-4,1044,2396,20
58027938546,58027938544,-2,1122,2111,20
58031749697,58031749695,-2,734,1626,20
58031992118,58031992098,-20,289,1026,20
58032963506,58032963501,-5,1689,4810,20
58033572133,58033572130,-3,903,1937,20
58035288991,58035288993,2,1721,1357,20
58036032059,58036032057,-2,1059,2242,20
58037632113,58037632107,-6,744,2075,20
58038027596,58038027595,-1,1512,2075,20
58040601374,58040601370,-4,1242,2575,20
58043051990,58043051988,-2,1007,2549,20
58046561207,58046561204,-3,1472,2461,20
58053467864,58053467861,-3,1090,2755,20
58059296606,58059296610,4,837,569,20
58061631327,58061631325,-2,1503,2358,20
58061735512,58061735531,19,780,1828,20
58067072285,58067072282,-3,1325,2791,20
58070278886,58070278882,-4,1034,2996,20
58070813119,58070813116,-3,1642,2775,20
58071154635,58071154632,-3,1315,2434,20
58073425038,58073425037,-1,816,1589,20
58076500235,58076500230,-5,1375,3988,20
58076914014,58076914013,-1,1181,2411,20
58080847891,58080847886,-5,2180,5688,20
58081099777,58081099773,-4,961,2092,20
58081474486,58081474507,21,146,1465,20
58082161165,58082161187,22,138,1014,20
58083630573,58083630569,-4,1185,2161,20
58088849850,58088849847,-3,823,3442,20
58092733726,58092733723,-3,1018,2218,20
58100062852,58100062849,-3,976,2762,20
58109577789,58109577786,-3,1114,2047,20
58113755207,58113755202,-5,672,3132,20
58115502769,58115502766,-3,1102,3091,20
58117740295,58117740291,-4,970,2540,20
58118195116,58118195119,3,562,1115,20
58119536926,58119536922,-4,727,2711,20
58122213619,58122213616,-3,1325,2584,20
58122530667,58122530664,-3,1204,1933,20
58124410901,58124410898,-3,892,2191,20
58124992995,58124992998,3,28132,21530,20
58125584378,58125584374,-4,940,2691,20
58128764835,58128764831,-4,811,2288,20
58130118311,58130118330,19,643,1701,20
58135571923,58135571917,-6,830,2343,20
58138513938,58138513938,0,1139,2211,20
58138657623,58138657638,15,505,789,20
58140341685,58140341681,-4,1325,2593,20
58142506589,58142506586,-3,873,2011,20
58143276187,58143276188,1,1082,2449,20
58145365617,58145365614,-3,845,1627,20
58147483275,58147483273,-2,1184,2406,20
58150734846,58150734842,-4,1010,2605,20
58154392793,58154392789,-4,1310,2233,20
58165194223,58165194219,-4,1466,2764,20
58168336759,58168336757,-2,1353,2579,20
58175030009,58175030005,-4,1109,2141,20
58177795747,58177795742,-5,1095,2739,20
58178851709,58178851709,0,939,1553,20
58180162414,58180162412,-2,802,1978,20
58184362746,58184362742,-4,631,1946,20
58186202594,58186202590,-4,980,2411,20
58186855222,58186855243,21,1048,1525,20
58189609394,58189609399,5,1732,32203,20
58190012374,58190012372,-2,1558,2009,20
58197261351,58197261348,-3,1310,2937,20
58197938377,58197938374,-3,1177,1901,20
58198718062,58198718083,21,1035,2128,20
58206696921,58206696916,-5,1143,1729,20
58209723035,58209723038,3,1392,1196,20
58209884100,58209884098,-2,897,3026,20
58215805198,58215805195,-3,1050,2081,20
58216948671,58216948670,-1,1252,1587,20
58219810111,58219810121,10,14795,37873,20
58228892975,58228892972,-3,1196,2549,20
58240338481,58240338477,-4,892,1507,20
58241681662,58241681662,0,691,1386,20
58242862247,58242862241,-6,987,837,20
58249313723,58249313725,2,1397,918,20
58251457465,58251457461,-4,882,2046,20
58255039157,58255039154,-3,1309,2655,20
58259083265,58259083262,-3,1372,2351,20
58260024275,58260024269,-6,896,1834,20
58262543038,58262543035,-3,648,1922,20
58262717013,58262716995,-18,130,913,20
58266279906,58266279903,-3,1118,2196,20
58266850090,58266850086,-4,788,2228,20
58267452710,58267452705,-5,1054,2030,20
58268678222,58268678219,-3,1251,1608,20
58275931785,58275931785,0,961,1926,20
58277305170,58277305167,-3,924,2343,20
58278812006,58278812003,-3,680,2099,20
58283642095,58283642094,-1,825,2493,20
58288347054,58288347061,7,5168,1362,20
58288662814,58288662816,2,1534,1777,20
58297907295,58297907292,-3,1537,1792,20
58298912798,58298912799,1,1796,1836,20
58299313784,58299313781,-3,876,1956,20
58299665842,58299665838,-4,1250,3026,20
58301310305,58301310304,-1,874,2133,20
58302996365,58302996361,-4,1032,2849,20
58304560923,58304560919,-4,747,2419,20
58307408259,58307408252,-7,1011,4280,20
58311079809,58311079804,-5,1354,3151,20
58311165462,58311165464,2,163,2433,20
58317304366,58317304365,-1,1125,2077,20
58319300102,58319300098,-4,1382,3235,20
58328481958,58328481954,-4,963,1802,20
58328933254,58328933251,-3,976,2386,20
58334253294,58334253294,0,1135,1987,20
58334456377,58334456377,0,1511,1860,20
58336869342,58336869339,-3,227,1167,20
58338943195,58338943198,3,1496,1566,20
58341331394,58341331397,3,2043,1152,20
58345273140,58345273140,0,1406,1572,20
58346556440,58346556437,-3,952,1915,20
58347876263,58347876261,-2,1157,2409,20
58348010784,58348010781,-3,1275,3170,20
58350520525,58350520522,-3,1285,2140,20
58356033961,58356033971,10,12509,42551,20
58357028758,58357028758,0,1430,1914,20
58357469854,58357469848,-6,46371,24069,20
58360554591,58360554588,-3,1390,2158,20
58362203481,58362203478,-3,1003,2439,20
58368414518,58368414515,-3,1029,1725,20
58370095907,58370095905,-2,1175,1526,20
58371077863,58371077860,-3,1361,1926,20
58371245648,58371245645,-3,1077,2150,20
58372041618,58372041614,-4,1029,1607,20
58376606168,58376606166,-2,1266,2267,20
58377431166,58377431179,13,472,1417,20
58380085386,58380085393,7,3983,1545,20
58383212107,58383212112,5,2352,1530,20
58385024050,58385024048,-2,634,1721,20
58385413831,58385413821,-10,869,2336,20
58388355235,58388355233,-2,740,2145,20
58394890189,58394890187,-2,1131,2710,20
58398701081,58398701077,-4,1266,2342,20
58399343859,58399343855,-4,926,2920,20
58399803510,58399803507,-3,767,2314,20
58404970149,58404970145,-4,1363,2687,20
58406180252,58406180255,3,1776,1473,20
58408990693,58408990690,-3,1683,1816,20
58410936410,58410936407,-3,954,1728,20
58411172254,58411172274,20,810,1771,20
58413728260,58413728258,-2,1350,2321,20
58415617307,58415617305,-2,1438,2569,20
58417589185,58417589183,-2,657,1458,20
58418414515,58418414509,-6,955,2120,20
58427210095,58427210092,-3,1336,2883,20
58428382395,58428382391,-4,921,2393,20
58428712845,58428712831,-14,127,571,20
58429990042,58429990039,-3,1200,2728,20
58430920863,58430920858,-5,970,1812,20
58431327407,58431327406,-1,926,2713,20
58436636048,58436636046,-2,1063,1840,20
58437362183,58437362181,-2,1354,3012,20
58437824775,58437824774,-1,969,2249,20
58443108443,58443108439,-4,1191,2832,20
58445525813,58445525811,-2,960,2900,20
58445965003,58445965000,-3,1073,1773,20
58453946929,58453946926,-3,1147,1778,20
58454278354,58454278350,-4,731,2538,20
58456412751,58456412748,-3,1009,2454,20
58461214544,58461214542,-2,1427,2630,20
58465663594,58465663586,-8,1106,2508,20
58466869893,58466869891,-2,1492,2249,20
58468411500,58468411497,-3,1024,1968,20
58473875499,58473875498,-1,1361,2974,20
58476405761,58476405758,-3,1011,2735,20
58478732214,58478732211,-3,1359,3797,20
58482336494,58482336490,-4,823,1865,20
58484748172,58484748172,0,1224,2045,20
58496782873,58496782872,-1,1001,2138,20
58509940015,58509940011,-4,1544,2315,20
58510472005,58510472001,-4,1085,2775,20
58514784460,58514784455,-5,1036,2346,20
58517043718,58517043715,-3,1280,2150,20
58521998650,58521998647,-3,1256,1993,20
58523830329,58523830329,0,1367,1269,20
58524149850,58524149848,-2,1556,2330,20
58527255603,58527255604,1,3532,3842,20
58529180994,58529180990,-4,1348,2282,20
58529299525,58529299510,-15,1048,2573,20
58543135986,58543135981,-5,1025,2587,20
58547575189,58547575186,-3,903,2491,20
58552680287,58552680286,-1,1082,1806,20
58557411264,58557411266,2,1213,1675,20
58559468794,58559468798,4,1561,801,20
58563574214,58563574212,-2,1514,3010,20
58563734815,58563734814,-1,1300,2042,20
58567840191,58567840187,-4,1274,2270,20
58576038878,58576038884,6,2228,1187,20
58577259097,58577259095,-2,1109,2156,20
58577827005,58577827001,-4,1355,2374,20
58585707134,58585707138,4,2356,1277,20
58590581889,58590581885,-4,1525,2678,20
58593142862,58593142861,-1,1373,1297,20
58594778488,58594778501,13,802,2833,20
58599871810,58599871807,-3,1618,2892,20
58600465686,58600465675,-11,1051,2826,20
58606005036,58606005034,-2,1716,2132,20
58607245618,58607245609,-9,1281,5082,20
58612485927,58612485922,-5,853,2440,20
58612959950,58612959946,-4,768,2250,20
58621296957,58621296953,-4,1444,2195,20
58625416802,58625416802,0,2035,2959,20
58627214167,58627214164,-3,1240,2937,20
58633083363,58633083362,-1,613,1837,20
58637247055,58637247054,-1,865,3165,20
58637397278,58637397276,-2,1184,2335,20
58639958496,58639958494,-2,21513,11783,20
58645283698,58645283697,-1,1832,1989,20
58650271370,58650271367,-3,1804,2324,20
58650677346,58650677343,-3,1413,2566,20
58652272022,58652272021,-1,1290,2822,20
58663798542,58663798542,0,1507,1707,20
58667902658,58667902654,-4,729,1500,20
58671327834,58671327832,-2,1184,2723,20
58671525483,58671525489,6,1229,1598,20
58672916471,58672916466,-5,767,1131,20
58674135955,58674135953,-2,1159,1506,20
58674944486,58674944503,17,868,1910,20
58676125973,58676125975,2,2022,1601,20
58679560330,58679560329,-1,1388,2497,20
58686254855,58686254851,-4,957,2288,20
58687624918,58687624922,4,4045,3290,20
58688386830,58688386825,-5,1409,1827,20
58688707360,58688707354,-6,1235,2286,20
58689576423,58689576418,-5,1031,2255,20
58691593483,58691593489,6,3025,906,20
58700350186,58700350185,-1,1198,2482,20
58700840867,58700840866,-1,481,1454,20
58700926903,58700926905,2,302,827,20
58701869890,58701869886,-4,1356,2205,20
58702847995,58702847991,-4,1335,2682,20
58705657950,58705657953,3,1699,1554,20
58708361210,58708361205,-5,826,2425,20
58708970679,58708970678,-1,1344,2159,20
58709082593,58709082589,-4,1173,2076,20
58715579246,58715579245,-1,919,2190,20
58717647889,58717647885,-4,996,1851,20
58729114509,58729114506,-3,1224,2485,20
58731626021,58731626015,-6,570,1663,20
58733415966,58733415950,-16,1073,1859,20
58733709078,58733709094,16,965,2538,20
58734267741,58734267757,16,671,1762,20
58738194266,58738194266,0,2037,1558,20
58741397455,58741397451,-4,1095,2752,20
58748758379,58748758398,19,156,821,20
58754191033,58754191029,-4,1029,2553,20
58757545123,58757545120,-3,1193,2486,20
58758930399,58758930398,-1,1573,2047,20
58763038527,58763038523,-4,977,2076,20
58764600159,58764600157,-2,752,1728,20
58764824438,58764824426,-12,1281,1465,20
58765689099,58765689097,-2,1067,1983,20
58768217225,58768217222,-3,910,2911,20
58768300913,58768300910,-3,795,1362,20
58773774142,58773774143,1,1454,1352,20
58775805766,58775805765,-1,697,1894,20
58776033316,58776033313,-3,1140,2061,20
58777662533,58777662529,-4,1170,2646,20
58778927214,58778927218,4,8815,4960,20
58779625015,58779624996,-19,785,1918,20
58781557127,58781557125,-2,1230,2467,20
58787183205,58787183203,-2,978,2376,20
58789840670,58789840669,-1,1128,3001,20
58790314624,58790314621,-3,1637,3022,20
58792961974,58792961972,-2,1247,2306,20
58797214678,58797214676,-2,615,1816,20
58799526973,58799526970,-3,1297,2716,20
58802972090,58802972094,4,40151,2561,20
58806072423,58806072419,-4,732,1686,20
58809400678,58809400675,-3,959,1923,20
58816291371,58816291369,-2,979,1946,20
58821128653,58821128658,5,2820,848,20
58822663581,58822663578,-3,1052,2308,20
58823283479,58823283477,-2,1294,3111,20
58827032942,58827032937,-5,599,2138,20
58827077431,58827077429,-2,1354,2397,20
58827873823,58827873821,-2,1164,1632,20
58828427422,58828427417,-5,855,1071,20
58830488761,58830488759,-2,1497,3210,20
58831117074,58831117070,-4,1050,1495,20
58832614915,58832614914,-1,1083,1859,20
58839584945,58839584945,0,1921,3794,20
58840100175,58840100172,-3,1029,2303,20
58842087644,58842087643,-1,1163,1751,20
58845093538,58845093535,-3,1510,2766,20
58846337322,58846337319,-3,1353,1975,20
58847780674,58847780655,-19,4277,957,20
58847961587,58847961585,-2,1330,2538,20
58857801058,58857801054,-4,1610,4049,20
58858906451,58858906449,-2,922,1665,20
58864379430,58864379427,-3,1022,1878,20
58864484863,58864484882,19,1219,2894,20
58864535999,58864535995,-4,1325,3495,20
58865594679,58865594678,-1,942,1925,20
58872212513,58872212510,-3,781,2002,20
58873797373,58873797370,-3,1777,2586,20
58884422178,58884422172,-6,967,2876,20
58889547148,58889547145,-3,805,2542,20
58890134502,58890134499,-3,908,1974,20
58899439958,58899439955,-3,1139,1843,20
58899634816,58899634812,-4,1264,2420,20
58900312679,58900312676,-3,1279,2893,20
58908247210,58908247206,-4,922,2770,20
58908703471,58908703465,-6,963,1549,20
58912939511,58912939508,-3,1425,3017,20
58919909697,58919909694,-3,1217,2587,20
58920933804,58920933802,-2,748,1717,20
58921570450,58921570449,-1,1801,2884,20
58924208269,58924208265,-4,961,2111,20
58925698248,58925698246,-2,1155,1832,20
58926616686,58926616684,-2,1190,2552,20
58928166723,58928166719,-4,1694,3445,20
58928214495,58928214493,-2,1378,2271,20
58931122018,58931122016,-2,1335,2210,20
58931484735,58931484733,-2,1288,1934,20
58932399818,58932399815,-3,1013,2736,20
58932588717,58932588734,17,1191,2538,20
58934196904,58934196901,-3,1438,3334,20
58935770635,58935770631,-4,802,2377,20
58938740513,58938740511,-2,1203,2943,20
58940233546,58940233542,-4,965,1965,20
58940531788,58940531791,3,202,607,20
58941829116,58941829113,-3,1305,1963,20
58943337209,58943337203,-6,1132,3122,20
58945910484,58945910478,-6,2608,6369,20
58947031197,58947031194,-3,1148,1901,20
58947938550,58947938548,-2,1237,2657,20
58959195649,58959195647,-2,1376,2306,20
58959471260,58959471255,-5,1430,2459,20
58967861252,58967861248,-4,1187,3245,20
58968409885,58968409881,-4,1032,1982,20
58973143316,58973143314,-2,1148,1803,20
58976795647,58976795645,-2,1029,2337,20
58977411273,58977411269,-4,1066,3104,20
58981800181,58981800182,1,1301,1534,20
58986369284,58986369281,-3,1395,2568,20
58987070362,58987070358,-4,783,2952,20
58989127133,58989127130,-3,875,1908,20
58989843333,58989843330,-3,1427,2740,20
58990215799,58990215798,-1,735,1971,20
58991331595,58991331591,-4,941,1172,20
58991936301,58991936298,-3,946,2043,20
58994626421,58994626419,-2,1256,2398,20
58995688990,58995688985,-5,863,2472,20
58997059226,58997059224,-2,1254,2195,20
58997650893,58997650893,0,1226,2108,20
59004257369,59004257374,5,2892,1766,20
59008315440,59008315437,-3,1208,2114,20
59016883677,59016883674,-3,1172,2033,20
59017106302,59017106298,-4,1472,3036,20
59018538942,59018538939,-3,870,2133,20
59019150311,59019150305,-6,835,2160,20
59019244127,59019244147,20,1135,2899,20
59021114046,59021114041,-5,889,1339,20
59028053793,59028053790,-3,1048,2928,20
59028800504,59028800503,-1,686,1022,20
59029242277,59029242274,-3,1668,2940,20
59033821943,59033821941,-2,1386,2404,20
59038019186,59038019185,-1,1686,2975,20
59041514284,59041514289,5,2047,1342,20
59042683653,59042683650,-3,1197,2287,20
59045435717,59045435714,-3,944,1337,20
59051377910,59051377907,-3,1214,3301,20
59054088413,59054088409,-4,932,2372,20
59054214342,59054214359,17,554,1806,20
59056932409,59056932406,-3,896,2134,20
59057923902,59057923902,0,1356,2503,20
59061237028,59061237025,-3,1153,1936,20
59063160557,59063160552,-5,1067,2987,20
59064641591,59064641586,-5,955,4029,20
59067100243,59067100239,-4,1270,3037,20
59073760871,59073760868,-3,1753,1977,20
59077051114,59077051114,0,638,1779,20
59081849171,59081849167,-4,1026,1858,20
59082053095,59082053083,-12,28,609,20
59087384021,59087384018,-3,969,1810,20
59088240984,59088240981,-3,985,2952,20
59088616749,59088616744,-5,1251,2579,20
59089883925,59089883924,-1,875,2092,20
59090250191,59090250211,20,812,2264,20
59093348907,59093348907,0,1109,2464,20
59095934697,59095934698,1,1489,1314,20
59098256757,59098256757,0,1788,2710,20
59100033550,59100033549,-1,1272,2381,20
59103353426,59103353429,3,1459,1288,20
59108238071,59108238077,6,1477,1439,20
59110101819,59110101814,-5,921,4025,20
59116764615,59116764621,6,3026,991,20
59119022811,59119022809,-2,1075,1254,20
59119146141,59119146138,-3,1202,1974,20
59123895636,59123895634,-2,1331,2656,20
59124801738,59124801733,-5,960,2140,20
59134853265,59134853262,-3,984,2496,20
59138021854,59138021853,-1,920,2335,20
59139220373,59139220378,5,2454,1501,20
59139395849,59139395847,-2,1036,1559,20
59140905714,59140905713,-1,892,2520,20
59142470472,59142470468,-4,2859,4826,20
59146612835,59146612846,11,13216,30698,20
59148267955,59148267952,-3,804,2532,20
59149763178,59149763179,1,47048,75175,20
59150812835,59150812832,-3,1128,3162,20
59155009710,59155009707,-3,826,2564,20
59158815795,59158815789,-6,3072,8486,20
59162677931,59162677930,-1,1003,2515,20
59166968734,59166968741,7,1728,1083,20
59167744436,59167744434,-2,1104,1979,20
59168026678,59168026676,-2,1013,1996,20
59168710688,59168710683,-5,1091,2399,20
59169660872,59169660889,17,839,1727,20
59172251602,59172251599,-3,1411,3446,20
59176892607,59176892602,-5,1157,2696,20
59177536614,59177536611,-3,834,2384,20
59178742097,59178742095,-2,805,1037,20
59179339693,59179339692,-1,1188,2322,20
59182127988,59182127985,-3,816,2074,20
59182648957,59182648955,-2,1246,1777,20
59185040445,59185040445,0,1522,1827,20
59188653415,59188653415,0,1170,1582,20
59190374370,59190374369,-1,1106,2897,20
59195024454,59195024450,-4,1176,2817,20
59200444906,59200444903,-3,1035,2897,20
59217706180,59217706177,-3,858,1467,20
59219105231,59219105226,-5,838,2277,20
59219815302,59219815301,-1,933,2185,20
59220632438,59220632434,-4,992,2016,20
59220816086,59220816082,-4,1060,2117,20
59221474366,59221474360,-6,1281,4741,20
59221824454,59221824461,7,2648,1332,20
59226200398,59226200394,-4,821,2083,20
59233121707,59233121704,-3,1221,2899,20
59233326608,59233326607,-1,2526,5143,20
59235291335,59235291329,-6,899,1656,20
59240723132,59240723129,-3,1209,3053,20
59244465057,59244465051,-6,1079,3249,20
59249995853,59249995849,-4,511,2248,20
59257665324,59257665322,-2,18501,7795,20
59258557655,59258557651,-4,658,1923,20
59259608414,59259608409,-5,574,1805,20
59264796282,59264796281,-1,1238,2224,20
59265125773,59265125793,20,810,1974,20
59266156492,59266156491,-1,1021,1205,20
59267651822,59267651817,-5,894,2513,20
59268906896,59268906890,-6,1107,2839,20
59269094341,59269094358,17,12685,52718,20
59272466020,59272466013,-7,1452,3295,20
59278031166,59278031162,-4,875,2380,20
59278828902,59278828889,-13,1073,2107,20
59279565646,59279565628,-18,2619,1739,20
59280562524,59280562522,-2,816,1542,20
59282315918,59282315915,-3,736,2568,20
59287558761,59287558759,-2,909,1835,20
59293678590,59293678591,1,3517,3513,20
59294839712,59294839708,-4,1024,1678,20
59297158291,59297158288,-3,851,1412,20
59299015754,59299015757,3,1137,1552,20
59302596459,59302596457,-2,1427,2622,20
59304878443,59304878441,-2,1650,1916,20
59318522759,59318522758,-1,1527,2523,20
59324648315,59324648313,-2,1051,2400,20
59324785924,59324785922,-2,1491,2130,20
59331262880,59331262885,5,19889,32365,20
59336545425,59336545423,-2,1373,2006,20
59338291369,59338291367,-2,1033,1799,20
59342979565,59342979560,-5,1264,2017,20
59343386159,59343386157,-2,1320,2190,20
59344528666,59344528662,-4,968,2128,20
59345545858,59345545858,0,626,1654,20
59346054011,59346054009,-2,951,2092,20
59351183323,59351183321,-2,1002,1742,20
59355612957,59355612956,-1,1131,1926,20
59357251121,59357251116,-5,1341,2378,20
59366518442,59366518437,-5,1264,2537,20
59370362217,59370362212,-5,1016,2392,20
59371650346,59371650342,-4,801,1570,20
59372770509,59372770506,-3,1109,2146,20
59376351947,59376351947,0,917,1311,20
59377667069,59377667066,-3,1146,1798,20
59378940997,59378940998,1,30740,17005,20
59382186027,59382186025,-2,821,2248,20
59382963842,59382963843,1,1199,2395,20
59387625962,59387625961,-1,994,1937,20
59390666513,59390666509,-4,910,1874,20
59396740387,59396740383,-4,1142,1592,20
59400276357,59400276354,-3,944,1944,20
59400609908,59400609905,-3,1433,3125,20
59403926161,59403926167,6,5999,2267,20
59405909318,59405909314,-4,1223,1701,20
59406788796,59406788790,-6,819,1803,20
59411689863,59411689861,-2,808,1270,20
59417136241,59417136237,-4,1224,1985,20
59420244840,59420244836,-4,1639,2762,20
59422355800,59422355805,5,61047,40156,20
59425114453,59425114449,-4,1033,2944,20
59425554272,59425554269,-3,1224,3713,20
59426482763,59426482759,-4,905,1889,20
59429760295,59429760313,18,2701,1348,20
59431286630,59431286625,-5,1099,2436,20
59432490302,59432490318,16,742,1542,20
59432952049,59432952049,0,2876,3745,20
59435145867,59435145865,-2,1907,2969,20
59436141471,59436141467,-4,926,1805,20
59442354546,59442354543,-3,1086,2312,20
59443892259,59443892255,-4,935,2201,20
59446322139,59446322135,-4,846,2391,20
59449064542,59449064537,-5,2156,3414,20
59450401782,59450401785,3,1439,1886,20
59450479996,59450480018,22,691,2164,20
59451418134,59451418133,-1,1428,3000,20
59456578084,59456578080,-4,701,2407,20
59465309563,59465309561,-2,1460,2859,20
59465658575,59465658573,-2,1169,2120,20
59470655623,59470655619,-4,905,2750,20
59471811476,59471811474,-2,1448,2002,20
59472289159,59472289165,6,5119,1708,20
59481181598,59481181594,-4,1008,1615,20
59484605402,59484605401,-1,1082,2407,20
59485173641,59485173634,-7,613,4473,20
59485524801,59485524797,-4,1033,2398,20
59486892021,59486892018,-3,1588,3046,20
59488552786,59488552783,-3,1576,2157,20
59488804486,59488804481,-5,1001,3133,20
59491535082,59491535078,-4,966,1417,20
59492226441,59492226437,-4,1050,2215,20
59497844535,59497844533,-2,840,1618,20
59499301776,59499301774,-2,1208,2005,20
59499721462,59499721469,7,185,1580,20
59500111164,59500111182,18,917,2169,20
59503198385,59503198382,-3,1070,3311,20
59509068391,59509068388,-3,1167,2226,20
59511911113,59511911109,-4,1051,2522,20
59512696976,59512696973,-3,1561,2043,20
59512951941,59512951940,-1,1096,2300,20
59513841625,59513841622,-3,1284,3034,20
59515715146,59515715143,-3,995,1519,20
59515961549,59515961567,18,585,1692,20
59523655470,59523655478,8,4091,1232,20
59525506471,59525506467,-4,638,2074,20
59528075290,59528075286,-4,1242,1955,20
59535844014,59535844010,-4,863,2144,20
59540110039,59540110038,-1,1371,2762,20
59544278806,59544278803,-3,829,1987,20
59548994718,59548994717,-1,1033,1457,20
59550342670,59550342670,0,2935,4804,20
59550997970,59550997964,-6,907,2184,20
59552078539,59552078535,-4,1059,3004,20
59554910038,59554910034,-4,1187,2409,20
59556635339,59556635337,-2,874,1627,20
59562650162,59562650169,7,58339,29518,20
59574344363,59574344362,-1,1094,2119,20
59577021357,59577021357,0,12032,12770,20
59579665117,59579665114,-3,1846,3139,20
59589949069,59589949064,-5,703,1963,20
59590290663,59590290680,17,645,2342,20
59592035152,59592035150,-2,1083,1920,20
59599844894,59599844898,4,5276,3002,20
59604434262,59604434264,2,961,1011,20
59605202163,59605202162,-1,799,1280,20
59608736332,59608736327,-5,1170,2908,20
59615061283,59615061279,-4,1206,2897,20
59617009787,59617009791,4,3587,2386,20
59618302508,59618302505,-3,1388,2616,20
59619512959,59619512961,2,1358,1442,20
59620508004,59620508002,-2,1256,2622,20
59627062549,59627062548,-1,1378,2175,20
59629464323,59629464339,16,1387,983,20
59634411938,59634411934,-4,1473,2519,20
59642262836,59642262831,-5,1152,2802,20
59643337655,59643337657,2,1504,1738,20
59648829517,59648829517,0,1344,1964,20
59649682313,59649682310,-3,907,1730,20
59654228225,59654228221,-4,939,2507,20
59654893329,59654893325,-4,1264,1796,20
59659557821,59659557820,-1,1117,2020,20
59667607063,59667607060,-3,1096,2670,20
59668283222,59668283225,3,1638,1673,20
59669955236,59669955234,-2,1138,1588,20
59670232162,59670232160,-2,1197,2137,20
59672249644,59672249641,-3,2240,5819,20
59675786353,59675786353,0,1130,1982,20
59681106381,59681106381,0,1401,1680,20
59681537129,59681537125,-4,918,2559,20
59682515297,59682515294,-3,887,1893,20
59685424091,59685424091,0,1603,2043,20
59697756654,59697756654,0,1097,2023,20
59703414746,59703414744,-2,993,2602,20
59705051398,59705051403,5,3109,1765,20
59707990971,59707990970,-1,996,2348,20
59708576626,59708576621,-5,1000,1848,20
59709891323,59709891320,-3,660,2461,20
59711143134,59711143117,-17,1090,1875,20
59711275078,59711275085,7,7313,2438,20
59716224221,59716224220,-1,1531,2366,20
59729535025,59729535031,6,1953,1001,20
59736823919,59736823917,-2,1389,1351,20
59738611974,59738611973,-1,1287,2370,20
59739222944,59739222939,-5,1082,2786,20
59741714566,59741714564,-2,874,1987,20
59744223622,59744223619,-3,487,2612,20
59744361261,59744361278,17,818,1723,20
59744968749,59744968746,-3,1566,2900,20
59747179177,59747179174,-3,907,1943,20
59747276112,59747276131,19,336,390,20
59748895745,59748895742,-3,805,2702,20
59750048207,59750048205,-2,1012,1869,20
59759548569,59759548566,-3,917,2210,20
59760447027,59760447022,-5,1114,2163,20
59761759966,59761759965,-1,819,1569,20
59766273340,59766273342,2,1444,1607,20
59767611117,59767611113,-4,1691,2451,20
59769053654,59769053650,-4,808,2654,20
59776341133,59776341127,-6,649,1960,20
59776466694,59776466693,-1,957,1551,20
59778764103,59778764098,-5,1414,2518,20
59787505699,59787505697,-2,1083,1759,20
59790465509,59790465504,-5,1149,2174,20
59791544799,59791544797,-2,1100,2575,20
59791629407,59791629402,-5,1043,2632,20
59797863098,59797863094,-4,1359,3119,20
59798884451,59798884451,0,1076,2473,20
59799856407,59799856405,-2,1423,2584,20
59803898953,59803898950,-3,1258,1893,20
59817417127,59817417133,6,2662,1260,20
59819769276,59819769278,2,1471,1949,20
59821060502,59821060498,-4,1365,2697,20
59823111015,59823111012,-3,1488,2509,20
59824576467,59824576462,-5,606,3236,20
59825212652,59825212650,-2,1199,2471,20
59826031180,59826031175,-5,1130,2692,20
59830843452,59830843449,-3,1240,2134,20
59831108918,59831108918,0,230,856,20
59831698572,59831698593,21,1339,2587,20
59833821462,59833821457,-5,1200,2106,20
59834134153,59834134161,8,3769,1487,20
59839100502,59839100503,1,1662,1694,20
59845077733,59845077730,-3,1275,2084,20
59845816846,59845816852,6,7469,3150,20
59846682251,59846682254,3,1788,2143,20
59848363249,59848363247,-2,1034,1908,20
59849298042,59849298040,-2,1376,1998,20
59851572622,59851572622,0,1131,3773,20
59854344790,59854344778,-12,304,935,20
59858202978,59858202976,-2,1118,3744,20
59861903901,59861903898,-3,952,1555,20
59862890555,59862890553,-2,1387,1900,20
59865587738,59865587738,0,859,1393,20
59874338975,59874338974,-1,1352,2074,20
59875067957,59875067958,1,2174,3508,20
59878425343,59878425342,-1,1188,1604,20
59880089973,59880089962,-11,36709,15475,20
59880126776,59880126777,1,4434,6230,20
59884324218,59884324226,8,6001,2500,20
59884692295,59884692291,-4,937,2289,20
59884750388,59884750385,-3,1037,3144,20
59887053635,59887053636,1,1205,1931,20
59892734171,59892734150,-21,1197,2086,20
59893863201,59893863196,-5,926,2812,20
59898972462,59898972467,5,1479,1364,20
59899107321,59899107314,-7,692,1216,20
59900223415,59900223410,-5,1331,2250,20
59905561375,59905561371,-4,997,2747,20
59909893842,59909893838,-4,1565,3362,20
59910529435,59910529441,6,988,1151,20
59912801577,59912801575,-2,962,1898,20
59915166795,59915166792,-3,1645,2650,20
59916323671,59916323665,-6,1079,1923,20
59918265828,59918265827,-1,1743,2424,20
59920081287,59920081291,4,1547,1639,20
59923292249,59923292247,-2,836,2084,20
59928349170,59928349167,-3,959,2363,20
59931852003,59931852006,3,2315,1299,20
59933595947,59933595945,-2,1531,1935,20
59935907374,59935907373,-1,1206,3001,20
59942907067,59942907065,-2,1033,2406,20
59944079401,59944079398,-3,1003,1520,20
59944581656,59944581653,-3,1178,2522,20
59945616335,59945616338,3,49286,35630,20
59949887203,59949887201,-2,929,1706,20
59950924766,59950924763,-3,1895,3412,20
59951075299,59951075296,-3,1266,2372,20
59952111042,59952111039,-3,1335,2470,20
59956282625,59956282628,3,7390,23948,20
59962969901,59962969898,-3,1324,2801,20
59963935294,59963935294,0,1405,1630,20
59965294953,59965294949,-4,1124,3741,20
59966471657,59966471673,16,686,1546,20
59967018126,59967018111,-15,993,2675,20
59967735654,59967735671,17,618,1389,20
59976110705,59976110702,-3,1127,2322,20
59977379293,59977379291,-2,1415,1766,20
59980282095,59980282091,-4,1009,2215,20
59981451460,59981451458,-2,1305,1914,20
59982299807,59982299803,-4,1193,2360,20
59982355893,59982355889,-4,902,1870,20
59982619599,59982619596,-3,874,2674,20
59986803568,59986803563,-5,1164,2024,20
59989312351,59989312355,4,1622,1718,20
59989359130,59989359127,-3,1092,2878,20
59989470892,59989470879,-13,68,1134,20
59991422568,59991422567,-1,1265,1770,20
59994263766,59994263761,-5,1224,2223,20
59994672027,59994672026,-1,668,2586,20
59996224050,59996224051,1,1438,2594,20
59997559824,59997559819,-5,1047,2417,20
60001958134,60001958135,1,1371,2499,20
60003658911,60003658910,-1,1344,2154,20
60004009271,60004009269,-2,688,1774,20
60006632322,60006632326,4,61139,32995,20
60009106777,60009106777,0,1345,2248,20
60012142387,60012142382,-5,729,1988,20
60013904093,60013904090,-3,1003,2665,20
60014198597,60014198619,22,673,2752,20
60017229911,60017229909,-2,931,1504,20
60017782355,60017782353,-2,1235,2297,20
60019883403,60019883401,-2,614,1213,20
60022165190,60022165186,-4,2301,4864,20
60022579760,60022579754,-6,1049,2919,20
60023424414,60023424411,-3,768,1565,20
60030543270,60030543269,-1,984,1846,20
60030609026,60030609005,-21,1968,979,20
60031677829,60031677825,-4,1635,1854,20
60034550995,60034550989,-6,1084,4199,20
60034957309,60034957329,20,1167,2367,20
60035019582,60035019578,-4,965,2892,20
60047835382,60047835379,-3,1581,2588,20
60047999942,60047999935,-7,1102,2445,20
60049138163,60049138163,0,27666,24577,20
60049923035,60049923032,-3,1072,2768,20
60050259391,60050259375,-16,1038,2478,20
60050406964,60050406962,-2,1058,2701,20
60050484910,60050484907,-3,911,1631,20
60054078142,60054078139,-3,1198,2842,20
60054376946,60054376943,-3,895,2130,20
60055356981,60055356979,-2,1201,1903,20
60056648492,60056648489,-3,1326,3390,20
60061360089,60061360088,-1,1074,1834,20
60061768399,60061768386,-13,1044,2172,20
60062844005,60062844023,18,465,866,20
60063552874,60063552872,-2,1271,2287,20
60064223790,60064223785,-5,809,2304,20
60068530023,60068530020,-3,993,3079,20
60079621826,60079621827,1,1529,1113,20
60080908322,60080908320,-2,1080,2436,20
60082954659,60082954673,14,35,1521,20
60089177318,60089177314,-4,1215,1742,20
60092607946,60092607944,-2,1445,2359,20
60095108835,60095108833,-2,839,2010,20
60099972985,60099972981,-4,993,2208,20
60104696887,60104696891,4,794,1872,20
60114049477,60114049473,-4,1343,2782,20
60118666403,60118666400,-3,1248,1533,20
60123451901,60123451899,-2,1433,2921,20
60124605494,60124605491,-3,1285,2663,20
60126140340,60126140337,-3,1268,2451,20
60127907566,60127907563,-3,1278,2239,20
60128177606,60128177605,-1,1041,2778,20
60129086593,60129086590,-3,999,2262,20
60129228334,60129228330,-4,1067,2120,20
60142085844,60142085841,-3,861,2211,20
60143441342,60143441338,-4,1355,2179,20
60144495542,60144495558,16,1073,2178,20
60144600082,60144600079,-3,832,2480,20
60144785562,60144785557,-5,1286,3211,20
60149542624,60149542620,-4,1060,3212,20
60151739369,60151739366,-3,1005,1760,20
60151904666,60151904664,-2,1301,2340,20
60155868713,60155868718,5,2343,1098,20
60158169019,60158169018,-1,1033,2003,20
60163932019,60163932017,-2,1582,2195,20
60165661643,60165661640,-3,978,1730,20
60170125095,60170125093,-2,814,1351,20
60171186583,60171186580,-3,1138,1754,20
60173902017,60173902013,-4,1167,2142,20
60176342982,60176342977,-5,1622,2600,20
60177279296,60177279273,-23,830,2329,20
60179441135,60179441132,-3,1163,1366,20
60185166369,60185166365,-4,1203,2653,20
60185962178,60185962175,-3,902,2170,20
60188155514,60188155511,-3,1144,2386,20
60190838864,60190838860,-4,873,2707,20
60191534719,60191534717,-2,740,1744,20
60191765674,60191765675,1,1810,1779,20
60200934833,60200934829,-4,1021,2654,20
60203305301,60203305308,7,2563,1074,20
60205107013,60205107009,-4,1154,3017,20
60205233183,60205233202,19,1451,2478,20
60205460090,60205460095,5,1599,1081,20
60208961710,60208961706,-4,1272,2170,20
60210478134,60210478138,4,2321,1441,20
60215351984,60215351982,-2,767,1117,20
60216255946,60216255943,-3,903,2548,20
60218430038,60218430035,-3,917,2483,20
60221502277,60221502288,11,18008,23207,20
60225488405,60225488397,-8,1060,3718,20
60228110246,60228110247,1,3342,3824,20
60232999537,60232999535,-2,1149,2793,20
60234480870,60234480864,-6,765,1699,20
60234617069,60234617086,17,1678,3141,20
60236987253,60236987250,-3,790,1606,20
60238111754,60238111750,-4,5321,11008,20
60241397883,60241397878,-5,835,1809,20
60252002591,60252002588,-3,1489,2991,20
60255477458,60255477456,-2,1312,2280,20
60255983146,60255983142,-4,1381,2524,20
60256571834,60256571832,-2,1224,1717,20
60259641872,60259641870,-2,1232,2288,20
60261096374,60261096371,-3,1104,1801,20
60267036132,60267036136,4,2013,1293,20
60269691123,60269691122,-1,1117,2257,20
60269775274,60269775272,-2,1458,2873,20
60270479250,60270479248,-2,1964,2285,20
60270547725,60270547722,-3,1110,3125,20
60270994710,60270994704,-6,1137,2285,20
60271458841,60271458850,9,15571,27975,20
60275092410,60275092407,-3,1156,2278,20
60278565969,60278565965,-4,1080,2930,20
60290668210,60290668205,-5,1091,1324,20
60294615647,60294615645,-2,1146,2030,20
60294878170,60294878167,-3,975,2053,20
60295207230,60295207221,-9,1255,2139,20
60295256323,60295256323,0,1110,1517,20
60295543286,60295543267,-19,425,1267,20
60299100158,60299100156,-2,842,2734,20
60299780965,60299780966,1,159,460,20
60304975793,60304975797,4,183,750,20
60307372450,60307372447,-3,1352,2541,20
60313475183,60313475179,-4,764,2064,20
60314126103,60314126114,11,12,608,20
60321923902,60321923902,0,903,1606,20
60325608898,60325608894,-4,861,1711,20
60326455704,60326455698,-6,1120,2770,20
60328842974,60328842972,-2,1008,1540,20
60341810966,60341810961,-5,1133,2079,20
60343090907,60343090906,-1,1071,2966,20
60346277173,60346277169,-4,1328,2467,20
60359300485,60359300482,-3,1526,2190,20
60361357837,60361357833,-4,1181,2138,20
60371758996,60371758993,-3,1016,2053,20
60375832227,60375832225,-2,1333,2699,20
60386399295,60386399298,3,2591,2183,20
60392104531,60392104545,14,898,1120,20
60398702882,60398702881,-1,903,1376,20
60399474599,60399474597,-2,1423,2185,20
60399866563,60399866559,-4,739,2679,20
60401636921,60401636917,-4,1551,2925,20
60402027976,60402027975,-1,1579,2556,20
60403287878,60403287875,-3,1399,2589,20
60404095902,60404095903,1,2933,2975,20
60408915581,60408915578,-3,1075,1960,20
60419820410,60419820409,-1,1305,2794,20
60426266511,60426266511,0,1256,1278,20
60427779433,60427779428,-5,1001,3700,20
60428052533,60428052531,-2,769,1583,20
60436160557,60436160554,-3,1018,2894,20
60441408464,60441408462,-2,1635,2520,20
60446550495,60446550494,-1,1821,2920,20
60451723590,60451723586,-4,1091,3028,20
60454213098,60454213093,-5,1257,2497,20
60455771358,60455771354,-4,1228,1840,20
60456299452,60456299450,-2,1332,2053,20
60456976863,60456976861,-2,652,864,20
60462014483,60462014479,-4,1078,1438,20
60462748899,60462748894,-5,1056,1418,20
60464432931,60464432927,-4,1206,2262,20
60465577343,60465577341,-2,1490,2085,20
60466761719,60466761700,-19,796,824,20
60468440599,60468440598,-1,999,1681,20
60468666028,60468666046,18,925,2576,20
60477149356,60477149354,-2,943,2025,20
60479090239,60479090238,-1,1097,1854,20
60484210650,60484210646,-4,1351,2631,20
60484679295,60484679297,2,733,841,20
60489069292,60489069287,-5,1565,2866,20
60489739854,60489739852,-2,1504,2800,20
60490752975,60490752974,-1,775,1794,20
60494837002,60494836999,-3,715,1418,20
60499026164,60499026168,4,4489,3477,20
60500527253,60500527246,-7,2890,9645,20
60503020327,60503020326,-1,1047,2424,20
60503525627,60503525625,-2,973,2436,20
60504713081,60504713078,-3,1075,2664,20
60507801973,60507801985,12,11018,46044,20
60508572527,60508572525,-2,900,1783,20
60512719046,60512719042,-4,1179,2251,20
60513808130,60513808126,-4,1178,2274,20
60514395173,60514395162,-11,30839,14133,20
60523784547,60523784546,-1,1177,2095,20
60524039447,60524039444,-3,1135,2242,20
60529426932,60529426931,-1,1684,1940,20
60532433322,60532433319,-3,834,2939,20
60537413165,60537413169,4,2311,1397,20
60538773853,60538773851,-2,1139,2639,20
60542367621,60542367617,-4,1434,3500,20
60542581118,60542581119,1,1669,1005,20
60544603367,60544603368,1,843,1708,20
60544641791,60544641789,-2,1270,1802,20
60549708969,60549708965,-4,1846,2383,20
60552400520,60552400518,-2,1113,2018,20
60553148419,60553148417,-2,1435,3332,20
60553771909,60553771896,-13,948,3027,20
60564929192,60564929198,6,2897,1254,20
60567116650,60567116641,-9,1010,4917,20
60568973105,60568973104,-1,1127,1785,20
60569125477,60569125477,0,1281,1840,20
60570288469,60570288462,-7,1482,9690,20
60576590687,60576590695,8,2710,1072,20
60577689306,60577689308,2,1566,1703,20
60578839777,60578839774,-3,1039,2411,20
60579557536,60579557530,-6,1033,2300,20
60586631021,60586631017,-4,1475,2804,20
60592791806,60592791803,-3,1119,2667,20
60595340067,60595340062,-5,859,2164,20
60597716508,60597716505,-3,1152,2114,20
60597975883,60597975880,-3,1095,1868,20
60603332686,60603332686,0,1744,1614,20
60603679766,60603679766,0,601,1231,20
60604629847,60604629845,-2,709,1595,20
60607711385,60607711383,-2,1264,1907,20
60610274597,60610274594,-3,982,2382,20
60610371822,60610371837,15,192,674,20
60611672491,60611672489,-2,1101,1817,20
60612015254,60612015245,-9,1211,2253,20
60615503747,60615503754,7,5849,2257,20
60616939824,60616939822,-2,1456,2359,20
60617636181,60617636198,17,727,1735,20
60619041086,60619041083,-3,1116,1893,20
60619154358,60619154357,-1,669,1418,20
60619498592,60619498609,17,746,1694,20
60621512359,60621512355,-4,893,2224,20
60621872250,60621872250,0,1132,2006,20
60622933786,60622933784,-2,1322,2393,20
60625246686,60625246684,-2,1361,1814,20
60626768689,60626768687,-2,867,2063,20
60627676725,60627676721,-4,1388,2713,20
60633801275,60633801274,-1,1002,2509,20
60638737869,60638737864,-5,1061,2982,20
60639286462,60639286462,0,11007,11951,20
60640046479,60640046477,-2,774,1484,20
60641312795,60641312791,-4,994,2061,20
60648279295,60648279290,-5,988,2811,20
60651608597,60651608594,-3,733,1941,20
60655712755,60655712758,3,3262,3317,20
60667622404,60667622404,0,1348,1782,20
60668633434,60668633430,-4,1276,2497,20
60676033291,60676033290,-1,1591,2626,20
60678191551,60678191553,2,1117,1172,20
60679008919,60679008917,-2,1471,2322,20
60682012669,60682012669,0,1091,2397,20
60682467182,60682467178,-4,1039,2170,20
60688084712,60688084707,-5,981,2336,20
60693907975,60693907972,-3,1163,2966,20
60694366841,60694366835,-6,919,1628,20
60703757718,60703757734,16,948,2414,20
60716478575,60716478572,-3,2296,5980,20
60717706562,60717706559,-3,1486,2918,20
60727394865,60727394862,-3,1365,2397,20
60727792268,60727792274,6,5814,2845,20
60728834592,60728834583,-9,20895,17925,20
60729713264,60729713262,-2,1093,2502,20
60732815549,60732815545,-4,963,2273,20
60737531965,60737531964,-1,30891,55537,20
60738614943,60738614939,-4,807,2167,20
60738642468,60738642486,18,1125,2659,20
60740878130,60740878129,-1,1293,2665,20
60746809471,60746809469,-2,1058,2510,20
60751233709,60751233707,-2,1046,2401,20
60757088678,60757088678,0,1420,3034,20
60757213390,60757213389,-1,843,1817,20
60767189164,60767189163,-1,1239,2541,20
60768814762,60768814758,-4,1009,3500,20
60770358717,60770358714,-3,1139,2504,20
60771114555,60771114550,-5,1252,2194,20
60777145549,60777145548,-1,811,2041,20
60779550299,60779550298,-1,2083,1879,20
60781229011,60781229007,-4,902,2647,20
60785768366,60785768362,-4,937,1939,20
60793358799,60793358796,-3,1121,1899,20
60794919453,60794919449,-4,1483,1712,20
60796058089,60796058087,-2,998,1738,20
60801838516,60801838514,-2,1183,2410,20
60802140778,60802140779,1,10215,11737,20
60805050493,60805050490,-3,965,2239,20
60812162225,60812162222,-3,1109,1936,20
60816119325,60816119322,-3,1480,2483,20
60825984869,60825984866,-3,1053,2478,20
60826260139,60826260137,-2,856,1781,20
60833682610,60833682593,-17,1246,225,20
60835457672,60835457668,-4,1373,3043,20
60837424402,60837424398,-4,947,2168,20
60839866869,60839866866,-3,2348,4689,20
60848733593,60848733598,5,3736,1777,20
60850540215,60850540213,-2,1269,2710,20
60851015438,60851015423,-15,166,688,20
60852746258,60852746263,5,5650,2713,20
60853735884,60853735880,-4,949,1634,20
60856347173,60856347169,-4,1200,2952,20
60858354118,60858354114,-4,1135,2311,20
60859697406,60859697402,-4,1013,2840,20
60861774164,60861774175,11,170,550,20
60864037524,60864037527,3,2144,1282,20
60872144546,60872144542,-4,970,1939,20
60873880030,60873880027,-3,1072,2362,20
60879485870,60879485870,0,1151,2012,20
60880389893,60880389890,-3,1384,2964,20
60880922090,60880922087,-3,1205,1868,20
60883501970,60883501966,-4,1038,2497,20
60886801955,60886801952,-3,1031,1903,20
60888804078,60888804085,7,4084,1741,20
60889914697,60889914694,-3,1568,3219,20
60896348636,60896348632,-4,1185,2814,20
60906521017,60906521012,-5,1432,3334,20
60906850221,60906850241,20,793,2031,20
60907570098,60907570093,-5,1181,2558,20
60912161906,60912161904,-2,1037,1725,20
60913875332,60913875330,-2,1389,2412,20
60920168176,60920168174,-2,810,1621,20
60921384026,60921384025,-1,1464,1775,20
60923165602,60923165599,-3,1006,2018,20
60928248288,60928248286,-2,1135,2029,20
60930038526,60930038526,0,2313,2318,20
60937494175,60937494166,-9,400,3655,20
60940039122,60940039122,0,1207,1959,20
60942922384,60942922382,-2,644,1240,20
60943625465,60943625462,-3,802,2062,20
60944423371,60944423370,-1,1690,3133,20
60946020399,60946020397,-2,1190,2088,20
60946656591,60946656589,-2,1270,2226,20
60951357218,60951357220,2,1891,1765,20
60951781188,60951781183,-5,1346,1857,20
60958298512,60958298509,-3,948,2358,20
60966426040,60966426057,17,16758,54685,20
60977732978,60977732976,-2,2022,3023,20
60979495797,60979495796,-1,772,1514,20
60980266719,60980266714,-5,1455,2925,20
60983904958,60983904956,-2,943,2330,20
60984287930,60984287926,-4,1078,2403,20
60986315628,60986315624,-4,1407,2206,20
60990429169,60990429169,0,1010,1136,20
60991268599,60991268597,-2,873,2793,20
60992090718,60992090718,0,193,661,20
60994239934,60994239954,20,356,464,20
60995049536,60995049533,-3,1532,3210,20
60995755901,60995755903,2,1712,1564,20
61001812761,61001812759,-2,1364,2641,20
61002138271,61002138269,-2,1119,2537,20
61004039250,61004039246,-4,1041,1938,20
61005289482,61005289479,-3,1691,3291,20
61007276869,61007276867,-2,835,1700,20
61011206185,61011206185,0,1263,1752,20
61012134234,61012134229,-5,866,1910,20
61019621645,61019621642,-3,1348,2536,20
61024761133,61024761131,-2,1597,2279,20
61027571393,61027571393,0,1614,1734,20
61028039715,61028039714,-1,1202,2151,20
61029036791,61029036786,-5,2221,7220,20
61030636946,61030636942,-4,977,2558,20
61034008806,61034008802,-4,1253,2209,20
61038340774,61038340770,-4,1213,3003,20
61041401346,61041401342,-4,1135,2553,20
61041842263,61041842259,-4,1570,2681,20
61043092583,61043092579,-4,1127,2207,20
61043289023,61043289021,-2,1494,2181,20
61043854308,61043854307,-1,919,2018,20
61044280341,61044280337,-4,991,2961,20
61049938934,61049938931,-3,1364,1920,20
61058691422,61058691427,5,2518,1174,20
61065336284,61065336281,-3,1299,3341,20
61067390711,61067390709,-2,962,1831,20
61071057911,61071057906,-5,1040,1813,20
61073125114,61073125117,3,1546,1532,20
61075221373,61075221352,-21,960,3263,20
61079226035,61079226032,-3,1085,2525,20
61082067314,61082067313,-1,623,965,20
61083829219,61083829214,-5,1007,2504,20
61089317323,61089317320,-3,949,2066,20
61089426855,61089426852,-3,1325,2093,20
61091655597,61091655598,1,1346,2108,20
61094135271,61094135251,-20,26364,29279,20
61097607774,61097607771,-3,1078,3185,20
61098352793,61098352788,-5,1126,2366,20
61099753071,61099753070,-1,993,2189,20
61100248986,61100248982,-4,588,1391,20
61101022684,61101022681,-3,1520,3238,20
61102186381,61102186379,-2,1306,3198,20
61104628603,61104628599,-4,1142,3026,20
61109458365,61109458364,-1,1400,1673,20
61112174862,61112174859,-3,547,1894,20
61115588096,61115588091,-5,1467,2428,20
61116591758,61116591753,-5,757,4285,20
61125996480,61125996477,-3,1395,2738,20
61133381647,61133381650,3,2281,1344,20
61137328405,61137328402,-3,939,2063,20
61145162319,61145162315,-4,793,1387,20
61148690782,61148690786,4,3818,1479,20
61151406742,61151406737,-5,1101,2105,20
61153406726,61153406722,-4,1459,2730,20
61156914023,61156914021,-2,865,1656,20
61157863901,61157863898,-3,1017,1354,20
61161639470,61161639466,-4,1488,3201,20
61163269373,61163269371,-2,1219,1491,20
61163354647,61163354636,-11,1091,1933,20
61167018008,61167018009,1,38218,16564,20
61168153074,61168153072,-2,1218,2550,20
61168867815,61168867813,-2,1282,2162,20
61170657244,61170657243,-1,1017,2244,20
61172659214,61172659210,-4,1009,2497,20
61174288038,61174288037,-1,1104,1858,20
61180845131,61180845133,2,1306,1400,20
61181964625,61181964626,1,976,1013,20
61182885022,61182885023,1,1459,1426,20
61185204189,61185204195,6,5789,2760,20
61186361745,61186361745,0,17676,23458,20
61187170036,61187170041,5,2036,1395,20
61189266757,61189266753,-4,1441,3291,20
61191731319,61191731316,-3,1236,3101,20
61194465200,61194465197,-3,1432,2334,20
61196501806,61196501802,-4,1559,2385,20
61202038541,61202038539,-2,1410,2609,20
61202765512,61202765508,-4,1043,2655,20
61205868042,61205868041,-1,909,2421,20
61208089901,61208089897,-4,1037,2161,20
61208747201,61208747197,-4,1125,2330,20
61210836160,61210836157,-3,1497,2318,20
61211058673,61211058666,-7,896,4187,20
61212960922,61212960920,-2,1427,2128,20
61213172198,61213172195,-3,1467,2627,20
61217324391,61217324389,-2,1051,2339,20
61222500059,61222500053,-6,210,2123,20
61224039673,61224039673,0,1173,1446,20
61225347218,61225347217,-1,723,2752,20
61225754354,61225754349,-5,1188,3044,20
61228371970,61228371970,0,805,1276,20
61229787263,61229787258,-5,918,2519,20
61232341677,61232341672,-5,1273,1791,20
61236620970,61236620967,-3,786,2015,20
61238143702,61238143698,-4,1221,2517,20
61242452859,61242452855,-4,923,1700,20
61251202645,61251202643,-2,1609,2791,20
61252243026,61252243024,-2,888,1775,20
61252833654,61252833650,-4,1336,2401,20
61253013020,61253013018,-2,1305,2175,20
61255944908,61255944905,-3,1232,2574,20
61263470191,61263470190,-1,722,1462,20
61274591235,61274591230,-5,1010,1605,20
61278218790,61278218787,-3,756,1462,20
61279675738,61279675734,-4,1080,2290,20
61279884892,61279884910,18,841,2258,20
61279951209,61279951204,-5,1118,2948,20
61282147319,61282147317,-2,404,1878,20
61284150998,61284150999,1,1082,1794,20
61285192195,61285192195,0,1192,1631,20
61285434182,61285434181,-1,1047,1938,20
61285919846,61285919845,-1,1375,1771,20
61289893604,61289893601,-3,1008,2670,20
61292254230,61292254227,-3,1251,2063,20
61293379997,61293380015,18,1289,2976,20
61302549982,61302549982,0,1242,2557,20
61302808302,61302808299,-3,1135,2667,20
61308932870,61308932870,0,964,1110,20
61310668397,61310668393,-4,1615,1815,20
61311498741,61311498737,-4,859,2383,20
61311872701,61311872705,4,1480,1223,20
61319084266,61319084265,-1,923,1772,20
61320316281,61320316287,6,2493,1104,20
61324759645,61324759642,-3,1145,2673,20
61325741009,61325741005,-4,891,2241,20
61327787018,61327787016,-2,826,2354,20
61329937914,61329937911,-3,936,2899,20
61333865666,61333865663,-3,1031,1953,20
61340386382,61340386378,-4,1083,2862,20
61340743914,61340743915,1,886,939,20
61342205583,61342205579,-4,873,2187,20
61344316219,61344316218,-1,921,2088,20
61347309976,61347309974,-2,1008,2263,20
61348838126,61348838122,-4,1050,4097,20
61350288003,61350288007,4,385,1105,20
61351474949,61351474946,-3,1431,2324,20
61352997073,61352997063,-10,17506,27978,20
61356353669,61356353665,-4,1094,2854,20
61362429738,61362429736,-2,1103,1706,20
61362738111,61362738130,19,763,2313,20
61363989550,61363989546,-4,862,2567,20
61364595422,61364595418,-4,1292,2868,20
61365302888,61365302885,-3,1500,2368,20
61369310890,61369310887,-3,1010,3183,20
61369383388,61369383406,18,447,1773,20
61370669203,61370669183,-20,3648,3322,20
61375828539,61375828537,-2,780,1882,20
61378550747,61378550744,-3,1255,2141,20
61382375666,61382375664,-2,1030,2447,20
61382449189,61382449185,-4,759,1557,20
61383087921,61383087924,3,3135,2698,20
61383858029,61383858026,-3,1541,3441,20
61385275640,61385275637,-3,1337,2118,20
61385344370,61385344370,0,1554,1230,20
61386172926,61386172926,0,1177,2676,20
61386979819,61386979818,-1,396,959,20
61389723149,61389723145,-4,1172,2142,20
61392893191,61392893190,-1,1092,1840,20
61403190711,61403190710,-1,1107,1415,20
61407705266,61407705265,-1,872,2172,20
61417723829,61417723828,-1,832,1964,20
61418173956,61418173955,-1,1262,1995,20
61421231901,61421231898,-3,1825,2694,20
61421367071,61421367069,-2,1215,1854,20
61426974294,61426974290,-4,1017,2166,20
61429991980,61429991976,-4,1323,2669,20
61430149835,61430149834,-1,1457,2621,20
61434395065,61434395063,-2,1711,1870,20
61436259201,61436259198,-3,1073,2285,20
61444415531,61444415529,-2,1074,2133,20
61447485593,61447485590,-3,1394,1777,20
61449151899,61449151894,-5,1302,2956,20
61453742730,61453742736,6,10637,35288,20
61455162082,61455162078,-4,879,2095,20
61456011859,61456011854,-5,1094,2780,20
61458976096,61458976093,-3,601,1485,20
61459274718,61459274716,-2,1252,2789,20
61463333647,61463333644,-3,941,2296,20
61467404022,61467404019,-3,833,1590,20
61467840941,61467840962,21,1034,1751,20
61468186762,61468186758,-4,1507,2481,20
61472691557,61472691554,-3,1702,2162,20
61475764462,61475764459,-3,984,2329,20
61476117093,61476117089,-4,1659,2276,20
61484770519,61484770513,-6,935,3779,20
61486229543,61486229541,-2,1680,2416,20
61496104822,61496104815,-7,563,1300,20
61503769475,61503769474,-1,926,1816,20
61503806214,61503806234,20,680,1229,20
61516271645,61516271642,-3,954,1709,20
61518863730,61518863728,-2,1108,2448,20
61522034851,61522034849,-2,1353,2526,20
61525942814,61525942806,-8,1263,4486,20
61526048930,61526048934,4,4734,2961,20
61530079355,61530079353,-2,748,2420,20
61532334811,61532334809,-2,1101,1471,20
61533816582,61533816580,-2,936,1736,20
61534370730,61534370728,-2,909,1561,20
61538094042,61538094038,-4,874,2771,20
61540272397,61540272395,-2,814,1548,20
61543805638,61543805635,-3,1513,2224,20
61546470273,61546470270,-3,636,2559,20
61546991813,61546991816,3,271,802,20
61548561887,61548561882,-5,844,2521,20
61548656471,61548656461,-10,1152,2046,20
61548725857,61548725850,-7,1642,5550,20
61550204929,61550204925,-4,1112,1878,20
61550615206,61550615185,-21,138,758,20
61552159084,61552159090,6,2415,695,20
61559742946,61559742943,-3,620,2077,20
61566088129,61566088128,-1,1603,1846,20
61567784914,61567784911,-3,1708,2924,20
61569776665,61569776661,-4,1016,2348,20
61571138802,61571138798,-4,672,1825,20
61574545491,61574545489,-2,796,1486,20
61579724223,61579724222,-1,988,1937,20
61579971542,61579971555,13,4,682,20
61581422642,61581422638,-4,1261,2045,20
61587066659,61587066654,-5,834,1431,20
61593234112,61593234110,-2,1731,3031,20
61593319790,61593319789,-1,1230,1830,20
61593420094,61593420090,-4,998,2218,20
61593960950,61593960946,-4,1372,2632,20
61594501034,61594501030,-4,1147,3051,20
61595205415,61595205410,-5,1549,2854,20
61598040982,61598040980,-2,1460,2519,20
61601160130,61601160126,-4,1086,2096,20
61601387651,61601387646,-5,1452,3089,20
61606819675,61606819671,-4,1188,2431,20
61607613998,61607614017,19,1012,1986,20
61608445012,61608444992,-20,755,1646,20
61610416442,61610416439,-3,1321,2796,20
61612533066,61612533064,-2,1528,3057,20
61614758731,61614758730,-1,802,2452,20
61614952527,61614952513,-14,656,2624,20
61615262014,61615262012,-2,1177,2026,20
61617371517,61617371521,4,3307,2462,20
61618691647,61618691644,-3,1569,2894,20
61619076019,61619076034,15,804,235,20
61619206494,61619206509,15,284,1173,20
61622102012,61622102008,-4,839,1900,20
61623927791,61623927786,-5,979,2520,20
61626888172,61626888167,-5,1374,4717,20
61628785338,61628785335,-3,1264,2232,20
61632146401,61632146397,-4,1313,1966,20
61635493558,61635493557,-1,1334,1515,20
61638353474,61638353472,-2,1010,3235,20
61639345439,61639345442,3,1506,1267,20
61641697470,61641697465,-5,876,2232,20
61643137169,61643137166,-3,1014,1853,20
61646778436,61646778433,-3,1059,1697,20
61647492858,61647492863,5,1206,990,20
61649122218,61649122214,-4,1031,1855,20
61650633990,61650633994,4,1305,983,20
61650984565,61650984572,7,15978,18460,20
61651502994,61651502992,-2,967,1811,20
61653478675,61653478674,-1,1524,2434,20
61655530075,61655530072,-3,1575,3258,20
61661122870,61661122866,-4,793,1371,20
61662323991,61662323985,-6,1212,4024,20
61663151677,61663151673,-4,1083,2139,20
61664282787,61664282785,-2,1002,1639,20
61664750183,61664750179,-4,1304,2876,20
61664869196,61664869186,-10,263,802,20
61666112135,61666112134,-1,848,1625,20
61678512916,61678512911,-5,22750,13477,20
61682056553,61682056555,2,1745,1214,20
61682877525,61682877523,-2,1140,2061,20
61684619560,61684619558,-2,874,2439,20
61686259359,61686259358,-1,1227,2241,20
61686882486,61686882485,-1,1447,2353,20
61699940088,61699940085,-3,1462,2261,20
61700969709,61700969705,-4,1073,2447,20
61702612821,61702612820,-1,2347,3977,20
61710237970,61710237966,-4,1127,2645,20
61711627827,61711627825,-2,1646,1879,20
61716344061,61716344058,-3,1082,1355,20
61717537333,61717537329,-4,1000,2121,20
61718366839,61718366836,-3,1105,2105,20
61721239234,61721239231,-3,861,2771,20
61721909724,61721909721,-3,945,2544,20
61723199575,61723199574,-1,1015,1784,20
61725046407,61725046405,-2,1202,2151,20
61725203320,61725203323,3,1792,1302,20
61725764887,61725764894,7,1579,830,20
61725945866,61725945861,-5,1031,2849,20
61729979310,61729979309,-1,2035,2934,20
61736959408,61736959402,-6,803,2600,20
61741357725,61741357725,0,1666,2467,20
61742790216,61742790215,-1,1661,2879,20
61746962510,61746962507,-3,967,1690,20
61747763005,61747763003,-2,1053,2551,20
61748254237,61748254234,-3,961,2515,20
61753141429,61753141424,-5,1031,3496,20
61756103733,61756103731,-2,1053,2335,20
61759846410,61759846406,-4,4337,14097,20
61760919121,61760919118,-3,1188,2426,20
61765920264,61765920267,3,1945,1246,20
61770831732,61770831726,-6,1317,2333,20
61773499010,61773499005,-5,908,2228,20
61779324434,61779324442,8,3519,1629,20
61779432885,61779432893,8,9564,1238,20
61780461193,61780461190,-3,2198,4621,20
61782302601,61782302598,-3,1063,2199,20
61783514203,61783514201,-2,1128,1546,20
61785928262,61785928262,0,2103,2069,20
61787999861,61787999858,-3,754,2190,20
61789400190,61789400188,-2,1012,1674,20
61792322249,61792322246,-3,965,2310,20
61792642158,61792642155,-3,907,2008,20
61793705576,61793705573,-3,659,1751,20
61800803731,61800803725,-6,2772,8691,20
61806692911,61806692909,-2,775,1955,20
61807060801,61807060799,-2,972,2183,20
61811465135,61811465130,-5,856,1867,20
61813312812,61813312809,-3,1619,2324,20
61813629123,61813629122,-1,1061,1925,20
61820413869,61820413862,-7,937,1706,20
61821149739,61821149734,-5,1055,3261,20
61821649093,61821649095,2,33993,20794,20
61822008499,61822008494,-5,1267,2878,20
61823423009,61823423005,-4,1119,1913,20
61826616902,61826616898,-4,1176,2960,20
61828740880,61828740892,12,1389,4018,20
61829129891,61829129887,-4,2185,6834,20
61832694307,61832694303,-4,504,850,20
61835277218,61835277215,-3,1469,2818,20
61835836238,61835836234,-4,1238,2873,20
61838951645,61838951645,0,1621,1761,20
61839963810,61839963807,-3,1044,1889,20
61849460759,61849460757,-2,1206,3207,20
61850542400,61850542394,-6,690,2155,20
61851140286,61851140300,14,628,2836,20
61851671838,61851671834,-4,1010,1984,20
61852420786,61852420785,-1,1203,2133,20
61857028804,61857028805,1,1706,2602,20
61858478754,61858478753,-1,1840,3749,20
61860141110,61860141106,-4,1151,3215,20
61860409885,61860409905,20,920,1944,20
61863495742,61863495739,-3,1218,2054,20
61871510958,61871510957,-1,1141,2244,20
61872311907,61872311900,-7,1333,2694,20
61877155251,61877155252,1,2103,1537,20
61878866231,61878866230,-1,1400,2482,20
61882263699,61882263697,-2,927,1885,20
61884757467,61884757465,-2,1303,2837,20
61887230586,61887230583,-3,1339,2138,20
61887295886,61887295886,0,1375,2385,20
61887575950,61887575949,-1,1269,2325,20
61891647358,61891647354,-4,1372,2113,20
61901677654,61901677650,-4,979,2926,20
61904354162,61904354161,-1,1588,2580,20
61904383006,61904383005,-1,1384,1730,20
61907352993,61907352991,-2,990,1627,20
61908136604,61908136598,-6,979,2313,20
61912417899,61912417894,-5,1607,3327,20
61916034718,61916034716,-2,1134,1884,20
61918881107,61918881104,-3,930,2312,20
61925038352,61925038349,-3,1143,2386,20
61926450205,61926450201,-4,1399,1954,20
61926780727,61926780721,-6,1061,2148,20
61932881661,61932881658,-3,1201,1779,20
61936941142,61936941138,-4,1190,2819,20
61939340486,61939340483,-3,1477,2262,20
61943038255,61943038251,-4,1146,2881,20
61944230966,61944230964,-2,732,2017,20
61945357493,61945357490,-3,1413,2198,20
61946005870,61946005868,-2,1806,2433,20
61948488267,61948488263,-4,739,1572,20
61962066627,61962066626,-1,704,1971,20
61963866903,61963866900,-3,1528,2867,20
61965342210,61965342207,-3,1619,3599,20
61965453620,61965453616,-4,1203,2603,20
61967074745,61967074741,-4,997,2040,20
61968396486,61968396484,-2,929,1693,20
61970652796,61970652794,-2,1066,2278,20
61973776678,61973776675,-3,778,1358,20
61976329225,61976329223,-2,35344,46193,20
61979933719,61979933718,-1,685,2426,20
61980715665,61980715662,-3,1125,1695,20
61982196057,61982196054,-3,1392,2133,20
61982279216,61982279235,19,1055,2115,20
61982890110,61982890109,-1,1214,2019,20
61987122862,61987122857,-5,752,2492,20
61988626005,61988626007,2,941,1450,20
61990984502,61990984499,-3,660,2343,20
61993389150,61993389146,-4,891,2667,20
61993725845,61993725846,1,255,798,20
61994474557,61994474554,-3,1028,2251,20
61997361817,61997361814,-3,944,2276,20
62002105879,62002105877,-2,1065,2126,20
62002607893,62002607890,-3,1228,1967,20
62006110530,62006110525,-5,1312,2853,20
62006760895,62006760899,4,2091,1023,20
62011622726,62011622747,21,1415,1025,20
62014813424,62014813447,23,443,758,20
62016626838,62016626838,0,1205,2615,20
62018402498,62018402498,0,1236,3172,20
62018963107,62018963110,3,1482,1259,20
62020467285,62020467285,0,979,2094,20
62022005772,62022005768,-4,1077,2955,20
62022715506,62022715511,5,2066,1312,20
62026491132,62026491139,7,3449,1289,20
62027971818,62027971815,-3,1040,1887,20
62032863824,62032863825,1,1250,1696,20
62035967586,62035967583,-3,1244,2529,20
62036355975,62036355956,-19,952,1772,20
62036498894,62036498910,16,278,836,20
62037356199,62037356200,1,1203,1456,20
62038810378,62038810375,-3,1473,2262,20
62041582026,62041582021,-5,802,2713,20
62045098595,62045098592,-3,1100,1742,20
62048151157,62048151154,-3,1032,1480,20
62049527330,62049527327,-3,1107,2087,20
62050357174,62050357164,-10,1376,2978,20
62050931598,62050931595,-3,1420,2416,20
62050976939,62050976935,-4,1168,2493,20
62053974117,62053974113,-4,940,2480,20
62055100585,62055100582,-3,1047,2020,20
62055492431,62055492450,19,1139,2182,20
62056298383,62056298382,-1,1211,1913,20
62057561455,62057561453,-2,1946,2860,20
62062342902,62062342897,-5,871,3049,20
62062783923,62062783920,-3,1362,2974,20
62064837037,62064837038,1,1150,1722,20
62065884975,62065884976,1,1898,2289,20
62072000362,62072000361,-1,1385,1965,20
62074581176,62074581174,-2,1312,2738,20
62076775672,62076775667,-5,1122,2682,20
62079133811,62079133809,-2,812,1654,20
62081003674,62081003671,-3,1015,2373,20
62082802527,62082802526,-1,918,1799,20
62091974693,62091974691,-2,795,1368,20
62094913678,62094913676,-2,1167,2518,20
62108883490,62108883486,-4,1220,1940,20
62110370070,62110370055,-15,163,701,20
62112305678,62112305678,0,1166,2511,20
62113091769,62113091766,-3,1034,1987,20
62115612690,62115612686,-4,1295,3492,20
62117602932,62117602935,3,1394,898,20
62118964169,62118964166,-3,1251,1827,20
62121351301,62121351297,-4,1163,1833,20
62125831118,62125831117,-1,809,2339,20
62127069855,62127069852,-3,1280,2169,20
62127952794,62127952793,-1,997,1619,20
62128633945,62128633941,-4,992,2615,20
62129228594,62129228591,-3,1161,1672,20
62131447175,62131447193,18,949,2779,20
62131871593,62131871591,-2,590,1507,20
62132225494,62132225490,-4,472,1766,20
62133583123,62133583121,-2,1161,2409,20
62135182558,62135182557,-1,1302,1668,20
62137665151,62137665153,2,1866,2379,20
62140072039,62140072036,-3,1314,2094,20
62143646495,62143646493,-2,1059,3022,20
62143812013,62143812010,-3,759,2415,20
62149970548,62149970543,-5,841,1383,20
62153410093,62153410092,-1,1026,1852,20
62154264089,62154264087,-2,1144,2580,20
62155174382,62155174379,-3,1215,2232,20
62156437115,62156437110,-5,899,2505,20
62159807139,62159807145,6,3111,1694,20
62160620573,62160620577,4,1254,1089,20
62162235680,62162235703,23,789,1413,20
62162463845,62162463843,-2,1394,2465,20
62166090146,62166090145,-1,1320,2817,20
62166491157,62166491142,-15,1119,2204,20
62168920675,62168920671,-4,604,2377,20
62172597863,62172597861,-2,1128,2236,20
62179620732,62179620733,1,1609,1221,20
62185002976,62185002973,-3,1465,2019,20
62185295549,62185295543,-6,794,1897,20
62185483163,62185483158,-5,1099,2408,20
62185921074,62185921074,0,1089,2176,20
62187109076,62187109073,-3,1056,2646,20
62188511662,62188511662,0,1244,1564,20
62189172999,62189172994,-5,1221,1852,20
62190563146,62190563146,0,1151,1906,20
62199107442,62199107440,-2,1219,2200,20
62201722762,62201722760,-2,778,2095,20
62204823583,62204823580,-3,1288,2849,20
62213197863,62213197861,-2,1060,2009,20
62219077826,62219077830,4,2123,1804,20
62221645626,62221645622,-4,1258,2994,20
62224188313,62224188309,-4,1379,3219,20
62224610537,62224610533,-4,904,1748,20
62226017475,62226017472,-3,906,2295,20
62228774811,62228774810,-1,1605,3061,20
62230449439,62230449436,-3,1007,2890,20
62233322967,62233322968,1,1450,1550,20
62238136856,62238136853,-3,1851,3663,20
62239957937,62239957935,-2,1030,1949,20
62248503933,62248503933,0,1601,1995,20
62252355927,62252355922,-5,1451,3063,20
62253457167,62253457163,-4,981,1958,20
62261461670,62261461666,-4,958,2557,20
62265861439,62265861433,-6,1022,1335,20
62267307027,62267307021,-6,1365,3982,20
62274332200,62274332194,-6,265,1288,20
62278629965,62278629962,-3,1136,2618,20
62282390750,62282390746,-4,1103,2159,20
62284217498,62284217497,-1,1178,2545,20
62285666123,62285666121,-2,1080,2303,20
62290874681,62290874678,-3,1197,1649,20
62295359005,62295359004,-1,877,1841,20
62296732620,62296732614,-6,992,2860,20
62300105593,62300105595,2,2095,1618,20
62304936338,62304936339,1,1512,1539,20
62314244698,62314244695,-3,992,2754,20
62314802155,62314802149,-6,1182,2562,20
62319064626,62319064630,4,1970,1829,20
62320814597,62320814594,-3,1502,2998,20
62323512653,62323512649,-4,966,3416,20
62326035943,62326035940,-3,1136,2321,20
62326845818,62326845825,7,1500,806,20
62328229324,62328229318,-6,1616,6400,20
62331188309,62331188312,3,2556,2063,20
62333292266,62333292264,-2,1167,3282,20
62334895555,62334895553,-2,708,1901,20
62336201571,62336201577,6,181,612,20
62341671546,62341671542,-4,1090,2997,20
62342563502,62342563500,-2,1785,2786,20
62348395887,62348395885,-2,964,1889,20
62348867809,62348867806,-3,1095,1821,20
62355822375,62355822371,-4,1814,3526,20
62360270235,62360270234,-1,1207,2255,20
62362799642,62362799641,-1,931,2813,20
62364354433,62364354432,-1,1221,2180,20
62364443974,62364443983,9,125,365,20
62365197703,62365197682,-21,288,1060,20
62365723010,62365723010,0,609,694,20
62368907503,62368907502,-1,974,1358,20
62371693929,62371693923,-6,890,2711,20
62372573706,62372573711,5,1114,893,20
62374984878,62374984879,1,1642,1441,20
62378595078,62378595076,-2,1206,1582,20
62379785118,62379785117,-1,1477,2123,20
62388070290,62388070289,-1,1275,2343,20
62388383702,62388383701,-1,20332,34447,20
62390192520,62390192519,-1,1566,2995,20
62390256419,62390256417,-2,830,2463,20
62393337755,62393337750,-5,1165,1958,20
62395001682,62395001679,-3,1356,2845,20
62411554626,62411554623,-3,993,2324,20
62413005463,62413005460,-3,1573,2138,20
62419783979,62419783976,-3,1091,2915,20
62420566470,62420566465,-5,1245,2089,20
62421592706,62421592701,-5,1102,3435,20
62431441122,62431441105,-17,686,1831,20
62432217876,62432217887,11,229,671,20
62432257174,62432257167,-7,792,1674,20
62432442249,62432442246,-3,898,1823,20
62434054306,62434054301,-5,1577,3409,20
62434335076,62434335097,21,960,2089,20
62435370930,62435370933,3,1907,1485,20
62436800169,62436800165,-4,1483,2478,20
62443861041,62443861038,-3,845,1622,20
62444603839,62444603834,-5,1157,2350,20
62445119514,62445119513,-1,1183,1690,20
62446263221,62446263217,-4,1071,2584,20
62452296873,62452296894,21,1030,1814,20
62452877111,62452877108,-3,1257,2931,20
62453601041,62453601036,-5,984,2549,20
62458154381,62458154360,-21,1659,2151,20
62458511387,62458511386,-1,1104,2256,20
62459089677,62459089671,-6,1051,3539,20
62459805844,62459805842,-2,1278,2617,20
62460684656,62460684670,14,601,1646,20
62461664251,62461664248,-3,723,1547,20
62466068222,62466068222,0,1191,2691,20
62468567023,62468567019,-4,1069,2355,20
62470116343,62470116341,-2,1020,1911,20
62475667450,62475667457,7,3246,1238,20
62476475006,62476475003,-3,1223,2844,20
62478038278,62478038273,-5,931,2323,20
62483886687,62483886684,-3,1077,1917,20
62486397558,62486397557,-1,1722,2712,20
62488434882,62488434886,4,1794,832,20
62493017882,62493017877,-5,1132,1712,20
62496317936,62496317931,-5,890,2275,20
62497686659,62497686657,-2,734,2662,20
62501784513,62501784517,4,1760,1154,20
62505341138,62505341139,1,1095,2124,20
62506383504,62506383501,-3,1057,1876,20
62512035987,62512035984,-3,1227,2713,20
62515337655,62515337655,0,1119,2131,20
62523313853,62523313862,9,2986,1619,20
62523576837,62523576833,-4,1441,2622,20
62527270315,62527270313,-2,1735,4212,20
62529722675,62529722673,-2,1206,2018,20
62534175350,62534175348,-2,1071,2345,20
62537124570,62537124569,-1,958,2855,20
62538556390,62538556388,-2,1482,2784,20
62549532794,62549532794,0,1398,2718,20
62552254410,62552254409,-1,1071,2652,20
62553336072,62553336061,-11,1424,2181,20
62555612727,62555612722,-5,1090,2128,20
62559446823,62559446822,-1,1110,2103,20
62560608047,62560608044,-3,1290,3559,20
62563860099,62563860094,-5,711,1971,20
62564295671,62564295669,-2,1466,2534,20
62566888416,62566888413,-3,1190,1901,20
62570126705,62570126701,-4,1075,2478,20
62573462986,62573462984,-2,855,2285,20
62574342630,62574342631,1,1388,1976,20
62584471531,62584471529,-2,938,2095,20
62586042068,62586042062,-6,1211,2029,20
62589574931,62589574926,-5,1604,3317,20
62592036027,62592036026,-1,810,2048,20
62592214893,62592214910,17,1405,3126,20
62595316173,62595316169,-4,2210,5247,20
62596039549,62596039548,-1,1904,2661,20
62599556436,62599556433,-3,1094,2407,20
62602215939,62602215936,-3,1145,2554,20
62612947507,62612947499,-8,855,2927,20
62619078535,62619078537,2,1053,1564,20
62627039962,62627039955,-7,1018,2857,20
62633203758,62633203755,-3,1297,2447,20
62639071065,62639071063,-2,1230,2810,20
62642290784,62642290782,-2,1029,2404,20
62645180645,62645180644,-1,1195,2233,20
62645361826,62645361822,-4,1180,1894,20
62648002570,62648002565,-5,1470,6245,20
62649310297,62649310298,1,1428,1259,20
62652483246,62652483244,-2,1829,2482,20
62654843335,62654843354,19,674,1827,20
62655280797,62655280796,-1,8,2102,20
62656365412,62656365409,-3,1085,2087,20
62658180711,62658180707,-4,1413,1815,20
62660129356,62660129353,-3,1062,2666,20
62666597104,62666597102,-2,937,1413,20
62667456950,62667456946,-4,1323,2568,20
62668461146,62668461145,-1,1302,2352,20
62668492381,62668492377,-4,1202,2672,20
62674007549,62674007546,-3,1019,3661,20
62677510273,62677510269,-4,1217,2397,20
62686063011,62686063007,-4,1015,2457,20
62688805073,62688805079,6,3822,1491,20
62690373296,62690373291,-5,1545,3882,20
62691170358,62691170352,-6,1210,2879,20
62692522113,62692522130,17,474,1063,20
62694464844,62694464852,8,15032,41453,20
62698419759,62698419758,-1,1273,1845,20
62706406111,62706406107,-4,897,2257,20
62708677353,62708677347,-6,1461,4965,20
62709469730,62709469726,-4,1735,5954,20
62710085249,62710085246,-3,1076,2175,20
62711802050,62711802046,-4,1212,2984,20
62714117981,62714117979,-2,1282,1849,20
62714773724,62714773719,-5,973,3278,20
62721749902,62721749906,4,4378,2428,20
62726425182,62726425179,-3,1160,1852,20
62728862171,62728862170,-1,1102,2310,20
62736038462,62736038468,6,3198,1544,20
62736898099,62736898097,-2,1466,2112,20
62736954041,62736954038,-3,1284,3102,20
62747572312,62747572330,18,1202,2094,20
62751771197,62751771194,-3,1059,1778,20
62752891686,62752891702,16,503,1005,20
62754353871,62754353866,-5,1141,2995,20
62757909414,62757909416,2,1293,1067,20
62758315825,62758315824,-1,1670,2691,20
62763514391,62763514388,-3,1292,2775,20
62763631639,62763631634,-5,825,1923,20
62768371528,62768371527,-1,1249,2346,20
62769874425,62769874424,-1,1172,1515,20
62774438561,62774438558,-3,887,1676,20
62775209107,62775209104,-3,1481,2153,20
62780402855,62780402853,-2,1299,1980,20
62784044596,62784044593,-3,1114,2688,20
62788990612,62788990610,-2,1313,3354,20
62791771847,62791771846,-1,1036,2478,20
62792367971,62792367969,-2,1205,2389,20
62792413974,62792413995,21,887,1458,20
62794052575,62794052577,2,4413,4579,20
62797541110,62797541110,0,812,2144,20
62800880899,62800880894,-5,687,1784,20
62805850967,62805850963,-4,617,1475,20
62809451365,62809451362,-3,1317,1939,20
62809992312,62809992306,-6,1068,2851,20
62814545462,62814545460,-2,894,1688,20
62814695967,62814695964,-3,1110,2343,20
62819801759,62819801756,-3,1033,2114,20
62821852147,62821852146,-1,800,1969,20
62823742021,62823742041,20,550,1065,20
62823768022,62823768020,-2,1055,2407,20
62831089527,62831089528,1,1466,2881,20
62832280949,62832280947,-2,1054,3433,20
62842634288,62842634284,-4,975,2875,20
62843792489,62843792486,-3,1431,3062,20
62843878677,62843878674,-3,1221,2543,20
62847355686,62847355682,-4,1048,2557,20
62856447297,62856447295,-2,870,2191,20
62857143462,62857143461,-1,1229,2058,20
62859858393,62859858393,0,1242,2128,20
62863216700,62863216698,-2,1095,2222,20
62869579734,62869579731,-3,1552,3251,20
62870395628,62870395625,-3,1154,2310,20
62874124519,62874124517,-2,938,2844,20
62879443457,62879443456,-1,1184,2761,20
62881436995,62881436996,1,1528,1167,20
62882347046,62882347050,4,2756,2079,20
62889520543,62889520549,6,2486,1608,20
62893178927,62893178925,-2,915,1844,20
62893251671,62893251677,6,205,733,20
62897125329,62897125326,-3,1384,2352,20
62904054892,62904054890,-2,1111,1658,20
62904671317,62904671316,-1,1167,1529,20
62905831032,62905831030,-2,802,1735,20
62910375970,62910375969,-1,1170,2147,20
62912046633,62912046628,-5,1100,2685,20
62913722199,62913722197,-2,1009,1825,20
62914748753,62914748750,-3,1064,2417,20
62918107913,62918107910,-3,991,1818,20
62925534048,62925534055,7,5393,1680,20
62927112310,62927112291,-19,689,1498,20
62928117582,62928117577,-5,1793,3792,20
62928283227,62928283225,-2,1601,3002,20
62933005150,62933005146,-4,1418,2425,20
62934219094,62934219090,-4,682,1894,20
62935622881,62935622878,-3,1258,2674,20
62935664565,62935664562,-3,900,2848,20
62939566391,62939566390,-1,1390,2157,20
62941471151,62941471146,-5,1142,3178,20
62943074074,62943074073,-1,874,2465,20
62944508554,62944508553,-1,635,1524,20
62952432722,62952432719,-3,1274,2748,20
62953548746,62953548744,-2,1101,2475,20
62955721638,62955721636,-2,804,2124,20
62955780958,62955780954,-4,1283,2894,20
62957111804,62957111828,24,1010,210,20
62958954971,62958954967,-4,1185,2985,20
62960145011,62960145009,-2,1092,2232,20
62962772103,62962772100,-3,940,1854,20
62969471964,62969471961,-3,1020,1870,20
62972400116,62972400112,-4,1149,2176,20
62974279715,62974279711,-4,1668,3305,20
62975847678,62975847675,-3,932,1640,20
62976238907,62976238903,-4,1151,2888,20
62979574839,62979574834,-5,1123,2366,20
62985118363,62985118359,-4,1374,1985,20
62990210622,62990210619,-3,811,2387,20
62990425277,62990425274,-3,1148,2090,20
62997989762,62997989758,-4,1609,2484,20
62999985578,62999985574,-4,1415,3647,20
63001502391,63001502387,-4,654,1492,20
63002220367,63002220362,-5,1296,2415,20
63005324427,63005324422,-5,950,2648,20
63006936450,63006936449,-1,932,2124,20
63010019091,63010019088,-3,1210,2397,20
63010226088,63010226101,13,885,2273,20
63012352975,63012352970,-5,667,1639,20
63015737270,63015737267,-3,1197,2444,20
63020285913,63020285910,-3,1136,2511,20
63022795451,63022795449,-2,951,2820,20
63025463596,63025463594,-2,1033,1652,20
63030343811,63030343810,-1,1313,2881,20
63032998138,63032998148,10,15308,24768,20
63035323805,63035323802,-3,754,1233,20
63036424360,63036424359,-1,1486,1072,20
63036581698,63036581693,-5,1134,3171,20
63038486311,63038486329,18,488,771,20
63039971013,63039971014,1,1354,1520,20
63041333926,63041333922,-4,499,1342,20
63043006956,63043006954,-2,1157,2132,20
63043250806,63043250802,-4,1046,2262,20
63043312654,63043312669,15,227,1609,20
63044409281,63044409279,-2,973,2408,20
63045424963,63045424959,-4,857,2242,20
63046590396,63046590394,-2,1303,1931,20
63046678886,63046678904,18,58,760,20
63049263206,63049263201,-5,2206,4194,20
63055566647,63055566648,1,3784,2842,20
63059101595,63059101591,-4,1080,2387,20
63059657885,63059657873,-12,62,1181,20
63065260270,63065260266,-4,999,2351,20
63066129298,63066129297,-1,1086,1988,20
63071566769,63071566765,-4,1446,2987,20
63084863931,63084863926,-5,1342,3001,20
63085182555,63085182551,-4,981,2260,20
63086211865,63086211866,1,1086,992,20
63088090590,63088090587,-3,877,2325,20
63089323837,63089323836,-1,1998,3386,20
63091007579,63091007577,-2,1164,2434,20
63092324145,63092324141,-4,831,1460,20
63093796603,63093796598,-5,918,2731,20
63094505579,63094505573,-6,954,2680,20
63094732589,63094732572,-17,865,1983,20
63099241318,63099241314,-4,1184,2028,20
63099799518,63099799516,-2,873,1575,20
63101039650,63101039646,-4,1434,2606,20
63101542388,63101542391,3,1666,1898,20
63104060214,63104060211,-3,917,2570,20
63107293572,63107293591,19,795,1142,20
63109004146,63109004154,8,3726,1313,20
63109107966,63109107962,-4,1150,2458,20
63109173944,63109173943,-1,1759,2433,20
63109621322,63109621323,1,1683,2246,20
63113198659,63113198657,-2,832,1645,20
63114544213,63114544210,-3,1308,1991,20
63115129270,63115129269,-1,1019,2033,20
63116956422,63116956419,-3,918,1425,20
63117439865,63117439860,-5,943,2286,20
63122131546,63122131543,-3,1183,2126,20
63122656623,63122656619,-4,1582,3057,20
63125414845,63125414842,-3,1626,2481,20
63126085640,63126085638,-2,1431,2195,20
63130764295,63130764291,-4,1385,3001,20
63137780031,63137780030,-1,1273,2775,20
63139843723,63139843733,10,16590,18349,20
63142372481,63142372477,-4,1018,2663,20
63145951591,63145951589,-2,1072,2560,20
63147519673,63147519681,8,3166,1083,20
63149453196,63149453190,-6,1759,2761,20
63150067236,63150067232,-4,1032,2533,20
63153459893,63153459886,-7,28312,15422,20
63159886569,63159886562,-7,1153,1888,20
63160564298,63160564296,-2,1501,3339,20
63164119210,63164119209,-1,1220,2162,20
63164415470,63164415468,-2,2483,4977,20
63167765434,63167765433,-1,1174,2481,20
63167955772,63167955753,-19,941,2427,20
63171358989,63171358989,0,1166,1302,20
63172375627,63172375625,-2,975,2122,20
63180435038,63180435033,-5,1398,2263,20
63180675406,63180675410,4,1737,1929,20
63190496533,63190496531,-2,826,1521,20
63193903294,63193903289,-5,929,2337,20
63200402405,63200402401,-4,1001,2363,20
63209187774,63209187777,3,1250,1312,20
63210141197,63210141196,-1,1117,2022,20
63211539249,63211539245,-4,1524,2647,20
63211571239,63211571229,-10,695,2213,20
63216021994,63216021989,-5,944,2329,20
63218300419,63218300417,-2,954,1467,20
63218533897,63218533898,1,2767,2895,20
63219922938,63219922936,-2,996,2669,20
63220123748,63220123746,-2,1228,2046,20
63220820546,63220820545,-1,1241,1756,20
63224725793,63224725791,-2,1169,2163,20
63226494626,63226494622,-4,904,2324,20
63229009654,63229009650,-4,1089,2256,20
63234130297,63234130297,0,1321,1622,20
63237344943,63237344941,-2,886,2475,20
63238856099,63238856098,-1,1569,2971,20
63246098877,63246098873,-4,1037,2141,20
63247637889,63247637887,-2,1083,1876,20
63248283413,63248283406,-7,1233,2279,20
63248436351,63248436350,-1,917,1285,20
63251995806,63251995801,-5,1288,2494,20
63256282572,63256282571,-1,1566,2070,20
63256992024,63256992022,-2,1598,3552,20
63262014087,63262014085,-2,1272,2840,20
63262567405,63262567414,9,159,874,20
63264342114,63264342112,-2,1207,1201,20
63265676495,63265676494,-1,971,2201,20
63265856842,63265856837,-5,1402,3644,20
63267118339,63267118335,-4,1515,2564,20
63269271987,63269271985,-2,850,1906,20
63275113034,63275113031,-3,1133,2182,20
63276734625,63276734628,3,1107,1979,20
63277006572,63277006582,10,64,521,20
63281349862,63281349857,-5,1155,2613,20
63284466910,63284466906,-4,629,1652,20
63289460266,63289460267,1,1194,1023,20
63290473798,63290473797,-1,1225,2175,20
63291406931,63291406930,-1,28083,46019,20
63296618817,63296618800,-17,1158,692,20
63301193800,63301193796,-4,1610,2120,20
63306352317,63306352314,-3,1043,2023,20
63311999778,63311999781,3,1168,1416,20
63312693682,63312693680,-2,813,1864,20
63316162720,63316162718,-2,1073,2202,20
63316763867,63316763864,-3,826,2046,20
63317017181,63317017177,-4,60,650,20
63324904389,63324904411,22,1289,2336,20
63327038829,63327038830,1,1482,1204,20
63329294156,63329294155,-1,1060,1888,20
63329412308,63329412321,13,230,932,20
63331215575,63331215571,-4,741,2362,20
63331827978,63331827974,-4,1304,2892,20
63331884204,63331884223,19,649,1726,20
63333919064,63333919061,-3,974,1946,20
63335795305,63335795299,-6,985,3884,20
63342780497,63342780494,-3,921,2318,20
63344648021,63344648019,-2,1349,2551,20
63345530699,63345530700,1,1407,1204,20
63345647381,63345647377,-4,938,2013,20
63346057138,63346057137,-1,1402,2174,20
63346145051,63346145049,-2,1104,1975,20
63347703678,63347703698,20,1274,2100,20
63350831128,63350831127,-1,1002,2558,20
63350896236,63350896226,-10,569,1508,20
63353358132,63353358148,16,407,972,20
63362668875,63362668874,-1,1164,2986,20
63363264143,63363264139,-4,1381,2819,20
63363777442,63363777439,-3,765,1235,20
63367783369,63367783366,-3,1326,2876,20
63374237337,63374237334,-3,1417,1835,20
63376326595,63376326593,-2,1053,1890,20
63378721567,63378721566,-1,1327,2094,20
63379686734,63379686733,-1,1176,1826,20
63382870166,63382870163,-3,900,2507,20
63383473514,63383473513,-1,1292,1949,20
63393503639,63393503637,-2,1423,2496,20
63395516819,63395516818,-1,987,2098,20
63401597821,63401597818,-3,1378,2479,20
63404129635,63404129633,-2,1313,2168,20
63404885271,63404885273,2,4597,3315,20
63408318754,63408318752,-2,1784,2162,20
63411738725,63411738721,-4,1105,2091,20
63413478079,63413478095,16,981,2360,20
63414549035,63414549033,-2,770,1978,20
63417622512,63417622509,-3,1150,2384,20
63418863316,63418863314,-2,1168,1944,20
63419562893,63419562891,-2,1262,1976,20
63422351604,63422351610,6,1894,1010,20
63423562226,63423562222,-4,1092,1868,20
63428770974,63428770975,1,1043,1678,20
63433569330,63433569327,-3,1105,1632,20
63433614374,63433614362,-12,963,1982,20
63440485766,63440485762,-4,750,1357,20
63444617225,63444617230,5,1886,1417,20
63449535370,63449535366,-4,1392,3421,20
63451210869,63451210865,-4,1227,2386,20
63453125209,63453125206,-3,1412,3093,20
63453497826,63453497822,-4,1117,3074,20
63453946765,63453946772,7,5168,2596,20
63458337795,63458337793,-2,1004,1320,20
63458678390,63458678386,-4,1176,2238,20
63459433934,63459433933,-1,1570,2776,20
63461074626,63461074623,-3,1120,2343,20
63466114030,63466114029,-1,1239,2766,20
63466960275,63466960273,-2,839,1874,20
63467228013,63467228014,1,1598,1675,20
63469212346,63469212341,-5,752,2272,20
63472804543,63472804541,-2,995,1651,20
63476094994,63476094998,4,1177,1026,20
63480930051,63480930048,-3,844,2540,20
63481603569,63481603567,-2,1004,1721,20
63488770176,63488770173,-3,934,1776,20
63489041792,63489041791,-1,1044,2050,20
63491327547,63491327542,-5,1178,3452,20
63495935102,63495935097,-5,960,2396,20
63509277733,63509277731,-2,3006,4662,20
63511985419,63511985417,-2,1224,2326,20
63512469847,63512469845,-2,1116,2840,20
63513524344,63513524340,-4,829,2216,20
63518977272,63518977272,0,1404,1975,20
63525504658,63525504656,-2,1276,2451,20
63525697893,63525697890,-3,1149,2052,20
63526704839,63526704838,-1,1237,2614,20
63528998481,63528998478,-3,873,2816,20
63533946578,63533946577,-1,1417,2037,20
63533979328,63533979324,-4,1276,2979,20
63541045376,63541045374,-2,1218,1848,20
63550877739,63550877735,-4,870,3227,20
63551827626,63551827626,0,1067,2335,20
63553455742,63553455739,-3,1128,2891,20
63557312379,63557312375,-4,1037,2065,20
63559331989,63559331985,-4,1279,3541,20
63559474663,63559474660,-3,949,2691,20
63565271359,63565271356,-3,1695,4732,20
63567202089,63567202086,-3,1165,2358,20
63570778732,63570778730,-2,1814,2935,20
63571911610,63571911606,-4,1289,2315,20
63572696933,63572696928,-5,993,1981,20
63574745949,63574745949,0,1038,1631,20
63576014638,63576014634,-4,957,3354,20
63577344730,63577344726,-4,959,1868,20
63577624925,63577624921,-4,901,2244,20
63583370388,63583370382,-6,1194,3325,20
63585557306,63585557305,-1,1095,2187,20
63585723174,63585723171,-3,1245,3187,20
63587064395,63587064391,-4,885,1646,20
63591461849,63591461846,-3,1154,2677,20
63594842265,63594842265,0,1463,2192,20
63598253127,63598253125,-2,1369,2279,20
63603297371,63603297369,-2,979,2088,20
63607548306,63607548304,-2,1102,1982,20
63607982248,63607982259,11,389,2020,20
63617726381,63617726377,-4,751,1851,20
63618192851,63618192849,-2,1740,3518,20
63622947371,63622947367,-4,874,2247,20
63623588044,63623588059,15,634,946,20
63628717098,63628717098,0,985,1347,20
63628992838,63628992846,8,4058,1428,20
63640509278,63640509276,-2,1032,1052,20
63646971799,63646971795,-4,1049,2674,20
63647569615,63647569603,-12,934,980,20
63652733939,63652733938,-1,1128,1975,20
63657379954,63657379952,-2,1486,2190,20
63659021057,63659021054,-3,907,2342,20
63660410959,63660410955,-4,538,1383,20
63664426022,63664426019,-3,2917,6710,20
63669245294,63669245291,-3,686,1460,20
63669786082,63669786079,-3,886,1715,20
63670527607,63670527616,9,193,4534,20
63672507753,63672507750,-3,1766,3069,20
63674600421,63674600419,-2,1212,1863,20
63678886558,63678886554,-4,960,2314,20
63680206627,63680206623,-4,1104,2715,20
63680920092,63680920089,-3,818,2651,20
63685097693,63685097690,-3,1018,2609,20
63690677083,63690677080,-3,1317,2300,20
63691232167,63691232165,-2,1505,2879,20
63692447913,63692447911,-2,1007,2166,20
63698466699,63698466698,-1,744,1610,20
63699621535,63699621532,-3,1187,2311,20
63703328610,63703328607,-3,1293,2228,20
63703622593,63703622590,-3,959,2409,20
63706454887,63706454886,-1,803,1413,20
63710250919,63710250918,-1,1232,3051,20
63710629472,63710629488,16,240,1145,20
63714138034,63714138030,-4,877,1783,20
63717891822,63717891826,4,8071,6437,20
63718161558,63718161576,18,741,1758,20
63719695257,63719695255,-2,1248,2124,20
63719951987,63719951985,-2,951,2341,20
63725846247,63725846247,0,1162,1456,20
63727889449,63727889448,-1,2396,3360,20
63729961750,63729961749,-1,1331,2163,20
63733301426,63733301421,-5,1232,2994,20
63736330765,63736330762,-3,1173,2313,20
63741698719,63741698735,16,586,1660,20
63754254914,63754254917,3,1876,1765,20
63757084814,63757084819,5,2330,1040,20
63757426419,63757426416,-3,1136,2101,20
63767402241,63767402237,-4,1112,2219,20
63770331481,63770331479,-2,1489,2650,20
63773294253,63773294249,-4,939,2252,20
63774996451,63774996448,-3,1007,2049,20
63780892077,63780892075,-2,1117,2343,20
63783816354,63783816347,-7,718,1753,20
63793521990,63793521986,-4,677,1581,20
63793856334,63793856327,-7,1340,2326,20
63800328782,63800328783,1,1113,1509,20
63800403568,63800403565,-3,977,2365,20
63800622133,63800622154,21,952,2575,20
63801850381,63801850379,-2,955,2720,20
63803049817,63803049814,-3,706,1905,20
63807624637,63807624638,1,1844,1643,20
63809843922,63809843923,1,2009,2076,20
63814641251,63814641249,-2,1455,2183,20
63817234145,63817234141,-4,1209,1770,20
63819054527,63819054526,-1,1663,4043,20
63831938182,63831938180,-2,1066,1960,20
63833863873,63833863852,-21,3726,1588,20
63836249710,63836249707,-3,946,1061,20
63838064113,63838064116,3,2940,1380,20
63841883935,63841883931,-4,1152,2309,20
63849381726,63849381739,13,10701,41726,20
63857748098,63857748096,-2,1102,1281,20
63859814074,63859814080,6,3277,1201,20
63864148075,63864148075,0,1510,1882,20
63865737142,63865737140,-2,1269,2342,20
63875532590,63875532591,1,1383,1597,20
63876689723,63876689723,0,1652,2384,20
63881675938,63881675919,-19,1875,3398,20
63881906889,63881906886,-3,1263,3402,20
63883843627,63883843627,0,1533,1524,20
63888157889,63888157886,-3,832,2273,20
63890667404,63890667410,6,3103,1346,20
63893535454,63893535451,-3,1684,3273,20
63895919077,63895919084,7,4821,1996,20
63896594191,63896594188,-3,882,1745,20
63896759526,63896759511,-15,380,749,20
63898342287,63898342295,8,9278,34583,20
63898788652,63898788649,-3,1295,2461,20
63899416468,63899416453,-15,921,1861,20
63902113477,63902113475,-2,1261,1876,20
63903195645,63903195639,-6,60,780,20
63906252876,63906252870,-6,28269,16966,20
63908169463,63908169462,-1,1561,1889,20
63908282742,63908282746,4,2704,1650,20
63910791350,63910791346,-4,1363,2412,20
63914361632,63914361626,-6,1085,3376,20
63916962877,63916962874,-3,1341,2165,20
63919351737,63919351733,-4,1078,1737,20
63919935222,63919935222,0,1169,1780,20
63920654485,63920654483,-2,1053,2257,20
63922837485,63922837483,-2,1212,1835,20
63928248951,63928248949,-2,1083,1987,20
63929443050,63929443048,-2,787,2137,20
63937409559,63937409536,-23,2631,1642,20
63938455932,63938455929,-3,1384,2741,20
63939807651,63939807649,-2,1517,1826,20
63946483039,63946483037,-2,861,1610,20
63947731091,63947731089,-2,1007,1933,20
63948152916,63948152914,-2,685,1736,20
63951817458,63951817465,7,6242,2009,20
63952422707,63952422705,-2,1218,3135,20
63952896063,63952896062,-1,1310,1743,20
63959653605,63959653615,10,14386,36958,20
63961469130,63961469126,-4,891,2206,20
63965842911,63965842908,-3,1227,3036,20
63968431557,63968431557,0,952,2102,20
63969564819,63969564817,-2,17570,4912,20
63970826165,63970826158,-7,1184,2931,20
63973611354,63973611358,4,2541,1058,20
63986130247,63986130253,6,858,1041,20
63992286079,63992286077,-2,1186,2705,20
63994751549,63994751546,-3,1380,3316,20
63994962258,63994962256,-2,981,2865,20
63996132719,63996132718,-1,1599,1462,20
63998894764,63998894760,-4,1146,3141,20
64006371146,64006371142,-4,1564,3032,20
64009899186,64009899185,-1,889,2500,20
64013384408,64013384405,-3,1018,1965,20
64013414161,64013414162,1,1445,2426,20
64016980505,64016980508,3,1375,1704,20
64017224519,64017224534,15,158,1109,20
64017564278,64017564283,5,4326,2317,20
64018383059,64018383058,-1,1034,1371,20
64018758783,64018758781,-2,1323,2425,20
64020425061,64020425059,-2,1411,1898,20
64023709125,64023709121,-4,1261,1671,20
64025543163,64025543158,-5,560,2691,20
64028810327,64028810325,-2,888,2027,20
64028836373,64028836371,-2,1263,2813,20
64029601898,64029601894,-4,1032,2617,20
64029757456,64029757455,-1,1553,2454,20
64030050461,64030050468,7,3758,1245,20
64030078397,64030078401,4,5056,3382,20
64030799190,64030799197,7,5839,2210,20
64035797109,64035797117,8,3321,1693,20
64038718796,64038718794,-2,1159,1745,20
64040350266,64040350264,-2,976,1778,20
64048001986,64048001990,4,3428,2642,20
64048379835,64048379832,-3,1940,2995,20
64059818957,64059818964,7,4175,1283,20
64060168198,64060168197,-1,1253,1999,20
64061229689,64061229693,4,1916,1138,20
64061852176,64061852180,4,35675,47295,20
64065612032,64065612031,-1,1115,3125,20
64066141541,64066141562,21,247,539,20
64072973511,64072973521,10,13765,43275,20
64073168182,64073168181,-1,820,2153,20
64074373630,64074373626,-4,1004,2178,20
64076778828,64076778826,-2,1570,3040,20
64078454232,64078454228,-4,1533,2737,20
64080286849,64080286846,-3,961,2266,20
64080889654,64080889674,20,373,1086,20
64086259575,64086259573,-2,1176,2451,20
64087486817,64087486814,-3,1188,3062,20
64089482869,64089482866,-3,1187,2053,20
64090478600,64090478614,14,95,1168,20
64092326731,64092326729,-2,1246,1962,20
64093018814,64093018835,21,1155,2063,20
64098202914,64098202910,-4,1360,3261,20
64098937883,64098937886,3,42129,36361,20
64102582697,64102582682,-15,929,2009,20
64106015413,64106015409,-4,1335,2414,20
64106160223,64106160229,6,2346,1081,20
64108608689,64108608687,-2,1277,2276,20
64112555086,64112555085,-1,1395,1738,20
64114279236,64114279230,-6,1481,2910,20
64116191661,64116191659,-2,1327,2534,20
64120877010,64120877014,4,10095,5643,20
64121062277,64121062277,0,1246,1852,20
64128946913,64128946917,4,3177,1478,20
64132280214,64132280211,-3,733,1965,20
64132403283,64132403281,-2,1287,2421,20
64133175538,64133175535,-3,1368,2242,20
64138004137,64138004140,3,1716,2000,20
64140526685,64140526682,-3,1043,1830,20
64141607346,64141607342,-4,1204,2347,20
64148115254,64148115251,-3,1092,2118,20
64148450894,64148450892,-2,1004,2941,20
64157046739,64157046735,-4,939,3080,20
64158992526,64158992525,-1,1324,2447,20
64159357300,64159357322,22,1190,1535,20
64164377122,64164377118,-4,1220,2017,20
64168702665,64168702663,-2,1195,2852,20
64173129990,64173129988,-2,1169,2900,20
64174813910,64174813914,4,2161,1488,20
64174997738,64174997745,7,2194,1992,20
64176157010,64176157008,-2,1262,2418,20
64192271679,64192271675,-4,1136,1877,20
64193918033,64193918027,-6,1144,2132,20
64195697612,64195697610,-2,948,2049,20
64197683979,64197683976,-3,1139,1808,20
64200531189,64200531188,-1,797,1790,20
64203480301,64203480300,-1,865,1178,20
64208078818,64208078820,2,24233,37970,20
64208435460,64208435453,-7,1169,3514,20
64209923667,64209923663,-4,1156,2643,20
64210741599,64210741596,-3,1086,1911,20
64211797805,64211797801,-4,1406,3242,20
64212041594,64212041599,5,2737,1369,20
64215453786,64215453784,-2,1200,1948,20
64218693090,64218693085,-5,1320,3419,20
64220000261,64220000261,0,895,2257,20
64220703981,64220703980,-1,1163,2022,20
64221579653,64221579650,-3,932,1857,20
64224004038,64224004038,0,537,1425,20
64224488186,64224488182,-4,1100,2649,20
64226135913,64226135910,-3,1423,2945,20
64228369971,64228369970,-1,928,1996,20
64228604912,64228604910,-2,955,1846,20
64233363055,64233363051,-4,1236,1894,20
64238827510,64238827508,-2,1287,2324,20
64240443882,64240443876,-6,3176,11063,20
64241677577,64241677576,-1,1203,1713,20
64244337138,64244337136,-2,782,1770,20
64246912438,64246912440,2,2126,1670,20
64247153578,64247153576,-2,1202,2381,20
64248579525,64248579522,-3,857,2302,20
64250901993,64250901990,-3,992,2236,20
64256077630,64256077635,5,2841,1298,20
64265762098,64265762102,4,1202,1070,20
64269294495,64269294492,-3,1444,2861,20
64271284671,64271284668,-3,1019,1973,20
64274469709,64274469710,1,1194,1961,20
64277256744,64277256742,-2,1085,2295,20
64278039743,64278039725,-18,908,1445,20
64286401946,64286401943,-3,937,2786,20
64290200715,64290200710,-5,1026,2462,20
64293237001,64293236998,-3,1338,1272,20
64295063982,64295063980,-2,1061,1597,20
64295301634,64295301634,0,1904,2127,20
64299832523,64299832518,-5,1113,2132,20
64300098309,64300098306,-3,1252,2182,20
64300193805,64300193790,-15,196,634,20
64301388678,64301388677,-1,669,1349,20
64309527338,64309527337,-1,929,1980,20
64310344717,64310344714,-3,1223,3598,20
64313399850,64313399845,-5,1091,2314,20
64316497910,64316497906,-4,1419,3135,20
64317569494,64317569489,-5,827,2101,20
64320561371,64320561369,-2,1007,1792,20
64321739963,64321739961,-2,1075,2733,20
64323863645,64323863642,-3,1094,3224,20
64325623663,64325623660,-3,1391,2716,20
64326273191,64326273188,-3,1226,2817,20
64327399771,64327399769,-2,1276,2251,20
64329388762,64329388760,-2,1288,2796,20
64333871416,64333871422,6,2012,1198,20
64345542437,64345542433,-4,1686,1917,20
64345602997,64345602988,-9,675,1671,20
64347199726,64347199723,-3,896,2879,20
64347272661,64347272681,20,186,975,20
64352521444,64352521437,-7,1096,1744,20
64352741838,64352741840,2,248,340,20
64355368017,64355368019,2,2648,1934,20
64356828118,64356828121,3,655,1142,20
64357747738,64357747737,-1,1315,2410,20
64360629726,64360629725,-1,858,2813,20
64364462670,64364462690,20,924,2211,20
64365684273,64365684269,-4,1247,2544,20
64370344258,64370344254,-4,1100,1684,20
64373805476,64373805475,-1,1681,1800,20
64378889161,64378889159,-2,726,1276,20
64381899850,64381899845,-5,1061,2083,20
64387788389,64387788385,-4,902,2678,20
64387982823,64387982821,-2,1116,2031,20
64390877838,64390877845,7,11344,36675,20
64393035601,64393035598,-3,1297,2044,20
64394884114,64394884111,-3,1323,2792,20
64399760056,64399760053,-3,879,1658,20
64400235088,64400235084,-4,914,2227,20
64400330417,64400330419,2,1205,1168,20
64404735639,64404735636,-3,1329,2694,20
64404921616,64404921598,-18,385,1275,20
64406206522,64406206518,-4,1304,2512,20
64410642175,64410642172,-3,711,2082,20
64414654106,64414654104,-2,1379,1564,20
64419743962,64419743961,-1,1169,2893,20
64420480284,64420480282,-2,610,2099,20
64421181070,64421181069,-1,1326,2115,20
64421329054,64421329054,0,1283,2499,20
64421387943,64421387938,-5,1076,2621,20
64423535369,64423535366,-3,1063,2243,20
64425805169,64425805166,-3,1175,2845,20
64428351097,64428351093,-4,1046,2060,20
64428878461,64428878456,-5,1005,1930,20
64429724434,64429724431,-3,1221,2046,20
64430814351,64430814350,-1,1838,2551,20
64431565233,64431565228,-5,2714,9664,20
64431657342,64431657340,-2,1391,3906,20
64433642442,64433642438,-4,1144,2520,20
64433678518,64433678516,-2,1023,2531,20
64433786906,64433786903,-3,600,1504,20
64434322470,64434322469,-1,2163,4359,20
64436163531,64436163528,-3,1035,2215,20
64448686042,64448686039,-3,1137,3159,20
64452825458,64452825455,-3,1501,2322,20
64458340815,64458340813,-2,903,1741,20
64458709386,64458709389,3,1753,1434,20
64461002732,64461002728,-4,993,2161,20
64461353304,64461353322,18,806,1472,20
64461546474,64461546470,-4,893,2918,20
64466930323,64466930320,-3,823,1400,20
64470696365,64470696362,-3,1088,2561,20
64473061362,64473061358,-4,1361,2295,20
64476792733,64476792730,-3,1387,2570,20
64479109102,64479109099,-3,1149,1955,20
64480552447,64480552445,-2,1075,1518,20
64481824035,64481824033,-2,904,1774,20
64481944248,64481944229,-19,775,2182,20
64482896639,64482896619,-20,969,2249,20
64483199367,64483199363,-4,777,2170,20
64488449959,64488449955,-4,1200,1973,20
64490472133,64490472129,-4,830,2095,20
64491621169,64491621164,-5,1245,2190,20
64493691902,64493691901,-1,860,1804,20
64494584952,64494584948,-4,1039,2555,20
64496712246,64496712244,-2,917,1744,20
64508416598,64508416596,-2,944,2233,20
64510702598,64510702594,-4,1019,2833,20
64510847199,64510847193,-6,1085,2418,20
64513129920,64513129925,5,2255,1717,20
64514443506,64514443502,-4,1027,2185,20
64515630973,64515630971,-2,1225,2779,20
64515920393,64515920390,-3,1289,2687,20
64518306794,64518306793,-1,989,2345,20
64519020466,64519020462,-4,714,1524,20
64527445218,64527445214,-4,898,2119,20
64528036526,64528036523,-3,606,954,20
64529082619,64529082615,-4,1042,1410,20
64531588287,64531588286,-1,1087,1525,20
64535195088,64535195085,-3,1366,2420,20
64535429084,64535429084,0,2076,1891,20
64536080179,64536080176,-3,1197,2592,20
64544253721,64544253721,0,2110,2902,20
64544489256,64544489254,-2,1224,2895,20
64548070909,64548070908,-1,1134,2440,20
64553540123,64553540119,-4,620,1344,20
64554923283,64554923281,-2,428,1217,20
64557192614,64557192615,1,783,1412,20
64558118617,64558118612,-5,1142,2921,20
64562759583,64562759580,-3,942,2428,20
64564253517,64564253528,11,13318,45078,20
64566448145,64566448143,-2,1705,2880,20
64567645039,64567645042,3,2379,2443,20
64586599079,64586599076,-3,1342,2392,20
64586637672,64586637670,-2,1382,1713,20
64586692268,64586692266,-2,1204,1604,20
64590732585,64590732579,-6,812,2841,20
64594759327,64594759325,-2,1381,2126,20
64595251975,64595251962,-13,1041,2368,20
64599561799,64599561792,-7,355,656,20
64600174143,64600174141,-2,761,2922,20
64604475266,64604475266,0,2645,4777,20
64605352573,64605352569,-4,1280,2721,20
64608081424,64608081421,-3,1702,2677,20
64613696454,64613696458,4,2906,1331,20
64614481771,64614481771,0,1541,2107,20
64616285511,64616285508,-3,786,2968,20
64617600709,64617600711,2,7469,5932,20
64619005657,64619005655,-2,1490,3008,20
64629923619,64629923619,0,1064,1823,20
64631819830,64631819829,-1,1353,2884,20
64635814195,64635814190,-5,1194,1990,20
64638316286,64638316282,-4,1103,2417,20
64639242838,64639242838,0,1045,1831,20
64639677853,64639677850,-3,1335,2102,20
64639724165,64639724161,-4,958,2143,20
64640824431,64640824428,-3,962,2512,20
64641723417,64641723411,-6,1259,1958,20
64647341070,64647341065,-5,984,1796,20
64648424842,64648424838,-4,1289,2737,20
64649160271,64649160275,4,4553,3072,20
64654098322,64654098321,-1,2057,3232,20
64656183877,64656183875,-2,1227,1167,20
64656401391,64656401383,-8,196,558,20
64660405907,64660405906,-1,752,1667,20
64661065854,64661065852,-2,362,1538,20
64663831426,64663831423,-3,1353,2909,20
64664381550,64664381545,-5,1048,1884,20
64664877721,64664877719,-2,1281,2401,20
64666509031,64666509027,-4,1509,2113,20
64666653755,64666653754,-1,1209,2262,20
64666746990,64666746987,-3,936,1667,20
64672418598,64672418597,-1,1342,1621,20
64679129309,64679129305,-4,1247,2848,20
64679350777,64679350778,1,1497,2123,20
64680839282,64680839277,-5,939,2397,20
64685385412,64685385408,-4,1241,2618,20
64688192466,64688192468,2,1964,1384,20
64690153994,64690153992,-2,1387,2155,20
64692002037,64692002035,-2,757,2123,20
64694540658,64694540654,-4,792,1565,20
64698371926,64698371920,-6,1724,5025,20
64699605241,64699605238,-3,1458,2054,20
64700530591,64700530587,-4,1477,2952,20
64708913403,64708913401,-2,1030,1979,20
64711064956,64711064953,-3,1357,2813,20
64711300994,64711300998,4,1352,1098,20
64712036554,64712036550,-4,1430,2590,20
64713073078,64713073075,-3,998,1926,20
64723862504,64723862506,2,1448,1545,20
64725458705,64725458702,-3,1013,2164,20
64727318010,64727318007,-3,1321,3126,20
64731290859,64731290862,3,1373,915,20
64732142121,64732142123,2,1345,1381,20
64735263700,64735263697,-3,1432,3167,20
64737864350,64737864345,-5,1263,2907,20
64743690060,64743690064,4,1231,1259,20
64744999167,64744999165,-2,1035,2493,20
64745073810,64745073809,-1,3015,3831,20
64745402223,64745402221,-2,962,1353,20
64745588881,64745588877,-4,1531,1857,20
64747426444,64747426441,-3,979,2606,20
64752876563,64752876557,-6,974,3020,20
64753425942,64753425932,-10,1413,1336,20
64753865306,64753865305,-1,967,2288,20
64755823271,64755823268,-3,1311,1835,20
64756855436,64756855434,-2,1059,2085,20
64759326657,64759326657,0,2576,3161,20
64763181393,64763181392,-1,2316,3226,20
64763289538,64763289536,-2,882,1793,20
64765813391,64765813387,-4,1163,2001,20
64766954119,64766954117,-2,1078,2431,20
64768257207,64768257203,-4,1791,3369,20
64768557427,64768557425,-2,1089,1682,20
64768813108,64768813106,-2,854,1717,20
64775657782,64775657780,-2,898,2263,20
64780304068,64780304066,-2,784,1297,20
64782633128,64782633126,-2,1013,2547,20
64783847763,64783847760,-3,856,1929,20
64784048565,64784048583,18,769,1202,20
64784816839,64784816838,-1,1009,1768,20
64784844109,64784844107,-2,1227,2699,20
64785106032,64785106031,-1,1111,3018,20
64788070326,64788070322,-4,1285,3119,20
64788104622,64788104643,21,822,2053,20
64788183677,64788183674,-3,1165,2556,20
64794830702,64794830701,-1,1228,2320,20
64802451546,64802451542,-4,1036,2265,20
64803006016,64803006034,18,723,2056,20
64803520394,64803520389,-5,780,1500,20
64808789654,64808789650,-4,913,3534,20
64808957676,64808957660,-16,1326,1386,20
64810660607,64810660606,-1,663,1510,20
64812748869,64812748869,0,433,1221,20
64814011405,64814011403,-2,861,1874,20
64814278276,64814278282,6,3065,1297,20
64814566747,64814566749,2,2077,1215,20
64823698863,64823698861,-2,699,1384,20
64829011319,64829011318,-1,618,1116,20
64832750837,64832750835,-2,995,1021,20
64835747079,64835747073,-6,1084,4221,20
64839389475,64839389471,-4,1166,2390,20
64840738921,64840738917,-4,1059,2168,20
64840821167,64840821163,-4,1154,3053,20
64843096706,64843096705,-1,643,880,20
64846677069,64846677069,0,1660,1400,20
64849444065,64849444060,-5,1094,2741,20
64849679966,64849679961,-5,1257,2303,20
64852085092,64852085086,-6,1385,3200,20
64852679690,64852679692,2,1974,1970,20
64854657115,64854657112,-3,575,1566,20
64855142335,64855142333,-2,1261,2312,20
64855312605,64855312601,-4,1040,2104,20
64861900933,64861900929,-4,1085,2793,20
64866597557,64866597553,-4,1517,3118,20
64870060962,64870060963,1,1237,1809,20
64870658449,64870658446,-3,1483,3007,20
64872653767,64872653765,-2,986,1182,20
64873456170,64873456167,-3,1190,2438,20
64876933885,64876933881,-4,1143,2703,20
64879973950,64879973946,-4,908,2186,20
64880905731,64880905728,-3,1176,2523,20
64881698263,64881698260,-3,1015,2464,20
64884473341,64884473336,-5,949,2566,20
64886581030,64886581037,7,665,2020,20
64887880027,64887880026,-1,913,1751,20
64891811684,64891811681,-3,5307,12788,20
64895324918,64895324915,-3,799,1023,20
64897675687,64897675680,-7,222,547,20
64906378045,64906378041,-4,1300,2542,20
64909344390,64909344383,-7,985,7492,20
64910797653,64910797646,-7,38190,14208,20
64917219714,64917219707,-7,1989,7289,20
64920408151,64920408150,-1,980,2305,20
64928481318,64928481315,-3,1059,2536,20
64930141231,64930141227,-4,1176,2277,20
64932737369,64932737366,-3,775,2631,20
64933796316,64933796317,1,1098,1241,20
64948850713,64948850710,-3,798,1737,20
64949295148,64949295146,-2,740,2468,20
64949981284,64949981281,-3,288,658,20
64951787838,64951787834,-4,1391,1935,20
64953955550,64953955546,-4,637,1395,20
64957604991,64957604989,-2,1551,2724,20
64961663823,64961663820,-3,1994,2122,20
64965765681,64965765678,-3,1451,2275,20
64966247855,64966247851,-4,745,1767,20
64970381867,64970381871,4,2735,1490,20
64970889323,64970889320,-3,1173,2280,20
64979209058,64979209056,-2,1288,3161,20
64980211157,64980211154,-3,1287,3106,20
64986111807,64986111805,-2,537,1821,20
64988484789,64988484784,-5,1265,3504,20
64988568336,64988568349,13,1079,2448,20
64995120489,64995120486,-3,1271,3107,20
65002875924,65002875928,4,2149,1375,20
65006948661,65006948658,-3,1061,2576,20
65009228038,65009228043,5,2924,1603,20
65011093601,65011093599,-2,1293,2722,20
65011246626,65011246623,-3,1276,3079,20
65012501091,65012501089,-2,680,1810,20
65013251155,65013251151,-4,902,3059,20
65013651895,65013651893,-2,1414,2039,20
65021931542,65021931538,-4,843,2014,20
65022374653,65022374638,-15,766,2785,20
65027161443,65027161441,-2,910,1918,20
65034583721,65034583719,-2,653,1423,20
65035162501,65035162484,-17,151,926,20
65038231716,65038231715,-1,1164,1470,20
65042233066,65042233063,-3,1589,2484,20
65045138886,65045138882,-4,1464,3220,20
65045678273,65045678270,-3,1219,2722,20
65045769781,65045769778,-3,1081,2401,20
65046777649,65046777648,-1,1254,2493,20
65047410517,65047410514,-3,1125,2140,20
65050373089,65050373087,-2,1320,2059,20
65051448556,65051448552,-4,978,2266,20
65052945172,65052945169,-3,1483,3487,20
65053590735,65053590731,-4,1241,2526,20
65063763914,65063763914,0,5381,7271,20
65063993151,65063993150,-1,1794,2025,20
65067242214,65067242213,-1,1434,1802,20
65068377510,65068377505,-5,1261,3226,20
65072214434,65072214431,-3,1247,2797,20
65074254202,65074254198,-4,18362,55972,20
65074686392,65074686391,-1,765,1898,20
65077561115,65077561113,-2,797,2734,20
65078280288,65078280285,-3,1327,1850,20
65086815818,65086815818,0,1335,1785,20
65087308105,65087308108,3,1818,1699,20
65087906487,65087906483,-4,1192,1476,20
65095728450,65095728445,-5,992,2594,20
65095920999,65095921013,14,919,3456,20
65096502846,65096502844,-2,1109,2360,20
65098719272,65098719269,-3,990,2193,20
65099516818,65099516814,-4,987,1990,20
65102855153,65102855151,-2,1619,1927,20
65110503034,65110503033,-1,1464,2305,20
65112838052,65112838048,-4,1326,2681,20
65113516379,65113516374,-5,927,2940,20
65116890719,65116890714,-5,1117,2200,20
65118502484,65118502471,-13,1423,2279,20
65130651101,65130651105,4,3161,1944,20
65138148101,65138148098,-3,1347,2562,20
65139289616,65139289612,-4,1027,2279,20
65142622383,65142622379,-4,891,3086,20
65146168671,65146168651,-20,468,862,20
65147697249,65147697255,6,1266,707,20
65148861354,65148861352,-2,1068,2534,20
65149189153,65149189150,-3,1605,3140,20
65156377642,65156377634,-8,32999,12754,20
65157389035,65157389030,-5,1040,1637,20
65158467117,65158467128,11,15147,39766,20
65158999793,65158999795,2,1812,1205,20
65162530086,65162530087,1,3363,3885,20
65163062251,65163062249,-2,1080,2623,20
65164468763,65164468764,1,1637,1948,20
65167879416,65167879416,0,1602,2640,20
65170097134,65170097131,-3,1316,2591,20
65172082541,65172082534,-7,725,1518,20
65174828407,65174828405,-2,723,1650,20
65174929374,65174929394,20,727,1498,20
65176177517,65176177514,-3,1672,2561,20
65176982654,65176982651,-3,944,2050,20
65177273174,65177273173,-1,1110,2029,20
65181579938,65181579937,-1,1397,1737,20
65184617082,65184617080,-2,1153,1887,20
65185368213,65185368211,-2,1721,2528,20
65186901867,65186901865,-2,1386,3079,20
65190532577,65190532577,0,1583,2503,20
65191745456,65191745455,-1,1478,2186,20
65195416528,65195416526,-2,1553,2445,20
65196004892,65196004889,-3,978,1812,20
65199976541,65199976537,-4,1390,2456,20
65200138036,65200138026,-10,946,2236,20
65200232959,65200232977,18,1142,2138,20
65201203855,65201203852,-3,1098,2649,20
65201551735,65201551752,17,797,2018,20
65209279802,65209279799,-3,943,2844,20
65209352158,65209352150,-8,1134,2441,20
65215348905,65215348902,-3,1363,2855,20
65217508595,65217508590,-5,956,2420,20
65217775467,65217775465,-2,1046,1773,20
65218417022,65218417020,-2,838,1821,20
65223455979,65223455973,-6,181,888,20
65230037806,65230037806,0,1569,2360,20
65232146956,65232146953,-3,1349,2039,20
65235844586,65235844593,7,3769,2001,20
65238287973,65238287972,-1,1367,2518,20
65238796075,65238796072,-3,1565,3592,20
65240628391,65240628388,-3,886,2279,20
65246609339,65246609336,-3,898,1593,20
65248018607,65248018602,-5,976,2304,20
65253055766,65253055764,-2,902,2019,20
65257525566,65257525558,-8,1212,9068,20
65262328249,65262328246,-3,1162,3314,20
65263172991,65263172990,-1,1066,2476,20
65264445047,65264445045,-2,767,1595,20
65266203153,65266203150,-3,1364,2263,20
65267855453,65267855451,-2,1234,2945,20
65284574387,65284574385,-2,1560,2911,20
65284937953,65284937950,-3,849,2028,20
65285653086,65285653084,-2,1032,2172,20
65286937779,65286937776,-3,1115,2451,20
65287056451,65287056448,-3,1224,3273,20
65290065938,65290065934,-4,986,2685,20
65291356270,65291356266,-4,1329,2730,20
65294499207,65294499202,-5,1346,3027,20
65297298127,65297298133,6,3960,1507,20
65304848541,65304848538,-3,1489,2664,20
65308152577,65308152574,-3,1269,2512,20
65313051260,65313051258,-2,1491,3586,20
65314053595,65314053593,-2,1282,2408,20
65314198141,65314198148,7,2303,1621,20
65320849234,65320849231,-3,1235,2149,20
65326173745,65326173739,-6,682,2488,20
65327227734,65327227730,-4,1043,1737,20
65327936922,65327936920,-2,1018,2256,20
65330625047,65330625041,-6,1068,2257,20
65330979683,65330979684,1,1500,1417,20
65331262514,65331262535,21,514,1552,20
65331936855,65331936853,-2,1093,2900,20
65331993296,65331993290,-6,1338,2744,20
65332535581,65332535577,-4,822,2270,20
65333225565,65333225569,4,3488,2857,20
65333692856,65333692851,-5,1087,2475,20
65342471057,65342471054,-3,848,1557,20
65343739013,65343739009,-4,1300,2287,20
65344332480,65344332471,-9,1102,4670,20
65344598060,65344598058,-2,1284,2439,20
65346068826,65346068824,-2,1642,4114,20
65346309857,65346309853,-4,962,2582,20
65350216977,65350216974,-3,693,1007,20
65354832630,65354832626,-4,818,2649,20
65356259789,65356259789,0,1248,2165,20
65356701462,65356701478,16,1209,2280,20
65358699404,65358699402,-2,2167,4804,20
65359103534,65359103529,-5,847,2879,20
65360941675,65360941674,-1,1278,1872,20
65361195017,65361195014,-3,1283,1855,20
65362506005,65362506002,-3,1351,2963,20
65363263470,65363263491,21,884,3164,20
65364733405,65364733402,-3,1361,2078,20
65365205005,65365205003,-2,1025,2030,20
65366911796,65366911793,-3,1281,2886,20
65368297413,65368297411,-2,1129,2292,20
65370088689,65370088685,-4,1386,3271,20
65373321504,65373321522,18,1479,1487,20
65375077721,65375077721,0,1399,2572,20
65376059523,65376059521,-2,1148,1773,20
65380825151,65380825149,-2,1107,3254,20
65381146038,65381146036,-2,886,1606,20
65389631391,65389631389,-2,823,1724,20
65390765858,65390765854,-4,1204,2285,20
65393789714,65393789711,-3,1349,1539,20
65394272521,65394272517,-4,1681,2172,20
65395304911,65395304909,-2,917,914,20
65399687312,65399687305,-7,1175,3350,20
65399972263,65399972246,-17,205,936,20
65405647035,65405647033,-2,1336,2188,20
65407377974,65407377973,-1,949,2392,20
65407962490,65407962487,-3,882,3678,20
65412954157,65412954153,-4,1060,3933,20
65413199511,65413199506,-5,1546,3061,20
65413745437,65413745433,-4,982,2933,20
65414164070,65414164090,20,1209,2033,20
65418373926,65418373925,-1,781,2238,20
65419245816,65419245814,-2,1159,2236,20
65421346681,65421346684,3,3268,3076,20
65422825926,65422825925,-1,1042,2048,20
65423924366,65423924363,-3,1598,2602,20
65424279974,65424279970,-4,908,2720,20
65424425820,65424425817,-3,857,1644,20
65428009685,65428009679,-6,180,919,20
65430143855,65430143853,-2,1285,2589,20
65431340390,65431340390,0,1507,2003,20
65432118390,65432118390,0,723,1529,20
65433422912,65433422910,-2,639,2449,20
65439690557,65439690555,-2,1101,1654,20
65444789149,65444789146,-3,1222,1937,20
65444989575,65444989581,6,267,724,20
65451075983,65451075983,0,2890,3846,20
65451822398,65451822394,-4,1138,2154,20
65452233042,65452233064,22,852,1210,20
65452786777,65452786775,-2,1139,2735,20
65453405195,65453405194,-1,1179,2046,20
65458721136,65458721133,-3,1175,2584,20
65462784678,65462784674,-4,882,1744,20
65466317981,65466317977,-4,830,1741,20
65469534695,65469534693,-2,781,1852,20
65470183442,65470183437,-5,824,1864,20
65470713480,65470713490,10,90,700,20
65471528343,65471528341,-2,688,1647,20
65479103069,65479103076,7,13072,26512,20
65480952314,65480952312,-2,970,2327,20
65481204538,65481204535,-3,1010,2515,20
65485187958,65485187954,-4,1188,2512,20
65487805655,65487805651,-4,1159,3304,20
65493257090,65493257085,-5,1395,2055,20
65494037664,65494037662,-2,1214,1926,20
65498093015,65498093011,-4,1428,2446,20
65500113798,65500113795,-3,1220,3766,20
65500532662,65500532658,-4,1184,2204,20
65503894899,65503894901,2,1769,2104,20
65504546737,65504546734,-3,1278,2175,20
65506461558,65506461557,-1,1376,2399,20
65508801324,65508801331,7,2415,1283,20
65509337358,65509337378,20,1577,1853,20
65513780034,65513780032,-2,1024,1623,20
65517419362,65517419358,-4,1361,3321,20
65518821115,65518821110,-5,1208,2296,20
65520278251,65520278247,-4,1221,2535,20
65526300313,65526300309,-4,1070,4949,20
65531406330,65531406328,-2,1239,2184,20
65533205629,65533205614,-15,933,3142,20
65536768899,65536768896,-3,1202,2080,20
65537598410,65537598409,-1,819,1582,20
65537627187,65537627186,-1,834,2465,20
65538717547,65538717545,-2,1045,1638,20
65544095277,65544095279,2,55108,75511,20
65545433891,65545433889,-2,935,1241,20
65548789021,65548789018,-3,1164,2026,20
65550549699,65550549703,4,770,585,20
65551474463,65551474461,-2,902,2873,20
65551989839,65551989837,-2,1429,2737,20
65552120316,65552120314,-2,892,2399,20
65552194659,65552194659,0,1134,1197,20
65552395787,65552395782,-5,1378,5291,20
65552973646,65552973641,-5,534,1786,20
65553569434,65553569433,-1,990,1741,20
65553704834,65553704834,0,3016,4362,20
65557617083,65557617099,16,223,3717,20
65559176490,65559176486,-4,867,2992,20
65560624045,65560624042,-3,969,2054,20
65561712343,65561712338,-5,825,1692,20
65563880686,65563880684,-2,1112,1728,20
65565973615,65565973612,-3,977,1655,20
65566045379,65566045377,-2,1384,2518,20
65569504684,65569504682,-2,690,2044,20
65570340178,65570340174,-4,826,1909,20
65571392070,65571392086,16,600,1396,20
65572033668,65572033665,-3,1347,2684,20
65573220919,65573220914,-5,1317,3548,20
65574836462,65574836458,-4,1211,2629,20
65577385523,65577385521,-2,1385,2723,20
65582656044,65582656041,-3,1532,2823,20
65587606462,65587606461,-1,1093,1908,20
65589527278,65589527273,-5,508,1392,20
65591696948,65591696946,-2,1231,2498,20
65593346008,65593346006,-2,673,1385,20
65598527367,65598527364,-3,1022,2136,20
65600391693,65600391688,-5,1646,3290,20
65608473970,65608473983,13,10687,45383,20
65610522247,65610522244,-3,854,2229,20
65615447715,65615447713,-2,928,1963,20
65619660230,65619660234,4,1674,1282,20
65623220793,65623220790,-3,1157,1575,20
65630840296,65630840293,-3,1260,1990,20
65631192447,65631192445,-2,1257,3347,20
65634298742,65634298735,-7,915,3523,20
65636113545,65636113542,-3,823,2054,20
65637133300,65637133299,-1,1382,2008,20
65642732379,65642732379,0,1295,1664,20
65645070209,65645070205,-4,911,2135,20
65645755856,65645755853,-3,1308,2756,20
65647707224,65647707222,-2,1215,2877,20
65649807546,65649807545,-1,2818,4029,20
65650983051,65650983048,-3,1877,4043,20
65657646734,65657646731,-3,1732,3868,20
65657791866,65657791863,-3,835,2128,20
65658916291,65658916287,-4,770,2395,20
65659434806,65659434789,-17,1181,2097,20
65659735243,65659735241,-2,772,2634,20
65661697614,65661697617,3,1310,1764,20
65663728733,65663728730,-3,1114,2142,20
65669858160,65669858158,-2,986,1646,20
65670061462,65670061463,1,290,1010,20
65672396703,65672396699,-4,889,2428,20
65673490684,65673490681,-3,895,1694,20
65674524182,65674524180,-2,759,1538,20
65676418495,65676418492,-3,1394,3281,20
65677888633,65677888630,-3,995,2256,20
65679266871,65679266869,-2,899,1910,20
65681654254,65681654255,1,2285,2519,20
65682553552,65682553550,-2,1561,2321,20
65683711256,65683711254,-2,1535,2124,20
65684930774,65684930771,-3,610,1236,20
65686281578,65686281574,-4,861,1694,20
65686523708,65686523710,2,1362,1571,20
65691005498,65691005495,-3,963,2269,20
65696962163,65696962159,-4,1095,1871,20
65697097687,65697097674,-13,834,1880,20
65697607481,65697607477,-4,1294,2361,20
65698277405,65698277402,-3,965,1297,20
65699857887,65699857885,-2,870,2313,20
65700660626,65700660629,3,2765,2429,20
65701180636,65701180633,-3,985,2021,20
65705317183,65705317178,-5,1177,2189,20
65705516933,65705516954,21,1005,1987,20
65709149691,65709149687,-4,942,2108,20
65711117452,65711117446,-6,983,2174,20
65712105506,65712105503,-3,1263,2021,20
65726853561,65726853560,-1,1338,3146,20
65730160226,65730160223,-3,1312,2093,20
65736064622,65736064616,-6,1254,2351,20
65737186918,65737186914,-4,991,2071,20
65737822607,65737822605,-2,1146,2584,20
65737865063,65737865080,17,969,2287,20
65739938061,65739938065,4,12937,8015,20
65740639978,65740639971,-7,2469,9265,20
65740860515,65740860517,2,1741,1507,20
65741540739,65741540743,4,2672,1682,20
65742203288,65742203303,15,703,2416,20
65744234458,65744234458,0,1339,2614,20
65746150194,65746150191,-3,843,2299,20
65751590326,65751590326,0,1649,1820,20
65752921864,65752921862,-2,1249,1999,20
65754296150,65754296145,-5,817,1728,20
65756786637,65756786626,-11,870,2242,20
65757974274,65757974272,-2,1554,2220,20
65759421081,65759421077,-4,805,1710,20
65767549530,65767549528,-2,1002,2555,20
65778172907,65778172904,-3,884,1653,20
65780314217,65780314214,-3,1266,2796,20
65782350712,65782350706,-6,1368,4261,20
65782513649,65782513647,-2,1076,1408,20
65787913679,65787913674,-5,940,2865,20
65790980250,65790980250,0,1306,1491,20
65793532115,65793532110,-5,813,3145,20
65798497303,65798497300,-3,1047,2964,20
65804768118,65804768117,-1,1029,2152,20
65807770068,65807770061,-7,1320,3254,20
65818399347,65818399344,-3,1127,2033,20
65819961697,65819961695,-2,1105,2121,20
65821794069,65821794049,-20,1491,1302,20
65824318727,65824318726,-1,1168,2131,20
65828209191,65828209188,-3,1074,2380,20
65828683309,65828683326,17,969,2745,20
65830021502,65830021496,-6,1156,3860,20
65831000725,65831000718,-7,1089,1930,20
65835435710,65835435706,-4,1178,2697,20
65838882710,65838882709,-1,1056,1481,20
65840214612,65840214610,-2,1056,2940,20
65841211615,65841211616,1,158,1509,20
65846405635,65846405632,-3,533,2138,20
65846901832,65846901846,14,874,2523,20
65852660643,65852660639,-4,1107,1865,20
65855807710,65855807708,-2,1191,1897,20
65858523583,65858523580,-3,1582,2349,20
65860190230,65860190226,-4,26194,17757,20
65862426954,65862426954,0,1098,1974,20
65863893777,65863893770,-7,1379,5234,20
65865573168,65865573165,-3,1078,1475,20
65866183492,65866183489,-3,990,2157,20
65867542700,65867542695,-5,633,2117,20
65868283527,65868283522,-5,694,1737,20
65870787382,65870787379,-3,991,1823,20
65871351135,65871351131,-4,691,1960,20
65875125278,65875125283,5,1701,809,20
65877924157,65877924153,-4,791,1290,20
65880793419,65880793417,-2,1114,2367,20
65882779283,65882779278,-5,693,1799,20
65883246207,65883246203,-4,1066,1762,20
65890280246,65890280241,-5,1205,1990,20
65892325430,65892325429,-1,1166,2352,20
65894492134,65894492131,-3,870,2268,20
65895215753,65895215749,-4,1177,1861,20
65898040919,65898040915,-4,778,2011,20
65898856796,65898856818,22,1005,2620,20
65899956074,65899956072,-2,1278,3222,20
65901471249,65901471246,-3,1060,2008,20
65902220461,65902220458,-3,1413,2125,20
65904799174,65904799170,-4,1060,1935,20
65910854679,65910854677,-2,1486,2577,20
65913721245,65913721242,-3,1191,2029,20
65922761871,65922761870,-1,828,1441,20
65922888322,65922888315,-7,1163,4200,20
65926449547,65926449545,-2,1099,2436,20
65927001214,65927001212,-2,932,2404,20
65927078274,65927078271,-3,1475,2300,20
65927321702,65927321717,15,342,1004,20
65929990091,65929990089,-2,1159,2655,20
65930021037,65930021034,-3,845,2562,20
65937816621,65937816623,2,1278,1157,20
65944151366,65944151365,-1,976,1851,20
65945774770,65945774767,-3,1494,2035,20
65946062596,65946062593,-3,1465,2262,20
65947384283,65947384285,2,1199,916,20
65953660629,65953660626,-3,955,1920,20
65953973146,65953973141,-5,1518,2232,20
65957839499,65957839495,-4,1060,2215,20
65963948779,65963948778,-1,999,2142,20
65967892363,65967892357,-6,1383,3504,20
65968781670,65968781665,-5,1164,2488,20
65973216444,65973216443,-1,1318,2900,20
65976178874,65976178870,-4,882,1850,20
65981763898,65981763906,8,3000,1138,20
65983865383,65983865380,-3,1085,2776,20
66002142253,66002142251,-2,1079,2114,20
66005177997,66005177993,-4,800,2410,20
66006632606,66006632602,-4,1029,2920,20
66012023659,66012023662,3,2324,1757,20
66013017714,66013017711,-3,1012,1299,20
66019012578,66019012574,-4,1651,3493,20
66019160436,66019160434,-2,1581,2169,20
66019645479,66019645470,-9,154,1162,20
66020654897,66020654893,-4,935,2178,20
66025906551,66025906550,-1,905,2251,20
66033585833,66033585830,-3,1776,3138,20
66037692433,66037692431,-2,1176,2118,20
66039858290,66039858286,-4,880,1659,20
66044160489,66044160489,0,1275,2110,20
66050807893,66050807890,-3,1250,1952,20
66051844637,66051844632,-5,1173,2132,20
66056686199,66056686197,-2,987,2270,20
66057740114,66057740110,-4,865,3056,20
66062083618,66062083614,-4,1180,3074,20
66062423527,66062423545,18,198,1535,20
66065589558,66065589556,-2,813,1268,20
66068191262,66068191258,-4,1414,3314,20
66072641094,66072641090,-4,1466,3820,20
66074698674,66074698674,0,1533,1424,20
66079274074,66079274071,-3,754,2040,20
66082125178,66082125175,-3,1188,2030,20
66084165434,66084165435,1,1245,1724,20
66087599866,66087599862,-4,1040,2345,20
66089201474,66089201472,-2,924,2380,20
66091397473,66091397469,-4,903,1809,20
66093482878,66093482873,-5,869,2839,20
66099118489,66099118483,-6,1298,4515,20
66099890944,66099890940,-4,1272,2508,20
66100661291,66100661290,-1,1347,2332,20
66101565787,66101565783,-4,717,2226,20
66105339259,66105339259,0,1413,1648,20
66107766870,66107766867,-3,976,2121,20
66107880606,66107880586,-20,1577,2088,20
66115320449,66115320446,-3,1122,1860,20
66118315113,66118315109,-4,1301,2056,20
66118557391,66118557376,-15,931,2785,20
66121043263,66121043260,-3,1052,2627,20
66125226003,66125225998,-5,787,2388,20
66126776047,66126776044,-3,1046,1136,20
66127967259,66127967257,-2,1116,1736,20
66128782555,66128782556,1,1148,1715,20
66134653332,66134653330,-2,1042,1742,20
66135727888,66135727907,19,787,2438,20
66140298907,66140298900,-7,1470,2470,20
66142454991,66142454989,-2,1244,3127,20
66143516425,66143516422,-3,1135,3131,20
66144318353,66144318350,-3,1489,2555,20
66148094393,66148094390,-3,1173,2195,20
66150304374,66150304370,-4,1306,2199,20
66155717066,66155717062,-4,1030,2490,20
66157321346,66157321343,-3,1449,2840,20
66158552705,66158552703,-2,920,1441,20
66165472271,66165472265,-6,1230,2805,20
66169282169,66169282166,-3,1448,2343,20
66171098645,66171098645,0,1348,1541,20
66174271190,66174271187,-3,997,2116,20
66180148602,66180148600,-2,610,1774,20
66183466493,66183466490,-3,1240,2852,20
66183890179,66183890176,-3,706,1299,20
66186329762,66186329758,-4,1453,2370,20
66186837262,66186837262,0,1067,1849,20
66187531366,66187531385,19,292,634,20
66188494713,66188494710,-3,1973,3005,20
66190203606,66190203602,-4,1465,2962,20
66191321661,66191321659,-2,1545,2533,20
66192435894,66192435894,0,1474,2050,20
66194921538,66194921533,-5,1436,1862,20
66197212818,66197212819,1,1414,968,20
66200939410,66200939409,-1,1327,2639,20
66201263143,66201263139,-4,949,2103,20
66202242543,66202242547,4,2087,1117,20
66202310150,66202310148,-2,1055,3169,20
66203364486,66203364482,-4,1506,2033,20
66203919630,66203919648,18,1409,1463,20
66206298181,66206298183,2,2363,1689,20
66209650359,66209650354,-5,1351,2402,20
66211063617,66211063614,-3,809,2041,20
66215983898,66215983894,-4,949,2559,20
66216207897,66216207894,-3,752,1615,20
66219174363,66219174359,-4,1145,2056,20
66222909998,66222910003,5,1932,1125,20
66223209839,66223209837,-2,959,2054,20
66224009223,66224009226,3,1262,1407,20
66225002986,66225002982,-4,822,2393,20
66226042789,66226042786,-3,1157,2909,20
66228356774,66228356770,-4,1037,2599,20
66241518663,66241518661,-2,1104,2164,20
66243282570,66243282565,-5,805,1880,20
66246802098,66246802095,-3,1311,3041,20
66248007174,66248007187,13,15842,28451,20
66249028744,66249028742,-2,873,2712,20
66251700621,66251700617,-4,1282,1861,20
66253514581,66253514580,-1,2491,2646,20
66256471126,66256471126,0,1475,1399,20
66266645590,66266645588,-2,1003,2330,20
66267927558,66267927558,0,1513,1745,20
66268188623,66268188621,-2,1384,2535,20
66268251039,66268251037,-2,874,2420,20
66276693339,66276693336,-3,1077,2265,20
66277009566,66277009563,-3,1678,2989,20
66280252636,66280252633,-3,1482,2758,20
66281275653,66281275653,0,911,1810,20
66281494515,66281494522,7,2529,664,20
66288367013,66288367011,-2,1285,2238,20
66289642410,66289642407,-3,678,1438,20
66290334441,66290334436,-5,996,1696,20
66290495933,66290495930,-3,990,1488,20
66291374682,66291374678,-4,1037,2156,20
66298003802,66298003802,0,1019,1724,20
66299969659,66299969662,3,1244,2212,20
66300981696,66300981692,-4,935,1421,20
66301846869,66301846866,-3,1204,2769,20
66302433035,66302433031,-4,768,1369,20
66305786031,66305786028,-3,1264,2107,20
66305840923,66305840922,-1,1159,2165,20
66306785262,66306785261,-1,991,1948,20
66312582752,66312582750,-2,1502,2699,20
66313255690,66313255687,-3,1597,2606,20
66314032985,66314032979,-6,963,1513,20
66316917712,66316917710,-2,1071,2350,20
66316972942,66316972941,-1,680,2292,20
66324903934,66324903937,3,3075,2104,20
66331981650,66331981647,-3,1685,2088,20
66332447026,66332447025,-1,1385,2401,20
66333896286,66333896283,-3,1314,3108,20
66337530538,66337530534,-4,1395,3009,20
66337968222,66337968242,20,1160,1648,20
66344953683,66344953681,-2,765,2169,20
66353085789,66353085786,-3,1145,2685,20
66358855323,66358855322,-1,1269,2125,20
66359612163,66359612160,-3,1046,1869,20
66367207763,66367207759,-4,1457,2746,20
66367265154,66367265153,-1,1157,2736,20
66368833018,66368833014,-4,834,2189,20
66370411290,66370411287,-3,910,2111,20
66372495309,66372495307,-2,845,1797,20
66372659928,66372659943,15,282,1833,20
66373721575,66373721573,-2,1164,2416,20
66374089210,66374089208,-2,1219,2553,20
66375247039,66375247035,-4,957,3147,20
66375357523,66375357522,-1,656,767,20
66375600376,66375600374,-2,996,2409,20
66376328394,66376328390,-4,1586,2656,20
66379121305,66379121301,-4,1176,1640,20
66387211499,66387211495,-4,1026,2184,20
66391032219,66391032218,-1,734,1614,20
66392371239,66392371234,-5,1303,3149,20
66392509371,66392509368,-3,798,1526,20
66398356759,66398356754,-5,1106,2324,20
66399561100,66399561097,-3,1509,3295,20
66407820699,66407820698,-1,1097,2527,20
66408932180,66408932178,-2,1412,1540,20
66418351907,66418351903,-4,1134,2696,20
66428350724,66428350721,-3,1049,3065,20
66428459854,66428459850,-4,1304,2718,20
66432039180,66432039176,-4,1282,2118,20
66436918962,66436918959,-3,929,1850,20
66445815623,66445815621,-2,1592,2746,20
66447820498,66447820496,-2,1213,2267,20
66450536471,66450536470,-1,2665,3226,20
66452422562,66452422560,-2,648,1793,20
66456781652,66456781648,-4,1203,3079,20
66456979744,66456979739,-5,1385,2877,20
66459626023,66459626021,-2,882,2055,20
66464017527,66464017530,3,2911,1468,20
66465229139,66465229137,-2,795,2442,20
66465874691,66465874687,-4,1117,2622,20
66467954106,66467954105,-1,1417,2594,20
66468731344,66468731362,18,1358,2610,20
66469804746,66469804746,0,1260,1951,20
66471111439,66471111436,-3,689,1687,20
66479617301,66479617301,0,9224,13373,20
66479897352,66479897348,-4,1216,2404,20
66480904146,66480904147,1,2774,2474,20
66485087065,66485087062,-3,1875,3589,20
66487767632,66487767627,-5,1083,1775,20
66490160248,66490160245,-3,1528,2883,20
66491371456,66491371454,-2,1264,2722,20
66491654551,66491654549,-2,1097,2752,20
66499852853,66499852851,-2,1332,2144,20
66501724250,66501724248,-2,1302,1828,20
66506275922,66506275918,-4,1269,2201,20
66508828997,66508828994,-3,1127,2778,20
66515632555,66515632554,-1,1356,1979,20
66516616432,66516616429,-3,545,2078,20
66516685092,66516685077,-15,1226,2553,20
66517567214,66517567211,-3,1183,1906,20
66518658651,66518658647,-4,1168,1945,20
66519599091,66519599091,0,562,1837,20
66525117505,66525117501,-4,1370,2226,20
66525277687,66525277684,-3,1106,3403,20
66528161323,66528161318,-5,791,2232,20
66528210590,66528210610,20,971,1953,20
66529579191,66529579188,-3,1267,1926,20
66531046730,66531046726,-4,1005,2468,20
66531113669,66531113668,-1,738,2291,20
66533509935,66533509934,-1,699,1376,20
66535545575,66535545572,-3,877,2064,20
66537679798,66537679794,-4,1304,2861,20
66538292734,66538292750,16,685,1454,20
66539454197,66539454194,-3,1124,2949,20
66539568559,66539568541,-18,973,2721,20
66540111942,66540111934,-8,1016,1999,20
66540725369,66540725367,-2,1545,2268,20
66541552529,66541552522,-7,1042,2621,20
66541897527,66541897511,-16,283,1134,20
66543929201,66543929197,-4,1020,2264,20
66553057717,66553057715,-2,1133,2488,20
66553684659,66553684653,-6,1012,3127,20
66558490414,66558490413,-1,1345,1850,20
66560093113,66560093109,-4,928,1561,20
66568633899,66568633897,-2,1665,3489,20
66568680103,66568680099,-4,981,2363,20
66575529665,66575529662,-3,890,1879,20
66581808386,66581808390,4,2393,1055,20
66582852021,66582852029,8,7434,1899,20
66593168908,66593168904,-4,1013,2146,20
66594724878,66594724874,-4,1356,1553,20
66596150643,66596150641,-2,958,1565,20
66605336829,66605336829,0,1034,2723,20
66608073808,66608073805,-3,1493,2803,20
66610941661,66610941657,-4,1433,3126,20
66615429450,66615429447,-3,1389,2045,20
66615471999,66615471990,-9,964,2357,20
66617427947,66617427943,-4,855,1816,20
66623329128,66623329126,-2,1536,3086,20
66626632971,66626632969,-2,911,3552,20
66635633822,66635633818,-4,1001,2279,20
66639532558,66639532558,0,1304,2774,20
66640311838,66640311835,-3,1428,2426,20
66641300446,66641300445,-1,1590,2315,20
66644913018,66644913017,-1,904,2023,20
66647628038,66647628037,-1,1594,3531,20
66649546053,66649546058,5,1862,495,20
66651443090,66651443085,-5,814,2377,20
66653235490,66653235486,-4,1022,2273,20
66653669498,66653669498,0,1625,1580,20
66654582795,66654582794,-1,1744,1846,20
66654696178,66654696177,-1,1121,2179,20
66658517969,66658517966,-3,869,2127,20
66660498095,66660498092,-3,904,2369,20
66665005959,66665005956,-3,1547,2625,20
66666859681,66666859679,-2,1321,2747,20
66667438526,66667438525,-1,1493,1604,20
66669165142,66669165139,-3,1884,2866,20
66669488043,66669488041,-2,1278,3195,20
66672172944,66672172949,5,3514,2277,20
66672250514,66672250512,-2,1107,2628,20
66673010187,66673010181,-6,1590,2806,20
66677114994,66677114990,-4,1107,3546,20
66678876207,66678876205,-2,1181,2619,20
66679587186,66679587183,-3,844,2913,20
66680512970,66680512971,1,1735,1423,20
66681798859,66681798857,-2,977,2828,20
66686638726,66686638722,-4,1040,2884,20
66688542166,66688542163,-3,983,2109,20
66693565523,66693565521,-2,1618,2521,20
66702321586,66702321584,-2,654,1951,20
66705676419,66705676415,-4,1250,2576,20
66711819688,66711819686,-2,1705,3591,20
66713724143,66713724141,-2,853,1881,20
66719667423,66719667419,-4,911,1674,20
66720198995,66720198989,-6,865,2960,20
66723342769,66723342766,-3,1214,2064,20
66723423669,66723423652,-17,304,1290,20
66724643269,66724643265,-4,1183,2192,20
66725631625,66725631623,-2,1590,2197,20
66731643178,66731643177,-1,995,1993,20
66734796462,66734796457,-5,1133,2140,20
66737011176,66737011173,-3,826,1757,20
66748177827,66748177826,-1,1339,2012,20
66751741977,66751741974,-3,836,1939,20
66757402509,66757402507,-2,1081,1919,20
66766021886,66766021883,-3,884,2833,20
66766642375,66766642372,-3,750,1618,20
66778481458,66778481454,-4,1061,1580,20
66782355946,66782355945,-1,1145,2786,20
66783415674,66783415687,13,2138,1565,20
66785115730,66785115726,-4,920,2430,20
66786400694,66786400702,8,1753,628,20
66788647526,66788647522,-4,989,2725,20
66789536601,66789536596,-5,1286,2044,20
66792987917,66792987925,8,5828,1206,20
66793227510,66793227518,8,983,1298,20
66793825743,66793825723,-20,753,2195,20
66796001896,66796001915,19,371,728,20
66804811810,66804811807,-3,1074,2462,20
66807820339,66807820336,-3,844,2431,20
66811076990,66811076986,-4,1472,2842,20
66811759012,66811759004,-8,900,4749,20
66817225446,66817225442,-4,1171,2762,20
66817253658,66817253653,-5,1025,2225,20
66817845943,66817845941,-2,1156,1717,20
66819699198,66819699198,0,1064,1345,20
66821566187,66821566185,-2,1059,3699,20
66825676455,66825676453,-2,1466,2403,20
66826215319,66826215317,-2,1253,2628,20
66826360165,66826360163,-2,1125,2702,20
66827799847,66827799845,-2,1556,2782,20
66830182417,66830182416,-1,692,864,20
66832688651,66832688649,-2,937,2115,20
66833346693,66833346690,-3,746,1648,20
66837764350,66837764346,-4,1388,2864,20
66842784355,66842784352,-3,934,2644,20
66845893701,66845893698,-3,1284,2835,20
66846606592,66846606590,-2,1260,1956,20
66846665031,66846665046,15,385,678,20
66847579022,66847579021,-1,934,1662,20
66848388642,66848388640,-2,1167,2858,20
66848606658,66848606654,-4,1256,2328,20
66850911535,66850911531,-4,5549,12606,20
66857919858,66857919857,-1,1421,1515,20
66858551987,66858551983,-4,1197,2119,20
66860797005,66860797005,0,1341,1366,20
66867250897,66867250894,-3,1205,3118,20
66869707034,66869707030,-4,1171,1840,20
66872358499,66872358497,-2,1234,2336,20
66880686713,66880686711,-2,1390,3061,20
66881896406,66881896405,-1,644,2118,20
66882256925,66882256923,-2,1428,2884,20
66882355151,66882355148,-3,828,1570,20
66882651152,66882651149,-3,1486,3594,20
66883627636,66883627633,-3,808,1952,20
66892624957,66892624956,-1,1013,1646,20
66898651167,66898651165,-2,641,1697,20
66902732151,66902732149,-2,771,1424,20
66903958326,66903958324,-2,805,1655,20
66905763431,66905763430,-1,1052,2088,20
66908218196,66908218190,-6,1481,2439,20
66909190582,66909190579,-3,1207,2771,20
66912521764,66912521762,-2,1238,2445,20
66912747966,66912747969,3,88,661,20
66915117436,66915117433,-3,1118,2254,20
66918212495,66918212492,-3,2027,4222,20
66920094190,66920094185,-5,973,1784,20
66920763106,66920763103,-3,1524,3084,20
66921146550,66921146546,-4,735,1223,20
66923444064,66923444061,-3,1148,2635,20
66931711072,66931711069,-3,1160,2554,20
66933650074,66933650074,0,1178,1858,20
66934266697,66934266698,1,1339,2367,20
66937398462,66937398459,-3,998,2043,20
66937581849,66937581847,-2,1361,3016,20
66937768342,66937768338,-4,913,2106,20
66937894053,66937894049,-4,1622,2188,20
66938563080,66938563076,-4,1063,2190,20
66941220967,66941220965,-2,2049,4051,20
66942643133,66942643131,-2,1371,2925,20
66943508850,66943508847,-3,1098,1986,20
66949200981,66949200987,6,7258,33837,20
66949426278,66949426274,-4,1305,2935,20
66949629488,66949629502,14,262,1439,20
66950783807,66950783825,18,1690,2866,20
66956362190,66956362185,-5,1376,3206,20
66956908397,66956908394,-3,1114,2640,20
66960339780,66960339778,-2,1872,3108,20
66962445536,66962445537,1,1537,1288,20
66963609622,66963609618,-4,756,1794,20
66964312181,66964312181,0,1339,2442,20
66969501822,66969501820,-2,618,1777,20
66970937486,66970937482,-4,1343,3048,20
66973386741,66973386742,1,1494,1699,20
66975006162,66975006158,-4,1102,3809,20
66976036976,66976036974,-2,1355,2099,20
66978362938,66978362935,-3,1463,2753,20
66981191433,66981191431,-2,1494,2874,20
66987597286,66987597286,0,1373,1857,20
66989037712,66989037707,-5,1380,1826,20
66992582049,66992582056,7,3114,805,20
66995534881,66995534878,-3,822,1896,20
66997798327,66997798326,-1,1286,2290,20
66999615767,66999615765,-2,995,2436,20
67000289181,67000289177,-4,1526,3140,20
67003560950,67003560955,5,1699,1149,20
67006775263,67006775262,-1,1103,2292,20
67007100950,67007100948,-2,1197,1993,20
67007653814,67007653793,-21,846,2508,20
67009549164,67009549162,-2,1372,2407,20
67013277908,67013277904,-4,1191,2411,20
67014840066,67014840065,-1,1187,1901,20
67016505959,67016505956,-3,1272,3166,20
67018470758,67018470756,-2,1633,3169,20
67021758118,67021758115,-3,665,842,20
67022292923,67022292920,-3,1144,2968,20
67022433005,67022433001,-4,995,1989,20
67023030597,67023030594,-3,1246,2396,20
67024571441,67024571439,-2,1139,2386,20
67025617370,67025617370,0,728,1710,20
67025754574,67025754587,13,275,821,20
67030274705,67030274701,-4,1273,2488,20
67034892841,67034892838,-3,1067,2061,20
67036080389,67036080386,-3,1225,2434,20
67040230797,67040230797,0,1225,1976,20
67040583864,67040583881,17,1057,2416,20
67041028863,67041028861,-2,1395,1591,20
67042377594,67042377592,-2,924,2049,20
67046616946,67046616942,-4,946,1617,20
67047583159,67047583173,14,653,1988,20
67052433568,67052433568,0,19131,25773,20
67057069319,67057069315,-4,952,1857,20
67057311815,67057311812,-3,1230,2321,20
67063998552,67063998550,-2,1220,2520,20
67066345763,67066345759,-4,984,3384,20
67073977849,67073977853,4,1841,1320,20
67075948111,67075948110,-1,1620,2437,20
67076366787,67076366785,-2,1148,2237,20
67076721126,67076721124,-2,1340,2302,20
67079715151,67079715149,-2,662,1394,20
67080449429,67080449442,13,215,830,20
67082049241,67082049240,-1,1269,2076,20
67085383520,67085383543,23,27,1997,20
67087244581,67087244578,-3,1189,2080,20
67089075513,67089075516,3,1691,1401,20
67098966479,67098966482,3,1521,1602,20
67100766323,67100766318,-5,980,1855,20
67102293465,67102293462,-3,684,1624,20
67103122736,67103122719,-17,156,792,20
67103891614,67103891620,6,4282,2944,20
67104497757,67104497754,-3,893,1068,20
67105847661,67105847661,0,1284,1324,20
67107468530,67107468534,4,4186,2021,20
67107704815,67107704813,-2,1033,1785,20
67115124998,67115125001,3,1822,1235,20
67117504421,67117504417,-4,933,2736,20
67119250282,67119250281,-1,1019,2314,20
67120963000,67120963018,18,678,1733,20
67122422671,67122422666,-5,571,1750,20
67123869615,67123869613,-2,748,1192,20
67124948279,67124948274,-5,1173,3634,20
67128753950,67128753947,-3,981,1615,20
67130185923,67130185919,-4,677,991,20
67130936851,67130936846,-5,1180,4365,20
67135754910,67135754908,-2,1279,2629,20
67137028079,67137028083,4,1016,1240,20
67142006633,67142006627,-6,1044,2460,20
67146846797,67146846794,-3,1109,2563,20
67149318203,67149318200,-3,1183,2694,20
67151910841,67151910838,-3,597,1617,20
67151970007,67151970002,-5,1193,2894,20
67152996078,67152996078,0,1116,892,20
67153914181,67153914178,-3,1088,2366,20
67155118087,67155118107,20,834,895,20
67156966317,67156966314,-3,1336,2937,20
67158622504,67158622504,0,1041,1872,20
67160888805,67160888803,-2,1561,2293,20
67166145992,67166145991,-1,1091,2262,20
67170668177,67170668174,-3,1258,3442,20
67175655537,67175655534,-3,922,2675,20
67190202974,67190202970,-4,1132,2746,20
67190770502,67190770513,11,217,1097,20
67191405450,67191405442,-8,1605,5883,20
67191604590,67191604588,-2,1339,2602,20
67193235690,67193235686,-4,879,2214,20
67194932621,67194932620,-1,1618,2127,20
67195464979,67195464976,-3,880,1276,20
67197257674,67197257671,-3,1217,2254,20
67204882318,67204882315,-3,1310,2092,20
67207169670,67207169666,-4,1099,2282,20
67212769257,67212769260,3,1709,1728,20
67219067494,67219067487,-7,1005,2200,20
67220586963,67220586961,-2,791,1991,20
67221597288,67221597285,-3,1185,1969,20
67223571034,67223571030,-4,1177,1996,20
67228286767,67228286765,-2,886,1455,20
67228639221,67228639218,-3,905,2228,20
67229364603,67229364600,-3,1127,3413,20
67229534639,67229534655,16,1390,2918,20
67234260853,67234260852,-1,982,1842,20
67234623495,67234623502,7,3675,1510,20
67240834963,67240834961,-2,1478,2907,20
67242046007,67242046002,-5,1182,1880,20
67246781238,67246781235,-3,1324,2572,20
67249301835,67249301833,-2,831,2220,20
67262037559,67262037557,-2,1324,2446,20
67262775071,67262775069,-2,1195,2427,20
67263171342,67263171341,-1,1555,2165,20
67267218906,67267218903,-3,1150,2413,20
67268425082,67268425079,-3,1565,1933,20
67269027146,67269027141,-5,1176,1937,20
67272297007,67272297004,-3,1505,2532,20
67273491126,67273491121,-5,953,2223,20
67273531182,67273531199,17,502,939,20
67274372107,67274372105,-2,1021,1879,20
67275943137,67275943135,-2,792,2022,20
67276874990,67276874988,-2,951,2321,20
67277121071,67277121066,-5,699,1725,20
67277255087,67277255085,-2,606,1452,20
67277542724,67277542729,5,243,1305,20
67278325327,67278325321,-6,1128,2747,20
67281367874,67281367870,-4,902,2576,20
67281649017,67281649014,-3,50084,26462,20
67285615127,67285615125,-2,1322,2826,20
67289996012,67289996010,-2,1400,1878,20
67293681051,67293681049,-2,640,1489,20
67295097797,67295097802,5,3067,940,20
67295664810,67295664807,-3,997,1619,20
67302087004,67302087000,-4,920,3858,20
67303288355,67303288355,0,869,1839,20
67305805874,67305805871,-3,1557,1894,20
67306152651,67306152648,-3,1878,2946,20
67307505898,67307505891,-7,1399,4319,20
67314461078,67314461076,-2,857,2666,20
67315068886,67315068884,-2,899,2319,20
67321115640,67321115643,3,1310,977,20
67326245682,67326245677,-5,1082,1969,20
67330442949,67330442945,-4,1752,4079,20
67340106106,67340106105,-1,1320,2688,20
67340241359,67340241366,7,2685,896,20
67344844826,67344844824,-2,1252,2092,20
67345655623,67345655627,4,1970,1727,20
67345763081,67345763079,-2,1085,2057,20
67346974890,67346974886,-4,1000,2290,20
67347862697,67347862694,-3,1176,2357,20
67348445200,67348445214,14,289,975,20
67349802726,67349802746,20,627,2102,20
67351232558,67351232553,-5,760,4069,20
67354683549,67354683547,-2,997,1540,20
67357622024,67357622022,-2,861,1444,20
67357981906,67357981906,0,1153,2365,20
67359253258,67359253257,-1,1065,2983,20
67361244606,67361244602,-4,1056,1930,20
67363706687,67363706685,-2,861,1736,20
67364911874,67364911870,-4,786,1851,20
67365464675,67365464671,-4,1231,2180,20
67365683883,67365683879,-4,1249,3159,20
67366140679,67366140680,1,1172,2177,20
67366323025,67366323024,-1,2516,2995,20
67366971081,67366971078,-3,1122,2149,20
67370841176,67370841174,-2,860,1507,20
67379119728,67379119734,6,2399,1289,20
67380902187,67380902185,-2,1113,2730,20
67390545041,67390545043,2,1287,1305,20
67394209084,67394209080,-4,835,1646,20
67395973742,67395973742,0,1087,1958,20
67403380074,67403380071,-3,902,2687,20
67406156326,67406156322,-4,1260,2541,20
67410541177,67410541175,-2,1139,1978,20
67413729599,67413729596,-3,825,1569,20
67413972242,67413972237,-5,1007,2597,20
67419357570,67419357577,7,3393,1706,20
67419401250,67419401247,-3,1116,2435,20
67420352939,67420352935,-4,2717,5793,20
67422894655,67422894650,-5,1441,2611,20
67423845362,67423845361,-1,1273,1774,20
67424888567,67424888563,-4,919,2656,20
67425079102,67425079119,17,830,1832,20
67425918799,67425918797,-2,1221,2966,20
67429932709,67429932705,-4,1166,2685,20
67431396280,67431396278,-2,1289,2145,20
67431759572,67431759568,-4,1447,2253,20
67432154930,67432154927,-3,1080,2872,20
67438369586,67438369582,-4,1289,2157,20
67440625518,67440625516,-2,853,1051,20
67442570309,67442570306,-3,806,1698,20
67442702814,67442702833,19,380,1602,20
67444548202,67444548202,0,1345,2474,20
67444848502,67444848510,8,4123,1361,20
67446020758,67446020754,-4,978,1944,20
67448232046,67448232058,12,172,948,20
67452419810,67452419808,-2,737,1620,20
67459352031,67459352027,-4,834,1686,20
67460386615,67460386612,-3,1727,2283,20
67460509277,67460509262,-15,1174,2472,20
67461422069,67461422064,-5,1181,2802,20
67463010271,67463010270,-1,1148,3133,20
67469502126,67469502125,-1,1087,3035,20
67470904069,67470904066,-3,1071,2109,20
67470986273,67470986271,-2,904,2581,20
67473360036,67473360033,-3,1538,3146,20
67480814516,67480814513,-3,1045,2415,20
67484163641,67484163642,1,1043,1371,20
67485170222,67485170220,-2,2009,2940,20
67486947718,67486947716,-2,1572,2757,20
67490710379,67490710386,7,2040,1179,20
67491876636,67491876632,-4,1352,2557,20
67494818446,67494818443,-3,989,2558,20
67495252224,67495252217,-7,596,3695,20
67495344262,67495344279,17,511,1097,20
67496642836,67496642856,20,463,1062,20
67506788627,67506788624,-3,901,2669,20
67510280759,67510280757,-2,351,1011,20
67517031934,67517031926,-8,1203,1710,20
67518799539,67518799536,-3,1250,2078,20
67520021190,67520021186,-4,1000,1759,20
67525659673,67525659668,-5,1346,3167,20
67527121523,67527121519,-4,851,1883,20
67533028053,67533028049,-4,973,1772,20
67533532063,67533532060,-3,1172,2611,20
67533621703,67533621720,17,1349,2916,20
67538778515,67538778513,-2,858,1505,20
67541125055,67541125052,-3,1735,2904,20
67541394655,67541394651,-4,1288,2300,20
67548785318,67548785314,-4,1031,2700,20
67555706127,67555706123,-4,583,610,20
67558604841,67558604838,-3,1101,2057,20
67562432679,67562432674,-5,1245,2958,20
67564170177,67564170160,-17,1505,1121,20
67568306427,67568306425,-2,1027,2609,20
67571453011,67571453009,-2,1018,1295,20
67577456738,67577456737,-1,1296,3414,20
67577947951,67577947946,-5,1016,2103,20
67586086190,67586086189,-1,779,1793,20
67587152683,67587152680,-3,937,2516,20
67588977549,67588977545,-4,1074,2453,20
67592065163,67592065161,-2,1407,2957,20
67592549218,67592549212,-6,1569,3358,20
67599071269,67599071264,-5,915,2715,20
67601213511,67601213507,-4,1373,2498,20
67604446543,67604446540,-3,952,1807,20
67607912109,67607912106,-3,1185,2189,20
67608850586,67608850580,-6,1373,4708,20
67611349143,67611349140,-3,838,2843,20
67611817810,67611817807,-3,1166,2251,20
67612510999,67612511019,20,729,2343,20
67615671835,67615671833,-2,1009,1889,20
67616243030,67616243029,-1,922,1413,20
67617966698,67617966696,-2,1031,2159,20
67618531615,67618531614,-1,1023,2006,20
67619452282,67619452279,-3,1156,2688,20
67621157570,67621157567,-3,1568,2107,20
67623711948,67623711947,-1,2414,3529,20
67629714875,67629714873,-2,883,2346,20
67630916258,67630916253,-5,1548,4120,20
67631198316,67631198315,-1,1471,2237,20
67631892870,67631892868,-2,1554,2303,20
67632236321,67632236317,-4,1045,2259,20
67637196411,67637196418,7,5097,1388,20
67640949327,67640949321,-6,896,2317,20
67641838743,67641838730,-13,197,1131,20
67643647174,67643647171,-3,1257,2611,20
67643830318,67643830339,21,140,834,20
67648857496,67648857493,-3,1385,3444,20
67649175479,67649175474,-5,771,2689,20
67652671562,67652671558,-4,899,2445,20
67656888459,67656888458,-1,1313,2383,20
67657619931,67657619926,-5,1122,3176,20
67658177678,67658177674,-4,1367,2825,20
67659875140,67659875135,-5,1259,1834,20
67661708271,67661708268,-3,1577,2581,20
67662148730,67662148727,-3,1136,1222,20
67663103466,67663103466,0,981,1928,20
67667019440,67667019437,-3,1376,3312,20
67667731570,67667731566,-4,1140,2392,20
67671510606,67671510605,-1,717,1993,20
67673777761,67673777761,0,1072,1796,20
67676473129,67676473126,-3,772,1893,20
67677491974,67677491981,7,8672,3089,20
67678851347,67678851344,-3,1222,2475,20
67682310759,67682310758,-1,1379,2248,20
67684306933,67684306933,0,1906,2036,20
67685004914,67685004912,-2,1522,2847,20
67685582733,67685582730,-3,1346,2731,20
67688150359,67688150358,-1,906,1773,20
67688291888,67688291905,17,737,1670,20
67695376848,67695376845,-3,1359,2674,20
67695748308,67695748305,-3,951,2181,20
67696418941,67696418938,-3,653,2727,20
67697796463,67697796462,-1,923,1791,20
67699596748,67699596746,-2,850,2587,20
67702449823,67702449821,-2,1118,2210,20
67711309727,67711309726,-1,1076,2472,20
67713173883,67713173861,-22,1048,1829,20
67713263709,67713263703,-6,209,801,20
67713626259,67713626256,-3,1247,2414,20
67717383019,67717383016,-3,995,2457,20
67720038975,67720038970,-5,1205,2521,20
67730083082,67730083081,-1,780,1786,20
67732033835,67732033831,-4,1273,2039,20
67733127317,67733127315,-2,1200,2673,20
67736597043,67736597041,-2,958,2301,20
67739730275,67739730272,-3,873,2248,20
67740299791,67740299771,-20,1521,3758,20
67744671233,67744671228,-5,1175,3180,20
67746203394,67746203377,-17,282,788,20
67748006411,67748006408,-3,979,2134,20
67748774434,67748774430,-4,1075,2557,20
67748949702,67748949697,-5,725,2001,20
67757617624,67757617622,-2,1411,3231,20
67757693411,67757693407,-4,1623,2461,20
67758477281,67758477273,-8,1391,2374,20
67758965104,67758965106,2,1006,1207,20
67760940029,67760940050,21,5,800,20
67762020442,67762020438,-4,802,1554,20
67762328142,67762328121,-21,1383,1979,20
67762681348,67762681334,-14,77,3090,20
67765583798,67765583796,-2,1278,2513,20
67769857050,67769857047,-3,859,2798,20
67774669506,67774669511,5,1610,1176,20
67777968483,67777968482,-1,1371,2056,20
67781035246,67781035245,-1,1311,2405,20
67783265557,67783265551,-6,1242,2842,20
67788060311,67788060309,-2,882,1758,20
67790207778,67790207777,-1,1410,2285,20
67793815145,67793815142,-3,1754,3280,20
67797338350,67797338347,-3,1240,2661,20
67799764900,67799764900,0,1257,1601,20
67804388753,67804388752,-1,902,1735,20
67805763637,67805763654,17,179,939,20
67807559557,67807559557,0,1280,2059,20
67810022135,67810022133,-2,710,1400,20
67810154891,67810154890,-1,828,2474,20
67811254879,67811254878,-1,1099,1841,20
67812458594,67812458590,-4,1169,1752,20
67823070591,67823070586,-5,1055,2407,20
67826918999,67826918997,-2,1288,2381,20
67837106783,67837106782,-1,1105,1412,20
67840912491,67840912499,8,617,1522,20
67842531657,67842531653,-4,1368,2292,20
67846472225,67846472222,-3,1445,3468,20
67847831466,67847831465,-1,1246,2437,20
67849258515,67849258513,-2,1611,2699,20
67850876630,67850876625,-5,1485,3029,20
67851201855,67851201852,-3,930,2532,20
67854781022,67854781019,-3,1289,1902,20
67855244865,67855244862,-3,857,2696,20
67856996350,67856996348,-2,1302,2588,20
67857574415,67857574412,-3,1260,2403,20
67860637142,67860637139,-3,843,1590,20
67865753165,67865753162,-3,1520,2495,20
67865992952,67865992949,-3,1074,1881,20
67866580214,67866580211,-3,1326,3247,20
67869140218,67869140214,-4,793,2342,20
67871199090,67871199089,-1,1390,2163,20
67871290038,67871290042,4,2561,1603,20
67874498574,67874498574,0,1001,849,20
67876742793,67876742790,-3,1218,1804,20
67876896269,67876896249,-20,1079,2593,20
67878775561,67878775558,-3,1377,2416,20
67881001610,67881001608,-2,764,2439,20
67883260479,67883260474,-5,978,2047,20
67883417331,67883417338,7,9518,30711,20
67886044101,67886044099,-2,1266,2045,20
67886653149,67886653134,-15,262,757,20
67889108481,67889108486,5,6299,2518,20
67891990778,67891990775,-3,1313,2645,20
67894426642,67894426641,-1,1197,2399,20
67896344335,67896344332,-3,722,1271,20
67898756887,67898756885,-2,752,2984,20
67899291291,67899291287,-4,1278,2214,20
67900161771,67900161767,-4,1166,2359,20
67903103782,67903103778,-4,915,2010,20
67907628139,67907628143,4,3649,1952,20
67911726498,67911726493,-5,1311,3216,20
67912922341,67912922337,-4,1105,2441,20
67913412157,67913412178,21,879,1789,20
67917617210,67917617206,-4,1443,2504,20
67920493226,67920493221,-5,1007,3302,20
67924613753,67924613752,-1,899,2191,20
67928545269,67928545266,-3,1151,2524,20
67929014207,67929014193,-14,270,840,20
67930763456,67930763455,-1,1369,2765,20
67939560584,67939560588,4,6954,3813,20
67942223008,67942223005,-3,1085,2621,20
67949662039,67949662035,-4,1374,2337,20
67950043201,67950043198,-3,1022,2468,20
67950311031,67950311027,-4,963,1447,20
67951117517,67951117514,-3,1220,3096,20
67953712758,67953712754,-4,1378,2710,20
67960894494,67960894494,0,2763,3319,20
67969449361,67969449357,-4,1635,5423,20
67973379668,67973379673,5,2964,1547,20
67973514953,67973514950,-3,1384,2326,20
67974504797,67974504794,-3,1377,2470,20
67974842959,67974842959,0,1077,2073,20
67975713462,67975713458,-4,1592,1988,20
67977119114,67977119114,0,1277,1766,20
67978982455,67978982451,-4,794,2963,20
67982977122,67982977118,-4,1469,2347,20
67984233993,67984233994,1,2102,1735,20
67984648109,67984648105,-4,1172,3262,20
67985348840,67985348858,18,742,2360,20
67986546906,67986546903,-3,1292,3139,20
67989559648,67989559645,-3,1166,2640,20
67994599559,67994599558,-1,1463,1959,20
67997719584,67997719581,-3,970,2222,20
68000128825,68000128822,-3,1156,1933,20
68002579741,68002579738,-3,944,1943,20
68004256123,68004256118,-5,1169,1955,20
68007431229,68007431227,-2,1137,2543,20
68016913447,68016913443,-4,1127,2225,20
68017256343,68017256341,-2,925,2237,20
68017736949,68017736940,-9,47236,18129,20
68018850339,68018850337,-2,1229,1959,20
68021279182,68021279179,-3,578,979,20
68024244271,68024244267,-4,1213,2254,20
68024689878,68024689858,-20,972,2587,20
68029522439,68029522438,-1,657,2109,20
68034005874,68034005871,-3,1001,2004,20
68034528199,68034528195,-4,1019,2929,20
68036520090,68036520087,-3,1217,2438,20
68039284585,68039284586,1,1345,1936,20
68040027187,68040027184,-3,1367,2459,20
68042488354,68042488351,-3,1087,2322,20
68049168729,68049168725,-4,993,1967,20
68054155698,68054155695,-3,1130,2176,20
68054203333,68054203317,-16,827,1503,20
68054834971,68054834980,9,13113,27642,20
68055512616,68055512613,-3,1312,2759,20
68059475044,68059475054,10,15760,11792,20
68065524314,68065524313,-1,1444,2577,20
68066215023,68066215018,-5,1038,3067,20
68068424225,68068424224,-1,902,1796,20
68074118667,68074118670,3,38668,11247,20
68075633785,68075633784,-1,1524,2634,20
68076250463,68076250458,-5,1203,1952,20
68079752085,68079752085,0,1612,2081,20
68080818358,68080818354,-4,1140,3699,20
68081733346,68081733344,-2,1110,1710,20
68084227274,68084227273,-1,1779,2190,20
68086626074,68086626070,-4,1094,2102,20
68091685114,68091685111,-3,978,2825,20
68091844639,68091844630,-9,846,2216,20
68092662053,68092662053,0,1475,1598,20
68093122156,68093122154,-2,940,2009,20
68096498459,68096498456,-3,1057,1467,20
68098374838,68098374842,4,2121,1848,20
68105184429,68105184429,0,964,2394,20
68105581797,68105581777,-20,1055,2238,20
68110290579,68110290577,-2,1150,2289,20
68110805551,68110805549,-2,920,2795,20
68111557386,68111557383,-3,951,1806,20
68113417682,68113417680,-2,1244,2724,20
68120654030,68120654026,-4,1318,1955,20
68124194793,68124194793,0,1521,1916,20
68124428793,68124428790,-3,939,1789,20
68125614589,68125614586,-3,1115,2640,20
68127498815,68127498812,-3,1063,2460,20
68134288130,68134288109,-21,1415,524,20
68137676999,68137676998,-1,1403,2108,20
68145743852,68145743850,-2,980,1224,20
68147792238,68147792217,-21,9413,8226,20
68148214901,68148214881,-20,1173,1840,20
68148623976,68148623973,-3,859,2258,20
68148736362,68148736358,-4,880,1976,20
68150457707,68150457705,-2,1719,2494,20
68150808272,68150808289,17,988,2254,20
68151768283,68151768278,-5,1086,2982,20
68159590357,68159590353,-4,1130,2465,20
68162008831,68162008828,-3,1355,1935,20
68163976225,68163976220,-5,983,2677,20
68165217213,68165217210,-3,1278,2057,20
68167912438,68167912436,-2,1296,2280,20
68169279299,68169279296,-3,1187,2745,20
68169578297,68169578296,-1,1201,2451,20
68170364610,68170364609,-1,785,2181,20
68172415823,68172415821,-2,783,2103,20
68172523560,68172523578,18,911,1532,20
68172872552,68172872554,2,2070,1457,20
68178490174,68178490170,-4,1425,2254,20
68178588407,68178588386,-21,1028,3260,20
68182277458,68182277452,-6,1000,2499,20
68182839234,68182839233,-1,1090,1815,20
68183075905,68183075903,-2,869,1827,20
68183247922,68183247922,0,42656,5010,20
68185032293,68185032290,-3,1179,2761,20
68189059909,68189059927,18,1262,2672,20
68189296211,68189296209,-2,857,2217,20
68191009504,68191009525,21,839,2088,20
68193793630,68193793623,-7,1981,7732,20
68199868858,68199868864,6,2528,1598,20
68201760953,68201760951,-2,967,1597,20
68203526123,68203526126,3,3162,2337,20
68210542543,68210542541,-2,931,1587,20
68212126583,68212126578,-5,1135,2260,20
68214795286,68214795284,-2,1161,2261,20
68216120614,68216120609,-5,1111,2028,20
68219409185,68219409184,-1,1044,2258,20
68219928791,68219928788,-3,1159,2414,20
68220135017,68220135014,-3,917,2407,20
68220850574,68220850561,-13,1257,3502,20
68223163401,68223163406,5,3121,1608,20
68229473110,68229473109,-1,963,2663,20
68235040978,68235040974,-4,1225,2734,20
68243753450,68243753454,4,2014,1575,20
68249797262,68249797257,-5,1387,2680,20
68251162775,68251162771,-4,675,869,20
68252690318,68252690314,-4,678,1424,20
68254185354,68254185351,-3,833,2480,20
68255180046,68255180053,7,4660,1874,20
68256939099,68256939095,-4,929,2332,20
68258013503,68258013505,2,274,990,20
68259551982,68259551981,-1,1096,2153,20
68262069291,68262069290,-1,1366,2768,20
68267690145,68267690151,6,3827,2343,20
68268383483,68268383481,-2,1288,2814,20
68271988635,68271988631,-4,1318,2363,20
68277467754,68277467750,-4,1310,2609,20
68278643578,68278643577,-1,1324,2302,20
68278703480,68278703479,-1,1097,1049,20
68280628942,68280628938,-4,1866,2933,20
68281870014,68281870007,-7,679,2318,20
68282943406,68282943405,-1,1109,2019,20
68283904614,68283904609,-5,1353,2345,20
68285419542,68285419541,-1,914,2147,20
68285562077,68285562094,17,583,1155,20
68291613852,68291613846,-6,1100,3269,20
68293446732,68293446730,-2,1396,2082,20
68295560031,68295560030,-1,1290,2083,20
68297204436,68297204438,2,23851,17351,20
68305985169,68305985167,-2,952,2128,20
68311165229,68311165227,-2,1215,2202,20
68312574093,68312574086,-7,1047,2766,20
68312863607,68312863601,-6,910,2534,20
68313003757,68313003752,-5,1080,2230,20
68314420791,68314420809,18,521,1410,20
68316579270,68316579271,1,820,2120,20
68319010138,68319010134,-4,960,1751,20
68321234343,68321234345,2,2479,1947,20
68324836663,68324836661,-2,31236,20526,20
68327705107,68327705105,-2,1002,2878,20
68338445071,68338445070,-1,1128,2400,20
68346500139,68346500134,-5,1017,3349,20
68348482506,68348482501,-5,1170,3378,20
68349207322,68349207318,-4,1141,3057,20
68356782394,68356782393,-1,1301,1757,20
68357431542,68357431537,-5,1666,5880,20
68360316877,68360316874,-3,1551,2343,20
68362922747,68362922745,-2,1020,2497,20
68366304946,68366304942,-4,868,2527,20
68374241497,68374241494,-3,1088,2468,20
68375668463,68375668478,15,322,1060,20
68376704159,68376704157,-2,761,2178,20
68379885292,68379885288,-4,681,1382,20
68383218566,68383218564,-2,605,1469,20
68384919083,68384919078,-5,1176,2644,20
68389273814,68389273810,-4,834,2792,20
68390114548,68390114551,3,2201,1835,20
68392251121,68392251117,-4,1264,2138,20
68394915254,68394915249,-5,1107,2615,20
68395249790,68395249777,-13,1535,3210,20
68396372702,68396372698,-4,856,2052,20
68397568965,68397568962,-3,1729,3619,20
68399243986,68399243982,-4,1149,2784,20
68400127122,68400127119,-3,885,2054,20
68400590157,68400590153,-4,1310,2058,20
68404221330,68404221327,-3,955,2513,20
68404615910,68404615922,12,299,1580,20
68404672735,68404672731,-4,937,2985,20
68409025591,68409025587,-4,1409,2537,20
68411523170,68411523168,-2,1461,2009,20
68416564329,68416564327,-2,1181,2373,20
68419425239,68419425234,-5,1121,2644,20
68421715111,68421715110,-1,1143,1950,20
68422889204,68422889201,-3,1130,2550,20
68425086889,68425086887,-2,1212,2460,20
68425291408,68425291407,-1,1124,1176,20
68430211321,68430211322,1,1468,981,20
68431840478,68431840474,-4,984,2249,20
68433537438,68433537438,0,1227,1824,20
68442113164,68442113161,-3,1092,2486,20
68446725433,68446725430,-3,1163,2045,20
68451664795,68451664794,-1,1691,2000,20
68452643567,68452643564,-3,817,1771,20
68453064882,68453064885,3,2479,1516,20
68454355671,68454355668,-3,1795,3567,20
68455936150,68455936149,-1,1432,3187,20
68458254226,68458254223,-3,1534,3903,20
68461174498,68461174496,-2,1013,2253,20
68461358850,68461358845,-5,733,2023,20
68462086530,68462086526,-4,1238,2317,20
68471846816,68471846813,-3,1183,2442,20
68472466711,68472466728,17,510,1438,20
68481356006,68481356010,4,1224,1505,20
68483892218,68483892214,-4,1343,1931,20
68484216235,68484216234,-1,711,1110,20
68484371711,68484371709,-2,1361,2572,20
68486339406,68486339402,-4,914,2906,20
68487638543,68487638540,-3,1373,2577,20
68488838755,68488838750,-5,1397,3813,20
68490265756,68490265753,-3,1688,2526,20
68491401175,68491401175,0,1636,2180,20
68499692731,68499692726,-5,1612,2798,20
68501936549,68501936546,-3,1319,2262,20
68502175708,68502175688,-20,869,1940,20
68503425830,68503425829,-1,1131,2455,20
68506586775,68506586775,0,1484,1167,20
68514275274,68514275273,-1,1017,1592,20
68515384846,68515384845,-1,2464,2116,20
68522246904,68522246903,-1,1797,2873,20
68524604274,68524604270,-4,1089,2297,20
68525948481,68525948477,-4,1201,2792,20
68527142189,68527142187,-2,847,1957,20
68530416698,68530416697,-1,941,1587,20
68530704510,68530704491,-19,26448,25445,20
68531949927,68531949925,-2,1209,1641,20
68532338694,68532338693,-1,1453,2192,20
68532640923,68532640922,-1,2663,3035,20
68532879920,68532879922,2,1441,1780,20
68539337707,68539337694,-13,1272,554,20
68540007322,68540007337,15,954,1804,20
68541697323,68541697320,-3,1073,2481,20
68546146898,68546146898,0,2207,1724,20
68548107318,68548107314,-4,1109,3157,20
68550531377,68550531373,-4,1096,2424,20
68550683050,68550683048,-2,905,2170,20
68553867326,68553867329,3,1055,1380,20
68558887543,68558887538,-5,1263,4049,20
68560648022,68560648018,-4,1062,2834,20
68561109230,68561109251,21,773,1822,20
68561313483,68561313480,-3,796,2064,20
68561936106,68561936105,-1,1018,1593,20
68562934888,68562934878,-10,753,1870,20
68564020982,68564020981,-1,1470,1919,20
68564387354,68564387350,-4,1080,2967,20
68573211575,68573211574,-1,989,2049,20
68573796049,68573796045,-4,1537,2659,20
68575851292,68575851289,-3,1050,2688,20
68576110055,68576110052,-3,1405,2577,20
68577490302,68577490302,0,1083,1531,20
68578253319,68578253317,-2,1569,1990,20
68578869526,68578869524,-2,898,1646,20
68579270924,68579270918,-6,727,2003,20
68579841403,68579841401,-2,1341,3026,20
68583169219,68583169214,-5,1615,3232,20
68583896674,68583896674,0,1078,1955,20
68588499354,68588499354,0,1236,2913,20
68590407062,68590407060,-2,1621,2918,20
68590523894,68590523890,-4,1132,2696,20
68591886844,68591886838,-6,1165,5115,20
68604502630,68604502627,-3,1132,2898,20
68613077351,68613077348,-3,876,1721,20
68613315434,68613315433,-1,1052,1777,20
68613441075,68613441074,-1,983,1933,20
68617408515,68617408513,-2,634,1321,20
68618782506,68618782502,-4,860,1211,20
68624415889,68624415888,-1,1637,2251,20
68625872179,68625872175,-4,1639,3668,20
68626823929,68626823928,-1,1237,2294,20
68635201467,68635201462,-5,1113,3368,20
68635683544,68635683538,-6,1118,2711,20
68638818033,68638818030,-3,1540,2651,20
68643245680,68643245677,-3,1288,2670,20
68649221939,68649221939,0,1632,1801,20
68649271742,68649271755,13,11254,44067,20
68652309343,68652309340,-3,1146,2079,20
68653995655,68653995653,-2,1074,2080,20
68657436238,68657436234,-4,1145,2145,20
68660063117,68660063113,-4,1313,1909,20
68660359838,68660359839,1,751,1005,20
68661653327,68661653326,-1,1323,3235,20
68661958610,68661958609,-1,1144,2201,20
68666464343,68666464339,-4,1069,2578,20
68666865120,68666865137,17,428,996,20
68670170087,68670170083,-4,1293,1966,20
68673506559,68673506557,-2,1025,2215,20
68673557667,68673557664,-3,1047,2289,20
68674159960,68674159957,-3,1172,2233,20
68675893155,68675893153,-2,952,1428,20
68676296522,68676296522,0,866,2261,20
68680426195,68680426194,-1,1188,2386,20
68682561089,68682561087,-2,1171,2387,20
68694270450,68694270446,-4,1095,2051,20
68695801685,68695801682,-3,1356,2346,20
68696384386,68696384382,-4,602,2038,20
68697450270,68697450276,6,4058,1328,20
68697994630,68697994626,-4,785,3273,20
68700019262,68700019259,-3,607,1165,20
68703100345,68703100341,-4,1074,2545,20
68706914071,68706914066,-5,736,1696,20
68710845824,68710845818,-6,1546,3030,20
68712652717,68712652714,-3,1113,2617,20
68713029820,68713029815,-5,1252,1993,20
68715667114,68715667120,6,3133,1623,20
68717175267,68717175264,-3,606,1761,20
68718535899,68718535902,3,1227,1324,20
68718958836,68718958829,-7,1214,5068,20
68720800467,68720800465,-2,954,1896,20
68724466030,68724466026,-4,1156,3203,20
68726513269,68726513265,-4,1049,1861,20
68726740717,68726740727,10,3536,41400,20
68728110573,68728110577,4,1881,1707,20
68728896478,68728896475,-3,1411,3279,20
68729641531,68729641526,-5,1363,2729,20
68730717174,68730717171,-3,891,2574,20
68732206377,68732206374,-3,996,1576,20
68734045079,68734045076,-3,713,2334,20
68736063149,68736063139,-10,58,1086,20
68737793265,68737793262,-3,1043,2417,20
68738864420,68738864419,-1,1381,2414,20
68739424434,68739424432,-2,1674,3702,20
68739469085,68739469082,-3,1080,2275,20
68739925506,68739925506,0,2327,3720,20
68740203318,68740203315,-3,613,1920,20
68746503595,68746503590,-5,947,2603,20
68749400230,68749400222,-8,2158,7107,20
68753943573,68753943573,0,680,1062,20
68755968646,68755968641,-5,878,2318,20
68758763371,68758763367,-4,662,1537,20
68760654450,68760654446,-4,1539,1767,20
68762200439,68762200437,-2,990,2238,20
68770741667,68770741663,-4,1131,2671,20
68771358019,68771358014,-5,1060,2467,20
68773207149,68773207145,-4,861,1398,20
68774123075,68774123074,-1,656,1368,20
68774902197,68774902206,9,13956,30574,20
68775166945,68775166940,-5,1174,2637,20
68776099259,68776099258,-1,799,1567,20
68776289762,68776289757,-5,995,2476,20
68777111444,68777111437,-7,21,1480,20
68783663824,68783663823,-1,1227,1772,20
68787348598,68787348595,-3,1109,2090,20
68788328775,68788328779,4,2594,1419,20
68788869313,68788869309,-4,1078,2244,20
68797003298,68797003296,-2,1206,2583,20
68798773276,68798773274,-2,1258,2929,20
68799107698,68799107698,0,1470,1205,20
68802643793,68802643790,-3,988,2209,20
68803253118,68803253117,-1,1069,2016,20
68803743317,68803743314,-3,867,2172,20
68806657567,68806657565,-2,820,2164,20
68807577773,68807577780,7,2374,1142,20
68809590978,68809590977,-1,1149,2379,20
68816845922,68816845917,-5,1612,2561,20
68817663534,68817663529,-5,1214,2974,20
68822231968,68822231973,5,3643,1442,20
68825799639,68825799637,-2,1084,1991,20
68828378207,68828378203,-4,1175,2176,20
68834400158,68834400157,-1,1185,2509,20
68839970961,68839970960,-1,1941,3128,20
68840022441,68840022441,0,22052,17372,20
68841544761,68841544763,2,2580,1260,20
68843232824,68843232821,-3,977,2137,20
68845876936,68845876933,-3,1185,2719,20
68846455142,68846455140,-2,1323,2364,20
68847475082,68847475079,-3,749,1621,20
68849909766,68849909762,-4,845,2464,20
68851070245,68851070241,-4,1058,2768,20
68853673245,68853673242,-3,1352,2571,20
68855387226,68855387222,-4,813,2429,20
68856112142,68856112123,-19,1403,1650,20
68856848052,68856848050,-2,1374,2368,20
68859384235,68859384233,-2,1209,2109,20
68863038500,68863038497,-3,1144,3217,20
68866569089,68866569092,3,2950,1556,20
68868842074,68868842073,-1,935,1923,20
68874648569,68874648559,-10,1512,3394,20
68876655061,68876655057,-4,771,1975,20
68878377278,68878377277,-1,1037,2365,20
68884476671,68884476669,-2,980,2648,20
68885597358,68885597353,-5,1246,2355,20
68886133706,68886133703,-3,2044,2322,20
68886544663,68886544671,8,2097,1570,20
68892823293,68892823289,-4,899,1925,20
68892888233,68892888229,-4,1052,2363,20
68893071445,68893071442,-3,1250,2719,20
68895738799,68895738797,-2,1085,2038,20
68898834576,68898834560,-16,101,1240,20
68899762246,68899762242,-4,934,2618,20
68900603231,68900603228,-3,1059,2314,20
68905367706,68905367703,-3,1478,3639,20
68910181635,68910181631,-4,733,2301,20
68919017570,68919017566,-4,1134,2349,20
68919242719,68919242714,-5,1042,2776,20
68919711509,68919711513,4,55414,34139,20
68920905183,68920905181,-2,1235,2128,20
68921655044,68921655045,1,1497,1696,20
68927471685,68927471678,-7,1001,2773,20
68927691214,68927691230,16,334,1012,20
68929930867,68929930862,-5,1452,3276,20
68930022577,68930022579,2,1565,1154,20
68947365814,68947365811,-3,978,2158,20
68948096975,68948096964,-11,1535,3237,20
68950621974,68950621973,-1,1110,1816,20
68950725027,68950725026,-1,3023,3347,20
68953613683,68953613681,-2,898,1420,20
68955078362,68955078358,-4,915,2314,20
68955763235,68955763238,3,1695,1316,20
68963827798,68963827794,-4,771,2243,20
68968251151,68968251149,-2,1074,2009,20
68968929767,68968929762,-5,1387,2838,20
68970338407,68970338409,2,1241,1937,20
68974346078,68974346082,4,1456,1021,20
68975457736,68975457731,-5,1424,2311,20
68977073746,68977073757,11,16034,20095,20
68980998909,68980998906,-3,1309,2099,20
68983136295,68983136287,-8,850,3800,20
68984197354,68984197350,-4,1099,2233,20
68985230654,68985230651,-3,730,1966,20
68989224750,68989224745,-5,1099,2593,20
68989686047,68989686043,-4,1229,2734,20
68992340959,68992340957,-2,1093,2371,20
68997660435,68997660432,-3,1181,2281,20
68998474714,68998474711,-3,1450,2504,20
68999079263,68999079262,-1,1560,2343,20
69000623292,69000623296,4,37670,29137,20
69003308004,69003308001,-3,1410,2318,20
69004985381,69004985378,-3,1183,2075,20
69008174048,69008174045,-3,1584,1701,20
69011964831,69011964828,-3,975,1515,20
69016766015,69016766022,7,2568,1200,20
69027675795,69027675794,-1,816,1001,20
69028893517,69028893513,-4,1086,2072,20
69030170130,69030170129,-1,968,2311,20
69030263322,69030263319,-3,966,2348,20
69030932769,69030932769,0,929,1619,20
69032363950,69032363946,-4,954,3104,20
69033673893,69033673890,-3,1024,2979,20
69034403862,69034403858,-4,750,1464,20
69036072121,69036072114,-7,2534,4787,20
69043995611,69043995609,-2,1113,2294,20
69044962252,69044962262,10,301,671,20
69046260707,69046260705,-2,1183,1982,20
69047586202,69047586207,5,1519,1247,20
69050061915,69050061921,6,2571,961,20
69050230530,69050230525,-5,1006,2329,20
69059740754,69059740750,-4,824,1763,20
69066376445,69066376441,-4,1279,2162,20
69067188639,69067188637,-2,1280,1792,20
69067667238,69067667237,-1,1149,1371,20
69074611583,69074611581,-2,1154,2046,20
69075835779,69075835774,-5,997,1656,20
69077752338,69077752337,-1,911,2151,20
69079850045,69079850041,-4,1182,1962,20
69080891603,69080891606,3,4723,2504,20
69082260211,69082260209,-2,1197,2096,20
69086233193,69086233190,-3,1600,2589,20
69091856113,69091856110,-3,1161,2246,20
69091959367,69091959362,-5,1177,2147,20
69094289430,69094289428,-2,981,2012,20
69094625981,69094625997,16,677,2023,20
69097730254,69097730251,-3,929,1905,20
69099292535,69099292539,4,1825,1933,20
69099925293,69099925289,-4,1317,2340,20
69100432390,69100432407,17,304,617,20
69110719767,69110719763,-4,808,2185,20
69111102926,69111102939,13,365,1898,20
69112920779,69112920773,-6,880,2362,20
69116044850,69116044847,-3,1061,2615,20
69118086407,69118086403,-4,1275,3423,20
69120973879,69120973879,0,881,1647,20
69125196867,69125196869,2,714,1115,20
69127293706,69127293706,0,1102,2190,20
69128545587,69128545583,-4,999,2084,20
69131135732,69131135730,-2,1302,3309,20
69134766227,69134766227,0,1029,2784,20
69144157615,69144157613,-2,692,1996,20
69147930852,69147930859,7,3923,1970,20
69152939119,69152939117,-2,877,1794,20
69153163375,69153163373,-2,964,2692,20
69153933354,69153933350,-4,824,2301,20
69156405133,69156405132,-1,1586,2490,20
69158465963,69158465957,-6,1601,5770,20
69162208315,69162208310,-5,999,2425,20
69162280560,69162280558,-2,1099,2387,20
69166334374,69166334370,-4,1025,3016,20
69166550496,69166550514,18,760,2166,20
69166992996,69166992990,-6,212,714,20
69171312221,69171312217,-4,1139,2127,20
69171374194,69171374186,-8,967,3233,20
69173812869,69173812870,1,2844,3213,20
69183016922,69183016939,17,495,941,20
69188313209,69188313207,-2,1869,2037,20
69191029086,69191029085,-1,1398,2756,20
69193760235,69193760231,-4,1259,3212,20
69193834149,69193834145,-4,1135,2945,20
69194081009,69194081005,-4,2081,3285,20
69194980162,69194980166,4,1766,1237,20
69199702514,69199702510,-4,1102,2879,20
69200592060,69200592056,-4,1037,2451,20
69203202467,69203202465,-2,805,2103,20
69203716608,69203716606,-2,1204,1867,20
69205903057,69205903055,-2,1189,2677,20
69208026502,69208026498,-4,1520,2764,20
69212942250,69212942249,-1,1632,3112,20
69213507190,69213507203,13,10028,43788,20
69216671693,69216671690,-3,919,2114,20
69217036630,69217036625,-5,1109,2850,20
69225156038,69225156042,4,2002,1734,20
69231390718,69231390717,-1,1090,2219,20
69233335196,69233335191,-5,1492,4235,20
69234431490,69234431491,1,1216,1214,20
69235428138,69235428135,-3,1153,2141,20
69241506617,69241506613,-4,1010,2791,20
69243714374,69243714367,-7,2242,7347,20
69253245356,69253245354,-2,983,2039,20
69253934797,69253934793,-4,1163,1967,20
69256114209,69256114206,-3,1158,2940,20
69258710402,69258710398,-4,915,1782,20
69262576854,69262576851,-3,753,1799,20
69264241483,69264241480,-3,1011,2494,20
69265426841,69265426846,5,2569,1420,20
69267862154,69267862151,-3,1427,1617,20
69270383411,69270383410,-1,1308,2472,20
69270446358,69270446377,19,589,2566,20
69274064624,69274064622,-2,964,2000,20
69279938690,69279938690,0,1172,2051,20
69281776438,69281776435,-3,1098,2660,20
69282374338,69282374337,-1,1763,1853,20
69283690544,69283690549,5,2647,1876,20
69287686606,69287686603,-3,1399,2913,20
69289104073,69289104075,2,1142,1440,20
69293413008,69293413005,-3,920,1803,20
69297437391,69297437387,-4,1381,3128,20
69303224282,69303224278,-4,1269,1582,20
69303612380,69303612397,17,329,1796,20
69304890195,69304890191,-4,678,1816,20
69306450511,69306450505,-6,672,3145,20
69307429268,69307429266,-2,1452,2227,20
69308987317,69308987313,-4,512,2161,20
69312934025,69312934021,-4,1025,2942,20
69313717831,69313717828,-3,1579,3229,20
69314673121,69314673118,-3,896,2273,20
69317439623,69317439619,-4,701,1817,20
69319162759,69319162759,0,637,1371,20
69320557839,69320557835,-4,969,1383,20
69323952721,69323952718,-3,1194,2350,20
69324063970,69324063965,-5,1228,2164,20
69324664135,69324664134,-1,883,2257,20
69326823845,69326823847,2,1557,1162,20
69332090136,69332090134,-2,1468,2187,20
69332395041,69332395038,-3,1455,2153,20
69334037723,69334037722,-1,1102,1746,20
69334893705,69334893703,-2,1167,1097,20
69336220914,69336220913,-1,1437,1787,20
69337536689,69337536687,-2,1135,1994,20
69339109087,69339109081,-6,951,2631,20
69339501719,69339501726,7,2825,1197,20
69339760601,69339760598,-3,1419,2913,20
69341011844,69341011841,-3,1484,2012,20
69341868583,69341868579,-4,1271,2574,20
69342359119,69342359102,-17,1420,2583,20
69345809637,69345809636,-1,1266,2054,20
69347613933,69347613937,4,3065,2068,20
69351154620,69351154618,-2,1261,2346,20
69351267589,69351267577,-12,885,2673,20
69356865039,69356865035,-4,965,1650,20
69360379671,69360379668,-3,881,1832,20
69366815722,69366815721,-1,681,1316,20
69366984766,69366984764,-2,1110,2487,20
69368318818,69368318815,-3,1011,1713,20
69370326149,69370326145,-4,826,1481,20
69370620029,69370620034,5,123,299,20
69372076769,69372076766,-3,1909,3585,20
69377058758,69377058754,-4,1070,3952,20
69377204030,69377204042,12,312,759,20
69377977414,69377977411,-3,1330,2387,20
69378652124,69378652139,15,210,926,20
69383006335,69383006330,-5,1274,2308,20
69386876696,69386876691,-5,960,2200,20
69389127893,69389127890,-3,917,2332,20
69390058511,69390058506,-5,1647,1913,20
69393599943,69393599941,-2,842,2279,20
69398341825,69398341827,2,3507,2438,20
69399863367,69399863366,-1,1172,2952,20
69401767822,69401767818,-4,1614,4239,20
69405470226,69405470225,-1,1145,2156,20
69408972591,69408972586,-5,1156,1937,20
69413125949,69413125946,-3,924,1371,20
69413295585,69413295590,5,3069,2138,20
69415039065,69415039063,-2,1367,1574,20
69419132882,69419132879,-3,908,1796,20
69421323263,69421323259,-4,1120,2818,20
69423765929,69423765925,-4,1122,2498,20
69427297890,69427297896,6,4776,1747,20
69427571744,69427571741,-3,1558,2557,20
69431048701,69431048699,-2,1414,2289,20
69437226115,69437226114,-1,1021,1874,20
69439674973,69439674969,-4,956,1612,20
69447118395,69447118398,3,2766,3300,20
69447414126,69447414125,-1,1147,2321,20
69449525399,69449525394,-5,974,2355,20
69459870713,69459870729,16,824,1734,20
69459972879,69459972876,-3,1643,2348,20
69463433651,69463433650,-1,1349,1734,20
69464106021,69464106019,-2,1164,2011,20
69467138682,69467138679,-3,1516,2902,20
69468395743,69468395738,-5,658,2436,20
69468604038,69468604055,17,1571,2989,20
69470329656,69470329650,-6,1605,7593,20
69472837230,69472837236,6,3269,1744,20
69482282541,69482282550,9,1944,1037,20
69482999374,69482999371,-3,967,1289,20
69483605022,69483605017,-5,1108,2857,20
69486793315,69486793309,-6,1100,1959,20
69488240471,69488240468,-3,991,2276,20
69489480441,69489480437,-4,1250,1904,20
69489973325,69489973329,4,243,1061,20
69495124139,69495124135,-4,768,1279,20
69496409143,69496409138,-5,744,1735,20
69500036214,69500036213,-1,1313,2491,20
69501433730,69501433733,3,1434,1170,20
69501690392,69501690406,14,820,2716,20
69502591135,69502591129,-6,1077,3551,20
69504332346,69504332345,-1,1069,1954,20
69506192179,69506192178,-1,989,1639,20
69513024014,69513024010,-4,1250,2032,20
69513947708,69513947703,-5,1457,3005,20
69519499699,69519499699,0,1101,1822,20
69519671606,69519671596,-10,1191,2446,20
69533205757,69533205754,-3,1338,2214,20
69533443764,69533443777,13,196,1140,20
69534084188,69534084179,-9,941,2035,20
69536095431,69536095426,-5,1099,2691,20
69537842712,69537842730,18,1105,2073,20
69537963663,69537963678,15,192,946,20
69539335393,69539335389,-4,1368,2153,20
69543413114,69543413112,-2,1026,2214,20
69545761928,69545761926,-2,939,2160,20
69558407349,69558407346,-3,1235,2650,20
69558729418,69558729414,-4,1344,2560,20
69558861005,69558861025,20,752,1279,20
69566475162,69566475159,-3,779,1170,20
69566736135,69566736122,-13,102,619,20
69567402323,69567402318,-5,948,2862,20
69568826109,69568826106,-3,1395,3017,20
69569729294,69569729292,-2,981,1354,20
69575678111,69575678106,-5,1092,3480,20
69576942993,69576942990,-3,945,2173,20
69578757717,69578757714,-3,503,1856,20
69584327211,69584327209,-2,1256,2404,20
69585286146,69585286142,-4,1167,1908,20
69585540806,69585540793,-13,406,1398,20
69590587462,69590587458,-4,752,2117,20
69591365774,69591365771,-3,1163,2443,20
69591850358,69591850374,16,373,1037,20
69595525538,69595525534,-4,1290,3667,20
69599924689,69599924686,-3,919,2366,20
69600962294,69600962294,0,890,1447,20
69601050070,69601050071,1,18806,100622,20
69601292543,69601292554,11,434,11692,20
69603154569,69603154565,-4,1072,2131,20
69603267726,69603267704,-22,1499,3028,20
69604994243,69604994238,-5,1362,2313,20
69610527086,69610527082,-4,1020,1839,20
69610809639,69610809654,15,439,1206,20
69611881021,69611881018,-3,854,1638,20
69614103831,69614103827,-4,1043,2791,20
69618945283,69618945279,-4,1361,2666,20
69621313469,69621313467,-2,1463,2073,20
69627025822,69627025829,7,1973,1454,20
69627383314,69627383313,-1,1882,3206,20
69630517026,69630517025,-1,1143,2243,20
69630804854,69630804846,-8,154,631,20
69639295833,69639295839,6,2827,1499,20
69640620180,69640620188,8,14104,39463,20
69645790782,69645790780,-2,1372,2137,20
69648820518,69648820516,-2,992,2183,20
69648994101,69648994097,-4,1202,1739,20
69649801532,69649801554,22,1086,1960,20
69651503429,69651503429,0,1208,1589,20
69652701223,69652701220,-3,809,2614,20
69655285832,69655285830,-2,1088,1685,20
69659681127,69659681126,-1,1528,3043,20
69659989869,69659989865,-4,1272,2461,20
69661672817,69661672814,-3,1345,2469,20
69662463940,69662463937,-3,988,2093,20
69663661098,69663661095,-3,966,1690,20
69664947777,69664947775,-2,1236,2317,20
69666865861,69666865858,-3,1075,2466,20
69669117726,69669117722,-4,1010,2135,20
69672324859,69672324856,-3,1218,2991,20
69675476923,69675476921,-2,829,2338,20
69678740664,69678740667,3,2303,1550,20
69679442595,69679442591,-4,671,1595,20
69679630917,69679630915,-2,1180,2624,20
69687688655,69687688654,-1,1144,2340,20
69687998854,69687998852,-2,822,2612,20
69690064546,69690064552,6,40216,15915,20
69691306288,69691306282,-6,989,1948,20
69692263850,69692263847,-3,992,2515,20
69694220115,69694220113,-2,1342,2328,20
69695329748,69695329745,-3,1589,1959,20
69704202396,69704202393,-3,1070,2146,20
69704875172,69704875169,-3,1467,3234,20
69708137557,69708137554,-3,1440,2273,20
69711944242,69711944238,-4,1016,1975,20
69712549206,69712549214,8,81,1249,20
69713523314,69713523310,-4,982,2257,20
69716515354,69716515354,0,1156,2333,20
69718838970,69718838966,-4,1150,2793,20
69723978177,69723978173,-4,831,2666,20
69726095184,69726095181,-3,1187,1854,20
69726444596,69726444598,2,8839,7895,20
69726518156,69726518138,-18,962,1797,20
69726980249,69726980247,-2,985,2002,20
69728728741,69728728749,8,2276,1071,20
69729257209,69729257206,-3,1280,1680,20
69741468939,69741468938,-1,1434,2709,20
69746342903,69746342900,-3,566,1483,20
69750019886,69750019884,-2,902,1864,20
69750573541,69750573560,19,346,1735,20
69752100410,69752100405,-5,870,1638,20
69758488834,69758488831,-3,1415,3696,20
69760346153,69760346152,-1,1224,2220,20
69765691111,69765691116,5,4472,2534,20
69767627442,69767627441,-1,1529,2590,20
69769420881,69769420878,-3,1128,1964,20
69775999119,69775999118,-1,1179,1949,20
69787099274,69787099271,-3,1209,2521,20
69788439674,69788439674,0,1070,1336,20
69789081328,69789081329,1,19599,18803,20
69790561894,69790561891,-3,1352,3105,20
69792621526,69792621525,-1,942,2083,20
69793720418,69793720418,0,885,2701,20
69798706907,69798706904,-3,1227,2954,20
69799176510,69799176529,19,335,730,20
69803036704,69803036701,-3,1190,2340,20
69804238475,69804238475,0,886,1950,20
69805042917,69805042914,-3,997,1891,20
69814235319,69814235317,-2,1194,2328,20
69815085699,69815085695,-4,1106,2527,20
69815181125,69815181119,-6,1446,2654,20
69815609735,69815609733,-2,1226,2266,20
69815790959,69815790951,-8,72,893,20
69816262743,69816262741,-2,1451,2292,20
69816755114,69816755113,-1,1158,2455,20
69818520292,69818520288,-4,533,1361,20
69821809092,69821809087,-5,1366,2137,20
69823445465,69823445459,-6,819,2675,20
69825562239,69825562237,-2,403,1005,20
69826995267,69826995261,-6,1088,4334,20
69829579783,69829579782,-1,1362,1508,20
69829836989,69829837011,22,711,2123,20
69831202558,69831202557,-1,952,2710,20
69833737494,69833737492,-2,1117,2505,20
69840465262,69840465259,-3,1345,2552,20
69840831095,69840831102,7,164,885,20
69843692902,69843692900,-2,824,2310,20
69849042167,69849042162,-5,1283,3095,20
69855239051,69855239049,-2,1120,1892,20
69860036470,69860036466,-4,1349,3057,20
69863722956,69863722955,-1,1221,2254,20
69868236683,69868236678,-5,1052,2256,20
69868414486,69868414481,-5,653,1544,20
69869661967,69869661965,-2,1466,2978,20
69871123978,69871123973,-5,1539,2017,20
69881023475,69881023471,-4,1035,3716,20
69883551018,69883551014,-4,1473,1962,20
69884488493,69884488488,-5,1296,3571,20
69888211231,69888211227,-4,1422,2391,20
69891766501,69891766497,-4,1548,2453,20
69897521817,69897521814,-3,1185,2152,20
69898088534,69898088531,-3,1315,3115,20
69898366533,69898366533,0,1703,2005,20
69898582882,69898582878,-4,996,3043,20
69907378062,69907378058,-4,1044,1228,20
69907682334,69907682333,-1,1180,2175,20
69910837662,69910837658,-4,1073,3083,20
69918831178,69918831176,-2,1033,2648,20
69922310643,69922310642,-1,1301,1918,20
69923923394,69923923389,-5,1413,4162,20
69927008130,69927008126,-4,1178,3094,20
69932254109,69932254109,0,1012,1525,20
69934614577,69934614574,-3,1428,2006,20
69936845055,69936845053,-2,1218,2289,20
69937100799,69937100798,-1,847,2689,20
69938769178,69938769175,-3,1271,2239,20
69939355739,69939355736,-3,1268,1976,20
69941432854,69941432847,-7,831,2869,20
69943073853,69943073851,-2,997,1895,20
69944194374,69944194374,0,1243,1804,20
69944305333,69944305331,-2,1362,1941,20
69944631513,69944631526,13,10840,46433,20
69946130070,69946130069,-1,1896,3657,20
69946316334,69946316337,3,962,1625,20
69947147310,69947147307,-3,909,2660,20
69948640726,69948640722,-4,1110,2142,20
69951453780,69951453778,-2,1083,2607,20
69951927717,69951927715,-2,1367,2503,20
69956186618,69956186615,-3,1476,2136,20
69960826738,69960826736,-2,837,2106,20
69962111265,69962111263,-2,802,1174,20
69970624094,69970624093,-1,1007,1841,20
69974014530,69974014526,-4,1192,1836,20
69978270502,69978270501,-1,859,3044,20
69978878696,69978878693,-3,1486,2833,20
69979351703,69979351702,-1,652,911,20
69981314490,69981314487,-3,1360,2792,20
69982122255,69982122273,18,598,1761,20
69982260522,69982260519,-3,954,2582,20
69982370750,69982370732,-18,1032,2702,20
69983939955,69983939954,-1,1406,2731,20
69987187078,69987187076,-2,773,1853,20
69990075149,69990075146,-3,1155,2339,20
69991502707,69991502706,-1,871,2964,20
69994634509,69994634506,-3,1026,2624,20
69995703595,69995703593,-2,1169,2627,20
69998716086,69998716090,4,2370,1370,20
70001463561,70001463557,-4,1074,2187,20
70002968473,70002968468,-5,1052,1849,20
70003188398,70003188399,1,750,1206,20
70006217897,70006217893,-4,683,2001,20
70006996463,70006996463,0,1016,2029,20
70010087939,70010087959,20,564,831,20
70014828405,70014828401,-4,1385,2579,20
70015144531,70015144528,-3,934,1927,20
70016595797,70016595794,-3,1446,2914,20
70017461311,70017461292,-19,1264,2538,20
70020832110,70020832110,0,1404,2113,20
70022532386,70022532393,7,16143,21350,20
70024115295,70024115294,-1,1098,2955,20
70027441977,70027441978,1,1402,1603,20
70030039819,70030039814,-5,1266,2701,20
70030411135,70030411131,-4,1430,2467,20
70034956014,70034956010,-4,1144,2131,20
70035534222,70035534229,7,3174,1547,20
70037208357,70037208356,-1,446,1200,20
70043024718,70043024727,9,18315,46886,20
70044313494,70044313498,4,1387,2398,20
70045006652,70045006647,-5,1536,2040,20
70050826418,70050826412,-6,735,3239,20
70051698365,70051698361,-4,713,1849,20
70052559926,70052559918,-8,844,3576,20
70063850284,70063850281,-3,1399,2641,20
70069751827,70069751824,-3,1693,2052,20
70070354205,70070354202,-3,1075,2452,20
70071594591,70071594587,-4,1116,2618,20
70073738193,70073738203,10,23276,46627,20
70074799857,70074799853,-4,917,2271,20
70077241599,70077241596,-3,1893,4068,20
70079475554,70079475558,4,1640,1014,20
70084391341,70084391338,-3,800,1952,20
70089159890,70089159888,-2,725,2376,20
70090797931,70090797929,-2,1457,2233,20
70093815911,70093815908,-3,764,2332,20
70094848560,70094848556,-4,1305,2863,20
70098556286,70098556290,4,2406,1689,20
70098614157,70098614153,-4,1107,2442,20
70101152770,70101152777,7,3092,1451,20
70102336327,70102336326,-1,1226,1770,20
70102507381,70102507378,-3,1259,1971,20
70115496479,70115496475,-4,802,1421,20
70116153858,70116153857,-1,1219,3097,20
70120123607,70120123603,-4,1147,2540,20
70122575401,70122575398,-3,1331,3389,20
70122712078,70122712089,11,337,885,20
70124638527,70124638520,-7,785,1966,20
70125405274,70125405277,3,1837,1753,20
70126573693,70126573692,-1,1222,1742,20
70127544331,70127544326,-5,1334,2425,20
70132072606,70132072605,-1,1347,2146,20
70137313029,70137313026,-3,1391,3027,20
70138158767,70138158769,2,171,948,20
70144412510,70144412508,-2,1230,2038,20
70145460531,70145460530,-1,1387,2730,20
70147656222,70147656218,-4,1336,2563,20
70148395162,70148395158,-4,1207,1700,20
70150494779,70150494775,-4,1480,2478,20
70150643505,70150643503,-2,1264,1819,20
70153883608,70153883606,-2,1361,2890,20
70154029215,70154029210,-5,225,753,20
70155675642,70155675639,-3,964,1923,20
70158759504,70158759502,-2,1437,2523,20
70159954762,70159954770,8,4229,1273,20
70160919145,70160919145,0,1413,3486,20
70164998850,70164998845,-5,1112,2349,20
70165848734,70165848729,-5,757,1440,20
70168764191,70168764187,-4,1269,3003,20
70168815446,70168815442,-4,999,2849,20
70174015618,70174015619,1,847,1095,20
70175805118,70175805115,-3,1076,2258,20
70182600207,70182600214,7,3860,1650,20
70183206265,70183206262,-3,1147,2334,20
70183665291,70183665288,-3,946,2022,20
70183724321,70183724318,-3,1372,2819,20
70189172465,70189172462,-3,1239,2053,20
70191515166,70191515164,-2,1094,2123,20
70193419254,70193419250,-4,1399,2527,20
70198161879,70198161878,-1,1241,1760,20
70200891267,70200891265,-2,1498,3043,20
70202207689,70202207696,7,17920,17669,20
70213054163,70213054160,-3,1337,2706,20
70218483289,70218483285,-4,1041,1867,20
70220448507,70220448510,3,1970,843,20
70227247211,70227247208,-3,610,1330,20
70227990319,70227990300,-19,956,3712,20
70228991759,70228991755,-4,1029,2499,20
70230511815,70230511819,4,1724,1132,20
70238207749,70238207771,22,82,916,20
70238449255,70238449271,16,443,1002,20
70242227329,70242227326,-3,850,1202,20
70247287098,70247287094,-4,993,2765,20
70251230874,70251230870,-4,1531,2600,20
70251892950,70251892949,-1,1079,2211,20
70258883116,70258883113,-3,1146,2183,20
70261068917,70261068939,22,299,1179,20
70261689710,70261689714,4,3384,1130,20
70263453974,70263453974,0,1090,1649,20
70265678159,70265678155,-4,1145,2390,20
70267349761,70267349758,-3,1339,2450,20
70267650847,70267650841,-6,966,2641,20
70269524718,70269524714,-4,851,1779,20
70271722678,70271722674,-4,988,2287,20
70272168515,70272168512,-3,1036,3026,20
70276303126,70276303122,-4,767,2483,20
70276735391,70276735409,18,414,957,20
70280858691,70280858687,-4,1414,2121,20
70282084028,70282084026,-2,1045,1793,20
70283878825,70283878823,-2,1005,1855,20
70285805675,70285805671,-4,1140,1985,20
70292343021,70292343017,-4,959,1341,20
70301808415,70301808412,-3,893,2273,20
70308250850,70308250855,5,1153,887,20
70310832328,70310832325,-3,1169,1768,20
70313304036,70313304033,-3,1142,2032,20
70313830767,70313830782,15,564,1420,20
70313956081,70313956086,5,7039,4606,20
70317213694,70317213691,-3,2075,1758,20
70317971142,70317971138,-4,846,1526,20
70319849655,70319849662,7,694,1260,20
70323709662,70323709658,-4,1492,3053,20
70326159948,70326159944,-4,1201,1907,20
70326217143,70326217123,-20,180,873,20
70327250995,70327250991,-4,886,2085,20
70327465685,70327465685,0,1090,1971,20
70327565955,70327565954,-1,1164,2675,20
70328896744,70328896740,-4,1199,3162,20
70335750805,70335750825,20,1125,1396,20
70335905838,70335905835,-3,949,2029,20
70336319191,70336319179,-12,1183,3103,20
70337739650,70337739650,0,1092,2271,20
70341398050,70341398047,-3,1250,2372,20
70344459604,70344459602,-2,584,958,20
70347279158,70347279154,-4,826,2366,20
70348645155,70348645153,-2,1151,1922,20
70351862161,70351862161,0,871,1825,20
70352740498,70352740496,-2,1574,2419,20
70354160518,70354160518,0,1448,2041,20
70360788177,70360788175,-2,1196,2019,20
70364205355,70364205354,-1,1725,3316,20
70366230611,70366230607,-4,1473,2751,20
70366772257,70366772254,-3,1082,1767,20
70366804391,70366804377,-14,1067,2190,20
70368011968,70368011966,-2,1580,1977,20
70369183578,70369183577,-1,1126,2349,20
70370888597,70370888589,-8,3930,17135,20
70371261057,70371261054,-3,1228,2556,20
70371767326,70371767324,-2,1051,2160,20
70372035126,70372035123,-3,1309,3100,20
70372622159,70372622154,-5,954,1578,20
70374671582,70374671578,-4,694,2078,20
70377214226,70377214222,-4,1475,3495,20
70380742388,70380742390,2,2104,1397,20
70384288691,70384288691,0,1574,2255,20
70387902353,70387902350,-3,1338,2652,20
70388429711,70388429708,-3,1790,2668,20
70388744287,70388744282,-5,1210,2888,20
70388786082,70388786078,-4,579,2159,20
70389893815,70389893820,5,2087,1078,20
70391214528,70391214522,-6,949,2121,20
70397604523,70397604519,-4,837,1836,20
70398802672,70398802688,16,847,2404,20
70399808030,70399808029,-1,902,1773,20
70401152960,70401152955,-5,1400,3195,20
70401599283,70401599281,-2,1021,2635,20
70402115737,70402115740,3,7560,5568,20
70406319169,70406319165,-4,1310,3219,20
70407433515,70407433511,-4,1441,2818,20
70409941798,70409941798,0,1697,1744,20
70414442502,70414442502,0,973,2702,20
70414562671,70414562654,-17,903,1941,20
70417752046,70417752049,3,2130,1477,20
70418271839,70418271837,-2,1359,2154,20
70419038858,70419038852,-6,1105,4458,20
70420986371,70420986369,-2,1557,2760,20
70424697995,70424697994,-1,1122,2087,20
70426434986,70426434989,3,2029,1146,20
70429499172,70429499153,-19,1323,2042,20
70438416311,70438416307,-4,1452,2165,20
70443347986,70443347991,5,2716,1448,20
70447022886,70447022885,-1,995,2132,20
70447921529,70447921526,-3,1076,1624,20
70450610381,70450610379,-2,1120,2094,20
70454092994,70454092990,-4,1096,2172,20
70454352023,70454352034,11,364,998,20
70454790191,70454790187,-4,1004,1629,20
70457737629,70457737626,-3,1377,2480,20
70462389309,70462389304,-5,1405,1874,20
70463443602,70463443599,-3,1714,1916,20
70465248963,70465248961,-2,1799,3041,20
70466337949,70466337949,0,1151,2251,20
70466590588,70466590585,-3,1243,2474,20
70467552136,70467552137,1,1413,1680,20
70468726620,70468726639,19,691,1916,20
70480529968,70480529966,-2,159,416,20
70484051828,70484051829,1,7819,10586,20
70490408565,70490408563,-2,1157,2399,20
70496794019,70496794017,-2,1501,2442,20
70496921093,70496921087,-6,106,480,20
70497999629,70497999650,21,1312,3478,20
70498530970,70498530969,-1,1114,2412,20
70498891747,70498891745,-2,889,1220,20
70499479263,70499479261,-2,919,1670,20
70506564082,70506564082,0,871,1684,20
70507042127,70507042123,-4,1276,2158,20
70509647031,70509647030,-1,900,2009,20
70509964142,70509964123,-19,1142,1903,20
70511111322,70511111318,-4,1407,2364,20
70514136346,70514136348,2,3021,2507,20
70520723320,70520723317,-3,1112,2308,20
70521740961,70521740956,-5,1023,3194,20
70527048017,70527048024,7,1762,3482,20
70529487182,70529487178,-4,1161,2814,20
70530064789,70530064786,-3,1078,1648,20
70533402507,70533402503,-4,1172,2324,20
70535783703,70535783699,-4,1286,2095,20
70539104806,70539104800,-6,1215,1873,20
70547206180,70547206177,-3,1209,2670,20
70547914134,70547914131,-3,1542,3308,20
70549335843,70549335842,-1,899,2159,20
70554518777,70554518774,-3,1155,1760,20
70555165496,70555165494,-2,1244,3279,20
70555486123,70555486118,-5,1554,2314,20
70561917118,70561917114,-4,1096,2259,20
70565862910,70565862916,6,2246,1962,20
70577689995,70577689989,-6,1024,2615,20
70578417502,70578417511,9,324,1661,20
70583268528,70583268522,-6,1420,2797,20
70585330518,70585330517,-1,1369,1853,20
70587821269,70587821267,-2,1265,2524,20
70590089269,70590089277,8,7027,2017,20
70590623543,70590623538,-5,1445,5361,20
70594661265,70594661262,-3,1272,2826,20
70596727346,70596727345,-1,904,2053,20
70596769453,70596769449,-4,1404,2922,20
70610228327,70610228326,-1,975,2256,20
70612454601,70612454600,-1,27271,18970,20
70612996629,70612996626,-3,950,1983,20
70613142638,70613142637,-1,1022,1691,20
70614898463,70614898463,0,1466,1335,20
70615089426,70615089424,-2,1300,1552,20
70615360072,70615360069,-3,1220,1724,20
70621147583,70621147580,-3,1206,2149,20
70623106634,70623106633,-1,1353,1731,20
70623696251,70623696247,-4,1005,2157,20
70624475806,70624475801,-5,798,1852,20
70634643209,70634643204,-5,1257,2468,20
70634708842,70634708839,-3,1181,2767,20
70638045830,70638045825,-5,1106,2381,20
70640408035,70640408032,-3,1218,2859,20
70645118321,70645118319,-2,894,2439,20
70645222145,70645222141,-4,1030,2378,20
70646766050,70646766049,-1,1267,1859,20
70647500283,70647500278,-5,1318,2869,20
70649403783,70649403781,-2,864,1995,20
70650114255,70650114251,-4,1452,3048,20
70652411294,70652411289,-5,991,2681,20
70652802241,70652802238,-3,1555,2391,20
70657558478,70657558486,8,3431,1197,20
70658771054,70658771049,-5,751,2049,20
70659307813,70659307810,-3,946,2070,20
70659994251,70659994247,-4,689,1195,20
70666751102,70666751098,-4,1320,3935,20
70666784632,70666784650,18,744,2080,20
70666920110,70666920104,-6,1354,2472,20
70669887071,70669887068,-3,988,2371,20
70671011751,70671011746,-5,1312,3056,20
70678525286,70678525284,-2,1116,1989,20
70680503327,70680503324,-3,1066,3087,20
70681448307,70681448302,-5,789,1830,20
70682163851,70682163857,6,5896,1718,20
70684998535,70684998530,-5,822,2119,20
70685145304,70685145301,-3,1005,2477,20
70687922865,70687922868,3,1770,1471,20
70687984985,70687985004,19,2100,1322,20
70693288083,70693288080,-3,822,1952,20
70693436806,70693436799,-7,82,913,20
70697201014,70697201013,-1,1215,1728,20
70698643029,70698643030,1,2624,1983,20
70700645573,70700645577,4,2671,1054,20
70700847218,70700847215,-3,1794,3368,20
70701917002,70701917002,0,41730,30244,20
70705739747,70705739744,-3,561,1467,20
70705783015,70705783012,-3,1219,2373,20
70715183854,70715183852,-2,722,1941,20
70715534248,70715534246,-2,1458,2666,20
70716487055,70716487053,-2,783,1869,20
70716654085,70716654082,-3,1838,3137,20
70717090978,70717090974,-4,2339,5010,20
70719206518,70719206514,-4,1491,3720,20
70724736423,70724736430,7,3103,1621,20
70737265091,70737265086,-5,1056,1568,20
70744331109,70744331108,-1,1035,1814,20
70744857369,70744857362,-7,992,4322,20
70749196714,70749196712,-2,769,2298,20
70749978442,70749978442,0,1048,1785,20
70753942020,70753942017,-3,1339,2337,20
70755817016,70755817017,1,1096,758,20
70755914764,70755914750,-14,957,1701,20
70757297798,70757297794,-4,1449,3582,20
70757431686,70757431685,-1,1212,2011,20
70758786521,70758786519,-2,1170,1916,20
70772587437,70772587435,-2,1361,2420,20
70779944395,70779944392,-3,1339,2207,20
70783079330,70783079327,-3,870,1825,20
70786577657,70786577654,-3,826,3178,20
70788837649,70788837657,8,2694,1350,20
70793413701,70793413693,-8,270,1090,20
70794758981,70794758978,-3,1188,3430,20
70799326355,70799326349,-6,1390,2019,20
70799709702,70799709723,21,56,630,20
70808729426,70808729421,-5,1425,4245,20
70809847261,70809847256,-5,1105,2634,20
70812085746,70812085742,-4,1374,2381,20
70819315203,70819315202,-1,993,1852,20
70827008014,70827008012,-2,1173,2129,20
70830227026,70830227022,-4,700,1931,20
70830685871,70830685869,-2,1548,2633,20
70839563084,70839563079,-5,912,2839,20
70841000419,70841000417,-2,823,1768,20
70847487075,70847487065,-10,44584,13604,20
70849071612,70849071611,-1,897,929,20
70853435170,70853435165,-5,924,4359,20
70853728858,70853728879,21,890,1528,20
70855444255,70855444252,-3,530,1597,20
70858347446,70858347444,-2,1317,1600,20
70866303378,70866303379,1,1250,1398,20
70866777242,70866777241,-1,1400,2815,20
70867293777,70867293774,-3,1470,3075,20
70867358310,70867358329,19,1415,2082,20
70868170878,70868170877,-1,1284,2092,20
70868218948,70868218971,23,758,1645,20
70870651823,70870651805,-18,231,1076,20
70872328978,70872328974,-4,1028,1975,20
70879731782,70879731779,-3,1216,2789,20
70884618985,70884618981,-4,847,2652,20
70886928689,70886928685,-4,1038,3367,20
70889592318,70889592317,-1,1091,1808,20
70890813402,70890813398,-4,1016,1568,20
70891152254,70891152275,21,1760,2878,20
70893407365,70893407362,-3,1409,2345,20
70898747523,70898747521,-2,1459,3395,20
70900621533,70900621540,7,6202,2415,20
70900815698,70900815695,-3,1273,1662,20
70903447222,70903447218,-4,979,1967,20
70907966407,70907966410,3,1660,1169,20
70909540133,70909540130,-3,1284,1925,20
70911409539,70911409539,0,1300,3094,20
70911802631,70911802628,-3,1058,3134,20
70914636031,70914636029,-2,1103,2236,20
70918901515,70918901514,-1,724,1320,20
70921915731,70921915728,-3,1598,2881,20
70922923575,70922923570,-5,1255,2116,20
70923157934,70923157930,-4,1172,2922,20
70928100178,70928100173,-5,875,2455,20
70929024058,70929024062,4,1750,1946,20
70932750783,70932750781,-2,774,2160,20
70937921370,70937921368,-2,454,1357,20
70941585272,70941585278,6,24974,25013,20
70943766595,70943766594,-1,956,1521,20
70943884935,70943884925,-10,944,1428,20
70945068412,70945068409,-3,1456,2713,20
70945932846,70945932841,-5,945,3057,20
70951618010,70951618007,-3,939,1630,20
70960001387,70960001380,-7,38314,23237,20
70960869280,70960869277,-3,1442,2235,20
70972895807,70972895804,-3,1331,2470,20
70973979168,70973979172,4,1079,1227,20
70978149835,70978149833,-2,814,1302,20
70983062859,70983062855,-4,1239,2355,20
70984767511,70984767507,-4,1162,2461,20
70986278906,70986278909,3,3054,2259,20
70986797983,70986797983,0,775,1779,20
70987051302,70987051314,12,139,848,20
70990861957,70990861959,2,2124,1684,20
70992105918,70992105918,0,634,1478,20
70992929851,70992929846,-5,1180,3112,20
70997675958,70997675957,-1,1757,2601,20
71004212138,71004212135,-3,889,2712,20
71005034661,71005034658,-3,1217,2225,20
71008103142,71008103140,-2,555,1772,20
71009369262,71009369262,0,1413,2942,20
71015116567,71015116564,-3,1035,2914,20
71019007864,71019007861,-3,1445,1486,20
71024433960,71024433956,-4,1466,3085,20
71025225165,71025225146,-19,419,1891,20
71026514465,71026514460,-5,1223,2732,20
71027172614,71027172592,-22,735,1781,20
71032175280,71032175275,-5,1305,3002,20
71036788557,71036788553,-4,1318,2617,20
71037156118,71037156115,-3,831,2227,20
71038220720,71038220743,23,475,1076,20
71040918129,71040918132,3,1389,1776,20
71043265335,71043265338,3,2206,1814,20
71047163034,71047163029,-5,844,1963,20
71049479053,71049479050,-3,1595,3337,20
71050626222,71050626221,-1,1270,2518,20
71051617469,71051617465,-4,1313,2639,20
71054117445,71054117446,1,653,1505,20
71054381126,71054381124,-2,1148,1641,20
71063102699,71063102698,-1,1357,1959,20
71065106335,71065106333,-2,1041,2079,20
71066051687,71066051683,-4,1515,2916,20
71068461305,71068461300,-5,857,2700,20
71070482505,71070482502,-3,1245,3681,20
71076165100,71076165096,-4,1195,2439,20
71077277355,71077277353,-2,1166,2288,20
71077573058,71077573057,-1,1331,2947,20
71078916956,71078916955,-1,1239,1323,20
71081092444,71081092438,-6,2395,7328,20
71085882192,71085882191,-1,1491,2381,20
71089155907,71089155906,-1,1357,1773,20
71095712089,71095712086,-3,1359,2448,20
71102170410,71102170407,-3,1593,1864,20
71103783049,71103783046,-3,1201,2369,20
71107999655,71107999652,-3,721,2639,20
71111708526,71111708524,-2,1039,1827,20
71113938122,71113938121,-1,1257,3087,20
71126403708,71126403705,-3,1516,1945,20
71126688375,71126688378,3,317,708,20
71129688375,71129688373,-2,1189,3065,20
71135402945,71135402943,-2,1291,1987,20
71137923046,71137923053,7,1320,1145,20
71139733561,71139733558,-3,1334,3388,20
71139852059,71139852057,-2,1158,2470,20
71144369878,71144369884,6,15728,21780,20
71145715677,71145715678,1,1445,1277,20
71150657816,71150657810,-6,926,1783,20
71154823933,71154823941,8,4866,1500,20
71155889475,71155889474,-1,1357,2191,20
71159474107,71159474105,-2,1047,1989,20
71162737065,71162737062,-3,1117,2514,20
71163364202,71163364199,-3,1630,2762,20
71164489322,71164489319,-3,1246,2278,20
71165020943,71165020943,0,153,1013,20
71166404045,71166404042,-3,983,2359,20
71175741094,71175741091,-3,830,2650,20
71181448233,71181448232,-1,1697,2670,20
71187251090,71187251084,-6,1727,8000,20
71188642523,71188642521,-2,1163,3423,20
71191615760,71191615760,0,973,1874,20
71194925213,71194925211,-2,1212,1344,20
71195383038,71195383034,-4,1079,1484,20
71195856917,71195856934,17,521,1510,20
71196687133,71196687130,-3,1074,1972,20
71197573173,71197573170,-3,1499,2320,20
71198644986,71198644982,-4,964,2228,20
71199948666,71199948662,-4,682,1847,20
71200224205,71200224222,17,692,1799,20
71202385622,71202385620,-2,823,2119,20
71202778483,71202778481,-2,738,2105,20
71203109795,71203109793,-2,1018,2286,20
71215225065,71215225061,-4,1169,3695,20
71222711354,71222711356,2,2319,1872,20
71226408047,71226408042,-5,1270,2928,20
71226946813,71226946808,-5,1051,2193,20
71227528610,71227528607,-3,964,2903,20
71228383974,71228383974,0,1214,1852,20
71228480873,71228480876,3,4200,1843,20
71230161209,71230161206,-3,1324,2648,20
71230361183,71230361181,-2,1393,3477,20
71232266497,71232266491,-6,1673,2544,20
71233469447,71233469445,-2,1165,2574,20
71237305343,71237305342,-1,1095,2884,20
71237692757,71237692754,-3,1506,2088,20
71238977289,71238977285,-4,1283,1794,20
71240192515,71240192514,-1,1010,2417,20
71243348083,71243348091,8,217,747,20
71244453622,71244453619,-3,1313,2635,20
71247702716,71247702715,-1,1160,2207,20
71248697455,71248697452,-3,1149,2402,20
71254585323,71254585322,-1,821,2362,20
71255399017,71255399015,-2,909,1958,20
71257606955,71257606952,-3,1053,2019,20
71257726507,71257726505,-2,817,1177,20
71261894501,71261894499,-2,851,1646,20
71265130320,71265130324,4,4448,2968,20
71266416917,71266416913,-4,1124,2569,20
71268202918,71268202915,-3,1104,2379,20
71271488999,71271488997,-2,1109,2570,20
71271576428,71271576431,3,35468,30730,20
71272894088,71272894086,-2,1477,1657,20
71273828524,71273828543,19,863,1760,20
71277584430,71277584428,-2,1050,2103,20
71286598783,71286598781,-2,1494,2363,20
71289019507,71289019505,-2,1079,1811,20
71290142611,71290142606,-5,1506,3456,20
71296492428,71296492425,-3,25086,12654,20
71297503285,71297503283,-2,963,1759,20
71304649737,71304649725,-12,1071,1861,20
71311633353,71311633349,-4,1135,3207,20
71311879807,71311879821,14,682,1718,20
71312687541,71312687538,-3,906,2124,20
71316157673,71316157674,1,34870,17555,20
71318431459,71318431455,-4,1002,1859,20
71320288754,71320288752,-2,1344,3083,20
71321869227,71321869222,-5,1193,2364,20
71326223102,71326223098,-4,1153,1863,20
71327940378,71327940378,0,1036,1591,20
71332054591,71332054588,-3,1065,1938,20
71333014102,71333014097,-5,1529,2738,20
71343583986,71343583983,-3,1771,3287,20
71345085761,71345085757,-4,1197,3548,20
71346693368,71346693366,-2,1097,2036,20
71347256046,71347256059,13,204,1270,20
71348766160,71348766156,-4,809,1536,20
71352550822,71352550818,-4,1188,2730,20
71357857538,71357857538,0,1061,1495,20
71361230651,71361230659,8,8480,39722,20
71363813635,71363813641,6,2859,1534,20
71364118477,71364118474,-3,1410,1783,20
71366155974,71366155969,-5,1196,3707,20
71368862374,71368862368,-6,900,2143,20
71370087827,71370087823,-4,659,1796,20
71373812270,71373812266,-4,1512,4144,20
71374539674,71374539673,-1,752,854,20
71375500939,71375500937,-2,1059,2441,20
71375661372,71375661358,-14,348,773,20
71379433197,71379433189,-8,1693,6003,20
71380020648,71380020666,18,853,1569,20
71384128386,71384128384,-2,1157,2614,20
71384708532,71384708553,21,1116,2087,20
71386910154,71386910150,-4,1463,2738,20
71388532373,71388532373,0,2894,3046,20
71401773594,71401773591,-3,537,959,20
71402530622,71402530621,-1,1155,2627,20
71403856667,71403856665,-2,1003,2135,20
71404240804,71404240802,-2,1307,2590,20
71410218430,71410218429,-1,699,1500,20
71415393777,71415393773,-4,1185,1679,20
71419290953,71419290945,-8,1864,6182,20
71420573555,71420573562,7,14352,22923,20
71422342532,71422342526,-6,1146,2665,20
71426109028,71426109027,-1,1586,2218,20
71427217332,71427217325,-7,1534,1822,20
71427647943,71427647941,-2,1159,2830,20
71429127023,71429127020,-3,1227,2345,20
71429181958,71429181949,-9,14,741,20
71430237543,71430237541,-2,859,1709,20
71432117250,71432117246,-4,1190,4269,20
71432156724,71432156716,-8,148,1107,20
71439190093,71439190090,-3,1345,2810,20
71452996336,71452996333,-3,1211,2227,20
71453079254,71453079274,20,561,1984,20
71453742322,71453742332,10,1061,2092,20
71453947412,71453947407,-5,217,1157,20
71456688105,71456688101,-4,981,2488,20
71460524482,71460524478,-4,1077,1478,20
71460925208,71460925205,-3,1156,1807,20
71461523304,71461523301,-3,1112,1938,20
71461577381,71461577376,-5,1300,4350,20
71462546131,71462546129,-2,1127,2404,20
71468099430,71468099428,-2,1093,2133,20
71468594482,71468594481,-1,1591,3197,20
71469145746,71469145742,-4,774,2376,20
71471672398,71471672395,-3,2320,4367,20
71472552611,71472552606,-5,818,2425,20
71482639282,71482639278,-4,944,3410,20
71485998235,71485998233,-2,1268,1888,20
71491143205,71491143200,-5,892,3712,20
71493843877,71493843874,-3,1062,1394,20
71497419792,71497419793,1,20637,7237,20
71497787929,71497787926,-3,1407,2573,20
71498094400,71498094397,-3,1393,2315,20
71502334209,71502334208,-1,959,1839,20
71509644445,71509644443,-2,1093,1811,20
71510459130,71510459126,-4,1519,2781,20
71510661445,71510661442,-3,670,2379,20
71512181874,71512181878,4,35017,50070,20
71512653198,71512653195,-3,1174,2027,20
71515007226,71515007225,-1,1085,3134,20
71515754885,71515754882,-3,998,2281,20
71516557581,71516557579,-2,868,1506,20
71521829849,71521829845,-4,1399,3088,20
71522266188,71522266210,22,1599,3110,20
71535471319,71535471318,-1,1171,1796,20
71537827026,71537827021,-5,1133,1758,20
71540688558,71540688554,-4,1059,2596,20
71541026799,71541026798,-1,1149,2094,20
71544664370,71544664365,-5,931,1909,20
71545034839,71545034837,-2,1042,1588,20
71545128952,71545128948,-4,1165,3108,20
71549344650,71549344651,1,1356,2787,20
71554916866,71554916862,-4,959,1888,20
71556253098,71556253101,3,3290,2899,20
71557895159,71557895156,-3,970,1997,20
71561864033,71561864030,-3,1374,2060,20
71563284891,71563284888,-3,1110,2306,20
71566269110,71566269106,-4,1222,2528,20
71570407606,71570407602,-4,928,2346,20
71570921661,71570921678,17,697,1436,20
71573581843,71573581839,-4,1492,3273,20
71574560147,71574560144,-3,1514,2478,20
71576601009,71576601006,-3,1079,2540,20
71586304734,71586304732,-2,979,2643,20
71586392530,71586392527,-3,1110,2397,20
71586510342,71586510353,11,7,1504,20
71593191049,71593191045,-4,1230,2137,20
71594575855,71594575850,-5,1280,3112,20
71596437509,71596437507,-2,1440,1933,20
71599030194,71599030192,-2,1045,3083,20
71599416038,71599416035,-3,137,947,20
71607542580,71607542577,-3,1011,1912,20
71609119513,71609119520,7,47427,20087,20
71609847591,71609847586,-5,1100,2636,20
71610739698,71610739697,-1,1667,1874,20
71612269729,71612269727,-2,1028,1910,20
71612399791,71612399789,-2,653,2214,20
71613543729,71613543729,0,1641,2073,20
71618783896,71618783892,-4,1416,2925,20
71623546297,71623546294,-3,1339,1880,20
71623823434,71623823430,-4,1199,3221,20
71623994613,71623994605,-8,1317,4811,20
71624074351,71624074349,-2,1895,2974,20
71625322258,71625322262,4,4253,3602,20
71631228974,71631228972,-2,1422,2631,20
71635781361,71635781358,-3,1660,2596,20
71637446929,71637446928,-1,1048,1559,20
71637797437,71637797435,-2,1673,2005,20
71639237666,71639237662,-4,1613,3085,20
71640120666,71640120672,6,5995,2534,20
71640314867,71640314864,-3,762,2080,20
71644637394,71644637392,-2,981,2023,20
71648000296,71648000295,-1,1476,1671,20
71652788213,71652788210,-3,1353,3035,20
71655089065,71655089062,-3,930,1639,20
71656607215,71656607212,-3,1068,2178,20
71658919317,71658919313,-4,966,2307,20
71661972021,71661972018,-3,1326,1888,20
71662977155,71662977152,-3,1163,2401,20
71669315205,71669315202,-3,1263,3053,20
71669752216,71669752216,0,1317,2244,20
71671149093,71671149096,3,1513,1409,20
71671290443,71671290442,-1,792,2434,20
71677955221,71677955217,-4,1289,2595,20
71679364717,71679364706,-11,152,1006,20
71681672226,71681672224,-2,1064,1812,20
71682285253,71682285250,-3,1330,2086,20
71682440607,71682440626,19,1012,2209,20
71684734911,71684734918,7,3162,1311,20
71686766099,71686766098,-1,877,2210,20
71691836858,71691836856,-2,960,2706,20
71696989929,71696989926,-3,939,1356,20
71699686705,71699686709,4,2290,1134,20
71700981365,71700981358,-7,1207,2548,20
71702257003,71702257002,-1,601,1423,20
71705120449,71705120449,0,1130,2211,20
71705985303,71705985301,-2,1062,2248,20
71708449733,71708449729,-4,1205,2884,20
71709266978,71709266972,-6,1827,8236,20
71709304903,71709304901,-2,795,2290,20
71713744687,71713744679,-8,1925,8628,20
71716777799,71716777796,-3,1160,2151,20
71718885306,71718885303,-3,1224,2082,20
71719729214,71719729209,-5,646,2647,20
71719805519,71719805522,3,1822,1140,20
71723432006,71723432002,-4,993,2214,20
71724713167,71724713165,-2,1068,2610,20
71725746307,71725746303,-4,757,1770,20
71725902228,71725902251,23,1030,1795,20
71741996893,71741996897,4,1096,1485,20
71742172309,71742172295,-14,104,287,20
71746133175,71746133172,-3,1077,2407,20
71746815472,71746815474,2,17732,16270,20
71750688014,71750688010,-4,953,1575,20
71751433470,71751433467,-3,1211,3034,20
71751741510,71751741499,-11,171,1077,20
71753098021,71753098018,-3,1502,2666,20
71754848825,71754848822,-3,1492,2731,20
71755455090,71755455088,-2,1147,1982,20
71760110325,71760110324,-1,1511,2939,20
71760705274,71760705273,-1,1537,1702,20
71762626942,71762626937,-5,1144,1934,20
71763926951,71763926948,-3,1278,3024,20
71766579443,71766579440,-3,1260,1973,20
71766759143,71766759140,-3,690,2383,20
71768991869,71768991866,-3,928,3271,20
71770134374,71770134370,-4,1170,2575,20
71770346173,71770346157,-16,1011,1810,20
71770608276,71770608258,-18,247,1063,20
71772316989,71772316986,-3,1270,2391,20
71772524375,71772524357,-18,925,1991,20
71783050006,71783050004,-2,1851,2618,20
71787788809,71787788806,-3,1223,1921,20
71789911200,71789911192,-8,711,1762,20
71790601115,71790601109,-6,1047,5394,20
71792829353,71792829354,1,1282,1928,20
71794461465,71794461470,5,2577,1174,20
71800457906,71800457912,6,3217,1506,20
71800958977,71800958974,-3,848,2405,20
71802542929,71802542926,-3,1549,3091,20
71805522199,71805522193,-6,925,2519,20
71805645932,71805645930,-2,1349,2243,20
71807512842,71807512846,4,1278,908,20
71809471691,71809471689,-2,1210,2608,20
71811976079,71811976078,-1,1052,1699,20
71813302441,71813302440,-1,1166,2364,20
71813955978,71813955974,-4,1202,2657,20
71815139460,71815139458,-2,1310,2166,20
71818585666,71818585673,7,5091,1821,20
71820737235,71820737231,-4,890,2029,20
71822747322,71822747320,-2,1137,3028,20
71826639421,71826639418,-3,1469,2108,20
71831035094,71831035093,-1,1480,2543,20
71831075323,71831075322,-1,1108,2033,20
71834969528,71834969524,-4,1229,3385,20
71837872324,71837872321,-3,1511,2184,20
71838918032,71838918049,17,382,1214,20
71839461504,71839461499,-5,1512,2822,20
71843711990,71843711990,0,2603,4769,20
71844001567,71844001566,-1,1049,1972,20
71846753407,71846753403,-4,1363,2178,20
71847783180,71847783177,-3,1123,2488,20
71848537887,71848537885,-2,1167,2673,20
71856031065,71856031062,-3,1619,2349,20
71858476683,71858476682,-1,700,2429,20
71865645669,71865645666,-3,1113,1800,20
71870024742,71870024738,-4,1372,2108,20
71872093927,71872093930,3,2377,1247,20
71879422278,71879422277,-1,1123,2324,20
71879868670,71879868667,-3,362,1012,20
71880150852,71880150849,-3,1310,3165,20
71882549037,71882549035,-2,795,1333,20
71885491981,71885491979,-2,1266,3052,20
71887918486,71887918482,-4,1261,1950,20
71889005120,71889005117,-3,899,1660,20
71898967416,71898967415,-1,1007,1763,20
71904833419,71904833414,-5,1070,2760,20
71912488173,71912488171,-2,985,1872,20
71912635226,71912635222,-4,1064,2134,20
71915072589,71915072586,-3,1122,2056,20
71921681314,71921681314,0,938,1980,20
71923558627,71923558624,-3,1048,2295,20
71926248006,71926248004,-2,1321,2880,20
71926664657,71926664654,-3,1669,2828,20
71927305254,71927305250,-4,1615,3337,20
71928486531,71928486529,-2,237,890,20
71928582462,71928582460,-2,1478,3231,20
71930098020,71930098017,-3,1110,2773,20
71931414960,71931414958,-2,1747,3092,20
71935799839,71935799839,0,869,1686,20
71936211368,71936211385,17,949,2462,20
71938356250,71938356249,-1,1082,2242,20
71939210574,71939210569,-5,1449,2730,20
71941746287,71941746281,-6,1374,4144,20
71942121607,71942121605,-2,1430,2058,20
71943836979,71943836974,-5,1212,2827,20
71945107942,71945107941,-1,947,2878,20
71951177984,71951177982,-2,1181,2044,20
71951994066,71951994063,-3,1005,2459,20
71952766096,71952766103,7,4247,1449,20
71953015762,71953015762,0,820,1316,20
71953255555,71953255554,-1,1819,2550,20
71956468256,71956468254,-2,1570,2615,20
71958324502,71958324498,-4,1214,1649,20
71958419372,71958419365,-7,1130,2683,20
71959392358,71959392375,17,247,521,20
71963795290,71963795289,-1,1231,2322,20
71971223855,71971223854,-1,1341,2527,20
71972389010,71972389011,1,2055,1692,20
71976001786,71976001781,-5,1427,2139,20
71985842901,71985842917,16,983,2021,20
71990589107,71990589111,4,3456,2468,20
71991455376,71991455373,-3,893,2525,20
71992675377,71992675374,-3,1014,2066,20
71992734630,71992734646,16,652,2421,20
72000441022,72000441019,-3,1475,3495,20
72002230618,72002230614,-4,1026,2239,20
72007350203,72007350201,-2,1109,1835,20
72014127709,72014127706,-3,1360,2935,20
72020336195,72020336199,4,2489,1370,20
72021670118,72021670119,1,1268,940,20
72023317478,72023317473,-5,887,2114,20
72024428318,72024428335,17,1179,3949,20
72028449194,72028449192,-2,1179,2031,20
72028958642,72028958639,-3,1304,1975,20
72030003397,72030003397,0,693,1265,20
72031185633,72031185630,-3,1173,2159,20
72035487414,72035487409,-5,1143,3754,20
72040533166,72040533169,3,1212,985,20
72046660036,72046660033,-3,1554,3030,20
72049182449,72049182446,-3,1244,2500,20
72049894162,72049894158,-4,948,2439,20
72051152574,72051152570,-4,926,2058,20
72053250671,72053250666,-5,1072,2108,20
72055074193,72055074190,-3,1068,2641,20
72064952110,72064952118,8,3946,1507,20
72070648806,72070648800,-6,1417,2845,20
72071185875,72071185873,-2,607,1616,20
72072016402,72072016399,-3,1604,2694,20
72072943146,72072943142,-4,1515,2559,20
72080659853,72080659849,-4,995,1923,20
72086751073,72086751069,-4,911,2390,20
72090027678,72090027678,0,945,2223,20
72090159535,72090159531,-4,848,2254,20
72090374934,72090374927,-7,1128,2427,20
72093380638,72093380635,-3,1220,2439,20
72095038251,72095038250,-1,942,2572,20
72099414119,72099414121,2,2471,1644,20
72106811778,72106811775,-3,815,1950,20
72107292710,72107292722,12,95,876,20
72118640966,72118640965,-1,1268,2346,20
72121565791,72121565789,-2,1171,2446,20
72125914799,72125914795,-4,793,2410,20
72127586675,72127586674,-1,608,1004,20
72128714847,72128714842,-5,669,2610,20
72129454186,72129454181,-5,1094,3132,20
72129732941,72129732926,-15,891,1924,20
72133473471,72133473471,0,1131,1708,20
72136383959,72136383955,-4,1110,2785,20
72137723137,72137723143,6,2071,1238,20
72143221338,72143221337,-1,947,2053,20
72143682855,72143682853,-2,691,2243,20
72146071826,72146071822,-4,1202,2552,20
72148015269,72148015265,-4,736,2495,20
72148295805,72148295823,18,938,1993,20
72149003214,72149003211,-3,1367,3006,20
72149914833,72149914831,-2,1061,2399,20
72155836258,72155836254,-4,1336,2491,20
72167577570,72167577565,-5,737,2748,20
72170040694,72170040690,-4,1108,3099,20
72170334494,72170334491,-3,683,2100,20
72174623137,72174623133,-4,521,1700,20
72175321717,72175321716,-1,1016,2077,20
72182969526,72182969546,20,294,844,20
72185062938,72185062935,-3,1228,2479,20
72186531182,72186531179,-3,794,1537,20
72189559135,72189559131,-4,1087,2022,20
72191759207,72191759205,-2,918,1534,20
72194176106,72194176102,-4,914,2322,20
72195717287,72195717285,-2,1161,3086,20
72197009478,72197009473,-5,1228,3606,20
72202077998,72202077996,-2,1068,3253,20
72202302855,72202302853,-2,744,2251,20
72202892636,72202892635,-1,962,1721,20
72203227775,72203227775,0,1217,2486,20
72207032450,72207032446,-4,1061,2030,20
72207414884,72207414884,0,205,1207,20
72207519404,72207519426,22,1125,2592,20
72208321401,72208321401,0,1742,2577,20
72208618162,72208618161,-1,1107,2341,20
72214438893,72214438890,-3,859,3019,20
72218464442,72218464440,-2,1190,2832,20
72219119483,72219119468,-15,1093,631,20
72219234810,72219234808,-2,981,2014,20
72222856710,72222856706,-4,1574,4974,20
72223272703,72223272683,-20,690,1799,20
72223834627,72223834621,-6,883,2616,20
72225013779,72225013778,-1,1099,1539,20
72226039156,72226039153,-3,704,1805,20
72226374521,72226374518,-3,982,2090,20
72230002358,72230002355,-3,1597,3213,20
72234128390,72234128387,-3,933,1815,20
72234401916,72234401908,-8,1137,2361,20
72236275827,72236275825,-2,1135,2860,20
72237773211,72237773209,-2,1103,2623,20
72242169785,72242169782,-3,808,2588,20
72250936456,72250936453,-3,1433,2429,20
72252673973,72252673970,-3,1333,2887,20
72255452534,72255452530,-4,1024,2734,20
72256106174,72256106189,15,689,1238,20
72256248200,72256248197,-3,958,2044,20
72258196939,72258196935,-4,922,1784,20
72258842638,72258842638,0,999,1631,20
72270347742,72270347737,-5,813,3520,20
72275081478,72275081475,-3,1262,2460,20
72275292969,72275292971,2,1718,1278,20
72277583423,72277583420,-3,742,2378,20
72277667394,72277667391,-3,1135,2495,20
72279743160,72279743157,-3,1435,2326,20
72281149168,72281149162,-6,1028,2706,20
72285519854,72285519854,0,1502,2031,20
72285920865,72285920864,-1,1173,2140,20
72286875262,72286875261,-1,845,1290,20
72288361305,72288361302,-3,1960,2764,20
72290680024,72290680020,-4,1294,2084,20
72291241139,72291241137,-2,715,1731,20
72292941993,72292941992,-1,849,2507,20
72297480591,72297480588,-3,1109,2508,20
72299453817,72299453815,-2,1157,2709,20
72300273371,72300273370,-1,991,1981,20
72301750775,72301750770,-5,901,1845,20
72302621528,72302621530,2,2186,1698,20
72310464767,72310464762,-5,912,1560,20
72311496533,72311496529,-4,973,1922,20
72315998999,72315998996,-3,1142,1858,20
72320832767,72320832765,-2,919,1629,20
72323652659,72323652658,-1,1095,2543,20
72323760070,72323760067,-3,912,1800,20
72323874634,72323874630,-4,1244,2582,20
72333031412,72333031418,6,2439,1195,20
72333697077,72333697074,-3,1160,2408,20
72342177604,72342177600,-4,1671,3897,20
72342280404,72342280401,-3,1278,2415,20
72343999287,72343999285,-2,674,1676,20
72350285471,72350285470,-1,1058,2667,20
72350403890,72350403886,-4,803,2527,20
72353825870,72353825866,-4,1162,2675,20
72354365998,72354365998,0,2966,2486,20
72355412513,72355412509,-4,1384,3594,20
72358945329,72358945325,-4,921,2318,20
72361497518,72361497517,-1,1279,2543,20
72361934761,72361934756,-5,1360,4582,20
72362489742,72362489748,6,5143,2584,20
72365519144,72365519142,-2,1352,2837,20
72367725915,72367725912,-3,843,2464,20
72371311169,72371311165,-4,1121,2639,20
72372719234,72372719231,-3,1217,1986,20
72373652325,72373652343,18,820,1930,20
72376067334,72376067334,0,1681,1655,20
72378289471,72378289477,6,3610,1296,20
72384912013,72384912006,-7,1782,5249,20
72386536907,72386536905,-2,1267,2458,20
72387281590,72387281587,-3,791,1842,20
72389442477,72389442474,-3,1323,2155,20
72390407890,72390407887,-3,1187,2703,20
72391221309,72391221302,-7,1098,2790,20
72392603701,72392603698,-3,1470,2404,20
72394086341,72394086337,-4,719,1480,20
72400941965,72400941961,-4,1063,1524,20
72402915111,72402915105,-6,2160,6514,20
72407007438,72407007437,-1,952,2410,20
72413285814,72413285811,-3,1232,1395,20
72415390661,72415390658,-3,1195,1361,20
72422708731,72422708730,-1,1734,1633,20
72427512516,72427512514,-2,1288,2915,20
72429268289,72429268287,-2,1002,2034,20
72432407947,72432407946,-1,1462,2194,20
72436128349,72436128345,-4,1154,1832,20
72437807312,72437807309,-3,1216,3365,20
72443488379,72443488376,-3,1087,2861,20
72443605154,72443605157,3,4042,2903,20
72443814234,72443814235,1,1723,981,20
72445908348,72445908346,-2,661,1282,20
72449377242,72449377241,-1,1157,2129,20
72451617493,72451617497,4,1627,1443,20
72451690643,72451690639,-4,1516,3332,20
72455379667,72455379662,-5,901,2590,20
72459231063,72459231062,-1,2268,3745,20
72462884180,72462884164,-16,1903,12704,20
72464573023,72464573019,-4,773,2046,20
72466021658,72466021655,-3,758,1606,20
72466727149,72466727146,-3,1254,2275,20
72467243430,72467243436,6,16387,6188,20
72469757286,72469757291,5,6488,2780,20
72469862599,72469862597,-2,1241,2545,20
72471839615,72471839595,-20,1756,3572,20
72472343013,72472343030,17,1021,2376,20
72479080703,72479080702,-1,1343,2475,20
72479221113,72479221110,-3,1102,2172,20
72479938026,72479938030,4,2351,1872,20
72480825886,72480825884,-2,1112,2548,20
72483491889,72483491894,5,2698,1673,20
72485639586,72485639586,0,1151,1573,20
72487333135,72487333129,-6,1152,4797,20
72502268810,72502268808,-2,893,1913,20
72504056326,72504056321,-5,1228,2210,20
72504405094,72504405094,0,1214,1628,20
72506706175,72506706171,-4,1321,2139,20
72509806382,72509806378,-4,1019,2807,20
72510243732,72510243750,18,1068,2779,20
72510610054,72510610053,-1,1243,2387,20
72515753499,72515753498,-1,845,1801,20
72516709248,72516709253,5,2431,1252,20
72517729946,72517729951,5,2442,1315,20
72518585619,72518585617,-2,1227,2005,20
72519986722,72519986729,7,3795,1100,20
72525684723,72525684726,3,1122,824,20
72528427266,72528427266,0,1654,2670,20
72538553395,72538553393,-2,840,1999,20
72538876187,72538876185,-2,679,2370,20
72539151966,72539151961,-5,1329,2246,20
72544923629,72544923626,-3,861,2829,20
72550602759,72550602755,-4,735,1409,20
72550737197,72550737194,-3,1606,3184,20
72551288442,72551288437,-5,907,2507,20
72551539994,72551540002,8,6713,2357,20
72554452832,72554452829,-3,829,1892,20
72556622555,72556622553,-2,1627,3025,20
72561921629,72561921631,2,1230,1545,20
72562213684,72562213701,17,735,2677,20
72568570162,72568570169,7,2388,1074,20
72571009489,72571009486,-3,1442,3276,20
72571413812,72571413834,22,493,1257,20
72574571247,72574571245,-2,1203,3032,20
72577531105,72577531111,6,4266,1244,20
72583151010,72583151031,21,801,2515,20
72584390037,72584390042,5,2923,1829,20
72587266292,72587266287,-5,1716,4808,20
72588908691,72588908688,-3,1174,2113,20
72589310632,72589310630,-2,1351,1856,20
72591746801,72591746798,-3,642,1843,20
72593606373,72593606370,-3,1367,2470,20
72593650915,72593650910,-5,1523,4112,20
72594792634,72594792633,-1,1097,1768,20
72598011047,72598011044,-3,1314,2059,20
72601389907,72601389906,-1,6673,9333,20
72602819112,72602819109,-3,1156,2548,20
72602975806,72602975822,16,615,2112,20
72603215492,72603215491,-1,1336,2984,20
72607533071,72607533069,-2,1189,1874,20
72610229646,72610229645,-1,933,2006,20
72611349578,72611349575,-3,1080,2026,20
72612824767,72612824763,-4,998,2442,20
72616073026,72616073023,-3,1415,3356,20
72617221131,72617221128,-3,739,1944,20
72624742294,72624742298,4,2841,2235,20
72627838270,72627838275,5,5435,2745,20
72634215303,72634215298,-5,1166,2216,20
72635523476,72635523473,-3,675,2516,20
72637094247,72637094243,-4,902,1676,20
72640901524,72640901526,2,1261,1642,20
72643721975,72643721971,-4,1063,2148,20
72644148479,72644148477,-2,873,1641,20
72644438398,72644438398,0,1119,1528,20
72645397162,72645397159,-3,1117,1835,20
72650822290,72650822287,-3,559,1807,20
72660865602,72660865597,-5,1032,3586,20
72661400337,72661400334,-3,1127,2089,20
72664705835,72664705833,-2,933,1612,20
72666469469,72666469466,-3,920,2442,20
72671332357,72671332353,-4,1525,3390,20
72672405483,72672405479,-4,656,2522,20
72675412203,72675412201,-2,1070,2080,20
72680066370,72680066352,-18,2373,1587,20
72680381795,72680381794,-1,1013,2909,20
72682646054,72682646053,-1,657,1436,20
72683077932,72683077941,9,189,796,20
72683769743,72683769753,10,5325,1079,20
72685702160,72685702158,-2,1892,3144,20
72686756483,72686756480,-3,982,1512,20
72688040277,72688040276,-1,1417,2428,20
72688580178,72688580174,-4,2187,4849,20
72689957838,72689957833,-5,1042,2753,20
72690005672,72690005690,18,705,1411,20
72691542969,72691542969,0,1245,2191,20
72694087393,72694087390,-3,1058,2480,20
72694794831,72694794828,-3,1055,2202,20
72696567298,72696567297,-1,831,2469,20
72697362831,72697362828,-3,1074,2216,20
72700653214,72700653213,-1,1246,2226,20
72706732634,72706732632,-2,1238,2485,20
72708516116,72708516113,-3,1089,2388,20
72710495051,72710495050,-1,1026,2317,20
72712624367,72712624373,6,4351,2403,20
72713056658,72713056661,3,1645,1113,20
72716161015,72716161018,3,17035,43417,20
72718645967,72718645963,-4,653,968,20
72723326364,72723326362,-2,1193,2411,20
72726077151,72726077154,3,1743,1830,20
72733861959,72733861965,6,1696,1208,20
72735370082,72735370078,-4,1528,2810,20
72738959722,72738959720,-2,1214,1644,20
72739023676,72739023698,22,576,1499,20
72739235514,72739235511,-3,1373,2522,20
72745098587,72745098582,-5,1176,2634,20
72745519502,72745519501,-1,1565,2393,20
72749980634,72749980633,-1,1112,1690,20
72751878566,72751878579,13,645,1532,20
72753977376,72753977373,-3,1093,2872,20
72755764942,72755764942,0,1390,1704,20
72758865898,72758865892,-6,1150,3927,20
72759222843,72759222843,0,624,1257,20
72759759673,72759759670,-3,1044,2447,20
72761420607,72761420601,-6,1432,3190,20
72761963174,72761963194,20,1450,2183,20
72762389122,72762389129,7,12884,5179,20
72763718055,72763718053,-2,922,1858,20
72768840186,72768840190,4,1913,1580,20
72773161714,72773161711,-3,1244,3002,20
72778284418,72778284418,0,800,2543,20
72778990199,72778990197,-2,666,2002,20
72779336706,72779336703,-3,1062,2024,20
72779957086,72779957081,-5,984,3343,20
72780672238,72780672234,-4,1356,3120,20
72781273746,72781273743,-3,1348,2537,20
72783903441,72783903439,-2,1384,2586,20
72785110351,72785110346,-5,1160,2057,20
72785367941,72785367935,-6,1035,2264,20
72786861975,72786861972,-3,862,2701,20
72790808750,72790808747,-3,28219,12019,20
72790914969,72790914966,-3,818,2363,20
72792385441,72792385440,-1,637,1438,20
72794858657,72794858657,0,1233,2496,20
72796516859,72796516860,1,938,1348,20
72810132866,72810132861,-5,953,1970,20
72810168693,72810168713,20,380,854,20
72818988138,72818988135,-3,1031,2459,20
72819888934,72819888934,0,729,1234,20
72820133067,72820133067,0,924,1847,20
72821420997,72821420993,-4,1573,2147,20
72830993999,72830993997,-2,993,2119,20
72833364072,72833364066,-6,930,2244,20
72838105553,72838105550,-3,1033,2391,20
72838137782,72838137778,-4,159,850,20
72841562422,72841562421,-1,744,1385,20
72843950982,72843950980,-2,1237,2308,20
72844175935,72844175949,14,371,896,20
72851815947,72851815945,-2,1184,1742,20
72852099300,72852099317,17,702,2660,20
72853679790,72853679788,-2,1709,3117,20
72854802379,72854802384,5,3027,1535,20
72855104455,72855104454,-1,1062,2014,20
72857895330,72857895333,3,1708,1464,20
72864054869,72864054870,1,960,1187,20
72868647191,72868647190,-1,1127,1542,20
72871790306,72871790304,-2,2635,4873,20
72872549734,72872549733,-1,1098,2060,20
72873404306,72873404302,-4,1249,3055,20
72878553586,72878553582,-4,1132,2335,20
72886549000,72886548996,-4,897,1528,20
72886801997,72886801995,-2,1352,2119,20
72891335172,72891335170,-2,1385,2473,20
72901003599,72901003599,0,268,934,20
72907576597,72907576593,-4,1923,3545,20
72908103474,72908103470,-4,968,2555,20
72921620621,72921620626,5,3421,1962,20
72921664427,72921664422,-5,536,889,20
72923729260,72923729253,-7,128,739,20
72924675677,72924675670,-7,1031,3899,20
72925489022,72925489019,-3,1067,1826,20
72930127865,72930127862,-3,1187,1712,20
72932285338,72932285337,-1,856,1931,20
72937028292,72937028289,-3,1280,2057,20
72938557117,72938557113,-4,1091,2947,20
72939293509,72939293524,15,420,1674,20
72941268782,72941268778,-4,913,1754,20
72944561908,72944561906,-2,757,1595,20
72947143661,72947143657,-4,1128,3343,20
72953255925,72953255923,-2,1642,2163,20
72958829871,72958829867,-4,1069,1854,20
72963110854,72963110851,-3,993,2073,20
72968241762,72968241758,-4,1045,2667,20
72970637807,72970637802,-5,1121,2649,20
72973093733,72973093730,-3,1035,2182,20
72982229042,72982229038,-4,1092,2387,20
72982924975,72982924970,-5,849,2037,20
72984064179,72984064177,-2,649,1287,20
72985469526,72985469525,-1,596,1872,20
72987427477,72987427473,-4,1571,3125,20
72987540925,72987540924,-1,1001,1935,20
72988450099,72988450095,-4,1133,1468,20
72994284335,72994284333,-2,1128,2390,20
73000353850,73000353846,-4,1003,2199,20
73001041893,73001041888,-5,857,2184,20
73001893789,73001893786,-3,1175,3115,20
73003313691,73003313691,0,840,1885,20
73003917217,73003917216,-1,1415,2023,20
73005592326,73005592325,-1,1199,2041,20
73007146574,73007146571,-3,787,1835,20
73007603805,73007603802,-3,1246,2696,20
73011950399,73011950399,0,1211,2041,20
73012390103,73012390102,-1,1022,3013,20
73012455487,73012455482,-5,903,1515,20
73021384079,73021384077,-2,767,1651,20
73024497436,73024497431,-5,1458,2954,20
73026917864,73026917862,-2,1543,2787,20
73029013689,73029013687,-2,1152,2626,20
73031431503,73031431508,5,11266,22508,20
73032311475,73032311470,-5,887,1207,20
73033517582,73033517577,-5,1314,3086,20
73034072988,73034072985,-3,1159,2439,20
73035636280,73035636263,-17,194,995,20
73037266627,73037266628,1,1132,1868,20
73037870016,73037870011,-5,1851,4717,20
73038126771,73038126771,0,839,1775,20
73038345526,73038345518,-8,948,2342,20
73039705823,73039705814,-9,752,1425,20
73039880147,73039880145,-2,1257,2994,20
73039967284,73039967305,21,1280,1844,20
73043265982,73043265985,3,1138,1054,20
73047871601,73047871598,-3,1230,2278,20
73048146410,73048146407,-3,1853,3249,20
73054555193,73054555192,-1,1087,1962,20
73057325441,73057325438,-3,1160,2177,20
73057595575,73057595570,-5,1152,3256,20
73057828277,73057828274,-3,1472,1867,20
73060335600,73060335595,-5,1648,3549,20
73065903606,73065903602,-4,1239,4099,20
73068659034,73068659041,7,1798,1296,20
73069116460,73069116456,-4,739,1715,20
73075618832,73075618830,-2,789,1728,20
73077644695,73077644693,-2,1224,1966,20
73077779094,73077779094,0,1199,1141,20
73079724849,73079724859,10,1371,1589,20
73081001906,73081001902,-4,1359,2246,20
73081180610,73081180609,-1,1241,2410,20
73083229369,73083229364,-5,1273,2270,20
73083265150,73083265131,-19,1106,1587,20
73090651810,73090651808,-2,1378,2743,20
73092090773,73092090769,-4,949,1962,20
73100659423,73100659418,-5,1648,3100,20
73103162098,73103162095,-3,1370,2244,20
73106059619,73106059618,-1,1017,1979,20
73107541030,73107541026,-4,934,2555,20
73107802414,73107802411,-3,774,1631,20
73111592205,73111592199,-6,819,3033,20
73113048146,73113048141,-5,1166,2542,20
73113807949,73113807945,-4,524,916,20
73117028079,73117028075,-4,1036,2724,20
73120298338,73120298337,-1,1550,2395,20
73123697086,73123697083,-3,929,2501,20
73123798008,73123798026,18,290,1181,20
73130161788,73130161785,-3,1401,1786,20
73137255667,73137255662,-5,846,1814,20
73143946478,73143946473,-5,1114,2412,20
73147600872,73147600894,22,865,1783,20
73151778995,73151778991,-4,1374,3313,20
73153581887,73153581884,-3,809,1378,20
73156818949,73156818945,-4,638,1639,20
73157138797,73157138815,18,542,1307,20
73161240974,73161240970,-4,1246,2495,20
73167909150,73167909146,-4,1035,2509,20
73172013570,73172013575,5,1895,1821,20
73172237898,73172237895,-3,1093,3211,20
73173795090,73173795088,-2,1124,2494,20
73174267958,73174267954,-4,1135,2247,20
73177520387,73177520386,-1,1063,2150,20
73179999222,73179999220,-2,1675,3275,20
73180770517,73180770513,-4,731,1314,20
73184775005,73184775003,-2,1182,2502,20
73190300773,73190300773,0,1671,2743,20
73192696795,73192696792,-3,624,1675,20
73192793658,73192793654,-4,962,2407,20
73196373550,73196373545,-5,1025,2231,20
73204494395,73204494392,-3,1343,3672,20
73204963133,73204963130,-3,1327,3175,20
73205622992,73205623001,9,21590,57080,20
73206290502,73206290500,-2,652,2218,20
73218676708,73218676691,-17,1034,1477,20
73222360333,73222360330,-3,1447,2756,20
73223845158,73223845156,-2,872,1475,20
73224616322,73224616318,-4,1004,2942,20
73237433500,73237433498,-2,1389,1881,20
73237903702,73237903705,3,2142,1672,20
73240773214,73240773215,1,45313,33726,20
73242190876,73242190879,3,1996,967,20
73242587264,73242587278,14,326,1283,20
73242842206,73242842203,-3,1312,1854,20
73243959694,73243959690,-4,976,1983,20
73244682882,73244682879,-3,1294,3207,20
73246855545,73246855543,-2,986,1981,20
73247675454,73247675458,4,3243,1581,20
73250578291,73250578286,-5,1320,2241,20
73255293943,73255293942,-1,1103,1729,20
73255802756,73255802751,-5,978,1613,20
73256652987,73256652987,0,1142,927,20
73257028839,73257028837,-2,912,2803,20
73259475138,73259475134,-4,1046,1931,20
73261397158,73261397153,-5,1179,1975,20
73264646306,73264646306,0,1339,2051,20
73266341845,73266341839,-6,1080,2849,20
73268044579,73268044577,-2,1374,2693,20
73270470563,73270470560,-3,889,1510,20
73271848210,73271848206,-4,1068,2971,20
73272096655,73272096650,-5,1103,2380,20
73273275508,73273275528,20,302,792,20
73275163858,73275163861,3,2868,12970,20
73287189125,73287189123,-2,1351,2501,20
73290181001,73290181000,-1,1066,1604,20
73295293796,73295293792,-4,1360,1967,20
73300002212,73300002209,-3,606,2268,20
73302810339,73302810338,-1,1279,1771,20
73303247591,73303247570,-21,1008,2489,20
73306092464,73306092463,-1,1126,1723,20
73306754814,73306754810,-4,1173,2550,20
73307742722,73307742721,-1,1187,2381,20
73313625767,73313625762,-5,956,2754,20
73315125404,73315125423,19,247,822,20
73321461715,73321461712,-3,964,2655,20
73324884328,73324884326,-2,24085,9636,20
73330729262,73330729260,-2,1065,1512,20
73335989958,73335989957,-1,1310,2657,20
73341566982,73341566979,-3,700,1012,20
73341948326,73341948322,-4,1513,2216,20
73343741991,73343741987,-4,1341,2416,20
73345290639,73345290635,-4,1270,2382,20
73346854747,73346854745,-2,1003,2138,20
73349335966,73349335964,-2,524,1305,20
73355322487,73355322466,-21,10987,12625,20
73357812546,73357812542,-4,977,1888,20
73360993336,73360993339,3,2152,1269,20
73362456114,73362456111,-3,1026,2165,20
73362670887,73362670866,-21,992,2120,20
73364576835,73364576834,-1,1248,1987,20
73366645815,73366645812,-3,1407,2730,20
73367029353,73367029350,-3,1069,2835,20
73368874531,73368874527,-4,1034,2062,20
73369109388,73369109386,-2,1034,2748,20
73370755502,73370755499,-3,1472,2279,20
73371647239,73371647237,-2,1379,2923,20
73377448241,73377448238,-3,1006,2464,20
73378135957,73378135953,-4,1259,3296,20
73380789522,73380789518,-4,1130,2698,20
73384100730,73384100727,-3,1186,2905,20
73387158133,73387158129,-4,1018,1564,20
73390816210,73390816209,-1,1073,1767,20
73393348163,73393348160,-3,1257,1852,20
73396467876,73396467874,-2,1196,2223,20
73402145416,73402145412,-4,1003,2695,20
73402830726,73402830721,-5,977,2613,20
73402905135,73402905132,-3,662,1970,20
73403608769,73403608768,-1,984,1492,20
73404004486,73404004485,-1,1100,2423,20
73404265005,73404265027,22,304,995,20
73405535637,73405535635,-2,1360,2740,20
73409863061,73409863057,-4,1498,2681,20
73409938806,73409938798,-8,994,1841,20
73412687913,73412687911,-2,890,1999,20
73417372965,73417372960,-5,1106,2463,20
73417624653,73417624637,-16,339,824,20
73420151177,73420151177,0,1089,2369,20
73423583605,73423583607,2,1175,1338,20
73426011353,73426011350,-3,1566,2877,20
73429019770,73429019767,-3,1378,2014,20
73430706071,73430706071,0,1306,1550,20
73434055493,73434055494,1,1024,2010,20
73434893023,73434893040,17,1356,2790,20
73445293467,73445293466,-1,430,999,20
73447603709,73447603705,-4,1238,3973,20
73453601176,73453601174,-2,1538,1616,20
73454193530,73454193530,0,1119,1537,20
73460635383,73460635379,-4,1231,2410,20
73463402632,73463402630,-2,1390,3176,20
73464554238,73464554234,-4,905,2410,20
73465441516,73465441522,6,2871,1528,20
73466029508,73466029505,-3,1294,2084,20
73466326946,73466326946,0,1240,2598,20
73468170276,73468170277,1,1576,1873,20
73470735105,73470735101,-4,1553,2655,20
73476422413,73476422409,-4,1078,2187,20
73480426184,73480426181,-3,928,1654,20
73480781866,73480781864,-2,948,1724,20
73481781590,73481781586,-4,1350,3240,20
73484366064,73484366064,0,1624,1574,20
73485608609,73485608604,-5,28189,14670,20
73486279066,73486279063,-3,1406,3130,20
73487391634,73487391630,-4,915,2686,20
73493924645,73493924641,-4,838,2077,20
73494756035,73494756032,-3,976,2221,20
73505619086,73505619082,-4,737,2320,20
73505746506,73505746503,-3,1299,2033,20
73509626754,73509626753,-1,1160,2031,20
73511895669,73511895665,-4,1377,3420,20
73515268813,73515268811,-2,955,2278,20
73516094841,73516094840,-1,849,1754,20
73519250622,73519250619,-3,1263,1936,20
73520254420,73520254419,-1,1455,3031,20
73521935666,73521935661,-5,1004,2568,20
73528059249,73528059252,3,31287,114920,20
73528558542,73528558540,-2,706,1783,20
73528623611,73528623609,-2,1001,2526,20
73537624985,73537624980,-5,986,2886,20
73539353827,73539353824,-3,1509,3128,20
73539559126,73539559122,-4,1215,2661,20
73542683972,73542683971,-1,987,1704,20
73543196955,73543196953,-2,1263,3073,20
73544237170,73544237173,3,2014,1494,20
73546715050,73546715050,0,1085,2163,20
73552032915,73552032910,-5,1088,2490,20
73554919153,73554919150,-3,1128,2908,20
73569262125,73569262120,-5,1437,2902,20
73572893546,73572893542,-4,1279,2215,20
73573299506,73573299502,-4,969,2429,20
73584511514,73584511511,-3,1203,2864,20
73584680254,73584680251,-3,1238,3629,20
73584976290,73584976288,-2,1481,3757,20
73585650389,73585650386,-3,1772,2807,20
73586944333,73586944331,-2,894,2280,20
73593122952,73593122949,-3,1542,2331,20
73595550211,73595550192,-19,644,1685,20
73599746602,73599746598,-4,968,2565,20
73600697357,73600697345,-12,653,2289,20
73602684086,73602684082,-4,1131,1667,20
73605464744,73605464741,-3,1629,2821,20
73605695516,73605695514,-2,1162,1714,20
73610014883,73610014881,-2,1184,2418,20
73612003072,73612003070,-2,576,1214,20
73612737188,73612737185,-3,1409,3608,20
73614020206,73614020202,-4,1101,3025,20
73614406689,73614406686,-3,1587,2266,20
73614907501,73614907497,-4,697,2041,20
73615224661,73615224657,-4,5,4614,20
73615929395,73615929395,0,1550,2193,20
73616545190,73616545185,-5,1493,2993,20
73617722598,73617722593,-5,1266,1781,20
73618614186,73618614182,-4,1044,1906,20
73624026840,73624026835,-5,1054,2121,20
73628507787,73628507784,-3,1143,2476,20
73633206194,73633206192,-2,939,1809,20
73635308064,73635308061,-3,1069,2228,20
73635580980,73635580978,-2,1667,2877,20
73637785279,73637785282,3,103,908,20
73641028544,73641028541,-3,1351,2743,20
73644264009,73644264006,-3,1618,2644,20
73644647237,73644647235,-2,1037,3016,20
73645821881,73645821879,-2,1482,3052,20
73647344494,73647344493,-1,1341,1946,20
73671323778,73671323774,-4,1368,3462,20
73672658386,73672658387,1,1930,2092,20
73681290309,73681290309,0,1050,2168,20
73685081117,73685081113,-4,1286,1831,20
73686359539,73686359537,-2,1018,2460,20
73691743783,73691743782,-1,1145,1898,20
73695195806,73695195803,-3,842,2028,20
73695724327,73695724330,3,1568,1655,20
73696327995,73696327994,-1,968,2146,20
73698479935,73698479934,-1,1541,2192,20
73702116757,73702116754,-3,1036,2167,20
73703497260,73703497257,-3,1029,2633,20
73703701534,73703701530,-4,1360,2470,20
73717432462,73717432458,-4,1504,2577,20
73717568369,73717568368,-1,1336,1397,20
73718424832,73718424833,1,3004,3963,20
73718475382,73718475379,-3,895,2041,20
73724185875,73724185892,17,564,1142,20
73727586866,73727586861,-5,1082,2963,20
73727852686,73727852686,0,1558,2850,20
73728657219,73728657217,-2,1212,2538,20
73732643441,73732643437,-4,922,2010,20
73733387078,73733387099,21,734,1762,20
73733871326,73733871325,-1,1088,2197,20
73736044326,73736044325,-1,1436,2490,20
73736829489,73736829489,0,1274,2484,20
73738424157,73738424150,-7,890,3152,20
73742343676,73742343678,2,1321,1539,20
73754533774,73754533769,-5,1140,4133,20
73756324043,73756324039,-4,1303,2033,20
73758734615,73758734596,-19,2093,1099,20
73759171090,73759171085,-5,1024,2514,20
73759544503,73759544503,0,32,1132,20
73761416258,73761416257,-1,1008,1252,20
73767250755,73767250754,-1,1326,2202,20
73773256201,73773256206,5,2556,1600,20
73776835754,73776835750,-4,723,1972,20
73777043820,73777043806,-14,976,3469,20
73778056557,73778056554,-3,1115,2078,20
73780016559,73780016555,-4,1185,1699,20
73780259892,73780259875,-17,1172,1852,20
73785143411,73785143430,19,1185,2169,20
73785628169,73785628166,-3,1229,2719,20
73786373706,73786373703,-3,1296,3116,20
73787887415,73787887411,-4,731,1328,20
73792591089,73792591087,-2,1486,2315,20
73792883567,73792883565,-2,1908,3278,20
73793183614,73793183614,0,657,1771,20
73793732134,73793732132,-2,1133,2134,20
73795416851,73795416852,1,1572,1889,20
73797285956,73797285953,-3,1891,3039,20
73797974803,73797974801,-2,930,2172,20
73798010595,73798010593,-2,1354,2190,20
73798465809,73798465813,4,1790,1739,20
73801340620,73801340617,-3,1104,2760,20
73807161690,73807161687,-3,1332,3611,20
73807447450,73807447449,-1,1363,3066,20
73809623023,73809623001,-22,1001,2693,20
73812792847,73812792845,-2,847,1506,20
73820106594,73820106593,-1,1389,2020,20
73823945593,73823945593,0,744,1308,20
73824659289,73824659282,-7,1381,2532,20
73829270735,73829270734,-1,1282,2181,20
73833806026,73833806025,-1,1239,2577,20
73835659072,73835659074,2,3425,3088,20
73835964581,73835964577,-4,1277,2227,20
73843624267,73843624265,-2,1000,2085,20
73846957087,73846957084,-3,668,1777,20
73848654087,73848654085,-2,1403,2675,20
73849535750,73849535748,-2,1005,2648,20
73851968887,73851968882,-5,1071,1866,20
73853132882,73853132880,-2,1446,2611,20
73853227797,73853227817,20,1016,2593,20
73854854927,73854854926,-1,1347,1198,20
73857271485,73857271480,-5,1722,2963,20
73860649826,73860649824,-2,1077,2108,20
73864036525,73864036522,-3,1014,2563,20
73868625376,73868625372,-4,1088,2633,20
73868944272,73868944270,-2,1546,2197,20
73871792749,73871792747,-2,835,2530,20
73872033831,73872033844,13,120,1240,20
73872776334,73872776331,-3,827,2200,20
73875496274,73875496271,-3,631,1214,20
73880628642,73880628638,-4,836,1167,20
73881954187,73881954184,-3,1220,2245,20
73882353974,73882353969,-5,856,2273,20
73882381127,73882381122,-5,1061,2575,20
73885553675,73885553671,-4,1004,1160,20
73886351411,73886351409,-2,992,1890,20
73889132291,73889132286,-5,958,4272,20
73890996245,73890996236,-9,1077,2391,20
73891287297,73891287297,0,1113,1616,20
73891466137,73891466135,-2,1449,2297,20
73901718874,73901718878,4,1072,732,20
73902587363,73902587362,-1,1095,2119,20
73905013821,73905013818,-3,898,2544,20
73912128199,73912128197,-2,1173,2189,20
73916772306,73916772304,-2,1191,2207,20
73917067366,73917067362,-4,1048,2440,20
73921401085,73921401084,-1,1662,2416,20
73921530722,73921530720,-2,871,2301,20
73922297609,73922297606,-3,1101,2355,20
73929383648,73929383645,-3,956,2479,20
73930212426,73930212422,-4,1120,2428,20
73936440022,73936440018,-4,719,877,20
73939170998,73939170995,-3,874,1763,20
73940656060,73940656058,-2,1291,1987,20
73941284991,73941284989,-2,946,2454,20
73943587816,73943587813,-3,1158,1954,20
73949076237,73949076234,-3,1093,1544,20
73950134330,73950134326,-4,1502,2486,20
73950564581,73950564574,-7,1123,1924,20
73952003230,73952003237,7,4489,1805,20
73953550234,73953550234,0,1251,2255,20
73956143150,73956143149,-1,1386,2497,20
73958467934,73958467930,-4,1395,2671,20
73959841843,73959841838,-5,1383,2709,20
73961113323,73961113320,-3,1249,2727,20
73963173533,73963173519,-14,977,1097,20
73963523046,73963523066,20,394,1631,20
73964380610,73964380607,-3,878,2384,20
73965250773,73965250774,1,1640,1335,20
73970288136,73970288131,-5,1561,3669,20
73972531936,73972531933,-3,1164,2008,20
73973258167,73973258165,-2,1074,2109,20
73974747314,73974747310,-4,761,3191,20
73975574094,73975574100,6,2492,1129,20
73982985399,73982985406,7,1455,1365,20
73983561022,73983561019,-3,1092,2824,20
73992204269,73992204266,-3,996,2393,20
73994242309,73994242304,-5,1301,4139,20
74000087904,74000087902,-2,1077,2067,20
74008358510,74008358506,-4,1154,2614,20
74013347778,74013347775,-3,1070,2723,20
74013393694,74013393693,-1,28216,46314,20
74014665679,74014665678,-1,753,1442,20
74015969873,74015969870,-3,1379,2781,20
74021410525,74021410521,-4,1047,2232,20
74023332176,74023332173,-3,1005,2433,20
74024244847,74024244845,-2,736,1195,20
74025086030,74025086027,-3,1258,3001,20
74027241645,74027241641,-4,965,3089,20
74028475358,74028475355,-3,1083,2599,20
74031770162,74031770159,-3,1491,3235,20
74035360354,74035360349,-5,1105,1765,20
74041322458,74041322463,5,1700,890,20
74043011160,74043011166,6,1882,1301,20
74043320289,74043320286,-3,864,2287,20
74046547627,74046547624,-3,869,2266,20
74046579777,74046579774,-3,1027,2766,20
74049598432,74049598434,2,2594,2530,20
74050290005,74050290004,-1,710,1916,20
74056843530,74056843529,-1,1286,2050,20
74057246539,74057246539,0,663,838,20
74059541956,74059541954,-2,1798,3135,20
74060671612,74060671609,-3,1381,3086,20
74061097506,74061097502,-4,1291,2790,20
74065703159,74065703153,-6,1394,2106,20
74068318336,74068318334,-2,965,1976,20
74070503605,74070503616,11,12463,25361,20
74072426527,74072426521,-6,1150,2427,20
74074700681,74074700677,-4,1266,2619,20
74077963634,74077963631,-3,1213,2163,20
74079263227,74079263225,-2,828,2317,20
74080874616,74080874613,-3,1483,3010,20
74092891835,74092891842,7,2058,1049,20
74092985759,74092985757,-2,875,2023,20
74097881119,74097881124,5,2697,1532,20
74099952448,74099952449,1,1995,1581,20
74112868592,74112868594,2,3299,2136,20
74115198058,74115198059,1,999,2235,20
74117358469,74117358475,6,5612,2440,20
74118368110,74118368106,-4,752,1554,20
74118781031,74118781010,-21,286,1048,20
74120313777,74120313778,1,969,1616,20
74123582974,74123582970,-4,1099,2072,20
74123699741,74123699737,-4,1649,2992,20
74126235428,74126235441,13,14119,47850,20
74135510694,74135510693,-1,1268,1553,20
74136685775,74136685770,-5,1218,2950,20
74138773301,74138773302,1,1296,784,20
74139403708,74139403728,20,352,705,20
74141638106,74141638104,-2,1202,2082,20
74144553698,74144553697,-1,1400,1693,20
74144711139,74144711134,-5,1154,2399,20
74145492901,74145492899,-2,838,2238,20
74146434566,74146434566,0,1675,3973,20
74149515585,74149515589,4,1234,925,20
74149694254,74149694253,-1,883,1792,20
74151271063,74151271058,-5,1091,1909,20
74154310783,74154310780,-3,1344,3553,20
74156221153,74156221158,5,1701,1155,20
74158832933,74158832930,-3,1235,3236,20
74159410818,74159410817,-1,809,2692,20
74164436293,74164436290,-3,1079,2339,20
74167695377,74167695373,-4,884,1498,20
74170769486,74170769487,1,1658,2224,20
74174721967,74174721966,-1,1399,3313,20
74174785740,74174785739,-1,875,2528,20
74183424715,74183424709,-6,946,1320,20
74185014805,74185014806,1,2621,3856,20
74185337338,74185337337,-1,941,1588,20
74187838655,74187838653,-2,1540,2514,20
74187934554,74187934549,-5,691,2076,20
74188026158,74188026151,-7,1187,2022,20
74189969708,74189969704,-4,1275,2979,20
74190185461,74190185468,7,1207,1004,20
74192531786,74192531783,-3,1740,2818,20
74194008615,74194008613,-2,1013,2153,20
74194669567,74194669563,-4,1022,2932,20
74197194087,74197194084,-3,1005,1574,20
74202095892,74202095892,0,1300,1729,20
74203616197,74203616194,-3,1135,1565,20
74208158407,74208158405,-2,1398,2102,20
74210676645,74210676641,-4,1316,4074,20
74211042381,74211042379,-2,1303,2772,20
74214952622,74214952618,-4,1065,1680,20
74216401195,74216401195,0,1026,1442,20
74218159918,74218159914,-4,1102,1840,20
74228795612,74228795610,-2,754,1561,20
74229160067,74229160066,-1,1844,1341,20
74234929934,74234929930,-4,848,1143,20
74239095207,74239095206,-1,1282,1955,20
74243244003,74243244000,-3,955,1777,20
74246322910,74246322909,-1,1541,2887,20
74261304850,74261304846,-4,954,3083,20
74263358034,74263358029,-5,1288,2232,20
74263494187,74263494182,-5,1050,2601,20
74267399813,74267399809,-4,757,2491,20
74269388451,74269388448,-3,1215,2062,20
74271008406,74271008400,-6,2366,7575,20
74273406139,74273406135,-4,1462,2958,20
74276008711,74276008709,-2,1436,2919,20
74277228722,74277228721,-1,702,1456,20
74277859606,74277859600,-6,95,5428,20
74281881691,74281881689,-2,1103,2399,20
74292084852,74292084849,-3,1191,2311,20
74293632926,74293632929,3,1037,919,20
74295870805,74295870802,-3,1553,2702,20
74298676563,74298676560,-3,1126,2399,20
74299038378,74299038376,-2,811,1556,20
74303678899,74303678896,-3,946,3109,20
74303924691,74303924689,-2,2437,4439,20
74307738246,74307738242,-4,1260,3035,20
74309859310,74309859308,-2,721,1711,20
74316541723,74316541722,-1,985,2536,20
74321617919,74321617917,-2,1285,2319,20
74321822000,74321821997,-3,1150,2022,20
74325374250,74325374248,-2,1075,2570,20
74329053871,74329053875,4,2824,1538,20
74331754071,74331754066,-5,1047,2677,20
74336096939,74336096937,-2,1429,2359,20
74338343981,74338343977,-4,1524,2916,20
74338436070,74338436069,-1,1452,2121,20
74340373550,74340373550,0,1091,1070,20
74344033642,74344033638,-4,1549,2683,20
74345593788,74345593787,-1,1418,1715,20
74350077834,74350077833,-1,1043,2184,20
74352427918,74352427914,-4,1053,2256,20
74356202042,74356202038,-4,1034,2399,20
74364034231,74364034228,-3,1470,3060,20
74365632551,74365632547,-4,920,2742,20
74369282119,74369282115,-4,1355,2608,20
74371955562,74371955559,-3,1148,1971,20
74372098650,74372098654,4,2290,1819,20
74373319255,74373319252,-3,1134,1760,20
74377620511,74377620510,-1,1237,2101,20
74384727178,74384727174,-4,1053,2015,20
74385342699,74385342697,-2,903,770,20
74386776562,74386776559,-3,1531,2897,20
74386986330,74386986327,-3,1235,2649,20
74387613891,74387613887,-4,15673,4132,20
74388371774,74388371773,-1,1202,2461,20
74390057907,74390057911,4,372,1242,20
74391296729,74391296727,-2,768,1660,20
74399868772,74399868773,1,3136,3321,20
74400242921,74400242925,4,6407,4562,20
74400721118,74400721115,-3,899,2449,20
74402295894,74402295890,-4,1169,2370,20
74402405738,74402405737,-1,414,1584,20
74404101613,74404101610,-3,1057,1475,20
74407514159,74407514156,-3,1256,2227,20
74412531253,74412531241,-12,30252,14746,20
74413308215,74413308223,8,6059,2702,20
74413892238,74413892233,-5,824,1621,20
74415040636,74415040634,-2,1276,2570,20
74415214182,74415214165,-17,1239,2501,20
74422465837,74422465834,-3,910,1855,20
74426011063,74426011062,-1,1067,2442,20
74426613383,74426613382,-1,1194,1252,20
74426785275,74426785272,-3,950,1973,20
74427357788,74427357809,21,1102,2722,20
74429540874,74429540873,-1,1794,2836,20
74429910226,74429910224,-2,873,2316,20
74431679841,74431679838,-3,1239,1984,20
74433059450,74433059447,-3,1053,3260,20
74438438936,74438438953,17,543,1264,20
74439304290,74439304286,-4,1308,2025,20
74444761665,74444761662,-3,1073,2235,20
74447575734,74447575732,-2,791,1909,20
74451411659,74451411664,5,15196,2230,20
74451693437,74451693434,-3,580,1423,20
74454950574,74454950570,-4,1486,1950,20
74455518063,74455518057,-6,942,3097,20
74460478102,74460478098,-4,830,2170,20
74462749550,74462749544,-6,1121,2307,20
74462797382,74462797390,8,4209,1787,20
74463395567,74463395565,-2,1318,2132,20
74465482806,74465482798,-8,1031,3742,20
74466367390,74466367387,-3,893,1946,20
74467328999,74467329003,4,85,603,20
74476577910,74476577909,-1,4926,6228,20
74479472583,74479472581,-2,982,1719,20
74480949659,74480949654,-5,1209,3870,20
74483017327,74483017330,3,1556,1577,20
74487904858,74487904854,-4,1114,1726,20
74490239426,74490239422,-4,857,943,20
74506053655,74506053632,-23,832,1837,20
74506439536,74506439532,-4,977,2376,20
74506693696,74506693698,2,1251,1393,20
74507242504,74507242490,-14,362,1045,20
74510691611,74510691609,-2,1589,2320,20
74511640217,74511640219,2,2083,1237,20
74512939069,74512939076,7,2637,1703,20
74515727545,74515727541,-4,1135,2137,20
74527707671,74527707670,-1,849,1323,20
74528450844,74528450842,-2,19530,37049,20
74529126214,74529126210,-4,1199,2689,20
74532481329,74532481325,-4,1313,2298,20
74536236095,74536236089,-6,976,2765,20
74538495769,74538495767,-2,1271,2956,20
74538613728,74538613746,18,335,572,20
74549348970,74549348964,-6,772,1249,20
74549857647,74549857630,-17,912,3264,20
74550202120,74550202117,-3,1144,2174,20
74550435134,74550435129,-5,177,1493,20
74551714317,74551714313,-4,900,2314,20
74561336783,74561336779,-4,1193,3312,20
74563716295,74563716291,-4,2092,6067,20
74567741823,74567741821,-2,1006,2262,20
74568762716,74568762713,-3,1481,3043,20
74576812885,74576812880,-5,827,2206,20
74578420719,74578420735,16,894,2118,20
74579799732,74579799728,-4,1217,2259,20
74582739472,74582739470,-2,1336,2338,20
74582884176,74582884173,-3,1054,3060,20
74584718505,74584718501,-4,1159,3183,20
74586688310,74586688306,-4,865,2424,20
74589129910,74589129908,-2,1128,2713,20
74597121686,74597121691,5,1801,1380,20
74599509130,74599509127,-3,1026,2053,20
74601296083,74601296079,-4,1455,2613,20
74602286823,74602286822,-1,1086,3256,20
74602696163,74602696159,-4,1246,2633,20
74609005707,74609005705,-2,1061,1584,20
74611159806,74611159801,-5,1070,2228,20
74612711000,74612711017,17,145,1357,20
74613504166,74613504185,19,1061,1629,20
74615582079,74615582077,-2,1114,1635,20
74620162474,74620162472,-2,927,1999,20
74621665830,74621665828,-2,1446,3315,20
74622007555,74622007554,-1,1086,1723,20
74624105585,74624105582,-3,1387,2413,20
74628286453,74628286450,-3,1223,2915,20
74635118586,74635118587,1,1982,1863,20
74636526045,74636526040,-5,2121,5807,20
74639045413,74639045410,-3,1504,2938,20
74644657524,74644657521,-3,793,1211,20
74644901982,74644901979,-3,731,695,20
74649453623,74649453622,-1,947,1646,20
74649708774,74649708769,-5,927,2120,20
74652151930,74652151929,-1,1400,3174,20
74655308606,74655308611,5,5636,2646,20
74657949822,74657949822,0,11243,17258,20
74662094179,74662094177,-2,1137,2337,20
74664009071,74664009067,-4,1132,1815,20
74671184517,74671184515,-2,1781,3193,20
74673341177,74673341179,2,3204,2848,20
74679337053,74679337050,-3,1155,2202,20
74681468978,74681468980,2,1675,1753,20
74684449331,74684449328,-3,1185,3588,20
74684755443,74684755441,-2,1190,2708,20
74685457688,74685457685,-3,1717,2650,20
74687836585,74687836590,5,1181,900,20
74689304098,74689304097,-1,1396,1702,20
74691251409,74691251405,-4,804,1713,20
74697281320,74697281317,-3,1172,2803,20
74700907766,74700907765,-1,1141,2301,20
74704982858,74704982857,-1,1076,2199,20
74705191678,74705191698,20,773,2213,20
74705294196,74705294191,-5,1215,1491,20
74707185662,74707185659,-3,875,1558,20
74707936433,74707936429,-4,1613,1932,20
74709121404,74709121423,19,1382,2125,20
74709287813,74709287809,-4,994,2429,20
74709328687,74709328691,4,11245,8028,20
74709878738,74709878733,-5,1781,2153,20
74710028942,74710028941,-1,1065,1702,20
74715336178,74715336174,-4,1569,3189,20
74716629919,74716629917,-2,1595,3368,20
74719210420,74719210417,-3,1242,2004,20
74736268690,74736268687,-3,1120,2054,20
74743100979,74743100991,12,849,1493,20
74750278525,74750278521,-4,1256,2247,20
74752520886,74752520885,-1,852,2024,20
74755755685,74755755682,-3,1048,2727,20
74756651822,74756651821,-1,1110,2041,20
74756786790,74756786787,-3,1621,2780,20
74757729322,74757729323,1,4242,49463,20
74761022325,74761022321,-4,1221,2104,20
74762722922,74762722918,-4,973,2838,20
74777317256,74777317254,-2,1681,2128,20
74779234342,74779234341,-1,1178,1969,20
74779958837,74779958834,-3,880,2169,20
74780728642,74780728638,-4,1090,2164,20
74781022378,74781022377,-1,1081,1543,20
74784869309,74784869311,2,1563,1978,20
74785564996,74785565018,22,843,2027,20
74787407264,74787407258,-6,34503,12927,20
74796036743,74796036741,-2,1201,2741,20
74796902614,74796902610,-4,1675,3445,20
74797777862,74797777859,-3,1419,1938,20
74809309859,74809309856,-3,882,2053,20
74809848535,74809848545,10,482,1636,20
74811225733,74811225729,-4,949,3199,20
74811275063,74811275062,-1,1111,2593,20
74811921618,74811921634,16,14403,44972,20
74813148793,74813148791,-2,692,2299,20
74813224334,74813224331,-3,594,1257,20
74815521182,74815521178,-4,1009,2562,20
74825573073,74825573069,-4,1570,2971,20
74827043272,74827043270,-2,1416,1938,20
74829351536,74829351546,10,222,970,20
74831223339,74831223338,-1,1670,1569,20
74836218744,74836218767,23,1111,2577,20
74837259116,74837259111,-5,915,1795,20
74838366845,74838366839,-6,1056,1662,20
74838438778,74838438774,-4,1260,3144,20
74840732462,74840732459,-3,887,2034,20
74846793751,74846793747,-4,948,1898,20
74847222895,74847222891,-4,1713,2787,20
74848653849,74848653844,-5,1174,3453,20
74853662389,74853662385,-4,628,2098,20
74856379967,74856379970,3,1962,1558,20
74856710923,74856710922,-1,1302,2236,20
74859071334,74859071330,-4,1684,3008,20
74863165624,74863165626,2,1490,1935,20
74870060958,74870060952,-6,1336,6420,20
74871622393,74871622390,-3,984,1979,20
74878282594,74878282593,-1,985,1951,20
74881639163,74881639161,-2,809,1852,20
74885624100,74885624098,-2,913,2522,20
74888462438,74888462434,-4,1212,3742,20
74888640346,74888640344,-2,1412,1840,20
74888860185,74888860181,-4,1305,3519,20
74890150967,74890150966,-1,1047,1706,20
74891966982,74891966980,-2,1176,3170,20
74893470882,74893470878,-4,1156,2772,20
74897094258,74897094255,-3,1190,2212,20
74899609490,74899609495,5,2327,671,20
74901067114,74901067114,0,3363,3620,20
74901363917,74901363916,-1,1768,2260,20
74906328399,74906328395,-4,805,1718,20
74908527598,74908527594,-4,987,1664,20
74914305143,74914305141,-2,1110,1979,20
74916423658,74916423656,-2,1302,2314,20
74917623450,74917623470,20,803,2071,20
74919384406,74919384407,1,754,1357,20
74925149582,74925149578,-4,1078,3611,20
74927416959,74927416954,-5,1067,2909,20
74930147458,74930147455,-3,1201,2487,20
74931702227,74931702225,-2,1492,3402,20
74931771210,74931771212,2,1283,1108,20
74932633925,74932633922,-3,1119,2142,20
74939365014,74939365010,-4,932,1874,20
74942266953,74942266950,-3,1090,2267,20
74942984687,74942984684,-3,911,2841,20
74944559025,74944559023,-2,1175,2155,20
74947625990,74947625986,-4,1405,2944,20
74951286522,74951286519,-3,1055,2427,20
74955608474,74955608470,-4,1049,2233,20
74964722962,74964722962,0,613,723,20
74966184751,74966184737,-14,1413,1659,20
74968824741,74968824747,6,2972,1231,20
74970972958,74970972954,-4,973,1404,20
74978071403,74978071399,-4,1124,2822,20
74978846330,74978846323,-7,1252,4420,20
74979821852,74979821875,23,594,1013,20
74980165024,74980165021,-3,1444,3393,20
74981312222,74981312218,-4,892,2074,20
74991095534,74991095530,-4,1219,3331,20
74991623127,74991623126,-1,986,1405,20
74994516923,74994516919,-4,1167,2163,20
74995159261,74995159260,-1,1338,2133,20
75004592634,75004592631,-3,911,2604,20
75009184039,75009184038,-1,1097,2348,20
75009508734,75009508754,20,1311,1898,20
75010535244,75010535244,0,1402,1619,20
75013606112,75013606108,-4,1049,2846,20
75015086904,75015086901,-3,1433,3285,20
75015495215,75015495213,-2,951,2179,20
75017116582,75017116577,-5,1193,2779,20
75018949027,75018949025,-2,826,1407,20
75020580866,75020580862,-4,498,1307,20
75021787520,75021787518,-2,1471,2759,20
75027165770,75027165767,-3,1366,2391,20
75030395545,75030395542,-3,1366,2572,20
75031219795,75031219793,-2,1099,1938,20
75032223584,75032223588,4,2281,2793,20
75032279946,75032279944,-2,1200,1683,20
75034598727,75034598724,-3,871,3293,20
75035884511,75035884509,-2,816,1526,20
75038031779,75038031778,-1,817,2065,20
75040847954,75040847950,-4,1496,3550,20
75040978335,75040978331,-4,764,1503,20
75043520086,75043520083,-3,1181,3445,20
75043982870,75043982869,-1,914,1978,20
75046418223,75046418217,-6,1007,2821,20
75047118756,75047118752,-4,143,1469,20
75048544772,75048544769,-3,948,1744,20
75048678397,75048678393,-4,1261,2539,20
75050894192,75050894190,-2,1487,2919,20
75050921054,75050921058,4,3095,1503,20
75051119905,75051119902,-3,1707,2608,20
75056871786,75056871784,-2,1158,2040,20
75058727495,75058727499,4,2140,1312,20
75061484934,75061484933,-1,1206,2853,20
75063174776,75063174771,-5,1553,2534,20
75066065816,75066065815,-1,1040,2210,20
75068729895,75068729891,-4,1003,2093,20
75069194128,75069194141,13,623,1120,20
75069730238,75069730234,-4,1002,2038,20
75073227118,75073227110,-8,905,3823,20
75073327753,75073327749,-4,1181,1749,20
75075415249,75075415246,-3,1273,2224,20
75082999855,75082999854,-1,1123,1720,20
75091858914,75091858910,-4,1592,2525,20
75110062318,75110062314,-4,795,2196,20
75111909850,75111909849,-1,1282,2158,20
75116560286,75116560291,5,3410,1439,20
75116893739,75116893719,-20,646,1750,20
75118335914,75118335913,-1,1503,2619,20
75123244040,75123244037,-3,1332,2754,20
75126025006,75126025005,-1,1267,2197,20
75126218372,75126218392,20,567,1491,20
75129099791,75129099787,-4,1041,2248,20
75132168604,75132168602,-2,1499,2514,20
75132705249,75132705245,-4,832,1771,20
75134876762,75134876766,4,1478,1337,20
75135698241,75135698237,-4,579,2201,20
75143340594,75143340592,-2,1040,2017,20
75146231155,75146231150,-5,1228,2106,20
75147052214,75147052209,-5,976,2421,20
75147553207,75147553204,-3,794,2325,20
75149606846,75149606845,-1,1463,1503,20
75150206012,75150206010,-2,253,862,20
75150235077,75150235091,14,379,767,20
75150739332,75150739319,-13,2055,5898,20
75155677942,75155677938,-4,1116,2187,20
75156174527,75156174514,-13,1044,2326,20
75156513375,75156513374,-1,696,1523,20
75163116398,75163116398,0,997,881,20
75164629655,75164629655,0,1786,1560,20
75167850645,75167850647,2,1212,1710,20
75168213221,75168213218,-3,432,1589,20
75170976891,75170976891,0,1110,1526,20
75172629055,75172629050,-5,932,2034,20
75174165447,75174165446,-1,1049,2637,20
75176728715,75176728712,-3,1141,2155,20
75177534291,75177534290,-1,825,2175,20
75181046179,75181046177,-2,461,2048,20
75181216408,75181216426,18,1316,2571,20
75181492590,75181492581,-9,1158,2266,20
75181698295,75181698311,16,353,604,20
75186382342,75186382339,-3,1374,2980,20
75187118135,75187118132,-3,739,1030,20
75194040155,75194040152,-3,1272,2222,20
75196613847,75196613850,3,2192,1855,20
75197618027,75197618022,-5,1016,2395,20
75197987952,75197987950,-2,1133,2083,20
75198064344,75198064362,18,599,1803,20
75199768497,75199768493,-4,1502,2254,20
75202109499,75202109496,-3,1131,2668,20
75202686959,75202686954,-5,1115,2033,20
75208651478,75208651475,-3,1220,1983,20
75208832713,75208832711,-2,1219,1453,20
75209646553,75209646552,-1,1095,2240,20
75218098363,75218098361,-2,1460,2831,20
75222577147,75222577146,-1,1032,1940,20
75223069284,75223069282,-2,1238,2463,20
75226880790,75226880784,-6,845,2728,20
75227238276,75227238273,-3,1499,2503,20
75228171814,75228171814,0,1803,2217,20
75232871679,75232871677,-2,843,2106,20
75235103917,75235103914,-3,1197,2361,20
75235337178,75235337175,-3,928,2195,20
75236507097,75236507095,-2,1358,2745,20
75238130180,75238130177,-3,700,1460,20
75244504967,75244504965,-2,1677,3340,20
75246477953,75246477946,-7,1059,3240,20
75248032499,75248032497,-2,1064,2295,20
75249736691,75249736691,0,1369,1298,20
75253738589,75253738583,-6,1704,2707,20
75261569370,75261569365,-5,793,2111,20
75262823534,75262823532,-2,1359,2379,20
75263182427,75263182424,-3,1214,1819,20
75267353651,75267353646,-5,744,1795,20
75268236346,75268236351,5,1333,963,20
75268604158,75268604158,0,1327,1234,20
75271874622,75271874621,-1,1299,2042,20
75274903395,75274903396,1,1006,1140,20
75279640345,75279640342,-3,1179,2385,20
75282987189,75282987193,4,3401,3762,20
75286780555,75286780553,-2,1268,2200,20
75287955170,75287955167,-3,1094,2472,20
75291783528,75291783534,6,2528,1137,20
75293568793,75293568790,-3,1312,2491,20
75295672544,75295672541,-3,1283,2597,20
75297186962,75297186961,-1,805,1632,20
75301795434,75301795431,-3,732,1801,20
75302293706,75302293702,-4,1346,2154,20
75303335236,75303335230,-6,1046,3121,20
75305480362,75305480361,-1,1582,2496,20
75307206477,75307206474,-3,1435,2879,20
75309266817,75309266815,-2,920,1534,20
75309432244,75309432237,-7,204,953,20
75310077362,75310077358,-4,1080,3051,20
75310969925,75310969921,-4,1370,2404,20
75311116301,75311116297,-4,947,1885,20
75321306925,75321306922,-3,1161,2133,20
75323713594,75323713591,-3,1108,2182,20
75327163911,75327163909,-2,860,1354,20
75329897567,75329897563,-4,742,1251,20
75332577058,75332577055,-3,873,2027,20
75332924137,75332924134,-3,615,1301,20
75336226354,75336226351,-3,1029,2595,20
75336987257,75336987255,-2,1156,1738,20
75341748454,75341748452,-2,1129,2151,20
75343257763,75343257761,-2,1306,2804,20
75350212082,75350212078,-4,1133,2118,20
75352008697,75352008694,-3,1044,2528,20
75354856325,75354856321,-4,1388,2125,20
75355982307,75355982303,-4,1102,3594,20
75359337246,75359337241,-5,1524,2531,20
75368221659,75368221658,-1,1673,2007,20
75368978051,75368978049,-2,912,1488,20
75370085477,75370085473,-4,1040,1588,20
75371914581,75371914577,-4,1223,1885,20
75379738965,75379738957,-8,980,5871,20
75380211786,75380211785,-1,1107,2115,20
75380387447,75380387444,-3,604,2510,20
75381607438,75381607459,21,69,594,20
75383256061,75383256057,-4,1206,2468,20
75384475724,75384475722,-2,1614,3412,20
75387871439,75387871435,-4,1013,2387,20
75397026958,75397026957,-1,1414,2663,20
75397708505,75397708505,0,1049,1895,20
75397919628,75397919647,19,462,1087,20
75404547204,75404547201,-3,959,2026,20
75406471514,75406471510,-4,1137,2154,20
75408211309,75408211306,-3,1189,3312,20
75410719743,75410719738,-5,928,1926,20
75415316222,75415316220,-2,1088,2486,20
75428774210,75428774206,-4,1255,2029,20
75432481252,75432481254,2,32206,24264,20
75433767757,75433767756,-1,983,2373,20
75436581611,75436581607,-4,1276,3139,20
75443286526,75443286521,-5,971,1893,20
75449594923,75449594922,-1,1268,1868,20
75450127790,75450127787,-3,1211,2440,20
75454588127,75454588122,-5,1077,2594,20
75458853482,75458853489,7,3533,1004,20
75462861527,75462861522,-5,735,1427,20
75463735157,75463735156,-1,1405,1660,20
75466011231,75466011238,7,12541,24405,20
75466768862,75466768861,-1,2033,2814,20
75468783032,75468783026,-6,1027,3415,20
75472340239,75472340238,-1,1216,1069,20
75473016537,75473016534,-3,977,2083,20
75475466330,75475466326,-4,1586,1954,20
75475929428,75475929425,-3,1114,2273,20
75476016250,75476016249,-1,844,2036,20
75479525627,75479525625,-2,997,1447,20
75486999160,75486999157,-3,1120,2144,20
75492202521,75492202518,-3,1266,2210,20
75492845418,75492845415,-3,1175,1914,20
75495262495,75495262490,-5,485,1229,20
75496868727,75496868722,-5,1194,4394,20
75498381015,75498381014,-1,1068,1833,20
75502624567,75502624562,-5,1180,2372,20
75502808610,75502808608,-2,932,1301,20
75504655569,75504655566,-3,1474,2581,20
75511115700,75511115697,-3,1547,2628,20
75516555562,75516555558,-4,983,2502,20
75518776286,75518776283,-3,1198,2239,20
75519036738,75519036734,-4,968,2628,20
75522863819,75522863818,-1,1045,2158,20
75523931445,75523931444,-1,754,1703,20
75524010857,75524010850,-7,1040,3767,20
75529440159,75529440157,-2,1111,2792,20
75530343501,75530343498,-3,865,2045,20
75532077296,75532077293,-3,1482,3219,20
75532185959,75532185955,-4,719,1818,20
75532755744,75532755761,17,575,2673,20
75540664435,75540664432,-3,548,1367,20
75541340486,75541340502,16,721,2194,20
75542501663,75542501660,-3,1142,2642,20
75545340540,75545340538,-2,902,2260,20
75546754599,75546754594,-5,1216,2585,20
75548904701,75548904705,4,3339,2520,20
75550798943,75550798941,-2,1059,2365,20
75550831749,75550831767,18,491,902,20
75553711171,75553711174,3,4028,3299,20
75554494895,75554494903,8,2880,1330,20
75561317385,75561317381,-4,1207,2980,20
75569414805,75569414801,-4,1105,2614,20
75572950342,75572950339,-3,836,2651,20
75580192458,75580192457,-1,1299,2131,20
75583359378,75583359374,-4,1424,3103,20
75592595090,75592595088,-2,832,2207,20
75593232411,75593232407,-4,1412,2891,20
75595771606,75595771605,-1,1244,2025,20
75601085583,75601085581,-2,1475,2240,20
75602028175,75602028174,-1,1405,1338,20
75605069320,75605069318,-2,1053,1804,20
75606474686,75606474707,21,1598,2286,20
75609023461,75609023459,-2,1366,3211,20
75609399709,75609399731,22,1005,2926,20
75614064873,75614064869,-4,1275,2316,20
75616241167,75616241164,-3,905,3006,20
75618069795,75618069794,-1,1089,2717,20
75621706670,75621706667,-3,1181,1988,20
75626634962,75626634961,-1,869,2120,20
75626895688,75626895685,-3,1322,2622,20
75631661066,75631661065,-1,1165,1569,20
75636118070,75636118068,-2,858,1144,20
75638524445,75638524442,-3,1270,2168,20
75644895796,75644895799,3,1484,1424,20
75644945084,75644945081,-3,1126,2225,20
75655019522,75655019518,-4,1071,2020,20
75655166236,75655166234,-2,1025,2441,20
75658618387,75658618385,-2,1039,1685,20
75658736148,75658736150,2,315,999,20
75665415385,75665415383,-2,1374,3200,20
75678880636,75678880638,2,1796,1403,20
75684189828,75684189825,-3,1880,2967,20
75684631907,75684631904,-3,1344,3845,20
75687371322,75687371321,-1,944,2223,20
75688093926,75688093926,0,1701,2386,20
75689887494,75689887493,-1,1322,3869,20
75693201233,75693201230,-3,1307,2190,20
75693941051,75693941049,-2,1096,2055,20
75697785004,75697784999,-5,1423,2218,20
75698976506,75698976503,-3,1519,2718,20
75700460490,75700460498,8,4748,1947,20
75701633754,75701633753,-1,1033,1491,20
75703808178,75703808177,-1,1145,1345,20
75704415103,75704415110,7,114,959,20
75706483430,75706483428,-2,956,1845,20
75710068745,75710068755,10,985,1914,20
75716565887,75716565885,-2,1076,1830,20
75718462594,75718462591,-3,953,2907,20
75726119077,75726119096,19,418,1248,20
75726234331,75726234327,-4,1062,2342,20
75728496098,75728496098,0,1153,2467,20
75731983609,75731983602,-7,930,3419,20
75733717879,75733717879,0,1101,1489,20
75735901009,75735901006,-3,1164,2095,20
75736724282,75736724277,-5,1262,2294,20
75740683403,75740683401,-2,1054,2346,20
75741260351,75741260358,7,2819,1332,20
75742142936,75742142932,-4,1272,1907,20
75744049797,75744049793,-4,1334,1615,20
75748346355,75748346353,-2,887,2252,20
75755351846,75755351843,-3,1056,2952,20
75759762850,75759762847,-3,983,2481,20
75761901446,75761901443,-3,1429,2619,20
75762450157,75762450174,17,224,718,20
75764251458,75764251453,-5,850,2141,20
75770183758,75770183756,-2,1282,1696,20
75771991080,75771991093,13,320,856,20
75775546632,75775546619,-13,1418,9254,20
75778568234,75778568231,-3,760,1902,20
75783474870,75783474865,-5,1241,2881,20
75785210386,75785210386,0,1121,2641,20
75787820062,75787820064,2,1549,1623,20
75789626059,75789626057,-2,1442,2849,20
75791587673,75791587668,-5,1332,2934,20
75792418260,75792418261,1,2189,2796,20
75800187036,75800187029,-7,1546,9921,20
75800675990,75800675975,-15,957,2133,20
75803098338,75803098334,-4,907,2612,20
75810411712,75810411715,3,3428,2823,20
75811106318,75811106315,-3,67,360,20
75817252798,75817252802,4,1530,24187,20
75822172065,75822172064,-1,1550,1791,20
75827556072,75827556070,-2,1281,3018,20
75827626257,75827626258,1,1153,1896,20
75832027108,75832027105,-3,481,1161,20
75833003963,75833003961,-2,1101,2298,20
75841962502,75841962498,-4,1332,3163,20
75843277377,75843277375,-2,883,2113,20
75843456822,75843456822,0,348,1172,20
75850849321,75850849317,-4,608,931,20
75851647678,75851647675,-3,1094,2670,20
75853277055,75853277053,-2,1272,2826,20
75854388995,75854388992,-3,982,2141,20
75855447857,75855447853,-4,1526,3228,20
75856793261,75856793258,-3,1165,2348,20
75857478195,75857478190,-5,1516,3360,20
75859280462,75859280452,-10,435,1689,20
75863556590,75863556588,-2,1156,2163,20
75864869097,75864869096,-1,1740,2866,20
75867536671,75867536666,-5,1279,3187,20
75871594338,75871594337,-1,1334,1666,20
75872304878,75872304875,-3,1121,2381,20
75874138934,75874138930,-4,1291,2759,20
75876380181,75876380186,5,13456,5808,20
75881965758,75881965755,-3,507,1251,20
75882070338,75882070335,-3,899,1422,20
75882693158,75882693178,20,1182,1985,20
75882794334,75882794354,20,1053,2538,20
75887553377,75887553374,-3,1046,2589,20
75889352301,75889352298,-3,960,2202,20
75898659680,75898659677,-3,1157,2172,20
75900370398,75900370395,-3,921,2549,20
75900477277,75900477275,-2,1408,1951,20
75901298680,75901298658,-22,130,865,20
75904982929,75904982926,-3,1499,2713,20
75905921393,75905921389,-4,1348,3196,20
75906133012,75906133009,-3,1135,1952,20
75907790123,75907790119,-4,937,2756,20
75908838895,75908838890,-5,707,1371,20
75913746130,75913746129,-1,946,1384,20
75917511889,75917511888,-1,1048,2432,20
75920345735,75920345739,4,2663,882,20
75920596712,75920596708,-4,1316,2479,20
75924415370,75924415369,-1,1134,2686,20
75926443325,75926443323,-2,1274,1985,20
75932137655,75932137653,-2,1063,2295,20
75932583741,75932583731,-10,806,3555,20
75942861165,75942861162,-3,903,1924,20
75945507819,75945507814,-5,1060,3113,20
75950675953,75950675948,-5,1745,7517,20
75955210674,75955210668,-6,959,2464,20
75955298728,75955298744,16,561,2018,20
75957026390,75957026386,-4,885,1998,20
75958225555,75958225550,-5,704,1762,20
75967025135,75967025138,3,1941,1619,20
75973855743,75973855741,-2,1166,1920,20
75980152474,75980152474,0,1037,1843,20
75981276172,75981276169,-3,1143,2729,20
75981369894,75981369913,19,845,2333,20
75982912630,75982912630,0,1361,1252,20
75988688862,75988688869,7,2647,1902,20
75991603239,75991603241,2,2503,2696,20
75993865576,75993865574,-2,1790,2757,20
75994638803,75994638802,-1,961,1759,20
75995893466,75995893465,-1,1430,2629,20
75996935657,75996935654,-3,1631,2749,20
75998352610,75998352609,-1,1128,1813,20
76000520117,76000520113,-4,1378,2734,20
76004102085,76004102084,-1,1001,1407,20
76005363023,76005363002,-21,1276,1860,20
76008638013,76008638012,-1,1930,2802,20
76009009853,76009009847,-6,972,2541,20
76009342570,76009342567,-3,1015,2569,20
76009987930,76009987928,-2,1050,1470,20
76010433261,76010433258,-3,826,1264,20
76021275450,76021275447,-3,1188,3820,20
76023174519,76023174515,-4,1630,3166,20
76023467467,76023467463,-4,912,2540,20
76023657605,76023657603,-2,966,1641,20
76024717839,76024717835,-4,1287,2337,20
76035043185,76035043181,-4,1373,2423,20
76039532150,76039532149,-1,1551,2350,20
76039606969,76039606966,-3,827,2121,20
76039784255,76039784243,-12,344,1117,20
76042167980,76042167981,1,1495,2182,20
76050278782,76050278786,4,2011,1503,20
76052117846,76052117845,-1,1171,1612,20
76055784605,76055784598,-7,1710,6398,20
76057524829,76057524826,-3,1372,2793,20
76062706894,76062706890,-4,1094,2781,20
76062782998,76062782993,-5,414,843,20
76071001631,76071001628,-3,1052,2043,20
76074485035,76074485030,-5,929,2062,20
76075324537,76075324536,-1,1315,2070,20
76075773791,76075773807,16,1180,2411,20
76076953647,76076953645,-2,1134,2564,20
76079591130,76079591127,-3,1190,3148,20
76080183425,76080183421,-4,1474,2933,20
76081427763,76081427761,-2,796,1541,20
76084170189,76084170171,-18,44,1124,20
76085792766,76085792769,3,1645,1682,20
76086951103,76086951099,-4,1082,2443,20
76097445245,76097445243,-2,788,2047,20
76101971691,76101971689,-2,1246,1982,20
76102522210,76102522206,-4,856,2003,20
76109379537,76109379538,1,802,2215,20
76110469446,76110469442,-4,1324,2353,20
76116205586,76116205585,-1,1593,3916,20
76118687333,76118687330,-3,903,2086,20
76119156541,76119156538,-3,1133,2606,20
76121797911,76121797909,-2,733,1437,20
76126090517,76126090513,-4,884,2058,20
76126803498,76126803496,-2,984,2011,20
76127670666,76127670666,0,1477,1238,20
76129577750,76129577771,21,754,1924,20
76130472931,76130472930,-1,1360,2472,20
76134813892,76134813887,-5,1188,2690,20
76136327478,76136327475,-3,1089,3099,20
76136662687,76136662704,17,545,1216,20
76145379103,76145379105,2,1324,1910,20
76148747525,76148747522,-3,2046,5148,20
76150271079,76150271073,-6,1375,4113,20
76150300717,76150300717,0,212,819,20
76151530476,76151530461,-15,804,1798,20
76155593571,76155593569,-2,947,1576,20
76158753916,76158753914,-2,1218,2442,20
76159647678,76159647676,-2,1318,2890,20
76161168545,76161168538,-7,803,3507,20
76163273473,76163273472,-1,1393,2386,20
76163901352,76163901347,-5,1270,2960,20
76174547493,76174547490,-3,723,1740,20
76182948022,76182948017,-5,717,1317,20
76185633810,76185633816,6,708,1089,20
76191443227,76191443226,-1,822,1516,20
76194735767,76194735763,-4,1230,3035,20
76201435884,76201435885,1,1789,1811,20
76202410845,76202410842,-3,1169,1509,20
76205465614,76205465612,-2,554,1409,20
76209010895,76209010892,-3,1249,2198,20
76209249590,76209249586,-4,1082,2877,20
76209607178,76209607176,-2,972,2534,20
76211868531,76211868530,-1,1029,2614,20
76215613110,76215613105,-5,922,2629,20
76217163905,76217163906,1,15997,18229,20
76217229023,76217229020,-3,1031,1822,20
76218000443,76218000441,-2,1129,1797,20
76218252623,76218252621,-2,1251,2613,20
76219381248,76219381242,-6,986,2523,20
76220404009,76220404006,-3,1281,2246,20
76222581929,76222581934,5,324,436,20
76225254020,76225254017,-3,770,1647,20
76226991020,76226991020,0,2647,2959,20
76227110163,76227110159,-4,1063,2443,20
76227460870,76227460868,-2,1363,2807,20
76229463262,76229463259,-3,1073,2298,20
76231718475,76231718474,-1,1901,2488,20
76232385302,76232385298,-4,1391,2250,20
76234621630,76234621626,-4,1256,2207,20
76236239142,76236239140,-2,961,1910,20
76236278802,76236278800,-2,1047,2487,20
76237852030,76237852025,-5,1253,2529,20
76239111446,76239111443,-3,997,2471,20
76239780009,76239780005,-4,889,2374,20
76244024210,76244024208,-2,1452,2607,20
76247099679,76247099677,-2,1202,1797,20
76247499123,76247499121,-2,1054,2014,20
76248127206,76248127202,-4,1114,2993,20
76252923957,76252923954,-3,1382,2750,20
76255274895,76255274893,-2,858,1088,20
76256021904,76256021905,1,15802,17048,20
76263721034,76263721051,17,983,2667,20
76264143558,76264143556,-2,818,1427,20
76265180718,76265180703,-15,1003,2295,20
76266054090,76266054094,4,9615,4250,20
76271767133,76271767129,-4,918,2279,20
76275954753,76275954750,-3,708,1764,20
76278314158,76278314154,-4,1241,1868,20
76280859182,76280859178,-4,1045,2580,20
76286037635,76286037637,2,872,1231,20
76289521486,76289521483,-3,1158,2098,20
76298743142,76298743138,-4,1412,2819,20
76299983725,76299983705,-20,778,1938,20
76307214566,76307214563,-3,1024,2090,20
76308257955,76308257953,-2,1175,2974,20
76309052459,76309052457,-2,620,3232,20
76311271991,76311271988,-3,1330,2262,20
76315167153,76315167149,-4,1263,2131,20
76317597805,76317597801,-4,1114,1964,20
76320760805,76320760803,-2,664,1307,20
76324157941,76324157943,2,1402,1596,20
76328025927,76328025923,-4,1384,2785,20
76331447833,76331447831,-2,1070,1163,20
76331938137,76331938135,-2,1326,2847,20
76332515069,76332515053,-16,1040,2722,20
76333401222,76333401218,-4,2206,4367,20
76337321657,76337321657,0,1188,2151,20
76337365751,76337365750,-1,745,1983,20
76337681795,76337681793,-2,1661,3254,20
76338156480,76338156494,14,223,1024,20
76339808302,76339808296,-6,1049,2311,20
76345462992,76345462990,-2,1052,1833,20
76348540120,76348540125,5,2977,1354,20
76352015786,76352015782,-4,1186,1777,20
76355541394,76355541392,-2,1248,2762,20
76361258708,76361258705,-3,1180,2563,20
76361318540,76361318525,-15,1132,2073,20
76361840567,76361840582,15,747,2271,20
76362414869,76362414869,0,1231,1459,20
76365093698,76365093695,-3,1599,3235,20
76368708314,76368708312,-2,1286,1768,20
76369864703,76369864701,-2,1125,2489,20
76369946755,76369946749,-6,1448,2840,20
76371028315,76371028313,-2,750,2204,20
76380410638,76380410636,-2,1087,2102,20
76381004430,76381004432,2,2935,2330,20
76381839110,76381839114,4,1553,1412,20
76384573719,76384573715,-4,1287,2558,20
76385753461,76385753457,-4,799,2783,20
76388798722,76388798718,-4,1720,3755,20
76396515331,76396515329,-2,1159,2454,20
76398815950,76398815945,-5,1110,3113,20
76400976161,76400976159,-2,3381,4512,20
76406357734,76406357729,-5,1142,2762,20
76407592166,76407592163,-3,744,1658,20
76409003091,76409003090,-1,1027,2083,20
76411056413,76411056410,-3,951,2279,20
76413296055,76413296052,-3,758,2548,20
76414141354,76414141349,-5,1428,2262,20
76422299491,76422299489,-2,991,2508,20
76422865911,76422865930,19,1503,3470,20
76423354398,76423354381,-17,61,778,20
76423631810,76423631809,-1,2366,3007,20
76424084167,76424084161,-6,942,2566,20
76425016330,76425016326,-4,1626,3818,20
76425801071,76425801069,-2,831,1931,20
76426933165,76426933161,-4,1388,2529,20
76428083718,76428083715,-3,1328,2707,20
76428544846,76428544845,-1,833,2801,20
76429075475,76429075474,-1,1334,2639,20
76429650996,76429650993,-3,1062,2303,20
76430694708,76430694702,-6,1167,2745,20
76430723967,76430723945,-22,697,2328,20
76431975189,76431975184,-5,1500,2479,20
76433655477,76433655474,-3,1453,2409,20
76434141501,76434141498,-3,1211,2341,20
76439496166,76439496165,-1,1023,2112,20
76440283830,76440283826,-4,1218,3117,20
76444696369,76444696366,-3,1530,2101,20
76449915861,76449915858,-3,1310,2357,20
76452030613,76452030610,-3,1064,2545,20
76454226430,76454226428,-2,1152,2031,20
76454556513,76454556509,-4,967,3308,20
76455241914,76455241912,-2,1441,2105,20
76461560939,76461560935,-4,1162,2996,20
76465852096,76465852094,-2,1247,2481,20
76468123029,76468123026,-3,1182,2339,20
76468797278,76468797276,-2,1476,2327,20
76473779691,76473779689,-2,1249,1920,20
76474453366,76474453364,-2,1209,1799,20
76480918068,76480918064,-4,1500,2098,20
76485505043,76485505048,5,1935,1509,20
76486349823,76486349822,-1,1160,2032,20
76489577092,76489577098,6,3540,1095,20
76490834881,76490834878,-3,1058,2444,20
76492655690,76492655689,-1,1138,2653,20
76493078119,76493078118,-1,1529,2652,20
76501745357,76501745353,-4,973,2632,20
76502048836,76502048838,2,2755,1407,20
76502666916,76502666913,-3,1033,2525,20
76503843354,76503843354,0,1063,2090,20
76506096293,76506096289,-4,934,2094,20
76506539539,76506539535,-4,1140,2873,20
76506588520,76506588518,-2,1339,2376,20
76512883591,76512883586,-5,1145,2937,20
76513072199,76513072192,-7,865,3453,20
76523605466,76523605473,7,9592,2647,20
76524261923,76524261922,-1,1368,2880,20
76529448329,76529448328,-1,1213,2470,20
76532199410,76532199406,-4,927,2560,20
76533441342,76533441340,-2,1337,3455,20
76540925842,76540925851,9,16923,19156,20
76555312058,76555312057,-1,1027,2434,20
76556634807,76556634805,-2,822,1941,20
76559507328,76559507325,-3,1088,2028,20
76560341681,76560341678,-3,1270,2765,20
76562364824,76562364823,-1,1213,1817,20
76565568727,76565568723,-4,1510,2784,20
76572537702,76572537699,-3,736,2241,20
76575042301,76575042298,-3,818,1238,20
76577273429,76577273426,-3,1031,2556,20
76581617730,76581617735,5,1712,708,20
76587721757,76587721752,-5,906,1927,20
76589711940,76589711936,-4,1136,2198,20
76595852928,76595852925,-3,1077,2854,20
76596037031,76596037027,-4,1560,3324,20
76596905800,76596905797,-3,1089,3412,20
76597378477,76597378473,-4,60,1745,20
76599489118,76599489114,-4,1250,2294,20
76601948794,76601948790,-4,1355,3305,20
76606912809,76606912807,-2,1250,2800,20
76607345246,76607345242,-4,1049,2384,20
76609473991,76609473990,-1,1197,1629,20
76611637921,76611637919,-2,1790,2907,20
76613714802,76613714798,-4,663,1674,20
76620856555,76620856550,-5,1214,2368,20
76625685654,76625685650,-4,1197,2107,20
76625970399,76625970397,-2,1007,1507,20
76629018434,76629018432,-2,676,1289,20
76631145307,76631145307,0,1311,1903,20
76631225711,76631225709,-2,1105,2001,20
76634827158,76634827157,-1,2649,4935,20
76643793505,76643793526,21,1045,2139,20
76650617781,76650617776,-5,1348,2640,20
76651356115,76651356114,-1,1322,2116,20
76652043455,76652043458,3,944,1693,20
76652205164,76652205157,-7,1408,5579,20
76653724806,76653724802,-4,1540,2824,20
76656281915,76656281912,-3,1435,2465,20
76661721206,76661721216,10,966,2186,20
76664285504,76664285499,-5,1039,2248,20
76664385653,76664385652,-1,17120,7575,20
76667177885,76667177881,-4,1424,3155,20
76670413521,76670413519,-2,1944,2608,20
76673237576,76673237577,1,1882,2238,20
76677781366,76677781365,-1,7514,12839,20
76694631650,76694631645,-5,628,1095,20
76696177791,76696177786,-5,1200,2652,20
76700131710,76700131708,-2,1139,2021,20
76702661210,76702661208,-2,947,2204,20
76703392659,76703392655,-4,423,1627,20
76703631909,76703631898,-11,1078,3186,20
76705008814,76705008809,-5,1317,2477,20
76705337895,76705337890,-5,900,2219,20
76709827858,76709827856,-2,1197,2502,20
76710484258,76710484254,-4,952,2226,20
76713535785,76713535782,-3,791,1688,20
76714449983,76714449978,-5,723,2221,20
76715592348,76715592350,2,1564,1434,20
76715775194,76715775207,13,1073,1293,20
76723222014,76723222010,-4,677,1574,20
76728661121,76728661127,6,20622,28985,20
76729413869,76729413867,-2,1454,2338,20
76729838565,76729838562,-3,1148,3235,20
76730231372,76730231369,-3,1107,2753,20
76731324243,76731324239,-4,1204,2618,20
76733817087,76733817082,-5,1026,4567,20
76733930919,76733930918,-1,1012,3002,20
76734519414,76734519411,-3,1682,2395,20
76735411083,76735411081,-2,1234,2161,20
76735984045,76735984042,-3,1188,2573,20
76737046067,76737046063,-4,1315,2045,20
76737412126,76737412124,-2,1095,2148,20
76738865714,76738865711,-3,1197,2347,20
76739010118,76739010134,16,633,1559,20
76748934031,76748934028,-3,1599,2409,20
76755513270,76755513290,20,2907,1419,20
76756356123,76756356118,-5,1030,2258,20
76757716606,76757716601,-5,1185,2357,20
76758826868,76758826866,-2,1627,2296,20
76762073662,76762073658,-4,1456,1806,20
76763620923,76763620923,0,720,1441,20
76766579345,76766579342,-3,1409,2860,20
76772426839,76772426837,-2,1080,2257,20
76782983382,76782983381,-1,850,2391,20
76784588582,76784588581,-1,962,2689,20
76788318949,76788318947,-2,1013,2448,20
76791205219,76791205215,-4,853,2741,20
76792242855,76792242835,-20,1516,3027,20
76792373118,76792373113,-5,626,1070,20
76792964791,76792964787,-4,1248,3257,20
76798641186,76798641183,-3,808,2338,20
76799075220,76799075215,-5,131,494,20
76805154018,76805154013,-5,1334,2330,20
76805242884,76805242879,-5,1117,3464,20
76807105551,76807105548,-3,1154,3002,20
76813331495,76813331493,-2,1114,2484,20
76815205228,76815205225,-3,986,2557,20
76815265304,76815265301,-3,1344,2586,20
76815759302,76815759301,-1,1159,1977,20
76816306014,76816306011,-3,1720,2520,20
76818203306,76818203310,4,2672,1784,20
76823514942,76823514939,-3,793,1783,20
76832789931,76832789928,-3,972,2029,20
76837797058,76837797055,-3,957,2647,20
76838553441,76838553441,0,964,2034,20
76840143070,76840143070,0,1036,2544,20
76845573127,76845573122,-5,1071,2404,20
76847625565,76847625570,5,1903,1078,20
76848683506,76848683505,-1,1475,1776,20
76849262187,76849262181,-6,726,1264,20
76851060499,76851060502,3,1609,1152,20
76852054071,76852054070,-1,783,1435,20
76863972790,76863972790,0,1207,2296,20
76864443383,76864443390,7,8781,3922,20
76872249135,76872249133,-2,1370,2482,20
76872565269,76872565267,-2,1037,2218,20
76873883680,76873883679,-1,1586,2150,20
76874045758,76874045756,-2,1051,2270,20
76874504998,76874504991,-7,953,1030,20
76878196843,76878196842,-1,1254,1550,20
76881329579,76881329576,-3,1274,3030,20
76883642639,76883642637,-2,848,1898,20
76885108677,76885108667,-10,240,502,20
76885599522,76885599525,3,2422,1349,20
76886515379,76886515374,-5,1282,3953,20
76895464221,76895464217,-4,1678,3433,20
76898002659,76898002653,-6,1605,5228,20
76898123445,76898123462,17,1086,1920,20
76902736155,76902736150,-5,700,2141,20
76914367689,76914367686,-3,831,2032,20
76915434262,76915434266,4,4329,2788,20
76919584487,76919584483,-4,1315,1825,20
76920468089,76920468087,-2,869,2048,20
76921681147,76921681141,-6,974,1436,20
76922702197,76922702194,-3,1735,3262,20
76922901014,76922901011,-3,1271,2875,20
76923164078,76923164076,-2,1262,2033,20
76923669161,76923669162,1,1589,1259,20
76926092529,76926092528,-1,1131,3123,20
76932347269,76932347267,-2,734,2092,20
76935029766,76935029766,0,1399,2213,20
76935408306,76935408306,0,764,2243,20
76935548149,76935548162,13,122,884,20
76936425827,76936425822,-5,1179,2715,20
76937705915,76937705912,-3,1472,3704,20
76946192834,76946192829,-5,1022,2638,20
76946292262,76946292281,19,1537,2246,20
76946792659,76946792656,-3,908,2640,20
76949116653,76949116647,-6,704,996,20
76960372197,76960372194,-3,819,2433,20
76962829262,76962829259,-3,1233,2246,20
76966325675,76966325671,-4,786,2254,20
76967423015,76967423021,6,2407,1272,20
76971904800,76971904797,-3,104221,57740,20
76973605629,76973605623,-6,1023,5659,20
76982309163,76982309156,-7,1383,3657,20
76984661056,76984661053,-3,813,2638,20
76984814642,76984814637,-5,1071,2587,20
76986731529,76986731525,-4,1512,2095,20
76987276446,76987276445,-1,951,2550,20
76987381067,76987381064,-3,1151,2582,20
76990720171,76990720168,-3,1305,3280,20
76992577526,76992577523,-3,910,2287,20
76998956705,76998956701,-4,949,2321,20
77002341710,77002341709,-1,1003,2025,20
77005500192,77005500189,-3,1278,2335,20
77005886941,77005886936,-5,998,3314,20
77016987754,77016987751,-3,962,2712,20
77018069282,77018069282,0,1042,1983,20
77019096439,77019096437,-2,972,2088,20
77019423711,77019423709,-2,1264,2081,20
77029168765,77029168761,-4,2002,6367,20
77031591811,77031591808,-3,972,2185,20
77035534162,77035534159,-3,1193,3182,20
77041449665,77041449661,-4,977,2209,20
77043261407,77043261405,-2,1208,2799,20
77048668804,77048668802,-2,907,1999,20
77051096651,77051096648,-3,882,2067,20
77058071014,77058071010,-4,1007,2275,20
77061098022,77061098020,-2,869,2445,20
77062160632,77062160630,-2,1152,2870,20
77064214098,77064214095,-3,1305,2021,20
77068454245,77068454242,-3,1208,2363,20
77068503186,77068503184,-2,1196,1979,20
77070004683,77070004681,-2,1090,1636,20
77073102835,77073102831,-4,1282,2831,20
77073616170,77073616168,-2,1112,2197,20
77074626411,77074626410,-1,1628,2700,20
77074796114,77074796114,0,1392,1086,20
77077943847,77077943849,2,2150,2129,20
77078173486,77078173482,-4,890,2319,20
77078869511,77078869510,-1,1181,2231,20
77080888686,77080888684,-2,1533,2721,20
77081664398,77081664398,0,1717,2255,20
77081929741,77081929737,-4,999,1569,20
77083751858,77083751855,-3,1573,3275,20
77087370554,77087370551,-3,756,2165,20
77090346446,77090346442,-4,856,2004,20
77097748746,77097748743,-3,1150,2942,20
77098491288,77098491285,-3,1094,2378,20
77098677858,77098677854,-4,1172,2457,20
77103275714,77103275709,-5,875,2514,20
77103466343,77103466336,-7,877,1861,20
77113365026,77113365023,-3,1005,2568,20
77114208909,77114208906,-3,1012,2414,20
77114709110,77114709108,-2,1194,2222,20
77116589501,77116589498,-3,1075,1675,20
77117061807,77117061804,-3,1175,2138,20
77118063882,77118063884,2,1729,2353,20
77119337433,77119337431,-2,1432,2317,20
77122567816,77122567813,-3,2041,6330,20
77125309182,77125309178,-4,1262,2105,20
77127557429,77127557429,0,2378,2504,20
77128276210,77128276206,-4,809,2285,20
77132443951,77132443950,-1,1108,2171,20
77135779119,77135779117,-2,721,2159,20
77138908907,77138908904,-3,697,1492,20
77144013333,77144013331,-2,1450,2814,20
77145141551,77145141548,-3,898,2312,20
77147849662,77147849660,-2,1276,2735,20
77150215806,77150215802,-4,1476,2078,20
77150989286,77150989286,0,1064,1674,20
77155922068,77155922067,-1,994,1443,20
77159495009,77159495006,-3,1015,3039,20
77159804437,77159804433,-4,1111,1994,20
77162109415,77162109410,-5,938,1614,20
77165607214,77165607212,-2,971,1615,20
77167675801,77167675797,-4,998,2258,20
77170328034,77170328050,16,1120,2588,20
77177144842,77177144841,-1,1528,2474,20
77179805242,77179805240,-2,907,1805,20
77181983518,77181983517,-1,493,1890,20
77182289543,77182289539,-4,905,1533,20
77182637719,77182637717,-2,1114,2308,20
77186506991,77186506989,-2,985,1601,20
77190068627,77190068622,-5,884,1772,20
77200999837,77200999834,-3,1164,2261,20
77202880376,77202880373,-3,1320,2149,20
77210368441,77210368438,-3,1263,3191,20
77210813194,77210813193,-1,1665,2431,20
77222598995,77222598993,-2,1168,3510,20
77226095706,77226095704,-2,1139,2055,20
77228041433,77228041442,9,3983,1063,20
77231829795,77231829793,-2,508,1477,20
77234485399,77234485402,3,1610,2100,20
77235482758,77235482763,5,1187,667,20
77236285908,77236285905,-3,1329,2363,20
77238458821,77238458817,-4,1452,2143,20
77238685698,77238685694,-4,1169,2236,20
77238778694,77238778688,-6,1557,2437,20
77241009529,77241009525,-4,1283,2648,20
77243776699,77243776694,-5,961,2547,20
77244027951,77244027949,-2,1008,2751,20
77248536057,77248536054,-3,1191,2329,20
77249354227,77249354224,-3,1063,2131,20
77250278114,77250278119,5,6080,3206,20
77250358583,77250358581,-2,1100,1742,20
77250726926,77250726923,-3,1209,2597,20
77262797787,77262797785,-2,1229,2670,20
77262899419,77262899418,-1,869,2025,20
77264608898,77264608897,-1,1221,1669,20
77271490491,77271490488,-3,1504,3252,20
77275579533,77275579530,-3,1112,2469,20
77280462435,77280462434,-1,1175,2046,20
77282529274,77282529269,-5,1135,1924,20
77282865094,77282865093,-1,1293,2398,20
77283610191,77283610188,-3,1202,2337,20
77283885115,77283885112,-3,948,2147,20
77284047049,77284047046,-3,988,2135,20
77286118742,77286118738,-4,820,2305,20
77287699818,77287699817,-1,1573,2250,20
77288426213,77288426217,4,2681,1399,20
77290185401,77290185398,-3,1537,2452,20
77291983120,77291983118,-2,1084,2788,20
77293477847,77293477842,-5,1206,2601,20
77293630662,77293630665,3,1923,1777,20
77294634753,77294634756,3,3425,2974,20
77297247186,77297247182,-4,1367,2442,20
77298801876,77298801870,-6,898,2321,20
77301327376,77301327374,-2,1270,1893,20
77306089325,77306089331,6,2445,938,20
77313571225,77313571245,20,1026,2222,20
77315694197,77315694197,0,516,1039,20
77322615633,77322615629,-4,1252,3441,20
77331837311,77331837310,-1,913,1943,20
77334489030,77334489028,-2,1063,1201,20
77339104953,77339104950,-3,24085,10363,20
77341380381,77341380378,-3,836,1507,20
77342758042,77342758042,0,1302,2378,20
77345836806,77345836811,5,1418,1295,20
77348030235,77348030215,-20,1645,2740,20
77348493389,77348493396,7,3466,1377,20
77348887754,77348887753,-1,1394,1980,20
77349352622,77349352619,-3,733,2083,20
77351303389,77351303386,-3,2024,2721,20
77351932694,77351932694,0,1145,1523,20
77352812307,77352812305,-2,1101,2171,20
77354107649,77354107648,-1,1256,1853,20
77355874938,77355874936,-2,612,1721,20
77356302399,77356302405,6,177,1202,20
77361989127,77361989126,-1,1626,2334,20
77366592106,77366592105,-1,1075,2074,20
77368371323,77368371321,-2,1233,3039,20
77373277431,77373277427,-4,1549,2877,20
77374967477,77374967474,-3,1516,2254,20
77377425496,77377425494,-2,1818,3032,20
77378219357,77378219354,-3,1109,2306,20
77378913819,77378913818,-1,984,2532,20
77381164755,77381164749,-6,831,2398,20
77383275580,77383275575,-5,929,2297,20
77387246439,77387246442,3,3050,1187,20
77391760563,77391760559,-4,1293,3196,20
77393634222,77393634218,-4,724,1452,20
77398569657,77398569654,-3,915,2838,20
77401056298,77401056303,5,1696,1163,20
77403696250,77403696247,-3,1323,2755,20
77404353574,77404353570,-4,1602,2754,20
77406082068,77406082065,-3,1859,3234,20
77409439579,77409439579,0,1164,1927,20
77411219775,77411219771,-4,682,1637,20
77411327028,77411327024,-4,1092,1625,20
77416108771,77416108767,-4,719,1410,20
77416233263,77416233262,-1,955,1320,20
77416659370,77416659367,-3,1023,2422,20
77422595428,77422595426,-2,1498,2459,20
77422930117,77422930114,-3,1154,3653,20
77425185501,77425185497,-4,1548,3147,20
77425258236,77425258234,-2,1506,3655,20
77425862947,77425862946,-1,1200,1423,20
77429806182,77429806179,-3,984,2642,20
77430304758,77430304756,-2,1298,1696,20
77436120251,77436120251,0,1416,2298,20
77441201238,77441201238,0,612,1929,20
77444123250,77444123248,-2,1429,2751,20
77445138487,77445138481,-6,1293,2285,20
77445815131,77445815127,-4,1226,2163,20
77446464447,77446464446,-1,862,975,20
77447697816,77447697822,6,1625,1106,20
77449613822,77449613826,4,5099,2931,20
77461089737,77461089735,-2,1054,1668,20
77461311997,77461312003,6,114,705,20
77463322278,77463322276,-2,791,2642,20
77473654561,77473654558,-3,1234,1971,20
77476114943,77476114942,-1,695,2306,20
77477721993,77477721994,1,1438,1655,20
77478891829,77478891826,-3,1114,1343,20
77482542678,77482542674,-4,956,1984,20
77486177618,77486177614,-4,1434,3008,20
77486575125,77486575122,-3,1190,1861,20
77489089918,77489089914,-4,1479,3424,20
77489194869,77489194888,19,350,1566,20
77489699678,77489699676,-2,617,1593,20
77492616937,77492616942,5,4834,3298,20
77494130920,77494130918,-2,1301,2619,20
77494795646,77494795645,-1,1163,2281,20
77495252070,77495252066,-4,992,1930,20
77495315237,77495315233,-4,1729,3232,20
77502851487,77502851485,-2,1223,2285,20
77504663946,77504663943,-3,1371,2702,20
77512215225,77512215222,-3,1043,1970,20
77517897299,77517897295,-4,1448,2303,20
77520561172,77520561168,-4,881,2014,20
77525929926,77525929922,-4,923,2044,20
77525964512,77525964526,14,1036,1390,20
77526322670,77526322670,0,1205,1805,20
77527555771,77527555766,-5,1224,3583,20
77536028905,77536028911,6,3219,1156,20
77537174067,77537174064,-3,1470,2850,20
77539430660,77539430655,-5,840,1846,20
77540515077,77540515076,-1,612,1970,20
77540780543,77540780540,-3,890,2261,20
77544416049,77544416046,-3,882,2749,20
77544894148,77544894132,-16,605,1662,20
77547604213,77547604210,-3,975,2542,20
77547803725,77547803710,-15,1203,2453,20
77553681290,77553681287,-3,1241,3652,20
77556557183,77556557180,-3,801,2252,20
77565706626,77565706620,-6,976,2646,20
77565953530,77565953530,0,1353,2503,20
77569959794,77569959790,-4,814,2320,20
77570385614,77570385610,-4,1249,2107,20
77571331347,77571331342,-5,951,2025,20
77572136543,77572136538,-5,1147,2389,20
77572813508,77572813512,4,344,849,20
77578504187,77578504181,-6,31684,15229,20
77579114622,77579114609,-13,1008,2758,20
77582480875,77582480872,-3,688,2467,20
77583769207,77583769203,-4,1021,2139,20
77594293070,77594293066,-4,1044,2245,20
77596702303,77596702300,-3,1868,3258,20
77597447050,77597447047,-3,1080,2414,20
77598617130,77598617129,-1,1186,2584,20
77599353756,77599353740,-16,359,1150,20
77599838341,77599838363,22,701,1995,20
77605470482,77605470477,-5,980,1821,20
77605558006,77605557986,-20,1092,1856,20
77610224783,77610224778,-5,1311,2951,20
77611761575,77611761571,-4,758,1414,20
77611866093,77611866114,21,957,2435,20
77617658905,77617658897,-8,1099,3420,20
77618255092,77618255088,-4,1147,2365,20
77623018753,77623018750,-3,1518,2514,20
77623085346,77623085345,-1,1044,1726,20
77623743583,77623743581,-2,1544,2552,20
77623886134,77623886128,-6,1117,3063,20
77624127755,77624127751,-4,1248,2657,20
77631389970,77631389967,-3,1552,3444,20
77636515205,77636515202,-3,765,1850,20
77650798437,77650798437,0,1256,2578,20
77653064294,77653064290,-4,1201,2475,20
77653422462,77653422458,-4,1305,3456,20
77653730613,77653730606,-7,1123,1857,20
77656588006,77656588004,-2,918,1518,20
77662138576,77662138590,14,14388,51988,20
77663603829,77663603825,-4,1714,2809,20
77665117236,77665117233,-3,1199,3096,20
77665655534,77665655518,-16,1137,2225,20
77665716279,77665716258,-21,48,989,20
77667587509,77667587506,-3,1644,3074,20
77670361972,77670361969,-3,1293,2358,20
77670488566,77670488564,-2,1486,2073,20
77672700771,77672700769,-2,807,2321,20
77673775860,77673775878,18,1027,1681,20
77674021348,77674021363,15,253,937,20
77680829490,77680829497,7,2845,1621,20
77682231760,77682231758,-2,1139,2200,20
77683418474,77683418470,-4,975,1926,20
77683449504,77683449517,13,429,896,20
77687488271,77687488269,-2,1117,1914,20
77690354111,77690354108,-3,1191,2350,20
77693329161,77693329157,-4,1822,6508,20
77695666547,77695666542,-5,1015,2102,20
77701302611,77701302607,-4,1140,2206,20
77704563545,77704563550,5,1292,807,20
77706480979,77706480975,-4,1031,1745,20
77711145414,77711145410,-4,1355,1734,20
77712904054,77712904054,0,1385,1971,20
77719888107,77719888104,-3,1488,1741,20
77722400470,77722400465,-5,2082,6867,20
77724194030,77724194027,-3,1442,2526,20
77724605968,77724605963,-5,1121,2813,20
77724992488,77724992498,10,397,786,20
77725157214,77725157213,-1,1114,2185,20
77728122759,77728122757,-2,915,2219,20
77730474122,77730474121,-1,1510,2030,20
77731472478,77731472478,0,1150,1468,20
77736201534,77736201533,-1,1309,1505,20
77742720266,77742720262,-4,1388,2449,20
77743175786,77743175785,-1,1050,2577,20
77748319577,77748319585,8,13980,52259,20
77758311279,77758311277,-2,949,1971,20
77758571317,77758571315,-2,392,754,20
77771370401,77771370399,-2,935,1849,20
77771642778,77771642776,-2,935,1841,20
77772271291,77772271288,-3,1103,2166,20
77777032100,77777032094,-6,1087,2404,20
77777660701,77777660702,1,639,1355,20
77779117394,77779117390,-4,1070,2251,20
77784515741,77784515741,0,1034,2516,20
77784566942,77784566940,-2,1257,2542,20
77790667287,77790667284,-3,870,2090,20
77790970847,77790970847,0,1609,2612,20
77791484109,77791484106,-3,1295,2290,20
77793788678,77793788669,-9,837,3779,20
77799948659,77799948651,-8,698,3776,20
77800655573,77800655581,8,2,1298,20
77807584842,77807584839,-3,1114,2699,20
77809232968,77809232965,-3,867,1490,20
77809782902,77809782902,0,1229,1421,20
77812346378,77812346386,8,1335,190,20
77817061757,77817061763,6,6404,2486,20
77818695963,77818695957,-6,33107,2066,20
77822744129,77822744126,-3,992,2214,20
77822930965,77822930984,19,617,2053,20
77823942673,77823942665,-8,1798,7202,20
77825166713,77825166707,-6,1021,3825,20
77832748559,77832748557,-2,1486,1974,20
77832852118,77832852119,1,200,1663,20
77832884735,77832884722,-13,1453,3335,20
77835149206,77835149201,-5,1024,3739,20
77838152458,77838152453,-5,1022,3580,20
77839562477,77839562497,20,1056,2162,20
77839839590,77839839595,5,29187,37707,20
77845210053,77845210050,-3,908,1994,20
77846728974,77846728970,-4,1537,2572,20
77848162545,77848162543,-2,1041,1720,20
77849442910,77849442910,0,2154,1896,20
77850834002,77850833998,-4,948,2576,20
77853907519,77853907498,-21,1079,3184,20
77855897843,77855897840,-3,2044,2504,20
77860352374,77860352371,-3,1404,1647,20
77862326775,77862326771,-4,1255,3102,20
77866696194,77866696194,0,1114,1962,20
77874492211,77874492209,-2,951,1414,20
77878205394,77878205391,-3,612,2034,20
77882838194,77882838190,-4,992,2235,20
77882962727,77882962745,18,1058,2034,20
77893495090,77893495093,3,4248,17144,20
77896014246,77896014250,4,2377,1488,20
77899582981,77899582977,-4,892,3242,20
77901413815,77901413812,-3,1201,2294,20
77913414543,77913414541,-2,925,2661,20
77916383771,77916383769,-2,1561,2852,20
77918032410,77918032406,-4,965,2991,20
77918243102,77918243119,17,181,695,20
77922124123,77922124122,-1,1059,2285,20
77924825043,77924825038,-5,965,1687,20
77929322442,77929322443,1,574,882,20
77929990826,77929990825,-1,843,1996,20
77933305314,77933305310,-4,946,2186,20
77940911609,77940911604,-5,645,1976,20
77948269928,77948269925,-3,1103,1590,20
77948578831,77948578824,-7,1389,2876,20
77949362275,77949362273,-2,1220,2336,20
77949425897,77949425895,-2,653,895,20
77951889246,77951889251,5,2659,1384,20
77954310231,77954310229,-2,1081,2140,20
77958492613,77958492610,-3,1561,2860,20
77962414237,77962414235,-2,951,1902,20
77964122139,77964122135,-4,1073,2093,20
77967002278,77967002278,0,1238,1411,20
77967765703,77967765701,-2,1236,3262,20
77967995084,77967995082,-2,1130,2919,20
77968882425,77968882422,-3,1052,1408,20
77973498085,77973498087,2,1419,881,20
77974172231,77974172230,-1,795,2038,20
77975848730,77975848726,-4,19970,15867,20
77976110509,77976110506,-3,1144,3020,20
77976985152,77976985149,-3,1036,2319,20
77978545938,77978545935,-3,1452,2518,20
77979230605,77979230600,-5,1611,2554,20
77979409141,77979409136,-5,1354,3235,20
77981395625,77981395621,-4,870,1893,20
77982631137,77982631135,-2,1422,2905,20
77987077643,77987077641,-2,963,2079,20
77988142263,77988142260,-3,1343,2989,20
77994449042,77994449037,-5,1085,3254,20
77994584036,77994584017,-19,190,862,20
78002465939,78002465937,-2,1483,2020,20
78004608954,78004608949,-5,818,2171,20
78009699597,78009699603,6,2495,1105,20
78012221667,78012221663,-4,963,1953,20
78015914368,78015914366,-2,1573,3043,20
78017156479,78017156478,-1,1577,1426,20
78018824694,78018824691,-3,1043,2426,20
78022798451,78022798446,-5,780,2394,20
78023749261,78023749258,-3,1191,3355,20
78024614705,78024614702,-3,1475,2339,20
78033355381,78033355383,2,1501,1342,20
78034272011,78034272009,-2,1112,1235,20
78037814253,78037814248,-5,1406,2951,20
78049410778,78049410775,-3,1463,2665,20
78051898902,78051898901,-1,868,2111,20
78052845461,78052845458,-3,999,2558,20
78056780970,78056780969,-1,1183,2575,20
78065310867,78065310864,-3,1142,2959,20
78070865622,78070865622,0,1005,2620,20
78079340703,78079340699,-4,807,3139,20
78079806322,78079806320,-2,988,2583,20
78081087171,78081087168,-3,1190,2476,20
78083389905,78083389902,-3,1067,2253,20
78094786198,78094786195,-3,1179,3088,20
78095361286,78095361287,1,1501,1639,20
78096599598,78096599595,-3,772,1708,20
78096900347,78096900342,-5,986,1689,20
78098832847,78098832838,-9,274,647,20
78099412757,78099412774,17,924,1892,20
78112204656,78112204653,-3,843,2482,20
78113833837,78113833834,-3,1237,2589,20
78114323456,78114323456,0,1727,1529,20
78114844136,78114844153,17,1089,2478,20
78115671827,78115671822,-5,1026,2991,20
78122697846,78122697842,-4,1465,2854,20
78124379845,78124379841,-4,1231,2026,20
78124924669,78124924653,-16,1520,1556,20
78128804650,78128804649,-1,777,1913,20
78129082974,78129082990,16,1037,2468,20
78129222282,78129222281,-1,975,1731,20
78131731566,78131731566,0,1417,1658,20
78131908616,78131908633,17,883,2284,20
78140996407,78140996403,-4,808,2201,20
78141375250,78141375247,-3,1020,2712,20
78144080045,78144080041,-4,1073,2484,20
78145667458,78145667457,-1,882,2364,20
78145802514,78145802513,-1,1046,2171,20
78150165318,78150165316,-2,1233,2079,20
78151669153,78151669149,-4,1070,2574,20
78152464343,78152464358,15,792,1422,20
78159526253,78159526250,-3,261,421,20
78160824364,78160824362,-2,1378,2818,20
78168314094,78168314094,0,820,1299,20
78168730530,78168730525,-5,1335,2316,20
78171437209,78171437206,-3,1098,2431,20
78172882521,78172882526,5,2665,1619,20
78174537227,78174537225,-2,1083,2280,20
78181235567,78181235566,-1,2046,3340,20
78182481549,78182481546,-3,1246,2548,20
78182971833,78182971830,-3,1365,2020,20
78185250946,78185250953,7,5160,1589,20
78187058858,78187058855,-3,1508,2567,20
78189759834,78189759829,-5,688,1844,20
78191093054,78191093073,19,887,1771,20
78191349509,78191349507,-2,193,647,20
78193283778,78193283775,-3,1121,2402,20
78193653684,78193653683,-1,36,1406,20
78195274630,78195274622,-8,1404,3789,20
78195308168,78195308166,-2,1335,2442,20
78195853569,78195853566,-3,1057,2963,20
78198209704,78198209702,-2,1014,2115,20
78200947527,78200947527,0,1440,1870,20
78203127886,78203127884,-2,1120,2351,20
78203581414,78203581403,-11,797,2096,20
78204023568,78204023584,16,471,1875,20
78204792950,78204792949,-1,729,1218,20
78213843915,78213843912,-3,1374,2070,20
78215301842,78215301859,17,710,943,20
78222641803,78222641806,3,1627,1637,20
78228843431,78228843430,-1,996,1956,20
78229404450,78229404446,-4,1327,1980,20
78230562998,78230562996,-2,1123,2174,20
78231739887,78231739884,-3,810,1840,20
78236199632,78236199629,-3,1312,2835,20
78240209785,78240209781,-4,953,2856,20
78241768330,78241768326,-4,1552,3182,20
78243730966,78243730962,-4,912,2781,20
78245207327,78245207320,-7,3901,33345,20
78248298919,78248298916,-3,1292,2425,20
78250243692,78250243690,-2,837,1661,20
78253643993,78253644011,18,1061,1499,20
78253971246,78253971241,-5,1198,2333,20
78259716392,78259716392,0,1173,2710,20
78263762127,78263762124,-3,1094,2753,20
78273779995,78273779994,-1,1212,1681,20
78275434911,78275434906,-5,1138,2130,20
78281126638,78281126633,-5,1256,5208,20
78290428483,78290428485,2,1135,1133,20
78297311815,78297311813,-2,992,1371,20
78299691864,78299691860,-4,1885,2603,20
78300377850,78300377851,1,674,1428,20
78302097769,78302097770,1,921,1439,20
78323363500,78323363503,3,8101,19789,20
78328461390,78328461389,-1,909,1754,20
78339868387,78339868407,20,1005,1817,20
78339922476,78339922465,-11,505,1264,20
78343566743,78343566738,-5,1137,2807,20
78345909652,78345909649,-3,1029,1815,20
78349419307,78349419306,-1,1151,2644,20
78351664638,78351664630,-8,64,3379,20
78363015018,78363015016,-2,1231,2302,20
78367812217,78367812216,-1,837,1817,20
78368174829,78368174818,-11,1485,2498,20
78369065845,78369065845,0,1325,2234,20
78371063643,78371063641,-2,1181,2862,20
78372652570,78372652567,-3,1464,2434,20
78378168902,78378168892,-10,823,7468,20
78388235403,78388235402,-1,938,1884,20
78389689387,78389689382,-5,812,2376,20
78392386025,78392386023,-2,997,2254,20
78393450834,78393450832,-2,1207,2342,20
78394286791,78394286786,-5,839,3288,20
78401637621,78401637619,-2,1403,3118,20
78406774570,78406774568,-2,658,2089,20
78409053888,78409053885,-3,924,2155,20
78410325680,78410325677,-3,1317,2307,20
78423313184,78423313184,0,1489,1770,20
78431133791,78431133789,-2,1729,2685,20
78431762215,78431762213,-2,782,1332,20
78433915259,78433915257,-2,1174,3091,20
78436935230,78436935227,-3,795,2395,20
78440517901,78440517906,5,2999,1796,20
78441283214,78441283211,-3,845,2091,20
78441610539,78441610533,-6,1758,5886,20
78442110915,78442110911,-4,1707,3096,20
78448073765,78448073762,-3,1153,2013,20
78449833979,78449833975,-4,773,1804,20
78455563214,78455563229,15,564,1436,20
78461965817,78461965817,0,1174,2206,20
78462354924,78462354906,-18,491,936,20
78463343614,78463343631,17,1178,2333,20
78463984790,78463984772,-18,915,1894,20
78464427037,78464427033,-4,991,1672,20
78474153694,78474153700,6,3135,901,20
78477591095,78477591093,-2,974,3314,20
78478187902,78478187880,-22,1192,2872,20
78482002183,78482002182,-1,1037,2893,20
78483568021,78483568018,-3,877,2881,20
78483829648,78483829666,18,560,976,20
78484564229,78484564247,18,3950,1409,20
78485541434,78485541433,-1,972,2045,20
78487735919,78487735914,-5,1111,2349,20
78487905651,78487905648,-3,897,2874,20
78491369574,78491369571,-3,820,1119,20
78491798138,78491798137,-1,659,1263,20
78494160873,78494160874,1,1626,1501,20
78495198098,78495198093,-5,1269,3078,20
78501307658,78501307655,-3,1143,3084,20
78503647086,78503647086,0,1079,1836,20
78503963450,78503963447,-3,466,1219,20
78504631822,78504631840,18,457,1476,20
78506706273,78506706271,-2,1306,2730,20
78512407390,78512407388,-2,1004,2086,20
78516143590,78516143598,8,3138,1287,20
78517876151,78517876148,-3,1127,2898,20
78521170575,78521170572,-3,1241,2360,20
78522327166,78522327161,-5,1508,7101,20
78522462518,78522462515,-3,1157,2410,20
78523784149,78523784145,-4,1007,2029,20
78523836312,78523836309,-3,1139,1808,20
78526534750,78526534753,3,2007,2141,20
78526890074,78526890071,-3,884,2407,20
78527813090,78527813097,7,1822,1025,20
78528146689,78528146683,-6,1425,1884,20
78532362670,78532362667,-3,1169,2064,20
78539617441,78539617442,1,1835,2109,20
78542629179,78542629174,-5,1280,2442,20
78543652560,78543652558,-2,1300,2321,20
78546839122,78546839121,-1,1194,2400,20
78550451330,78550451326,-4,1263,1959,20
78552757469,78552757467,-2,1049,1765,20
78556924894,78556924890,-4,1216,2661,20
78560045498,78560045497,-1,830,2083,20
78560740046,78560740026,-20,1095,927,20
78560865605,78560865611,6,3901,2136,20
78561804310,78561804306,-4,1026,2322,20
78563862905,78563862903,-2,1704,2532,20
78564988002,78564988001,-1,1459,2168,20
78569075849,78569075846,-3,1329,2375,20
78569294498,78569294495,-3,945,2032,20
78571572240,78571572236,-4,1276,2780,20
78571766422,78571766439,17,174,777,20
78572362538,78572362529,-9,878,7634,20
78584793326,78584793323,-3,1103,2501,20
78585134726,78585134719,-7,122,748,20
78589071379,78589071376,-3,1267,2640,20
78590871417,78590871421,4,2061,1148,20
78595167064,78595167061,-3,911,2245,20
78602649352,78602649349,-3,28099,13211,20
78602893292,78602893289,-3,1559,2390,20
78604154410,78604154408,-2,1685,2034,20
78605058102,78605058099,-3,1757,3142,20
78606217227,78606217222,-5,1060,1956,20
78610505339,78610505338,-1,687,996,20
78611557019,78611557017,-2,1048,1632,20
78621836806,78621836802,-4,1309,2744,20
78625494454,78625494453,-1,905,1301,20
78631462924,78631462930,6,2142,1861,20
78641252970,78641252973,3,1359,1336,20
78643201207,78643201184,-23,1152,1591,20
78647186559,78647186557,-2,974,2326,20
78651283486,78651283484,-2,1983,2886,20
78653033585,78653033582,-3,671,2498,20
78653147617,78653147616,-1,1121,2502,20
78654396536,78654396538,2,4026,3432,20
78654620123,78654620120,-3,1196,2933,20
78654833240,78654833237,-3,1461,2463,20
78660353027,78660353024,-3,954,1947,20
78661923075,78661923073,-2,724,1671,20
78662562329,78662562326,-3,1403,2914,20
78664002899,78664002896,-3,936,1575,20
78671949488,78671949484,-4,973,1944,20
78674925139,78674925135,-4,1060,1944,20
78675155739,78675155737,-2,1161,2107,20
78680161579,78680161577,-2,1156,2950,20
78680504991,78680504987,-4,1411,2236,20
78681867603,78681867604,1,1364,1684,20
78683713092,78683713088,-4,1255,2493,20
78684993918,78684993914,-4,1239,2521,20
78687371518,78687371515,-3,922,2170,20
78688360063,78688360060,-3,1406,2135,20
78691722947,78691722945,-2,1394,2389,20
78700917182,78700917181,-1,1230,1739,20
78703337550,78703337546,-4,1169,2654,20
78706614895,78706614891,-4,790,1931,20
78712598773,78712598769,-4,2039,3127,20
78715957167,78715957165,-2,1220,2663,20
78716402082,78716402082,0,1019,2035,20
78722232758,78722232753,-5,1509,1867,20
78728398144,78728398141,-3,1567,3636,20
78728448661,78728448678,17,735,1730,20
78729802234,78729802229,-5,1306,2611,20
78730850742,78730850749,7,5535,2244,20
78737277155,78737277152,-3,1359,3231,20
78737569886,78737569885,-1,1132,2094,20
78737667315,78737667321,6,2738,1107,20
78738440087,78738440083,-4,1223,2575,20
78743441482,78743441481,-1,1814,2537,20
78751932177,78751932199,22,3462,862,20
78753471750,78753471748,-2,1246,1919,20
78754001139,78754001138,-1,802,1994,20
78756346658,78756346657,-1,1074,1834,20
78756898062,78756898058,-4,1084,1550,20
78761078430,78761078422,-8,967,4493,20
78764298531,78764298528,-3,970,2478,20
78769340381,78769340388,7,4394,1653,20
78773395606,78773395610,4,838,1225,20
78774151760,78774151759,-1,836,1758,20
78774582469,78774582467,-2,1498,1707,20
78774693661,78774693683,22,223,815,20
78777007022,78777007019,-3,1167,2127,20
78778603950,78778603950,0,1273,1943,20
78779896114,78779896112,-2,963,2148,20
78780848747,78780848747,0,1716,2362,20
78786565415,78786565409,-6,779,2214,20
78789103591,78789103588,-3,1181,2469,20
78789640687,78789640694,7,1520,804,20
78790934294,78790934290,-4,1129,1768,20
78794250727,78794250726,-1,864,2517,20
78795314659,78795314658,-1,985,1867,20
78795412042,78795412041,-1,1510,1919,20
78799720477,78799720475,-2,1206,2037,20
78803894471,78803894467,-4,896,1570,20
78808881080,78808881079,-1,1634,2255,20
78812122991,78812122987,-4,1198,3397,20
78816223798,78816223794,-4,1345,2994,20
78817061582,78817061580,-2,1088,2234,20
78817094536,78817094549,13,518,1009,20
78821913867,78821913862,-5,959,2347,20
78822937532,78822937516,-16,1044,3187,20
78827347375,78827347378,3,19212,40968,20
78827768151,78827768150,-1,995,1781,20
78829002590,78829002582,-8,758,2419,20
78832524214,78832524213,-1,788,1990,20
78834861154,78834861152,-2,1355,2224,20
78842843210,78842843209,-1,895,2043,20
78847871843,78847871841,-2,1049,2553,20
78849107451,78849107450,-1,1369,1920,20
78850871602,78850871600,-2,991,2632,20
78856386607,78856386604,-3,1324,2392,20
78857061831,78857061826,-5,860,2574,20
78858505327,78858505331,4,24416,33307,20
78860577474,78860577470,-4,1621,2990,20
78861964558,78861964554,-4,943,2486,20
78862484998,78862485010,12,352,1289,20
78864926621,78864926618,-3,1209,1685,20
78870218807,78870218803,-4,1039,3050,20
78872522573,78872522570,-3,1578,2789,20
78873463750,78873463748,-2,1383,2009,20
78881434718,78881434722,4,4062,2237,20
78882172758,78882172755,-3,1415,2022,20
78882822647,78882822647,0,194,794,20
78887258027,78887258023,-4,868,2473,20
78891231431,78891231426,-5,1249,2779,20
78902027887,78902027886,-1,668,1495,20
78902260498,78902260494,-4,744,1162,20
78907207466,78907207465,-1,1158,2884,20
78908116722,78908116722,0,733,1885,20
78909178953,78909178950,-3,1277,2956,20
78909264824,78909264834,10,2033,905,20
78912429650,78912429646,-4,1232,3484,20
78916782878,78916782874,-4,1360,3316,20
78917435322,78917435321,-1,1419,3009,20
78918724874,78918724871,-3,1488,2772,20
78921445803,78921445800,-3,1124,2077,20
78922225607,78922225606,-1,1081,2105,20
78924816255,78924816255,0,1016,1483,20
78926664902,78926664902,0,1086,1687,20
78929786009,78929786016,7,3245,1536,20
78930590889,78930590887,-2,1630,3129,20
78930836645,78930836641,-4,843,2544,20
78930970494,78930970514,20,704,1600,20
78934426847,78934426853,6,1112,997,20
78935049850,78935049848,-2,1278,2233,20
78936369081,78936369074,-7,1014,2669,20
78937970298,78937970309,11,12918,51133,20
78938273539,78938273537,-2,662,1413,20
78940335207,78940335205,-2,764,1840,20
78940690669,78940690671,2,62,621,20
78942925038,78942925055,17,717,148,20
78947250847,78947250844,-3,1133,2563,20
78949273102,78949273099,-3,1245,2581,20
78952249073,78952249070,-3,1148,2299,20
78953249415,78953249415,0,1001,1183,20
78955009030,78955009030,0,970,1853,20
78960758478,78960758476,-2,858,1244,20
78964086410,78964086408,-2,752,1852,20
78972496485,78972496482,-3,1708,2618,20
78972612315,78972612309,-6,936,5261,20
78974540761,78974540761,0,1056,1843,20
78975023438,78975023439,1,1276,1049,20
78975866512,78975866510,-2,1046,2290,20
78977023867,78977023865,-2,1222,2307,20
78981930182,78981930177,-5,1833,3101,20
78986926510,78986926506,-4,664,1216,20
78990884362,78990884360,-2,1394,2239,20
78991320041,78991320038,-3,1040,2935,20
78994619751,78994619749,-2,826,1945,20
78995068535,78995068538,3,1848,1647,20
79000880728,79000880728,0,772,2058,20
79006452629,79006452626,-3,931,1623,20
79007925406,79007925405,-1,1564,2363,20
79010694717,79010694714,-3,1140,2114,20
79014611965,79014611960,-5,1138,2549,20
79014944011,79014944006,-5,942,3171,20
79016407982,79016407978,-4,1282,1646,20
79023097614,79023097611,-3,736,1307,20
79027690581,79027690578,-3,994,2166,20
79028935177,79028935176,-1,1225,2228,20
79029009955,79029009952,-3,1044,2293,20
79029441254,79029441246,-8,1165,3005,20
79030147645,79030147653,8,2726,1576,20
79036937246,79036937242,-4,1090,3047,20
79038248633,79038248630,-3,1196,2238,20
79038489421,79038489440,19,719,1977,20
79039171775,79039171773,-2,974,2580,20
79040562494,79040562490,-4,1019,1852,20
79043797608,79043797606,-2,847,1611,20
79052415370,79052415371,1,1870,2092,20
79056729549,79056729545,-4,1510,3005,20
79058983863,79058983861,-2,844,1765,20
79059067311,79059067317,6,254,636,20
79060123625,79060123623,-2,1000,2917,20
79062949194,79062949193,-1,1077,2324,20
79063442883,79063442880,-3,1295,1983,20
79074525567,79074525564,-3,1126,2343,20
79075417774,79075417776,2,1685,1333,20
79076085526,79076085531,5,1695,1597,20
79077557789,79077557788,-1,1488,1977,20
79079325581,79079325579,-2,1477,3493,20
79082868265,79082868261,-4,648,2290,20
79083564817,79083564814,-3,1026,1938,20
79088246166,79088246165,-1,1109,2114,20
79088380303,79088380323,20,959,2111,20
79091151983,79091152002,19,444,655,20
79092660390,79092660387,-3,1804,2662,20
79093049742,79093049741,-1,836,1684,20
79097403483,79097403479,-4,1154,2881,20
79097620124,79097620145,21,909,2551,20
79104516033,79104516041,8,3707,1952,20
79106916143,79106916140,-3,1057,1923,20
79110841474,79110841469,-5,1253,2207,20
79112426645,79112426630,-15,483,1020,20
79113379088,79113379105,17,985,2315,20
79114031613,79114031608,-5,1009,2451,20
79115367018,79115367018,0,1206,2406,20
79121962117,79121962113,-4,1255,2582,20
79123131907,79123131914,7,10208,30741,20
79124120811,79124120810,-1,785,1331,20
79127820805,79127820800,-5,826,3677,20
79130463835,79130463832,-3,1028,1981,20
79131058143,79131058158,15,529,1193,20
79133713879,79133713874,-5,1039,1796,20
79135313688,79135313685,-3,1414,2799,20
79138321936,79138321934,-2,908,1249,20
79138965418,79138965416,-2,1069,2137,20
79144149958,79144149958,0,826,1021,20
79144662575,79144662594,19,458,1316,20
79146509479,79146509475,-4,1110,1880,20
79146837768,79146837765,-3,1353,2286,20
79151814606,79151814604,-2,986,2529,20
79152213954,79152213951,-3,1053,2321,20
79156620937,79156620933,-4,1263,1901,20
79157255339,79157255334,-5,716,2887,20
79159103703,79159103699,-4,767,1022,20
79160292445,79160292464,19,907,2363,20
79160641294,79160641290,-4,990,3050,20
79161295365,79161295345,-20,1179,2160,20
79163018070,79163018063,-7,1389,4952,20
79164233788,79164233809,21,431,1798,20
79171876908,79171876906,-2,1632,2131,20
79172772781,79172772771,-10,987,2487,20
79173633398,79173633377,-21,76,5586,20
79173832822,79173832815,-7,882,1910,20
79178329538,79178329535,-3,1525,2640,20
79180923956,79180923951,-5,1053,2397,20
79183999841,79183999841,0,1744,2492,20
79185970038,79185970036,-2,1031,1890,20
79187558619,79187558628,9,13436,27975,20
79188007675,79188007672,-3,1561,2649,20
79188111359,79188111357,-2,1432,2455,20
79188662598,79188662596,-2,1030,2825,20
79188876271,79188876265,-6,584,1321,20
79198801962,79198801957,-5,1252,3289,20
79199452306,79199452304,-2,1506,3249,20
79201181633,79201181629,-4,1828,2905,20
79203668927,79203668921,-6,1203,3388,20
79203726570,79203726567,-3,1020,3198,20
79204918063,79204918061,-2,1306,2906,20
79205970436,79205970443,7,59558,23518,20
79206859147,79206859144,-3,1496,2815,20
79206901533,79206901530,-3,939,2257,20
79207344356,79207344340,-16,923,2103,20
79208734053,79208734049,-4,915,1945,20
79213754998,79213754998,0,1100,2125,20
79215909166,79215909145,-21,1437,2153,20
79232103094,79232103088,-6,1924,5458,20
79232307926,79232307922,-4,728,1238,20
79242540571,79242540570,-1,1284,2303,20
79243144230,79243144226,-4,803,2752,20
79248869226,79248869226,0,1830,1379,20
79256008437,79256008434,-3,943,2063,20
79257286298,79257286296,-2,944,1973,20
79267113035,79267113033,-2,1106,2029,20
79268842994,79268842992,-2,1044,2266,20
79271883743,79271883739,-4,1060,2100,20
79274574674,79274574673,-1,1058,2015,20
79274977134,79274977131,-3,1103,2348,20
79276843455,79276843452,-3,1026,1909,20
79277137757,79277137753,-4,319,2435,20
79279979925,79279979922,-3,692,1594,20
79280793837,79280793829,-8,1997,1161,20
79287711549,79287711545,-4,1344,2716,20
79293400394,79293400393,-1,1294,1994,20
79296754169,79296754166,-3,1766,2240,20
79298060629,79298060626,-3,1667,3024,20
79300438001,79300437997,-4,1077,2284,20
79304247390,79304247388,-2,875,1383,20
79305005801,79305005799,-2,824,2514,20
79307714881,79307714878,-3,577,1062,20
79309263978,79309263974,-4,1503,2784,20
79311642950,79311642946,-4,742,2246,20
79312394235,79312394233,-2,1038,1354,20
79312958326,79312958327,1,864,1427,20
79316036102,79316036098,-4,871,1338,20
79316475284,79316475279,-5,1102,2739,20
79322267738,79322267734,-4,1250,3450,20
79322924778,79322924776,-2,1395,2295,20
79323362907,79323362902,-5,1578,2534,20
79323475696,79323475694,-2,1497,2286,20
79324912741,79324912738,-3,1050,2271,20
79325397186,79325397186,0,1500,2015,20
79330044143,79330044140,-3,972,2650,20
79330818807,79330818788,-19,1178,2525,20
79334232371,79334232369,-2,1001,2288,20
79339630670,79339630668,-2,1448,2069,20
79339707014,79339707019,5,3223,1521,20
79343631257,79343631253,-4,744,1397,20
79344060671,79344060678,7,2777,1285,20
79345721022,79345721019,-3,1216,2066,20
79347453567,79347453562,-5,1850,2679,20
79349973073,79349973070,-3,1062,2132,20
79350400342,79350400341,-1,150,1524,20
79355014624,79355014622,-2,1312,3372,20
79356101869,79356101868,-1,986,2003,20
79356943109,79356943107,-2,959,1831,20
79362131051,79362131047,-4,1221,2522,20
79362349376,79362349391,15,13,1179,20
79362392084,79362392106,22,750,2147,20
79369919221,79369919220,-1,1198,2338,20
79371223738,79371223723,-15,6107,27009,20
79375278422,79375278420,-2,1510,2584,20
79376290135,79376290135,0,1460,1299,20
79378004590,79378004589,-1,1223,2711,20
79379890902,79379890898,-4,1592,2777,20
79385788305,79385788302,-3,1440,2956,20
79387204917,79387204914,-3,1055,1866,20
79389300158,79389300164,6,1139,666,20
79394337795,79394337790,-5,1118,1877,20
79395188450,79395188446,-4,993,1763,20
79397971067,79397971064,-3,1161,2604,20
79401117503,79401117499,-4,1130,2043,20
79401174941,79401174936,-5,997,3060,20
79404369279,79404369274,-5,1358,2139,20
79406024847,79406024845,-2,1289,2332,20
79407476635,79407476631,-4,1437,1745,20
79408417834,79408417829,-5,1342,2799,20
79408874442,79408874441,-1,2058,2249,20
79411639065,79411639063,-2,915,2001,20
79417346226,79417346230,4,2413,1951,20
79417492762,79417492761,-1,1649,2324,20
79421873813,79421873812,-1,1232,1768,20
79423271125,79423271116,-9,1303,2918,20
79425671813,79425671811,-2,1264,2261,20
79429809699,79429809703,4,1552,1108,20
79432557398,79432557395,-3,1059,2481,20
79435438809,79435438806,-3,1417,2346,20
79436696154,79436696150,-4,814,1798,20
79436797359,79436797376,17,1353,2961,20
79439452615,79439452611,-4,1222,2166,20
79440850074,79440850069,-5,1728,2907,20
79442470668,79442470665,-3,1099,2296,20
79458139661,79458139657,-4,1024,2255,20
79458472089,79458472086,-3,820,2214,20
79461231686,79461231684,-2,1093,2808,20
79462224915,79462224909,-6,1466,2353,20
79463371079,79463371079,0,808,1716,20
79463925038,79463925035,-3,1300,3043,20
79465150023,79465150006,-17,248,1248,20
79467995646,79467995643,-3,1000,1647,20
79471428085,79471428083,-2,1537,3536,20
79474310073,79474310069,-4,1277,3255,20
79482073030,79482073027,-3,1037,2205,20
79484629053,79484629061,8,3386,799,20
79486020210,79486020207,-3,1278,2144,20
79488362551,79488362546,-5,1328,2131,20
79489417161,79489417158,-3,1218,1887,20
79490402446,79490402442,-4,1242,1690,20
79491687251,79491687249,-2,1343,1943,20
79495657393,79495657390,-3,1114,2132,20
79500191962,79500191970,8,4080,1598,20
79503222575,79503222574,-1,958,2897,20
79504638388,79504638383,-5,1033,2697,20
79505275759,79505275749,-10,981,3554,20
79505734325,79505734313,-12,188,1070,20
79506450414,79506450410,-4,778,2035,20
79506721684,79506721667,-17,291,834,20
79508724320,79508724319,-1,1106,2477,20
79509012599,79509012597,-2,797,1922,20
79515130506,79515130503,-3,931,1839,20
79516020259,79516020257,-2,999,2458,20
79516643797,79516643802,5,6631,22987,20
79520078609,79520078606,-3,982,2196,20
79523173301,79523173297,-4,869,2659,20
79541397557,79541397554,-3,1677,2376,20
79543150400,79543150418,18,1714,3448,20
79543458357,79543458338,-19,771,1267,20
79544931203,79544931201,-2,1268,2336,20
79545317569,79545317567,-2,2747,4417,20
79547319990,79547319986,-4,992,2509,20
79558701958,79558701954,-4,1970,3540,20
79561767256,79561767258,2,2973,1912,20
79562590566,79562590573,7,7684,2655,20
79567434187,79567434182,-5,1479,2325,20
79570003434,79570003441,7,2566,1211,20
79571590749,79571590745,-4,872,2662,20
79572630090,79572630086,-4,1743,2993,20
79581492410,79581492410,0,1554,1441,20
79585084946,79585084943,-3,1724,2665,20
79588319897,79588319902,5,3939,1617,20
79589303705,79589303701,-4,955,1591,20
79593608971,79593608966,-5,897,2761,20
79595589063,79595589061,-2,1023,2446,20
79598258206,79598258198,-8,544,3525,20
79601602450,79601602449,-1,1207,2076,20
79603259553,79603259549,-4,1019,1885,20
79606710447,79606710445,-2,1205,1873,20
79607909870,79607909869,-1,685,1505,20
79611847747,79611847744,-3,1156,2466,20
79622788218,79622788217,-1,1261,2699,20
79624058419,79624058416,-3,1286,2283,20
79628042814,79628042810,-4,892,2560,20
79629958917,79629958914,-3,1050,2150,20
79630080246,79630080244,-2,1173,2292,20
79631744927,79631744923,-4,884,2840,20
79636920673,79636920695,22,1454,1462,20
79638414119,79638414116,-3,1289,2813,20
79640818172,79640818166,-6,1211,2064,20
79643871510,79643871507,-3,1513,3226,20
79645438345,79645438342,-3,1069,2066,20
79645713820,79645713813,-7,2307,8268,20
79652469993,79652469990,-3,1001,1952,20
79654604446,79654604450,4,1362,1270,20
79661150691,79661150686,-5,902,2107,20
79662284181,79662284163,-18,1541,2038,20
79662881779,79662881777,-2,910,2082,20
79665255292,79665255289,-3,1237,1967,20
79667346274,79667346270,-4,1123,2838,20
79674762818,79674762815,-3,1501,1965,20
79677878466,79677878462,-4,1493,2713,20
79678830383,79678830378,-5,1205,2638,20
79680927376,79680927374,-2,1093,2082,20
79683492294,79683492292,-2,1459,3282,20
79684744450,79684744450,0,1087,1903,20
79686346370,79686346367,-3,994,1939,20
79689791643,79689791648,5,1918,1906,20
79692020047,79692020042,-5,1408,2762,20
79701658078,79701658070,-8,1150,5721,20
79701977689,79701977686,-3,945,2132,20
79704146082,79704146076,-6,1017,2457,20
79713912727,79713912726,-1,1253,2152,20
79714979294,79714979302,8,14429,24665,20
79717323241,79717323238,-3,2335,4797,20
79721278651,79721278650,-1,1457,2166,20
79728438368,79728438365,-3,1092,2980,20
79728758958,79728758957,-1,518,1611,20
79730205127,79730205130,3,4390,2455,20
79731302430,79731302429,-1,1460,2484,20
79734101818,79734101818,0,1614,2079,20
79734173174,79734173172,-2,1000,2687,20
79735582883,79735582880,-3,1205,1990,20
79737039153,79737039153,0,3151,3682,20
79738048082,79738048080,-2,833,1304,20
79741420063,79741420062,-1,1593,3267,20
79742014668,79742014674,6,1724,624,20
79742591413,79742591412,-1,1075,2176,20
79744468182,79744468178,-4,1059,3126,20
79744633847,79744633846,-1,1071,1903,20
79753699741,79753699738,-3,792,2666,20
79758051009,79758051005,-4,1023,2248,20
79758327655,79758327653,-2,1101,2365,20
79759100260,79759100259,-1,2149,2139,20
79760354987,79760354981,-6,1561,10030,20
79762104221,79762104219,-2,1055,2484,20
79762524293,79762524302,9,184,811,20
79763466122,79763466119,-3,1245,3005,20
79764173745,79764173741,-4,1390,3091,20
79766213554,79766213553,-1,1063,2146,20
79770290109,79770290106,-3,947,2467,20
79773902343,79773902341,-2,1031,1685,20
79774703359,79774703355,-4,1358,2242,20
79774810617,79774810618,1,1423,1660,20
79783701792,79783701790,-2,1456,2616,20
79785072833,79785072832,-1,1210,2195,20
79791364494,79791364489,-5,1108,2330,20
79793474179,79793474175,-4,1182,2387,20
79796189673,79796189671,-2,1133,2051,20
79806313130,79806313126,-4,876,1835,20
79806987392,79806987389,-3,1407,2623,20
79808599352,79808599347,-5,433,709,20
79814109741,79814109737,-4,1491,2838,20
79815646407,79815646405,-2,1131,2526,20
79818678322,79818678319,-3,994,2297,20
79820466995,79820466993,-2,1181,1868,20
79827099467,79827099464,-3,1145,1926,20
79827653560,79827653558,-2,878,2301,20
79830428996,79830429010,14,16991,39430,20
79832600779,79832600774,-5,980,2830,20
79833435435,79833435433,-2,2053,3211,20
79833777127,79833777123,-4,838,1685,20
79834255522,79834255518,-4,1015,3106,20
79834766550,79834766530,-20,1114,2757,20
79834983102,79834983083,-19,978,2721,20
79835850835,79835850831,-4,1068,1509,20
79837434564,79837434583,19,266,950,20
79841585841,79841585837,-4,859,1423,20
79842137381,79842137386,5,199,683,20
79863849702,79863849703,1,3199,2963,20
79865213508,79865213506,-2,911,2478,20
79866440041,79866440037,-4,1024,1731,20
79867930166,79867930164,-2,1599,2248,20
79872280544,79872280542,-2,1723,2608,20
79885329587,79885329584,-3,1549,2939,20
79889052441,79889052437,-4,841,1986,20
79892513658,79892513655,-3,1342,2668,20
79895586238,79895586234,-4,861,1514,20
79901431638,79901431634,-4,1615,2955,20
79904686131,79904686127,-4,991,1804,20
79905237700,79905237696,-4,1746,2770,20
79906925402,79906925399,-3,1189,2701,20
79918391893,79918391889,-4,1085,2424,20
79918554926,79918554937,11,461,2146,20
79918915176,79918915174,-2,785,2258,20
79920035411,79920035407,-4,1105,1794,20
79923777265,79923777262,-3,1134,2959,20
79925015120,79925015113,-7,1441,4211,20
79934915358,79934915354,-4,1500,2310,20
79935380933,79935380953,20,1333,1860,20
79939968315,79939968311,-4,1236,3077,20
79945656328,79945656326,-2,1761,2902,20
79950506922,79950506918,-4,1435,2578,20
79954571974,79954571971,-3,1151,2188,20
79954721619,79954721615,-4,1126,1933,20
79957350881,79957350887,6,3284,1819,20
79960592021,79960592019,-2,714,2899,20
79964464329,79964464335,6,4112,933,20
79965111447,79965111444,-3,1337,3042,20
79966125901,79966125900,-1,1230,1847,20
79966792040,79966792036,-4,1232,2012,20
79967671934,79967671929,-5,984,2215,20
79976321062,79976321062,0,815,1955,20
79989987935,79989987933,-2,826,1324,20
79993527270,79993527264,-6,999,2185,20
79995148495,79995148494,-1,880,1073,20
79995484453,79995484450,-3,1297,1759,20
79996625848,79996625846,-2,1239,3224,20
80006159278,80006159277,-1,1181,2407,20
80006427802,80006427806,4,2429,1744,20
80009557395,80009557393,-2,2146,3874,20
80011104524,80011104521,-3,1269,3103,20
80013580295,80013580291,-4,1668,2725,20
80015659639,80015659646,7,5307,1762,20
80018813190,80018813189,-1,1049,1663,20
80019485698,80019485697,-1,973,2817,20
80021718235,80021718233,-2,725,1608,20
80022200761,80022200759,-2,1112,1674,20
80023094447,80023094467,20,1583,2975,20
80026770825,80026770822,-3,1129,1629,20
80027814341,80027814338,-3,1113,2644,20
80029274783,80029274781,-2,828,1779,20
80031554676,80031554673,-3,1276,3071,20
80035388190,80035388189,-1,1406,1751,20
80037510091,80037510086,-5,775,2721,20
80040959747,80040959756,9,14166,25321,20
80041803610,80041803619,9,816,1557,20
80045097151,80045097147,-4,1031,2111,20
80045627538,80045627534,-4,856,2129,20
80050699930,80050699929,-1,1111,1486,20
80059402556,80059402553,-3,1378,2830,20
80060657222,80060657218,-4,1528,2223,20
80061004554,80061004557,3,1517,1641,20
80061596084,80061596089,5,3589,1612,20
80064381953,80064381954,1,718,2031,20
80067677618,80067677622,4,1885,1252,20
80067810937,80067810936,-1,974,2180,20
80071365734,80071365732,-2,5439,11533,20
80072342867,80072342866,-1,1300,3091,20
80073184151,80073184148,-3,946,2436,20
80081629286,80081629285,-1,1296,1755,20
80091979894,80091979889,-5,1230,3242,20
80094630584,80094630582,-2,1293,3534,20
80099256031,80099256037,6,3378,1766,20
80099324338,80099324335,-3,939,1818,20
80103080022,80103080021,-1,1593,3262,20
80104612298,80104612294,-4,1228,2863,20
80107361119,80107361117,-2,1298,2186,20
80108166870,80108166886,16,514,1347,20
80111942936,80111942934,-2,1391,1501,20
80112155035,80112155042,7,3610,1143,20
80112961084,80112961083,-1,1283,1784,20
80113529482,80113529478,-4,762,2438,20
80114554007,80114554005,-2,1537,2728,20
80116933843,80116933842,-1,1137,2224,20
80120977559,80120977554,-5,985,2634,20
80122756300,80122756298,-2,804,1276,20
80131936345,80131936351,6,35,1175,20
80133653190,80133653190,0,1172,2231,20
80133840778,80133840773,-5,689,2284,20
80135104513,80135104510,-3,703,1618,20
80135580812,80135580809,-3,1195,2348,20
80137781800,80137781796,-4,1798,5999,20
80138500390,80138500390,0,1515,2062,20
80139810188,80139810208,20,1000,1802,20
80140750138,80140750137,-1,948,2593,20
80141255415,80141255416,1,878,943,20
80142653074,80142653072,-2,1010,2112,20
80143816880,80143816876,-4,1147,1975,20
80149433506,80149433505,-1,741,2499,20
80155789522,80155789519,-3,873,1917,20
80159413502,80159413498,-4,1002,1939,20
80162910282,80162910281,-1,1313,2314,20
80168391662,80168391657,-5,1005,2845,20
80169718239,80169718238,-1,1139,1544,20
80170767830,80170767824,-6,961,4656,20
80171820257,80171820251,-6,745,1598,20
80180018681,80180018682,1,11442,11858,20
80184224460,80184224457,-3,1308,1797,20
80184532261,80184532283,22,952,2802,20
80189604514,80189604513,-1,864,2417,20
80192871141,80192871139,-2,1066,2165,20
80195948867,80195948865,-2,1139,3235,20
80198225759,80198225766,7,13151,20533,20
80208691727,80208691723,-4,1175,1999,20
80211952067,80211952062,-5,1423,4093,20
80212068485,80212068482,-3,1185,3276,20
80212389069,80212389066,-3,1036,2303,20
80216171961,80216171966,5,42315,27577,20
80218249226,80218249224,-2,1025,1896,20
80219116125,80219116120,-5,122,518,20
80226676248,80226676244,-4,865,2264,20
80226785472,80226785462,-10,10,632,20
80228527029,80228527026,-3,1379,2496,20
80228903623,80228903618,-5,1237,2358,20
80236409046,80236409042,-4,866,1817,20
80241876027,80241876025,-2,811,1332,20
80246010258,80246010259,1,1198,1572,20
80247426856,80247426870,14,171,658,20
80248064930,80248064912,-18,2360,1938,20
80252676090,80252676086,-4,909,1958,20
80264907895,80264907893,-2,624,2326,20
80265478355,80265478351,-4,1358,2338,20
80267645746,80267645746,0,1265,1699,20
80267945216,80267945215,-1,1260,2001,20
80270611718,80270611714,-4,553,2068,20
80272938823,80272938819,-4,830,1632,20
80285853351,80285853349,-2,1222,2092,20
80286222466,80286222462,-4,1308,2911,20
80289038401,80289038398,-3,1059,2212,20
80289066885,80289066902,17,358,1420,20
80294909220,80294909216,-4,1326,2564,20
80295048782,80295048781,-1,1217,2601,20
80298921511,80298921507,-4,1089,1864,20
80303359308,80303359310,2,1616,1998,20
80306619709,80306619704,-5,1140,2076,20
80309579029,80309579026,-3,891,1993,20
80310436094,80310436094,0,2018,3583,20
80314396309,80314396305,-4,1163,2776,20
80315251958,80315251954,-4,1214,2989,20
80315320525,80315320545,20,356,1488,20
80320166187,80320166186,-1,1430,1896,20
80334125262,80334125258,-4,1354,3499,20
80337710283,80337710281,-2,1210,2290,20
80340658614,80340658610,-4,1291,2232,20
80341382433,80341382428,-5,974,2413,20
80343292106,80343292109,3,10293,9118,20
80345136091,80345136085,-6,1154,3244,20
80351154829,80351154825,-4,1941,3781,20
80353101234,80353101230,-4,1262,2743,20
80354914900,80354914899,-1,878,1300,20
80355725374,80355725371,-3,1184,3409,20
80361435786,80361435783,-3,1146,1990,20
80378162576,80378162573,-3,1592,3662,20
80382325415,80382325413,-2,766,1674,20
80382828896,80382828893,-3,858,1695,20
80384544696,80384544712,16,1140,2443,20
80388090735,80388090730,-5,1115,2326,20
80389316274,80389316272,-2,1334,2941,20
80390345393,80390345390,-3,1190,2146,20
80391020751,80391020749,-2,902,1433,20
80395606946,80395606945,-1,1044,1696,20
80399322986,80399322984,-2,1312,2057,20
80399908474,80399908471,-3,840,1609,20
80401906827,80401906823,-4,1017,2845,20
80402064051,80402064049,-2,1527,2523,20
80402510370,80402510371,1,2088,1800,20
80418902289,80418902286,-3,618,1669,20
80419327446,80419327426,-20,73,780,20
80419429365,80419429361,-4,952,2402,20
80427899978,80427899975,-3,1470,2412,20
80428498000,80428497997,-3,1044,2693,20
80429624617,80429624614,-3,1309,2322,20
80431823641,80431823642,1,2181,1724,20
80434839394,80434839393,-1,963,1990,20
80436359099,80436359098,-1,810,1681,20
80436904389,80436904386,-3,1154,2867,20
80442049701,80442049698,-3,1357,2343,20
80447021701,80447021699,-2,1075,1993,20
80455101378,80455101375,-3,948,1924,20
80456410529,80456410525,-4,1035,2108,20
80460624762,80460624762,0,1315,1466,20
80462032455,80462032451,-4,1129,1733,20
80462069245,80462069263,18,217,1073,20
80462578055,80462578050,-5,1127,2558,20
80469307815,80469307822,7,3966,2553,20
80469336677,80469336674,-3,1181,2255,20
80472236505,80472236500,-5,1270,2779,20
80474669030,80474669026,-4,961,1398,20
80474847037,80474847026,-11,1051,1521,20
80478611314,80478611322,8,2289,1038,20
80479608747,80479608745,-2,832,1819,20
80479955550,80479955547,-3,1199,2109,20
80482121641,80482121663,22,769,3972,20
80484121202,80484121200,-2,1308,1954,20
80484398517,80484398510,-7,1159,3658,20
80484874509,80484874523,14,1552,7011,20
80485855795,80485855794,-1,921,1703,20
80486936861,80486936858,-3,796,1441,20
80487695328,80487695325,-3,1190,2412,20
80488033037,80488033035,-2,1084,1934,20
80497340071,80497340069,-2,1278,2804,20
80497559944,80497559941,-3,1130,2162,20
80499338809,80499338805,-4,1123,3050,20
80499796563,80499796561,-2,1226,2827,20
80502319882,80502319887,5,2930,837,20
80503094182,80503094177,-5,1204,1834,20
80506884264,80506884268,4,2710,2292,20
80508012499,80508012496,-3,888,1945,20
80510968295,80510968291,-4,1362,2760,20
80511226197,80511226193,-4,986,2474,20
80511497135,80511497123,-12,323,574,20
80511721182,80511721178,-4,1171,2975,20
80513347598,80513347603,5,2964,1370,20
80515823643,80515823642,-1,758,2036,20
80517734673,80517734670,-3,1045,2124,20
80524157741,80524157738,-3,991,1086,20
80529002465,80529002461,-4,915,1939,20
80531849582,80531849581,-1,1276,2444,20
80534017974,80534017974,0,1257,2610,20
80535793546,80535793543,-3,1053,2212,20
80537716827,80537716831,4,2088,1132,20
80538297245,80538297243,-2,1664,2834,20
80541005307,80541005312,5,1381,1131,20
80544564424,80544564422,-2,1887,2211,20
80545331870,80545331870,0,893,1612,20
80547875073,80547875070,-3,845,1987,20
80551521244,80551521242,-2,1217,2354,20
80555812514,80555812512,-2,1767,2999,20
80557903255,80557903251,-4,1217,2511,20
80558223498,80558223494,-4,1024,2323,20
80558765486,80558765507,21,540,2896,20
80559157627,80559157626,-1,744,1830,20
80560239007,80560239005,-2,1112,2846,20
80562089414,80562089419,5,2413,1456,20
80570037499,80570037497,-2,1349,3584,20
80570167130,80570167126,-4,1184,2188,20
80574726044,80574726048,4,2560,1866,20
80580605758,80580605754,-4,1022,2586,20
80580668870,80580668868,-2,1166,1650,20
80586913849,80586913847,-2,1117,1524,20
80595909590,80595909591,1,1638,1379,20
80597683250,80597683249,-1,1256,3251,20
80598859082,80598859088,6,4772,2448,20
80599676809,80599676807,-2,1078,2440,20
80604381326,80604381323,-3,1652,2972,20
80606278370,80606278368,-2,506,1251,20
80608702275,80608702275,0,1306,1760,20
80611890437,80611890434,-3,1180,2605,20
80612719003,80612719000,-3,877,1842,20
80612749213,80612749234,21,1506,4063,20
80613438917,80613438911,-6,1221,2926,20
80623212389,80623212385,-4,2465,5730,20
80623274085,80623274081,-4,1064,3077,20
80626322633,80626322630,-3,1753,2651,20
80626541919,80626541939,20,335,1331,20
80629961608,80629961606,-2,1144,1980,20
80635986224,80635986219,-5,1471,1827,20
80636258491,80636258485,-6,1081,2196,20
80637766564,80637766561,-3,1281,1925,20
80638631762,80638631758,-4,1060,2742,20
80644945990,80644945986,-4,1092,2594,20
80649647410,80649647407,-3,1374,2238,20
80655492674,80655492671,-3,1126,2445,20
80655685450,80655685456,6,2824,1843,20
80656732443,80656732439,-4,853,1216,20
80666835794,80666835793,-1,4564,6571,20
80667672966,80667672965,-1,1079,2245,20
80674759562,80674759561,-1,1069,1872,20
80676514591,80676514589,-2,1031,2489,20
80678169120,80678169127,7,2829,1382,20
80680469031,80680469026,-5,1232,3282,20
80681664642,80681664639,-3,975,2957,20
80681996242,80681996238,-4,2163,4873,20
80683726535,80683726530,-5,1030,1265,20
80683883518,80683883538,20,711,1479,20
80686254718,80686254717,-1,867,1359,20
80686962870,80686962869,-1,1384,2495,20
80688905895,80688905894,-1,745,1123,20
80689820661,80689820659,-2,1110,2023,20
80697234733,80697234746,13,14679,33464,20
80705417322,80705417318,-4,1028,2375,20
80706872607,80706872604,-3,1536,2619,20
80709957839,80709957835,-4,538,1177,20
80710926262,80710926262,0,1397,1079,20
80711210781,80711210778,-3,1151,1841,20
80713013802,80713013798,-4,1095,2520,20
80713178607,80713178594,-13,997,2068,20
80714618202,80714618198,-4,1143,3252,20
80717262863,80717262859,-4,806,2262,20
80719441545,80719441539,-6,776,2038,20
80719478909,80719478925,16,457,2980,20
80720041574,80720041572,-2,1632,1915,20
80722617476,80722617474,-2,1395,2634,20
80722948955,80722948953,-2,921,1852,20
80724312157,80724312154,-3,1236,2843,20
80727731633,80727731634,1,3630,3574,20
80730242995,80730242990,-5,1160,2967,20
80733086286,80733086284,-2,1488,3048,20
80733562842,80733562838,-4,1320,2877,20
80735316170,80735316171,1,1464,1421,20
80739746192,80739746189,-3,1044,2374,20
80739910422,80739910413,-9,868,2324,20
80740326466,80740326466,0,1307,1501,20
80742371990,80742371989,-1,801,1992,20
80743959898,80743959896,-2,1200,2339,20
80746511516,80746511514,-2,793,2280,20
80748873582,80748873578,-4,1210,2681,20
80749196571,80749196566,-5,1309,2257,20
80752267075,80752267071,-4,1144,1787,20
80752371540,80752371524,-16,850,2045,20
80753909795,80753909794,-1,1673,1934,20
80755063790,80755063789,-1,1388,2484,20
80759258147,80759258145,-2,1030,2154,20
80762790211,80762790208,-3,1249,3168,20
80765428450,80765428447,-3,901,2201,20
80768066915,80768066913,-2,546,1569,20
80768325583,80768325578,-5,1202,1846,20
80771641974,80771641973,-1,1019,2119,20
80772519765,80772519763,-2,1229,1629,20
80775486758,80775486762,4,1807,1334,20
80778128304,80778128302,-2,982,2724,20
80780388399,80780388398,-1,1076,2035,20
80782622694,80782622691,-3,959,2511,20
80784221777,80784221773,-4,1365,2369,20
80786196446,80786196442,-4,1283,1739,20
80789047324,80789047321,-3,1280,1968,20
80790189604,80790189590,-14,1483,2390,20
80796919552,80796919550,-2,1364,2339,20
80798596477,80798596474,-3,953,1730,20
80798975221,80798975218,-3,830,1629,20
80800897859,80800897857,-2,943,2074,20
80801927028,80801927024,-4,1493,2982,20
80804355938,80804355937,-1,1497,2111,20
80812346911,80812346908,-3,931,1601,20
80814002888,80814002902,14,1215,2626,20
80814824226,80814824234,8,9283,3342,20
80817118158,80817118153,-5,790,2611,20
80818448962,80818448959,-3,974,2058,20
80822737126,80822737125,-1,1087,2436,20
80824268258,80824268255,-3,831,2518,20
80828371961,80828371958,-3,976,1970,20
80828490438,80828490435,-3,1320,2832,20
80835127759,80835127758,-1,924,2204,20
80836573534,80836573532,-2,1039,1963,20
80841585186,80841585188,2,1194,1832,20
80843515365,80843515366,1,886,2213,20
80846402651,80846402647,-4,634,2330,20
80847920771,80847920769,-2,1024,3045,20
80850368905,80850368911,6,55740,104541,20
80854524311,80854524306,-5,1164,2755,20
80854657005,80854656994,-11,122,965,20
80864074029,80864074035,6,3422,1917,20
80865139106,80865139102,-4,897,2866,20
80866969616,80866969610,-6,1129,3287,20
80867533842,80867533838,-4,1147,2538,20
80868570557,80868570554,-3,1378,2453,20
80869248678,80869248674,-4,708,1674,20
80871154598,80871154594,-4,792,2273,20
80873158860,80873158861,1,1185,1702,20
80878534090,80878534086,-4,1416,2698,20
80881273907,80881273905,-2,1185,1805,20
80883329538,80883329537,-1,1185,1779,20
80884579238,80884579233,-5,779,1856,20
80890448426,80890448423,-3,1040,2296,20
80896695296,80896695293,-3,1709,2356,20
80897407819,80897407817,-2,1464,1993,20
80897573349,80897573347,-2,647,1345,20
80900927836,80900927832,-4,808,1905,20
80902807414,80902807411,-3,1357,1419,20
80906691683,80906691682,-1,1296,1526,20
80908710302,80908710302,0,907,1715,20
80911177117,80911177114,-3,628,1500,20
80912555155,80912555151,-4,894,2223,20
80913596384,80913596382,-2,968,1388,20
80914106808,80914106805,-3,1415,2484,20
80918966981,80918966979,-2,2391,2389,20
80919804626,80919804622,-4,911,2159,20
80920020743,80920020734,-9,1411,2511,20
80920145088,80920145102,14,47,1125,20
80922195311,80922195307,-4,554,1616,20
80923903171,80923903166,-5,1392,2303,20
80926516384,80926516377,-7,1265,2553,20
80927761963,80927761958,-5,995,1374,20
80933086034,80933086031,-3,1150,2236,20
80933643441,80933643438,-3,1233,2774,20
80939483566,80939483562,-4,1069,2423,20
80945558893,80945558889,-4,1127,2740,20
80945691120,80945691118,-2,1094,2229,20
80954359570,80954359566,-4,1041,2816,20
80955310370,80955310366,-4,1204,2397,20
80955372086,80955372083,-3,960,1522,20
80959010086,80959010081,-5,1517,2190,20
80962805743,80962805738,-5,1296,2730,20
80965191616,80965191613,-3,1367,3273,20
80966893447,80966893446,-1,991,1776,20
80967094067,80967094065,-2,1084,2694,20
80971794285,80971794288,3,2061,1631,20
80982344106,80982344104,-2,919,2076,20
80986655750,80986655750,0,981,1652,20
80987398525,80987398543,18,937,2770,20
80987561957,80987561946,-11,939,1939,20
80989838326,80989838320,-6,772,2128,20
80992018047,80992018045,-2,1099,1601,20
80992174454,80992174450,-4,1113,1972,20
80994801850,80994801847,-3,1081,2019,20
80995179042,80995179039,-3,1247,2700,20
80997783789,80997783789,0,833,1752,20
81000067985,81000067981,-4,1292,1958,20
81001455271,81001455268,-3,984,3075,20
81005314487,81005314484,-3,1083,1953,20
81007834445,81007834441,-4,871,1968,20
81011304322,81011304320,-2,1201,3409,20
81013376866,81013376867,1,1291,1776,20
81013795435,81013795430,-5,1194,2506,20
81018936605,81018936604,-1,875,1987,20
81021121287,81021121285,-2,927,2680,20
81025844441,81025844437,-4,1084,1644,20
81033717882,81033717878,-4,915,2349,20
81034705968,81034705965,-3,1255,3559,20
81043433367,81043433364,-3,852,4438,20
81045195189,81045195184,-5,1048,3394,20
81047928111,81047928110,-1,796,1534,20
81056527059,81056527056,-3,870,1996,20
81062752771,81062752777,6,2429,1801,20
81063134986,81063134984,-2,991,2877,20
81064064282,81064064282,0,1384,1747,20
81064146174,81064146173,-1,1432,2685,20
81065406645,81065406641,-4,895,1455,20
81065764704,81065764719,15,427,1009,20
81066599502,81066599499,-3,1239,2200,20
81067293469,81067293472,3,1667,1772,20
81073111209,81073111215,6,2878,1946,20
81074353614,81074353613,-1,1204,3220,20
81074378977,81074378975,-2,1823,3147,20
81074631304,81074631300,-4,1317,1650,20
81078050408,81078050405,-3,1371,2831,20
81078186064,81078186062,-2,1086,2244,20
81080419088,81080419084,-4,1059,2538,20
81090372313,81090372310,-3,1329,2460,20
81090760627,81090760624,-3,773,3393,20
81090823337,81090823332,-5,1058,3017,20
81091643508,81091643505,-3,1364,2516,20
81091933005,81091932999,-6,1203,3243,20
81093942846,81093942842,-4,1219,2058,20
81095444270,81095444273,3,7340,6259,20
81100123437,81100123435,-2,1890,3236,20
81103519336,81103519332,-4,1306,3040,20
81104675769,81104675766,-3,1154,1811,20
81110061741,81110061741,0,1198,2173,20
81112103323,81112103322,-1,934,2414,20
81113716664,81113716661,-3,1124,2454,20
81117327119,81117327117,-2,998,1530,20
81120022246,81120022241,-5,1312,3092,20
81121552663,81121552662,-1,1446,2949,20
81121969153,81121969153,0,1785,2443,20
81122209538,81122209545,7,3466,1315,20
81124134879,81124134877,-2,897,2113,20
81129650471,81129650468,-3,1377,2584,20
81136760852,81136760848,-4,1383,2038,20
81141905771,81141905766,-5,1268,2856,20
81145402059,81145402058,-1,1061,1806,20
81150733711,81150733710,-1,895,1962,20
81150777557,81150777575,18,557,1307,20
81161894193,81161894189,-4,868,1707,20
81166904276,81166904272,-4,1290,2448,20
81167118482,81167118477,-5,919,1720,20
81167367922,81167367918,-4,1174,2287,20
81172548074,81172548072,-2,765,1795,20
81174094635,81174094632,-3,1001,2085,20
81174809741,81174809737,-4,1027,2720,20
81175655347,81175655341,-6,1048,4468,20
81176342739,81176342734,-5,941,2126,20
81179250341,81179250335,-6,1078,2810,20
81180902287,81180902286,-1,897,1409,20
81183813803,81183813803,0,988,1401,20
81184980186,81184980183,-3,973,2540,20
81187815403,81187815402,-1,844,1646,20
81188950367,81188950361,-6,667,2271,20
81189281825,81189281821,-4,1028,2999,20
81196578286,81196578285,-1,1093,2044,20
81196833755,81196833750,-5,1309,3291,20
81197297752,81197297750,-2,1350,2653,20
81201375759,81201375757,-2,1134,2211,20
81201928174,81201928169,-5,1229,2305,20
81203371506,81203371514,8,2782,1281,20
81203480449,81203480447,-2,1406,1898,20
81207465622,81207465618,-4,882,2078,20
81211700874,81211700871,-3,1037,3090,20
81212390553,81212390552,-1,851,2152,20
81214308089,81214308082,-7,1271,2682,20
81215226519,81215226516,-3,1284,2378,20
81216145539,81216145537,-2,801,1364,20
81218185683,81218185680,-3,1289,2809,20
81223885954,81223885950,-4,969,2233,20
81225595712,81225595709,-3,691,1795,20
81226717347,81226717343,-4,801,2044,20
81228325975,81228325986,11,10018,43848,20
81228897854,81228897851,-3,1180,2425,20
81230813370,81230813366,-4,1155,2650,20
81232452782,81232452777,-5,757,1565,20
81233200452,81233200471,19,775,2203,20
81247746229,81247746221,-8,1385,5044,20
81247864094,81247864074,-20,283,728,20
81255979766,81255979762,-4,797,2474,20
81258979725,81258979722,-3,1738,3626,20
81260368097,81260368093,-4,1497,3120,20
81262182007,81262182007,0,1764,1216,20
81262503102,81262503083,-19,1376,2945,20
81264193533,81264193531,-2,1136,1564,20
81264867075,81264867070,-5,770,2555,20
81265190618,81265190618,0,3580,3657,20
81266085799,81266085797,-2,937,2091,20
81268657461,81268657457,-4,1323,1838,20
81269285952,81269285949,-3,1573,3182,20
81271158303,81271158300,-3,1197,2029,20
81273474826,81273474824,-2,852,1579,20
81274133280,81274133281,1,968,1299,20
81277807896,81277807893,-3,946,2166,20
81282134123,81282134117,-6,946,2009,20
81284652695,81284652694,-1,1264,1927,20
81284834592,81284834611,19,191,796,20
81285433001,81285432999,-2,865,2036,20
81290483853,81290483849,-4,943,2237,20
81294714267,81294714263,-4,1114,2883,20
81294842654,81294842653,-1,1101,1473,20
81305700369,81305700365,-4,1103,1789,20
81305874842,81305874841,-1,1493,3052,20
81309656890,81309656889,-1,1215,2066,20
81311348306,81311348303,-3,1331,2387,20
81313493591,81313493589,-2,951,1865,20
81314099665,81314099660,-5,1163,3064,20
81314508117,81314508106,-11,897,2065,20
81315527952,81315527947,-5,192,1114,20
81318385029,81318385030,1,1067,1788,20
81328411480,81328411483,3,3528,3249,20
81328634078,81328634073,-5,1271,3674,20
81328816117,81328816106,-11,161,510,20
81329321449,81329321450,1,1625,1619,20
81334630295,81334630289,-6,1016,1979,20
81338108078,81338108075,-3,997,1791,20
81338278263,81338278242,-21,1430,2874,20
81339909753,81339909758,5,4245,2058,20
81340188844,81340188842,-2,1395,1826,20
81344993398,81344993393,-5,1280,2527,20
81347466518,81347466519,1,1489,1560,20
81352100911,81352100907,-4,1053,2540,20
81358630426,81358630425,-1,1266,1820,20
81359848111,81359848109,-2,1064,2023,20
81361035044,81361035040,-4,1000,1972,20
81361542813,81361542833,20,1045,2095,20
81363272688,81363272685,-3,791,1470,20
81364908701,81364908699,-2,963,1460,20
81367043613,81367043610,-3,871,1838,20
81370874569,81370874566,-3,1115,2801,20
81394698317,81394698314,-3,1305,2593,20
81395978423,81395978425,2,1648,1437,20
81397121954,81397121950,-4,1271,1876,20
81399442293,81399442315,22,863,1730,20
81403766930,81403766928,-2,1061,2238,20
81406640445,81406640446,1,2108,2135,20
81408157408,81408157412,4,31130,26347,20
81412288814,81412288814,0,9651,15212,20
81414019650,81414019646,-4,1279,2446,20
81418134970,81418134971,1,934,1100,20
81419203702,81419203698,-4,959,1282,20
81420994275,81420994271,-4,1013,2191,20
81421343169,81421343166,-3,1508,2075,20
81423067927,81423067922,-5,882,2337,20
81423501417,81423501414,-3,1302,3000,20
81428555405,81428555401,-4,1357,2569,20
81428928053,81428928059,6,253,4777,20
81430418039,81430418037,-2,1032,1789,20
81437142811,81437142810,-1,1756,1664,20
81438903393,81438903389,-4,1046,2610,20
81441324625,81441324622,-3,1709,2852,20
81444907801,81444907798,-3,813,1938,20
81448782303,81448782299,-4,1023,2667,20
81457030953,81457030951,-2,1007,2276,20
81457517091,81457517087,-4,1067,2521,20
81459448162,81459448158,-4,1127,2444,20
81459916147,81459916143,-4,1690,2846,20
81463219313,81463219311,-2,1494,2976,20
81463469126,81463469122,-4,1253,2472,20
81466928211,81466928206,-5,923,2800,20
81467250464,81467250462,-2,1121,1691,20
81471966690,81471966695,5,1358,887,20
81477384679,81477384677,-2,957,1748,20
81479636048,81479636045,-3,812,2522,20
81480705007,81480705015,8,8578,2367,20
81480860022,81480860021,-1,1453,2413,20
81483097106,81483097104,-2,872,2365,20
81484743771,81484743777,6,2026,836,20
81485152438,81485152433,-5,1085,2067,20
81485953200,81485953218,18,1150,2499,20
81490850079,81490850078,-1,1428,1962,20
81494522406,81494522403,-3,926,3236,20
81496884886,81496884884,-2,948,2071,20
81496956575,81496956570,-5,271,1315,20
81500007609,81500007609,0,2439,3492,20
81503219271,81503219268,-3,922,2235,20
81506171662,81506171667,5,1932,596,20
81509589720,81509589737,17,618,1433,20
81510807479,81510807479,0,1375,1514,20
81511389643,81511389641,-2,1093,2595,20
81513022130,81513022137,7,6635,2850,20
81525512072,81525512079,7,2271,645,20
81525727390,81525727387,-3,1563,2824,20
81526557834,81526557832,-2,1253,2565,20
81528955927,81528955924,-3,750,1667,20
81534816882,81534816878,-4,1326,2521,20
81535022582,81535022579,-3,1350,1718,20
81539063214,81539063214,0,1442,2633,20
81542337363,81542337358,-5,1353,2423,20
81546332055,81546332053,-2,1110,2212,20
81547566471,81547566468,-3,1615,3710,20
81548422646,81548422644,-2,1010,2606,20
81549788003,81549787997,-6,1206,1977,20
81557071863,81557071861,-2,1027,2572,20
81558065382,81558065378,-4,1161,3593,20
81561858180,81561858177,-3,1001,2053,20
81563235341,81563235338,-3,1019,2029,20
81566252364,81566252361,-3,859,1929,20
81568522750,81568522745,-5,1515,4627,20
81570126391,81570126389,-2,1343,2329,20
81574523155,81574523149,-6,846,2679,20
81576039591,81576039607,16,597,1392,20
81576590566,81576590563,-3,1635,3197,20
81581929638,81581929636,-2,1672,4320,20
81586036702,81586036697,-5,914,2035,20
81587021342,81587021357,15,656,1477,20
81588861912,81588861911,-1,1035,1626,20
81590432779,81590432776,-3,1320,2762,20
81596660854,81596660852,-2,801,2796,20
81598014636,81598014633,-3,943,1647,20
81601059339,81601059337,-2,1168,2766,20
81601380098,81601380095,-3,1076,2398,20
81603953696,81603953694,-2,1698,2498,20
81605139458,81605139455,-3,1206,1381,20
81619946487,81619946486,-1,1170,1677,20
81621812506,81621812505,-1,801,1663,20
81623248131,81623248128,-3,1175,2385,20
81625844848,81625844845,-3,1119,2868,20
81626565240,81626565238,-2,1109,2757,20
81628032128,81628032127,-1,667,1646,20
81635053317,81635053322,5,3211,1532,20
81636964838,81636964839,1,1333,1714,20
81638273400,81638273397,-3,924,2207,20
81639826557,81639826554,-3,1003,1361,20
81641317706,81641317705,-1,1072,2274,20
81643622486,81643622485,-1,1263,2319,20
81645649709,81645649709,0,411,1219,20
81647676651,81647676649,-2,1061,2049,20
81648870059,81648870054,-5,869,2010,20
81651069257,81651069253,-4,1202,2063,20
81655431848,81655431846,-2,871,2331,20
81661515341,81661515341,0,933,1651,20
81664255123,81664255121,-2,912,2552,20
81668221853,81668221849,-4,1316,2296,20
81668762587,81668762584,-3,1048,2028,20
81669351247,81669351245,-2,1039,1859,20
81673910634,81673910631,-3,1544,2924,20
81676838990,81676838986,-4,1167,1932,20
81677110506,81677110504,-2,1267,2150,20
81681150553,81681150550,-3,1419,2420,20
81683637425,81683637421,-4,813,2113,20
81683869294,81683869292,-2,1327,3173,20
81684924771,81684924770,-1,1372,2490,20
81685223262,81685223262,0,715,1231,20
81685452581,81685452603,22,575,1364,20
81691108202,81691108200,-2,828,2403,20
81691923526,81691923525,-1,1455,2836,20
81693812080,81693812077,-3,1289,2228,20
81695709517,81695709513,-4,1115,1965,20
81703635827,81703635825,-2,890,1798,20
81706180752,81706180748,-4,1338,2818,20
81708327081,81708327078,-3,951,1027,20
81709583987,81709583985,-2,1240,2431,20
81711003355,81711003354,-1,1128,2564,20
81712485838,81712485837,-1,1112,2508,20
81713402232,81713402246,14,1100,4843,20
81713755452,81713755434,-18,609,1714,20
81720269486,81720269484,-2,844,2289,20
81721503460,81721503457,-3,1068,2285,20
81722670069,81722670065,-4,1539,2346,20
81725366404,81725366421,17,937,2524,20
81726802255,81726802251,-4,1420,2346,20
81729708597,81729708591,-6,1570,4859,20
81732098515,81732098513,-2,1248,2016,20
81736271152,81736271146,-6,1373,2329,20
81738346048,81738346045,-3,1392,2296,20
81738843219,81738843220,1,1010,1085,20
81742541182,81742541180,-2,1714,3049,20
81747826552,81747826550,-2,1187,2355,20
81754741882,81754741881,-1,1514,3372,20
81755309411,81755309410,-1,2145,3071,20
81761030421,81761030419,-2,560,1500,20
81762277515,81762277512,-3,987,2421,20
81762469538,81762469534,-4,1304,2733,20
81777755608,81777755605,-3,1112,2568,20
81778213116,81778213138,22,923,2442,20
81778848366,81778848370,4,2501,1460,20
81784362583,81784362581,-2,1273,2563,20
81785888259,81785888256,-3,1764,3181,20
81790316834,81790316831,-3,1330,3262,20
81792187637,81792187633,-4,1043,2168,20
81796184343,81796184339,-4,1023,2762,20
81797677723,81797677718,-5,1552,2774,20
81801988497,81801988495,-2,1306,1972,20
81808967688,81808967686,-2,1756,2490,20
81814084883,81814084886,3,3417,2099,20
81821999181,81821999170,-11,857,2386,20
81827115418,81827115415,-3,1182,2423,20
81827915654,81827915653,-1,1411,2732,20
81828551104,81828551101,-3,1147,2117,20
81829768069,81829768075,6,3652,1725,20
81834854870,81834854866,-4,1159,2526,20
81843034694,81843034691,-3,1302,2532,20
81843345268,81843345266,-2,899,1483,20
81848635224,81848635220,-4,914,2502,20
81850042031,81850042027,-4,961,2205,20
81852030168,81852030174,6,2931,691,20
81856758999,81856758994,-5,1377,2232,20
81859623516,81859623516,0,1742,2885,20
81863247727,81863247722,-5,1057,2628,20
81865527403,81865527398,-5,1694,3212,20
81868644905,81868644914,9,3512,1531,20
81869309421,81869309422,1,1518,2208,20
81872213057,81872213055,-2,1272,1933,20
81877326501,81877326497,-4,1149,2400,20
81878664486,81878664484,-2,1322,2933,20
81878735505,81878735501,-4,882,3066,20
81883588462,81883588461,-1,1395,1500,20
81886604305,81886604302,-3,1550,2845,20
81888423593,81888423589,-4,1188,1607,20
81891562066,81891562063,-3,1002,1621,20
81892251134,81892251134,0,1145,2133,20
81896206797,81896206794,-3,697,1945,20
81903993163,81903993161,-2,941,2334,20
81904607428,81904607425,-3,1385,2164,20
81905968262,81905968261,-1,1032,2121,20
81908197377,81908197373,-4,1093,2242,20
81915058207,81915058205,-2,884,2355,20
81924874714,81924874720,6,15464,21819,20
81925977789,81925977783,-6,1278,2433,20
81926392005,81926392024,19,875,2224,20
81927969415,81927969422,7,3752,1357,20
81929005009,81929005007,-2,2063,2328,20
81933730263,81933730263,0,1590,1638,20
81934559714,81934559711,-3,1600,2838,20
81937339235,81937339233,-2,1120,1820,20
81937755966,81937755958,-8,1035,2327,20
81939625062,81939625065,3,1564,1496,20
81943555437,81943555441,4,1392,1074,20
81948446814,81948446818,4,4815,3798,20
81949063643,81949063645,2,1778,1582,20
81951670983,81951670979,-4,1127,3610,20
81952538384,81952538378,-6,761,1412,20
81952970687,81952970684,-3,1218,2586,20
81956717679,81956717677,-2,1879,2782,20
81958278534,81958278531,-3,1044,1217,20
81965631005,81965631003,-2,1188,2142,20
81967482071,81967482069,-2,1010,2078,20
81967587610,81967587614,4,1573,1073,20
81969127547,81969127544,-3,1127,1980,20
81970088344,81970088342,-2,809,2433,20
81970231418,81970231418,0,1069,1938,20
81974408707,81974408706,-1,1140,1726,20
81977491313,81977491309,-4,908,2127,20
81978578850,81978578846,-4,808,2316,20
81978755030,81978755027,-3,1164,2486,20
81978852598,81978852594,-4,1624,2438,20
81980248814,81980248810,-4,1372,2247,20
81983515147,81983515145,-2,904,1937,20
81984270921,81984270918,-3,1056,1976,20
81988823174,81988823170,-4,1570,3256,20
81989510298,81989510300,2,9239,10444,20
81989763816,81989763834,18,1137,2570,20
81989985983,81989985981,-2,1051,2201,20
81993879104,81993879098,-6,662,2043,20
81994831017,81994831018,1,1861,2808,20
81996817867,81996817867,0,999,1882,20
81999252021,81999252018,-3,804,2288,20
82000196711,82000196727,16,1261,3070,20
82003498798,82003498794,-4,1157,2174,20
82003907206,82003907221,15,728,1744,20
82007624214,82007624212,-2,971,2058,20
82007859781,82007859778,-3,979,2919,20
82008662891,82008662890,-1,1347,2693,20
82012499739,82012499735,-4,1342,2067,20
82015163688,82015163685,-3,1092,2460,20
82019983658,82019983653,-5,776,2337,20
82023033571,82023033565,-6,610,2757,20
82024266692,82024266683,-9,112,1193,20
82026505179,82026505178,-1,1376,2815,20
82027173903,82027173898,-5,992,1435,20
82028794921,82028794923,2,4516,3257,20
82030115153,82030115148,-5,1067,1773,20
82032330949,82032330943,-6,860,3456,20
82033315966,82033315965,-1,956,1864,20
82033448254,82033448251,-3,1087,2151,20
82037561546,82037561541,-5,934,1986,20
82038115122,82038115118,-4,1415,2939,20
82038244387,82038244386,-1,914,1395,20
82041630791,82041630790,-1,625,1422,20
82041835077,82041835058,-19,511,483,20
82045187994,82045187991,-3,661,1868,20
82045809497,82045809493,-4,1472,2514,20
82046764082,82046764078,-4,1299,2530,20
82049070714,82049070710,-4,842,1796,20
82057780575,82057780571,-4,1229,2400,20
82060229083,82060229080,-3,722,2121,20
82061105646,82061105644,-2,1017,2174,20
82066916026,82066916022,-4,1232,2040,20
82068249988,82068249990,2,1204,2033,20
82070448402,82070448399,-3,912,2416,20
82072395738,82072395734,-4,1141,2624,20
82072699599,82072699619,20,871,1879,20
82072892750,82072892746,-4,1002,2678,20
82074181831,82074181828,-3,1306,3197,20
82075610925,82075610922,-3,972,2630,20
82083701439,82083701433,-6,1036,4124,20
82086823042,82086823040,-2,1375,2033,20
82092033057,82092033060,3,1104,930,20
82095393355,82095393351,-4,1240,1928,20
82096979816,82096979811,-5,1004,2543,20
82101336790,82101336787,-3,949,2441,20
82103493689,82103493690,1,3331,2788,20
82104069746,82104069748,2,4000,4171,20
82104431667,82104431663,-4,1242,3346,20
82105573933,82105573930,-3,945,1439,20
82106590054,82106590072,18,948,2116,20
82107635310,82107635307,-3,1286,2928,20
82107895174,82107895171,-3,955,1827,20
82122869573,82122869571,-2,982,3406,20
82126890584,82126890582,-2,1601,3218,20
82130618835,82130618832,-3,1161,1670,20
82134858715,82134858711,-4,1059,2244,20
82137467332,82137467330,-2,1471,1810,20
82138071810,82138071809,-1,1545,2300,20
82139161522,82139161521,-1,986,1336,20
82140426644,82140426641,-3,1345,2219,20
82141005013,82141005006,-7,1369,11720,20
82143594793,82143594790,-3,911,1654,20
82147743730,82147743731,1,1049,1535,20
82148358251,82148358247,-4,990,2535,20
82154039080,82154039081,1,1070,1878,20
82157376780,82157376777,-3,1314,2426,20
82165889505,82165889503,-2,931,2165,20
82167584985,82167584982,-3,1346,2473,20
82169612077,82169612076,-1,1036,2546,20
82176900724,82176900724,0,1063,1481,20
82177475311,82177475330,19,720,1307,20
82178551326,82178551323,-3,889,1764,20
82181335734,82181335730,-4,1485,2994,20
82183303293,82183303289,-4,1324,2772,20
82184664663,82184664662,-1,1125,2396,20
82185198563,82185198560,-3,1343,2530,20
82185313734,82185313727,-7,881,2311,20
82185902764,82185902767,3,1516,1197,20
82189976420,82189976418,-2,1215,2415,20
82195349430,82195349427,-3,969,2028,20
82195707751,82195707749,-2,1256,2246,20
82195965495,82195965494,-1,631,1686,20
82197398451,82197398449,-2,1265,1761,20
82201200068,82201200066,-2,1322,2542,20
82201733879,82201733873,-6,836,2662,20
82201956286,82201956282,-4,1219,2076,20
82202778832,82202778830,-2,1063,1450,20
82208539558,82208539553,-5,1436,2671,20
82208763411,82208763408,-3,862,2153,20
82209129294,82209129287,-7,1080,2726,20
82211281739,82211281735,-4,974,2139,20
82220141654,82220141651,-3,1092,1893,20
82221750618,82221750615,-3,3089,11222,20
82225773951,82225773947,-4,925,2095,20
82231080732,82231080729,-3,1022,2254,20
82232267242,82232267238,-4,1169,1892,20
82240257090,82240257085,-5,1367,2841,20
82241430339,82241430337,-2,1180,2089,20
82242090836,82242090821,-15,283,1206,20
82249087879,82249087877,-2,1024,2133,20
82250667930,82250667929,-1,1224,2476,20
82251436394,82251436394,0,650,1879,20
82254222407,82254222404,-3,808,1588,20
82263507715,82263507712,-3,780,1404,20
82273057383,82273057380,-3,1115,2623,20
82275030057,82275030054,-3,432,1040,20
82276158514,82276158510,-4,1217,2736,20
82280243379,82280243375,-4,1041,2330,20
82283139918,82283139914,-4,967,1992,20
82284491450,82284491446,-4,1235,1750,20
82291879083,82291879081,-2,645,1165,20
82293536117,82293536114,-3,801,2208,20
82295943161,82295943162,1,1274,1231,20
82296242905,82296242901,-4,1125,2008,20
82297925973,82297925970,-3,1654,2571,20
82301672931,82301672930,-1,1193,2212,20
82304998270,82304998266,-4,981,2471,20
82305660984,82305660991,7,3209,1168,20
82306265862,82306265860,-2,955,2211,20
82310630126,82310630123,-3,1325,2400,20
82312132725,82312132722,-3,1813,1663,20
82314961647,82314961651,4,1040,960,20
82315840645,82315840642,-3,1177,1963,20
82316300799,82316300819,20,386,2059,20
82317374489,82317374486,-3,1189,1747,20
82318361031,82318361026,-5,557,2259,20
82322798225,82322798218,-7,939,3622,20
82324977604,82324977599,-5,926,3032,20
82326762574,82326762573,-1,1018,2290,20
82327121836,82327121834,-2,1489,2350,20
82328656784,82328656779,-5,1148,2525,20
82331014954,82331014953,-1,1390,2440,20
82332690914,82332690911,-3,782,2289,20
82337950987,82337950985,-2,1210,2038,20
82339381056,82339381052,-4,1308,3425,20
82344674191,82344674188,-3,1169,2131,20
82349733194,82349733190,-4,1085,1827,20
82351027771,82351027769,-2,1043,2038,20
82352682126,82352682122,-4,992,2563,20
82353543810,82353543806,-4,803,2122,20
82357945830,82357945827,-3,803,2330,20
82358564431,82358564428,-3,1397,1959,20
82359099557,82359099566,9,79,1452,20
82360587313,82360587309,-4,1452,2502,20
82360849522,82360849518,-4,969,1513,20
82365920216,82365920235,19,15907,57885,20
82372350795,82372350794,-1,961,1319,20
82372869204,82372869202,-2,1461,3255,20
82373972483,82373972478,-5,979,3273,20
82376536289,82376536286,-3,814,1963,20
82381982250,82381982246,-4,1066,2684,20
82387183518,82387183517,-1,958,2345,20
82387883222,82387883217,-5,951,3231,20
82388498842,82388498839,-3,1079,2104,20
82390775542,82390775539,-3,1262,3011,20
82390911607,82390911604,-3,922,2233,20
82392720503,82392720499,-4,2156,4125,20
82396056807,82396056805,-2,1256,1883,20
82398793637,82398793631,-6,98,498,20
82405012835,82405012830,-5,1249,2407,20
82405042079,82405042077,-2,932,2132,20
82405817686,82405817682,-4,1092,2054,20
82409102630,82409102630,0,1000,1364,20
82411892198,82411892197,-1,787,2099,20
82413786571,82413786567,-4,504,1133,20
82417070696,82417070696,0,1245,1990,20
82421217736,82421217734,-2,904,3628,20
82423719566,82423719568,2,1342,1787,20
82424331349,82424331370,21,644,1298,20
82424798478,82424798477,-1,775,2070,20
82444717270,82444717269,-1,1476,1828,20
82445510714,82445510711,-3,1285,2386,20
82447606286,82447606282,-4,1269,4266,20
82449018242,82449018246,4,1904,1095,20
82450591571,82450591570,-1,475,736,20
82460444519,82460444514,-5,720,2407,20
82465187755,82465187750,-5,773,2004,20
82466158734,82466158733,-1,1170,2672,20
82477334575,82477334571,-4,721,2285,20
82477623174,82477623173,-1,958,2016,20
82482376474,82482376473,-1,1386,2316,20
82488682930,82488682926,-4,1600,3156,20
82489698541,82489698539,-2,1179,1680,20
82491787795,82491787792,-3,1277,2483,20
82492460245,82492460228,-17,228,1481,20
82497033521,82497033518,-3,1144,2585,20
82500030690,82500030684,-6,1166,2117,20
82506038962,82506038962,0,774,1797,20
82507569353,82507569350,-3,1291,2580,20
82507884126,82507884125,-1,831,2068,20
82508081093,82508081109,16,1180,3413,20
82510742446,82510742444,-2,1012,2252,20
82512453948,82512453942,-6,1201,1905,20
82514839946,82514839940,-6,858,2344,20
82519056230,82519056227,-3,1269,2567,20
82519882329,82519882326,-3,1172,2640,20
82523319651,82523319647,-4,1294,2614,20
82525435797,82525435794,-3,1045,2283,20
82530955754,82530955758,4,8918,7920,20
82532253633,82532253629,-4,895,2408,20
82534045503,82534045500,-3,931,3193,20
82536328255,82536328251,-4,835,2051,20
82541530897,82541530893,-4,1024,2823,20
82545254575,82545254573,-2,1090,2314,20
82545737335,82545737327,-8,1226,1922,20
82550807806,82550807803,-3,1314,1838,20
82553747938,82553747936,-2,1336,2549,20
82554232966,82554232973,7,5399,1528,20
82556176702,82556176697,-5,876,2877,20
82558476294,82558476290,-4,964,1891,20
82564631797,82564631794,-3,1334,2144,20
82568060783,82568060778,-5,979,1832,20
82569550106,82569550103,-3,957,2676,20
82569874467,82569874465,-2,920,2162,20
82570031411,82570031409,-2,1344,3034,20
82572303235,82572303235,0,841,2625,20
82576503191,82576503188,-3,1223,2025,20
82578012113,82578012107,-6,1216,3422,20
82579835386,82579835386,0,1597,2423,20
82579897758,82579897756,-2,642,1654,20
82580341707,82580341705,-2,997,2078,20
82580618633,82580618629,-4,1121,1898,20
82583856329,82583856326,-3,1107,1895,20
82590303814,82590303813,-1,878,2146,20
82591315006,82591315003,-3,1190,1846,20
82592967633,82592967627,-6,1360,2447,20
82593004759,82593004746,-13,1034,1873,20
82593587447,82593587447,0,1192,1491,20
82594990962,82594990962,0,1341,2025,20
82595764055,82595764052,-3,753,1791,20
82598638005,82598638004,-1,1532,2340,20
82599477770,82599477770,0,6592,8766,20
82601647786,82601647789,3,1189,1194,20
82603461031,82603461027,-4,931,2139,20
82608043204,82608043203,-1,1029,1480,20
82611127017,82611127014,-3,25998,13243,20
82611775255,82611775251,-4,1416,2204,20
82615049198,82615049198,0,1349,1818,20
82615890350,82615890346,-4,1,892,20
82618835775,82618835771,-4,1368,2000,20
82620293697,82620293701,4,3085,2289,20
82621018301,82621018306,5,3578,1727,20
82622405250,82622405246,-4,1510,2811,20
82622439989,82622439985,-4,931,2948,20
82622796620,82622796617,-3,1121,2807,20
82623458858,82623458856,-2,1304,2327,20
82631272390,82631272386,-4,1411,3229,20
82632704516,82632704522,6,2628,1181,20
82634409570,82634409566,-4,893,2226,20
82637732991,82637732991,0,1031,2307,20
82637877832,82637877842,10,169,1244,20
82648593037,82648593035,-2,1426,2657,20
82650760693,82650760689,-4,1028,1198,20
82652833907,82652833901,-6,894,2788,20
82653456882,82653456876,-6,1458,2574,20
82658452286,82658452285,-1,889,1914,20
82663222057,82663222053,-4,1273,1981,20
82667459835,82667459833,-2,1165,2763,20
82671460552,82671460546,-6,1133,3730,20
82690897953,82690897951,-2,1125,2200,20
82691769918,82691769915,-3,972,1816,20
82694460897,82694460898,1,1528,1374,20
82701051512,82701051509,-3,1196,2451,20
82701478738,82701478734,-4,1085,2551,20
82702536465,82702536462,-3,1313,2629,20
82704195440,82704195435,-5,1401,3062,20
82705825339,82705825333,-6,29341,15543,20
82708074334,82708074331,-3,1611,2983,20
82711309927,82711309922,-5,1227,2724,20
82711534873,82711534867,-6,1379,2085,20
82713142614,82713142612,-2,1054,1972,20
82714108914,82714108913,-1,1261,967,20
82714167559,82714167557,-2,1256,1801,20
82717187323,82717187321,-2,1017,2168,20
82722362706,82722362702,-4,1610,3209,20
82724660957,82724660954,-3,750,2297,20
82725454442,82725454438,-4,1294,2496,20
82727827435,82727827429,-6,1226,2839,20
82728782317,82728782336,19,1649,3111,20
82731742464,82731742467,3,1943,1656,20
82733689206,82733689204,-2,1114,1458,20
82734301158,82734301139,-19,65,1092,20
82735068559,82735068556,-3,1263,3116,20
82736257307,82736257306,-1,1191,2384,20
82737890350,82737890350,0,1199,1604,20
82740485822,82740485817,-5,912,2159,20
82744866099,82744866095,-4,1348,2495,20
82745235310,82745235306,-4,1038,1333,20
82745269098,82745269094,-4,1149,2261,20
82745771631,82745771609,-22,967,1815,20
82753442425,82753442422,-3,637,2244,20
82760394055,82760394052,-3,989,2265,20
82760939023,82760939019,-4,1206,2779,20
82762088697,82762088695,-2,1402,3069,20
82767214162,82767214165,3,3010,3439,20
82767854816,82767854816,0,23443,24515,20
82772204075,82772204073,-2,1058,2106,20
82775835090,82775835087,-3,1308,2209,20
82776556464,82776556461,-3,973,2703,20
82787507483,82787507481,-2,1212,2494,20
82790226530,82790226527,-3,1132,2118,20
82792689754,82792689747,-7,985,6022,20
82796426576,82796426573,-3,1271,2386,20
82798929583,82798929582,-1,1026,1632,20
82800235169,82800235166,-3,790,2858,20
82809637789,82809637785,-4,1001,2333,20
82811237625,82811237622,-3,1203,1979,20
82812598715,82812598709,-6,777,3810,20
82816842930,82816842927,-3,1216,2203,20
82817626282,82817626279,-3,1479,1802,20
82819598206,82819598204,-2,830,2258,20
82821175781,82821175776,-5,913,2358,20
82822267701,82822267699,-2,1071,1634,20
82823780226,82823780222,-4,1272,2314,20
82827390301,82827390298,-3,1180,2278,20
82827681178,82827681177,-1,926,1636,20
82832094936,82832094937,1,1393,1584,20
82843299000,82843298997,-3,1370,2981,20
82843338525,82843338542,17,983,2652,20
82848298679,82848298678,-1,1131,1985,20
82848361917,82848361935,18,911,1742,20
82855407182,82855407178,-4,1074,2302,20
82855883242,82855883242,0,1274,2166,20
82857580265,82857580261,-4,897,2423,20
82858150160,82858150168,8,6402,1832,20
82863032601,82863032598,-3,1607,3149,20
82863453157,82863453158,1,1457,1330,20
82866187936,82866187930,-6,1158,4735,20
82871911222,82871911221,-1,1029,2024,20
82875362903,82875362902,-1,1170,1857,20
82876107667,82876107665,-2,1122,2090,20
82877536434,82877536434,0,1452,2023,20
82879940277,82879940274,-3,1569,2608,20
82882119426,82882119426,0,962,1563,20
82887011902,82887011899,-3,1252,2482,20
82890503334,82890503333,-1,1348,2766,20
82890983462,82890983461,-1,1159,2574,20
82894872657,82894872651,-6,1225,2421,20
82901026968,82901026965,-3,1006,2355,20
82902603242,82902603239,-3,1296,2221,20
82902987600,82902987617,17,265,808,20
82903148827,82903148833,6,51462,26381,20
82905103891,82905103880,-11,42369,12500,20
82906003791,82906003789,-2,2067,2691,20
82907421736,82907421740,4,24575,18252,20
82910243037,82910243033,-4,1604,3138,20
82913175758,82913175756,-2,1549,1832,20
82917354517,82917354514,-3,1124,1927,20
82921029495,82921029493,-2,1176,1900,20
82925843223,82925843223,0,1406,1316,20
82928405518,82928405515,-3,1647,2512,20
82936661833,82936661835,2,2197,1557,20
82941879384,82941879382,-2,1540,2647,20
82943029006,82943029002,-4,1598,2185,20
82948043465,82948043475,10,15277,33937,20
82948769467,82948769468,1,1135,2075,20
82949813349,82949813333,-16,125,1056,20
82956589597,82956589593,-4,1144,2669,20
82957726087,82957726085,-2,1271,2460,20
82958317955,82958317952,-3,1056,2325,20
82964886499,82964886496,-3,1249,2095,20
82965033405,82965033401,-4,1178,2717,20
82971938018,82971938014,-4,1079,2241,20
82985585674,82985585673,-1,779,2271,20
82987391338,82987391337,-1,865,1925,20
82989010823,82989010826,3,814,1028,20
82989694774,82989694788,14,11847,51628,20
82991201215,82991201210,-5,1874,3338,20
82997676247,82997676243,-4,902,3440,20
82998888379,82998888376,-3,1110,2383,20
82999609161,82999609159,-2,1746,3187,20
83004563263,83004563262,-1,1301,2856,20
83007300664,83007300661,-3,1246,2622,20
83018964742,83018964738,-4,1307,3133,20
83020585034,83020585030,-4,1390,1962,20
83021591470,83021591466,-4,975,3426,20
83023221478,83023221475,-3,1340,2333,20
83025069118,83025069115,-3,917,2542,20
83026927869,83026927866,-3,1254,2788,20
83033086779,83033086777,-2,756,2480,20
83048326605,83048326601,-4,999,2238,20
83048894084,83048894077,-7,530,937,20
83050401559,83050401557,-2,1718,2548,20
83056992696,83056992713,17,1656,2172,20
83057226129,83057226125,-4,1438,3187,20
83058251770,83058251767,-3,554,1190,20
83061225283,83061225282,-1,1146,1884,20
83062040474,83062040472,-2,1145,2850,20
83063170699,83063170697,-2,1052,3258,20
83064950639,83064950636,-3,1285,2079,20
83065383182,83065383179,-3,1118,2506,20
83068598302,83068598301,-1,1464,2305,20
83073334739,83073334737,-2,1475,3057,20
83073919783,83073919793,10,962,1811,20
83075620258,83075620253,-5,1145,2300,20
83084055556,83084055550,-6,1180,2121,20
83084440925,83084440930,5,292,1225,20
83084469145,83084469142,-3,1114,2370,20
83085393120,83085393115,-5,1428,2692,20
83086121640,83086121634,-6,1050,3786,20
83086686428,83086686415,-13,1277,2868,20
83086870919,83086870925,6,191,1068,20
83088808928,83088808942,14,676,3608,20
83100701809,83100701806,-3,1192,2163,20
83101441822,83101441816,-6,2380,6050,20
83104624693,83104624698,5,11976,6382,20
83104899267,83104899270,3,18142,31535,20
83106005538,83106005537,-1,872,2369,20
83107122502,83107122500,-2,577,1851,20
83107703087,83107703070,-17,839,2002,20
83113419471,83113419467,-4,1209,2696,20
83114531040,83114531038,-2,908,1894,20
83120745829,83120745826,-3,1327,2457,20
83126239595,83126239594,-1,1067,2636,20
83134880391,83134880388,-3,1065,2323,20
83141123048,83141123045,-3,1240,1518,20
83145965349,83145965346,-3,1512,3243,20
83152691219,83152691217,-2,568,1678,20
83152918564,83152918571,7,29814,24385,20
83166239090,83166239089,-1,476,1501,20
83168853422,83168853418,-4,1185,3144,20
83169652258,83169652254,-4,1082,2459,20
83171097490,83171097487,-3,1191,1733,20
83174140528,83174140534,6,22806,21109,20
83175461106,83175461105,-1,1435,3089,20
83179986334,83179986335,1,1211,2138,20
83184341018,83184341011,-7,803,2289,20
83187856154,83187856156,2,2000,1963,20
83188338263,83188338261,-2,1035,2056,20
83194884327,83194884323,-4,1127,2241,20
83195244110,83195244109,-1,1054,1366,20
83199440175,83199440177,2,36574,31717,20
83203987158,83203987154,-4,1316,3123,20
83207194525,83207194523,-2,1046,1701,20
83207239767,83207239774,7,265,1338,20
83212958160,83212958155,-5,1141,2193,20
83219994555,83219994554,-1,864,2025,20
83227022923,83227022922,-1,787,2105,20
83229554023,83229554017,-6,964,1310,20
83231002097,83231002095,-2,1270,2180,20
83234139358,83234139355,-3,782,1672,20
83236541582,83236541580,-2,850,2074,20
83237777438,83237777436,-2,1040,3131,20
83239976777,83239976770,-7,704,2425,20
83241517734,83241517731,-3,967,3100,20
83246714499,83246714496,-3,1585,2233,20
83247421018,83247421015,-3,564,1622,20
83248471590,83248471585,-5,1095,2547,20
83250278049,83250278049,0,1220,1847,20
83255655436,83255655434,-2,843,2154,20
83256303622,83256303622,0,964,2427,20
83257005891,83257005888,-3,1043,2350,20
83264835728,83264835727,-1,1986,3765,20
83265344487,83265344482,-5,1224,3274,20
83266866196,83266866193,-3,1017,2309,20
83269436037,83269436035,-2,657,1617,20
83270829973,83270829971,-2,1923,4644,20
83271490474,83271490482,8,4494,1659,20
83273706326,83273706325,-1,919,1991,20
83275066251,83275066249,-2,1158,2097,20
83281466655,83281466651,-4,1571,3954,20
83281801514,83281801512,-2,1382,3690,20
83282285216,83282285209,-7,1156,3535,20
83282790632,83282790646,14,438,1532,20
83286532686,83286532681,-5,789,2305,20
83287584808,83287584802,-6,790,3386,20
83296560408,83296560401,-7,2406,6556,20
83296796394,83296796394,0,1315,1644,20
83297055517,83297055501,-16,169,973,20
83302050669,83302050665,-4,1757,2898,20
83305531949,83305531950,1,1789,1849,20
83305887466,83305887462,-4,687,2048,20
83305941150,83305941167,17,491,1296,20
83306066159,83306066156,-3,926,2461,20
83306179489,83306179486,-3,1116,2266,20
83309388615,83309388610,-5,1174,2789,20
83310837050,83310837048,-2,839,1650,20
83313615426,83313615424,-2,1102,2601,20
83313819498,83313819505,7,8658,32061,20
83314968982,83314968978,-4,927,2729,20
83316328034,83316328031,-3,795,1415,20
83316893396,83316893393,-3,1445,2907,20
83317950003,83317950001,-2,1172,2566,20
83320077470,83320077478,8,5939,2547,20
83322978291,83322978289,-2,1272,1865,20
83323351762,83323351759,-3,1074,2626,20
83325334750,83325334754,4,1668,1251,20
83326352234,83326352237,3,1948,1476,20
83329071065,83329071061,-4,1250,3164,20
83329831589,83329831586,-3,746,2056,20
83332141570,83332141566,-4,1067,2443,20
83334935591,83334935588,-3,1948,5672,20
83337069608,83337069605,-3,1016,1926,20
83338040743,83338040738,-5,891,1997,20
83338441183,83338441186,3,283,1104,20
83340342987,83340342985,-2,904,1447,20
83341740336,83341740354,18,713,2737,20
83341959293,83341959290,-3,1074,2004,20
83346806113,83346806110,-3,1136,2747,20
83348327890,83348327870,-20,1085,1848,20
83349756126,83349756123,-3,986,2557,20
83351032785,83351032782,-3,958,2434,20
83359445615,83359445614,-1,572,1188,20
83359748729,83359748723,-6,1276,2962,20
83374279956,83374279966,10,14066,23693,20
83376594785,83376594781,-4,697,2075,20
83378451560,83378451556,-4,1050,2807,20
83379494872,83379494871,-1,1228,1854,20
83380598789,83380598784,-5,988,1970,20
83381943158,83381943157,-1,1236,2387,20
83383363781,83383363777,-4,785,2421,20
83385194106,83385194102,-4,950,1989,20
83392627925,83392627922,-3,926,1990,20
83393431651,83393431645,-6,493,1316,20
83396859154,83396859158,4,1619,1192,20
83396901179,83396901177,-2,1314,2756,20
83404387115,83404387109,-6,1134,2590,20
83408836122,83408836118,-4,1029,1623,20
83412462473,83412462470,-3,1822,3640,20
83412525430,83412525428,-2,644,1226,20
83413114483,83413114490,7,3372,1536,20
83413774456,83413774452,-4,910,2629,20
83415449572,83415449571,-1,1098,1875,20
83422051847,83422051846,-1,1136,2220,20
83423545012,83423545007,-5,1156,2033,20
83424749454,83424749450,-4,1188,3355,20
83426462980,83426462962,-18,1188,2127,20
83428978306,83428978302,-4,1006,2510,20
83435888773,83435888770,-3,957,1902,20
83436727874,83436727870,-4,1173,2814,20
83438368197,83438368194,-3,1053,2647,20
83450083234,83450083232,-2,898,2029,20
83451057678,83451057677,-1,1116,2028,20
83452609311,83452609307,-4,929,2137,20
83455848067,83455848064,-3,1324,2559,20
83459446209,83459446207,-2,752,2373,20
83461473382,83461473379,-3,903,2422,20
83462932990,83462932996,6,2450,1425,20
83463615282,83463615279,-3,1058,2730,20
83471436791,83471436789,-2,884,1415,20
83471993203,83471993199,-4,1039,2754,20
83475377656,83475377654,-2,1870,3185,20
83476038355,83476038363,8,3937,1734,20
83476894246,83476894241,-5,625,1303,20
83479058929,83479058922,-7,1552,7228,20
83481033429,83481033434,5,336,722,20
83482780239,83482780238,-1,1558,1828,20
83485531699,83485531698,-1,998,2021,20
83489667110,83489667107,-3,1362,3112,20
83489910852,83489910849,-3,1171,2753,20
83492254458,83492254454,-4,1392,3134,20
83493172376,83493172371,-5,1246,3554,20
83493419550,83493419567,17,751,2307,20
83497036946,83497036944,-2,1141,1854,20
83497952506,83497952507,1,1131,2559,20
83498513719,83498513715,-4,972,2491,20
83501449701,83501449698,-3,1065,2320,20
83505434555,83505434551,-4,1129,2241,20
83507729896,83507729902,6,2290,1074,20
83509001320,83509001317,-3,1002,2266,20
83509345799,83509345796,-3,1217,2161,20
83509401796,83509401793,-3,941,1770,20
83511436834,83511436831,-3,1445,2223,20
83515742509,83515742530,21,807,1802,20
83516843367,83516843365,-2,1672,3339,20
83517120204,83517120226,22,348,951,20
83518406186,83518406184,-2,1020,1625,20
83520264626,83520264629,3,1732,1466,20
83523275406,83523275405,-1,1179,1590,20
83525631859,83525631854,-5,1093,2256,20
83530615123,83530615122,-1,805,1583,20
83536092790,83536092788,-2,1027,2616,20
83536770433,83536770429,-4,925,2072,20
83542944339,83542944333,-6,1066,1987,20
83544626462,83544626461,-1,908,2247,20
83545882824,83545882819,-5,1025,3158,20
83551518681,83551518678,-3,1017,2530,20
83552013874,83552013870,-4,1454,3008,20
83552626146,83552626145,-1,1943,2728,20
83556319922,83556319919,-3,886,2018,20
83558813673,83558813669,-4,1399,4699,20
83564641520,83564641517,-3,1437,2395,20
83568867047,83568867043,-4,340,1074,20
83571394767,83571394765,-2,1005,1410,20
83573917909,83573917906,-3,1394,2291,20
83577833397,83577833393,-4,1520,2020,20
83579828374,83579828374,0,938,1171,20
83581444383,83581444381,-2,1274,2627,20
83583835771,83583835770,-1,1092,2183,20
83586426139,83586426135,-4,1047,2021,20
83587655163,83587655161,-2,971,2009,20
83591586008,83591586005,-3,898,3060,20
83591677471,83591677490,19,630,1320,20
83592347834,83592347829,-5,1158,2574,20
83594761942,83594761937,-5,880,3216,20
83594927770,83594927768,-2,1225,1812,20
83599136803,83599136810,7,9839,18360,20
83599563261,83599563280,19,1775,2821,20
83599630909,83599630906,-3,1522,2515,20
83600017924,83600017922,-2,654,1088,20
83603927512,83603927509,-3,986,1588,20
83607473640,83607473661,21,679,1651,20
83608552831,83608552829,-2,1036,1942,20
83609020374,83609020371,-3,834,2364,20
83610317921,83610317939,18,1571,2237,20
83611510172,83611510171,-1,1159,2086,20
83612088874,83612088871,-3,972,1368,20
83613832363,83613832361,-2,1386,1796,20
83616464146,83616464145,-1,1427,2569,20
83619062050,83619062053,3,1898,1402,20
83625190983,83625190980,-3,1584,2249,20
83627112531,83627112530,-1,1102,2297,20
83627207730,83627207728,-2,895,1623,20
83627473623,83627473621,-2,1327,1963,20
83627600913,83627600910,-3,767,2597,20
83634496355,83634496353,-2,1220,2248,20
83635146263,83635146263,0,1242,1845,20
83636575242,83636575239,-3,967,2311,20
83638062783,83638062779,-4,1020,2429,20
83638440324,83638440343,19,190,1129,20
83638871598,83638871594,-4,955,1191,20
83639270119,83639270106,-13,1155,2661,20
83644275593,83644275593,0,1274,1550,20
83649460148,83649460146,-2,572,2560,20
83649535103,83649535082,-21,1014,1815,20
83651717423,83651717418,-5,1048,2770,20
83653645918,83653645914,-4,1830,4710,20
83653747558,83653747556,-2,1289,2574,20
83656745363,83656745363,0,1673,2512,20
83665811944,83665811937,-7,968,4344,20
83672605228,83672605226,-2,985,2543,20
83678338587,83678338582,-5,837,2454,20
83681910989,83681910984,-5,1527,2580,20
83683236613,83683236610,-3,906,2087,20
83693488170,83693488170,0,1240,2409,20
83700813195,83700813200,5,3321,1685,20
83701088150,83701088167,17,1793,1024,20
83702952031,83702952029,-2,904,1975,20
83705824757,83705824753,-4,1045,2401,20
83706108706,83706108704,-2,1110,2644,20
83707985771,83707985769,-2,877,1832,20
83708903740,83708903736,-4,1514,2496,20
83711479569,83711479565,-4,1043,2623,20
83720225018,83720225010,-8,1797,5925,20
83721431477,83721431491,14,222,513,20
83723116496,83723116494,-2,934,3080,20
83727995003,83727994999,-4,1141,2483,20
83731424359,83731424357,-2,975,1923,20
83732893415,83732893413,-2,1056,2481,20
83733572713,83733572710,-3,2595,7197,20
83735105215,83735105212,-3,972,1557,20
83735736223,83735736229,6,392,825,20
83737097650,83737097647,-3,1099,2780,20
83748775242,83748775239,-3,1373,1863,20
83751436186,83751436185,-1,1248,1956,20
83753764705,83753764702,-3,1436,2157,20
83754962531,83754962528,-3,789,1086,20
83761136101,83761136101,0,987,2347,20
83762297269,83762297265,-4,1436,2213,20
83762698381,83762698401,20,815,3787,20
83769066099,83769066094,-5,1154,2398,20
83772860954,83772860952,-2,1207,1994,20
83777161646,83777161647,1,800,1278,20
83778409760,83778409758,-2,1210,2342,20
83782236307,83782236303,-4,998,2317,20
83783681210,83783681208,-2,1632,2760,20
83784254446,83784254443,-3,1477,2468,20
83796491650,83796491647,-3,864,2097,20
83796733542,83796733556,14,323,1890,20
83798190394,83798190398,4,1457,1652,20
83798874478,83798874474,-4,1239,2448,20
83800268241,83800268239,-2,1239,2820,20
83800901971,83800901968,-3,741,1906,20
83806344735,83806344731,-4,1377,2322,20
83811135966,83811135965,-1,905,1445,20
83812814362,83812814346,-16,1119,2958,20
83815082639,83815082635,-4,840,2714,20
83827356753,83827356749,-4,1136,1702,20
83831317312,83831317310,-2,1101,1572,20
83833019397,83833019394,-3,1282,2573,20
83834151063,83834151061,-2,1034,2814,20
83836332350,83836332349,-1,937,2532,20
83837741456,83837741453,-3,721,1652,20
83839773253,83839773250,-3,1428,2241,20
83840725783,83840725779,-4,1157,2703,20
83842554142,83842554139,-3,1253,3052,20
83842772373,83842772372,-1,644,1737,20
83842807676,83842807674,-2,287,712,20
83844013921,83844013921,0,1246,2288,20
83845257534,83845257532,-2,1090,2013,20
83846184534,83846184522,-12,1064,1843,20
83856945731,83856945747,16,1278,2236,20
83859808115,83859808116,1,946,1190,20
83865341347,83865341346,-1,1121,1613,20
83868955052,83868955047,-5,917,1675,20
83878538757,83878538753,-4,1216,2211,20
83879823417,83879823414,-3,1073,1649,20
83883409971,83883409967,-4,1063,2451,20
83889549155,83889549151,-4,1244,2558,20
83891617378,83891617374,-4,1273,3653,20
83892106373,83892106368,-5,1058,3405,20
83894713443,83894713455,12,8814,47210,20
83900968610,83900968607,-3,1461,2911,20
83901895284,83901895282,-2,1633,2301,20
83902318555,83902318554,-1,1152,2102,20
83902761126,83902761145,19,1104,2822,20
83904734004,83904734002,-2,1328,2203,20
83905806985,83905806991,6,19545,34774,20
83909500407,83909500405,-2,1321,2466,20
83914712708,83914712706,-2,1259,2281,20
83919948586,83919948579,-7,1798,4975,20
83925613634,83925613632,-2,1137,2189,20
83925773797,83925773797,0,1309,1861,20
83928394402,83928394399,-3,888,1916,20
83933710673,83933710668,-5,960,2656,20
83936530979,83936530974,-5,1210,4493,20
83936801085,83936801084,-1,992,2124,20
83940170647,83940170654,7,3969,1513,20
83944744423,83944744422,-1,1345,2607,20
83946240891,83946240887,-4,814,2564,20
83946342912,83946342925,13,899,1747,20
83947493439,83947493438,-1,1500,2989,20
83952279637,83952279631,-6,1136,2585,20
83957629543,83957629540,-3,959,1869,20
83959764227,83959764227,0,1291,1746,20
83961751327,83961751321,-6,1074,2445,20
83971510418,83971510415,-3,686,1413,20
83973284943,83973284940,-3,1066,2302,20
83977030303,83977030300,-3,1173,3403,20
83978761551,83978761550,-1,1375,2866,20
83979016506,83979016512,6,3831,2068,20
83980794411,83980794408,-3,709,1518,20
83986563890,83986563889,-1,1067,2355,20
83986942494,83986942489,-5,1058,3042,20
83988744502,83988744501,-1,1099,1783,20
83991081691,83991081689,-2,1369,2367,20
83991286542,83991286538,-4,1381,2708,20
83999252455,83999252441,-14,46125,14327,20
84000248912,84000248909,-3,1098,2742,20
84007878571,84007878566,-5,911,2055,20
84010675118,84010675118,0,859,2072,20
84014574744,84014574742,-2,1187,2565,20
84019485839,84019485835,-4,1198,2721,20
84020111359,84020111358,-1,2558,3681,20
84021335080,84021335080,0,1357,1812,20
84024272019,84024272015,-4,876,2390,20
84025381316,84025381310,-6,1183,3353,20
84026100528,84026100524,-4,1586,3191,20
84028041394,84028041394,0,1553,2777,20
84033783076,84033783073,-3,1187,2668,20
84033867794,84033867791,-3,1031,1915,20
84036743188,84036743187,-1,853,1931,20
84041557646,84041557643,-3,1505,2521,20
84041615606,84041615591,-15,419,1085,20
84041776744,84041776758,14,746,2235,20
84047511665,84047511662,-3,1017,2232,20
84050945020,84050945017,-3,1728,4555,20
84057214738,84057214733,-5,1137,2221,20
84062489609,84062489609,0,1511,2635,20
84063248321,84063248317,-4,1329,2234,20
84071621130,84071621126,-4,1166,1661,20
84072950979,84072950978,-1,743,1097,20
84074191918,84074191934,16,1236,2428,20
84082176349,84082176346,-3,1847,3459,20
84086253563,84086253560,-3,1217,2860,20
84090426301,84090426297,-4,1791,3090,20
84090882511,84090882507,-4,519,2078,20
84092392062,84092392061,-1,1142,2026,20
84092497467,84092497465,-2,904,1542,20
84094408411,84094408410,-1,1407,2742,20
84095153219,84095153216,-3,1197,2155,20
84095443829,84095443850,21,947,1826,20
84098227794,84098227793,-1,957,2489,20
84099293478,84099293475,-3,1305,1737,20
84101543952,84101543950,-2,1027,2615,20
84102198770,84102198766,-4,1312,3122,20
84104817886,84104817883,-3,1563,2949,20
84109016366,84109016363,-3,429,891,20
84109467877,84109467897,20,539,1792,20
84109918031,84109918029,-2,628,2002,20
84110608821,84110608812,-9,125,2585,20
84122668014,84122668015,1,931,1256,20
84123234390,84123234409,19,734,1560,20
84128184427,84128184425,-2,1176,1614,20
84130619861,84130619858,-3,1171,2553,20
84130765712,84130765725,13,368,1284,20
84131256461,84131256458,-3,1682,2089,20
84137345735,84137345734,-1,1700,2897,20
84142327012,84142327010,-2,761,1453,20
84148651538,84148651538,0,1192,1567,20
84149493956,84149493953,-3,1230,1798,20
84158024805,84158024803,-2,971,1318,20
84158382554,84158382550,-4,1380,2643,20
84161468642,84161468638,-4,1396,2448,20
84171222423,84171222421,-2,925,2300,20
84172197395,84172197393,-2,1104,2338,20
84177950087,84177950082,-5,844,2046,20
84179394374,84179394374,0,1184,1494,20
84179660935,84179660932,-3,1234,2154,20
84182784259,84182784254,-5,1152,2319,20
84185348905,84185348911,6,1561,900,20
84186019853,84186019875,22,644,2034,20
84194294714,84194294707,-7,1017,2647,20
84197697276,84197697273,-3,1277,3504,20
84199980545,84199980547,2,2815,3024,20
84204829898,84204829899,1,1452,1760,20
84213321596,84213321593,-3,1431,1964,20
84219584426,84219584422,-4,645,1408,20
84220814869,84220814866,-3,1547,2357,20
84223938868,84223938865,-3,1690,2812,20
84224201790,84224201811,21,400,951,20
84226053254,84226053250,-4,1191,1967,20
84232399993,84232399990,-3,1082,2530,20
84235063732,84235063730,-2,1505,2498,20
84236537409,84236537408,-1,1848,2558,20
84239417933,84239417929,-4,955,1921,20
84241759093,84241759092,-1,1088,2325,20
84243476393,84243476392,-1,895,2024,20
84246341267,84246341264,-3,919,1976,20
84249210942,84249210939,-3,886,2272,20
84262118330,84262118329,-1,892,2462,20
84264173577,84264173575,-2,1375,3020,20
84264603726,84264603722,-4,206,573,20
84265606238,84265606233,-5,1176,1810,20
84266235615,84266235611,-4,1152,2215,20
84270793006,84270793005,-1,961,1859,20
84271032760,84271032760,0,1574,2111,20
84273044283,84273044281,-2,1093,2130,20
84277916186,84277916182,-4,1647,3192,20
84280906680,84280906677,-3,959,2096,20
84282149586,84282149590,4,4521,2821,20
84284783038,84284783039,1,751,1721,20
84284823764,84284823779,15,153,631,20
84290775551,84290775546,-5,1120,2027,20
84291026044,84291026038,-6,1611,5905,20
84293869067,84293869065,-2,1266,2442,20
84294359261,84294359258,-3,2894,4359,20
84294657789,84294657783,-6,499,1227,20
84296556709,84296556705,-4,984,2955,20
84296923984,84296923995,11,617,1527,20
84301223775,84301223772,-3,1017,3105,20
84303641203,84303641198,-5,761,1997,20
84304639102,84304639100,-2,1141,1664,20
84307996402,84307996399,-3,1388,2514,20
84310276987,84310276985,-2,1105,2469,20
84310860686,84310860706,20,134,4819,20
84312851086,84312851082,-4,1287,2380,20
84313118829,84313118823,-6,773,2525,20
84313818981,84313818978,-3,1168,2465,20
84314066351,84314066350,-1,907,2531,20
84314108895,84314108892,-3,760,946,20
84315865294,84315865294,0,1150,1933,20
84316528064,84316528061,-3,1462,2787,20
84318953757,84318953753,-4,1416,2826,20
84319567778,84319567778,0,1725,3056,20
84320877002,84320876997,-5,1353,3157,20
84323115354,84323115350,-4,1082,2235,20
84329066242,84329066238,-4,1463,3157,20
84335026595,84335026593,-2,1084,2042,20
84340175843,84340175838,-5,812,1761,20
84343470449,84343470445,-4,1441,1917,20
84346483347,84346483346,-1,724,1583,20
84346957451,84346957446,-5,1271,2724,20
84347574633,84347574633,0,1437,1339,20
84348542531,84348542526,-5,1308,2457,20
84353499503,84353499499,-4,733,1717,20
84357404856,84357404849,-7,672,3058,20
84367629664,84367629662,-2,1097,2115,20
84368601109,84368601130,21,277,824,20
84368986895,84368986897,2,3348,2864,20
84370509945,84370509942,-3,1161,2805,20
84370551554,84370551551,-3,1064,2870,20
84371205045,84371205027,-18,526,1153,20
84374086143,84374086149,6,2057,1277,20
84374855357,84374855350,-7,1359,3821,20
84376599023,84376599021,-2,654,1615,20
84380866961,84380866963,2,2065,1659,20
84397568609,84397568606,-3,1206,2929,20
84397691283,84397691276,-7,2221,6546,20
84398694791,84398694789,-2,1494,1326,20
84399452703,84399452703,0,645,2221,20
84400766206,84400766203,-3,1208,1942,20
84402240240,84402240236,-4,1623,2399,20
84402489446,84402489442,-4,1073,2518,20
84403775391,84403775387,-4,830,2962,20
84405722134,84405722131,-3,732,1048,20
84406570030,84406570022,-8,1133,2636,20
84410886470,84410886466,-4,1145,2007,20
84411610963,84411610959,-4,1290,2937,20
84412180950,84412180954,4,3875,2789,20
84412478514,84412478510,-4,1088,3914,20
84413469991,84413469986,-5,1218,3900,20
84416437600,84416437599,-1,1364,1602,20
84421471972,84421471968,-4,1251,2980,20
84426246728,84426246722,-6,784,1442,20
84435711202,84435711201,-1,765,1491,20
84437162286,84437162306,20,1093,2379,20
84438383009,84438383014,5,3467,1346,20
84439168614,84439168612,-2,1098,1718,20
84439379642,84439379642,0,1345,1429,20
84442497537,84442497542,5,2670,1233,20
84445780316,84445780313,-3,1294,1850,20
84447364049,84447364044,-5,1006,2301,20
84450013948,84450013945,-3,681,2273,20
84453537192,84453537189,-3,1135,2636,20
84453622367,84453622355,-12,1007,1791,20
84455360623,84455360618,-5,1085,2345,20
84466613330,84466613326,-4,1221,1716,20
84475326862,84475326854,-8,39866,15337,20
84479189851,84479189847,-4,931,2399,20
84483443378,84483443376,-2,1628,2828,20
84483911729,84483911726,-3,1635,2214,20
84490543262,84490543259,-3,952,2294,20
84491376087,84491376082,-5,1474,2298,20
84492683859,84492683857,-2,938,2488,20
84496231081,84496231079,-2,803,2495,20
84496291100,84496291099,-1,277,827,20
84500145118,84500145113,-5,1128,4183,20
84500661219,84500661216,-3,1533,2773,20
84503053491,84503053490,-1,1279,1210,20
84504946282,84504946302,20,736,2091,20
84506131196,84506131194,-2,1136,2688,20
84506454990,84506454987,-3,746,1170,20
84509851474,84509851470,-4,1104,2699,20
84510323305,84510323304,-1,1229,2389,20
84512327297,84512327294,-3,888,2427,20
84513946069,84513946065,-4,1134,2274,20
84515479754,84515479753,-1,1111,2065,20
84515780750,84515780747,-3,1067,2146,20
84519056717,84519056714,-3,1308,2160,20
84520794296,84520794291,-5,953,2792,20
84520987197,84520987195,-2,1134,1655,20
84526113486,84526113484,-2,1118,2169,20
84526260114,84526260111,-3,955,2368,20
84530755186,84530755181,-5,1285,2314,20
84531285127,84531285125,-2,1140,2189,20
84533341046,84533341042,-4,1033,2113,20
84540702695,84540702693,-2,1113,1960,20
84542007989,84542007988,-1,656,1424,20
84548478706,84548478701,-5,844,2987,20
84549868709,84549868715,6,157,682,20
84554799758,84554799754,-4,895,1982,20
84554959719,84554959731,12,258,758,20
84558640690,84558640688,-2,855,2104,20
84561217463,84561217460,-3,1425,2328,20
84561702279,84561702277,-2,934,2584,20
84562265448,84562265442,-6,813,2343,20
84576164678,84576164674,-4,1176,2704,20
84578123430,84578123429,-1,1063,2155,20
84585254882,84585254863,-19,1025,3464,20
84586435822,84586435819,-3,851,1666,20
84592472289,84592472287,-2,1493,2458,20
84594000485,84594000484,-1,1369,2512,20
84597267518,84597267518,0,529,1491,20
84597964882,84597964879,-3,1276,2033,20
84598005653,84598005637,-16,971,2218,20
84598306994,84598306993,-1,722,1080,20
84600277389,84600277385,-4,1185,2269,20
84601449410,84601449409,-1,881,1723,20
84602435993,84602435990,-3,1262,2099,20
84606296031,84606296033,2,984,1059,20
84607508839,84607508837,-2,1326,2153,20
84609313474,84609313471,-3,1505,2962,20
84611821164,84611821160,-4,1093,2600,20
84613225037,84613225034,-3,957,1805,20
84614737086,84614737089,3,1465,1571,20
84615459679,84615459674,-5,1275,1680,20
84618716102,84618716102,0,33456,41970,20
84618991834,84618991829,-5,1115,3349,20
84620395432,84620395429,-3,1047,1981,20
84623801547,84623801544,-3,1244,1709,20
84624802553,84624802555,2,1789,1634,20
84625286522,84625286519,-3,1126,3032,20
84632115187,84632115190,3,1019,699,20
84632473261,84632473248,-13,2127,811,20
84635532825,84635532822,-3,1452,2761,20
84641115750,84641115748,-2,1392,2553,20
84642779896,84642779895,-1,744,1250,20
84644556262,84644556275,13,13490,39420,20
84645639956,84645639962,6,2707,1341,20
84647066498,84647066496,-2,970,1936,20
84648054080,84648054076,-4,783,2334,20
84649082122,84649082119,-3,1349,2051,20
84650065686,84650065682,-4,881,1981,20
84655849686,84655849684,-2,1548,2354,20
84657542747,84657542743,-4,845,2028,20
84667449550,84667449549,-1,1092,1844,20
84668410454,84668410450,-4,1448,3380,20
84669907871,84669907867,-4,919,2674,20
84672438322,84672438320,-2,511,1509,20
84674481802,84674481801,-1,1233,2186,20
84677452334,84677452331,-3,1080,1793,20
84678409601,84678409607,6,4272,1395,20
84680425081,84680425097,16,307,1080,20
84687554514,84687554514,0,922,1748,20
84689316975,84689316972,-3,1471,2559,20
84691787926,84691787922,-4,1105,1572,20
84694429116,84694429118,2,2219,1290,20
84696500391,84696500387,-4,1156,2228,20
84696743731,84696743729,-2,1089,1718,20
84697823010,84697823007,-3,1064,1943,20
84698013542,84698013554,12,307,1057,20
84699003464,84699003462,-2,1472,2588,20
84699308499,84699308506,7,4053,1313,20
84702988091,84702988090,-1,936,1662,20
84704802966,84704802964,-2,1424,2082,20
84705651904,84705651901,-3,870,3044,20
84706006710,84706006706,-4,1247,2631,20
84709001106,84709001102,-4,933,2071,20
84709431912,84709431917,5,1814,1138,20
84713677653,84713677650,-3,1130,2817,20
84715626050,84715626046,-4,1214,3037,20
84716988755,84716988751,-4,957,2649,20
84718437631,84718437628,-3,1247,2293,20
84724309291,84724309289,-2,981,2769,20
84724615022,84724615043,21,1530,2561,20
84731445448,84731445445,-3,1185,2029,20
84735496815,84735496810,-5,1097,2126,20
84738916402,84738916400,-2,1260,1956,20
84744445144,84744445138,-6,35919,13506,20
84744802952,84744802950,-2,1128,3353,20
84745839121,84745839132,11,1529,888,20
84755190265,84755190263,-2,1249,2443,20
84759676440,84759676436,-4,962,2633,20
84760244933,84760244926,-7,921,5192,20
84760361998,84760361994,-4,906,2488,20
84760830357,84760830354,-3,221,5877,20
84761018273,84761018271,-2,1183,1926,20
84767474717,84767474710,-7,1901,5258,20
84769470979,84769470977,-2,700,2263,20
84772796938,84772796947,9,12085,23770,20
84775728320,84775728315,-5,935,1505,20
84775783925,84775783945,20,901,2669,20
84778534082,84778534080,-2,1163,1898,20
84782315663,84782315666,3,2435,1582,20
84787408732,84787408733,1,787,1661,20
84789700249,84789700246,-3,1509,2533,20
84794670888,84794670894,6,2265,1358,20
84798126815,84798126814,-1,1597,3470,20
84799661946,84799661944,-2,1077,2162,20
84802594503,84802594501,-2,887,1576,20
84804519583,84804519579,-4,1044,1789,20
84811026134,84811026133,-1,1918,4697,20
84812911189,84812911186,-3,1230,2223,20
84814101174,84814101174,0,941,1776,20
84823372409,84823372405,-4,1194,2121,20
84823694292,84823694287,-5,1155,2776,20
84824849405,84824849403,-2,1286,2199,20
84826121917,84826121921,4,3452,1543,20
84826211909,84826211906,-3,1578,3043,20
84827008818,84827008816,-2,1076,2055,20
84827145208,84827145222,14,930,1394,20
84829262286,84829262293,7,4573,1534,20
84833463673,84833463670,-3,1133,2385,20
84834347134,84834347153,19,661,1899,20
84835582026,84835582023,-3,819,1651,20
84836643674,84836643670,-4,1393,2164,20
84837892025,84837892022,-3,833,2511,20
84838789543,84838789542,-1,1129,3065,20
84853731679,84853731676,-3,1103,2690,20
84856110342,84856110341,-1,1348,2485,20
84858523965,84858523967,2,1130,1381,20
84858570038,84858570037,-1,1288,2287,20
84861856287,84861856285,-2,1029,1527,20
84866454923,84866454921,-2,1192,2655,20
84875769725,84875769721,-4,1129,3015,20
84878877483,84878877479,-4,915,2218,20
84882175572,84882175567,-5,944,2244,20
84888302451,84888302448,-3,1706,2187,20
84889351924,84889351933,9,18459,19226,20
84895408544,84895408540,-4,1070,3059,20
84896218761,84896218758,-3,1304,2541,20
84901398074,84901398073,-1,904,2932,20
84901843580,84901843577,-3,95,590,20
84904330527,84904330522,-5,1053,2212,20
84904773631,84904773628,-3,983,1581,20
84907841926,84907841922,-4,1105,2304,20
84911462543,84911462541,-2,1072,2932,20
84912206117,84912206113,-4,1036,2386,20
84917246837,84917246835,-2,1240,2258,20
84919280766,84919280763,-3,1602,2507,20
84922953639,84922953637,-2,1684,2297,20
84926666991,84926666989,-2,821,2070,20
84927526432,84927526453,21,560,1945,20
84934350254,84934350250,-4,709,1490,20
84936136257,84936136261,4,1875,1735,20
84938805302,84938805307,5,1684,1349,20
84944799300,84944799297,-3,1002,2076,20
84944912270,84944912258,-12,41,1193,20
84949651001,84949650997,-4,947,2107,20
84949831239,84949831237,-2,1048,2420,20
84955001139,84955001146,7,7996,1861,20
84956512509,84956512508,-1,1407,1701,20
84960570987,84960570984,-3,717,1662,20
84962469998,84962469995,-3,1298,1541,20
84967468534,84967468531,-3,1189,1906,20
84968443263,84968443258,-5,1329,3169,20
84969339121,84969339118,-3,922,2076,20
84970080175,84970080170,-5,1313,2480,20
84974306720,84974306716,-4,1025,1634,20
84976406735,84976406733,-2,1012,2087,20
84981271587,84981271584,-3,1012,2882,20
84981665591,84981665609,18,772,2257,20
84982557747,84982557743,-4,1181,3510,20
84982913944,84982913942,-2,1408,2355,20
84985922338,84985922337,-1,1164,2368,20
84989775374,84989775373,-1,833,1530,20
84999114935,84999114938,3,1408,1051,20
84999254795,84999254792,-3,1065,2384,20
84999406641,84999406636,-5,1618,2062,20
85006799686,85006799685,-1,1380,2273,20
85015271001,85015270998,-3,1328,2723,20
85022659158,85022659153,-5,1319,2317,20
85027171668,85027171674,6,29589,37915,20
85027230578,85027230573,-5,848,2257,20
85030466379,85030466379,0,739,1126,20
85032177961,85032177954,-7,31465,17347,20
85033539006,85033539003,-3,822,1696,20
85034078500,85034078483,-17,1084,1857,20
85035523750,85035523748,-2,1004,2364,20
85035849333,85035849332,-1,1193,2719,20
85037964978,85037964975,-3,1304,2721,20
85047138621,85047138622,1,1673,1826,20
85049297190,85049297189,-1,1146,2377,20
85051442850,85051442849,-1,1083,1923,20
85051761618,85051761616,-2,1505,2710,20
85051874882,85051874877,-5,880,2068,20
85053132978,85053132973,-5,1338,2121,20
85053489058,85053489055,-3,988,2129,20
85055722779,85055722775,-4,843,2295,20
85056713522,85056713520,-2,1027,2050,20
85061959919,85061959937,18,1320,2377,20
85065383926,85065383922,-4,1180,2426,20
85068053377,85068053374,-3,1179,2568,20
85070294455,85070294453,-2,1073,2175,20
85070391055,85070391046,-9,1460,2749,20
85074645907,85074645916,9,3610,1599,20
85075471353,85075471353,0,918,1656,20
85081810065,85081810066,1,1563,1735,20
85083008890,85083008895,5,2043,1295,20
85091333997,85091334002,5,2236,1699,20
85091462369,85091462365,-4,1231,2201,20
85094344140,85094344134,-6,1195,2260,20
85101829098,85101829094,-4,1695,2839,20
85104076940,85104076936,-4,1205,2900,20
85107536367,85107536365,-2,1173,2929,20
85109675009,85109675002,-7,769,1890,20
85113048142,85113048137,-5,2044,7906,20
85114133271,85114133269,-2,1492,3122,20
85118396586,85118396587,1,1763,1878,20
85118545025,85118545021,-4,935,2615,20
85118801896,85118801912,16,905,1539,20
85124201201,85124201198,-3,1518,2675,20
85124550862,85124550857,-5,1248,3285,20
85124604425,85124604419,-6,2067,7062,20
85125293484,85125293466,-18,916,1754,20
85126153044,85126153067,23,989,2317,20
85127440728,85127440727,-1,1168,2129,20
85127550307,85127550303,-4,1325,2544,20
85130973991,85130973991,0,1114,2084,20
85132933793,85132933789,-4,1402,2206,20
85134138491,85134138487,-4,753,2465,20
85135198751,85135198748,-3,1134,2748,20
85138844008,85138844004,-4,695,2013,20
85140409285,85140409282,-3,1214,2052,20
85146239061,85146239068,7,6803,2438,20
85146385088,85146385083,-5,1123,2759,20
85152079170,85152079168,-2,872,2250,20
85158683190,85158683191,1,1640,1439,20
85160698418,85160698415,-3,1017,2506,20
85168403855,85168403850,-5,768,1664,20
85169222331,85169222326,-5,1203,3434,20
85170031021,85170031018,-3,1534,2324,20
85171603138,85171603134,-4,1431,2557,20
85172070968,85172070966,-2,1058,2800,20
85173036041,85173036038,-3,1135,3087,20
85173701149,85173701146,-3,892,1678,20
85184517773,85184517769,-4,1031,2176,20
85186024341,85186024338,-3,1206,3504,20
85186947702,85186947701,-1,1053,3144,20
85187177025,85187177022,-3,1315,2779,20
85189925662,85189925661,-1,1189,2175,20
85190024469,85190024466,-3,1241,2208,20
85196750102,85196750101,-1,784,1179,20
85198922815,85198922812,-3,1137,2340,20
85199114877,85199114874,-3,1381,3311,20
85211605842,85211605839,-3,1260,2432,20
85212339494,85212339472,-22,1008,1413,20
85212739323,85212739318,-5,1208,2171,20
85214168061,85214168057,-4,1161,2920,20
85215067863,85215067859,-4,1794,2895,20
85216702758,85216702755,-3,1402,2336,20
85218445613,85218445611,-2,1164,2134,20
85221302007,85221302005,-2,1372,1895,20
85242763809,85242763805,-4,1852,6013,20
85247955944,85247955942,-2,1120,2534,20
85255745858,85255745872,14,434,1148,20
85257389838,85257389834,-4,1325,1957,20
85260393708,85260393701,-7,1287,4461,20
85264131740,85264131737,-3,1455,2317,20
85264377910,85264377892,-18,885,2151,20
85265815295,85265815290,-5,1208,2059,20
85269337051,85269337070,19,560,274,20
85270173731,85270173738,7,2702,1300,20
85272920816,85272920811,-5,1058,2674,20
85277816309,85277816317,8,11950,35851,20
85280812662,85280812661,-1,1553,2275,20
85281683851,85281683849,-2,929,2566,20
85282008687,85282008678,-9,746,1890,20
85285617157,85285617152,-5,1158,3021,20
85287926640,85287926636,-4,1442,2806,20
85288830885,85288830903,18,948,1675,20
85291524028,85291524046,18,876,2280,20
85291868689,85291868694,5,2037,1089,20
85293702958,85293702956,-2,887,1872,20
85293973989,85293973985,-4,1262,1976,20
85294645246,85294645242,-4,1062,2466,20
85294926625,85294926623,-2,1794,2344,20
85303792829,85303792834,5,4930,2867,20
85306722262,85306722258,-4,973,2937,20
85307997211,85307997210,-1,500,1658,20
85308774806,85308774805,-1,1810,3086,20
85310132974,85310132971,-3,1002,2130,20
85310796363,85310796359,-4,1235,2693,20
85316026045,85316026043,-2,992,2741,20
85317256810,85317256805,-5,1002,2189,20
85318386937,85318386933,-4,947,3135,20
85319752198,85319752195,-3,1115,2094,20
85320606505,85320606502,-3,1064,1737,20
85326138645,85326138638,-7,1042,4638,20
85327514849,85327514849,0,1504,1925,20
85330186197,85330186194,-3,1083,2445,20
85334358202,85334358201,-1,737,1407,20
85335353680,85335353678,-2,1408,2481,20
85336587607,85336587603,-4,922,2341,20
85341203079,85341203075,-4,1014,1715,20
85342483774,85342483772,-2,1198,3194,20
85343457725,85343457722,-3,1308,2047,20
85344461619,85344461614,-5,1095,1850,20
85348729840,85348729838,-2,1523,2815,20
85354743297,85354743299,2,927,906,20
85356775485,85356775481,-4,1052,1705,20
85356818605,85356818602,-3,890,2222,20
85358120926,85358120922,-4,1011,2109,20
85358471559,85358471557,-2,901,2546,20
85359398698,85359398702,4,2462,1998,20
85360574862,85360574858,-4,1117,2796,20
85360870581,85360870577,-4,1447,2956,20
85362173758,85362173752,-6,981,1872,20
85365503097,85365503095,-2,1031,2474,20
85370333055,85370333050,-5,922,2947,20
85379021202,85379021199,-3,946,1822,20
85382843576,85382843573,-3,823,1950,20
85391087635,85391087627,-8,718,2891,20
85393075983,85393075979,-4,1119,2559,20
85406438307,85406438307,0,863,1693,20
85408539031,85408539026,-5,1627,2389,20
85414211025,85414211021,-4,1463,2913,20
85414564619,85414564617,-2,1336,2548,20
85416755683,85416755681,-2,1514,1867,20
85418884243,85418884241,-2,1051,2413,20
85420580543,85420580538,-5,642,1119,20
85422155178,85422155175,-3,1229,2292,20
85428229771,85428229767,-4,1156,2725,20
85432721583,85432721570,-13,209,755,20
85435588182,85435588189,7,7954,2984,20
85437750989,85437750985,-4,1609,3044,20
85439598268,85439598265,-3,1323,2234,20
85440064605,85440064597,-8,1144,5161,20
85443841700,85443841701,1,1804,1294,20
85444484349,85444484368,19,1384,2970,20
85446547719,85446547737,18,1224,2306,20
85453627121,85453627117,-4,997,2100,20
85454343466,85454343462,-4,1121,3084,20
85455582037,85455582042,5,8217,3213,20
85456026631,85456026630,-1,1140,2743,20
85458376232,85458376227,-5,757,1246,20
85460263876,85460263874,-2,945,1615,20
85470882690,85470882690,0,1050,1321,20
85475967179,85475967177,-2,1663,3254,20
85491361261,85491361257,-4,1192,2737,20
85493129722,85493129721,-1,904,1748,20
85496597630,85496597630,0,534,1956,20
85499756966,85499756963,-3,3943,9480,20
85502628613,85502628608,-5,937,2927,20
85503478973,85503478971,-2,22259,11270,20
85504611488,85504611485,-3,943,1940,20
85508740834,85508740831,-3,1651,3173,20
85510281995,85510281993,-2,491,1919,20
85514106907,85514106903,-4,935,2942,20
85517043806,85517043800,-6,1194,5083,20
85518553731,85518553728,-3,1904,3255,20
85521659015,85521659012,-3,1075,2129,20
85522098073,85522098067,-6,1229,4751,20
85526991658,85526991655,-3,1117,2423,20
85529226062,85529226061,-1,980,2204,20
85532808191,85532808189,-2,982,1463,20
85533743542,85533743542,0,994,1126,20
85543842066,85543842067,1,2742,2815,20
85550500724,85550500720,-4,1351,2830,20
85553481677,85553481673,-4,1847,2231,20
85556163753,85556163747,-6,989,2034,20
85557866454,85557866454,0,166,1052,20
85561513049,85561513047,-2,1005,2891,20
85564370974,85564370972,-2,1184,2270,20
85566100895,85566100890,-5,747,2691,20
85567579799,85567579818,19,1024,2390,20
85572870950,85572870948,-2,855,1773,20
85576739699,85576739697,-2,1483,2247,20
85577033267,85577033264,-3,894,2820,20
85577754440,85577754438,-2,1014,2213,20
85578483823,85578483835,12,199,967,20
85579486720,85579486717,-3,1065,2037,20
85581562946,85581562945,-1,1112,2123,20
85586951183,85586951180,-3,1014,1883,20
85590114875,85590114873,-2,1208,2775,20
85590394895,85590394894,-1,1086,2269,20
85592883387,85592883385,-2,1041,2185,20
85597880209,85597880207,-2,744,2340,20
85599491337,85599491334,-3,1445,3033,20
85599578882,85599578878,-4,974,1436,20
85600646182,85600646169,-13,1379,2397,20
85604599838,85604599835,-3,1011,2407,20
85607835374,85607835369,-5,912,1971,20
85609904300,85609904299,-1,1223,2494,20
85609936257,85609936253,-4,845,2890,20
85612777662,85612777663,1,1621,1340,20
85613870638,85613870636,-2,999,2283,20
85618288054,85618288059,5,2387,1432,20
85618853233,85618853230,-3,1201,2790,20
85621817450,85621817446,-4,1113,2588,20
85623373098,85623373094,-4,750,2485,20
85624091865,85624091862,-3,980,1853,20
85633664191,85633664188,-3,1054,2534,20
85634670606,85634670601,-5,794,2013,20
85636118358,85636118358,0,63,854,20
85641046177,85641046175,-2,1083,2576,20
85641277383,85641277379,-4,730,2606,20
85646593600,85646593599,-1,1241,1854,20
85652067850,85652067845,-5,1432,2674,20
85655554807,85655554803,-4,1084,4474,20
85659039145,85659039141,-4,1174,2180,20
85663308414,85663308411,-3,1081,3173,20
85665632339,85665632336,-3,994,3042,20
85666281643,85666281642,-1,1415,2269,20
85670802870,85670802865,-5,1297,3171,20
85672516539,85672516540,1,1933,1795,20
85675627111,85675627113,2,1777,1592,20
85683361463,85683361458,-5,1218,3241,20
85683739436,85683739434,-2,1276,3564,20
85701035074,85701035073,-1,1166,1919,20
85703371102,85703371106,4,2034,1241,20
85704047818,85704047817,-1,938,2256,20
85708818831,85708818832,1,2556,2921,20
85710463982,85710463979,-3,1006,2752,20
85710547975,85710547973,-2,772,2309,20
85713014407,85713014402,-5,968,2241,20
85718307646,85718307646,0,2006,2076,20
85718888653,85718888650,-3,1090,1663,20
85720464858,85720464858,0,891,1732,20
85723250232,85723250229,-3,1102,2060,20
85726731562,85726731559,-3,2100,3629,20
85727610702,85727610700,-2,1552,3623,20
85729893039,85729893034,-5,942,3277,20
85729978934,85729978933,-1,345,890,20
85731938118,85731938133,15,950,1730,20
85736082128,85736082124,-4,883,2526,20
85738376907,85738376904,-3,1091,2485,20
85741819091,85741819088,-3,1124,3392,20
85742069334,85742069333,-1,1314,2012,20
85744504748,85744504745,-3,1166,2257,20
85747292098,85747292096,-2,1389,2924,20
85755175153,85755175149,-4,1157,2987,20
85756320459,85756320453,-6,1732,5878,20
85759858134,85759858132,-2,1294,2924,20
85769231893,85769231891,-2,1065,2437,20
85770587687,85770587682,-5,859,1776,20
85772002726,85772002721,-5,1118,1868,20
85775072247,85775072246,-1,972,2376,20
85786853851,85786853849,-2,1081,2581,20
85787702931,85787702927,-4,1273,2332,20
85792876399,85792876398,-1,992,2236,20
85792901668,85792901651,-17,808,1416,20
85796876694,85796876691,-3,873,2237,20
85797486327,85797486322,-5,654,2884,20
85798779275,85798779272,-3,1416,3090,20
85799597258,85799597258,0,936,2022,20
85805119120,85805119116,-4,1155,2848,20
85807801990,85807801987,-3,764,1566,20
85809437691,85809437689,-2,1086,1835,20
85809583244,85809583230,-14,1255,2776,20
85814004927,85814004924,-3,981,2531,20
85815838915,85815838909,-6,2344,6757,20
85817925613,85817925610,-3,1213,2160,20
85822031879,85822031874,-5,1601,3236,20
85823338515,85823338521,6,13300,29509,20
85830808783,85830808779,-4,1162,2108,20
85833279774,85833279772,-2,994,1958,20
85836585275,85836585282,7,6965,1976,20
85837002630,85837002629,-1,908,2441,20
85840488101,85840488097,-4,1290,2142,20
85843065658,85843065658,0,1679,1962,20
85844996338,85844996335,-3,837,1908,20
85845114340,85845114353,13,319,628,20
85845607786,85845607782,-4,467,1053,20
85846305033,85846305026,-7,886,2951,20
85848017027,85848017026,-1,1442,2127,20
85850445987,85850445984,-3,1447,1962,20
85852391978,85852391974,-4,874,1874,20
85852669630,85852669650,20,801,2180,20
85852816839,85852816838,-1,1295,2110,20
85853241415,85853241412,-3,1052,2243,20
85859901644,85859901639,-5,1377,3027,20
85861458675,85861458666,-9,1477,5544,20
85861940613,85861940603,-10,1092,2205,20
85865683882,85865683878,-4,1284,2130,20
85867383439,85867383426,-13,906,3124,20
85879550000,85879550003,3,2377,2164,20
85884576471,85884576467,-4,941,2680,20
85890112631,85890112629,-2,869,2173,20
85890236551,85890236550,-1,768,1160,20
85895491427,85895491425,-2,960,2116,20
85898551113,85898551109,-4,847,1333,20
85900034653,85900034650,-3,1165,1853,20
85901092910,85901092908,-2,1002,2673,20
85902018306,85902018301,-5,829,1494,20
85912729063,85912729058,-5,2104,3680,20
85913902710,85913902710,0,790,2690,20
85917271876,85917271898,22,902,1884,20
85919998419,85919998418,-1,1647,1586,20
85921226367,85921226363,-4,846,2516,20
85923847639,85923847636,-3,1008,1927,20
85924105666,85924105663,-3,1576,2990,20
85924264275,85924264274,-1,1065,1800,20
85926505778,85926505774,-4,1002,2092,20
85928446619,85928446617,-2,798,2311,20
85928629148,85928629145,-3,946,2268,20
85928813973,85928813967,-6,47,854,20
85938938967,85938938965,-2,897,1616,20
85939214559,85939214554,-5,966,3343,20
85939749734,85939749729,-5,975,2688,20
85940214866,85940214866,0,1502,3132,20
85942133943,85942133941,-2,1896,2556,20
85946000231,85946000229,-2,842,2232,20
85946959646,85946959640,-6,1044,2863,20
85952008942,85952008960,18,1024,1801,20
85952723487,85952723483,-4,1073,2415,20
85953249787,85953249785,-2,952,1505,20
85967095909,85967095906,-3,1172,1769,20
85969937706,85969937703,-3,1154,1303,20
85970216602,85970216598,-4,1129,2189,20
85971701084,85971701082,-2,1535,1909,20
85977093977,85977093975,-2,1646,1436,20
85982298639,85982298638,-1,1294,1832,20
85983443794,85983443812,18,1156,714,20
85989852502,85989852498,-4,1238,1955,20
85994757799,85994757796,-3,651,1858,20
85996954219,85996954215,-4,1217,2891,20
85998146338,85998146334,-4,679,2452,20
85999554014,85999554011,-3,1092,1708,20
86002358507,86002358504,-3,1223,1733,20
86004427030,86004427026,-4,1101,2323,20
86004948754,86004948753,-1,970,2253,20
86011503498,86011503494,-4,1538,2708,20
86014901421,86014901418,-3,1634,2761,20
86015051399,86015051396,-3,1051,2679,20
86021310894,86021310895,1,966,1443,20
86024408445,86024408446,1,1209,1021,20
86032908374,86032908371,-3,1287,1718,20
86033971566,86033971561,-5,1540,6202,20
86035393855,86035393862,7,4030,1488,20
86036163408,86036163404,-4,938,2747,20
86048082607,86048082606,-1,1085,2210,20
86056250207,86056250202,-5,1135,2150,20
86057421290,86057421286,-4,1154,2148,20
86058451870,86058451862,-8,6845,15223,20
86058741974,86058741971,-3,959,2769,20
86059746792,86059746789,-3,1440,3548,20
86061928826,86061928821,-5,1128,2351,20
86068158286,86068158282,-4,1016,2355,20
86068667482,86068667477,-5,1094,3138,20
86068799501,86068799493,-8,983,2133,20
86070445232,86070445228,-4,1857,2624,20
86074668095,86074668094,-1,2944,4069,20
86079601474,86079601470,-4,1031,1760,20
86080386342,86080386337,-5,903,1992,20
86081924216,86081924212,-4,852,2646,20
86081998475,86081998473,-2,1432,2764,20
86083364079,86083364084,5,1874,944,20
86087059761,86087059759,-2,1026,2046,20
86089674273,86089674272,-1,1390,1512,20
86092200487,86092200486,-1,1030,1747,20
86096177191,86096177186,-5,893,2844,20
86096670069,86096670068,-1,1451,2257,20
86101339606,86101339601,-5,867,2017,20
86105420388,86105420384,-4,1432,3534,20
86107866116,86107866110,-6,496,2100,20
86110864878,86110864874,-4,1071,2307,20
86111056903,86111056895,-8,987,1740,20
86111249310,86111249330,20,469,2094,20
86114121864,86114121855,-9,26823,16698,20
86115141018,86115141018,0,1059,1743,20
86116241163,86116241161,-2,1228,2736,20
86117387010,86117387007,-3,1084,2642,20
86117910832,86117910850,18,657,1487,20
86118658520,86118658516,-4,992,2116,20
86119916674,86119916674,0,3286,3058,20
86124199370,86124199367,-3,1386,2129,20
86133605507,86133605504,-3,902,2462,20
86134175282,86134175279,-3,1535,2699,20
86135691729,86135691725,-4,1576,2565,20
86139982786,86139982784,-2,1549,2455,20
86140018676,86140018674,-2,1227,1886,20
86142255330,86142255326,-4,1037,2889,20
86142400819,86142400818,-1,1542,1236,20
86142805674,86142805670,-4,1467,2134,20
86145758426,86145758425,-1,686,1491,20
86148701124,86148701127,3,2377,1288,20
86153414063,86153414061,-2,681,1443,20
86154606705,86154606703,-2,912,2406,20
86155201612,86155201609,-3,1637,2543,20
86169355467,86169355465,-2,1438,1922,20
86170141200,86170141196,-4,987,2357,20
86174510335,86174510331,-4,1015,2723,20
86174747957,86174747946,-11,1674,2821,20
86177227998,86177228015,17,1046,2806,20
86181198432,86181198426,-6,1307,1973,20
86186634762,86186634762,0,476,1079,20
86186937181,86186937172,-9,1206,2491,20
86187199446,86187199444,-2,1433,3321,20
86189215838,86189215845,7,3820,1697,20
86193216902,86193216899,-3,781,2000,20
86196120447,86196120446,-1,1125,2044,20
86203410313,86203410308,-5,781,2097,20
86208532074,86208532073,-1,1517,2511,20
86215263201,86215263194,-7,213,597,20
86217300211,86217300209,-2,1239,2105,20
86218985776,86218985774,-2,978,2586,20
86219111255,86219111253,-2,1171,2840,20
86224235122,86224235124,2,32953,32617,20
86224315999,86224315995,-4,18810,12182,20
86224503803,86224503802,-1,1174,1945,20
86229125002,86229125000,-2,1238,2229,20
86232881331,86232881330,-1,708,2011,20
86234117913,86234117911,-2,1300,2418,20
86239089290,86239089286,-4,757,808,20
86240025684,86240025679,-5,1465,2047,20
86243871257,86243871257,0,1437,2408,20
86244935834,86244935835,1,1575,1630,20
86245417955,86245417950,-5,1089,3343,20
86249590557,86249590554,-3,1064,2823,20
86250058149,86250058143,-6,1131,2901,20
86250721772,86250721757,-15,1053,2044,20
86252560145,86252560142,-3,1145,2674,20
86253474801,86253474798,-3,1314,2904,20
86261489461,86261489467,6,3017,1464,20
86282260333,86282260330,-3,1194,2135,20
86282643199,86282643197,-2,954,2122,20
86282693477,86282693494,17,427,995,20
86286224119,86286224114,-5,1575,3181,20
86290522214,86290522213,-1,1111,3115,20
86292478003,86292477998,-5,753,1177,20
86294092406,86294092403,-3,901,1982,20
86296711220,86296711226,6,42268,3193,20
86305620342,86305620341,-1,1294,2302,20
86306757795,86306757790,-5,1135,1865,20
86309063798,86309063802,4,2999,1986,20
86309686879,86309686878,-1,1324,1908,20
86311955286,86311955285,-1,1650,2291,20
86312270451,86312270447,-4,1085,1558,20
86314916590,86314916594,4,2364,1024,20
86315811019,86315811014,-5,1047,2555,20
86322302567,86322302562,-5,993,2569,20
86322353626,86322353622,-4,999,2842,20
86322502352,86322502371,19,264,1190,20
86325402966,86325402985,19,1145,2004,20
86327243022,86327243030,8,3775,1354,20
86328843762,86328843760,-2,1342,2507,20
86333215040,86333215037,-3,1068,2033,20
86336413520,86336413531,11,11248,22899,20
86348265686,86348265684,-2,800,2165,20
86349592725,86349592721,-4,1101,3025,20
86352895999,86352895994,-5,1670,2943,20
86357796011,86357796010,-1,711,2244,20
86360949884,86360949881,-3,1115,3087,20
86362266682,86362266678,-4,1036,2038,20
86368695743,86368695746,3,963,867,20
86376565726,86376565723,-3,877,1795,20
86382880013,86382880009,-4,1371,3497,20
86386247730,86386247726,-4,741,1495,20
86386597066,86386597071,5,2274,1261,20
86392268365,86392268362,-3,1117,2617,20
86395172159,86395172157,-2,1570,2868,20
86396151754,86396151753,-1,914,2084,20
86400111661,86400111658,-3,1010,3439,20
86402410779,86402410777,-2,1103,3482,20
86403648384,86403648385,1,1675,2439,20
86410869735,86410869729,-6,898,1969,20
86421146434,86421146437,3,24960,20554,20
86428788706,86428788703,-3,1075,1806,20
86429597813,86429597805,-8,1264,1804,20
86434461417,86434461415,-2,1642,2427,20
86441994566,86441994563,-3,1033,1386,20
86443598957,86443598954,-3,1275,2942,20
86443967407,86443967405,-2,1150,1708,20
86445122963,86445122960,-3,1205,2072,20
86446092548,86446092548,0,880,1952,20
86448038125,86448038125,0,1071,2279,20
86448580790,86448580772,-18,1293,4488,20
86452160266,86452160262,-4,989,3346,20
86454632732,86454632729,-3,1155,2294,20
86454876166,86454876151,-15,915,1791,20
86462668714,86462668713,-1,783,2214,20
86462765602,86462765598,-4,994,1929,20
86463683620,86463683616,-4,1365,2637,20
86464832718,86464832715,-3,1342,2857,20
86465070058,86465070055,-3,1235,2149,20
86467952791,86467952787,-4,1034,2066,20
86468685726,86468685735,9,72,797,20
86482688484,86482688490,6,2259,736,20
86484143066,86484143063,-3,1383,1878,20
86485263930,86485263928,-2,1203,1983,20
86485646702,86485646709,7,357,912,20
86488032995,86488032994,-1,1004,2618,20
86488377369,86488377368,-1,3584,15701,20
86495370716,86495370713,-3,1487,3047,20
86496099342,86496099338,-4,2210,7606,20
86498374794,86498374796,2,1817,2336,20
86505946551,86505946548,-3,1434,2652,20
86512141178,86512141174,-4,1290,2320,20
86518155774,86518155753,-21,985,1897,20
86520393912,86520393908,-4,1091,3157,20
86520491324,86520491305,-19,1232,2057,20
86522231192,86522231189,-3,1303,2318,20
86522415003,86522415009,6,2874,1004,20
86524529881,86524529887,6,2924,1371,20
86527246464,86527246470,6,1655,1315,20
86530162840,86530162839,-1,1323,2237,20
86531000243,86531000241,-2,4097,9263,20
86531307923,86531307918,-5,650,3295,20
86532230509,86532230506,-3,1117,2087,20
86532911702,86532911714,12,375,1008,20
86535389065,86535389063,-2,2962,5665,20
86536203799,86536203795,-4,875,2230,20
86536305150,86536305146,-4,1293,2242,20
86539085666,86539085670,4,32559,37694,20
86540142825,86540142822,-3,1265,2699,20
86540782173,86540782174,1,1280,2496,20
86542303361,86542303381,20,18535,39922,20
86543277381,86543277375,-6,1474,3982,20
86547130542,86547130539,-3,1192,2117,20
86549162062,86549162056,-6,1817,6528,20
86550163069,86550163066,-3,1124,2333,20
86551640154,86551640150,-4,972,2337,20
86554269276,86554269286,10,1630,1040,20
86559155761,86559155757,-4,1157,1875,20
86561456798,86561456794,-4,1100,2136,20
86564570489,86564570487,-2,1429,2120,20
86565505783,86565505780,-3,1021,2136,20
86566796878,86566796874,-4,623,1583,20
86567027843,86567027840,-3,913,3597,20
86569076195,86569076193,-2,1178,1748,20
86569516807,86569516821,14,158,659,20
86570340086,86570340083,-3,942,2141,20
86575560625,86575560622,-3,1475,2589,20
86575665493,86575665490,-3,1012,1808,20
86577654040,86577654038,-2,1301,1893,20
86579331855,86579331854,-1,770,2339,20
86579511719,86579511719,0,793,1268,20
86580131292,86580131290,-2,1250,2522,20
86581354257,86581354253,-4,1223,2797,20
86582492102,86582492099,-3,1114,2745,20
86584263143,86584263142,-1,891,1897,20
86585661899,86585661896,-3,1307,3057,20
86586366748,86586366746,-2,1306,2800,20
86586961532,86586961530,-2,1450,2500,20
86587533935,86587533934,-1,1263,2321,20
86590056038,86590056034,-4,1473,2954,20
86590435362,86590435361,-1,1106,2358,20
86595126115,86595126120,5,1843,1368,20
86601127025,86601127024,-1,920,1291,20
86602396471,86602396467,-4,1284,2116,20
86604976991,86604976995,4,1007,942,20
86607115407,86607115405,-2,1308,1898,20
86608553533,86608553533,0,1246,2182,20
86609436430,86609436427,-3,18039,6973,20
86609487435,86609487437,2,1671,2018,20
86610394960,86610394952,-8,1077,3399,20
86610635944,86610635930,-14,865,2908,20
86611579064,86611579061,-3,1103,1785,20
86615157675,86615157681,6,5670,2296,20
86617453045,86617453042,-3,1131,2480,20
86620184982,86620184981,-1,1071,2433,20
86620943819,86620943817,-2,1215,2553,20
86623328900,86623328899,-1,1315,1383,20
86625069742,86625069738,-4,1031,2484,20
86629025281,86629025287,6,2478,1363,20
86630899747,86630899746,-1,1275,1994,20
86635448747,86635448742,-5,1362,1964,20
86641529535,86641529534,-1,1136,1396,20
86643754675,86643754675,0,666,1516,20
86646738957,86646738953,-4,1033,2599,20
86653947490,86653947486,-4,25486,15849,20
86656954375,86656954375,0,1431,1603,20
86657245439,86657245440,1,1738,1199,20
86661467420,86661467417,-3,1391,2473,20
86663924013,86663924011,-2,1345,1964,20
86664503629,86664503629,0,1074,1952,20
86667991173,86667991171,-2,849,2198,20
86679111963,86679111961,-2,750,1611,20
86680569574,86680569571,-3,1129,1908,20
86681507586,86681507582,-4,859,2572,20
86684985045,86684985042,-3,1480,2876,20
86686945607,86686945603,-4,1599,3749,20
86686976846,86686976843,-3,957,2296,20
86695216889,86695216887,-2,1434,3152,20
86701122269,86701122268,-1,464,1573,20
86704961541,86704961538,-3,1088,1984,20
86707031841,86707031838,-3,1324,2493,20
86709435868,86709435865,-3,1237,2072,20
86714651538,86714651537,-1,1094,2786,20
86718059775,86718059774,-1,1187,2746,20
86719614312,86719614310,-2,868,1421,20
86719843968,86719843985,17,1151,2162,20
86720096758,86720096754,-4,1365,2379,20
86721983991,86721983989,-2,1725,3125,20
86729896469,86729896464,-5,1257,2269,20
86737013591,86737013587,-4,1082,1722,20
86737951904,86737951901,-3,1356,2513,20
86739949362,86739949366,4,2324,1510,20
86747027670,86747027666,-4,1065,2337,20
86747074990,86747074988,-2,1293,3219,20
86747158770,86747158766,-4,1514,3834,20
86751640477,86751640477,0,1392,2458,20
86752582212,86752582233,21,1006,2482,20
86753599079,86753599073,-6,2150,6045,20
86754222855,86754222851,-4,1805,3117,20
86756895251,86756895249,-2,1468,3892,20
86763534105,86763534102,-3,1029,2083,20
86763707949,86763707947,-2,1329,2801,20
86773427074,86773427070,-4,1729,3381,20
86781452294,86781452297,3,2180,1466,20
86783782563,86783782558,-5,996,1954,20
86785429412,86785429401,-11,71,724,20
86788065371,86788065365,-6,988,4491,20
86792867387,86792867386,-1,760,1767,20
86796645101,86796645098,-3,1377,1973,20
86808587962,86808587966,4,3271,1910,20
86811443765,86811443757,-8,1272,5935,20
86812449235,86812449230,-5,818,2018,20
86816374157,86816374152,-5,1082,2567,20
86816457702,86816457686,-16,149,1370,20
86818653735,86818653734,-1,981,2724,20
86820900604,86820900601,-3,1346,1542,20
86821652134,86821652133,-1,827,1934,20
86824052742,86824052738,-4,1069,2525,20
86828293364,86828293366,2,291,1139,20
86829199808,86829199804,-4,1520,2630,20
86832748437,86832748435,-2,1004,2229,20
86834308007,86834308004,-3,1303,1884,20
86839500228,86839500226,-2,1008,1570,20
86842784278,86842784276,-2,1038,1715,20
86843248447,86843248456,9,489,1025,20
86848011557,86848011561,4,2960,1853,20
86848557305,86848557303,-2,1043,1425,20
86849836977,86849836974,-3,1370,2257,20
86851705658,86851705655,-3,1537,2345,20
86854576705,86854576702,-3,1423,2906,20
86856581232,86856581227,-5,947,1657,20
86861405427,86861405430,3,1741,1950,20
86864789878,86864789877,-1,1176,1461,20
86865853330,86865853331,1,1495,1582,20
86866041460,86866041454,-6,1344,1421,20
86867854828,86867854825,-3,1313,2442,20
86868471986,86868471982,-4,1174,2951,20
86869935776,86869935771,-5,691,2295,20
86871059842,86871059837,-5,1186,2494,20
86872942848,86872942856,8,400,1463,20
86873158698,86873158702,4,1779,1276,20
86876843669,86876843666,-3,1241,2364,20
86888956414,86888956413,-1,849,1913,20
86890863138,86890863135,-3,1579,2404,20
86894884319,86894884317,-2,1318,2906,20
86895922185,86895922182,-3,898,1604,20
86906324609,86906324607,-2,1001,2230,20
86908119021,86908119017,-4,1392,3059,20
86909928895,86909928890,-5,1085,1926,20
86916963853,86916963848,-5,982,1304,20
86918932799,86918932795,-4,1124,3214,20
86919179037,86919179031,-6,1113,2879,20
86919518325,86919518311,-14,1258,1368,20
86919724993,86919724989,-4,1356,2957,20
86926941926,86926941925,-1,2993,4862,20
86927207911,86927207909,-2,1881,2513,20
86928722141,86928722140,-1,850,2023,20
86928816389,86928816411,22,1597,2475,20
86929681759,86929681757,-2,1014,1744,20
86931127014,86931127010,-4,1339,2326,20
86934040668,86934040665,-3,1139,2769,20
86935012178,86935012176,-2,1246,3103,20
86936076985,86936076981,-4,1035,2003,20
86938430546,86938430544,-2,1075,2209,20
86939084431,86939084426,-5,745,1272,20
86939768111,86939768107,-4,1230,2301,20
86957429067,86957429065,-2,729,2205,20
86958471858,86958471855,-3,1043,2371,20
86958787110,86958787110,0,1142,1232,20
86964634504,86964634502,-2,1333,2283,20
86967450158,86967450146,-12,1104,1768,20
86971407638,86971407634,-4,875,2265,20
86973260387,86973260385,-2,1292,2050,20
86973481547,86973481542,-5,937,2890,20
86974728030,86974728026,-4,1223,3023,20
86979148955,86979148953,-2,1295,2363,20
86984145099,86984145097,-2,1246,2426,20
86984187315,86984187312,-3,1228,2643,20
86985342915,86985342913,-2,867,2201,20
86987142678,86987142682,4,3194,1681,20
86988764681,86988764678,-3,1138,2115,20
86989555742,86989555730,-12,181,757,20
86991626765,86991626765,0,1172,2900,20
86992633285,86992633282,-3,1588,2669,20
86995736539,86995736538,-1,1603,2055,20
86998433425,86998433421,-4,1682,3424,20
87001464399,87001464399,0,1344,2578,20
87002355255,87002355252,-3,979,3075,20
87006592726,87006592722,-4,979,2617,20
87007685950,87007685929,-21,1177,1628,20
87012519406,87012519403,-3,1045,2318,20
87021397201,87021397198,-3,796,2584,20
87025459218,87025459213,-5,1027,3882,20
87035230606,87035230602,-4,876,2207,20
87040959438,87040959434,-4,1222,2558,20
87041916824,87041916822,-2,939,2320,20
87042601530,87042601526,-4,1716,2974,20
87043855863,87043855856,-7,1151,6289,20
87046470927,87046470927,0,1509,1430,20
87052167616,87052167622,6,22774,41001,20
87055736586,87055736582,-4,1402,3735,20
87057663091,87057663086,-5,1136,3159,20
87057810670,87057810649,-21,2202,1493,20
87065642139,87065642135,-4,1315,1849,20
87070335770,87070335767,-3,1224,2184,20
87071967641,87071967642,1,2083,2060,20
87074355103,87074355098,-5,2048,2502,20
87075372507,87075372505,-2,1001,1873,20
87077071086,87077071082,-4,1053,2084,20
87081885645,87081885642,-3,1103,1995,20
87084434273,87084434269,-4,1235,3496,20
87088547251,87088547246,-5,828,2397,20
87091620751,87091620758,7,2992,1227,20
87095081682,87095081678,-4,878,2470,20
87101863805,87101863802,-3,963,2770,20
87103572870,87103572890,20,1975,3417,20
87104574452,87104574449,-3,1230,1967,20
87105784139,87105784141,2,3485,3618,20
87106082148,87106082155,7,3933,1224,20
87108130285,87108130304,19,15353,48544,20
87108419423,87108419418,-5,1089,2857,20
87110067970,87110067967,-3,1160,2592,20
87127999184,87127999183,-1,873,1335,20
87129015651,87129015649,-2,1114,2014,20
87129522071,87129522065,-6,1255,13806,20
87130854399,87130854397,-2,1146,2527,20
87131539863,87131539870,7,34,803,20
87134559738,87134559734,-4,1002,2075,20
87138186628,87138186626,-2,1418,2007,20
87138482234,87138482230,-4,1049,2686,20
87143902021,87143902019,-2,988,2337,20
87144865951,87144865948,-3,1680,2013,20
87146121725,87146121723,-2,1193,2102,20
87151201825,87151201826,1,1714,2577,20
87165432682,87165432680,-2,1125,2312,20
87166673210,87166673206,-4,1159,1592,20
87171587738,87171587737,-1,1273,1920,20
87172459347,87172459346,-1,583,1275,20
87172910859,87172910857,-2,913,1854,20
87175634638,87175634642,4,1976,1015,20
87176901674,87176901671,-3,1088,1645,20
87177873599,87177873593,-6,1097,2851,20
87178071339,87178071335,-4,961,1784,20
87181465020,87181465018,-2,1462,2715,20
87181581334,87181581336,2,4271,3487,20
87181880862,87181880859,-3,1111,2320,20
87183306462,87183306458,-4,1188,2604,20
87185774274,87185774269,-5,508,708,20
87188013348,87188013340,-8,1219,2129,20
87188755075,87188755073,-2,1016,1931,20
87195859675,87195859674,-1,1061,3403,20
87196186042,87196186039,-3,1206,2892,20
87198856738,87198856735,-3,708,2431,20
87199537307,87199537307,0,1674,1597,20
87203891584,87203891580,-4,833,1557,20
87205646754,87205646750,-4,1618,2809,20
87206704738,87206704737,-1,1515,1928,20
87207982907,87207982904,-3,1370,2020,20
87211115395,87211115394,-1,1281,1899,20
87214038951,87214038946,-5,1037,2083,20
87216490978,87216490973,-5,889,2291,20
87221739857,87221739853,-4,1151,5009,20
87222219590,87222219609,19,1162,2428,20
87225958427,87225958423,-4,1238,2932,20
87226801967,87226801967,0,27498,21006,20
87234030879,87234030875,-4,799,1538,20
87236375927,87236375925,-2,1358,2463,20
87237524158,87237524154,-4,1177,2285,20
87245115273,87245115286,13,14001,46777,20
87245644755,87245644751,-4,1452,1906,20
87246145355,87246145353,-2,1473,3082,20
87246912372,87246912373,1,1441,1205,20
87253561508,87253561504,-4,699,1738,20
87256011162,87256011158,-4,771,1990,20
87258218098,87258218098,0,1147,1690,20
87260436421,87260436423,2,31807,30841,20
87263998288,87263998286,-2,1495,3095,20
87266397599,87266397597,-2,1286,2546,20
87269385426,87269385422,-4,1184,2091,20
87269450629,87269450646,17,687,2323,20
87270253233,87270253230,-3,975,3096,20
87272139753,87272139751,-2,1309,2170,20
87272577991,87272577989,-2,977,1986,20
87273314122,87273314120,-2,982,2577,20
87274884034,87274884033,-1,1143,2091,20
87279670647,87279670646,-1,1034,1537,20
87281189248,87281189243,-5,1010,3268,20
87283751061,87283751066,5,3994,1345,20
87284261001,87284260999,-2,1333,2647,20
87294258690,87294258690,0,1875,1744,20
87296477055,87296477055,0,1079,1372,20
87296590571,87296590566,-5,1123,2038,20
87298777998,87298777997,-1,872,1921,20
87298851857,87298851854,-3,1309,2478,20
87305248277,87305248278,1,2000,2699,20
87309980553,87309980552,-1,1526,1983,20
87310065308,87310065314,6,3811,1314,20
87311861289,87311861285,-4,1338,2734,20
87312386525,87312386530,5,3097,1608,20
87314157179,87314157177,-2,1130,2654,20
87316850687,87316850683,-4,1347,2559,20
87320794134,87320794131,-3,994,2387,20
87323090046,87323090042,-4,1278,2650,20
87323131111,87323131131,20,168,525,20
87325090335,87325090332,-3,1193,2463,20
87326014089,87326014096,7,3782,1967,20
87326356983,87326356986,3,1106,2121,20
87328174125,87328174123,-2,874,1750,20
87330601669,87330601677,8,4523,1145,20
87333596650,87333596648,-2,684,1231,20
87337998711,87337998709,-2,965,1965,20
87345396368,87345396364,-4,1257,2455,20
87355327655,87355327654,-1,933,1884,20
87360381485,87360381483,-2,1031,2439,20
87362634557,87362634553,-4,1020,2183,20
87364323451,87364323445,-6,1192,2620,20
87365578328,87365578327,-1,801,1510,20
87366543899,87366543894,-5,959,4013,20
87368405190,87368405189,-1,1070,2672,20
87373926247,87373926243,-4,847,2569,20
87374425175,87374425173,-2,852,2301,20
87374547645,87374547629,-16,1557,3218,20
87379609953,87379609946,-7,1838,8877,20
87380589723,87380589721,-2,977,1523,20
87388158402,87388158398,-4,1334,2050,20
87389082029,87389082027,-2,1675,2244,20
87390771602,87390771602,0,1620,1670,20
87391518632,87391518649,17,1490,2198,20
87394503688,87394503694,6,1628,1266,20
87395747016,87395747012,-4,1049,2813,20
87397525391,87397525386,-5,758,1918,20
87401117897,87401117894,-3,1177,3193,20
87401610975,87401610964,-11,6290,16520,20
87403474685,87403474682,-3,58642,23794,20
87405346910,87405346908,-2,1291,2554,20
87406791055,87406791051,-4,1652,2832,20
87408641521,87408641520,-1,1009,2364,20
87411101159,87411101155,-4,774,2240,20
87422144424,87422144422,-2,1287,1694,20
87429879241,87429879236,-5,845,2703,20
87432081520,87432081516,-4,1021,3557,20
87433442910,87433442906,-4,1163,2778,20
87436342336,87436342332,-4,958,2805,20
87438087589,87438087594,5,3233,1613,20
87439868852,87439868850,-2,785,1896,20
87440461602,87440461606,4,2239,1310,20
87441389576,87441389574,-2,1542,2199,20
87443875258,87443875252,-6,1387,4073,20
87447179810,87447179808,-2,1477,2362,20
87452580100,87452580098,-2,1223,2144,20
87455916537,87455916534,-3,1289,3104,20
87456930022,87456930021,-1,1153,1673,20
87459409943,87459409936,-7,852,1352,20
87462245395,87462245391,-4,963,1837,20
87466002937,87466002934,-3,1152,2517,20
87467030147,87467030147,0,1417,1816,20
87471300772,87471300769,-3,995,2260,20
87472753824,87472753822,-2,764,1943,20
87475906993,87475906989,-4,1217,2786,20
87476031959,87476031938,-21,893,2169,20
87478834640,87478834637,-3,1016,1505,20
87479680183,87479680181,-2,1436,1807,20
87481557150,87481557149,-1,1143,2366,20
87482230418,87482230416,-2,1317,1938,20
87483111538,87483111535,-3,749,940,20
87485657550,87485657545,-5,753,2119,20
87485794820,87485794816,-4,1267,2290,20
87486640086,87486640088,2,1593,1231,20
87489690786,87489690782,-4,1168,2474,20
87491334625,87491334622,-3,1510,2763,20
87491810194,87491810190,-4,1302,3153,20
87492999261,87492999259,-2,1857,2649,20
87494230102,87494230100,-2,518,1642,20
87497376488,87497376484,-4,701,2233,20
87498766309,87498766305,-4,1180,1998,20
87499821169,87499821168,-1,1402,2095,20
87500738180,87500738177,-3,1326,2239,20
87505158602,87505158599,-3,1148,2120,20
87506992746,87506992742,-4,1216,2530,20
87507357458,87507357456,-2,996,2222,20
87513695318,87513695316,-2,955,3083,20
87519658966,87519658973,7,3721,2083,20
87522957462,87522957462,0,1077,1791,20
87525794132,87525794125,-7,1368,2361,20
87527919596,87527919586,-10,633,1968,20
87530045679,87530045675,-4,1232,2531,20
87531256754,87531256753,-1,926,2526,20
87532325165,87532325162,-3,1591,2973,20
87537530732,87537530729,-3,1507,2980,20
87544555775,87544555770,-5,1724,4106,20
87545092841,87545092837,-4,1081,2188,20
87545447578,87545447574,-4,956,2865,20
87546458126,87546458127,1,1552,1685,20
87550750179,87550750176,-3,1136,2172,20
87566242820,87566242815,-5,1282,3268,20
87566474470,87566474470,0,641,1527,20
87568036688,87568036685,-3,2163,5304,20
87570070586,87570070584,-2,1331,2205,20
87574857149,87574857145,-4,1048,2105,20
87578196831,87578196828,-3,949,2184,20
87578261272,87578261290,18,782,2068,20
87579831514,87579831520,6,4155,2306,20
87580533347,87580533342,-5,1401,2630,20
87585793767,87585793765,-2,887,2034,20
87588681819,87588681814,-5,723,2765,20
87594069699,87594069697,-2,858,2335,20
87595331815,87595331810,-5,1164,2631,20
87597870380,87597870374,-6,1346,2502,20
87598022664,87598022682,18,533,1636,20
87599538766,87599538764,-2,923,2440,20
87600079246,87600079243,-3,1430,2578,20
87604892914,87604892911,-3,1510,2805,20
87605999030,87605999037,7,943,2273,20
87610664319,87610664315,-4,1148,2641,20
87611297314,87611297311,-3,617,1444,20
87612397342,87612397339,-3,1085,1861,20
87616354541,87616354539,-2,1196,1927,20
87616581130,87616581128,-2,865,2771,20
87618637338,87618637337,-1,1439,2172,20
87621961054,87621961052,-2,870,1898,20
87622139322,87622139318,-4,1108,3190,20
87624511903,87624511909,6,3465,1518,20
87630172271,87630172268,-3,733,2050,20
87631016663,87631016656,-7,820,1559,20
87635707247,87635707246,-1,1248,2015,20
87635850800,87635850796,-4,737,2861,20
87641524131,87641524127,-4,1246,2446,20
87642618606,87642618602,-4,962,1709,20
87642861032,87642861047,15,330,740,20
87647426326,87647426322,-4,1404,1814,20
87653609187,87653609185,-2,1187,2866,20
87656781462,87656781462,0,3746,3355,20
87660265938,87660265934,-4,1469,2430,20
87662720036,87662720033,-3,1083,2011,20
87673499321,87673499318,-3,1454,2630,20
87679052731,87679052729,-2,1215,2018,20
87685019075,87685019095,20,729,2287,20
87690266170,87690266168,-2,1374,2166,20
87694069520,87694069523,3,2915,1247,20
87694871328,87694871326,-2,1147,2231,20
87698730492,87698730486,-6,1810,6471,20
87698879617,87698879623,6,2839,936,20
87699007791,87699007789,-2,1162,2376,20
87701129597,87701129595,-2,1190,2631,20
87701956126,87701956123,-3,920,2669,20
87704450605,87704450620,15,2586,1016,20
87705504979,87705504977,-2,1219,2552,20
87706242831,87706242828,-3,1381,2190,20
87706442491,87706442488,-3,1245,2797,20
87715210646,87715210642,-4,1310,2435,20
87716739130,87716739127,-3,1573,2721,20
87722949623,87722949621,-2,965,2643,20
87723003365,87723003362,-3,1871,2215,20
87727008921,87727008918,-3,1601,2487,20
87728529551,87728529548,-3,1238,2091,20
87729161987,87729161984,-3,1267,2472,20
87729931343,87729931340,-3,1915,3243,20
87730593139,87730593135,-4,994,2841,20
87737900090,87737900093,3,2373,1693,20
87738730804,87738730790,-14,1149,1762,20
87743078859,87743078858,-1,1538,2133,20
87746192535,87746192531,-4,871,2555,20
87746575986,87746575986,0,1447,2640,20
87747512826,87747512833,7,1699,1258,20
87754356545,87754356544,-1,864,2105,20
87755532709,87755532731,22,445,478,20
87761717059,87761717055,-4,1475,2144,20
87764189901,87764189894,-7,927,2660,20
87765152721,87765152726,5,6340,2667,20
87776465178,87776465181,3,23615,35249,20
87780512422,87780512417,-5,1178,2508,20
87782136685,87782136680,-5,1183,3166,20
87782247448,87782247466,18,189,1081,20
87783768055,87783768052,-3,1682,2238,20
87788526534,87788526531,-3,1176,1938,20
87789187089,87789187085,-4,808,2231,20
87789680385,87789680381,-4,1502,2560,20
87791426405,87791426401,-4,897,2134,20
87798303347,87798303345,-2,1455,2233,20
87800279126,87800279124,-2,1338,1682,20
87801072365,87801072362,-3,1541,3249,20
87802167623,87802167619,-4,985,1416,20
87803622067,87803622066,-1,1285,3666,20
87807829325,87807829329,4,1235,1284,20
87810039554,87810039573,19,806,1969,20
87811355453,87811355453,0,825,2343,20
87813166725,87813166722,-3,916,2249,20
87814251951,87814251954,3,1990,1321,20
87822540814,87822540810,-4,923,2671,20
87822851993,87822851988,-5,1083,2805,20
87823570478,87823570469,-9,1034,2509,20
87832292563,87832292561,-2,1198,1854,20
87832907805,87832907801,-4,1288,2543,20
87835008111,87835008109,-2,899,1822,20
87843814002,87843813998,-4,850,2667,20
87845125974,87845125971,-3,1166,2991,20
87860011681,87860011684,3,2513,2175,20
87863790467,87863790465,-2,986,2317,20
87866558249,87866558243,-6,1376,2246,20
87867093087,87867093073,-14,211,906,20
87871394800,87871394798,-2,1580,3449,20
87875160455,87875160453,-2,885,2843,20
87875369833,87875369832,-1,1079,1685,20
87875994549,87875994558,9,11723,37665,20
87876564629,87876564625,-4,1358,3102,20
87889535606,87889535612,6,887,1375,20
87890321002,87890320999,-3,674,1605,20
87891681053,87891681050,-3,1108,2525,20
87891848836,87891848834,-2,104,1145,20
87894900577,87894900574,-3,1151,2090,20
87895331110,87895331108,-2,1353,2546,20
87897863910,87897863906,-4,1226,1721,20
87900599078,87900599078,0,900,1387,20
87905951765,87905951762,-3,894,1965,20
87906011106,87906011105,-1,1071,2755,20
87906171357,87906171355,-2,1720,3335,20
87908379661,87908379661,0,641,1201,20
87908525413,87908525395,-18,961,2663,20
87911131509,87911131506,-3,1259,2446,20
87916136860,87916136857,-3,1280,2427,20
87916433262,87916433258,-4,1095,1888,20
87916952187,87916952191,4,2617,1269,20
87920221701,87920221700,-1,1164,2467,20
87920662888,87920662886,-2,942,2071,20
87920887330,87920887329,-1,1690,1681,20
87924924690,87924924693,3,1562,1220,20
87926477085,87926477081,-4,1183,3079,20
87927001194,87927001190,-4,836,1598,20
87927959466,87927959461,-5,765,1800,20
87935629614,87935629614,0,2712,3370,20
87936315880,87936315874,-6,968,2956,20
87941395176,87941395172,-4,805,2139,20
87945254311,87945254306,-5,728,1587,20
87949083246,87949083243,-3,920,2373,20
87950131535,87950131531,-4,1006,2308,20
87953808638,87953808637,-1,1246,2376,20
87954520519,87954520517,-2,1056,2735,20
87955465079,87955465074,-5,928,2634,20
87957702441,87957702438,-3,1070,1863,20
87962389587,87962389583,-4,1560,2911,20
87964987551,87964987547,-4,1002,3019,20
87971253034,87971253032,-2,861,1825,20
87973655658,87973655655,-3,1159,3091,20
87981637778,87981637782,4,1542,1259,20
87982222915,87982222911,-4,896,2676,20
87982397268,87982397266,-2,1231,1620,20
87984439831,87984439829,-2,923,2120,20
87991304045,87991304041,-4,1421,2875,20
87992735185,87992735181,-4,1397,3328,20
87993893109,87993893105,-4,1320,2081,20
87995945494,87995945489,-5,1129,3651,20
87996487006,87996487014,8,516,1234,20
88001573731,88001573731,0,1730,2220,20
88001794556,88001794563,7,2043,1296,20
88002055215,88002055221,6,2804,1969,20
88002189149,88002189145,-4,1508,2255,20
88006641460,88006641454,-6,1725,8451,20
88008193475,88008193473,-2,1211,1989,20
88009526642,88009526643,1,1816,2440,20
88019736463,88019736460,-3,1043,2628,20
88022685174,88022685173,-1,901,1954,20
88023961259,88023961254,-5,864,2327,20
88030965768,88030965766,-2,1043,2609,20
88033420795,88033420790,-5,1072,2727,20
88035903977,88035903973,-4,1104,3572,20
88039459122,88039459118,-4,930,2618,20
88046828843,88046828850,7,7841,3294,20
88051079478,88051079475,-3,839,2729,20
88053181416,88053181412,-4,1323,2804,20
88061587389,88061587391,2,1370,1482,20
88067122953,88067122948,-5,1394,2349,20
88071243750,88071243747,-3,1306,2191,20
88074270186,88074270185,-1,1213,1687,20
88074510261,88074510257,-4,1003,1641,20
88074580221,88074580210,-11,27,3615,20
88075863000,88075863015,15,201,622,20
88077478745,88077478742,-3,1044,2026,20
88078714272,88078714277,5,1628,781,20
88080493809,88080493815,6,3487,1636,20
88080600293,88080600290,-3,962,2221,20
88080734094,88080734113,19,480,3301,20
88081801707,88081801711,4,6009,3516,20
88082739749,88082739746,-3,1202,2038,20
88085019831,88085019827,-4,817,1747,20
88086160050,88086160046,-4,1171,2950,20
88089217938,88089217935,-3,975,2475,20
88089562471,88089562468,-3,1250,2662,20
88092497921,88092497919,-2,1022,2490,20
88094273710,88094273708,-2,1231,2865,20
88096916205,88096916200,-5,1602,3530,20
88097606698,88097606694,-4,842,1939,20
88099072962,88099072958,-4,850,2232,20
88103712519,88103712518,-1,1068,2237,20
88105461414,88105461410,-4,1362,2076,20
88106893118,88106893113,-5,746,1409,20
88107096697,88107096695,-2,1279,2625,20
88108352162,88108352156,-6,889,1948,20
88110137861,88110137858,-3,949,1382,20
88111915295,88111915294,-1,1036,2056,20
88112610148,88112610142,-6,962,2942,20
88114103360,88114103376,16,403,1615,20
88115325170,88115325170,0,1141,1422,20
88120901220,88120901217,-3,1236,2711,20
88123716755,88123716751,-4,1064,2164,20
88125661039,88125661038,-1,957,1538,20
88128700955,88128700958,3,3521,3429,20
88129622316,88129622313,-3,1325,2129,20
88133583966,88133583965,-1,1654,1764,20
88134807434,88134807433,-1,1036,2007,20
88137572000,88137571997,-3,1249,2870,20
88139350023,88139350018,-5,695,1718,20
88145137979,88145137978,-1,1279,3175,20
88146577736,88146577735,-1,1325,1996,20
88148472557,88148472554,-3,917,1928,20
88155832610,88155832606,-4,994,2328,20
88160395950,88160395948,-2,1025,3048,20
88160745897,88160745902,5,1713,1243,20
88164335330,88164335326,-4,1153,1928,20
88164962074,88164962072,-2,1454,2415,20
88165841665,88165841663,-2,786,2348,20
88166486535,88166486532,-3,943,2001,20
88168743487,88168743487,0,1018,1842,20
88176219882,88176219878,-4,1088,1303,20
88181311088,88181311085,-3,1998,2630,20
88182911795,88182911790,-5,891,2193,20
88187256779,88187256775,-4,1270,2458,20
88188316767,88188316765,-2,826,2585,20
88194058525,88194058521,-4,1050,1756,20
88195778864,88195778862,-2,1941,3025,20
88196539499,88196539495,-4,855,1818,20
88202787755,88202787753,-2,614,2074,20
88216910512,88216910509,-3,863,1471,20
88218702358,88218702355,-3,1246,2364,20
88223500118,88223500114,-4,1241,2179,20
88224501086,88224501083,-3,1784,4949,20
88225086749,88225086754,5,5487,2987,20
88227217699,88227217696,-3,1027,1412,20
88227795669,88227795667,-2,1222,2244,20
88228177211,88228177210,-1,949,2136,20
88232139424,88232139426,2,1887,1832,20
88232328823,88232328821,-2,725,1347,20
88233813218,88233813215,-3,1262,2139,20
88234401441,88234401440,-1,1808,1703,20
88237959615,88237959610,-5,787,1706,20
88238611174,88238611170,-4,1109,2402,20
88239172442,88239172439,-3,1210,2599,20
88243712145,88243712143,-2,969,1096,20
88244452088,88244452086,-2,1299,1960,20
88245225161,88245225158,-3,981,2382,20
88251654283,88251654281,-2,996,2136,20
88253029402,88253029399,-3,1100,1836,20
88264877406,88264877402,-4,608,1130,20
88269437670,88269437670,0,1447,2319,20
88272346133,88272346132,-1,1154,1827,20
88274891231,88274891220,-11,1422,2689,20
88281693010,88281693006,-4,1339,1630,20
88283865895,88283865894,-1,923,2391,20
88284058474,88284058471,-3,924,1668,20
88288131438,88288131435,-3,1173,1768,20
88288694501,88288694498,-3,1287,2981,20
88290283634,88290283632,-2,1286,2813,20
88292705291,88292705286,-5,1018,2529,20
88294442222,88294442221,-1,1640,2670,20
88295471132,88295471130,-2,805,2150,20
88295740915,88295740913,-2,880,2373,20
88297682286,88297682283,-3,936,1805,20
88301681449,88301681445,-4,1117,2581,20
88306421126,88306421122,-4,1345,2144,20
88308578509,88308578509,0,1460,1733,20
88314954096,88314954090,-6,1020,2556,20
88317631910,88317631908,-2,1023,2350,20
88318502825,88318502822,-3,1103,3065,20
88324028231,88324028230,-1,1393,1841,20
88325775651,88325775647,-4,949,2822,20
88333259115,88333259118,3,1570,1735,20
88339835002,88339835014,12,7924,48081,20
88340746203,88340746198,-5,1087,2541,20
88342162698,88342162697,-1,740,1697,20
88342757475,88342757470,-5,895,2493,20
88350977277,88350977278,1,228,618,20
88354596629,88354596626,-3,892,2105,20
88354807999,88354808019,20,239,887,20
88355992303,88355992300,-3,956,2875,20
88360287975,88360287972,-3,1294,2756,20
88363191139,88363191137,-2,1074,2428,20
88364491301,88364491299,-2,1285,2080,20
88364638191,88364638189,-2,1100,2657,20
88367976325,88367976330,5,2231,1475,20
88369889649,88369889647,-2,1132,1511,20
88370803880,88370803899,19,794,1732,20
88372961902,88372961898,-4,884,1883,20
88376743141,88376743137,-4,1311,2050,20
88378634183,88378634178,-5,1010,2132,20
88378699252,88378699248,-4,1119,3139,20
88389994646,88389994644,-2,852,3395,20
88395104207,88395104205,-2,1109,2651,20
88395141296,88395141294,-2,1507,2285,20
88401426782,88401426777,-5,913,2415,20
88401871190,88401871206,16,1045,2965,20
88403020441,88403020438,-3,1104,2147,20
88404866419,88404866423,4,24085,17411,20
88407581522,88407581517,-5,986,2084,20
88408114146,88408114143,-3,896,1526,20
88408378144,88408378146,2,13065,13778,20
88417301103,88417301102,-1,1571,1906,20
88421762658,88421762650,-8,19205,17010,20
88423269254,88423269253,-1,1213,2044,20
88429220619,88429220636,17,666,4279,20
88435259295,88435259305,10,1202,1476,20
88439469790,88439469786,-4,884,1893,20
88441112001,88441112002,1,3693,2841,20
88443348118,88443348114,-4,777,1856,20
88443567935,88443567929,-6,1207,2142,20
88444353142,88444353121,-21,1053,2443,20
88445382539,88445382535,-4,1168,2850,20
88445640208,88445640205,-3,26135,17169,20
88448155845,88448155843,-2,1128,2676,20
88451744591,88451744589,-2,1105,2034,20
88453656951,88453656957,6,2325,1327,20
88455241246,88455241242,-4,974,3388,20
88463158814,88463158811,-3,1136,2212,20
88465065777,88465065780,3,837,1642,20
88466030965,88466030962,-3,1037,1935,20
88466277155,88466277154,-1,859,1576,20
88467526886,88467526882,-4,878,2023,20
88473734659,88473734657,-2,1350,3146,20
88479608634,88479608634,0,1493,2239,20
88479707731,88479707741,10,13161,39646,20
88482433002,88482433004,2,2238,1542,20
88484758518,88484758514,-4,1095,2618,20
88485779269,88485779265,-4,1214,1526,20
88488517765,88488517785,20,1591,1130,20
88491025013,88491025016,3,7947,26210,20
88491591359,88491591357,-2,1093,1683,20
88492127685,88492127682,-3,1068,2339,20
88492997002,88492997000,-2,2455,3656,20
88493128499,88493128496,-3,1621,2872,20
88503610998,88503610994,-4,1263,3435,20
88504301647,88504301639,-8,232,765,20
88515800557,88515800553,-4,1413,3507,20
88516336507,88516336510,3,3226,3413,20
88520842512,88520842508,-4,1060,3056,20
88526159022,88526159019,-3,1278,2967,20
88531638731,88531638726,-5,807,1369,20
88534227382,88534227392,10,14671,24739,20
88534612211,88534612210,-1,1072,1821,20
88536232779,88536232777,-2,1273,1384,20
88537060576,88537060573,-3,893,2832,20
88544739629,88544739626,-3,1363,2521,20
88549044023,88549044021,-2,964,1762,20
88550377190,88550377187,-3,989,1503,20
88552100501,88552100498,-3,1261,2132,20
88553027303,88553027301,-2,1123,2364,20
88558917574,88558917571,-3,1146,1944,20
88559480921,88559480927,6,1607,266,20
88564205428,88564205431,3,2308,1618,20
88566096836,88566096832,-4,1370,3035,20
88567294539,88567294535,-4,764,2804,20
88568683598,88568683595,-3,734,1740,20
88569042949,88569042931,-18,91,734,20
88571277407,88571277403,-4,2169,6630,20
88572756053,88572756049,-4,662,2004,20
88573562203,88573562202,-1,1624,2974,20
88577325422,88577325418,-4,712,1416,20
88578140224,88578140222,-2,1995,2961,20
88578201716,88578201713,-3,1033,1886,20
88582223966,88582223960,-6,842,2803,20
88586593542,88586593539,-3,1214,1885,20
88592784157,88592784154,-3,1549,2197,20
88593266786,88593266785,-1,1310,1962,20
88595541803,88595541801,-2,942,1650,20
88600102878,88600102874,-4,953,2542,20
88600179031,88600179013,-18,1147,1643,20
88604100450,88604100442,-8,1316,7418,20
88604325456,88604325451,-5,661,1444,20
88604648625,88604648622,-3,1156,3123,20
88605274902,88605274900,-2,1256,1823,20
88607498943,88607498947,4,2842,1531,20
88608180169,88608180166,-3,1268,2217,20
88612290065,88612290062,-3,1405,2908,20
88613408882,88613408879,-3,882,3352,20
88614257488,88614257487,-1,1076,2302,20
88614787735,88614787734,-1,1384,3241,20
88615121141,88615121142,1,1232,1341,20
88615540090,88615540087,-3,748,2193,20
88626236543,88626236543,0,1570,1704,20
88628775990,88628775985,-5,1507,3428,20
88629381001,88629380997,-4,2040,2762,20
88630210825,88630210831,6,4701,2154,20
88633365510,88633365507,-3,1254,2825,20
88642384849,88642384846,-3,850,2270,20
88642416216,88642416232,16,1245,3244,20
88642936650,88642936648,-2,1276,2168,20
88654972882,88654972879,-3,806,2833,20
88658058627,88658058626,-1,679,1104,20
88660225974,88660225967,-7,6522,25267,20
88660624797,88660624790,-7,900,2993,20
88661093687,88661093683,-4,117,651,20
88663060005,88663060005,0,1286,2574,20
88663716583,88663716581,-2,947,1553,20
88667633070,88667633072,2,1928,2021,20
88668151742,88668151742,0,1299,1634,20
88677543898,88677543891,-7,936,4349,20
88678405640,88678405638,-2,1176,2255,20
88679723163,88679723163,0,1724,2751,20
88680993573,88680993566,-7,752,3046,20
88681634678,88681634677,-1,1100,2342,20
88682024079,88682024076,-3,1029,2272,20
88688535943,88688535941,-2,1405,2839,20
88688861645,88688861643,-2,1242,2355,20
88694956453,88694956458,5,6016,2749,20
88696944298,88696944298,0,1285,2038,20
88706014864,88706014867,3,1379,811,20
88707741445,88707741467,22,1038,1856,20
88708845439,88708845452,13,136,986,20
88713124727,88713124724,-3,968,2382,20
88716970999,88716970998,-1,1241,2797,20
88717734006,88717734004,-2,1381,2792,20
88719734246,88719734244,-2,1282,2226,20
88721801386,88721801383,-3,855,2893,20
88724235699,88724235695,-4,845,2369,20
88725047507,88725047505,-2,1412,2310,20
88729268970,88729268965,-5,1206,1409,20
88731310874,88731310870,-4,1216,3047,20
88731440014,88731440010,-4,1440,2855,20
88732377929,88732377927,-2,1299,2330,20
88732816503,88732816503,0,1022,2311,20
88734751898,88734751893,-5,696,1702,20
88741119291,88741119286,-5,917,2627,20
88744661603,88744661603,0,1374,2341,20
88745201501,88745201498,-3,864,1800,20
88748029002,88748029000,-2,528,1925,20
88756062046,88756062042,-4,642,1789,20
88757941262,88757941262,0,830,1845,20
88760315127,88760315123,-4,893,2110,20
88764924213,88764924211,-2,1814,3126,20
88767530571,88767530567,-4,808,2201,20
88769361121,88769361117,-4,761,3627,20
88769585446,88769585433,-13,356,802,20
88769720902,88769720922,20,315,1184,20
88771008845,88771008842,-3,904,1804,20
88772093790,88772093803,13,31,688,20
88773771806,88773771804,-2,901,1433,20
88774557017,88774557014,-3,897,2142,20
88775378124,88775378109,-15,1335,2243,20
88775613662,88775613660,-2,1240,2676,20
88775920266,88775920262,-4,1290,1679,20
88777259149,88777259162,13,281,792,20
88780023716,88780023714,-2,1779,3722,20
88782086157,88782086143,-14,201,956,20
88783931996,88783931993,-3,1421,1941,20
88791822363,88791822361,-2,988,2032,20
88794767833,88794767828,-5,1137,2298,20
88796327069,88796327065,-4,1412,3088,20
88810855645,88810855642,-3,794,1728,20
88811563325,88811563323,-2,1193,1190,20
88814551992,88814551989,-3,1005,2497,20
88820588001,88820587995,-6,1182,2218,20
88821347977,88821347975,-2,1948,3254,20
88821793222,88821793218,-4,708,1882,20
88824670342,88824670341,-1,941,2179,20
88825132170,88825132166,-4,965,2056,20
88826041846,88826041844,-2,1310,2035,20
88826592226,88826592230,4,2218,1527,20
88829899954,88829899938,-16,204,672,20
88832640522,88832640518,-4,953,1386,20
88833098087,88833098082,-5,1211,2484,20
88834297367,88834297361,-6,1815,4587,20
88838437522,88838437518,-4,1305,2337,20
88847810927,88847810926,-1,1112,2235,20
88852902355,88852902353,-2,863,2102,20
88856702280,88856702295,15,10539,44388,20
88858265598,88858265594,-4,1029,3070,20
88859835220,88859835218,-2,1127,3039,20
88861362185,88861362180,-5,1617,2620,20
88862537864,88862537861,-3,1554,2657,20
88862670077,88862670074,-3,1246,2153,20
88862737877,88862737899,22,962,2074,20
88865574783,88865574782,-1,1143,2246,20
88870537220,88870537216,-4,1294,2263,20
88871119008,88871118999,-9,201,753,20
88871774175,88871774173,-2,912,2464,20
88877429009,88877429006,-3,1110,2496,20
88879428005,88879427999,-6,1581,5635,20
88885429583,88885429580,-3,1186,2323,20
88886356954,88886356953,-1,1007,1956,20
88888079275,88888079270,-5,1152,3523,20
88891481890,88891481885,-5,1193,5601,20
88894544316,88894544314,-2,991,2583,20
88896788130,88896788127,-3,944,2194,20
88901862057,88901862053,-4,1288,2027,20
88902910936,88902910959,23,788,2795,20
88903489291,88903489287,-4,878,2597,20
88907363677,88907363674,-3,1004,2214,20
88911672411,88911672406,-5,975,2556,20
88915149195,88915149194,-1,1037,2134,20
88917604767,88917604765,-2,1272,1828,20
88919245277,88919245275,-2,889,2099,20
88922073351,88922073347,-4,1237,3564,20
88923733501,88923733498,-3,1315,1645,20
88925701335,88925701329,-6,952,2516,20
88929737166,88929737162,-4,1053,2295,20
88930869037,88930869035,-2,927,1810,20
88931119670,88931119657,-13,214,647,20
88933485958,88933485952,-6,1360,3126,20
88938412658,88938412657,-1,1148,2124,20
88941912793,88941912788,-5,1225,2397,20
88943733645,88943733641,-4,1175,2344,20
88945955422,88945955420,-2,1241,2374,20
88946614095,88946614093,-2,738,2338,20
88947175582,88947175578,-4,1255,2457,20
88947450984,88947450988,4,2584,1943,20
88947545694,88947545691,-3,840,1888,20
88953514974,88953514970,-4,1075,2719,20
88954308949,88954308947,-2,1142,2210,20
88954742638,88954742637,-1,854,2355,20
88955415021,88955415019,-2,840,2287,20
88955521654,88955521653,-1,802,1537,20
88959185855,88959185849,-6,847,3678,20
88960194695,88960194681,-14,1320,3400,20
88968924331,88968924329,-2,1151,1419,20
88974489689,88974489685,-4,900,1722,20
88976635403,88976635402,-1,1250,2758,20
88978064096,88978064114,18,330,920,20
88980240965,88980240962,-3,1394,1617,20
88981952435,88981952433,-2,1032,2230,20
88982146659,88982146656,-3,931,2049,20
88982720425,88982720422,-3,1199,2182,20
88982861612,88982861631,19,499,1348,20
88983052945,88983052939,-6,949,3959,20
88984067783,88984067780,-3,1443,1662,20
88985601996,88985601995,-1,753,1641,20
88991069898,88991069894,-4,1066,2103,20
88993759020,88993759018,-2,667,1173,20
89000222278,89000222275,-3,1104,2019,20
89001448808,89001448805,-3,1329,2123,20
89006013995,89006013991,-4,1166,2748,20
89008984363,89008984361,-2,1546,2615,20
89009129258,89009129255,-3,824,1839,20
89015903074,89015903070,-4,1584,3881,20
89018060933,89018060939,6,2149,1704,20
89020783522,89020783521,-1,1311,1387,20
89023549779,89023549774,-5,1079,1978,20
89024919259,89024919255,-4,1067,1625,20
89027184925,89027184921,-4,1337,2257,20
89027268654,89027268651,-3,1003,1622,20
89028545249,89028545255,6,2079,1329,20
89031242140,89031242134,-6,754,1516,20
89034418553,89034418550,-3,1149,2032,20
89035886828,89035886822,-6,886,2511,20
89037250750,89037250749,-1,1508,2821,20
89038262016,89038262013,-3,1069,1969,20
89038363176,89038363165,-11,327,880,20
89039191518,89039191517,-1,890,2415,20
89042783182,89042783179,-3,898,2103,20
89045676625,89045676622,-3,1529,2438,20
89045841583,89045841579,-4,950,1915,20
89048888763,89048888760,-3,1632,3135,20
89060437711,89060437707,-4,1074,2475,20
89062058222,89062058221,-1,571,1609,20
89066409546,89066409548,2,3152,2639,20
89067227454,89067227460,6,1318,806,20
89067510245,89067510242,-3,1200,1759,20
89067683022,89067683005,-17,1253,2637,20
89071232731,89071232711,-20,506,632,20
89074175617,89074175614,-3,1037,2718,20
89076564846,89076564844,-2,1257,2562,20
89079707746,89079707748,2,2408,2377,20
89082750631,89082750625,-6,1000,3248,20
89084011710,89084011710,0,1431,2643,20
89084817906,89084817912,6,2975,1237,20
89087944142,89087944141,-1,1553,2829,20
89087999386,89087999382,-4,1205,2795,20
89088119898,89088119893,-5,936,1626,20
89091625779,89091625775,-4,806,1257,20
89097872528,89097872527,-1,1194,2987,20
89098184981,89098184995,14,135,766,20
89101231198,89101231194,-4,889,2114,20
89103511298,89103511294,-4,736,2016,20
89108088851,89108088849,-2,743,2104,20
89108288085,89108288075,-10,35938,15917,20
89116642273,89116642270,-3,685,1544,20
89116923910,89116923911,1,223,636,20
89125205726,89125205722,-4,998,2165,20
89127379093,89127379092,-1,1338,2506,20
89127809750,89127809746,-4,1105,2423,20
89130277402,89130277399,-3,1377,2282,20
89132508369,89132508366,-3,1057,3036,20
89134724926,89134724922,-4,935,2815,20
89138443999,89138443997,-2,738,1555,20
89140601744,89140601741,-3,1346,3424,20
89146662517,89146662515,-2,1167,2863,20
89146778743,89146778742,-1,984,2928,20
89149877207,89149877197,-10,831,2091,20
89151509143,89151509146,3,2441,2225,20
89156939158,89156939154,-4,981,1838,20
89161141359,89161141354,-5,881,2735,20
89161938427,89161938425,-2,1200,2130,20
89162724302,89162724321,19,828,2279,20
89168376773,89168376778,5,34818,17989,20
89168570903,89168570907,4,11412,9145,20
89170440073,89170440074,1,1380,1623,20
89171298997,89171298999,2,915,1262,20
89172497615,89172497616,1,25388,91167,20
89181499198,89181499196,-2,943,1843,20
89185721777,89185721772,-5,1025,2347,20
89186351665,89186351667,2,1354,1201,20
89186649391,89186649388,-3,1057,2542,20
89187965665,89187965664,-1,954,2069,20
89189520543,89189520538,-5,1245,1981,20
89189981120,89189981117,-3,1513,2425,20
89197004450,89197004449,-1,1283,2142,20
89197892788,89197892790,2,2194,2193,20
89199530458,89199530454,-4,1161,3032,20
89203536923,89203536922,-1,1260,3374,20
89204184246,89204184240,-6,839,2016,20
89206616399,89206616396,-3,1089,2257,20
89206956488,89206956489,1,1968,2522,20
89208543990,89208543987,-3,966,3603,20
89210595390,89210595386,-4,1258,1852,20
89215316694,89215316689,-5,708,1461,20
89215577901,89215577899,-2,1037,1969,20
89215799126,89215799126,0,1606,2029,20
89215839575,89215839573,-2,979,2045,20
89224348789,89224348785,-4,1160,2551,20
89228719231,89228719229,-2,1374,2690,20
89229806082,89229806079,-3,1297,3019,20
89232564910,89232564905,-5,1063,1925,20
89233480190,89233480186,-4,1312,1791,20
89234069520,89234069518,-2,1069,1997,20
89238241679,89238241677,-2,1194,2548,20
89243592096,89243592114,18,982,1747,20
89259332284,89259332282,-2,937,1585,20
89264604657,89264604654,-3,1505,2097,20
89265429758,89265429757,-1,1040,2966,20
89266782742,89266782737,-5,994,2338,20
89270622661,89270622659,-2,1058,2070,20
89270873455,89270873453,-2,1240,2113,20
89274422753,89274422747,-6,1437,2320,20
89275256547,89275256546,-1,1275,2207,20
89276840890,89276840896,6,14270,22284,20
89279576450,89279576449,-1,479,1631,20
89281338376,89281338373,-3,1159,2324,20
89283263083,89283263080,-3,930,2360,20
89289260861,89289260862,1,1355,1840,20
89295525390,89295525398,8,2042,1004,20
89300772930,89300772929,-1,1135,2008,20
89303378478,89303378477,-1,1090,1884,20
89305773829,89305773826,-3,3564,7973,20
89308227910,89308227912,2,2192,2181,20
89313717699,89313717697,-2,441,682,20
89315915327,89315915307,-20,216,805,20
89317389673,89317389668,-5,1084,2933,20
89319202807,89319202805,-2,855,1985,20
89320022127,89320022125,-2,1285,2392,20
89321832115,89321832114,-1,1388,2332,20
89322954845,89322954841,-4,1475,2352,20
89323032246,89323032254,8,152,1064,20
89325587399,89325587394,-5,1271,2256,20
89326489609,89326489606,-3,1736,2266,20
89328370494,89328370493,-1,885,2174,20
89328476935,89328476938,3,3121,2227,20
89329445002,89329445001,-1,1144,3398,20
89331058227,89331058223,-4,812,2063,20
89332195252,89332195250,-2,1328,2008,20
89332968909,89332968909,0,1360,2303,20
89334067942,89334067941,-1,1017,2351,20
89335315751,89335315756,5,2462,1471,20
89336491275,89336491272,-3,825,2801,20
89336865839,89336865859,20,887,2436,20
89337106407,89337106405,-2,1203,2305,20
89338416127,89338416123,-4,1022,1806,20
89340202949,89340202947,-2,1232,2070,20
89345877091,89345877089,-2,1180,2187,20
89349050388,89349050386,-2,934,2428,20
89354160868,89354160862,-6,845,3151,20
89355296891,89355296886,-5,1211,1872,20
89357553775,89357553773,-2,1475,3164,20
89359007087,89359007084,-3,1274,3266,20
89359853027,89359853025,-2,1081,2850,20
89362017733,89362017729,-4,1156,2187,20
89362098799,89362098795,-4,916,2512,20
89364102894,89364102891,-3,1254,2298,20
89367803292,89367803294,2,1325,1666,20
89368297956,89368297946,-10,1252,2502,20
89371587793,89371587791,-2,709,1928,20
89375749418,89375749414,-4,1264,2733,20
89380970875,89380970874,-1,694,2016,20
89383921944,89383921948,4,8202,31287,20
89384158847,89384158845,-2,1472,2398,20
89384909850,89384909848,-2,1192,2414,20
89387022661,89387022658,-3,826,1795,20
89391526863,89391526857,-6,1401,2025,20
89393360773,89393360769,-4,1101,2135,20
89393962633,89393962628,-5,1002,2146,20
89396726372,89396726370,-2,951,2181,20
89396920173,89396920161,-12,1049,2159,20
89397021621,89397021640,19,690,2031,20
89401473613,89401473618,5,1953,1201,20
89402351111,89402351109,-2,868,2277,20
89402702254,89402702243,-11,1019,2860,20
89414120677,89414120674,-3,1442,3140,20
89414937037,89414937054,17,398,1366,20
89418602242,89418602241,-1,1726,2040,20
89421781807,89421781804,-3,1034,1819,20
89422363351,89422363351,0,77,896,20
89423147890,89423147888,-2,1191,2728,20
89425210325,89425210322,-3,1575,3775,20
89426289050,89426289047,-3,784,2332,20
89432047830,89432047827,-3,1149,2137,20
89433064477,89433064474,-3,1166,2569,20
89433866026,89433866026,0,1154,1799,20
89437888186,89437888190,4,3339,2102,20
89440143235,89440143215,-20,1743,3445,20
89441644741,89441644721,-20,257,636,20
89444731626,89444731622,-4,1351,3222,20
89447476953,89447476950,-3,1472,2844,20
89453088246,89453088241,-5,914,2373,20
89458741219,89458741217,-2,1774,3798,20
89466142042,89466142047,5,2037,1230,20
89469005437,89469005436,-1,971,2120,20
89469478501,89469478498,-3,1427,2600,20
89471170015,89471170011,-4,1038,3773,20
89471198222,89471198215,-7,1352,2015,20
89471957423,89471957418,-5,1006,1279,20
89480543405,89480543403,-2,694,1733,20
89481736409,89481736404,-5,1270,2281,20
89491232470,89491232466,-4,1310,3418,20
89492652257,89492652254,-3,924,2024,20
89492837605,89492837621,16,444,981,20
89493826478,89493826476,-2,881,2498,20
89498608478,89498608474,-4,773,2365,20
89498944884,89498944874,-10,1059,1893,20
89503497534,89503497534,0,1275,2302,20
89503603419,89503603417,-2,1184,1830,20
89504518478,89504518476,-2,1759,3141,20
89504813690,89504813690,0,1383,2177,20
89514403294,89514403292,-2,1345,3062,20
89519716907,89519716904,-3,912,2421,20
89520068191,89520068187,-4,1094,3253,20
89522959994,89522959991,-3,730,1786,20
89530271566,89530271565,-1,1288,3355,20
89531061413,89531061410,-3,864,1187,20
89532427758,89532427754,-4,1185,2242,20
89536098703,89536098702,-1,1263,3302,20
89536933070,89536933066,-4,1296,2772,20
89537460969,89537460965,-4,725,2055,20
89544144844,89544144841,-3,1043,2534,20
89544559783,89544559781,-2,1080,1896,20
89550647627,89550647625,-2,1143,3485,20
89550755735,89550755733,-2,1470,2354,20
89550949818,89550949814,-4,938,1653,20
89553532144,89553532140,-4,1429,2912,20
89555452402,89555452399,-3,1249,2526,20
89556086261,89556086261,0,1233,1779,20
89560787884,89560787890,6,2673,1433,20
89561465764,89561465765,1,792,2058,20
89566532262,89566532258,-4,828,2444,20
89568272274,89568272270,-4,1192,1955,20
89572534094,89572534094,0,1142,2045,20
89573279858,89573279854,-4,1227,2427,20
89577385818,89577385816,-2,1361,3094,20
89577858398,89577858376,-22,1136,1999,20
89579230308,89579230303,-5,1095,1871,20
89580526221,89580526218,-3,1235,1691,20
89583900040,89583900034,-6,1256,2318,20
89586693379,89586693377,-2,2087,3958,20
89593538134,89593538131,-3,1448,3209,20
89600884470,89600884466,-4,888,2643,20
89603256882,89603256878,-4,908,2280,20
89606679157,89606679154,-3,824,2018,20
89608716325,89608716321,-4,935,2362,20
89609933538,89609933535,-3,1390,2568,20
89615191972,89615191970,-2,1214,2156,20
89616167407,89616167425,18,233,1356,20
89617875807,89617875805,-2,1049,1662,20
89618161418,89618161418,0,1195,1999,20
89618599191,89618599189,-2,2939,4597,20
89618929606,89618929602,-4,1683,2387,20
89619185965,89619185961,-4,895,2306,20
89621188470,89621188468,-2,1341,2361,20
89621696875,89621696872,-3,834,2003,20
89624729818,89624729813,-5,988,2168,20
89625924579,89625924576,-3,788,2004,20
89630062143,89630062145,2,953,1227,20
89632655985,89632655981,-4,957,2164,20
89632848138,89632848137,-1,930,1948,20
89640696883,89640696879,-4,1210,1772,20
89643324870,89643324865,-5,1136,2935,20
89644053222,89644053226,4,1198,1328,20
89646753998,89646753994,-4,874,3074,20
89647492983,89647492980,-3,1270,2958,20
89648646679,89648646679,0,850,1298,20
89648848349,89648848345,-4,1412,2261,20
89656934743,89656934737,-6,1127,2415,20
89657621454,89657621465,11,40,678,20
89659983642,89659983639,-3,808,2110,20
89673028862,89673028860,-2,1121,2991,20
89673506150,89673506146,-4,1038,1952,20
89676061335,89676061333,-2,1122,2453,20
89677669165,89677669158,-7,902,3737,20
89679724578,89679724576,-2,1508,1988,20
89683242756,89683242762,6,10240,18751,20
89688970254,89688970251,-3,568,1228,20
89694694848,89694694845,-3,1287,3562,20
89696356649,89696356654,5,4638,2113,20
89701502442,89701502441,-1,1741,2977,20
89701829238,89701829234,-4,1426,2385,20
89702490845,89702490831,-14,159,728,20
89703241255,89703241274,19,939,1532,20
89705627481,89705627478,-3,1251,2176,20
89708966010,89708966009,-1,1327,2080,20
89715343774,89715343774,0,967,2226,20
89718908921,89718908923,2,17924,22039,20
89719093647,89719093646,-1,1264,2424,20
89723208615,89723208613,-2,826,1159,20
89723894991,89723894970,-21,1266,2153,20
89732156857,89732156850,-7,864,3563,20
89735343211,89735343206,-5,1175,2505,20
89743121771,89743121765,-6,1649,6096,20
89745723868,89745723859,-9,1139,2713,20
89751849744,89751849742,-2,1512,2668,20
89759183085,89759183082,-3,1474,2822,20
89761825686,89761825687,1,925,1118,20
89764380162,89764380163,1,1071,1568,20
89768680152,89768680150,-2,1369,2846,20
89771578318,89771578312,-6,1098,3043,20
89773607484,89773607480,-4,905,1880,20
89774221842,89774221838,-4,838,1053,20
89774870967,89774870986,19,799,2923,20
89778158625,89778158625,0,959,1856,20
89786761933,89786761930,-3,1061,2020,20
89790104361,89790104358,-3,1323,2090,20
89792919512,89792919518,6,3811,1831,20
89796731923,89796731930,7,7306,1202,20
89798295491,89798295488,-3,781,2262,20
89803473002,89803473004,2,1100,1608,20
89814999201,89814999205,4,3040,1640,20
89818383214,89818383212,-2,1173,2517,20
89818546243,89818546238,-5,1617,3151,20
89825540797,89825540801,4,1927,1814,20
89825728167,89825728162,-5,1207,2625,20
89826078709,89826078706,-3,1021,1969,20
89828770911,89828770924,13,163,821,20
89830259086,89830259086,0,723,1803,20
89831720087,89831720085,-2,991,1517,20
89831910475,89831910472,-3,818,2660,20
89837513577,89837513574,-3,855,2069,20
89838841266,89838841264,-2,1002,2776,20
89838976167,89838976148,-19,1287,2527,20
89839881305,89839881302,-3,1422,2905,20
89840880062,89840880057,-5,881,1887,20
89844068838,89844068835,-3,1462,2824,20
89848079107,89848079106,-1,882,1931,20
89852828726,89852828722,-4,1066,2109,20
89864608753,89864608750,-3,1089,2732,20
89864990378,89864990375,-3,1047,2084,20
89867448430,89867448428,-2,1289,1626,20
89871891310,89871891306,-4,1040,2341,20
89875175242,89875175240,-2,1010,2216,20
89875843747,89875843743,-4,904,1858,20
89877646891,89877646890,-1,1260,3022,20
89880937685,89880937679,-6,873,3103,20
89881014318,89881014331,13,825,4491,20
89885179817,89885179812,-5,806,1758,20
89885810797,89885810791,-6,1365,5089,20
89887770053,89887770050,-3,1208,2663,20
89887898719,89887898728,9,203,1162,20
89891659637,89891659632,-5,780,2769,20
89894854991,89894854987,-4,1486,2832,20
89901693706,89901693703,-3,1079,2440,20
89907802861,89907802858,-3,783,1961,20
89909498717,89909498717,0,1835,2111,20
89915739710,89915739706,-4,965,1850,20
89916225000,89916224997,-3,1207,2593,20
89917575332,89917575329,-3,933,1611,20
89928484892,89928484890,-2,913,1663,20
89929770117,89929770114,-3,1180,2157,20
89938930388,89938930386,-2,1632,1469,20
89940138482,89940138479,-3,1488,2010,20
89947176854,89947176854,0,1672,1814,20
89947353439,89947353437,-2,717,1741,20
89951148523,89951148521,-2,706,1979,20
89952046454,89952046474,20,832,2036,20
89952508795,89952508791,-4,1081,2165,20
89953196263,89953196261,-2,1449,2546,20
89968050999,89968051000,1,1509,1168,20
89971920694,89971920690,-4,1354,2483,20
89982437494,89982437490,-4,1493,2926,20
89984990306,89984990302,-4,627,2302,20
89986091859,89986091855,-4,813,2460,20
89987660959,89987660956,-3,1375,2401,20
89991642130,89991642128,-2,1458,2428,20
89991788827,89991788827,0,1272,2182,20
89999264234,89999264230,-4,1003,2755,20
90004219150,90004219146,-4,1428,2593,20
90004509865,90004509866,1,1175,1219,20
90006819434,90006819430,-4,1294,2433,20
90006941085,90006941074,-11,937,2424,20
90007257671,90007257666,-5,967,1759,20
90008630891,90008630889,-2,1128,1768,20
90014122902,90014122901,-1,1114,2232,20
90018615755,90018615755,0,1280,2295,20
90026863086,90026863083,-3,1130,2473,20
90031535383,90031535380,-3,1147,3029,20
90035760978,90035760976,-2,1045,2694,20
90039715371,90039715367,-4,843,1497,20
90040206619,90040206614,-5,1021,2816,20
90040568338,90040568338,0,1010,2337,20
90042907091,90042907086,-5,695,2768,20
90043247148,90043247146,-2,19210,8243,20
90044829204,90044829211,7,1720,557,20
90047180758,90047180755,-3,928,1336,20
90049220863,90049220861,-2,1993,2367,20
90049509050,90049509049,-1,1169,1666,20
90051584949,90051584946,-3,988,2147,20
90052068539,90052068534,-5,1461,2742,20
90053289095,90053289091,-4,1081,1772,20
90056388615,90056388612,-3,951,2028,20
90065445394,90065445390,-4,669,2827,20
90068195883,90068195880,-3,1111,2125,20
90068990537,90068990534,-3,1244,2071,20
90071229153,90071229148,-5,1180,2855,20
90073221989,90073221983,-6,1374,2980,20
90073790646,90073790645,-1,1140,2211,20
90076139688,90076139703,15,252,654,20
90077288298,90077288295,-3,1154,1732,20
90080166498,90080166497,-1,1731,2042,20
90085050622,90085050619,-3,926,2341,20
90085161514,90085161513,-1,1017,1899,20
90088786400,90088786397,-3,1818,3232,20
90093574904,90093574902,-2,1280,2485,20
90094547021,90094547001,-20,1220,2692,20
90097478883,90097478882,-1,1151,3023,20
90098857923,90098857920,-3,1016,1580,20
90099759979,90099759977,-2,1043,1889,20
90100113391,90100113387,-4,1115,2764,20
90105664239,90105664236,-3,1715,2478,20
90107369551,90107369546,-5,1260,1954,20
90109190235,90109190255,20,797,2820,20
90114538434,90114538438,4,2162,1582,20
90117521695,90117521691,-4,1012,2242,20
90119189087,90119189086,-1,1540,2509,20
90121994610,90121994605,-5,1097,1721,20
90123311253,90123311258,5,3689,2332,20
90125024137,90125024134,-3,934,2247,20
90134710723,90134710721,-2,1399,3040,20
90138582826,90138582822,-4,1058,2786,20
90140397165,90140397162,-3,1708,3116,20
90145554978,90145554974,-4,1446,3979,20
90147941726,90147941722,-4,1024,3322,20
90148624755,90148624750,-5,1369,3246,20
90153105034,90153105031,-3,822,2309,20
90153742021,90153742017,-4,1002,2259,20
90153770410,90153770414,4,3070,2052,20
90163460174,90163460178,4,2426,1501,20
90165343451,90165343447,-4,957,3314,20
90169807038,90169807046,8,3230,1309,20
90171643983,90171643980,-3,1020,1858,20
90172127666,90172127663,-3,879,2236,20
90178505406,90178505404,-2,1298,2416,20
90179556006,90179556011,5,2512,1473,20
90180117364,90180117364,0,975,1278,20
90180484142,90180484137,-5,838,1405,20
90181482931,90181482928,-3,1068,1620,20
90185818066,90185818070,4,1726,966,20
90186699638,90186699634,-4,827,2009,20
90188699395,90188699390,-5,1532,2563,20
90191509646,90191509642,-4,898,1655,20
90194470551,90194470546,-5,1322,2088,20
90194531163,90194531159,-4,924,2606,20
90196637244,90196637238,-6,1034,2521,20
90199514737,90199514732,-5,904,2320,20
90199783204,90199783210,6,22454,48623,20
90199951840,90199951838,-2,1259,3171,20
90203663985,90203663981,-4,920,2357,20
90204971398,90204971400,2,3015,2612,20
90209434635,90209434633,-2,1197,2326,20
90210737424,90210737421,-3,1288,2254,20
90213374460,90213374454,-6,1699,5502,20
90214066637,90214066635,-2,1441,2376,20
90219716731,90219716726,-5,1187,2361,20
90222586328,90222586326,-2,1197,2055,20
90223363322,90223363318,-4,1016,1924,20
90223576943,90223576943,0,99,1276,20
90225138574,90225138570,-4,490,834,20
90228029649,90228029648,-1,998,2483,20
90230608183,90230608181,-2,594,1550,20
90232876922,90232876918,-4,1165,2407,20
90233069337,90233069341,4,2865,1469,20
90233997728,90233997727,-1,1065,1974,20
90234289061,90234289058,-3,925,1570,20
90235512826,90235512824,-2,1444,2374,20
90239183204,90239183201,-3,1230,1967,20
90241191947,90241191945,-2,832,1093,20
90244542638,90244542634,-4,921,2273,20
90245328092,90245328087,-5,1069,2024,20
90246581997,90246581993,-4,1168,2746,20
90248383053,90248383050,-3,597,1171,20
90253693875,90253693888,13,711,1263,20
90256837264,90256837262,-2,1296,1995,20
90259558303,90259558302,-1,1025,966,20
90259813781,90259813801,20,534,1830,20
90263204027,90263204021,-6,1120,2378,20
90265154542,90265154552,10,11477,45576,20
90276000570,90276000569,-1,1541,1600,20
90277127944,90277127937,-7,1298,2886,20
90279232174,90279232170,-4,870,2716,20
90285274139,90285274134,-5,1235,2627,20
90286316670,90286316669,-1,23195,31183,20
90290150329,90290150327,-2,1528,2578,20
90292511818,90292511815,-3,1707,3227,20
90297225755,90297225757,2,1511,1743,20
90297471971,90297471968,-3,864,2544,20
90298364694,90298364689,-5,1100,1751,20
90298503294,90298503273,-21,1024,2314,20
90300756274,90300756274,0,1095,1476,20
90302513529,90302513526,-3,993,1765,20
90302558710,90302558706,-4,1481,2179,20
90304734862,90304734858,-4,1445,4416,20
90306875400,90306875397,-3,1292,1947,20
90313874670,90313874664,-6,1215,3743,20
90313930855,90313930841,-14,912,1843,20
90315762181,90315762179,-2,1247,1730,20
90318620193,90318620189,-4,738,2271,20
90319132422,90319132415,-7,1120,2885,20
90323296746,90323296744,-2,1119,2177,20
90324235257,90324235255,-2,1303,1485,20
90325746799,90325746801,2,1565,1857,20
90328986500,90328986497,-3,1223,2579,20
90329780046,90329780046,0,1493,2949,20
90336768911,90336768906,-5,1032,2317,20
90337663944,90337663961,17,846,1631,20
90338755535,90338755534,-1,1134,1779,20
90340790142,90340790140,-2,1327,2283,20
90343415291,90343415289,-2,1026,2948,20
90351002582,90351002581,-1,981,2238,20
90355673706,90355673704,-2,1458,2397,20
90357111716,90357111715,-1,1032,1786,20
90361426766,90361426765,-1,1074,2406,20
90368654739,90368654738,-1,1110,1845,20
90368875720,90368875717,-3,861,1325,20
90369244970,90369244965,-5,1247,2322,20
90377788626,90377788624,-2,1159,2583,20
90379019467,90379019456,-11,881,334,20
90380419333,90380419336,3,3873,3074,20
90384038333,90384038330,-3,790,2561,20
90385800639,90385800635,-4,1163,3008,20
90385894320,90385894320,0,7695,12038,20
90386685466,90386685462,-4,733,1866,20
90387471899,90387471898,-1,990,2886,20
90391361872,90391361868,-4,1197,2516,20
90391642895,90391642894,-1,921,2069,20
90393776801,90393776805,4,3853,1661,20
90396050979,90396050974,-5,1140,2489,20
90399743818,90399743816,-2,1295,2359,20
90402179766,90402179763,-3,772,2241,20
90403226050,90403226055,5,4637,2597,20
90403972694,90403972691,-3,987,2811,20
90404985710,90404985712,2,1285,1793,20
90406949391,90406949387,-4,869,1869,20
90407687337,90407687332,-5,774,1741,20
90408502322,90408502320,-2,1515,2590,20
90409046097,90409046103,6,3598,1797,20
90413425373,90413425366,-7,1145,2150,20
90413928170,90413928165,-5,1290,2472,20
90425890314,90425890334,20,1180,2728,20
90429927109,90429927105,-4,991,1896,20
90430695774,90430695775,1,970,1193,20
90434057683,90434057686,3,4459,3512,20
90435226843,90435226840,-3,1027,2450,20
90443812679,90443812677,-2,1059,2041,20
90443851676,90443851690,14,553,2369,20
90445501025,90445501021,-4,1053,2348,20
90446763047,90446763046,-1,919,2572,20
90448243495,90448243492,-3,623,1887,20
90454208824,90454208821,-3,1218,2892,20
90454352511,90454352522,11,14573,20127,20
90454983504,90454983513,9,28795,53990,20
90455305712,90455305711,-1,1517,2140,20
90455459428,90455459450,22,267,865,20
90456541257,90456541254,-3,1228,1699,20
90457270383,90457270384,1,891,1575,20
90458791490,90458791487,-3,985,1689,20
90458856151,90458856148,-3,1476,2720,20
90460615113,90460615110,-3,1341,2233,20
90460869342,90460869358,16,1290,2213,20
90464683025,90464683022,-3,863,1677,20
90468836583,90468836581,-2,1237,2613,20
90470648696,90470648694,-2,1629,2560,20
90471087187,90471087182,-5,860,1862,20
90478516680,90478516683,3,3887,2819,20
90485544333,90485544329,-4,935,3329,20
90490847684,90490847682,-2,1250,1930,20
90494030166,90494030164,-2,1629,2655,20
90496950021,90496950017,-4,1284,2824,20
90498262162,90498262160,-2,969,2285,20
90501715340,90501715337,-3,954,2220,20
90501744333,90501744331,-2,1375,2925,20
90502466787,90502466782,-5,592,1901,20
90507724559,90507724557,-2,1064,3157,20
90514919659,90514919657,-2,1046,2068,20
90519883650,90519883647,-3,905,2194,20
90522683564,90522683557,-7,752,1785,20
90525726953,90525726951,-2,1164,1579,20
90529659898,90529659903,5,2819,1111,20
90537987674,90537987671,-3,1163,2082,20
90538076171,90538076168,-3,718,1966,20
90547774115,90547774113,-2,1022,1927,20
90548666579,90548666577,-2,886,1389,20
90551513626,90551513626,0,862,2234,20
90555788267,90555788274,7,1034,2321,20
90562617511,90562617514,3,1474,1260,20
90568063200,90568063193,-7,1459,4826,20
90569535312,90569535309,-3,1682,3543,20
90570858864,90570858864,0,1140,2088,20
90571319906,90571319901,-5,1001,2677,20
90571625983,90571625979,-4,1369,2733,20
90573902099,90573902116,17,952,2107,20
90575029547,90575029546,-1,1155,1718,20
90576032927,90576032926,-1,694,1386,20
90580969273,90580969270,-3,972,1352,20
90584604639,90584604635,-4,1079,2769,20
90586636515,90586636514,-1,645,2019,20
90592259802,90592259810,8,8229,32987,20
90593398934,90593398932,-2,825,2475,20
90594405360,90594405366,6,2698,1195,20
90599155933,90599155937,4,19471,28011,20
90603504935,90603504942,7,3390,1764,20
90608073900,90608073914,14,163,1001,20
90608524937,90608524933,-4,116,844,20
90615026169,90615026166,-3,1401,2908,20
90616489983,90616489980,-3,1083,1456,20
90617773303,90617773298,-5,1277,2535,20
90619140796,90619140794,-2,1469,2822,20
90621650445,90621650440,-5,1081,2456,20
90625566839,90625566837,-2,1448,2624,20
90626207520,90626207519,-1,1408,3807,20
90626612994,90626612990,-4,678,1691,20
90628114601,90628114598,-3,1051,2438,20
90632261250,90632261249,-1,1239,1564,20
90633200839,90633200837,-2,860,2288,20
90633482237,90633482217,-20,884,2992,20
90634675640,90634675654,14,164,964,20
90636302634,90636302641,7,1711,951,20
90636765234,90636765230,-4,1453,2975,20
90637093334,90637093333,-1,718,1663,20
90641256289,90641256286,-3,668,1360,20
90643154139,90643154135,-4,1057,1869,20
90643733754,90643733756,2,2191,2138,20
90647798395,90647798401,6,2272,1728,20
90651427993,90651427990,-3,1129,3208,20
90652505470,90652505469,-1,1317,1818,20
90654309585,90654309582,-3,1064,2927,20
90656596019,90656596016,-3,1562,2840,20
90657910435,90657910432,-3,1465,2395,20
90660541766,90660541765,-1,1039,2250,20
90661097927,90661097923,-4,1215,3210,20
90661503456,90661503474,18,986,2114,20
90662151327,90662151325,-2,777,2645,20
90662266597,90662266577,-20,982,1946,20
90662808340,90662808337,-3,1253,2686,20
90667336622,90667336619,-3,1122,1359,20
90670845050,90670845048,-2,789,1906,20
90672147143,90672147141,-2,960,1413,20
90673039022,90673039034,12,16793,24949,20
90676864167,90676864161,-6,1243,3108,20
90677125285,90677125283,-2,995,1772,20
90677432942,90677432934,-8,1385,2196,20
90677820581,90677820578,-3,1294,1852,20
90687624485,90687624482,-3,959,2141,20
90688480365,90688480362,-3,1352,1732,20
90689025521,90689025518,-3,1107,2599,20
90689820376,90689820395,19,748,1241,20
90697576073,90697576069,-4,1803,3504,20
90697875132,90697875117,-15,184,1132,20
90698830684,90698830681,-3,831,1759,20
90699624511,90699624531,20,674,1115,20
90701261622,90701261625,3,1412,1361,20
90702158230,90702158225,-5,1232,2885,20
90702800757,90702800760,3,3078,3092,20
90703447118,90703447114,-4,1818,2488,20
90703512178,90703512176,-2,1455,2830,20
90706944443,90706944441,-2,1485,2542,20
90708483923,90708483919,-4,1299,2708,20
90708976810,90708976805,-5,942,1876,20
90709783341,90709783340,-1,1038,2100,20
90713072718,90713072715,-3,1081,2892,20
90717915054,90717915057,3,952,1515,20
90724872953,90724872948,-5,1186,2726,20
90729805611,90729805610,-1,1173,2087,20
90730065788,90730065806,18,1060,2262,20
90738750983,90738750980,-3,1117,2356,20
90746996327,90746996323,-4,879,2419,20
90757135979,90757135978,-1,1781,2739,20
90762347382,90762347380,-2,1530,1516,20
90764145713,90764145710,-3,1104,2402,20
90767250015,90767250011,-4,1017,1313,20
90770293344,90770293341,-3,1070,2580,20
90770749970,90770749969,-1,1176,2859,20
90772858946,90772858945,-1,1229,1689,20
90775781938,90775781941,3,2667,1986,20
90777839511,90777839510,-1,4488,6901,20
90780880257,90780880253,-4,1258,3739,20
90786507613,90786507610,-3,1753,3095,20
90791212039,90791212035,-4,840,2415,20
90791294766,90791294782,16,337,1076,20
90794164073,90794164069,-4,964,1656,20
90794428870,90794428865,-5,962,2442,20
90794780506,90794780503,-3,1491,2451,20
90811904721,90811904723,2,1182,1133,20
90814741273,90814741266,-7,2630,7691,20
90814913863,90814913858,-5,1019,2492,20
90816325610,90816325607,-3,1239,3143,20
90816658421,90816658416,-5,1057,1805,20
90817153831,90817153819,-12,13325,41685,20
90819782154,90819782149,-5,949,2802,20
90820958797,90820958778,-19,1690,2308,20
90829443334,90829443333,-1,1122,2534,20
90833735154,90833735151,-3,1073,3063,20
90836135198,90836135195,-3,1439,3486,20
90839890657,90839890654,-3,1432,2396,20
90840578901,90840578887,-14,148,691,20
90841445699,90841445694,-5,1213,2483,20
90843588765,90843588772,7,5154,2363,20
90847193002,90847193000,-2,1687,2550,20
90848545449,90848545447,-2,1432,2738,20
90852694426,90852694425,-1,1231,1708,20
90854975969,90854975966,-3,1439,2823,20
90856086535,90856086538,3,1361,1287,20
90857002499,90857002498,-1,1126,2289,20
90857237669,90857237687,18,398,1153,20
90858460564,90858460562,-2,1624,2665,20
90863447513,90863447507,-6,1541,3430,20
90865652785,90865652783,-2,1520,2887,20
90866439089,90866439083,-6,1222,3188,20
90875380511,90875380509,-2,1097,1503,20
90879283832,90879283828,-4,1097,2336,20
90880404710,90880404708,-2,1268,2116,20
90881993363,90881993361,-2,959,1766,20
90883708422,90883708420,-2,1068,2334,20
90884962919,90884962916,-3,1168,2298,20
90886565198,90886565194,-4,1163,2021,20
90891673530,90891673526,-4,944,1818,20
90896580261,90896580262,1,1391,1708,20
90898031674,90898031670,-4,829,1967,20
90900295778,90900295775,-3,1401,2359,20
90900577078,90900577074,-4,835,1902,20
90903242414,90903242409,-5,679,2069,20
90903335508,90903335502,-6,335,1097,20
90907127253,90907127249,-4,1178,1980,20
90910157703,90910157703,0,1856,1868,20
90915087671,90915087669,-2,1892,3016,20
90919972057,90919972054,-3,1774,2980,20
90921070089,90921070071,-18,22685,28942,20
90921606451,90921606450,-1,700,1390,20
90923459718,90923459714,-4,1046,1923,20
90924582850,90924582856,6,4158,2416,20
90924698715,90924698711,-4,1189,1777,20
90925135849,90925135857,8,955,1588,20
90933250935,90933250931,-4,879,2099,20
90934045814,90934045821,7,3834,1709,20
90937143160,90937143157,-3,1364,2412,20
90937889824,90937889821,-3,1500,1948,20
90938142883,90938142881,-2,1596,3444,20
90938376951,90938376948,-3,1277,3165,20
90938952495,90938952514,19,1222,2378,20
90947643850,90947643847,-3,1127,2257,20
90947732394,90947732392,-2,862,1552,20
90948165293,90948165288,-5,807,2129,20
90948361444,90948361465,21,674,1053,20
90949061526,90949061521,-5,1010,3556,20
90949093311,90949093307,-4,1431,2819,20
90950531260,90950531256,-4,954,1440,20
90955763725,90955763722,-3,1071,1832,20
90956683108,90956683106,-2,800,1875,20
90961687407,90961687401,-6,1736,6103,20
90962022059,90962022054,-5,1078,2289,20
90962190126,90962190125,-1,747,1324,20
90962686495,90962686493,-2,1157,1940,20
90972479510,90972479506,-4,887,2892,20
90972885280,90972885275,-5,1654,2551,20
90977196430,90977196429,-1,670,2271,20
90985015168,90985015165,-3,1157,2075,20
90990690203,90990690200,-3,1364,2897,20
90990756937,90990756933,-4,1092,2190,20
90993551087,90993551084,-3,852,1183,20
90994354600,90994354595,-5,1675,2462,20
90998424246,90998424243,-3,937,1702,20
90999289448,90999289445,-3,1304,2249,20
91005881742,91005881737,-5,1155,1813,20
91006730179,91006730176,-3,1199,2202,20
91010483385,91010483382,-3,1040,2427,20
91011675945,91011675945,0,1588,2247,20
91015371494,91015371491,-3,1788,3351,20
91015769069,91015769065,-4,1323,3066,20
91018899951,91018899947,-4,921,3020,20
91023068448,91023068453,5,2702,1658,20
91023160394,91023160400,6,3666,1433,20
91025786299,91025786298,-1,1050,2069,20
91027239851,91027239849,-2,1281,2485,20
91033277561,91033277560,-1,1341,2569,20
91038374558,91038374557,-1,849,2033,20
91039409351,91039409349,-2,1076,2511,20
91039490031,91039490029,-2,845,2675,20
91042440504,91042440502,-2,1283,2723,20
91042853987,91042853986,-1,1548,2711,20
91043188614,91043188631,17,909,1222,20
91043336901,91043336898,-3,1506,3763,20
91044613710,91044613707,-3,1000,1355,20
91045096059,91045096057,-2,1266,3059,20
91046363710,91046363715,5,1704,1223,20
91048149898,91048149894,-4,1325,2457,20
91048704366,91048704362,-4,974,4109,20
91054290847,91054290844,-3,1520,1955,20
91054714264,91054714262,-2,970,2380,20
91055156610,91055156609,-1,1405,2286,20
91056403397,91056403393,-4,1436,2394,20
91057238737,91057238742,5,3091,1777,20
91060136519,91060136524,5,1203,962,20
91060790367,91060790363,-4,1799,3368,20
91061665144,91061665143,-1,913,2545,20
91068698815,91068698810,-5,829,2615,20
91069400626,91069400625,-1,1227,2434,20
91069496935,91069496930,-5,456,1032,20
91072208614,91072208615,1,698,1720,20
91075201162,91075201162,0,1116,1375,20
91085734070,91085734070,0,1415,1145,20
91089790827,91089790822,-5,903,1804,20
91089936687,91089936684,-3,870,2578,20
91090017018,91090017014,-4,696,2118,20
91090774047,91090774045,-2,1183,1695,20
91091354103,91091354099,-4,1075,2871,20
91092935991,91092935989,-2,1282,2503,20
91094312370,91094312382,12,24,3016,20
91097864152,91097864150,-2,975,1868,20
91097953418,91097953418,0,544,2162,20
91099433761,91099433759,-2,804,1983,20
91100373825,91100373823,-2,1361,2450,20
91103792687,91103792699,12,113,695,20
91105541514,91105541512,-2,1297,2871,20
91105606675,91105606682,7,3817,1438,20
91107694846,91107694847,1,1412,1717,20
91109449930,91109449927,-3,1188,2346,20
91115587492,91115587472,-20,1825,1124,20
91116343166,91116343163,-3,1329,2701,20
91116915746,91116915742,-4,1365,2991,20
91117463923,91117463918,-5,980,2179,20
91117614174,91117614177,3,1914,897,20
91118155379,91118155377,-2,890,1560,20
91118831594,91118831591,-3,1095,2064,20
91119537165,91119537145,-20,191,801,20
91120063743,91120063738,-5,1319,2696,20
91124914748,91124914745,-3,1436,2925,20
91125428612,91125428634,22,619,2553,20
91127948849,91127948847,-2,762,1462,20
91130502648,91130502646,-2,270,872,20
91133276858,91133276854,-4,1143,2472,20
91134335039,91134335054,15,586,655,20
91135997081,91135997086,5,3614,2300,20
91138717706,91138717704,-2,1609,2489,20
91142157461,91142157462,1,2095,1332,20
91142471941,91142471937,-4,1440,3092,20
91142715526,91142715524,-2,1069,2717,20
91144322293,91144322290,-3,1296,2204,20
91145105559,91145105557,-2,1091,2124,20
91145704275,91145704271,-4,689,1401,20
91150234250,91150234245,-5,1255,2823,20
91150577109,91150577105,-4,1100,2738,20
91153603549,91153603547,-2,792,2901,20
91157563032,91157563030,-2,1085,2433,20
91160342733,91160342730,-3,1035,2238,20
91160721745,91160721744,-1,1005,1885,20
91165291757,91165291753,-4,1675,2968,20
91167842085,91167842081,-4,957,2678,20
91174485103,91174485110,7,3485,1096,20
91177282063,91177282053,-10,1047,2309,20
91178767770,91178767765,-5,1097,3167,20
91179873393,91179873402,9,11989,30000,20
91183728908,91183728901,-7,890,1574,20
91186938326,91186938325,-1,570,1843,20
91189633301,91189633297,-4,1481,3095,20
91189845863,91189845861,-2,921,2451,20
91190483221,91190483219,-2,839,1671,20
91190596718,91190596711,-7,153,1085,20
91191607366,91191607363,-3,1042,3817,20
91192960555,91192960551,-4,898,2055,20
91197655949,91197655969,20,1122,1432,20
91200944428,91200944425,-3,1127,2428,20
91204483247,91204483243,-4,1072,1759,20
91208826078,91208826075,-3,1020,1266,20
91211396441,91211396438,-3,1403,2162,20
91212892751,91212892747,-4,1055,2846,20
91223996158,91223996158,0,1596,2675,20
91227123935,91227123935,0,553,1766,20
91230749230,91230749227,-3,884,1753,20
91232131689,91232131686,-3,841,2247,20
91235358498,91235358493,-5,1561,2821,20
91235394878,91235394882,4,4909,2874,20
91236892353,91236892350,-3,1193,1984,20
91237248753,91237248750,-3,1756,2456,20
91239344840,91239344838,-2,2321,4320,20
91243969247,91243969245,-2,1145,2122,20
91247234141,91247234138,-3,817,3636,20
91250470746,91250470743,-3,866,2143,20
91252153526,91252153523,-3,737,2389,20
91252763029,91252763026,-3,1242,1813,20
91254064199,91254064198,-1,1130,1916,20
91254230668,91254230664,-4,917,2354,20
91255496626,91255496631,5,12831,7130,20
91256820162,91256820158,-4,1389,2637,20
91261369345,91261369341,-4,1792,3812,20
91262175055,91262175051,-4,1221,2250,20
91268786014,91268786011,-3,1534,2415,20
91268827347,91268827353,6,2581,1534,20
91270236727,91270236725,-2,1216,2315,20
91275208666,91275208663,-3,1290,2231,20
91285310850,91285310846,-4,1132,2308,20
91293094619,91293094617,-2,1206,2037,20
91294480462,91294480458,-4,1478,3927,20
91301782226,91301782222,-4,1412,3705,20
91302978405,91302978403,-2,1152,2001,20
91303321210,91303321205,-5,1337,3031,20
91304896813,91304896809,-4,1247,2455,20
91305465013,91305465031,18,724,760,20
91306241978,91306241982,4,1428,1714,20
91307227851,91307227846,-5,1463,3380,20
91309170949,91309170949,0,943,1718,20
91317727535,91317727534,-1,1365,1960,20
91318630829,91318630825,-4,1486,2703,20
91318941221,91318941217,-4,845,1513,20
91320987461,91320987457,-4,1367,2368,20
91321356777,91321356775,-2,1263,3236,20
91324956738,91324956735,-3,1089,3016,20
91325660390,91325660408,18,818,1952,20
91330822030,91330822025,-5,1334,3080,20
91342800678,91342800677,-1,1020,2236,20
91343111212,91343111234,22,710,1221,20
91343793942,91343793940,-2,1167,2077,20
91349372030,91349372029,-1,979,2131,20
91352076380,91352076396,16,1299,1317,20
91361643123,91361643119,-4,1005,2477,20
91363899118,91363899117,-1,1053,3025,20
91364585027,91364585023,-4,1271,2331,20
91365767383,91365767382,-1,707,1605,20
91367063496,91367063502,6,3966,1710,20
91367945341,91367945339,-2,1337,3143,20
91371228845,91371228844,-1,1314,2622,20
91372116061,91372116058,-3,614,875,20
91374166422,91374166417,-5,1107,2388,20
91382107893,91382107890,-3,1216,2468,20
91383151078,91383151075,-3,780,1515,20
91386455128,91386455126,-2,878,2338,20
91386883173,91386883178,5,2885,1402,20
91387581342,91387581341,-1,937,2765,20
91391899454,91391899450,-4,1266,2760,20
91394899774,91394899771,-3,1321,2669,20
91396144298,91396144296,-2,956,2137,20
91403544710,91403544714,4,1645,1444,20
91404459178,91404459183,5,3217,1484,20
91407900042,91407900042,0,1232,1716,20
91414359610,91414359607,-3,1144,2419,20
91415876999,91415876998,-1,1235,2547,20
91417578561,91417578558,-3,1116,2447,20
91417922219,91417922215,-4,1134,2101,20
91421823829,91421823824,-5,1038,3688,20
91422734317,91422734314,-3,849,2083,20
91424163254,91424163252,-2,1600,2053,20
91424775070,91424775066,-4,1112,3841,20
91443194813,91443194811,-2,1054,2659,20
91443901881,91443901876,-5,1185,2541,20
91446409307,91446409324,17,1129,2102,20
91452888811,91452888815,4,849,1239,20
91457466457,91457466454,-3,1359,3309,20
91461208197,91461208193,-4,1099,3797,20
91461424318,91461424302,-16,753,2008,20
91461489010,91461489007,-3,1384,2183,20
91462407891,91462407887,-4,1229,2698,20
91464443962,91464443961,-1,920,2031,20
91465883267,91465883266,-1,1562,2499,20
91466391485,91466391483,-2,1690,2405,20
91466447311,91466447308,-3,1213,2766,20
91472674458,91472674462,4,1788,1375,20
91473617794,91473617790,-4,817,1883,20
91474156421,91474156416,-5,910,1278,20
91476155977,91476155974,-3,1259,2831,20
91478135060,91478135067,7,3094,1146,20
91481692099,91481692098,-1,844,2158,20
91483157917,91483157914,-3,780,1449,20
91483918477,91483918494,17,340,1259,20
91488431286,91488431281,-5,1186,2274,20
91496156501,91496156500,-1,983,2044,20
91496669071,91496669069,-2,1292,2300,20
91496947359,91496947355,-4,1981,2976,20
91499641870,91499641866,-4,1099,1720,20
91501518965,91501518964,-1,815,1832,20
91502567674,91502567670,-4,1339,2827,20
91503131220,91503131218,-2,1017,2311,20
91508731998,91508731996,-2,1432,2781,20
91522765160,91522765158,-2,1332,2445,20
91523758278,91523758275,-3,591,1496,20
91525101810,91525101817,7,2732,971,20
91526474374,91526474371,-3,1004,2448,20
91528206873,91528206870,-3,728,1071,20
91528951198,91528951194,-4,1268,2358,20
91530658060,91530658062,2,1162,1006,20
91532230162,91532230158,-4,801,3177,20
91533784610,91533784609,-1,1331,2374,20
91536659213,91536659210,-3,1250,3064,20
91540095668,91540095662,-6,1236,3957,20
91542298758,91542298754,-4,998,2135,20
91544774598,91544774593,-5,1268,2651,20
91546791288,91546791285,-3,1102,2727,20
91550609530,91550609528,-2,1046,2109,20
91553638446,91553638448,2,1631,1532,20
91553744234,91553744231,-3,781,1354,20
91553855063,91553855058,-5,1430,2374,20
91558864606,91558864601,-5,1205,2308,20
91558973890,91558973888,-2,885,2256,20
91561969530,91561969527,-3,1170,2266,20
91564150393,91564150388,-5,1423,3147,20
91564683599,91564683595,-4,969,1603,20
91565868197,91565868193,-4,1086,2528,20
91567380970,91567380966,-4,1446,2543,20
91571293038,91571293036,-2,1401,3509,20
91572277988,91572277984,-4,1126,2787,20
91574791619,91574791619,0,1172,2126,20
91575016010,91575016011,1,1970,1235,20
91577632988,91577632987,-1,1604,2590,20
91580413031,91580413029,-2,1132,1623,20
91585729823,91585729821,-2,1598,2729,20
91591717978,91591717975,-3,428,2425,20
91592149626,91592149623,-3,942,1956,20
91592717158,91592717156,-2,1150,2425,20
91596530040,91596530038,-2,1072,1584,20
91597963451,91597963457,6,1941,1029,20
91599463654,91599463659,5,3239,1603,20
91601612730,91601612726,-4,852,1721,20
91604065642,91604065639,-3,979,2587,20
91613292561,91613292559,-2,1124,2862,20
91615869621,91615869617,-4,1194,2209,20
91620371340,91620371338,-2,914,1783,20
91622494994,91622494993,-1,731,1909,20
91626318598,91626318597,-1,875,2713,20
91631750466,91631750464,-2,1211,2379,20
91635325626,91635325626,0,10399,10006,20
91639967434,91639967430,-4,1371,3505,20
91641288515,91641288514,-1,1020,1706,20
91641479786,91641479786,0,1659,2233,20
91643933043,91643933039,-4,1624,3494,20
91646806171,91646806168,-3,1272,2538,20
91648480143,91648480139,-4,834,2353,20
91661118490,91661118494,4,2507,2184,20
91669252030,91669252034,4,2313,1913,20
91673171074,91673171072,-2,970,2161,20
91674514725,91674514722,-3,863,2464,20
91675381163,91675381161,-2,754,2020,20
91686042570,91686042569,-1,1210,2949,20
91688136399,91688136396,-3,1069,2274,20
91688192165,91688192164,-1,1140,2119,20
91693004125,91693004121,-4,1605,5175,20
91694088923,91694088918,-5,1870,5742,20
91702500421,91702500418,-3,1040,2368,20
91703669773,91703669776,3,1338,1024,20
91712736468,91712736464,-4,1042,2248,20
91713201533,91713201530,-3,1360,2564,20
91713782400,91713782398,-2,2431,4697,20
91716616041,91716616038,-3,1223,2647,20
91717070960,91717070979,19,159,715,20
91718054424,91718054442,18,710,1112,20
91721013918,91721013916,-2,927,2129,20
91721595823,91721595821,-2,1158,2082,20
91722083653,91722083650,-3,1540,2667,20
91734950085,91734950085,0,1303,2819,20
91739561366,91739561366,0,1250,2628,20
91739942330,91739942325,-5,1554,2589,20
91740135455,91740135450,-5,681,2609,20
91744625982,91744625981,-1,1355,1822,20
91744876385,91744876391,6,1199,999,20
91745202015,91745202010,-5,1373,2571,20
91745758996,91745758991,-5,1394,3477,20
91745937582,91745937602,20,1511,3117,20
91747416223,91747416223,0,1430,2000,20
91751325519,91751325517,-2,1402,2485,20
91755444623,91755444623,0,720,1528,20
91756907983,91756907982,-1,2196,5009,20
91759167612,91759167609,-3,1363,2797,20
91759383588,91759383611,23,218,1451,20
91762989436,91762989432,-4,1387,2461,20
91769070826,91769070823,-3,1241,3375,20
91775475714,91775475712,-2,876,2067,20
91776025822,91776025819,-3,986,2111,20
91776117526,91776117522,-4,1248,3234,20
91776618581,91776618577,-4,1387,1553,20
91780022657,91780022654,-3,1037,2057,20
91783020515,91783020511,-4,1226,1790,20
91783415431,91783415430,-1,253,892,20
91784563182,91784563179,-3,1118,1701,20
91789590891,91789590889,-2,1137,2459,20
91789993311,91789993309,-2,808,1902,20
91790526999,91790526995,-4,862,1897,20
91791398731,91791398726,-5,2386,5169,20
91804559835,91804559829,-6,2341,7291,20
91805904399,91805904397,-2,1129,2313,20
91808277506,91808277501,-5,1231,2694,20
91808602696,91808602692,-4,705,1613,20
91808785814,91808785806,-8,1047,2650,20
91811820978,91811820979,1,1764,2055,20
91812033461,91812033460,-1,776,2544,20
91814327215,91814327218,3,1578,1274,20
91814795663,91814795659,-4,921,2564,20
91815424390,91815424410,20,1223,2195,20
91819216430,91819216426,-4,967,1830,20
91820728357,91820728354,-3,1074,1594,20
91830085763,91830085761,-2,1112,2734,20
91833209635,91833209634,-1,1047,2447,20
91836844551,91836844547,-4,1153,2153,20
91839822274,91839822272,-2,999,2200,20
91847167967,91847167964,-3,1139,2931,20
91853255970,91853255969,-1,839,1973,20
91857287014,91857287011,-3,659,1754,20
91857690151,91857690150,-1,900,2749,20
91858594250,91858594246,-4,2297,5021,20
91859275058,91859275054,-4,1409,3002,20
91861239127,91861239121,-6,590,1422,20
91865148398,91865148394,-4,830,1931,20
91865267222,91865267241,19,1296,3150,20
91866911814,91866911810,-4,1549,3250,20
91868304622,91868304620,-2,1075,3135,20
91871367391,91871367390,-1,1364,1909,20
91871895505,91871895502,-3,1525,2264,20
91874668470,91874668466,-4,1438,3045,20
91879397430,91879397428,-2,1388,1939,20
91880611150,91880611147,-3,1124,3248,20
91883739453,91883739450,-3,1299,2346,20
91886693690,91886693686,-4,687,2006,20
91887931500,91887931499,-1,421,1770,20
91888952038,91888952032,-6,963,3724,20
91889011727,91889011743,16,858,2064,20
91889804361,91889804358,-3,1194,2276,20
91891108147,91891108145,-2,1390,2528,20
91893801727,91893801723,-4,1189,2868,20
91895641302,91895641295,-7,1821,9115,20
91897059284,91897059282,-2,1183,2821,20
91901179026,91901179023,-3,1005,2311,20
91910024783,91910024781,-2,963,2248,20
91910853486,91910853482,-4,1278,2018,20
91911427094,91911427093,-1,1144,2180,20
91912576987,91912576981,-6,623,2240,20
91912849954,91912849951,-3,1362,1914,20
91913440474,91913440472,-2,1083,2105,20
91914655987,91914655983,-4,1121,1864,20
91915522159,91915522144,-15,1371,265,20
91921098839,91921098834,-5,1027,1474,20
91921677683,91921677682,-1,924,1435,20
91929771079,91929771077,-2,1287,2113,20
91936141979,91936141981,2,2024,2569,20
91937028545,91937028541,-4,1344,3085,20
91937745216,91937745214,-2,1260,2717,20
91939572438,91939572434,-4,1005,2291,20
91940407071,91940407069,-2,1436,3022,20
91942544770,91942544770,0,1005,2100,20
91948849418,91948849417,-1,974,1577,20
91949465973,91949465970,-3,1420,2709,20
91951079691,91951079686,-5,1338,2813,20
91951200527,91951200526,-1,976,1485,20
91951440307,91951440305,-2,1188,2542,20
91968939350,91968939349,-1,1238,2568,20
91972428161,91972428157,-4,880,2037,20
91973210572,91973210566,-6,1434,3298,20
91974956056,91974956050,-6,999,2377,20
91979068328,91979068326,-2,816,2921,20
91980303574,91980303569,-5,1621,3053,20
91983672494,91983672493,-1,1003,2094,20
91983860010,91983860007,-3,1309,3022,20
91984551017,91984551018,1,1689,1897,20
91992479382,91992479378,-4,1405,2541,20
91995024638,91995024634,-4,974,2658,20
91995900846,91995900853,7,6875,2757,20
91995946277,91995946282,5,1884,1096,20
92000124179,92000124177,-2,1458,3249,20
92001705943,92001705940,-3,1414,2489,20
92002209054,92002209052,-2,809,1510,20
92004101246,92004101237,-9,947,4827,20
92005631022,92005631019,-3,1126,2882,20
92005919525,92005919507,-18,1230,2337,20
92013723038,92013723037,-1,929,2263,20
92020656366,92020656370,4,1765,1448,20
92021636994,92021636991,-3,1263,2641,20
92022358274,92022358273,-1,1608,3081,20
92023466138,92023466141,3,1461,1139,20
92025462267,92025462266,-1,1400,2906,20
92025833700,92025833686,-14,318,893,20
92032276695,92032276692,-3,746,1652,20
92033025847,92033025845,-2,1876,1942,20
92033498810,92033498809,-1,1010,2236,20
92040927898,92040927897,-1,1183,2547,20
92043893649,92043893654,5,2130,1067,20
92052955102,92052955117,15,850,2151,20
92053283489,92053283487,-2,1077,2186,20
92060955547,92060955552,5,2326,1704,20
92062103450,92062103454,4,4734,3328,20
92062565313,92062565310,-3,909,2455,20
92063259961,92063259958,-3,1304,2756,20
92063490141,92063490163,22,834,1726,20
92071157661,92071157658,-3,913,2113,20
92071729804,92071729801,-3,875,1533,20
92073549641,92073549638,-3,1397,2721,20
92081170667,92081170664,-3,1011,2018,20
92081707974,92081707969,-5,1647,7716,20
92082701319,92082701318,-1,749,1334,20
92085397055,92085397051,-4,1161,1722,20
92091824944,92091824951,7,26528,26732,20
92092933599,92092933597,-2,809,1803,20
92093855008,92093855004,-4,1438,1781,20
92095170419,92095170415,-4,860,2446,20
92096531535,92096531532,-3,1080,2398,20
92097063358,92097063354,-4,1264,1948,20
92101057630,92101057624,-6,2313,12490,20
92101595058,92101595053,-5,952,2890,20
92105087695,92105087691,-4,1198,2283,20
92108863386,92108863385,-1,1467,2266,20
92110540881,92110540878,-3,1474,2731,20
92112815919,92112815918,-1,1111,1182,20
92115966086,92115966086,0,986,2437,20
92117372627,92117372625,-2,1288,2479,20
92119944778,92119944782,4,1796,1360,20
92122502009,92122502006,-3,791,2676,20
92124561719,92124561718,-1,726,2004,20
92125653913,92125653912,-1,1388,2154,20
92128564110,92128564110,0,973,1883,20
92128659562,92128659561,-1,1212,2106,20
92129789039,92129789036,-3,1847,2974,20
92129934043,92129934039,-4,1791,1865,20
92132475695,92132475694,-1,813,1736,20
92136125837,92136125831,-6,1453,4233,20
92137289542,92137289550,8,1769,829,20
92139223370,92139223366,-4,1267,3245,20
92147225554,92147225553,-1,1137,2745,20
92150016650,92150016654,4,7145,26769,20
92150210166,92150210163,-3,22958,13958,20
92152598626,92152598624,-2,849,1746,20
92156696651,92156696649,-2,1789,2888,20
92157996261,92157996262,1,1404,1465,20
92159191427,92159191425,-2,904,2231,20
92159916582,92159916602,20,790,2112,20
92162390778,92162390777,-1,1108,1910,20
92162854739,92162854737,-2,1239,2540,20
92165172480,92165172476,-4,1428,3391,20
92165560735,92165560731,-4,1797,3655,20
92175812634,92175812634,0,2652,2889,20
92178397971,92178397968,-3,1337,3211,20
92180217317,92180217314,-3,1299,2668,20
92185186755,92185186753,-2,850,1672,20
92187412297,92187412292,-5,1010,2629,20
92189306643,92189306639,-4,741,1523,20
92205942363,92205942361,-2,1118,2273,20
92207905746,92207905745,-1,3431,7320,20
92210294043,92210294041,-2,974,2268,20
92215021894,92215021893,-1,1185,2875,20
92216917097,92216917094,-3,1425,2754,20
92219044739,92219044737,-2,1118,2345,20
92219671013,92219671005,-8,1287,1666,20
92223001750,92223001747,-3,849,1676,20
92223308546,92223308546,0,1461,1815,20
92225915701,92225915698,-3,880,1475,20
92230170012,92230170009,-3,1178,3027,20
92231495538,92231495537,-1,1173,2731,20
92231634103,92231634101,-2,1078,2115,20
92236579081,92236579077,-4,1474,2525,20
92241146242,92241146241,-1,1458,2416,20
92242914582,92242914582,0,1063,1774,20
92247972861,92247972858,-3,1249,2257,20
92248061035,92248061038,3,22226,42762,20
92248573255,92248573258,3,2068,1568,20
92251289387,92251289385,-2,1272,2371,20
92251825023,92251825020,-3,762,2172,20
92253323075,92253323072,-3,792,2430,20
92253490170,92253490166,-4,1631,3219,20
92253661023,92253661021,-2,1227,2598,20
92266316136,92266316133,-3,1453,2774,20
92266408119,92266408118,-1,1271,2190,20
92268610299,92268610295,-4,960,2226,20
92270452898,92270452898,0,1318,1670,20
92279447802,92279447800,-2,1532,2027,20
92279603293,92279603290,-3,1072,1522,20
92281615926,92281615921,-5,1291,2467,20
92283919442,92283919438,-4,1465,2868,20
92289406555,92289406549,-6,1216,1975,20
92290833009,92290833006,-3,942,1927,20
92291241246,92291241242,-4,1174,2788,20
92291731582,92291731577,-5,1949,2915,20
92293051562,92293051558,-4,858,1833,20
92295772566,92295772562,-4,1181,2551,20
92295845791,92295845775,-16,252,992,20
92297409614,92297409611,-3,373,1128,20
92301074111,92301074108,-3,1096,3048,20
92305093473,92305093469,-4,1287,2833,20
92305903395,92305903393,-2,1223,2187,20
92308135516,92308135512,-4,1082,2390,20
92308609832,92308609849,17,690,1284,20
92310853354,92310853353,-1,1001,3152,20
92313451317,92313451311,-6,1302,3422,20
92314050775,92314050771,-4,1048,2182,20
92317761047,92317761045,-2,1317,2074,20
92318094076,92318094070,-6,1233,2254,20
92319924458,92319924454,-4,1394,2318,20
92324095405,92324095401,-4,1370,3015,20
92327870817,92327870814,-3,1054,3083,20
92329008891,92329008887,-4,1002,2098,20
92329761069,92329761052,-17,1087,1812,20
92331599778,92331599775,-3,1207,2519,20
92335643739,92335643738,-1,1970,2300,20
92336110199,92336110199,0,1595,1405,20
92338606586,92338606583,-3,1227,2359,20
92344086652,92344086653,1,1269,1574,20
92345959496,92345959491,-5,997,2456,20
92346518812,92346518810,-2,704,1288,20
92347193047,92347193041,-6,1185,1868,20
92348819499,92348819498,-1,1067,1875,20
92350974523,92350974519,-4,958,3067,20
92353741387,92353741383,-4,877,2628,20
92353999576,92353999571,-5,1499,2715,20
92355383164,92355383161,-3,1283,3230,20
92357177449,92357177443,-6,2000,8186,20
92358556759,92358556757,-2,1222,1812,20
92363690450,92363690446,-4,940,1718,20
92366161989,92366161986,-3,911,1917,20
92371782482,92371782480,-2,1181,1652,20
92372856081,92372856086,5,4353,1151,20
92374447822,92374447820,-2,1189,2543,20
92375142548,92375142566,18,449,1645,20
92377633590,92377633586,-4,1147,2005,20
92382626970,92382626967,-3,1012,3113,20
92384300464,92384300467,3,2719,2004,20
92388767947,92388767946,-1,763,1697,20
92389247345,92389247342,-3,795,2189,20
92389488926,92389488928,2,1005,2647,20
92392925022,92392925030,8,4908,1969,20
92394842363,92394842357,-6,837,1954,20
92396020911,92396020908,-3,1368,2184,20
92398607379,92398607376,-3,1051,2077,20
92400720138,92400720135,-3,1032,2361,20
92401140410,92401140402,-8,1820,9443,20
92401822283,92401822281,-2,2012,2911,20
92404904346,92404904343,-3,1047,1737,20
92407916801,92407916798,-3,1160,2808,20
92418873338,92418873333,-5,1274,2741,20
92418963839,92418963845,6,7328,3679,20
92420868856,92420868863,7,1233,1911,20
92421435491,92421435488,-3,1027,2361,20
92422576142,92422576139,-3,1174,2708,20
92427350493,92427350501,8,16545,23674,20
92430509941,92430509937,-4,1486,2208,20
92433312837,92433312830,-7,1013,3775,20
92434130826,92434130822,-4,1280,3357,20
92435205162,92435205158,-4,996,1916,20
92436407593,92436407589,-4,1075,2868,20
92438490399,92438490397,-2,961,1876,20
92439546332,92439546329,-3,1500,3004,20
92441312914,92441312909,-5,1527,2425,20
92443343575,92443343572,-3,674,1482,20
92447341530,92447341527,-3,1283,3052,20
92450538699,92450538696,-3,822,2380,20
92454780974,92454780975,1,2662,3723,20
92455988241,92455988238,-3,881,2439,20
92459750335,92459750330,-5,1312,2907,20
92464040542,92464040542,0,1244,2063,20
92464742610,92464742609,-1,1098,2063,20
92467815755,92467815753,-2,956,2298,20
92468208294,92468208295,1,1998,1748,20
92468434082,92468434078,-4,2038,2855,20
92471084896,92471084893,-3,1177,2239,20
92478865455,92478865453,-2,1186,2526,20
92478982603,92478982599,-4,836,1436,20
92483640154,92483640162,8,6731,1969,20
92484684322,92484684320,-2,1316,2942,20
92486853193,92486853191,-2,837,1629,20
92491419818,92491419817,-1,1176,1714,20
92494763149,92494763150,1,1920,1614,20
92500435275,92500435272,-3,601,1738,20
92505490370,92505490368,-2,1299,2598,20
92507761361,92507761357,-4,1572,2134,20
92509276026,92509276023,-3,885,2523,20
92511059821,92511059819,-2,573,1583,20
92514579387,92514579385,-2,1304,2781,20
92518270015,92518270021,6,4084,2284,20
92519901710,92519901706,-4,771,3076,20
92520124981,92520124963,-18,168,876,20
92521723661,92521723665,4,1278,1791,20
92522228907,92522228906,-1,1248,2487,20
92522393183,92522393180,-3,1265,2777,20
92522646752,92522646749,-3,1020,2338,20
92527493159,92527493155,-4,1056,1421,20
92531249043,92531249041,-2,1259,3114,20
92537566802,92537566797,-5,1630,5512,20
92544461339,92544461334,-5,745,2359,20
92546656324,92546656323,-1,1256,1426,20
92548107614,92548107612,-2,1049,2790,20
92548259847,92548259858,11,118,1019,20
92553886534,92553886532,-2,1102,2381,20
92553914924,92553914907,-17,340,619,20
92556148910,92556148907,-3,1280,3450,20
92559238350,92559238346,-4,975,2349,20
92559271829,92559271813,-16,726,1573,20
92561837336,92561837334,-2,921,2312,20
92564761663,92564761661,-2,1105,2201,20
92565352166,92565352162,-4,1200,1970,20
92565666159,92565666178,19,549,2309,20
92566197350,92566197347,-3,963,2419,20
92570796414,92570796411,-3,1012,2368,20
92571775006,92571775007,1,2052,2747,20
92573557886,92573557883,-3,1094,2070,20
92586006951,92586006954,3,2431,1945,20
92586114722,92586114721,-1,1162,2957,20
92588074075,92588074074,-1,2965,3142,20
92601015865,92601015861,-4,1406,3355,20
92601284203,92601284204,1,959,2487,20
92602014215,92602014202,-13,1260,3316,20
92602632270,92602632268,-2,836,2151,20
92603301214,92603301211,-3,1148,2091,20
92607545257,92607545264,7,11221,29787,20
92613227570,92613227569,-1,1058,3755,20
92613352011,92613352007,-4,822,1689,20
92613958543,92613958542,-1,1002,2557,20
92614578490,92614578485,-5,1038,2182,20
92620603446,92620603443,-3,1228,2476,20
92624400711,92624400710,-1,1145,2579,20
92626791634,92626791630,-4,978,2224,20
92628926315,92628926314,-1,1030,1742,20
92629112719,92629112722,3,1570,1104,20
92630705190,92630705186,-4,1186,2577,20
92631195010,92631195008,-2,597,1683,20
92631754302,92631754322,20,1185,2450,20
92631990306,92631990304,-2,1358,2230,20
92632291093,92632291109,16,218,1189,20
92634586183,92634586181,-2,687,1723,20
92635213902,92635213899,-3,985,2460,20
92639240806,92639240801,-5,996,1891,20
92639304655,92639304658,3,1948,2108,20
92640515676,92640515674,-2,1149,2092,20
92640564949,92640564943,-6,957,3289,20
92642927392,92642927386,-6,805,1975,20
92647325695,92647325694,-1,1096,2124,20
92647982936,92647982938,2,132,939,20
92650517383,92650517381,-2,1498,2057,20
92650894016,92650894012,-4,1136,2074,20
92651778691,92651778689,-2,1627,2425,20
92655692231,92655692231,0,1256,2511,20
92658499087,92658499084,-3,1184,1802,20
92658853958,92658853957,-1,1063,1804,20
92661506462,92661506458,-4,707,1142,20
92663009250,92663009246,-4,1333,2676,20
92663479969,92663479965,-4,1531,2899,20
92664997811,92664997807,-4,1032,2170,20
92668964172,92668964171,-1,1125,1726,20
92677961719,92677961713,-6,1065,2456,20
92680536826,92680536822,-4,1077,2204,20
92684473685,92684473681,-4,1133,2205,20
92692060746,92692060754,8,3244,1932,20
92692680342,92692680335,-7,1421,2466,20
92695253511,92695253510,-1,1067,2605,20
92696849118,92696849115,-3,981,2449,20
92698299680,92698299675,-5,965,3126,20
92700383075,92700383071,-4,1099,2481,20
92706926326,92706926326,0,1469,1919,20
92708080913,92708080909,-4,1378,1744,20
92712009973,92712009969,-4,887,1929,20
92713068116,92713068114,-2,1292,3176,20
92714564477,92714564475,-2,1550,2165,20
92716255217,92716255214,-3,1285,1919,20
92718343287,92718343282,-5,1691,3635,20
92718953158,92718953155,-3,1408,2422,20
92718999971,92718999966,-5,1169,3232,20
92721430418,92721430417,-1,943,2022,20
92721565778,92721565773,-5,1212,2189,20
92730361962,92730361961,-1,843,1887,20
92733533670,92733533669,-1,2474,3121,20
92737705491,92737705489,-2,1017,1891,20
92740886002,92740886000,-2,955,2772,20
92742415550,92742415548,-2,1261,2954,20
92749083699,92749083697,-2,1572,2647,20
92751697133,92751697133,0,6463,8627,20
92752539551,92752539548,-3,834,1960,20
92756697547,92756697545,-2,1382,2682,20
92767014867,92767014864,-3,1401,2511,20
92772887159,92772887157,-2,1220,2442,20
92776235029,92776235024,-5,66639,96120,20
92777033819,92777033817,-2,1222,2517,20
92778919490,92778919489,-1,1091,1680,20
92784196972,92784196965,-7,1016,2842,20
92784925238,92784925237,-1,810,2265,20
92788694044,92788694045,1,1780,1858,20
92790035341,92790035339,-2,1313,2180,20
92792550446,92792550442,-4,2026,3012,20
92800104606,92800104607,1,1315,1510,20
92803017801,92803017799,-2,1132,1678,20
92804488156,92804488170,14,702,3224,20
92805599023,92805599021,-2,877,2353,20
92807942992,92807942992,0,1150,1813,20
92812762691,92812762688,-3,1068,1749,20
92815432046,92815432040,-6,2146,7035,20
92822271753,92822271749,-4,1606,2733,20
92823550501,92823550498,-3,1077,2751,20
92824018332,92824018352,20,892,2121,20
92826073621,92826073627,6,5225,2196,20
92827062421,92827062419,-2,914,2154,20
92827390801,92827390800,-1,944,2183,20
92829159429,92829159425,-4,1572,2545,20
92834528804,92834528818,14,771,2620,20
92835367690,92835367685,-5,1991,7151,20
92836196438,92836196435,-3,1456,3492,20
92839601678,92839601676,-2,875,2432,20
92848433846,92848433842,-4,1061,3312,20
92858526532,92858526527,-5,1479,3878,20
92865355022,92865355017,-5,937,3331,20
92867077695,92867077693,-2,1094,2435,20
92871054954,92871054950,-4,1505,1665,20
92871255993,92871255990,-3,1138,2108,20
92875099403,92875099400,-3,1197,2684,20
92877495150,92877495146,-4,1053,1723,20
92878467557,92878467554,-3,1404,2564,20
92889892758,92889892754,-4,709,1372,20
92890411182,92890411166,-16,1263,2837,20
92891493803,92891493801,-2,1292,2196,20
92898236863,92898236859,-4,1673,2591,20
92899170841,92899170838,-3,1248,3743,20
92902457831,92902457829,-2,1174,1513,20
92907422840,92907422843,3,3921,3412,20
92914039470,92914039466,-4,1112,2170,20
92914114956,92914114954,-2,1153,2489,20
92916194061,92916194053,-8,1269,3208,20
92918973605,92918973601,-4,957,2061,20
92921207622,92921207618,-4,1349,2338,20
92921566852,92921566850,-2,1189,2254,20
92922418950,92922418950,0,1312,1980,20
92924404992,92924404986,-6,1145,2109,20
92931229438,92931229435,-3,984,1680,20
92931580034,92931580031,-3,1126,3032,20
92938301682,92938301678,-4,740,1884,20
92946461268,92946461263,-5,1014,2203,20
92954155993,92954155990,-3,1287,2209,20
92956806498,92956806496,-2,1328,2050,20
92956993191,92956993182,-9,734,1717,20
92958731358,92958731356,-2,5765,9523,20
92959494018,92959494014,-4,916,1664,20
92960663978,92960663974,-4,1461,1815,20
92961661171,92961661171,0,1303,1333,20
92964216226,92964216225,-1,936,2265,20
92966261049,92966261047,-2,1631,2322,20
92974118805,92974118800,-5,1093,1682,20
92974744090,92974744094,4,1905,1683,20
92985670794,92985670790,-4,1184,2927,20
92993773456,92993773453,-3,1181,2576,20
92993969566,92993969566,0,1300,1898,20
92996261004,92996261001,-3,1227,2863,20
93001078813,93001078809,-4,1356,3630,20
93005243783,93005243780,-3,1142,1980,20
93006538317,93006538314,-3,611,2225,20
93007902354,93007902349,-5,1074,4726,20
93009309761,93009309755,-6,821,1620,20
93011108241,93011108238,-3,1007,1606,20
93014134529,93014134527,-2,1036,1776,20
93022051489,93022051486,-3,2606,5275,20
93029844517,93029844513,-4,1213,3866,20
93033125745,93033125743,-2,605,1382,20
93034552614,93034552611,-3,287,906,20
93039194689,93039194687,-2,893,3248,20
93039881388,93039881385,-3,969,1861,20
93042278425,93042278421,-4,541,1996,20
93044482184,93044482180,-4,1099,2905,20
93046842973,93046842972,-1,1582,2123,20
93048513415,93048513410,-5,998,2288,20
93052672098,93052672094,-4,1330,2789,20
93054915725,93054915719,-6,1131,2816,20
93058120207,93058120206,-1,1071,1720,20
93061157713,93061157713,0,1208,2326,20
93061751755,93061751750,-5,1283,3007,20
93062768343,93062768340,-3,1426,2839,20
93065163722,93065163719,-3,1178,2667,20
93065744753,93065744754,1,887,1240,20
93071510363,93071510358,-5,946,2846,20
93081127182,93081127185,3,7481,22718,20
93082616315,93082616310,-5,608,2112,20
93085175336,93085175341,5,4046,3317,20
93086595297,93086595291,-6,650,1627,20
93087073365,93087073365,0,1183,1950,20
93091401263,93091401262,-1,1540,2543,20
93093668044,93093668041,-3,1280,2578,20
93096042073,93096042070,-3,1416,4320,20
93099899341,93099899337,-4,1027,2858,20
93102780608,93102780606,-2,1529,2662,20
93104969381,93104969386,5,3028,1434,20
93113075237,93113075233,-4,754,1571,20
93114787865,93114787862,-3,1173,2178,20
93123557918,93123557917,-1,1328,2067,20
93123614923,93123614919,-4,979,2732,20
93126990217,93126990213,-4,1090,2250,20
93133311657,93133311656,-1,816,1613,20
93133866550,93133866562,12,1205,2210,20
93139239470,93139239465,-5,898,2744,20
93139835066,93139835063,-3,1019,1732,20
93151530962,93151530958,-4,1189,2647,20
93151695433,93151695431,-2,1088,2266,20
93154429482,93154429479,-3,900,1778,20
93155567678,93155567677,-1,1061,2124,20
93155860697,93155860696,-1,939,1763,20
93161361715,93161361711,-4,956,2671,20
93163849955,93163849953,-2,1327,2955,20
93164025681,93164025676,-5,2671,6436,20
93166527015,93166527011,-4,1177,3109,20
93168353974,93168353973,-1,1301,2224,20
93170265250,93170265247,-3,1800,2223,20
93172491379,93172491377,-2,1107,1441,20
93173020406,93173020421,15,877,2344,20
93173746335,93173746331,-4,637,1674,20
93177060478,93177060481,3,1282,1904,20
93179370058,93179370055,-3,1312,3178,20
93180016894,93180016890,-4,1801,2687,20
93183361414,93183361410,-4,1289,3111,20
93186192909,93186192905,-4,714,2428,20
93190146843,93190146839,-4,879,1754,20
93192686371,93192686369,-2,809,1193,20
93192798127,93192798126,-1,485,1694,20
93194750601,93194750600,-1,1238,3102,20
93195815670,93195815666,-4,1022,1995,20
93205713654,93205713652,-2,1062,3130,20
93206245614,93206245595,-19,644,1917,20
93210486930,93210486924,-6,1069,3171,20
93213005712,93213005708,-4,1326,3094,20
93213458566,93213458563,-3,1570,2998,20
93214541393,93214541391,-2,946,2565,20
93214947168,93214947166,-2,1486,2868,20
93220824287,93220824285,-2,1598,3016,20
93222103809,93222103805,-4,1395,2533,20
93227234545,93227234542,-3,1142,1899,20
93231168735,93231168730,-5,1367,3291,20
93231973294,93231973294,0,1757,2132,20
93233620349,93233620346,-3,1416,2631,20
93244640421,93244640419,-2,845,1833,20
93247548350,93247548348,-2,1220,2143,20
93248888855,93248888853,-2,1263,2518,20
93249153264,93249153275,11,28438,45423,20
93254318634,93254318633,-1,1349,2925,20
93255916917,93255916917,0,1478,1571,20
93259009149,93259009149,0,906,2267,20
93260296311,93260296307,-4,938,2112,20
93262707930,93262707927,-3,864,2329,20
93263339540,93263339538,-2,1318,2580,20
93266174082,93266174078,-4,783,1861,20
93269198010,93269198004,-6,904,2381,20
93276367766,93276367763,-3,895,1824,20
93276624442,93276624441,-1,13611,27995,20
93277006112,93277006127,15,209,1251,20
93277057917,93277057915,-2,920,1847,20
93277501189,93277501187,-2,972,1962,20
93280062202,93280062200,-2,1383,2597,20
93280490151,93280490149,-2,1142,2997,20
93291268538,93291268536,-2,1322,2224,20
93292968631,93292968628,-3,1177,2670,20
93293344188,93293344185,-3,1196,2096,20
93296574945,93296574938,-7,1184,2987,20
93296936404,93296936425,21,868,2111,20
93298325984,93298325982,-2,1187,2073,20
93304518882,93304518880,-2,1254,1969,20
93304856473,93304856455,-18,244,866,20
93310259436,93310259434,-2,1390,2069,20
93313392218,93313392215,-3,1194,1955,20
93313892876,93313892864,-12,1371,2649,20
93325988890,93325988888,-2,902,1985,20
93333242017,93333242014,-3,950,1722,20
93333913318,93333913322,4,10888,22008,20
93335981035,93335981033,-2,593,1605,20
93337724431,93337724428,-3,1233,2162,20
93338440309,93338440309,0,1415,704,20
93338481407,93338481404,-3,1294,2187,20
93339636186,93339636186,0,1367,2154,20
93345687742,93345687738,-4,1317,2881,20
93355128712,93355128708,-4,947,2287,20
93356073529,93356073526,-3,1035,2775,20
93357068506,93357068503,-3,1085,1954,20
93359087865,93359087861,-4,1160,2105,20
93366956402,93366956397,-5,1473,2855,20
93369477919,93369477916,-3,1261,2837,20
93370791310,93370791306,-4,1499,2820,20
93372549577,93372549573,-4,1050,2024,20
93373243574,93373243570,-4,1232,2670,20
93379495691,93379495686,-5,737,4095,20
93381946279,93381946275,-4,1088,2368,20
93387377296,93387377293,-3,1330,1886,20
93387915096,93387915093,-3,1658,3036,20
93392526271,93392526269,-2,970,2241,20
93393410282,93393410276,-6,1016,1748,20
93395294339,93395294338,-1,1229,1875,20
93395415135,93395415132,-3,957,2178,20
93395804263,93395804265,2,1925,2226,20
93398955681,93398955691,10,9388,37462,20
93399767763,93399767759,-4,780,1675,20
93401609621,93401609617,-4,1163,2408,20
93405516763,93405516758,-5,650,1646,20
93408154660,93408154675,15,338,709,20
93409941567,93409941562,-5,1527,2205,20
93411143867,93411143866,-1,924,2292,20
93415631659,93415631654,-5,836,1541,20
93422432770,93422432766,-4,1002,2574,20
93428039200,93428039198,-2,918,1985,20
93434718959,93434718961,2,1733,2058,20
93436740610,93436740609,-1,1488,3027,20
93438784691,93438784687,-4,1126,2216,20
93439643574,93439643570,-4,1397,2633,20
93440230162,93440230160,-2,1137,2536,20
93441585573,93441585571,-2,847,1638,20
93441725232,93441725248,16,773,2578,20
93445175697,93445175694,-3,927,2120,20
93447659581,93447659578,-3,1182,2646,20
93447811969,93447811966,-3,1338,1814,20
93448731163,93448731158,-5,1602,5464,20
93451081133,93451081131,-2,1009,2415,20
93451516742,93451516746,4,1454,1342,20
93453793451,93453793449,-2,1130,2362,20
93456094312,93456094309,-3,1616,2321,20
93456417766,93456417762,-4,1091,1319,20
93458188122,93458188119,-3,687,2390,20
93463054890,93463054886,-4,1315,3043,20
93465390227,93465390223,-4,1111,2495,20
93473100866,93473100863,-3,953,2093,20
93473805143,93473805135,-8,736,2365,20
93476897291,93476897290,-1,928,1866,20
93482386621,93482386618,-3,1354,2406,20
93482758644,93482758631,-13,210,953,20
93486014671,93486014666,-5,1242,2448,20
93488465697,93488465694,-3,1306,2229,20
93492413851,93492413846,-5,952,2912,20
93494508338,93494508334,-4,789,2058,20
93497158600,93497158598,-2,1166,2860,20
93499806636,93499806634,-2,1125,2811,20
93500848962,93500848959,-3,1067,2966,20
93503416282,93503416277,-5,1449,3445,20
93505477112,93505477111,-1,1023,1605,20
93506557757,93506557754,-3,1218,1995,20
93511859767,93511859763,-4,662,1735,20
93512695185,93512695189,4,3356,1682,20
93515706216,93515706221,5,5410,2237,20
93515892743,93515892739,-4,16839,8475,20
93525377996,93525377997,1,1149,1272,20
93530932737,93530932731,-6,853,2077,20
93531406251,93531406248,-3,1139,2341,20
93532431222,93532431221,-1,1055,1906,20
93532561867,93532561864,-3,1247,2207,20
93534251478,93534251474,-4,788,1972,20
93536824882,93536824879,-3,1059,2209,20
93536927957,93536927975,18,426,1620,20
93539365229,93539365225,-4,1144,2244,20
93540258119,93540258116,-3,1232,2800,20
93541910729,93541910726,-3,882,2217,20
93542116718,93542116738,20,557,2712,20
93542855406,93542855404,-2,902,2234,20
93543499851,93543499847,-4,877,1654,20
93551097738,93551097734,-4,1272,2648,20
93551142349,93551142368,19,197,1134,20
93559559150,93559559147,-3,1181,1837,20
93560239237,93560239224,-13,706,1979,20
93563955474,93563955484,10,888,1870,20
93565950146,93565950142,-4,1345,1755,20
93567634889,93567634886,-3,1400,1840,20
93571050983,93571050979,-4,1032,2183,20
93574635375,93574635373,-2,778,1541,20
93576038441,93576038437,-4,1377,2402,20
93576993446,93576993445,-1,1758,2847,20
93577425898,93577425894,-4,785,2185,20
93578929325,93578929323,-2,1122,2368,20
93579022421,93579022414,-7,274,705,20
93580604441,93580604440,-1,1056,2597,20
93587609359,93587609355,-4,682,1686,20
93587914324,93587914339,15,52,262,20
93589528811,93589528806,-5,1043,2188,20
93590107671,93590107669,-2,1535,2542,20
93590677259,93590677257,-2,947,2110,20
93591429510,93591429506,-4,628,2472,20
93593087988,93593087990,2,2137,2107,20
93595126774,93595126770,-4,722,2209,20
93604959812,93604959812,0,1372,2264,20
93605876910,93605876906,-4,1102,2088,20
93606518657,93606518653,-4,1295,3127,20
93606736961,93606736962,1,1174,2391,20
93611936156,93611936152,-4,1171,2404,20
93612538398,93612538393,-5,999,2932,20
93612660488,93612660503,15,731,1313,20
93628342366,93628342363,-3,1291,2227,20
93631806259,93631806261,2,36211,33732,20
93632871127,93632871123,-4,1332,1871,20
93634739219,93634739216,-3,827,1584,20
93635726403,93635726404,1,1549,1880,20
93639234906,93639234903,-3,1452,2125,20
93640274493,93640274492,-1,613,835,20
93640442392,93640442388,-4,1037,2643,20
93640886430,93640886430,0,1566,2030,20
93643846039,93643846034,-5,1349,2836,20
93646087285,93646087282,-3,1372,2275,20
93648602254,93648602253,-1,1012,2229,20
93656661025,93656661023,-2,965,1914,20
93657695329,93657695329,0,2065,2289,20
93659298487,93659298485,-2,817,1805,20
93662087794,93662087791,-3,734,1886,20
93670068179,93670068174,-5,895,2636,20
93670646034,93670646031,-3,1376,2884,20
93673582732,93673582730,-2,1103,1946,20
93674722961,93674722966,5,4932,2638,20
93682838702,93682838698,-4,1189,1682,20
93683267198,93683267195,-3,1057,2084,20
93685896035,93685896033,-2,1169,2237,20
93695368123,93695368121,-2,1082,1710,20
93700446508,93700446510,2,2264,2197,20
93701130046,93701130045,-1,956,2952,20
93704370379,93704370379,0,1135,1830,20
93704822086,93704822082,-4,1066,1968,20
93706289560,93706289554,-6,1467,2862,20
93709356829,93709356822,-7,1910,8810,20
93710103977,93710103974,-3,754,2142,20
93710260675,93710260671,-4,1322,2148,20
93714842395,93714842393,-2,952,2251,20
93716892614,93716892611,-3,786,1955,20
93717362415,93717362430,15,432,972,20
93719242036,93719242033,-3,1057,2429,20
93723221850,93723221842,-8,936,2568,20
93725662368,93725662365,-3,942,2159,20
93728390527,93728390514,-13,31844,15201,20
93729151326,93729151323,-3,1060,1469,20
93730156470,93730156466,-4,1355,3568,20
93730572683,93730572678,-5,1179,1991,20
93734610709,93734610707,-2,920,2680,20
93736703575,93736703571,-4,986,4061,20
93743125144,93743125139,-5,1268,3750,20
93744775418,93744775414,-4,1425,3165,20
93745573839,93745573834,-5,1114,2617,20
93746700317,93746700315,-2,1119,2256,20
93747667902,93747667900,-2,2819,4434,20
93750836726,93750836724,-2,760,1281,20
93753992095,93753992098,3,3622,2849,20
93755726615,93755726613,-2,897,1886,20
93756246245,93756246240,-5,997,2039,20
93756967907,93756967905,-2,817,2650,20
93762478007,93762478001,-6,765,2963,20
93769398658,93769398652,-6,755,1515,20
93772419010,93772419005,-5,1575,2485,20
93772791840,93772791836,-4,973,2657,20
93774004658,93774004661,3,1382,1577,20
93775558349,93775558347,-2,1004,2912,20
93782294442,93782294441,-1,1281,2310,20
93787168175,93787168171,-4,776,2374,20
93787558997,93787558995,-2,1112,2368,20
93789862971,93789862969,-2,658,1555,20
93791545698,93791545694,-4,1241,2180,20
93791768999,93791768994,-5,995,1652,20
93792885380,93792885396,16,3908,17567,20
93793326798,93793326808,10,9759,45614,20
93803940620,93803940618,-2,920,2708,20
93805741178,93805741175,-3,1216,1511,20
93807586662,93807586658,-4,1202,2215,20
93807774832,93807774829,-3,1489,2834,20
93808145023,93808145021,-2,913,1883,20
93808353588,93808353585,-3,1304,2885,20
93815622507,93815622503,-4,1022,1908,20
93817136163,93817136160,-3,1647,2954,20
93818491049,93818491046,-3,1264,2057,20
93820887141,93820887138,-3,1277,2113,20
93822767937,93822767932,-5,1227,2778,20
93823893532,93823893534,2,2774,3000,20
93828313363,93828313362,-1,1103,1900,20
93830424376,93830424383,7,6669,2713,20
93830590495,93830590492,-3,863,2514,20
93833365813,93833365811,-2,813,2275,20
93836954726,93836954723,-3,1136,2371,20
93837520227,93837520222,-5,448,1824,20
93838392644,93838392642,-2,958,2218,20
93839087474,93839087470,-4,1546,2970,20
93839781023,93839781021,-2,952,2400,20
93844392871,93844392869,-2,850,1511,20
93851017020,93851017022,2,1593,2002,20
93852631884,93852631879,-5,1288,2782,20
93852682407,93852682418,11,159,1366,20
93856182775,93856182774,-1,968,2207,20
93856873681,93856873676,-5,1235,3044,20
93864316473,93864316478,5,3592,2297,20
93864474098,93864474097,-1,1038,2363,20
93868014212,93868014208,-4,1782,2059,20
93875045849,93875045854,5,2130,1495,20
93875471876,93875471897,21,1310,2220,20
93876796363,93876796360,-3,1143,2234,20
93879919363,93879919360,-3,1388,2246,20
93888233588,93888233594,6,2472,1872,20
93889403926,93889403926,0,1537,2495,20
93894175263,93894175258,-5,792,2329,20
93894767739,93894767734,-5,888,2410,20
93904211238,93904211233,-5,1040,2005,20
93905039221,93905039218,-3,698,1123,20
93914831419,93914831417,-2,926,1946,20
93919066817,93919066814,-3,905,1454,20
93921101823,93921101838,15,216,1069,20
93922871120,93922871118,-2,1085,3121,20
93924517775,93924517772,-3,949,2345,20
93927917613,93927917610,-3,1464,2296,20
93928014210,93928014214,4,3354,1983,20
93932442497,93932442494,-3,1387,2770,20
93935337423,93935337422,-1,10717,15920,20
93936145599,93936145598,-1,1986,2411,20
93939059943,93939059940,-3,1060,2846,20
93939086029,93939086026,-3,996,1880,20
93944073219,93944073217,-2,835,2872,20
93945505981,93945505979,-2,1123,1289,20
93947846148,93947846145,-3,1287,2809,20
93948486610,93948486607,-3,1095,2767,20
93956649560,93956649557,-3,1172,2138,20
93956766131,93956766128,-3,1007,1881,20
93961592832,93961592830,-2,700,1838,20
93961779821,93961779818,-3,736,2629,20
93962686063,93962686061,-2,1346,2386,20
93963979511,93963979506,-5,913,2491,20
93964102536,93964102534,-2,1363,2669,20
93968127329,93968127322,-7,1247,3914,20
93968206803,93968206801,-2,1441,2848,20
93974567093,93974567089,-4,1332,2328,20
93981503978,93981503977,-1,1455,3297,20
93983334467,93983334466,-1,47494,38612,20
93994172577,93994172570,-7,1162,3748,20
93995696007,93995696005,-2,975,2222,20
93997015282,93997015281,-1,992,2388,20
94000189921,94000189921,0,985,2235,20
94002752745,94002752749,4,2242,789,20
94006161351,94006161346,-5,716,1821,20
94007705536,94007705533,-3,664,1606,20
94009594521,94009594526,5,3092,1561,20
94015283513,94015283510,-3,1148,2252,20
94018450676,94018450675,-1,1173,1583,20
94018896758,94018896758,0,779,1721,20
94019652570,94019652570,0,1625,2020,20
94022029482,94022029478,-4,1198,2508,20
94022096222,94022096242,20,225,1433,20
94026685721,94026685719,-2,849,1592,20
94029048438,94029048433,-5,1395,2949,20
94029404022,94029404026,4,2475,1615,20
94035222231,94035222226,-5,1499,2726,20
94040982912,94040982910,-2,1367,2136,20
94041826095,94041826093,-2,804,2467,20
94051033589,94051033586,-3,1409,2790,20
94068066195,94068066194,-1,1179,2069,20
94070499780,94070499775,-5,1109,2345,20
94076754305,94076754300,-5,1285,2481,20
94079154024,94079154029,5,2386,1003,20
94082024474,94082024472,-2,1053,2372,20
94082393467,94082393463,-4,952,1479,20
94084010814,94084010810,-4,851,2196,20
94084428754,94084428757,3,8176,25312,20
94084700283,94084700281,-2,1013,2037,20
94089862852,94089862850,-2,1078,1930,20
94092377707,94092377702,-5,1300,2115,20
94092976695,94092976701,6,1362,889,20
94095745916,94095745916,0,814,1935,20
94098538030,94098538027,-3,1343,2731,20
94099834941,94099834938,-3,1750,3088,20
94101746416,94101746422,6,2113,1237,20
94105006935,94105006932,-3,1083,1963,20
94105904578,94105904576,-2,1065,2735,20
94107270847,94107270844,-3,844,1925,20
94107309128,94107309146,18,336,868,20
94110676914,94110676910,-4,646,2328,20
94113622859,94113622854,-5,975,2061,20
94117869486,94117869485,-1,1326,1767,20
94122527366,94122527368,2,1213,1641,20
94122721945,94122721943,-2,937,2274,20
94122873127,94122873125,-2,1237,2746,20
94123808682,94123808682,0,1310,2429,20
94127005082,94127005079,-3,1339,2955,20
94130559739,94130559737,-2,839,2078,20
94133547373,94133547369,-4,1287,3366,20
94138592485,94138592482,-3,1181,2758,20
94139391087,94139391106,19,1268,2115,20
94140993670,94140993669,-1,603,1343,20
94143163437,94143163435,-2,93,883,20
94144515459,94144515453,-6,1027,3731,20
94152703794,94152703791,-3,939,1914,20
94155640759,94155640758,-1,1179,1966,20
94157883227,94157883222,-5,813,2198,20
94161895203,94161895201,-2,1107,1921,20
94171511930,94171511930,0,888,1449,20
94175399034,94175399031,-3,1567,3569,20
94178947765,94178947765,0,1174,2014,20
94188202326,94188202322,-4,1334,2482,20
94190475473,94190475470,-3,528,1729,20
94193731866,94193731863,-3,922,2111,20
94195105003,94195105001,-2,1421,2445,20
94196400298,94196400294,-4,1062,2205,20
94197984319,94197984318,-1,115,691,20
94199973571,94199973565,-6,1281,2240,20
94200445210,94200445207,-3,2001,2809,20
94204427728,94204427723,-5,1172,2223,20
94211338050,94211338050,0,1046,1571,20
94212765600,94212765580,-20,217,1332,20
94213784186,94213784191,5,2528,1312,20
94215122286,94215122286,0,1493,1842,20
94217322444,94217322442,-2,1112,2553,20
94220834022,94220834019,-3,811,2052,20
94220966445,94220966442,-3,1216,2335,20
94226141374,94226141373,-1,1051,2302,20
94226442046,94226442040,-6,1270,3242,20
94228414947,94228414943,-4,1023,2482,20
94229316461,94229316458,-3,998,2259,20
94233581835,94233581830,-5,435,1244,20
94234194387,94234194385,-2,1085,2554,20
94235265294,94235265297,3,2709,2313,20
94242717234,94242717230,-4,1511,1822,20
94244803934,94244803931,-3,1378,2315,20
94246612036,94246612031,-5,1477,2186,20
94247153407,94247153405,-2,1337,2170,20
94251376029,94251376025,-4,793,2617,20
94261388914,94261388911,-3,841,1760,20
94264296386,94264296384,-2,1218,1632,20
94265601279,94265601277,-2,1004,1692,20
94267168525,94267168522,-3,1053,2218,20
94267962758,94267962754,-4,1116,2127,20
94268679678,94268679680,2,1769,1843,20
94278021507,94278021504,-3,931,2690,20
94279831054,94279831050,-4,1077,2094,20
94281925559,94281925556,-3,623,1297,20
94284205371,94284205371,0,1048,1551,20
94290604638,94290604651,13,144,771,20
94291175103,94291175103,0,1679,2243,20
94291833566,94291833563,-3,814,2723,20
94291874385,94291874384,-1,29519,46370,20
94293544242,94293544241,-1,1369,2776,20
94294499288,94294499285,-3,958,1629,20
94300066266,94300066268,2,5462,5684,20
94302482051,94302482049,-2,943,1201,20
94305355770,94305355765,-5,1181,3367,20
94306451884,94306451891,7,4482,1401,20
94307523351,94307523347,-4,911,2451,20
94308282894,94308282892,-2,1063,2254,20
94313652021,94313652028,7,2743,1618,20
94316995206,94316995200,-6,1285,5203,20
94317291532,94317291554,22,459,2996,20
94324058962,94324058961,-1,27221,11219,20
94325056402,94325056399,-3,934,2243,20
94325220031,94325220027,-4,1400,2812,20
94329462751,94329462749,-2,978,2743,20
94337528174,94337528171,-3,1051,2731,20
94340672067,94340672064,-3,918,1743,20
94344585507,94344585504,-3,933,2065,20
94344963982,94344963967,-15,216,622,20
94345106135,94345106126,-9,1011,2780,20
94350119999,94350120018,19,1502,2594,20
94351257921,94351257917,-4,990,2147,20
94354159941,94354159937,-4,1611,3371,20
94356364054,94356364054,0,1595,2598,20
94358479749,94358479745,-4,1463,2374,20
94362660523,94362660521,-2,1489,1891,20
94362775403,94362775399,-4,22845,58535,20
94368447243,94368447241,-2,1216,2607,20
94369040942,94369040945,3,1364,1706,20
94369732031,94369732027,-4,1492,1927,20
94373919838,94373919836,-2,897,2354,20
94374096934,94374096922,-12,257,947,20
94376409227,94376409222,-5,1472,2635,20
94379413483,94379413478,-5,494,1979,20
94380103658,94380103656,-2,1219,2303,20
94380248887,94380248893,6,19444,52540,20
94381007526,94381007526,0,1437,1124,20
94386484011,94386484009,-2,1851,2207,20
94387198206,94387198207,1,1628,1177,20
94387901293,94387901290,-3,1261,2273,20
94394772553,94394772551,-2,3542,4477,20
94395634194,94395634194,0,1135,1393,20
94398972991,94398972989,-2,761,1783,20
94399237973,94399237984,11,217,1389,20
94400918235,94400918232,-3,733,1704,20
94403616370,94403616365,-5,1027,1720,20
94412651129,94412651128,-1,1051,2008,20
94415159287,94415159280,-7,2089,8644,20
94415924379,94415924378,-1,1147,1626,20
94421914935,94421914931,-4,1127,2841,20
94424001117,94424001116,-1,853,2085,20
94426043386,94426043385,-1,1227,2153,20
94427018434,94427018433,-1,1404,2217,20
94428504462,94428504460,-2,1101,2644,20
94429882150,94429882150,0,1314,2291,20
94440235734,94440235730,-4,1238,2127,20
94441971655,94441971654,-1,1046,2645,20
94442065407,94442065405,-2,390,1195,20
94448807560,94448807557,-3,1299,2846,20
94453775452,94453775463,11,960,1749,20
94463047238,94463047234,-4,662,2610,20
94472416760,94472416758,-2,836,1898,20
94475273951,94475273950,-1,1126,2213,20
94479710885,94479710881,-4,1320,2973,20
94484976895,94484976891,-4,1487,2980,20
94490719825,94490719822,-3,1303,2229,20
94491061766,94491061764,-2,1121,2816,20
94495262284,94495262281,-3,935,2209,20
94496958687,94496958682,-5,978,2787,20
94497967197,94497967193,-4,2107,4909,20
94498228747,94498228747,0,1347,1874,20
94499911018,94499911014,-4,1291,2218,20
94509740435,94509740434,-1,999,1335,20
94514185590,94514185586,-4,1067,2253,20
94514363262,94514363254,-8,1066,2146,20
94516058584,94516058583,-1,969,1456,20
94525954588,94525954586,-2,1088,1487,20
94525980398,94525980395,-3,901,2476,20
94528372822,94528372820,-2,876,2427,20
94529620881,94529620878,-3,1247,2624,20
94533703633,94533703631,-2,1039,1235,20
94537857535,94537857531,-4,432,1738,20
94543257330,94543257334,4,2405,1545,20
94543667505,94543667501,-4,1208,2305,20
94544007227,94544007224,-3,923,2196,20
94545072062,94545072058,-4,1166,1972,20
94547866522,94547866517,-5,1001,2885,20
94548363614,94548363631,17,173,405,20
94549673614,94549673613,-1,1151,2320,20
94550798134,94550798131,-3,835,1974,20
94552755135,94552755134,-1,785,1915,20
94553071824,94553071831,7,3049,1030,20
94568266309,94568266306,-3,1014,2598,20
94569567265,94569567261,-4,1328,2332,20
94576236755,94576236750,-5,865,2329,20
94578990889,94578990886,-3,1406,2943,20
94583466602,94583466598,-4,1440,3064,20
94588203272,94588203271,-1,1209,1919,20
94588917222,94588917220,-2,1135,2163,20
94590460583,94590460581,-2,853,2288,20
94591605807,94591605810,3,1181,1389,20
94594043987,94594043987,0,634,1859,20
94600316268,94600316266,-2,1040,2258,20
94600811012,94600811011,-1,1001,1797,20
94606015635,94606015633,-2,1178,2814,20
94609203370,94609203370,0,964,1985,20
94618289529,94618289525,-4,1406,3731,20
94623697854,94623697850,-4,1067,2178,20
94624427265,94624427263,-2,1399,2134,20
94626832518,94626832514,-4,1049,2780,20
94627039159,94627039157,-2,1333,2121,20
94627078814,94627078810,-4,2079,5629,20
94632692964,94632692962,-2,1057,2380,20
94632807326,94632807323,-3,1035,2634,20
94633749090,94633749085,-5,1046,2222,20
94634036436,94634036458,22,1084,2153,20
94639555136,94639555133,-3,1825,4931,20
94641456981,94641456975,-6,1052,2190,20
94643886019,94643886017,-2,679,3055,20
94649270334,94649270329,-5,1116,2642,20
94649366131,94649366128,-3,1413,2887,20
94660319790,94660319788,-2,1450,2938,20
94661571887,94661571885,-2,1418,3399,20
94670150222,94670150219,-3,1139,3250,20
94671488316,94671488317,1,1558,1903,20
94674657753,94674657754,1,2155,2834,20
94679622570,94679622565,-5,1052,3663,20
94680391084,94680391085,1,1499,1655,20
94681121175,94681121173,-2,1071,2088,20
94684079591,94684079589,-2,1778,2759,20
94684204746,94684204742,-4,1436,3347,20
94685303473,94685303472,-1,1292,2506,20
94689407567,94689407564,-3,1051,2247,20
94696665270,94696665267,-3,1058,2265,20
94701518594,94701518591,-3,1402,2250,20
94711917869,94711917870,1,2229,1315,20
94714588264,94714588261,-3,1086,2869,20
94720063506,94720063505,-1,1272,1922,20
94724748542,94724748540,-2,855,2583,20
94729984694,94729984690,-4,949,3560,20
94730802372,94730802370,-2,1178,2539,20
94734838840,94734838837,-3,975,1717,20
94736599603,94736599611,8,3830,1804,20
94737287111,94737287106,-5,944,2030,20
94738886659,94738886654,-5,1035,2789,20
94740628263,94740628262,-1,1512,2272,20
94741020478,94741020474,-4,1271,2038,20
94743769393,94743769390,-3,844,1503,20
94744596209,94744596209,0,1362,2462,20
94745261370,94745261366,-4,1446,3338,20
94748531899,94748531896,-3,771,1573,20
94751510986,94751510985,-1,1329,2608,20
94752382811,94752382810,-1,931,2549,20
94756606551,94756606547,-4,1008,1857,20
94758649435,94758649432,-3,1277,2928,20
94761354686,94761354682,-4,1064,2681,20
94761883332,94761883329,-3,552,1920,20
94768927362,94768927360,-2,1122,2557,20
94769883551,94769883549,-2,1204,2850,20
94774230674,94774230672,-2,984,2549,20
94776552287,94776552283,-4,2092,5595,20
94777593810,94777593811,1,2013,2823,20
94778139035,94778139032,-3,1324,2281,20
94782287439,94782287435,-4,981,3056,20
94782831715,94782831711,-4,1027,2308,20
94783297250,94783297245,-5,1239,2750,20
94783502588,94783502587,-1,957,1766,20
94790131954,94790131949,-5,896,2826,20
94791281241,94791281237,-4,1186,3911,20
94791550939,94791550936,-3,1223,1764,20
94794219673,94794219671,-2,1111,1902,20
94794648754,94794648749,-5,1096,2741,20
94795751163,94795751158,-5,937,1975,20
94796047154,94796047152,-2,706,1753,20
94798401644,94798401642,-2,1422,2639,20
94798900470,94798900468,-2,1031,2046,20
94805212884,94805212879,-5,1075,1408,20
94813384719,94813384716,-3,337,989,20
94813726285,94813726268,-17,892,1353,20
94816853330,94816853328,-2,1311,1820,20
94817348856,94817348833,-23,1444,2311,20
94817837853,94817837851,-2,853,2563,20
94820938757,94820938754,-3,986,1963,20
94822839015,94822839010,-5,1030,2460,20
94823205618,94823205617,-1,547,1855,20
94826527017,94826527010,-7,1047,2722,20
94827231148,94827231146,-2,953,2033,20
94837907599,94837907594,-5,669,2147,20
94838590402,94838590401,-1,861,2386,20
94843079451,94843079446,-5,371,2170,20
94845989986,94845989982,-4,1088,3400,20
94846243252,94846243266,14,478,1015,20
94847442359,94847442357,-2,939,1810,20
94851458847,94851458841,-6,2418,6296,20
94853036306,94853036323,17,1324,2121,20
94853431425,94853431422,-3,1267,3260,20
94853866070,94853866066,-4,1017,2549,20
94864719274,94864719272,-2,783,1624,20
94867105212,94867105229,17,821,1602,20
94868179414,94868179420,6,2543,1293,20
94874167795,94874167793,-2,863,1453,20
94877193588,94877193584,-4,1197,1880,20
94881742035,94881742034,-1,1122,1859,20
94882484905,94882484911,6,2046,1071,20
94887001111,94887001108,-3,1175,2126,20
94888603262,94888603258,-4,985,2690,20
94891121366,94891121364,-2,1309,2639,20
94893128531,94893128527,-4,628,1185,20
94896887003,94896887003,0,1517,2385,20
94897919914,94897919907,-7,37261,12651,20
94899446652,94899446650,-2,767,2514,20
94900207332,94900207313,-19,734,1718,20
94900370604,94900370623,19,282,940,20
94903069311,94903069308,-3,936,1974,20
94905225954,94905225958,4,2379,1740,20
94907237637,94907237633,-4,1300,2144,20
94907396784,94907396793,9,366,961,20
94909807693,94909807698,5,2695,1450,20
94917233960,94917233957,-3,820,2622,20
94919548350,94919548345,-5,1250,2829,20
94920619461,94920619442,-19,17394,26090,20
94921912388,94921912386,-2,917,2101,20
94922440145,94922440142,-3,1368,2834,20
94927992598,94927992596,-2,794,1516,20
94930469387,94930469385,-2,992,2054,20
94930692081,94930692081,0,1318,1440,20
94931939596,94931939592,-4,1309,3760,20
94936788508,94936788505,-3,1380,2455,20
94937212079,94937212074,-5,1009,1753,20
94937935038,94937935031,-7,4442,12551,20
94942617378,94942617382,4,1842,1821,20
94943505922,94943505919,-3,1163,2061,20
94946289537,94946289535,-2,1557,2116,20
94948031786,94948031783,-3,769,2090,20
94951381381,94951381379,-2,949,1763,20
94955451077,94955451075,-2,1114,2556,20
94956609184,94956609190,6,13928,6007,20
94958753439,94958753437,-2,832,1067,20
94960717835,94960717829,-6,1007,1776,20
94961091630,94961091642,12,408,954,20
94966537126,94966537122,-4,1186,2519,20
94969436019,94969436025,6,1116,632,20
94969656553,94969656548,-5,1103,1131,20
94973876737,94973876732,-5,1375,1754,20
94975958871,94975958862,-9,23861,13754,20
94976925507,94976925506,-1,1091,1319,20
94980101718,94980101715,-3,1018,2928,20
94980916406,94980916401,-5,1243,3109,20
94984202106,94984202106,0,999,2350,20
94985288141,94985288138,-3,1257,2664,20
94988610801,94988610797,-4,920,1779,20
94990377453,94990377449,-4,1578,2505,20
94992269245,94992269243,-2,1059,2379,20
94992443366,94992443345,-21,1036,2619,20
94995161675,94995161674,-1,1014,1871,20
94997096860,94997096856,-4,1235,3302,20
95000650698,95000650695,-3,966,1689,20
95000875844,95000875846,2,1613,1914,20
95016394446,95016394445,-1,882,1436,20
95017090535,95017090533,-2,781,2593,20
95018612042,95018612039,-3,1269,2320,20
95019238241,95019238237,-4,1691,3305,20
95020646794,95020646793,-1,1004,2924,20
95020846831,95020846808,-23,1055,2468,20
95021376293,95021376290,-3,1424,2910,20
95022837322,95022837319,-3,931,1456,20
95027394363,95027394358,-5,1043,2622,20
95029324523,95029324519,-4,1076,2555,20
95033715602,95033715597,-5,850,2452,20
95039561653,95039561667,14,527,2653,20
95041470125,95041470122,-3,1274,2003,20
95043209214,95043209210,-4,1780,4096,20
95047051637,95047051634,-3,1679,2389,20
95047099139,95047099137,-2,1147,2784,20
95049190252,95049190258,6,5635,4649,20
95053803522,95053803521,-1,1626,2617,20
95056665782,95056665778,-4,1159,2118,20
95058050978,95058050975,-3,1087,1968,20
95059895701,95059895696,-5,1002,2073,20
95062504538,95062504534,-4,888,1648,20
95066031101,95066031098,-3,951,1951,20
95068192587,95068192586,-1,1319,3259,20
95071744269,95071744265,-4,937,1938,20
95071812334,95071812350,16,918,11763,20
95075677614,95075677611,-3,1407,1878,20
95076074714,95076074712,-2,1252,2236,20
95076252350,95076252365,15,12619,51182,20
95080521106,95080521104,-2,1255,2298,20
95084145282,95084145278,-4,1030,2176,20
95084450905,95084450901,-4,1628,2175,20
95084916215,95084916213,-2,977,1812,20
95084977678,95084977669,-9,924,2303,20
95085979077,95085979073,-4,833,1710,20
95091579715,95091579714,-1,868,1670,20
95095850976,95095850974,-2,1264,1956,20
95098295493,95098295490,-3,1007,2427,20
95098518647,95098518644,-3,1232,2993,20
95101902292,95101902288,-4,39995,12252,20
95102794787,95102794785,-2,961,1884,20
95104689265,95104689263,-2,2883,4487,20
95106622819,95106622818,-1,888,2088,20
95109072047,95109072050,3,1295,1138,20
95113480379,95113480376,-3,1185,2929,20
95113581990,95113581990,0,1126,2153,20
95115707905,95115707901,-4,1411,2365,20
95115812242,95115812237,-5,1234,2054,20
95117035207,95117035202,-5,898,2523,20
95117842121,95117842117,-4,1141,2581,20
95118424449,95118424442,-7,980,3047,20
95118722596,95118722618,22,647,1390,20
95122740421,95122740417,-4,1090,2137,20
95122868697,95122868695,-2,1580,2400,20
95125091376,95125091378,2,1401,1034,20
95127967234,95127967247,13,14986,37048,20
95129277454,95129277450,-4,1275,2314,20
95131399695,95131399691,-4,980,2810,20
95131525095,95131525113,18,880,1798,20
95137853838,95137853835,-3,1103,2024,20
95140017855,95140017853,-2,1154,2788,20
95141622939,95141622937,-2,942,1811,20
95143874015,95143874013,-2,699,2706,20
95145213106,95145213103,-3,1154,3089,20
95149541346,95149541342,-4,1291,3031,20
95152678997,95152678995,-2,1909,2641,20
95153455672,95153455671,-1,44350,18664,20
95159639306,95159639305,-1,707,1150,20
95167154137,95167154138,1,1625,1708,20
95167893074,95167893071,-3,1271,2661,20
95169826905,95169826909,4,2264,1664,20
95173416606,95173416604,-2,947,1818,20
95175675491,95175675490,-1,1111,2282,20
95177298830,95177298827,-3,1125,2042,20
95183030571,95183030569,-2,1747,2948,20
95187991177,95187991173,-4,1375,2756,20
95188102413,95188102413,0,1597,1321,20
95189053080,95189053067,-13,218,1468,20
95190093356,95190093352,-4,823,1324,20
95193351841,95193351839,-2,1404,3767,20
95194457039,95194457034,-5,1668,3040,20
95198246236,95198246234,-2,1722,3021,20
95198582443,95198582439,-4,1579,2573,20
95206091298,95206091294,-4,992,3588,20
95207693791,95207693789,-2,991,2023,20
95207944717,95207944718,1,30585,36883,20
95211018785,95211018766,-19,895,1103,20
95211422916,95211422913,-3,867,1487,20
95213728836,95213728838,2,1236,1284,20
95213789127,95213789125,-2,944,2139,20
95214922093,95214922094,1,259,865,20
95216049659,95216049654,-5,1589,2516,20
95225073815,95225073812,-3,1185,2408,20
95231208100,95231208098,-2,1221,2672,20
95233243002,95233242998,-4,1328,2210,20
95237726451,95237726446,-5,848,1895,20
95239171807,95239171805,-2,1483,2272,20
95239549123,95239549122,-1,1664,2154,20
95252498292,95252498290,-2,1262,2388,20
95258497622,95258497626,4,222,1276,20
95261298753,95261298751,-2,1069,2218,20
95261346821,95261346842,21,1228,1997,20
95265938329,95265938328,-1,1366,2613,20
95270930524,95270930521,-3,1477,2396,20
95271821280,95271821274,-6,1078,2736,20
95275231166,95275231161,-5,1345,2595,20
95277445030,95277445027,-3,1286,2893,20
95280896666,95280896661,-5,961,1462,20
95281372050,95281372046,-4,863,3625,20
95284011826,95284011824,-2,1064,1685,20
95286637039,95286637036,-3,998,1619,20
95288215781,95288215778,-3,1100,1803,20
95292458989,95292458998,9,39,1292,20
95295714334,95295714331,-3,865,3049,20
95296050059,95296050056,-3,1333,3374,20
95297991751,95297991749,-2,456,1613,20
95298694538,95298694534,-4,1076,2782,20
95300151627,95300151626,-1,563,1326,20
95301187735,95301187730,-5,1164,2760,20
95302798025,95302798022,-3,1019,1862,20
95306794466,95306794466,0,662,912,20
95313885402,95313885398,-4,1331,3558,20
95314836419,95314836425,6,15820,18192,20
95316082153,95316082154,1,1601,1984,20
95319623433,95319623433,0,2881,2614,20
95319834487,95319834483,-4,1244,3145,20
95322748572,95322748572,0,1503,2597,20
95326396978,95326396974,-4,1308,2249,20
95328002995,95328002993,-2,1579,2372,20
95330450891,95330450889,-2,1520,3259,20
95331384066,95331384063,-3,1818,3237,20
95334354951,95334354950,-1,1097,1679,20
95335007825,95335007822,-3,864,2246,20
95339611707,95339611702,-5,1258,1975,20
95348335665,95348335663,-2,1203,2540,20
95352657867,95352657859,-8,983,5474,20
95354273214,95354273211,-3,855,2267,20
95357262785,95357262787,2,1554,1331,20
95357535002,95357535002,0,1392,2033,20
95358374502,95358374500,-2,1354,2629,20
95359824846,95359824843,-3,995,2783,20
95365645956,95365645951,-5,1135,3164,20
95368758150,95368758145,-5,866,2555,20
95369393585,95369393582,-3,911,2406,20
95371821300,95371821296,-4,521,1385,20
95372624273,95372624270,-3,1248,2170,20
95379397249,95379397245,-4,1134,1729,20
95381229905,95381229906,1,2152,1675,20
95386116561,95386116561,0,1260,1596,20
95387533336,95387533334,-2,1118,2241,20
95388162442,95388162448,6,5850,2077,20
95388861279,95388861275,-4,1153,2304,20
95390628247,95390628259,12,11607,26229,20
95392479780,95392479787,7,10143,4823,20
95392660114,95392660111,-3,879,2059,20
95392943170,95392943165,-5,1707,3468,20
95393738687,95393738683,-4,1432,3951,20
95397549429,95397549427,-2,1044,2435,20
95399893420,95399893421,1,1493,2405,20
95404176553,95404176549,-4,1737,3326,20
95407152417,95407152414,-3,1286,1986,20
95415126296,95415126294,-2,1656,2412,20
95417272810,95417272806,-4,1385,3342,20
95419004979,95419004977,-2,641,1679,20
95425849672,95425849667,-5,1008,2499,20
95427687106,95427687103,-3,983,2219,20
95429578314,95429578310,-4,1128,2331,20
95436384800,95436384795,-5,1084,3427,20
95436512365,95436512363,-2,871,1728,20
95436597266,95436597272,6,901,1010,20
95442793243,95442793241,-2,1049,3484,20
95442950268,95442950290,22,1252,1720,20
95445999846,95445999843,-3,1234,2063,20
95446874106,95446874103,-3,1024,1788,20
95447114221,95447114213,-8,603,1875,20
95453905421,95453905422,1,2124,1678,20
95461765153,95461765150,-3,1515,3433,20
95462094274,95462094279,5,1464,1175,20
95462127887,95462127885,-2,629,2141,20
95462625142,95462625135,-7,1065,2092,20
95463678861,95463678882,21,297,677,20
95469285978,95469285975,-3,1296,2811,20
95475263475,95475263472,-3,1215,2149,20
95477536076,95477536073,-3,1240,2952,20
95477991026,95477991021,-5,908,2623,20
95480728807,95480728806,-1,1211,1436,20
95482691134,95482691131,-3,1202,2931,20
95483109702,95483109705,3,1232,1265,20
95492322647,95492322651,4,3692,2962,20
95492638366,95492638362,-4,789,2735,20
95496734150,95496734150,0,1271,2552,20
95497968794,95497968801,7,4867,2163,20
95506275668,95506275665,-3,1271,2930,20
95507950178,95507950177,-1,1117,3049,20
95509272327,95509272325,-2,927,1355,20
95514130526,95514130525,-1,1176,2004,20
95519571409,95519571409,0,1571,1671,20
95520516827,95520516824,-3,763,1802,20
95523814478,95523814474,-4,1481,2379,20
95532811103,95532811099,-4,511,1338,20
95533611351,95533611349,-2,857,1841,20
95535863583,95535863581,-2,1071,1970,20
95537393779,95537393774,-5,912,2306,20
95538061596,95538061590,-6,836,1372,20
95538393320,95538393327,7,2651,649,20
95539079948,95539079947,-1,963,1216,20
95544816451,95544816450,-1,864,1799,20
95546358913,95546358907,-6,1013,3956,20
95548906631,95548906627,-4,749,1216,20
95550912354,95550912353,-1,1089,2026,20
95555333861,95555333858,-3,1138,2014,20
95561321787,95561321786,-1,747,1409,20
95563756908,95563756905,-3,1346,3101,20
95565620038,95565620037,-1,1201,2108,20
95567946556,95567946554,-2,1340,2580,20
95568646557,95568646555,-2,1008,2617,20
95572698744,95572698742,-2,1576,1919,20
95573497889,95573497885,-4,331,810,20
95577867558,95577867554,-4,1107,3131,20
95583385782,95583385779,-3,1306,1632,20
95585714340,95585714337,-3,1132,2989,20
95586988215,95586988212,-3,986,2016,20
95587876782,95587876779,-3,1049,2799,20
95588704431,95588704428,-3,1116,2109,20
95589830396,95589830395,-1,1275,2222,20
95591566795,95591566793,-2,1038,2059,20
95593128816,95593128813,-3,1460,3921,20
95594824674,95594824670,-4,1188,1981,20
95596793915,95596793909,-6,1241,5090,20
95601111710,95601111707,-3,793,1470,20
95602546489,95602546487,-2,1467,2614,20
95602716568,95602716566,-2,1125,2313,20
95605577615,95605577613,-2,880,1448,20
95608579880,95608579876,-4,936,2188,20
95609013538,95609013535,-3,818,2272,20
95610907967,95610907961,-6,1137,2734,20
95615429894,95615429913,19,2065,1454,20
95616495595,95616495594,-1,1094,2892,20
95618006186,95618006183,-3,1057,1205,20
95624463954,95624463951,-3,1126,2128,20
95626190897,95626190890,-7,1117,3145,20
95627655551,95627655550,-1,994,2853,20
95629781057,95629781054,-3,1234,2553,20
95631049518,95631049515,-3,612,1203,20
95632202605,95632202602,-3,1505,2628,20
95634068429,95634068426,-3,662,2264,20
95634331252,95634331269,17,172,526,20
95634500854,95634500872,18,887,2569,20
95635029522,95635029518,-4,1030,1648,20
95640564417,95640564423,6,2263,1405,20
95641511794,95641511796,2,1464,1238,20
95641840962,95641840960,-2,834,1830,20
95645940166,95645940161,-5,1031,2643,20
95646057786,95646057784,-2,1227,2031,20
95646115503,95646115502,-1,1172,1828,20
95648542307,95648542304,-3,1296,1697,20
95648758158,95648758159,1,2437,2271,20
95650821609,95650821614,5,1784,1293,20
95655910581,95655910577,-4,1381,3645,20
95656013687,95656013685,-2,1138,2242,20
95656595288,95656595282,-6,1159,1882,20
95656998339,95656998337,-2,714,1965,20
95657790606,95657790601,-5,920,2602,20
95657952788,95657952783,-5,871,1586,20
95659725106,95659725104,-2,1097,1911,20
95676143128,95676143121,-7,44757,15927,20
95677541495,95677541491,-4,875,2977,20
95683189931,95683189929,-2,1105,2029,20
95685884526,95685884522,-4,1358,3878,20
95692053467,95692053466,-1,1351,3643,20
95692374850,95692374855,5,1574,1371,20
95694089216,95694089213,-3,953,1919,20
95694277993,95694277985,-8,875,4688,20
95694819407,95694819393,-14,1158,2263,20
95696846721,95696846718,-3,1101,1665,20
95703604129,95703604125,-4,1020,2268,20
95706048342,95706048338,-4,1461,2372,20
95706500211,95706500208,-3,1134,2295,20
95706902053,95706902047,-6,647,1560,20
95707625784,95707625780,-4,953,2432,20
95708548963,95708548961,-2,1412,2196,20
95709095535,95709095531,-4,1065,2091,20
95715457090,95715457088,-2,947,2203,20
95716392731,95716392726,-5,1323,3325,20
95719533534,95719533530,-4,1234,2318,20
95721640456,95721640451,-5,1405,3678,20
95723991739,95723991737,-2,1008,2416,20
95728455719,95728455714,-5,1252,2836,20
95730834237,95730834234,-3,1321,2318,20
95734293434,95734293433,-1,1370,1704,20
95735867740,95735867736,-4,1074,2454,20
95741216170,95741216174,4,2199,1891,20
95760776838,95760776833,-5,1610,2891,20
95767292795,95767292792,-3,1043,2941,20
95779399686,95779399680,-6,591,2974,20
95780026927,95780026909,-18,1210,3459,20
95783986528,95783986525,-3,1101,2149,20
95784758390,95784758386,-4,744,1274,20
95786837776,95786837793,17,304,792,20
95787298445,95787298467,22,862,2107,20
95790892740,95790892737,-3,1270,3272,20
95794918687,95794918682,-5,876,2066,20
95796380195,95796380189,-6,1045,2962,20
95797665659,95797665658,-1,921,2568,20
95797890478,95797890476,-2,907,1336,20
95806455989,95806455987,-2,922,2688,20
95814441821,95814441818,-3,1083,2615,20
95817009941,95817009937,-4,1017,1854,20
95821256231,95821256227,-4,1265,2951,20
95822865114,95822865127,13,86,818,20
95826024900,95826024896,-4,1405,1935,20
95829501351,95829501348,-3,805,2089,20
95834174098,95834174097,-1,1073,2614,20
95834463172,95834463189,17,478,7290,20
95835259654,95835259653,-1,1176,2333,20
95840436465,95840436459,-6,1164,2735,20
95840655495,95840655490,-5,1111,2913,20
95840928978,95840928974,-4,918,2090,20
95842278319,95842278325,6,3079,1659,20
95846591698,95846591696,-2,1092,2907,20
95855288180,95855288175,-5,1065,3102,20
95869032789,95869032787,-2,1564,2416,20
95881157522,95881157520,-2,8356,17380,20
95882906050,95882906046,-4,1034,1540,20
95886098321,95886098320,-1,869,2230,20
95887233615,95887233610,-5,1144,2445,20
95887406682,95887406686,4,1799,1105,20
95889580712,95889580709,-3,1044,2172,20
95889615258,95889615254,-4,750,1626,20
95892021636,95892021633,-3,834,2747,20
95892890374,95892890373,-1,1163,1904,20
95895902359,95895902354,-5,1077,3635,20
95899389087,95899389083,-4,1091,1460,20
95916478471,95916478469,-2,1359,3141,20
95918460896,95918460894,-2,1305,1762,20
95919471991,95919471989,-2,726,1353,20
95920335241,95920335237,-4,747,1940,20
95924590419,95924590415,-4,1456,3012,20
95927422963,95927422960,-3,1703,2525,20
95927647557,95927647554,-3,1133,2361,20
95928491486,95928491483,-3,1303,1808,20
95933596555,95933596561,6,3073,2098,20
95939508759,95939508755,-4,1180,2402,20
95940527723,95940527723,0,530,1191,20
95941647682,95941647678,-4,1400,3646,20
95942207908,95942207905,-3,1114,2910,20
95948671473,95948671476,3,1452,1747,20
95948898873,95948898870,-3,1178,2268,20
95951357205,95951357202,-3,958,1715,20
95961803771,95961803769,-2,1276,2151,20
95962894410,95962894407,-3,1344,1704,20
95964484797,95964484794,-3,1064,2685,20
95965300274,95965300270,-4,1002,1759,20
95966632065,95966632060,-5,1022,2097,20
95967024853,95967024849,-4,1019,2354,20
95967091359,95967091377,18,1073,2789,20
95967547754,95967547751,-3,851,2669,20
95975886986,95975886967,-19,1777,820,20
95977027626,95977027621,-5,925,1340,20
95979607557,95979607553,-4,1149,2411,20
95984122926,95984122925,-1,826,1103,20
95985852817,95985852814,-3,894,2690,20
95986805117,95986805137,20,349,867,20
95992615437,95992615434,-3,1186,2834,20
95998179515,95998179510,-5,1265,3005,20
95998796102,95998796099,-3,1148,2567,20
95999527442,95999527438,-4,923,2424,20
96001067287,96001067286,-1,1238,1173,20
96006439239,96006439234,-5,830,2168,20
96006646767,96006646784,17,903,2933,20
96007259326,96007259325,-1,946,1654,20
96008732081,96008732078,-3,1665,2663,20
96011876091,96011876086,-5,1162,2679,20
96013098534,96013098530,-4,1430,2858,20
96015446023,96015446017,-6,883,2146,20
96016449254,96016449262,8,4125,1319,20
96017431494,96017431497,3,1646,1950,20
96019684474,96019684470,-4,1770,2427,20
96021126322,96021126319,-3,1225,2738,20
96024125873,96024125870,-3,791,2265,20
96027405365,96027405361,-4,840,1946,20
96029410603,96029410599,-4,1010,1646,20
96032894596,96032894593,-3,1706,3514,20
96034452895,96034452899,4,3779,16694,20
96045522462,96045522458,-4,1372,3865,20
96047647159,96047647157,-2,1740,2803,20
96047842303,96047842300,-3,1310,2329,20
96048081551,96048081546,-5,1117,2433,20
96048492294,96048492291,-3,1038,2539,20
96052198111,96052198109,-2,1430,3008,20
96052992569,96052992566,-3,1167,2786,20
96053765248,96053765265,17,284,1012,20
96054360915,96054360913,-2,1124,2190,20
96055843047,96055843042,-5,1125,4357,20
96059351873,96059351870,-3,1302,3053,20
96060983101,96060983098,-3,2504,4794,20
96063907783,96063907778,-5,1262,2310,20
96065275193,96065275189,-4,1097,3500,20
96065610495,96065610474,-21,1110,1928,20
96069194410,96069194410,0,876,2145,20
96069288679,96069288676,-3,1169,1753,20
96069358206,96069358225,19,1071,2495,20
96069489150,96069489148,-2,649,1343,20
96070992929,96070992927,-2,1091,2757,20
96072005813,96072005809,-4,1110,2521,20
96073106262,96073106258,-4,1228,3349,20
96073137113,96073137112,-1,1529,2832,20
96073585900,96073585898,-2,1565,1928,20
96075236552,96075236547,-5,1510,2765,20
96077079311,96077079310,-1,1321,1311,20
96077458900,96077458896,-4,1142,3028,20
96077539278,96077539266,-12,903,1786,20
96080622318,96080622317,-1,821,1868,20
96081813357,96081813356,-1,1100,2182,20
96082723355,96082723350,-5,20592,10747,20
96084089696,96084089695,-1,1166,1376,20
96093801038,96093801033,-5,844,1897,20
96103300055,96103300053,-2,1436,2377,20
96104234919,96104234918,-1,1344,2472,20
96106187762,96106187758,-4,1043,3124,20
96108225107,96108225101,-6,759,3363,20
96108385568,96108385569,1,1217,1458,20
96110418803,96110418799,-4,1063,1775,20
96111151181,96111151185,4,18670,27673,20
96121891679,96121891675,-4,1472,2946,20
96132227511,96132227507,-4,1247,2739,20
96133998255,96133998270,15,336,920,20
96134988028,96134988025,-3,1297,1722,20
96142510350,96142510345,-5,953,1973,20
96144425482,96144425478,-4,844,2429,20
96149374833,96149374833,0,1034,1764,20
96153346527,96153346525,-2,1471,2470,20
96155343271,96155343269,-2,993,1933,20
96156815923,96156815921,-2,1112,2168,20
96160447067,96160447064,-3,1218,3434,20
96164430983,96164430978,-5,1039,2237,20
96164663770,96164663767,-3,1169,2065,20
96165464690,96165464687,-3,820,2084,20
96165574774,96165574760,-14,1234,2273,20
96169469479,96169469477,-2,1162,3107,20
96175758762,96175758761,-1,1456,2259,20
96183885680,96183885679,-1,1516,968,20
96184459461,96184459458,-3,817,2938,20
96187438053,96187438050,-3,1474,2629,20
96194165930,96194165928,-2,1313,2474,20
96197235568,96197235563,-5,1319,2198,20
96202281944,96202281944,0,1373,2084,20
96208474580,96208474578,-2,1352,1373,20
96210441645,96210441643,-2,1150,1605,20
96213387374,96213387370,-4,1392,2292,20
96219610079,96219610077,-2,768,1722,20
96219714840,96219714826,-14,1205,2431,20
96224389914,96224389934,20,289,397,20
96229268870,96229268867,-3,1377,2568,20
96237129021,96237129019,-2,1048,2670,20
96238144884,96238144880,-4,1340,2449,20
96238182814,96238182812,-2,939,1650,20
96243338882,96243338878,-4,1175,2904,20
96243470374,96243470369,-5,1360,3310,20
96245544534,96245544532,-2,1041,2632,20
96249654570,96249654567,-3,1004,2607,20
96249822359,96249822353,-6,529,2684,20
96256896483,96256896482,-1,1170,2161,20
96260247014,96260247011,-3,1178,2427,20
96263761743,96263761739,-4,1194,1536,20
96266022077,96266022075,-2,845,2568,20
96267450545,96267450540,-5,1160,3258,20
96267748550,96267748567,17,670,1600,20
96269717142,96269717139,-3,1435,2737,20
96269804299,96269804298,-1,944,2018,20
96270875039,96270875038,-1,1354,1908,20
96274524247,96274524241,-6,677,2194,20
96274928862,96274928855,-7,1236,4143,20
96277181785,96277181789,4,3008,1788,20
96277792444,96277792433,-11,1104,2543,20
96278291018,96278291014,-4,1273,3533,20
96279563643,96279563643,0,1495,2525,20
96286097492,96286097489,-3,1229,2189,20
96289473015,96289473016,1,1618,2620,20
96293248195,96293248191,-4,1250,2058,20
96294032631,96294032623,-8,167,834,20
96302530134,96302530128,-6,1318,4078,20
96302856058,96302856058,0,1032,1655,20
96303347001,96303346997,-4,797,2288,20
96304106622,96304106607,-15,1156,3048,20
96304524842,96304524838,-4,1361,2218,20
96307582194,96307582190,-4,1009,2227,20
96312273578,96312273576,-2,1158,2340,20
96318374178,96318374178,0,931,1782,20
96318797113,96318797109,-4,1116,2499,20
96323094564,96323094562,-2,1323,2677,20
96323387015,96323387010,-5,915,2679,20
96327847907,96327847903,-4,1184,2403,20
96331473623,96331473621,-2,739,1706,20
96336089166,96336089163,-3,815,1564,20
96336683579,96336683575,-4,1413,2405,20
96337418620,96337418641,21,811,1869,20
96340178698,96340178694,-4,1102,2372,20
96340259763,96340259762,-1,1318,1839,20
96343313009,96343313007,-2,701,2236,20
96347851695,96347851694,-1,938,1770,20
96348391163,96348391161,-2,1578,2233,20
96350088007,96350088002,-5,1210,1808,20
96350656554,96350656551,-3,1175,2547,20
96351847407,96351847404,-3,1128,2017,20
96353789958,96353789954,-4,946,2121,20
96354220390,96354220386,-4,1493,2522,20
96354391946,96354391949,3,3700,3294,20
96358074769,96358074769,0,1049,2664,20
96359432153,96359432159,6,2216,1283,20
96360775050,96360775046,-4,1179,2849,20
96364824942,96364824937,-5,1248,3441,20
96365667591,96365667596,5,2472,1623,20
96366898511,96366898526,15,599,824,20
96373914846,96373914844,-2,1336,2293,20
96374877033,96374877030,-3,1397,2650,20
96380762322,96380762317,-5,1254,2629,20
96381019103,96381019101,-2,1268,3090,20
96381245296,96381245292,-4,755,689,20
96383456634,96383456629,-5,1387,2042,20
96389447842,96389447845,3,2760,2262,20
96393471640,96393471636,-4,1222,2971,20
96395089911,96395089907,-4,1387,2647,20
96397699643,96397699643,0,961,1303,20
96402119921,96402119917,-4,1339,2946,20
96405537825,96405537819,-6,29265,10273,20
96405979618,96405979617,-1,1010,2321,20
96407229543,96407229540,-3,1298,2738,20
96413152952,96413152950,-2,1229,2504,20
96415835174,96415835168,-6,1339,4332,20
96415907979,96415907974,-5,1173,2417,20
96417514697,96417514695,-2,899,1954,20
96417937435,96417937430,-5,1351,2652,20
96419538879,96419538873,-6,1055,2697,20
96420385103,96420385101,-2,1354,2622,20
96421645831,96421645826,-5,1033,2524,20
96426128013,96426128018,5,2694,1372,20
96427089920,96427089916,-4,393,1446,20
96434057495,96434057492,-3,1210,2156,20
96438069058,96438069055,-3,915,2680,20
96448786783,96448786781,-2,1467,3446,20
96451846064,96451846062,-2,948,1815,20
96454999414,96454999410,-4,1154,2520,20
96457734574,96457734571,-3,907,1513,20
96458981151,96458981146,-5,1022,2583,20
96461422027,96461422017,-10,35049,14287,20
96466046195,96466046193,-2,1315,3264,20
96471471055,96471471053,-2,1023,2078,20
96471977497,96471977493,-4,1069,1469,20
96476357679,96476357676,-3,1064,2533,20
96478242069,96478242065,-4,812,1879,20
96483348503,96483348500,-3,1237,2595,20
96488260021,96488260017,-4,1176,1904,20
96491936728,96491936747,19,346,1174,20
96497724881,96497724879,-2,1070,1308,20
96501894491,96501894489,-2,1041,2852,20
96504886333,96504886331,-2,663,1568,20
96510964099,96510964097,-2,817,1567,20
96511604154,96511604150,-4,1117,2939,20
96515273590,96515273587,-3,2177,4837,20
96521569543,96521569540,-3,1013,1911,20
96524379294,96524379291,-3,1566,2840,20
96529830364,96529830361,-3,1165,2710,20
96532436329,96532436329,0,1316,2804,20
96536512191,96536512190,-1,1127,2738,20
96540339698,96540339702,4,2935,1530,20
96540697508,96540697505,-3,889,2344,20
96542410035,96542410032,-3,1323,2470,20
96550294491,96550294485,-6,682,4608,20
96553038679,96553038675,-4,1624,3731,20
96554254549,96554254546,-3,1829,2537,20
96564750171,96564750167,-4,941,1546,20
96566305379,96566305374,-5,1155,1949,20
96567334771,96567334769,-2,1186,2716,20
96568868455,96568868453,-2,767,1424,20
96571122794,96571122801,7,2584,826,20
96573855417,96573855423,6,4650,2039,20
96580975478,96580975475,-3,909,2788,20
96581429349,96581429345,-4,1345,2818,20
96591768420,96591768418,-2,1673,2788,20
96599886315,96599886311,-4,653,1156,20
96600778134,96600778131,-3,1000,2009,20
96601247978,96601247975,-3,981,1761,20
96605615547,96605615549,2,3378,1831,20
96609364865,96609364862,-3,1666,2508,20
96609817333,96609817338,5,200,1084,20
96610287038,96610287059,21,948,3592,20
96613306882,96613306881,-1,1047,2549,20
96613360674,96613360670,-4,621,1888,20
96617671074,96617671074,0,1058,1665,20
96622102686,96622102686,0,2953,4549,20
96624315310,96624315309,-1,1793,2328,20
96624912327,96624912322,-5,1364,2442,20
96625630913,96625630909,-4,1241,2562,20
96629479049,96629479046,-3,1383,2576,20
96632038321,96632038318,-3,1442,2969,20
96632165253,96632165239,-14,618,2329,20
96640058397,96640058395,-2,1125,2189,20
96643407542,96643407538,-4,1042,1935,20
96647053306,96647053309,3,1602,1959,20
96647663781,96647663778,-3,900,2007,20
96648534588,96648534584,-4,1444,2776,20
96650327002,96650327000,-2,885,2551,20
96650488304,96650488318,14,556,1282,20
96650625037,96650625037,0,2873,4747,20
96650726361,96650726360,-1,1087,1513,20
96660218775,96660218771,-4,996,2336,20
96666252490,96666252488,-2,1015,2382,20
96668097942,96668097940,-2,954,2217,20
96669003151,96669003139,-12,143,758,20
96682888009,96682888007,-2,1293,3137,20
96687390622,96687390620,-2,1576,2823,20
96688589335,96688589333,-2,1136,2545,20
96689523290,96689523286,-4,976,1980,20
96689694737,96689694730,-7,2052,8832,20
96691596858,96691596854,-4,1313,2696,20
96693495270,96693495265,-5,1015,2484,20
96693860712,96693860710,-2,1142,1920,20
96701643870,96701643867,-3,1088,1743,20
96702440294,96702440291,-3,1161,3074,20
96711530514,96711530510,-4,918,1647,20
96711581846,96711581832,-14,947,1907,20
96713068235,96713068231,-4,1039,2159,20
96713320606,96713320605,-1,1293,2659,20
96715665699,96715665697,-2,825,1583,20
96719639105,96719639102,-3,1511,3048,20
96721855862,96721855863,1,1212,1612,20
96722883591,96722883587,-4,1452,2581,20
96724956216,96724956219,3,27569,20104,20
96728371771,96728371767,-4,848,1380,20
96730549622,96730549619,-3,857,2052,20
96730586222,96730586203,-19,1311,2119,20
96736715853,96736715849,-4,1428,3493,20
96736931850,96736931847,-3,809,1919,20
96737633270,96737633268,-2,1200,2177,20
96738093580,96738093577,-3,1328,2597,20
96739578104,96739578118,14,1023,1583,20
96744346535,96744346530,-5,915,2671,20
96750982657,96750982663,6,2419,1320,20
96753622454,96753622450,-4,1277,3124,20
96754745511,96754745512,1,3113,4084,20
96758455261,96758455257,-4,1468,2566,20
96758837730,96758837728,-2,1715,2457,20
96763715467,96763715461,-6,953,3592,20
96764674838,96764674835,-3,1079,1765,20
96768710213,96768710210,-3,1347,3085,20
96768976363,96768976362,-1,1181,2439,20
96771455141,96771455137,-4,1602,3114,20
96778529818,96778529819,1,1709,2469,20
96779180777,96779180770,-7,1347,6974,20
96779662034,96779662031,-3,836,1956,20
96782406851,96782406850,-1,996,2803,20
96782849042,96782849049,7,2881,1599,20
96784541871,96784541867,-4,974,1714,20
96785017061,96785017065,4,2289,1160,20
96785669086,96785669084,-2,3194,6472,20
96790019212,96790019209,-3,1514,2889,20
96795113223,96795113224,1,2746,3017,20
96797312647,96797312644,-3,965,2250,20
96798614699,96798614698,-1,971,1491,20
96802530502,96802530500,-2,1080,2247,20
96804634285,96804634282,-3,909,1864,20
96809356824,96809356821,-3,1649,1908,20
96810417795,96810417794,-1,1128,1946,20
96818283382,96818283378,-4,1151,2576,20
96820147047,96820147045,-2,890,1973,20
96820539082,96820539078,-4,1068,2871,20
96821473511,96821473507,-4,1176,2149,20
96823305170,96823305167,-3,616,2256,20
96823620849,96823620846,-3,708,1680,20
96829054795,96829054795,0,1552,2010,20
96830720346,96830720341,-5,1758,3374,20
96833958582,96833958581,-1,1609,1714,20
96839200837,96839200833,-4,456,1462,20
96841258955,96841258952,-3,1196,2816,20
96841310674,96841310670,-4,1347,2725,20
96842394270,96842394267,-3,1034,2813,20
96846331437,96846331434,-3,1240,2437,20
96846508634,96846508637,3,2075,842,20
96851639522,96851639522,0,1247,2486,20
96853627289,96853627285,-4,1184,3319,20
96858202751,96858202749,-2,963,2969,20
96858773730,96858773730,0,1049,1983,20
96862240714,96862240711,-3,1436,2346,20
96863179194,96863179191,-3,1068,3625,20
96864687586,96864687594,8,4047,1838,20
96867524988,96867524985,-3,981,3068,20
96871296610,96871296607,-3,1159,2252,20
96872015086,96872015082,-4,1175,2346,20
96875251591,96875251588,-3,646,1642,20
96877940262,96877940258,-4,1367,1827,20
96878344494,96878344495,1,3899,4498,20
96879033577,96879033574,-3,1287,2363,20
96879607574,96879607580,6,3081,1408,20
96883215735,96883215731,-4,1269,3075,20
96884200918,96884200915,-3,1232,2190,20
96887873486,96887873486,0,1252,1857,20
96890298729,96890298727,-2,1061,1850,20
96892344066,96892344065,-1,1270,1998,20
96892694729,96892694724,-5,1013,3240,20
96893681500,96893681498,-2,887,2253,20
96894996818,96894996816,-2,949,1912,20
96895643235,96895643233,-2,1441,1889,20
96898315623,96898315623,0,1092,2103,20
96902441644,96902441639,-5,1253,2712,20
96904371939,96904371937,-2,1074,2007,20
96905494843,96905494841,-2,1427,2402,20
96911337711,96911337710,-1,1424,2929,20
96914790126,96914790123,-3,1242,2156,20
96916697147,96916697144,-3,1105,2063,20
96918362398,96918362397,-1,850,2673,20
96926733397,96926733403,6,1874,900,20
96929864699,96929864694,-5,1776,3037,20
96930007395,96930007391,-4,874,1702,20
96932589435,96932589431,-4,1124,2326,20
96934205551,96934205547,-4,1294,3317,20
96936392815,96936392810,-5,788,2193,20
96942279797,96942279793,-4,1709,3212,20
96942426585,96942426582,-3,909,2454,20
96944062531,96944062528,-3,1626,2735,20
96945373226,96945373224,-2,947,2106,20
96949747502,96949747500,-2,1415,2421,20
96952983854,96952983852,-2,1092,2270,20
96958219311,96958219306,-5,691,1253,20
96967293081,96967293078,-3,1054,1927,20
96975069735,96975069733,-2,938,1795,20
96981084283,96981084280,-3,1343,2083,20
96984351291,96984351289,-2,1147,2277,20
96987032803,96987032802,-1,3980,6333,20
96988327017,96988327014,-3,1872,5229,20
96991830610,96991830605,-5,1161,3064,20
97004591547,97004591543,-4,906,2873,20
97007282134,97007282130,-4,473,1609,20
97008278750,97008278747,-3,1312,2321,20
97008545175,97008545173,-2,1365,2272,20
97009113394,97009113393,-1,1125,2100,20
97009377415,97009377430,15,839,2373,20
97011656757,97011656755,-2,908,1603,20
97012350556,97012350558,2,1264,2073,20
97012382734,97012382731,-3,1292,2078,20
97014380318,97014380317,-1,845,2352,20
97015121463,97015121460,-3,1131,2435,20
97025336307,97025336305,-2,1362,2155,20
97029032428,97029032413,-15,970,2759,20
97033956938,97033956937,-1,1554,3247,20
97042249447,97042249443,-4,1029,2332,20
97045233115,97045233114,-1,1028,1935,20
97047784211,97047784209,-2,930,1807,20
97053679685,97053679689,4,3670,1544,20
97054120943,97054120939,-4,985,2407,20
97054778559,97054778558,-1,2348,2539,20
97055836949,97055836947,-2,1088,2615,20
97057126162,97057126159,-3,999,3058,20
97060894107,97060894102,-5,1128,2910,20
97061763991,97061763989,-2,1542,2577,20
97063437331,97063437329,-2,1151,2087,20
97064796932,97064796927,-5,1215,4425,20
97065013870,97065013870,0,178,1453,20
97069327578,97069327577,-1,1556,2264,20
97070840166,97070840165,-1,1346,1176,20
97074749521,97074749518,-3,923,1721,20
97078712226,97078712223,-3,1073,2965,20
97079016231,97079016250,19,1009,2236,20
97079298367,97079298373,6,349,641,20
97081911057,97081911058,1,2823,3324,20
97085139985,97085139982,-3,859,1582,20
97091409438,97091409434,-4,618,1637,20
97092299597,97092299594,-3,1017,2720,20
97093738614,97093738613,-1,1002,1717,20
97097866175,97097866170,-5,1221,3410,20
97098540034,97098540032,-2,1276,2906,20
97106956274,97106956272,-2,972,2597,20
97107215544,97107215539,-5,1064,2999,20
97111156558,97111156554,-4,884,1729,20
97112134774,97112134772,-2,1385,2545,20
97112738777,97112738774,-3,1002,1738,20
97112850924,97112850945,21,965,2334,20
97112909182,97112909177,-5,951,1599,20
97113348574,97113348559,-15,303,879,20
97117959182,97117959179,-3,1241,1750,20
97120558805,97120558803,-2,1221,3432,20
97121903252,97121903250,-2,778,2127,20
97125103311,97125103317,6,2830,1426,20
97127498946,97127498942,-4,986,1819,20
97129036629,97129036634,5,11195,6713,20
97131230877,97131230874,-3,815,2107,20
97133911233,97133911239,6,10162,3700,20
97134279283,97134279281,-2,1113,2257,20
97137647839,97137647835,-4,880,2170,20
97138911028,97138911025,-3,804,2583,20
97139379533,97139379555,22,529,1401,20
97139688226,97139688225,-1,760,2150,20
97141624995,97141624990,-5,966,2910,20
97142502369,97142502365,-4,872,2401,20
97142702600,97142702616,16,387,985,20
97144372241,97144372237,-4,1558,2874,20
97145303908,97145303901,-7,2811,7969,20
97146126426,97146126422,-4,1008,1861,20
97160427436,97160427434,-2,877,1977,20
97165676322,97165676327,5,4287,2236,20
97166383926,97166383921,-5,1266,1997,20
97167382941,97167382936,-5,1136,2716,20
97168987378,97168987376,-2,1084,1895,20
97171318286,97171318282,-4,896,2607,20
97174246810,97174246806,-4,853,2737,20
97175366990,97175366989,-1,1404,2771,20
97176390595,97176390594,-1,852,1780,20
97178777278,97178777273,-5,1477,2939,20
97184201302,97184201301,-1,2122,3922,20
97184857626,97184857622,-4,1332,2989,20
97188532543,97188532540,-3,1133,2540,20
97189011124,97189011114,-10,999,2091,20
97193905159,97193905157,-2,615,1402,20
97194658007,97194658004,-3,1266,1983,20
97195538674,97195538670,-4,853,2537,20
97200068454,97200068450,-4,1316,2087,20
97200563154,97200563149,-5,1189,2843,20
97207207448,97207207442,-6,896,1962,20
97208035045,97208035042,-3,1120,2049,20
97209703559,97209703557,-2,911,1521,20
97209796946,97209796943,-3,1500,2956,20
97213521125,97213521128,3,4621,2439,20
97214378562,97214378562,0,1114,1396,20
97215601715,97215601713,-2,1073,3356,20
97221402049,97221402046,-3,1512,2287,20
97223638642,97223638640,-2,1249,3048,20
97229762825,97229762834,9,17178,22302,20
97231008268,97231008266,-2,838,2309,20
97234795162,97234795162,0,1105,1211,20
97238076423,97238076419,-4,1396,2795,20
97238802523,97238802521,-2,822,2006,20
97239481692,97239481714,22,804,2032,20
97241739462,97241739461,-1,1294,2334,20
97243334240,97243334258,18,518,1557,20
97244806098,97244806094,-4,813,2439,20
97246220796,97246220793,-3,1622,2387,20
97252675019,97252675015,-4,835,2574,20
97254070303,97254070302,-1,950,2312,20
97257705121,97257705117,-4,965,2188,20
97257869878,97257869896,18,847,2710,20
97258720795,97258720793,-2,795,2473,20
97259320290,97259320286,-4,1642,2468,20
97263395342,97263395339,-3,984,2129,20
97268973454,97268973448,-6,21227,13760,20
97269739210,97269739210,0,1557,3062,20
97277953815,97277953813,-2,694,1815,20
97279845787,97279845785,-2,1687,2254,20
97283687382,97283687378,-4,834,1432,20
97293063143,97293063140,-3,1115,2674,20
97294581738,97294581735,-3,1010,2341,20
97297168266,97297168265,-1,1306,2596,20
97301357252,97301357249,-3,1098,2275,20
97303469322,97303469317,-5,828,2238,20
97304604103,97304604099,-4,1253,3123,20
97305052174,97305052170,-4,1129,2719,20
97305119869,97305119869,0,943,1611,20
97309304119,97309304117,-2,1103,3069,20
97310212227,97310212226,-1,1121,1934,20
97313576441,97313576439,-2,979,2087,20
97314787664,97314787661,-3,1269,2778,20
97318169187,97318169188,1,951,1802,20
97320337774,97320337771,-3,1289,2370,20
97321807258,97321807263,5,2091,1110,20
97324006471,97324006469,-2,734,2417,20
97325184989,97325184988,-1,510,1682,20
97326516491,97326516489,-2,1155,2506,20
97329070394,97329070394,0,1353,1726,20
97330653329,97330653325,-4,1100,3168,20
97333539142,97333539140,-2,1199,2286,20
97345133272,97345133268,-4,1001,2256,20
97347148367,97347148365,-2,896,2045,20
97347845423,97347845421,-2,1134,1995,20
97349113270,97349113267,-3,773,1923,20
97349584509,97349584507,-2,2543,4301,20
97350853569,97350853574,5,51778,21575,20
97354755853,97354755844,-9,1017,2702,20
97357144490,97357144494,4,4508,2982,20
97357809889,97357809886,-3,1085,2130,20
97357851252,97357851253,1,1529,1808,20
97368023703,97368023702,-1,2475,4006,20
97374430302,97374430305,3,2496,1373,20
97375457890,97375457885,-5,1216,2574,20
97377219622,97377219618,-4,922,3285,20
97377492620,97377492602,-18,859,1688,20
97381165233,97381165230,-3,812,2075,20
97383909931,97383909928,-3,924,1758,20
97384035326,97384035304,-22,1029,1749,20
97388637809,97388637806,-3,1338,2984,20
97400249982,97400249978,-4,1127,2765,20
97402519383,97402519382,-1,819,1685,20
97403563180,97403563185,5,257,1079,20
97405172242,97405172239,-3,1611,3095,20
97405617906,97405617912,6,3699,1677,20
97406600462,97406600462,0,837,1473,20
97407201722,97407201717,-5,920,2840,20
97410444069,97410444065,-4,1547,2485,20
97411954203,97411954199,-4,766,1213,20
97413797400,97413797398,-2,856,1596,20
97417420086,97417420082,-4,810,1601,20
97418362163,97418362166,3,1726,1576,20
97418916562,97418916557,-5,1377,2478,20
97420455987,97420455982,-5,1068,3244,20
97423009228,97423009227,-1,962,1588,20
97425678241,97425678246,5,2905,1627,20
97425971443,97425971439,-4,1004,1833,20
97428644866,97428644864,-2,1245,3121,20
97429596251,97429596246,-5,1334,2517,20
97430359776,97430359773,-3,1256,2542,20
97432011818,97432011817,-1,1290,1446,20
97432902359,97432902344,-15,1106,2339,20
97433035884,97433035880,-4,1917,3052,20
97435359223,97435359219,-4,1126,3269,20
97438387480,97438387477,-3,1445,3066,20
97438736957,97438736954,-3,1292,1552,20
97439834081,97439834078,-3,2430,4821,20
97441177062,97441177059,-3,608,1513,20
97444819855,97444819850,-5,1396,1877,20
97447610571,97447610566,-5,1321,3019,20
97449464162,97449464160,-2,1171,1969,20
97450456471,97450456467,-4,1325,3542,20
97451650675,97451650671,-4,660,1901,20
97453502898,97453502896,-2,1440,2960,20
97455720394,97455720393,-1,1288,2173,20
97457555849,97457555847,-2,852,1867,20
97462957399,97462957395,-4,958,1933,20
97469372398,97469372402,4,3407,2500,20
97476399131,97476399129,-2,1073,2399,20
97489229610,97489229614,4,1789,1653,20
97490082159,97490082153,-6,1431,3362,20
97491373138,97491373142,4,7337,24358,20
97492063219,97492063215,-4,1143,1576,20
97494964839,97494964838,-1,1208,2667,20
97495208414,97495208411,-3,790,2765,20
97499830131,97499830127,-4,909,2182,20
97501166563,97501166561,-2,1125,2211,20
97502179926,97502179924,-2,1299,1625,20
97502496653,97502496651,-2,1122,2020,20
97505731760,97505731755,-5,1243,3240,20
97506431206,97506431207,1,1630,1685,20
97508636411,97508636405,-6,828,1615,20
97509444971,97509444967,-4,986,3125,20
97511683462,97511683458,-4,849,2815,20
97512661978,97512661974,-4,1287,2673,20
97514359358,97514359358,0,1438,1687,20
97514989263,97514989259,-4,1180,1856,20
97517070378,97517070374,-4,1058,1991,20
97517524491,97517524489,-2,1106,1786,20
97517645232,97517645250,18,849,2751,20
97519574547,97519574548,1,2687,2399,20
97526146898,97526146896,-2,1213,1565,20
97526534159,97526534141,-18,898,1506,20
97536741114,97536741113,-1,1249,2566,20
97538038294,97538038298,4,2041,1076,20
97542567515,97542567513,-2,905,2666,20
97542743759,97542743756,-3,1117,1929,20
97544285023,97544285018,-5,951,1907,20
97546566876,97546566875,-1,1440,3005,20
97548053079,97548053076,-3,837,3036,20
97550303838,97550303837,-1,1233,2408,20
97555032375,97555032374,-1,983,2502,20
97561353083,97561353080,-3,944,2021,20
97561686896,97561686911,15,1151,2192,20
97562387831,97562387813,-18,1112,2654,20
97567126195,97567126192,-3,1240,2617,20
97572243335,97572243330,-5,1003,3348,20
97577488871,97577488870,-1,1151,2200,20
97578448038,97578448036,-2,1230,2192,20
97579243403,97579243399,-4,1171,1617,20
97585309304,97585309302,-2,1226,1939,20
97586963186,97586963182,-4,1044,2297,20
97587017976,97587017991,15,1226,2427,20
97587525134,97587525122,-12,164,739,20
97595355533,97595355530,-3,1306,2239,20
97601011306,97601011302,-4,1076,1758,20
97601044321,97601044318,-3,1307,2628,20
97602324206,97602324204,-2,1178,3094,20
97606335306,97606335304,-2,1173,1600,20
97606510298,97606510295,-3,975,2035,20
97611222703,97611222700,-3,1070,1830,20
97611352151,97611352149,-2,1440,1743,20
97613300239,97613300233,-6,711,2167,20
97616154567,97616154566,-1,1611,2135,20
97618939322,97618939314,-8,922,3215,20
97621119942,97621119941,-1,719,1664,20
97625326705,97625326701,-4,733,2290,20
97631018297,97631018302,5,3986,2533,20
97634979067,97634979063,-4,1247,1965,20
97635848063,97635848061,-2,1082,2498,20
97641996562,97641996558,-4,2203,4778,20
97642166949,97642166946,-3,1147,3388,20
97643581979,97643581974,-5,926,3255,20
97645747676,97645747695,19,1226,2345,20
97647118819,97647118817,-2,598,1418,20
97651645213,97651645208,-5,1158,3072,20
97652248235,97652248234,-1,803,1859,20
97654003196,97654003193,-3,854,2389,20
97655568024,97655568042,18,338,1062,20
97658943408,97658943418,10,3379,936,20
97659474518,97659474515,-3,1099,2257,20
97663238270,97663238269,-1,956,1900,20
97666509837,97666509834,-3,1341,2269,20
97667922572,97667922569,-3,769,1888,20
97676022206,97676022206,0,840,1175,20
97678603674,97678603672,-2,1170,2000,20
97679927750,97679927747,-3,1543,3319,20
97680159600,97680159598,-2,1138,3153,20
97682973101,97682973098,-3,1550,2818,20
97684616732,97684616730,-2,1034,2237,20
97691845939,97691845934,-5,688,1743,20
97701499474,97701499474,0,1092,1547,20
97705072139,97705072137,-2,935,1884,20
97711665219,97711665216,-3,1304,2903,20
97711933441,97711933438,-3,1365,2331,20
97712116018,97712116016,-2,612,2260,20
97715336572,97715336573,1,1752,1843,20
97716069681,97716069677,-4,2667,7491,20
97716212359,97716212355,-4,1668,2177,20
97723484985,97723484982,-3,1560,3255,20
97728365559,97728365560,1,1757,2888,20
97728395343,97728395338,-5,1112,1421,20
97729885559,97729885556,-3,1201,2997,20
97735844506,97735844502,-4,1206,3061,20
97736631687,97736631665,-22,2014,1812,20
97736666950,97736666947,-3,911,1798,20
97739898734,97739898732,-2,884,1420,20
97741989531,97741989528,-3,1515,2860,20
97742668462,97742668461,-1,781,1961,20
97745783298,97745783296,-2,1021,1511,20
97747153709,97747153706,-3,1580,1977,20
97748809247,97748809244,-3,1205,2053,20
97755216987,97755216985,-2,628,976,20
97755920381,97755920389,8,5071,2155,20
97760310641,97760310639,-2,1764,2377,20
97761973433,97761973430,-3,1382,1941,20
97764567176,97764567174,-2,1414,2774,20
97764959282,97764959279,-3,1056,2781,20
97765393995,97765393991,-4,1238,2054,20
97770723109,97770723102,-7,1018,1865,20
97772025522,97772025518,-4,1160,2580,20
97772479863,97772479858,-5,1267,2493,20
97772820825,97772820822,-3,2166,2483,20
97776737165,97776737161,-4,1432,2462,20
97778356542,97778356541,-1,1515,3229,20
97780477957,97780477953,-4,1423,2795,20
97782944754,97782944752,-2,740,2170,20
97783684145,97783684142,-3,1131,1959,20
97785775946,97785775945,-1,795,2706,20
97789935218,97789935218,0,995,2712,20
97791441747,97791441749,2,1163,1158,20
97796730826,97796730822,-4,1276,2570,20
97800436346,97800436344,-2,1191,2439,20
97803292535,97803292531,-4,1308,2332,20
97809796381,97809796378,-3,1320,2620,20
97810202437,97810202459,22,1188,1980,20
97816588330,97816588326,-4,951,2461,20
97818634588,97818634609,21,1254,2850,20
97821555879,97821555874,-5,1304,3147,20
97822907251,97822907248,-3,1229,1721,20
97826294214,97826294214,0,1317,2334,20
97827927141,97827927135,-6,892,2783,20
97829715798,97829715795,-3,1141,2919,20
97831229019,97831229014,-5,1100,2593,20
97831454874,97831454872,-2,1342,2297,20
97832616840,97832616836,-4,1121,2219,20
97837256381,97837256377,-4,1008,2846,20
97840812970,97840812967,-3,946,2127,20
97841709772,97841709753,-19,1133,2163,20
97841976054,97841976055,1,310,1025,20
97847740662,97847740658,-4,927,2395,20
97848384768,97848384774,6,1059,1489,20
97851603186,97851603181,-5,1593,6802,20
97851771107,97851771102,-5,808,1742,20
97852241681,97852241679,-2,1606,2330,20
97853658046,97853658049,3,1084,2005,20
97854385815,97854385812,-3,933,2302,20
97855050415,97855050410,-5,932,1793,20
97855120441,97855120437,-4,1310,2442,20
97857315073,97857315069,-4,1460,2321,20
97857857447,97857857440,-7,1302,2584,20
97858909715,97858909714,-1,1161,1758,20
97859644321,97859644318,-3,1397,2344,20
97861114205,97861114204,-1,1120,2904,20
97863937669,97863937665,-4,837,2085,20
97864746199,97864746197,-2,1079,2795,20
97865709076,97865709072,-4,959,2577,20
97870229083,97870229078,-5,1049,2806,20
97871001725,97871001722,-3,957,1627,20
97872649893,97872649890,-3,1214,3030,20
97876928746,97876928742,-4,738,2277,20
97881560182,97881560180,-2,1193,2479,20
97885153540,97885153537,-3,1491,2108,20
97886252614,97886252613,-1,755,2542,20
97886889410,97886889406,-4,1241,2647,20
97887764523,97887764521,-2,889,2368,20
97895437889,97895437887,-2,880,1766,20
97895810357,97895810353,-4,5066,12716,20
97896683631,97896683626,-5,908,2722,20
97899156577,97899156576,-1,1388,2081,20
97901356166,97901356165,-1,1124,2110,20
97901517089,97901517094,5,3615,1910,20
97904315849,97904315855,6,4147,1324,20
97905617534,97905617528,-6,1170,2565,20
97906184201,97906184208,7,13179,24970,20
97907150237,97907150248,11,15939,33419,20
97907232197,97907232193,-4,891,2507,20
97907702322,97907702317,-5,986,2752,20
97908635455,97908635450,-5,1225,2699,20
97909264134,97909264132,-2,790,1754,20
97914032279,97914032289,10,8954,44446,20
97916054658,97916054655,-3,1711,2911,20
97921542226,97921542224,-2,1293,3014,20
97921628810,97921628805,-5,723,1537,20
97928575151,97928575152,1,1568,1534,20
97931425785,97931425781,-4,1289,2795,20
97936481065,97936481062,-3,826,2340,20
97940433536,97940433533,-3,1138,2260,20
97940824782,97940824780,-2,1230,3228,20
97943009081,97943009087,6,3203,1216,20
97944458238,97944458236,-2,1445,1959,20
97945986693,97945986687,-6,1085,1718,20
97949777465,97949777462,-3,1342,2490,20
97954942595,97954942590,-5,1029,2229,20
97957645573,97957645574,1,1353,2395,20
97962929201,97962929198,-3,939,1750,20
97965507849,97965507846,-3,1428,3209,20
97973071567,97973071564,-3,1181,3344,20
97974231910,97974231909,-1,1095,1698,20
97975195206,97975195207,1,3580,3295,20
97979615523,97979615519,-4,1008,2124,20
97980317131,97980317127,-4,751,2141,20
97981430333,97981430331,-2,1275,1964,20
97984160439,97984160437,-2,1065,2245,20
97985416282,97985416279,-3,1066,1815,20
97987549544,97987549550,6,5517,2769,20
97988973918,97988973914,-4,853,2818,20
97989125094,97989125111,17,617,1575,20
97990469839,97990469835,-4,1069,1892,20
97995574814,97995574811,-3,963,1534,20
97996494504,97996494501,-3,1652,2894,20
97997900622,97997900618,-4,1004,2468,20
97998186757,97998186754,-3,1301,2972,20
97999646823,97999646822,-1,1077,1723,20
98000273934,98000273932,-2,1179,1930,20
98000514694,98000514693,-1,1935,1595,20
98004699007,98004699005,-2,1237,2628,20
98007431740,98007431738,-2,982,2475,20
98008594776,98008594771,-5,1288,2440,20
98009982599,98009982595,-4,1537,3483,20
98011969613,98011969615,2,2496,1671,20
98014134358,98014134355,-3,964,2544,20
98019337850,98019337854,4,2024,1248,20
98021154623,98021154617,-6,1003,2061,20
98021260872,98021260889,17,909,2720,20
98026082143,98026082149,6,659,56,20
98026217655,98026217658,3,2388,2645,20
98028485686,98028485686,0,1169,2861,20
98030796931,98030796926,-5,724,2476,20
98031382494,98031382490,-4,907,3718,20
98033372693,98033372691,-2,930,2292,20
98034706479,98034706477,-2,888,2839,20
98034941326,98034941323,-3,614,1250,20
98037983146,98037983144,-2,1126,2125,20
98040948375,98040948371,-4,1068,2955,20
98042311551,98042311546,-5,1216,2828,20
98044504675,98044504674,-1,1137,1911,20
98044540995,98044540992,-3,1211,2094,20
98052875030,98052875030,0,1558,2451,20
98055672430,98055672426,-4,1426,2192,20
98056252427,98056252425,-2,1516,3145,20
98060620590,98060620590,0,1316,3216,20
98062299365,98062299363,-2,930,2070,20
98062715549,98062715533,-16,614,1493,20
98069681353,98069681351,-2,939,1511,20
98075532886,98075532883,-3,1246,2604,20
98076231610,98076231617,7,4600,1323,20
98078750747,98078750745,-2,1321,1914,20
98088081259,98088081257,-2,1181,2249,20
98088120733,98088120730,-3,1171,2648,20
98088153207,98088153189,-18,1549,3037,20
98090653713,98090653711,-2,1299,2302,20
98091643046,98091643045,-1,1074,2239,20
98097405438,98097405435,-3,1397,2548,20
98099713594,98099713593,-1,1349,2753,20
98101705719,98101705714,-5,652,2278,20
98105346406,98105346402,-4,1230,2978,20
98108718495,98108718492,-3,1092,1743,20
98110081893,98110081886,-7,898,3175,20
98110448559,98110448556,-3,1059,2254,20
98112679782,98112679778,-4,1115,2270,20
98117787573,98117787571,-2,1318,2137,20
98121212683,98121212681,-2,1075,2401,20
98135673194,98135673190,-4,1836,3122,20
98141130339,98141130335,-4,1146,1727,20
98149716450,98149716448,-2,1160,2448,20
98153743099,98153743093,-6,450,1954,20
98154691459,98154691455,-4,964,2565,20
98154800980,98154800986,6,4323,1971,20
98155342221,98155342216,-5,976,2351,20
98163364769,98163364766,-3,1395,2734,20
98163678488,98163678485,-3,844,1630,20
98163863981,98163863977,-4,95,1689,20
98177370750,98177370749,-1,1524,2237,20
98177506498,98177506493,-5,1173,2065,20
98184245525,98184245523,-2,1101,2886,20
98184903573,98184903570,-3,1140,1296,20
98188547891,98188547889,-2,1595,3148,20
98189235683,98189235680,-3,1129,2340,20
98189432214,98189432211,-3,821,1237,20
98192974322,98192974321,-1,1502,2698,20
98193110619,98193110613,-6,949,2933,20
98195914417,98195914410,-7,3063,10187,20
98198562082,98198562086,4,1561,1447,20
98200833578,98200833574,-4,951,2720,20
98203920847,98203920852,5,1175,1427,20
98208002903,98208002903,0,1221,2167,20
98210009266,98210009262,-4,685,1382,20
98210476020,98210476014,-6,925,2056,20
98218459574,98218459571,-3,1013,1800,20
98220310982,98220310978,-4,770,2172,20
98221649343,98221649345,2,1928,1914,20
98222600728,98222600725,-3,1045,2668,20
98224515331,98224515332,1,979,1682,20
98228759975,98228759976,1,924,2400,20
98228943386,98228943385,-1,3149,5535,20
98231356341,98231356339,-2,1375,2221,20
98232073013,98232073010,-3,1214,1948,20
98232183185,98232183181,-4,984,2194,20
98235985500,98235985496,-4,1129,3445,20
98236776756,98236776751,-5,156,1109,20
98238600862,98238600877,15,1082,1361,20
98240113834,98240113830,-4,1298,3217,20
98244239914,98244239910,-4,1284,2668,20
98246511875,98246511871,-4,984,2183,20
98247115402,98247115397,-5,1145,3719,20
98250228243,98250228241,-2,368,1485,20
98252760455,98252760453,-2,780,1689,20
98255710327,98255710325,-2,1419,3364,20
98260502772,98260502769,-3,1322,3263,20
98263863798,98263863795,-3,1149,2558,20
98267982187,98267982184,-3,1501,1874,20
98269000722,98269000720,-2,1214,2506,20
98271607847,98271607842,-5,1117,2472,20
98272044621,98272044614,-7,907,2190,20
98273399611,98273399606,-5,1262,2522,20
98283594894,98283594910,16,446,1664,20
98287710895,98287710896,1,1321,1414,20
98288787397,98288787393,-4,831,2205,20
98289970723,98289970723,0,1372,2009,20
98290339594,98290339590,-4,1003,2094,20
98295653785,98295653789,4,2710,2143,20
98296128495,98296128493,-2,1448,1991,20
98300071354,98300071351,-3,1549,2334,20
98301969990,98301969989,-1,934,2090,20
98302463210,98302463199,-11,25028,18671,20
98310725758,98310725759,1,2866,2107,20
98312367444,98312367450,6,2170,1107,20
98314014698,98314014697,-1,1009,2230,20
98314424966,98314424977,11,15637,38589,20
98316115138,98316115135,-3,1254,2525,20
98319979413,98319979410,-3,1781,2854,20
98324272186,98324272185,-1,962,2248,20
98331675208,98331675218,10,11404,41801,20
98332246754,98332246752,-2,903,2421,20
98335454031,98335454035,4,6205,4947,20
98339042435,98339042442,7,4709,2199,20
98339308721,98339308716,-5,1199,2184,20
98348388582,98348388578,-4,1141,2446,20
98349935213,98349935209,-4,1167,2156,20
98357731514,98357731511,-3,957,2330,20
98363910970,98363910970,0,1436,1759,20
98367551293,98367551291,-2,1214,2608,20
98368231299,98368231297,-2,1088,2147,20
98369968989,98369968970,-19,762,2828,20
98371211778,98371211773,-5,1108,3284,20
98371625271,98371625269,-2,910,2042,20
98379519083,98379519081,-2,994,2367,20
98386817786,98386817784,-2,1341,1766,20
98388507339,98388507337,-2,678,1452,20
98391036638,98391036634,-4,955,2831,20
98391820742,98391820745,3,1827,1511,20
98394055209,98394055206,-3,998,2533,20
98395511483,98395511481,-2,1806,3025,20
98398501248,98398501246,-2,1189,1823,20
98403981607,98403981611,4,5468,2781,20
98404969221,98404969222,1,1552,1644,20
98405374123,98405374121,-2,1374,2282,20
98414257262,98414257258,-4,1298,2213,20
98416805854,98416805853,-1,1363,2596,20
98417073476,98417073495,19,164,877,20
98424104575,98424104573,-2,1192,2206,20
98426715193,98426715189,-4,998,3409,20
98428961290,98428961289,-1,1268,1906,20
98429077143,98429077140,-3,1461,2833,20
98430451073,98430451069,-4,1412,2383,20
98432693505,98432693503,-2,704,2027,20
98433979770,98433979768,-2,1046,2163,20
98434379966,98434379954,-12,963,3457,20
98436790686,98436790683,-3,1463,2696,20
98437115542,98437115540,-2,1334,2085,20
98438118608,98438118605,-3,1403,2711,20
98438272815,98438272811,-4,968,3058,20
98438846455,98438846451,-4,822,2731,20
98440472881,98440472882,1,1875,1620,20
98441264173,98441264170,-3,1512,2222,20
98446868877,98446868874,-3,1062,2872,20
98449323749,98449323757,8,7174,2813,20
98455566340,98455566343,3,9904,7319,20
98460803380,98460803377,-3,887,1750,20
98466816237,98466816234,-3,1094,2547,20
98467182902,98467182901,-1,1008,1489,20
98467830251,98467830246,-5,681,1371,20
98479097342,98479097345,3,1931,1344,20
98480475249,98480475246,-3,1242,2665,20
98480596914,98480596911,-3,1367,2478,20
98481916230,98481916222,-8,1589,6520,20
98482775759,98482775771,12,25558,1697,20
98482927395,98482927392,-3,1615,3515,20
98484904505,98484904499,-6,839,2279,20
98486129013,98486129014,1,1539,1525,20
98498027310,98498027306,-4,1550,3033,20
98502292275,98502292274,-1,1474,2855,20
98503670668,98503670672,4,1739,1545,20
98504096062,98504096060,-2,1316,2408,20
98506316990,98506316989,-1,1126,1963,20
98506522068,98506522057,-11,1396,3571,20
98512162963,98512162961,-2,852,1502,20
98516380317,98516380313,-4,1330,2695,20
98516587034,98516587029,-5,874,3648,20
98520537069,98520537064,-5,1417,3276,20
98521012094,98521012093,-1,667,1950,20
98522420223,98522420218,-5,1151,2934,20
98525803182,98525803177,-5,927,2691,20
98532032254,98532032250,-4,994,2341,20
98532456704,98532456703,-1,1095,1670,20
98533979490,98533979486,-4,1208,1973,20
98534054742,98534054738,-4,731,2321,20
98538421114,98538421114,0,1194,1829,20
98541756062,98541756062,0,1515,2334,20
98543165768,98543165767,-1,1616,1898,20
98548492706,98548492703,-3,1732,2896,20
98555465319,98555465318,-1,682,1030,20
98557351923,98557351922,-1,1347,2312,20
98558130793,98558130793,0,1125,2191,20
98559009459,98559009457,-2,899,2681,20
98559456067,98559456062,-5,1899,3041,20
98560811009,98560811005,-4,50536,20194,20
98561702852,98561702853,1,1326,2055,20
98562951111,98562951109,-2,941,1698,20
98566861794,98566861796,2,818,1451,20
98569517997,98569517993,-4,841,2572,20
98570032363,98570032359,-4,1023,2152,20
98575395649,98575395647,-2,1856,3363,20
98577861151,98577861149,-2,1173,2303,20
98578425460,98578425481,21,815,1694,20
98580805316,98580805314,-2,1671,2593,20
98581602215,98581602215,0,1206,2295,20
98585809402,98585809401,-1,1182,1988,20
98588022894,98588022897,3,3092,2911,20
98592659958,98592659954,-4,931,2418,20
98595882352,98595882349,-3,1155,2296,20
98596211353,98596211347,-6,920,2381,20
98596964066,98596964062,-4,1458,2651,20
98598108506,98598108510,4,1393,936,20
98602915503,98602915501,-2,1252,3340,20
98605917626,98605917621,-5,474,2293,20
98610155237,98610155233,-4,920,2744,20
98614563890,98614563885,-5,1116,2804,20
98617644871,98617644867,-4,910,2782,20
98617734658,98617734664,6,2887,1727,20
98618467185,98618467181,-4,1246,2735,20
98619567819,98619567814,-5,1194,3274,20
98621738692,98621738697,5,1950,1056,20
98622826045,98622826041,-4,1396,2632,20
98624641828,98624641824,-4,834,1599,20
98628085499,98628085497,-2,1035,1467,20
98631825650,98631825649,-1,522,1581,20
98632390062,98632390058,-4,1219,2431,20
98632780237,98632780233,-4,830,1853,20
98633585788,98633585774,-14,1652,1833,20
98634663656,98634663675,19,189,894,20
98638926018,98638926014,-4,1267,2088,20
98638957381,98638957402,21,941,2174,20
98640605339,98640605320,-19,368,892,20
98640866542,98640866538,-4,1153,2621,20
98645404578,98645404576,-2,1258,1693,20
98645747827,98645747825,-2,1028,1653,20
98651911446,98651911443,-3,1141,2320,20
98656253748,98656253743,-5,1315,1912,20
98658318047,98658318044,-3,1475,2472,20
98658958786,98658958788,2,18665,44792,20
98661042743,98661042739,-4,1040,2863,20
98666891310,98666891306,-4,969,2317,20
98669625904,98669625898,-6,491,1667,20
98670499114,98670499122,8,17831,40486,20
98671606970,98671606980,10,15082,38255,20
98672201759,98672201759,0,2785,4465,20
98679232771,98679232769,-2,1056,2191,20
98680472445,98680472441,-4,788,2078,20
98681861831,98681861826,-5,1327,2980,20
98683533960,98683533958,-2,1399,3164,20
98683898017,98683898013,-4,1284,3008,20
98688370058,98688370055,-3,596,1696,20
98690514930,98690514926,-4,1387,2621,20
98695491830,98695491826,-4,1230,2175,20
98697661414,98697661409,-5,1014,2583,20
98700962715,98700962713,-2,1033,2309,20
98702988795,98702988793,-2,1472,2862,20
98704569920,98704569926,6,3476,1464,20
98705542360,98705542358,-2,589,1490,20
98708833481,98708833479,-2,1325,2775,20
98714020745,98714020737,-8,1550,7644,20
98714632606,98714632606,0,1022,1139,20
98716492279,98716492277,-2,1244,2556,20
98717541102,98717541081,-21,1222,3113,20
98718296486,98718296481,-5,1461,2036,20
98722038743,98722038741,-2,963,1332,20
98723162953,98723162958,5,1512,790,20
98729324021,98729324017,-4,619,1916,20
98730237293,98730237315,22,1588,3080,20
98730491915,98730491913,-2,1005,1953,20
98731153231,98731153211,-20,1525,2062,20
98734062319,98734062316,-3,1072,2281,20
98734522326,98734522342,16,863,2247,20
98736772310,98736772309,-1,1080,1924,20
98737004751,98737004752,1,1499,1584,20
98745198694,98745198690,-4,1090,2709,20
98746950281,98746950278,-3,1329,1843,20
98757251322,98757251318,-4,1020,2671,20
98759256068,98759256065,-3,1129,2352,20
98760919841,98760919839,-2,1084,1425,20
98768511861,98768511858,-3,1128,1981,20
98773977237,98773977235,-2,779,1943,20
98776619665,98776619663,-2,1422,2157,20
98777463908,98777463911,3,1610,1817,20
98777651421,98777651438,17,1078,1822,20
98780282918,98780282915,-3,1192,2360,20
98785228362,98785228359,-3,1437,3336,20
98785658989,98785658982,-7,770,1727,20
98793000410,98793000406,-4,722,2244,20
98793421870,98793421890,20,521,2400,20
98796200937,98796200938,1,1854,1960,20
98796988275,98796988271,-4,1009,2122,20
98799117698,98799117694,-4,681,3797,20
98799976055,98799976071,16,19,1210,20
98801378005,98801378010,5,2139,758,20
98803647428,98803647439,11,11958,27383,20
98806169311,98806169307,-4,1072,3194,20
98807920577,98807920578,1,1126,1400,20
98809560680,98809560677,-3,753,2587,20
98811159780,98811159775,-5,1432,2918,20
98811948986,98811948986,0,913,2131,20
98813400698,98813400694,-4,1912,2591,20
98813799967,98813799962,-5,1127,3346,20
98816091167,98816091166,-1,1193,1802,20
98816318523,98816318521,-2,759,1311,20
98821442186,98821442182,-4,1243,2358,20
98822669934,98822669930,-4,1058,2077,20
98822844169,98822844168,-1,1223,2355,20
98826518770,98826518791,21,1274,2027,20
98826820273,98826820273,0,2583,3497,20
98827792487,98827792486,-1,652,1532,20
98829728995,98829728993,-2,1080,1841,20
98831041875,98831041872,-3,1251,2077,20
98835452879,98835452877,-2,880,2231,20
98840039623,98840039621,-2,1055,2024,20
98842983467,98842983464,-3,779,1316,20
98848671019,98848671015,-4,1089,2261,20
98853430846,98853430842,-4,1230,3539,20
98853514055,98853514042,-13,891,2210,20
98854711685,98854711677,-8,939,3555,20
98854821247,98854821266,19,734,2862,20
98861129008,98861129007,-1,1119,2261,20
98864150886,98864150882,-4,885,2293,20
98865856546,98865856545,-1,1047,1785,20
98872866626,98872866625,-1,692,1404,20
98882400410,98882400406,-4,1008,2399,20
98885885423,98885885430,7,3310,1390,20
98886563297,98886563295,-2,1491,3030,20
98887018261,98887018240,-21,290,824,20
98887558096,98887558113,17,1285,2617,20
98890938698,98890938695,-3,1038,2140,20
98891719682,98891719679,-3,534,900,20
98894324423,98894324442,19,1065,2101,20
98895255867,98895255862,-5,1483,3890,20
98896403018,98896403013,-5,1769,6063,20
98897331208,98897331204,-4,1563,2783,20
98898440134,98898440130,-4,1142,2310,20
98899098374,98899098378,4,2125,2056,20
98900693027,98900693025,-2,979,1984,20
98903308930,98903308929,-1,853,1574,20
98903660837,98903660856,19,1052,1903,20
98911625842,98911625845,3,1493,1621,20
98914794814,98914794811,-3,1155,1920,20
98915475715,98915475712,-3,1138,2112,20
98916233130,98916233126,-4,1288,2804,20
98916396638,98916396619,-19,833,1318,20
98916674636,98916674633,-3,1011,2652,20
98918943851,98918943849,-2,1486,2834,20
98922841338,98922841342,4,1718,1069,20
98924398678,98924398674,-4,1043,2608,20
98925732446,98925732442,-4,1431,2503,20
98928021038,98928021035,-3,1176,2663,20
98931349347,98931349344,-3,1013,2430,20
98932566571,98932566568,-3,816,1963,20
98934520523,98934520520,-3,1169,2300,20
98938069910,98938069906,-4,1084,2086,20
98943418067,98943418063,-4,864,2104,20
98944556795,98944556794,-1,971,2188,20
98948634196,98948634194,-2,1286,2012,20
98949108431,98949108427,-4,1416,3122,20
98950939436,98950939433,-3,1114,1840,20
98957442010,98957442009,-1,1186,1744,20
98964017565,98964017562,-3,1476,2725,20
98964821495,98964821491,-4,699,2619,20
98966200038,98966200033,-5,1032,3351,20
98967071407,98967071394,-13,768,2294,20
98970725296,98970725293,-3,1263,2129,20
98974455741,98974455737,-4,1123,3082,20
98975843291,98975843288,-3,1202,3131,20
98976407593,98976407589,-4,1128,2213,20
98983125601,98983125609,8,4678,1724,20
98985506574,98985506571,-3,1208,2840,20
98985796086,98985796077,-9,1083,2332,20
98988637043,98988637039,-4,1101,2259,20
98988680985,98988680992,7,2562,1466,20
98991690222,98991690220,-2,21269,25245,20
98993626166,98993626162,-4,858,3107,20
99000801691,99000801690,-1,526,891,20
99007124898,99007124897,-1,1473,1841,20
99017100321,99017100322,1,3455,3179,20
99017642953,99017642971,18,1302,2315,20
99020089146,99020089142,-4,1200,3158,20
99020812595,99020812591,-4,1205,1984,20
99020838904,99020838905,1,1964,1484,20
99021905446,99021905443,-3,1120,2622,20
99023536265,99023536263,-2,1049,2229,20
99024912666,99024912664,-2,1225,2232,20
99025607539,99025607533,-6,1372,1483,20
99028492849,99028492846,-3,953,2656,20
99029758721,99029758727,6,2589,950,20
99034283237,99034283234,-3,1073,2574,20
99040097278,99040097274,-4,1091,2670,20
99041234405,99041234402,-3,1170,1889,20
99047787232,99047787230,-2,1343,1803,20
99047998303,99047998308,5,836,1787,20
99050873068,99050873063,-5,992,1302,20
99053583174,99053583187,13,109942,104502,20
99055305263,99055305258,-5,1482,3463,20
99057104795,99057104794,-1,1273,2510,20
99058108291,99058108288,-3,958,2348,20
99062361293,99062361289,-4,933,2529,20
99065643638,99065643634,-4,1287,2140,20
99068926092,99068926088,-4,1133,2212,20
99076514824,99076514821,-3,1019,2070,20
99077956695,99077956689,-6,1368,2499,20
99078282633,99078282633,0,1339,2122,20
99080004350,99080004347,-3,1471,2983,20
99086671922,99086671922,0,947,1188,20
99091336246,99091336225,-21,2523,1011,20
99093109462,99093109458,-4,1081,2207,20
99099198604,99099198605,1,1606,1626,20
99100054133,99100054129,-4,1939,2510,20
99100157090,99100157088,-2,1037,2537,20
99101397198,99101397194,-4,1071,2359,20
99110223143,99110223137,-6,1028,2250,20
99113163122,99113163119,-3,843,1751,20
99116224707,99116224706,-1,953,2221,20
99118692377,99118692374,-3,879,2398,20
99124122958,99124122956,-2,1027,2751,20
99124881390,99124881387,-3,1233,2728,20
99125635883,99125635883,0,1686,1617,20
99128529771,99128529767,-4,855,2310,20
99128842036,99128842034,-2,1679,2336,20
99131686996,99131686994,-2,1381,2679,20
99132727285,99132727291,6,4621,1777,20
99132883338,99132883333,-5,546,1342,20
99135111628,99135111623,-5,998,2625,20
99137408422,99137408422,0,1560,2063,20
99141734973,99141734979,6,2099,879,20
99143679351,99143679350,-1,1034,2150,20
99147331331,99147331327,-4,1776,2829,20
99147624847,99147624845,-2,1533,2530,20
99148426886,99148426882,-4,1173,2191,20
99150154938,99150154935,-3,1084,2612,20
99155710261,99155710257,-4,1531,3076,20
99156371609,99156371605,-4,1330,3467,20
99159838590,99159838589,-1,1408,2672,20
99161296818,99161296815,-3,1439,2660,20
99162063422,99162063418,-4,807,2714,20
99167519207,99167519204,-3,1034,2185,20
99169169509,99169169505,-4,1144,2784,20
99171217486,99171217484,-2,1437,2763,20
99172017180,99172017177,-3,1093,1779,20
99173037942,99173037940,-2,995,2893,20
99176420366,99176420365,-1,1034,1968,20
99178895924,99178895925,1,2166,2336,20
99178949806,99178949803,-3,1217,2939,20
99185907767,99185907767,0,1234,1258,20
99186525985,99186525983,-2,827,2099,20
99186953492,99186953514,22,680,967,20
99196799915,99196799912,-3,1185,1964,20
99198195572,99198195569,-3,1088,2459,20
99200058783,99200058778,-5,977,2571,20
99200989582,99200989578,-4,1143,1644,20
99203285686,99203285687,1,1032,1612,20
99204094077,99204094070,-7,857,3256,20
99205943078,99205943075,-3,947,1590,20
99207282554,99207282550,-4,1361,2842,20
99207496586,99207496585,-1,1073,1953,20
99210554497,99210554491,-6,1382,4754,20
99211165741,99211165739,-2,747,2157,20
99216983030,99216983028,-2,1563,2089,20
99218331309,99218331305,-4,880,1669,20
99218953754,99218953750,-4,1042,2325,20
99222261273,99222261271,-2,1759,2362,20
99223678211,99223678209,-2,862,2126,20
99224843327,99224843324,-3,1130,3199,20
99228439682,99228439688,6,3034,972,20
99233632749,99233632749,0,1354,1704,20
99233746934,99233746946,12,15605,30099,20
99238551629,99238551626,-3,1088,2102,20
99239953339,99239953333,-6,1954,6897,20
99240696411,99240696406,-5,700,1836,20
99244264871,99244264868,-3,909,2821,20
99245977811,99245977813,2,2169,2315,20
99252023042,99252023040,-2,1147,2138,20
99255767939,99255767934,-5,1035,1836,20
99256698071,99256698069,-2,1576,2823,20
99258734266,99258734265,-1,1061,2493,20
99262205701,99262205698,-3,1086,2224,20
99262629139,99262629140,1,1302,1550,20
99264836728,99264836724,-4,1204,2481,20
99265406464,99265406440,-24,73,783,20
99273643831,99273643830,-1,1335,2207,20
99282373226,99282373219,-7,1673,5520,20
99282940710,99282940708,-2,1043,1438,20
99292587313,99292587309,-4,1416,3508,20
99297358307,99297358305,-2,879,1900,20
99301611387,99301611393,6,4803,2639,20
99304174815,99304174811,-4,1060,2279,20
99305074790,99305074785,-5,2695,8088,20
99305580358,99305580354,-4,989,2432,20
99328912299,99328912297,-2,816,1871,20
99329114601,99329114603,2,1407,952,20
99329577874,99329577869,-5,1029,1640,20
99343422633,99343422630,-3,642,2070,20
99348517536,99348517559,23,660,2239,20
99349041350,99349041346,-4,816,2779,20
99349162862,99349162869,7,228,554,20
99355763486,99355763481,-5,844,1904,20
99358592556,99358592564,8,2268,1144,20
99359495422,99359495419,-3,1251,2334,20
99361033787,99361033785,-2,1201,2464,20
99361285591,99361285589,-2,858,2133,20
99363311445,99363311443,-2,1334,2425,20
99363710958,99363710965,7,9763,36110,20
99363942933,99363942930,-3,976,1584,20
99364970300,99364970294,-6,118,756,20
99365803551,99365803549,-2,1316,2300,20
99365989835,99365989833,-2,1220,2128,20
99367807635,99367807632,-3,1526,2381,20
99368206638,99368206635,-3,1269,1806,20
99369678395,99369678393,-2,1333,2384,20
99370671423,99370671421,-2,1250,2367,20
99371410338,99371410338,0,2333,3489,20
99372384908,99372384905,-3,1555,2618,20
99372611590,99372611587,-3,251,1019,20
99374469742,99374469737,-5,1112,2258,20
99376488378,99376488383,5,2153,1186,20
99381533029,99381533031,2,1547,1643,20
99383474055,99383474052,-3,1066,2204,20
99389743239,99389743240,1,8614,10015,20
99399522551,99399522549,-2,1744,3057,20
99400972098,99400972094,-4,1136,2176,20
99403040689,99403040683,-6,1118,3386,20
99406879704,99406879698,-6,1247,3301,20
99408936722,99408936718,-4,1257,2866,20
99410497125,99410497125,0,262,1603,20
99411424520,99411424525,5,2164,1143,20
99413817186,99413817182,-4,842,2125,20
99416109058,99416109055,-3,1297,2763,20
99418382258,99418382255,-3,1129,3733,20
99418585926,99418585922,-4,1085,3174,20
99420437967,99420437965,-2,846,2433,20
99421604098,99421604097,-1,692,1168,20
99422337670,99422337665,-5,1192,2909,20
99424595514,99424595510,-4,621,2983,20
99425163010,99425163006,-4,1170,1569,20
99429727878,99429727876,-2,1629,3927,20
99429921745,99429921742,-3,1395,2143,20
99432630922,99432630923,1,1865,1933,20
99433845066,99433845061,-5,1136,3537,20
99440318330,99440318329,-1,1040,1955,20
99441167629,99441167624,-5,1032,1685,20
99444884249,99444884248,-1,1159,1933,20
99456826042,99456826038,-4,948,2268,20
99457247180,99457247175,-5,786,1826,20
99458932357,99458932357,0,909,1569,20
99460779834,99460779830,-4,1007,1685,20
99464148874,99464148873,-1,970,1861,20
99464544510,99464544530,20,630,1992,20
99466507580,99466507578,-2,142,1042,20
99467315111,99467315127,16,1078,2427,20
99475575043,99475575041,-2,1189,2387,20
99475723095,99475723095,0,1008,2648,20
99477493644,99477493652,8,11785,38920,20
99477703053,99477703052,-1,985,2151,20
99480831895,99480831894,-1,1529,2337,20
99481101691,99481101689,-2,978,2804,20
99488594744,99488594741,-3,3806,6884,20
99494340169,99494340167,-2,1207,2262,20
99495729613,99495729610,-3,884,2332,20
99496152163,99496152161,-2,1142,2212,20
99496337094,99496337091,-3,852,1617,20
99496775525,99496775522,-3,1277,2439,20
99496807466,99496807465,-1,1103,2913,20
99499851357,99499851361,4,4385,2991,20
99501778103,99501778098,-5,1262,4516,20
99503369362,99503369358,-4,1465,2584,20
99505697226,99505697226,0,1578,1677,20
99518672206,99518672208,2,1148,1131,20
99519702247,99519702242,-5,1692,2589,20
99522275776,99522275771,-5,1133,1269,20
99524480789,99524480782,-7,1185,2180,20
99525167764,99525167761,-3,1522,3128,20
99526594401,99526594396,-5,1210,2585,20
99527584015,99527584013,-2,1153,2398,20
99536144517,99536144519,2,1438,1307,20
99536478156,99536478152,-4,1733,2373,20
99536769471,99536769470,-1,1148,2073,20
99537287010,99537287006,-4,793,1871,20
99540528965,99540528962,-3,1515,1916,20
99540712727,99540712723,-4,1078,2596,20
99540833470,99540833491,21,662,2292,20
99541660399,99541660394,-5,775,1791,20
99553020028,99553020022,-6,793,2404,20
99553883881,99553883878,-3,1339,1925,20
99554053231,99554053231,0,1210,1325,20
99554568043,99554568041,-2,864,2601,20
99554710004,99554710006,2,1296,904,20
99555581917,99555581914,-3,1269,2631,20
99556596812,99556596810,-2,1366,1812,20
99556985526,99556985528,2,813,1883,20
99568819794,99568819790,-4,1255,2279,20
99569380479,99569380472,-7,1458,3012,20
99571537974,99571537974,0,1712,2334,20
99573945130,99573945125,-5,636,2009,20
99574629182,99574629179,-3,925,1789,20
99576059570,99576059569,-1,995,2043,20
99582451766,99582451763,-3,1356,2812,20
99597667042,99597667041,-1,1040,2101,20
99599108460,99599108455,-5,1374,1500,20
99600004866,99600004863,-3,1050,2275,20
99600974043,99600974039,-4,1398,2584,20
99601192099,99601192097,-2,938,1809,20
99602097507,99602097505,-2,1372,2414,20
99602526430,99602526425,-5,990,2579,20
99603097417,99603097414,-3,742,2042,20
99606071290,99606071289,-1,1520,2134,20
99606717796,99606717790,-6,830,2997,20
99607518649,99607518646,-3,1368,2530,20
99616253629,99616253627,-2,1443,1811,20
99617303109,99617303105,-4,1248,2481,20
99619994589,99619994587,-2,1404,3049,20
99627096218,99627096215,-3,638,1493,20
99627318287,99627318275,-12,186,386,20
99629811682,99629811679,-3,1180,2135,20
99638309593,99638309586,-7,1680,6946,20
99639380981,99639380978,-3,1240,1965,20
99640092294,99640092292,-2,1416,1940,20
99641867021,99641867018,-3,1413,2687,20
99643156207,99643156224,17,938,2003,20
99657819081,99657819079,-2,2892,6235,20
99661251394,99661251391,-3,789,1720,20
99663668070,99663668070,0,1931,2663,20
99669174493,99669174490,-3,1568,2559,20
99670782519,99670782517,-2,1580,3285,20
99671228146,99671228142,-4,1309,2437,20
99672105871,99672105867,-4,1117,2084,20
99673155067,99673155065,-2,1481,2904,20
99674856110,99674856105,-5,1257,2246,20
99677872607,99677872605,-2,933,3001,20
99685031461,99685031458,-3,1032,2103,20
99690011447,99690011444,-3,1331,2319,20
99694726980,99694726977,-3,952,3037,20
99703597478,99703597474,-4,1444,2877,20
99711987176,99711987173,-3,1444,2037,20
99712352429,99712352423,-6,1189,2430,20
99713213347,99713213366,19,867,2469,20
99713707017,99713707014,-3,1356,2395,20
99715370854,99715370850,-4,1093,2760,20
99716269562,99716269558,-4,1288,2211,20
99716782751,99716782743,-8,1199,2179,20
99723469071,99723469069,-2,1536,2522,20
99723849829,99723849825,-4,1465,2755,20
99728995610,99728995618,8,9124,3351,20
99729202618,99729202626,8,9295,41606,20
99732314634,99732314629,-5,920,2286,20
99742024539,99742024535,-4,1138,2600,20
99743379169,99743379173,4,2016,1411,20
99747697163,99747697164,1,1931,2124,20
99748095804,99748095799,-5,955,2395,20
99751783860,99751783844,-16,961,1811,20
99756915359,99756915362,3,1979,1248,20
99760205199,99760205192,-7,32396,19212,20
99760565906,99760565902,-4,1125,2233,20
99765001510,99765001523,13,13541,29324,20
99766894478,99766894483,5,1815,1081,20
99768651130,99768651127,-3,1486,2164,20
99772636061,99772636058,-3,1035,2679,20
99775237490,99775237499,9,17215,20095,20
99776283582,99776283578,-4,886,2123,20
99779556644,99779556637,-7,1232,2025,20
99786173404,99786173398,-6,1055,2364,20
99788467023,99788467021,-2,990,2702,20
99791475823,99791475820,-3,1479,2088,20
99792499689,99792499686,-3,893,2881,20
99793274860,99793274882,22,604,2146,20
99794050749,99794050745,-4,1123,2225,20
99797174766,99797174764,-2,1096,1640,20
99797375960,99797375975,15,1109,2867,20
99798206881,99798206878,-3,851,2984,20
99813821153,99813821150,-3,936,1754,20
99816904751,99816904746,-5,1761,2856,20
99823110406,99823110403,-3,1044,3109,20
99828420446,99828420442,-4,923,2083,20
99830482189,99830482188,-1,1175,2281,20
99837790435,99837790439,4,2132,1797,20
99847786879,99847786878,-1,1338,2531,20
99850229922,99850229919,-3,1248,1961,20
99854375022,99854375022,0,1074,1528,20
99855195894,99855195891,-3,1838,2747,20
99860700010,99860700008,-2,1469,2790,20
99861829999,99861829998,-1,724,1730,20
99863220262,99863220258,-4,1088,2520,20
99863828782,99863828778,-4,1161,2434,20
99866557195,99866557199,4,1721,1101,20
99871259933,99871259933,0,1090,560,20
99873458752,99873458746,-6,41858,15702,20
99874489807,99874489803,-4,701,2083,20
99876879830,99876879829,-1,1400,3125,20
99878199141,99878199141,0,1012,2009,20
99878320131,99878320127,-4,797,1648,20
99881563354,99881563360,6,10285,30751,20
99886547217,99886547213,-4,1076,2533,20
99889189195,99889189192,-3,905,2919,20
99889392064,99889392083,19,280,839,20
99890979159,99890979156,-3,1113,2274,20
99893033774,99893033772,-2,1072,2391,20
99895936302,99895936298,-4,951,1972,20
99896804479,99896804475,-4,992,2908,20
99897872789,99897872808,19,540,1037,20
99898980274,99898980277,3,2484,2802,20
99899497733,99899497732,-1,1467,2164,20
99902568562,99902568558,-4,1286,2299,20
99903086116,99903086107,-9,877,2150,20
99905243979,99905243963,-16,32644,14808,20
99908210686,99908210682,-4,901,1963,20
99919744173,99919744181,8,4161,1822,20
99921653458,99921653455,-3,1263,2203,20
99923620347,99923620345,-2,619,1621,20
99926336117,99926336115,-2,1568,2190,20
99928802583,99928802581,-2,921,2557,20
99932782410,99932782409,-1,1446,2591,20
99935379226,99935379226,0,1124,1804,20
99937610366,99937610371,5,2414,1677,20
99939898103,99939898100,-3,1661,3498,20
99943944167,99943944163,-4,1123,3216,20
99953254786,99953254786,0,998,1821,20
99953972750,99953972749,-1,1031,1749,20
99956176270,99956176262,-8,1275,4647,20
99959268010,99959268008,-2,912,3090,20
99965540051,99965540047,-4,1208,2585,20
99965914417,99965914416,-1,870,1554,20
99968133859,99968133857,-2,1148,3628,20
99970404060,99970404058,-2,1352,2116,20
99972310710,99972310706,-4,1120,2037,20
99974589850,99974589849,-1,1001,1517,20
99980843147,99980843144,-3,586,1366,20
99984725215,99984725210,-5,1076,3116,20
99988722637,99988722634,-3,1193,1840,20
99991047270,99991047269,-1,1480,2814,20
99992347286,99992347282,-4,1074,2917,20
99997996825,99997996824,-1,1097,2085,20
99998091684,99998091681,-3,973,2229,20
99998482631,99998482625,-6,873,3444,20
100002279661,100002279657,-4,1229,2856,20
100006347891,100006347889,-2,1702,3590,20
100008573327,100008573325,-2,920,2170,20
100010775505,100010775502,-3,1132,2758,20
100011206224,100011206221,-3,883,2177,20
100018867215,100018867213,-2,1326,2860,20
100020565482,100020565478,-4,1414,2842,20
100022814791,100022814788,-3,1351,1814,20
100027628421,100027628421,0,1578,1741,20
100029633327,100029633323,-4,1057,2348,20
100030828951,100030828948,-3,984,1467,20
100031955594,100031955591,-3,1677,3722,20
100033363857,100033363854,-3,868,2076,20
100036027870,100036027876,6,4968,2278,20
100036078206,100036078203,-3,1537,2410,20
100040486094,100040486090,-4,915,2219,20
100040536781,100040536777,-4,1332,2443,20
100045373443,100045373441,-2,1195,3026,20
100050776318,100050776314,-4,761,1964,20
100052598656,100052598653,-3,1423,2640,20
100053136902,100053136884,-18,823,1908,20
100058038489,100058038486,-3,1113,2068,20
100060423856,100060423853,-3,988,12988,20
100063041187,100063041186,-1,978,1681,20
100064811134,100064811133,-1,1290,3310,20
100065041483,100065041479,-4,1051,2326,20
100066403530,100066403527,-3,785,2217,20
100071258886,100071258884,-2,1226,1874,20
100071589671,100071589670,-1,1106,2290,20
100073591238,100073591238,0,953,1353,20
100076009027,100076009024,-3,1056,2639,20
100077261366,100077261362,-4,1016,1892,20
100078106811,100078106817,6,5533,2668,20
100083357152,100083357152,0,1315,2239,20
100087224274,100087224272,-2,1388,1946,20
100088719432,100088719427,-5,1144,3269,20
100090606251,100090606250,-1,1100,2691,20
100092345890,100092345893,3,1681,1616,20
100097471435,100097471431,-4,945,2707,20
100097969935,100097969914,-21,164,1737,20
100099804846,100099804843,-3,862,1820,20
100100096517,100100096535,18,207,1222,20
100100955091,100100955097,6,3429,1196,20
100103790006,100103790004,-2,1110,2292,20
100106459120,100106459118,-2,1503,2175,20
100108181206,100108181201,-5,1213,2112,20
100116141547,100116141545,-2,1062,2453,20
100121873476,100121873475,-1,979,2008,20
100122267822,100122267832,10,158,1552,20
100126429456,100126429450,-6,2142,9954,20
100129021294,100129021293,-1,853,1481,20
100133051690,100133051686,-4,905,2128,20
100135096139,100135096137,-2,1086,2291,20
100141281243,100141281241,-2,788,1535,20
100143870570,100143870566,-4,876,1993,20
100149308240,100149308237,-3,1180,2226,20
100150366987,100150366984,-3,749,1830,20
100154762141,100154762138,-3,1260,2515,20
100155434410,100155434407,-3,1212,2622,20
100158950674,100158950673,-1,805,1863,20
100160791859,100160791861,2,1425,2057,20
100163330197,100163330194,-3,1293,2872,20
100167108211,100167108213,2,33933,32762,20
100171248564,100171248564,0,1141,1797,20
100173625930,100173625926,-4,1243,2800,20
100180494459,100180494457,-2,1396,2092,20
100186937715,100186937713,-2,1328,3438,20
100190671990,100190671996,6,3078,1339,20
100192190497,100192190493,-4,1170,2648,20
100194861926,100194861923,-3,1325,2660,20
100197906006,100197906003,-3,855,2453,20
100203147462,100203147458,-4,996,3507,20
100204363613,100204363610,-3,1228,2240,20
100205876675,100205876672,-3,1020,2584,20
100210573927,100210573923,-4,1160,2528,20
100214216680,100214216676,-4,1242,2454,20
100214911924,100214911930,6,4315,1479,20
100225987853,100225987850,-3,701,1784,20
100228343802,100228343800,-2,856,2185,20
100230501400,100230501397,-3,984,2190,20
100238140790,100238140789,-1,764,2440,20
100240477391,100240477387,-4,748,2289,20
100242101343,100242101344,1,1626,2447,20
100245584195,100245584203,8,4029,1601,20
100249574562,100249574569,7,16845,23092,20
100251297853,100251297854,1,826,1875,20
100253055178,100253055179,1,1134,1176,20
100258478843,100258478836,-7,1087,2337,20
100264727534,100264727534,0,1692,2714,20
100265094171,100265094171,0,1367,2698,20
100265413855,100265413849,-6,3659,12171,20
100269277846,100269277851,5,2235,1311,20
100270273279,100270273275,-4,1385,2501,20
100270756946,100270756942,-4,987,1946,20
100271527509,100271527510,1,121,816,20
100274322354,100274322351,-3,1316,2083,20
100278188555,100278188551,-4,1270,3242,20
100281128906,100281128906,0,1083,2777,20
100281765870,100281765866,-4,44262,19311,20
100282496087,100282496085,-2,1122,2420,20
100287437326,100287437322,-4,1169,2643,20
100291449545,100291449542,-3,1088,2211,20
100292006239,100292006239,0,1123,1597,20
100297824171,100297824167,-4,1280,2223,20
100297948355,100297948351,-4,921,2869,20
100304302034,100304302030,-4,1082,1697,20
100306104519,100306104514,-5,1172,2714,20
100306858740,100306858737,-3,973,2206,20
100311067410,100311067406,-4,1458,2892,20
100311574414,100311574409,-5,772,2713,20
100312664150,100312664147,-3,855,2378,20
100316542514,100316542510,-4,1209,1982,20
100324647154,100324647150,-4,922,1383,20
100325783415,100325783413,-2,1309,2260,20
100328017037,100328017034,-3,464,2425,20
100328665060,100328665057,-3,1102,2268,20
100330119379,100330119379,0,787,2037,20
100333749919,100333749917,-2,779,1883,20
100343577935,100343577932,-3,971,2108,20
100347146741,100347146745,4,1097,1230,20
100352013800,100352013794,-6,1372,2094,20
100352714157,100352714157,0,1442,2076,20
100358382231,100358382229,-2,1618,3384,20
100361548339,100361548343,4,1854,1438,20
100362350536,100362350538,2,1817,1739,20
100362430198,100362430197,-1,1172,1983,20
100362918393,100362918389,-4,1088,2525,20
100366223096,100366223095,-1,1361,1964,20
100368069670,100368069666,-4,1141,2043,20
100368303659,100368303657,-2,1450,2348,20
100369397660,100369397655,-5,1385,2475,20
100383852990,100383852988,-2,1283,2831,20
100390551446,100390551442,-4,1028,2132,20
100393081470,100393081469,-1,1098,1939,20
100393826623,100393826622,-1,1542,2226,20
100394911541,100394911545,4,21931,20191,20
100399106086,100399106083,-3,847,2047,20
100406719606,100406719602,-4,1535,3572,20
100410120406,100410120403,-3,1227,2708,20
100410636723,100410636718,-5,1386,2992,20
100413641746,100413641745,-1,767,1517,20
100414563703,100414563700,-3,954,1898,20
100415896143,100415896139,-4,895,2819,20
100424527735,100424527731,-4,1110,2392,20
100426806529,100426806529,0,1261,2046,20
100429721407,100429721404,-3,561,2235,20
100442951996,100442951992,-4,1144,2386,20
100443631272,100443631261,-11,290,1236,20
100445226106,100445226102,-4,1154,3714,20
100448728549,100448728545,-4,1247,2018,20
100453800542,100453800542,0,1016,1799,20
100458188731,100458188730,-1,987,2244,20
100460103689,100460103691,2,1445,1360,20
100461120881,100461120890,9,14116,18418,20
100461430464,100461430463,-1,1090,1967,20
100465081493,100465081491,-2,737,2688,20
100465332176,100465332153,-23,1,979,20
100468446359,100468446359,0,1493,1283,20
100468479127,100468479125,-2,828,1752,20
100468595451,100468595452,1,1744,1359,20
100469407750,100469407749,-1,985,2148,20
100475555257,100475555254,-3,1538,3142,20
100475771313,100475771311,-2,1719,3026,20
100478657676,100478657674,-2,1314,2875,20
100480247303,100480247300,-3,1088,2388,20
100486042514,100486042510,-4,1145,2033,20
100487044488,100487044486,-2,1574,2029,20
100488187978,100488187975,-3,1211,3231,20
100491081708,100491081704,-4,1574,3029,20
100492282551,100492282547,-4,1320,1517,20
100493671577,100493671573,-4,1780,2598,20
100493731130,100493731128,-2,984,3046,20
100497226001,100497225997,-4,900,2185,20
100499555577,100499555583,6,3473,1618,20
100504615494,100504615493,-1,1109,2213,20
100504805844,100504805842,-2,1118,2371,20
100507122863,100507122860,-3,1065,1825,20
100509710191,100509710192,1,1393,1893,20
100511091562,100511091557,-5,1139,2830,20
100511894945,100511894942,-3,1378,2511,20
100513269442,100513269438,-4,1321,2915,20
100514561618,100514561616,-2,1119,2537,20
100515030166,100515030174,8,3082,1575,20
100519993727,100519993725,-2,1195,3059,20
100522010915,100522010923,8,2307,916,20
100525070635,100525070633,-2,1193,1621,20
100525251605,100525251603,-2,2652,4127,20
100525282362,100525282357,-5,1084,3279,20
100527519538,100527519537,-1,529,1737,20
100536160131,100536160130,-1,998,1713,20
100537076045,100537076042,-3,1089,1798,20
100538706318,100538706315,-3,893,2467,20
100539210110,100539210108,-2,719,2364,20
100541112291,100541112287,-4,1023,2603,20
100544753238,100544753237,-1,906,2513,20
100547686738,100547686743,5,2403,1305,20
100551814962,100551814962,0,3229,4836,20
100558141199,100558141197,-2,676,2126,20
100559246393,100559246393,0,20959,24586,20
100561463734,100561463732,-2,451,1497,20
100563930118,100563930117,-1,1226,2621,20
100565028902,100565028901,-1,1708,2594,20
100566904694,100566904694,0,901,1522,20
100573737806,100573737803,-3,1254,2637,20
100574199765,100574199762,-3,1312,2166,20
100574352478,100574352498,20,954,2613,20
100577661519,100577661519,0,1001,1928,20
100578354045,100578354041,-4,1143,2721,20
100579135902,100579135899,-3,1013,1962,20
100582302926,100582302923,-3,780,1306,20
100586438138,100586438134,-4,980,2107,20
100593979026,100593979022,-4,1036,1618,20
100600294437,100600294437,0,1940,3428,20
100605179424,100605179421,-3,1279,2207,20
100606801044,100606801034,-10,911,2168,20
100609240039,100609240036,-3,714,1854,20
100610010413,100610010392,-21,947,1775,20
100611310543,100611310542,-1,837,2047,20
100612107550,100612107533,-17,1283,2931,20
100612460710,100612460729,19,843,1870,20
100612855360,100612855377,17,1166,3084,20
100614093470,100614093468,-2,887,2475,20
100615125021,100615125017,-4,1287,2808,20
100616590750,100616590753,3,1882,1635,20
100617145781,100617145779,-2,1203,2162,20
100618834702,100618834703,1,1324,1845,20
100620406211,100620406208,-3,1086,2707,20
100624799411,100624799410,-1,900,1204,20
100627859242,100627859243,1,932,2300,20
100628013179,100628013176,-3,1082,1998,20
100634049186,100634049178,-8,708,1095,20
100636307088,100636307086,-2,888,1552,20
100641603569,100641603570,1,4675,15541,20
100647795366,100647795370,4,4751,3250,20
100648777930,100648777934,4,2850,2328,20
100649297090,100649297088,-2,1513,2560,20
100650821999,100650822006,7,4368,2164,20
100654317513,100654317510,-3,471,2016,20
100656939877,100656939875,-2,1168,2201,20
100662229322,100662229320,-2,1204,2726,20
100663951666,100663951663,-3,1015,3039,20
100666756327,100666756330,3,1136,1499,20
100667061683,100667061682,-1,1172,2470,20
100667530069,100667530065,-4,1176,2367,20
100669430023,100669430020,-3,1167,1829,20
100677957406,100677957403,-3,1100,2185,20
100678042248,100678042265,17,582,1840,20
100678529212,100678529206,-6,1182,2480,20
100679355029,100679355027,-2,1099,2527,20
100679912284,100679912302,18,952,1677,20
100681900949,100681900949,0,1267,2513,20
100683270071,100683270068,-3,1348,2522,20
100686824110,100686824109,-1,963,2262,20
100692279941,100692279942,1,1738,2450,20
100696090835,100696090832,-3,941,1720,20
100698855422,100698855419,-3,844,1453,20
100701495010,100701495009,-1,1213,2605,20
100702208359,100702208378,19,853,1791,20
100705122914,100705122911,-3,1287,2409,20
100705586754,100705586753,-1,1105,3417,20
100705637419,100705637416,-3,1330,2148,20
100707479746,100707479743,-3,1443,2172,20
100708708703,100708708700,-3,1642,2921,20
100710188251,100710188249,-2,1224,2369,20
100711639273,100711639269,-4,1035,1540,20
100716408913,100716408918,5,3221,1462,20
100717524607,100717524605,-2,1233,2104,20
100720033575,100720033573,-2,903,1732,20
100721355917,100721355913,-4,1369,2137,20
100725847763,100725847762,-1,1030,1426,20
100728484699,100728484697,-2,1435,2576,20
100729761094,100729761089,-5,906,2205,20
100730144715,100730144711,-4,1791,2708,20
100730252974,100730252973,-1,1218,2838,20
100730602018,100730602015,-3,810,2025,20
100734877750,100734877751,1,920,1688,20
100736301568,100736301565,-3,1264,1618,20
100738385125,100738385123,-2,999,2069,20
100738836924,100738836945,21,1029,2092,20
100740557732,100740557729,-3,1266,2442,20
100750869826,100750869822,-4,909,1676,20
100751649163,100751649157,-6,887,3064,20
100752293102,100752293120,18,901,1887,20
100754956318,100754956314,-4,541,2854,20
100756158146,100756158142,-4,716,1484,20
100757279821,100757279818,-3,1327,2818,20
100757868279,100757868298,19,181,590,20
100759625025,100759625023,-2,1264,2059,20
100765758422,100765758417,-5,1270,2825,20
100767284482,100767284478,-4,901,2239,20
100771661342,100771661338,-4,1046,2961,20
100773013766,100773013763,-3,1444,3123,20
100774884542,100774884538,-4,1181,1326,20
100777028838,100777028836,-2,923,2043,20
100784194671,100784194667,-4,1208,921,20
100787309923,100787309921,-2,939,1807,20
100790957642,100790957638,-4,815,1760,20
100797616598,100797616597,-1,959,2399,20
100798078383,100798078377,-6,1104,5255,20
100805413254,100805413253,-1,1195,2144,20
100808348285,100808348283,-2,1021,2397,20
100814972751,100814972746,-5,1501,2795,20
100815021530,100815021529,-1,996,1729,20
100818878538,100818878536,-2,1335,2062,20
100821831997,100821831993,-4,990,2007,20
100827923902,100827923906,4,2768,1903,20
100830800144,100830800142,-2,1189,1675,20
100835906639,100835906638,-1,1194,1820,20
100836166050,100836166045,-5,1299,2103,20
100841043401,100841043399,-2,759,1205,20
100843596767,100843596762,-5,1036,1804,20
100848844830,100848844829,-1,1027,1587,20
100849825256,100849825256,0,2103,2135,20
100856334289,100856334285,-4,1047,2922,20
100863433182,100863433180,-2,1120,1882,20
100866561959,100866561956,-3,1391,2106,20
100868415382,100868415379,-3,1133,2424,20
100868977753,100868977750,-3,1225,2280,20
100869356003,100869356002,-1,776,1678,20
100872502078,100872502079,1,1192,1175,20
100873572410,100873572407,-3,688,1542,20
100877624851,100877624870,19,2108,1402,20
100880637195,100880637192,-3,995,1952,20
100881629849,100881629846,-3,698,1638,20
100883687939,100883687937,-2,1265,1913,20
100891179973,100891179969,-4,626,2098,20
100895488423,100895488422,-1,1055,2092,20
100906435265,100906435262,-3,1326,3112,20
100907994944,100907994941,-3,1534,3043,20
100913348061,100913348058,-3,1328,2688,20
100918967323,100918967318,-5,1237,1834,20
100921613011,100921613009,-2,1205,2026,20
100922460527,100922460526,-1,1299,2731,20
100926013554,100926013549,-5,1086,2201,20
100930888844,100930888841,-3,1148,3139,20
100933917545,100933917527,-18,908,2973,20
100935029376,100935029373,-3,776,2031,20
100946269395,100946269394,-1,1152,2057,20
100951433282,100951433280,-2,1067,1581,20
100952719756,100952719753,-3,3984,8397,20
100953623807,100953623810,3,1564,1308,20
100954586824,100954586822,-2,1301,2328,20
100955472152,100955472157,5,3991,2892,20
100958624130,100958624127,-3,1077,2357,20
100968569541,100968569537,-4,1530,2437,20
100968772430,100968772426,-4,1115,1907,20
100975165623,100975165618,-5,1183,2758,20
100979984373,100979984372,-1,1241,2459,20
100981438501,100981438497,-4,988,1892,20
100987561695,100987561694,-1,1446,1108,20
100988451765,100988451763,-2,1575,2116,20
100997540161,100997540158,-3,1019,2167,20
101009086653,101009086649,-4,877,2738,20
101012578788,101012578793,5,1642,1306,20
101013719515,101013719513,-2,1350,2373,20
101017229574,101017229573,-1,922,1888,20
101017312234,101017312231,-3,1463,2973,20
101023545182,101023545179,-3,952,1575,20
101024476599,101024476598,-1,1215,1957,20
101032195435,101032195433,-2,787,2448,20
101035916313,101035916310,-3,1194,3002,20
101037028848,101037028833,-15,1793,1020,20
101037179070,101037179077,7,3740,1681,20
101038252482,101038252478,-4,980,2069,20
101040015471,101040015466,-5,1231,1933,20
101042054787,101042054783,-4,1133,2172,20
101042251179,101042251175,-4,951,3174,20
101045730250,101045730246,-4,1237,3165,20
101048842623,101048842621,-2,861,2868,20
101050315774,101050315772,-2,757,3115,20
101054282137,101054282133,-4,953,996,20
101054967293,101054967290,-3,1315,2730,20
101059934561,101059934558,-3,994,1852,20
101063036603,101063036601,-2,1343,2393,20
101067770353,101067770351,-2,1827,2671,20
101068060097,101068060098,1,1221,1119,20
101068354311,101068354308,-3,1333,2965,20
101073201426,101073201423,-3,833,1749,20
101077110717,101077110716,-1,1439,2158,20
101079976218,101079976212,-6,1732,9869,20
101080313719,101080313714,-5,1538,2994,20
101081315808,101081315806,-2,1126,1847,20
101083334850,101083334847,-3,1126,1923,20
101086188078,101086188078,0,1255,2312,20
101087010149,101087010147,-2,154,456,20
101091818074,101091818079,5,1548,1160,20
101093795674,101093795681,7,4697,3110,20
101099897014,101099897010,-4,723,1870,20
101100103971,101100103969,-2,1216,1949,20
101100135882,101100135879,-3,687,1108,20
101105801234,101105801231,-3,1109,2381,20
101107528074,101107528073,-1,1937,2434,20
101109496961,101109496958,-3,1226,2970,20
101115807405,101115807403,-2,1130,2531,20
101118834730,101118834729,-1,872,1977,20
101121437893,101121437889,-4,1149,2899,20
101122653474,101122653473,-1,1670,2146,20
101123080091,101123080086,-5,1034,3431,20
101123142299,101123142294,-5,1291,3267,20
101125892738,101125892737,-1,1130,1977,20
101133969149,101133969147,-2,1280,2560,20
101147384417,101147384417,0,2005,2217,20
101148167478,101148167477,-1,879,1415,20
101148917587,101148917584,-3,1071,2119,20
101156406426,101156406422,-4,1412,2163,20
101159536698,101159536694,-4,1115,2143,20
101159719357,101159719338,-19,424,929,20
101164248655,101164248654,-1,819,1901,20
101165959247,101165959243,-4,1258,2133,20
101167660051,101167660055,4,1518,796,20
101169017732,101169017734,2,172,1097,20
101172993957,101172993953,-4,1083,2682,20
101174620366,101174620362,-4,1071,2132,20
101182463706,101182463708,2,1416,1491,20
101190097643,101190097638,-5,1343,3407,20
101190590191,101190590201,10,432,2022,20
101194381506,101194381502,-4,1265,1935,20
101195960603,101195960602,-1,1183,2134,20
101196658297,101196658293,-4,829,2261,20
101201199650,101201199647,-3,1363,2180,20
101201373171,101201373169,-2,1375,2497,20
101201871405,101201871402,-3,1079,1528,20
101202162996,101202162993,-3,989,2050,20
101203109191,101203109190,-1,1212,2193,20
101206402688,101206402683,-5,1066,1813,20
101208834617,101208834613,-4,1291,4227,20
101209174464,101209174461,-3,1130,1907,20
101214848226,101214848223,-3,753,1386,20
101218848387,101218848382,-5,853,2548,20
101219254658,101219254657,-1,1565,2234,20
101220086627,101220086622,-5,1330,3638,20
101221841643,101221841640,-3,1179,2565,20
101222293619,101222293614,-5,1083,1689,20
101224521986,101224521985,-1,934,1948,20
101226198142,101226198140,-2,1461,3245,20
101226670942,101226670939,-3,1112,2566,20
101232693667,101232693668,1,1471,2244,20
101234092839,101234092839,0,1051,2011,20
101234377436,101234377433,-3,1532,2349,20
101236892597,101236892602,5,3599,2963,20
101237064171,101237064168,-3,1258,2593,20
101237804731,101237804730,-1,754,2229,20
101238841547,101238841553,6,6403,2273,20
101245417915,101245417912,-3,1471,1931,20
101245472580,101245472577,-3,1368,2577,20
101247521033,101247521033,0,1337,2092,20
101248790742,101248790742,0,1757,2089,20
101252014493,101252014490,-3,1197,2024,20
101252935974,101252935970,-4,1113,2906,20
101254947598,101254947595,-3,821,2377,20
101258477242,101258477241,-1,1223,2163,20
101261032250,101261032247,-3,1669,2378,20
101261791220,101261791219,-1,1633,2854,20
101261918475,101261918470,-5,1014,1937,20
101267029557,101267029559,2,921,1321,20
101269497323,101269497322,-1,1367,2072,20
101274221791,101274221788,-3,1197,1821,20
101274897351,101274897347,-4,1674,2798,20
101278666545,101278666542,-3,1504,2744,20
101280295938,101280295934,-4,1488,2377,20
101284053648,101284053642,-6,1725,7142,20
101287063297,101287063294,-3,1065,3082,20
101288309913,101288309908,-5,1113,2283,20
101288994426,101288994421,-5,1899,6032,20
101300859825,101300859834,9,217,1624,20
101303583499,101303583505,6,3545,1247,20
101307948047,101307948045,-2,1268,2655,20
101309315087,101309315084,-3,1187,2617,20
101309771714,101309771712,-2,1296,2009,20
101312173177,101312173172,-5,903,3271,20
101315326106,101315326104,-2,1213,2416,20
101316088831,101316088827,-4,1085,2580,20
101318531798,101318531803,5,14157,6774,20
101319555103,101319555101,-2,1269,3311,20
101329258498,101329258493,-5,1179,2304,20
101329313911,101329313907,-4,798,1764,20
101330990619,101330990614,-5,1565,2833,20
101332183570,101332183566,-4,1035,2073,20
101332344103,101332344082,-21,877,2576,20
101332494801,101332494799,-2,1418,2824,20
101334389511,101334389508,-3,923,2254,20
101335740291,101335740289,-2,1276,2646,20
101336093640,101336093659,19,223,578,20
101341239175,101341239172,-3,787,1708,20
101344444391,101344444393,2,1479,1367,20
101346187326,101346187322,-4,1021,2281,20
101349375594,101349375590,-4,1311,2982,20
101351648198,101351648193,-5,1446,3478,20
101351912930,101351912927,-3,1210,2016,20
101351950248,101351950265,17,1451,2297,20
101354786283,101354786281,-2,900,2079,20
101356083973,101356083974,1,1424,1226,20
101356625398,101356625396,-2,1213,2118,20
101357802306,101357802305,-1,1112,2346,20
101358394111,101358394109,-2,1079,1811,20
101365336603,101365336608,5,598,872,20
101366746714,101366746710,-4,854,2021,20
101371611966,101371611965,-1,1272,2851,20
101371762135,101371762134,-1,2006,3258,20
101375712634,101375712638,4,1545,1748,20
101377806519,101377806526,7,10327,3628,20
101379278971,101379278967,-4,1177,3306,20
101383742197,101383742194,-3,1286,2616,20
101392045067,101392045065,-2,1153,2371,20
101394975929,101394975925,-4,1213,3170,20
101395706701,101395706705,4,4942,2152,20
101397103241,101397103240,-1,1435,1303,20
101400108679,101400108679,0,2159,2367,20
101403795310,101403795316,6,5697,3007,20
101413554282,101413554284,2,945,1213,20
101415829003,101415829001,-2,1796,2433,20
101415910754,101415910750,-4,949,2806,20
101421990979,101421990974,-5,1138,2728,20
101426844478,101426844473,-5,1307,2507,20
101426905438,101426905435,-3,1134,2835,20
101429111909,101429111906,-3,1256,1888,20
101429316418,101429316414,-4,1247,2165,20
101429997578,101429997575,-3,1206,1922,20
101430936991,101430936989,-2,840,2588,20
101431802045,101431802042,-3,987,2243,20
101444020177,101444020173,-4,991,1659,20
101444494789,101444494785,-4,1241,1929,20
101445016301,101445016298,-3,1065,2925,20
101445875076,101445875072,-4,1267,2251,20
101446954587,101446954583,-4,1529,2968,20
101448558814,101448558812,-2,1748,2263,20
101451148523,101451148522,-1,1558,2310,20
101452980717,101452980712,-5,1341,2843,20
101457441963,101457441961,-2,875,1951,20
101460301739,101460301734,-5,1108,2387,20
101462993286,101462993283,-3,1300,2177,20
101467409352,101467409370,18,987,2654,20
101467787726,101467787726,0,839,2740,20
101476097900,101476097909,9,22067,22103,20
101478174163,101478174169,6,3539,2513,20
101481635255,101481635250,-5,1345,4494,20
101484219774,101484219770,-4,946,2402,20
101485208845,101485208842,-3,910,2093,20
101487608313,101487608319,6,7031,2490,20
101488715156,101488715154,-2,1484,3201,20
101488902213,101488902209,-4,1059,2085,20
101492295922,101492295925,3,1771,1158,20
101492511870,101492511869,-1,697,2062,20
101492652232,101492652229,-3,1159,2027,20
101493040309,101493040291,-18,740,1994,20
101493559103,101493559100,-3,1363,2893,20
101493826734,101493826732,-2,1359,1685,20
101494879409,101494879406,-3,1109,1668,20
101498874227,101498874224,-3,1353,2736,20
101498932023,101498932019,-4,1183,3140,20
101500625902,101500625906,4,2290,1228,20
101508991015,101508991014,-1,1164,1770,20
101510587522,101510587520,-2,1370,2056,20
101537993216,101537993212,-4,4451,10613,20
101541765950,101541765946,-4,1268,2886,20
101542152657,101542152649,-8,976,4606,20
101542293413,101542293393,-20,836,1431,20
101543736434,101543736430,-4,1144,2334,20
101544143589,101544143582,-7,852,2073,20
101545362167,101545362165,-2,979,2621,20
101549753938,101549753935,-3,1196,2241,20
101552838146,101552838143,-3,1329,3378,20
101556343641,101556343638,-3,969,2190,20
101556865339,101556865338,-1,1002,1647,20
101560888475,101560888472,-3,1102,3560,20
101566189870,101566189868,-2,1186,2670,20
101566434843,101566434840,-3,1165,3024,20
101569858547,101569858552,5,2285,1548,20
101572457839,101572457837,-2,797,2470,20
101572717349,101572717337,-12,689,1820,20
101573152636,101573152634,-2,918,2018,20
101575044694,101575044685,-9,1347,2684,20
101577195230,101577195231,1,1264,1097,20
101577503163,101577503158,-5,1082,2818,20
101581024734,101581024731,-3,968,2227,20
101594529492,101594529489,-3,968,2238,20
101596083100,101596083099,-1,1672,2109,20
101602631281,101602631277,-4,1234,3014,20
101609407697,101609407697,0,969,2411,20
101610103219,101610103217,-2,1174,2658,20
101612823396,101612823414,18,1027,2590,20
101618183013,101618183010,-3,1120,2821,20
101619817610,101619817606,-4,1003,2501,20
101622076930,101622076927,-3,1224,3724,20
101627154535,101627154533,-2,1101,2470,20
101632399958,101632399954,-4,917,1867,20
101635279355,101635279354,-1,1291,2646,20
101640767583,101640767577,-6,1072,2799,20
101642889390,101642889389,-1,610,1239,20
101652640899,101652640896,-3,1006,2754,20
101655198443,101655198439,-4,950,2671,20
101656716214,101656716214,0,9766,11929,20
101659199683,101659199681,-2,1164,2382,20
101667127406,101667127411,5,4822,3506,20
101667970434,101667970429,-5,958,2768,20
101668136606,101668136602,-4,1339,1810,20
101668959902,101668959897,-5,1280,2878,20
101676561034,101676561034,0,1008,1765,20
101681050329,101681050332,3,33203,27307,20
101681803613,101681803611,-2,1272,2719,20
101693934394,101693934391,-3,1503,3326,20
101696293284,101696293278,-6,1017,1722,20
101696916928,101696916913,-15,462,1686,20
101698513955,101698513950,-5,285,1132,20
101701599335,101701599332,-3,1204,2817,20
101704883271,101704883267,-4,1054,2319,20
101705181396,101705181403,7,6269,2452,20
101706567245,101706567241,-4,1089,1394,20
101707162050,101707162046,-4,1147,2164,20
101708531737,101708531742,5,3350,2583,20
101716162064,101716162062,-2,1380,2137,20
101721956887,101721956883,-4,979,2077,20
101722819463,101722819461,-2,1323,2811,20
101726074182,101726074179,-3,1726,2571,20
101726781242,101726781241,-1,1314,3629,20
101734544681,101734544677,-4,845,3048,20
101736809798,101736809793,-5,810,2065,20
101743270186,101743270183,-3,1553,2401,20
101746495848,101746495846,-2,1848,4044,20
101750126241,101750126249,8,7828,38650,20
101752015255,101752015253,-2,1484,2868,20
101756048647,101756048644,-3,1168,2136,20
101764917949,101764917945,-4,1418,3620,20
101769613261,101769613257,-4,1025,3349,20
101771141517,101771141514,-3,949,1536,20
101776802837,101776802834,-3,1449,2221,20
101788132273,101788132276,3,2271,1910,20
101792817047,101792817046,-1,1310,2337,20
101797888554,101797888553,-1,1428,2594,20
101798107656,101798107653,-3,1194,2045,20
101798345430,101798345434,4,3278,1927,20
101810514913,101810514910,-3,1318,1690,20
101811649466,101811649461,-5,765,2209,20
101814450425,101814450422,-3,1149,2587,20
101819761443,101819761442,-1,993,1866,20
101821202411,101821202407,-4,1073,2660,20
101822697241,101822697239,-2,1613,3568,20
101823081371,101823081370,-1,360,903,20
101824057633,101824057630,-3,839,1707,20
101825287206,101825287203,-3,648,1473,20
101826016555,101826016554,-1,1107,2159,20
101831470455,101831470451,-4,1018,1692,20
101832781450,101832781446,-4,819,1419,20
101833507516,101833507499,-17,189,1233,20
101833991519,101833991517,-2,905,2182,20
101837185925,101837185922,-3,1347,2184,20
101838721421,101838721417,-4,1379,4096,20
101841202636,101841202633,-3,969,2176,20
101847300603,101847300601,-2,1135,2286,20
101847589222,101847589200,-22,1762,1535,20
101850014202,101850014199,-3,1259,2331,20
101850273517,101850273535,18,594,1562,20
101855161871,101855161867,-4,971,1990,20
101857602243,101857602238,-5,607,1880,20
101862378711,101862378708,-3,1529,3177,20
101864989810,101864989806,-4,870,3039,20
101865748711,101865748709,-2,1030,2269,20
101865913999,101865913995,-4,131,1223,20
101872112982,101872112979,-3,840,1450,20
101875266690,101875266689,-1,978,1385,20
101876294793,101876294790,-3,956,1684,20
101878971489,101878971485,-4,962,2936,20
101879362918,101879362926,8,2948,1117,20
101880586931,101880586928,-3,1099,1948,20
101881852434,101881852433,-1,1020,1807,20
101881955759,101881955755,-4,1617,2580,20
101883060625,101883060621,-4,877,1074,20
101895899414,101895899411,-3,1385,2533,20
101900665845,101900665841,-4,1490,2559,20
101902064748,101902064746,-2,1618,2835,20
101911455925,101911455927,2,7396,6397,20
101911504096,101911504111,15,889,2673,20
101920099239,101920099237,-2,1094,2603,20
101921241666,101921241665,-1,937,1678,20
101922867334,101922867329,-5,944,1161,20
101923286158,101923286179,21,481,1527,20
101927512442,101927512440,-2,1203,2291,20
101929330971,101929330968,-3,901,1800,20
101934193135,101934193134,-1,1225,2103,20
101934689957,101934689971,14,332,910,20
101935143610,101935143609,-1,730,1451,20
101936407766,101936407768,2,2022,1470,20
101943596507,101943596502,-5,763,2062,20
101947503253,101947503249,-4,1083,3106,20
101948752105,101948752102,-3,1489,3518,20
101950984544,101950984540,-4,1329,3216,20
101954204838,101954204834,-4,1276,1451,20
101954733053,101954733049,-4,1135,1637,20
101960143978,101960143999,21,1124,1783,20
101960564840,101960564858,18,1138,2370,20
101961897958,101961897957,-1,1200,2547,20
101962539612,101962539605,-7,1169,2928,20
101966278726,101966278728,2,1510,1673,20
101966884327,101966884325,-2,961,1870,20
101972344491,101972344490,-1,1046,1946,20
101976395091,101976395090,-1,681,1888,20
101980974458,101980974454,-4,1288,3273,20
101988492459,101988492455,-4,797,1650,20
101988610367,101988610383,16,927,1734,20
101988805554,101988805550,-4,882,1156,20
101991211397,101991211384,-13,1138,2353,20
101993844511,101993844508,-3,1048,2221,20
101993985221,101993985210,-11,1045,1592,20
101995579679,101995579675,-4,880,1669,20
101999795295,101999795293,-2,650,708,20
102003661809,102003661803,-6,1178,2140,20
102008170415,102008170412,-3,993,2350,20
102012904818,102012904814,-4,688,1927,20
102014888815,102014888814,-1,1303,1741,20
102017266286,102017266282,-4,1563,2299,20
102019073965,102019073962,-3,1472,2498,20
102019180178,102019180174,-4,1058,2113,20
102020018331,102020018326,-5,1224,2815,20
102020778486,102020778494,8,3434,1044,20
102026816854,102026816852,-2,1157,1649,20
102031130025,102031130023,-2,1394,2908,20
102035052631,102035052630,-1,425,1544,20
102038807382,102038807377,-5,1684,2814,20
102042783714,102042783711,-3,985,1567,20
102043146402,102043146400,-2,1276,2438,20
102045944143,102045944146,3,2465,2543,20
102046881896,102046881893,-3,1159,2053,20
102047132737,102047132735,-2,1546,2336,20
102050313358,102050313357,-1,928,1730,20
102051189620,102051189643,23,326,759,20
102053967901,102053967897,-4,1065,2616,20
102054821729,102054821721,-8,730,2218,20
102054921118,102054921115,-3,1097,2716,20
102062477924,102062477921,-3,616,2229,20
102064541937,102064541934,-3,832,1708,20
102069462826,102069462821,-5,905,1759,20
102071368111,102071368126,15,478,1198,20
102078942089,102078942086,-3,786,2339,20
102079288827,102079288820,-7,58369,27650,20
102081973393,102081973389,-4,1392,2898,20
102083390359,102083390355,-4,1016,2875,20
102087325925,102087325921,-4,1566,4079,20
102090120992,102090120990,-2,1392,2109,20
102091102672,102091102674,2,1425,1400,20
102094815739,102094815738,-1,942,2194,20
102095179729,102095179725,-4,1396,4099,20
102095976852,102095976848,-4,1586,3480,20
102101122363,102101122347,-16,295,2076,20
102102071817,102102071817,0,1923,3108,20
102102674722,102102674722,0,699,1395,20
102104010226,102104010223,-3,941,2401,20
102105408209,102105408206,-3,926,2304,20
102107479587,102107479585,-2,1420,3182,20
102112275153,102112275148,-5,1180,2751,20
102113004750,102113004745,-5,1309,2510,20
102113181749,102113181769,20,1265,1890,20
102114092186,102114092182,-4,601,1514,20
102117470619,102117470615,-4,830,1951,20
102119228740,102119228738,-2,1055,2188,20
102121431893,102121431896,3,4038,3216,20
102121528867,102121528865,-2,1167,2560,20
102121715650,102121715647,-3,1465,2275,20
102122082210,102122082217,7,3732,1405,20
102126550087,102126550090,3,1401,2029,20
102127097606,102127097602,-4,1430,2913,20
102130695065,102130695061,-4,1250,1791,20
102130937583,102130937572,-11,1098,1913,20
102138169381,102138169378,-3,1079,2269,20
102138861718,102138861715,-3,986,2477,20
102140930802,102140930801,-1,1341,2317,20
102142025479,102142025475,-4,848,1774,20
102144682892,102144682897,5,1321,1020,20
102145205927,102145205925,-2,976,1863,20
102148808196,102148808193,-3,1383,2423,20
102152474906,102152474902,-4,1099,2090,20
102153441394,102153441390,-4,786,2414,20
102159472293,102159472312,19,1271,974,20
102159698053,102159698042,-11,234,748,20
102160060684,102160060683,-1,1595,2611,20
102161871328,102161871326,-2,1275,1745,20
102164312301,102164312299,-2,3195,4489,20
102164372922,102164372922,0,1257,1912,20
102168312029,102168312039,10,11334,25118,20
102170175884,102170175881,-3,1144,3507,20
102171709635,102171709633,-2,1454,2978,20
102173140977,102173140970,-7,1384,5585,20
102179761826,102179761825,-1,921,1440,20
102180722173,102180722169,-4,1177,3396,20
102184971115,102184971112,-3,1116,2323,20
102189913003,102189913001,-2,1397,2464,20
102190332863,102190332858,-5,641,1757,20
102195169633,102195169630,-3,965,2446,20
102195294834,102195294835,1,1557,1598,20
102195609453,102195609450,-3,1128,1872,20
102199277528,102199277524,-4,1399,1886,20
102199310814,102199310831,17,874,2121,20
102201355515,102201355514,-1,1555,2593,20
102201669853,102201669850,-3,1806,4296,20
102201997327,102201997324,-3,1620,2701,20
102203790862,102203790859,-3,929,1972,20
102204896127,102204896120,-7,1013,5296,20
102209135058,102209135054,-4,871,2642,20
102212697946,102212697949,3,680,843,20
102213246335,102213246330,-5,1309,3911,20
102220311267,102220311265,-2,1202,2142,20
102222451858,102222451854,-4,1070,2175,20
102222617093,102222617102,9,92,890,20
102227516306,102227516302,-4,1238,2195,20
102227550215,102227550208,-7,711,1555,20
102237287130,102237287128,-2,1100,2747,20
102238845467,102238845462,-5,1422,2541,20
102239874268,102239874268,0,1313,1776,20
102244900981,102244900981,0,1419,2188,20
102247891338,102247891334,-4,1125,3422,20
102251130552,102251130550,-2,977,2002,20
102251772262,102251772259,-3,804,1783,20
102251801566,102251801583,17,451,922,20
102256124680,102256124678,-2,1124,2532,20
102256823758,102256823755,-3,656,1343,20
102257194691,102257194690,-1,984,1043,20
102257580021,102257580019,-2,886,2530,20
102258355101,102258355122,21,1066,2340,20
102262845197,102262845194,-3,1148,2136,20
102263792271,102263792267,-4,972,2123,20
102264368244,102264368234,-10,728,2006,20
102269152473,102269152464,-9,992,1831,20
102271864547,102271864546,-1,1056,2468,20
102273622546,102273622542,-4,935,2561,20
102281571349,102281571343,-6,906,1914,20
102283384538,102283384530,-8,31258,13902,20
102286976091,102286976089,-2,1182,2182,20
102289384906,102289384904,-2,932,1687,20
102292845703,102292845700,-3,1497,2947,20
102293862243,102293862244,1,983,2006,20
102295611895,102295611892,-3,1104,3484,20
102299255153,102299255153,0,1020,1764,20
102303485430,102303485430,0,794,2104,20
102306764653,102306764650,-3,772,1297,20
102307431204,102307431186,-18,1113,1809,20
102307961394,102307961391,-3,520,2138,20
102312595839,102312595836,-3,1778,4082,20
102317582795,102317582793,-2,1529,3264,20
102319547803,102319547800,-3,1066,2183,20
102319792215,102319792213,-2,1160,2339,20
102320172161,102320172168,7,5188,1352,20
102320543293,102320543294,1,2890,11928,20
102321266917,102321266917,0,1377,1183,20
102322950918,102322950914,-4,1247,3240,20
102332880979,102332880977,-2,1251,3282,20
102333633060,102333633057,-3,856,2083,20
102333936148,102333936130,-18,942,1462,20
102334004860,102334004882,22,1176,6421,20
102334821870,102334821869,-1,902,2008,20
102355359271,102355359270,-1,1491,1942,20
102362942050,102362942050,0,2077,2159,20
102367631493,102367631493,0,1186,1865,20
102370165665,102370165661,-4,1220,2255,20
102372894345,102372894341,-4,754,1712,20
102375537336,102375537351,15,12020,43844,20
102383034085,102383034081,-4,843,3875,20
102391604805,102391604800,-5,1124,3021,20
102391728527,102391728523,-4,1847,2976,20
102393689341,102393689331,-10,1067,2607,20
102394759598,102394759594,-4,995,1662,20
102397608505,102397608501,-4,1351,2946,20
102399981123,102399981121,-2,1033,2695,20
102402383009,102402383006,-3,1094,2601,20
102405767975,102405767974,-1,786,2818,20
102406672828,102406672824,-4,1117,2389,20
102407870098,102407870117,19,1509,2195,20
102408523843,102408523841,-2,669,2435,20
102409296937,102409296935,-2,932,3099,20
102410944563,102410944560,-3,1133,1950,20
102414670535,102414670533,-2,983,2762,20
102416641637,102416641630,-7,1175,3237,20
102418330275,102418330274,-1,911,2253,20
102419173090,102419173086,-4,1048,2255,20
102419958062,102419958059,-3,1249,2458,20
102426746972,102426746972,0,1012,2290,20
102430331214,102430331210,-4,945,2157,20
102431380397,102431380402,5,1801,1074,20
102435157373,102435157370,-3,1221,2157,20
102437849337,102437849343,6,1338,1007,20
102440927513,102440927510,-3,1455,2571,20
102441484395,102441484390,-5,1194,2500,20
102447109787,102447109785,-2,986,2338,20
102450475713,102450475710,-3,1700,2984,20
102452296491,102452296489,-2,1149,3249,20
102452627895,102452627894,-1,1125,1744,20
102459371780,102459371793,13,1202,1396,20
102462150111,102462150093,-18,324,898,20
102466416115,102466416110,-5,1073,2238,20
102467496030,102467496028,-2,1258,2208,20
102475490427,102475490422,-5,1085,3057,20
102477055018,102477055015,-3,2632,5664,20
102477338687,102477338683,-4,1001,1868,20
102482273581,102482273577,-4,1224,3150,20
102482866356,102482866353,-3,1048,2186,20
102483867434,102483867433,-1,1115,2348,20
102484166494,102484166493,-1,879,2067,20
102492370102,102492370108,6,10848,28705,20
102495001705,102495001702,-3,1249,2175,20
102498474879,102498474877,-2,2491,4160,20
102503297206,102503297203,-3,1340,1989,20
102505093582,102505093580,-2,576,1537,20
102505661384,102505661399,15,474,1609,20
102508714187,102508714181,-6,996,2105,20
102510274640,102510274637,-3,846,1651,20
102510791431,102510791431,0,1289,2182,20
102515895157,102515895152,-5,1476,2654,20
102518263947,102518263945,-2,984,2025,20
102519359447,102519359443,-4,565,1734,20
102527439681,102527439678,-3,1021,2451,20
102532797755,102532797751,-4,1010,2141,20
102542336081,102542336077,-4,920,2136,20
102545081169,102545081166,-3,1411,3145,20
102545294021,102545294006,-15,847,2515,20
102545968027,102545968022,-5,849,2406,20
102546237990,102546237986,-4,1146,2819,20
102546304062,102546304042,-20,1019,2136,20
102546687259,102546687255,-4,1333,2037,20
102554873978,102554873976,-2,1492,2267,20
102555844497,102555844477,-20,642,1366,20
102556149154,102556149153,-1,1221,2710,20
102559330259,102559330257,-2,971,1872,20
102560171856,102560171853,-3,1451,2382,20
102560811733,102560811730,-3,914,2972,20
102565694011,102565694009,-2,816,2400,20
102569543229,102569543223,-6,1509,2450,20
102569887514,102569887514,0,2219,3430,20
102570873241,102570873241,0,1123,2214,20
102571549207,102571549205,-2,1339,2809,20
102573455982,102573455977,-5,627,1797,20
102579845979,102579845974,-5,872,2562,20
102582426895,102582426892,-3,1275,2136,20
102585884507,102585884505,-2,520,2191,20
102590468803,102590468798,-5,883,2066,20
102591244882,102591244881,-1,1159,2383,20
102594178390,102594178395,5,4370,2148,20
102599674925,102599674922,-3,941,1772,20
102601281861,102601281855,-6,1002,2051,20
102602151998,102602151995,-3,923,2061,20
102608135584,102608135565,-19,860,2394,20
102609096171,102609096169,-2,758,2067,20
102609966293,102609966292,-1,1380,2164,20
102612475517,102612475505,-12,4153,14300,20
102612894941,102612894938,-3,1304,2753,20
102621032823,102621032818,-5,1003,2295,20
102621245820,102621245821,1,2538,1768,20
102628054168,102628054165,-3,908,2636,20
102629489912,102629489910,-2,1070,2731,20
102631100783,102631100790,7,3425,1072,20
102635611073,102635611071,-2,1276,2482,20
102635818115,102635818112,-3,1232,2250,20
102642364784,102642364782,-2,1165,2951,20
102648761046,102648761041,-5,884,3118,20
102650815411,102650815409,-2,798,1782,20
102650893891,102650893888,-3,843,2945,20
102652566658,102652566654,-4,1007,1354,20
102659515562,102659515560,-2,877,1959,20
102662377301,102662377298,-3,1241,2163,20
102663243216,102663243212,-4,1296,3487,20
102668471330,102668471326,-4,1251,3077,20
102671228870,102671228867,-3,696,2594,20
102674206118,102674206127,9,1912,794,20
102675273511,102675273507,-4,2342,4588,20
102678266305,102678266302,-3,762,2371,20
102681926800,102681926797,-3,949,2023,20
102684522197,102684522201,4,914,1619,20
102686536108,102686536106,-2,1268,1877,20
102688095087,102688095068,-19,1054,1934,20
102690965549,102690965553,4,2143,1687,20
102695765412,102695765415,3,1254,1363,20
102696673773,102696673771,-2,1233,1690,20
102698380921,102698380919,-2,1301,2044,20
102698429660,102698429657,-3,1155,1865,20
102703067661,102703067658,-3,1162,2356,20
102704260820,102704260843,23,348,1171,20
102706850871,102706850871,0,1067,1974,20
102708230694,102708230690,-4,1033,1657,20
102709136951,102709136950,-1,1014,2687,20
102715277750,102715277749,-1,1174,1488,20
102718007659,102718007655,-4,910,2235,20
102723313846,102723313843,-3,638,1832,20
102723490415,102723490432,17,1175,2065,20
102731157776,102731157772,-4,1079,2678,20
102738740685,102738740682,-3,786,2129,20
102739137142,102739137134,-8,1138,2948,20
102740354726,102740354722,-4,966,1634,20
102743015979,102743015982,3,1524,1425,20
102747047066,102747047062,-4,783,2378,20
102747280460,102747280454,-6,665,1958,20
102750613186,102750613194,8,4488,1342,20
102751756816,102751756813,-3,1323,2263,20
102751795388,102751795385,-3,764,2106,20
102755350642,102755350646,4,4083,2755,20
102767165048,102767165047,-1,1892,2551,20
102773430915,102773430912,-3,854,1754,20
102773855447,102773855443,-4,833,2300,20
102777729049,102777729029,-20,7881,1837,20
102781626125,102781626121,-4,1418,2641,20
102784410674,102784410670,-4,826,1493,20
102784513560,102784513549,-11,213,836,20
102786332468,102786332462,-6,959,1779,20
102787409482,102787409480,-2,1056,2736,20
102787769230,102787769226,-4,1039,2300,20
102788708211,102788708207,-4,924,2040,20
102791949940,102791949938,-2,1255,1942,20
102796972635,102796972632,-3,989,2011,20
102798131450,102798131446,-4,958,1855,20
102800376519,102800376518,-1,1152,2306,20
102801908390,102801908388,-2,1001,2140,20
102808536790,102808536790,0,1248,1563,20
102815361367,102815361360,-7,952,3285,20
102817369313,102817369310,-3,1146,1816,20
102817471881,102817471876,-5,1103,3216,20
102818200022,102818200018,-4,863,2471,20
102824687024,102824687021,-3,1388,3226,20
102825286590,102825286588,-2,1889,3407,20
102825962382,102825962383,1,881,1537,20
102828795278,102828795281,3,1362,1170,20
102830906423,102830906418,-5,1106,3031,20
102832932342,102832932341,-1,1073,2193,20
102836763339,102836763341,2,1346,1397,20
102840500110,102840500106,-4,1466,2995,20
102842622311,102842622314,3,1792,1992,20
102844427279,102844427282,3,3617,3821,20
102845069047,102845069047,0,1092,2120,20
102846488981,102846488978,-3,1082,2201,20
102849548245,102849548240,-5,1369,2628,20
102850298894,102850298915,21,852,2325,20
102858199139,102858199135,-4,884,1604,20
102861587053,102861587049,-4,1455,2121,20
102863560726,102863560726,0,1159,1690,20
102864928348,102864928346,-2,1071,1976,20
102872830927,102872830926,-1,1104,1522,20
102874270798,102874270797,-1,1074,1959,20
102883322987,102883322985,-2,1028,2713,20
102886286030,102886286046,16,1230,1656,20
102887621931,102887621928,-3,1079,2192,20
102890316670,102890316666,-4,909,1568,20
102891534534,102891534531,-3,843,2679,20
102893636030,102893636027,-3,1386,2559,20
102895057994,102895057991,-3,652,2868,20
102897201237,102897201232,-5,886,3162,20
102897720286,102897720307,21,374,972,20
102900507475,102900507474,-1,1218,2970,20
102901275470,102901275465,-5,767,1912,20
102904507170,102904507165,-5,989,2506,20
102908085338,102908085339,1,910,2084,20
102908136118,102908136116,-2,808,1524,20
102910616098,102910616099,1,1008,1363,20
102911592423,102911592419,-4,1233,2967,20
102913306599,102913306596,-3,1224,3559,20
102914621035,102914621031,-4,825,2404,20
102916969432,102916969438,6,3012,1353,20
102920600534,102920600530,-4,1080,3043,20
102926476882,102926476881,-1,1212,2298,20
102928040574,102928040567,-7,609,2632,20
102930302781,102930302779,-2,1296,2447,20
102948592014,102948592011,-3,1246,2342,20
102948918119,102948918115,-4,945,2196,20
102956408890,102956408889,-1,1199,2187,20
102958213627,102958213623,-4,718,1581,20
102959986172,102959986167,-5,1157,2752,20
102964362410,102964362408,-2,1132,2775,20
102965147841,102965147837,-4,971,3311,20
102968955201,102968955198,-3,1718,2587,20
102971669109,102971669107,-2,1410,2128,20
102973497915,102973497911,-4,597,871,20
102976330379,102976330378,-1,984,2014,20
102980204090,102980204090,0,1157,2380,20
102981630814,102981630813,-1,1085,2557,20
102986531882,102986531863,-19,1331,391,20
102994280523,102994280518,-5,877,1912,20
102995161782,102995161781,-1,1805,1637,20
102997811362,102997811362,0,1081,1202,20
103006941630,103006941629,-1,899,1058,20
103010090174,103010090170,-4,1063,2677,20
103012070562,103012070559,-3,1202,2321,20
103015296841,103015296836,-5,1278,2787,20
103016951875,103016951881,6,4399,1449,20
103019601561,103019601561,0,1539,2031,20
103020208464,103020208460,-4,1597,3407,20
103020364440,103020364439,-1,1524,1994,20
103027166385,103027166382,-3,1010,2422,20
103030146913,103030146910,-3,1251,3266,20
103033122791,103033122789,-2,546,1648,20
103033456499,103033456497,-2,1766,2584,20
103033981421,103033981427,6,3442,2060,20
103037178840,103037178837,-3,1657,3278,20
103037579474,103037579473,-1,1117,2645,20
103039500671,103039500667,-4,810,2358,20
103041067028,103041067029,1,1008,2254,20
103041488920,103041488925,5,3519,2019,20
103045970983,103045970978,-5,1176,2131,20
103050246900,103050246902,2,1632,1972,20
103050809622,103050809619,-3,1245,2374,20
103055450636,103055450635,-1,1169,1134,20
103058682623,103058682621,-2,1041,2283,20
103058758856,103058758854,-2,1494,2162,20
103058997025,103058997021,-4,1475,2289,20
103061549723,103061549719,-4,1115,2912,20
103064078250,103064078260,10,12994,50789,20
103064695474,103064695469,-5,1067,2377,20
103065349839,103065349835,-4,1449,2507,20
103066826398,103066826397,-1,883,2173,20
103068052447,103068052444,-3,797,1544,20
103069055098,103069055097,-1,1038,1996,20
103070801561,103070801556,-5,1376,2840,20
103071641259,103071641258,-1,1242,2275,20
103076904639,103076904634,-5,1354,1717,20
103078095023,103078095023,0,1421,1674,20
103082442338,103082442338,0,1154,1874,20
103084183427,103084183427,0,1034,1999,20
103085096842,103085096838,-4,881,2355,20
103085580191,103085580198,7,5137,2486,20
103085771869,103085771865,-4,1422,4146,20
103086877239,103086877240,1,185,731,20
103094895423,103094895422,-1,1398,2243,20
103095953886,103095953885,-1,1390,3085,20
103096617565,103096617561,-4,1200,2046,20
103105098002,103105097999,-3,995,2637,20
103109213248,103109213247,-1,1451,1390,20
103109266880,103109266879,-1,1834,2508,20
103116483006,103116483000,-6,1031,2258,20
103117107494,103117107482,-12,1414,650,20
103125426072,103125426068,-4,1177,2457,20
103125719383,103125719380,-3,1243,1819,20
103126699615,103126699631,16,363,1291,20
103130154608,103130154605,-3,1014,1809,20
103136674112,103136674095,-17,1435,4704,20
103137978162,103137978160,-2,1050,2150,20
103138893139,103138893137,-2,1274,2679,20
103139120983,103139120979,-4,878,1747,20
103140100667,103140100667,0,952,1052,20
103145903142,103145903138,-4,781,1741,20
103149295286,103149295283,-3,1132,2542,20
103155501444,103155501442,-2,1253,2441,20
103156711791,103156711789,-2,753,1866,20
103156959926,103156959910,-16,1295,2195,20
103158737422,103158737420,-2,1115,1867,20
103160028874,103160028869,-5,656,1573,20
103163144090,103163144086,-4,1463,2587,20
103165502738,103165502738,0,2155,1981,20
103170111353,103170111350,-3,1069,1832,20
103170935534,103170935531,-3,833,2357,20
103179052791,103179052786,-5,1070,2407,20
103179310370,103179310366,-4,1174,3069,20
103181030731,103181030726,-5,1515,3193,20
103181201826,103181201824,-2,1145,2765,20
103183727677,103183727672,-5,1105,2833,20
103184397115,103184397110,-5,969,1690,20
103186085806,103186085802,-4,1155,2700,20
103191563254,103191563250,-4,898,2097,20
103191891118,103191891107,-11,1037,2106,20
103196526018,103196526017,-1,986,2027,20
103196556443,103196556441,-2,1045,2087,20
103202775558,103202775555,-3,1310,1924,20
103206417762,103206417762,0,1007,1739,20
103208279362,103208279359,-3,1375,2778,20
103213839847,103213839846,-1,1004,2157,20
103215116719,103215116717,-2,1349,2824,20
103215857662,103215857662,0,1214,2199,20
103217729652,103217729650,-2,1026,2445,20
103219969691,103219969690,-1,876,2234,20
103231924905,103231924905,0,610,888,20
103246640025,103246640022,-3,1191,2971,20
103247431751,103247431754,3,2773,1861,20
103254783991,103254783989,-2,1224,2082,20
103256583879,103256583875,-4,823,1761,20
103256633502,103256633499,-3,1138,2206,20
103257828389,103257828381,-8,1168,5589,20
103259371827,103259371826,-1,1233,1766,20
103263403852,103263403845,-7,908,2170,20
103267433604,103267433600,-4,1042,2351,20
103268182909,103268182907,-2,1499,2343,20
103270236346,103270236344,-2,1300,2241,20
103274606845,103274606851,6,19144,21886,20
103275129000,103275128998,-2,1385,2744,20
103281214367,103281214364,-3,1145,2343,20
103281428635,103281428634,-1,871,2044,20
103281551878,103281551872,-6,1152,2357,20
103283668590,103283668595,5,2179,1177,20
103284285127,103284285122,-5,605,2150,20
103285332350,103285332348,-2,674,2478,20
103285674071,103285674067,-4,1006,2544,20
103286976474,103286976471,-3,997,1949,20
103290454683,103290454681,-2,614,1345,20
103293098442,103293098440,-2,1032,2910,20
103295598748,103295598745,-3,1256,2867,20
103295751622,103295751619,-3,1404,3742,20
103296038450,103296038447,-3,1463,1876,20
103296382395,103296382393,-2,917,2268,20
103309120757,103309120758,1,979,1790,20
103310819346,103310819340,-6,1086,1774,20
103314906478,103314906494,16,1337,1690,20
103315656022,103315656016,-6,1051,3301,20
103317025594,103317025590,-4,1434,3074,20
103318261989,103318261987,-2,973,2693,20
103322158838,103322158835,-3,1671,2415,20
103324666737,103324666734,-3,989,1443,20
103328838466,103328838464,-2,1380,2118,20
103330725746,103330725741,-5,1247,1773,20
103331739132,103331739131,-1,1120,1472,20
103332405998,103332405994,-4,766,1634,20
103336874015,103336874011,-4,1122,2392,20
103342329225,103342329222,-3,705,1588,20
103342897529,103342897522,-7,1205,2880,20
103343149366,103343149363,-3,1151,1929,20
103344062706,103344062705,-1,1281,2335,20
103347477634,103347477631,-3,1017,2015,20
103351241378,103351241377,-1,776,2106,20
103353061687,103353061685,-2,1081,2475,20
103354854319,103354854313,-6,929,4767,20
103357446399,103357446417,18,1119,1603,20
103360630690,103360630687,-3,816,1713,20
103362791040,103362791037,-3,1228,3246,20
103364623430,103364623426,-4,1126,2260,20
103377366501,103377366498,-3,1242,2437,20
103377550474,103377550471,-3,1259,2577,20
103378744802,103378744800,-2,1313,2379,20
103383294450,103383294451,1,1502,2060,20
103384941390,103384941399,9,6549,33757,20
103386605164,103386605162,-2,1220,1903,20
103387338246,103387338267,21,532,1686,20
103389627577,103389627573,-4,1410,2660,20
103392837985,103392837981,-4,460,1699,20
103397987803,103397987801,-2,843,2058,20
103402186042,103402186038,-4,910,1721,20
103408032027,103408032025,-2,947,2363,20
103409322135,103409322129,-6,1531,5900,20
103411807147,103411807144,-3,1149,1916,20
103414772143,103414772135,-8,1595,6079,20
103415878584,103415878590,6,2055,1201,20
103419361125,103419361129,4,14466,9265,20
103421245254,103421245251,-3,838,2509,20
103425315080,103425315085,5,3248,1822,20
103426294379,103426294379,0,906,1781,20
103430040439,103430040434,-5,798,2646,20
103431415558,103431415554,-4,1056,2871,20
103434557678,103434557674,-4,1358,1850,20
103434686642,103434686640,-2,1213,2669,20
103435186214,103435186213,-1,1034,2195,20
103436611165,103436611161,-4,789,2430,20
103440733387,103440733384,-3,1108,2820,20
103442011309,103442011305,-4,1433,1901,20
103446443314,103446443310,-4,1374,1958,20
103451667207,103451667201,-6,1102,2220,20
103451988591,103451988569,-22,1034,2130,20
103453261982,103453261978,-4,866,1974,20
103454948946,103454948945,-1,1123,2623,20
103461558744,103461558737,-7,2031,7645,20
103462685810,103462685809,-1,2277,4314,20
103468224934,103468224931,-3,1557,3781,20
103468663419,103468663415,-4,1427,2611,20
103474468130,103474468127,-3,1120,2827,20
103479396747,103479396746,-1,825,2666,20
103486878901,103486878897,-4,1012,1978,20
103487458254,103487458252,-2,1729,3528,20
103487779506,103487779509,3,1839,1545,20
103499950560,103499950567,7,11571,19705,20
103500567946,103500567944,-2,1390,2069,20
103503008874,103503008872,-2,1432,2772,20
103510402553,103510402549,-4,1651,2540,20
103515504046,103515504042,-4,1041,3613,20
103523118005,103523118002,-3,1835,2288,20
103527835653,103527835651,-2,1316,2779,20
103528159975,103528159971,-4,1052,2111,20
103532264025,103532264022,-3,1175,2557,20
103536734490,103536734486,-4,1351,3019,20
103537865963,103537865962,-1,1282,2237,20
103540413650,103540413649,-1,971,1750,20
103544187046,103544187042,-4,1038,1578,20
103547128243,103547128242,-1,1147,2160,20
103547821245,103547821238,-7,1473,3078,20
103550218781,103550218781,0,1441,1955,20
103551196422,103551196426,4,2204,2153,20
103559158805,103559158803,-2,1308,2237,20
103563982536,103563982533,-3,870,2227,20
103572457610,103572457610,0,1071,1226,20
103574271490,103574271485,-5,1029,2559,20
103575713111,103575713107,-4,1161,2377,20
103575872476,103575872474,-2,1929,3317,20
103578708046,103578708042,-4,1385,3127,20
103581011124,103581011121,-3,1433,2985,20
103586646590,103586646585,-5,1247,2976,20
103590154770,103590154769,-1,1211,2807,20
103591636959,103591636958,-1,794,1892,20
103591947537,103591947536,-1,981,2275,20
103594097756,103594097755,-1,1081,1461,20
103594461759,103594461758,-1,1461,3085,20
103594966483,103594966478,-5,1157,2462,20
103595479980,103595479978,-2,575,1272,20
103599953295,103599953293,-2,1023,2040,20
103610628115,103610628111,-4,1115,2944,20
103614469266,103614469246,-20,2114,812,20
103618815531,103618815527,-4,1083,2918,20
103620087268,103620087265,-3,1101,2130,20
103623092114,103623092106,-8,638,2453,20
103626419550,103626419547,-3,804,2612,20
103632158194,103632158189,-5,1097,2531,20
103633077164,103633077159,-5,1446,3917,20
103634850241,103634850238,-3,1123,2651,20
103634918423,103634918440,17,662,1761,20
103634988774,103634988769,-5,1253,4515,20
103635655711,103635655711,0,872,1789,20
103639667561,103639667557,-4,937,2784,20
103644466162,103644466161,-1,904,2467,20
103645372354,103645372351,-3,1061,2072,20
103648280034,103648280033,-1,1190,1909,20
103649943179,103649943181,2,1857,1319,20
103652263123,103652263120,-3,924,2913,20
103656297362,103656297365,3,1933,2011,20
103657653931,103657653926,-5,1037,2442,20
103658212628,103658212622,-6,1005,2216,20
103658440608,103658440625,17,1621,2161,20
103659695199,103659695193,-6,733,3204,20
103663591911,103663591909,-2,860,1595,20
103665650312,103665650307,-5,1378,2933,20
103668332033,103668332031,-2,1504,2386,20
103670466549,103670466549,0,902,1541,20
103671608307,103671608304,-3,895,1860,20
103674334391,103674334389,-2,1220,2427,20
103676175519,103676175517,-2,1042,2060,20
103688114458,103688114458,0,1358,1870,20
103689584834,103689584832,-2,1364,1686,20
103691071515,103691071511,-4,1150,2801,20
103692006250,103692006247,-3,1024,2640,20
103699281790,103699281786,-4,1173,1751,20
103704716236,103704716234,-2,1055,2133,20
103705082744,103705082756,12,139,909,20
103705384455,103705384453,-2,1301,2335,20
103706347704,103706347702,-2,1614,3019,20
103706507189,103706507186,-3,1143,2181,20
103707716013,103707716009,-4,1338,2795,20
103711960140,103711960136,-4,1475,3179,20
103714191197,103714191193,-4,936,2291,20
103721088423,103721088419,-4,1091,2770,20
103722156095,103722156092,-3,1366,2794,20
103729826459,103729826456,-3,734,2617,20
103731193360,103731193356,-4,998,2525,20
103735637986,103735637983,-3,677,2757,20
103741661074,103741661069,-5,1356,6139,20
103746512688,103746512682,-6,1297,3339,20
103748919557,103748919557,0,1227,2097,20
103749033883,103749033881,-2,928,2061,20
103749573423,103749573439,16,1008,1648,20
103752212534,103752212530,-4,1061,2690,20
103754101466,103754101477,11,962,1916,20
103754480789,103754480786,-3,831,2381,20
103760067066,103760067060,-6,753,2330,20
103767188851,103767188847,-4,862,2546,20
103770943628,103770943623,-5,1360,2744,20
103772655334,103772655329,-5,1112,2563,20
103775686391,103775686387,-4,1552,5360,20
103776179547,103776179543,-4,1129,2883,20
103778539732,103778539731,-1,1109,1802,20
103778744669,103778744660,-9,860,1653,20
103782547619,103782547617,-2,1183,1702,20
103784430574,103784430573,-1,609,2553,20
103786423351,103786423345,-6,1378,5091,20
103787810035,103787810031,-4,1290,2511,20
103792229681,103792229677,-4,1012,3046,20
103796715299,103796715296,-3,956,2076,20
103801059546,103801059550,4,4601,2789,20
103803782794,103803782798,4,3479,2661,20
103804305803,103804305807,4,2008,1397,20
103806105067,103806105065,-2,1217,2301,20
103808731087,103808731090,3,2259,1768,20
103813567390,103813567386,-4,1123,2192,20
103817887678,103817887674,-4,729,1423,20
103825018866,103825018865,-1,1156,1222,20
103825813846,103825813843,-3,1428,2551,20
103827657667,103827657664,-3,789,1974,20
103831075973,103831075980,7,5636,1736,20
103834544670,103834544666,-4,1027,2318,20
103836358838,103836358846,8,1692,1667,20
103841143306,103841143305,-1,1759,1972,20
103842280359,103842280355,-4,581,1044,20
103848292901,103848292898,-3,1013,1995,20
103850133153,103850133151,-2,1415,1664,20
103855491786,103855491782,-4,1087,2734,20
103856221644,103856221651,7,167,961,20
103856688102,103856688098,-4,842,2973,20
103860349873,103860349869,-4,1519,3284,20
103861338766,103861338764,-2,600,1683,20
103862681682,103862681678,-4,1059,1401,20
103863904357,103863904353,-4,1772,3137,20
103871399994,103871399993,-1,1510,2064,20
103876537134,103876537130,-4,1165,3474,20
103882403491,103882403489,-2,1410,1721,20
103883403785,103883403783,-2,539,1587,20
103885755582,103885755586,4,1803,1477,20
103886369214,103886369212,-2,1138,2392,20
103887613022,103887613020,-2,930,2049,20
103890300211,103890300210,-1,1249,2287,20
103890502501,103890502517,16,16769,24522,20
103897609137,103897609137,0,878,1838,20
103898845589,103898845585,-4,1341,2516,20
103900459421,103900459407,-14,1142,1748,20
103901617295,103901617293,-2,1121,2301,20
103905236472,103905236467,-5,1121,2818,20
103905392125,103905392122,-3,638,2070,20
103910976710,103910976707,-3,1258,2111,20
103911396639,103911396637,-2,1288,3003,20
103915927178,103915927176,-2,997,2265,20
103916055224,103916055221,-3,1135,2344,20
103916426454,103916426450,-4,1119,2722,20
103917290524,103917290531,7,68,1063,20
103918889078,103918889077,-1,1261,1718,20
103928340235,103928340232,-3,926,2170,20
103928570462,103928570478,16,893,1667,20
103930678003,103930677999,-4,875,1819,20
103933180526,103933180524,-2,1004,2042,20
103933585073,103933585071,-2,1056,2026,20
103937358122,103937358119,-3,1117,2593,20
103939611822,103939611821,-1,951,2365,20
103941452933,103941452931,-2,846,1491,20
103942873241,103942873238,-3,2198,2236,20
103944792315,103944792310,-5,1237,2854,20
103953000105,103953000101,-4,1373,2700,20
103954585541,103954585546,5,3499,1364,20
103955746994,103955746990,-4,1202,2861,20
103956169226,103956169223,-3,564,1731,20
103956773781,103956773779,-2,1199,2160,20
103959569302,103959569297,-5,2696,6238,20
103960123965,103960123963,-2,1677,2156,20
103962161487,103962161486,-1,845,2006,20
103963805531,103963805530,-1,573,1387,20
103965086746,103965086743,-3,1239,2877,20
103971288860,103971288857,-3,3325,7032,20
103972788786,103972788791,5,2308,1660,20
103973438685,103973438681,-4,1091,1651,20
103981479570,103981479570,0,1557,1791,20
103985642659,103985642656,-3,1206,2416,20
103989265226,103989265222,-4,1002,2404,20
103989861417,103989861412,-5,1114,2673,20
103992576315,103992576313,-2,860,2537,20
103995363895,103995363891,-4,1541,3086,20
103997185168,103997185174,6,4687,2311,20
103998493058,103998493054,-4,1274,2842,20
103998777763,103998777760,-3,1274,3150,20
104000408126,104000408143,17,28,1209,20
104012525983,104012525982,-1,1229,1628,20
104012931628,104012931646,18,867,1846,20
104013848326,104013848325,-1,1393,2331,20
104026231754,104026231751,-3,1133,3211,20
104029580214,104029580235,21,1657,963,20
104038691641,104038691639,-2,1296,1928,20
104040228138,104040228134,-4,879,1891,20
104040447134,104040447116,-18,1249,1987,20
104041860516,104041860521,5,4130,1666,20
104046254491,104046254487,-4,689,991,20
104049527138,104049527137,-1,1134,1583,20
104049662182,104049662197,15,210,1193,20
104053513227,104053513225,-2,1229,2003,20
104054692123,104054692119,-4,975,2050,20
104054857184,104054857177,-7,2243,6095,20
104056853424,104056853422,-2,1118,2609,20
104059583376,104059583371,-5,1390,3554,20
104059708839,104059708834,-5,891,2241,20
104059848159,104059848159,0,732,1497,20
104061829303,104061829303,0,760,1533,20
104062159423,104062159410,-13,1248,1988,20
104063988828,104063988826,-2,1326,2234,20
104065324323,104065324320,-3,1274,2778,20
104067744839,104067744834,-5,2082,7875,20
104070570470,104070570467,-3,1073,2057,20
104074800662,104074800658,-4,1085,1402,20
104076229013,104076229010,-3,1021,2770,20
104077821618,104077821616,-2,1334,1996,20
104079928106,104079928102,-4,1422,2881,20
104082940694,104082940691,-3,790,1502,20
104084147255,104084147254,-1,984,1946,20
104085562587,104085562586,-1,962,1927,20
104089699327,104089699321,-6,809,4705,20
104093858701,104093858697,-4,1321,2801,20
104094285032,104094285030,-2,1292,2133,20
104097641001,104097640995,-6,1276,2156,20
104099168524,104099168521,-3,1250,1602,20
104099727464,104099727462,-2,2048,3972,20
104101485836,104101485834,-2,975,2232,20
104102262650,104102262648,-2,1510,1993,20
104117647069,104117647066,-3,1238,2722,20
104121230890,104121230869,-21,52417,15155,20
104123906058,104123906054,-4,1260,2564,20
104124902235,104124902234,-1,1136,2589,20
104126668142,104126668141,-1,1067,2157,20
104126733118,104126733126,8,3509,1009,20
104128918145,104128918142,-3,1168,2549,20
104133945544,104133945539,-5,1200,3024,20
104134566122,104134566121,-1,2089,2007,20
104139350381,104139350378,-3,1248,1576,20
104143632867,104143632866,-1,1313,2147,20
104143788810,104143788809,-1,1140,2701,20
104145982262,104145982258,-4,1076,1908,20
104147742145,104147742141,-4,1133,1897,20
104148876658,104148876655,-3,893,2530,20
104154000958,104154000957,-1,1130,2959,20
104157511718,104157511717,-1,1187,1379,20
104157949134,104157949130,-4,1129,1588,20
104159739727,104159739723,-4,823,2095,20
104159941829,104159941846,17,279,748,20
104162398731,104162398729,-2,1129,1398,20
104163414060,104163414067,7,112,623,20
104166303762,104166303757,-5,1115,2097,20
104178603694,104178603693,-1,1114,2069,20
104185754513,104185754509,-4,1066,2117,20
104191541462,104191541458,-4,1056,1947,20
104191701793,104191701791,-2,1080,2104,20
104194452290,104194452289,-1,894,2164,20
104196066962,104196066960,-2,1283,2024,20
104196399423,104196399422,-1,1132,2039,20
104197183025,104197183022,-3,1112,2358,20
104199014847,104199014846,-1,1241,2612,20
104200542426,104200542424,-2,1090,2454,20
104201265376,104201265394,18,1032,1688,20
104206483846,104206483841,-5,1650,3919,20
104209372357,104209372353,-4,1363,2994,20
104217567806,104217567805,-1,1364,1840,20
104220402257,104220402257,0,1093,2157,20
104220481487,104220481483,-4,999,2645,20
104221562863,104221562858,-5,1339,3912,20
104221704551,104221704547,-4,1218,2280,20
104223172677,104223172693,16,12961,56009,20
104225786487,104225786485,-2,1478,2427,20
104226724481,104226724467,-14,1167,1945,20
104232023582,104232023580,-2,1227,1895,20
104233894937,104233894933,-4,981,2043,20
104244206067,104244206068,1,1529,2424,20
104250942047,104250942045,-2,945,2584,20
104251464216,104251464235,19,490,1132,20
104255129837,104255129833,-4,1404,2984,20
104256088135,104256088132,-3,1323,2679,20
104258980448,104258980446,-2,1074,3179,20
104259547734,104259547714,-20,1055,1768,20
104262890945,104262890942,-3,1013,2503,20
104264789403,104264789402,-1,1491,2769,20
104266157374,104266157371,-3,1533,2816,20
104268342091,104268342090,-1,1747,2350,20
104270453378,104270453378,0,1638,1245,20
104273796462,104273796457,-5,1461,3540,20
104278559846,104278559844,-2,1400,1704,20
104287757151,104287757147,-4,864,1196,20
104288059236,104288059258,22,1002,2368,20
104289234444,104289234439,-5,1118,2506,20
104292365591,104292365588,-3,1069,1767,20
104294226172,104294226169,-3,1484,3334,20
104294513718,104294513731,13,489,2351,20
104294827176,104294827174,-2,383,1345,20
104303184874,104303184874,0,990,2172,20
104310022890,104310022883,-7,741,2780,20
104310731193,104310731199,6,2450,1746,20
104317193923,104317193920,-3,773,1940,20
104317594473,104317594471,-2,1198,2974,20
104322312979,104322312976,-3,1077,3185,20
104324522247,104324522246,-1,1166,2192,20
104332882707,104332882705,-2,786,2301,20
104333081711,104333081718,7,3898,1820,20
104337570882,104337570877,-5,1181,2421,20
104346583995,104346583991,-4,968,1852,20
104350468913,104350468903,-10,3006,18099,20
104351929399,104351929393,-6,1116,4350,20
104354657716,104354657713,-3,556,858,20
104355406975,104355406992,17,1363,1976,20
104357712883,104357712879,-4,961,1923,20
104358475759,104358475754,-5,660,2352,20
104358875865,104358875870,5,4300,2421,20
104362355506,104362355504,-2,972,2102,20
104364238806,104364238800,-6,902,2425,20
104366871123,104366871122,-1,1961,3504,20
104367827571,104367827569,-2,1402,1942,20
104372169025,104372169023,-2,1063,1960,20
104380663987,104380663983,-4,957,2330,20
104380913278,104380913274,-4,982,3097,20
104383059754,104383059752,-2,697,2452,20
104383259838,104383259842,4,123,889,20
104386020230,104386020229,-1,996,1954,20
104388308514,104388308512,-2,1277,2976,20
104396945080,104396945078,-2,821,1931,20
104399412185,104399412180,-5,1314,3690,20
104400162918,104400162915,-3,1273,2123,20
104400437228,104400437235,7,24824,24622,20
104400867172,104400867169,-3,882,1905,20
104402636279,104402636274,-5,1317,2911,20
104405941525,104405941520,-5,1377,3135,20
104406487413,104406487410,-3,1423,2540,20
104406841937,104406841934,-3,1135,2057,20
104408325450,104408325449,-1,578,1598,20
104410009144,104410009141,-3,652,1730,20
104410870086,104410870081,-5,885,1698,20
104412420087,104412420083,-4,1338,2299,20
104413605275,104413605270,-5,1238,3241,20
104414267518,104414267514,-4,1180,2371,20
104420030145,104420030142,-3,1263,2969,20
104421657275,104421657274,-1,1703,3708,20
104425495374,104425495370,-4,1005,2986,20
104425841495,104425841498,3,2610,1979,20
104430555342,104430555345,3,385,2122,20
104432485712,104432485710,-2,1013,2216,20
104435959099,104435959095,-4,920,2980,20
104440024493,104440024490,-3,991,1664,20
104444325997,104444325994,-3,1027,2189,20
104449694042,104449694038,-4,974,3159,20
104450620953,104450620950,-3,824,2064,20
104452706326,104452706345,19,718,3648,20
104453582791,104453582789,-2,968,2337,20
104460192204,104460192215,11,19939,48660,20
104463652453,104463652451,-2,1190,1438,20
104463872556,104463872547,-9,305,787,20
104464354290,104464354285,-5,2090,6724,20
104469678828,104469678833,5,1714,1144,20
104470975884,104470975889,5,2988,1379,20
104471902751,104471902750,-1,665,1651,20
104472022886,104472022883,-3,1120,1830,20
104476335290,104476335286,-4,1153,2555,20
104478838934,104478838929,-5,1424,3924,20
104479269547,104479269541,-6,1135,2698,20
104479966114,104479966112,-2,1502,2523,20
104480550727,104480550724,-3,1263,2024,20
104480859597,104480859593,-4,1488,1885,20
104483538093,104483538092,-1,717,2006,20
104488837311,104488837310,-1,1278,2508,20
104491790793,104491790792,-1,783,1049,20
104495029145,104495029143,-2,1320,3064,20
104498684563,104498684561,-2,1211,2279,20
104501368691,104501368690,-1,1137,2695,20
104501846065,104501846061,-4,1348,2673,20
104508789715,104508789712,-3,1113,1750,20
104511269212,104511269210,-2,947,2240,20
104514579282,104514579281,-1,1352,2053,20
104514928797,104514928795,-2,1111,2244,20
104515876598,104515876594,-4,1125,2439,20
104520579686,104520579682,-4,905,2066,20
104525988894,104525988901,7,11185,2902,20
104528692887,104528692883,-4,1179,2694,20
104533629747,104533629765,18,11817,56062,20
104535306815,104535306811,-4,1265,2163,20
104535394044,104535394041,-3,1056,2734,20
104535471543,104535471522,-21,1055,2820,20
104550110891,104550110885,-6,969,2766,20
104554639670,104554639666,-4,1138,2404,20
104555594843,104555594839,-4,907,1619,20
104557121892,104557121890,-2,1381,2830,20
104561118013,104561118009,-4,537,1510,20
104561521481,104561521480,-1,1350,2025,20
104564969650,104564969647,-3,1111,2864,20
104565059897,104565059898,1,1008,1740,20
104567621738,104567621735,-3,898,1006,20
104568190710,104568190710,0,797,2264,20
104568797117,104568797098,-19,160,850,20
104571616631,104571616629,-2,585,1774,20
104571716016,104571716035,19,899,2411,20
104574863885,104574863885,0,1353,2223,20
104575905847,104575905858,11,11113,36401,20
104577032826,104577032823,-3,1449,2863,20
104583792363,104583792360,-3,823,2188,20
104586193333,104586193330,-3,1581,2588,20
104590091571,104590091566,-5,1178,4924,20
104591364378,104591364375,-3,813,1589,20
104596268424,104596268422,-2,1543,2510,20
104596824266,104596824263,-3,1164,2612,20
104598279495,104598279498,3,1206,1369,20
104598710403,104598710400,-3,1361,2430,20
104601691961,104601691959,-2,988,2323,20
104602286491,104602286486,-5,804,2181,20
104604576746,104604576744,-2,1100,2124,20
104604964841,104604964838,-3,1345,2700,20
104605748649,104605748647,-2,1519,2163,20
104605794042,104605794036,-6,937,2140,20
104607308439,104607308434,-5,908,1824,20
104607777279,104607777269,-10,84,1680,20
104616304036,104616304053,17,228,868,20
104621276603,104621276598,-5,1181,2968,20
104622309754,104622309752,-2,989,2303,20
104623038586,104623038584,-2,997,2220,20
104624000194,104624000194,0,1083,1699,20
104626018894,104626018890,-4,698,1563,20
104627218496,104627218490,-6,1552,3561,20
104629870820,104629870817,-3,1645,2937,20
104631509736,104631509733,-3,1179,1719,20
104641859105,104641859105,0,907,1978,20
104641898462,104641898459,-3,1311,2164,20
104648595650,104648595647,-3,1492,2496,20
104652011257,104652011250,-7,929,2682,20
104652073121,104652073117,-4,1193,2214,20
104652332313,104652332315,2,1752,1486,20
104653506115,104653506114,-1,1224,2953,20
104654687338,104654687334,-4,1344,2567,20
104656890711,104656890717,6,2876,1063,20
104658609090,104658609087,-3,1064,1884,20
104661246751,104661246750,-1,1455,2928,20
104662687006,104662687002,-4,1126,2471,20
104663039541,104663039561,20,1064,1456,20
104664300279,104664300276,-3,1355,3170,20
104664465331,104664465326,-5,1357,3366,20
104665175752,104665175751,-1,1038,2599,20
104677479903,104677479902,-1,2745,3733,20
104680835417,104680835415,-2,1386,3196,20
104680960051,104680960046,-5,998,2695,20
104681206310,104681206299,-11,106,1198,20
104681820066,104681820061,-5,1019,2948,20
104683146554,104683146550,-4,1272,2300,20
104686390378,104686390374,-4,1167,2717,20
104690555502,104690555495,-7,954,2281,20
104690803976,104690803982,6,82,700,20
104693335416,104693335421,5,2536,1097,20
104696906570,104696906568,-2,762,1333,20
104698007094,104698007090,-4,1087,3268,20
104700519102,104700519097,-5,1243,3521,20
104700692404,104700692426,22,1314,2755,20
104701977496,104701977492,-4,1218,2343,20
104703782570,104703782569,-1,1165,1978,20
104704551047,104704551045,-2,1513,2157,20
104707225645,104707225644,-1,1149,2373,20
104707975179,104707975177,-2,597,1836,20
104708032894,104708032913,19,1096,1228,20
104708547638,104708547634,-4,1072,2942,20
104709758639,104709758636,-3,1051,2224,20
104710351222,104710351221,-1,1149,1677,20
104710881550,104710881539,-11,1320,2035,20
104711106358,104711106357,-1,807,1813,20
104712379964,104712379987,23,142,946,20
104715319694,104715319690,-4,1003,2207,20
104715657090,104715657094,4,2039,1176,20
104716910489,104716910487,-2,966,1664,20
104717865443,104717865439,-4,877,2369,20
104720111509,104720111506,-3,985,1477,20
104720610483,104720610478,-5,905,2546,20
104721696032,104721696030,-2,746,1717,20
104721727050,104721727052,2,1662,1624,20
104721823461,104721823462,1,1840,1639,20
104722891987,104722891984,-3,1403,3170,20
104727242955,104727242950,-5,1006,2831,20
104729833618,104729833616,-2,1304,2717,20
104730439004,104730439012,8,1466,964,20
104734416909,104734416907,-2,1133,2760,20
104734590753,104734590751,-2,973,2475,20
104735115132,104735115126,-6,1401,3164,20
104736381832,104736381851,19,1082,1587,20
104736449792,104736449808,16,1010,2395,20
104740757914,104740757913,-1,1056,2029,20
104742383839,104742383838,-1,969,1911,20
104744485999,104744485997,-2,1307,2273,20
104746531606,104746531599,-7,1925,7363,20
104749437800,104749437797,-3,993,2016,20
104751634162,104751634158,-4,714,1635,20
104752018843,104752018842,-1,57576,54313,20
104753320044,104753320041,-3,1169,2816,20
104759572121,104759572114,-7,1213,3920,20
104759993486,104759993507,21,1232,2580,20
104760028661,104760028657,-4,1128,1995,20
104767716599,104767716597,-2,1171,2532,20
104768639388,104768639385,-3,947,2199,20
104768834158,104768834157,-1,649,2004,20
104773038755,104773038751,-4,1274,2897,20
104773650095,104773650113,18,365,1106,20
104776895438,104776895436,-2,821,2217,20
104786379762,104786379760,-2,590,1482,20
104786484714,104786484718,4,2761,1434,20
104786629221,104786629217,-4,1243,2812,20
104792482315,104792482311,-4,1067,2366,20
104792857177,104792857175,-2,1318,1875,20
104798014413,104798014410,-3,1478,2227,20
104799056419,104799056419,0,1413,2248,20
104801737179,104801737185,6,2685,1391,20
104803236707,104803236705,-2,551,1702,20
104803943297,104803943294,-3,1223,2142,20
104809950421,104809950418,-3,1482,4388,20
104811066923,104811066922,-1,724,1146,20
104814683838,104814683836,-2,1248,1949,20
104815086734,104815086731,-3,1195,2608,20
104817476548,104817476542,-6,785,3383,20
104817552937,104817552934,-3,1277,1913,20
104822805770,104822805762,-8,761,2780,20
104825920785,104825920781,-4,839,1841,20
104826227208,104826227205,-3,1115,2108,20
104826354720,104826354731,11,307,1587,20
104828507475,104828507471,-4,1519,2974,20
104837770890,104837770889,-1,1618,2368,20
104840498603,104840498603,0,1377,1554,20
104843275852,104843275847,-5,1274,1692,20
104846354886,104846354883,-3,821,1703,20
104849778689,104849778687,-2,1295,2042,20
104851138616,104851138612,-4,1440,2783,20
104852845162,104852845158,-4,1222,2467,20
104853295758,104853295754,-4,1223,2868,20
104854307742,104854307738,-4,997,1943,20
104864941561,104864941558,-3,1315,2954,20
104870676726,104870676727,1,1181,1229,20
104872623702,104872623698,-4,761,2093,20
104873724997,104873724994,-3,1015,2454,20
104873838183,104873838177,-6,1474,5428,20
104874960372,104874960378,6,2865,1573,20
104878275595,104878275592,-3,1473,2820,20
104879043645,104879043645,0,549,1477,20
104879644038,104879644037,-1,982,2000,20
104882375935,104882375930,-5,1022,2761,20
104886761109,104886761106,-3,1155,2059,20
104888034051,104888034054,3,1651,2001,20
104888712378,104888712374,-4,1073,2667,20
104892422014,104892422011,-3,1386,2135,20
104892954295,104892954293,-2,763,2030,20
104893211647,104893211634,-13,1131,2674,20
104894833027,104894833024,-3,777,2159,20
104897242873,104897242878,5,3679,1724,20
104899068421,104899068404,-17,639,404,20
104899543552,104899543570,18,1487,2902,20
104899900222,104899900221,-1,1184,1556,20
104905309798,104905309795,-3,976,2830,20
104909860379,104909860377,-2,3077,4651,20
104913381746,104913381742,-4,1248,2517,20
104915983054,104915983050,-4,937,2346,20
104916721962,104916721960,-2,1212,2810,20
104917081214,104917081207,-7,853,2435,20
104918349698,104918349690,-8,928,4170,20
104921127693,104921127690,-3,1059,3126,20
104921339702,104921339698,-4,1043,1667,20
104922523082,104922523090,8,2867,1305,20
104923813929,104923813925,-4,1107,3486,20
104923844013,104923844010,-3,1172,3134,20
104929968522,104929968518,-4,970,1407,20
104931289398,104931289396,-2,1061,2228,20
104932225785,104932225782,-3,1248,2361,20
104933345481,104933345481,0,1763,2086,20
104936069745,104936069741,-4,1534,2370,20
104936233879,104936233862,-17,213,1286,20
104937664014,104937664012,-2,979,2565,20
104938454544,104938454542,-2,1156,3102,20
104948789115,104948789120,5,4178,1557,20
104951772375,104951772373,-2,1155,2790,20
104955156564,104955156561,-3,740,2586,20
104966439352,104966439349,-3,1140,2601,20
104984624662,104984624659,-3,1430,3191,20
104986242567,104986242563,-4,980,1583,20
104986295872,104986295853,-19,1147,2056,20
104989458722,104989458721,-1,1035,1320,20
104992941975,104992941973,-2,1367,2205,20
104993283669,104993283666,-3,614,1491,20
104996660878,104996660875,-3,1332,1984,20
104998004119,104998004117,-2,1729,3217,20
105000397266,105000397265,-1,1288,2303,20
105004916226,105004916223,-3,1251,2769,20
105025969974,105025969971,-3,1250,2214,20
105028157003,105028156998,-5,876,1598,20
105029257758,105029257777,19,967,1769,20
105030687639,105030687638,-1,817,2130,20
105036100135,105036100130,-5,1277,1920,20
105038483167,105038483164,-3,1020,2822,20
105040502240,105040502245,5,1613,1441,20
105042009525,105042009519,-6,1222,3334,20
105047424938,105047424937,-1,22203,33909,20
105048011066,105048011064,-2,1302,2886,20
105050302149,105050302145,-4,891,2342,20
105050523117,105050523136,19,1335,2482,20
105051729666,105051729663,-3,1186,3057,20
105053145930,105053145926,-4,596,2060,20
105054653736,105054653734,-2,877,1772,20
105060362792,105060362783,-9,847,1164,20
105060677707,105060677706,-1,1345,2054,20
105062778867,105062778862,-5,1095,1936,20
105067580589,105067580585,-4,935,1798,20
105067680999,105067680994,-5,1210,2691,20
105077899793,105077899791,-2,1613,2332,20
105078076895,105078076895,0,774,1653,20
105079138398,105079138396,-2,893,2685,20
105080312822,105080312821,-1,855,2253,20
105082259601,105082259599,-2,1213,2261,20
105083771722,105083771718,-4,1149,1476,20
105091875841,105091875838,-3,1267,2188,20
105094691941,105094691937,-4,1480,4111,20
105097590625,105097590624,-1,1199,2434,20
105098282642,105098282637,-5,1077,2416,20
105102011157,105102011154,-3,975,3445,20
105102977582,105102977580,-2,1528,2183,20
105103026599,105103026598,-1,1309,1946,20
105103706781,105103706791,10,29,1292,20
105105028588,105105028586,-2,1097,1775,20
105109133551,105109133550,-1,1734,2513,20
105109750702,105109750698,-4,901,2350,20
105110863098,105110863098,0,748,2042,20
105111688093,105111688090,-3,1387,2776,20
105116212383,105116212386,3,1281,1771,20
105126301966,105126301963,-3,1056,2469,20
105129475094,105129475092,-2,1308,2187,20
105135887661,105135887658,-3,1111,2455,20
105139098240,105139098245,5,5674,1576,20
105140385172,105140385166,-6,1106,2782,20
105140784402,105140784398,-4,934,2589,20
105143932454,105143932452,-2,1115,2437,20
105150077128,105150077136,8,2663,1425,20
105150688874,105150688870,-4,1051,2399,20
105150797086,105150797094,8,372,1188,20
105153693667,105153693662,-5,1738,4837,20
105155440530,105155440529,-1,922,1622,20
105161050667,105161050665,-2,680,2468,20
105164091482,105164091479,-3,1157,2229,20
105164498265,105164498267,2,805,1283,20
105167311578,105167311575,-3,807,1626,20
105168145368,105168145367,-1,1395,2302,20
105174216157,105174216154,-3,1300,1978,20
105177316883,105177316882,-1,1075,1507,20
105179785763,105179785762,-1,736,2096,20
105182377559,105182377553,-6,1025,2781,20
105185030079,105185030077,-2,1135,2030,20
105193853341,105193853340,-1,1114,3313,20
105195128654,105195128651,-3,888,1801,20
105195290584,105195290600,16,443,1515,20
105198654182,105198654178,-4,1578,2785,20
105200158709,105200158694,-15,189,1199,20
105201520790,105201520786,-4,748,2520,20
105202842322,105202842316,-6,909,4045,20
105204014258,105204014259,1,1107,1214,20
105204715779,105204715775,-4,1010,2199,20
105206657887,105206657883,-4,1011,2506,20
105207508267,105207508271,4,3880,2037,20
105214301847,105214301846,-1,1305,3141,20
105214876075,105214876073,-2,812,2128,20
105217559386,105217559383,-3,973,2091,20
105222745602,105222745599,-3,1161,2794,20
105223590057,105223590059,2,1365,770,20
105223926160,105223926175,15,343,1537,20
105225869059,105225869057,-2,848,2060,20
105226816269,105226816267,-2,1189,3217,20
105233361135,105233361130,-5,1034,2209,20
105234881691,105234881690,-1,1101,1790,20
105238276325,105238276323,-2,1155,1877,20
105244330090,105244330089,-1,1144,1827,20
105249611517,105249611515,-2,901,2468,20
105258221897,105258221894,-3,1009,2107,20
105262628266,105262628265,-1,1338,2025,20
105264612333,105264612337,4,2679,2261,20
105267554052,105267554051,-1,2543,4222,20
105268081492,105268081489,-3,1615,2968,20
105271214115,105271214112,-3,1009,2147,20
105282357830,105282357829,-1,1263,2232,20
105285677336,105285677339,3,1508,1339,20
105288463866,105288463863,-3,855,1516,20
105292442482,105292442478,-4,1066,2550,20
105294235554,105294235557,3,1447,1207,20
105294665903,105294665898,-5,431,1547,20
105296929908,105296929903,-5,853,2265,20
105303266153,105303266153,0,884,2617,20
105304012342,105304012337,-5,631,2445,20
105304842843,105304842835,-8,759,2529,20
105305060686,105305060675,-11,765,1661,20
105309687894,105309687892,-2,1412,2548,20
105311911229,105311911226,-3,1077,2256,20
105313240062,105313240059,-3,1163,2074,20
105315129572,105315129569,-3,1041,2631,20
105315925917,105315925938,21,558,1740,20
105317696236,105317696233,-3,993,1743,20
105318104038,105318104035,-3,1044,2455,20
105318532314,105318532310,-4,873,1872,20
105320535094,105320535091,-3,846,2390,20
105321731493,105321731487,-6,1065,2537,20
105323780173,105323780161,-12,1415,2568,20
105323867042,105323867038,-4,1322,1779,20
105325416886,105325416884,-2,1083,2233,20
105331756685,105331756679,-6,1039,2304,20
105331979435,105331979434,-1,1641,2168,20
105334919382,105334919379,-3,522,1359,20
105337603256,105337603253,-3,1109,2061,20
105338127937,105338127932,-5,1424,3508,20
105339679725,105339679721,-4,1166,3295,20
105339999113,105339999117,4,10690,27588,20
105350483735,105350483730,-5,1111,2757,20
105356897146,105356897145,-1,1248,2433,20
105359590295,105359590290,-5,1263,3285,20
105362059362,105362059359,-3,1133,1911,20
105362263814,105362263833,19,674,2507,20
105362372142,105362372138,-4,1307,2555,20
105366418203,105366418199,-4,1273,2443,20
105369770570,105369770566,-4,1138,2340,20
105373284637,105373284634,-3,1309,2311,20
105376752503,105376752498,-5,898,2577,20
105388117078,105388117081,3,1488,1165,20
105390103255,105390103251,-4,1179,2962,20
105392740034,105392740031,-3,1327,2578,20
105394002057,105394002055,-2,1577,2877,20
105400745007,105400745003,-4,1068,2341,20
105402744966,105402744966,0,1040,1682,20
105403168270,105403168270,0,1155,1703,20
105403880634,105403880629,-5,1461,2967,20
105407078019,105407078017,-2,1848,2256,20
105410293134,105410293134,0,1366,2139,20
105413317306,105413317303,-3,910,2886,20
105413558631,105413558629,-2,1313,2224,20
105417650399,105417650397,-2,1347,2365,20
105417967787,105417967784,-3,1071,2298,20
105421403541,105421403534,-7,1684,9185,20
105421632126,105421632126,0,1139,1415,20
105426029468,105426029466,-2,1143,2226,20
105427203651,105427203646,-5,1882,5553,20
105434576506,105434576504,-2,1142,1733,20
105436414876,105436414873,-3,780,1746,20
105436931191,105436931169,-22,601,7075,20
105439627413,105439627408,-5,1388,2139,20
105445058611,105445058609,-2,1756,2310,20
105450753446,105450753442,-4,1046,3062,20
105451032445,105451032461,16,419,2038,20
105453851535,105453851530,-5,1757,7307,20
105457632346,105457632345,-1,1178,2451,20
105459600318,105459600316,-2,1248,2152,20
105460968877,105460968874,-3,849,1896,20
105466078245,105466078240,-5,700,1797,20
105468693085,105468693082,-3,849,2171,20
105470540583,105470540578,-5,1358,1789,20
105470991341,105470991337,-4,1532,2119,20
105476340916,105476340909,-7,945,3948,20
105479632506,105479632503,-3,1024,1695,20
105479757494,105479757499,5,2426,1474,20
105480328698,105480328696,-2,1364,2395,20
105481331986,105481331983,-3,957,2104,20
105483149445,105483149441,-4,1020,1583,20
105483179137,105483179136,-1,922,2335,20
105486552452,105486552446,-6,1178,2457,20
105488632174,105488632168,-6,920,3880,20
105494717371,105494717369,-2,716,1673,20
105496305867,105496305865,-2,1188,1838,20
105503140606,105503140605,-1,1074,1318,20
105506610449,105506610452,3,1891,21877,20
105506765380,105506765379,-1,1234,2551,20
105509317035,105509317034,-1,1292,2987,20
105511512585,105511512581,-4,612,1684,20
105514238941,105514238939,-2,1123,1391,20
105514288308,105514288288,-20,1122,2665,20
105517707230,105517707226,-4,1517,2487,20
105523957757,105523957762,5,4266,2005,20
105528822293,105528822291,-2,1450,3203,20
105531378486,105531378482,-4,983,2493,20
105532689844,105532689841,-3,1393,3900,20
105534700898,105534700897,-1,1452,1937,20
105535576922,105535576919,-3,1316,2892,20
105536012287,105536012285,-2,1087,2158,20
105539910553,105539910550,-3,1392,2486,20
105541115575,105541115572,-3,1518,2616,20
105547820292,105547820287,-5,1818,1925,20
105549670066,105549670062,-4,839,2225,20
105549843510,105549843490,-20,313,862,20
105556376629,105556376631,2,2051,1044,20
105556811755,105556811753,-2,916,1167,20
105563643159,105563643153,-6,1378,3387,20
105566582506,105566582504,-2,1174,2436,20
105572393428,105572393425,-3,1131,2409,20
105573110242,105573110242,0,1558,1319,20
105574912214,105574912217,3,1948,1520,20
105577216413,105577216410,-3,1151,2512,20
105577352166,105577352164,-2,1589,3060,20
105577417999,105577417994,-5,1340,2780,20
105577713178,105577713173,-5,1148,1799,20
105578293159,105578293157,-2,1048,1959,20
105579318824,105579318838,14,857,1822,20
105582709818,105582709836,18,422,3145,20
105583997488,105583997486,-2,1287,2404,20
105585713518,105585713515,-3,1624,3692,20
105588642822,105588642817,-5,1268,2981,20
105588861534,105588861550,16,277,1254,20
105589639130,105589639126,-4,1432,2350,20
105590522294,105590522290,-4,970,2702,20
105591610465,105591610460,-5,973,2185,20
105600800801,105600800799,-2,2346,4939,20
105602617928,105602617925,-3,1162,2080,20
105602664557,105602664576,19,670,1771,20
105602973199,105602973196,-3,1124,2788,20
105603366232,105603366230,-2,1285,1873,20
105604100659,105604100656,-3,1139,3186,20
105604306573,105604306567,-6,833,1766,20
105604988478,105604988474,-4,1280,2329,20
105605030407,105605030384,-23,1172,2682,20
105605350974,105605350953,-21,922,2968,20
105606364661,105606364679,18,606,2323,20
105606974926,105606974922,-4,825,1970,20
105614389919,105614389913,-6,47325,19739,20
105617154225,105617154221,-4,1021,2675,20
105621863541,105621863538,-3,1601,1998,20
105625532576,105625532573,-3,1411,2837,20
105629244140,105629244146,6,1977,1268,20
105630816551,105630816545,-6,1085,3993,20
105632083594,105632083589,-5,1521,7632,20
105632613787,105632613783,-4,1233,2275,20
105638405523,105638405521,-2,1690,2620,20
105640577658,105640577652,-6,1047,2002,20
105641516654,105641516645,-9,1117,2031,20
105642067327,105642067321,-6,2350,7196,20
105644712707,105644712704,-3,1136,4016,20
105646659906,105646659913,7,3484,1278,20
105648332941,105648332938,-3,1259,2422,20
105649385730,105649385728,-2,1002,2889,20
105649751364,105649751355,-9,957,2006,20
105660296195,105660296193,-2,1365,3215,20
105661405163,105661405158,-5,1212,2388,20
105663148933,105663148931,-2,969,1085,20
105665784778,105665784778,0,1050,2110,20
105668402494,105668402490,-4,755,1692,20
105669837669,105669837666,-3,842,2061,20
105679300942,105679300938,-4,1078,2586,20
105680176378,105680176376,-2,1405,2140,20
105681421262,105681421260,-2,1285,2558,20
105681621049,105681621047,-2,956,1620,20
105682496023,105682496022,-1,1894,3520,20
105686694513,105686694511,-2,1617,2481,20
105691083451,105691083449,-2,881,2064,20
105698000889,105698000885,-4,1464,3029,20
105700223354,105700223353,-1,2190,2323,20
105701894992,105701894989,-3,1275,2544,20
105707537911,105707537909,-2,1497,2358,20
105710956740,105710956736,-4,1102,2117,20
105711079619,105711079618,-1,1605,1649,20
105712440693,105712440690,-3,1173,2793,20
105712608927,105712608925,-2,843,2205,20
105714400462,105714400467,5,2164,1431,20
105720970321,105720970318,-3,756,1516,20
105721480246,105721480266,20,285,991,20
105724593513,105724593510,-3,1362,2923,20
105725442945,105725442947,2,764,1344,20
105727752686,105727752682,-4,1242,3107,20
105728819277,105728819285,8,8449,2046,20
105731973050,105731973047,-3,1646,2293,20
105734320003,105734319999,-4,794,1989,20
105735294386,105735294382,-4,1503,2723,20
105735855896,105735855894,-2,991,2409,20
105738325287,105738325283,-4,825,2147,20
105738935541,105738935539,-2,1332,2315,20
105742130122,105742130118,-4,1261,2593,20
105743098211,105743098209,-2,1112,2298,20
105746007391,105746007385,-6,658,2859,20
105748739047,105748739044,-3,1123,1940,20
105756747982,105756747973,-9,611,2970,20
105757068982,105757068980,-2,1089,2661,20
105757194816,105757194798,-18,1163,2337,20
105758901526,105758901526,0,1198,1496,20
105764345143,105764345145,2,2005,1157,20
105765243125,105765243125,0,1312,1736,20
105773781079,105773781077,-2,1596,2161,20
105779703141,105779703135,-6,872,3786,20
105779801910,105779801913,3,2064,2510,20
105781049560,105781049553,-7,845,2740,20
105784648914,105784648912,-2,929,1863,20
105787438050,105787438048,-2,1061,1675,20
105789150854,105789150850,-4,845,1684,20
105794872123,105794872121,-2,873,2660,20
105797395310,105797395308,-2,761,1796,20
105797444634,105797444630,-4,1118,2064,20
105799096748,105799096746,-2,967,1789,20
105801188660,105801188662,2,7,407,20
105803662134,105803662131,-3,971,2579,20
105806855225,105806855228,3,35189,31432,20
105808142295,105808142294,-1,1075,1595,20
105813681666,105813681676,10,13639,48446,20
105814079301,105814079302,1,930,1128,20
105815281215,105815281212,-3,1037,1883,20
105818204111,105818204110,-1,1201,2845,20
105828884134,105828884129,-5,1239,3549,20
105830283587,105830283585,-2,1031,1638,20
105834304336,105834304351,15,839,1506,20
105834579646,105834579641,-5,1092,2765,20
105838774283,105838774282,-1,1092,1211,20
105841222432,105841222427,-5,1587,3300,20
105845128232,105845128229,-3,1493,2041,20
105849264637,105849264638,1,1917,2067,20
105853689555,105853689552,-3,1303,2773,20
105856743211,105856743206,-5,1226,2496,20
105859494985,105859494978,-7,1548,2220,20
105863218576,105863218573,-3,1334,2893,20
105865045215,105865045214,-1,1193,2257,20
105866628657,105866628653,-4,1758,2692,20
105868688927,105868688924,-3,1353,2319,20
105870067969,105870067966,-3,1225,2437,20
105871121914,105871121910,-4,910,1687,20
105881230188,105881230187,-1,1217,1811,20
105882850767,105882850766,-1,1274,2003,20
105883916902,105883916894,-8,1139,4542,20
105886253794,105886253792,-2,1510,3612,20
105888209550,105888209548,-2,1027,2133,20
105891678590,105891678587,-3,999,1900,20
105892063421,105892063416,-5,1099,3878,20
105894219774,105894219771,-3,1033,2306,20
105894929624,105894929638,14,1024,2823,20
105900493848,105900493838,-10,396,1188,20
105900837343,105900837342,-1,1407,2383,20
105901830555,105901830554,-1,884,1205,20
105902250069,105902250065,-4,1349,3290,20
105904351698,105904351695,-3,1020,2202,20
105906314101,105906314087,-14,249,1289,20
105906750166,105906750163,-3,947,1656,20
105908882695,105908882691,-4,979,2037,20
105911516862,105911516861,-1,1357,2725,20
105912748585,105912748582,-3,1370,2546,20
105913264813,105913264813,0,865,1733,20
105913917959,105913917955,-4,1225,3183,20
105916657427,105916657423,-4,751,1624,20
105917987524,105917987529,5,4081,2769,20
105918820091,105918820086,-5,692,2665,20
105922151637,105922151634,-3,1531,2768,20
105923536099,105923536095,-4,957,2292,20
105925455910,105925455906,-4,1197,2104,20
105926957031,105926957029,-2,1215,2195,20
105928032804,105928032800,-4,949,2218,20
105928509862,105928509858,-4,19576,67062,20
105931143234,105931143230,-4,1215,2493,20
105936505442,105936505458,16,16006,19731,20
105939168192,105939168191,-1,941,1673,20
105942199770,105942199766,-4,1477,2689,20
105944655471,105944655467,-4,1097,1772,20
105948117166,105948117165,-1,1316,2516,20
105948824699,105948824699,0,1499,1569,20
105972180538,105972180539,1,677,1820,20
105975521588,105975521585,-3,1131,2203,20
105977828914,105977828911,-3,1323,3081,20
105978794076,105978794073,-3,1299,3841,20
105983499082,105983499078,-4,1367,3877,20
105985503559,105985503557,-2,1089,2393,20
105985689687,105985689694,7,3721,1908,20
105985925674,105985925674,0,587,1298,20
105986271647,105986271642,-5,1022,3378,20
105987362095,105987362093,-2,866,2201,20
105992259947,105992259945,-2,1178,2570,20
105992848301,105992848298,-3,173,768,20
105995108903,105995108900,-3,929,2415,20
105996434118,105996434123,5,2696,2062,20
106000697858,106000697856,-2,1360,2300,20
106001834787,106001834786,-1,1066,2937,20
106004179420,106004179422,2,14068,11306,20
106007591612,106007591608,-4,1434,2813,20
106007984758,106007984779,21,719,1485,20
106009312538,106009312534,-4,1662,2641,20
106010398978,106010398976,-2,701,1519,20
106010753390,106010753388,-2,1169,2097,20
106012739133,106012739139,6,2963,1306,20
106016253737,106016253735,-2,1267,1916,20
106021062876,106021062879,3,1706,1183,20
106022002642,106022002638,-4,1332,2201,20
106023568269,106023568266,-3,1447,3673,20
106027482397,106027482394,-3,1253,2657,20
106029060068,106029060063,-5,1099,3529,20
106029392494,106029392503,9,32,668,20
106030139346,106030139342,-4,861,2661,20
106030668325,106030668305,-20,951,2077,20
106032226598,106032226603,5,3820,2125,20
106032632638,106032632633,-5,1218,3606,20
106042150871,106042150866,-5,1195,2912,20
106042590735,106042590741,6,2521,1792,20
106043140142,106043140140,-2,1297,2318,20
106043230725,106043230721,-4,869,1751,20
106046590535,106046590540,5,12148,21671,20
106047272331,106047272327,-4,1084,2487,20
106047742351,106047742349,-2,788,1548,20
106048906611,106048906608,-3,1139,3577,20
106049088393,106049088394,1,1385,2241,20
106053675724,106053675722,-2,1775,1879,20
106057267112,106057267110,-2,1536,3273,20
106058926299,106058926295,-4,1667,3598,20
106059529286,106059529285,-1,1357,1916,20
106060241906,106060241898,-8,1011,2377,20
106062518027,106062518025,-2,1038,3364,20
106064442558,106064442561,3,2579,1856,20
106065231895,106065231894,-1,1332,2662,20
106067266138,106067266135,-3,998,1926,20
106068504991,106068504989,-2,1243,2174,20
106068930385,106068930382,-3,769,3337,20
106069632646,106069632663,17,306,548,20
106072538964,106072538961,-3,840,1997,20
106073653394,106073653392,-2,956,2492,20
106074613004,106074613001,-3,1023,2998,20
106084836406,106084836401,-5,1145,2416,20
106085787136,106085787134,-2,1278,2572,20
106087148670,106087148667,-3,858,2539,20
106088434901,106088434922,21,1267,2809,20
106089665005,106089665013,8,2223,741,20
106089976560,106089976559,-1,1379,2191,20
106090569045,106090569066,21,206,864,20
106092398719,106092398718,-1,1057,1654,20
106094481314,106094481310,-4,1309,2787,20
106094526574,106094526573,-1,1433,1935,20
106097136600,106097136607,7,3809,1339,20
106098258155,106098258152,-3,1507,2541,20
106101815075,106101815073,-2,777,1395,20
106106617499,106106617497,-2,1556,3185,20
106114531509,106114531514,5,4469,2207,20
106118340313,106118340310,-3,1232,2718,20
106120021532,106120021551,19,886,1172,20
106120056305,106120056326,21,1753,1237,20
106131421433,106131421429,-4,1351,2598,20
106138082779,106138082776,-3,1048,1862,20
106140099840,106140099838,-2,844,1739,20
106142607911,106142607907,-4,888,2759,20
106145809615,106145809611,-4,970,2083,20
106146600214,106146600214,0,1117,2187,20
106147413888,106147413885,-3,1263,2187,20
106156946135,106156946131,-4,1156,2092,20
106157582602,106157582601,-1,1308,2421,20
106161189336,106161189332,-4,1413,2476,20
106161352954,106161352953,-1,1503,2801,20
106161816776,106161816775,-1,1450,2728,20
106163246330,106163246328,-2,1018,3452,20
106163385513,106163385514,1,1712,1653,20
106163899267,106163899263,-4,1274,2609,20
106168169459,106168169457,-2,1091,2434,20
106170808714,106170808710,-4,1114,1670,20
106171527780,106171527777,-3,861,2352,20
106178998810,106178998809,-1,892,1700,20
106180155702,106180155695,-7,941,1095,20
106182295049,106182295043,-6,1169,5454,20
106182709010,106182709005,-5,1289,2192,20
106186171932,106186171929,-3,1231,3172,20
106191540716,106191540711,-5,895,1857,20
106192353479,106192353477,-2,894,2086,20
106195015312,106195015309,-3,1216,2503,20
106197353722,106197353718,-4,881,2776,20
106202088126,106202088129,3,1249,1186,20
106203138802,106203138798,-4,1305,2258,20
106206075018,106206075014,-4,1177,1490,20
106210213954,106210213950,-4,1241,3411,20
106212333713,106212333723,10,13394,43386,20
106212546852,106212546849,-3,1232,2642,20
106213225885,106213225881,-4,1261,2490,20
106213984282,106213984287,5,4723,2892,20
106214218354,106214218353,-1,902,2403,20
106218288689,106218288685,-4,1355,2135,20
106219140806,106219140819,13,664,1758,20
106221140874,106221140871,-3,894,1862,20
106228331806,106228331806,0,1147,2498,20
106232682142,106232682139,-3,1134,2075,20
106234301086,106234301085,-1,1115,1982,20
106234632407,106234632406,-1,793,2528,20
106237118025,106237118026,1,1383,1844,20
106238073617,106238073614,-3,1056,2418,20
106238589683,106238589680,-3,1319,2596,20
106244150925,106244150922,-3,1482,3079,20
106246187570,106246187569,-1,1557,2845,20
106250392983,106250392977,-6,1183,2027,20
106256830902,106256830898,-4,1052,2263,20
106257380674,106257380670,-4,938,2334,20
106260792166,106260792163,-3,978,2031,20
106267225553,106267225546,-7,1152,3129,20
106273663147,106273663146,-1,1165,2097,20
106277931682,106277931677,-5,1021,1827,20
106280156518,106280156514,-4,1415,2721,20
106289155311,106289155305,-6,1089,2400,20
106290388262,106290388267,5,1884,1005,20
106291140273,106291140270,-3,1262,2801,20
106300535679,106300535674,-5,827,2244,20
106304882430,106304882427,-3,1015,1923,20
106309509180,106309509180,0,1590,1282,20
106317049644,106317049641,-3,1189,3013,20
106318787515,106318787511,-4,986,2407,20
106320545829,106320545833,4,1971,1762,20
106325047890,106325047885,-5,1082,3344,20
106325545493,106325545494,1,1101,2189,20
106326055871,106326055869,-2,1110,1669,20
106328871890,106328871886,-4,632,1486,20
106329940187,106329940185,-2,1020,2350,20
106335306733,106335306731,-2,963,1974,20
106335557150,106335557147,-3,1009,1952,20
106337350802,106337350800,-2,1680,2365,20
106337678293,106337678288,-5,660,2811,20
106338196567,106338196566,-1,1592,2669,20
106340181277,106340181277,0,543,814,20
106340801511,106340801528,17,1167,3126,20
106341867762,106341867762,0,924,1256,20
106348290291,106348290289,-2,850,1144,20
106351394810,106351394807,-3,808,2215,20
106355792843,106355792841,-2,1213,2139,20
106356532319,106356532316,-3,1051,2253,20
106359819256,106359819253,-3,1176,1639,20
106364459646,106364459643,-3,934,2148,20
106365659488,106365659486,-2,740,1159,20
106366982126,106366982124,-2,1641,1772,20
106376187586,106376187582,-4,743,2026,20
106382702994,106382702993,-1,905,2026,20
106382991906,106382991905,-1,38457,18815,20
106383468214,106383468211,-3,1223,2398,20
106387212600,106387212597,-3,1829,3264,20
106391890401,106391890398,-3,1037,2257,20
106395415395,106395415395,0,1341,2094,20
106396573644,106396573641,-3,1209,2379,20
106397425862,106397425879,17,794,2132,20
106398635085,106398635079,-6,580,1378,20
106399013830,106399013817,-13,875,1238,20
106402316282,106402316281,-1,1445,2318,20
106407163917,106407163919,2,1188,1158,20
106407757268,106407757289,21,714,1663,20
106410757846,106410757843,-3,2550,4730,20
106413096828,106413096822,-6,284,1306,20
106414046694,106414046682,-12,1035,3559,20
106417070613,106417070617,4,2991,1227,20
106420987391,106420987389,-2,1147,2588,20
106421108950,106421108964,14,190,716,20
106422787986,106422787985,-1,743,1756,20
106425283613,106425283610,-3,1318,1831,20
106425438780,106425438778,-2,1007,1951,20
106426773214,106426773213,-1,905,2055,20
106430443514,106430443510,-4,1468,2471,20
106438272214,106438272210,-4,911,1831,20
106438311404,106438311426,22,1010,2003,20
106439321630,106439321629,-1,1188,1998,20
106442375870,106442375866,-4,612,1567,20
106445207931,106445207926,-5,1075,2739,20
106446114278,106446114274,-4,684,1485,20
106447603791,106447603789,-2,613,1422,20
106450539198,106450539196,-2,956,2196,20
106450927409,106450927407,-2,1414,3123,20
106458573524,106458573521,-3,1053,2747,20
106459058183,106459058177,-6,960,2264,20
106460035263,106460035259,-4,1246,2174,20
106460560260,106460560258,-2,1109,3000,20
106462329600,106462329594,-6,1280,1975,20
106465568515,106465568511,-4,1094,1962,20
106470786099,106470786102,3,1635,1440,20
106472091863,106472091862,-1,1227,2408,20
106472393330,106472393328,-2,918,1801,20
106475127462,106475127474,12,238,1266,20
106475731345,106475731342,-3,1226,2377,20
106477643042,106477643037,-5,1006,3871,20
106480756469,106480756465,-4,2262,4878,20
106483319860,106483319854,-6,435,2262,20
106485514950,106485514946,-4,1170,2609,20
106486364130,106486364124,-6,1209,3536,20
106488032405,106488032402,-3,1150,2265,20
106489927217,106489927215,-2,1125,1488,20
106490620073,106490620070,-3,1130,1933,20
106502432078,106502432075,-3,625,1408,20
106507785485,106507785480,-5,1189,2323,20
106508101994,106508101990,-4,598,1495,20
106511514602,106511514599,-3,1623,2352,20
106519907086,106519907085,-1,1132,2588,20
106521297642,106521297661,19,544,1632,20
106521542290,106521542286,-4,1357,1543,20
106522850569,106522850565,-4,856,1778,20
106525484679,106525484673,-6,926,1529,20
106526998146,106526998143,-3,1046,2311,20
106527943919,106527943922,3,1393,1266,20
106529462679,106529462677,-2,999,2466,20
106532791483,106532791478,-5,1314,2598,20
106536374408,106536374406,-2,1527,2304,20
106536799102,106536799099,-3,1182,1941,20
106541664983,106541664988,5,1246,1533,20
106544335962,106544335958,-4,1180,2277,20
106544865555,106544865554,-1,1173,2008,20
106547855267,106547855264,-3,1514,3324,20
106548392650,106548392653,3,2238,1248,20
106550799218,106550799217,-1,1371,2906,20
106559262063,106559262060,-3,1151,2044,20
106559626695,106559626687,-8,949,3051,20
106560103806,106560103806,0,1182,2288,20
106564647595,106564647593,-2,1223,2770,20
106565091445,106565091441,-4,861,1678,20
106568094577,106568094575,-2,968,2844,20
106568455607,106568455625,18,577,9189,20
106570754419,106570754426,7,2115,1104,20
106574432449,106574432448,-1,1374,2278,20
106579367403,106579367396,-7,1256,5646,20
106580138311,106580138307,-4,947,3041,20
106583584319,106583584316,-3,927,2295,20
106585202958,106585202957,-1,766,1215,20
106591898896,106591898894,-2,1209,2794,20
106594506045,106594506041,-4,1019,1876,20
106598026119,106598026115,-4,993,2023,20
106601780615,106601780614,-1,838,2159,20
106603685994,106603685990,-4,1044,2416,20
106611803743,106611803738,-5,1113,2371,20
106613895614,106613895612,-2,1073,2535,20
106614488666,106614488670,4,1973,1376,20
106614640679,106614640682,3,3864,3234,20
106616574794,106616574790,-4,1245,2584,20
106618939656,106618939658,2,73,1346,20
106620390867,106620390865,-2,1346,3590,20
106622740346,106622740343,-3,1123,2321,20
106626484741,106626484735,-6,1827,3275,20
106629657722,106629657725,3,4817,24604,20
106630022722,106630022719,-3,1686,2645,20
106645465151,106645465147,-4,1162,1676,20
106656235476,106656235473,-3,1280,3106,20
106663782783,106663782780,-3,910,2049,20
106667849575,106667849572,-3,854,2413,20
106680404399,106680404396,-3,892,1491,20
106684286073,106684286070,-3,1570,2457,20
106684745810,106684745806,-4,1230,2565,20
106686930418,106686930421,3,1599,2231,20
106687548846,106687548843,-3,1062,1754,20
106696200393,106696200389,-4,1232,2908,20
106701899553,106701899550,-3,1354,2149,20
106703794067,106703794065,-2,1217,3283,20
106708283654,106708283653,-1,1067,1610,20
106709888331,106709888329,-2,1037,1395,20
106713825399,106713825397,-2,864,2516,20
106714112963,106714112963,0,1056,1648,20
106714926945,106714926951,6,2306,965,20
106715406108,106715406105,-3,1175,2485,20
106715658254,106715658250,-4,1074,2569,20
106721250453,106721250451,-2,1579,2811,20
106721809389,106721809387,-2,1487,2929,20
106725386939,106725386934,-5,917,2642,20
106725419551,106725419551,0,246,950,20
106726373448,106726373445,-3,697,2316,20
106726677702,106726677698,-4,1363,2448,20
106731647490,106731647489,-1,1726,2638,20
106732695435,106732695432,-3,929,2210,20
106734159941,106734159937,-4,1286,2259,20
106737964377,106737964394,17,1001,1516,20
106739143646,106739143642,-4,1454,2385,20
106740451971,106740451969,-2,895,2295,20
106741102818,106741102813,-5,1109,2668,20
106743317126,106743317144,18,471,1509,20
106749554698,106749554694,-4,1434,2502,20
106751894162,106751894157,-5,1225,2263,20
106756836774,106756836773,-1,1162,2343,20
106758948085,106758948088,3,1322,1662,20
106764226635,106764226633,-2,1032,3108,20
106764912810,106764912804,-6,2317,5516,20
106764979607,106764979601,-6,956,1866,20
106768112938,106768112944,6,4587,2126,20
106768596750,106768596754,4,1174,907,20
106769136659,106769136657,-2,1184,2090,20
106778088550,106778088549,-1,681,2442,20
106783946302,106783946298,-4,1162,2442,20
106787566549,106787566544,-5,1724,4023,20
106788945374,106788945371,-3,1300,2307,20
106793262036,106793262033,-3,1253,2540,20
106793348622,106793348621,-1,894,1532,20
106794933829,106794933829,0,3025,4276,20
106795049538,106795049534,-4,1017,1963,20
106795756462,106795756458,-4,913,2011,20
106797640126,106797640125,-1,932,1396,20
106799342324,106799342320,-4,1126,2887,20
106800913062,106800913058,-4,878,2465,20
106801554239,106801554237,-2,1098,2807,20
106806163994,106806163999,5,4548,2983,20
106812394342,106812394340,-2,954,2582,20
106814308558,106814308555,-3,322,966,20
106818267618,106818267616,-2,2432,4570,20
106819151697,106819151694,-3,1119,2196,20
106838512127,106838512123,-4,1163,2354,20
106843316000,106843315998,-2,1111,1685,20
106844034746,106844034745,-1,1358,2206,20
106844317054,106844317038,-16,874,2558,20
106848159470,106848159466,-4,1113,2116,20
106849137156,106849137141,-15,1068,2520,20
106851202153,106851202154,1,991,927,20
106854470583,106854470589,6,1615,1002,20
106858354797,106858354793,-4,1072,2859,20
106860680961,106860680959,-2,1314,2461,20
106861491826,106861491823,-3,1337,2129,20
106861596148,106861596170,22,509,1275,20
106862417020,106862417018,-2,1166,2308,20
106863037303,106863037282,-21,758,1400,20
106864749178,106864749172,-6,1539,7987,20
106865797119,106865797118,-1,992,1478,20
106866753293,106866753294,1,1523,1225,20
106869715493,106869715490,-3,1219,1881,20
106872553223,106872553210,-13,1799,2359,20
106872726601,106872726598,-3,1248,2274,20
106877894419,106877894417,-2,1473,3250,20
106878337094,106878337095,1,1928,1840,20
106881652717,106881652716,-1,2597,3899,20
106887981568,106887981564,-4,1476,2519,20
106889979599,106889979598,-1,848,1277,20
106890407370,106890407366,-4,1076,2654,20
106891382796,106891382793,-3,43,644,20
106896084507,106896084504,-3,821,2780,20
106896194832,106896194845,13,794,4092,20
106896912783,106896912789,6,3454,1490,20
106897170084,106897170079,-5,1211,2501,20
106904731242,106904731241,-1,1438,1942,20
106911433574,106911433571,-3,1133,2905,20
106912689363,106912689362,-1,1435,2554,20
106913654503,106913654502,-1,918,1659,20
106914259654,106914259651,-3,1202,2418,20
106914803382,106914803380,-2,1170,1937,20
106919388974,106919388972,-2,1080,2413,20
106920428302,106920428299,-3,556,1323,20
106928758982,106928758980,-2,1014,2216,20
106928905882,106928905885,3,1091,1473,20
106933944658,106933944657,-1,1418,2566,20
106936336951,106936336947,-4,1132,2068,20
106942840480,106942840476,-4,1025,1899,20
106944915994,106944915990,-4,870,2347,20
106945878511,106945878507,-4,1029,3414,20
106947941475,106947941472,-3,1019,2059,20
106950078739,106950078743,4,1263,1282,20
106952347119,106952347100,-19,798,1847,20
106955329015,106955329017,2,1728,2141,20
106956852104,106956852097,-7,758,2073,20
106959452879,106959452878,-1,918,2183,20
106963777986,106963777981,-5,1174,3188,20
106964855819,106964855816,-3,1174,2537,20
106972529259,106972529255,-4,762,1317,20
106972692044,106972692034,-10,681,2417,20
106973215221,106973215206,-15,1140,2204,20
106974861175,106974861170,-5,823,2201,20
106975614129,106975614130,1,2164,2230,20
106979765272,106979765283,11,14151,22471,20
106981032713,106981032709,-4,1770,2879,20
106984013741,106984013739,-2,1208,1990,20
106986934358,106986934355,-3,1027,2210,20
106989194958,106989194957,-1,1827,2617,20
106990100409,106990100405,-4,1469,4945,20
106990202064,106990202061,-3,1025,2748,20
106991268439,106991268437,-2,864,1824,20
106999280774,106999280770,-4,961,1583,20
107000768163,107000768161,-2,1062,1812,20
107001393887,107001393885,-2,1854,2678,20
107002223174,107002223171,-3,1650,2863,20
107002649222,107002649220,-2,1352,2552,20
107003450166,107003450163,-3,782,2030,20
107003840721,107003840716,-5,1209,1408,20
107008942830,107008942825,-5,1224,2850,20
107013543787,107013543785,-2,1062,2440,20
107014195779,107014195777,-2,661,1594,20
107014266949,107014266947,-2,1245,1883,20
107021412887,107021412885,-2,1321,2800,20
107029192077,107029192073,-4,1307,2955,20
107032279599,107032279601,2,1133,2074,20
107035942466,107035942464,-2,1163,2246,20
107037255134,107037255131,-3,957,1976,20
107037564326,107037564342,16,1260,1898,20
107039078259,107039078258,-1,1068,2453,20
107039586046,107039586045,-1,917,2494,20
107042070914,107042070913,-1,1199,2942,20
107043066266,107043066262,-4,1044,2470,20
107043619496,107043619494,-2,1116,2317,20
107047611494,107047611486,-8,1172,2580,20
107049487743,107049487738,-5,752,2081,20
107050039603,107050039602,-1,818,1857,20
107052279490,107052279485,-5,1275,2884,20
107056080886,107056080883,-3,1561,2219,20
107062476918,107062476916,-2,2600,3220,20
107072112890,107072112887,-3,1234,1868,20
107078938805,107078938799,-6,966,2954,20
107080413857,107080413854,-3,923,2268,20
107080767028,107080767035,7,1312,591,20
107091617841,107091617838,-3,2529,3924,20
107095131989,107095131985,-4,1177,3286,20
107099449282,107099449262,-20,659,633,20
107108880170,107108880189,19,583,1483,20
107110967377,107110967375,-2,950,2257,20
107119625616,107119625614,-2,1098,3175,20
107119904397,107119904395,-2,1340,2910,20
107122166134,107122166130,-4,1465,2962,20
107124353647,107124353642,-5,1162,1531,20
107126469037,107126469033,-4,1003,2174,20
107128517337,107128517336,-1,2071,2259,20
107131564054,107131564050,-4,1327,4258,20
107132027319,107132027316,-3,1293,1966,20
107140304351,107140304346,-5,677,1673,20
107145639067,107145639066,-1,807,1649,20
107148185690,107148185687,-3,1173,2605,20
107149109558,107149109555,-3,1273,2485,20
107156924570,107156924566,-4,1205,2087,20
107159785610,107159785609,-1,1281,2215,20
107162633081,107162633079,-2,868,1400,20
107165770506,107165770503,-3,1183,2172,20
107166440251,107166440247,-4,952,2096,20
107166886345,107166886342,-3,1400,2629,20
107171753260,107171753256,-4,666,2204,20
107172068789,107172068810,21,1330,2359,20
107175954103,107175954102,-1,1041,2535,20
107182710697,107182710693,-4,1167,3381,20
107186500042,107186500037,-5,1315,2032,20
107187009198,107187009186,-12,259,1205,20
107196291662,107196291660,-2,1349,2338,20
107198779279,107198779277,-2,781,1675,20
107201535534,107201535530,-4,802,2350,20
107206723930,107206723932,2,2212,1852,20
107207123190,107207123187,-3,1007,1284,20
107207516392,107207516390,-2,1404,2277,20
107216284182,107216284178,-4,829,1697,20
107218482131,107218482128,-3,977,2334,20
107229115928,107229115933,5,2436,1397,20
107232569815,107232569814,-1,1137,2183,20
107234196672,107234196689,17,675,1265,20
107235160886,107235160883,-3,1037,1858,20
107235276018,107235276013,-5,1186,1887,20
107235426578,107235426574,-4,1528,2058,20
107242584031,107242584029,-2,1060,1834,20
107255410951,107255410930,-21,1399,2924,20
107257803869,107257803865,-4,909,2214,20
107258514487,107258514480,-7,2010,9411,20
107262363551,107262363550,-1,1132,2220,20
107265646776,107265646772,-4,1795,3819,20
107266447158,107266447156,-2,1179,2003,20
107277116045,107277116039,-6,834,1862,20
107280620195,107280620194,-1,1925,2108,20
107288866142,107288866139,-3,743,1650,20
107289691369,107289691366,-3,1184,3763,20
107290137035,107290137031,-4,710,1604,20
107291859389,107291859386,-3,1268,2530,20
107295655110,107295655107,-3,1825,3229,20
107297092096,107297092093,-3,1378,2600,20
107298098391,107298098370,-21,1127,2501,20
107298369286,107298369282,-4,1132,4659,20
107306628890,107306628884,-6,565,1535,20
107313395946,107313395942,-4,688,1541,20
107319885588,107319885582,-6,858,2031,20
107326134988,107326134986,-2,1192,1451,20
107326595768,107326595782,14,270,939,20
107327218959,107327218958,-1,1345,2092,20
107328673495,107328673494,-1,1664,2659,20
107330939542,107330939540,-2,1094,1688,20
107338033334,107338033330,-4,1552,3719,20
107338155829,107338155829,0,937,2061,20
107339744355,107339744354,-1,1013,2173,20
107343577182,107343577182,0,1130,1180,20
107346929361,107346929357,-4,981,2100,20
107348935450,107348935449,-1,1010,1555,20
107351954733,107351954730,-3,1010,1937,20
107352267135,107352267130,-5,1178,1876,20
107352669499,107352669497,-2,1310,2349,20
107354780682,107354780689,7,3317,1625,20
107365996062,107365996059,-3,1033,2609,20
107372033208,107372033206,-2,1709,3072,20
107375157920,107375157917,-3,1306,2843,20
107377045201,107377045198,-3,1624,2797,20
107377385769,107377385766,-3,819,2486,20
107380662843,107380662850,7,13394,5824,20
107386339597,107386339593,-4,1136,1750,20
107387304250,107387304249,-1,1286,2399,20
107390255170,107390255166,-4,1905,3076,20
107390466964,107390466950,-14,1009,2384,20
107391193516,107391193533,17,247,764,20
107397107319,107397107317,-2,555,2182,20
107398896191,107398896190,-1,988,1572,20
107404811645,107404811642,-3,1144,2877,20
107409854399,107409854396,-3,1294,1821,20
107416873998,107416873997,-1,990,1745,20
107417393238,107417393227,-11,789,1814,20
107424392792,107424392790,-2,903,2368,20
107427623723,107427623722,-1,1026,2761,20
107428245312,107428245309,-3,1846,3006,20
107431038751,107431038749,-2,1286,4459,20
107431488658,107431488658,0,1657,1651,20
107431819316,107431819307,-9,18219,25453,20
107431978023,107431978019,-4,1484,3313,20
107432135286,107432135281,-5,1331,2696,20
107433451323,107433451320,-3,1087,2252,20
107434420474,107434420472,-2,1341,2530,20
107438138044,107438138039,-5,1265,2769,20
107441061681,107441061677,-4,1358,2492,20
107451185741,107451185742,1,14276,13539,20
107453867390,107453867388,-2,1333,3071,20
107456512879,107456512877,-2,1515,2541,20
107456814294,107456814290,-4,1277,2574,20
107457175508,107457175505,-3,996,2774,20
107462311059,107462311058,-1,960,1403,20
107462370786,107462370782,-4,1304,2404,20
107466872392,107466872406,14,328,1457,20
107469331322,107469331326,4,1317,1244,20
107471319374,107471319371,-3,2118,4332,20
107471997076,107471997074,-2,1383,1555,20
107474794297,107474794294,-3,1169,2198,20
107476276471,107476276459,-12,40516,15051,20
107479754207,107479754204,-3,1349,2658,20
107480332118,107480332114,-4,1239,2056,20
107483838059,107483838053,-6,1012,2903,20
107488180766,107488180764,-2,551,1529,20
107492035388,107492035388,0,1424,2036,20
107493379378,107493379374,-4,779,2109,20
107494476205,107494476202,-3,1229,3444,20
107495920112,107495920109,-3,1511,2260,20
107496082759,107496082757,-2,1264,1836,20
107496647070,107496647068,-2,901,1678,20
107501561567,107501561566,-1,1196,1887,20
107503146738,107503146735,-3,2076,4069,20
107509289203,107509289199,-4,738,1161,20
107510459421,107510459419,-2,1090,1905,20
107517107698,107517107695,-3,1072,2195,20
107519530579,107519530586,7,151,903,20
107520689829,107520689827,-2,1430,3207,20
107522769749,107522769746,-3,1215,2643,20
107524567633,107524567629,-4,1194,1861,20
107527731877,107527731873,-4,1091,2531,20
107528962235,107528962231,-4,995,1986,20
107529509022,107529509002,-20,736,1478,20
107531663121,107531663121,0,1235,2152,20
107535230233,107535230232,-1,1194,1622,20
107535835531,107535835530,-1,1242,2104,20
107536997220,107536997223,3,9864,8826,20
107537853809,107537853807,-2,1223,1845,20
107540030428,107540030434,6,3274,1867,20
107541859678,107541859677,-1,1364,2614,20
107542218307,107542218304,-3,1053,2535,20
107545292295,107545292294,-1,1207,1816,20
107547398387,107547398385,-2,1198,1441,20
107548508742,107548508741,-1,1508,1814,20
107549998431,107549998429,-2,1635,1891,20
107555216473,107555216470,-3,1560,1858,20
107562038641,107562038638,-3,1018,2078,20
107562359784,107562359795,11,120,1315,20
107564944027,107564944022,-5,814,2344,20
107567785939,107567785936,-3,1110,3055,20
107571722990,107571722989,-1,1091,2176,20
107572300778,107572300774,-4,1051,2163,20
107576560547,107576560546,-1,666,2121,20
107579531937,107579531934,-3,664,1808,20
107587509654,107587509654,0,1029,1643,20
107588036189,107588036206,17,37,1186,20
107589612057,107589612052,-5,986,2283,20
107591309731,107591309725,-6,952,2508,20
107591745690,107591745686,-4,1421,2168,20
107596992623,107596992618,-5,1408,4964,20
107598368487,107598368484,-3,935,2621,20
107605362278,107605362273,-5,1339,2820,20
107605692635,107605692630,-5,796,1705,20
107606646126,107606646122,-4,1015,2330,20
107608619074,107608619070,-4,1046,2331,20
107609633808,107609633805,-3,1079,2460,20
107612574820,107612574823,3,1886,1882,20
107612807503,107612807501,-2,809,2136,20
107613756487,107613756507,20,279,1163,20
107616843806,107616843802,-4,1006,1885,20
107617716169,107617716167,-2,1261,2054,20
107631144349,107631144346,-3,1198,1742,20
107633200779,107633200774,-5,1243,3530,20
107636212968,107636212966,-2,909,2386,20
107638239062,107638239061,-1,1092,3094,20
107640127743,107640127758,15,720,2490,20
107644037147,107644037144,-3,1272,2834,20
107645998727,107645998733,6,2341,1421,20
107648211356,107648211354,-2,1142,2745,20
107650352521,107650352518,-3,1231,2182,20
107651218962,107651218958,-4,986,2443,20
107656425875,107656425871,-4,1384,2128,20
107670343566,107670343565,-1,1171,2307,20
107671067143,107671067146,3,272,758,20
107672711954,107672711957,3,5614,4773,20
107680970150,107680970149,-1,1482,2031,20
107685671847,107685671842,-5,975,2497,20
107689678119,107689678118,-1,1039,2211,20
107692528960,107692528958,-2,1241,2559,20
107694781652,107694781650,-2,1204,2211,20
107695616355,107695616354,-1,944,2734,20
107697155409,107697155405,-4,24572,11603,20
107698571277,107698571274,-3,1496,2149,20
107699303543,107699303563,20,387,1011,20
107706303035,107706303029,-6,947,2536,20
107707295405,107707295398,-7,587,9282,20
107709352627,107709352626,-1,756,2354,20
107709408997,107709408993,-4,1080,1942,20
107710296405,107710296400,-5,768,2630,20
107713786770,107713786766,-4,1017,2646,20
107713988245,107713988242,-3,69,909,20
107721263062,107721263060,-2,722,2054,20
107729831121,107729831118,-3,1305,3401,20
107731259766,107731259747,-19,984,2461,20
107736248873,107736248868,-5,883,1907,20
107740360317,107740360315,-2,1119,2711,20
107740664618,107740664617,-1,921,2088,20
107740705341,107740705358,17,744,1429,20
107742055890,107742055885,-5,1214,2844,20
107743090618,107743090618,0,1130,2163,20
107744588623,107744588623,0,1069,1341,20
107744951862,107744951862,0,1736,2702,20
107756898789,107756898785,-4,1251,2442,20
107760955675,107760955670,-5,970,1595,20
107763640088,107763640085,-3,1536,3260,20
107763717477,107763717473,-4,1223,2996,20
107772517516,107772517513,-3,1300,2517,20
107777754018,107777754015,-3,663,2642,20
107780188250,107780188243,-7,914,3047,20
107790362951,107790362949,-2,999,2403,20
107790696447,107790696445,-2,1294,3038,20
107792052122,107792052118,-4,1151,2981,20
107795796986,107795796990,4,4416,3231,20
107796058261,107796058265,4,1529,856,20
107801195045,107801195042,-3,1319,2680,20
107801491834,107801491832,-2,1196,3256,20
107807834910,107807834909,-1,1283,3293,20
107810616101,107810616098,-3,1128,1951,20
107812789100,107812789104,4,4906,23575,20
107820834361,107820834355,-6,2143,6506,20
107825235141,107825235138,-3,970,2329,20
107828966362,107828966364,2,2018,1948,20
107832453479,107832453473,-6,1177,2450,20
107850883921,107850883918,-3,819,2296,20
107851223858,107851223862,4,2083,1389,20
107853900995,107853900990,-5,1056,2506,20
107856056721,107856056718,-3,1335,2665,20
107857488754,107857488752,-2,1117,2265,20
107861325835,107861325831,-4,1235,2051,20
107861881499,107861881496,-3,1115,2315,20
107862274780,107862274797,17,881,2492,20
107864411542,107864411538,-4,1179,2167,20
107866269650,107866269647,-3,855,1979,20
107866707497,107866707484,-13,1559,469,20
107867958510,107867958506,-4,1046,2700,20
107872801695,107872801696,1,25607,19497,20
107875914085,107875914081,-4,746,2089,20
107878342158,107878342154,-4,871,2383,20
107879272817,107879272800,-17,1039,2584,20
107880729805,107880729801,-4,850,2181,20
107882943565,107882943563,-2,1326,2014,20
107883793357,107883793355,-2,1304,2521,20
107887790079,107887790082,3,4052,2817,20
107895033234,107895033233,-1,1492,2731,20
107895671966,107895671964,-2,832,2044,20
107898372574,107898372570,-4,1257,3008,20
107898574886,107898574881,-5,995,2600,20
107899726980,107899726979,-1,17884,7920,20
107901336205,107901336203,-2,1088,2566,20
107902047080,107902047078,-2,1155,1395,20
107904392294,107904392290,-4,1244,2765,20
107906167669,107906167666,-3,1058,2466,20
107906934510,107906934507,-3,1020,2076,20
107907983687,107907983684,-3,829,2809,20
107913144070,107913144070,0,398,1322,20
107917415032,107917415028,-4,1148,2180,20
107920374231,107920374228,-3,909,2454,20
107923790350,107923790354,4,2866,1688,20
107923858515,107923858514,-1,2568,3542,20
107928985037,107928985038,1,1372,1898,20
107929185063,107929185061,-2,851,2918,20
107930752251,107930752249,-2,1185,2837,20
107933935672,107933935669,-3,1007,2676,20
107934396102,107934396101,-1,972,2340,20
107939124705,107939124705,0,1368,2381,20
107941812113,107941812109,-4,1441,2597,20
107941871461,107941871446,-15,922,1819,20
107942531676,107942531662,-14,386,1007,20
107948634587,107948634585,-2,1351,3742,20
107949682772,107949682769,-3,1132,2256,20
107950247755,107950247750,-5,833,2710,20
107951322039,107951322035,-4,1432,3682,20
107954187350,107954187346,-4,704,1204,20
107956363512,107956363519,7,2574,957,20
107959553973,107959553969,-4,1206,5100,20
107965900337,107965900333,-4,1100,2686,20
107966714474,107966714472,-2,1321,2255,20
107977006391,107977006390,-1,1358,1939,20
107983609525,107983609522,-3,1246,3775,20
107985469905,107985469903,-2,1254,2617,20
107988441757,107988441754,-3,952,1972,20
107993382779,107993382774,-5,1121,2566,20
107998449193,107998449191,-2,1175,2625,20
108004753357,108004753354,-3,1162,2090,20
108006703397,108006703395,-2,949,2014,20
108007402683,108007402683,0,1319,1602,20
108010212276,108010212271,-5,1242,2827,20
108010509950,108010509936,-14,680,2066,20
108011068654,108011068651,-3,1057,2446,20
108015815687,108015815683,-4,1167,2152,20
108016165473,108016165470,-3,1506,3093,20
108016296254,108016296254,0,1441,1998,20
108022946721,108022946719,-2,29547,12767,20
108023931974,108023931981,7,8937,3344,20
108025755632,108025755631,-1,2301,1989,20
108032396746,108032396742,-4,965,2163,20
108039301694,108039301691,-3,1436,2978,20
108040335946,108040335944,-2,997,2598,20
108041573083,108041573081,-2,1191,2478,20
108048470184,108048470187,3,2223,1654,20
108052132834,108052132833,-1,986,2295,20
108059130411,108059130408,-3,1488,2055,20
108064651090,108064651086,-4,738,2105,20
108073422250,108073422246,-4,695,2050,20
108073997160,108073997157,-3,1010,2264,20
108074312048,108074312045,-3,870,1853,20
108074984261,108074984283,22,417,2895,20
108076986570,108076986569,-1,1151,1756,20
108078612428,108078612425,-3,1448,2581,20
108080295430,108080295443,13,919,2351,20
108080769327,108080769321,-6,353,1697,20
108090434910,108090434909,-1,1188,2482,20
108091625502,108091625498,-4,1134,3114,20
108096906133,108096906129,-4,1000,2351,20
108100311706,108100311713,7,2964,1250,20
108102930913,108102930913,0,1187,1697,20
108105809285,108105809281,-4,1223,2044,20
108107390067,108107390066,-1,1405,2440,20
108110005716,108110005725,9,11567,31773,20
108113239510,108113239505,-5,1257,3743,20
108114142621,108114142618,-3,1344,2258,20
108122743027,108122743025,-2,927,2311,20
108123414906,108123414904,-2,1034,2997,20
108129587582,108129587581,-1,1098,2277,20
108151609482,108151609478,-4,1139,2568,20
108156163781,108156163779,-2,1390,2020,20
108158566127,108158566122,-5,1430,2315,20
108158910874,108158910873,-1,1608,2729,20
108160631522,108160631518,-4,1199,1958,20
108165812170,108165812186,16,1934,2976,20
108166197115,108166197110,-5,822,1160,20
108167092111,108167092111,0,2160,2140,20
108168900982,108168900980,-2,771,1351,20
108170661506,108170661502,-4,1314,2919,20
108171612375,108171612370,-5,1268,2169,20
108171652108,108171652106,-2,758,1540,20
108172158486,108172158467,-19,608,1338,20
108172268145,108172268141,-4,1170,2539,20
108180993938,108180993935,-3,1147,2735,20
108188597615,108188597612,-3,823,2180,20
108190202008,108190202007,-1,1265,1746,20
108191429669,108191429665,-4,1365,2694,20
108195768216,108195768213,-3,1129,2759,20
108196331858,108196331855,-3,955,2677,20
108197988640,108197988637,-3,1393,2771,20
108200469363,108200469357,-6,868,2036,20
108201513984,108201513982,-2,1081,3454,20
108205408379,108205408375,-4,1462,2286,20
108215339863,108215339860,-3,1210,2485,20
108216067510,108216067506,-4,811,1876,20
108218193085,108218193081,-4,1041,2497,20
108219047741,108219047741,0,862,1839,20
108219488213,108219488196,-17,1050,2024,20
108220970184,108220970179,-5,1138,2942,20
108223237762,108223237762,0,1575,1808,20
108225452399,108225452399,0,1166,881,20
108227364485,108227364482,-3,1198,2729,20
108227955982,108227955974,-8,1059,2614,20
108230624777,108230624775,-2,1115,2293,20
108231234245,108231234246,1,1272,2059,20
108232162673,108232162670,-3,1324,2089,20
108240200977,108240200974,-3,1199,2077,20
108241113883,108241113882,-1,1097,1946,20
108244191447,108244191444,-3,998,1773,20
108244596571,108244596568,-3,763,1777,20
108244696589,108244696589,0,1011,2066,20
108246676158,108246676156,-2,1073,1932,20
108248110203,108248110202,-1,1383,2736,20
108251020665,108251020661,-4,1318,2457,20
108256173762,108256173762,0,1230,1590,20
108261051912,108261051909,-3,1435,3047,20
108263243990,108263243987,-3,1050,2408,20
108268659151,108268659154,3,581,1067,20
108268736072,108268736090,18,695,1905,20
108273890971,108273890969,-2,1229,2282,20
108282068887,108282068884,-3,974,1744,20
108286221004,108286221001,-3,1296,2525,20
108288471334,108288471330,-4,1007,2431,20
108289069874,108289069873,-1,997,1797,20
108296708990,108296708989,-1,837,2246,20
108300695088,108300695085,-3,1032,2134,20
108301987893,108301987913,20,1282,1844,20
108311590143,108311590140,-3,1150,3007,20
108311853060,108311853059,-1,4,1107,20
108313472785,108313472781,-4,1037,1862,20
108313724956,108313724958,2,1829,1620,20
108317446001,108317445990,-11,57,3658,20
108326356810,108326356815,5,2079,1578,20
108326607584,108326607570,-14,142,829,20
108332188757,108332188755,-2,975,1464,20
108332965181,108332965173,-8,244,635,20
108334831710,108334831705,-5,848,1840,20
108337692046,108337692042,-4,1247,1674,20
108341332874,108341332872,-2,1007,1916,20
108343600633,108343600630,-3,1111,2101,20
108346153242,108346153241,-1,1184,1615,20
108355530538,108355530540,2,1476,1626,20
108355813011,108355813007,-4,574,2156,20
108360056391,108360056389,-2,944,2278,20
108362767445,108362767442,-3,1266,1870,20
108374393270,108374393266,-4,1034,2822,20
108376975627,108376975622,-5,967,2867,20
108378131390,108378131386,-4,732,1642,20
108387369257,108387369255,-2,1340,2198,20
108388347691,108388347697,6,1808,965,20
108388997971,108388997977,6,9872,30449,20
108391060637,108391060633,-4,1764,3687,20
108402461371,108402461370,-1,1711,2716,20
108402661904,108402661898,-6,972,2358,20
108404225147,108404225145,-2,1083,2483,20
108405371322,108405371320,-2,767,2230,20
108407426691,108407426686,-5,1162,2723,20
108407477972,108407477969,-3,1145,2577,20
108409107750,108409107747,-3,1312,2071,20
108409411065,108409411070,5,2848,1941,20
108412027182,108412027182,0,1121,1903,20
108412380821,108412380806,-15,1063,2732,20
108412427695,108412427715,20,471,1266,20
108415244939,108415244935,-4,1147,1992,20
108416066333,108416066353,20,472,1499,20
108419775710,108419775705,-5,1646,4411,20
108419836929,108419836927,-2,1378,2807,20
108431284857,108431284854,-3,954,2349,20
108431596547,108431596545,-2,1294,2900,20
108437301246,108437301246,0,664,1921,20
108441024621,108441024617,-4,1146,2478,20
108441915438,108441915435,-3,1154,2445,20
108446265907,108446265905,-2,999,2480,20
108451147428,108451147424,-4,1125,2111,20
108455461356,108455461354,-2,1178,2500,20
108456447447,108456447424,-23,106,1132,20
108458032428,108458032426,-2,1241,2652,20
108461063224,108461063222,-2,1214,2403,20
108462279383,108462279379,-4,1380,3605,20
108462749806,108462749803,-3,1365,1935,20
108464768647,108464768642,-5,881,1857,20
108464867006,108464867002,-4,954,2805,20
108465930981,108465930978,-3,1174,2149,20
108467241982,108467241962,-20,854,1645,20
108475683606,108475683603,-3,1472,3147,20
108485898786,108485898779,-7,537,2092,20
108487661223,108487661203,-20,1148,1901,20
108489622596,108489622594,-2,2079,3485,20
108492259644,108492259642,-2,1171,2315,20
108492977799,108492977813,14,649,1889,20
108496025983,108496025982,-1,886,2492,20
108496670877,108496670876,-1,1376,2600,20
108498303257,108498303258,1,668,837,20
108499351772,108499351770,-2,644,1861,20
108508362694,108508362690,-4,1430,2566,20
108513331765,108513331762,-3,1287,2968,20
108515538503,108515538499,-4,629,2208,20
108516330677,108516330672,-5,1013,2768,20
108520251197,108520251194,-3,1011,1794,20
108520738893,108520738891,-2,1295,2879,20
108522120330,108522120327,-3,1091,2474,20
108527159347,108527159335,-12,1334,1959,20
108527375271,108527375252,-19,945,2472,20
108527847135,108527847124,-11,996,2745,20
108532577130,108532577129,-1,1116,1950,20
108536134342,108536134341,-1,1112,2538,20
108536211071,108536211050,-21,1102,2403,20
108537019466,108537019464,-2,873,2266,20
108538215842,108538215841,-1,700,2452,20
108540871701,108540871698,-3,1244,2636,20
108541290860,108541290882,22,812,1697,20
108542693325,108542693322,-3,1509,2690,20
108543807831,108543807827,-4,981,2033,20
108547237717,108547237714,-3,1046,2467,20
108552448806,108552448802,-4,770,2573,20
108552818620,108552818642,22,134,697,20
108553253669,108553253666,-3,1080,1914,20
108558906609,108558906600,-9,37285,16427,20
108560843217,108560843213,-4,1146,2536,20
108563807850,108563807847,-3,455,1455,20
108565972872,108565972874,2,1486,1961,20
108566662946,108566662941,-5,1438,2982,20
108576974842,108576974840,-2,1289,2171,20
108578883572,108578883568,-4,1373,2833,20
108579058559,108579058555,-4,1370,2344,20
108581455596,108581455594,-2,1398,2946,20
108582774830,108582774830,0,1626,1515,20
108584003583,108584003580,-3,807,2284,20
108590917618,108590917616,-2,1006,1813,20
108594925712,108594925731,19,533,1624,20
108597391813,108597391809,-4,1301,3271,20
108597827751,108597827748,-3,590,1490,20
108600077175,108600077169,-6,787,2621,20
108603576646,108603576642,-4,1655,3024,20
108607635738,108607635735,-3,1232,1935,20
108612895756,108612895755,-1,1490,2979,20
108613109782,108613109779,-3,1236,2655,20
108614015983,108614015981,-2,975,2438,20
108620490879,108620490877,-2,1015,1580,20
108623947675,108623947673,-2,868,1742,20
108624972394,108624972393,-1,1686,3066,20
108625756957,108625756954,-3,1064,2649,20
108626558204,108626558201,-3,1107,1593,20
108629166587,108629166585,-2,1123,1876,20
108630710405,108630710404,-1,1481,2969,20
108633099713,108633099710,-3,1207,1609,20
108635700237,108635700234,-3,1165,2533,20
108635795311,108635795306,-5,779,2133,20
108637241874,108637241870,-4,1776,2940,20
108640145610,108640145606,-4,951,1661,20
108641747633,108641747627,-6,1084,2240,20
108642843555,108642843553,-2,1086,2096,20
108645685527,108645685524,-3,807,2272,20
108657562356,108657562354,-2,909,1342,20
108657877010,108657877004,-6,947,3799,20
108659817533,108659817529,-4,661,1978,20
108667907728,108667907724,-4,1494,1985,20
108669385065,108669385061,-4,1120,2199,20
108670961625,108670961621,-4,810,2200,20
108674350618,108674350617,-1,1262,2604,20
108676372615,108676372612,-3,1059,1947,20
108676542514,108676542511,-3,933,1839,20
108677106535,108677106553,18,744,3214,20
108678713534,108678713532,-2,726,2381,20
108679087668,108679087689,21,1214,2268,20
108679829424,108679829422,-2,1151,2045,20
108682595394,108682595390,-4,1425,1731,20
108684184318,108684184314,-4,1441,3390,20
108686851331,108686851327,-4,1066,1986,20
108691326430,108691326426,-4,991,1942,20
108692622480,108692622474,-6,935,3094,20
108697690770,108697690766,-4,1090,2344,20
108702478737,108702478734,-3,913,1476,20
108702851863,108702851854,-9,1371,1365,20
108707246178,108707246176,-2,833,2057,20
108708916473,108708916495,22,1033,659,20
108710047407,108710047405,-2,1094,1574,20
108714367030,108714367028,-2,1053,1837,20
108715521383,108715521380,-3,753,2117,20
108718373062,108718373060,-2,1527,3153,20
108718539534,108718539532,-2,1126,2734,20
108720323106,108720323101,-5,946,2640,20
108724446112,108724446118,6,4080,1254,20
108728680186,108728680191,5,3909,2706,20
108729689696,108729689694,-2,1752,3357,20
108734921795,108734921794,-1,1185,2296,20
108738915143,108738915141,-2,991,1581,20
108741447449,108741447448,-1,43429,21809,20
108742980384,108742980385,1,4039,3768,20
108743260654,108743260653,-1,1112,2028,20
108748896095,108748896090,-5,694,2061,20
108749351938,108749351935,-3,1107,2907,20
108750897523,108750897518,-5,822,2487,20
108754821507,108754821504,-3,651,1257,20
108754968899,108754968897,-2,1182,1818,20
108755051157,108755051154,-3,1270,1854,20
108763796687,108763796685,-2,1464,2945,20
108768042158,108768042155,-3,1005,2055,20
108769481296,108769481293,-3,1381,3182,20
108771919929,108771919927,-2,1042,2561,20
108776406678,108776406677,-1,1274,2163,20
108777997867,108777997866,-1,962,2040,20
108782597487,108782597483,-4,1485,2762,20
108786027682,108786027678,-4,888,2196,20
108788707108,108788707121,13,697,1344,20
108793207440,108793207443,3,1331,1783,20
108793831706,108793831705,-1,1457,1512,20
108800123409,108800123406,-3,1164,3042,20
108803281561,108803281558,-3,1383,2519,20
108809764644,108809764641,-3,1232,3321,20
108811121282,108811121279,-3,1156,3683,20
108813725734,108813725754,20,343,1082,20
108821570839,108821570837,-2,735,1797,20
108830241264,108830241269,5,2701,970,20
108833905468,108833905467,-1,1562,2428,20
108843225013,108843225009,-4,1285,1857,20
108846704452,108846704449,-3,1300,3134,20
108846800638,108846800639,1,1666,1781,20
108849679854,108849679849,-5,984,2847,20
108849894974,108849894973,-1,1288,2794,20
108850593699,108850593697,-2,553,1403,20
108854932488,108854932480,-8,187,1064,20
108857072606,108857072609,3,2129,2146,20
108861578661,108861578655,-6,1149,2678,20
108863835345,108863835342,-3,635,1763,20
108871407831,108871407828,-3,848,2272,20
108871699421,108871699418,-3,1043,2661,20
108875642922,108875642920,-2,957,2692,20
108877495581,108877495581,0,27672,33814,20
108878567075,108878567073,-2,1008,2496,20
108879778199,108879778196,-3,1007,1909,20
108880389140,108880389138,-2,1058,3064,20
108883014558,108883014554,-4,1364,3083,20
108885651493,108885651490,-3,1174,2397,20
108886169389,108886169381,-8,644,1687,20
108892447439,108892447437,-2,918,1960,20
108897693435,108897693437,2,1228,1426,20
108898077523,108898077521,-2,883,1789,20
108902504726,108902504723,-3,1007,1644,20
108902867214,108902867214,0,1265,1917,20
108906025718,108906025714,-4,1024,2066,20
108909994979,108909994977,-2,1118,2752,20
108910480420,108910480401,-19,830,2422,20
108913564150,108913564146,-4,941,2384,20
108915702207,108915702204,-3,1206,2489,20
108920588441,108920588439,-2,1286,2635,20
108920745311,108920745310,-1,1109,1043,20
108921098733,108921098730,-3,1013,2276,20
108923977511,108923977507,-4,1014,2786,20
108925452768,108925452762,-6,1071,2058,20
108926185657,108926185655,-2,1137,2014,20
108926966082,108926966078,-4,1156,2748,20
108928548181,108928548188,7,6273,2428,20
108929643584,108929643582,-2,1232,2074,20
108929699380,108929699373,-7,596,1651,20
108931712207,108931712205,-2,1200,1635,20
108934745115,108934745112,-3,1248,2343,20
108943717611,108943717606,-5,918,2848,20
108944180830,108944180815,-15,985,1987,20
108945034285,108945034278,-7,1986,6427,20
108947913614,108947913610,-4,1362,2937,20
108948417892,108948417887,-5,1142,2254,20
108950514640,108950514639,-1,820,1262,20
108955018691,108955018685,-6,1207,3421,20
108956044436,108956044434,-2,447,1880,20
108959517768,108959517765,-3,1195,2205,20
108960240504,108960240501,-3,1002,1799,20
108961313806,108961313790,-16,271,633,20
108971910238,108971910235,-3,842,1657,20
108972756741,108972756721,-20,153,750,20
108975231638,108975231635,-3,765,1146,20
108978783609,108978783605,-4,871,1543,20
108983436587,108983436585,-2,1068,2978,20
108983589246,108983589267,21,1282,2974,20
108989070143,108989070138,-5,1280,2560,20
108989132267,108989132260,-7,1859,9256,20
108990691165,108990691161,-4,1036,3399,20
108994583159,108994583154,-5,1397,2094,20
108994986932,108994986927,-5,1037,1969,20
108995353533,108995353551,18,478,867,20
108997588738,108997588737,-1,1423,1799,20
108998177266,108998177265,-1,1159,2185,20
108998714403,108998714401,-2,1079,2055,20
109000030554,109000030550,-4,1051,2383,20
109003162535,109003162533,-2,1115,1804,20
109006953359,109006953356,-3,1361,2435,20
109010111280,109010111278,-2,578,1826,20
109012110420,109012110418,-2,1380,2038,20
109013114566,109013114565,-1,1564,2257,20
109016147557,109016147551,-6,1028,2440,20
109016880400,109016880418,18,781,1381,20
109019781820,109019781826,6,2362,1284,20
109020969187,109020969184,-3,987,1899,20
109024503553,109024503553,0,963,1642,20
109030327241,109030327239,-2,1221,2134,20
109030465674,109030465671,-3,582,1690,20
109030791708,109030791696,-12,235,1202,20
109033396105,109033396102,-3,985,2195,20
109034879939,109034879939,0,1211,1978,20
109035353287,109035353304,17,1102,4472,20
109036490077,109036490076,-1,1320,2305,20
109039341230,109039341226,-4,1339,2572,20
109042721819,109042721817,-2,1376,3032,20
109043316896,109043316895,-1,2828,3534,20
109046238507,109046238486,-21,1243,3278,20
109047764625,109047764606,-19,1513,695,20
109048970245,109048970242,-3,696,2117,20
109049382351,109049382358,7,233,827,20
109054238775,109054238770,-5,784,1963,20
109056566014,109056566022,8,3108,1642,20
109061226046,109061226042,-4,1066,2220,20
109065408359,109065408356,-3,1206,2970,20
109070461125,109070461126,1,1199,1695,20
109078710648,109078710649,1,1396,1545,20
109082254937,109082254936,-1,1028,1719,20
109090785350,109090785349,-1,1049,2259,20
109092807894,109092807891,-3,1128,1897,20
109094681899,109094681914,15,100,921,20
109098738622,109098738619,-3,741,1084,20
109099110382,109099110378,-4,835,1293,20
109105988370,109105988367,-3,786,2948,20
109109413138,109109413136,-2,1143,2738,20
109111033133,109111033131,-2,973,1985,20
109113312965,109113312961,-4,1366,2085,20
109114888382,109114888378,-4,950,2486,20
109114948742,109114948760,18,889,1741,20
109117683722,109117683722,0,877,2946,20
109117994351,109117994331,-20,138,819,20
109120542161,109120542157,-4,1258,2703,20
109125156313,109125156315,2,258,827,20
109128388134,109128388133,-1,955,1785,20
109130269641,109130269638,-3,1348,1962,20
109135177572,109135177568,-4,919,2198,20
109136857406,109136857403,-3,1197,2082,20
109142749657,109142749653,-4,1222,2178,20
109156694872,109156694866,-6,1429,5263,20
109160133005,109160133001,-4,1464,2996,20
109161094734,109161094730,-4,1127,2269,20
109163521129,109163521126,-3,1123,1889,20
109164299146,109164299145,-1,1193,2100,20
109168836306,109168836304,-2,1138,2159,20
109177315395,109177315394,-1,944,1584,20
109177959003,109177958999,-4,976,1908,20
109178437434,109178437432,-2,1360,2452,20
109185026207,109185026206,-1,918,2019,20
109187068909,109187068908,-1,969,1380,20
109188320251,109188320246,-5,1224,2616,20
109188875717,109188875723,6,2940,1502,20
109190062917,109190062914,-3,1300,2089,20
109199236430,109199236434,4,1993,1775,20
109201133214,109201133209,-5,1034,2616,20
109201252276,109201252299,23,1103,2251,20
109203632786,109203632781,-5,858,1798,20
109205954669,109205954666,-3,935,2552,20
109211489437,109211489440,3,2648,2659,20
109211960982,109211960979,-3,1208,2362,20
109219048671,109219048669,-2,1108,2575,20
109220694209,109220694206,-3,568,2901,20
109221378380,109221378379,-1,1513,3723,20
109223092555,109223092553,-2,998,1993,20
109225764215,109225764213,-2,668,1557,20
109226103514,109226103511,-3,690,1534,20
109227219916,109227219913,-3,1119,2817,20
109228666394,109228666390,-4,1007,2754,20
109231532651,109231532647,-4,997,2595,20
109233370551,109233370549,-2,1318,3169,20
109234837776,109234837774,-2,840,2070,20
109238160690,109238160690,0,1306,2427,20
109238856849,109238856842,-7,3110,9099,20
109239098959,109239098954,-5,1634,3825,20
109241226208,109241226205,-3,967,2007,20
109241353815,109241353826,11,97,5408,20
109242489432,109242489429,-3,1591,2376,20
109243075775,109243075764,-11,540,1595,20
109243724526,109243724523,-3,1392,1851,20
109249827534,109249827530,-4,1133,3048,20
109251543215,109251543213,-2,1084,2190,20
109253177810,109253177810,0,1663,2260,20
109253552946,109253552944,-2,677,1528,20
109255637394,109255637390,-4,1262,2047,20
109260769825,109260769821,-4,977,2167,20
109262912622,109262912619,-3,1505,2678,20
109265938140,109265938138,-2,1694,2160,20
109266854525,109266854521,-4,1199,2271,20
109267452634,109267452631,-3,983,2730,20
109267596979,109267596982,3,65003,71671,20
109268134173,109268134173,0,1352,1650,20
109271210360,109271210358,-2,779,2046,20
109274761647,109274761642,-5,637,2158,20
109274815478,109274815457,-21,1055,2286,20
109275652822,109275652816,-6,1160,2769,20
109280857362,109280857370,8,1724,1225,20
109281504082,109281504078,-4,1255,2078,20
109283616115,109283616113,-2,1184,2520,20
109291110689,109291110690,1,979,1835,20
109298074646,109298074641,-5,1570,3561,20
109305681524,109305681521,-3,1371,2402,20
109305720140,109305720121,-19,795,2157,20
109308105505,109308105503,-2,1100,1868,20
109310475986,109310475990,4,2470,1398,20
109312319827,109312319823,-4,1729,2990,20
109313406988,109313407002,14,434,1680,20
109315216099,109315216097,-2,842,1510,20
109315793440,109315793446,6,65,1383,20
109319513689,109319513685,-4,1210,2852,20
109324402667,109324402663,-4,786,1872,20
109324900991,109324900987,-4,726,1275,20
109333832248,109333832247,-1,934,2260,20
109341731847,109341731845,-2,936,1991,20
109342030977,109342030973,-4,1035,1670,20
109343134041,109343134038,-3,1093,2654,20
109343957567,109343957565,-2,1208,2289,20
109351788866,109351788865,-1,1187,2452,20
109355510610,109355510607,-3,1323,2706,20
109357047787,109357047793,6,5001,2344,20
109360534386,109360534383,-3,939,1687,20
109361508229,109361508249,20,859,2469,20
109362385819,109362385818,-1,994,2903,20
109362961267,109362961264,-3,1143,2952,20
109365871694,109365871697,3,2422,1636,20
109367675196,109367675191,-5,524,1446,20
109368893103,109368893087,-16,1035,2142,20
109369401529,109369401525,-4,949,2697,20
109369869213,109369869200,-13,990,1614,20
109371511457,109371511457,0,1318,2113,20
109377572362,109377572362,0,1286,1911,20
109384167363,109384167359,-4,1144,2041,20
109392890219,109392890216,-3,1521,2430,20
109404300334,109404300333,-1,1067,2409,20
109404636839,109404636833,-6,1198,2945,20
109409511535,109409511533,-2,1250,2085,20
109410353573,109410353577,4,2865,1669,20
109412380570,109412380565,-5,1243,4591,20
109415022683,109415022681,-2,1057,2421,20
109416981966,109416981965,-1,993,2181,20
109417169576,109417169565,-11,689,1780,20
109419178326,109419178333,7,17411,17353,20
109423074048,109423074046,-2,1550,2596,20
109423943243,109423943238,-5,906,2251,20
109434781459,109434781457,-2,973,1657,20
109435397923,109435397920,-3,1179,1981,20
109437880594,109437880592,-2,1304,2304,20
109444695453,109444695449,-4,1200,2444,20
109447945808,109447945805,-3,972,2247,20
109449828588,109449828586,-2,1190,2518,20
109458642521,109458642513,-8,2274,10443,20
109461512211,109461512206,-5,1176,3870,20
109464368109,109464368106,-3,5806,13931,20
109466461980,109466461976,-4,1702,4099,20
109467404646,109467404641,-5,1243,2142,20
109473603847,109473603845,-2,1354,1986,20
109474503990,109474503987,-3,833,2553,20
109476447919,109476447916,-3,942,2389,20
109477752543,109477752539,-4,941,1874,20
109477961683,109477961681,-2,1322,1902,20
109480711958,109480711954,-4,1058,2215,20
109481887695,109481887692,-3,1495,2559,20
109482415288,109482415306,18,639,1890,20
109483816374,109483816371,-3,1577,3169,20
109486102340,109486102338,-2,830,1702,20
109494895871,109494895868,-3,760,3381,20
109495170269,109495170266,-3,824,2180,20
109500831226,109500831222,-4,981,2371,20
109502502350,109502502348,-2,1110,3193,20
109504063815,109504063810,-5,1338,2148,20
109507206182,109507206181,-1,1392,1967,20
109508729685,109508729680,-5,1262,2273,20
109512821281,109512821283,2,34273,92775,20
109517086937,109517086934,-3,3087,5425,20
109520017869,109520017866,-3,873,2162,20
109520712648,109520712666,18,1013,2636,20
109522797770,109522797766,-4,1252,2102,20
109523072800,109523072796,-4,1197,2171,20
109529660241,109529660239,-2,1290,2751,20
109533373354,109533373350,-4,944,2430,20
109538937847,109538937845,-2,848,1727,20
109539794859,109539794855,-4,1503,1925,20
109551152553,109551152550,-3,1145,2390,20
109552163731,109552163728,-3,1128,2098,20
109552280295,109552280293,-2,987,2167,20
109554199729,109554199725,-4,1415,4034,20
109555932733,109555932737,4,4453,2982,20
109560690302,109560690298,-4,1656,2539,20
109576346189,109576346186,-3,1558,2508,20
109581594665,109581594663,-2,1007,2512,20
109581741866,109581741862,-4,1150,1737,20
109586014325,109586014321,-4,610,1456,20
109587623942,109587623938,-4,787,1465,20
109592332685,109592332681,-4,1030,2547,20
109596478542,109596478548,6,4284,1746,20
109597093760,109597093755,-5,906,1726,20
109614014286,109614014281,-5,1330,1908,20
109614118199,109614118197,-2,1122,2156,20
109614815363,109614815361,-2,1118,2103,20
109618612173,109618612169,-4,1365,2856,20
109619044388,109619044390,2,1317,1501,20
109627369874,109627369870,-4,818,2234,20
109637925414,109637925410,-4,1721,3042,20
109638088936,109638088933,-3,1339,2305,20
109638394867,109638394870,3,2074,1465,20
109644700195,109644700191,-4,1503,3026,20
109645940777,109645940772,-5,947,1856,20
109648970461,109648970466,5,2919,970,20
109649889538,109649889534,-4,2129,5858,20
109653480554,109653480552,-2,1268,2298,20
109655002494,109655002492,-2,1170,2358,20
109655071821,109655071816,-5,1443,3345,20
109660093369,109660093366,-3,924,2150,20
109661525854,109661525870,16,442,1562,20
109662589499,109662589493,-6,726,3411,20
109663546789,109663546786,-3,1302,2403,20
109663750390,109663750386,-4,937,2318,20
109666795295,109666795293,-2,1147,2280,20
109669879783,109669879782,-1,26435,33591,20
109672011720,109672011718,-2,694,2615,20
109676369343,109676369340,-3,639,1795,20
109676647000,109676647009,9,486,1494,20
109681464211,109681464210,-1,1159,1895,20
109681777778,109681777775,-3,869,2360,20
109684645848,109684645848,0,2554,2238,20
109685108417,109685108414,-3,1118,2737,20
109685622294,109685622290,-4,1206,2756,20
109686318189,109686318186,-3,1434,2022,20
109698587490,109698587486,-4,724,2005,20
109699375938,109699375937,-1,1279,2236,20
109701826397,109701826392,-5,1253,2585,20
109702330236,109702330235,-1,1685,2264,20
109702793613,109702793607,-6,904,1784,20
109704213012,109704213009,-3,1292,1998,20
109704597756,109704597774,18,840,1109,20
109707892415,109707892413,-2,1055,1886,20
109709143994,109709143993,-1,1268,2478,20
109715851114,109715851113,-1,1314,1506,20
109718289210,109718289206,-4,1334,2520,20
109719639310,109719639302,-8,1113,4939,20
109722222909,109722222905,-4,800,1971,20
109727856436,109727856433,-3,1233,2232,20
109730050670,109730050675,5,2859,1694,20
109730410900,109730410898,-2,1989,3226,20
109732052715,109732052712,-3,1197,2391,20
109739752475,109739752473,-2,1380,2569,20
109746162905,109746162903,-2,1473,3034,20
109747230681,109747230702,21,416,1022,20
109749284953,109749284958,5,1826,1047,20
109751806267,109751806265,-2,969,2570,20
109753103719,109753103715,-4,1478,3749,20
109753827598,109753827593,-5,1129,2607,20
109755905942,109755905940,-2,1228,2284,20
109756653645,109756653641,-4,968,2799,20
109757257383,109757257380,-3,1203,2587,20
109767066649,109767066645,-4,1859,3152,20
109772220275,109772220273,-2,1135,1813,20
109775491979,109775491974,-5,1013,2203,20
109788855071,109788855066,-5,647,2952,20
109794449337,109794449342,5,1647,1329,20
109798450648,109798450646,-2,1454,1950,20
109799266493,109799266491,-2,904,1545,20
109799756295,109799756293,-2,1313,2763,20
109799884443,109799884441,-2,1060,1828,20
109800239469,109800239467,-2,1217,2267,20
109801475566,109801475575,9,13674,30532,20
109802525629,109802525626,-3,1132,1867,20
109805619311,109805619308,-3,1628,1589,20
109806722415,109806722412,-3,1120,2327,20
109810111472,109810111458,-14,308,815,20
109811752307,109811752304,-3,700,1769,20
109811895850,109811895852,2,1453,1751,20
109814078866,109814078863,-3,919,2020,20
109814602142,109814602141,-1,744,1028,20
109816036719,109816036718,-1,1391,2792,20
109818175089,109818175086,-3,1644,1681,20
109820125234,109820125233,-1,1173,2898,20
109822843078,109822843077,-1,913,1728,20
109823432202,109823432198,-4,1369,2225,20
109825858432,109825858429,-3,831,240,20
109829899725,109829899721,-4,652,1171,20
109832080960,109832080958,-2,1367,2255,20
109834687326,109834687325,-1,1076,2130,20
109837296169,109837296169,0,557,1016,20
109840228922,109840228921,-1,1110,1721,20
109840353999,109840353997,-2,1420,2803,20
109841590200,109841590192,-8,10163,16964,20
109843135926,109843135929,3,1830,1506,20
109843336554,109843336553,-1,1546,2444,20
109844180651,109844180648,-3,1068,3138,20
109847617718,109847617715,-3,953,1610,20
109851012470,109851012466,-4,1087,2043,20
109852483795,109852483790,-5,1213,2943,20
109859880987,109859880984,-3,851,2255,20
109860442125,109860442143,18,1112,3138,20
109863276139,109863276138,-1,861,1852,20
109863805126,109863805122,-4,990,2547,20
109865594622,109865594618,-4,1020,2279,20
109867139042,109867139039,-3,1023,1892,20
109868831386,109868831386,0,1285,1970,20
109871311492,109871311489,-3,1445,3267,20
109871921250,109871921253,3,1212,1306,20
109873300187,109873300182,-5,1049,2164,20
109875283381,109875283376,-5,1037,1244,20
109875466534,109875466534,0,2897,3456,20
109876036135,109876036131,-4,810,2610,20
109884752279,109884752276,-3,583,1521,20
109887477065,109887477058,-7,2452,12513,20
109889569218,109889569216,-2,1373,2822,20
109890517797,109890517797,0,1007,1420,20
109892068234,109892068232,-2,1428,2578,20
109898415949,109898415947,-2,951,2120,20
109903936930,109903936927,-3,1050,2756,20
109906826682,109906826678,-4,1095,2365,20
109913877579,109913877577,-2,1245,2793,20
109916046627,109916046623,-4,914,2982,20
109921567406,109921567402,-4,1070,1527,20
109921701803,109921701799,-4,641,2491,20
109922377614,109922377630,16,581,1157,20
109925254496,109925254494,-2,1383,2436,20
109925752650,109925752649,-1,1048,1478,20
109925939102,109925939116,14,127,1131,20
109927213731,109927213725,-6,2664,7674,20
109933273955,109933273953,-2,1470,2444,20
109934618071,109934618066,-5,757,2521,20
109934673103,109934673117,14,136,726,20
109936059343,109936059340,-3,1274,2445,20
109938408009,109938408006,-3,1472,2845,20
109939662178,109939662176,-2,970,1601,20
109940276300,109940276298,-2,669,2805,20
109945117182,109945117178,-4,1081,2159,20
109946271342,109946271343,1,1401,1899,20
109949416710,109949416707,-3,1597,3378,20
109954144802,109954144809,7,1588,1166,20
109957120432,109957120426,-6,1761,7794,20
109958324480,109958324478,-2,973,2220,20
109958902568,109958902554,-14,888,1391,20
109959621662,109959621661,-1,723,1498,20
109967013486,109967013482,-4,1304,2775,20
109979358666,109979358665,-1,1294,1978,20
109982896357,109982896354,-3,1134,1736,20
109987361190,109987361187,-3,1058,2860,20
109988253214,109988253210,-4,1284,2481,20
109990434346,109990434345,-1,1154,1901,20
109992680311,109992680306,-5,1147,2291,20
109998622649,109998622646,-3,1196,2726,20
109999243896,109999243889,-7,2020,9655,20
110001297254,110001297250,-4,1055,1635,20
110002460323,110002460320,-3,1616,2944,20
110010710947,110010710945,-2,1162,2030,20
110012367523,110012367520,-3,1113,1850,20
110013954906,110013954900,-6,31601,15873,20
110016187110,110016187106,-4,943,1500,20
110019585799,110019585796,-3,1205,2940,20
110021414518,110021414518,0,1160,2064,20
110024303887,110024303885,-2,1097,2165,20
110024828910,110024828910,0,1405,2023,20
110025118338,110025118336,-2,1712,3739,20
110030105673,110030105671,-2,1088,3088,20
110030981495,110030981492,-3,1182,2041,20
110037631257,110037631254,-3,1136,1947,20
110038645053,110038645050,-3,1064,3028,20
110038787006,110038786999,-7,1123,3141,20
110042031061,110042031056,-5,1120,3883,20
110042216557,110042216542,-15,1377,2265,20
110042281191,110042281210,19,1146,2029,20
110049434658,110049434653,-5,1161,3002,20
110050150165,110050150161,-4,1111,2188,20
110053488933,110053488933,0,1816,2229,20
110055357941,110055357939,-2,1133,1588,20
110055873886,110055873881,-5,1200,2658,20
110057149777,110057149774,-3,1937,6277,20
110063521372,110063521367,-5,830,2788,20
110065452314,110065452309,-5,847,2572,20
110067054138,110067054134,-4,1292,3411,20
110069304612,110069304607,-5,1066,2242,20
110074948046,110074948045,-1,1056,1611,20
110082822325,110082822329,4,2306,1302,20
110083845248,110083845247,-1,1380,2126,20
110084546213,110084546235,22,906,1945,20
110085100343,110085100341,-2,914,2308,20
110085506553,110085506550,-3,1026,1513,20
110087556268,110087556265,-3,1204,2366,20
110089200340,110089200361,21,849,2708,20
110095932566,110095932570,4,1660,1437,20
110102889347,110102889342,-5,820,3070,20
110104364075,110104364070,-5,1307,2979,20
110104987650,110104987649,-1,1577,2951,20
110108069206,110108069202,-4,1116,2432,20
110108657383,110108657381,-2,1525,2157,20
110118842597,110118842603,6,1128,1133,20
110121174366,110121174363,-3,1172,2022,20
110121511754,110121511751,-3,1149,2468,20
110121978601,110121978607,6,1544,1288,20
110124384539,110124384537,-2,1245,2702,20
110124837303,110124837300,-3,870,2746,20
110125695229,110125695220,-9,1032,1828,20
110129151258,110129151257,-1,1121,2077,20
110133396774,110133396771,-3,1496,3046,20
110150277814,110150277812,-2,1009,1953,20
110150965653,110150965650,-3,1230,2656,20
110152147381,110152147377,-4,1134,2051,20
110155133484,110155133479,-5,35455,5582,20
110155748158,110155748152,-6,1291,3564,20
110156921526,110156921522,-4,1286,2352,20
110158836850,110158836851,1,1097,1932,20
110159680818,110159680822,4,3133,2345,20
110172765735,110172765737,2,1666,1849,20
110173168913,110173168912,-1,1208,2213,20
110174678993,110174678990,-3,1581,2865,20
110175932433,110175932431,-2,901,1654,20
110177072125,110177072123,-2,1093,2419,20
110180530035,110180530042,7,5200,1574,20
110183690138,110183690137,-1,1262,2312,20
110183805359,110183805355,-4,849,2553,20
110184973401,110184973402,1,1210,2419,20
110185879727,110185879725,-2,1245,3115,20
110186592665,110186592673,8,2201,1047,20
110187209519,110187209514,-5,1795,6648,20
110188952526,110188952524,-2,2536,4799,20
110189985924,110189985921,-3,1289,2214,20
110191907430,110191907426,-4,1046,2140,20
110192272844,110192272842,-2,1293,2776,20
110193408950,110193408947,-3,1143,2383,20
110195598485,110195598483,-2,939,2393,20
110207445786,110207445782,-4,1419,3554,20
110211566382,110211566379,-3,938,2734,20
110212288415,110212288410,-5,1032,1898,20
110217425107,110217425103,-4,1430,3442,20
110220345494,110220345490,-4,766,2056,20
110221791398,110221791393,-5,1913,3572,20
110221981937,110221981934,-3,838,1842,20
110227357051,110227357047,-4,658,2084,20
110227510268,110227510271,3,30405,30669,20
110228490714,110228490712,-2,807,2010,20
110230619046,110230619043,-3,1056,2365,20
110233785423,110233785421,-2,1081,1442,20
110238593678,110238593672,-6,541,1821,20
110238622792,110238622811,19,945,2407,20
110246204027,110246204026,-1,793,2055,20
110248272054,110248272050,-4,1027,2522,20
110249870766,110249870767,1,1077,1323,20
110250696740,110250696737,-3,726,1263,20
110251605374,110251605383,9,4892,1060,20
110253386055,110253386053,-2,1093,2064,20
110259120403,110259120400,-3,1045,2724,20
110267379379,110267379375,-4,1180,2252,20
110267535330,110267535327,-3,1076,2709,20
110270499918,110270499915,-3,1418,2895,20
110270935191,110270935187,-4,872,1509,20
110272119562,110272119560,-2,1319,2054,20
110273317511,110273317506,-5,1175,2024,20
110273504255,110273504251,-4,894,1444,20
110274600537,110274600534,-3,1061,3150,20
110278287514,110278287515,1,7937,8836,20
110279138786,110279138783,-3,958,1854,20
110279618861,110279618866,5,2290,1603,20
110280825256,110280825253,-3,1456,3594,20
110286609055,110286609052,-3,986,2109,20
110289220618,110289220623,5,1487,898,20
110292520373,110292520371,-2,1398,2682,20
110295552619,110295552615,-4,980,2165,20
110300551359,110300551358,-1,1045,1811,20
110301872480,110301872483,3,2512,18255,20
110302980974,110302980973,-1,1155,2327,20
110303104693,110303104693,0,1399,2021,20
110303455549,110303455569,20,775,1434,20
110305706741,110305706744,3,1259,1276,20
110311580846,110311580846,0,1838,1468,20
110316051813,110316051812,-1,1444,2144,20
110317631879,110317631877,-2,1633,2480,20
110319305290,110319305287,-3,1218,2013,20
110319334784,110319334802,18,1050,2234,20
110326184914,110326184920,6,1873,1663,20
110330226879,110330226875,-4,1212,2481,20
110333482281,110333482279,-2,1184,2086,20
110334347406,110334347410,4,1511,1198,20
110338998642,110338998639,-3,1294,2308,20
110341286413,110341286410,-3,1130,2107,20
110343223082,110343223083,1,2399,3191,20
110346130366,110346130366,0,1252,1396,20
110346722629,110346722625,-4,1028,1994,20
110353860142,110353860146,4,3118,1421,20
110356271286,110356271285,-1,760,2107,20
110357129597,110357129579,-18,1292,2915,20
110361784476,110361784474,-2,1031,2538,20
110367137310,110367137308,-2,789,1271,20
110376270275,110376270271,-4,1264,2559,20
110377104080,110377104075,-5,1184,2886,20
110377731873,110377731876,3,934,1180,20
110378250138,110378250138,0,1430,2306,20
110381227539,110381227537,-2,1007,2713,20
110382651156,110382651155,-1,990,2444,20
110382839676,110382839699,23,587,816,20
110383432002,110383432008,6,2602,1406,20
110383614042,110383614037,-5,841,1732,20
110385913122,110385913119,-3,1069,2265,20
110389310090,110389310089,-1,1123,1662,20
110389479788,110389479779,-9,1471,2599,20
110391235631,110391235632,1,960,1148,20
110392347326,110392347324,-2,1362,2252,20
110393718455,110393718447,-8,1189,1728,20
110395985383,110395985378,-5,1142,4156,20
110400403014,110400403010,-4,941,2946,20
110400670881,110400670878,-3,1019,2156,20
110406499071,110406499070,-1,1306,2122,20
110407410154,110407410151,-3,1127,2180,20
110422863352,110422863350,-2,1157,1977,20
110424139838,110424139835,-3,959,1466,20
110430708106,110430708102,-4,1183,1646,20
110435543528,110435543526,-2,1004,2735,20
110436387051,110436387049,-2,1797,3154,20
110438829907,110438829902,-5,1542,2266,20
110447845987,110447845985,-2,876,1448,20
110448292308,110448292330,22,741,1868,20
110448559489,110448559486,-3,889,1928,20
110448706965,110448706962,-3,815,2257,20
110449208877,110449208865,-12,843,1505,20
110449687915,110449687913,-2,1223,2010,20
110451080969,110451080967,-2,1301,1669,20
110456165481,110456165479,-2,1587,2390,20
110457411254,110457411253,-1,878,2276,20
110457654699,110457654695,-4,1042,2995,20
110465225723,110465225717,-6,1029,1904,20
110466571921,110466571918,-3,647,1362,20
110474799943,110474799938,-5,870,2234,20
110478490482,110478490480,-2,1000,2697,20
110484534631,110484534626,-5,1135,2444,20
110488523995,110488523994,-1,1429,3298,20
110489551975,110489551971,-4,1389,3238,20
110501549193,110501549189,-4,1142,2984,20
110504324033,110504324031,-2,1252,2590,20
110504962201,110504962198,-3,769,1680,20
110506827840,110506827836,-4,1036,1968,20
110507305636,110507305630,-6,904,2054,20
110510463855,110510463854,-1,1311,2221,20
110517098070,110517098066,-4,2108,5659,20
110517261090,110517261088,-2,1453,3127,20
110517788694,110517788690,-4,1176,3245,20
110521098131,110521098130,-1,1235,2755,20
110523374481,110523374478,-3,795,1880,20
110524342294,110524342295,1,1218,1778,20
110526782091,110526782087,-4,985,1334,20
110531780607,110531780605,-2,881,1290,20
110538381010,110538381013,3,1585,1749,20
110542055560,110542055561,1,2119,2169,20
110542379220,110542379218,-2,1558,2457,20
110546673230,110546673226,-4,1240,1735,20
110547150468,110547150451,-17,937,1996,20
110551258565,110551258562,-3,1389,2916,20
110555210626,110555210624,-2,717,1960,20
110556079016,110556079034,18,644,1696,20
110556863018,110556863015,-3,589,2106,20
110564015771,110564015771,0,1165,1064,20
110564927313,110564927310,-3,1696,2767,20
110566078012,110566078009,-3,603,2208,20
110567506125,110567506145,20,408,2037,20
110572894633,110572894632,-1,1173,2423,20
110572945389,110572945382,-7,1130,2165,20
110574682238,110574682235,-3,894,1751,20
110577019387,110577019382,-5,821,2534,20
110581210461,110581210462,1,1842,2068,20
110588355009,110588355015,6,2604,1598,20
110589043369,110589043363,-6,1243,2144,20
110591628127,110591628124,-3,843,2251,20
110591966743,110591966739,-4,29,554,20
110595915486,110595915485,-1,1619,2544,20
110595951268,110595951286,18,468,3120,20
110596194655,110596194653,-2,1043,2296,20
110596286647,110596286643,-4,1063,2887,20
110598382214,110598382212,-2,1108,1908,20
110602659339,110602659335,-4,1286,2115,20
110604021878,110604021874,-4,1039,2082,20
110610740751,110610740749,-2,2362,3273,20
110611616899,110611616894,-5,986,2622,20
110613981111,110613981113,2,1106,791,20
110629242522,110629242517,-5,1177,2346,20
110632103929,110632103926,-3,27585,8680,20
110633739917,110633739915,-2,1336,1822,20
110634804718,110634804716,-2,1257,2461,20
110635665592,110635665590,-2,1351,2766,20
110642321807,110642321802,-5,951,2214,20
110644846030,110644846023,-7,978,6271,20
110658637908,110658637905,-3,1131,2732,20
110658871849,110658871845,-4,857,1777,20
110660945371,110660945367,-4,1833,3803,20
110663648025,110663648022,-3,1328,2652,20
110665072326,110665072326,0,8790,13204,20
110666164862,110666164858,-4,1004,2110,20
110673680180,110673680185,5,3470,1737,20
110674957571,110674957566,-5,1118,2029,20
110676579666,110676579662,-4,1474,2537,20
110678461933,110678461928,-5,1136,3302,20
110678652855,110678652852,-3,1049,2016,20
110688163707,110688163706,-1,970,1764,20
110692707912,110692707910,-2,1061,2357,20
110694859610,110694859605,-5,1108,2375,20
110695673505,110695673505,0,1495,1725,20
110701270234,110701270230,-4,1104,2221,20
110702754560,110702754546,-14,676,1303,20
110706314183,110706314181,-2,2440,3502,20
110707190534,110707190532,-2,1096,2429,20
110709318634,110709318632,-2,995,2994,20
110709699625,110709699623,-2,1329,2273,20
110711818754,110711818751,-3,1106,2276,20
110728149854,110728149852,-2,659,1947,20
110728397078,110728397062,-16,266,1884,20
110730619934,110730619929,-5,1471,2168,20
110732772048,110732772044,-4,1610,2749,20
110733954912,110733954910,-2,1001,1781,20
110738446531,110738446529,-2,1532,3283,20
110738871922,110738871919,-3,1070,2127,20
110739615574,110739615571,-3,903,2037,20
110742043447,110742043445,-2,1433,1960,20
110745166438,110745166435,-3,1234,2327,20
110746136695,110746136694,-1,1127,1971,20
110746719705,110746719702,-3,1341,2874,20
110748054486,110748054481,-5,615,2156,20
110751485326,110751485324,-2,1050,2554,20
110751865127,110751865146,19,712,1496,20
110752311214,110752311212,-2,1623,2855,20
110753999794,110753999790,-4,817,1892,20
110760201546,110760201550,4,2158,1273,20
110761736358,110761736357,-1,1316,1342,20
110762603462,110762603461,-1,1185,2322,20
110769147946,110769147951,5,4312,2839,20
110771577746,110771577743,-3,816,2433,20
110774531618,110774531615,-3,635,1210,20
110776074920,110776074914,-6,1186,2802,20
110776885003,110776884997,-6,995,2659,20
110778442670,110778442665,-5,1093,3107,20
110779300071,110779300088,17,787,2563,20
110779731495,110779731490,-5,990,2677,20
110779849838,110779849828,-10,1691,2092,20
110783570477,110783570474,-3,883,2277,20
110797959832,110797959825,-7,1350,1961,20
110800302603,110800302601,-2,934,2401,20
110801838649,110801838644,-5,1346,2231,20
110804005547,110804005543,-4,820,2471,20
110807241694,110807241692,-2,1671,2128,20
110808714789,110808714789,0,977,1926,20
110808886330,110808886328,-2,1187,2392,20
110809314987,110809314985,-2,1088,1387,20
110809700148,110809700141,-7,967,4274,20
110810200547,110810200554,7,10869,37801,20
110812118833,110812118829,-4,1197,3287,20
110812280662,110812280681,19,1196,2217,20
110813376810,110813376815,5,5909,2377,20
110814132539,110814132534,-5,29922,30207,20
110814299678,110814299677,-1,772,2558,20
110818333979,110818333975,-4,1033,2027,20
110821261760,110821261757,-3,1359,2283,20
110823189800,110823189797,-3,1217,2687,20
110823767596,110823767578,-18,653,1738,20
110824083739,110824083737,-2,1352,2231,20
110825953603,110825953600,-3,1278,1921,20
110826856410,110826856407,-3,1207,2170,20
110827437391,110827437388,-3,1117,1894,20
110829817983,110829817982,-1,1257,1877,20
110830895287,110830895285,-2,564,1479,20
110836851733,110836851730,-3,452,1617,20
110842080533,110842080540,7,4317,1304,20
110846928314,110846928313,-1,1101,2875,20
110849204742,110849204739,-3,1845,2966,20
110852916397,110852916390,-7,644,2395,20
110853409141,110853409122,-19,920,2264,20
110855755007,110855755004,-3,678,2405,20
110856160315,110856160313,-2,1195,2663,20
110863532087,110863532085,-2,762,1894,20
110863664016,110863664033,17,1088,2110,20
110869222586,110869222582,-4,1145,2422,20
110875169723,110875169718,-5,873,2243,20
110876171245,110876171243,-2,1306,2760,20
110876829422,110876829418,-4,1128,1997,20
110876992456,110876992439,-17,803,807,20
110879419489,110879419495,6,2250,1285,20
110880409759,110880409755,-4,930,2100,20
110880706954,110880706953,-1,999,2459,20
110881082868,110881082866,-2,1368,2740,20
110885459124,110885459119,-5,1200,2722,20
110890502823,110890502820,-3,2683,11424,20
110891331530,110891331528,-2,1008,2477,20
110892521650,110892521647,-3,792,2172,20
110898393910,110898393907,-3,1020,2842,20
110900486985,110900486982,-3,1254,1925,20
110903615218,110903615214,-4,764,2090,20
110906435890,110906435889,-1,1616,2371,20
110909536294,110909536289,-5,734,3151,20
110914378167,110914378162,-5,957,1946,20
110920208893,110920208892,-1,1433,2046,20
110921590226,110921590224,-2,928,1520,20
110924612102,110924612101,-1,836,1748,20
110925623770,110925623765,-5,1142,2144,20
110927911249,110927911246,-3,991,2453,20
110930712285,110930712285,0,1356,2150,20
110931615678,110931615674,-4,1031,2686,20
110935493217,110935493214,-3,1307,2386,20
110935611030,110935611026,-4,1228,1935,20
110941553090,110941553086,-4,718,1939,20
110948579270,110948579269,-1,1103,1695,20
110951153552,110951153549,-3,1286,2574,20
110951236038,110951236036,-2,1474,2290,20
110957361988,110957361985,-3,1373,1887,20
110961683166,110961683165,-1,995,2309,20
110964390645,110964390666,21,992,2753,20
110969178229,110969178226,-3,679,2075,20
110969723135,110969723134,-1,1428,2462,20
110971988707,110971988703,-4,1151,2332,20
110972952434,110972952430,-4,1543,3166,20
110974392411,110974392406,-5,865,2655,20
110975423574,110975423573,-1,1033,2412,20
110977871372,110977871368,-4,1144,2177,20
110979227971,110979227966,-5,818,1131,20
110981195059,110981195057,-2,1241,2004,20
110983376618,110983376616,-2,1352,2251,20
110985729518,110985729515,-3,799,3357,20
110986210345,110986210345,0,5864,18070,20
110988880130,110988880127,-3,1213,2696,20
110993030062,110993030069,7,1874,732,20
110995424647,110995424649,2,2672,1227,20
110996490445,110996490446,1,1295,1638,20
111000350097,111000350094,-3,1516,2603,20
111007418011,111007418006,-5,1244,2991,20
111010114555,111010114554,-1,934,2216,20
111013032769,111013032774,5,4098,2309,20
111018916775,111018916770,-5,1152,2663,20
111019836458,111019836454,-4,912,2051,20
111021141031,111021141030,-1,1120,2149,20
111027840102,111027840102,0,1668,2105,20
111030547711,111030547709,-2,1444,2660,20
111032082693,111032082689,-4,1832,3573,20
111042841701,111042841698,-3,850,1980,20
111044988575,111044988571,-4,912,2211,20
111046590282,111046590278,-4,827,2255,20
111047973720,111047973717,-3,1463,2824,20
111048782578,111048782576,-2,709,2584,20
111049096149,111049096150,1,851,1482,20
111049511328,111049511326,-2,1548,2199,20
111058578778,111058578774,-4,1317,2642,20
111058998490,111058998487,-3,1642,3408,20
111060222462,111060222461,-1,1468,2126,20
111060804840,111060804835,-5,672,2226,20
111062723081,111062723079,-2,1080,2085,20
111063067361,111063067363,2,2010,1467,20
111065421878,111065421879,1,1288,1384,20
111068451731,111068451727,-4,1165,1272,20
111068917258,111068917254,-4,934,2285,20
111072856650,111072856649,-1,1153,2522,20
111073115052,111073115070,18,532,1839,20
111074211833,111074211830,-3,1126,3656,20
111075917239,111075917237,-2,1328,2455,20
111077330020,111077330017,-3,1114,2590,20
111078844293,111078844289,-4,1196,2062,20
111081073118,111081073113,-5,1207,2633,20
111083446107,111083446105,-2,1112,2351,20
111084298699,111084298698,-1,1664,2697,20
111084900142,111084900135,-7,824,1347,20
111085864822,111085864803,-19,1098,1987,20
111087588183,111087588178,-5,2044,5676,20
111090344786,111090344782,-4,1314,2581,20
111091026916,111091026915,-1,1697,2001,20
111092530525,111092530535,10,14645,26998,20
111093598812,111093598807,-5,1106,2266,20
111093700111,111093700095,-16,48444,12824,20
111094481564,111094481562,-2,1341,1840,20
111096843827,111096843822,-5,1701,3344,20
111099017490,111099017486,-4,1459,2871,20
111101640799,111101640795,-4,916,2664,20
111104752492,111104752491,-1,1293,2911,20
111110709118,111110709117,-1,616,1445,20
111112745271,111112745266,-5,1617,4416,20
111114600818,111114600818,0,1600,2970,20
111116008363,111116008360,-3,957,2638,20
111118039028,111118039026,-2,1929,2582,20
111118463873,111118463864,-9,988,2289,20
111123283392,111123283394,2,2976,3335,20
111123457572,111123457577,5,1963,1401,20
111124641940,111124641937,-3,1128,2325,20
111128026779,111128026774,-5,1219,2227,20
111129407457,111129407454,-3,1280,2735,20
111131158456,111131158454,-2,1034,2297,20
111135611052,111135611050,-2,971,1840,20
111135909138,111135909135,-3,1284,2929,20
111140230686,111140230684,-2,962,2342,20
111143289198,111143289194,-4,1015,2372,20
111147318705,111147318703,-2,778,1675,20
111147362987,111147362985,-2,1160,1794,20
111148070902,111148070899,-3,921,2065,20
111149058350,111149058347,-3,1724,2564,20
111150110273,111150110270,-3,996,1896,20
111151844501,111151844502,1,1499,1633,20
111152531114,111152531110,-4,1385,2945,20
111153093721,111153093720,-1,1339,2127,20
111162101212,111162101210,-2,1203,2044,20
111162483423,111162483418,-5,928,2099,20
111166725293,111166725286,-7,774,5945,20
111167258904,111167258899,-5,1135,1979,20
111167312686,111167312694,8,503,1545,20
111169689208,111169689185,-23,1193,2295,20
111178538550,111178538546,-4,1029,1265,20
111180490569,111180490574,5,4526,2489,20
111189909889,111189909885,-4,1116,3344,20
111192808608,111192808606,-2,908,3370,20
111197300327,111197300324,-3,1054,2642,20
111199588004,111199588001,-3,1135,2461,20
111201609686,111201609685,-1,907,1474,20
111204736369,111204736366,-3,957,2070,20
111206710755,111206710753,-2,1643,2155,20
111211612202,111211612199,-3,758,2709,20
111213080290,111213080285,-5,836,2354,20
111213883499,111213883496,-3,819,2010,20
111217169390,111217169386,-4,983,2718,20
111240591067,111240591065,-2,702,1305,20
111243626982,111243626978,-4,891,2089,20
111244276352,111244276350,-2,277,839,20
111244654006,111244654004,-2,1422,2227,20
111246314014,111246314012,-2,1254,1821,20
111246543487,111246543485,-2,720,1118,20
111247738054,111247738061,7,3149,1504,20
111250070212,111250070210,-2,995,1368,20
111258231482,111258231478,-4,925,2722,20
111259061721,111259061722,1,1339,1685,20
111259362130,111259362126,-4,962,1960,20
111261127523,111261127519,-4,1275,1664,20
111261679496,111261679509,13,303,1403,20
111262422662,111262422666,4,23711,20438,20
111266901404,111266901403,-1,43173,16700,20
111272121895,111272121893,-2,805,2085,20
111276461878,111276461877,-1,3080,3788,20
111278285055,111278285050,-5,920,2244,20
111280680943,111280680939,-4,782,3155,20
111281795246,111281795245,-1,938,2442,20
111282174867,111282174866,-1,1460,1850,20
111282335955,111282335953,-2,1526,1887,20
111284952213,111284952212,-1,1138,2403,20
111285876142,111285876126,-16,134,631,20
111288945153,111288945154,1,1446,1201,20
111289607862,111289607864,2,2507,1992,20
111292201105,111292201100,-5,1127,3711,20
111293641834,111293641830,-4,1087,2703,20
111294441509,111294441510,1,2764,2005,20
111294837989,111294837985,-4,1084,1956,20
111301506711,111301506710,-1,1212,2298,20
111305066701,111305066701,0,1271,2013,20
111305741845,111305741866,21,1456,3042,20
111306259606,111306259602,-4,1484,2112,20
111310874434,111310874429,-5,905,2358,20
111313475047,111313475065,18,1068,1721,20
111315267673,111315267670,-3,1177,2222,20
111315497180,111315497184,4,4909,2438,20
111315882915,111315882911,-4,1367,2148,20
111326684375,111326684374,-1,956,2129,20
111330389422,111330389439,17,781,1856,20
111330546293,111330546290,-3,1271,2726,20
111333709589,111333709585,-4,1240,2901,20
111335052318,111335052317,-1,553,1176,20
111338390939,111338390935,-4,1515,2050,20
111339002877,111339002875,-2,1228,2825,20
111339265559,111339265578,19,817,1529,20
111340399006,111340399002,-4,1021,2696,20
111341986739,111341986738,-1,1636,1668,20
111343062150,111343062148,-2,1149,2267,20
111346111299,111346111298,-1,874,2185,20
111348040533,111348040521,-12,855,2637,20
111348232162,111348232158,-4,726,2116,20
111348396632,111348396646,14,317,753,20
111349431087,111349431083,-4,1658,2330,20
111351341287,111351341285,-2,962,1366,20
111352375573,111352375554,-19,864,3285,20
111353152366,111353152363,-3,1674,3235,20
111353404947,111353404945,-2,1596,2388,20
111354787233,111354787229,-4,1523,2938,20
111355981198,111355981211,13,2413,1818,20
111356329959,111356329958,-1,930,2254,20
111362832347,111362832344,-3,1536,3138,20
111363847015,111363847014,-1,904,2479,20
111366558902,111366558898,-4,1379,3254,20
111371074595,111371074591,-4,650,1654,20
111371545612,111371545609,-3,957,2002,20
111373141742,111373141738,-4,1348,1761,20
111375697382,111375697379,-3,981,1945,20
111376247779,111376247777,-2,879,2214,20
111379103034,111379103030,-4,1463,3295,20
111379399845,111379399842,-3,1277,1870,20
111380268285,111380268271,-14,212,1125,20
111382047731,111382047728,-3,1094,2100,20
111382126879,111382126878,-1,1640,2695,20
111383897996,111383897993,-3,1431,2293,20
111387718929,111387718926,-3,2116,3182,20
111389465219,111389465217,-2,1092,2791,20
111389796485,111389796478,-7,871,1960,20
111400773907,111400773903,-4,908,1992,20
111403538142,111403538138,-4,1164,3046,20
111404049046,111404049041,-5,796,1566,20
111408355590,111408355587,-3,1599,2615,20
111410921113,111410921109,-4,1402,2546,20
111413067874,111413067878,4,2214,1559,20
111413221725,111413221722,-3,1376,2285,20
111414621658,111414621656,-2,1339,1991,20
111419444474,111419444470,-4,1106,2049,20
111424145702,111424145708,6,1183,1406,20
111428973583,111428973580,-3,1253,2563,20
111430799358,111430799356,-2,1016,1932,20
111431126178,111431126177,-1,654,1529,20
111434136610,111434136609,-1,1008,2111,20
111436117668,111436117666,-2,1279,2492,20
111437364003,111437363999,-4,1919,3022,20
111439294707,111439294705,-2,1065,1947,20
111439697397,111439697399,2,270,639,20
111440736621,111440736610,-11,1199,3002,20
111441024792,111441024783,-9,891,1808,20
111443193225,111443193218,-7,990,3976,20
111446459633,111446459630,-3,578,1405,20
111448814642,111448814641,-1,1168,2052,20
111449182081,111449182085,4,3201,2607,20
111449679678,111449679677,-1,1324,2043,20
111453309559,111453309557,-2,1363,2133,20
111456350915,111456350912,-3,942,1756,20
111457924762,111457924760,-2,1349,2080,20
111458159496,111458159493,-3,974,2223,20
111459827122,111459827122,0,1306,2211,20
111462024122,111462024119,-3,1115,2256,20
111463645929,111463645927,-2,1460,1693,20
111467500554,111467500552,-2,1198,1604,20
111474529053,111474529050,-3,1107,2797,20
111476029894,111476029890,-4,1219,2786,20
111476767280,111476767279,-1,933,1209,20
111477217640,111477217653,13,244,601,20
111481433227,111481433219,-8,1063,1937,20
111481533793,111481533791,-2,960,2194,20
111484095409,111484095409,0,925,2003,20
111484631820,111484631817,-3,1210,1800,20
111485503240,111485503251,11,632,1944,20
111488595496,111488595497,1,1962,2338,20
111489756799,111489756798,-1,851,2328,20
111493798839,111493798837,-2,1107,3688,20
111494645439,111494645435,-4,1363,2848,20
111495568366,111495568364,-2,1344,2470,20
111499104913,111499104909,-4,1186,2900,20
111501117833,111501117830,-3,1179,2294,20
111501511941,111501511938,-3,935,2508,20
111504290971,111504290963,-8,996,7018,20
111504859261,111504859283,22,1037,1567,20
111505038610,111505038605,-5,1063,2131,20
111505077667,111505077665,-2,1414,2143,20
111506118982,111506118981,-1,1139,2326,20
111507673742,111507673741,-1,1490,2428,20
111509257751,111509257749,-2,782,1788,20
111510579973,111510579969,-4,1121,2515,20
111514137203,111514137202,-1,977,1719,20
111520307306,111520307302,-4,1358,2447,20
111520721085,111520721105,20,839,1485,20
111522172985,111522172984,-1,2314,2536,20
111523683783,111523683780,-3,1373,2380,20
111531615413,111531615410,-3,1068,1665,20
111534602699,111534602698,-1,1118,2596,20
111535151501,111535151498,-3,1360,2748,20
111543292763,111543292758,-5,1519,2617,20
111548373110,111548373107,-3,1514,2415,20
111559414185,111559414194,9,80,1403,20
111560633702,111560633697,-5,1237,4922,20
111560928569,111560928565,-4,1212,3987,20
111563959126,111563959123,-3,1200,2591,20
111573805054,111573805051,-3,1175,3524,20
111576608455,111576608451,-4,977,1501,20
111577066878,111577066898,20,1592,1988,20
111583682570,111583682570,0,38739,24325,20
111584054597,111584054598,1,878,1190,20
111587251275,111587251270,-5,894,2727,20
111593193297,111593193294,-3,831,3097,20
111597433324,111597433319,-5,826,1985,20
111599273894,111599273890,-4,881,1728,20
111602659081,111602659078,-3,1022,1819,20
111603875226,111603875223,-3,1047,1776,20
111611202887,111611202886,-1,1168,2060,20
111611534530,111611534527,-3,1107,3129,20
111615443438,111615443434,-4,1155,2149,20
111619571485,111619571490,5,4634,2240,20
111620146228,111620146225,-3,1653,3251,20
111621573995,111621573993,-2,907,1662,20
111631894956,111631894951,-5,1231,3715,20
111632098966,111632098966,0,1495,3013,20
111634777088,111634777091,3,6755,21795,20
111635259994,111635259993,-1,782,2565,20
111649075707,111649075704,-3,1418,2662,20
111653902666,111653902674,8,11915,2968,20
111656483293,111656483288,-5,967,2120,20
111657268622,111657268620,-2,1867,3298,20
111658804888,111658804884,-4,989,2336,20
111670841232,111670841229,-3,976,1558,20
111671699306,111671699303,-3,1165,2563,20
111673000122,111673000119,-3,873,3066,20
111676707639,111676707635,-4,785,1957,20
111677179551,111677179566,15,1220,2920,20
111683110141,111683110138,-3,1065,2303,20
111683277733,111683277739,6,82,3111,20
111691414779,111691414774,-5,898,2006,20
111691913100,111691913098,-2,1159,3918,20
111702311248,111702311243,-5,675,1868,20
111707704287,111707704286,-1,1503,2739,20
111707795069,111707795067,-2,970,2005,20
111710478427,111710478422,-5,1394,2653,20
111713497949,111713497946,-3,1169,2473,20
111716512274,111716512270,-4,949,1908,20
111724882225,111724882221,-4,1066,3118,20
111727013636,111727013632,-4,1028,1887,20
111732974105,111732974104,-1,835,941,20
111734299310,111734299306,-4,1312,2126,20
111739909994,111739909991,-3,836,2020,20
111743067746,111743067743,-3,1089,2289,20
111746440187,111746440185,-2,1008,1574,20
111747494719,111747494709,-10,811,2442,20
111752054354,111752054350,-4,948,1556,20
111755523116,111755523114,-2,1699,2144,20
111757934859,111757934858,-1,1046,1694,20
111758232203,111758232207,4,1201,1464,20
111758522874,111758522871,-3,787,1465,20
111760240411,111760240410,-1,1566,2227,20
111761527847,111761527844,-3,773,2684,20
111762004207,111762004203,-4,1209,2649,20
111762353095,111762353085,-10,1445,2731,20
111762487710,111762487726,16,113,1125,20
111767567144,111767567142,-2,1182,2249,20
111771146303,111771146297,-6,1144,3697,20
111777376438,111777376434,-4,988,2157,20
111781155616,111781155614,-2,1685,2713,20
111783760023,111783760020,-3,1232,2510,20
111788293178,111788293174,-4,852,1620,20
111789631083,111789631078,-5,1312,1982,20
111792177095,111792177091,-4,903,1538,20
111796309678,111796309684,6,5235,2584,20
111800357595,111800357601,6,11738,23280,20
111801041060,111801041057,-3,1037,1878,20
111804187660,111804187655,-5,1100,2630,20
111806443167,111806443165,-2,1044,1913,20
111807155435,111807155431,-4,1291,2331,20
111808646807,111808646809,2,2983,3601,20
111813346719,111813346716,-3,1565,2909,20
111813892487,111813892484,-3,1293,2671,20
111815977146,111815977143,-3,1594,3180,20
111817688057,111817688063,6,4327,1639,20
111819660599,111819660601,2,773,824,20
111822312033,111822312032,-1,1227,2258,20
111825441966,111825441962,-4,1469,2714,20
111827804794,111827804794,0,1250,1557,20
111833088830,111833088825,-5,810,1977,20
111837024220,111837024218,-2,1363,2279,20
111846531050,111846531049,-1,1180,2359,20
111847497442,111847497438,-4,1794,3215,20
111850017614,111850017610,-4,1061,2054,20
111858013159,111858013154,-5,1011,2683,20
111858343909,111858343907,-2,962,2576,20
111864611162,111864611160,-2,1121,1875,20
111864925641,111864925639,-2,1031,2287,20
111864965694,111864965681,-13,770,1997,20
111866656307,111866656305,-2,1016,2587,20
111868246573,111868246574,1,1449,1677,20
111868865519,111868865516,-3,1253,2138,20
111870530694,111870530691,-3,734,2268,20
111876033053,111876033060,7,5831,2003,20
111877821092,111877821089,-3,1408,3033,20
111884161533,111884161538,5,2524,1195,20
111886496119,111886496118,-1,1329,2393,20
111891755263,111891755258,-5,1215,2741,20
111892295332,111892295350,18,894,1652,20
111893064347,111893064343,-4,947,2693,20
111893894336,111893894333,-3,1745,3876,20
111895626123,111895626127,4,1705,1655,20
111897980497,111897980497,0,938,1538,20
111900480391,111900480390,-1,1137,2587,20
111903347938,111903347935,-3,1265,2221,20
111909393987,111909393985,-2,961,2295,20
111909798846,111909798840,-6,2577,6371,20
111910643903,111910643900,-3,967,2356,20
111911159732,111911159754,22,48,235,20
111916117867,111916117866,-1,724,2430,20
111916711945,111916711942,-3,979,2841,20
111917113059,111917113056,-3,1127,2610,20
111918439281,111918439277,-4,1017,2255,20
111922706761,111922706758,-3,1086,3023,20
111923172487,111923172487,0,1404,1887,20
111923407590,111923407587,-3,298,763,20
111923696160,111923696157,-3,1154,2698,20
111924841667,111924841660,-7,1161,6714,20
111925968233,111925968230,-3,857,2565,20
111930157605,111930157602,-3,1250,3660,20
111934930879,111934930876,-3,982,2970,20
111935672663,111935672659,-4,1410,2872,20
111945387189,111945387185,-4,1054,2306,20
111946312254,111946312249,-5,1081,1766,20
111947055845,111947055842,-3,1082,2805,20
111954476798,111954476795,-3,1387,1847,20
111954642731,111954642729,-2,1041,1729,20
111958865803,111958865802,-1,1087,1857,20
111961242959,111961242963,4,6796,22259,20
111967334993,111967334997,4,3528,1843,20
111967592125,111967592121,-4,869,1836,20
111978520298,111978520297,-1,2273,4317,20
111978973671,111978973668,-3,1266,2803,20
111984433057,111984433054,-3,925,2388,20
111986624153,111986624150,-3,907,1969,20
111988282042,111988282040,-2,914,2301,20
111993968634,111993968631,-3,1093,3480,20
111994084293,111994084290,-3,1158,2469,20
111995637418,111995637414,-4,1117,1958,20
111998992804,111998992801,-3,1051,2350,20
112001629815,112001629814,-1,1198,2217,20
112004368298,112004368296,-2,1504,2729,20
112006197032,112006197030,-2,1058,2044,20
112009385021,112009385027,6,3173,1922,20
112010489934,112010489938,4,2675,1380,20
112013535001,112013534998,-3,1500,2031,20
112013593822,112013593822,0,2368,2670,20
112015950386,112015950383,-3,1070,3190,20
112018230664,112018230660,-4,1373,3695,20
112018821004,112018821021,17,745,1046,20
112025521730,112025521727,-3,1104,2212,20
112030030047,112030030045,-2,837,1524,20
112043613457,112043613455,-2,1627,2883,20
112046693636,112046693632,-4,842,3527,20
112046830654,112046830637,-17,232,964,20
112047284939,112047284937,-2,1148,2216,20
112055565091,112055565084,-7,1097,2109,20
112058436870,112058436866,-4,974,1511,20
112058534207,112058534201,-6,963,4169,20
112062326587,112062326582,-5,519,2723,20
112063675591,112063675588,-3,1061,3097,20
112063923333,112063923339,6,6554,2429,20
112064492225,112064492227,2,3617,2762,20
112065529852,112065529850,-2,1114,2539,20
112068567362,112068567360,-2,1229,3096,20
112069034409,112069034406,-3,709,1492,20
112070227345,112070227342,-3,913,2313,20
112071495726,112071495725,-1,950,1978,20
112074441796,112074441803,7,3654,1851,20
112077260841,112077260841,0,1675,1496,20
112077799910,112077799907,-3,1093,1389,20
112084254506,112084254502,-4,1268,2630,20
112084661893,112084661889,-4,739,1698,20
112085063971,112085063975,4,957,754,20
112086420140,112086420146,6,191,966,20
112090010517,112090010517,0,1135,1371,20
112091546841,112091546839,-2,1406,2711,20
112092781542,112092781541,-1,1639,2498,20
112093290754,112093290761,7,3598,1240,20
112093976830,112093976826,-4,1032,1660,20
112100335227,112100335229,2,1679,1980,20
112101041258,112101041255,-3,1016,2346,20
112103098099,112103098097,-2,705,2354,20
112104345968,112104345965,-3,1443,2060,20
112109880402,112109880402,0,1293,2637,20
112114387175,112114387171,-4,1033,2107,20
112119217506,112119217503,-3,1131,2538,20
112121777338,112121777334,-4,861,1655,20
112122103995,112122103996,1,3406,3363,20
112127049098,112127049097,-1,936,2129,20
112127963143,112127963139,-4,1236,2230,20
112129707397,112129707397,0,1290,1650,20
112133579374,112133579378,4,1177,1469,20
112135814183,112135814181,-2,820,2030,20
112136801957,112136801955,-2,954,1595,20
112145184771,112145184769,-2,659,1626,20
112148300322,112148300322,0,1221,1634,20
112149212746,112149212742,-4,1423,2516,20
112158721235,112158721233,-2,906,2658,20
112160345973,112160345970,-3,1525,2841,20
112163629815,112163629813,-2,1549,2167,20
112167461417,112167461415,-2,1773,3010,20
112171662515,112171662511,-4,1128,2231,20
112172242074,112172242073,-1,1195,2800,20
112172310330,112172310329,-1,930,2203,20
112173934771,112173934767,-4,974,1881,20
112183746746,112183746742,-4,1026,2329,20
112184918553,112184918549,-4,1296,3259,20
112188755518,112188755515,-3,1335,2003,20
112189805614,112189805620,6,2589,957,20
112190390035,112190390031,-4,1001,2443,20
112191172078,112191172076,-2,997,2119,20
112192012370,112192012368,-2,1197,2562,20
112200931527,112200931525,-2,1122,2020,20
112201543237,112201543235,-2,1122,1871,20
112204948815,112204948813,-2,1135,2441,20
112206107509,112206107506,-3,1403,2496,20
112206235692,112206235686,-6,1575,2576,20
112206845994,112206845993,-1,1183,2155,20
112207136373,112207136370,-3,1299,2993,20
112208267663,112208267658,-5,1397,3204,20
112208813833,112208813841,8,6068,2600,20
112218847767,112218847763,-4,1029,2155,20
112223880621,112223880622,1,1018,1837,20
112225104800,112225104794,-6,2231,9100,20
112226048086,112226048085,-1,1524,2094,20
112227739994,112227739991,-3,1081,2181,20
112228374813,112228374834,21,1297,2950,20
112231730170,112231730167,-3,1139,2572,20
112232359264,112232359259,-5,1362,3209,20
112236550525,112236550522,-3,1338,3047,20
112237292214,112237292212,-2,1130,1746,20
112237452239,112237452235,-4,1216,1886,20
112238072001,112238071998,-3,816,2455,20
112240496246,112240496242,-4,1147,2478,20
112241211621,112241211618,-3,1584,2614,20
112246153497,112246153494,-3,1055,2711,20
112249893985,112249893981,-4,1111,1901,20
112252278518,112252278516,-2,1228,2541,20
112252758151,112252758150,-1,1469,2737,20
112260938449,112260938446,-3,1247,2273,20
112264241996,112264241994,-2,1323,2737,20
112264405701,112264405711,10,467,1313,20
112265650132,112265650126,-6,1045,2774,20
112271276997,112271276994,-3,1077,2277,20
112272119375,112272119372,-3,530,1222,20
112273906076,112273906073,-3,1589,2396,20
112275489636,112275489633,-3,1116,1970,20
112286249869,112286249863,-6,1226,2505,20
112293398026,112293398022,-4,1027,2208,20
112293635086,112293635086,0,873,1635,20
112298824505,112298824502,-3,1358,2241,20
112301145235,112301145233,-2,1084,1764,20
112303783047,112303783043,-4,1142,3765,20
112308164833,112308164834,1,1978,1405,20
112310322229,112310322231,2,1439,1560,20
112314821329,112314821326,-3,891,1852,20
112317365286,112317365282,-4,1227,1642,20
112329512243,112329512242,-1,1282,2148,20
112330576142,112330576146,4,6900,20386,20
112332522838,112332522837,-1,1684,2286,20
112334637565,112334637562,-3,1396,2359,20
112337485627,112337485625,-2,1149,2462,20
112343138474,112343138470,-4,1395,2353,20
112343629034,112343629031,-3,1413,3237,20
112348630838,112348630833,-5,708,1392,20
112350394744,112350394742,-2,879,2273,20
112350863017,112350863023,6,3026,2025,20
112354095785,112354095784,-1,987,1348,20
112355364859,112355364857,-2,735,1877,20
112368255689,112368255685,-4,1375,2762,20
112369394198,112369394194,-4,835,2400,20
112369759874,112369759879,5,2531,1392,20
112370763339,112370763337,-2,662,1164,20
112376154344,112376154342,-2,1133,2213,20
112379432019,112379432033,14,13616,48091,20
112392592922,112392592918,-4,2223,3173,20
112400665451,112400665458,7,2809,1236,20
112408175679,112408175676,-3,832,2150,20
112408965667,112408965664,-3,1384,2713,20
112411166087,112411166086,-1,676,1089,20
112414511357,112414511354,-3,872,2407,20
112418341398,112418341394,-4,1186,1974,20
112428921907,112428921903,-4,1495,2330,20
112431373459,112431373456,-3,881,2453,20
112432901386,112432901382,-4,831,2091,20
112435730761,112435730762,1,1042,2160,20
112437233836,112437233835,-1,1445,1713,20
112447221080,112447221082,2,2399,2187,20
112448996053,112448996050,-3,969,1915,20
112449484332,112449484326,-6,1317,2205,20
112451577837,112451577834,-3,1257,2548,20
112451716038,112451716037,-1,1007,2436,20
112454158149,112454158148,-1,1307,2570,20
112459637615,112459637611,-4,1403,2609,20
112459818521,112459818519,-2,1198,2301,20
112460329790,112460329801,11,413,841,20
112461049618,112461049618,0,1263,1586,20
112462784754,112462784750,-4,918,2740,20
112463918200,112463918197,-3,996,2210,20
112464064721,112464064718,-3,1297,2239,20
112465282986,112465282981,-5,843,2581,20
112473278274,112473278270,-4,766,2190,20
112475171780,112475171778,-2,1235,1958,20
112479651099,112479651097,-2,1479,2222,20
112481912510,112481912506,-4,1258,2618,20
112488778109,112488778107,-2,1117,2552,20
112488888676,112488888694,18,846,2735,20
112499643269,112499643265,-4,989,1703,20
112504269931,112504269926,-5,1039,1684,20
112504534382,112504534403,21,839,1362,20
112506024318,112506024318,0,1296,1823,20
112512109661,112512109653,-8,907,1490,20
112513046397,112513046395,-2,1230,2324,20
112513131766,112513131786,20,782,2088,20
112516438259,112516438255,-4,998,2117,20
112520845534,112520845529,-5,1444,2117,20
112520962483,112520962481,-2,1121,2477,20
112521873354,112521873346,-8,23289,18260,20
112525602250,112525602247,-3,1188,2284,20
112527565106,112527565103,-3,842,1545,20
112538702313,112538702309,-4,1152,2464,20
112540146850,112540146847,-3,1288,2562,20
112542426990,112542426990,0,871,1765,20
112547538662,112547538658,-4,1020,2198,20
112548540199,112548540213,14,16166,28032,20
112549367357,112549367354,-3,1187,3077,20
112550573382,112550573378,-4,1029,2173,20
112553971602,112553971599,-3,1255,2051,20
112554688213,112554688212,-1,1444,2311,20
112555910504,112555910499,-5,1024,1782,20
112558868699,112558868698,-1,743,2216,20
112562763193,112562763186,-7,1973,4669,20
112565384323,112565384319,-4,1054,2431,20
112571581438,112571581442,4,2442,980,20
112572108743,112572108737,-6,1108,3875,20
112572205918,112572205938,20,644,1891,20
112576385522,112576385526,4,4688,1879,20
112577601199,112577601195,-4,1195,2094,20
112578070903,112578070906,3,229,969,20
112583773222,112583773218,-4,1182,1985,20
112585046378,112585046377,-1,858,1878,20
112588688892,112588688891,-1,963,1764,20
112593036343,112593036341,-2,1333,2087,20
112593500931,112593500926,-5,1078,1279,20
112594424798,112594424797,-1,930,1841,20
112600002759,112600002754,-5,817,2003,20
112600389133,112600389130,-3,1012,2245,20
112605802542,112605802540,-2,2034,4162,20
112607320918,112607320914,-4,1235,3813,20
112610501091,112610501089,-2,832,2111,20
112611104633,112611104641,8,7865,32410,20
112616508509,112616508505,-4,1757,2549,20
112618033537,112618033534,-3,1470,2711,20
112619266138,112619266136,-2,1415,2296,20
112623763486,112623763482,-4,860,2632,20
112627189882,112627189881,-1,1155,1660,20
112628858247,112628858243,-4,1044,1527,20
112632380462,112632380458,-4,1172,2435,20
112639252635,112639252631,-4,882,2738,20
112641046878,112641046876,-2,1287,3072,20
112641859636,112641859633,-3,1018,2383,20
112642433230,112642433232,2,852,1653,20
112649647936,112649647932,-4,1269,3451,20
112652231319,112652231315,-4,760,2303,20
112659097562,112659097560,-2,1114,2944,20
112664098446,112664098441,-5,1817,3111,20
112664380769,112664380764,-5,1673,2418,20
112664803244,112664803243,-1,1148,1437,20
112666693346,112666693346,0,1199,1906,20
112671013133,112671013126,-7,1082,2565,20
112675195998,112675195996,-2,1293,2514,20
112676035787,112676035786,-1,1005,2063,20
112676634146,112676634144,-2,872,1778,20
112683985583,112683985580,-3,1122,2161,20
112688388365,112688388362,-3,1135,2888,20
112689262907,112689262906,-1,1662,1986,20
112690225789,112690225787,-2,1452,2884,20
112692079954,112692079950,-4,688,1734,20
112692169062,112692169046,-16,198,745,20
112693153829,112693153826,-3,908,2203,20
112696356938,112696356942,4,1882,2109,20
112696548846,112696548841,-5,1245,1970,20
112696655127,112696655123,-4,1376,2861,20
112697025880,112697025876,-4,1152,1603,20
112699550487,112699550491,4,42683,2562,20
112699599107,112699599113,6,2911,1516,20
112702476503,112702476501,-2,1350,2355,20
112712649710,112712649716,6,3991,1459,20
112713777835,112713777833,-2,1045,1970,20
112714785723,112714785721,-2,760,2013,20
112716783984,112716783982,-2,1246,2288,20
112717702458,112717702455,-3,1394,1906,20
112718962825,112718962823,-2,697,2588,20
112722043627,112722043625,-2,1037,2571,20
112722975654,112722975658,4,1804,1773,20
112725136320,112725136318,-2,9248,17050,20
112725494947,112725494945,-2,1233,1631,20
112726771169,112726771164,-5,1333,2820,20
112731283865,112731283861,-4,889,1818,20
112732520836,112732520832,-4,1389,2690,20
112736932419,112736932416,-3,1214,2652,20
112737547175,112737547193,18,544,1467,20
112737701779,112737701774,-5,1910,3321,20
112738587074,112738587071,-3,1388,2292,20
112739118343,112739118339,-4,1520,2592,20
112739147392,112739147390,-2,1404,2916,20
112740350247,112740350244,-3,1135,1982,20
112745655059,112745655065,6,1914,915,20
112746134385,112746134379,-6,1149,2941,20
112747018415,112747018408,-7,689,4923,20
112748515522,112748515521,-1,1331,3430,20
112748700371,112748700365,-6,1120,2899,20
112749112806,112749112822,16,804,1177,20
112749893726,112749893732,6,2711,1617,20
112754933863,112754933860,-3,1215,1642,20
112761902733,112761902730,-3,1191,2302,20
112771004877,112771004876,-1,748,2082,20
112773262285,112773262281,-4,1234,4941,20
112777270382,112777270375,-7,2747,8165,20
112778149179,112778149178,-1,982,1487,20
112779792567,112779792565,-2,1118,2320,20
112780765263,112780765261,-2,968,2513,20
112782427918,112782427912,-6,30578,11652,20
112785400944,112785400942,-2,1220,1844,20
112786568746,112786568738,-8,1455,7110,20
112787027251,112787027250,-1,1095,2204,20
112791049570,112791049567,-3,1238,3183,20
112791482434,112791482430,-4,984,1762,20
112794501548,112794501546,-2,1496,1800,20
112798901900,112798901882,-18,212,938,20
112803754426,112803754421,-5,1091,2323,20
112809779381,112809779378,-3,1553,2769,20
112812490774,112812490779,5,1445,1198,20
112813095682,112813095678,-4,1197,3207,20
112814134298,112814134298,0,1560,2369,20
112814598838,112814598834,-4,1542,2586,20
112820771350,112820771347,-3,866,1662,20
112822736706,112822736705,-1,1909,2935,20
112830085067,112830085063,-4,810,1376,20
112830758457,112830758459,2,1553,1425,20
112834778943,112834778946,3,2255,1439,20
112837219663,112837219661,-2,1098,2126,20
112839312182,112839312178,-4,1146,2434,20
112840429475,112840429473,-2,1191,1985,20
112840722513,112840722506,-7,1470,2729,20
112847289227,112847289226,-1,1230,2132,20
112847402598,112847402594,-4,1487,3549,20
112855221513,112855221511,-2,1686,2541,20
112858222386,112858222385,-1,1313,2260,20
112861281528,112861281523,-5,960,2057,20
112864296184,112864296178,-6,1086,4149,20
112864540237,112864540257,20,953,2160,20
112878550761,112878550758,-3,1335,2785,20
112879052974,112879052970,-4,1071,2048,20
112882032872,112882032868,-4,1469,3198,20
112882456599,112882456594,-5,1101,2277,20
112892445432,112892445430,-2,1739,2590,20
112898289965,112898289961,-4,1114,1603,20
112898432166,112898432178,12,483,2078,20
112899734820,112899734818,-2,1262,2498,20
112902630088,112902630087,-1,1513,2120,20
112902818990,112902818982,-8,1053,2195,20
112902946502,112902946481,-21,1190,2730,20
112903844186,112903844186,0,957,1814,20
112905120282,112905120281,-1,1622,2271,20
112905348163,112905348167,4,2992,1866,20
112907966196,112907966193,-3,1036,2611,20
112911270773,112911270770,-3,993,1654,20
112912373454,112912373434,-20,1178,2795,20
112912507110,112912507129,19,840,1729,20
112918690701,112918690696,-5,1492,2031,20
112919425895,112919425893,-2,1283,2645,20
112919466596,112919466593,-3,1019,2298,20
112922168275,112922168271,-4,1396,3327,20
112924292913,112924292909,-4,1093,2885,20
112924418072,112924418089,17,1077,2549,20
112927260370,112927260372,2,1642,1661,20
112928320079,112928320075,-4,987,2534,20
112929275138,112929275137,-1,1102,2153,20
112929582309,112929582329,20,610,1395,20
112930001201,112930001198,-3,1196,2496,20
112931811957,112931811963,6,6771,2597,20
112932842284,112932842284,0,1456,1756,20
112934051378,112934051382,4,1184,1240,20
112934105602,112934105601,-1,1237,1911,20
112935226797,112935226792,-5,1221,2637,20
112939071888,112939071885,-3,1082,2157,20
112939737470,112939737466,-4,988,1908,20
112942672938,112942672935,-3,1165,2845,20
112947737891,112947737888,-3,1013,2045,20
112949347258,112949347257,-1,1268,2338,20
112951248462,112951248460,-2,1252,2389,20
112952023541,112952023538,-3,1102,3172,20
112953190674,112953190670,-4,1133,3065,20
112953227655,112953227635,-20,106,1001,20
112954896537,112954896532,-5,893,3126,20
112958927967,112958927965,-2,992,2690,20
112959717687,112959717686,-1,920,2093,20
112962707461,112962707461,0,1034,2296,20
112963409931,112963409927,-4,1570,2605,20
112966694739,112966694736,-3,1407,2196,20
112967548045,112967548043,-2,1078,1849,20
112967726776,112967726791,15,1203,2329,20
112969417002,112969417000,-2,925,2347,20
112972466331,112972466329,-2,991,2224,20
112974972878,112974972878,0,3410,3235,20
112977518094,112977518088,-6,1019,2769,20
112982662790,112982662786,-4,1028,2827,20
112982921954,112982921952,-2,1130,2604,20
112983633170,112983633169,-1,936,1863,20
112984882966,112984882963,-3,736,2678,20
112985728514,112985728510,-4,1552,2682,20
112988038727,112988038724,-3,992,3006,20
112988064583,112988064582,-1,1491,2565,20
112993493419,112993493418,-1,929,1917,20
112995464865,112995464863,-2,1147,2300,20
113000137043,113000137043,0,814,1594,20
113000315495,113000315493,-2,1580,2208,20
113000539273,113000539270,-3,1033,2464,20
113001123194,113001123193,-1,629,1518,20
113002285546,113002285541,-5,1370,2798,20
113002747038,113002747045,7,453,1443,20
113005899662,113005899664,2,1446,2177,20
113009586666,113009586662,-4,1237,1795,20
113013844707,113013844704,-3,1161,2118,20
113017113347,113017113344,-3,955,2052,20
113020902431,113020902429,-2,1251,1869,20
113021781497,113021781493,-4,1549,4062,20
113022571772,113022571770,-2,1285,2611,20
113023852170,113023852165,-5,1622,3758,20
113028982777,113028982773,-4,1380,2302,20
113030009389,113030009385,-4,1302,1943,20
113036741548,113036741550,2,98,672,20
113038634118,113038634118,0,1595,3012,20
113040543622,113040543617,-5,1111,2215,20
113042784898,113042784894,-4,1488,2280,20
113043404698,113043404694,-4,783,2179,20
113047449313,113047449311,-2,949,1764,20
113048013151,113048013147,-4,1067,1916,20
113052409678,113052409675,-3,1084,2844,20
113054811838,113054811837,-1,964,2075,20
113056223481,113056223478,-3,999,2168,20
113058296942,113058296938,-4,1112,2429,20
113058409428,113058409408,-20,244,570,20
113059937657,113059937655,-2,1058,2038,20
113076907062,113076907063,1,3359,2529,20
113079996359,113079996355,-4,1625,2445,20
113081668192,113081668197,5,2620,1191,20
113082611563,113082611561,-2,805,2431,20
113087170263,113087170259,-4,1290,2453,20
113090174841,113090174837,-4,1023,1921,20
113090663288,113090663285,-3,1229,3797,20
113098390975,113098390970,-5,1212,3561,20
113103303746,113103303744,-2,1273,3255,20
113105089746,113105089741,-5,989,2430,20
113106767814,113106767810,-4,1373,3047,20
113107433471,113107433468,-3,1324,2631,20
113109667180,113109667178,-2,1305,1598,20
113127980289,113127980285,-4,1583,2923,20
113130767689,113130767682,-7,1015,2680,20
113131888700,113131888691,-9,239,1098,20
113133662821,113133662815,-6,1864,6596,20
113133792070,113133792068,-2,1088,2602,20
113135138735,113135138712,-23,1046,2402,20
113137237785,113137237782,-3,1426,2779,20
113140407249,113140407244,-5,1317,2576,20
113147144493,113147144489,-4,1083,2373,20
113149978654,113149978650,-4,947,2591,20
113150101173,113150101158,-15,994,1901,20
113157398967,113157398965,-2,1148,2298,20
113158932740,113158932737,-3,1401,2461,20
113163821218,113163821219,1,1225,1266,20
113166321523,113166321521,-2,1161,1955,20
113166826855,113166826858,3,1756,1407,20
113171228145,113171228142,-3,1234,2628,20
113171764987,113171764985,-2,1262,2733,20
113182188611,113182188609,-2,1110,2072,20
113184970201,113184970198,-3,1235,3050,20
113187475243,113187475240,-3,1144,2276,20
113189268491,113189268490,-1,969,1569,20
113192921702,113192921697,-5,844,1868,20
113193690314,113193690311,-3,1026,2477,20
113195980253,113195980250,-3,1073,2188,20
113197483913,113197483916,3,1715,1650,20
113197937541,113197937538,-3,1066,2314,20
113199140026,113199140023,-3,732,1986,20
113202215198,113202215195,-3,1378,3482,20
113202694740,113202694736,-4,1106,2127,20
113203217327,113203217322,-5,1071,3749,20
113203734781,113203734778,-3,1227,2648,20
113205620188,113205620186,-2,982,1671,20
113206511580,113206511585,5,2019,1545,20
113210406270,113210406268,-2,707,1564,20
113214031418,113214031414,-4,1069,2401,20
113214613327,113214613322,-5,925,2163,20
113214982036,113214982059,23,645,1462,20
113217954662,113217954659,-3,830,1959,20
113218060005,113218060001,-4,1036,2612,20
113219024559,113219024561,2,1272,1732,20
113225125311,113225125314,3,2805,1667,20
113231581458,113231581454,-4,1368,2772,20
113237348970,113237348965,-5,1346,2444,20
113243781170,113243781169,-1,1052,2351,20
113249038064,113249038071,7,62,945,20
113253135471,113253135468,-3,929,1953,20
113255721713,113255721710,-3,1170,2448,20
113258815770,113258815766,-4,900,3302,20
113260983982,113260983997,15,566,1531,20
113261453090,113261453089,-1,1238,2233,20
113265306575,113265306574,-1,1299,3295,20
113265421119,113265421117,-2,959,2287,20
113266133718,113266133717,-1,815,2196,20
113271382347,113271382345,-2,1089,3128,20
113272121844,113272121841,-3,1970,3675,20
113273531703,113273531699,-4,1101,2231,20
113273799757,113273799777,20,1063,2135,20
113275276425,113275276422,-3,1161,2627,20
113283736327,113283736324,-3,1038,2994,20
113284007358,113284007338,-20,878,2287,20
113284428055,113284428052,-3,1023,2062,20
113284975231,113284975251,20,1731,2661,20
113291509118,113291509118,0,1825,2725,20
113291933957,113291933955,-2,1254,2358,20
113296700994,113296700990,-4,924,2646,20
113296745941,113296745933,-8,258,1031,20
113296821718,113296821716,-2,1249,2498,20
113297128695,113297128693,-2,1147,2071,20
113297477391,113297477410,19,916,1864,20
113299193004,113299193002,-2,749,1233,20
113299855617,113299855614,-3,965,2450,20
113305079762,113305079761,-1,967,2563,20
113308124870,113308124875,5,1963,1034,20
113312005243,113312005240,-3,909,2811,20
113313075085,113313075106,21,1023,3248,20
113315242643,113315242638,-5,811,2387,20
113320145050,113320145048,-2,1309,2468,20
113329192713,113329192711,-2,1746,2794,20
113331307606,113331307604,-2,1137,1666,20
113331981349,113331981346,-3,1302,1815,20
113332339986,113332339982,-4,1072,3477,20
113336643256,113336643251,-5,1114,2167,20
113338160043,113338160038,-5,606,1524,20
113340835342,113340835340,-2,1102,2988,20
113341904187,113341904184,-3,941,3122,20
113342205586,113342205585,-1,1218,1791,20
113349710871,113349710868,-3,1170,1955,20
113353970437,113353970434,-3,1628,2799,20
113358025366,113358025363,-3,1288,2311,20
113364784493,113364784490,-3,969,3193,20
113367330803,113367330802,-1,830,2183,20
113368691333,113368691339,6,17171,32498,20
113380542644,113380542649,5,1253,1235,20
113383930252,113383930246,-6,1646,3894,20
113389011066,113389011061,-5,761,1800,20
113393877615,113393877609,-6,1191,2447,20
113399157968,113399157966,-2,1264,2296,20
113404234871,113404234868,-3,897,1894,20
113404757060,113404757082,22,1745,3113,20
113417082321,113417082316,-5,966,2037,20
113419577250,113419577246,-4,1201,2619,20
113421038474,113421038466,-8,610,1559,20
113424490346,113424490343,-3,1268,2797,20
113430670042,113430670041,-1,1496,2247,20
113431160045,113431160033,-12,1023,1811,20
113431999947,113431999943,-4,1233,2413,20
113433053503,113433053498,-5,1345,3591,20
113433897526,113433897524,-2,1552,2012,20
113434428094,113434428088,-6,1088,5831,20
113435139525,113435139518,-7,1315,2530,20
113438374717,113438374722,5,3764,1555,20
113444924494,113444924490,-4,696,3668,20
113445478244,113445478227,-17,1230,756,20
113450268072,113450268070,-2,1539,2598,20
113450686894,113450686886,-8,1252,2656,20
113454040433,113454040438,5,3173,1648,20
113455286661,113455286667,6,1969,1337,20
113455881558,113455881562,4,2775,1644,20
113459499222,113459499218,-4,765,2088,20
113467023304,113467023308,4,842,1541,20
113468649895,113468649892,-3,1105,2982,20
113469099967,113469099966,-1,1013,2326,20
113470245461,113470245481,20,815,1817,20
113471898056,113471898053,-3,1287,2461,20
113476279395,113476279393,-2,973,2834,20
113478770739,113478770737,-2,1222,2527,20
113480533100,113480533102,2,1370,1312,20
113480979535,113480979531,-4,1184,2682,20
113483332338,113483332333,-5,670,2585,20
113491519499,113491519498,-1,1063,2876,20
113494937385,113494937381,-4,1487,2738,20
113498827982,113498827980,-2,975,2159,20
113499088629,113499088626,-3,1117,1986,20
113500006960,113500006958,-2,1795,2311,20
113500967234,113500967228,-6,1273,4284,20
113501456756,113501456775,19,357,923,20
113504520762,113504520761,-1,1127,2042,20
113505621391,113505621398,7,5797,2060,20
113513133930,113513133927,-3,1350,2139,20
113514688646,113514688643,-3,854,2166,20
113515189405,113515189398,-7,1352,2741,20
113515643849,113515643847,-2,765,1625,20
113516978396,113516978398,2,4022,3222,20
113517893311,113517893308,-3,1078,2120,20
113521093703,113521093719,16,476,1285,20
113521397204,113521397201,-3,917,2367,20
113522317145,113522317142,-3,1149,2536,20
113525716139,113525716137,-2,1153,2770,20
113526377109,113526377106,-3,786,3217,20
113526542838,113526542835,-3,1327,2886,20
113528360694,113528360698,4,1783,1132,20
113530291914,113530291913,-1,985,1770,20
113531459717,113531459713,-4,658,1648,20
113533190129,113533190125,-4,597,2547,20
113534209567,113534209567,0,1291,1299,20
113534248590,113534248589,-1,962,2359,20
113534914770,113534914766,-4,926,2507,20
113536167125,113536167121,-4,1004,3040,20
113536823405,113536823393,-12,687,1618,20
113538736066,113538736062,-4,828,1739,20
113539967327,113539967326,-1,829,1811,20
113540826215,113540826212,-3,1004,2730,20
113541409986,113541409985,-1,1256,2089,20
113545056841,113545056838,-3,927,2903,20
113545392909,113545392904,-5,1612,2389,20
113545536838,113545536850,12,454,591,20
113546166557,113546166554,-3,1183,1783,20
113549165614,113549165612,-2,1263,3184,20
113549212869,113549212866,-3,721,2299,20
113550220061,113550220058,-3,1021,2009,20
113550845967,113550845965,-2,1330,2900,20
113561284642,113561284639,-3,1020,1960,20
113562818905,113562818904,-1,414,1431,20
113563363512,113563363522,10,188,936,20
113569136755,113569136750,-5,854,2692,20
113569494475,113569494477,2,31893,22749,20
113571549729,113571549729,0,1453,1503,20
113579931278,113579931282,4,1717,1898,20
113580714002,113580713999,-3,1257,3350,20
113584839091,113584839095,4,669,1511,20
113585707059,113585707057,-2,1381,2278,20
113587022208,113587022206,-2,694,1746,20
113587641997,113587641995,-2,822,2436,20
113588665314,113588665313,-1,1617,2108,20
113590204584,113590204589,5,4016,1667,20
113596521117,113596521114,-3,1206,2271,20
113602174766,113602174764,-2,1644,2781,20
113605122287,113605122283,-4,1334,3084,20
113605843946,113605843942,-4,1382,2366,20
113609363987,113609363984,-3,1822,4819,20
113616214648,113616214646,-2,646,2562,20
113617332554,113617332552,-2,1225,2100,20
113621986621,113621986618,-3,1165,2409,20
113622367589,113622367587,-2,1296,2566,20
113623972259,113623972255,-4,797,1818,20
113624428856,113624428873,17,958,2010,20
113628379208,113628379205,-3,1331,2892,20
113631498562,113631498558,-4,1021,2053,20
113635282092,113635282078,-14,200,968,20
113635598256,113635598250,-6,1865,3915,20
113637255741,113637255737,-4,969,2025,20
113640377922,113640377923,1,1294,1338,20
113644906475,113644906474,-1,1250,1648,20
113645299962,113645299970,8,283,1327,20
113647013414,113647013413,-1,1190,2286,20
113649130882,113649130884,2,1671,1564,20
113649641050,113649641049,-1,1331,2073,20
113651606693,113651606694,1,1771,1784,20
113654976516,113654976520,4,1779,1579,20
113656399562,113656399563,1,1442,1546,20
113657288354,113657288354,0,719,1542,20
113658430510,113658430495,-15,255,1573,20
113658938710,113658938719,9,208,769,20
113667887702,113667887698,-4,705,2454,20
113668324898,113668324895,-3,924,1834,20
113673115531,113673115529,-2,798,2353,20
113677258886,113677258889,3,8523,7193,20
113677598414,113677598411,-3,1558,2720,20
113682621481,113682621479,-2,1075,2075,20
113684872529,113684872527,-2,1286,1755,20
113687938276,113687938273,-3,1232,1961,20
113697298646,113697298644,-2,975,2375,20
113699978826,113699978825,-1,1169,1385,20
113701655389,113701655410,21,1775,2733,20
113706956894,113706956891,-3,988,1962,20
113716133491,113716133488,-3,1460,2345,20
113720474076,113720474072,-4,1148,2140,20
113720506370,113720506369,-1,1616,2746,20
113721427485,113721427481,-4,745,2009,20
113721542088,113721542102,14,620,1281,20
113724331499,113724331496,-3,1199,1936,20
113725132333,113725132331,-2,701,1982,20
113729118530,113729118526,-4,1397,1770,20
113732783523,113732783520,-3,1300,2107,20
113734891605,113734891602,-3,1178,2142,20
113735708898,113735708889,-9,1441,8492,20
113743070772,113743070777,5,2131,1515,20
113745473895,113745473895,0,1483,2414,20
113749221966,113749221962,-4,1116,1832,20
113752449022,113752449019,-3,960,1918,20
113752612347,113752612345,-2,538,1210,20
113753469790,113753469790,0,725,1734,20
113757710415,113757710414,-1,1052,1530,20
113762795274,113762795277,3,56448,38715,20
113764361542,113764361538,-4,1328,2831,20
113765110477,113765110474,-3,1435,2509,20
113766420402,113766420403,1,1741,1536,20
113766678846,113766678841,-5,1058,3231,20
113770179645,113770179641,-4,892,1842,20
113776735269,113776735264,-5,5092,13729,20
113779052071,113779052069,-2,793,1653,20
113784136519,113784136515,-4,1541,2222,20
113784696932,113784696925,-7,2665,11278,20
113786487388,113786487382,-6,1051,4309,20
113788915074,113788915070,-4,1155,2019,20
113789326113,113789326110,-3,1506,2471,20
113790253652,113790253649,-3,856,2126,20
113791558316,113791558309,-7,1144,2582,20
113793120799,113793120795,-4,1207,2103,20
113794938901,113794938898,-3,1558,2673,20
113795282606,113795282624,18,545,2489,20
113796175366,113796175362,-4,649,2202,20
113796553152,113796553149,-3,1311,2438,20
113796947040,113796947038,-2,1270,2455,20
113802963098,113802963095,-3,1002,2215,20
113805957885,113805957884,-1,1024,2229,20
113806678847,113806678842,-5,1341,2529,20
113807616562,113807616559,-3,892,1965,20
113812823475,113812823470,-5,1103,1974,20
113812960054,113812960046,-8,1100,2502,20
113816804341,113816804339,-2,1307,2085,20
113821691650,113821691647,-3,1087,2692,20
113822388815,113822388813,-2,1249,1715,20
113826486679,113826486676,-3,1113,3065,20
113830561258,113830561257,-1,902,1783,20
113836530309,113836530306,-3,1289,2038,20
113838136198,113838136194,-4,1501,3034,20
113840136273,113840136269,-4,1083,2482,20
113846572922,113846572919,-3,882,2949,20
113847168095,113847168091,-4,1008,3015,20
113849737954,113849737957,3,5183,2601,20
113856676661,113856676658,-3,1045,2397,20
113857897342,113857897341,-1,776,2303,20
113860563191,113860563189,-2,907,1987,20
113862875443,113862875441,-2,1211,2834,20
113870988454,113870988449,-5,1135,4696,20
113873319199,113873319196,-3,921,2545,20
113873411045,113873411041,-4,1171,1995,20
113873979782,113873979779,-3,997,1702,20
113874898531,113874898527,-4,985,1817,20
113875677885,113875677879,-6,973,1675,20
113876390856,113876390872,16,374,1671,20
113877498785,113877498783,-2,1565,3426,20
113877633899,113877633898,-1,1271,1958,20
113878795949,113878795945,-4,1051,2767,20
113880305104,113880305101,-3,1346,2918,20
113881374527,113881374523,-4,500,915,20
113882746136,113882746131,-5,1380,4109,20
113884817233,113884817230,-3,1382,2221,20
113894586139,113894586137,-2,868,907,20
113903443895,113903443891,-4,814,2529,20
113903949213,113903949198,-15,70,559,20
113905374276,113905374273,-3,1157,2561,20
113908961501,113908961498,-3,1012,2419,20
113915783363,113915783347,-16,24761,18365,20
113921376410,113921376399,-11,29973,14505,20
113927058718,113927058714,-4,1151,1791,20
113930474303,113930474299,-4,1294,2167,20
113931025299,113931025294,-5,1236,2145,20
113931695315,113931695313,-2,842,1622,20
113932247530,113932247525,-5,1088,2118,20
113938589779,113938589777,-2,1194,2312,20
113939136725,113939136721,-4,981,1259,20
113940900905,113940900902,-3,1329,1834,20
113940946282,113940946278,-4,1129,2308,20
113944350011,113944350006,-5,824,2140,20
113944386268,113944386290,22,106,639,20
113947090752,113947090748,-4,848,1746,20
113947792530,113947792528,-2,1263,2674,20
113948454225,113948454223,-2,1089,2832,20
113948532677,113948532696,19,586,1376,20
113951673518,113951673515,-3,978,2983,20
113955693201,113955693201,0,1676,2447,20
113960282902,113960282899,-3,1788,2720,20
113960683597,113960683602,5,12543,5855,20
113965169606,113965169603,-3,1152,2560,20
113969000871,113969000869,-2,1076,2223,20
113969321693,113969321689,-4,1369,2437,20
113971022049,113971022045,-4,1253,2371,20
113973145198,113973145194,-4,1357,2810,20
113973643005,113973643009,4,1649,1226,20
113973791199,113973791196,-3,1413,3471,20
113981100895,113981100890,-5,1087,2254,20
113981706539,113981706554,15,1630,3835,20
113983002240,113983002237,-3,1687,3067,20
113985218758,113985218751,-7,1193,3264,20
113987001694,113987001694,0,11479,16064,20
113989688371,113989688370,-1,1068,1766,20
113991760386,113991760383,-3,1580,2313,20
113991933490,113991933485,-5,1030,1398,20
113996996703,113996996701,-2,1408,2839,20
113999514676,113999514682,6,4634,2347,20
114000241147,114000241141,-6,997,2272,20
114000693098,114000693095,-3,1258,2720,20
114005369746,114005369744,-2,924,2136,20
114007906613,114007906609,-4,1164,2653,20
114014819383,114014819378,-5,1178,3433,20
114016340958,114016340952,-6,1111,2243,20
114022462942,114022462938,-4,1087,2589,20
114023792165,114023792161,-4,1078,1562,20
114025152600,114025152598,-2,1297,2409,20
114025811583,114025811581,-2,858,1511,20
114027104909,114027104905,-4,1487,2408,20
114028135475,114028135474,-1,1373,2770,20
114029649070,114029649069,-1,828,1921,20
114031813214,114031813210,-4,1301,2844,20
114032475828,114032475817,-11,666,2358,20
114040408099,114040408100,1,1091,1211,20
114042508037,114042508033,-4,1401,2516,20
114046309915,114046309913,-2,724,1463,20
114046633373,114046633370,-3,1371,2654,20
114046796859,114046796857,-2,947,2587,20
114064051318,114064051315,-3,1626,2873,20
114064964327,114064964322,-5,1067,3293,20
114067970312,114067970309,-3,1225,3198,20
114069347786,114069347781,-5,1143,2865,20
114071309135,114071309132,-3,1109,1814,20
114072040507,114072040502,-5,964,2004,20
114072097597,114072097582,-15,1267,2849,20
114079076231,114079076226,-5,1568,2295,20
114085049051,114085049047,-4,1027,2681,20
114085727874,114085727870,-4,1050,3105,20
114089985119,114089985136,17,31084,21300,20
114092808275,114092808271,-4,1055,2355,20
114096913148,114096913146,-2,1370,3401,20
114098960953,114098960952,-1,733,2706,20
114099157196,114099157200,4,48,1370,20
114103230146,114103230145,-1,1137,1767,20
114111159454,114111159452,-2,1184,2189,20
114118051468,114118051465,-3,1446,2749,20
114121853126,114121853126,0,10834,13005,20
114127181417,114127181414,-3,825,3051,20
114127522863,114127522859,-4,1204,3782,20
114128682757,114128682779,22,199,4934,20
114128753177,114128753173,-4,738,2679,20
114129904723,114129904719,-4,914,2591,20
114130240614,114130240612,-2,1073,2435,20
114132695573,114132695574,1,1741,2790,20
114134360766,114134360762,-4,1076,2681,20
114139434526,114139434505,-21,787,2800,20
114141769714,114141769711,-3,1263,2385,20
114145734466,114145734466,0,1035,1922,20
114147470374,114147470369,-5,1090,2119,20
114149544430,114149544444,14,527,896,20
114153698786,114153698785,-1,1103,1913,20
114154340795,114154340793,-2,1653,2559,20
114159031485,114159031482,-3,1227,2650,20
114160527646,114160527642,-4,1296,2958,20
114160754818,114160754814,-4,1024,1972,20
114161261009,114161261009,0,1235,1588,20
114166974271,114166974266,-5,933,2192,20
114172916978,114172916973,-5,1076,1897,20
114182583475,114182583473,-2,1199,2718,20
114187381351,114187381349,-2,1131,2419,20
114191054099,114191054095,-4,901,1988,20
114191186638,114191186635,-3,1077,2262,20
114192296433,114192296429,-4,1216,1762,20
114194962365,114194962360,-5,785,2159,20
114198277747,114198277741,-6,1948,7724,20
114199181025,114199181022,-3,1098,1698,20
114205487074,114205487070,-4,524,2528,20
114209174106,114209174103,-3,593,1531,20
114222769117,114222769113,-4,1209,3205,20
114223327142,114223327134,-8,821,2265,20
114224381388,114224381368,-20,609,2139,20
114224989580,114224989577,-3,917,1214,20
114226594188,114226594186,-2,998,2049,20
114228000195,114228000190,-5,640,1382,20
114228170142,114228170141,-1,961,1397,20
114233383003,114233383000,-3,1255,2454,20
114234834294,114234834292,-2,1594,1838,20
114236797202,114236797200,-2,911,2230,20
114238245681,114238245677,-4,966,2599,20
114239554003,114239554002,-1,1072,1762,20
114243532161,114243532161,0,1322,2642,20
114246232026,114246232006,-20,13,868,20
114247684415,114247684410,-5,1227,1771,20
114250169267,114250169266,-1,652,2455,20
114252936475,114252936474,-1,940,2056,20
114255089291,114255089286,-5,909,1968,20
114256661808,114256661810,2,1713,1647,20
114263084755,114263084749,-6,1026,2713,20
114263200039,114263200034,-5,741,2729,20
114266273813,114266273810,-3,729,1446,20
114267002331,114267002326,-5,939,1994,20
114267061726,114267061743,17,727,1371,20
114267599307,114267599305,-2,1142,1900,20
114269262514,114269262513,-1,2615,3204,20
114270136551,114270136552,1,1035,1277,20
114271773247,114271773243,-4,841,2674,20
114273495190,114273495186,-4,716,1670,20
114274677274,114274677270,-4,1296,2952,20
114275012861,114275012877,16,985,2020,20
114275389642,114275389647,5,2915,1245,20
114277658334,114277658330,-4,840,2620,20
114282181811,114282181810,-1,1012,1922,20
114285195771,114285195762,-9,1205,2972,20
114290574702,114290574698,-4,741,2480,20
114293308445,114293308441,-4,148,1229,20
114293809606,114293809602,-4,1478,3286,20
114305794506,114305794513,7,18440,44776,20
114309504640,114309504636,-4,1322,3451,20
114312752942,114312752938,-4,760,1999,20
114314309893,114314309893,0,969,1692,20
114314732622,114314732618,-4,1419,2226,20
114315677238,114315677236,-2,928,1375,20
114316307551,114316307541,-10,849,1555,20
114316477071,114316477067,-4,903,2343,20
114316973750,114316973734,-16,2815,1121,20
114330260839,114330260835,-4,1478,2712,20
114331565860,114331565861,1,1394,1911,20
114335318270,114335318266,-4,1280,3411,20
114345271442,114345271442,0,1367,1748,20
114352950712,114352950708,-4,1729,2546,20
114354212022,114354212021,-1,997,2222,20
114357812681,114357812678,-3,849,2654,20
114359161550,114359161547,-3,1142,3009,20
114359248837,114359248829,-8,275,1170,20
114369790138,114369790136,-2,1014,2661,20
114369943434,114369943431,-3,951,1808,20
114371404117,114371404116,-1,1287,3096,20
114371824650,114371824643,-7,883,1966,20
114373480284,114373480278,-6,1145,1943,20
114381359261,114381359258,-3,985,2112,20
114381494693,114381494684,-9,1056,1786,20
114383777876,114383777876,0,1842,2873,20
114387251289,114387251286,-3,1367,2032,20
114387311647,114387311662,15,298,855,20
114392661181,114392661180,-1,622,1821,20
114394359718,114394359714,-4,1047,2077,20
114394736683,114394736681,-2,1097,1694,20
114395077921,114395077917,-4,1631,2176,20
114396867661,114396867658,-3,1360,3483,20
114401222056,114401222054,-2,1765,2541,20
114402464950,114402464951,1,39623,22037,20
114402644723,114402644720,-3,822,2040,20
114402838145,114402838145,0,1392,2196,20
114404969491,114404969485,-6,1112,2501,20
114406545974,114406545970,-4,822,2051,20
114407375734,114407375733,-1,1017,1867,20
114413661658,114413661655,-3,1174,2146,20
114421204839,114421204835,-4,1062,2424,20
114424455799,114424455794,-5,1148,3514,20
114431261903,114431261901,-2,882,1434,20
114433781901,114433781896,-5,1240,1749,20
114443195563,114443195561,-2,960,1805,20
114446064161,114446064158,-3,1171,3296,20
114446093174,114446093171,-3,1295,2836,20
114454954740,114454954751,11,13471,27372,20
114456376632,114456376630,-2,1764,2172,20
114460374366,114460374364,-2,1245,2189,20
114460624651,114460624647,-4,1115,1922,20
114469548948,114469548945,-3,1077,2311,20
114473227121,114473227115,-6,1045,3918,20
114475301669,114475301663,-6,1744,5335,20
114476439102,114476439101,-1,1417,2482,20
114480265387,114480265386,-1,1264,2140,20
114482932643,114482932639,-4,958,1868,20
114486274845,114486274844,-1,1313,2263,20
114486315677,114486315676,-1,1192,1991,20
114487243046,114487243043,-3,1263,1965,20
114487567855,114487567852,-3,869,2177,20
114500148546,114500148567,21,2431,1630,20
114501445542,114501445542,0,713,1945,20
114509084087,114509084085,-2,723,1835,20
114509163458,114509163457,-1,947,2020,20
114511882826,114511882821,-5,1093,2049,20
114513110359,114513110356,-3,1015,1927,20
114518987158,114518987155,-3,1153,2143,20
114519221057,114519221061,4,2883,1403,20
114521150114,114521150112,-2,1348,3106,20
114521195555,114521195550,-5,611,1941,20
114523044374,114523044371,-3,769,1881,20
114534634981,114534634979,-2,1253,2225,20
114537674909,114537674907,-2,1521,2585,20
114545548294,114545548292,-2,1471,2978,20
114546132113,114546132110,-3,1112,1832,20
114547398179,114547398178,-1,639,1031,20
114558027028,114558027025,-3,868,2692,20
114558635658,114558635660,2,1897,1436,20
114559667250,114559667248,-2,805,1640,20
114561790591,114561790588,-3,1278,2282,20
114562787142,114562787138,-4,1632,2786,20
114565685691,114565685688,-3,1053,2067,20
114565876779,114565876786,7,2592,1054,20
114568906398,114568906397,-1,1053,2355,20
114573186337,114573186346,9,18825,20575,20
114574635978,114574635974,-4,1247,2674,20
114575446826,114575446823,-3,989,2539,20
114576799773,114576799768,-5,843,3635,20
114580610618,114580610614,-4,867,2561,20
114581216825,114581216825,0,1168,2186,20
114582121752,114582121749,-3,1055,2734,20
114587683510,114587683511,1,1301,2622,20
114588197895,114588197894,-1,1321,2730,20
114588675242,114588675239,-3,1140,1687,20
114590040606,114590040603,-3,855,1881,20
114594922626,114594922623,-3,1106,2592,20
114595815012,114595814993,-19,992,1795,20
114596118810,114596118809,-1,922,1913,20
114596787021,114596787018,-3,1815,2847,20
114598593864,114598593870,6,6201,2277,20
114598661348,114598661346,-2,1004,2380,20
114604084266,114604084266,0,934,2004,20
114604595054,114604595034,-20,1047,1243,20
114610516721,114610516719,-2,612,2311,20
114613100237,114613100233,-4,894,2253,20
114619623281,114619623278,-3,1245,2009,20
114624321579,114624321574,-5,1134,2873,20
114625012081,114625012080,-1,1892,2570,20
114625452940,114625452935,-5,1325,2544,20
114626575776,114626575777,1,29717,21977,20
114627010999,114627010998,-1,844,1942,20
114627667630,114627667628,-2,1148,2128,20
114630036329,114630036327,-2,1302,1798,20
114633628711,114633628710,-1,1273,2283,20
114635276101,114635276097,-4,1112,3131,20
114636002532,114636002538,6,4644,1670,20
114646513907,114646513905,-2,999,3452,20
114646980985,114646980982,-3,1149,2540,20
114649407475,114649407473,-2,1004,1757,20
114650682449,114650682450,1,1619,1383,20
114652867871,114652867869,-2,1642,2854,20
114658551646,114658551642,-4,815,2828,20
114658925924,114658925943,19,648,2199,20
114660200065,114660200066,1,1677,1607,20
114665744063,114665744059,-4,1081,2847,20
114671605786,114671605784,-2,1448,2076,20
114682000050,114682000030,-20,1521,1528,20
114683472811,114683472810,-1,760,1910,20
114691494466,114691494462,-4,1239,2762,20
114703392607,114703392603,-4,992,1378,20
114708628397,114708628393,-4,1125,2503,20
114709464629,114709464621,-8,968,2942,20
114713751726,114713751726,0,1190,2416,20
114718085424,114718085421,-3,852,2543,20
114719369931,114719369929,-2,1433,2615,20
114721733483,114721733477,-6,1090,1772,20
114722412943,114722412928,-15,219,1046,20
114723754807,114723754786,-21,1031,2600,20
114727975038,114727975036,-2,1406,3276,20
114728140660,114728140682,22,660,1217,20
114729042506,114729042502,-4,932,2298,20
114729195502,114729195489,-13,339,966,20
114730492713,114730492709,-4,1660,2369,20
114739978034,114739978030,-4,918,2228,20
114740977575,114740977574,-1,905,1729,20
114742724621,114742724618,-3,1454,3750,20
114745520238,114745520235,-3,983,1852,20
114749956226,114749956233,7,5679,1977,20
114751935450,114751935446,-4,1266,3200,20
114752778543,114752778534,-9,1094,1789,20
114754571499,114754571497,-2,1055,1426,20
114756313198,114756313196,-2,1430,1917,20
114758305370,114758305368,-2,1120,2451,20
114767027450,114767027446,-4,1886,3294,20
114772761787,114772761784,-3,1362,2380,20
114776418702,114776418698,-4,687,1817,20
114778289643,114778289638,-5,1715,3742,20
114778907627,114778907626,-1,1009,1370,20
114779972842,114779972836,-6,986,3800,20
114783289804,114783289800,-4,942,1848,20
114788541814,114788541810,-4,1239,3303,20
114794589453,114794589450,-3,1206,2238,20
114795119417,114795119414,-3,1194,2924,20
114796360814,114796360820,6,197,895,20
114798913634,114798913631,-3,1020,2167,20
114800955254,114800955246,-8,882,4731,20
114802263316,114802263313,-3,1019,1905,20
114804496402,114804496399,-3,677,2013,20
114805658914,114805658912,-2,920,2112,20
114806299434,114806299431,-3,1060,1927,20
114806994011,114806994008,-3,3364,8389,20
114809006014,114809006010,-4,1117,3982,20
114809172932,114809172954,22,328,1095,20
114810774320,114810774317,-3,1295,2110,20
114810814087,114810814103,16,922,2238,20
114817995451,114817995449,-2,1385,3136,20
114821811600,114821811597,-3,1249,3094,20
114825109170,114825109166,-4,1084,3704,20
114826094625,114826094625,0,1479,2088,20
114826383183,114826383181,-2,1283,2551,20
114827082970,114827082968,-2,1138,2692,20
114829924939,114829924939,0,1339,2248,20
114835617502,114835617502,0,1054,2133,20
114837997017,114837997038,21,489,1440,20
114841112307,114841112303,-4,1035,1811,20
114841661638,114841661625,-13,205,999,20
114842448918,114842448918,0,1186,1988,20
114842581635,114842581633,-2,1187,1951,20
114846938132,114846938129,-3,1168,2475,20
114849107946,114849107941,-5,880,2068,20
114852727558,114852727558,0,1394,2036,20
114856120708,114856120706,-2,1137,1694,20
114862030036,114862030036,0,1301,1789,20
114865279765,114865279762,-3,1319,2430,20
114867682599,114867682597,-2,1039,2100,20
114871014039,114871014036,-3,1240,2606,20
114871335961,114871335964,3,981,1008,20
114873165150,114873165147,-3,1401,1929,20
114877672249,114877672247,-2,892,1925,20
114878937811,114878937808,-3,1092,2500,20
114884012919,114884012916,-3,1228,2759,20
114884863449,114884863443,-6,913,4641,20
114886386200,114886386202,2,1343,877,20
114890619966,114890619963,-3,1135,2045,20
114892511907,114892511905,-2,650,1582,20
114901543233,114901543234,1,1028,1140,20
114901760310,114901760293,-17,845,2611,20
114905011835,114905011832,-3,1224,2575,20
114905106221,114905106210,-11,672,2496,20
114905742777,114905742777,0,1377,1642,20
114907888831,114907888850,19,812,1755,20
114909257369,114909257365,-4,1247,2178,20
114909739693,114909739714,21,748,2291,20
114910034438,114910034434,-4,1514,2293,20
114916371197,114916371194,-3,917,2779,20
114919766463,114919766461,-2,1167,1811,20
114921874995,114921874994,-1,537,1213,20
114922215537,114922215535,-2,1232,2487,20
114924621285,114924621281,-4,1653,2940,20
114928647450,114928647430,-20,1083,982,20
114933160697,114933160693,-4,659,2342,20
114934315348,114934315370,22,2774,1191,20
114934776048,114934776045,-3,1241,2352,20
114936778979,114936778978,-1,914,1850,20
114938677550,114938677543,-7,1061,2866,20
114939464783,114939464780,-3,729,2262,20
114939788099,114939788093,-6,1435,2684,20
114943763291,114943763294,3,1433,1024,20
114944275602,114944275598,-4,1152,2695,20
114950322253,114950322250,-3,1355,1941,20
114956143898,114956143899,1,1293,1848,20
114958704466,114958704465,-1,1313,2201,20
114961268123,114961268122,-1,1334,2715,20
114963857354,114963857352,-2,1500,2346,20
114964360993,114964360990,-3,889,2192,20
114971992290,114971992289,-1,1165,2874,20
114972829534,114972829532,-2,1260,2759,20
114980725053,114980725050,-3,1212,2570,20
114982677395,114982677393,-2,535,1723,20
114983087530,114983087538,8,2558,1328,20
114983431474,114983431471,-3,970,2080,20
114985867874,114985867881,7,3573,1230,20
114986612467,114986612464,-3,1042,2211,20
114994143826,114994143824,-2,909,2980,20
114994677559,114994677575,16,326,751,20
114995685254,114995685262,8,7516,2084,20
114995840325,114995840321,-4,46159,23552,20
114996068027,114996068021,-6,1009,3387,20
114998466652,114998466648,-4,815,2042,20
115007020437,115007020433,-4,1450,2868,20
115008345283,115008345282,-1,1257,1332,20
115009912787,115009912789,2,1565,2034,20
115012266197,115012266195,-2,1376,2443,20
115017630254,115017630248,-6,933,3161,20
115020087721,115020087719,-2,1180,2203,20
115022879931,115022879929,-2,1086,2598,20
115027793327,115027793322,-5,358,1016,20
115031135063,115031135059,-4,864,2228,20
115031175214,115031175235,21,523,1126,20
115034804622,115034804619,-3,1037,1905,20
115036096150,115036096146,-4,1258,2984,20
115036896285,115036896281,-4,949,2667,20
115037764878,115037764876,-2,808,2218,20
115038879198,115038879193,-5,1211,3170,20
115039075303,115039075299,-4,746,2197,20
115046154708,115046154727,19,1489,3652,20
115047506010,115047506009,-1,1067,1781,20
115061116227,115061116223,-4,1421,2587,20
115063819401,115063819399,-2,1507,1422,20
115067089283,115067089279,-4,1120,2310,20
115080137543,115080137540,-3,928,2287,20
115081678380,115081678375,-5,1470,2352,20
115085591403,115085591401,-2,1441,2706,20
115087598539,115087598531,-8,452,1840,20
115090258651,115090258648,-3,896,2647,20
115095772221,115095772217,-4,1148,2359,20
115099670808,115099670805,-3,1319,2744,20
115102317481,115102317487,6,3636,2099,20
115104485178,115104485174,-4,884,1500,20
115105199882,115105199880,-2,1197,2467,20
115105990414,115105990410,-4,921,2261,20
115108061790,115108061789,-1,1265,2160,20
115110574625,115110574622,-3,1494,2247,20
115115543146,115115543142,-4,1487,2854,20
115118941674,115118941672,-2,1347,2563,20
115128871550,115128871550,0,1001,1386,20
115135690000,115135689997,-3,1534,2390,20
115135834436,115135834432,-4,998,2274,20
115135977690,115135977689,-1,2506,2569,20
115136433447,115136433443,-4,1089,2234,20
115138234545,115138234541,-4,914,2749,20
115139014550,115139014547,-3,1074,2285,20
115144749649,115144749645,-4,1045,2404,20
115159384968,115159384966,-2,1732,1965,20
115160076234,115160076233,-1,1038,1705,20
115160207491,115160207489,-2,831,1162,20
115160613494,115160613498,4,108,617,20
115160946762,115160946758,-4,841,1869,20
115162310462,115162310458,-4,1012,2442,20
115163591670,115163591666,-4,1254,2210,20
115168689117,115168689134,17,308,917,20
115169030102,115169030123,21,460,1174,20
115169472194,115169472193,-1,898,1933,20
115175331505,115175331502,-3,690,2015,20
115177522839,115177522836,-3,1003,2013,20
115178924475,115178924467,-8,1289,4922,20
115191178475,115191178472,-3,1150,2691,20
115198061281,115198061281,0,915,1786,20
115200839050,115200839048,-2,1310,2311,20
115203477959,115203477957,-2,908,2354,20
115205126013,115205126028,15,161,1032,20
115206101559,115206101554,-5,225,986,20
115212397769,115212397766,-3,818,2195,20
115220371698,115220371695,-3,1079,2568,20
115221912981,115221912979,-2,917,1697,20
115222977213,115222977210,-3,1483,2486,20
115227504465,115227504462,-3,1080,2376,20
115227772766,115227772763,-3,1109,2662,20
115228959362,115228959357,-5,910,1970,20
115231781614,115231781611,-3,989,2145,20
115234365802,115234365797,-5,1094,2188,20
115234665902,115234665901,-1,1511,2649,20
115236363887,115236363897,10,10702,31919,20
115236971443,115236971441,-2,907,2361,20
115237781274,115237781280,6,3558,1410,20
115242082252,115242082250,-2,3058,4197,20
115243104925,115243104921,-4,947,2391,20
115245712738,115245712735,-3,968,2040,20
115249027200,115249027195,-5,1063,2561,20
115252426949,115252426951,2,3191,1707,20
115253846619,115253846616,-3,913,2178,20
115258156169,115258156166,-3,1015,2167,20
115258822303,115258822300,-3,1172,2441,20
115263740462,115263740461,-1,1199,2337,20
115264033140,115264033128,-12,1139,1652,20
115265572963,115265572957,-6,1194,3135,20
115268752499,115268752494,-5,1355,3593,20
115270278614,115270278621,7,2751,1196,20
115270474871,115270474865,-6,979,2805,20
115270558814,115270558813,-1,1033,2318,20
115273954061,115273954057,-4,1058,1785,20
115274963228,115274963225,-3,1329,3347,20
115276813793,115276813789,-4,1248,2697,20
115279862834,115279862830,-4,887,2157,20
115280279780,115280279764,-16,1231,2338,20
115282628833,115282628830,-3,977,2355,20
115282796437,115282796437,0,1328,2156,20
115284824426,115284824423,-3,1745,2281,20
115285443179,115285443175,-4,800,1856,20
115286840263,115286840259,-4,791,1081,20
115288139798,115288139794,-4,1128,2304,20
115293177489,115293177485,-4,1248,3163,20
115296726142,115296726147,5,1714,1177,20
115296879229,115296879225,-4,153,1054,20
115302141114,115302141113,-1,1480,2044,20
115305803445,115305803443,-2,968,1795,20
115310287398,115310287396,-2,1240,2918,20
115312033766,115312033765,-1,1508,2019,20
115316579461,115316579457,-4,1370,2936,20
115323749880,115323749881,1,1690,2458,20
115324081343,115324081325,-18,1102,1804,20
115324189955,115324189951,-4,773,2777,20
115325225563,115325225560,-3,1094,2706,20
115327245002,115327244999,-3,1024,2413,20
115332897505,115332897501,-4,1655,3378,20
115340779811,115340779790,-21,1874,838,20
115341541258,115341541254,-4,636,2001,20
115344140233,115344140230,-3,801,2015,20
115344191566,115344191571,5,34,681,20
115345836453,115345836449,-4,1135,2136,20
115346802431,115346802450,19,1618,2119,20
115356680825,115356680824,-1,1381,2366,20
115366126541,115366126538,-3,1038,1542,20
115366575169,115366575166,-3,842,2642,20
115366631286,115366631283,-3,1065,2742,20
115366835411,115366835405,-6,1040,2552,20
115369312002,115369311999,-3,1079,1474,20
115369874933,115369874932,-1,1291,1675,20
115371716339,115371716337,-2,1036,1546,20
115381035425,115381035426,1,1787,2344,20
115385803202,115385803197,-5,1293,5317,20
115388199464,115388199459,-5,1319,2170,20
115391840653,115391840650,-3,542,1557,20
115393869666,115393869662,-4,1050,3121,20
115394385394,115394385393,-1,1217,2426,20
115395046737,115395046736,-1,899,2451,20
115403600407,115403600405,-2,1331,2693,20
115405991618,115405991616,-2,1064,2073,20
115413173583,115413173582,-1,1044,2151,20
115415821421,115415821419,-2,1301,1066,20
115416674522,115416674520,-2,1010,2104,20
115417671121,115417671119,-2,1275,2431,20
115419584534,115419584533,-1,1004,2717,20
115419661934,115419661953,19,1039,2201,20
115420714319,115420714315,-4,1213,2756,20
115421553806,115421553802,-4,707,1049,20
115423288899,115423288897,-2,998,2625,20
115432088347,115432088345,-2,1311,3561,20
115432614753,115432614750,-3,729,2030,20
115433022551,115433022548,-3,1176,2273,20
115434716382,115434716378,-4,978,1878,20
115436712261,115436712259,-2,1051,1131,20
115442822479,115442822477,-2,1215,3139,20
115443742346,115443742344,-2,1061,2753,20
115444930378,115444930377,-1,1022,2017,20
115446683331,115446683330,-1,1444,3474,20
115458128625,115458128621,-4,1821,2929,20
115459029494,115459029491,-3,1044,1487,20
115461090310,115461090307,-3,1236,2727,20
115461411210,115461411207,-3,1031,2345,20
115465842874,115465842871,-3,1035,2357,20
115467586727,115467586723,-4,986,1856,20
115471219028,115471219025,-3,927,1103,20
115476011652,115476011659,7,1345,900,20
115476423238,115476423244,6,5222,2419,20
115483629241,115483629245,4,1628,1500,20
115486424417,115486424422,5,21453,20148,20
115488671497,115488671493,-4,1141,2098,20
115489310375,115489310373,-2,687,1385,20
115493298588,115493298586,-2,1664,2708,20
115498045054,115498045050,-4,927,2501,20
115501528894,115501528892,-2,1251,2428,20
115505263115,115505263114,-1,697,2290,20
115511426241,115511426239,-2,949,1822,20
115518718661,115518718659,-2,823,1216,20
115519378020,115519378018,-2,910,1340,20
115522339947,115522339942,-5,1084,1458,20
115528920006,115528920002,-4,1138,2687,20
115530319968,115530319971,3,2011,1252,20
115531446486,115531446483,-3,1146,2230,20
115538616546,115538616552,6,3744,2028,20
115541516946,115541516946,0,3200,3101,20
115542315937,115542315937,0,1194,2116,20
115542770757,115542770750,-7,1518,3726,20
115554480957,115554480953,-4,713,2128,20
115561841644,115561841641,-3,744,2639,20
115562664231,115562664227,-4,887,1920,20
115568151144,115568151142,-2,735,1331,20
115570654882,115570654879,-3,1028,2558,20
115573030706,115573030705,-1,1048,1481,20
115574759265,115574759261,-4,1085,2119,20
115580434695,115580434690,-5,1202,2280,20
115583048465,115583048462,-3,1082,2189,20
115585023479,115585023474,-5,1426,2608,20
115589972187,115589972184,-3,1216,2719,20
115590702203,115590702206,3,1291,1262,20
115594314499,115594314497,-2,945,2113,20
115599459090,115599459087,-3,1262,2532,20
115599907182,115599907183,1,1265,1026,20
115602170822,115602170818,-4,1078,2838,20
115603009373,115603009371,-2,1252,1919,20
115606665850,115606665845,-5,30596,15875,20
115609794911,115609794905,-6,1750,5703,20
115615441942,115615441939,-3,987,2194,20
115617792207,115617792203,-4,1189,2477,20
115619507678,115619507675,-3,953,2566,20
115628689658,115628689656,-2,1083,1794,20
115631739002,115631739002,0,661,1668,20
115631989917,115631989935,18,445,957,20
115633962967,115633962964,-3,979,2311,20
115634467166,115634467163,-3,976,2658,20
115641655974,115641655980,6,2431,1623,20
115642449985,115642449991,6,19013,16669,20
115647088063,115647088060,-3,1013,1844,20
115653094351,115653094350,-1,1042,3256,20
115656591742,115656591738,-4,1373,1920,20
115656938276,115656938295,19,694,1345,20
115657326083,115657326081,-2,1147,2037,20
115659810714,115659810710,-4,969,2769,20
115661029686,115661029682,-4,1134,3099,20
115665279347,115665279343,-4,1403,2224,20
115667381306,115667381306,0,2143,2300,20
115667934342,115667934340,-2,995,2379,20
115668304734,115668304734,0,365,454,20
115670867923,115670867921,-2,1093,1533,20
115672467116,115672467114,-2,814,2993,20
115674242422,115674242420,-2,1161,2477,20
115675685854,115675685850,-4,694,2290,20
115677972636,115677972635,-1,1193,1637,20
115679358358,115679358354,-4,1540,2494,20
115685514219,115685514214,-5,962,2767,20
115687172389,115687172386,-3,968,2773,20
115689323502,115689323501,-1,1332,2702,20
115692135564,115692135566,2,1821,1628,20
115693945874,115693945873,-1,1449,1966,20
115700028987,115700028984,-3,867,2060,20
115705680743,115705680741,-2,1011,2760,20
115707144902,115707144898,-4,852,1914,20
115710559519,115710559515,-4,889,2546,20
115715206526,115715206525,-1,1340,2140,20
115717313363,115717313359,-4,950,2153,20
115717751538,115717751537,-1,17184,18355,20
115718305478,115718305474,-4,955,2150,20
115722250249,115722250248,-1,1537,2502,20
115723139381,115723139378,-3,886,1997,20
115724163210,115724163211,1,1283,1665,20
115726149068,115726149065,-3,1504,2605,20
115728069205,115728069199,-6,1018,5637,20
115728219231,115728219226,-5,1100,2144,20
115729519250,115729519247,-3,1245,2824,20
115730866475,115730866473,-2,999,2087,20
115734677867,115734677866,-1,1321,1888,20
115736249066,115736249063,-3,906,2150,20
115737749370,115737749368,-2,1081,1928,20
115741313694,115741313691,-3,1531,3095,20
115743221208,115743221205,-3,1430,3066,20
115744281548,115744281545,-3,1364,2631,20
115747055830,115747055826,-4,863,2366,20
115749194927,115749194925,-2,1042,2122,20
115751213371,115751213370,-1,851,1241,20
115753247585,115753247582,-3,1298,2455,20
115756243156,115756243153,-3,1809,2104,20
115762031428,115762031426,-2,1209,2433,20
115766575054,115766575051,-3,1143,2321,20
115769835418,115769835417,-1,906,1727,20
115771432699,115771432694,-5,1145,2008,20
115772781198,115772781195,-3,1036,1337,20
115774550023,115774550018,-5,724,2021,20
115775220611,115775220607,-4,908,2124,20
115780625596,115780625594,-2,1424,2279,20
115787061371,115787061370,-1,1415,3130,20
115787377132,115787377130,-2,1224,2388,20
115787934102,115787934098,-4,818,1660,20
115789835623,115789835620,-3,1144,3281,20
115790623901,115790623900,-1,1378,2148,20
115794338730,115794338727,-3,17956,8931,20
115796246634,115796246631,-3,1025,1923,20
115803219190,115803219186,-4,1358,2888,20
115805634855,115805634850,-5,1221,2458,20
115809618531,115809618529,-2,1416,2110,20
115809994247,115809994262,15,461,1655,20
115810703271,115810703267,-4,1372,2185,20
115812184046,115812184041,-5,1034,1997,20
115813018479,115813018478,-1,953,1614,20
115814684662,115814684660,-2,1028,2131,20
115820317821,115820317819,-2,1457,2582,20
115830600378,115830600374,-4,1262,2349,20
115831359750,115831359755,5,3603,1832,20
115832094355,115832094353,-2,996,2644,20
115835806179,115835806178,-1,721,2724,20
115839316311,115839316308,-3,976,2379,20
115857552506,115857552503,-3,1120,2284,20
115863005439,115863005434,-5,958,2933,20
115865212232,115865212227,-5,936,2909,20
115865778414,115865778410,-4,635,1785,20
115867343216,115867343215,-1,1191,2372,20
115867627878,115867627874,-4,1212,1607,20
115876843198,115876843197,-1,765,2598,20
115881219482,115881219478,-4,1063,1418,20
115890753478,115890753475,-3,1213,2581,20
115891660569,115891660566,-3,1038,2884,20
115892204846,115892204844,-2,973,2446,20
115893479477,115893479467,-10,867,1532,20
115904176167,115904176164,-3,983,1850,20
115904396940,115904396958,18,1118,2815,20
115904939870,115904939868,-2,787,1953,20
115908154886,115908154884,-2,992,2914,20
115911002339,115911002336,-3,765,2370,20
115911282534,115911282532,-2,977,2580,20
115911513591,115911513589,-2,1256,2477,20
115911647630,115911647649,19,652,2177,20
115915464980,115915464977,-3,1041,2148,20
115916066880,115916066896,16,1689,2294,20
115917239767,115917239765,-2,1248,2823,20
115917512086,115917512082,-4,1080,2338,20
115918189788,115918189787,-1,920,1954,20
115927207671,115927207667,-4,975,3866,20
115932914403,115932914397,-6,1202,2887,20
115936508235,115936508229,-6,787,1394,20
115942940101,115942940089,-12,23960,18083,20
115949738366,115949738365,-1,1160,1497,20
115953408851,115953408849,-2,1505,2788,20
115953628422,115953628438,16,1123,2578,20
115957537287,115957537282,-5,1209,2679,20
115959376886,115959376890,4,3885,1758,20
115959548918,115959548914,-4,1247,2334,20
115961921884,115961921901,17,1050,2101,20
115964064534,115964064530,-4,950,1843,20
115966508417,115966508418,1,2078,1546,20
115971285186,115971285185,-1,952,1761,20
115971483494,115971483511,17,910,1755,20
115973366506,115973366500,-6,1091,3080,20
115975079042,115975079039,-3,1154,2150,20
115975859349,115975859361,12,153,977,20
115978356178,115978356174,-4,1264,2391,20
115979867586,115979867581,-5,296,1203,20
115979916324,115979916311,-13,1314,2146,20
115988601990,115988601990,0,850,911,20
115988923327,115988923345,18,1198,3030,20
115989351088,115989351081,-7,1332,5201,20
115995342495,115995342493,-2,1249,2382,20
116001525830,116001525826,-4,1697,3115,20
116008243105,116008243102,-3,1444,2091,20
116008838826,116008838823,-3,1121,2847,20
116011558134,116011558133,-1,1653,2296,20
116012890556,116012890554,-2,802,1870,20
116023380992,116023380987,-5,980,1719,20
116024861202,116024861198,-4,1071,1495,20
116031968770,116031968765,-5,1216,2848,20
116032561991,116032561989,-2,810,2796,20
116033859010,116033859006,-4,1044,3424,20
116034498300,116034498296,-4,1462,2635,20
116042495194,116042495190,-4,1425,3291,20
116046086763,116046086761,-2,1141,2296,20
116047929274,116047929275,1,933,2699,20
116048871704,116048871700,-4,1017,2427,20
116049308863,116049308858,-5,1246,2598,20
116050506170,116050506166,-4,1131,2972,20
116053910949,116053910954,5,2629,1056,20
116055900846,116055900842,-4,938,2022,20
116057783381,116057783378,-3,844,2761,20
116059559099,116059559092,-7,664,2548,20
116060894209,116060894207,-2,1103,1828,20
116063924071,116063924070,-1,2599,4447,20
116066424756,116066424754,-2,1024,2323,20
116069650503,116069650499,-4,974,2285,20
116073895552,116073895550,-2,2450,4294,20
116074969350,116074969347,-3,981,2290,20
116075927250,116075927247,-3,931,1578,20
116081311957,116081311954,-3,891,2577,20
116082779266,116082779262,-4,1104,2933,20
116083142414,116083142421,7,4550,1249,20
116084575618,116084575614,-4,1473,2663,20
116086224960,116086224956,-4,1026,2704,20
116087138581,116087138578,-3,718,2723,20
116095856895,116095856893,-2,1640,2392,20
116096786576,116096786573,-3,657,1780,20
116097674882,116097674881,-1,1052,1690,20
116102120479,116102120477,-2,1519,2682,20
116103295415,116103295412,-3,1297,2732,20
116109605693,116109605690,-3,851,1989,20
116118652534,116118652530,-4,799,1392,20
116121940061,116121940058,-3,1413,2620,20
116131492037,116131492034,-3,919,1806,20
116134044290,116134044288,-2,1041,1863,20
116136415994,116136415990,-4,1143,2565,20
116138534902,116138534897,-5,1054,1437,20
116140713983,116140713981,-2,1383,2783,20
116141007011,116141007006,-5,1140,2452,20
116141667697,116141667694,-3,1464,2742,20
116145013649,116145013646,-3,1248,3093,20
116148016772,116148016770,-2,1259,2015,20
116148048916,116148048913,-3,1598,3370,20
116152538517,116152538514,-3,1299,2534,20
116157699602,116157699598,-4,1237,2598,20
116159532861,116159532857,-4,767,1887,20
116161240950,116161240949,-1,988,2570,20
116164006858,116164006854,-4,740,2232,20
116167045331,116167045327,-4,630,1571,20
116167416615,116167416630,15,841,1247,20
116172643070,116172643065,-5,3340,8451,20
116178868439,116178868435,-4,1047,3247,20
116179052302,116179052320,18,716,1961,20
116186434683,116186434681,-2,1069,2091,20
116189862013,116189862017,4,2363,1769,20
116191224019,116191224016,-3,755,1383,20
116192003066,116192003062,-4,852,983,20
116193188991,116193188987,-4,1025,1951,20
116195295518,116195295511,-7,302,878,20
116196172830,116196172829,-1,1566,2544,20
116197279087,116197279084,-3,879,2481,20
116204936471,116204936470,-1,1314,2375,20
116210993895,116210993892,-3,2011,4277,20
116213812490,116213812491,1,1094,1171,20
116214166196,116214166213,17,953,2538,20
116216769149,116216769146,-3,1248,2659,20
116219468981,116219468979,-2,1542,2878,20
116228699335,116228699332,-3,1451,3072,20
116230350035,116230350055,20,1071,1809,20
116233279362,116233279360,-2,907,1984,20
116234210546,116234210546,0,942,1745,20
116234637802,116234637797,-5,973,2910,20
116235139334,116235139331,-3,1093,2154,20
116244536613,116244536610,-3,975,2447,20
116245466876,116245466856,-20,932,2480,20
116246927229,116246927225,-4,926,1594,20
116254330826,116254330822,-4,1499,3149,20
116255315658,116255315653,-5,708,1665,20
116261025058,116261025065,7,38278,18125,20
116261449206,116261449202,-4,918,2191,20
116274945305,116274945301,-4,1353,2764,20
116275456200,116275456199,-1,894,1197,20
116275826502,116275826500,-2,1656,3298,20
116276464703,116276464701,-2,1452,1769,20
116276599395,116276599394,-1,1037,1851,20
116280892069,116280892071,2,1151,1857,20
116281715455,116281715453,-2,1125,2183,20
116283837918,116283837925,7,2286,1712,20
116286375039,116286375033,-6,1129,2431,20
116287795063,116287795061,-2,1064,2226,20
116287977100,116287977097,-3,1409,2650,20
116293897819,116293897816,-3,1146,2212,20
116294290839,116294290836,-3,1151,2650,20
116295924990,116295924988,-2,958,1861,20
116297475454,116297475450,-4,1283,2435,20
116298872201,116298872198,-3,794,1491,20
116299169615,116299169610,-5,1149,3766,20
116299234438,116299234429,-9,1093,2320,20
116299585253,116299585250,-3,698,1633,20
116300890065,116300890062,-3,755,1589,20
116304665030,116304665026,-4,794,2736,20
116305517438,116305517436,-2,1337,2789,20
116306206627,116306206638,11,880,1265,20
116306818469,116306818465,-4,1656,3083,20
116307206359,116307206356,-3,1118,2756,20
116313548210,116313548208,-2,1125,2093,20
116314006266,116314006262,-4,1182,3250,20
116314831886,116314831885,-1,1096,2261,20
116315225493,116315225489,-4,1573,3368,20
116318268926,116318268910,-16,2559,1341,20
116319343419,116319343416,-3,971,1946,20
116321646928,116321646925,-3,939,1672,20
116321846747,116321846744,-3,1077,2315,20
116322930357,116322930352,-5,1460,3832,20
116326536507,116326536503,-4,1190,2132,20
116327090253,116327090275,22,800,2438,20
116327541203,116327541198,-5,935,2113,20
116329390480,116329390478,-2,1458,2709,20
116333761051,116333761048,-3,1092,2342,20
116337978615,116337978611,-4,1177,2051,20
116341307719,116341307717,-2,1067,2208,20
116344852751,116344852750,-1,2192,2074,20
116345131620,116345131617,-3,976,2308,20
116346406426,116346406421,-5,768,1980,20
116352705187,116352705183,-4,1538,3074,20
116355781031,116355781027,-4,1459,2626,20
116358783582,116358783580,-2,897,1709,20
116359042706,116359042705,-1,1110,1970,20
116360161031,116360161027,-4,1334,2252,20
116360539490,116360539486,-4,1023,1719,20
116365492541,116365492537,-4,1378,1694,20
116374654814,116374654810,-4,909,1855,20
116379455289,116379455285,-4,940,2695,20
116379657350,116379657347,-3,1082,2373,20
116383013324,116383013320,-4,1369,1550,20
116390364081,116390364077,-4,1034,1738,20
116395716340,116395716337,-3,254,1412,20
116399186226,116399186217,-9,797,3597,20
116402944510,116402944507,-3,2452,4899,20
116404464246,116404464241,-5,1212,2743,20
116405908902,116405908898,-4,956,2798,20
116406052011,116406052007,-4,1468,3670,20
116418656651,116418656646,-5,1107,2243,20
116419957639,116419957638,-1,1866,1808,20
116424213206,116424213205,-1,1253,2368,20
116426593550,116426593546,-4,1171,2234,20
116427109541,116427109542,1,1378,1787,20
116429576502,116429576508,6,3575,1706,20
116431472566,116431472565,-1,1139,2741,20
116431639311,116431639308,-3,821,2896,20
116434689020,116434689016,-4,1167,1811,20
116436499314,116436499311,-3,738,1762,20
116437430695,116437430688,-7,1730,10781,20
116437957378,116437957373,-5,1096,3878,20
116442093319,116442093315,-4,1170,2923,20
116442766304,116442766318,14,1277,3000,20
116449450211,116449450209,-2,1144,2207,20
116455115808,116455115807,-1,1580,2371,20
116455714439,116455714446,7,571,1835,20
116456085506,116456085499,-7,932,6025,20
116459123255,116459123253,-2,1050,1818,20
116460293686,116460293682,-4,958,2466,20
116463972859,116463972856,-3,745,2070,20
116470446094,116470446093,-1,1436,3341,20
116471572135,116471572132,-3,1430,2257,20
116480640900,116480640897,-3,758,1642,20
116484409759,116484409758,-1,1164,2383,20
116486361608,116486361607,-1,1164,1319,20
116488826409,116488826406,-3,713,1243,20
116490232015,116490232013,-2,1303,2803,20
116497744693,116497744694,1,1993,1704,20
116503362437,116503362436,-1,1579,2325,20
116509076312,116509076310,-2,780,1914,20
116510622548,116510622546,-2,1136,2492,20
116512315470,116512315469,-1,1693,1985,20
116512774509,116512774506,-3,923,2393,20
116515493524,116515493526,2,26136,22024,20
116516278597,116516278594,-3,1057,2724,20
116518394167,116518394170,3,3059,1850,20
116519114895,116519114893,-2,892,2014,20
116520867285,116520867276,-9,46129,8199,20
116521558576,116521558574,-2,1062,2008,20
116522483458,116522483455,-3,1565,2810,20
116524679937,116524679935,-2,1115,1708,20
116524736487,116524736486,-1,974,2212,20
116525269217,116525269211,-6,699,3079,20
116526289159,116526289155,-4,976,1744,20
116527355881,116527355877,-4,1331,2580,20
116531123233,116531123230,-3,1199,2105,20
116531515990,116531516009,19,439,1463,20
116533018327,116533018326,-1,446,1282,20
116534460590,116534460586,-4,1057,3173,20
116537851058,116537851054,-4,1113,2911,20
116538523268,116538523250,-18,1466,2701,20
116540133662,116540133658,-4,927,2190,20
116541091553,116541091550,-3,1407,3083,20
116542001075,116542001073,-2,1358,2639,20
116542326142,116542326138,-4,872,2179,20
116542879501,116542879511,10,13366,35879,20
116545146721,116545146718,-3,1376,2200,20
116552017251,116552017249,-2,1170,2395,20
116553358330,116553358327,-3,1394,4059,20
116554140730,116554140730,0,1151,1647,20
116554888676,116554888672,-4,895,1947,20
116557131791,116557131788,-3,1458,2321,20
116559337583,116559337579,-4,825,1262,20
116559633095,116559633078,-17,1656,3810,20
116561113299,116561113297,-2,1396,3282,20
116562369114,116562369108,-6,997,2484,20
116564782170,116564782163,-7,6152,11773,20
116571102462,116571102464,2,1515,1154,20
116574138060,116574138057,-3,778,2000,20
116574646358,116574646374,16,453,3279,20
116575403825,116575403821,-4,1077,2637,20
116575645717,116575645698,-19,1195,1418,20
116576968701,116576968698,-3,1352,2888,20
116578852578,116578852576,-2,1170,2199,20
116581202375,116581202373,-2,1522,3015,20
116582775535,116582775533,-2,1607,1622,20
116586147690,116586147685,-5,943,1908,20
116588812954,116588812951,-3,1113,2493,20
116597075465,116597075461,-4,1008,1793,20
116601681123,116601681122,-1,995,1575,20
116601949666,116601949661,-5,910,3191,20
116605351559,116605351554,-5,1346,2972,20
116605402221,116605402214,-7,932,1532,20
116611230868,116611230867,-1,1120,1606,20
116612486008,116612486005,-3,1774,2675,20
116613503691,116613503692,1,1508,2025,20
116615923463,116615923462,-1,815,2820,20
116618703039,116618703034,-5,1259,2245,20
116619281895,116619281893,-2,1274,2700,20
116625062891,116625062891,0,968,1451,20
116625891290,116625891285,-5,1264,2617,20
116629722698,116629722697,-1,1254,2015,20
116632113862,116632113860,-2,1044,2222,20
116633313898,116633313913,15,18482,22954,20
116638951180,116638951176,-4,1536,2507,20
116639055856,116639055854,-2,1023,2329,20
116641599902,116641599900,-2,1036,2400,20
116645166514,116645166511,-3,766,2115,20
116646408713,116646408713,0,784,1487,20
116647603076,116647603070,-6,1274,2240,20
116648312818,116648312814,-4,1477,2700,20
116650090668,116650090663,-5,1012,1862,20
116661952394,116661952389,-5,739,1127,20
116668473694,116668473692,-2,1068,1666,20
116668879475,116668879473,-2,996,2936,20
116671242570,116671242566,-4,1076,2879,20
116671323782,116671323779,-3,893,2066,20
116672158671,116672158659,-12,783,1110,20
116673594948,116673594969,21,881,1911,20
116674508753,116674508755,2,1081,2179,20
116678467119,116678467113,-6,973,3201,20
116682757566,116682757571,5,2091,1427,20
116685535870,116685535869,-1,856,2225,20
116686999915,116686999911,-4,853,1951,20
116689000005,116689000005,0,1527,2257,20
116690818893,116690818899,6,3725,1779,20
116691229570,116691229568,-2,1551,1748,20
116691630106,116691630103,-3,1216,2328,20
116693800495,116693800492,-3,1622,2688,20
116694257857,116694257854,-3,1350,2213,20
116696842156,116696842154,-2,793,2328,20
116697665894,116697665895,1,3906,14566,20
116697832319,116697832314,-5,924,2558,20
116698161350,116698161350,0,861,2371,20
116698313492,116698313490,-2,1053,2121,20
116706220291,116706220288,-3,1061,2839,20
116708919407,116708919405,-2,961,1771,20
116710873087,116710873086,-1,694,1166,20
116718030473,116718030472,-1,736,1669,20
116719680703,116719680699,-4,603,1539,20
116720023736,116720023753,17,758,2381,20
116720076575,116720076591,16,737,1852,20
116721497234,116721497236,2,1353,1777,20
116730828095,116730828094,-1,1194,2758,20
116731260838,116731260834,-4,1304,2874,20
116732279709,116732279694,-15,1846,2589,20
116737061642,116737061642,0,1027,1292,20
116738337343,116738337350,7,3071,1965,20
116738632286,116738632291,5,2744,1179,20
116739058339,116739058334,-5,1090,2487,20
116739341330,116739341331,1,2258,1985,20
116740719031,116740719027,-4,728,2334,20
116744139343,116744139341,-2,783,1753,20
116750281591,116750281587,-4,928,3103,20
116752162757,116752162752,-5,1197,2702,20
116755864583,116755864581,-2,1433,2191,20
116769666419,116769666415,-4,1519,2194,20
116774449811,116774449811,0,782,1367,20
116776302300,116776302303,3,18617,12837,20
116778563741,116778563739,-2,1366,2910,20
116787048349,116787048344,-5,1119,1738,20
116795261215,116795261210,-5,1191,2933,20
116796511650,116796511649,-1,749,1988,20
116797537162,116797537160,-2,1299,2897,20
116800267434,116800267434,0,2878,2299,20
116804696222,116804696217,-5,1326,4018,20
116805455973,116805455970,-3,1007,2890,20
116808843366,116808843372,6,1000,2177,20
116817991252,116817991250,-2,1364,2386,20
116824725443,116824725438,-5,1325,3204,20
116827837639,116827837636,-3,1109,2321,20
116828121708,116828121705,-3,925,2362,20
116829558199,116829558196,-3,1150,2968,20
116829726215,116829726212,-3,1031,1800,20
116830686884,116830686907,23,798,2844,20
116832078101,116832078120,19,533,736,20
116841677817,116841677814,-3,1412,2930,20
116844438249,116844438247,-2,724,1590,20
116844832146,116844832142,-4,1266,3038,20
116845438696,116845438712,16,1209,2056,20
116847207538,116847207535,-3,743,1601,20
116848310167,116848310154,-13,1430,2701,20
116855171058,116855171056,-2,1046,2609,20
116855959046,116855959043,-3,1251,2106,20
116856064093,116856064106,13,338,1630,20
116858964961,116858964960,-1,1016,2846,20
116860400573,116860400569,-4,1417,2442,20
116863372974,116863372971,-3,1020,2473,20
116867721642,116867721638,-4,1713,2215,20
116869713305,116869713309,4,2085,1336,20
116871743641,116871743638,-3,1390,2568,20
116872847845,116872847846,1,1852,2053,20
116876600379,116876600386,7,2856,1371,20
116878527795,116878527791,-4,1195,1691,20
116881679353,116881679358,5,3340,1173,20
116883203031,116883203028,-3,1230,2667,20
116883306522,116883306523,1,2844,4465,20
116883983833,116883983830,-3,1083,2678,20
116884542350,116884542345,-5,1110,2528,20
116885650269,116885650265,-4,1768,3916,20
116889010894,116889010892,-2,1414,3190,20
116895311816,116895311814,-2,1306,2264,20
116898419693,116898419692,-1,1261,2221,20
116901165118,116901165115,-3,788,1600,20
116901401238,116901401242,4,8275,7963,20
116904849399,116904849397,-2,1206,1971,20
116906029704,116906029701,-3,1246,2959,20
116914640299,116914640297,-2,1220,2278,20
116917509225,116917509222,-3,2833,5320,20
116920721788,116920721786,-2,1641,2823,20
116921658584,116921658583,-1,917,1480,20
116925913942,116925913941,-1,6324,12798,20
116934475190,116934475186,-4,928,2308,20
116936151825,116936151826,1,1489,1612,20
116936793790,116936793784,-6,997,3000,20
116937284372,116937284383,11,111,613,20
116938820371,116938820369,-2,840,1681,20
116940073611,116940073610,-1,1105,1427,20
116941957743,116941957747,4,2190,1449,20
116944314789,116944314795,6,6366,30417,20
116945950254,116945950238,-16,1054,1675,20
116946499643,116946499638,-5,1075,2148,20
116953828233,116953828240,7,10429,43832,20
116953919086,116953919086,0,756,1273,20
116954577638,116954577634,-4,1192,2808,20
116957523277,116957523274,-3,840,2155,20
116962255739,116962255742,3,1482,1070,20
116966032731,116966032729,-2,1038,2894,20
116968455318,116968455319,1,930,1522,20
116970825690,116970825686,-4,756,1417,20
116971836842,116971836848,6,14611,30550,20
116973557071,116973557069,-2,535,1955,20
116977847396,116977847392,-4,1470,3710,20
116984646330,116984646326,-4,815,1424,20
116986151072,116986151070,-2,1285,2127,20
116986456421,116986456442,21,282,3805,20
116990868698,116990868697,-1,688,1281,20
116991624982,116991624980,-2,1132,2496,20
116997617190,116997617187,-3,1368,2305,20
116997896930,116997896926,-4,1104,2218,20
116998829562,116998829555,-7,1225,6442,20
117003156649,117003156646,-3,1461,2216,20
117011435417,117011435423,6,5185,2075,20
117011857773,117011857770,-3,1146,2155,20
117013780118,117013780115,-3,1115,2019,20
117014189053,117014189040,-13,1104,2504,20
117016009623,117016009622,-1,920,1669,20
117017063493,117017063488,-5,906,2325,20
117017287248,117017287246,-2,1115,1913,20
117018076004,117018076027,23,465,1191,20
117020544647,117020544641,-6,1388,2656,20
117025510086,117025510085,-1,1386,2240,20
117030529441,117030529441,0,3968,4781,20
117030987423,117030987422,-1,1010,1920,20
117031044241,117031044237,-4,857,1732,20
117031801794,117031801793,-1,886,2433,20
117034004598,117034004595,-3,898,1677,20
117034964735,117034964731,-4,764,2677,20
117039560762,117039560759,-3,1280,2677,20
117040296079,117040296075,-4,664,1135,20
117041450370,117041450373,3,2917,3548,20
117044657638,117044657635,-3,1117,2931,20
117048510732,117048510729,-3,1386,2090,20
117051878088,117051878084,-4,1141,2719,20
117055475818,117055475816,-2,1127,1968,20
117056244054,117056244070,16,377,1382,20
117060723144,117060723142,-2,1116,2403,20
117064764826,117064764829,3,8717,8176,20
117066208406,117066208422,16,363,903,20
117067618253,117067618250,-3,861,1518,20
117069611101,117069611106,5,2980,1652,20
117080664613,117080664610,-3,1212,2388,20
117080948648,117080948645,-3,35056,11876,20
117082838798,117082838794,-4,1194,3069,20
117084188163,117084188162,-1,848,2259,20
117085885707,117085885704,-3,934,2308,20
117088218534,117088218538,4,1309,793,20
117089632062,117089632062,0,1100,1328,20
117090633385,117090633385,0,938,1788,20
117092508134,117092508130,-4,1429,2160,20
117100956129,117100956134,5,2027,1574,20
117105154702,117105154701,-1,1257,2364,20
117108134884,117108134880,-4,1680,2776,20
117111735442,117111735439,-3,1016,1286,20
117114931498,117114931497,-1,1059,2130,20
117116235977,117116235972,-5,1086,2061,20
117118174624,117118174621,-3,1731,2578,20
117118826283,117118826279,-4,1234,2873,20
117119610382,117119610382,0,1179,1630,20
117121282071,117121282066,-5,1314,2749,20
117122894955,117122894954,-1,1498,1940,20
117134355655,117134355653,-2,1253,1611,20
117135474607,117135474605,-2,1182,1567,20
117141748706,117141748701,-5,932,1730,20
117148006701,117148006701,0,1181,2290,20
117153239694,117153239693,-1,871,1811,20
117156200472,117156200469,-3,1029,3305,20
117159577942,117159577942,0,1188,1635,20
117163249505,117163249510,5,2752,2116,20
117166274140,117166274137,-3,925,2301,20
117167604388,117167604382,-6,1051,1641,20
117169589900,117169589897,-3,745,1131,20
117172125032,117172125029,-3,1286,2515,20
117172636430,117172636433,3,2080,1939,20
117174584209,117174584207,-2,1202,3103,20
117174931268,117174931290,22,1562,4509,20
117178243418,117178243419,1,1346,1573,20
117178947034,117178947052,18,1318,2177,20
117179490083,117179490077,-6,965,2883,20
117181649426,117181649423,-3,1276,2300,20
117181989893,117181989892,-1,1539,2282,20
117185910403,117185910406,3,13997,11084,20
117186230583,117186230589,6,2906,1390,20
117188853178,117188853174,-4,1177,1596,20
117203707402,117203707400,-2,1085,2717,20
117207823552,117207823551,-1,1110,1673,20
117210866782,117210866781,-1,1575,2908,20
117215150002,117215150000,-2,1070,1228,20
117219301749,117219301745,-4,24193,12867,20
117221034705,117221034702,-3,1399,2226,20
117227107145,117227107139,-6,1372,2549,20
117227509882,117227509878,-4,1227,3157,20
117230668525,117230668522,-3,1166,2922,20
117232536933,117232536929,-4,1489,3049,20
117235228070,117235228063,-7,1356,3763,20
117235558867,117235558867,0,1196,1637,20
117238563034,117238563033,-1,788,1780,20
117238919116,117238919102,-14,1462,1890,20
117240733278,117240733278,0,735,970,20
117241688438,117241688434,-4,986,1939,20
117242251999,117242251995,-4,1268,2419,20
117244667046,117244667046,0,1329,3129,20
117245401155,117245401154,-1,1056,1762,20
117247137355,117247137352,-3,944,2163,20
117264968081,117264968077,-4,1028,2189,20
117268408487,117268408484,-3,1279,3135,20
117272324506,117272324503,-3,1151,2376,20
117273227722,117273227718,-4,960,1831,20
117273669310,117273669308,-2,1637,2336,20
117274724919,117274724919,0,1131,1449,20
117280834935,117280834929,-6,1146,2160,20
117284586115,117284586111,-4,971,2299,20
117285137364,117285137386,22,1158,2193,20
117291194329,117291194325,-4,988,1712,20
117292219726,117292219719,-7,1078,1878,20
117294643389,117294643387,-2,1386,2317,20
117295496343,117295496342,-1,1048,3163,20
117297934535,117297934531,-4,1292,2438,20
117298018412,117298018433,21,347,1212,20
117299180207,117299180205,-2,1151,2533,20
117299750568,117299750571,3,1922,1146,20
117302736546,117302736549,3,1581,988,20
117303200830,117303200827,-3,985,1883,20
117304644724,117304644722,-2,985,2543,20
117306882100,117306882096,-4,1022,2307,20
117307475754,117307475751,-3,1096,1846,20
117307571727,117307571735,8,326,709,20
117307990274,117307990277,3,1654,2217,20
117308458806,117308458805,-1,1403,2970,20
117311408414,117311408413,-1,1541,1916,20
117314078279,117314078277,-2,777,1947,20
117316328237,117316328229,-8,939,4763,20
117318386232,117318386236,4,1464,1641,20
117318499399,117318499394,-5,1052,2688,20
117320873247,117320873245,-2,1038,1885,20
117321015399,117321015391,-8,767,1611,20
117321682147,117321682151,4,1750,1413,20
117325640651,117325640629,-22,1158,1843,20
117328504747,117328504747,0,1360,1808,20
117328733358,117328733355,-3,933,2088,20
117330396303,117330396301,-2,1043,2733,20
117331252811,117331252810,-1,1139,2741,20
117331432066,117331432062,-4,783,1907,20
117341713671,117341713658,-13,759,1611,20
117349910622,117349910618,-4,1105,2432,20
117350936642,117350936639,-3,721,2350,20
117352974823,117352974817,-6,1601,2212,20
117353692078,117353692083,5,3623,1119,20
117358078690,117358078686,-4,1270,2512,20
117358894695,117358894692,-3,1112,1828,20
117359371743,117359371742,-1,1371,2348,20
117366301470,117366301467,-3,1057,2247,20
117367289793,117367289786,-7,25878,17594,20
117372868619,117372868615,-4,991,2030,20
117374341723,117374341722,-1,1200,2691,20
117377836291,117377836290,-1,1173,2447,20
117379794230,117379794227,-3,1276,1647,20
117382314247,117382314244,-3,787,1694,20
117386140000,117386139995,-5,982,2242,20
117387412779,117387412774,-5,756,2694,20
117391412373,117391412372,-1,1067,2292,20
117395558427,117395558446,19,1218,2560,20
117397162674,117397162673,-1,861,2169,20
117401430998,117401431007,9,4562,1432,20
117402754430,117402754428,-2,877,2200,20
117403987539,117403987538,-1,935,2601,20
117405302926,117405302925,-1,888,1938,20
117411199220,117411199216,-4,1282,2648,20
117415308087,117415308086,-1,1025,1941,20
117415565297,117415565294,-3,934,2163,20
117418275576,117418275569,-7,872,2244,20
117418899408,117418899419,11,84,716,20
117419996363,117419996364,1,1744,1484,20
117424244278,117424244276,-2,1249,2070,20
117425436155,117425436154,-1,819,2765,20
117427457338,117427457342,4,1943,1676,20
117433685995,117433685995,0,1233,1638,20
117434631353,117434631350,-3,923,2127,20
117435032135,117435032130,-5,1246,2749,20
117447013794,117447013788,-6,1031,2810,20
117450342655,117450342657,2,1857,1685,20
117452213779,117452213778,-1,1484,2125,20
117453259391,117453259389,-2,1145,1990,20
117455780014,117455780012,-2,1032,2384,20
117455996203,117455996200,-3,1496,2733,20
117458880683,117458880681,-2,1435,2512,20
117459299599,117459299617,18,552,1185,20
117465774095,117465774090,-5,1019,2898,20
117468134701,117468134693,-8,766,2252,20
117469145230,117469145225,-5,1012,2676,20
117469435512,117469435525,13,501,882,20
117473849307,117473849303,-4,1184,2522,20
117476129662,117476129658,-4,1095,2238,20
117478465553,117478465550,-3,1033,1778,20
117479029046,117479029046,0,1981,2007,20
117481644517,117481644513,-4,20963,17725,20
117483961013,117483961022,9,13498,22909,20
117486107562,117486107559,-3,896,1955,20
117493141539,117493141537,-2,1386,2422,20
117494458042,117494458042,0,873,1595,20
117495791731,117495791726,-5,1833,2453,20
117513719951,117513719946,-5,1091,1688,20
117515418722,117515418720,-2,1014,2132,20
117516570788,117516570782,-6,1282,2503,20
117517829167,117517829166,-1,1003,1558,20
117519284399,117519284395,-4,588,2175,20
117522498190,117522498188,-2,853,1720,20
117522819864,117522819876,12,481,1926,20
117523849049,117523849045,-4,1505,1895,20
117530688643,117530688641,-2,1628,3512,20
117531703747,117531703743,-4,1295,2698,20
117531745623,117531745602,-21,1173,1544,20
117536990742,117536990741,-1,813,1996,20
117538309558,117538309557,-1,968,1717,20
117542081713,117542081710,-3,1123,2123,20
117542284198,117542284217,19,730,2062,20
117543075734,117543075731,-3,1030,2019,20
117546489162,117546489157,-5,1150,1930,20
117547220958,117547220956,-2,1101,2315,20
117550400286,117550400283,-3,810,1953,20
117550455097,117550455095,-2,1462,2299,20
117552659698,117552659695,-3,1369,2541,20
117554314542,117554314540,-2,930,2272,20
117555414430,117555414424,-6,1562,4987,20
117557904694,117557904691,-3,1345,2830,20
117559004186,117559004185,-1,1894,2695,20
117563471846,117563471842,-4,1267,2996,20
117564817643,117564817638,-5,1387,2865,20
117566266755,117566266775,20,1110,2135,20
117570489382,117570489383,1,1273,1138,20
117574516022,117574516020,-2,1361,2390,20
117578397110,117578397106,-4,1015,2173,20
117579784314,117579784311,-3,933,1772,20
117580601834,117580601832,-2,992,2360,20
117588976578,117588976575,-3,1237,2396,20
117591916837,117591916834,-3,1551,2641,20
117592252929,117592252924,-5,2115,6567,20
117593510542,117593510538,-4,1389,2970,20
117595855204,117595855217,13,1105,4642,20
117597400366,117597400363,-3,928,1509,20
117598351654,117598351643,-11,1308,1366,20
117599992126,117599992106,-20,412,966,20
117600760289,117600760287,-2,1164,2481,20
117602456106,117602456103,-3,986,1369,20
117604832914,117604832912,-2,1186,2231,20
117605623507,117605623506,-1,1258,2029,20
117608100107,117608100103,-4,1433,2986,20
117610554950,117610554949,-1,409,1175,20
117613834791,117613834788,-3,1173,2641,20
117619188610,117619188609,-1,1106,2562,20
117620632729,117620632723,-6,1307,4628,20
117622710962,117622710958,-4,820,2552,20
117623795543,117623795548,5,677,12563,20
117627315115,117627315113,-2,1048,1479,20
117631193381,117631193378,-3,634,1451,20
117634855265,117634855271,6,10597,3942,20
117635991803,117635991799,-4,1192,1899,20
117636742663,117636742662,-1,1138,2544,20
117639490054,117639490049,-5,928,1965,20
117643453281,117643453282,1,1278,1044,20
117644315210,117644315218,8,11286,31550,20
117647332304,117647332300,-4,596,2372,20
117653827032,117653827030,-2,1070,2220,20
117654901242,117654901240,-2,965,2420,20
117655962554,117655962550,-4,1694,3702,20
117657529915,117657529913,-2,1113,1689,20
117662458665,117662458665,0,1222,1775,20
117665385002,117665385002,0,1418,1293,20
117666170907,117666170904,-3,865,1803,20
117668159739,117668159734,-5,734,1671,20
117668550885,117668550904,19,765,1095,20
117675446005,117675446001,-4,1726,3247,20
117677794989,117677794986,-3,1228,3126,20
117677934070,117677934059,-11,155,846,20
117680727657,117680727653,-4,1035,2631,20
117685387558,117685387554,-4,1153,2963,20
117685828791,117685828789,-2,599,1731,20
117685914110,117685914130,20,759,1815,20
117686587341,117686587338,-3,942,2438,20
117690138642,117690138637,-5,1198,2185,20
117690380916,117690380938,22,803,1474,20
117692322642,117692322638,-4,1348,2877,20
117694387536,117694387533,-3,1074,2352,20
117700613000,117700612997,-3,1305,2186,20
117703727743,117703727741,-2,1290,2190,20
117705453458,117705453457,-1,636,760,20
117706609170,117706609168,-2,1102,2036,20
117706851349,117706851336,-13,925,2045,20
117706969360,117706969377,17,1006,3189,20
117710019230,117710019226,-4,1283,2641,20
117713424349,117713424349,0,1617,1637,20
117714948877,117714948874,-3,959,2136,20
117720827651,117720827649,-2,950,1476,20
117726828021,117726828019,-2,1392,2010,20
117727644742,117727644743,1,891,1736,20
117732119931,117732119929,-2,1004,2130,20
117732232929,117732232925,-4,1510,2985,20
117733831094,117733831092,-2,1087,2840,20
117736351975,117736351970,-5,1352,2299,20
117742319243,117742319242,-1,2065,1930,20
117744534147,117744534143,-4,681,1929,20
117746307727,117746307721,-6,1080,3584,20
117747330511,117747330507,-4,1047,2613,20
117751578093,117751578075,-18,986,2355,20
117752073190,117752073189,-1,1664,2714,20
117753338253,117753338254,1,1310,1674,20
117755463133,117755463131,-2,1635,2150,20
117757776894,117757776891,-3,697,2117,20
117761165957,117761165954,-3,1145,2558,20
117765629642,117765629644,2,1950,1297,20
117766368735,117766368733,-2,1214,2469,20
117771335431,117771335430,-1,902,1942,20
117775970752,117775970749,-3,1520,2295,20
117777122842,117777122851,9,13254,25028,20
117778139234,117778139234,0,844,2177,20
117779031767,117779031758,-9,34238,13149,20
117779393512,117779393517,5,3515,890,20
117780466204,117780466201,-3,1181,2496,20
117785097074,117785097070,-4,1300,1736,20
117786085515,117786085513,-2,1458,2368,20
117787051064,117787051061,-3,1055,2176,20
117790192506,117790192501,-5,1004,2258,20
117790325868,117790325888,20,795,2051,20
117790460357,117790460353,-4,890,1929,20
117795587787,117795587782,-5,803,1477,20
117805022852,117805022845,-7,1700,3183,20
117806956401,117806956398,-3,1562,3052,20
117809265090,117809265088,-2,1856,2367,20
117810001887,117810001883,-4,1014,2378,20
117810095638,117810095636,-2,1102,2047,20
117816739615,117816739610,-5,986,2406,20
117816831970,117816831966,-4,927,2786,20
117819862066,117819862066,0,852,1416,20
117820096827,117820096822,-5,1714,2623,20
117822523670,117822523667,-3,860,2354,20
117823515956,117823515954,-2,1928,4058,20
117828736195,117828736192,-3,1907,5221,20
117832578078,117832578074,-4,921,2487,20
117833023123,117833023121,-2,931,2248,20
117834740219,117834740217,-2,912,2091,20
117836502427,117836502425,-2,944,1819,20
117838191765,117838191765,0,663,1579,20
117841093718,117841093715,-3,1073,1927,20
117841975599,117841975595,-4,1064,2893,20
117843230393,117843230390,-3,1024,2048,20
117843411921,117843411934,13,890,2061,20
117848926504,117848926501,-3,899,3153,20
117849001021,117849001034,13,350,1499,20
117851404654,117851404653,-1,798,1556,20
117852887979,117852887977,-2,1253,2494,20
117852962782,117852962762,-20,1096,1932,20
117858735615,117858735614,-1,818,2070,20
117863403719,117863403714,-5,947,1308,20
117864392831,117864392828,-3,971,2491,20
117865943748,117865943746,-2,1035,1956,20
117867761291,117867761289,-2,1252,2405,20
117872536551,117872536549,-2,1035,2135,20
117874199297,117874199294,-3,1241,2010,20
117876427567,117876427562,-5,1248,3501,20
117876777193,117876777189,-4,1063,2531,20
117880587729,117880587731,2,1347,1701,20
117881083925,117881083947,22,888,2414,20
117882801932,117882801926,-6,174,713,20
117886249094,117886249092,-2,1045,2423,20
117886717609,117886717607,-2,1112,2252,20
117887804505,117887804504,-1,1103,1810,20
117891110930,117891110926,-4,1088,1969,20
117893713041,117893713038,-3,1074,1924,20
117894010852,117894010874,22,1128,2524,20
117906740281,117906740277,-4,955,2294,20
117906884315,117906884314,-1,1380,1811,20
117907435997,117907435993,-4,953,2550,20
117907739918,117907739918,0,1300,2778,20
117908940265,117908940263,-2,784,1318,20
117910603437,117910603437,0,969,1610,20
117918276018,117918276014,-4,981,2942,20
117919435533,117919435530,-3,978,2250,20
117927374245,117927374243,-2,886,2158,20
117927578464,117927578482,18,1127,2150,20
117929983076,117929983074,-2,1084,2428,20
117930176555,117930176548,-7,626,3743,20
117937176899,117937176894,-5,1076,2937,20
117937940600,117937940619,19,1091,2139,20
117942452917,117942452918,1,1756,1505,20
117942636871,117942636866,-5,1466,2916,20
117942867259,117942867258,-1,953,1964,20
117943053902,117943053884,-18,730,2092,20
117944274746,117944274744,-2,1016,2203,20
117947091426,117947091425,-1,716,1915,20
117950778008,117950778006,-2,1019,1473,20
117951076972,117951076968,-4,1274,1983,20
117951500688,117951500686,-2,1416,2465,20
117951859262,117951859258,-4,1158,2433,20
117955103671,117955103666,-5,1274,2273,20
117957246533,117957246528,-5,847,2810,20
117962178283,117962178281,-2,1364,1940,20
117962498145,117962498141,-4,1123,2805,20
117965417289,117965417289,0,1817,3117,20
117965805141,117965805139,-2,1156,2800,20
117968511246,117968511241,-5,1002,1713,20
117968585373,117968585370,-3,915,2045,20
117974285830,117974285826,-4,811,2166,20
117977778083,117977778081,-2,674,1977,20
117977929445,117977929462,17,531,1659,20
117986594891,117986594886,-5,1191,1406,20
117987582196,117987582185,-11,1797,2277,20
117991331906,117991331902,-4,1048,2943,20
117991650793,117991650790,-3,1317,2784,20
117995408354,117995408340,-14,1677,949,20
118002942290,118002942286,-4,997,3191,20
118004570145,118004570143,-2,1235,2115,20
118008105702,118008105700,-2,1227,3057,20
118010999068,118010999065,-3,1245,2892,20
118011602977,118011602975,-2,854,2842,20
118012282619,118012282615,-4,1024,1918,20
118014154946,118014154944,-2,974,1893,20
118017925692,118017925688,-4,821,2358,20
118020833058,118020833056,-2,1041,2567,20
118023711925,118023711921,-4,1193,2058,20
118024186746,118024186744,-2,1012,2618,20
118024905558,118024905551,-7,5857,28066,20
118032173971,118032173978,7,2697,1448,20
118033167198,118033167176,-22,1811,827,20
118038012317,118038012314,-3,1258,3320,20
118038727290,118038727285,-5,1089,1696,20
118038960200,118038960193,-7,1040,3446,20
118039635053,118039635073,20,373,630,20
118040344300,118040344298,-2,1163,1822,20
118043388762,118043388757,-5,922,2902,20
118051315367,118051315381,14,1280,1879,20
118052463279,118052463274,-5,978,2278,20
118053144202,118053144201,-1,988,1828,20
118053330652,118053330670,18,778,1787,20
118053660839,118053660838,-1,879,1440,20
118063596210,118063596205,-5,981,2391,20
118066085508,118066085505,-3,908,2069,20
118067153390,118067153405,15,428,2388,20
118067636201,118067636197,-4,1229,2199,20
118068686206,118068686202,-4,1204,2432,20
118069814914,118069814912,-2,1285,1853,20
118071726195,118071726192,-3,1149,1889,20
118073895528,118073895525,-3,1333,2997,20
118083719065,118083719062,-3,1350,2330,20
118084259372,118084259365,-7,811,1601,20
118085280281,118085280278,-3,1080,2372,20
118093928431,118093928426,-5,1445,2559,20
118095119494,118095119495,1,1808,2327,20
118103026278,118103026277,-1,1606,1642,20
118103803484,118103803480,-4,1175,3045,20
118103942524,118103942521,-3,1555,2874,20
118105458888,118105458885,-3,1191,2656,20
118106916889,118106916886,-3,891,2450,20
118109740928,118109740925,-3,1120,1827,20
118110353783,118110353781,-2,1002,2364,20
118111018237,118111018235,-2,744,1632,20
118113145575,118113145575,0,944,1584,20
118115264696,118115264713,17,270,1071,20
118120672364,118120672362,-2,1020,2135,20
118125817786,118125817783,-3,1252,1474,20
118127533463,118127533461,-2,1383,2421,20
118128133514,118128133511,-3,1069,2992,20
118128510382,118128510371,-11,313,854,20
118131310998,118131310997,-1,1195,2207,20
118133913879,118133913877,-2,982,1268,20
118135468127,118135468125,-2,857,1504,20
118135841398,118135841411,13,190,826,20
118140008286,118140008282,-4,1266,3026,20
118141511895,118141511892,-3,1473,2579,20
118142357394,118142357390,-4,737,1869,20
118145094939,118145094937,-2,873,2177,20
118147355921,118147355918,-3,1720,2226,20
118151768983,118151768981,-2,1090,1497,20
118153110054,118153110053,-1,1331,1727,20
118153350641,118153350641,0,829,1661,20
118161821130,118161821132,2,1623,1449,20
118161986947,118161986945,-2,888,1603,20
118162039814,118162039833,19,590,7961,20
118164573298,118164573294,-4,1163,2188,20
118164807604,118164807626,22,1059,2917,20
118167275546,118167275539,-7,1236,3086,20
118170212838,118170212835,-3,1226,2225,20
118176343179,118176343178,-1,683,2076,20
118177211753,118177211750,-3,1235,3427,20
118177722255,118177722270,15,750,1844,20
118190530678,118190530677,-1,1351,3036,20
118190941766,118190941764,-2,1490,2662,20
118191737918,118191737916,-2,1297,2673,20
118192094054,118192094046,-8,282,1625,20
118201055602,118201055599,-3,817,1595,20
118202310941,118202310925,-16,1476,2406,20
118207513581,118207513577,-4,1571,3177,20
118207548771,118207548769,-2,907,1991,20
118209144404,118209144426,22,1098,2324,20
118210847174,118210847162,-12,11349,38672,20
118213216351,118213216350,-1,931,2445,20
118217504790,118217504787,-3,1200,2312,20
118217831182,118217831176,-6,795,2247,20
118217874458,118217874459,1,1274,1469,20
118220917959,118220917957,-2,842,1218,20
118223285706,118223285705,-1,1524,1907,20
118223825638,118223825636,-2,1588,2500,20
118228286579,118228286574,-5,1230,2404,20
118230517636,118230517634,-2,1417,2308,20
118231276890,118231276885,-5,745,2102,20
118232236536,118232236538,2,1665,1593,20
118232813109,118232813111,2,1060,1174,20
118233241157,118233241161,4,3195,1674,20
118233409171,118233409166,-5,848,2862,20
118234512372,118234512368,-4,1236,2586,20
118237945887,118237945887,0,1135,1890,20
118237989663,118237989658,-5,655,2369,20
118241532302,118241532302,0,1342,2457,20
118241858534,118241858530,-4,1116,1901,20
118242481050,118242481049,-1,875,2540,20
118242782132,118242782129,-3,1729,2448,20
118244060410,118244060408,-2,1340,1737,20
118246422746,118246422750,4,2545,1294,20
118248291650,118248291647,-3,1344,2717,20
118260594238,118260594242,4,1418,1120,20
118265352365,118265352362,-3,1082,1872,20
118267257943,118267257939,-4,1115,2575,20
118268066983,118268066981,-2,1181,2461,20
118269541731,118269541727,-4,550,1590,20
118276185970,118276185967,-3,1191,3342,20
118276357423,118276357418,-5,838,2864,20
118277515070,118277515066,-4,958,2235,20
118278040979,118278040975,-4,1864,6119,20
118280998187,118280998186,-1,1377,1763,20
118282242994,118282242990,-4,952,2053,20
118284262994,118284262990,-4,1158,1930,20
118285103621,118285103618,-3,964,2282,20
118286761294,118286761291,-3,992,2284,20
118287377156,118287377153,-3,942,1881,20
118287528284,118287528307,23,1098,951,20
118289842454,118289842441,-13,1112,2089,20
118292072098,118292072094,-4,1123,2258,20
118295904723,118295904720,-3,1151,3019,20
118296609765,118296609783,18,895,2030,20
118297146487,118297146486,-1,1383,1549,20
118297771088,118297771105,17,1332,2152,20
118302832025,118302832020,-5,1071,2641,20
118303976347,118303976342,-5,1155,2124,20
118304893699,118304893698,-1,1443,3420,20
118320187226,118320187212,-14,15,2461,20
118320496358,118320496358,0,1609,2451,20
118322676782,118322676781,-1,1036,1335,20
118323476693,118323476689,-4,1194,1976,20
118324039386,118324039381,-5,868,2740,20
118331511559,118331511555,-4,897,2485,20
118339062326,118339062322,-4,941,2073,20
118340647163,118340647157,-6,953,4151,20
118344707626,118344707626,0,1247,1458,20
118348666762,118348666757,-5,771,1485,20
118349238541,118349238539,-2,1074,2471,20
118350555399,118350555396,-3,853,1689,20
118351496902,118351496899,-3,1180,3061,20
118352435078,118352435074,-4,1213,2199,20
118352975531,118352975529,-2,1311,2708,20
118353237706,118353237701,-5,1663,7068,20
118354915939,118354915937,-2,1060,2122,20
118356783359,118356783356,-3,902,2303,20
118365270997,118365270990,-7,2258,10475,20
118365345766,118365345762,-4,2107,3629,20
118366612730,118366612727,-3,963,1861,20
118370780998,118370780998,0,1411,1570,20
118372208483,118372208479,-4,772,2378,20
118381379653,118381379651,-2,988,2418,20
118389096933,118389096939,6,3555,1594,20
118391587215,118391587215,0,2071,3853,20
118394100661,118394100665,4,1798,1600,20
118395522667,118395522665,-2,1009,2303,20
118402846639,118402846638,-1,975,1770,20
118406587063,118406587057,-6,1072,4836,20
118409315761,118409315750,-11,21201,14008,20
118414825994,118414825990,-4,1588,3170,20
118423155546,118423155543,-3,851,2158,20
118423990996,118423990994,-2,1241,1962,20
118425493886,118425493883,-3,1488,2961,20
118434092426,118434092421,-5,912,2551,20
118434393839,118434393835,-4,1145,2276,20
118438542434,118438542434,0,1542,1569,20
118441932489,118441932486,-3,1378,3198,20
118442110254,118442110274,20,311,657,20
118443668546,118443668543,-3,663,1096,20
118450692368,118450692369,1,1342,1802,20
118457418367,118457418364,-3,792,2220,20
118457827111,118457827099,-12,981,1914,20
118457981693,118457981677,-16,1206,2323,20
118458096169,118458096162,-7,1240,3091,20
118462444059,118462444055,-4,1085,2499,20
118463507631,118463507628,-3,1215,2498,20
118464126364,118464126362,-2,1063,2038,20
118469445219,118469445218,-1,1166,1775,20
118472522367,118472522362,-5,1176,2912,20
118477229272,118477229275,3,1534,1852,20
118481892125,118481892122,-3,852,1822,20
118482973699,118482973697,-2,713,1568,20
118484379486,118484379483,-3,990,1646,20
118485579806,118485579805,-1,979,2117,20
118487373225,118487373222,-3,1362,2479,20
118488084459,118488084456,-3,961,2120,20
118496211719,118496211714,-5,933,2163,20
118499663869,118499663866,-3,1220,1635,20
118507695685,118507695679,-6,1388,2353,20
118510231887,118510231882,-5,1492,2712,20
118510535652,118510535637,-15,1017,3279,20
118512067719,118512067716,-3,1145,2541,20
118512824038,118512824033,-5,1178,2285,20
118516162803,118516162801,-2,850,2126,20
118517017570,118517017567,-3,1591,2078,20
118518453438,118518453436,-2,916,2060,20
118520573960,118520573957,-3,1422,2672,20
118520844163,118520844162,-1,831,1744,20
118526053630,118526053626,-4,1161,2158,20
118532364867,118532364867,0,1278,1898,20
118535053927,118535053925,-2,915,1420,20
118541253530,118541253526,-4,913,1557,20
118541445314,118541445313,-1,1674,2479,20
118542661359,118542661358,-1,908,2403,20
118543008950,118543008949,-1,1045,1458,20
118543231597,118543231618,21,1177,1871,20
118547954005,118547954002,-3,1495,2509,20
118555178991,118555178995,4,2478,2125,20
118556574066,118556574071,5,1524,1135,20
118563718839,118563718838,-1,1042,2160,20
118564416613,118564416610,-3,1192,2132,20
118566499516,118566499519,3,3271,2239,20
118567862710,118567862707,-3,1262,2375,20
118568002078,118568002074,-4,865,1418,20
118569168785,118569168782,-3,1404,2573,20
118572031506,118572031501,-5,1194,2356,20
118584908143,118584908142,-1,1154,1527,20
118585971607,118585971605,-2,1204,2818,20
118589266010,118589266007,-3,1146,2896,20
118590305976,118590305972,-4,1343,3200,20
118590905154,118590905149,-5,2058,4993,20
118595816494,118595816490,-4,1149,2891,20
118600074487,118600074495,8,12108,23413,20
118601198518,118601198511,-7,1066,2689,20
118605819539,118605819534,-5,821,2419,20
118608604894,118608604891,-3,1068,2072,20
118609037783,118609037774,-9,1117,2206,20
118612448469,118612448466,-3,1354,2717,20
118614898763,118614898760,-3,1119,2058,20
118619086169,118619086170,1,1868,2200,20
118622963629,118622963626,-3,1074,3063,20
118623514997,118623514994,-3,1266,2183,20
118626792718,118626792714,-4,1042,2370,20
118626955279,118626955274,-5,936,2180,20
118627804319,118627804318,-1,994,1994,20
118628210855,118628210874,19,170,2047,20
118631353205,118631353201,-4,1342,3098,20
118631428987,118631428990,3,3348,2808,20
118638272835,118638272833,-2,718,1977,20
118642875218,118642875214,-4,1271,2542,20
118649404222,118649404219,-3,1128,3164,20
118652343033,118652343031,-2,1331,3309,20
118653899867,118653899865,-2,1049,2291,20
118654697110,118654697105,-5,787,2503,20
118654864124,118654864147,23,1378,2420,20
118657360698,118657360695,-3,1197,2708,20
118658988739,118658988739,0,1224,1591,20
118662876257,118662876240,-17,1090,2581,20
118668720590,118668720586,-4,1461,3246,20
118669349604,118669349625,21,491,2117,20
118671063894,118671063892,-2,1083,1846,20
118671813493,118671813491,-2,983,1758,20
118678279742,118678279742,0,1405,2164,20
118679178395,118679178393,-2,1253,1764,20
118682015029,118682015025,-4,1376,3304,20
118685308552,118685308550,-2,1562,2824,20
118686932997,118686932993,-4,1006,1802,20
118692907619,118692907617,-2,1023,2125,20
118696359176,118696359173,-3,1226,2716,20
118697636064,118697636068,4,2967,1566,20
118702828574,118702828577,3,2274,2359,20
118706826250,118706826248,-2,940,1801,20
118707396110,118707396107,-3,926,2074,20
118707767414,118707767430,16,328,635,20
118711041566,118711041564,-2,1088,1902,20
118712317742,118712317741,-1,18896,30934,20
118712884862,118712884861,-1,1159,2606,20
118714507682,118714507679,-3,1590,2512,20
118715007027,118715007022,-5,1103,4317,20
118715612210,118715612210,0,906,1854,20
118725089240,118725089221,-19,48,491,20
118725920744,118725920741,-3,1065,2791,20
118728575803,118728575810,7,3946,986,20
118731006390,118731006388,-2,1152,2230,20
118736408671,118736408665,-6,1277,4313,20
118737001875,118737001865,-10,674,212,20
118738046289,118738046287,-2,883,1281,20
118739549933,118739549929,-4,1223,2323,20
118740856329,118740856324,-5,1129,2170,20
118741910357,118741910350,-7,346,1074,20
118742732515,118742732513,-2,817,2799,20
118743116157,118743116153,-4,1124,1997,20
118744685899,118744685896,-3,1002,2435,20
118745795872,118745795870,-2,1083,1850,20
118755548970,118755548969,-1,908,2170,20
118756631611,118756631605,-6,940,1822,20
118758201466,118758201463,-3,928,2707,20
118758368334,118758368333,-1,974,2097,20
118759342434,118759342431,-3,1198,2299,20
118760345230,118760345226,-4,1044,2624,20
118761427012,118761427010,-2,1356,3006,20
118766487697,118766487697,0,2458,3709,20
118767712119,118767712117,-2,1074,3244,20
118770218059,118770218057,-2,1213,1341,20
118772049818,118772049816,-2,843,1820,20
118772623814,118772623810,-4,1208,2160,20
118774715814,118774715810,-4,1267,1960,20
118778115819,118778115817,-2,1685,3120,20
118778249870,118778249865,-5,1017,2918,20
118786652319,118786652316,-3,1150,1842,20
118790159490,118790159486,-4,894,2406,20
118791779554,118791779551,-3,1535,3179,20
118793777002,118793776998,-4,772,1613,20
118800187025,118800187013,-12,971,1926,20
118800738935,118800738932,-3,912,2164,20
118806097698,118806097694,-4,969,2033,20
118806613467,118806613467,0,1018,2231,20
118809995954,118809995952,-2,965,3171,20
118811508711,118811508709,-2,1563,2256,20
118812332396,118812332400,4,2650,1591,20
118813395537,118813395534,-3,1051,2408,20
118814174176,118814174177,1,1382,2282,20
118814201730,118814201729,-1,1448,2275,20
118820288427,118820288423,-4,1284,2150,20
118821906956,118821906949,-7,1164,5186,20
118822896870,118822896871,1,1694,1142,20
118827446034,118827446034,0,659,1967,20
118828763087,118828763084,-3,1090,3476,20
118834726994,118834726991,-3,1035,2808,20
118834889016,118834888994,-22,1725,3271,20
118838347885,118838347881,-4,972,1961,20
118844352197,118844352193,-4,1143,2096,20
118844782510,118844782505,-5,781,2609,20
118844823572,118844823570,-2,44,960,20
118846971831,118846971829,-2,948,2491,20
118848284466,118848284462,-4,735,2439,20
118851438340,118851438337,-3,1216,1498,20
118855816045,118855816050,5,6077,2316,20
118857213025,118857213030,5,3206,2227,20
118857864746,118857864742,-4,858,2231,20
118859484289,118859484283,-6,558,1128,20
118860174214,118860174195,-19,843,2535,20
118862638348,118862638346,-2,1363,1898,20
118866636790,118866636788,-2,1131,2098,20
118868032194,118868032191,-3,1186,2322,20
118870602001,118870602001,0,1175,1754,20
118875960886,118875960883,-3,3510,6491,20
118876554349,118876554344,-5,1456,2500,20
118876756028,118876756027,-1,899,1905,20
118887673623,118887673621,-2,1010,1951,20
118888279186,118888279181,-5,1115,4472,20
118897679773,118897679770,-3,1347,2805,20
118901098414,118901098410,-4,1071,2660,20
118901493491,118901493490,-1,1104,2242,20
118902092645,118902092642,-3,1051,1996,20
118902605407,118902605409,2,148,762,20
118902777173,118902777170,-3,1065,2341,20
118906158580,118906158576,-4,702,3560,20
118907729905,118907729901,-4,1183,1885,20
118915994994,118915994995,1,1297,1594,20
118916201847,118916201842,-5,1111,1412,20
118917138796,118917138793,-3,1355,3075,20
118919710159,118919710157,-2,797,1261,20
118923818436,118923818435,-1,1055,2444,20
118924874795,118924874793,-2,964,1174,20
118926790829,118926790838,9,11570,20864,20
118928196522,118928196521,-1,1102,2256,20
118929104911,118929104910,-1,1194,2565,20
118931633208,118931633205,-3,1642,3376,20
118937480598,118937480594,-4,939,2092,20
118944258913,118944258911,-2,1189,2242,20
118944637267,118944637265,-2,1262,2711,20
118947040630,118947040630,0,1042,2002,20
118948445723,118948445721,-2,1511,1997,20
118948494285,118948494280,-5,952,3215,20
118950079999,118950079998,-1,1771,2367,20
118951585809,118951585806,-3,999,2427,20
118953561141,118953561138,-3,862,754,20
118954738281,118954738278,-3,1203,2799,20
118958218135,118958218133,-2,1113,2832,20
118958742110,118958742110,0,1285,2099,20
118960302879,118960302869,-10,791,3129,20
118962222066,118962222062,-4,1153,2903,20
118965924334,118965924330,-4,1117,2481,20
118966227050,118966227046,-4,1418,2450,20
118967182817,118967182814,-3,1077,2511,20
118968628937,118968628935,-2,1003,2546,20
118970878932,118970878928,-4,1291,2431,20
118974352426,118974352426,0,1030,1924,20
118974821984,118974821981,-3,1580,2882,20
118979655511,118979655510,-1,1023,1969,20
118980378173,118980378191,18,608,2142,20
118980800615,118980800613,-2,1198,2260,20
118983637489,118983637485,-4,985,2097,20
