fTNear,fTFar,fDelT,fQNear,fQFar,d
119117474028,119117474025,-3,17,17,-10
820661,820666,5,2192,780,-10
1529526,1529507,-19,2010,1321,-10
4489217,4489218,1,891,1091,-10
5140566,5140569,3,1837,1580,-10
7390244,7390245,1,2302,1764,-10
10940576,10940577,1,1604,2083,-10
14206023,14206023,0,985,1540,-10
15712223,15712223,0,1270,878,-10
17990486,17990488,2,1244,1900,-10
18234734,18234735,1,1537,2065,-10
18768754,18768754,0,1325,1486,-10
19624050,19624050,0,1924,1643,-10
21086256,21086258,2,1589,897,-10
26694651,26694653,2,947,1169,-10
30166381,30166383,2,1875,1694,-10
32164716,32164718,2,1574,2274,-10
32455182,32455182,0,1802,1862,-10
33266954,33266956,2,1282,1659,-10
34196152,34196153,1,30926,92216,-10
34336408,34336409,1,1008,1451,-10
39612467,39612463,-4,1005,1805,-10
42950564,42950572,8,10948,36906,-10
49769731,49769735,4,940,838,-10
50315515,50315516,1,1965,1717,-10
50469858,50469855,-3,1144,2119,-10
50868130,50868133,3,1721,1750,-10
54305995,54305998,3,1815,1574,-10
55092429,55092430,1,1148,1120,-10
55121349,55121351,2,1786,1626,-10
55660454,55660455,1,1553,1493,-10
55854601,55854603,2,1248,1937,-10
58123861,58123861,0,1088,1249,-10
59979509,59979505,-4,1443,2435,-10
62533589,62533590,1,1168,1556,-10
63313847,63313849,2,1216,1420,-10
69952114,69952115,1,1679,1725,-10
72112685,72112686,1,1345,1873,-10
72606665,72606666,1,1503,1478,-10
72949126,72949128,2,2282,2298,-10
73166402,73166405,3,1254,1233,-10
76495726,76495726,0,1066,1551,-10
79112625,79112626,1,1365,1944,-10
79921345,79921349,4,3587,2985,-10
81995863,81995862,-1,2180,1577,-10
82316829,82316824,-5,1241,1996,-10
82907494,82907494,0,1551,1411,-10
84767521,84767523,2,1923,1737,-10
84918137,84918134,-3,1361,1307,-10
85108144,85108139,-5,1445,1505,-10
86732514,86732516,2,1965,1975,-10
92121371,92121366,-5,1534,5197,-10
93605756,93605757,1,1674,1389,-10
93856575,93856554,-21,1778,1796,-10
106273730,106273733,3,1185,1526,-10
106818961,106818963,2,1836,1424,-10
108520669,108520670,1,1755,1691,-10
109504279,109504277,-2,1622,2040,-10
109963647,109963652,5,1949,1128,-10
116005942,116005944,2,1207,1399,-10
120149965,120149968,3,1280,1460,-10
121835038,121835033,-5,1804,4079,-10
123445535,123445537,2,1210,1381,-10
123854134,123854136,2,1168,1296,-10
124132432,124132435,3,1270,1118,-10
127747741,127747747,6,1784,1525,-10
133247302,133247303,1,1429,1441,-10
134820011,134820012,1,1375,1269,-10
137018868,137018882,14,16438,47570,-10
139757385,139757386,1,1003,1669,-10
142068941,142068943,2,1289,1637,-10
147582758,147582761,3,1792,1658,-10
150331554,150331556,2,1106,1104,-10
158690459,158690461,2,1149,890,-10
160450471,160450472,1,1540,1495,-10
161578564,161578564,0,37109,16850,-10
164863953,164863956,3,2014,1567,-10
165146076,165146077,1,2152,2090,-10
166409765,166409768,3,1828,1880,-10
167883130,167883130,0,701,1675,-10
169353030,169353025,-5,1316,4562,-10
171705114,171705117,3,1303,1329,-10
171980159,171980176,17,1421,1714,-10
174287151,174287154,3,1799,1891,-10
178170735,178170739,4,961,925,-10
179160355,179160355,0,1757,2288,-10
179423257,179423258,1,1569,1788,-10
181788360,181788365,5,2927,1476,-10
183721990,183721992,2,1693,1589,-10
185506642,185506643,1,2378,2299,-10
187221423,187221425,2,1652,1636,-10
187331021,187331033,12,1993,1267,-10
188207210,188207213,3,1166,739,-10
189047466,189047467,1,991,1101,-10
189621118,189621120,2,1913,1790,-10
190430327,190430329,2,1541,1240,-10
191569030,191569030,0,1542,1387,-10
196976715,196976713,-2,959,1631,-10
203957428,203957430,2,1545,1710,-10
205139826,205139826,0,1469,1706,-10
205904934,205904934,0,1489,2460,-10
207220237,207220241,4,1630,1301,-10
207311617,207311618,1,1391,1808,-10
207443193,207443207,14,12453,45685,-10
207753839,207753841,2,1641,1688,-10
209709090,209709086,-4,1494,2089,-10
210583715,210583717,2,1223,1382,-10
211709142,211709144,2,1398,1606,-10
213352921,213352923,2,1760,2066,-10
217480943,217480947,4,947,1404,-10
220807054,220807056,2,1700,2166,-10
222055545,222055546,1,1099,1219,-10
224261157,224261160,3,3006,3216,-10
226741530,226741530,0,1252,2051,-10
231344111,231344115,4,772,1067,-10
232276795,232276789,-6,20946,12929,-10
238465054,238465057,3,1931,1471,-10
241559399,241559401,2,1554,2086,-10
242400938,242400938,0,972,761,-10
243036783,243036786,3,953,898,-10
248738249,248738250,1,1388,2225,-10
250794077,250794079,2,1610,1505,-10
252186454,252186457,3,1495,1841,-10
253480693,253480695,2,1192,1995,-10
256742194,256742193,-1,1507,2072,-10
258169331,258169331,0,2257,1828,-10
258203087,258203090,3,1063,788,-10
260633217,260633218,1,1539,1430,-10
262259482,262259485,3,2124,1524,-10
264719882,264719885,3,1595,1977,-10
265751699,265751713,14,1381,1120,-10
266647684,266647701,17,263,1127,-10
269001951,269001938,-13,37742,15709,-10
269817207,269817210,3,1655,1612,-10
271093110,271093112,2,2093,1824,-10
272841841,272841842,1,1028,636,-10
279148406,279148407,1,1426,1285,-10
281631204,281631205,1,1997,2250,-10
283588191,283588191,0,1433,1654,-10
289674446,289674449,3,1570,1554,-10
292739294,292739296,2,1932,2133,-10
295056612,295056613,1,1388,1086,-10
296948527,296948529,2,1484,1563,-10
297694633,297694636,3,1684,1542,-10
299214653,299214654,1,1736,1773,-10
300443297,300443298,1,1584,1835,-10
302110611,302110611,0,5769,7389,-10
303710015,303710015,0,1244,1819,-10
304128463,304128465,2,1146,1306,-10
304876238,304876240,2,1490,2376,-10
305437152,305437154,2,1795,2352,-10
306330512,306330515,3,1261,1379,-10
311123068,311123074,6,1475,793,-10
312166618,312166623,5,2145,1320,-10
312626786,312626789,3,2157,2486,-10
313344546,313344549,3,1619,1729,-10
313558621,313558600,-21,1226,1574,-10
317002921,317002922,1,1660,2053,-10
317298401,317298402,1,1536,1543,-10
321155138,321155139,1,1511,1655,-10
322069545,322069545,0,2318,2185,-10
322830029,322830034,5,1624,1509,-10
323593146,323593149,3,1444,1666,-10
325803195,325803202,7,2542,1600,-10
326517516,326517517,1,1609,2611,-10
326870391,326870392,1,1688,1771,-10
327651383,327651386,3,1930,1445,-10
329998042,329998043,1,2073,1709,-10
332880195,332880195,0,1770,1428,-10
333930533,333930533,0,1143,1371,-10
340560857,340560849,-8,1978,7115,-10
343242603,343242605,2,540,663,-10
344666999,344667000,1,1842,1657,-10
345096858,345096860,2,1435,1415,-10
347520624,347520626,2,1520,1260,-10
348141303,348141303,0,1232,1604,-10
348202751,348202753,2,1493,1079,-10
348320141,348320143,2,1712,1810,-10
348659471,348659473,2,1707,1719,-10
353922614,353922615,1,1771,1606,-10
354503206,354503207,1,1200,1505,-10
355239499,355239501,2,1856,1665,-10
357264982,357264986,4,981,1320,-10
358524120,358524124,4,1355,1476,-10
360559190,360559200,10,1283,1087,-10
362687119,362687122,3,1522,1666,-10
363990170,363990170,0,1386,1884,-10
365854846,365854849,3,2453,1481,-10
366290249,366290254,5,1635,1089,-10
369691487,369691494,7,6720,3105,-10
369876939,369876942,3,1415,1387,-10
370750398,370750402,4,1795,1426,-10
371604842,371604848,6,3169,1531,-10
372334110,372334110,0,1184,1215,-10
373939663,373939666,3,1453,1277,-10
376422550,376422550,0,1580,1643,-10
379006127,379006130,3,1162,1082,-10
379354178,379354181,3,2147,1427,-10
382004270,382004271,1,1533,1720,-10
382572829,382572825,-4,2167,4752,-10
391126291,391126293,2,1671,1529,-10
391358143,391358154,11,1336,1173,-10
395219714,395219718,4,1887,1976,-10
397726147,397726150,3,1797,1477,-10
397780042,397780045,3,2028,1852,-10
399890419,399890401,-18,1489,1695,-10
400235037,400235037,0,1403,1217,-10
401094970,401094972,2,2184,1545,-10
401460890,401460892,2,1820,1688,-10
403001911,403001911,0,1083,1107,-10
404497630,404497630,0,1050,1393,-10
407050543,407050544,1,1692,1757,-10
410647366,410647367,1,1329,1995,-10
410689625,410689629,4,1558,1182,-10
412299680,412299683,3,1733,1546,-10
412840437,412840439,2,1550,1166,-10
412865848,412865849,1,1182,1393,-10
413891796,413891799,3,1502,1254,-10
419302722,419302722,0,883,1612,-10
420352800,420352803,3,3042,1866,-10
420969168,420969170,2,1119,1054,-10
421729863,421729864,1,1171,1624,-10
423052294,423052294,0,1567,1735,-10
427068916,427068939,23,1005,1393,-10
429408322,429408319,-3,751,952,-10
430114734,430114734,0,1478,1393,-10
435232485,435232486,1,1558,1364,-10
436276360,436276362,2,1267,1193,-10
436860666,436860667,1,1338,1311,-10
437098797,437098805,8,2295,779,-10
442570249,442570249,0,1180,1405,-10
442866469,442866471,2,1699,1486,-10
443928901,443928902,1,1280,1072,-10
444310213,444310214,1,1063,1779,-10
447074687,447074689,2,1042,1161,-10
448568413,448568416,3,1245,752,-10
449704246,449704248,2,1501,2016,-10
451395659,451395659,0,1477,1753,-10
457456041,457456043,2,1174,947,-10
462043311,462043314,3,1562,1012,-10
464413510,464413509,-1,1373,1570,-10
465106925,465106925,0,1965,1553,-10
466029331,466029332,1,1437,1736,-10
466778334,466778338,4,1736,1379,-10
476373220,476373227,7,2164,1692,-10
476830310,476830311,1,1739,1543,-10
479792850,479792854,4,1271,1566,-10
480465307,480465305,-2,1392,1279,-10
482228882,482228884,2,1780,1791,-10
482630897,482630895,-2,1840,2305,-10
483421900,483421902,2,1165,1291,-10
486106212,486106218,6,3051,1455,-10
486321526,486321528,2,1775,1994,-10
486461414,486461427,13,1978,1356,-10
486588683,486588697,14,2482,1041,-10
488059234,488059234,0,1360,1558,-10
490442577,490442578,1,1962,2210,-10
492121057,492121059,2,1615,1313,-10
493097952,493097953,1,1486,1611,-10
493518200,493518216,16,1469,980,-10
502244470,502244473,3,1767,1726,-10
505588209,505588213,4,2413,2107,-10
506769737,506769737,0,1133,1233,-10
507560967,507560969,2,1476,1714,-10
507638721,507638723,2,1865,1514,-10
508022297,508022298,1,1773,1644,-10
510530994,510530995,1,2929,2388,-10
511284717,511284719,2,1585,1565,-10
514833098,514833098,0,1438,1763,-10
515943371,515943377,6,1848,1574,-10
516720808,516720810,2,1726,1619,-10
516869567,516869570,3,1463,1529,-10
520393094,520393094,0,1381,2004,-10
526170106,526170110,4,1374,1957,-10
526871312,526871314,2,1445,1359,-10
527632866,527632869,3,2040,1981,-10
527715778,527715781,3,1934,1700,-10
527962106,527962108,2,1330,1457,-10
531208330,531208334,4,1784,1581,-10
531369378,531369377,-1,1300,1465,-10
534064937,534064941,4,1247,1297,-10
536340376,536340377,1,1398,1260,-10
538236437,538236417,-20,1262,996,-10
538828756,538828758,2,1456,1648,-10
546160877,546160877,0,1086,1479,-10
549234055,549234058,3,1264,1769,-10
550408176,550408178,2,851,803,-10
551328179,551328183,4,1923,1709,-10
551703811,551703815,4,994,819,-10
553722731,553722712,-19,1116,1306,-10
555249298,555249298,0,1374,1128,-10
556913061,556913061,0,1507,1147,-10
558166938,558166944,6,1857,1248,-10
560419309,560419311,2,1362,1547,-10
565217912,565217914,2,1834,1348,-10
566614351,566614353,2,1289,1429,-10
568705564,568705566,2,1800,1209,-10
569716422,569716421,-1,16828,12449,-10
574236431,574236433,2,1064,1263,-10
575356779,575356757,-22,2025,1836,-10
576412170,576412171,1,1629,1586,-10
577205198,577205198,0,1373,1326,-10
579118423,579118422,-1,1185,1501,-10
581050297,581050301,4,1321,1364,-10
584448377,584448379,2,1837,1893,-10
586083194,586083197,3,1789,1440,-10
588281762,588281766,4,1342,1521,-10
589037965,589037965,0,1726,1536,-10
589152604,589152605,1,977,1616,-10
591392505,591392507,2,1719,1194,-10
592576726,592576727,1,1601,1923,-10
593984631,593984633,2,1542,1959,-10
597958049,597958051,2,2175,1900,-10
604630538,604630540,2,1336,1565,-10
604842675,604842674,-1,1084,1386,-10
606819617,606819619,2,1446,1349,-10
607103505,607103507,2,1609,1473,-10
608269868,608269870,2,1489,1564,-10
608439922,608439924,2,1805,1500,-10
610747647,610747651,4,2591,1375,-10
612187865,612187866,1,1608,1313,-10
612273345,612273346,1,1718,1743,-10
613776741,613776742,1,1734,1829,-10
613811850,613811853,3,1035,1036,-10
622327108,622327111,3,1149,1165,-10
625662360,625662363,3,1974,2302,-10
626246011,626246011,0,1222,1307,-10
629730051,629730052,1,1605,1684,-10
629908002,629908018,16,1078,3271,-10
636038607,636038607,0,1635,1605,-10
636616859,636616857,-2,785,1658,-10
637000253,637000251,-2,2205,3735,-10
637076243,637076245,2,1854,1472,-10
637396160,637396160,0,1814,1538,-10
637926460,637926463,3,1702,1120,-10
640698341,640698342,1,1629,1470,-10
643938894,643938898,4,1457,1412,-10
647737754,647737755,1,1564,1588,-10
650686247,650686249,2,1816,1624,-10
651845825,651845826,1,910,1664,-10
653170343,653170341,-2,1193,2147,-10
653315575,653315577,2,1678,2089,-10
655433082,655433081,-1,1358,1594,-10
658508229,658508230,1,1038,1515,-10
662288256,662288259,3,1943,1786,-10
662826921,662826923,2,1594,2152,-10
664247297,664247297,0,1205,1709,-10
665749415,665749418,3,1490,1593,-10
671492826,671492827,1,2130,2077,-10
673009094,673009088,-6,1313,3135,-10
677856059,677856061,2,1062,1708,-10
679905714,679905717,3,2029,1654,-10
682772967,682772967,0,1481,1914,-10
682852992,682852991,-1,1214,1242,-10
683161474,683161475,1,1845,2315,-10
685537733,685537734,1,1924,1544,-10
687907907,687907909,2,1952,2093,-10
692396528,692396530,2,1707,1893,-10
692554414,692554414,0,2092,1831,-10
694303765,694303768,3,1484,1121,-10
696950529,696950526,-3,1214,2204,-10
697387755,697387758,3,1613,1682,-10
698706353,698706354,1,47534,59017,-10
698997486,698997488,2,2019,1983,-10
700530316,700530317,1,1508,1499,-10
705535368,705535373,5,1754,1496,-10
707353562,707353565,3,1604,1667,-10
710219785,710219787,2,892,1358,-10
714057946,714057947,1,1236,1395,-10
714363847,714363850,3,1407,1396,-10
716407762,716407764,2,1746,1429,-10
716599729,716599729,0,1526,1453,-10
717463514,717463516,2,1376,2222,-10
722269438,722269441,3,1982,1226,-10
725325018,725325017,-1,1601,3018,-10
728959198,728959198,0,1787,1644,-10
729351262,729351265,3,1684,1385,-10
733273698,733273698,0,1762,1237,-10
735005572,735005575,3,937,1102,-10
736312811,736312811,0,1072,1196,-10
744609110,744609112,2,1678,1592,-10
744726171,744726172,1,800,1379,-10
746929341,746929343,2,1746,1688,-10
747363074,747363075,1,2088,1676,-10
747475974,747475974,0,1219,1148,-10
750189530,750189531,1,1656,1850,-10
750830462,750830462,0,911,1219,-10
752156985,752156987,2,1668,1659,-10
753283826,753283827,1,1258,1332,-10
757171313,757171314,1,1133,1337,-10
758774275,758774277,2,1810,1437,-10
759416290,759416293,3,2007,2263,-10
760333378,760333377,-1,836,1064,-10
760578065,760578065,0,1219,1770,-10
765476393,765476381,-12,1297,1343,-10
766274152,766274147,-5,818,1234,-10
771160221,771160223,2,1132,999,-10
773045819,773045822,3,1231,1365,-10
774212513,774212514,1,1852,1164,-10
775384804,775384806,2,1145,1917,-10
777494893,777494895,2,1549,1197,-10
778612059,778612062,3,1372,1296,-10
783445746,783445748,2,1754,1473,-10
783907562,783907562,0,1847,2180,-10
788189298,788189300,2,1840,1684,-10
792104974,792104975,1,1110,1519,-10
792369917,792369918,1,1243,1393,-10
793018074,793018078,4,2308,1345,-10
794282186,794282189,3,1027,1209,-10
796143814,796143817,3,1864,1675,-10
797850703,797850702,-1,1133,1775,-10
800395782,800395786,4,1178,1392,-10
802584057,802584058,1,1301,1493,-10
804366433,804366435,2,1243,1668,-10
807916586,807916587,1,1307,1463,-10
808415350,808415352,2,1532,1719,-10
808447014,808447014,0,1687,2335,-10
810977470,810977471,1,2253,1874,-10
811566867,811566870,3,1341,1183,-10
813660524,813660546,22,1233,1224,-10
814602002,814602003,1,1661,1603,-10
818286165,818286166,1,1241,1176,-10
820865722,820865725,3,2089,1430,-10
820930741,820930742,1,1692,1738,-10
822855735,822855738,3,1812,1277,-10
825172077,825172082,5,1343,1651,-10
830020018,830020022,4,4107,2593,-10
835731886,835731888,2,1215,1182,-10
838133162,838133162,0,1179,1272,-10
838166325,838166321,-4,1026,1183,-10
839414854,839414857,3,1569,1873,-10
841084404,841084409,5,13825,7206,-10
841221803,841221805,2,2123,1184,-10
845157939,845157939,0,1699,1512,-10
850208022,850208023,1,1287,1404,-10
853333430,853333432,2,1845,2109,-10
857610655,857610657,2,1783,2138,-10
858371798,858371800,2,1415,1251,-10
860495247,860495247,0,1348,2793,-10
862578370,862578369,-1,1320,2762,-10
872649514,872649517,3,2393,1298,-10
875612965,875612968,3,1553,1842,-10
879480935,879480934,-1,1542,1275,-10
880509039,880509041,2,1427,1655,-10
887840958,887840963,5,943,449,-10
888570642,888570639,-3,1351,1824,-10
888599130,888599132,2,1103,1823,-10
893838758,893838762,4,834,726,-10
893901996,893902002,6,1105,1161,-10
894749418,894749424,6,12353,4487,-10
896605217,896605221,4,1463,1343,-10
901462862,901462865,3,1816,1338,-10
903856706,903856706,0,2096,1913,-10
904089629,904089631,2,1220,863,-10
904542184,904542183,-1,1948,1426,-10
908600363,908600367,4,1810,1609,-10
908890204,908890205,1,1559,1467,-10
908925232,908925232,0,1417,2328,-10
911578850,911578850,0,2231,2326,-10
913381917,913381918,1,1135,1221,-10
913485118,913485120,2,1122,1557,-10
914907911,914907910,-1,1593,2760,-10
915885146,915885147,1,1687,1446,-10
916096562,916096566,4,1424,1474,-10
917423960,917423962,2,2259,2651,-10
918821281,918821282,1,945,1424,-10
919645118,919645118,0,1557,1265,-10
921977179,921977180,1,1482,1083,-10
925339278,925339279,1,1639,1910,-10
926008087,926008086,-1,1181,1892,-10
926618524,926618526,2,1429,1413,-10
926804662,926804643,-19,622,446,-10
931302661,931302661,0,858,1282,-10
931452442,931452443,1,1481,1314,-10
932137721,932137722,1,1319,1106,-10
932223952,932223954,2,1350,1601,-10
934887997,934887999,2,2219,2147,-10
938291670,938291671,1,1281,2061,-10
940684805,940684800,-5,1085,4872,-10
942254454,942254454,0,1297,1574,-10
951686951,951686951,0,1053,1599,-10
955683323,955683325,2,1495,1356,-10
960220020,960220023,3,1358,1387,-10
962509674,962509676,2,1765,1581,-10
967280493,967280494,1,1208,1666,-10
968959884,968959885,1,1761,1269,-10
970579958,970579962,4,1882,1577,-10
972456143,972456145,2,1242,2221,-10
975805679,975805681,2,1614,1574,-10
978924119,978924123,4,1198,1504,-10
979561178,979561182,4,1836,1609,-10
981284603,981284607,4,1680,1557,-10
981566189,981566190,1,1765,1892,-10
984148133,984148136,3,2071,2028,-10
986181348,986181351,3,1982,1634,-10
986709206,986709206,0,1996,2549,-10
995494826,995494820,-6,1211,5385,-10
997076312,997076305,-7,879,4492,-10
1000949794,1000949797,3,1206,1050,-10
1001308745,1001308747,2,1990,1414,-10
1002380578,1002380579,1,888,1654,-10
1004299347,1004299349,2,1414,1038,-10
1012094707,1012094707,0,1049,1669,-10
1013312151,1013312154,3,1054,1458,-10
1017676806,1017676811,5,1560,1546,-10
1019373112,1019373115,3,1911,1264,-10
1020130714,1020130715,1,1596,1278,-10
1021965685,1021965685,0,1491,2741,-10
1025108778,1025108782,4,2026,1252,-10
1025134590,1025134593,3,1334,1837,-10
1025668615,1025668614,-1,1726,1004,-10
1027000967,1027000970,3,1668,1877,-10
1027094739,1027094742,3,1661,1277,-10
1028522639,1028522638,-1,1977,3667,-10
1029008802,1029008797,-5,723,4082,-10
1032011107,1032011110,3,2213,1732,-10
1032668486,1032668487,1,2178,2130,-10
1033501405,1033501408,3,1565,1238,-10
1035081868,1035081871,3,787,1465,-10
1039037121,1039037124,3,1923,1386,-10
1039511152,1039511155,3,1317,967,-10
1044048430,1044048434,4,1231,1057,-10
1047025610,1047025611,1,1671,1334,-10
1047243574,1047243575,1,1476,1220,-10
1047987125,1047987123,-2,1094,1745,-10
1049900704,1049900701,-3,974,1592,-10
1050611206,1050611209,3,1970,1414,-10
1051433957,1051433958,1,1919,1335,-10
1052341505,1052341504,-1,1532,2246,-10
1059920377,1059920382,5,1962,1436,-10
1061940641,1061940643,2,2210,2022,-10
1063069691,1063069693,2,1277,1454,-10
1063755050,1063755054,4,987,805,-10
1066307974,1066307977,3,1794,1862,-10
1067634265,1067634265,0,2598,2031,-10
1068371546,1068371548,2,1568,1615,-10
1069844942,1069844944,2,959,1104,-10
1073751262,1073751258,-4,1084,1481,-10
1077794734,1077794733,-1,1314,1815,-10
1077863685,1077863687,2,1273,1301,-10
1086439086,1086439087,1,967,1290,-10
1087506262,1087506259,-3,1068,1793,-10
1089553230,1089553232,2,2355,1972,-10
1090653722,1090653729,7,869,1089,-10
1092129329,1092129331,2,1587,1339,-10
1095202294,1095202298,4,3028,1677,-10
1095322502,1095322506,4,2308,1752,-10
1095387234,1095387242,8,2189,879,-10
1095706048,1095706048,0,1639,1660,-10
1097706244,1097706246,2,1981,1909,-10
1097769360,1097769361,1,1751,1463,-10
1099450764,1099450766,2,1844,1930,-10
1105263520,1105263521,1,1644,1575,-10
1106758775,1106758775,0,1804,1273,-10
1108087526,1108087528,2,1552,1736,-10
1110178424,1110178423,-1,1215,1940,-10
1112974099,1112974101,2,880,1290,-10
1113045252,1113045258,6,1969,1046,-10
1114362323,1114362324,1,1043,1395,-10
1116518286,1116518303,17,1320,1424,-10
1119253819,1119253799,-20,1763,1418,-10
1119527950,1119527953,3,2049,1179,-10
1119582567,1119582569,2,1744,1785,-10
1120285766,1120285771,5,1903,1388,-10
1120484865,1120484866,1,1228,1252,-10
1121475303,1121475303,0,1950,1411,-10
1122117004,1122117006,2,1648,1631,-10
1126352900,1126352903,3,1201,1703,-10
1128716669,1128716671,2,928,902,-10
1131176359,1131176358,-1,1612,1756,-10
1132193589,1132193591,2,2237,2650,-10
1139369972,1139369971,-1,1532,1642,-10
1139831482,1139831484,2,1376,1237,-10
1145764997,1145764999,2,1912,1617,-10
1149873970,1149873972,2,922,1285,-10
1152853045,1152853046,1,1391,1399,-10
1156050522,1156050522,0,887,935,-10
1156869384,1156869386,2,1273,1702,-10
1157555954,1157555957,3,947,924,-10
1158502107,1158502106,-1,1308,1789,-10
1161646849,1161646850,1,1319,1462,-10
1162127317,1162127313,-4,1491,4942,-10
1163875821,1163875822,1,2168,2100,-10
1163974561,1163974563,2,1984,1472,-10
1165036292,1165036294,2,1321,1348,-10
1167493346,1167493350,4,2528,2281,-10
1171262553,1171262554,1,1583,1880,-10
1172675117,1172675117,0,1493,1800,-10
1173718790,1173718791,1,1533,1301,-10
1175481890,1175481891,1,1686,1389,-10
1177457886,1177457888,2,1448,1696,-10
1178949582,1178949585,3,2129,1825,-10
1180163962,1180163965,3,1502,1485,-10
1181619212,1181619213,1,1430,1188,-10
1182318884,1182318887,3,1775,1175,-10
1184328083,1184328085,2,1362,2062,-10
1184464554,1184464557,3,1103,1458,-10
1187581233,1187581233,0,999,1222,-10
1187677306,1187677305,-1,1453,1553,-10
1193113339,1193113340,1,1101,1147,-10
1194573591,1194573593,2,1848,1466,-10
1195389259,1195389262,3,1809,1384,-10
1195632838,1195632839,1,1615,2262,-10
1197403598,1197403599,1,1584,1318,-10
1202320254,1202320250,-4,1030,1893,-10
1204977748,1204977750,2,1447,1706,-10
1209973222,1209973237,15,1918,1627,-10
1213776853,1213776845,-8,7483,16105,-10
1215764061,1215764063,2,1202,1651,-10
1218180220,1218180226,6,2222,1282,-10
1219250394,1219250395,1,1390,2275,-10
1220947673,1220947674,1,1709,1291,-10
1223750456,1223750448,-8,1058,5429,-10
1223965043,1223965037,-6,241,1225,-10
1224467380,1224467387,7,9145,2488,-10
1225711122,1225711116,-6,1508,5176,-10
1227232358,1227232362,4,1145,1385,-10
1234411780,1234411781,1,1388,1351,-10
1235411514,1235411521,7,4222,1663,-10
1243557811,1243557814,3,1659,1704,-10
1244736541,1244736543,2,2023,1982,-10
1248961455,1248961458,3,1813,1470,-10
1249435525,1249435527,2,1878,1668,-10
1252303329,1252303330,1,883,1142,-10
1253924380,1253924382,2,1482,1549,-10
1260194622,1260194626,4,1317,1414,-10
1260517138,1260517139,1,1923,1743,-10
1262513147,1262513146,-1,2064,1540,-10
1263312342,1263312344,2,1902,1457,-10
1264512550,1264512553,3,1719,1122,-10
1265269768,1265269769,1,1695,1765,-10
1266747600,1266747600,0,1201,1492,-10
1267689487,1267689490,3,1797,1893,-10
1268020037,1268020039,2,1010,1036,-10
1275819860,1275819861,1,1812,1790,-10
1276287821,1276287820,-1,1282,2407,-10
1280331794,1280331796,2,1615,1636,-10
1281331335,1281331339,4,1982,1981,-10
1282139706,1282139710,4,2186,2003,-10
1282190990,1282190991,1,1692,1404,-10
1283997130,1283997130,0,1335,1137,-10
1284368502,1284368505,3,1398,1195,-10
1284786041,1284786044,3,1965,1651,-10
1286999263,1286999275,12,1313,1262,-10
1292443083,1292443085,2,1932,1230,-10
1292926662,1292926669,7,5413,1190,-10
1294430272,1294430278,6,1493,1254,-10
1296727659,1296727662,3,1130,1362,-10
1297645065,1297645067,2,1759,1626,-10
1297967217,1297967218,1,995,860,-10
1298003000,1298002991,-9,1345,1561,-10
1300006639,1300006642,3,1866,1270,-10
1304118340,1304118344,4,2561,1564,-10
1305958054,1305958055,1,1261,1648,-10
1306182173,1306182176,3,2385,2242,-10
1308503413,1308503414,1,1360,1535,-10
1310345074,1310345075,1,1570,2128,-10
1313584339,1313584341,2,833,1087,-10
1317023733,1317023734,1,1447,1328,-10
1318120129,1318120132,3,1207,1580,-10
1319919186,1319919188,2,2029,2471,-10
1320368795,1320368798,3,2028,1576,-10
1323370214,1323370214,0,1447,1634,-10
1325400818,1325400821,3,2085,1837,-10
1327627115,1327627122,7,2301,711,-10
1329650962,1329650963,1,2079,1601,-10
1331022060,1331022070,10,150,1090,-10
1335354871,1335354875,4,1998,1514,-10
1336145616,1336145614,-2,1433,1346,-10
1342075574,1342075575,1,1743,1178,-10
1342351040,1342351042,2,1365,1532,-10
1343209209,1343209229,20,543,1409,-10
1343414738,1343414738,0,1315,1349,-10
1346842072,1346842078,6,3067,1456,-10
1347115507,1347115510,3,1352,1669,-10
1347259095,1347259102,7,2541,1120,-10
1349228365,1349228367,2,1497,1489,-10
1353471078,1353471078,0,1905,1818,-10
1356435804,1356435805,1,1605,1748,-10
1357543810,1357543816,6,2644,1120,-10
1363759913,1363759932,19,15495,43433,-10
1365788410,1365788411,1,1516,1308,-10
1367284257,1367284258,1,1013,999,-10
1368209858,1368209858,0,666,1116,-10
1370586829,1370586827,-2,813,1606,-10
1371859110,1371859111,1,880,958,-10
1375011697,1375011701,4,1705,1462,-10
1381601970,1381601973,3,1139,1385,-10
1383258459,1383258457,-2,1827,2178,-10
1387278987,1387278988,1,1096,1771,-10
1388191686,1388191681,-5,1349,4051,-10
1389371485,1389371487,2,2046,1603,-10
1389613622,1389613623,1,1625,1516,-10
1390450644,1390450645,1,1386,1273,-10
1392631918,1392631920,2,1550,1481,-10
1393592118,1393592119,1,2486,1911,-10
1394190081,1394190082,1,1092,1348,-10
1394546883,1394546886,3,1106,1043,-10
1395310153,1395310153,0,1730,1833,-10
1399868930,1399868932,2,1359,1485,-10
1403653437,1403653438,1,1442,1237,-10
1405503586,1405503589,3,1178,1761,-10
1413683146,1413683152,6,1837,1399,-10
1415920676,1415920678,2,1551,1980,-10
1416336210,1416336211,1,1760,1537,-10
1416694985,1416694986,1,1456,1353,-10
1418930086,1418930089,3,1881,1721,-10
1422891585,1422891586,1,1402,1232,-10
1423004174,1423004175,1,1360,1265,-10
1423072230,1423072234,4,1431,1462,-10
1423355078,1423355078,0,1336,1264,-10
1424078818,1424078821,3,2388,1629,-10
1424628882,1424628881,-1,805,1032,-10
1425438446,1425438447,1,1324,1494,-10
1426653375,1426653376,1,956,1218,-10
1427490298,1427490300,2,1335,1288,-10
1427550931,1427550932,1,1377,2022,-10
1427838566,1427838567,1,1880,1831,-10
1429664493,1429664494,1,2128,1960,-10
1430868593,1430868597,4,1664,1511,-10
1434980272,1434980275,3,1479,1355,-10
1436793582,1436793583,1,1956,1596,-10
1437235629,1437235631,2,1566,1588,-10
1447971074,1447971074,0,1586,1239,-10
1449335654,1449335658,4,2369,1750,-10
1451339131,1451339134,3,1907,1636,-10
1453898939,1453898938,-1,1091,1336,-10
1454351225,1454351228,3,2025,1529,-10
1455021694,1455021698,4,1830,1390,-10
1457358427,1457358429,2,1083,1726,-10
1457406734,1457406736,2,1052,1286,-10
1458197410,1458197414,4,1663,1810,-10
1458239682,1458239685,3,1904,1701,-10
1459932190,1459932191,1,2141,2142,-10
1465569971,1465569974,3,1410,1522,-10
1469959165,1469959166,1,1473,1204,-10
1471130966,1471130969,3,14166,10070,-10
1471269382,1471269384,2,1918,1535,-10
1474048650,1474048653,3,1664,1648,-10
1476283917,1476283919,2,1143,1486,-10
1478043458,1478043461,3,1747,1930,-10
1480183624,1480183626,2,1441,1365,-10
1487549374,1487549373,-1,1572,1990,-10
1492269025,1492269026,1,1514,1348,-10
1493506924,1493506927,3,1859,1228,-10
1497495018,1497495039,21,387,533,-10
1497671413,1497671414,1,1684,1948,-10
1500373762,1500373762,0,1588,1664,-10
1500510569,1500510570,1,1417,1641,-10
1503734508,1503734510,2,1159,1636,-10
1505531645,1505531646,1,1732,1362,-10
1506926400,1506926393,-7,1461,6034,-10
1507648855,1507648858,3,1836,1525,-10
1507802452,1507802452,0,1839,1959,-10
1509559904,1509559906,2,1751,1411,-10
1514372960,1514372962,2,1620,1510,-10
1515034298,1515034299,1,1160,943,-10
1517006721,1517006717,-4,1403,2507,-10
1522030788,1522030792,4,2064,2007,-10
1526451457,1526451457,0,1882,2280,-10
1527593777,1527593793,16,2035,1625,-10
1529267553,1529267554,1,1456,1687,-10
1529833819,1529833821,2,2289,1560,-10
1531928141,1531928142,1,1133,1464,-10
1532156209,1532156213,4,2242,1792,-10
1533303944,1533303948,4,1351,957,-10
1534144598,1534144601,3,1469,1562,-10
1534954638,1534954641,3,1767,1409,-10
1537564209,1537564211,2,1419,1204,-10
1539526513,1539526510,-3,1220,1305,-10
1540296545,1540296547,2,1239,1438,-10
1542241394,1542241395,1,1700,2012,-10
1544968333,1544968332,-1,1771,1224,-10
1545128731,1545128734,3,1573,2193,-10
1545827948,1545827947,-1,1865,2316,-10
1546489682,1546489686,4,1463,1779,-10
1547025467,1547025468,1,1359,1401,-10
1547104723,1547104724,1,997,1252,-10
1549178733,1549178735,2,1142,1276,-10
1550299821,1550299820,-1,1525,2122,-10
1553705306,1553705305,-1,1390,1085,-10
1554155387,1554155392,5,1898,1613,-10
1558547985,1558547987,2,1733,1490,-10
1558947520,1558947521,1,1850,1901,-10
1559548546,1559548550,4,2507,2174,-10
1561589047,1561589051,4,1992,2043,-10
1562596467,1562596456,-11,24463,16481,-10
1566250843,1566250847,4,1465,1619,-10
1570178710,1570178711,1,1301,2138,-10
1570636745,1570636751,6,2903,1964,-10
1571127122,1571127122,0,1358,1730,-10
1584622341,1584622346,5,1903,1567,-10
1584829741,1584829736,-5,1965,7249,-10
1585108375,1585108374,-1,1270,1964,-10
1585460829,1585460825,-4,776,1900,-10
1592678824,1592678823,-1,1579,1328,-10
1594700347,1594700348,1,1190,1531,-10
1595320195,1595320196,1,1373,1674,-10
1597467795,1597467794,-1,1620,1854,-10
1597819383,1597819386,3,1738,1114,-10
1598092514,1598092529,15,1465,1618,-10
1598780403,1598780405,2,1030,1980,-10
1599166207,1599166210,3,1860,1922,-10
1599573470,1599573471,1,1200,1683,-10
1599618144,1599618145,1,1132,1519,-10
1600586416,1600586420,4,1761,1203,-10
1602727890,1602727894,4,1838,897,-10
1603546061,1603546063,2,1919,1260,-10
1604759569,1604759576,7,16932,19615,-10
1607830661,1607830665,4,1567,1407,-10
1608091931,1608091934,3,1151,1168,-10
1608544910,1608544918,8,2931,1363,-10
1609422743,1609422749,6,1224,1086,-10
1613949159,1613949163,4,1414,1404,-10
1615851481,1615851481,0,885,1187,-10
1617103598,1617103600,2,1543,1552,-10
1619162960,1619162976,16,1384,1294,-10
1619624658,1619624661,3,1681,1538,-10
1621622641,1621622642,1,1019,1138,-10
1622953149,1622953149,0,1622,2010,-10
1627379582,1627379583,1,1803,1118,-10
1628315713,1628315715,2,1833,1547,-10
1631731525,1631731526,1,2048,1145,-10
1631769603,1631769605,2,1976,1560,-10
1632589324,1632589325,1,1447,1244,-10
1635529450,1635529451,1,1788,1749,-10
1644669611,1644669614,3,1909,1576,-10
1648404506,1648404508,2,1825,1143,-10
1651397169,1651397169,0,1876,1978,-10
1653282419,1653282421,2,1140,997,-10
1655432810,1655432810,0,1313,1511,-10
1657634114,1657634117,3,1907,2020,-10
1658105717,1658105718,1,2126,1565,-10
1658792040,1658792040,0,1660,1305,-10
1663374443,1663374443,0,1295,1591,-10
1663625174,1663625178,4,2088,1782,-10
1663773917,1663773918,1,2110,2176,-10
1667964473,1667964478,5,3252,2003,-10
1670067283,1670067285,2,1455,1654,-10
1670207322,1670207322,0,1412,2113,-10
1670469521,1670469522,1,2029,1150,-10
1672233750,1672233753,3,1366,1245,-10
1673195744,1673195749,5,2229,1519,-10
1675206464,1675206450,-14,1128,1280,-10
1679553192,1679553188,-4,2262,4991,-10
1680889378,1680889379,1,1796,1457,-10
1682449926,1682449926,0,1693,1983,-10
1684222804,1684222807,3,38428,20870,-10
1688864033,1688864035,2,1680,2218,-10
1691945482,1691945484,2,1117,1137,-10
1692944746,1692944750,4,1766,1132,-10
1697128113,1697128117,4,1686,1592,-10
1698125023,1698125024,1,1984,1435,-10
1698956241,1698956243,2,1732,2154,-10
1699826006,1699826006,0,1318,1106,-10
1701173265,1701173267,2,1222,1110,-10
1703872735,1703872730,-5,1191,4148,-10
1704078489,1704078491,2,1196,1094,-10
1704545680,1704545682,2,1988,1538,-10
1707303053,1707303055,2,1263,1543,-10
1707798239,1707798240,1,1767,1506,-10
1717079668,1717079670,2,1109,1267,-10
1717605201,1717605202,1,1905,1399,-10
1718671082,1718671087,5,2626,1980,-10
1722328234,1722328238,4,1486,1342,-10
1724363609,1724363610,1,2147,1615,-10
1730591842,1730591842,0,1612,1432,-10
1730938879,1730938881,2,1192,1112,-10
1733110575,1733110574,-1,979,1661,-10
1733629451,1733629452,1,1142,1436,-10
1734532802,1734532804,2,1401,1339,-10
1736650053,1736650054,1,1428,1272,-10
1736784683,1736784665,-18,2094,1779,-10
1739033006,1739033010,4,1476,1169,-10
1739903607,1739903609,2,1283,1445,-10
1740385125,1740385126,1,1304,1580,-10
1740753136,1740753138,2,970,1127,-10
1741067410,1741067414,4,1937,1550,-10
1742319994,1742319991,-3,1478,2964,-10
1745761402,1745761402,0,1259,1430,-10
1746104647,1746104645,-2,1513,1901,-10
1746357181,1746357185,4,1645,1468,-10
1749366839,1749366841,2,1933,2895,-10
1754131482,1754131485,3,1920,1922,-10
1756230347,1756230349,2,1572,1608,-10
1761487664,1761487667,3,1711,1769,-10
1762644908,1762644911,3,1907,1954,-10
1763643322,1763643326,4,1588,1328,-10
1765172449,1765172451,2,1866,2196,-10
1769853504,1769853507,3,1229,1462,-10
1774685831,1774685833,2,1568,1712,-10
1782173754,1782173758,4,2171,1567,-10
1782646324,1782646326,2,1554,1756,-10
1783116290,1783116291,1,1796,1194,-10
1783762611,1783762613,2,1829,1368,-10
1789458431,1789458434,3,1623,1684,-10
1791638046,1791638047,1,1757,2107,-10
1791965417,1791965412,-5,48150,31322,-10
1792849811,1792849811,0,2181,1435,-10
1794269327,1794269323,-4,1347,4040,-10
1795947794,1795947800,6,1704,1704,-10
1799184277,1799184279,2,1834,1700,-10
1802083619,1802083620,1,1943,1630,-10
1802804037,1802804036,-1,1467,1174,-10
1803252379,1803252382,3,1551,2021,-10
1803459962,1803459961,-1,1045,1452,-10
1805692027,1805692026,-1,1216,1204,-10
1807694675,1807694674,-1,810,1192,-10
1809260019,1809260022,3,1738,1510,-10
1809459033,1809459037,4,2561,1495,-10
1812128973,1812128976,3,1471,1654,-10
1814278402,1814278409,7,11973,3622,-10
1814427751,1814427745,-6,1292,1459,-10
1815899431,1815899432,1,638,1199,-10
1817465057,1817465063,6,3629,1594,-10
1822195265,1822195266,1,1226,1778,-10
1823188610,1823188611,1,1252,1332,-10
1825352194,1825352194,0,1784,1469,-10
1830719173,1830719178,5,2875,2040,-10
1831536203,1831536202,-1,1617,1557,-10
1832504774,1832504774,0,1483,1373,-10
1833473940,1833473942,2,4474,21217,-10
1833885970,1833885970,0,1177,1633,-10
1836304835,1836304842,7,3586,2402,-10
1842475793,1842475815,22,1173,1061,-10
1844660413,1844660415,2,648,799,-10
1846193508,1846193509,1,1533,1535,-10
1846663995,1846664001,6,1934,636,-10
1851344746,1851344747,1,1737,1554,-10
1858248075,1858248078,3,1591,1579,-10
1859464979,1859464982,3,1179,1089,-10
1860397727,1860397728,1,1540,1107,-10
1864128843,1864128846,3,1286,938,-10
1866877980,1866877982,2,688,1107,-10
1867454231,1867454234,3,1603,842,-10
1869919055,1869919061,6,4749,2148,-10
1873017122,1873017125,3,945,1167,-10
1874983428,1874983430,2,1479,1436,-10
1876380273,1876380273,0,1703,1478,-10
1878751645,1878751647,2,1083,1426,-10
1881276550,1881276553,3,1163,1711,-10
1887224702,1887224705,3,1742,1339,-10
1897056598,1897056599,1,1334,1631,-10
1897480716,1897480719,3,1874,1228,-10
1898062086,1898062088,2,1247,1433,-10
1899682137,1899682139,2,1343,1282,-10
1901979634,1901979634,0,1774,1312,-10
1902029238,1902029239,1,1585,2105,-10
1904730031,1904730033,2,1750,1279,-10
1906635400,1906635386,-14,1234,946,-10
1906754991,1906754994,3,1708,1350,-10
1912151750,1912151753,3,1840,2358,-10
1914673935,1914673934,-1,1346,1358,-10
1917257295,1917257297,2,1634,1384,-10
1917847758,1917847760,2,1867,2305,-10
1921666324,1921666326,2,968,1026,-10
1921908979,1921908982,3,1200,1498,-10
1923007924,1923007926,2,1689,1703,-10
1924638215,1924638214,-1,1511,1779,-10
1928446637,1928446640,3,1764,1754,-10
1928775834,1928775838,4,1842,1864,-10
1930684874,1930684874,0,1143,1952,-10
1932256970,1932256972,2,1334,1500,-10
1932577512,1932577514,2,1809,1872,-10
1933269804,1933269804,0,1657,1989,-10
1934967429,1934967428,-1,32118,55776,-10
1936193499,1936193503,4,1194,1228,-10
1936543963,1936543965,2,1332,1819,-10
1941535643,1941535646,3,1679,1506,-10
1942227998,1942228000,2,921,1347,-10
1942570853,1942570853,0,1464,1653,-10
1946631827,1946631837,10,2081,730,-10
1947838649,1947838651,2,957,850,-10
1956602905,1956602910,5,1934,760,-10
1959883607,1959883609,2,1248,1468,-10
1960995918,1960995917,-1,1166,2575,-10
1962538435,1962538437,2,932,1179,-10
1970638387,1970638389,2,1684,1744,-10
1970874532,1970874534,2,1946,2344,-10
1974587858,1974587858,0,1558,2086,-10
1977174960,1977174963,3,1649,1644,-10
1979630557,1979630562,5,3670,2101,-10
1981276489,1981276490,1,2186,1815,-10
1981440157,1981440160,3,1756,1729,-10
1981875454,1981875454,0,1573,1351,-10
1984962470,1984962471,1,1092,1906,-10
1985669265,1985669267,2,2165,1879,-10
1986859871,1986859873,2,1509,2384,-10
1988286668,1988286667,-1,1207,1161,-10
1990179656,1990179658,2,1904,1557,-10
1990286730,1990286730,0,1194,1234,-10
1997114566,1997114567,1,1261,1065,-10
2001696463,2001696465,2,1557,1589,-10
2002490769,2002490770,1,1405,1029,-10
2005201498,2005201499,1,1067,1230,-10
2007898519,2007898522,3,1441,1672,-10
2012024942,2012024944,2,1739,1527,-10
2013205273,2013205275,2,1752,1168,-10
2014867534,2014867535,1,1764,1965,-10
2015844220,2015844221,1,1175,1351,-10
2016321190,2016321192,2,1635,2135,-10
2024390533,2024390533,0,1285,1624,-10
2028063799,2028063803,4,1705,1335,-10
2028261651,2028261653,2,2165,1413,-10
2028920064,2028920065,1,1864,1312,-10
2033661130,2033661131,1,1363,1430,-10
2035152462,2035152463,1,729,470,-10
2038979245,2038979247,2,1443,851,-10
2041698474,2041698477,3,1565,1352,-10
2042422446,2042422450,4,996,929,-10
2045054422,2045054423,1,1681,1096,-10
2052105941,2052105946,5,1325,1419,-10
2052684909,2052684909,0,1538,2046,-10
2055093468,2055093470,2,1296,1286,-10
2057193162,2057193165,3,1364,1592,-10
2058360288,2058360298,10,2085,1145,-10
2058995663,2058995665,2,1668,1871,-10
2059252207,2059252209,2,1584,1490,-10
2061026690,2061026693,3,1690,1631,-10
2061621548,2061621550,2,1659,1204,-10
2062560064,2062560066,2,1864,1645,-10
2063069546,2063069546,0,1191,1271,-10
2067892784,2067892787,3,1303,1019,-10
2071266047,2071266051,4,1042,862,-10
2071868671,2071868673,2,1095,1022,-10
2074483876,2074483883,7,3784,1288,-10
2074562607,2074562625,18,3213,1352,-10
2076012286,2076012289,3,2020,1967,-10
2076468518,2076468521,3,1835,1594,-10
2077147265,2077147267,2,1528,1288,-10
2079583859,2079583862,3,1746,1907,-10
2080301458,2080301459,1,1544,1440,-10
2084277411,2084277414,3,1386,1292,-10
2084905714,2084905718,4,2522,1563,-10
2088184863,2088184865,2,1241,1819,-10
2088889077,2088889079,2,1502,1209,-10
2092137541,2092137542,1,1017,1055,-10
2092279935,2092279936,1,1078,1608,-10
2093604776,2093604778,2,1826,1601,-10
2094154879,2094154881,2,1791,1722,-10
2098584082,2098584085,3,3017,1882,-10
2099424671,2099424666,-5,1035,3251,-10
2103926037,2103926039,2,919,1008,-10
2107845386,2107845386,0,1583,1459,-10
2111257974,2111257974,0,860,1727,-10
2112239955,2112239958,3,1554,1546,-10
2117054133,2117054135,2,1320,1132,-10
2117553026,2117553029,3,1031,1262,-10
2122029892,2122029894,2,1512,1316,-10
2123213119,2123213122,3,1916,1283,-10
2128114408,2128114406,-2,1150,1983,-10
2129599185,2129599185,0,870,947,-10
2132475459,2132475460,1,1122,1557,-10
2133441993,2133441995,2,1947,1595,-10
2134802297,2134802294,-3,935,1588,-10
2139053154,2139053157,3,1582,1495,-10
2141714929,2141714929,0,1322,1352,-10
2144097631,2144097635,4,1379,1625,-10
2144619082,2144619086,4,1368,1338,-10
2155320323,2155320326,3,1499,1103,-10
2159279930,2159279931,1,2244,1424,-10
2160504034,2160504038,4,1078,1392,-10
2160709762,2160709762,0,1391,1556,-10
2162754254,2162754257,3,1763,2185,-10
2163072205,2163072206,1,43869,4249,-10
2163199612,2163199611,-1,1307,2386,-10
2166333545,2166333545,0,1977,1497,-10
2168221108,2168221112,4,1330,1467,-10
2171438009,2171438003,-6,1287,2755,-10
2172383654,2172383661,7,1678,1175,-10
2172693313,2172693312,-1,1466,898,-10
2172794811,2172794813,2,2057,1530,-10
2173010466,2173010468,2,1729,1687,-10
2174952156,2174952158,2,1698,1378,-10
2175825625,2175825643,18,29,1895,-10
2178975541,2178975542,1,1032,1164,-10
2179973381,2179973386,5,1974,1964,-10
2180881826,2180881827,1,1900,1894,-10
2181686011,2181686015,4,2291,1248,-10
2185139340,2185139341,1,911,1516,-10
2190310563,2190310566,3,1507,1577,-10
2190595697,2190595698,1,2000,2638,-10
2191153054,2191153055,1,1742,1803,-10
2191350590,2191350595,5,2539,1331,-10
2191625658,2191625657,-1,1455,2290,-10
2192183502,2192183507,5,1286,1316,-10
2192285511,2192285513,2,2174,1896,-10
2194205310,2194205312,2,1533,1787,-10
2195175994,2195175997,3,1502,1666,-10
2197308431,2197308430,-1,1621,1690,-10
2197517482,2197517483,1,1141,959,-10
2197909392,2197909394,2,1503,1221,-10
2198354755,2198354758,3,1586,1600,-10
2198761925,2198761927,2,1057,1141,-10
2202418101,2202418101,0,1363,1758,-10
2203315195,2203315197,2,1637,1881,-10
2209063521,2209063523,2,1681,2146,-10
2215612509,2215612515,6,2137,1053,-10
2220344361,2220344361,0,1793,1576,-10
2223094697,2223094698,1,1529,841,-10
2223461282,2223461286,4,1792,1413,-10
2225035306,2225035308,2,1450,1420,-10
2228234259,2228234261,2,1361,1600,-10
2229445602,2229445603,1,1123,1573,-10
2229679700,2229679702,2,1204,1902,-10
2230465403,2230465405,2,1767,1863,-10
2231010788,2231010787,-1,1093,1135,-10
2231314751,2231314754,3,846,1219,-10
2231912274,2231912281,7,7216,3301,-10
2233855215,2233855217,2,1291,1797,-10
2234894240,2234894234,-6,31754,14458,-10
2235593212,2235593213,1,1366,1759,-10
2235913333,2235913333,0,1554,1849,-10
2242658574,2242658575,1,1183,863,-10
2243660951,2243660951,0,1726,1499,-10
2245110915,2245110918,3,1969,2048,-10
2247655604,2247655607,3,1104,1540,-10
2248022257,2248022257,0,1716,1597,-10
2249527739,2249527734,-5,992,4714,-10
2250906549,2250906550,1,1625,2162,-10
2251002346,2251002351,5,1335,1154,-10
2256081378,2256081378,0,1658,2027,-10
2256136610,2256136612,2,1398,1550,-10
2258942617,2258942597,-20,1105,1021,-10
2261429241,2261429242,1,1557,1297,-10
2264002411,2264002414,3,1717,1794,-10
2265599361,2265599363,2,1412,1475,-10
2268267949,2268267952,3,1697,1786,-10
2269123671,2269123674,3,1744,1802,-10
2269923870,2269923881,11,1128,1006,-10
2270262646,2270262646,0,726,1353,-10
2272749880,2272749882,2,2099,2023,-10
2273796156,2273796158,2,1620,2064,-10
2275443545,2275443548,3,1611,1515,-10
2277157878,2277157879,1,876,1441,-10
2278723165,2278723167,2,1512,1408,-10
2282240629,2282240629,0,1032,1420,-10
2282650744,2282650746,2,3980,4096,-10
2293272005,2293272006,1,1946,1360,-10
2293862575,2293862578,3,1438,1365,-10
2295729967,2295729970,3,1600,1914,-10
2299467774,2299467777,3,1953,2088,-10
2300347660,2300347662,2,1640,1790,-10
2300599008,2300599010,2,1938,1591,-10
2301993001,2301993004,3,2039,2033,-10
2306200597,2306200598,1,2130,1904,-10
2307925397,2307925398,1,1609,1371,-10
2308019240,2308019249,9,17313,18405,-10
2310723074,2310723076,2,1030,1551,-10
2313343906,2313343908,2,1684,1625,-10
2315785318,2315785321,3,1626,1608,-10
2319944590,2319944592,2,1574,1437,-10
2319996110,2319996113,3,1185,1291,-10
2320546476,2320546478,2,2053,2241,-10
2320894474,2320894474,0,1408,1513,-10
2330595971,2330595973,2,2001,1950,-10
2331629759,2331629754,-5,832,2489,-10
2333185669,2333185671,2,1616,1427,-10
2335780297,2335780296,-1,1449,1780,-10
2335850648,2335850649,1,1582,1695,-10
2337638106,2337638111,5,1713,1650,-10
2339375831,2339375832,1,2227,2245,-10
2339909607,2339909609,2,1496,1459,-10
2340218475,2340218476,1,2567,1980,-10
2341324699,2341324702,3,1921,2011,-10
2348253986,2348253988,2,1358,1717,-10
2349101193,2349101195,2,1713,1566,-10
2350816622,2350816626,4,1819,1637,-10
2351321348,2351321352,4,1109,1141,-10
2352264061,2352264063,2,1284,1737,-10
2356113462,2356113465,3,1403,1514,-10
2356912621,2356912626,5,2060,1683,-10
2358511758,2358511759,1,1936,1614,-10
2360099391,2360099393,2,1696,1815,-10
2370003377,2370003378,1,1643,1380,-10
2370694916,2370694917,1,1433,2111,-10
2372657588,2372657590,2,1421,1362,-10
2374348655,2374348658,3,1146,962,-10
2375141174,2375141177,3,1309,1672,-10
2377013314,2377013317,3,1654,2014,-10
2377477409,2377477413,4,1452,1321,-10
2377635290,2377635291,1,1221,2042,-10
2387638994,2387639007,13,1877,1113,-10
2390186474,2390186469,-5,1696,3949,-10
2390670338,2390670339,1,1222,2018,-10
2390904893,2390904898,5,3342,1569,-10
2393545601,2393545603,2,1688,1169,-10
2396546386,2396546386,0,1424,1163,-10
2397426402,2397426404,2,2313,2196,-10
2399070316,2399070316,0,1549,2013,-10
2399335198,2399335198,0,912,1129,-10
2401227886,2401227887,1,1315,1662,-10
2401397094,2401397098,4,1298,1515,-10
2401620612,2401620615,3,1423,1244,-10
2406325954,2406325954,0,1686,1285,-10
2407214759,2407214762,3,1248,1005,-10
2408469686,2408469688,2,1511,1283,-10
2409944118,2409944118,0,1075,2272,-10
2410001155,2410001155,0,1688,1229,-10
2410779415,2410779415,0,1282,1270,-10
2413911797,2413911798,1,1780,1449,-10
2414812377,2414812380,3,1458,1413,-10
2416360893,2416360898,5,5098,2527,-10
2416606533,2416606535,2,1561,1102,-10
2417894909,2417894909,0,1971,2302,-10
2417985850,2417985855,5,1935,1340,-10
2418086435,2418086435,0,1410,1514,-10
2420546790,2420546791,1,1660,1755,-10
2422187763,2422187763,0,1030,1382,-10
2423067329,2423067330,1,1814,1432,-10
2423983623,2423983622,-1,1853,2355,-10
2424332989,2424332991,2,1668,1360,-10
2425002599,2425002602,3,1935,1601,-10
2430887430,2430887430,0,1559,1389,-10
2434721032,2434721042,10,14277,26992,-10
2440368363,2440368364,1,1985,1771,-10
2441992495,2441992495,0,1636,1075,-10
2442311290,2442311291,1,2162,1268,-10
2443470216,2443470217,1,1868,2218,-10
2445255739,2445255741,2,1315,1564,-10
2446388193,2446388193,0,1034,1126,-10
2448512832,2448512833,1,1981,2641,-10
2449772997,2449772997,0,1182,1511,-10
2450879775,2450879778,3,1160,778,-10
2451786230,2451786231,1,1501,1334,-10
2452285341,2452285343,2,1439,1375,-10
2452957318,2452957318,0,1603,1269,-10
2453452263,2453452240,-23,2125,1547,-10
2457126126,2457126129,3,1737,1645,-10
2460752278,2460752278,0,1734,1925,-10
2463263275,2463263278,3,1322,1298,-10
2463739762,2463739763,1,1794,2285,-10
2464890454,2464890455,1,970,868,-10
2468313363,2468313366,3,987,1172,-10
2469124071,2469124073,2,1063,1297,-10
2472840638,2472840641,3,1705,1551,-10
2475747518,2475747522,4,2483,1865,-10
2476987510,2476987509,-1,3266,4305,-10
2478684159,2478684159,0,743,1243,-10
2482305798,2482305798,0,1207,1521,-10
2487326836,2487326838,2,1608,1902,-10
2488868918,2488868918,0,1113,1576,-10
2489014424,2489014421,-3,1603,1482,-10
2490950898,2490950906,8,2516,1103,-10
2493228922,2493228922,0,1148,1166,-10
2494462885,2494462870,-15,950,990,-10
2498615230,2498615231,1,1361,1141,-10
2499189984,2499189986,2,972,800,-10
2500737661,2500737661,0,1946,1977,-10
2502714474,2502714476,2,1808,1670,-10
2503417222,2503417223,1,1121,978,-10
2503781962,2503781963,1,1898,1515,-10
2504824697,2504824698,1,1646,1586,-10
2505787294,2505787298,4,3220,1571,-10
2508210118,2508210119,1,1268,1476,-10
2508771466,2508771468,2,1927,2052,-10
2512905967,2512905970,3,1114,1382,-10
2515805719,2515805720,1,1359,1104,-10
2517421716,2517421723,7,6448,1967,-10
2523529850,2523529852,2,1245,1962,-10
2528072306,2528072307,1,1502,1901,-10
2528851193,2528851191,-2,1170,1114,-10
2529381277,2529381278,1,1757,1998,-10
2534666782,2534666782,0,1515,2337,-10
2534706407,2534706409,2,1875,1578,-10
2537199479,2537199481,2,1476,1392,-10
2539111568,2539111572,4,1402,1464,-10
2539663739,2539663742,3,2459,1293,-10
2547057492,2547057494,2,1464,1381,-10
2547869482,2547869485,3,1862,1529,-10
2551316846,2551316846,0,2309,2039,-10
2552390421,2552390423,2,1334,1689,-10
2552552014,2552552016,2,1417,2271,-10
2555783745,2555783750,5,64779,90505,-10
2556028855,2556028856,1,1877,1539,-10
2558854314,2558854319,5,3277,1320,-10
2561157758,2561157757,-1,1844,2229,-10
2561197918,2561197920,2,1249,1503,-10
2566227842,2566227843,1,2182,2278,-10
2566988769,2566988770,1,1825,1928,-10
2567988917,2567988920,3,1772,1587,-10
2577196948,2577196948,0,2306,1820,-10
2578401175,2578401182,7,1382,722,-10
2582048752,2582048754,2,1323,1623,-10
2583707398,2583707401,3,1682,1533,-10
2587748652,2587748653,1,1527,1377,-10
2592227375,2592227378,3,1679,1879,-10
2592402811,2592402793,-18,837,1406,-10
2593228259,2593228262,3,1649,1864,-10
2598610988,2598610990,2,1578,1139,-10
2598702145,2598702146,1,1864,1517,-10
2599961640,2599961641,1,1998,1250,-10
2601847660,2601847660,0,1378,2187,-10
2605011047,2605011051,4,1571,2063,-10
2612095298,2612095298,0,1673,1239,-10
2612713376,2612713378,2,1460,1443,-10
2613475014,2613475015,1,1903,1552,-10
2614875355,2614875359,4,1510,861,-10
2618331780,2618331787,7,2038,1009,-10
2618833302,2618833304,2,1706,2071,-10
2619182675,2619182674,-1,1394,2381,-10
2626395262,2626395266,4,1764,1301,-10
2626770437,2626770430,-7,788,5010,-10
2629098798,2629098799,1,1689,1764,-10
2630705603,2630705603,0,1296,1975,-10
2631211142,2631211143,1,1882,1270,-10
2631281960,2631281961,1,1531,1354,-10
2632256227,2632256229,2,1330,1447,-10
2634540944,2634540947,3,1583,1548,-10
2635232691,2635232693,2,1940,1661,-10
2635346327,2635346331,4,765,321,-10
2638080546,2638080548,2,1566,1428,-10
2639085234,2639085234,0,2150,2318,-10
2640503994,2640503997,3,1436,1545,-10
2642479813,2642479811,-2,2598,3545,-10
2643135446,2643135446,0,1788,1888,-10
2646580662,2646580665,3,1968,1496,-10
2648232825,2648232828,3,1547,1271,-10
2648811945,2648811946,1,1432,1283,-10
2653618167,2653618169,2,1044,1531,-10
2657480562,2657480562,0,1326,1352,-10
2657735350,2657735354,4,1554,1681,-10
2659919646,2659919647,1,989,1011,-10
2662830742,2662830747,5,1380,1496,-10
2668543217,2668543218,1,1597,1281,-10
2669482806,2669482806,0,2049,1959,-10
2674408212,2674408214,2,1310,1163,-10
2675200763,2675200766,3,1530,1514,-10
2676589878,2676589874,-4,1735,2970,-10
2678488169,2678488170,1,1508,2023,-10
2680883351,2680883355,4,1507,1057,-10
2680950344,2680950342,-2,2062,1487,-10
2683372628,2683372630,2,1413,1800,-10
2686471913,2686471914,1,1309,1422,-10
2691977258,2691977258,0,1712,1776,-10
2695586101,2695586103,2,1327,1407,-10
2697791125,2697791147,22,1113,1270,-10
2698966674,2698966674,0,1764,1429,-10
2700926926,2700926926,0,1455,1668,-10
2701541754,2701541753,-1,797,1396,-10
2703076813,2703076814,1,1427,1098,-10
2705349701,2705349704,3,1680,1530,-10
2706073218,2706073233,15,1309,1183,-10
2707121760,2707121761,1,2112,1662,-10
2710273202,2710273201,-1,886,2435,-10
2712704712,2712704713,1,1473,1636,-10
2714464299,2714464302,3,1160,1353,-10
2716059978,2716059973,-5,816,3363,-10
2718895775,2718895777,2,1728,1643,-10
2721765763,2721765767,4,1244,1215,-10
2723117231,2723117234,3,2091,1929,-10
2726222423,2726222423,0,1426,1412,-10
2728157541,2728157542,1,1223,1029,-10
2729448355,2729448355,0,1580,1572,-10
2729490384,2729490382,-2,862,928,-10
2729670935,2729670938,3,1952,1450,-10
2731716636,2731716643,7,4210,1192,-10
2735244456,2735244457,1,2047,2667,-10
2735355141,2735355143,2,1838,1727,-10
2736934511,2736934502,-9,38849,15136,-10
2737125424,2737125427,3,1484,1266,-10
2739031961,2739031953,-8,1140,4521,-10
2740071648,2740071652,4,1781,2043,-10
2742294823,2742294817,-6,28457,13325,-10
2743958929,2743958931,2,1881,1925,-10
2745219877,2745219876,-1,1115,1754,-10
2747311537,2747311538,1,1436,1505,-10
2748519127,2748519127,0,1612,1358,-10
2748746037,2748746041,4,1038,741,-10
2749031909,2749031909,0,2001,2068,-10
2751019583,2751019589,6,1356,1839,-10
2752257914,2752257914,0,1287,1756,-10
2753408713,2753408715,2,1292,993,-10
2754302131,2754302133,2,1174,1611,-10
2754738760,2754738762,2,2163,2062,-10
2756485717,2756485717,0,1381,1668,-10
2758443195,2758443199,4,1543,1529,-10
2768649049,2768649050,1,1128,1860,-10
2770250582,2770250582,0,1534,1618,-10
2770346878,2770346880,2,927,1478,-10
2772245681,2772245683,2,1390,1261,-10
2775854731,2775854733,2,1914,1737,-10
2780198040,2780198038,-2,3117,3554,-10
2783172325,2783172326,1,1510,1660,-10
2785929881,2785929878,-3,1097,1887,-10
2786451781,2786451781,0,1403,1771,-10
2786581875,2786581877,2,1515,2072,-10
2786767841,2786767842,1,1396,1154,-10
2788822634,2788822637,3,1743,1187,-10
2790125125,2790125132,7,4013,1716,-10
2794792789,2794792788,-1,1683,2500,-10
2795453874,2795453877,3,2504,1932,-10
2795774193,2795774195,2,1409,1524,-10
2796154021,2796154026,5,1179,896,-10
2796859250,2796859250,0,2218,2378,-10
2799739469,2799739476,7,4563,1949,-10
2806403759,2806403752,-7,712,2373,-10
2811824330,2811824333,3,1772,1475,-10
2812112693,2812112695,2,1976,1473,-10
2813537030,2813537011,-19,1525,395,-10
2815429054,2815429059,5,1952,1243,-10
2816521169,2816521170,1,1489,1449,-10
2817560410,2817560413,3,1639,1606,-10
2819633953,2819633954,1,1147,1752,-10
2820101514,2820101516,2,1597,1253,-10
2820975884,2820975885,1,1242,1296,-10
2824649895,2824649899,4,1685,1226,-10
2826824635,2826824637,2,1615,1312,-10
2827672401,2827672405,4,3591,2682,-10
2829211613,2829211615,2,1785,1220,-10
2829684520,2829684522,2,1966,1329,-10
2830932394,2830932395,1,1679,2049,-10
2832697313,2832697314,1,1922,1849,-10
2834354099,2834354098,-1,1607,2110,-10
2837972359,2837972358,-1,915,1666,-10
2839956893,2839956893,0,1492,1418,-10
2845107396,2845107397,1,854,1423,-10
2845465941,2845465941,0,1785,1846,-10
2846682770,2846682773,3,1894,1747,-10
2848550678,2848550682,4,4133,2587,-10
2850023161,2850023165,4,1844,1747,-10
2851063987,2851063993,6,1719,1547,-10
2857491254,2857491255,1,984,1632,-10
2857709917,2857709920,3,1348,1169,-10
2859021417,2859021418,1,1498,1382,-10
2859147346,2859147349,3,1450,1739,-10
2861954610,2861954610,0,1958,1597,-10
2862820527,2862820529,2,1558,1576,-10
2865843350,2865843351,1,1277,1502,-10
2868370393,2868370394,1,2340,1665,-10
2868420147,2868420149,2,1661,1256,-10
2872601217,2872601215,-2,1085,1024,-10
2873547240,2873547241,1,1320,1867,-10
2875222553,2875222555,2,1840,1447,-10
2875715899,2875715902,3,1944,1628,-10
2877287359,2877287361,2,1490,1362,-10
2878895924,2878895927,3,1121,1348,-10
2881172963,2881172965,2,1222,1170,-10
2882921831,2882921831,0,1001,1286,-10
2884161929,2884161917,-12,1324,1794,-10
2886690778,2886690779,1,1442,1822,-10
2889379321,2889379322,1,1196,1566,-10
2890381934,2890381936,2,2009,1111,-10
2891351818,2891351822,4,2327,1680,-10
2892481471,2892481470,-1,1608,2318,-10
2895499369,2895499370,1,1505,1050,-10
2898640137,2898640138,1,1552,1698,-10
2900275606,2900275607,1,1456,1621,-10
2902442182,2902442182,0,2044,1646,-10
2904481120,2904481122,2,1629,1286,-10
2908365122,2908365119,-3,1066,2077,-10
2908612534,2908612535,1,1193,908,-10
2910541913,2910541911,-2,1610,2136,-10
2911935137,2911935138,1,1136,1309,-10
2914566986,2914566988,2,1710,2206,-10
2915113368,2915113370,2,1577,1870,-10
2916060271,2916060265,-6,1101,3982,-10
2920140061,2920140059,-2,1540,3272,-10
2923063098,2923063100,2,1363,1421,-10
2925060342,2925060343,1,1913,1902,-10
2927948843,2927948846,3,1391,1431,-10
2929303298,2929303301,3,1795,1485,-10
2930254068,2930254067,-1,2598,3289,-10
2936220539,2936220539,0,1743,2344,-10
2936548949,2936548949,0,1317,1275,-10
2937012089,2937012090,1,1443,1632,-10
2937052136,2937052144,8,1721,1595,-10
2939154836,2939154838,2,1239,1227,-10
2940245713,2940245709,-4,1900,3004,-10
2941471651,2941471657,6,23065,45053,-10
2942761926,2942761928,2,2008,1711,-10
2944882754,2944882752,-2,1561,1899,-10
2945455916,2945455919,3,1220,2004,-10
2946590225,2946590227,2,1791,1678,-10
2946921813,2946921816,3,1334,1500,-10
2952856754,2952856754,0,1361,1224,-10
2953620345,2953620348,3,1425,1754,-10
2957291876,2957291877,1,1175,1359,-10
2958258994,2958258998,4,1481,1768,-10
2959629973,2959629975,2,2241,1765,-10
2960064481,2960064482,1,1425,1392,-10
2964409748,2964409749,1,1404,1552,-10
2968842605,2968842610,5,1808,1098,-10
2969195569,2969195571,2,1975,1509,-10
2970405825,2970405828,3,1663,1294,-10
2972430407,2972430389,-18,1607,1509,-10
2973047148,2973047150,2,1494,1692,-10
2975243898,2975243901,3,2594,1877,-10
2979110658,2979110661,3,1464,1768,-10
2979780222,2979780225,3,1052,1132,-10
2982550961,2982550963,2,965,872,-10
2983886982,2983886987,5,1519,1179,-10
2986123326,2986123327,1,1349,1253,-10
2990430111,2990430111,0,988,1208,-10
2994272846,2994272846,0,1818,2017,-10
2994383236,2994383239,3,2083,1597,-10
2994419662,2994419663,1,1401,1856,-10
2994763540,2994763542,2,1430,1420,-10
2997866484,2997866486,2,1370,1544,-10
2998622751,2998622751,0,1549,1234,-10
3005961104,3005961107,3,1391,1863,-10
3008154314,3008154316,2,1357,1297,-10
3009112807,3009112807,0,1180,1474,-10
3009892267,3009892270,3,1755,1939,-10
3011764333,3011764335,2,918,1073,-10
3013499320,3013499321,1,1062,1298,-10
3013736398,3013736400,2,1334,1876,-10
3014180938,3014180937,-1,1658,1473,-10
3014693261,3014693262,1,1881,1773,-10
3022359322,3022359326,4,6133,29884,-10
3023002497,3023002500,3,1045,1164,-10
3025658835,3025658836,1,1355,1105,-10
3026282154,3026282154,0,1979,1707,-10
3026480141,3026480143,2,1610,1442,-10
3029317561,3029317563,2,1444,1486,-10
3030918617,3030918622,5,2380,1154,-10
3031536811,3031536813,2,1172,1566,-10
3043864805,3043864804,-1,1283,1342,-10
3045051911,3045051913,2,1500,2177,-10
3047607567,3047607569,2,1360,946,-10
3053523190,3053523192,2,1773,1591,-10
3053756115,3053756117,2,1641,930,-10
3053890164,3053890167,3,1341,1517,-10
3055326618,3055326618,0,1257,1278,-10
3058584436,3058584438,2,1803,1470,-10
3060566277,3060566281,4,1796,1528,-10
3061046821,3061046825,4,898,1184,-10
3063094980,3063094982,2,1656,1464,-10
3066485074,3066485074,0,1795,1292,-10
3067500306,3067500308,2,1632,1605,-10
3068723062,3068723065,3,1283,1370,-10
3079323325,3079323327,2,1669,1265,-10
3080924248,3080924247,-1,1463,1710,-10
3082336208,3082336210,2,1536,1487,-10
3083098265,3083098266,1,1069,933,-10
3083528798,3083528800,2,2277,1859,-10
3084810261,3084810261,0,1532,1415,-10
3086235977,3086235978,1,1445,1490,-10
3087194349,3087194351,2,1818,1806,-10
3092556570,3092556569,-1,1280,1640,-10
3097881639,3097881643,4,1288,1058,-10
3102338346,3102338350,4,1398,1298,-10
3105914211,3105914212,1,1232,1298,-10
3108627869,3108627869,0,1327,1442,-10
3109751670,3109751671,1,2063,2102,-10
3111425399,3111425418,19,1556,1284,-10
3113855429,3113855430,1,1948,1599,-10
3115487225,3115487227,2,1478,1636,-10
3115908173,3115908174,1,1469,1572,-10
3117219446,3117219446,0,1529,1404,-10
3118344065,3118344065,0,1314,2005,-10
3118623306,3118623326,20,530,3385,-10
3119606237,3119606239,2,1148,943,-10
3122133954,3122133957,3,1276,1574,-10
3127060347,3127060348,1,1450,1719,-10
3128364398,3128364394,-4,569,3609,-10
3130897913,3130897917,4,2152,2046,-10
3133215234,3133215235,1,1383,1545,-10
3134538863,3134538863,0,1474,1470,-10
3136581764,3136581765,1,1752,1326,-10
3136807433,3136807434,1,2253,2096,-10
3136906395,3136906395,0,1590,1674,-10
3138721486,3138721486,0,1384,1275,-10
3141399854,3141399856,2,1525,1798,-10
3142730304,3142730306,2,1243,1213,-10
3144621723,3144621718,-5,1047,2553,-10
3147715217,3147715218,1,1948,1920,-10
3148933193,3148933196,3,1886,1870,-10
3151755881,3151755884,3,1425,1708,-10
3152365719,3152365697,-22,1170,1220,-10
3153038238,3153038239,1,1369,1466,-10
3158772730,3158772735,5,977,631,-10
3161981569,3161981569,0,1590,1253,-10
3163770655,3163770658,3,1603,1656,-10
3164019774,3164019778,4,1053,972,-10
3171502329,3171502322,-7,1244,3049,-10
3173250654,3173250658,4,2402,1178,-10
3174395782,3174395785,3,1328,1809,-10
3174543235,3174543218,-17,1071,792,-10
3175889017,3175889019,2,871,1451,-10
3178795410,3178795414,4,1083,1298,-10
3182254962,3182254963,1,1736,1300,-10
3184197505,3184197510,5,1838,934,-10
3185211578,3185211584,6,1629,963,-10
3186699815,3186699817,2,1724,2149,-10
3190329942,3190329944,2,1705,1425,-10
3190745978,3190745982,4,1569,913,-10
3191355669,3191355670,1,1693,1725,-10
3192567360,3192567361,1,1709,1163,-10
3193810962,3193810963,1,1377,1364,-10
3194145357,3194145360,3,4143,2762,-10
3197256989,3197256989,0,1325,1246,-10
3197630829,3197630834,5,1267,1419,-10
3197985919,3197985921,2,1803,1693,-10
3206171870,3206171870,0,1600,1716,-10
3206641842,3206641843,1,1533,1873,-10
3206944386,3206944390,4,1788,1608,-10
3208320068,3208320069,1,1283,1602,-10
3209779890,3209779891,1,1721,1052,-10
3210950166,3210950166,0,1688,1516,-10
3213211226,3213211231,5,1132,1306,-10
3218108022,3218108023,1,1591,1990,-10
3218355238,3218355239,1,1275,1556,-10
3221344278,3221344282,4,1399,1302,-10
3222268569,3222268571,2,1334,1068,-10
3224730606,3224730584,-22,1279,1389,-10
3231453979,3231453982,3,1076,1439,-10
3234730185,3234730186,1,2065,2275,-10
3235122462,3235122462,0,1241,1596,-10
3237148578,3237148573,-5,1972,7504,-10
3238285271,3238285274,3,1200,1249,-10
3242743444,3242743443,-1,1801,1616,-10
3245661286,3245661292,6,4636,2765,-10
3248206656,3248206659,3,1595,1391,-10
3249695882,3249695875,-7,794,1879,-10
3249856239,3249856242,3,1875,1770,-10
3253536354,3253536346,-8,750,7321,-10
3254409438,3254409439,1,1109,1524,-10
3255358630,3255358631,1,1151,1547,-10
3258505965,3258505963,-2,1553,2744,-10
3260513248,3260513247,-1,1720,1710,-10
3262966547,3262966551,4,1582,1205,-10
3263298613,3263298615,2,1134,1353,-10
3263579301,3263579304,3,1718,1469,-10
3265392729,3265392730,1,1236,1600,-10
3273304714,3273304715,1,1422,1737,-10
3273897191,3273897193,2,1169,1464,-10
3275678372,3275678369,-3,840,1771,-10
3276841022,3276841027,5,1454,1986,-10
3278250255,3278250250,-5,1312,4548,-10
3278426626,3278426627,1,1377,2121,-10
3278862887,3278862890,3,2230,1663,-10
3283946914,3283946916,2,1546,1665,-10
3290388904,3290388906,2,1538,2107,-10
3292698558,3292698561,3,1155,1119,-10
3294878113,3294878114,1,1243,1727,-10
3295545662,3295545666,4,1275,1023,-10
3302378753,3302378758,5,596,628,-10
3302581079,3302581082,3,1558,1083,-10
3304928655,3304928654,-1,1214,1512,-10
3306416134,3306416139,5,1033,1049,-10
3308767385,3308767383,-2,1304,1496,-10
3309686192,3309686195,3,1603,1503,-10
3314409726,3314409725,-1,1394,1453,-10
3317676325,3317676324,-1,1410,1693,-10
3318616054,3318616055,1,1464,1898,-10
3318706894,3318706897,3,1299,1580,-10
3320101950,3320101951,1,1927,1499,-10
3325097638,3325097638,0,1437,1880,-10
3331003126,3331003127,1,2101,2305,-10
3331984898,3331984899,1,1144,1230,-10
3333316685,3333316688,3,1557,1755,-10
3334399497,3334399500,3,1761,1596,-10
3335222818,3335222823,5,1751,1413,-10
3335564553,3335564555,2,1047,1640,-10
3336043206,3336043206,0,561,1154,-10
3336618591,3336618590,-1,1014,922,-10
3337721003,3337721005,2,2199,1574,-10
3341260909,3341260911,2,1529,1410,-10
3342355885,3342355886,1,1444,1184,-10
3343768405,3343768408,3,1570,1492,-10
3344533203,3344533206,3,1938,1761,-10
3348082545,3348082538,-7,3508,11335,-10
3349056246,3349056247,1,1720,1520,-10
3350126548,3350126549,1,1731,1185,-10
3356894697,3356894698,1,1916,1803,-10
3359954277,3359954279,2,1775,1824,-10
3360919090,3360919091,1,1411,1646,-10
3367326999,3367326994,-5,980,3056,-10
3376036501,3376036502,1,1543,1354,-10
3379028890,3379028873,-17,2024,1770,-10
3379725237,3379725249,12,1830,1356,-10
3380029814,3380029818,4,1750,1243,-10
3381228230,3381228210,-20,764,1216,-10
3381800411,3381800409,-2,1126,1301,-10
3383310162,3383310162,0,1493,1152,-10
3385265654,3385265655,1,2318,1966,-10
3389376975,3389376977,2,18896,19918,-10
3390484040,3390484042,2,1902,1347,-10
3395433736,3395433737,1,2085,2143,-10
3396068304,3396068306,2,1492,1375,-10
3397389501,3397389503,2,2653,1725,-10
3399403992,3399403994,2,1589,1969,-10
3400156188,3400156199,11,30331,45168,-10
3401300172,3401300171,-1,1487,1269,-10
3404265306,3404265314,8,4495,1093,-10
3404727158,3404727155,-3,1441,3682,-10
3404933739,3404933739,0,1118,1254,-10
3406083537,3406083546,9,13856,22380,-10
3406752178,3406752179,1,1787,1600,-10
3407043639,3407043643,4,1801,2152,-10
3409401602,3409401606,4,1714,1449,-10
3414131493,3414131494,1,1804,1300,-10
3414835042,3414835043,1,791,552,-10
3415444610,3415444613,3,1505,1990,-10
3419677780,3419677783,3,1711,1243,-10
3422418549,3422418530,-19,938,583,-10
3423585362,3423585366,4,1709,1087,-10
3428672935,3428672935,0,1331,1958,-10
3431423749,3431423749,0,1094,1052,-10
3434572698,3434572700,2,1407,1830,-10
3434885720,3434885722,2,1219,1424,-10
3441656847,3441656849,2,2168,1920,-10
3442785390,3442785401,11,2084,1480,-10
3446135778,3446135786,8,15618,22432,-10
3446246666,3446246666,0,1528,1535,-10
3449197534,3449197528,-6,797,2522,-10
3450253386,3450253387,1,2286,1408,-10
3454993905,3454993906,1,1226,1350,-10
3455899704,3455899727,23,2115,1346,-10
3458885853,3458885854,1,1189,1230,-10
3463687339,3463687338,-1,1520,1841,-10
3464715874,3464715875,1,1276,1366,-10
3466006503,3466006502,-1,1649,2730,-10
3467028139,3467028139,0,1063,1383,-10
3470974986,3470974989,3,1901,1816,-10
3475231930,3475231933,3,999,1113,-10
3477289382,3477289383,1,1234,1893,-10
3479537972,3479537979,7,1518,1175,-10
3479612759,3479612737,-22,1175,841,-10
3479675416,3479675419,3,1615,1320,-10
3481149167,3481149169,2,1022,1218,-10
3481368561,3481368567,6,3680,1266,-10
3483270201,3483270201,0,1149,1507,-10
3484075386,3484075389,3,1373,1310,-10
3484319354,3484319354,0,1280,1734,-10
3485758787,3485758781,-6,31087,12722,-10
3486063861,3486063863,2,1386,1691,-10
3487798963,3487798965,2,1696,1656,-10
3490893385,3490893387,2,1742,1442,-10
3491344557,3491344563,6,1701,1069,-10
3494228823,3494228826,3,1173,1331,-10
3494282886,3494282886,0,1729,1159,-10
3495995841,3495995842,1,1154,1200,-10
3499025402,3499025405,3,1486,1640,-10
3505304873,3505304874,1,981,1369,-10
3511616088,3511616090,2,1928,1494,-10
3513670909,3513670909,0,1815,1515,-10
3514656155,3514656158,3,1508,1214,-10
3516032627,3516032632,5,1670,1580,-10
3516676935,3516676937,2,1729,1792,-10
3518919521,3518919523,2,1535,1563,-10
3519728912,3519728913,1,1813,1011,-10
3522170106,3522170111,5,2663,1470,-10
3522488461,3522488461,0,1488,1710,-10
3523014418,3523014421,3,1514,1714,-10
3523091618,3523091620,2,1762,1848,-10
3523378129,3523378136,7,3003,1551,-10
3524311923,3524311926,3,2296,1788,-10
3526237086,3526237088,2,1519,1375,-10
3526345459,3526345462,3,1928,2643,-10
3531492819,3531492823,4,1342,1169,-10
3532132828,3532132821,-7,1271,3763,-10
3537451774,3537451774,0,1376,1446,-10
3539570559,3539570560,1,1511,1230,-10
3539933321,3539933323,2,1392,1346,-10
3540385726,3540385726,0,1027,1479,-10
3543153977,3543153979,2,1238,1228,-10
3544538989,3544538990,1,977,1941,-10
3546066626,3546066628,2,2008,1824,-10
3552212441,3552212442,1,1560,1623,-10
3552847162,3552847164,2,1683,1460,-10
3554267860,3554267862,2,1511,1430,-10
3555174003,3555174005,2,1693,1251,-10
3556063820,3556063822,2,1644,1418,-10
3557971679,3557971682,3,2028,1459,-10
3558677867,3558677866,-1,1275,1735,-10
3560178527,3560178531,4,1861,2025,-10
3563219879,3563219874,-5,1433,1768,-10
3563356888,3563356890,2,1513,1510,-10
3564023222,3564023221,-1,1170,1269,-10
3565085338,3565085339,1,1706,1485,-10
3572002697,3572002698,1,821,1159,-10
3572955402,3572955406,4,1558,1036,-10
3573778062,3573778064,2,1673,1509,-10
3576515209,3576515199,-10,629,1496,-10
3578495291,3578495295,4,1525,1978,-10
3581266453,3581266455,2,1292,1769,-10
3582479679,3582479678,-1,1316,1533,-10
3587733010,3587732990,-20,1596,1238,-10
3588103217,3588103219,2,2355,1695,-10
3588298344,3588298338,-6,791,1489,-10
3590231611,3590231615,4,1632,1386,-10
3590872065,3590872070,5,1050,1328,-10
3593813125,3593813127,2,1558,1366,-10
3594889570,3594889572,2,881,1145,-10
3595230142,3595230145,3,1733,1251,-10
3596475061,3596475061,0,24464,39406,-10
3597129130,3597129131,1,1022,1114,-10
3598375278,3598375282,4,1371,1165,-10
3599139922,3599139922,0,723,1598,-10
3599693014,3599693014,0,1691,1868,-10
3600667294,3600667296,2,1501,1810,-10
3603177879,3603177882,3,1617,2028,-10
3603759682,3603759684,2,1528,1294,-10
3606180339,3606180342,3,1427,1707,-10
3606476582,3606476578,-4,1436,2641,-10
3612550693,3612550694,1,1433,1552,-10
3613240349,3613240350,1,1943,2067,-10
3613892674,3613892675,1,1479,1728,-10
3617035654,3617035654,0,2078,1765,-10
3617792809,3617792810,1,1562,1563,-10
3620367499,3620367501,2,1066,1198,-10
3622046421,3622046425,4,1681,1454,-10
3623507959,3623507962,3,1938,1544,-10
3623557823,3623557827,4,1265,747,-10
3625692400,3625692402,2,1658,1851,-10
3628181909,3628181911,2,971,1591,-10
3630601203,3630601206,3,1016,1622,-10
3633185100,3633185098,-2,1066,1813,-10
3634068767,3634068762,-5,744,2489,-10
3634203912,3634203913,1,1784,1963,-10
3639063714,3639063716,2,1905,2116,-10
3641713759,3641713762,3,3813,2474,-10
3641872845,3641872848,3,1755,777,-10
3644849050,3644849051,1,1524,1280,-10
3645623569,3645623569,0,1323,1104,-10
3646206050,3646206051,1,1733,1960,-10
3647203864,3647203866,2,1886,1810,-10
3650154527,3650154507,-20,1076,1382,-10
3654287870,3654287873,3,1356,1332,-10
3657269758,3657269760,2,838,1438,-10
3657830546,3657830549,3,1021,1751,-10
3659946445,3659946445,0,1875,1856,-10
3660368862,3660368865,3,1183,1386,-10
3660951482,3660951483,1,1754,1283,-10
3662043970,3662043971,1,1632,1373,-10
3663101753,3663101754,1,2022,1941,-10
3664878022,3664878023,1,1605,1874,-10
3665013218,3665013218,0,1301,1328,-10
3665905759,3665905757,-2,1154,1938,-10
3669383537,3669383539,2,1241,1613,-10
3670146210,3670146211,1,1473,1687,-10
3670308278,3670308280,2,1842,1525,-10
3671871443,3671871447,4,1776,1703,-10
3672383952,3672383955,3,1562,1376,-10
3673761109,3673761111,2,1959,2154,-10
3676609370,3676609371,1,1305,1711,-10
3676639998,3676640000,2,2238,1954,-10
3676794638,3676794640,2,1944,1670,-10
3678434681,3678434682,1,865,1069,-10
3678561476,3678561474,-2,1257,2186,-10
3679292399,3679292401,2,1366,1299,-10
3682072036,3682072039,3,2260,2354,-10
3685928674,3685928675,1,1111,969,-10
3689025819,3689025822,3,772,637,-10
3689983186,3689983189,3,1595,1221,-10
3694792782,3694792763,-19,1472,721,-10
3695022886,3695022890,4,2688,1663,-10
3699576495,3699576496,1,1449,1787,-10
3700657320,3700657321,1,1321,1742,-10
3704148977,3704148980,3,2025,1648,-10
3705496346,3705496347,1,1978,1638,-10
3706578571,3706578571,0,1153,1910,-10
3706718900,3706718902,2,1497,1410,-10
3709801395,3709801399,4,1959,1278,-10
3712233753,3712233755,2,1963,1308,-10
3714529305,3714529303,-2,1068,1364,-10
3716456854,3716456857,3,2786,1767,-10
3716801222,3716801226,4,1857,1561,-10
3717616702,3717616702,0,1415,1397,-10
3719949488,3719949491,3,1766,1732,-10
3720559749,3720559752,3,1239,1059,-10
3721687822,3721687817,-5,30191,12285,-10
3722191835,3722191838,3,1740,1279,-10
3727013554,3727013554,0,1554,2270,-10
3728159186,3728159187,1,1668,1337,-10
3732419982,3732419983,1,1516,1296,-10
3732591263,3732591267,4,1766,1301,-10
3734641448,3734641450,2,1806,1714,-10
3736860754,3736860764,10,10633,34290,-10
3737350031,3737350035,4,2838,2942,-10
3740138223,3740138226,3,1014,876,-10
3742233582,3742233582,0,1100,1377,-10
3745323243,3745323246,3,953,1014,-10
3746732089,3746732090,1,1905,2358,-10
3746916530,3746916533,3,1743,1817,-10
3747677183,3747677186,3,1256,998,-10
3750124196,3750124197,1,1908,1702,-10
3751320181,3751320181,0,1039,1431,-10
3751730648,3751730665,17,243,1089,-10
3752926480,3752926483,3,4264,3102,-10
3753999523,3753999525,2,1742,1436,-10
3755582754,3755582755,1,1123,1395,-10
3757967695,3757967697,2,1054,1353,-10
3768601549,3768601553,4,1889,1405,-10
3773013101,3773013099,-2,853,2481,-10
3774467349,3774467342,-7,1843,6406,-10
3774810089,3774810109,20,798,3242,-10
3777549033,3777549033,0,1240,1217,-10
3777942185,3777942187,2,1498,1513,-10
3778383220,3778383222,2,1733,1674,-10
3778619668,3778619669,1,1576,1626,-10
3779813801,3779813802,1,1418,1401,-10
3780884740,3780884742,2,1397,1103,-10
3781859149,3781859154,5,929,1147,-10
3784796888,3784796891,3,1314,1096,-10
3788481135,3788481138,3,1596,1666,-10
3789118906,3789118906,0,1288,1348,-10
3790562696,3790562699,3,1382,1212,-10
3790969638,3790969642,4,1152,1482,-10
3798864479,3798864479,0,1451,1274,-10
3803024669,3803024670,1,1720,1556,-10
3803295543,3803295545,2,1223,1168,-10
3804664210,3804664211,1,1843,1746,-10
3805740415,3805740416,1,1180,1588,-10
3806247654,3806247655,1,2215,1414,-10
3806699467,3806699470,3,1232,1188,-10
3807340629,3807340632,3,1576,1145,-10
3811432141,3811432142,1,1632,1772,-10
3812864566,3812864569,3,1343,951,-10
3821086691,3821086693,2,1461,1251,-10
3821931066,3821931061,-5,689,2050,-10
3822244442,3822244445,3,1700,1626,-10
3822734992,3822734993,1,1226,1239,-10
3823387750,3823387746,-4,1468,2996,-10
3824315191,3824315195,4,1040,1536,-10
3825157532,3825157534,2,1370,1613,-10
3826238401,3826238406,5,1448,1319,-10
3828066341,3828066343,2,1397,1594,-10
3828466141,3828466144,3,1689,1211,-10
3828720555,3828720558,3,1054,1300,-10
3829856513,3829856514,1,1648,1941,-10
3835610393,3835610393,0,1603,1603,-10
3838253157,3838253160,3,1241,1310,-10
3838854913,3838854914,1,1617,2157,-10
3842397933,3842397937,4,1426,1835,-10
3843416187,3843416191,4,1920,1495,-10
3848849274,3848849276,2,1369,1852,-10
3848882141,3848882142,1,1585,1496,-10
3852026806,3852026808,2,2103,1947,-10
3852681986,3852681987,1,1096,1191,-10
3857535229,3857535230,1,1280,1420,-10
3858789560,3858789561,1,1281,1543,-10
3859152613,3859152614,1,2283,1787,-10
3861966688,3861966688,0,1785,2799,-10
3862771002,3862771003,1,1866,2275,-10
3862944847,3862944847,0,1152,1252,-10
3865472467,3865472467,0,1632,1430,-10
3866417082,3866417086,4,1142,1524,-10
3867525866,3867525865,-1,1830,1826,-10
3868233602,3868233602,0,1438,1867,-10
3869000376,3869000379,3,973,895,-10
3869796134,3869796135,1,1492,1280,-10
3874708554,3874708557,3,19179,34519,-10
3875160637,3875160639,2,1913,1541,-10
3879807603,3879807605,2,1320,1160,-10
3881817656,3881817657,1,1363,1500,-10
3882195321,3882195321,0,1776,1966,-10
3886018234,3886018230,-4,1136,3507,-10
3886863158,3886863166,8,6801,1107,-10
3890377958,3890377957,-1,946,1760,-10
3892962288,3892962291,3,1393,1766,-10
3893762922,3893762927,5,3616,1853,-10
3897381794,3897381796,2,1417,1538,-10
3898758665,3898758668,3,1347,1345,-10
3900164922,3900164922,0,2082,2300,-10
3900684387,3900684387,0,1452,1747,-10
3900805007,3900805011,4,2007,1294,-10
3901954877,3901954878,1,1137,848,-10
3902286058,3902286059,1,1703,1228,-10
3904356167,3904356170,3,2112,1503,-10
3904765627,3904765629,2,1543,1308,-10
3904867335,3904867337,2,1393,1237,-10
3907839106,3907839106,0,1253,1231,-10
3908571110,3908571110,0,1435,956,-10
3912270256,3912270258,2,1601,990,-10
3914524439,3914524441,2,1748,1098,-10
3917696498,3917696501,3,1014,1919,-10
3918763979,3918763982,3,1369,1412,-10
3921560218,3921560219,1,1282,1485,-10
3927480106,3927480107,1,1560,1267,-10
3929524698,3929524700,2,2104,1770,-10
3930666453,3930666457,4,1314,1747,-10
3931301769,3931301768,-1,1292,1525,-10
3932697024,3932697025,1,1496,1226,-10
3935840845,3935840845,0,1403,1383,-10
3938136911,3938136916,5,1388,1211,-10
3940364281,3940364283,2,1518,1702,-10
3940810342,3940810346,4,1871,1223,-10
3944039819,3944039822,3,1391,1414,-10
3944141072,3944141053,-19,1500,1359,-10
3944664597,3944664598,1,1921,2288,-10
3945377074,3945377077,3,1269,1186,-10
3948005474,3948005475,1,1117,1396,-10
3952170893,3952170893,0,1580,1853,-10
3952813374,3952813377,3,1700,1587,-10
3956024859,3956024861,2,1402,1351,-10
3957537565,3957537566,1,1567,1608,-10
3958340364,3958340366,2,1195,1306,-10
3960434777,3960434778,1,1618,2124,-10
3962215011,3962215014,3,1454,1769,-10
3967054587,3967054591,4,2209,1532,-10
3968072006,3968072006,0,1707,1823,-10
3968150674,3968150669,-5,1871,6373,-10
3968964381,3968964381,0,1616,1640,-10
3971104896,3971104897,1,2111,2626,-10
3973353003,3973352988,-15,1620,817,-10
3976225235,3976225237,2,1249,1575,-10
3977959987,3977959989,2,1561,911,-10
3979726158,3979726158,0,1167,1118,-10
3983185909,3983185910,1,1239,1432,-10
3984851291,3984851291,0,1135,1252,-10
3986226004,3986226007,3,1994,1638,-10
3986778794,3986778803,9,29,1015,-10
3987919962,3987919966,4,1837,1119,-10
3988492030,3988492034,4,1967,1688,-10
3991286704,3991286707,3,1830,1499,-10
3992659794,3992659797,3,1932,1224,-10
3994438388,3994438390,2,1227,1786,-10
3994685959,3994685961,2,1545,1462,-10
3994754413,3994754414,1,1441,1492,-10
3994904169,3994904171,2,1023,870,-10
3998811336,3998811337,1,1905,1705,-10
3999372183,3999372186,3,2128,2046,-10
4000280909,4000280915,6,3470,1711,-10
4000391404,4000391405,1,2159,1475,-10
4001620106,4001620110,4,2216,1624,-10
4002998399,4002998401,2,1944,1215,-10
4004355696,4004355698,2,1533,1584,-10
4004430942,4004430946,4,1349,1340,-10
4006557616,4006557617,1,1792,1438,-10
4008919395,4008919398,3,1531,1170,-10
4011932675,4011932676,1,1992,2168,-10
4012116991,4012116994,3,1680,1642,-10
4012611010,4012611025,15,14830,34093,-10
4016647994,4016647998,4,1520,1372,-10
4017553650,4017553649,-1,1569,1998,-10
4021196197,4021196201,4,1731,1549,-10
4021687892,4021687894,2,1626,1825,-10
4024137933,4024137933,0,1411,1189,-10
4027142522,4027142526,4,2005,1386,-10
4027269393,4027269395,2,1682,1980,-10
4027482779,4027482774,-5,781,3106,-10
4030901426,4030901427,1,1542,994,-10
4031910876,4031910879,3,2124,1683,-10
4032224954,4032224963,9,1115,930,-10
4032323294,4032323291,-3,1236,2136,-10
4033712626,4033712626,0,1596,1816,-10
4037405918,4037405921,3,1857,1581,-10
4037779904,4037779906,2,1385,1265,-10
4038267304,4038267307,3,1282,1658,-10
4038956768,4038956769,1,3088,4661,-10
4039812749,4039812750,1,1415,1459,-10
4041547156,4041547158,2,1710,1538,-10
4041923527,4041923531,4,1102,1220,-10
4044364690,4044364693,3,1363,1539,-10
4046318834,4046318834,0,909,1048,-10
4052491277,4052491279,2,1505,1909,-10
4053137068,4053137088,20,889,287,-10
4058318980,4058318985,5,3041,1497,-10
4058978657,4058978660,3,2122,1928,-10
4060023196,4060023198,2,1579,1363,-10
4062336466,4062336466,0,1159,1876,-10
4063100450,4063100451,1,978,708,-10
4064043093,4064043094,1,1398,1475,-10
4065691622,4065691622,0,1166,1620,-10
4066240684,4066240683,-1,1175,1459,-10
4067803862,4067803866,4,1481,1334,-10
4068164421,4068164422,1,2081,2190,-10
4068436899,4068436902,3,732,1060,-10
4069323387,4069323386,-1,1325,1697,-10
4072036541,4072036547,6,4160,1339,-10
4074762959,4074762961,2,2204,1837,-10
4078917238,4078917239,1,1654,1477,-10
4079543811,4079543813,2,1926,1473,-10
4080668314,4080668317,3,1452,1490,-10
4081774316,4081774318,2,1832,1729,-10
4082735783,4082735785,2,1586,1385,-10
4083465297,4083465298,1,1349,1111,-10
4086833719,4086833720,1,1788,1655,-10
4089242803,4089242804,1,1271,1776,-10
4091633695,4091633697,2,1366,1173,-10
4092726949,4092726946,-3,1225,1469,-10
4094484598,4094484601,3,1331,1215,-10
4096859112,4096859113,1,1382,1627,-10
4097688752,4097688754,2,2200,2309,-10
4097937317,4097937316,-1,1611,2142,-10
4098749970,4098749972,2,1519,1443,-10
4099059265,4099059267,2,1621,1326,-10
4099177381,4099177381,0,1726,1502,-10
4101594675,4101594672,-3,1542,4331,-10
4102984992,4102984995,3,1908,1210,-10
4105711093,4105711098,5,2919,1030,-10
4106527209,4106527206,-3,2037,5252,-10
4108433114,4108433117,3,1736,1493,-10
4108783423,4108783442,19,1442,1000,-10
4110319953,4110319953,0,1851,1602,-10
4110502805,4110502802,-3,2627,4550,-10
4111347450,4111347453,3,1637,1534,-10
4115974658,4115974662,4,1693,1802,-10
4117175506,4117175511,5,1173,1036,-10
4117274338,4117274336,-2,1616,1920,-10
4119874221,4119874225,4,1983,1730,-10
4120433070,4120433074,4,1527,797,-10
4120509910,4120509906,-4,1024,1888,-10
4120910065,4120910071,6,1647,1291,-10
4124776878,4124776882,4,1254,1041,-10
4125397723,4125397727,4,1515,1029,-10
4126076246,4126076247,1,2029,1988,-10
4130605058,4130605062,4,1588,1523,-10
4130921849,4130921849,0,1406,1251,-10
4131762410,4131762413,3,1571,728,-10
4132406463,4132406464,1,1118,1691,-10
4134203833,4134203835,2,1299,1331,-10
4135298405,4135298407,2,1311,1561,-10
4136812446,4136812447,1,1488,1195,-10
4137085324,4137085325,1,1505,1424,-10
4140960256,4140960258,2,1569,1656,-10
4142268914,4142268914,0,1761,1667,-10
4142572390,4142572395,5,1931,1201,-10
4142997469,4142997472,3,2076,1129,-10
4144025235,4144025237,2,1289,1564,-10
4147645460,4147645463,3,1530,1408,-10
4149302174,4149302171,-3,1069,1281,-10
4154830654,4154830654,0,1448,1674,-10
4156695410,4156695411,1,1592,1797,-10
4165998810,4165998808,-2,1329,1739,-10
4170369329,4170369330,1,1132,1542,-10
4171288324,4171288327,3,1702,1888,-10
4171603638,4171603637,-1,800,2358,-10
4172884336,4172884335,-1,1435,1445,-10
4173249449,4173249451,2,2818,2151,-10
4175388523,4175388523,0,1369,1573,-10
4175680166,4175680167,1,1778,1835,-10
4178457919,4178457919,0,1668,2017,-10
4179929916,4179929918,2,3503,3574,-10
4183386979,4183386981,2,999,1298,-10
4184134061,4184134061,0,1589,1239,-10
4184811621,4184811622,1,1400,1315,-10
4188952882,4188952889,7,3398,1491,-10
4193719548,4193719550,2,2226,1344,-10
4196436723,4196436726,3,1330,1159,-10
4196615288,4196615288,0,34537,21570,-10
4198654821,4198654823,2,2057,1974,-10
4199352790,4199352791,1,1530,1874,-10
4200653747,4200653747,0,1187,1062,-10
4200755503,4200755484,-19,1532,1660,-10
4201490711,4201490711,0,2906,3115,-10
4201938026,4201938030,4,1881,1434,-10
4203701961,4203701958,-3,1066,1698,-10
4205704567,4205704571,4,890,1114,-10
4209096686,4209096686,0,1209,1271,-10
4209577982,4209577983,1,2411,1601,-10
4211595237,4211595242,5,2436,1862,-10
4212497162,4212497164,2,1770,1747,-10
4213613297,4213613298,1,1127,1073,-10
4213714918,4213714920,2,1617,1470,-10
4219564410,4219564410,0,1533,1575,-10
4223878403,4223878407,4,2048,1317,-10
4224339483,4224339483,0,739,1361,-10
4229647605,4229647602,-3,1434,1848,-10
4230319201,4230319203,2,1385,1312,-10
4232285085,4232285085,0,1065,1725,-10
4235544317,4235544318,1,2018,1450,-10
4239747839,4239747841,2,1517,1878,-10
4242268318,4242268318,0,1280,1377,-10
4244118777,4244118778,1,1327,1324,-10
4245448849,4245448853,4,2891,1228,-10
4247917246,4247917252,6,4375,2287,-10
4249860667,4249860670,3,2004,1368,-10
4251596678,4251596679,1,1049,1129,-10
4252294203,4252294205,2,1165,1146,-10
4253881968,4253881970,2,1534,1487,-10
4254940409,4254940412,3,7333,26981,-10
4256739049,4256739050,1,1424,1492,-10
4257491938,4257491937,-1,1050,1589,-10
4263148082,4263148086,4,1232,1475,-10
4263645401,4263645402,1,2200,1722,-10
4264371530,4264371532,2,1974,1732,-10
4264593354,4264593355,1,949,1200,-10
4264856908,4264856909,1,1309,1240,-10
4267360177,4267360176,-1,1352,1520,-10
4269753821,4269753823,2,1940,2004,-10
4272699354,4272699356,2,1256,1754,-10
4273503458,4273503460,2,2053,1804,-10
4276483904,4276483904,0,1611,1333,-10
4279718487,4279718486,-1,1556,1372,-10
4282107437,4282107436,-1,1525,1146,-10
4282540454,4282540455,1,1014,1850,-10
4283140715,4283140716,1,1189,2058,-10
4283550714,4283550713,-1,1232,1241,-10
4283664644,4283664647,3,1407,1270,-10
4285058217,4285058218,1,1098,1837,-10
4287515758,4287515758,0,1780,1400,-10
4287977090,4287977090,0,1570,1182,-10
4289866356,4289866358,2,1253,1299,-10
4293437753,4293437757,4,1160,1324,-10
4293859664,4293859666,2,1188,1472,-10
4294302290,4294302293,3,700,1407,-10
4294536774,4294536775,1,1928,1997,-10
4294810209,4294810211,2,1244,1407,-10
4296913314,4296913294,-20,1515,1330,-10
4298673315,4298673314,-1,1187,1071,-10
4298939024,4298939027,3,773,860,-10
4299430885,4299430905,20,1344,1323,-10
4300601874,4300601876,2,1185,1163,-10
4302372684,4302372682,-2,1562,3573,-10
4302599360,4302599362,2,1703,1169,-10
4304545094,4304545097,3,1403,1437,-10
4306007291,4306007269,-22,1765,1492,-10
4308155147,4308155149,2,1799,1389,-10
4310627693,4310627694,1,1516,1448,-10
4312055270,4312055271,1,822,1020,-10
4315711773,4315711774,1,1700,1335,-10
4316374171,4316374174,3,1015,1141,-10
4318145126,4318145135,9,1454,1352,-10
4321088722,4321088736,14,1127,1350,-10
4321690259,4321690264,5,2298,1344,-10
4322071655,4322071657,2,1683,1796,-10
4322479357,4322479358,1,1202,1125,-10
4323295444,4323295427,-17,1075,452,-10
4323437743,4323437743,0,1472,1681,-10
4325723220,4325723221,1,2340,2266,-10
4326145597,4326145598,1,1535,1729,-10
4327372255,4327372255,0,1622,1483,-10
4327815609,4327815611,2,1522,1221,-10
4332200316,4332200314,-2,1496,834,-10
4337784690,4337784694,4,2293,1788,-10
4338455601,4338455601,0,1278,1465,-10
4342490787,4342490791,4,1718,1069,-10
4343309289,4343309290,1,1402,1654,-10
4344236435,4344236437,2,1182,1643,-10
4351821958,4351821960,2,1081,1776,-10
4354533807,4354533802,-5,25229,12141,-10
4356086790,4356086793,3,1299,1234,-10
4356544602,4356544601,-1,1630,2028,-10
4357560023,4357560026,3,1368,1751,-10
4358552363,4358552342,-21,1655,1255,-10
4362471846,4362471848,2,929,1707,-10
4366181620,4366181625,5,2315,1292,-10
4368606846,4368606847,1,748,1333,-10
4371450740,4371450739,-1,1177,1634,-10
4373510568,4373510570,2,2001,1582,-10
4375696485,4375696488,3,2285,1257,-10
4377310843,4377310846,3,2254,1833,-10
4378381166,4378381167,1,1722,1480,-10
4382059074,4382059078,4,2202,1848,-10
4382286702,4382286706,4,1302,1277,-10
4384394224,4384394233,9,14473,37415,-10
4386655568,4386655561,-7,2583,8463,-10
4394119954,4394119955,1,1392,1291,-10
4394483256,4394483258,2,2090,1926,-10
4398700705,4398700709,4,2011,1634,-10
4399164303,4399164302,-1,2106,3248,-10
4399468729,4399468731,2,1552,1611,-10
4400157362,4400157363,1,877,1628,-10
4402565526,4402565527,1,1146,1840,-10
4402751546,4402751525,-21,1412,1468,-10
4403169051,4403169049,-2,1215,16794,-10
4406649802,4406649803,1,1707,2547,-10
4412291337,4412291338,1,1554,1382,-10
4416761657,4416761657,0,1841,1636,-10
4423294394,4423294387,-7,1590,1448,-10
4424956313,4424956314,1,2192,1655,-10
4425066599,4425066599,0,1211,1752,-10
4429255399,4429255393,-6,894,4901,-10
4429529356,4429529359,3,2321,1795,-10
4432309347,4432309347,0,1690,1198,-10
4432895470,4432895471,1,2104,1571,-10
4433585474,4433585474,0,1221,1381,-10
4433867366,4433867366,0,1223,2269,-10
4434645610,4434645611,1,1459,1561,-10
4440271762,4440271765,3,1668,1998,-10
4441647615,4441647619,4,1253,1410,-10
4444213838,4444213837,-1,1474,2165,-10
4444720709,4444720710,1,1606,1947,-10
4448987314,4448987306,-8,906,4173,-10
4451097474,4451097477,3,1571,2056,-10
4451528344,4451528345,1,1023,1269,-10
4451831246,4451831242,-4,854,2578,-10
4452143878,4452143881,3,869,1161,-10
4454053261,4454053263,2,1104,1396,-10
4454602910,4454602910,0,1533,2174,-10
4458124805,4458124806,1,1969,1807,-10
4462444108,4462444109,1,1139,1210,-10
4464303947,4464303949,2,1115,1283,-10
4464938130,4464938131,1,1464,1145,-10
4465477167,4465477166,-1,1105,1442,-10
4468675397,4468675399,2,1895,1625,-10
4469513765,4469513766,1,1402,1231,-10
4469793247,4469793247,0,1366,1573,-10
4469872926,4469872931,5,1213,1503,-10
4473832923,4473832925,2,2055,1579,-10
4476163608,4476163611,3,2318,2221,-10
4476491822,4476491823,1,1533,1957,-10
4479032433,4479032434,1,2309,2252,-10
4480437029,4480437030,1,1665,2043,-10
4481056326,4481056330,4,2079,1428,-10
4483371430,4483371430,0,1303,1222,-10
4486355791,4486355792,1,1513,1696,-10
4487467558,4487467559,1,2247,1850,-10
4487701472,4487701474,2,1644,1497,-10
4490482824,4490482824,0,1291,1111,-10
4491362071,4491362068,-3,1532,1889,-10
4492526045,4492526046,1,1133,1432,-10
4493069817,4493069835,18,1654,1234,-10
4494351063,4494351062,-1,1713,1741,-10
4494950292,4494950293,1,1521,1438,-10
4496141525,4496141525,0,1383,1356,-10
4496935155,4496935157,2,1338,1717,-10
4497354302,4497354303,1,1329,1418,-10
4505670479,4505670481,2,1519,1503,-10
4506817334,4506817334,0,1149,1966,-10
4509290150,4509290151,1,1431,1296,-10
4516068433,4516068433,0,1897,1642,-10
4521661304,4521661305,1,1401,1201,-10
4521990187,4521990188,1,1059,1445,-10
4523029170,4523029175,5,1349,1222,-10
4523849072,4523849058,-14,751,913,-10
4525525859,4525525860,1,1933,1710,-10
4528111179,4528111182,3,1445,1431,-10
4533505489,4533505494,5,4824,3050,-10
4533779685,4533779686,1,2167,1590,-10
4536477793,4536477793,0,1115,1687,-10
4537204141,4537204143,2,1742,1617,-10
4538427327,4538427330,3,1873,1693,-10
4540027569,4540027568,-1,1267,1315,-10
4542020849,4542020851,2,1700,1295,-10
4545492979,4545492983,4,786,975,-10
4546378562,4546378565,3,1300,1124,-10
4547517748,4547517750,2,1350,1416,-10
4555109860,4555109862,2,1450,1116,-10
4556138874,4556138877,3,1222,1234,-10
4558220243,4558220246,3,1578,1581,-10
4562200122,4562200123,1,1616,1535,-10
4564253944,4564253927,-17,1491,1477,-10
4567937318,4567937310,-8,29352,18023,-10
4569235081,4569235082,1,1321,1388,-10
4569273234,4569273232,-2,1279,2653,-10
4571051417,4571051418,1,1667,1427,-10
4571415473,4571415475,2,1129,1411,-10
4571679030,4571679031,1,1391,1409,-10
4573032722,4573032724,2,1231,1366,-10
4573667285,4573667286,1,1454,1328,-10
4577432802,4577432802,0,2248,1776,-10
4579160014,4579160015,1,1206,1011,-10
4579411364,4579411359,-5,1460,3098,-10
4582865107,4582865107,0,880,1027,-10
4582900043,4582900043,0,1266,856,-10
4583085751,4583085729,-22,1345,1298,-10
4587648506,4587648509,3,1176,873,-10
4599008680,4599008680,0,1449,1416,-10
4600741110,4600741113,3,2004,2434,-10
4601935141,4601935143,2,1567,1440,-10
4602616215,4602616221,6,3021,1696,-10
4604648663,4604648667,4,1568,1058,-10
4607079826,4607079828,2,1814,1634,-10
4607497193,4607497195,2,1562,1015,-10
4610707241,4610707246,5,1424,1072,-10
4611692782,4611692781,-1,1315,1601,-10
4612224366,4612224352,-14,1011,583,-10
4613833649,4613833650,1,1847,2417,-10
4613929709,4613929706,-3,746,4051,-10
4617303839,4617303841,2,1746,2422,-10
4617745434,4617745436,2,1334,1526,-10
4620287410,4620287413,3,2185,1608,-10
4625112424,4625112425,1,1418,1827,-10
4625917875,4625917879,4,1415,1305,-10
4627803902,4627803905,3,1629,1370,-10
4628206983,4628206986,3,1015,1297,-10
4630389821,4630389823,2,2648,1961,-10
4630486346,4630486348,2,1722,1566,-10
4631822984,4631822981,-3,1052,2258,-10
4638354294,4638354297,3,1607,1536,-10
4638466395,4638466395,0,1360,2558,-10
4638547397,4638547398,1,1879,1041,-10
4639776744,4639776744,0,1600,1521,-10
4643928191,4643928193,2,1546,1926,-10
4646437206,4646437207,1,1535,1471,-10
4652831102,4652831102,0,1295,1819,-10
4658333897,4658333898,1,1247,1795,-10
4658489060,4658489061,1,1810,1531,-10
4659361605,4659361606,1,1691,2170,-10
4664044978,4664044983,5,2072,2254,-10
4665957366,4665957367,1,1935,1557,-10
4668065364,4668065345,-19,2137,1382,-10
4668445512,4668445511,-1,1340,1593,-10
4669085471,4669085471,0,750,822,-10
4671155994,4671155995,1,1416,1545,-10
4672947173,4672947175,2,4287,3011,-10
4673789251,4673789250,-1,943,1716,-10
4675355011,4675354991,-20,1545,1356,-10
4675934098,4675934098,0,1612,1904,-10
4678058270,4678058270,0,1534,2160,-10
4681125386,4681125386,0,1948,1748,-10
4684336748,4684336731,-17,1138,808,-10
4687186614,4687186616,2,1585,699,-10
4693617011,4693617010,-1,967,1628,-10
4694507883,4694507884,1,1924,1865,-10
4695165459,4695165461,2,1342,1423,-10
4695223434,4695223436,2,1879,1544,-10
4696284680,4696284685,5,1150,1033,-10
4696715915,4696715906,-9,996,4918,-10
4697088025,4697088026,1,1082,899,-10
4699526802,4699526806,4,1446,1846,-10
4699636407,4699636410,3,2078,1983,-10
4700537903,4700537902,-1,1578,1610,-10
4700718898,4700718901,3,1801,1470,-10
4704236775,4704236777,2,2006,1667,-10
4707189232,4707189233,1,1342,1812,-10
4708370854,4708370856,2,1679,1651,-10
4708573324,4708573326,2,2088,1527,-10
4708995047,4708995050,3,1255,1309,-10
4709580398,4709580401,3,2282,1924,-10
4709635885,4709635884,-1,1622,1355,-10
4712040286,4712040290,4,1637,1171,-10
4712808400,4712808400,0,3562,4196,-10
4713145273,4713145274,1,1752,1562,-10
4714179178,4714179180,2,1341,1909,-10
4715606604,4715606608,4,1628,1239,-10
4719656817,4719656819,2,1632,1130,-10
4720192642,4720192645,3,1496,1725,-10
4725037360,4725037362,2,1782,1923,-10
4729302671,4729302674,3,1103,1549,-10
4729694803,4729694805,2,1653,1953,-10
4731989297,4731989298,1,1700,1898,-10
4732211053,4732211055,2,1491,1196,-10
4734033422,4734033424,2,1430,931,-10
4735938290,4735938290,0,1938,2378,-10
4740668615,4740668620,5,1850,1602,-10
4740830303,4740830306,3,1275,1156,-10
4741714230,4741714229,-1,1121,1339,-10
4743676447,4743676446,-1,1170,1486,-10
4745434676,4745434677,1,1729,1686,-10
4749972046,4749972049,3,2367,2384,-10
4750041082,4750041083,1,1824,1677,-10
4750080066,4750080068,2,1941,1974,-10
4750556386,4750556391,5,2013,1537,-10
4752381654,4752381658,4,1733,1503,-10
4752738332,4752738334,2,2148,2012,-10
4755746484,4755746486,2,2325,1963,-10
4760773695,4760773694,-1,1651,1239,-10
4764195935,4764195937,2,1233,1216,-10
4766752561,4766752562,1,1430,1489,-10
4769111895,4769111898,3,1988,1974,-10
4769733666,4769733666,0,1052,1404,-10
4770402255,4770402258,3,1533,1536,-10
4772494265,4772494266,1,1668,1476,-10
4774779414,4774779418,4,1532,1337,-10
4777349985,4777349980,-5,1066,4131,-10
4777591651,4777591654,3,2047,1375,-10
4779774180,4779774182,2,2282,1617,-10
4781178846,4781178847,1,1954,2004,-10
4783216190,4783216191,1,1771,1701,-10
4784736498,4784736498,0,1574,1494,-10
4785325078,4785325082,4,1260,621,-10
4786195299,4786195302,3,1334,1307,-10
4787812634,4787812638,4,1356,1356,-10
4793558526,4793558528,2,2287,1687,-10
4794071153,4794071154,1,2055,1392,-10
4797042122,4797042123,1,1244,1381,-10
4797681714,4797681719,5,5354,1938,-10
4798344918,4798344921,3,1203,1561,-10
4798611243,4798611242,-1,935,1081,-10
4799037225,4799037229,4,818,845,-10
4799897011,4799897015,4,2257,1580,-10
4803168671,4803168674,3,1690,1268,-10
4803593017,4803593018,1,1337,1348,-10
4807401301,4807401304,3,1204,1069,-10
4809820047,4809820047,0,1205,1468,-10
4810137288,4810137293,5,1799,1502,-10
4818660903,4818660905,2,1385,1140,-10
4820646942,4820646944,2,1137,1137,-10
4823065842,4823065840,-2,1354,1639,-10
4824306318,4824306320,2,1129,1557,-10
4825031025,4825031027,2,1269,1055,-10
4825629693,4825629698,5,1196,1323,-10
4826606950,4826606949,-1,1844,1477,-10
4826845736,4826845737,1,1256,1235,-10
4827578686,4827578686,0,1541,1510,-10
4827660318,4827660313,-5,917,3878,-10
4828161167,4828161169,2,1800,1768,-10
4828398887,4828398889,2,1662,1701,-10
4828819910,4828819910,0,1255,1480,-10
4829899781,4829899781,0,1767,2265,-10
4830888342,4830888345,3,1342,1827,-10
4845524623,4845524626,3,1437,1195,-10
4845835930,4845835930,0,1214,1913,-10
4849823709,4849823710,1,1806,2066,-10
4851212807,4851212809,2,1575,1609,-10
4852490229,4852490231,2,1860,1572,-10
4852539238,4852539240,2,1017,1112,-10
4852686258,4852686261,3,1579,1905,-10
4854828165,4854828167,2,1986,1648,-10
4856777943,4856777946,3,994,1283,-10
4858208455,4858208457,2,1378,1533,-10
4858325629,4858325631,2,1828,1702,-10
4858967869,4858967871,2,1915,1759,-10
4860020889,4860020892,3,3792,3090,-10
4860187693,4860187694,1,1328,1460,-10
4861213162,4861213165,3,1431,1502,-10
4864260213,4864260214,1,1348,1319,-10
4865249137,4865249139,2,1250,1380,-10
4871302314,4871302318,4,2009,1599,-10
4872761774,4872761773,-1,1789,1343,-10
4873024470,4873024470,0,1322,1803,-10
4873680821,4873680824,3,1846,1669,-10
4877347290,4877347289,-1,791,1014,-10
4879128341,4879128323,-18,1177,1152,-10
4880575282,4880575289,7,4246,1678,-10
4881079362,4881079362,0,1942,1642,-10
4882272123,4882272123,0,988,1130,-10
4885183840,4885183841,1,1828,2066,-10
4891568242,4891568242,0,737,892,-10
4893122877,4893122878,1,1526,1239,-10
4894615242,4894615242,0,1120,1491,-10
4895928082,4895928085,3,1767,1957,-10
4896420576,4896420581,5,1664,1488,-10
4897955947,4897955949,2,1600,1578,-10
4899679850,4899679853,3,2311,1531,-10
4901756741,4901756741,0,1690,2723,-10
4904566929,4904566931,2,1216,998,-10
4908184577,4908184578,1,1286,1636,-10
4908902595,4908902597,2,2061,1630,-10
4912128418,4912128419,1,2136,1591,-10
4916054050,4916054049,-1,1434,1262,-10
4920923774,4920923775,1,1787,2387,-10
4921551584,4921551586,2,1814,1080,-10
4922286308,4922286308,0,3338,4337,-10
4922912346,4922912345,-1,1256,1680,-10
4923630742,4923630742,0,1809,1482,-10
4929865017,4929865018,1,1282,1482,-10
4933525283,4933525287,4,1563,1267,-10
4935336020,4935336022,2,1249,835,-10
4935426092,4935426094,2,1673,2377,-10
4937565188,4937565189,1,1686,1571,-10
4942039306,4942039306,0,1310,1423,-10
4942446043,4942446042,-1,1221,1412,-10
4943777247,4943777248,1,2151,1613,-10
4944464654,4944464654,0,1817,1336,-10
4947977965,4947977965,0,995,1477,-10
4949234770,4949234770,0,1599,1609,-10
4950130833,4950130834,1,1304,1839,-10
4951600641,4951600644,3,1678,1738,-10
4953571497,4953571501,4,1423,1389,-10
4954806450,4954806450,0,1218,1522,-10
4956399974,4956399974,0,1210,1730,-10
4958024377,4958024378,1,1860,1814,-10
4958077930,4958077931,1,1025,1278,-10
4959196309,4959196310,1,1611,1767,-10
4959751810,4959751814,4,1532,1292,-10
4960366975,4960366975,0,9253,11069,-10
4961268707,4961268710,3,1699,1767,-10
4961619770,4961619774,4,2283,1371,-10
4962967110,4962967113,3,1104,1054,-10
4965262034,4965262034,0,1282,1514,-10
4967343398,4967343401,3,1867,2069,-10
4969400967,4969400969,2,1317,1279,-10
4970297185,4970297186,1,1580,1264,-10
4970599958,4970599960,2,1846,1834,-10
4972737463,4972737467,4,1300,1740,-10
4974294611,4974294614,3,1447,1253,-10
4974736814,4974736815,1,2334,1841,-10
4979189892,4979189893,1,1758,2026,-10
4981805718,4981805722,4,2699,1277,-10
4985698058,4985698064,6,1380,1286,-10
4986375159,4986375163,4,1739,1391,-10
4990816114,4990816116,2,2080,2344,-10
4991750704,4991750706,2,2151,1969,-10
4992713590,4992713592,2,1468,1743,-10
4992922898,4992922900,2,979,1232,-10
4994127637,4994127640,3,1950,1177,-10
4995025294,4995025293,-1,1696,1350,-10
4995772968,4995772973,5,2730,1377,-10
4996771083,4996771083,0,1017,1631,-10
4999540670,4999540675,5,1656,1239,-10
5001555720,5001555719,-1,1751,1572,-10
5003967962,5003967963,1,1294,1587,-10
5005998989,5005998987,-2,815,1584,-10
5006277385,5006277407,22,983,1222,-10
5008109930,5008109908,-22,752,712,-10
5010081223,5010081226,3,759,1480,-10
5011122659,5011122662,3,1548,1282,-10
5011409445,5011409446,1,1604,1475,-10
5013859693,5013859693,0,1759,1794,-10
5013965123,5013965121,-2,777,1754,-10
5015006166,5015006167,1,1548,2492,-10
5016954102,5016954104,2,1120,1520,-10
5018625078,5018625079,1,1374,1491,-10
5021146337,5021146338,1,1316,1701,-10
5022449784,5022449786,2,1636,1662,-10
5024724878,5024724879,1,1187,1407,-10
5026883726,5026883708,-18,1921,1553,-10
5028683299,5028683300,1,1400,1862,-10
5038582514,5038582515,1,1852,2153,-10
5039333798,5039333799,1,1576,1582,-10
5042217734,5042217735,1,1251,1579,-10
5042776222,5042776223,1,1658,1614,-10
5044177852,5044177854,2,1680,1575,-10
5045101555,5045101537,-18,1954,1734,-10
5045379674,5045379678,4,1601,1299,-10
5047123940,5047123942,2,1638,1813,-10
5047186346,5047186350,4,1350,1375,-10
5048604637,5048604643,6,1704,1044,-10
5051900416,5051900416,0,998,1014,-10
5054366092,5054366094,2,2279,1256,-10
5054667912,5054667914,2,1528,1746,-10
5055005697,5055005692,-5,2256,6750,-10
5058051333,5058051335,2,1921,1190,-10
5061356811,5061356814,3,1536,1539,-10
5061489505,5061489506,1,1951,1467,-10
5062434706,5062434707,1,1271,1318,-10
5062543635,5062543631,-4,1811,1122,-10
5065711624,5065711622,-2,639,825,-10
5069503271,5069503274,3,1798,2098,-10
5073633384,5073633366,-18,1784,989,-10
5076183078,5076183082,4,2855,886,-10
5076386694,5076386675,-19,669,388,-10
5076772211,5076772213,2,1713,1485,-10
5079322109,5079322113,4,1507,1826,-10
5082957730,5082957730,0,1233,1761,-10
5085360202,5085360206,4,2409,1639,-10
5088524583,5088524585,2,1187,1497,-10
5090879680,5090879682,2,2049,1723,-10
5092828843,5092828843,0,1157,1440,-10
5095454732,5095454750,18,1530,1318,-10
5095566878,5095566898,20,1820,1490,-10
5099769005,5099769007,2,2195,1720,-10
5099824810,5099824813,3,1847,1856,-10
5100014734,5100014737,3,1397,1036,-10
5105749459,5105749462,3,1519,1378,-10
5106819551,5106819550,-1,929,1277,-10
5107095857,5107095847,-10,1382,854,-10
5107892858,5107892860,2,1663,1776,-10
5109109707,5109109711,4,1699,1627,-10
5110383709,5110383710,1,2154,1501,-10
5110641869,5110641869,0,1759,1382,-10
5111179130,5111179138,8,1782,1172,-10
5114160501,5114160503,2,1094,1004,-10
5115443809,5115443810,1,1377,1441,-10
5115937507,5115937507,0,871,1268,-10
5118032759,5118032762,3,2365,2133,-10
5121419494,5121419498,4,1772,948,-10
5122944359,5122944362,3,1307,1212,-10
5123794194,5123794178,-16,713,449,-10
5123941913,5123941928,15,324,586,-10
5124972970,5124972972,2,1426,1198,-10
5124998929,5124998930,1,1109,1007,-10
5125620277,5125620278,1,1476,1322,-10
5126188977,5126188966,-11,1271,1218,-10
5131348178,5131348180,2,1318,1278,-10
5133105761,5133105763,2,1399,1473,-10
5136239277,5136239279,2,1905,1328,-10
5136623053,5136623055,2,1360,1544,-10
5137552878,5137552878,0,1538,1685,-10
5138891435,5138891417,-18,942,787,-10
5142779628,5142779620,-8,1370,1674,-10
5143945208,5143945210,2,807,994,-10
5145065259,5145065264,5,2083,1060,-10
5147592445,5147592448,3,1860,1855,-10
5148258674,5148258677,3,1533,1340,-10
5156891422,5156891423,1,628,1046,-10
5158758277,5158758281,4,1237,1627,-10
5159333292,5159333296,4,3753,2603,-10
5161625658,5161625658,0,1741,1534,-10
5161662067,5161662069,2,1486,1355,-10
5162983233,5162983239,6,1118,687,-10
5166293441,5166293442,1,1992,1887,-10
5166644391,5166644393,2,1325,1393,-10
5166895995,5166895998,3,2002,921,-10
5168335138,5168335139,1,1292,1504,-10
5171536475,5171536475,0,1939,2629,-10
5171763551,5171763552,1,1416,1739,-10
5172214825,5172214827,2,1863,2270,-10
5175511177,5175511184,7,2864,1285,-10
5176854894,5176854898,4,1855,1433,-10
5177418307,5177418309,2,1558,2064,-10
5177631710,5177631692,-18,1117,1223,-10
5178713523,5178713523,0,1392,1488,-10
5181970717,5181970719,2,1963,1898,-10
5182977867,5182977868,1,1725,1475,-10
5183768806,5183768827,21,490,661,-10
5188057423,5188057428,5,1627,1492,-10
5193157328,5193157330,2,1604,1751,-10
5193549366,5193549367,1,1693,1337,-10
5195351338,5195351339,1,1510,1377,-10
5199234481,5199234482,1,1704,1666,-10
5201552786,5201552787,1,1579,2092,-10
5203965917,5203965919,2,1111,1479,-10
5207118882,5207118883,1,1636,1922,-10
5210037654,5210037654,0,2026,1492,-10
5211921290,5211921291,1,1422,989,-10
5214020147,5214020150,3,1107,1451,-10
5214074057,5214074058,1,1242,1480,-10
5214156404,5214156410,6,2631,1232,-10
5214570897,5214570902,5,1922,1476,-10
5214807898,5214807901,3,2279,1636,-10
5215757010,5215757011,1,1926,1828,-10
5216528796,5216528810,14,1298,3911,-10
5216625522,5216625525,3,1869,1685,-10
5218681345,5218681341,-4,2486,6198,-10
5224673758,5224673759,1,813,1344,-10
5224922123,5224922125,2,1338,1198,-10
5230788662,5230788662,0,1320,1229,-10
5231607487,5231607489,2,1238,1523,-10
5232907546,5232907547,1,1945,1456,-10
5234625474,5234625474,0,1107,933,-10
5238811002,5238811003,1,1751,1803,-10
5240495526,5240495527,1,1420,1538,-10
5241793641,5241793642,1,1054,631,-10
5242792090,5242792091,1,1955,1696,-10
5246139970,5246139974,4,1538,1491,-10
5246925553,5246925556,3,1928,2060,-10
5248610964,5248610967,3,1536,1539,-10
5251202022,5251202028,6,2264,1449,-10
5254157949,5254157951,2,1813,1449,-10
5255652768,5255652770,2,1412,1629,-10
5259808305,5259808307,2,1452,1403,-10
5262495022,5262495024,2,1807,1741,-10
5263442302,5263442308,6,2836,1360,-10
5265122230,5265122232,2,1697,1803,-10
5268569321,5268569321,0,1431,1658,-10
5268713369,5268713371,2,1575,1768,-10
5270599043,5270599045,2,1623,1732,-10
5270944098,5270944098,0,1502,1264,-10
5278275643,5278275646,3,1960,1222,-10
5283013892,5283013894,2,1365,1783,-10
5285072051,5285072057,6,2259,1182,-10
5285590148,5285590157,9,10330,39933,-10
5286933034,5286933037,3,1628,1504,-10
5288078156,5288078158,2,1403,1460,-10
5289437914,5289437915,1,2078,1893,-10
5293034717,5293034718,1,1802,1873,-10
5294150306,5294150309,3,1619,1728,-10
5299741112,5299741114,2,1667,1234,-10
5300798123,5300798123,0,1091,1328,-10
5305215729,5305215731,2,1817,1536,-10
5305586273,5305586274,1,1613,1869,-10
5305678610,5305678609,-1,1473,2507,-10
5310973948,5310973950,2,1734,1549,-10
5311028506,5311028510,4,1901,1303,-10
5314036409,5314036417,8,13474,27256,-10
5314721622,5314721622,0,1663,1836,-10
5314977262,5314977264,2,2132,1905,-10
5316417858,5316417861,3,2241,1765,-10
5317004622,5317004625,3,1520,1563,-10
5318901718,5318901723,5,1559,1220,-10
5325166606,5325166609,3,1586,1419,-10
5325471680,5325471674,-6,1038,5538,-10
5326911934,5326911936,2,1552,1559,-10
5328355725,5328355727,2,1301,1744,-10
5329820637,5329820638,1,1572,1063,-10
5330873638,5330873637,-1,1331,1327,-10
5331026548,5331026553,5,1581,1409,-10
5331957010,5331957010,0,1558,1537,-10
5333355346,5333355354,8,3304,1233,-10
5334872182,5334872185,3,2077,1351,-10
5336422716,5336422720,4,1576,993,-10
5337541702,5337541703,1,2273,1915,-10
5337729573,5337729575,2,1624,1649,-10
5342951744,5342951745,1,959,1480,-10
5345185690,5345185695,5,1545,1354,-10
5346149893,5346149895,2,1858,1484,-10
5346352122,5346352124,2,1347,1713,-10
5346888359,5346888362,3,1836,1912,-10
5349806837,5349806838,1,2099,2449,-10
5354789927,5354789930,3,1782,1686,-10
5354869539,5354869537,-2,1318,1710,-10
5356128636,5356128637,1,1673,1419,-10
5356809920,5356809922,2,1208,1265,-10
5358065429,5358065430,1,1516,1757,-10
5358523682,5358523686,4,1350,1168,-10
5361376665,5361376666,1,1312,1132,-10
5363833406,5363833408,2,1928,1516,-10
5365308611,5365308613,2,2384,2156,-10
5366803446,5366803448,2,1539,1483,-10
5367014517,5367014521,4,1690,1188,-10
5367532345,5367532346,1,1780,1444,-10
5367812895,5367812899,4,1412,1228,-10
5367989134,5367989134,0,1383,1622,-10
5368952675,5368952676,1,1786,1458,-10
5369130610,5369130615,5,2370,1025,-10
5375213910,5375213910,0,1861,1894,-10
5376245748,5376245750,2,1525,1696,-10
5378713957,5378713955,-2,878,1294,-10
5382684498,5382684499,1,1259,1488,-10
5383567108,5383567109,1,1347,1561,-10
5388675629,5388675630,1,1698,2187,-10
5391184358,5391184359,1,1201,1433,-10
5402428203,5402428203,0,1699,1247,-10
5405113831,5405113832,1,1632,1707,-10
5407052800,5407052819,19,2254,1825,-10
5410479271,5410479275,4,1123,1528,-10
5411346739,5411346735,-4,19815,12713,-10
5416111166,5416111170,4,1422,1261,-10
5418186718,5418186719,1,1553,1649,-10
5422159654,5422159654,0,981,1110,-10
5424031303,5424031302,-1,903,2446,-10
5425562222,5425562223,1,1863,1204,-10
5426647109,5426647111,2,2148,2140,-10
5429613324,5429613323,-1,1160,1330,-10
5430948309,5430948311,2,1621,1404,-10
5431555734,5431555738,4,1469,1201,-10
5431755333,5431755336,3,1693,2603,-10
5435207025,5435207026,1,2052,1543,-10
5435983662,5435983664,2,1603,1113,-10
5436377435,5436377438,3,1320,1170,-10
5439761080,5439761081,1,1913,1643,-10
5439811675,5439811683,8,4031,1634,-10
5442443385,5442443364,-21,1203,911,-10
5445183134,5445183135,1,1405,1155,-10
5445560241,5445560258,17,634,2124,-10
5446487599,5446487598,-1,2216,1670,-10
5448874997,5448875001,4,1636,1519,-10
5451297150,5451297150,0,1461,1169,-10
5453915083,5453915087,4,1152,1633,-10
5454387406,5454387405,-1,1875,2320,-10
5455556417,5455556419,2,2389,1900,-10
5456067061,5456067064,3,2038,1298,-10
5456174756,5456174754,-2,1136,1424,-10
5457819282,5457819283,1,1906,2035,-10
5460220084,5460220086,2,1243,1332,-10
5462241531,5462241532,1,1318,2091,-10
5464048290,5464048297,7,3031,1285,-10
5467944942,5467944943,1,2152,1879,-10
5471094394,5471094394,0,1497,1429,-10
5471154328,5471154329,1,1344,1757,-10
5471645235,5471645237,2,833,1090,-10
5472259386,5472259393,7,2917,1664,-10
5473791294,5473791295,1,1896,1502,-10
5478593502,5478593504,2,1499,1265,-10
5480544934,5480544937,3,1350,1941,-10
5480707050,5480707051,1,1922,1171,-10
5484753998,5484753999,1,1489,1358,-10
5486036935,5486036944,9,11679,27806,-10
5486287370,5486287372,2,1457,1685,-10
5488771844,5488771847,3,1741,1610,-10
5491926566,5491926568,2,1391,1416,-10
5498412582,5498412583,1,1134,1593,-10
5498835489,5498835491,2,1983,1696,-10
5500543529,5500543530,1,1331,1497,-10
5500589779,5500589757,-22,1740,1450,-10
5504041758,5504041759,1,1262,1943,-10
5509820532,5509820534,2,1554,1322,-10
5513010110,5513010110,0,1239,2209,-10
5513254374,5513254375,1,1341,1747,-10
5513903355,5513903358,3,188,1944,-10
5518163525,5518163528,3,1725,1581,-10
5518806455,5518806455,0,1537,2157,-10
5523779695,5523779695,0,1161,1183,-10
5524386438,5524386438,0,1610,2589,-10
5530232947,5530232950,3,2781,1991,-10
5531526698,5531526699,1,1755,2066,-10
5534562070,5534562072,2,1138,1230,-10
5536443630,5536443634,4,1035,923,-10
5537582079,5537582078,-1,1124,2130,-10
5544007085,5544007088,3,1669,1845,-10
5552856737,5552856738,1,1232,1312,-10
5554601848,5554601850,2,1769,1346,-10
5555170384,5555170386,2,1930,1411,-10
5556345144,5556345145,1,2049,1649,-10
5562238900,5562238903,3,1959,1641,-10
5563187329,5563187330,1,1754,1815,-10
5565084321,5565084315,-6,1207,3831,-10
5567904134,5567904132,-2,1327,1056,-10
5568671912,5568671914,2,1480,1673,-10
5570134120,5570134123,3,1500,1136,-10
5574005454,5574005454,0,19011,25640,-10
5576758562,5576758566,4,1017,1278,-10
5578026445,5578026445,0,1349,905,-10
5581569667,5581569671,4,1313,1311,-10
5581681562,5581681562,0,1173,1020,-10
5585016031,5585016033,2,1841,1062,-10
5586171318,5586171319,1,1074,1154,-10
5587502518,5587502520,2,1350,1489,-10
5587708208,5587708210,2,1136,1420,-10
5589796827,5589796830,3,2025,1501,-10
5590051091,5590051085,-6,1474,6783,-10
5590546394,5590546395,1,1403,1937,-10
5591639595,5591639597,2,1446,1528,-10
5593600123,5593600123,0,984,1063,-10
5594434226,5594434226,0,1793,1620,-10
5599409894,5599409896,2,2016,1239,-10
5601019634,5601019634,0,1159,1789,-10
5606233766,5606233767,1,1448,1539,-10
5607759962,5607759963,1,1342,1993,-10
5608809926,5608809931,5,1103,1047,-10
5609230653,5609230655,2,1993,1901,-10
5611274865,5611274866,1,1389,1343,-10
5613469606,5613469606,0,1798,2551,-10
5614587189,5614587189,0,1042,2237,-10
5614979061,5614979061,0,1417,1739,-10
5615051995,5615051993,-2,945,1427,-10
5615667651,5615667650,-1,948,2659,-10
5616401390,5616401393,3,1516,1450,-10
5618994151,5618994148,-3,1363,2955,-10
5619052754,5619052757,3,2035,1434,-10
5620105156,5620105158,2,1849,2408,-10
5621528769,5621528770,1,30175,32246,-10
5623259123,5623259119,-4,1470,1653,-10
5623484542,5623484545,3,1826,1205,-10
5625349798,5625349799,1,1352,991,-10
5627470411,5627470415,4,2204,1684,-10
5629245791,5629245794,3,1283,1689,-10
5630489977,5630489977,0,2762,3232,-10
5633493129,5633493130,1,1072,1343,-10
5634079193,5634079194,1,2162,2154,-10
5634622129,5634622131,2,2043,2003,-10
5635967835,5635967841,6,5467,2767,-10
5636693113,5636693115,2,1587,984,-10
5645312465,5645312466,1,759,1088,-10
5646894303,5646894302,-1,1129,2108,-10
5650681948,5650681951,3,1453,1106,-10
5650712697,5650712698,1,1618,1610,-10
5651886817,5651886817,0,1389,1570,-10
5657601331,5657601333,2,882,936,-10
5658519375,5658519375,0,1668,1742,-10
5659488612,5659488617,5,21491,17980,-10
5659787926,5659787926,0,1827,2225,-10
5659820522,5659820525,3,1605,1647,-10
5660264559,5660264558,-1,1538,1505,-10
5662437006,5662437008,2,1641,1764,-10
5665396079,5665396079,0,1836,1613,-10
5666030038,5666030042,4,1977,1779,-10
5667226008,5667226010,2,1490,1512,-10
5667562914,5667562914,0,1169,1550,-10
5670397251,5670397253,2,1192,1483,-10
5671348906,5671348905,-1,1226,1798,-10
5675285618,5675285619,1,1050,1201,-10
5675730206,5675730211,5,11111,21728,-10
5675948602,5675948605,3,1643,1694,-10
5679934667,5679934687,20,1197,1392,-10
5681707255,5681707258,3,1751,1504,-10
5682941225,5682941243,18,1339,880,-10
5683027294,5683027295,1,1503,1448,-10
5687275519,5687275521,2,1079,771,-10
5688138754,5688138757,3,932,1278,-10
5689003663,5689003643,-20,1321,1468,-10
5689110150,5689110151,1,1953,2117,-10
5689536793,5689536793,0,1717,1256,-10
5691506490,5691506494,4,1595,1552,-10
5695022738,5695022738,0,1382,1572,-10
5696057322,5696057321,-1,1692,1849,-10
5696756178,5696756182,4,1670,1661,-10
5699398831,5699398833,2,1640,1708,-10
5702118383,5702118383,0,1874,1975,-10
5702624526,5702624528,2,1670,1531,-10
5706321406,5706321408,2,1281,1557,-10
5706489402,5706489400,-2,1644,2554,-10
5708715370,5708715369,-1,846,1034,-10
5710037058,5710037059,1,963,1357,-10
5714584450,5714584453,3,1793,1247,-10
5716632670,5716632674,4,1524,1170,-10
5721432586,5721432592,6,1390,1074,-10
5721734494,5721734494,0,1702,1984,-10
5723692505,5723692506,1,1365,1775,-10
5732016241,5732016239,-2,1362,1872,-10
5732619225,5732619227,2,1525,1746,-10
5733018717,5733018718,1,1176,1643,-10
5735122429,5735122431,2,2157,1604,-10
5739647383,5739647385,2,1540,1344,-10
5740454775,5740454778,3,30460,21198,-10
5740811286,5740811286,0,1515,1896,-10
5741609489,5741609491,2,1568,1050,-10
5741925043,5741925046,3,935,1150,-10
5742568121,5742568119,-2,1376,1200,-10
5743720477,5743720484,7,10185,29871,-10
5748148737,5748148737,0,1250,1860,-10
5749623801,5749623803,2,1699,1546,-10
5750616843,5750616843,0,871,1174,-10
5750937901,5750937906,5,1683,759,-10
5752589299,5752589300,1,1156,984,-10
5752943462,5752943462,0,1609,1424,-10
5753488759,5753488760,1,1638,1021,-10
5756237801,5756237805,4,2171,1444,-10
5756362342,5756362348,6,1389,1263,-10
5757496977,5757496979,2,1700,1275,-10
5759060514,5759060521,7,9490,31968,-10
5761379182,5761379185,3,1542,1210,-10
5764342687,5764342689,2,1427,1209,-10
5766541910,5766541911,1,2044,2146,-10
5768536530,5768536534,4,1625,1303,-10
5770444587,5770444588,1,827,1473,-10
5771001009,5771001013,4,1572,1468,-10
5775432470,5775432471,1,1258,1413,-10
5776566297,5776566299,2,1475,1498,-10
5777092577,5777092580,3,1365,1687,-10
5777603560,5777603562,2,1688,1474,-10
5778236543,5778236545,2,1337,1988,-10
5778815131,5778815130,-1,1113,1668,-10
5779380985,5779380988,3,1293,1578,-10
5780174409,5780174410,1,1911,1586,-10
5785702148,5785702150,2,1445,1400,-10
5793507815,5793507818,3,1438,1546,-10
5798137353,5798137353,0,1461,989,-10
5799171977,5799171978,1,2199,1381,-10
5800191846,5800191848,2,2155,2038,-10
5800707314,5800707314,0,1431,2243,-10
5801184270,5801184270,0,1572,1566,-10
5802281826,5802281829,3,1274,1448,-10
5802354094,5802354097,3,1704,2169,-10
5805962493,5805962495,2,2004,1798,-10
5806492321,5806492324,3,1201,1023,-10
5810726683,5810726687,4,2277,1975,-10
5811766246,5811766246,0,1057,1673,-10
5812917581,5812917582,1,1942,2288,-10
5821431650,5821431651,1,1172,1397,-10
5822157649,5822157649,0,1537,1655,-10
5824786995,5824786981,-14,1562,1300,-10
5826036833,5826036835,2,2485,1602,-10
5826496257,5826496262,5,1523,1497,-10
5829851815,5829851816,1,1803,1951,-10
5830671738,5830671741,3,1751,1073,-10
5841709901,5841709903,2,1489,1120,-10
5842548633,5842548635,2,2554,1767,-10
5842587715,5842587717,2,1506,1212,-10
5843689011,5843689011,0,1335,1304,-10
5848972995,5848972997,2,2246,1656,-10
5849753501,5849753503,2,1577,1512,-10
5854817790,5854817790,0,1148,1196,-10
5856702922,5856702927,5,1512,1084,-10
5857712797,5857712799,2,1359,1495,-10
5857918017,5857918020,3,1715,1496,-10
5862169701,5862169703,2,2503,1712,-10
5863846754,5863846760,6,3093,1299,-10
5876144326,5876144327,1,1764,1490,-10
5876981201,5876981203,2,1162,1250,-10
5877593526,5877593527,1,1102,1437,-10
5882769003,5882768998,-5,724,2889,-10
5883686855,5883686857,2,2116,1588,-10
5886697779,5886697781,2,1474,1818,-10
5888035222,5888035223,1,1291,2130,-10
5888784614,5888784615,1,887,1318,-10
5889287386,5889287387,1,690,800,-10
5890565526,5890565528,2,1222,1590,-10
5890928121,5890928124,3,1513,1655,-10
5892367862,5892367865,3,1988,1455,-10
5897621177,5897621178,1,2012,1310,-10
5902595027,5902595026,-1,1193,1373,-10
5903821818,5903821815,-3,777,2026,-10
5905746146,5905746149,3,1348,1534,-10
5905906707,5905906711,4,1099,1128,-10
5907756179,5907756169,-10,32250,15108,-10
5912117230,5912117234,4,1035,1126,-10
5915803944,5915803946,2,1177,1439,-10
5917147013,5917147014,1,1561,1788,-10
5917332255,5917332258,3,1451,1543,-10
5917593948,5917593950,2,1739,1923,-10
5918073660,5918073663,3,1624,1475,-10
5920236516,5920236509,-7,32028,13625,-10
5920646293,5920646295,2,1773,1273,-10
5920875446,5920875442,-4,1532,1869,-10
5922475769,5922475771,2,1387,1696,-10
5926857258,5926857262,4,1769,1087,-10
5933337455,5933337455,0,1688,1343,-10
5933692853,5933692846,-7,984,3202,-10
5935208698,5935208715,17,378,686,-10
5936413205,5936413206,1,1760,2287,-10
5937609562,5937609565,3,1672,1280,-10
5939115398,5939115401,3,1411,1212,-10
5939889730,5939889735,5,1415,1301,-10
5940591227,5940591216,-11,1516,1246,-10
5940859428,5940859417,-11,1272,1276,-10
5941498051,5941498053,2,2057,1651,-10
5947368668,5947368670,2,2053,2102,-10
5950134762,5950134767,5,1628,827,-10
5951199073,5951199090,17,2457,1184,-10
5957119490,5957119494,4,2569,2571,-10
5958478091,5958478094,3,1423,1651,-10
5959060852,5959060853,1,1247,1005,-10
5960290134,5960290136,2,1071,2431,-10
5960962851,5960962853,2,1264,2019,-10
5971064091,5971064090,-1,1147,1005,-10
5971935397,5971935398,1,1563,1561,-10
5973358543,5973358537,-6,1014,3580,-10
5977668993,5977668997,4,850,885,-10
5979141958,5979141959,1,1682,1199,-10
5982245326,5982245326,0,1881,2226,-10
5984093481,5984093481,0,1400,1666,-10
5984159899,5984159895,-4,1005,2291,-10
5987175099,5987175101,2,1972,1279,-10
5991248888,5991248886,-2,1408,1470,-10
5995125074,5995125075,1,1706,1377,-10
5997158727,5997158724,-3,1343,1315,-10
5999861482,5999861482,0,1810,1963,-10
6003163485,6003163487,2,1233,1315,-10
6003449105,6003449107,2,2854,1967,-10
6003584142,6003584142,0,1613,1803,-10
6003846191,6003846187,-4,877,1690,-10
6005760772,6005760774,2,1471,1278,-10
6009897049,6009897050,1,1720,1788,-10
6010616344,6010616346,2,1777,1763,-10
6010786386,6010786400,14,21,18,-10
6011015058,6011015059,1,940,1404,-10
6012282661,6012282662,1,1658,1701,-10
6014152238,6014152239,1,1704,1523,-10
6014648178,6014648179,1,1735,1785,-10
6017581326,6017581327,1,833,718,-10
6018271505,6018271506,1,1403,1186,-10
6020609818,6020609819,1,1171,1565,-10
6021188360,6021188362,2,1227,1101,-10
6021620674,6021620673,-1,1510,1976,-10
6022071479,6022071482,3,1565,1798,-10
6022114926,6022114927,1,2270,2898,-10
6022358741,6022358742,1,1207,1655,-10
6029497067,6029497070,3,1754,1249,-10
6030152478,6030152480,2,1646,1722,-10
6030794392,6030794397,5,2213,1354,-10
6031712898,6031712899,1,1908,1864,-10
6032968119,6032968122,3,1096,1160,-10
6034265442,6034265443,1,1357,1675,-10
6036219996,6036219998,2,1750,1305,-10
6036851451,6036851458,7,1361,1178,-10
6048474696,6048474697,1,1781,1681,-10
6057912752,6057912754,2,1236,1438,-10
6058846690,6058846693,3,1405,1000,-10
6061985423,6061985424,1,1624,1464,-10
6065611531,6065611526,-5,451,2057,-10
6069359641,6069359646,5,1244,1299,-10
6075590707,6075590707,0,2168,1535,-10
6076856755,6076856757,2,1857,1612,-10
6080907147,6080907149,2,1418,1177,-10
6081976059,6081976062,3,1732,1560,-10
6084865429,6084865430,1,1859,2005,-10
6085716394,6085716392,-2,1163,1792,-10
6087614848,6087614850,2,1906,1742,-10
6091854734,6091854736,2,1779,1508,-10
6093994852,6093994855,3,1635,1114,-10
6095346149,6095346154,5,1881,1200,-10
6097373198,6097373201,3,2040,1484,-10
6100752984,6100752983,-1,1393,1895,-10
6102401363,6102401365,2,1914,1655,-10
6103626483,6103626484,1,1354,1964,-10
6106375025,6106375027,2,1043,1233,-10
6108934641,6108934642,1,1364,1573,-10
6110853650,6110853655,5,1434,1274,-10
6113409841,6113409842,1,2298,1425,-10
6114044592,6114044595,3,1197,1485,-10
6117931894,6117931894,0,1583,1006,-10
6121272890,6121272891,1,919,942,-10
6128143649,6128143651,2,1764,1243,-10
6128408794,6128408796,2,1264,1648,-10
6134847381,6134847383,2,1521,1491,-10
6136185237,6136185241,4,2028,1987,-10
6137463834,6137463834,0,1490,990,-10
6137665554,6137665552,-2,1372,1977,-10
6138017900,6138017913,13,194,1425,-10
6139321806,6139321808,2,2035,1977,-10
6140695048,6140695050,2,2124,1948,-10
6141817539,6141817541,2,2465,2193,-10
6142554224,6142554226,2,1341,1187,-10
6143671666,6143671669,3,1955,1834,-10
6144256382,6144256383,1,1248,1698,-10
6147750520,6147750521,1,1730,1344,-10
6148662546,6148662545,-1,1126,1147,-10
6148857233,6148857235,2,1276,1160,-10
6151478514,6151478520,6,5069,1964,-10
6154808239,6154808240,1,1829,1599,-10
6156481327,6156481330,3,1526,1302,-10
6159423117,6159423125,8,3504,1253,-10
6159688900,6159688908,8,35823,3373,-10
6161721977,6161721978,1,1282,1531,-10
6163674974,6163674978,4,2481,1294,-10
6164391950,6164391931,-19,626,438,-10
6165240398,6165240401,3,1128,1392,-10
6165601069,6165601062,-7,1704,9508,-10
6165911791,6165911795,4,2106,960,-10
6168194558,6168194560,2,1400,1207,-10
6169489371,6169489375,4,1626,1540,-10
6170395985,6170395989,4,2015,1695,-10
6170806498,6170806499,1,1494,1612,-10
6174184006,6174184008,2,1447,947,-10
6178023718,6178023718,0,1501,1666,-10
6180615510,6180615514,4,1493,1711,-10
6184586794,6184586793,-1,1108,1576,-10
6186048012,6186048014,2,1279,877,-10
6187764073,6187764074,1,1685,1542,-10
6188204068,6188204052,-16,1263,1729,-10
6190261363,6190261366,3,1057,1484,-10
6190576367,6190576370,3,1749,1852,-10
6191713274,6191713275,1,1493,1716,-10
6194392222,6194392224,2,2500,1993,-10
6196839978,6196839974,-4,1274,1250,-10
6199387211,6199387215,4,1490,1600,-10
6200203998,6200203998,0,1559,1525,-10
6205904590,6205904594,4,1749,1603,-10
6215714239,6215714239,0,1387,1234,-10
6216352962,6216352962,0,1405,1442,-10
6218568699,6218568701,2,1722,1473,-10
6218926299,6218926304,5,1994,1676,-10
6219015919,6219015896,-23,1429,1086,-10
6219163471,6219163490,19,1468,1199,-10
6225280428,6225280447,19,574,671,-10
6226414459,6226414464,5,1469,1042,-10
6227585684,6227585680,-4,684,2245,-10
6228251773,6228251766,-7,563,2678,-10
6229064397,6229064398,1,1336,995,-10
6230076983,6230076985,2,1964,1924,-10
6231458213,6231458214,1,1446,1277,-10
6234021542,6234021543,1,1943,2063,-10
6235111148,6235111147,-1,2612,4455,-10
6239384649,6239384650,1,1308,1591,-10
6240453039,6240453039,0,1557,754,-10
6243876000,6243876001,1,1616,1951,-10
6245919294,6245919295,1,2382,1776,-10
6248363744,6248363746,2,1788,1224,-10
6249968716,6249968719,3,1666,1007,-10
6258398210,6258398214,4,2689,1370,-10
6260232527,6260232528,1,1514,1967,-10
6266967751,6266967752,1,1805,1669,-10
6269297571,6269297571,0,1720,1790,-10
6269884097,6269884102,5,944,1337,-10
6270186502,6270186520,18,1320,1695,-10
6271880812,6271880813,1,1050,1679,-10
6272571866,6272571869,3,1808,1059,-10
6274593862,6274593870,8,2082,1078,-10
6275104152,6275104154,2,1453,1231,-10
6275833771,6275833776,5,873,357,-10
6280458519,6280458513,-6,9380,14435,-10
6281325430,6281325433,3,1584,1604,-10
6286326410,6286326410,0,1172,1283,-10
6288091941,6288091942,1,1777,2008,-10
6290282950,6290282953,3,1463,1281,-10
6291456214,6291456221,7,2421,1167,-10
6291548206,6291548209,3,1641,1516,-10
6293830237,6293830238,1,1574,1670,-10
6298591817,6298591821,4,1604,1426,-10
6300818924,6300818927,3,2090,1593,-10
6301957678,6301957682,4,1216,1594,-10
6303496030,6303496033,3,2029,1814,-10
6304104049,6304104056,7,5743,1478,-10
6307938864,6307938867,3,1955,1142,-10
6310796754,6310796756,2,1368,2230,-10
6310965866,6310965869,3,1349,1460,-10
6311385225,6311385226,1,2633,2195,-10
6313244849,6313244852,3,2017,1816,-10
6314292145,6314292147,2,1648,1809,-10
6314651886,6314651890,4,1414,1354,-10
6318464522,6318464523,1,1154,1171,-10
6321178894,6321178897,3,1538,1230,-10
6322521711,6322521722,11,10115,44067,-10
6326693477,6326693478,1,1661,1479,-10
6329906792,6329906794,2,1524,1528,-10
6330298186,6330298188,2,1580,1079,-10
6331700254,6331700257,3,1233,1943,-10
6335779325,6335779326,1,1282,964,-10
6337486926,6337486933,7,8410,1196,-10
6338556264,6338556266,2,1698,1098,-10
6339550421,6339550426,5,1709,1923,-10
6339646457,6339646459,2,1793,1505,-10
6342247306,6342247308,2,1371,1317,-10
6346129348,6346129350,2,1587,1863,-10
6346595006,6346595005,-1,1347,1357,-10
6347188367,6347188370,3,1686,1429,-10
6348232519,6348232524,5,2362,1081,-10
6350472105,6350472104,-1,1369,1045,-10
6352337611,6352337614,3,2125,1547,-10
6352995985,6352995986,1,740,1298,-10
6353682999,6353683001,2,1612,2472,-10
6354532874,6354532877,3,1462,1093,-10
6358289810,6358289817,7,1990,1186,-10
6359547927,6359547929,2,1505,2084,-10
6361176565,6361176569,4,5745,25279,-10
6366225149,6366225153,4,3232,2356,-10
6367966755,6367966761,6,2863,1826,-10
6368482352,6368482358,6,2310,988,-10
6369321834,6369321837,3,1480,1511,-10
6371346590,6371346591,1,1407,1859,-10
6371949038,6371949041,3,1020,1239,-10
6372232538,6372232542,4,1016,1096,-10
6372572787,6372572774,-13,1436,1123,-10
6372907920,6372907901,-19,1497,1044,-10
6373010382,6373010382,0,1400,1739,-10
6376464484,6376464486,2,1510,1686,-10
6378643179,6378643185,6,24335,56892,-10
6380167765,6380167767,2,1385,1083,-10
6381684031,6381684033,2,1183,1688,-10
6381999181,6381999186,5,1620,1392,-10
6383933547,6383933531,-16,572,388,-10
6384777265,6384777280,15,984,4665,-10
6385579479,6385579479,0,1387,1864,-10
6387658756,6387658756,0,1678,1799,-10
6388489542,6388489545,3,1411,1737,-10
6399899103,6399899105,2,940,1663,-10
6400607863,6400607864,1,1253,1181,-10
6401011528,6401011530,2,2466,2230,-10
6402709050,6402709055,5,5466,2031,-10
6403482913,6403482915,2,1438,1497,-10
6405224977,6405224979,2,1073,1288,-10
6407148385,6407148387,2,2125,1659,-10
6409527431,6409527437,6,2499,1641,-10
6410002505,6410002506,1,2036,1391,-10
6413165159,6413165159,0,1353,1393,-10
6414209022,6414209026,4,2455,1314,-10
6414735911,6414735911,0,1084,1296,-10
6415180092,6415180098,6,3132,1532,-10
6415722615,6415722618,3,1378,1335,-10
6418953944,6418953946,2,1341,1127,-10
6419674346,6419674347,1,1592,1484,-10
6420358963,6420358962,-1,1437,1785,-10
6422500766,6422500769,3,1529,1562,-10
6423460835,6423460835,0,1414,1613,-10
6425781067,6425781066,-1,1107,1060,-10
6427975494,6427975496,2,2129,1573,-10
6431708243,6431708245,2,1074,1377,-10
6432592638,6432592639,1,1691,1559,-10
6436003087,6436003090,3,2198,1382,-10
6436838890,6436838894,4,1444,941,-10
6438950641,6438950642,1,1447,1323,-10
6443810442,6443810445,3,1135,885,-10
6444729112,6444729113,1,1093,1541,-10
6445135680,6445135681,1,1146,1391,-10
6447980050,6447980050,0,813,1195,-10
6450131508,6450131511,3,1415,923,-10
6451452001,6451452002,1,1939,2342,-10
6451816293,6451816294,1,1018,1482,-10
6451959964,6451959966,2,1523,1194,-10
6456231501,6456231502,1,1322,947,-10
6460898367,6460898367,0,1182,1425,-10
6462068366,6462068362,-4,899,2429,-10
6462509927,6462509935,8,587,1136,-10
6464184450,6464184451,1,1718,1388,-10
6464645671,6464645673,2,1901,1273,-10
6466324856,6466324857,1,1550,1676,-10
6466555929,6466555930,1,1677,1531,-10
6467977664,6467977661,-3,2735,4917,-10
6472643542,6472643542,0,1508,1702,-10
6473619411,6473619413,2,1479,1445,-10
6475722087,6475722083,-4,1846,3809,-10
6476337330,6476337331,1,2303,2071,-10
6479242627,6479242629,2,1092,1221,-10
6479629432,6479629435,3,1728,1188,-10
6482764617,6482764613,-4,2637,6044,-10
6485215989,6485215989,0,1429,1457,-10
6488061104,6488061105,1,1518,1613,-10
6490069613,6490069613,0,2673,3315,-10
6490864106,6490864106,0,979,1340,-10
6493084411,6493084394,-17,1349,1375,-10
6494769152,6494769154,2,2534,1651,-10
6496200750,6496200753,3,1292,1003,-10
6500666605,6500666609,4,2122,1432,-10
6502807425,6502807426,1,1403,1551,-10
6504645554,6504645547,-7,1710,8888,-10
6505293579,6505293583,4,1517,1365,-10
6506441006,6506441006,0,1797,1256,-10
6506926171,6506926169,-2,1331,1450,-10
6507973591,6507973594,3,1445,1525,-10
6510146202,6510146203,1,1332,1501,-10
6511255864,6511255865,1,1786,1812,-10
6516726941,6516726943,2,1616,2121,-10
6518379778,6518379781,3,1412,1684,-10
6518942152,6518942154,2,1427,1803,-10
6519645769,6519645774,5,2650,925,-10
6520647385,6520647395,10,9355,39298,-10
6521435489,6521435490,1,1366,1487,-10
6521755638,6521755641,3,1397,1682,-10
6521797254,6521797257,3,1928,1637,-10
6523326406,6523326409,3,1396,1261,-10
6524575898,6524575901,3,1201,1433,-10
6525823652,6525823655,3,1648,1625,-10
6526954355,6526954358,3,2351,2135,-10
6527697846,6527697850,4,1633,1815,-10
6528232682,6528232677,-5,1049,2206,-10
6529221621,6529221622,1,1763,1681,-10
6532764855,6532764855,0,1467,980,-10
6534394858,6534394859,1,1792,1954,-10
6540701183,6540701186,3,695,1411,-10
6540834143,6540834145,2,1263,1843,-10
6544510144,6544510146,2,1902,1465,-10
6546623799,6546623792,-7,580,2572,-10
6548223785,6548223791,6,2006,1219,-10
6549258845,6549258846,1,1445,1820,-10
6549371872,6549371874,2,1447,814,-10
6549656289,6549656289,0,1922,2324,-10
6552627076,6552627099,23,1172,2115,-10
6553750329,6553750332,3,1665,1543,-10
6558330782,6558330783,1,1070,758,-10
6558503926,6558503926,0,1201,2114,-10
6558640173,6558640175,2,1685,1487,-10
6559931782,6559931786,4,1371,1035,-10
6561173098,6561173099,1,1097,1698,-10
6562039538,6562039541,3,2093,1925,-10
6570091581,6570091583,2,1820,1568,-10
6579060566,6579060565,-1,1091,1236,-10
6581044501,6581044502,1,1248,1429,-10
6582945882,6582945882,0,1035,651,-10
6583366503,6583366502,-1,1730,1579,-10
6583652307,6583652307,0,1672,1432,-10
6587132273,6587132265,-8,1309,5086,-10
6587310798,6587310799,1,1098,1522,-10
6588449622,6588449623,1,1600,1548,-10
6589113813,6589113809,-4,1632,4226,-10
6589619111,6589619113,2,1419,1575,-10
6591869383,6591869385,2,1671,1450,-10
6592118413,6592118414,1,2311,1872,-10
6594979787,6594979791,4,1774,1276,-10
6596705614,6596705615,1,1198,1106,-10
6599860986,6599860986,0,1084,1680,-10
6600804387,6600804389,2,1235,1617,-10
6600925446,6600925452,6,1968,1976,-10
6602801478,6602801478,0,1169,1312,-10
6604335063,6604335066,3,953,1128,-10
6605204504,6605204506,2,1788,2400,-10
6606169407,6606169410,3,3051,1637,-10
6606582376,6606582378,2,1975,1791,-10
6614126385,6614126387,2,1401,1248,-10
6617700025,6617700026,1,1635,1387,-10
6618480234,6618480234,0,1241,1812,-10
6622897041,6622897043,2,1274,1288,-10
6623815837,6623815838,1,1695,1926,-10
6623941806,6623941808,2,1322,1294,-10
6624478467,6624478469,2,970,947,-10
6624733377,6624733381,4,1321,1426,-10
6627294222,6627294219,-3,912,1007,-10
6633038917,6633038919,2,1836,1504,-10
6634969858,6634969861,3,2360,1918,-10
6638286840,6638286843,3,1506,849,-10
6641366589,6641366589,0,1676,1937,-10
6645195035,6645195039,4,1046,1379,-10
6649140021,6649140022,1,1188,1736,-10
6651667088,6651667089,1,1628,1526,-10
6655466910,6655466913,3,2220,2340,-10
6657468602,6657468603,1,747,1103,-10
6658322651,6658322653,2,2483,1077,-10
6667139236,6667139235,-1,1239,1371,-10
6668474508,6668474502,-6,1409,3876,-10
6672111622,6672111622,0,1462,1833,-10
6672905441,6672905443,2,2014,1238,-10
6673491410,6673491410,0,1328,1574,-10
6674367505,6674367507,2,1288,1154,-10
6674492395,6674492398,3,1296,1716,-10
6676052276,6676052275,-1,1045,1007,-10
6677237224,6677237226,2,1997,1814,-10
6678571062,6678571063,1,1278,1262,-10
6679579271,6679579274,3,1471,1379,-10
6680366313,6680366315,2,2041,1357,-10
6683795723,6683795724,1,867,1608,-10
6686963550,6686963552,2,1487,1760,-10
6692284913,6692284913,0,1196,1242,-10
6692497862,6692497864,2,1308,2014,-10
6695635077,6695635079,2,1736,1606,-10
6696307425,6696307431,6,4894,1358,-10
6696854783,6696854785,2,1774,2255,-10
6697456647,6697456650,3,1897,1289,-10
6698850129,6698850132,3,1874,1554,-10
6701061103,6701061103,0,1356,1686,-10
6702489163,6702489166,3,1284,921,-10
6703483825,6703483826,1,1754,1415,-10
6707109597,6707109601,4,1727,1455,-10
6712608272,6712608274,2,1497,1777,-10
6714196158,6714196162,4,1809,1549,-10
6714858979,6714858981,2,1862,1338,-10
6714945462,6714945464,2,1065,607,-10
6715228822,6715228824,2,1326,1645,-10
6716473490,6716473493,3,1448,1275,-10
6716676507,6716676509,2,1464,1718,-10
6719946261,6719946264,3,1324,1522,-10
6723992416,6723992417,1,1578,1711,-10
6724614673,6724614675,2,1199,1203,-10
6727497990,6727497991,1,1272,1688,-10
6729242066,6729242070,4,1783,1694,-10
6729597176,6729597179,3,1863,1205,-10
6731337923,6731337925,2,1283,1840,-10
6732587185,6732587188,3,1557,1430,-10
6734980542,6734980557,15,1325,1015,-10
6737591416,6737591418,2,1867,1821,-10
6737872351,6737872353,2,1738,2015,-10
6743596402,6743596404,2,1431,1448,-10
6745540438,6745540440,2,1536,1343,-10
6750782162,6750782162,0,1417,2213,-10
6752745942,6752745943,1,1629,1893,-10
6754626874,6754626873,-1,1208,1795,-10
6757390192,6757390194,2,1632,1628,-10
6758740417,6758740418,1,1230,2389,-10
6760185626,6760185630,4,1575,1942,-10
6761960878,6761960879,1,1503,2125,-10
6762144886,6762144886,0,1011,1667,-10
6763469466,6763469466,0,1384,1031,-10
6765494399,6765494402,3,1723,1298,-10
6766299105,6766299107,2,1485,1876,-10
6768995438,6768995440,2,2077,1705,-10
6769345323,6769345325,2,2214,1776,-10
6769597425,6769597426,1,2081,2569,-10
6770311606,6770311587,-19,1604,1652,-10
6772018451,6772018453,2,1525,1967,-10
6772211859,6772211861,2,2025,1860,-10
6774842948,6774842949,1,1785,1900,-10
6775189145,6775189147,2,1882,1886,-10
6776588481,6776588480,-1,1703,2050,-10
6779327252,6779327254,2,1298,1317,-10
6785427409,6785427392,-17,2322,1637,-10
6785645724,6785645725,1,1943,1845,-10
6791034597,6791034603,6,962,1725,-10
6793285263,6793285246,-17,1308,1615,-10
6795320411,6795320413,2,1630,1528,-10
6797883302,6797883305,3,1336,1119,-10
6798104915,6798104918,3,1456,1381,-10
6806153385,6806153387,2,1441,1768,-10
6810262575,6810262577,2,3951,3864,-10
6811346953,6811346955,2,1352,1136,-10
6812126734,6812126736,2,2505,2335,-10
6813620186,6813620187,1,1494,1140,-10
6813979334,6813979334,0,1838,1925,-10
6817754119,6817754123,4,1947,1752,-10
6817921569,6817921570,1,2674,2057,-10
6819882401,6819882402,1,1283,1517,-10
6820448376,6820448377,1,1230,1630,-10
6821936626,6821936627,1,1744,1885,-10
6824411006,6824411006,0,1118,1207,-10
6826147410,6826147413,3,1830,1522,-10
6826449398,6826449398,0,1199,1115,-10
6829658038,6829658039,1,2025,1288,-10
6831683846,6831683849,3,2040,1527,-10
6836688861,6836688866,5,736,1300,-10
6840509323,6840509322,-1,1656,1396,-10
6842354078,6842354082,4,1559,1334,-10
6844015272,6844015273,1,1841,1901,-10
6845511250,6845511250,0,1163,1462,-10
6848148203,6848148207,4,1129,1162,-10
6850446568,6850446570,2,1777,2055,-10
6853697850,6853697854,4,1547,1487,-10
6854063697,6854063698,1,1835,1728,-10
6858290846,6858290846,0,905,1172,-10
6858558898,6858558901,3,1335,1889,-10
6859403985,6859403986,1,1458,1727,-10
6862611279,6862611280,1,1035,1268,-10
6865521063,6865521070,7,3459,1486,-10
6866495612,6866495613,1,20879,22090,-10
6868710821,6868710822,1,1772,1592,-10
6871042821,6871042827,6,2912,1557,-10
6872187202,6872187196,-6,2453,5000,-10
6873408992,6873408995,3,1981,1191,-10
6873838846,6873838849,3,1371,1529,-10
6875319245,6875319246,1,1681,1251,-10
6875792339,6875792347,8,11416,29399,-10
6876577915,6876577915,0,1085,1237,-10
6877775966,6877775967,1,1899,1857,-10
6878552544,6878552545,1,1350,1445,-10
6880025695,6880025698,3,1628,1568,-10
6880865331,6880865333,2,1305,1565,-10
6883404185,6883404188,3,1467,1325,-10
6885862665,6885862666,1,1289,901,-10
6886425040,6886425041,1,1200,2002,-10
6888162004,6888162008,4,1542,1928,-10
6889790139,6889790116,-23,755,430,-10
6890390627,6890390630,3,1311,1420,-10
6895906639,6895906640,1,2121,1931,-10
6900234938,6900234938,0,1536,1803,-10
6901151247,6901151248,1,948,1108,-10
6904109022,6904109023,1,2086,1407,-10
6905029670,6905029669,-1,1716,1731,-10
6905431331,6905431336,5,1577,1584,-10
6908802313,6908802315,2,1030,1617,-10
6910656769,6910656752,-17,938,1037,-10
6911168433,6911168436,3,2140,1358,-10
6911765305,6911765311,6,5625,2625,-10
6913529670,6913529670,0,1630,1756,-10
6913861034,6913861055,21,174,1944,-10
6915678217,6915678220,3,2247,2056,-10
6916274797,6916274797,0,1532,1310,-10
6917652062,6917652062,0,1436,2389,-10
6918639726,6918639727,1,1628,1147,-10
6921119247,6921119249,2,1657,1647,-10
6921961950,6921961950,0,1634,1513,-10
6922179817,6922179818,1,1356,1334,-10
6926138090,6926138089,-1,1812,1605,-10
6927685389,6927685392,3,1176,1220,-10
6931185946,6931185944,-2,1280,2245,-10
6931497659,6931497666,7,5608,1467,-10
6932022963,6932022963,0,1914,1931,-10
6935073252,6935073253,1,1795,1634,-10
6936068614,6936068617,3,1700,1286,-10
6937248395,6937248396,1,1922,2299,-10
6937531174,6937531175,1,1210,1481,-10
6940130803,6940130805,2,683,849,-10
6942015463,6942015462,-1,1193,1365,-10
6942432854,6942432856,2,1726,1481,-10
6943976361,6943976361,0,1646,1664,-10
6944208885,6944208887,2,1964,1825,-10
6944256865,6944256866,1,1213,2074,-10
6946765142,6946765145,3,1967,1289,-10
6947345525,6947345527,2,1701,1519,-10
6948227609,6948227611,2,1878,1792,-10
6951078432,6951078426,-6,1637,1438,-10
6955681423,6955681424,1,1088,1923,-10
6958020982,6958020983,1,1373,1554,-10
6960322228,6960322226,-2,789,1624,-10
6964375621,6964375623,2,2089,2048,-10
6969130045,6969130046,1,1309,1337,-10
6972871570,6972871572,2,1779,1606,-10
6973223531,6973223527,-4,2094,1988,-10
6974060965,6974060966,1,1975,1906,-10
6975562743,6975562747,4,1435,1273,-10
6976366611,6976366614,3,2333,1680,-10
6978922731,6978922731,0,3337,3485,-10
6980699022,6980699024,2,1558,1247,-10
6981428206,6981428207,1,1876,1319,-10
6982249351,6982249357,6,6303,2858,-10
6984120008,6984120008,0,1515,1942,-10
6986931361,6986931363,2,862,1251,-10
6987335789,6987335791,2,1325,1643,-10
6994100701,6994100703,2,2030,1412,-10
6995710854,6995710854,0,1516,2026,-10
6999618018,6999618018,0,1852,1970,-10
6999738241,6999738242,1,1714,1873,-10
7005061434,7005061434,0,936,761,-10
7009606059,7009606061,2,1952,1972,-10
7010401168,7010401170,2,1892,1808,-10
7015457906,7015457900,-6,22107,15567,-10
7018186092,7018186094,2,1525,984,-10
7019010567,7019010571,4,2149,1565,-10
7019966103,7019966105,2,969,1082,-10
7021189619,7021189625,6,1742,956,-10
7021571122,7021571125,3,1558,1184,-10
7023127751,7023127753,2,1933,1733,-10
7023577174,7023577177,3,1044,921,-10
7023964189,7023964191,2,1398,1318,-10
7025123837,7025123842,5,1683,781,-10
7025279369,7025279385,16,3255,1031,-10
7026333675,7026333677,2,2135,1381,-10
7027262665,7027262668,3,1109,1727,-10
7027686036,7027686038,2,1477,1537,-10
7027969618,7027969625,7,5674,2444,-10
7031297521,7031297524,3,2042,1958,-10
7032294760,7032294761,1,1247,972,-10
7033176261,7033176263,2,1308,1861,-10
7035605171,7035605175,4,1596,1316,-10
7039363406,7039363408,2,1784,1915,-10
7039773370,7039773373,3,1014,1186,-10
7040592122,7040592118,-4,773,950,-10
7041192485,7041192489,4,1712,1551,-10
7042001118,7042001122,4,2477,1709,-10
7046959733,7046959735,2,1991,1664,-10
7047134048,7047134050,2,1908,1870,-10
7049601715,7049601718,3,1622,1254,-10
7051883704,7051883706,2,1951,1789,-10
7052436951,7052436952,1,1330,1412,-10
7053985528,7053985529,1,1413,1680,-10
7055577713,7055577714,1,1208,1475,-10
7056043227,7056043225,-2,1070,940,-10
7061686946,7061686950,4,1604,1327,-10
7062491109,7062491109,0,1196,998,-10
7063722807,7063722809,2,1113,1588,-10
7066968018,7066968018,0,1142,1230,-10
7068914086,7068914089,3,1786,1290,-10
7069950964,7069950979,15,1032,1097,-10
7071188401,7071188403,2,769,1044,-10
7073146435,7073146437,2,1692,1511,-10
7073989219,7073989218,-1,1083,1814,-10
7074750066,7074750068,2,1930,1630,-10
7076145759,7076145762,3,1376,1170,-10
7078328730,7078328733,3,1420,1368,-10
7078594835,7078594817,-18,1594,1112,-10
7080356008,7080356009,1,1548,1078,-10
7082675694,7082675694,0,1085,1227,-10
7084632830,7084632831,1,1360,1349,-10
7085032825,7085032814,-11,1005,1312,-10
7085169802,7085169805,3,1533,1750,-10
7085307874,7085307874,0,1383,1308,-10
7086219818,7086219822,4,1366,1433,-10
7088142187,7088142185,-2,1803,1552,-10
7090494117,7090494119,2,1393,1531,-10
7092256737,7092256739,2,1241,1302,-10
7092360073,7092360073,0,1740,2361,-10
7092750666,7092750669,3,1200,1466,-10
7094621414,7094621415,1,1355,1154,-10
7096748572,7096748574,2,1942,1546,-10
7100001087,7100001087,0,1478,1573,-10
7100437787,7100437789,2,1432,1506,-10
7101328910,7101328917,7,3222,1295,-10
7103614899,7103614899,0,1603,1792,-10
7111531189,7111531192,3,1132,1153,-10
7115409722,7115409723,1,1614,1923,-10
7117666745,7117666747,2,1702,2011,-10
7120043747,7120043750,3,1743,1744,-10
7120603717,7120603718,1,1404,1990,-10
7122280714,7122280718,4,1395,1134,-10
7122460856,7122460863,7,12846,4710,-10
7125017971,7125017974,3,1042,1098,-10
7126446439,7126446443,4,1019,1284,-10
7130790379,7130790380,1,1851,1573,-10
7142944922,7142944923,1,1263,1567,-10
7149274298,7149274300,2,1890,1109,-10
7149597081,7149597083,2,2435,1856,-10
7150328246,7150328247,1,1909,2019,-10
7150808541,7150808541,0,1133,865,-10
7159440065,7159440086,21,1350,1494,-10
7163218870,7163218870,0,1895,1711,-10
7163473855,7163473858,3,1593,1508,-10
7163744446,7163744450,4,1180,1377,-10
7163787350,7163787350,0,735,1491,-10
7168720868,7168720870,2,1786,2449,-10
7170124343,7170124345,2,2025,1476,-10
7172820571,7172820574,3,2070,1225,-10
7175736297,7175736301,4,1937,1833,-10
7180153494,7180153498,4,3144,1377,-10
7180444929,7180444930,1,1634,1832,-10
7181164067,7181164065,-2,1299,1578,-10
7181721103,7181721109,6,3813,1692,-10
7182077127,7182077129,2,1350,1336,-10
7184555734,7184555738,4,1897,1320,-10
7186732532,7186732535,3,1637,1565,-10
7187941506,7187941509,3,1945,1633,-10
7189367289,7189367290,1,1750,1313,-10
7189422574,7189422579,5,2445,1995,-10
7189598298,7189598300,2,1533,1312,-10
7189953862,7189953864,2,964,1161,-10
7193670231,7193670234,3,941,1010,-10
7195941624,7195941627,3,1409,1326,-10
7198256846,7198256849,3,808,1057,-10
7200831929,7200831930,1,1314,1653,-10
7202380204,7202380205,1,1201,1680,-10
7202804689,7202804706,17,339,1315,-10
7208273578,7208273581,3,1287,1099,-10
7209685383,7209685385,2,1625,2601,-10
7211198771,7211198772,1,1567,1294,-10
7211828659,7211828658,-1,1762,1486,-10
7212640458,7212640462,4,1952,1423,-10
7212748847,7212748850,3,1513,1301,-10
7214499278,7214499282,4,304,1087,-10
7217727507,7217727513,6,1903,1075,-10
7218302006,7218302008,2,1960,2122,-10
7218331122,7218331127,5,2286,1769,-10
7220042254,7220042254,0,1583,2625,-10
7222814365,7222814365,0,1715,1464,-10
7225204595,7225204595,0,627,520,-10
7228381006,7228381010,4,1279,1310,-10
7229762909,7229762912,3,1555,1288,-10
7232528836,7232528837,1,1260,1344,-10
7233683046,7233683045,-1,1362,1685,-10
7234417495,7234417497,2,785,804,-10
7238921850,7238921853,3,1088,902,-10
7242046131,7242046130,-1,806,1679,-10
7243922688,7243922683,-5,1139,1251,-10
7245099934,7245099937,3,1354,1394,-10
7246159829,7246159823,-6,1149,2106,-10
7246908703,7246908707,4,2104,1204,-10
7252866367,7252866370,3,1628,1576,-10
7253086032,7253086029,-3,1783,5433,-10
7254713661,7254713663,2,1373,1683,-10
7256513716,7256513716,0,40086,22427,-10
7257878075,7257878077,2,1584,1497,-10
7261202986,7261202987,1,1955,1293,-10
7262635263,7262635265,2,1230,1437,-10
7263362001,7263362008,7,3005,1669,-10
7265195217,7265195222,5,2153,1365,-10
7265739615,7265739614,-1,1688,1576,-10
7266236378,7266236378,0,1262,1488,-10
7267831291,7267831294,3,2378,1756,-10
7268085651,7268085646,-5,1536,4767,-10
7268639627,7268639625,-2,1308,2077,-10
7270589679,7270589682,3,1236,1024,-10
7276166840,7276166845,5,2713,1550,-10
7278892786,7278892785,-1,1045,1238,-10
7282135693,7282135691,-2,1712,1557,-10
7285520241,7285520243,2,1057,1223,-10
7289222758,7289222758,0,1610,2026,-10
7290835967,7290835966,-1,905,1460,-10
7292423989,7292423989,0,1380,1528,-10
7293379163,7293379166,3,1014,1056,-10
7294487535,7294487538,3,1447,1629,-10
7296869666,7296869668,2,1608,1457,-10
7296970657,7296970658,1,1362,1976,-10
7298510389,7298510408,19,1444,1388,-10
7299613264,7299613266,2,1504,1809,-10
7301233470,7301233470,0,1560,1283,-10
7303738802,7303738805,3,1529,1166,-10
7306977291,7306977295,4,1741,1251,-10
7312256535,7312256552,17,1175,1516,-10
7313750325,7313750326,1,1380,2065,-10
7317932604,7317932606,2,1219,1076,-10
7320924983,7320924985,2,1909,1964,-10
7321064326,7321064329,3,1653,2082,-10
7322599850,7322599854,4,1364,1090,-10
7323053193,7323053195,2,2266,1463,-10
7324524986,7324524986,0,1955,1634,-10
7326671386,7326671386,0,1200,1967,-10
7326957639,7326957641,2,1587,1473,-10
7334104662,7334104659,-3,1405,1555,-10
7335442007,7335442007,0,1702,1123,-10
7337866201,7337866201,0,1503,2008,-10
7340271148,7340271150,2,884,1156,-10
7341227198,7341227200,2,1828,1601,-10
7341680160,7341680161,1,1777,1287,-10
7342760926,7342760927,1,1790,1315,-10
7345026973,7345026970,-3,1005,3201,-10
7345782656,7345782658,2,1590,1566,-10
7346472840,7346472842,2,1313,1942,-10
7346880223,7346880225,2,1777,1676,-10
7346994101,7346994107,6,1702,1304,-10
7351017794,7351017793,-1,1753,1475,-10
7351492156,7351492159,3,1436,1777,-10
7352682453,7352682453,0,2324,1820,-10
7358554782,7358554785,3,2056,1575,-10
7359907910,7359907912,2,2813,2079,-10
7360446657,7360446659,2,1456,1437,-10
7361872338,7361872335,-3,840,2246,-10
7362086867,7362086871,4,1827,1676,-10
7363323660,7363323663,3,2620,1528,-10
7365997310,7365997310,0,1291,1417,-10
7366480777,7366480783,6,2428,1288,-10
7366640659,7366640662,3,1389,1154,-10
7367419097,7367419101,4,3384,1417,-10
7368897386,7368897394,8,3980,1746,-10
7372869141,7372869143,2,1874,1531,-10
7373162017,7373162017,0,1452,1600,-10
7375449406,7375449407,1,1465,1291,-10
7375920732,7375920715,-17,838,974,-10
7376345270,7376345272,2,2043,1686,-10
7379919538,7379919542,4,1854,1363,-10
7380704204,7380704203,-1,2291,4386,-10
7380882474,7380882474,0,1315,1558,-10
7381366902,7381366903,1,851,790,-10
7386141544,7386141545,1,1345,1201,-10
7386758580,7386758581,1,1781,2297,-10
7386801801,7386801798,-3,1317,1345,-10
7386954291,7386954290,-1,1026,818,-10
7387714564,7387714566,2,1603,1732,-10
7390197911,7390197914,3,2212,1368,-10
7392024613,7392024617,4,1146,1226,-10
7392908531,7392908535,4,1428,1162,-10
7394474273,7394474275,2,1547,1435,-10
7396119058,7396119059,1,1092,987,-10
7396481385,7396481390,5,1332,1477,-10
7397063660,7397063662,2,1779,1698,-10
7397653981,7397653982,1,1643,2176,-10
7398399638,7398399639,1,1411,1336,-10
7400631723,7400631726,3,2552,1700,-10
7401228046,7401228050,4,1767,1564,-10
7404312876,7404312877,1,1709,1265,-10
7405042198,7405042200,2,1208,1608,-10
7412357492,7412357494,2,1488,1275,-10
7416487281,7416487283,2,2106,1736,-10
7417833095,7417833096,1,1873,1257,-10
7418511506,7418511506,0,1332,1453,-10
7418601773,7418601775,2,1446,1728,-10
7418678658,7418678660,2,1633,2000,-10
7419706499,7419706500,1,1470,2194,-10
7422836118,7422836118,0,1403,1430,-10
7423916374,7423916379,5,2281,1123,-10
7426650052,7426650052,0,1530,1410,-10
7427582955,7427582958,3,1566,1260,-10
7427928828,7427928828,0,1963,1372,-10
7430847816,7430847817,1,1630,1826,-10
7431100583,7431100582,-1,1072,1156,-10
7432529677,7432529678,1,2547,1469,-10
7433251920,7433251923,3,1912,1597,-10
7433334438,7433334441,3,1524,1007,-10
7434419165,7434419167,2,709,1309,-10
7434536573,7434536573,0,1072,1299,-10
7436356335,7436356337,2,1559,1284,-10
7436388768,7436388769,1,1484,1784,-10
7438204214,7438204227,13,1522,1725,-10
7440083197,7440083198,1,1601,1251,-10
7440276431,7440276433,2,1772,1713,-10
7440967326,7440967327,1,2098,1709,-10
7442514235,7442514237,2,1688,1413,-10
7444632084,7444632082,-2,1393,1858,-10
7448675984,7448675967,-17,1328,1648,-10
7451296335,7451296332,-3,1245,1380,-10
7453367496,7453367498,2,1306,1633,-10
7454832198,7454832197,-1,1131,1545,-10
7459671958,7459671960,2,1265,1916,-10
7462106789,7462106790,1,28144,22785,-10
7462497988,7462497990,2,1399,2087,-10
7467750218,7467750219,1,1111,1122,-10
7474389764,7474389768,4,1686,1403,-10
7476610233,7476610235,2,2260,1257,-10
7479887081,7479887082,1,1724,1471,-10
7480305588,7480305590,2,1979,1610,-10
7482742524,7482742528,4,2192,1224,-10
7482818825,7482818825,0,1470,1563,-10
7483240452,7483240451,-1,1855,1984,-10
7483517073,7483517074,1,1524,1699,-10
7484379891,7484379893,2,2039,1248,-10
7491982239,7491982240,1,1595,1720,-10
7494358318,7494358320,2,1317,1686,-10
7494560725,7494560727,2,1852,1863,-10
7495173952,7495173954,2,1364,1300,-10
7497920970,7497920972,2,1185,1155,-10
7499119779,7499119792,13,1529,1070,-10
7500975332,7500975332,0,1492,1699,-10
7501036025,7501036027,2,892,1151,-10
7501488298,7501488299,1,1477,1180,-10
7505764895,7505764890,-5,1478,6263,-10
7506150046,7506150066,20,930,103,-10
7506929437,7506929439,2,790,1217,-10
7507472485,7507472486,1,1699,1466,-10
7508187607,7508187606,-1,1639,2372,-10
7508674002,7508674001,-1,1468,1768,-10
7509268322,7509268330,8,4379,1151,-10
7511107762,7511107761,-1,1797,2122,-10
7513413234,7513413234,0,1603,1249,-10
7514125708,7514125708,0,1743,1266,-10
7514904701,7514904704,3,2129,2495,-10
7515869797,7515869799,2,1541,1151,-10
7517372568,7517372566,-2,1296,1434,-10
7517655021,7517655025,4,1653,1626,-10
7517948348,7517948350,2,1932,1698,-10
7519208974,7519208978,4,1770,1296,-10
7523866586,7523866589,3,1265,1514,-10
7530342911,7530342911,0,1695,1389,-10
7531277225,7531277230,5,1668,1771,-10
7534056032,7534056034,2,1396,1347,-10
7535156469,7535156472,3,1589,1615,-10
7537572386,7537572387,1,1541,1960,-10
7539358685,7539358688,3,3684,3618,-10
7541488821,7541488821,0,1267,1739,-10
7541615102,7541615103,1,1844,1526,-10
7543049339,7543049342,3,1868,1556,-10
7543773862,7543773864,2,3811,3414,-10
7548263865,7548263865,0,1814,1324,-10
7550406011,7550406011,0,1053,1044,-10
7555674405,7555674404,-1,1684,1730,-10
7561780912,7561780917,5,2653,1851,-10
7562888119,7562888120,1,1685,1217,-10
7563072039,7563072039,0,1351,1393,-10
7564078198,7564078198,0,1392,1985,-10
7564569465,7564569462,-3,1327,2402,-10
7564939338,7564939341,3,1346,1502,-10
7565951295,7565951284,-11,1305,1337,-10
7567327246,7567327247,1,1757,1539,-10
7568582131,7568582132,1,1945,2644,-10
7569272985,7569272985,0,1507,1791,-10
7570555365,7570555367,2,1523,1198,-10
7574072395,7574072394,-1,1022,2079,-10
7579304435,7579304438,3,1973,1834,-10
7579860496,7579860496,0,2059,1539,-10
7580696414,7580696409,-5,2206,6328,-10
7583003471,7583003472,1,1256,1588,-10
7586645998,7586646000,2,1736,1908,-10
7589878702,7589878703,1,568,1041,-10
7590427418,7590427406,-12,1132,12830,-10
7590705794,7590705793,-1,828,1062,-10
7600074399,7600074402,3,1381,1207,-10
7602666566,7602666546,-20,3720,1903,-10
7610057358,7610057358,0,1584,1593,-10
7613330522,7613330521,-1,1360,2607,-10
7617161978,7617161974,-4,1234,3011,-10
7617557303,7617557305,2,1510,2022,-10
7620354345,7620354349,4,1448,1365,-10
7622176099,7622176098,-1,1530,1560,-10
7625061434,7625061435,1,2003,1674,-10
7625149599,7625149600,1,1240,1165,-10
7628915807,7628915807,0,1972,2309,-10
7629821958,7629821960,2,1580,1695,-10
7630309474,7630309474,0,1200,1409,-10
7631469065,7631469069,4,894,1222,-10
7631854141,7631854143,2,1258,1378,-10
7632584833,7632584833,0,1214,1756,-10
7633320053,7633320056,3,1272,1296,-10
7634828415,7634828417,2,1366,1649,-10
7635208654,7635208655,1,1456,1505,-10
7636777089,7636777090,1,1261,1137,-10
7638888086,7638888087,1,1904,2001,-10
7639528862,7639528865,3,1311,1464,-10
7644009653,7644009653,0,1108,1729,-10
7648501111,7648501119,8,1370,1247,-10
7650181684,7650181686,2,910,666,-10
7652876552,7652876551,-1,990,1355,-10
7653327537,7653327537,0,3124,4141,-10
7657824571,7657824574,3,1190,1252,-10
7660492834,7660492834,0,1102,2168,-10
7662299095,7662299097,2,1437,1417,-10
7667684822,7667684823,1,2103,1680,-10
7673150510,7673150505,-5,2180,6748,-10
7673397742,7673397749,7,3171,831,-10
7679132875,7679132876,1,944,1288,-10
7680783485,7680783485,0,1678,1714,-10
7683396426,7683396425,-1,1133,1653,-10
7689438452,7689438452,0,1277,1701,-10
7692192811,7692192814,3,1748,1738,-10
7692465085,7692465086,1,1320,1932,-10
7695387353,7695387353,0,1660,2308,-10
7698003904,7698003907,3,1767,1289,-10
7699029012,7699029014,2,1699,1191,-10
7699150442,7699150437,-5,796,3435,-10
7699921553,7699921555,2,1011,1092,-10
7702929824,7702929825,1,1881,1792,-10
7705994558,7705994558,0,1969,1310,-10
7708628226,7708628228,2,1553,1772,-10
7710762122,7710762125,3,1567,1561,-10
7711423645,7711423647,2,1495,1844,-10
7711843170,7711843170,0,1376,1802,-10
7713328091,7713328093,2,1518,1570,-10
7718541956,7718541957,1,1353,1485,-10
7720383339,7720383341,2,1751,1135,-10
7722110845,7722110851,6,1737,1130,-10
7723084446,7723084447,1,2172,1667,-10
7723567089,7723567090,1,1246,1628,-10
7725566226,7725566229,3,1947,2148,-10
7727724689,7727724690,1,1643,1771,-10
7728080587,7728080586,-1,1052,1515,-10
7730364295,7730364294,-1,1627,1811,-10
7730517969,7730517971,2,1860,1342,-10
7733528798,7733528798,0,920,1392,-10
7738511666,7738511670,4,1316,1099,-10
7739795305,7739795289,-16,2041,1101,-10
7743638681,7743638681,0,1483,1238,-10
7744285388,7744285387,-1,1486,1265,-10
7744782063,7744782066,3,748,274,-10
7746404106,7746404109,3,1366,1601,-10
7746915637,7746915640,3,1508,1437,-10
7752925678,7752925680,2,1044,1220,-10
7753581270,7753581272,2,1431,1551,-10
7755450634,7755450638,4,2332,2496,-10
7755889932,7755889934,2,1442,1299,-10
7756746007,7756746011,4,1769,1461,-10
7759828942,7759828946,4,1577,1304,-10
7760251808,7760251809,1,1737,1628,-10
7763671516,7763671518,2,1661,1531,-10
7764542250,7764542252,2,1452,1477,-10
7764691738,7764691737,-1,642,1550,-10
7765999579,7765999579,0,1541,1772,-10
7768985225,7768985227,2,880,1084,-10
7770672759,7770672761,2,1655,1814,-10
7771014473,7771014476,3,1627,1782,-10
7774903101,7774903103,2,1772,1853,-10
7774995347,7774995347,0,1649,1309,-10
7776338442,7776338444,2,1951,2121,-10
7776758599,7776758602,3,1498,2078,-10
7778836566,7778836569,3,1699,1384,-10
7779243170,7779243171,1,1749,1271,-10
7779769822,7779769803,-19,1247,1105,-10
7783618380,7783618383,3,1146,1203,-10
7784763045,7784763047,2,1566,1476,-10
7785909733,7785909735,2,1968,1757,-10
7789070481,7789070483,2,1480,1365,-10
7790302350,7790302352,2,1426,1821,-10
7790823723,7790823717,-6,1393,8633,-10
7792773939,7792773943,4,1291,1603,-10
7794475487,7794475490,3,1427,1408,-10
7796054878,7796054879,1,1219,1484,-10
7796403093,7796403098,5,15731,46070,-10
7797350874,7797350876,2,1619,1627,-10
7798977521,7798977523,2,1642,1104,-10
7799284958,7799284953,-5,1581,3551,-10
7799513838,7799513841,3,1881,1682,-10
7801776919,7801776922,3,2488,1613,-10
7803708481,7803708486,5,2928,1492,-10
7806463799,7806463798,-1,2117,1962,-10
7807215331,7807215330,-1,1410,1608,-10
7809050005,7809050012,7,1581,972,-10
7809784003,7809784005,2,1900,1946,-10
7811460345,7811460347,2,1485,1129,-10
7816438635,7816438637,2,1879,1342,-10
7817403598,7817403600,2,1627,1400,-10
7819701616,7819701618,2,1199,1865,-10
7822351068,7822351069,1,937,1154,-10
7823843481,7823843486,5,1612,1450,-10
7826054410,7826054411,1,1340,1419,-10
7827844097,7827844098,1,1396,1574,-10
7830645702,7830645702,0,1441,1404,-10
7832284614,7832284615,1,1545,1513,-10
7833320809,7833320810,1,1594,1223,-10
7834065107,7834065108,1,1263,1868,-10
7835124785,7835124786,1,1443,1785,-10
7835216366,7835216364,-2,1287,2064,-10
7839527761,7839527763,2,1456,970,-10
7840648101,7840648103,2,1421,1473,-10
7842601884,7842601887,3,1353,1724,-10
7844144319,7844144322,3,1204,1557,-10
7846272483,7846272484,1,1041,1276,-10
7846542740,7846542741,1,1832,1477,-10
7848072205,7848072208,3,1742,1739,-10
7848276359,7848276360,1,1042,1431,-10
7849511385,7849511390,5,2634,1594,-10
7851929302,7851929302,0,935,875,-10
7853376973,7853376976,3,1143,1477,-10
7856007050,7856007053,3,1123,1188,-10
7856524826,7856524829,3,1655,1517,-10
7856642531,7856642532,1,1280,1236,-10
7858704502,7858704502,0,1539,1591,-10
7860888018,7860888021,3,1613,1578,-10
7861887045,7861887065,20,1830,1631,-10
7863903607,7863903616,9,1129,707,-10
7866165874,7866165871,-3,1028,1837,-10
7868525167,7868525168,1,1622,1305,-10
7868871175,7868871178,3,1708,1531,-10
7871319982,7871319983,1,1325,1364,-10
7871535515,7871535518,3,1952,1785,-10
7872191573,7872191574,1,1272,1412,-10
7872230704,7872230715,11,2064,1352,-10
7876837909,7876837911,2,1986,1552,-10
7876872548,7876872547,-1,1156,1078,-10
7877239357,7877239362,5,1280,1591,-10
7878038054,7878038053,-1,134,1206,-10
7880944969,7880944970,1,1712,1532,-10
7882208913,7882208918,5,2444,1110,-10
7882551101,7882551100,-1,1335,1473,-10
7882633362,7882633365,3,1703,1905,-10
7883760351,7883760348,-3,1071,2214,-10
7887564924,7887564921,-3,2309,4804,-10
7888085005,7888085008,3,2099,1541,-10
7890431354,7890431354,0,1211,1912,-10
7890644414,7890644414,0,1557,1387,-10
7891807455,7891807461,6,3068,1837,-10
7893123156,7893123154,-2,1095,1223,-10
7896247830,7896247832,2,1912,1677,-10
7897141879,7897141881,2,1772,2073,-10
7898253994,7898253995,1,1393,1436,-10
7898793355,7898793357,2,1431,1172,-10
7903230242,7903230242,0,1824,1921,-10
7903389255,7903389256,1,1050,1080,-10
7907927474,7907927478,4,1488,1365,-10
7909019109,7909019107,-2,1430,2298,-10
7910935741,7910935743,2,1758,1276,-10
7916438890,7916438895,5,1459,520,-10
7920460453,7920460455,2,1357,1241,-10
7922121503,7922121504,1,1327,887,-10
7922542853,7922542854,1,1356,1205,-10
7924233359,7924233362,3,698,1150,-10
7925951159,7925951161,2,1848,2325,-10
7926836418,7926836419,1,1474,1393,-10
7927112549,7927112552,3,1915,1720,-10
7927299018,7927299019,1,870,1304,-10
7928243675,7928243674,-1,1296,2269,-10
7931069810,7931069811,1,1861,1207,-10
7931108245,7931108247,2,1263,971,-10
7934091990,7934091990,0,1241,1452,-10
7940537479,7940537476,-3,1015,2496,-10
7944000985,7944000986,1,1248,1490,-10
7945878038,7945878042,4,1519,1152,-10
7945929198,7945929199,1,850,1097,-10
7946351002,7946351004,2,1652,1946,-10
7946949605,7946949606,1,1207,1666,-10
7950853162,7950853165,3,2028,1911,-10
7957771423,7957771425,2,2327,2480,-10
7958458416,7958458418,2,1743,1218,-10
7958963539,7958963542,3,1433,1020,-10
7960844482,7960844484,2,1017,1824,-10
7961618606,7961618605,-1,1484,1699,-10
7963287859,7963287859,0,1265,1572,-10
7963865519,7963865519,0,1070,902,-10
7963931167,7963931169,2,1826,1788,-10
7964007378,7964007367,-11,15633,28333,-10
7965154227,7965154230,3,1705,1651,-10
7969891414,7969891414,0,6266,7772,-10
7972112128,7972112129,1,913,1349,-10
7974069167,7974069171,4,1517,1247,-10
7974649004,7974649002,-2,1559,1825,-10
7975567756,7975567759,3,1753,1480,-10
7978659597,7978659598,1,1334,1812,-10
7979259457,7979259458,1,1110,1363,-10
7981481632,7981481634,2,1810,1145,-10
7983201946,7983201951,5,1164,1298,-10
7985345003,7985345002,-1,679,1663,-10
7985398894,7985398895,1,1303,1408,-10
7990854266,7990854267,1,1480,1827,-10
7993782849,7993782851,2,1510,1284,-10
7996692269,7996692269,0,1430,1217,-10
7998887867,7998887866,-1,3814,11876,-10
7999973685,7999973684,-1,1617,1796,-10
8003189409,8003189410,1,1506,1462,-10
8004871507,8004871509,2,1417,1473,-10
8006878174,8006878177,3,1919,2474,-10
8007211743,8007211746,3,1786,1378,-10
8009525113,8009525117,4,1378,1945,-10
8011940958,8011940953,-5,557,1695,-10
8017944597,8017944600,3,1448,1063,-10
8019745191,8019745190,-1,2099,1593,-10
8021543026,8021543025,-1,1248,1449,-10
8022159775,8022159774,-1,1651,2055,-10
8028293867,8028293869,2,1304,1368,-10
8029611309,8029611320,11,12595,43817,-10
8031146206,8031146207,1,1756,1552,-10
8034317681,8034317683,2,1699,1708,-10
8035441843,8035441843,0,1412,1780,-10
8035556737,8035556730,-7,1547,6096,-10
8037824380,8037824382,2,2056,1670,-10
8044630742,8044630736,-6,1585,5815,-10
8046385878,8046385881,3,1960,1662,-10
8046998659,8046998662,3,1854,1571,-10
8048361917,8048361918,1,1545,1194,-10
8049852694,8049852697,3,1787,1639,-10
8053563431,8053563433,2,1715,1169,-10
8054001686,8054001696,10,1397,1360,-10
8057261983,8057261985,2,1478,1605,-10
8058688911,8058688915,4,1474,1486,-10
8059363349,8059363351,2,1365,1714,-10
8060594920,8060594938,18,1086,1554,-10
8065025039,8065025039,0,1117,1185,-10
8068505112,8068505112,0,1359,1335,-10
8068763606,8068763605,-1,1339,2134,-10
8069990302,8069990301,-1,1195,1336,-10
8070269177,8070269178,1,1641,1486,-10
8071727654,8071727658,4,1596,1271,-10
8071970729,8071970729,0,1786,1399,-10
8074474002,8074474004,2,1267,2079,-10
8078840515,8078840515,0,2034,1792,-10
8080866317,8080866321,4,2062,1631,-10
8081182196,8081182194,-2,1483,2517,-10
8082121546,8082121545,-1,1722,2518,-10
8085757326,8085757329,3,1336,1424,-10
8087058695,8087058698,3,2004,2019,-10
8089168222,8089168227,5,1615,1261,-10
8090544158,8090544159,1,2511,1862,-10
8091278558,8091278558,0,704,904,-10
8096713425,8096713428,3,1118,1416,-10
8097527198,8097527203,5,1581,1467,-10
8097667678,8097667677,-1,1752,1447,-10
8099110287,8099110289,2,1702,1360,-10
8100492808,8100492809,1,1595,1357,-10
8101894645,8101894647,2,1647,1492,-10
8102228299,8102228302,3,2396,2081,-10
8103041275,8103041279,4,1689,1545,-10
8105322496,8105322497,1,1783,1750,-10
8105860755,8105860757,2,1391,1302,-10
8106315956,8106315958,2,2156,1339,-10
8106817580,8106817581,1,1997,2093,-10
8109458275,8109458278,3,1614,901,-10
8109918106,8109918108,2,2187,2293,-10
8112450425,8112450427,2,1074,1467,-10
8113533645,8113533647,2,710,964,-10
8117164747,8117164753,6,6287,2613,-10
8117679321,8117679322,1,1633,2103,-10
8119126761,8119126762,1,1486,1639,-10
8120673433,8120673433,0,1046,1518,-10
8121350507,8121350509,2,1332,1701,-10
8122692236,8122692237,1,1904,1572,-10
8124041997,8124041997,0,2348,3720,-10
8127817749,8127817750,1,1925,1838,-10
8131881069,8131881069,0,1093,1472,-10
8132301459,8132301461,2,1738,1770,-10
8134414118,8134414119,1,1758,1557,-10
8135406145,8135406147,2,1073,1658,-10
8138160234,8138160235,1,1500,2454,-10
8141487390,8141487395,5,2163,2379,-10
8143280426,8143280444,18,2107,1644,-10
8145473646,8145473650,4,1921,1015,-10
8147617510,8147617509,-1,865,1326,-10
8152020457,8152020459,2,1448,1458,-10
8152280447,8152280447,0,1111,1680,-10
8153356174,8153356175,1,1072,1412,-10
8158531057,8158531063,6,1124,1021,-10
8160195026,8160195032,6,1654,1341,-10
8166679055,8166679057,2,1418,1134,-10
8166708772,8166708793,21,1608,1225,-10
8168755211,8168755211,0,1781,1732,-10
8168954310,8168954313,3,2513,1791,-10
8169157625,8169157627,2,1265,1549,-10
8170933771,8170933774,3,1759,1921,-10
8172940995,8172940981,-14,1358,696,-10
8173982814,8173982805,-9,1041,15076,-10
8176744298,8176744294,-4,1237,3770,-10
8177816483,8177816486,3,1489,1150,-10
8178865854,8178865856,2,1735,1554,-10
8179618953,8179618955,2,1399,1947,-10
8180899475,8180899483,8,1722,1323,-10
8181465583,8181465585,2,1054,1311,-10
8189423055,8189423061,6,1290,839,-10
8189879398,8189879399,1,1080,1414,-10
8190397857,8190397857,0,1473,1704,-10
8193295865,8193295868,3,1070,1266,-10
8196931110,8196931110,0,1752,1317,-10
8197136006,8197136007,1,1131,1067,-10
8198600238,8198600239,1,1318,1325,-10
8203498329,8203498330,1,1532,1487,-10
8205731145,8205731145,0,1537,2278,-10
8206400223,8206400224,1,1872,2163,-10
8206438245,8206438248,3,1549,1110,-10
8208757626,8208757627,1,1275,886,-10
8213556005,8213556006,1,1018,1598,-10
8214694646,8214694646,0,1304,2162,-10
8215463853,8215463853,0,1496,1620,-10
8219106559,8219106553,-6,778,3815,-10
8220014162,8220014162,0,1924,1720,-10
8221411717,8221411721,4,1774,1638,-10
8222336893,8222336896,3,1747,1972,-10
8222418895,8222418898,3,2382,1141,-10
8225916639,8225916641,2,1348,1640,-10
8226100468,8226100470,2,1195,1375,-10
8227895141,8227895142,1,944,1043,-10
8228013294,8228013297,3,1592,1601,-10
8228149478,8228149481,3,1615,1045,-10
8228457413,8228457413,0,951,1320,-10
8231633659,8231633660,1,1337,1206,-10
8233755757,8233755758,1,1387,1442,-10
8234604938,8234604940,2,1426,2164,-10
8240025690,8240025690,0,1526,1643,-10
8242114615,8242114614,-1,1968,2041,-10
8242187457,8242187460,3,1064,1273,-10
8243578579,8243578578,-1,1197,2323,-10
8244321483,8244321486,3,1589,1779,-10
8245469036,8245469037,1,1056,1360,-10
8247035414,8247035414,0,2614,2109,-10
8248738573,8248738575,2,1782,1223,-10
8250693165,8250693167,2,1774,2081,-10
8251151009,8251151012,3,1234,2091,-10
8253021418,8253021422,4,1675,1781,-10
8257764552,8257764554,2,1400,929,-10
8258038246,8258038252,6,1144,1400,-10
8258608234,8258608236,2,1352,2034,-10
8263291861,8263291862,1,1600,1333,-10
8264232230,8264232228,-2,456,1522,-10
8267190316,8267190328,12,1113,990,-10
8267846059,8267846063,4,1799,1419,-10
8268120417,8268120417,0,1145,1251,-10
8270127894,8270127895,1,1374,1046,-10
8270445629,8270445631,2,1953,1542,-10
8271626979,8271626982,3,1813,1750,-10
8271659758,8271659739,-19,1924,1904,-10
8272154914,8272154919,5,1398,1556,-10
8275477583,8275477584,1,1314,1566,-10
8275866864,8275866846,-18,1599,1105,-10
8280609611,8280609613,2,1753,1810,-10
8282886746,8282886746,0,1538,1545,-10
8283458283,8283458303,20,1292,1301,-10
8285106139,8285106141,2,874,998,-10
8287475056,8287475058,2,1352,1593,-10
8288661164,8288661178,14,436,2126,-10
8292997149,8292997149,0,1719,1673,-10
8296549689,8296549690,1,1461,1395,-10
8296733570,8296733571,1,1526,1232,-10
8297792499,8297792502,3,1406,1735,-10
8298032449,8298032446,-3,947,1534,-10
8303907010,8303907012,2,1606,1475,-10
8307503774,8307503777,3,1791,1559,-10
8309112534,8309112535,1,1873,1567,-10
8310027578,8310027581,3,1844,1628,-10
8315431150,8315431151,1,1701,1917,-10
8316881339,8316881341,2,2203,1731,-10
8317102446,8317102449,3,1433,1775,-10
8319024701,8319024704,3,1184,1170,-10
8319720002,8319720005,3,1465,1256,-10
8322699316,8322699324,8,2998,1310,-10
8327962086,8327962088,2,1873,1774,-10
8328171054,8328171057,3,1062,1193,-10
8330421003,8330421006,3,1747,1957,-10
8331360288,8331360293,5,1854,1596,-10
8333078469,8333078473,4,2067,1473,-10
8336914635,8336914638,3,1613,1549,-10
8338684914,8338684914,0,1918,2184,-10
8341248351,8341248353,2,1590,1067,-10
8342742501,8342742506,5,1089,1171,-10
8353206488,8353206490,2,1418,1056,-10
8360241122,8360241122,0,1097,1262,-10
8363168109,8363168109,0,2021,1643,-10
8363854216,8363854223,7,2886,1105,-10
8366472250,8366472253,3,1755,1480,-10
8371689970,8371689971,1,1664,1341,-10
8372307098,8372307100,2,1262,888,-10
8374543734,8374543736,2,728,948,-10
8376497781,8376497782,1,1357,1482,-10
8376685666,8376685670,4,1829,1442,-10
8378679201,8378679202,1,1549,974,-10
8379798778,8379798779,1,1077,495,-10
8382750458,8382750437,-21,1646,1754,-10
8383588010,8383588013,3,1744,1454,-10
8386223030,8386223023,-7,2049,7074,-10
8386293865,8386293866,1,1353,1856,-10
8386378519,8386378519,0,1282,949,-10
8392800869,8392800870,1,1755,2132,-10
8394437745,8394437746,1,2966,3677,-10
8397775757,8397775760,3,1475,2220,-10
8397977486,8397977486,0,1495,1148,-10
8398607321,8398607323,2,1475,1309,-10
8401622454,8401622455,1,1483,1476,-10
8402182263,8402182251,-12,910,736,-10
8403513178,8403513181,3,924,1476,-10
8407604998,8407604999,1,1302,1294,-10
8408138989,8408138992,3,1361,1357,-10
8408649209,8408649212,3,1244,1265,-10
8408719125,8408719126,1,1299,1193,-10
8411079934,8411079934,0,1332,1590,-10
8411226244,8411226242,-2,957,1940,-10
8414769189,8414769191,2,1820,2259,-10
8418623875,8418623875,0,1207,1373,-10
8419555382,8419555386,4,1484,1488,-10
8422075769,8422075769,0,1096,1467,-10
8422956857,8422956858,1,1843,1541,-10
8423286016,8423286014,-2,44342,16262,-10
8423361893,8423361895,2,1694,1155,-10
8424979945,8424979947,2,2231,2164,-10
8425665573,8425665574,1,1398,1420,-10
8426207451,8426207452,1,1180,1637,-10
8426330417,8426330418,1,1033,1027,-10
8426695573,8426695579,6,1188,1336,-10
8427801856,8427801858,2,1742,1240,-10
8427935348,8427935370,22,831,1138,-10
8428665042,8428665036,-6,1789,1696,-10
8430734439,8430734436,-3,764,1534,-10
8432835277,8432835279,2,1568,1544,-10
8432956685,8432956693,8,2870,1226,-10
8433366699,8433366681,-18,1328,1536,-10
8435413606,8435413605,-1,1117,1637,-10
8438126283,8438126283,0,1973,1400,-10
8445847203,8445847204,1,1880,1722,-10
8447171264,8447171266,2,1897,1430,-10
8451174898,8451174900,2,1539,1395,-10
8454284567,8454284566,-1,956,931,-10
8454710922,8454710921,-1,1136,1489,-10
8455808424,8455808426,2,2051,1536,-10
8457853971,8457853972,1,1399,1169,-10
8459083290,8459083292,2,1056,1497,-10
8459135278,8459135297,19,1480,1334,-10
8459359382,8459359385,3,1940,1638,-10
8461324859,8461324862,3,1583,1243,-10
8463248911,8463248912,1,1987,2270,-10
8463769617,8463769619,2,1145,1284,-10
8464384681,8464384682,1,1242,1345,-10
8466698486,8466698488,2,1416,1670,-10
8472447317,8472447318,1,1585,1469,-10
8473187678,8473187679,1,1692,1362,-10
8474024431,8474024434,3,1973,2564,-10
8474486784,8474486781,-3,21661,15125,-10
8475055681,8475055683,2,2189,2272,-10
8475672271,8475672270,-1,1544,1761,-10
8477565430,8477565430,0,1415,1403,-10
8477741077,8477741080,3,1516,1869,-10
8478004097,8478004097,0,1239,2085,-10
8478101514,8478101512,-2,1298,1198,-10
8478650506,8478650508,2,2364,2293,-10
8481173206,8481173208,2,1164,898,-10
8482456315,8482456318,3,2747,2042,-10
8486735814,8486735817,3,1620,1292,-10
8490183176,8490183177,1,1355,1259,-10
8491461598,8491461600,2,1265,1748,-10
8497528958,8497528954,-4,1119,913,-10
8499490081,8499490082,1,1529,1399,-10
8500291993,8500291994,1,1382,1602,-10
8503837650,8503837654,4,846,944,-10
8505535894,8505535895,1,1651,1469,-10
8509862082,8509862087,5,1450,1644,-10
8512013942,8512013945,3,2305,2135,-10
8514664985,8514664987,2,1879,1672,-10
8520371386,8520371386,0,1873,1873,-10
8520492862,8520492863,1,1331,1227,-10
8521855724,8521855725,1,1486,1478,-10
8525097597,8525097602,5,2455,1257,-10
8525149363,8525149366,3,25477,21646,-10
8526320042,8526320044,2,1529,1276,-10
8528002854,8528002858,4,1284,1728,-10
8530584346,8530584348,2,1433,1604,-10
8530692814,8530692815,1,1514,1899,-10
8531453085,8531453084,-1,1865,2100,-10
8531719030,8531719034,4,1710,1748,-10
8532147697,8532147699,2,2029,1976,-10
8534773028,8534773030,2,1677,1362,-10
8536178653,8536178653,0,1220,1482,-10
8536223700,8536223719,19,666,1171,-10
8536539430,8536539434,4,1601,1598,-10
8540150474,8540150476,2,1199,1882,-10
8542634942,8542634944,2,1559,1340,-10
8543519074,8543519073,-1,1295,1020,-10
8544160284,8544160286,2,2100,1216,-10
8545036983,8545036982,-1,1689,2154,-10
8545580277,8545580279,2,2217,2183,-10
8547707357,8547707350,-7,1486,8006,-10
8548822923,8548822926,3,1770,1512,-10
8552024017,8552024017,0,1710,1469,-10
8555028561,8555028563,2,1396,1423,-10
8556124061,8556124063,2,1259,1057,-10
8559578834,8559578835,1,1161,1111,-10
8562071191,8562071193,2,1514,1676,-10
8567145314,8567145315,1,1516,1635,-10
8570774562,8570774564,2,1155,1428,-10
8571464802,8571464803,1,1516,1668,-10
8572994565,8572994566,1,1630,1485,-10
8578764295,8578764295,0,1251,1746,-10
8582645020,8582645021,1,1305,2043,-10
8588196497,8588196497,0,1444,2167,-10
8589065030,8589065031,1,1083,1089,-10
8590368718,8590368718,0,1612,1528,-10
8597010285,8597010280,-5,40030,20458,-10
8602677956,8602677959,3,1900,1595,-10
8602891728,8602891731,3,1381,1495,-10
8603956431,8603956432,1,1738,1944,-10
8604282131,8604282136,5,1186,1359,-10
8606305154,8606305153,-1,1453,2199,-10
8607835778,8607835782,4,2626,1503,-10
8607924306,8607924308,2,1583,1737,-10
8609233447,8609233453,6,4596,2097,-10
8609431509,8609431511,2,1429,1875,-10
8611711174,8611711175,1,2029,1890,-10
8614688286,8614688288,2,1491,1933,-10
8614842818,8614842822,4,1565,1354,-10
8615527620,8615527618,-2,6970,14763,-10
8615743923,8615743923,0,1229,1398,-10
8617133222,8617133225,3,1521,1421,-10
8617814122,8617814123,1,1384,1570,-10
8619854609,8619854610,1,1528,1298,-10
8620776141,8620776142,1,1535,1078,-10
8623097433,8623097434,1,1600,1799,-10
8625371755,8625371758,3,1545,1298,-10
8626832402,8626832405,3,1465,1501,-10
8627840302,8627840305,3,1450,1421,-10
8628369398,8628369399,1,1131,1470,-10
8628702135,8628702135,0,1634,2656,-10
8633081134,8633081143,9,1498,732,-10
8633310698,8633310701,3,1746,1489,-10
8633452594,8633452594,0,1422,1289,-10
8635624321,8635624322,1,963,1325,-10
8638008145,8638008146,1,1392,1530,-10
8639164446,8639164444,-2,2267,5730,-10
8639371558,8639371561,3,1823,1412,-10
8639884578,8639884580,2,1464,1384,-10
8641302271,8641302273,2,628,613,-10
8645163744,8645163743,-1,99619,50752,-10
8645720177,8645720178,1,1627,1969,-10
8645896212,8645896211,-1,1471,1375,-10
8648534474,8648534474,0,1947,1622,-10
8650227646,8650227649,3,1262,1500,-10
8654244059,8654244060,1,1319,1955,-10
8655123955,8655123956,1,1741,1140,-10
8655293662,8655293664,2,11960,19805,-10
8657236010,8657236013,3,1888,1819,-10
8660473835,8660473835,0,762,857,-10
8661559795,8661559798,3,2003,1546,-10
8663276080,8663276085,5,1600,982,-10
8664064128,8664064129,1,1640,1820,-10
8670774701,8670774708,7,3377,1540,-10
8672731843,8672731844,1,1518,1940,-10
8674135143,8674135146,3,2343,1133,-10
8675817482,8675817483,1,1380,1467,-10
8676376782,8676376784,2,1273,1639,-10
8678497257,8678497259,2,1626,1785,-10
8683081271,8683081271,0,1072,1082,-10
8683282577,8683282578,1,1717,1575,-10
8684390953,8684390955,2,1167,1488,-10
8685187526,8685187529,3,1347,1270,-10
8688010026,8688010029,3,1334,1715,-10
8688836182,8688836182,0,1100,885,-10
8690719759,8690719778,19,1209,1175,-10
8690974702,8690974683,-19,1328,1227,-10
8691119188,8691119189,1,1583,1533,-10
8692494610,8692494611,1,1409,1506,-10
8699091413,8699091418,5,1283,1884,-10
8700410238,8700410238,0,1430,1440,-10
8702040590,8702040590,0,1280,1713,-10
8702482023,8702482025,2,1412,1516,-10
8703601865,8703601865,0,1844,1552,-10
8703701721,8703701722,1,1221,1108,-10
8708438918,8708438919,1,1444,1439,-10
8709324553,8709324555,2,1724,1419,-10
8710173730,8710173734,4,1364,1298,-10
8711725814,8711725818,4,1608,927,-10
8713409725,8713409726,1,1828,1691,-10
8714451338,8714451341,3,1437,1103,-10
8716538003,8716538006,3,2058,1742,-10
8718752930,8718752931,1,2055,1894,-10
8722576952,8722576954,2,1723,1851,-10
8722720364,8722720365,1,1879,1600,-10
8724367536,8724367538,2,1409,1549,-10
8727985702,8727985707,5,1109,947,-10
8728493416,8728493417,1,1733,2015,-10
8729059699,8729059703,4,1132,1134,-10
8729414463,8729414468,5,2403,2373,-10
8732950391,8732950394,3,1536,1406,-10
8734906218,8734906220,2,1321,1420,-10
8735464586,8735464587,1,1649,1793,-10
8737149151,8737149150,-1,1024,1268,-10
8745456997,8745456998,1,1029,1273,-10
8746577253,8746577254,1,1796,2131,-10
8747142891,8747142890,-1,1337,1615,-10
8748525494,8748525497,3,1350,1678,-10
8754724338,8754724342,4,2126,1560,-10
8758181977,8758181978,1,2064,2105,-10
8758517595,8758517598,3,2091,1621,-10
8762406746,8762406746,0,2079,1856,-10
8770520409,8770520410,1,1538,1612,-10
8771097649,8771097651,2,1702,1618,-10
8773615977,8773615977,0,1320,1893,-10
8776291574,8776291575,1,1776,1865,-10
8776409814,8776409818,4,1896,1457,-10
8780000535,8780000540,5,1530,1800,-10
8780221419,8780221419,0,1226,2457,-10
8784433881,8784433874,-7,1118,4325,-10
8788639380,8788639379,-1,1429,2552,-10
8792061046,8792061047,1,1628,1855,-10
8792990338,8792990340,2,1640,1704,-10
8793855893,8793855894,1,1528,1613,-10
8795433226,8795433229,3,1779,1697,-10
8798306738,8798306739,1,1608,1152,-10
8801955229,8801955231,2,1216,1631,-10
8801984546,8801984546,0,1255,1649,-10
8803155644,8803155633,-11,1533,2064,-10
8806063474,8806063474,0,1441,2208,-10
8806648849,8806648850,1,1001,1308,-10
8808182054,8808182055,1,1226,1417,-10
8811151760,8811151762,2,1446,1749,-10
8811601516,8811601518,2,1728,1275,-10
8812475689,8812475691,2,1398,1944,-10
8812545069,8812545072,3,1471,1395,-10
8815254162,8815254161,-1,1534,1781,-10
8815603738,8815603742,4,1034,1195,-10
8815798817,8815798815,-2,3187,4162,-10
8818688538,8818688539,1,1720,2069,-10
8822058390,8822058391,1,1377,2116,-10
8822321789,8822321791,2,1969,1721,-10
8824539365,8824539371,6,1401,1419,-10
8826103121,8826103121,0,800,916,-10
8827216320,8827216323,3,3466,2070,-10
8831526775,8831526776,1,1885,1624,-10
8834818762,8834818763,1,1580,2173,-10
8841140207,8841140209,2,1244,892,-10
8841795179,8841795181,2,1635,1646,-10
8846316754,8846316756,2,1877,1287,-10
8852969014,8852969017,3,2193,1372,-10
8854007832,8854007833,1,1381,1363,-10
8854743765,8854743767,2,1380,1568,-10
8855577736,8855577721,-15,1185,1211,-10
8857201249,8857201255,6,2079,1082,-10
8857974670,8857974671,1,1340,1513,-10
8860534503,8860534486,-17,2176,2238,-10
8860861617,8860861618,1,1542,1552,-10
8863291254,8863291256,2,2191,1817,-10
8863556655,8863556659,4,1780,1559,-10
8869461865,8869461866,1,1345,1615,-10
8870246642,8870246642,0,1618,1636,-10
8874676915,8874676918,3,1551,1433,-10
8878870329,8878870330,1,2581,1269,-10
8880076959,8880076957,-2,1388,1926,-10
8881762998,8881763001,3,1994,2110,-10
8882906080,8882906084,4,1233,1006,-10
8885343698,8885343698,0,1026,1551,-10
8887993260,8887993263,3,1949,1194,-10
8888090247,8888090247,0,1119,1525,-10
8888444181,8888444185,4,2408,1174,-10
8888828725,8888828726,1,1366,1853,-10
8898997981,8898997985,4,1450,1366,-10
8899913914,8899913918,4,2508,1798,-10
8899977480,8899977481,1,1552,1461,-10
8903297572,8903297586,14,3626,1421,-10
8903455735,8903455739,4,2057,1665,-10
8904705226,8904705226,0,1339,1195,-10
8908139315,8908139318,3,1451,1714,-10
8915744902,8915744903,1,1591,2045,-10
8917598467,8917598467,0,1404,1280,-10
8919688689,8919688695,6,6401,2678,-10
8925386844,8925386837,-7,24606,17331,-10
8928444735,8928444735,0,1838,1877,-10
8930366387,8930366392,5,1828,1452,-10
8930594774,8930594754,-20,1520,1863,-10
8932029085,8932029093,8,5010,906,-10
8933380427,8933380426,-1,1486,2094,-10
8934065361,8934065362,1,1344,1693,-10
8938292638,8938292640,2,1188,1504,-10
8939214300,8939214302,2,1639,1272,-10
8940657261,8940657261,0,1388,1717,-10
8941501474,8941501479,5,1945,1881,-10
8942312518,8942312521,3,2263,2195,-10
8944408345,8944408346,1,1430,1652,-10
8944438177,8944438177,0,1883,2311,-10
8946108767,8946108768,1,1118,1661,-10
8946723219,8946723221,2,1472,1923,-10
8948047690,8948047695,5,964,1094,-10
8952145537,8952145538,1,1602,1397,-10
8954111202,8954111203,1,1126,1467,-10
8960553698,8960553702,4,1701,1418,-10
8962354186,8962354186,0,1944,2122,-10
8962482520,8962482522,2,1460,1458,-10
8963996483,8963996485,2,1958,1560,-10
8964757494,8964757496,2,1443,1645,-10
8967560149,8967560151,2,1076,1365,-10
8968844393,8968844394,1,2198,2210,-10
8970095728,8970095731,3,2025,1469,-10
8971469418,8971469418,0,781,2388,-10
8978292018,8978292018,0,1129,1834,-10
8978683225,8978683229,4,1487,1402,-10
8979454161,8979454162,1,1216,1074,-10
8981164423,8981164422,-1,1032,1274,-10
8983060401,8983060403,2,963,1081,-10
8984888218,8984888218,0,1566,1495,-10
8985343377,8985343377,0,1545,1428,-10
8985546750,8985546752,2,1679,1586,-10
8990288714,8990288717,3,1472,1467,-10
8990941286,8990941287,1,1241,1313,-10
8992995720,8992995722,2,1522,1650,-10
8995366022,8995366023,1,912,1718,-10
9000751687,9000751689,2,1679,1451,-10
9002903165,9002903170,5,2182,1241,-10
9004132278,9004132281,3,1382,1305,-10
9005446218,9005446221,3,1923,1726,-10
9006585790,9006585790,0,1868,1737,-10
9014343470,9014343471,1,1141,1312,-10
9014789069,9014789071,2,1530,1447,-10
9015099491,9015099493,2,1227,1055,-10
9015347065,9015347068,3,1180,1371,-10
9018607073,9018607075,2,2602,1885,-10
9018773290,9018773293,3,1982,1986,-10
9020526178,9020526180,2,1634,1163,-10
9021707355,9021707358,3,1712,1616,-10
9027091501,9027091503,2,1702,1830,-10
9027276871,9027276870,-1,1311,1301,-10
9028471349,9028471350,1,1616,1509,-10
9029861201,9029861205,4,2194,1644,-10
9032838210,9032838213,3,1471,1130,-10
9033191149,9033191128,-21,2174,2065,-10
9034800816,9034800818,2,1584,1666,-10
9036421855,9036421857,2,1840,1556,-10
9038256556,9038256556,0,1914,1874,-10
9039471351,9039471350,-1,1386,1169,-10
9042779481,9042779486,5,1502,1033,-10
9043555782,9043555783,1,1554,1493,-10
9045408053,9045408055,2,1293,1310,-10
9046221794,9046221796,2,1648,1458,-10
9047653493,9047653495,2,1080,1103,-10
9057041020,9057041022,2,1686,1692,-10
9058145178,9058145180,2,1351,1403,-10
9065534523,9065534525,2,2035,1235,-10
9065814299,9065814299,0,1669,1519,-10
9067448135,9067448139,4,1647,1189,-10
9068637471,9068637472,1,1801,1747,-10
9071344130,9071344132,2,1373,1435,-10
9072575650,9072575654,4,4063,1972,-10
9072692916,9072692937,21,1062,1448,-10
9076206550,9076206551,1,1234,1468,-10
9076722431,9076722433,2,2298,1605,-10
9077439424,9077439426,2,1496,1444,-10
9077948570,9077948573,3,826,721,-10
9081669782,9081669782,0,2602,2046,-10
9082207920,9082207921,1,1183,1648,-10
9087245684,9087245685,1,1844,1632,-10
9089052092,9089052095,3,1326,1247,-10
9089972166,9089972169,3,1841,1598,-10
9096662995,9096662995,0,1115,2212,-10
9097453535,9097453534,-1,1268,1575,-10
9102122468,9102122471,3,1637,1138,-10
9103935758,9103935759,1,1585,1214,-10
9106598201,9106598204,3,1549,1493,-10
9108500039,9108500040,1,1358,1399,-10
9109619474,9109619473,-1,1558,1255,-10
9110900606,9110900611,5,1124,1279,-10
9112171207,9112171208,1,1115,1130,-10
9115377145,9115377145,0,1180,1470,-10
9116593507,9116593506,-1,1740,1840,-10
9116799294,9116799295,1,1947,2568,-10
9119040125,9119040127,2,1241,1699,-10
9120420775,9120420775,0,2440,1464,-10
9124222231,9124222232,1,1717,1366,-10
9125393255,9125393257,2,2309,1681,-10
9126636581,9126636579,-2,1115,1572,-10
9127686975,9127686977,2,1502,1391,-10
9128566868,9128566870,2,1851,1576,-10
9130362490,9130362493,3,1332,1438,-10
9131070044,9131070055,11,13803,42526,-10
9131818924,9131818926,2,1378,1353,-10
9139467667,9139467664,-3,1529,2170,-10
9139583108,9139583109,1,1322,1895,-10
9140608041,9140608036,-5,1791,5194,-10
9142676174,9142676174,0,1072,1046,-10
9150843094,9150843095,1,1689,1562,-10
9152253099,9152253102,3,1282,1461,-10
9153697948,9153697951,3,1893,1503,-10
9155382627,9155382629,2,1555,1566,-10
9157554818,9157554820,2,1647,1384,-10
9158654449,9158654453,4,1939,1643,-10
9160512744,9160512742,-2,1679,2647,-10
9161140954,9161140958,4,1391,1708,-10
9162153828,9162153844,16,832,769,-10
9163004848,9163004854,6,4197,1419,-10
9163587110,9163587113,3,1059,1376,-10
9164617858,9164617858,0,1258,1483,-10
9166963192,9166963194,2,1486,1385,-10
9169804715,9169804718,3,1956,1883,-10
9170119914,9170119916,2,1787,1808,-10
9170439795,9170439789,-6,1489,5211,-10
9171166857,9171166859,2,1888,1277,-10
9174980943,9174980946,3,1690,1316,-10
9175593026,9175593027,1,1555,1314,-10
9178291704,9178291706,2,1240,1156,-10
9186264722,9186264723,1,1742,1493,-10
9187372918,9187372919,1,1359,1735,-10
9188802515,9188802514,-1,1466,1747,-10
9190880079,9190880082,3,2288,2328,-10
9192280730,9192280735,5,1625,1302,-10
9192919039,9192919041,2,1249,1319,-10
9194980917,9194980919,2,1429,1880,-10
9196683694,9196683691,-3,1076,2061,-10
9200834196,9200834194,-2,2162,2259,-10
9204242866,9204242868,2,1340,1460,-10
9204793015,9204793015,0,1433,1425,-10
9209037621,9209037623,2,1705,1232,-10
9209295016,9209295006,-10,1301,1251,-10
9209812677,9209812679,2,1354,1495,-10
9212560460,9212560453,-7,755,4237,-10
9213847193,9213847195,2,1166,1459,-10
9214438238,9214438242,4,2090,1512,-10
9215928999,9215929001,2,2552,2161,-10
9216142899,9216142903,4,2135,1210,-10
9220315101,9220315103,2,1173,1413,-10
9222774534,9222774539,5,1573,1477,-10
9223848931,9223848933,2,1927,1683,-10
9227376669,9227376670,1,2124,2071,-10
9229306201,9229306205,4,1488,1255,-10
9232342402,9232342403,1,1606,1873,-10
9234308756,9234308759,3,1387,1436,-10
9235563027,9235563031,4,1343,1290,-10
9236945334,9236945336,2,6201,21104,-10
9241763272,9241763274,2,2101,1553,-10
9242935374,9242935377,3,1243,1495,-10
9243910827,9243910822,-5,724,1987,-10
9250516690,9250516693,3,1664,1652,-10
9255778542,9255778522,-20,1225,936,-10
9256397983,9256397961,-22,1830,1315,-10
9257423543,9257423545,2,2026,1382,-10
9260183257,9260183259,2,1890,1499,-10
9260841446,9260841453,7,2816,1183,-10
9261115508,9261115513,5,2224,1639,-10
9264167325,9264167325,0,1147,1058,-10
9269069126,9269069124,-2,1262,2025,-10
9269763638,9269763639,1,1571,1833,-10
9271176984,9271176982,-2,1198,1369,-10
9273979219,9273979220,1,2078,1743,-10
9274534890,9274534894,4,1337,1331,-10
9277465031,9277465035,4,2470,1337,-10
9277775486,9277775487,1,1347,1385,-10
9278209630,9278209631,1,2137,1353,-10
9279168049,9279168050,1,1368,1657,-10
9280494108,9280494110,2,1427,1359,-10
9281704246,9281704247,1,1520,1526,-10
9282017262,9282017263,1,2037,2199,-10
9284908924,9284908926,2,1274,1513,-10
9287020267,9287020268,1,1918,1737,-10
9288485783,9288485785,2,1778,2004,-10
9295980327,9295980330,3,1167,2270,-10
9297057842,9297057842,0,2432,1895,-10
9297997885,9297997885,0,778,1213,-10
9298204466,9298204469,3,1286,1222,-10
9299162976,9299162977,1,2073,1966,-10
9303571895,9303571897,2,1032,1263,-10
9307566438,9307566439,1,1121,1286,-10
9309232311,9309232313,2,1202,936,-10
9312773338,9312773339,1,1280,1388,-10
9313359120,9313359121,1,1054,1596,-10
9318405502,9318405503,1,1801,1587,-10
9318915198,9318915202,4,1926,1758,-10
9320922910,9320922910,0,1143,1315,-10
9322378205,9322378207,2,1333,1398,-10
9323702942,9323702947,5,1395,1455,-10
9325575346,9325575348,2,1553,2234,-10
9327116928,9327116930,2,1347,1775,-10
9327340094,9327340099,5,2275,1781,-10
9328893092,9328893093,1,1331,1306,-10
9328958443,9328958447,4,1131,1123,-10
9329867918,9329867925,7,670,791,-10
9331092517,9331092519,2,1479,1418,-10
9332248536,9332248539,3,2043,1617,-10
9332923874,9332923875,1,1157,1110,-10
9335250029,9335250033,4,1778,1706,-10
9336228886,9336228889,3,1052,1329,-10
9337137938,9337137940,2,1719,1663,-10
9337569499,9337569503,4,2190,1179,-10
9343080278,9343080282,4,1558,1730,-10
9343984549,9343984551,2,1780,1384,-10
9344875769,9344875773,4,1856,1109,-10
9345425540,9345425541,1,1663,1846,-10
9345974886,9345974888,2,1803,2460,-10
9346152574,9346152574,0,1564,1398,-10
9348736650,9348736651,1,1137,1575,-10
9349246768,9349246770,2,1536,1199,-10
9350877488,9350877490,2,1246,1336,-10
9354452670,9354452673,3,1602,1712,-10
9357308113,9357308115,2,2118,1662,-10
9359789371,9359789375,4,1211,1187,-10
9361682342,9361682344,2,1761,1587,-10
9364087646,9364087650,4,2223,1635,-10
9364241905,9364241907,2,1599,972,-10
9367154850,9367154851,1,1680,1422,-10
9370501393,9370501394,1,1332,1653,-10
9370742625,9370742626,1,2046,1909,-10
9376393435,9376393438,3,1890,1966,-10
9383358273,9383358274,1,1153,1302,-10
9390092245,9390092246,1,2133,1805,-10
9391695302,9391695304,2,2143,2301,-10
9396140819,9396140823,4,1338,1357,-10
9398393351,9398393353,2,1460,1272,-10
9399196173,9399196175,2,1244,1741,-10
9399359262,9399359265,3,1519,1413,-10
9400809192,9400809198,6,1925,1251,-10
9401406414,9401406415,1,1218,1841,-10
9404229557,9404229558,1,1600,1553,-10
9409924805,9409924806,1,1445,1609,-10
9410989273,9410989277,4,1499,1720,-10
9412482202,9412482206,4,1927,1290,-10
9412581442,9412581443,1,1653,1303,-10
9413720037,9413720038,1,2014,2013,-10
9416789733,9416789734,1,1133,1635,-10
9420042149,9420042150,1,704,792,-10
9420728958,9420728961,3,1560,1672,-10
9421690745,9421690745,0,894,2219,-10
9422911641,9422911642,1,1657,1539,-10
9424681186,9424681189,3,1542,1261,-10
9425177834,9425177834,0,1304,1302,-10
9427368661,9427368663,2,1406,1923,-10
9430894618,9430894622,4,1802,1054,-10
9432653039,9432653042,3,1246,1534,-10
9433285623,9433285626,3,1404,1525,-10
9433880053,9433880052,-1,1646,1882,-10
9434202356,9434202358,2,1117,1421,-10
9436264703,9436264706,3,1195,1599,-10
9437009161,9437009165,4,1939,1294,-10
9438421120,9438421122,2,2453,2322,-10
9440875897,9440875898,1,1975,1627,-10
9441436571,9441436574,3,1451,2079,-10
9442585237,9442585237,0,1478,1617,-10
9446395533,9446395537,4,1414,1502,-10
9446769036,9446769038,2,1422,1492,-10
9449134209,9449134212,3,1424,1245,-10
9451758415,9451758416,1,909,1697,-10
9452686972,9452686975,3,4023,3117,-10
9452759270,9452759271,1,1889,1172,-10
9454292566,9454292567,1,1864,2401,-10
9457016659,9457016659,0,931,986,-10
9457329846,9457329847,1,1452,1716,-10
9457390246,9457390247,1,1100,1376,-10
9458416846,9458416847,1,780,799,-10
9461538237,9461538237,0,1180,961,-10
9464620242,9464620243,1,939,1104,-10
9466281098,9466281099,1,1951,1074,-10
9470538583,9470538581,-2,1191,1984,-10
9470621710,9470621692,-18,1889,1817,-10
9470779707,9470779709,2,1586,1405,-10
9470966150,9470966151,1,1149,1195,-10
9473994526,9473994528,2,2478,1715,-10
9475186869,9475186870,1,1184,819,-10
9476083918,9476083921,3,1996,1971,-10
9486240636,9486240636,0,1893,1459,-10
9488620087,9488620091,4,1696,1135,-10
9489782961,9489782961,0,1306,1551,-10
9491190644,9491190642,-2,1314,1629,-10
9492069861,9492069863,2,1605,1435,-10
9492425566,9492425566,0,1030,1083,-10
9499823939,9499823942,3,1595,1810,-10
9501928967,9501928969,2,1942,2289,-10
9503558863,9503558869,6,4489,1986,-10
9510454403,9510454405,2,1831,1509,-10
9512160242,9512160246,4,1660,1606,-10
9513788046,9513788047,1,1577,1813,-10
9517066634,9517066633,-1,1458,2068,-10
9519048687,9519048689,2,1187,1292,-10
9519514690,9519514693,3,1937,1741,-10
9520269678,9520269683,5,1892,1426,-10
9522065140,9522065140,0,7783,18232,-10
9525110798,9525110805,7,1518,1174,-10
9526798253,9526798257,4,2340,1477,-10
9526977445,9526977446,1,1027,1058,-10
9528778279,9528778281,2,1594,1074,-10
9531206645,9531206646,1,1607,1462,-10
9533746631,9533746633,2,1199,1369,-10
9534866149,9534866150,1,1344,1371,-10
9535082738,9535082738,0,1873,2571,-10
9540686030,9540686034,4,1404,1449,-10
9542921378,9542921379,1,1466,1295,-10
9544537179,9544537179,0,1910,1930,-10
9548718862,9548718865,3,1531,1135,-10
9548986001,9548986003,2,1850,2086,-10
9549698483,9549698485,2,753,1476,-10
9553308039,9553308042,3,1993,1645,-10
9554919303,9554919305,2,1184,1517,-10
9557227641,9557227642,1,1508,1477,-10
9557986553,9557986555,2,1555,1471,-10
9559871782,9559871785,3,1760,1537,-10
9565153105,9565153105,0,1467,1037,-10
9574036765,9574036771,6,1586,1356,-10
9574249964,9574249966,2,1905,2135,-10
9577967510,9577967513,3,1802,1521,-10
9578197153,9578197156,3,1424,1070,-10
9579552390,9579552391,1,1502,1505,-10
9582488105,9582488106,1,1388,2251,-10
9584237121,9584237124,3,1670,2056,-10
9585553679,9585553682,3,1661,1398,-10
9586970357,9586970358,1,1665,1228,-10
9587036271,9587036280,9,1556,891,-10
9589827229,9589827233,4,2018,1274,-10
9591188503,9591188502,-1,1652,1608,-10
9591808166,9591808169,3,1666,1574,-10
9592950195,9592950197,2,1936,1954,-10
9593781724,9593781730,6,2305,1099,-10
9593906591,9593906593,2,1745,1337,-10
9597052996,9597053002,6,2099,1534,-10
9597665890,9597665891,1,1778,1279,-10
9598267843,9598267845,2,2335,2168,-10
9598419946,9598419948,2,1681,1552,-10
9599408118,9599408120,2,1770,1582,-10
9603378329,9603378331,2,1424,1119,-10
9606739706,9606739708,2,593,1157,-10
9607728879,9607728886,7,10060,4120,-10
9613422870,9613422872,2,1564,1687,-10
9614068329,9614068332,3,1837,1361,-10
9615823566,9615823567,1,1373,1134,-10
9618175126,9618175127,1,1657,1601,-10
9624812602,9624812603,1,1741,1683,-10
9627735597,9627735599,2,1643,1984,-10
9628443079,9628443083,4,1288,1545,-10
9630090634,9630090637,3,1869,1762,-10
9636380315,9636380316,1,2258,2035,-10
9636970620,9636970620,0,1617,2004,-10
9641406598,9641406600,2,2549,2352,-10
9646206889,9646206889,0,1427,1160,-10
9648904077,9648904076,-1,1445,1694,-10
9650227040,9650227042,2,1234,1100,-10
9650677322,9650677320,-2,1327,2310,-10
9650857647,9650857650,3,1683,1508,-10
9652664317,9652664315,-2,1122,2384,-10
9652935438,9652935439,1,1653,1618,-10
9653196373,9653196374,1,1631,1601,-10
9653976061,9653976063,2,1534,1680,-10
9654584892,9654584893,1,1334,1199,-10
9654866589,9654866590,1,1628,1660,-10
9656390081,9656390082,1,1887,2128,-10
9658114030,9658114029,-1,1752,2267,-10
9658767965,9658767966,1,1620,1351,-10
9661321703,9661321705,2,1449,1889,-10
9667323631,9667323633,2,1301,1041,-10
9669407342,9669407342,0,1228,1255,-10
9672621932,9672621930,-2,2199,2191,-10
9674437687,9674437689,2,1846,2122,-10
9675852244,9675852246,2,1352,1128,-10
9679623111,9679623110,-1,1682,1494,-10
9680218747,9680218763,16,2169,1117,-10
9680946075,9680946076,1,1233,1275,-10
9685291551,9685291554,3,1903,1979,-10
9685646393,9685646394,1,1035,1133,-10
9685834827,9685834829,2,1545,1171,-10
9686735910,9686735913,3,1494,1855,-10
9688580333,9688580335,2,1352,1220,-10
9688866262,9688866264,2,1895,2064,-10
9690990237,9690990241,4,2128,1214,-10
9691514862,9691514865,3,1883,1638,-10
9692843403,9692843401,-2,971,1443,-10
9695519843,9695519843,0,1308,1552,-10
9696023314,9696023317,3,1422,1432,-10
9698042474,9698042474,0,2001,1227,-10
9698636210,9698636211,1,1001,1313,-10
9698995744,9698995746,2,1028,1498,-10
9702919680,9702919683,3,1398,1788,-10
9704416297,9704416298,1,2149,1720,-10
9705464189,9705464190,1,1462,1333,-10
9707879842,9707879842,0,1107,1727,-10
9708175203,9708175210,7,1422,1588,-10
9710604698,9710604701,3,1350,1220,-10
9711607489,9711607511,22,676,1190,-10
9714047847,9714047849,2,1653,1343,-10
9715732997,9715732997,0,1241,1318,-10
9717547203,9717547202,-1,1021,2039,-10
9717808039,9717808042,3,1849,1642,-10
9718281323,9718281326,3,1958,1467,-10
9722318090,9722318094,4,2279,1745,-10
9723208579,9723208581,2,1704,1558,-10
9724640295,9724640298,3,1631,1357,-10
9724889353,9724889352,-1,1363,925,-10
9727578818,9727578822,4,1769,1099,-10
9729814129,9729814130,1,1145,1501,-10
9731044056,9731044058,2,1666,1340,-10
9732623890,9732623893,3,1407,1523,-10
9733534514,9733534513,-1,1613,1348,-10
9735403778,9735403785,7,3290,1310,-10
9736393377,9736393379,2,513,782,-10
9742834478,9742834480,2,1330,1283,-10
9743803327,9743803322,-5,2828,6919,-10
9746214448,9746214450,2,1335,1327,-10
9751218889,9751218890,1,1354,1577,-10
9752337330,9752337331,1,1270,1488,-10
9755268083,9755268089,6,2689,1306,-10
9755919675,9755919677,2,1376,1550,-10
9758060814,9758060816,2,1189,1532,-10
9760799931,9760799930,-1,1147,1743,-10
9761061042,9761061043,1,1583,1955,-10
9761900428,9761900430,2,1568,1987,-10
9763029653,9763029654,1,1662,1685,-10
9765586254,9765586269,15,15088,32807,-10
9768339494,9768339473,-21,1402,1303,-10
9769605904,9769605906,2,1289,1463,-10
9769960892,9769960874,-18,78,3109,-10
9770643163,9770643163,0,1864,1777,-10
9771521919,9771521916,-3,1455,1981,-10
9778114021,9778114027,6,3891,1435,-10
9779262595,9779262591,-4,797,2896,-10
9779326665,9779326667,2,1631,1962,-10
9783145594,9783145594,0,1391,1612,-10
9784069540,9784069544,4,1499,1600,-10
9785706786,9785706787,1,1083,1509,-10
9792565796,9792565798,2,1076,1431,-10
9793755575,9793755578,3,851,909,-10
9801722693,9801722680,-13,3436,10479,-10
9803693566,9803693566,0,894,1152,-10
9804529909,9804529914,5,2105,1516,-10
9806264982,9806264986,4,1322,1275,-10
9818277314,9818277316,2,1044,1515,-10
9819177971,9819177971,0,1189,1598,-10
9820555736,9820555737,1,1556,1261,-10
9822707891,9822707894,3,1980,1633,-10
9823188079,9823188079,0,1186,1595,-10
9823443911,9823443913,2,1189,1126,-10
9830783481,9830783483,2,1086,1408,-10
9832134434,9832134435,1,1961,1712,-10
9836266771,9836266773,2,1956,1909,-10
9836346617,9836346619,2,1631,1107,-10
9836609697,9836609698,1,1806,1294,-10
9837385194,9837385194,0,1521,1511,-10
9837844443,9837844444,1,1241,1194,-10
9838554294,9838554295,1,1687,1913,-10
9839768360,9839768361,1,1261,1611,-10
9841499546,9841499546,0,1381,1582,-10
9842377035,9842377037,2,1238,1954,-10
9844039498,9844039500,2,1540,1538,-10
9846055475,9846055477,2,1265,1072,-10
9846509603,9846509605,2,1100,1361,-10
9848735057,9848735056,-1,952,854,-10
9850859690,9850859689,-1,3561,7456,-10
9851012059,9851012062,3,1471,2114,-10
9851251301,9851251301,0,1546,1612,-10
9855929287,9855929281,-6,1382,1387,-10
9856630555,9856630558,3,1490,1634,-10
9857875852,9857875853,1,1718,1823,-10
9860001814,9860001817,3,1773,1219,-10
9861248828,9861248828,0,1931,1563,-10
9863015260,9863015259,-1,1577,1790,-10
9863217400,9863217402,2,1544,1768,-10
9863426209,9863426211,2,997,949,-10
9865283627,9865283629,2,1586,1283,-10
9867069533,9867069534,1,1267,1415,-10
9869069737,9869069740,3,1306,1725,-10
9872985454,9872985457,3,1920,1467,-10
9877472907,9877472910,3,1312,1604,-10
9879458529,9879458531,2,1666,1622,-10
9882451598,9882451602,4,1541,1758,-10
9883166215,9883166219,4,1563,1905,-10
9885145006,9885145009,3,1308,1307,-10
9889451351,9889451355,4,1539,1780,-10
9891549234,9891549237,3,1018,1023,-10
9891777103,9891777106,3,2343,1503,-10
9893636167,9893636167,0,1375,1231,-10
9895102832,9895102833,1,1332,1194,-10
9898427562,9898427563,1,1471,1452,-10
9898756998,9898757002,4,1150,1681,-10
9901407001,9901407002,1,727,1369,-10
9902854082,9902854084,2,987,1748,-10
9905716090,9905716091,1,1283,1989,-10
9906941317,9906941322,5,1285,1488,-10
9907230380,9907230382,2,1581,1024,-10
9907717554,9907717548,-6,28093,11240,-10
9912959825,9912959829,4,1298,1514,-10
9914232765,9914232766,1,2073,1635,-10
9916219357,9916219358,1,935,1222,-10
9917308194,9917308198,4,1073,1206,-10
9918271427,9918271429,2,1983,2204,-10
9919680007,9919680004,-3,893,2161,-10
9920745051,9920745034,-17,181,986,-10
9923188749,9923188749,0,1333,2229,-10
9923437393,9923437394,1,1043,1558,-10
9927290298,9927290301,3,1127,1159,-10
9928979090,9928979094,4,1523,1027,-10
9930571081,9930571082,1,912,1150,-10
9931358322,9931358323,1,1471,1649,-10
9938261074,9938261074,0,1558,1287,-10
9940181029,9940181032,3,1424,1556,-10
9946152941,9946152942,1,1827,1838,-10
9950937649,9950937650,1,1465,1183,-10
9953451252,9953451260,8,12090,24282,-10
9966226369,9966226373,4,2130,1736,-10
9968024059,9968024059,0,1617,1675,-10
9968296299,9968296298,-1,1617,1966,-10
9968389645,9968389648,3,1095,1491,-10
9968948792,9968948794,2,1601,1522,-10
9970568086,9970568087,1,1509,1534,-10
9972901478,9972901479,1,1512,1546,-10
9973476178,9973476178,0,951,1307,-10
9974604405,9974604407,2,1015,1513,-10
9983347417,9983347411,-6,1294,1297,-10
9983937069,9983937071,2,2296,1965,-10
9984192102,9984192105,3,1672,1798,-10
9984908501,9984908503,2,1156,1312,-10
9985685143,9985685142,-1,1664,1248,-10
9988063451,9988063453,2,1633,1271,-10
9989949605,9989949606,1,1373,1707,-10
9993596169,9993596173,4,904,1034,-10
9993740149,9993740152,3,2273,1549,-10
9995249212,9995249213,1,1423,1455,-10
10000449663,10000449666,3,1301,1423,-10
10002941659,10002941662,3,3658,3199,-10
10003878441,10003878444,3,19354,21824,-10
10004102798,10004102802,4,1583,1166,-10
10008080490,10008080492,2,1629,1139,-10
10011933939,10011933942,3,1102,1220,-10
10012597750,10012597750,0,1482,1293,-10
10013579983,10013579983,0,1181,1302,-10
10015570653,10015570655,2,1764,1299,-10
10016349216,10016349218,2,1726,1237,-10
10016913638,10016913642,4,1823,1856,-10
10018448809,10018448814,5,7033,2264,-10
10022586410,10022586404,-6,1396,3853,-10
10024944869,10024944873,4,1033,1630,-10
10027725922,10027725923,1,1865,1925,-10
10027886737,10027886739,2,998,1372,-10
10033955996,10033955997,1,1018,1530,-10
10034711118,10034711118,0,2020,2457,-10
10035366058,10035366062,4,2383,1404,-10
10036881162,10036881162,0,1573,1743,-10
10038109782,10038109782,0,1307,1785,-10
10039454475,10039454475,0,1115,1484,-10
10041474890,10041474884,-6,1221,3280,-10
10044690146,10044690141,-5,1472,2319,-10
10045536186,10045536190,4,1656,1704,-10
10047511962,10047511963,1,2713,1334,-10
10048425743,10048425763,20,1326,1279,-10
10048871315,10048871320,5,3956,2918,-10
10051013062,10051013063,1,2039,2046,-10
10052107484,10052107486,2,1143,1406,-10
10054629768,10054629770,2,1898,1861,-10
10061467728,10061467730,2,1652,1449,-10
10065587033,10065587037,4,1405,1143,-10
10067681220,10067681219,-1,1988,1681,-10
10067745926,10067745920,-6,2571,6617,-10
10068499546,10068499549,3,1260,1817,-10
10073438487,10073438490,3,942,1054,-10
10073666937,10073666945,8,10820,2870,-10
10075835942,10075835944,2,1102,1393,-10
10077411450,10077411450,0,1515,1382,-10
10080406097,10080406098,1,1529,1576,-10
10080552729,10080552730,1,1605,1675,-10
10086158018,10086158021,3,1625,1364,-10
10087431717,10087431717,0,1493,1555,-10
10088363013,10088363019,6,2068,1343,-10
10092739759,10092739762,3,648,943,-10
10094043779,10094043781,2,1905,1283,-10
10094383402,10094383403,1,2005,2158,-10
10097705155,10097705158,3,1949,2387,-10
10098313743,10098313744,1,1691,1225,-10
10100494405,10100494405,0,1010,1794,-10
10100571279,10100571281,2,1723,1866,-10
10103339945,10103339946,1,1457,1757,-10
10106085285,10106085286,1,860,1334,-10
10107288436,10107288440,4,1686,1750,-10
10108157200,10108157199,-1,766,957,-10
10115779454,10115779457,3,1514,1422,-10
10116608734,10116608735,1,1368,1116,-10
10116908579,10116908582,3,1588,1724,-10
10118564557,10118564553,-4,1539,3042,-10
10122104376,10122104377,1,1280,1225,-10
10123549825,10123549827,2,1796,1394,-10
10123627624,10123627625,1,1388,1374,-10
10123742630,10123742611,-19,1452,1811,-10
10126111022,10126111024,2,2560,1401,-10
10128909213,10128909214,1,1596,1581,-10
10130276809,10130276810,1,1476,1691,-10
10131823057,10131823058,1,2153,2056,-10
10132512291,10132512294,3,1384,1541,-10
10133014776,10133014778,2,1672,995,-10
10133854069,10133854065,-4,25499,58807,-10
10135743908,10135743905,-3,656,1873,-10
10137353269,10137353269,0,1319,1752,-10
10138104963,10138104963,0,1415,1378,-10
10140585539,10140585540,1,951,1528,-10
10141940218,10141940221,3,1675,1600,-10
10144342868,10144342868,0,1447,1437,-10
10144968784,10144968786,2,1490,1380,-10
10145721904,10145721910,6,3182,1094,-10
10146265666,10146265669,3,1124,1194,-10
10147628732,10147628733,1,1492,1813,-10
10150434773,10150434775,2,1339,1541,-10
10151495362,10151495366,4,1451,1818,-10
10152697305,10152697306,1,1226,1238,-10
10153672091,10153672086,-5,2242,5952,-10
10154717149,10154717150,1,1212,1177,-10
10155380240,10155380243,3,1169,1340,-10
10156922046,10156922047,1,2038,1760,-10
10157811623,10157811623,0,1237,2101,-10
10163513101,10163513105,4,2725,1983,-10
10164504297,10164504306,9,3984,1521,-10
10165378706,10165378706,0,29573,23833,-10
10165856004,10165856004,0,1262,1536,-10
10170343346,10170343346,0,1478,1541,-10
10172211257,10172211259,2,1329,1966,-10
10173192168,10173192172,4,1139,719,-10
10173844139,10173844139,0,1906,2130,-10
10175985040,10175985047,7,1437,784,-10
10177186643,10177186643,0,1610,1331,-10
10179961409,10179961410,1,1250,1116,-10
10183744429,10183744429,0,1496,1615,-10
10187091302,10187091304,2,1983,1846,-10
10189227828,10189227831,3,2035,1688,-10
10199800448,10199800450,2,1124,1492,-10
10202643282,10202643285,3,2139,1556,-10
10210495102,10210495096,-6,1194,4189,-10
10210629122,10210629123,1,1464,1570,-10
10211621858,10211621863,5,50918,91501,-10
10212100831,10212100833,2,1694,1565,-10
10213307522,10213307523,1,1131,1261,-10
10216184749,10216184751,2,1818,2004,-10
10216277095,10216277096,1,1390,1427,-10
10216901720,10216901721,1,1225,1027,-10
10217646145,10217646146,1,1578,1602,-10
10218275978,10218275979,1,1965,2132,-10
10218795853,10218795856,3,2474,2183,-10
10224136840,10224136842,2,1911,2278,-10
10233149140,10233149139,-1,2095,2344,-10
10234257745,10234257747,2,1659,2047,-10
10236004999,10236005001,2,1356,1262,-10
10237260124,10237260126,2,1183,900,-10
10246676801,10246676803,2,1666,1382,-10
10246833346,10246833347,1,1502,1700,-10
10246966717,10246966719,2,1330,1458,-10
10249609238,10249609239,1,1508,1351,-10
10250914597,10250914598,1,1347,1726,-10
10252211558,10252211554,-4,1332,1758,-10
10252603806,10252603806,0,1446,1450,-10
10253087620,10253087621,1,1699,2015,-10
10254293581,10254293583,2,1257,1699,-10
10255328392,10255328399,7,5402,1655,-10
10256315311,10256315310,-1,1243,1584,-10
10259967757,10259967755,-2,1615,1665,-10
10261733266,10261733265,-1,1436,3028,-10
10264311689,10264311694,5,7851,4468,-10
10264572089,10264572092,3,2294,1645,-10
10268024774,10268024775,1,1721,2349,-10
10268461319,10268461316,-3,1076,2952,-10
10270695618,10270695621,3,2132,1745,-10
10270932973,10270932973,0,1399,1540,-10
10271286899,10271286902,3,1072,1328,-10
10271900953,10271900955,2,1359,1781,-10
10272576577,10272576559,-18,1395,1360,-10
10272649634,10272649635,1,1453,1451,-10
10275381459,10275381459,0,1055,1122,-10
10277197001,10277197004,3,2052,1526,-10
10278133431,10278133410,-21,1571,1638,-10
10278230430,10278230430,0,1611,1635,-10
10280449696,10280449698,2,1756,2141,-10
10282844374,10282844377,3,1423,1903,-10
10290675361,10290675362,1,1751,1713,-10
10293442691,10293442694,3,1040,1346,-10
10300683513,10300683516,3,1699,1670,-10
10302262597,10302262599,2,1525,1008,-10
10303836611,10303836614,3,1969,2003,-10
10304812454,10304812458,4,1039,1463,-10
10305263583,10305263586,3,706,1094,-10
10305952430,10305952408,-22,1384,1023,-10
10308498972,10308498973,1,1796,1355,-10
10309128626,10309128627,1,1931,1830,-10
10311752950,10311752952,2,2208,3151,-10
10312223983,10312223983,0,989,1079,-10
10314606890,10314606886,-4,1642,2972,-10
10315003354,10315003356,2,2031,2035,-10
10318210251,10318210253,2,2112,1799,-10
10318743334,10318743333,-1,1699,2984,-10
10319829759,10319829764,5,1719,1931,-10
10320632035,10320632035,0,26158,24474,-10
10321251957,10321251962,5,2078,1151,-10
10323396741,10323396743,2,1009,1374,-10
10325277006,10325277008,2,1361,1320,-10
10333348741,10333348739,-2,751,1284,-10
10334925109,10334925115,6,2068,1252,-10
10337490595,10337490597,2,1115,1487,-10
10341454793,10341454793,0,1655,1622,-10
10342368530,10342368531,1,1567,1271,-10
10343352311,10343352310,-1,1099,968,-10
10348459197,10348459201,4,873,1210,-10
10355325151,10355325151,0,1725,1640,-10
10356600294,10356600298,4,1308,1789,-10
10358787786,10358787787,1,1496,1729,-10
10362211075,10362211075,0,1143,945,-10
10363114522,10363114525,3,1705,1290,-10
10364053562,10364053563,1,1306,1556,-10
10368129234,10368129237,3,1592,1807,-10
10373036598,10373036600,2,1295,1566,-10
10379263849,10379263849,0,1565,2089,-10
10379564477,10379564474,-3,1101,3860,-10
10380257365,10380257365,0,1333,1420,-10
10386078485,10386078484,-1,1647,2046,-10
10388977851,10388977857,6,2817,1377,-10
10389756336,10389756338,2,1280,1228,-10
10393794177,10393794182,5,1172,1263,-10
10395457988,10395457990,2,1951,1622,-10
10396515566,10396515569,3,2275,1939,-10
10400707130,10400707132,2,2331,2136,-10
10404414469,10404414471,2,1637,1512,-10
10405766998,10405766999,1,1619,1550,-10
10406283821,10406283822,1,2052,1452,-10
10406446336,10406446339,3,1752,1430,-10
10413770393,10413770392,-1,1407,1711,-10
10416993415,10416993419,4,1876,1724,-10
10419064810,10419064811,1,966,1344,-10
10421221170,10421221173,3,1867,1790,-10
10422843029,10422843030,1,1447,1471,-10
10423405833,10423405843,10,7700,37509,-10
10424053708,10424053710,2,1517,1356,-10
10424603914,10424603913,-1,2362,1561,-10
10425646749,10425646752,3,1297,1600,-10
10426644471,10426644471,0,2035,1509,-10
10428802221,10428802221,0,6575,8386,-10
10429646410,10429646411,1,1502,2146,-10
10430078337,10430078321,-16,1387,7896,-10
10431237089,10431237090,1,1374,1446,-10
10432524614,10432524613,-1,802,2100,-10
10433714911,10433714914,3,1473,1475,-10
10433875698,10433875703,5,2696,1707,-10
10437484965,10437484969,4,1371,1695,-10
10440494366,10440494366,0,1797,1442,-10
10441333873,10441333878,5,1666,907,-10
10445291158,10445291158,0,1619,1426,-10
10445465958,10445465962,4,1427,1608,-10
10448192569,10448192573,4,1717,1123,-10
10450545104,10450545104,0,2487,3561,-10
10450886092,10450886087,-5,779,2950,-10
10455557754,10455557755,1,985,875,-10
10459300625,10459300628,3,1808,1511,-10
10459679188,10459679190,2,1431,1609,-10
10461978027,10461978030,3,1494,1644,-10
10463204551,10463204552,1,1641,1689,-10
10465829227,10465829227,0,1510,1614,-10
10468485444,10468485445,1,1341,1663,-10
10471961954,10471961955,1,1146,1332,-10
10475952323,10475952326,3,1833,1922,-10
10477353511,10477353513,2,1002,1344,-10
10481584002,10481584003,1,1952,2134,-10
10482326829,10482326830,1,1484,1147,-10
10487489103,10487489103,0,1501,2215,-10
10488855728,10488855729,1,1426,1363,-10
10491699722,10491699722,0,1184,1017,-10
10493163068,10493163069,1,1856,1365,-10
10497321961,10497321962,1,1443,1229,-10
10498060287,10498060286,-1,1423,1209,-10
10498886499,10498886500,1,1810,1682,-10
10503559296,10503559299,3,1388,995,-10
10508832683,10508832685,2,1799,1483,-10
10509948437,10509948438,1,1508,1489,-10
10510262330,10510262329,-1,2326,1790,-10
10510625897,10510625897,0,1992,1640,-10
10512515230,10512515232,2,1927,1976,-10
10512716999,10512716993,-6,1140,4019,-10
10512986913,10512986916,3,1559,1508,-10
10513636274,10513636275,1,2081,2340,-10
10517867322,10517867323,1,1587,1509,-10
10518037021,10518037021,0,1402,1451,-10
10518192229,10518192230,1,1530,1253,-10
10519641945,10519641947,2,1839,1358,-10
10520647614,10520647617,3,1410,1061,-10
10521465537,10521465538,1,1249,1189,-10
10522963069,10522963071,2,1590,1605,-10
10523104672,10523104675,3,1608,1702,-10
10528393158,10528393159,1,975,1508,-10
10528441706,10528441710,4,1920,1150,-10
10529783838,10529783839,1,1215,1175,-10
10530665366,10530665367,1,1505,1198,-10
10532504976,10532504979,3,1740,1150,-10
10539659625,10539659627,2,1853,1732,-10
10541576666,10541576667,1,1507,2074,-10
10541971717,10541971718,1,1349,1740,-10
10543395619,10543395622,3,1536,1736,-10
10543603238,10543603239,1,1115,1219,-10
10548669428,10548669430,2,1794,1617,-10
10551788654,10551788657,3,1573,2044,-10
10552145629,10552145630,1,1313,1454,-10
10554951951,10554951954,3,1579,1148,-10
10555879513,10555879513,0,1533,2053,-10
10559926334,10559926335,1,1375,1720,-10
10560469369,10560469371,2,1595,1446,-10
10564979691,10564979694,3,1149,1309,-10
10565857163,10565857166,3,1238,1340,-10
10566997143,10566997145,2,1682,1455,-10
10568466050,10568466055,5,1207,1549,-10
10571111350,10571111350,0,912,1367,-10
10571690439,10571690442,3,1333,1378,-10
10577078782,10577078778,-4,243,3504,-10
10577870626,10577870626,0,1503,1621,-10
10578230999,10578231001,2,1565,1741,-10
10579679088,10579679090,2,1275,892,-10
10580581692,10580581695,3,1150,1134,-10
10581927765,10581927767,2,1220,1007,-10
10583404113,10583404113,0,1461,1377,-10
10584287237,10584287237,0,1276,2106,-10
10585486047,10585486050,3,1116,1122,-10
10594989634,10594989634,0,34163,15085,-10
10595354979,10595354982,3,955,814,-10
10599725453,10599725454,1,1186,1804,-10
10600814885,10600814891,6,6092,2539,-10
10600857898,10600857899,1,1630,1693,-10
10607707633,10607707637,4,1344,1085,-10
10609128231,10609128231,0,1722,1385,-10
10613287490,10613287492,2,1661,1465,-10
10614000086,10614000088,2,1931,1373,-10
10614215977,10614215979,2,1546,1254,-10
10614895810,10614895811,1,1814,1836,-10
10617641558,10617641562,4,2032,1538,-10
10621376170,10621376173,3,1855,1352,-10
10622883541,10622883542,1,990,1443,-10
10629490890,10629490890,0,1273,907,-10
10631480243,10631480244,1,1671,1547,-10
10632353111,10632353113,2,2329,1855,-10
10635644240,10635644242,2,1081,697,-10
10640258418,10640258421,3,1155,1301,-10
10640903314,10640903319,5,2008,853,-10
10642419287,10642419287,0,1111,1454,-10
10643471995,10643471997,2,2117,2244,-10
10647564353,10647564338,-15,1164,1330,-10
10649055295,10649055298,3,1237,1413,-10
10651020126,10651020129,3,2354,2148,-10
10651557574,10651557577,3,1331,1335,-10
10655900257,10655900259,2,1626,1471,-10
10656745602,10656745605,3,2358,1614,-10
10656911385,10656911381,-4,2176,6573,-10
10658132665,10658132667,2,1393,1110,-10
10659510546,10659510547,1,2121,1676,-10
10664901986,10664901989,3,1038,1700,-10
10667714426,10667714428,2,1636,1447,-10
10670810520,10670810522,2,1619,1292,-10
10671463258,10671463258,0,1611,1060,-10
10673700235,10673700239,4,902,1020,-10
10679502704,10679502706,2,1823,1322,-10
10683301981,10683301985,4,1829,1181,-10
10684254106,10684254110,4,881,1187,-10
10684856588,10684856590,2,1191,1173,-10
10687665897,10687665895,-2,1759,1498,-10
10690443133,10690443134,1,1386,1681,-10
10693261082,10693261082,0,1740,1706,-10
10695756609,10695756607,-2,1131,1515,-10
10696596138,10696596141,3,1271,1890,-10
10698151902,10698151905,3,1530,1296,-10
10702392190,10702392179,-11,27291,16560,-10
10702613903,10702613903,0,1619,1781,-10
10702874029,10702874032,3,1251,1993,-10
10705030685,10705030686,1,1699,1743,-10
10706438382,10706438387,5,1146,714,-10
10707022096,10707022097,1,1668,1330,-10
10708479385,10708479386,1,1502,1233,-10
10708506831,10708506831,0,983,1272,-10
10709114821,10709114814,-7,2175,8507,-10
10709169296,10709169299,3,2215,1723,-10
10711844632,10711844634,2,1125,1335,-10
10714608441,10714608443,2,1097,1284,-10
10716062938,10716062937,-1,1974,1891,-10
10716462467,10716462474,7,11720,3622,-10
10716555662,10716555664,2,1642,1161,-10
10723827122,10723827126,4,1610,1562,-10
10724533786,10724533786,0,1131,2092,-10
10725711665,10725711668,3,1202,2282,-10
10738773202,10738773204,2,1434,1402,-10
10739524561,10739524563,2,1061,1432,-10
10739611578,10739611580,2,2405,1993,-10
10740375196,10740375198,2,1124,1491,-10
10741162025,10741162027,2,1096,1811,-10
10742960345,10742960342,-3,1070,1799,-10
10744039571,10744039574,3,1681,1477,-10
10744362977,10744362978,1,1482,1619,-10
10745030579,10745030582,3,1280,1424,-10
10745504454,10745504455,1,1542,1260,-10
10747363153,10747363157,4,2262,1295,-10
10748151113,10748151113,0,1559,1954,-10
10748680045,10748680048,3,1637,1663,-10
10751379511,10751379513,2,2032,1530,-10
10753272994,10753272997,3,1741,1195,-10
10756584093,10756584097,4,1588,1680,-10
10757695814,10757695815,1,1011,1464,-10
10760385631,10760385629,-2,1352,1385,-10
10762630438,10762630439,1,1228,1131,-10
10763437546,10763437544,-2,622,1505,-10
10764225195,10764225197,2,1711,1660,-10
10766408519,10766408518,-1,1607,3110,-10
10769425751,10769425753,2,1492,1184,-10
10770449837,10770449838,1,1140,1026,-10
10772185649,10772185642,-7,464,1514,-10
10773788361,10773788362,1,1896,1381,-10
10774273087,10774273094,7,8436,2442,-10
10778992798,10778992798,0,1750,1688,-10
10779933744,10779933746,2,1345,1172,-10
10781863513,10781863515,2,3138,1837,-10
10783121518,10783121518,0,1467,1192,-10
10784832140,10784832143,3,1860,1777,-10
10785837453,10785837454,1,1196,1646,-10
10787883443,10787883444,1,1159,1294,-10
10788541049,10788541050,1,1288,1635,-10
10788983913,10788983916,3,1149,1430,-10
10790692575,10790692577,2,2334,1811,-10
10792775295,10792775303,8,2753,1199,-10
10793348069,10793348070,1,1384,1023,-10
10796798423,10796798426,3,1215,1408,-10
10797248421,10797248422,1,1279,1252,-10
10797497355,10797497357,2,1568,1674,-10
10797626102,10797626102,0,1286,1513,-10
10799466523,10799466523,0,1893,1863,-10
10799671425,10799671426,1,1631,1093,-10
10800057510,10800057510,0,1345,1886,-10
10805400117,10805400118,1,1632,1695,-10
10806035507,10806035508,1,1375,1842,-10
10806773115,10806773120,5,1126,974,-10
10808129622,10808129619,-3,1580,1963,-10
10810704786,10810704787,1,1199,1391,-10
10821026602,10821026602,0,1586,1951,-10
10821188050,10821188038,-12,970,1146,-10
10822381494,10822381496,2,1149,1369,-10
10824122325,10824122326,1,1529,1170,-10
10824192626,10824192627,1,1264,1425,-10
10827026369,10827026370,1,37213,23596,-10
10827513743,10827513747,4,1954,1085,-10
10829198255,10829198257,2,1342,1213,-10
10831242859,10831242859,0,1498,1165,-10
10831576843,10831576845,2,1639,1801,-10
10835122994,10835122996,2,2051,1898,-10
10835190790,10835190793,3,1772,1933,-10
10835803806,10835803810,4,1699,1539,-10
10836998789,10836998790,1,1964,1460,-10
10837894636,10837894638,2,1366,1465,-10
10838602760,10838602761,1,1556,1337,-10
10839271462,10839271464,2,2831,2374,-10
10841201242,10841201243,1,1293,1305,-10
10842790998,10842790992,-6,942,3270,-10
10845538252,10845538250,-2,771,1991,-10
10847745251,10847745254,3,1471,1719,-10
10854588121,10854588123,2,1288,966,-10
10855663072,10855663077,5,2142,1530,-10
10857060968,10857060971,3,1505,1080,-10
10858250327,10858250329,2,1900,1879,-10
10858401567,10858401567,0,1112,1598,-10
10859262706,10859262705,-1,1308,1084,-10
10860271457,10860271459,2,1022,1172,-10
10860851088,10860851089,1,1636,1419,-10
10861170343,10861170347,4,1412,1902,-10
10861778617,10861778618,1,858,746,-10
10862891914,10862891919,5,1829,1116,-10
10863217166,10863217186,20,1894,1304,-10
10863551747,10863551749,2,1623,1671,-10
10864415636,10864415637,1,1686,1488,-10
10867820271,10867820248,-23,1842,2383,-10
10869773388,10869773390,2,1929,1481,-10
10871330857,10871330858,1,1299,879,-10
10873244897,10873244898,1,1852,1731,-10
10877218302,10877218302,0,1219,966,-10
10879190991,10879190994,3,1825,1487,-10
10879987389,10879987390,1,1396,1187,-10
10880235083,10880235085,2,1533,1947,-10
10888520809,10888520814,5,1772,1483,-10
10889067758,10889067759,1,1667,1501,-10
10893168764,10893168767,3,1492,1376,-10
10898134489,10898134491,2,2052,1476,-10
10898258902,10898258896,-6,58922,33766,-10
10898724187,10898724187,0,1233,1087,-10
10903941787,10903941786,-1,1310,1718,-10
10907203969,10907203973,4,2263,1176,-10
10909096558,10909096559,1,1718,1532,-10
10910625017,10910625019,2,1082,1347,-10
10911804898,10911804904,6,8142,3588,-10
10913386494,10913386495,1,1459,1565,-10
10913457607,10913457609,2,2397,1895,-10
10914387177,10914387177,0,1527,1009,-10
10914772168,10914772175,7,4591,1750,-10
10918305423,10918305436,13,1900,1487,-10
10918877310,10918877313,3,971,953,-10
10920371362,10920371363,1,1484,2102,-10
10921785003,10921785002,-1,1525,1512,-10
10930374702,10930374702,0,925,1109,-10
10931658294,10931658290,-4,723,1476,-10
10931846313,10931846305,-8,830,4261,-10
10934382277,10934382283,6,4666,2399,-10
10934687603,10934687602,-1,743,899,-10
10939189677,10939189678,1,1669,1887,-10
10939483974,10939483976,2,2498,1849,-10
10939919394,10939919398,4,1134,1018,-10
10941136701,10941136704,3,4759,2794,-10
10941302171,10941302173,2,2299,1704,-10
10946743249,10946743253,4,1879,1333,-10
10948991005,10948991010,5,1700,1395,-10
10954737298,10954737303,5,2522,1635,-10
10955819209,10955819212,3,1660,1532,-10
10960334386,10960334386,0,831,1205,-10
10962525603,10962525605,2,1684,1901,-10
10962879681,10962879682,1,1723,1291,-10
10963255497,10963255490,-7,1029,1326,-10
10972284498,10972284518,20,1120,1302,-10
10972919051,10972919055,4,1131,1134,-10
10975273960,10975273963,3,1082,1663,-10
10983167067,10983167068,1,1648,1554,-10
10987291975,10987291974,-1,1988,1727,-10
10987928879,10987928880,1,1720,1423,-10
10992872750,10992872756,6,1088,1413,-10
10997823190,10997823192,2,1596,1218,-10
11001756943,11001756946,3,2175,1911,-10
11004017586,11004017586,0,1693,1350,-10
11007191584,11007191586,2,832,884,-10
11007583313,11007583320,7,1884,645,-10
11008047163,11008047166,3,1104,1149,-10
11009123744,11009123746,2,823,710,-10
11009766649,11009766648,-1,1629,1892,-10
11011409769,11011409774,5,4916,3029,-10
11015599659,11015599658,-1,1277,1660,-10
11016491518,11016491517,-1,1788,2568,-10
11016959324,11016959330,6,4544,1792,-10
11017097706,11017097707,1,1918,1738,-10
11017171495,11017171492,-3,2097,4981,-10
11018912088,11018912091,3,2021,1478,-10
11019269282,11019269282,0,1425,1434,-10
11020833776,11020833776,0,1051,1776,-10
11021053674,11021053675,1,1819,1499,-10
11030645438,11030645433,-5,694,1636,-10
11030877282,11030877285,3,1827,1672,-10
11032116956,11032116959,3,2178,1560,-10
11033722631,11033722631,0,1274,1439,-10
11034325348,11034325350,2,1500,1213,-10
11036454382,11036454383,1,1163,2010,-10
11036900622,11036900628,6,1626,1317,-10
11039075085,11039075087,2,1745,1431,-10
11040025648,11040025649,1,1455,1823,-10
11040886306,11040886309,3,1780,1634,-10
11043757341,11043757341,0,1302,1409,-10
11047946402,11047946402,0,1438,1487,-10
11049057739,11049057739,0,1485,1941,-10
11053994753,11053994758,5,1658,1419,-10
11054183977,11054183993,16,991,1180,-10
11054909485,11054909491,6,2135,1276,-10
11055423516,11055423511,-5,1261,4311,-10
11055581554,11055581539,-15,1171,2176,-10
11058181016,11058181015,-1,1544,1732,-10
11060065633,11060065634,1,1556,1729,-10
11063259375,11063259377,2,1667,1581,-10
11066437377,11066437378,1,1817,2152,-10
11067538406,11067538406,0,1350,1637,-10
11070811085,11070811086,1,1300,1792,-10
11073094897,11073094899,2,1080,1489,-10
11073933119,11073933098,-21,1328,1686,-10
11074747699,11074747700,1,1113,1585,-10
11075935031,11075935033,2,1746,1451,-10
11076096756,11076096771,15,1835,1493,-10
11076974356,11076974361,5,1567,1348,-10
11083996231,11083996233,2,1502,1446,-10
11088827829,11088827831,2,876,1161,-10
11093595225,11093595213,-12,1290,1580,-10
11096730762,11096730762,0,1342,1760,-10
11099222440,11099222442,2,1575,1518,-10
11101584396,11101584388,-8,16190,33999,-10
11101660741,11101660721,-20,1753,901,-10
11102340247,11102340254,7,13074,21247,-10
11106420762,11106420765,3,1575,1777,-10
11116955655,11116955656,1,1287,1315,-10
11117441195,11117441198,3,1208,1466,-10
11119896281,11119896285,4,1093,1668,-10
11122236686,11122236687,1,1907,1730,-10
11123964211,11123964212,1,1737,2331,-10
11124040885,11124040887,2,814,681,-10
11126538328,11126538328,0,1612,1473,-10
11127460019,11127460020,1,1473,1909,-10
11127876563,11127876567,4,1586,1250,-10
11129548631,11129548634,3,846,795,-10
11133160234,11133160237,3,1899,1908,-10
11134596486,11134596488,2,1868,1696,-10
11141050887,11141050886,-1,1664,2228,-10
11142941322,11142941323,1,749,841,-10
11144287475,11144287476,1,1415,2035,-10
11144720927,11144720929,2,1669,1327,-10
11145521849,11145521850,1,1618,1702,-10
11146584142,11146584144,2,1688,1764,-10
11148295338,11148295342,4,1280,1442,-10
11153176614,11153176615,1,1402,1327,-10
11154415211,11154415212,1,1774,1873,-10
11158127275,11158127270,-5,1166,3699,-10
11158890151,11158890154,3,1528,980,-10
11159731588,11159731586,-2,1320,1975,-10
11160468291,11160468290,-1,1869,1508,-10
11161897423,11161897425,2,1725,1761,-10
11162787609,11162787610,1,1388,1458,-10
11163152592,11163152595,3,1518,1194,-10
11163240557,11163240558,1,1219,1963,-10
11163802293,11163802291,-2,1031,1817,-10
11164370686,11164370688,2,1693,1073,-10
11165465640,11165465635,-5,2751,6910,-10
11166401276,11166401277,1,1619,1720,-10
11168412246,11168412248,2,1327,1074,-10
11170075509,11170075516,7,2345,1124,-10
11172011759,11172011760,1,2028,2153,-10
11172155779,11172155782,3,1568,1540,-10
11173225191,11173225193,2,1577,1348,-10
11176023390,11176023392,2,1961,1842,-10
11178154169,11178154170,1,1517,1259,-10
11180124091,11180124091,0,1349,1581,-10
11181031889,11181031891,2,1832,2073,-10
11187799659,11187799659,0,1200,1418,-10
11188306535,11188306539,4,1565,1169,-10
11192591633,11192591634,1,1845,1788,-10
11193537811,11193537821,10,286,2767,-10
11196244978,11196244983,5,2339,1475,-10
11197951893,11197951894,1,1020,1187,-10
11199353331,11199353330,-1,905,1312,-10
11200131257,11200131259,2,1451,1259,-10
11200233737,11200233739,2,1263,911,-10
11200512890,11200512894,4,1294,1141,-10
11201258234,11201258238,4,1525,1663,-10
11203942717,11203942719,2,1989,1409,-10
11204397338,11204397340,2,3171,4278,-10
11207252438,11207252440,2,1779,1400,-10
11207680180,11207680170,-10,1399,1357,-10
11212899734,11212899734,0,1348,1334,-10
11214241109,11214241108,-1,1222,1813,-10
11227253967,11227253967,0,1335,1434,-10
11227369331,11227369336,5,1691,1654,-10
11227458078,11227458081,3,1946,1119,-10
11228972658,11228972661,3,1404,1459,-10
11231148767,11231148767,0,1082,1030,-10
11234479236,11234479239,3,1401,1355,-10
11235659181,11235659182,1,1730,1932,-10
11236879232,11236879242,10,1101,1019,-10
11237664254,11237664257,3,982,1923,-10
11240523789,11240523790,1,1731,1480,-10
11241513286,11241513287,1,1450,1034,-10
11244160602,11244160603,1,1388,1529,-10
11244248761,11244248762,1,1169,1413,-10
11246638681,11246638682,1,1484,1429,-10
11254648527,11254648529,2,1617,1901,-10
11257100395,11257100398,3,7284,6882,-10
11258773832,11258773833,1,1858,2107,-10
11261421295,11261421296,1,1176,1358,-10
11262649950,11262649953,3,1581,1378,-10
11264251181,11264251174,-7,2018,12965,-10
11265246779,11265246782,3,1062,699,-10
11267823618,11267823620,2,1424,1353,-10
11271596082,11271596100,18,48,2062,-10
11272143158,11272143159,1,1737,1529,-10
11279126970,11279126972,2,1803,1534,-10
11282699036,11282699034,-2,33435,1973,-10
11282959642,11282959642,0,1263,2031,-10
11283015414,11283015415,1,1520,1434,-10
11283367522,11283367536,14,792,979,-10
11283638497,11283638498,1,1472,1330,-10
11285389282,11285389284,2,1034,1733,-10
11288586945,11288586947,2,1828,1603,-10
11289485102,11289485102,0,1271,1097,-10
11289828371,11289828373,2,2038,1767,-10
11295328032,11295328035,3,1979,1589,-10
11295768078,11295768081,3,1843,1626,-10
11298210701,11298210703,2,835,1086,-10
11298349429,11298349430,1,1431,1301,-10
11301558342,11301558347,5,1378,1307,-10
11303137162,11303137166,4,1601,1550,-10
11306486742,11306486746,4,1382,1304,-10
11306682525,11306682531,6,2361,1307,-10
11310563783,11310563783,0,1158,1106,-10
11311033342,11311033344,2,1600,1359,-10
11311109812,11311109816,4,1960,1471,-10
11311698301,11311698302,1,1538,1991,-10
11311834068,11311834069,1,1929,1230,-10
11313922709,11313922714,5,2512,2196,-10
11314453594,11314453597,3,2253,1729,-10
11317292596,11317292597,1,1488,1421,-10
11318018839,11318018842,3,1658,1656,-10
11318448502,11318448502,0,1556,1549,-10
11320586283,11320586285,2,1911,1454,-10
11325866936,11325866936,0,1351,1713,-10
11326662206,11326662208,2,1686,1793,-10
11329050967,11329050967,0,1360,1360,-10
11334153529,11334153530,1,1281,1593,-10
11335497713,11335497715,2,1505,1282,-10
11336797348,11336797350,2,1661,1810,-10
11336967977,11336967985,8,2675,1365,-10
11338871626,11338871629,3,1923,1527,-10
11339881242,11339881244,2,1630,1723,-10
11340884219,11340884219,0,827,1076,-10
11342156417,11342156418,1,1488,1301,-10
11342532522,11342532522,0,995,1239,-10
11343469593,11343469595,2,970,1330,-10
11346596769,11346596771,2,1282,1550,-10
11348250619,11348250613,-6,1069,5093,-10
11350214487,11350214490,3,1468,1341,-10
11350444498,11350444501,3,1962,2039,-10
11351804138,11351804141,3,1091,1326,-10
11354326206,11354326206,0,2116,1689,-10
11354636070,11354636078,8,3377,957,-10
11355679561,11355679562,1,1514,1276,-10
11358282594,11358282595,1,1658,1594,-10
11359798940,11359798941,1,1341,1327,-10
11360649308,11360649310,2,1696,990,-10
11361840868,11361840870,2,1575,1555,-10
11364835707,11364835707,0,913,1024,-10
11365640429,11365640430,1,2314,2278,-10
11373341462,11373341464,2,2372,2321,-10
11373493714,11373493717,3,1209,1265,-10
11374569014,11374569015,1,1571,1202,-10
11381039032,11381039025,-7,1307,7895,-10
11382017449,11382017451,2,2229,1486,-10
11382153192,11382153192,0,1501,2052,-10
11385400590,11385400594,4,1324,1404,-10
11387629413,11387629414,1,1287,1488,-10
11388073461,11388073463,2,1837,1393,-10
11391896006,11391896008,2,1348,1273,-10
11394869307,11394869310,3,1686,1829,-10
11404553751,11404553753,2,1403,1484,-10
11406028939,11406028942,3,1567,1762,-10
11407580278,11407580280,2,1607,976,-10
11408207651,11408207653,2,1236,1141,-10
11410588154,11410588154,0,1530,2120,-10
11410642003,11410642005,2,2295,1787,-10
11413196378,11413196378,0,1422,1492,-10
11417235344,11417235345,1,1116,1124,-10
11418284341,11418284343,2,1296,2067,-10
11419991730,11419991731,1,1323,1878,-10
11420204150,11420204150,0,2420,2195,-10
11422422338,11422422340,2,1188,1645,-10
11424234109,11424234111,2,1490,1455,-10
11424446912,11424446934,22,86,1466,-10
11429210950,11429210950,0,1475,1387,-10
11437610311,11437610310,-1,1688,1250,-10
11438902406,11438902405,-1,2008,1425,-10
11439454208,11439454208,0,1634,2313,-10
11439765749,11439765752,3,1796,1798,-10
11440332104,11440332106,2,1862,1145,-10
11440924955,11440924956,1,1376,1642,-10
11441504970,11441504971,1,2406,1705,-10
11445492686,11445492686,0,904,2145,-10
11447206315,11447206319,4,4140,3022,-10
11447726353,11447726355,2,2268,1714,-10
11448545835,11448545829,-6,706,2145,-10
11452506401,11452506402,1,1906,1541,-10
11453253510,11453253511,1,2203,1382,-10
11454374114,11454374116,2,1285,1588,-10
11455605456,11455605459,3,702,681,-10
11457258142,11457258142,0,1037,869,-10
11457705341,11457705342,1,1514,973,-10
11458851167,11458851169,2,1805,1285,-10
11465050812,11465050814,2,1635,1795,-10
11465901290,11465901292,2,1358,1514,-10
11468521193,11468521194,1,1276,1405,-10
11470074755,11470074759,4,1603,1161,-10
11474468129,11474468131,2,1324,1137,-10
11474743781,11474743782,1,1738,2536,-10
11475013621,11475013623,2,1014,1588,-10
11475560494,11475560497,3,1607,1105,-10
11477453312,11477453313,1,1468,1536,-10
11480752570,11480752570,0,1384,2052,-10
11487525901,11487525902,1,1333,1341,-10
11487850706,11487850690,-16,827,376,-10
11488617661,11488617663,2,1861,1729,-10
11489382983,11489382978,-5,1273,1576,-10
11490697170,11490697170,0,1633,1592,-10
11496025541,11496025542,1,1617,1413,-10
11498402686,11498402688,2,1066,1877,-10
11498931281,11498931282,1,1266,1557,-10
11499292953,11499292954,1,1236,1407,-10
11500269963,11500269967,4,1603,1387,-10
11503496363,11503496369,6,892,895,-10
11505409478,11505409481,3,2237,1486,-10
11512166613,11512166615,2,1821,1600,-10
11514232368,11514232369,1,1621,1454,-10
11518287913,11518287914,1,1048,792,-10
11529014597,11529014601,4,1796,1458,-10
11530591085,11530591087,2,1430,1237,-10
11534803956,11534803959,3,2181,1494,-10
11536864686,11536864686,0,1289,1270,-10
11537032310,11537032314,4,1518,1667,-10
11539247289,11539247292,3,1631,1497,-10
11540256791,11540256791,0,1064,1043,-10
11543605504,11543605510,6,2318,1293,-10
11544726939,11544726941,2,1272,1718,-10
11548285925,11548285934,9,10428,31148,-10
11548377863,11548377864,1,1644,1544,-10
11550250536,11550250538,2,1701,1580,-10
11551277287,11551277290,3,1299,1474,-10
11551358262,11551358244,-18,1429,2103,-10
11552093871,11552093874,3,1653,1381,-10
11552128286,11552128291,5,4969,3483,-10
11552262405,11552262406,1,1373,1585,-10
11554686219,11554686222,3,1278,850,-10
11555719561,11555719543,-18,1628,1660,-10
11559196815,11559196814,-1,1427,1893,-10
11560546966,11560546968,2,1027,1754,-10
11562314879,11562314882,3,1306,1624,-10
11562486011,11562486014,3,1190,1193,-10
11564077687,11564077687,0,1122,1068,-10
11564926011,11564926013,2,1290,1238,-10
11565302565,11565302557,-8,2014,37797,-10
11565912544,11565912546,2,1910,1657,-10
11566545883,11566545886,3,2036,1565,-10
11568832640,11568832642,2,1956,1541,-10
11570554157,11570554158,1,1071,1358,-10
11571117582,11571117590,8,4638,1624,-10
11571591386,11571591387,1,1568,1160,-10
11572614974,11572614974,0,1823,1418,-10
11574312262,11574312266,4,1837,1321,-10
11575397572,11575397575,3,2056,1933,-10
11580069662,11580069662,0,1624,1159,-10
11582003217,11582003219,2,1780,1776,-10
11583019620,11583019621,1,1195,1362,-10
11589440779,11589440781,2,1203,1680,-10
11591399838,11591399843,5,1246,1465,-10
11593873733,11593873732,-1,1186,1450,-10
11594754524,11594754505,-19,1232,926,-10
11601197978,11601197982,4,1764,1400,-10
11605279772,11605279774,2,1382,1168,-10
11605462333,11605462337,4,2226,1989,-10
11608378494,11608378494,0,1355,1133,-10
11610883905,11610883908,3,1599,1449,-10
11612064110,11612064115,5,798,841,-10
11612518813,11612518815,2,1472,1247,-10
11615433490,11615433494,4,1848,1220,-10
11619596160,11619596162,2,1989,1118,-10
11622031041,11622031038,-3,1324,1647,-10
11622549734,11622549737,3,2113,1821,-10
11622895257,11622895259,2,2440,2334,-10
11624838673,11624838675,2,1639,1993,-10
11630438770,11630438773,3,2143,1889,-10
11633119230,11633119246,16,1493,1331,-10
11636037754,11636037758,4,1811,1880,-10
11637690600,11637690606,6,1267,952,-10
11638479158,11638479160,2,810,1403,-10
11640051850,11640051851,1,2355,1698,-10
11642175926,11642175930,4,1285,1488,-10
11644527486,11644527489,3,1246,1608,-10
11647364350,11647364350,0,2274,2187,-10
11648807405,11648807401,-4,1450,3442,-10
11650474005,11650474006,1,1165,1622,-10
11651245613,11651245615,2,1719,1796,-10
11653356964,11653356966,2,1557,1476,-10
11654991022,11654991022,0,1072,1253,-10
11655272783,11655272786,3,1319,1509,-10
11655753721,11655753722,1,3776,4139,-10
11656104177,11656104177,0,1390,914,-10
11659517240,11659517239,-1,1497,1607,-10
11660962139,11660962141,2,1790,1483,-10
11661021458,11661021442,-16,3568,1077,-10
11663188102,11663188103,1,26157,17027,-10
11663641550,11663641553,3,1396,1801,-10
11664478443,11664478446,3,2427,790,-10
11668953793,11668953795,2,1536,1391,-10
11669793897,11669793903,6,2423,1288,-10
11673889666,11673889666,0,1042,1240,-10
11676176447,11676176450,3,1857,1564,-10
11677353841,11677353842,1,1784,2429,-10
11678273249,11678273250,1,1301,1462,-10
11681048180,11681048183,3,1490,1407,-10
11682811204,11682811207,3,2759,1678,-10
11685597795,11685597798,3,2111,2054,-10
11688667932,11688667931,-1,1054,1279,-10
11689600682,11689600682,0,1917,1775,-10
11692629022,11692629024,2,2025,1954,-10
11694957696,11694957697,1,1495,1541,-10
11695240878,11695240881,3,1070,1427,-10
11696254882,11696254883,1,1471,1383,-10
11699097670,11699097669,-1,1522,1924,-10
11700762064,11700762041,-23,1163,1327,-10
11703419130,11703419130,0,878,988,-10
11707233502,11707233510,8,1854,979,-10
11707328023,11707328040,17,885,1008,-10
11709725125,11709725125,0,1461,1690,-10
11711613999,11711614001,2,1191,1292,-10
11712201870,11712201877,7,1500,1156,-10
11715306865,11715306858,-7,1752,6884,-10
11716659037,11716659038,1,1287,1742,-10
11718076460,11718076463,3,2038,1569,-10
11718695319,11718695316,-3,1178,2172,-10
11720285201,11720285205,4,1102,1316,-10
11723183656,11723183658,2,1401,960,-10
11726850540,11726850542,2,1380,2022,-10
11727883695,11727883699,4,1756,1332,-10
11729074460,11729074463,3,835,1045,-10
11735642659,11735642661,2,1450,1230,-10
11735820685,11735820687,2,2265,2369,-10
11740583133,11740583137,4,1669,1573,-10
11741697063,11741697067,4,1480,1343,-10
11749934473,11749934475,2,1599,2150,-10
11750729145,11750729150,5,1537,1885,-10
11752396703,11752396706,3,1713,1210,-10
11754483387,11754483389,2,1113,1708,-10
11757212646,11757212649,3,2139,1626,-10
11761622326,11761622326,0,1362,1567,-10
11765454018,11765454022,4,969,499,-10
11767378752,11767378755,3,793,860,-10
11768076070,11768076071,1,1968,2077,-10
11769172068,11769172067,-1,1459,1269,-10
11769753198,11769753194,-4,988,2008,-10
11770788102,11770788105,3,1882,1645,-10
11773262354,11773262356,2,1242,1463,-10
11773432832,11773432827,-5,841,3745,-10
11777758112,11777758105,-7,1892,10959,-10
11777845249,11777845250,1,1633,1256,-10
11779047132,11779047133,1,1864,1370,-10
11781390985,11781390986,1,1336,1647,-10
11783236730,11783236731,1,1325,1668,-10
11783704326,11783704328,2,2196,1621,-10
11784271227,11784271229,2,1520,1748,-10
11784985971,11784985971,0,1881,1247,-10
11785278835,11785278838,3,1711,1155,-10
11788016377,11788016378,1,746,834,-10
11794708176,11794708178,2,1655,1553,-10
11801624049,11801624051,2,2086,1318,-10
11802042007,11802042010,3,1652,1713,-10
11803638774,11803638775,1,1051,1107,-10
11807332206,11807332213,7,1951,1150,-10
11808943418,11808943418,0,942,1615,-10
11810496479,11810496483,4,1224,1252,-10
11810619812,11810619812,0,1430,1553,-10
11812726692,11812726693,1,1512,1618,-10
11814095343,11814095346,3,1290,1478,-10
11816284051,11816284054,3,1461,2013,-10
11818217310,11818217313,3,1812,1871,-10
11821088927,11821088927,0,1093,1617,-10
11821586023,11821586023,0,1404,1171,-10
11822097814,11822097816,2,1270,842,-10
11827152796,11827152799,3,1747,1782,-10
11827266861,11827266861,0,1511,1181,-10
11827592669,11827592670,1,1543,1517,-10
11828058487,11828058489,2,1751,2146,-10
11828725903,11828725901,-2,883,1978,-10
11829605770,11829605770,0,2251,2538,-10
11831470941,11831470942,1,2039,2088,-10
11832630470,11832630471,1,1156,1829,-10
11833902012,11833902006,-6,1259,1536,-10
11835466099,11835466102,3,2295,1539,-10
11839078521,11839078522,1,2012,1879,-10
11846055870,11846055871,1,1281,1345,-10
11846931022,11846931022,0,1472,1874,-10
11847498009,11847498009,0,1161,1440,-10
11853185875,11853185854,-21,1547,1220,-10
11856981953,11856981954,1,2482,2319,-10
11861623306,11861623305,-1,1268,1438,-10
11862242796,11862242798,2,1857,1956,-10
11864968775,11864968777,2,1585,1102,-10
11865693552,11865693555,3,1440,1435,-10
11866008338,11866008341,3,1560,1576,-10
11866687378,11866687381,3,1354,1235,-10
11867916681,11867916683,2,1822,1605,-10
11869946526,11869946526,0,1440,1394,-10
11871087202,11871087203,1,1202,1687,-10
11872561806,11872561806,0,1711,1908,-10
11872597512,11872597514,2,1942,1547,-10
11876963380,11876963382,2,2546,2165,-10
11877763675,11877763678,3,1137,1697,-10
11878185022,11878185025,3,1295,1128,-10
11881582797,11881582800,3,1077,1682,-10
11882612085,11882612083,-2,1374,2561,-10
11887394134,11887394133,-1,1623,1665,-10
11887462984,11887462985,1,1231,1517,-10
11889635706,11889635709,3,1484,1724,-10
11891610529,11891610528,-1,1333,1927,-10
11894756298,11894756299,1,1556,1396,-10
11902981455,11902981460,5,2390,1271,-10
11903116602,11903116607,5,1664,1478,-10
11903961917,11903961919,2,1485,1777,-10
11907368634,11907368639,5,3702,1752,-10
11911045557,11911045559,2,1774,1624,-10
11912855026,11912855030,4,1611,1440,-10
11913227211,11913227213,2,1518,1635,-10
11919069080,11919069082,2,1075,1100,-10
11920408283,11920408285,2,1275,1346,-10
11921613441,11921613442,1,1626,1913,-10
11922702794,11922702797,3,1430,1306,-10
11922919246,11922919250,4,2193,1919,-10
11923185337,11923185334,-3,2289,3248,-10
11923434783,11923434787,4,1151,932,-10
11925218145,11925218147,2,1508,1389,-10
11926929975,11926929976,1,1353,1518,-10
11927379946,11927379946,0,1198,1248,-10
11928678939,11928678942,3,1686,1263,-10
11930301822,11930301825,3,1970,1527,-10
11932517858,11932517859,1,1240,1326,-10
11932752600,11932752610,10,208,4168,-10
11940580242,11940580244,2,1791,1359,-10
11940680211,11940680213,2,1175,1208,-10
11940833102,11940833104,2,1126,1671,-10
11942215445,11942215449,4,2025,1506,-10
11947097241,11947097243,2,2389,2108,-10
11950209909,11950209903,-6,1475,3052,-10
11950731700,11950731701,1,2463,2512,-10
11953246042,11953246043,1,1614,1472,-10
11954073434,11954073436,2,1470,1582,-10
11954886961,11954886961,0,1948,1974,-10
11956720435,11956720435,0,995,1373,-10
11956979286,11956979290,4,991,1225,-10
11957107098,11957107100,2,1341,1840,-10
11957889618,11957889620,2,1526,1182,-10
11959069929,11959069931,2,2148,1482,-10
11960801440,11960801442,2,1107,1460,-10
11963298942,11963298945,3,1306,1295,-10
11964055110,11964055115,5,1144,1597,-10
11966870610,11966870612,2,1411,1705,-10
11967832721,11967832722,1,1166,1181,-10
11972721771,11972721773,2,1255,1772,-10
11974188264,11974188266,2,1593,1366,-10
11975066101,11975066102,1,1336,1297,-10
11978613563,11978613568,5,1063,852,-10
11978758046,11978758028,-18,1349,1587,-10
11984900770,11984900772,2,1043,1130,-10
11992418639,11992418639,0,1635,1731,-10
11993851964,11993851965,1,1414,1364,-10
11994316665,11994316666,1,1328,1904,-10
11994419476,11994419478,2,1208,1403,-10
11995968521,11995968524,3,2198,1942,-10
11997165368,11997165368,0,1628,1460,-10
11997909195,11997909201,6,1440,1413,-10
11998249128,11998249131,3,1807,1684,-10
11998410253,11998410253,0,1585,1821,-10
12001692757,12001692764,7,6249,2240,-10
12002516782,12002516782,0,981,1669,-10
12003442298,12003442302,4,1284,1606,-10
12005577579,12005577579,0,1099,1185,-10
12006447798,12006447802,4,1794,1365,-10
12007770214,12007770215,1,869,836,-10
12008693777,12008693780,3,1369,1744,-10
12011154938,12011154940,2,2168,1842,-10
12015700428,12015700430,2,975,936,-10
12018029726,12018029727,1,1424,2315,-10
12022982576,12022982576,0,1324,1670,-10
12026430277,12026430274,-3,1381,2438,-10
12027897548,12027897550,2,1497,1553,-10
12028474332,12028474335,3,1353,1644,-10
12029408211,12029408214,3,1257,994,-10
12031571322,12031571326,4,4653,2855,-10
12032386370,12032386373,3,1850,1803,-10
12032425181,12032425182,1,1410,1368,-10
12035212043,12035212042,-1,1759,1627,-10
12035892554,12035892558,4,1359,1441,-10
12042410097,12042410097,0,1002,989,-10
12044172739,12044172741,2,1440,1984,-10
12045704189,12045704184,-5,2439,6530,-10
12051101591,12051101591,0,31373,16630,-10
12051869441,12051869446,5,1548,1464,-10
12052102012,12052102013,1,1357,1315,-10
12055197499,12055197502,3,1621,1688,-10
12059585234,12059585235,1,1547,1164,-10
12060117318,12060117318,0,1255,1314,-10
12060832672,12060832671,-1,2039,2283,-10
12065325682,12065325685,3,1580,1693,-10
12068611626,12068611630,4,981,1093,-10
12071330714,12071330717,3,1063,1310,-10
12073013303,12073013306,3,1597,1965,-10
12077681882,12077681882,0,1340,1497,-10
12081833849,12081833851,2,2319,1615,-10
12082992235,12082992239,4,1344,1083,-10
12083870576,12083870578,2,1544,1382,-10
12086558274,12086558278,4,2027,1588,-10
12088115933,12088115934,1,1329,1440,-10
12090481461,12090481461,0,1213,1105,-10
12091037542,12091037545,3,2459,1860,-10
12091572969,12091572970,1,1337,1578,-10
12095015127,12095015131,4,1600,1723,-10
12097617621,12097617623,2,1342,1940,-10
12097838054,12097838053,-1,1206,1465,-10
12101158371,12101158358,-13,1926,14490,-10
12103784693,12103784694,1,1747,1344,-10
12104649814,12104649814,0,887,1933,-10
12104919377,12104919378,1,1939,1289,-10
12107073658,12107073662,4,1557,1553,-10
12110906019,12110906017,-2,1375,2010,-10
12112711678,12112711682,4,1083,1762,-10
12113665570,12113665574,4,1912,1599,-10
12114232591,12114232571,-20,1216,1334,-10
12114680034,12114680034,0,1314,1951,-10
12115667446,12115667446,0,2056,1491,-10
12117693449,12117693450,1,1186,1509,-10
12118904150,12118904151,1,1638,1583,-10
12119560078,12119560080,2,2332,1702,-10
12121451354,12121451357,3,1081,1389,-10
12123266580,12123266580,0,1467,1756,-10
12123345825,12123345826,1,1443,1133,-10
12124494774,12124494775,1,1214,1175,-10
12125008430,12125008437,7,3224,1234,-10
12130887381,12130887382,1,1774,2100,-10
12131516550,12131516553,3,1682,1742,-10
12131611507,12131611508,1,768,995,-10
12141364861,12141364862,1,1188,1163,-10
12141546797,12141546798,1,1212,1572,-10
12144133302,12144133302,0,1316,1949,-10
12148506689,12148506695,6,1397,1346,-10
12150548288,12150548290,2,1320,1731,-10
12152133986,12152133986,0,1478,1975,-10
12152566186,12152566186,0,1352,1112,-10
12152602379,12152602382,3,1059,1391,-10
12154270429,12154270432,3,1492,1548,-10
12155280303,12155280303,0,1104,1420,-10
12157412829,12157412830,1,1688,2047,-10
12158367349,12158367351,2,1318,1572,-10
12161046927,12161046929,2,2099,1747,-10
12163649821,12163649822,1,1655,1735,-10
12166261311,12166261311,0,884,1667,-10
12166979243,12166979249,6,1392,1393,-10
12168146082,12168146082,0,2042,1517,-10
12170327488,12170327489,1,1451,1565,-10
12174566608,12174566609,1,1137,1003,-10
12180557774,12180557777,3,1706,1494,-10
12182845350,12182845350,0,1794,1936,-10
12190413193,12190413194,1,1143,1422,-10
12193125287,12193125290,3,1600,1658,-10
12194373156,12194373159,3,2124,1521,-10
12197661933,12197661930,-3,1436,1165,-10
12201319358,12201319359,1,1374,1699,-10
12201710658,12201710658,0,1742,1488,-10
12203197640,12203197642,2,1389,1231,-10
12203980999,12203981003,4,1375,877,-10
12209037005,12209037006,1,1809,1704,-10
12210688231,12210688235,4,1932,1885,-10
12213360908,12213360907,-1,1325,1174,-10
12215613407,12215613407,0,1154,1561,-10
12221367654,12221367655,1,1263,1268,-10
12222941217,12222941219,2,1937,1745,-10
12236187373,12236187374,1,986,1332,-10
12238680715,12238680718,3,1386,1222,-10
12239185634,12239185651,17,1357,1332,-10
12241979654,12241979658,4,1329,958,-10
12245223821,12245223822,1,1788,1505,-10
12247063083,12247063082,-1,662,1179,-10
12248592731,12248592732,1,945,1124,-10
12250385638,12250385638,0,1758,1078,-10
12252843955,12252843958,3,1359,1484,-10
12255927054,12255927057,3,1397,1614,-10
12256454803,12256454805,2,1859,1569,-10
12257301915,12257301918,3,123,1293,-10
12258241494,12258241495,1,1494,1566,-10
12258528215,12258528215,0,1537,1319,-10
12261984708,12261984710,2,1640,1368,-10
12263593102,12263593105,3,913,1001,-10
12264465947,12264465950,3,1530,1578,-10
12265099440,12265099441,1,1781,1816,-10
12265700286,12265700290,4,1989,1566,-10
12274268423,12274268422,-1,1477,1618,-10
12275218966,12275218969,3,1847,1283,-10
12275345552,12275345571,19,1745,1410,-10
12278621961,12278621963,2,1490,2237,-10
12279695101,12279695104,3,1494,1624,-10
12279757789,12279757769,-20,2447,1402,-10
12281594190,12281594192,2,1942,1486,-10
12286096905,12286096906,1,993,1404,-10
12286779122,12286779126,4,2516,1402,-10
12287729619,12287729620,1,1503,1631,-10
12288710392,12288710394,2,1556,1300,-10
12290757012,12290757016,4,2003,927,-10
12291473060,12291473063,3,2154,2144,-10
12293456702,12293456706,4,1087,1255,-10
12296980999,12296981002,3,1224,1787,-10
12297397942,12297397923,-19,1516,1618,-10
12298587634,12298587634,0,1226,1279,-10
12299648367,12299648371,4,1006,1511,-10
12300242985,12300242986,1,907,862,-10
12301596388,12301596390,2,2191,1750,-10
12302032274,12302032274,0,1584,1995,-10
12303719362,12303719366,4,1654,1301,-10
12304921421,12304921422,1,1524,1907,-10
12307955034,12307955029,-5,1129,2404,-10
12308207141,12308207142,1,1925,1630,-10
12311002239,12311002243,4,1675,2216,-10
12314245831,12314245830,-1,1742,2579,-10
12314628617,12314628618,1,1845,1372,-10
12315298681,12315298682,1,1572,1902,-10
12315501946,12315501949,3,1248,1364,-10
12316602141,12316602143,2,1758,1614,-10
12320336873,12320336877,4,1159,1870,-10
12321494255,12321494257,2,1511,1380,-10
12321683485,12321683496,11,1112,2009,-10
12327816484,12327816485,1,1466,1818,-10
12331708371,12331708374,3,1682,1566,-10
12332041670,12332041672,2,1784,1680,-10
12332693296,12332693288,-8,72,821,-10
12335213047,12335213049,2,1399,1345,-10
12335595896,12335595898,2,1248,1177,-10
12340125830,12340125833,3,1684,1283,-10
12341885291,12341885294,3,1808,1308,-10
12342117091,12342117094,3,1764,1679,-10
12342444718,12342444719,1,1620,1594,-10
12344628595,12344628596,1,1757,1573,-10
12346503760,12346503761,1,2322,1859,-10
12351725779,12351725780,1,1720,1592,-10
12353998122,12353998127,5,2334,1666,-10
12357392103,12357392104,1,1651,2112,-10
12360016433,12360016434,1,2116,1907,-10
12366328409,12366328404,-5,1412,3275,-10
12370902586,12370902586,0,1236,1020,-10
12371693895,12371693897,2,2234,1737,-10
12372015878,12372015880,2,1090,1167,-10
12376619023,12376619023,0,2135,2172,-10
12379534034,12379534036,2,1311,1451,-10
12381018279,12381018278,-1,1387,1549,-10
12382764248,12382764255,7,4517,1532,-10
12383289680,12383289682,2,1227,1337,-10
12386902731,12386902734,3,1903,1075,-10
12387683883,12387683883,0,1552,1072,-10
12388559966,12388559971,5,1762,1335,-10
12393046063,12393046064,1,2006,2090,-10
12394148142,12394148146,4,2621,1282,-10
12397353987,12397353989,2,1982,1798,-10
12402002860,12402002862,2,1317,1658,-10
12402675782,12402675783,1,1268,1487,-10
12403515289,12403515295,6,1561,1082,-10
12403599085,12403599085,0,1658,1444,-10
12406117553,12406117555,2,1498,1558,-10
12408778782,12408778782,0,1094,1022,-10
12416014738,12416014740,2,1399,1910,-10
12417732358,12417732359,1,1374,1573,-10
12419157412,12419157414,2,1574,1208,-10
12420454489,12420454490,1,1050,1158,-10
12420743153,12420743154,1,1340,1190,-10
12420768770,12420768770,0,1201,1315,-10
12422102834,12422102840,6,1171,1393,-10
12423348213,12423348214,1,1655,1626,-10
12424358458,12424358461,3,1921,1662,-10
12424396489,12424396498,9,1566,1147,-10
12424956084,12424956085,1,1544,1335,-10
12428489598,12428489594,-4,998,3388,-10
12433344158,12433344162,4,1497,1708,-10
12435404204,12435404206,2,1462,1357,-10
12437676036,12437676039,3,1445,1428,-10
12439565170,12439565171,1,1671,1494,-10
12439825906,12439825909,3,1041,1244,-10
12441866249,12441866250,1,986,878,-10
12441974490,12441974491,1,1406,1386,-10
12442703789,12442703790,1,1238,1776,-10
12443003414,12443003415,1,1562,971,-10
12445431906,12445431910,4,1123,727,-10
12445708003,12445708000,-3,871,1373,-10
12446490912,12446490914,2,768,767,-10
12449457193,12449457193,0,2006,1680,-10
12453813514,12453813517,3,1632,1900,-10
12454029635,12454029634,-1,1317,2361,-10
12454066273,12454066274,1,1375,1585,-10
12457293382,12457293388,6,3582,1242,-10
12461327260,12461327262,2,1750,2167,-10
12463332748,12463332751,3,1177,732,-10
12465945429,12465945431,2,1051,1118,-10
12466303340,12466303334,-6,1393,1585,-10
12467761035,12467761037,2,1571,1672,-10
12471301306,12471301306,0,2317,2137,-10
12473298662,12473298664,2,2163,1948,-10
12473368469,12473368471,2,1507,1302,-10
12478675246,12478675247,1,1836,2190,-10
12482372956,12482372960,4,1691,1335,-10
12488293346,12488293346,0,1600,1548,-10
12490030649,12490030651,2,1981,1809,-10
12490279141,12490279143,2,1819,1840,-10
12492227914,12492227914,0,1614,1990,-10
12494537513,12494537514,1,1014,1222,-10
12495652170,12495652173,3,1167,921,-10
12497183704,12497183699,-5,622,1017,-10
12499055845,12499055849,4,2195,1754,-10
12501021174,12501021175,1,1789,1619,-10
12508607852,12508607854,2,1790,1298,-10
12508845771,12508845769,-2,1583,1297,-10
12510701302,12510701302,0,4125,6208,-10
12510952242,12510952245,3,1700,1318,-10
12514090738,12514090739,1,1097,1643,-10
12514570753,12514570753,0,1813,1630,-10
12517258598,12517258600,2,1535,1886,-10
12517724203,12517724206,3,2675,2328,-10
12519275478,12519275479,1,1101,1435,-10
12524858611,12524858615,4,2252,1121,-10
12525339488,12525339490,2,1312,1536,-10
12525689051,12525689053,2,996,1374,-10
12527986734,12527986732,-2,619,1669,-10
12530354114,12530354118,4,1437,1767,-10
12545766072,12545766073,1,1502,1544,-10
12546552506,12546552506,0,1022,467,-10
12547399286,12547399287,1,1344,1385,-10
12552112020,12552112022,2,1711,846,-10
12552286262,12552286282,20,1123,1410,-10
12552857740,12552857742,2,1225,1479,-10
12554425037,12554425034,-3,1196,1472,-10
12554793182,12554793186,4,2167,2123,-10
12555426062,12555426065,3,1481,1754,-10
12557776378,12557776382,4,1977,1555,-10
12560091875,12560091873,-2,955,1292,-10
12560713499,12560713498,-1,1294,1994,-10
12561739162,12561739166,4,2118,1231,-10
12564823537,12564823538,1,1841,1878,-10
12565358710,12565358713,3,1803,2222,-10
12567306138,12567306142,4,1266,1879,-10
12569039966,12569039965,-1,1409,1845,-10
12570317546,12570317549,3,1887,1517,-10
12572818600,12572818602,2,1246,860,-10
12574399151,12574399153,2,1766,1626,-10
12578323031,12578323036,5,2857,1334,-10
12584206607,12584206603,-4,949,2217,-10
12588765537,12588765539,2,1697,1862,-10
12591828885,12591828885,0,1005,1606,-10
12598500454,12598500458,4,1257,1601,-10
12600364056,12600364057,1,2037,1813,-10
12601058544,12601058543,-1,1292,1031,-10
12602579814,12602579818,4,1957,1582,-10
12605986460,12605986462,2,1501,1484,-10
12606498518,12606498499,-19,896,636,-10
12609091787,12609091788,1,1184,1593,-10
12610954324,12610954325,1,1645,1502,-10
12611506913,12611506923,10,1098,794,-10
12612594370,12612594371,1,1693,1762,-10
12617045602,12617045607,5,1376,1579,-10
12618111727,12618111727,0,1211,1515,-10
12618847806,12618847806,0,1280,1742,-10
12624454365,12624454380,15,2091,1329,-10
12624949878,12624949881,3,1420,1178,-10
12630572926,12630572929,3,1931,1154,-10
12632314061,12632314063,2,1286,1343,-10
12633870054,12633870057,3,2106,1531,-10
12636783954,12636783955,1,510,439,-10
12638289806,12638289809,3,2472,2087,-10
12639499135,12639499138,3,1170,1175,-10
12644056214,12644056215,1,1295,1357,-10
12644840669,12644840672,3,1448,1619,-10
12645688343,12645688342,-1,1603,1860,-10
12649445158,12649445157,-1,1889,1313,-10
12655838393,12655838391,-2,1956,3811,-10
12656651059,12656651062,3,1184,1465,-10
12656809910,12656809914,4,818,1030,-10
12657161253,12657161257,4,1979,1743,-10
12658166582,12658166583,1,1669,1854,-10
12660358105,12660358107,2,1948,1584,-10
12664453758,12664453760,2,1412,1394,-10
12665633750,12665633751,1,1593,1630,-10
12666840553,12666840555,2,1520,1231,-10
12666971782,12666971783,1,1547,1317,-10
12673898105,12673898100,-5,1000,3493,-10
12674012933,12674012935,2,2325,1642,-10
12675152718,12675152719,1,1758,1577,-10
12675887912,12675887913,1,1374,1497,-10
12676489628,12676489633,5,1726,1189,-10
12677426063,12677426067,4,1914,886,-10
12679228938,12679228944,6,1195,841,-10
12684196550,12684196554,4,1622,1632,-10
12685924842,12685924847,5,1750,1081,-10
12687889593,12687889594,1,1790,1555,-10
12695557422,12695557425,3,1756,2010,-10
12696729878,12696729882,4,1275,1203,-10
12697122398,12697122403,5,1044,1307,-10
12700924477,12700924481,4,2294,1953,-10
12702456826,12702456815,-11,12770,25563,-10
12703212418,12703212421,3,2177,1674,-10
12703835447,12703835446,-1,1190,1502,-10
12704060134,12704060135,1,1463,1375,-10
12709356941,12709356943,2,1798,1263,-10
12711334010,12711334010,0,1630,1616,-10
12711743047,12711743046,-1,1155,1433,-10
12711778507,12711778506,-1,1590,1646,-10
12719448634,12719448634,0,1686,1734,-10
12719522543,12719522544,1,2027,1604,-10
12719634715,12719634717,2,1231,1204,-10
12720152379,12720152380,1,2324,2380,-10
12720276078,12720276082,4,1286,962,-10
12722811986,12722811987,1,1494,1831,-10
12723796291,12723796293,2,2483,1575,-10
12735357037,12735357036,-1,897,1852,-10
12737332758,12737332762,4,2267,2039,-10
12738766046,12738766047,1,1910,1402,-10
12739758067,12739758069,2,1314,1329,-10
12742263345,12742263347,2,1212,1030,-10
12744350722,12744350723,1,1622,886,-10
12748033855,12748033856,1,1615,1046,-10
12748301163,12748301165,2,1538,1879,-10
12750687474,12750687474,0,1437,931,-10
12750894436,12750894435,-1,1848,3634,-10
12753704096,12753704099,3,6460,5727,-10
12756134838,12756134841,3,2484,1628,-10
12756497460,12756497462,2,1708,1802,-10
12757698632,12757698635,3,1492,1383,-10
12758572371,12758572354,-17,1211,1096,-10
12760301108,12760301113,5,2881,854,-10
12761202101,12761202102,1,1874,1866,-10
12762401552,12762401554,2,3527,17823,-10
12765374061,12765374062,1,1499,1264,-10
12765462205,12765462206,1,1279,928,-10
12765528519,12765528521,2,1550,1490,-10
12767275634,12767275638,4,1568,1034,-10
12770880069,12770880061,-8,1334,3621,-10
12771553861,12771553863,2,1835,2335,-10
12775324541,12775324542,1,1300,1211,-10
12776981911,12776981911,0,1825,1554,-10
12777739776,12777739775,-1,1505,1370,-10
12779079794,12779079799,5,1520,1363,-10
12779210368,12779210372,4,1588,2116,-10
12779619403,12779619406,3,1426,1676,-10
12780759741,12780759738,-3,1775,2805,-10
12781634214,12781634217,3,1153,1535,-10
12781839297,12781839289,-8,1615,1377,-10
12783524990,12783524991,1,736,815,-10
12786591063,12786591063,0,2087,1660,-10
12787651830,12787651834,4,1878,1233,-10
12791878755,12791878758,3,1636,1523,-10
12795389023,12795389025,2,1562,1014,-10
12796327074,12796327075,1,19,1249,-10
12796712704,12796712706,2,1296,1488,-10
12799407587,12799407588,1,1775,1744,-10
12801496885,12801496887,2,1585,1030,-10
12803019269,12803019267,-2,2190,3785,-10
12803853950,12803853952,2,964,730,-10
12806371318,12806371336,18,2180,1161,-10
12808064218,12808064219,1,1328,1417,-10
12808108976,12808108978,2,1783,1295,-10
12808490247,12808490250,3,1505,1603,-10
12812023570,12812023571,1,1392,1311,-10
12814154708,12814154710,2,1583,1104,-10
12815750090,12815750091,1,1073,1336,-10
12816270474,12816270478,4,1069,1189,-10
12820112523,12820112525,2,1762,1488,-10
12820244875,12820244883,8,12576,31513,-10
12824083502,12824083494,-8,382,6700,-10
12824274792,12824274793,1,1189,1105,-10
12825284343,12825284346,3,1100,1156,-10
12825704395,12825704381,-14,1226,1419,-10
12828457330,12828457332,2,1027,1044,-10
12829600347,12829600348,1,1789,1041,-10
12831774035,12831774040,5,1070,1042,-10
12835018702,12835018707,5,1833,1321,-10
12837302797,12837302799,2,1460,1661,-10
12837575105,12837575106,1,1820,2033,-10
12838554416,12838554413,-3,1934,3496,-10
12844353614,12844353617,3,1314,1621,-10
12849970986,12849970986,0,680,596,-10
12852342030,12852342016,-14,1336,695,-10
12852836963,12852836965,2,1719,1396,-10
12853879573,12853879574,1,1677,1869,-10
12854151048,12854151049,1,2193,2293,-10
12856231417,12856231423,6,2349,1060,-10
12858335834,12858335838,4,2181,1457,-10
12860546211,12860546211,0,1405,1683,-10
12868015213,12868015215,2,1091,997,-10
12870696021,12870696025,4,1741,1450,-10
12873070516,12873070522,6,1442,1125,-10
12874277678,12874277679,1,1247,1232,-10
12875027834,12875027835,1,1522,1284,-10
12875078349,12875078350,1,1889,1503,-10
12876507586,12876507588,2,2742,1835,-10
12879566973,12879566974,1,1893,1704,-10
12881436424,12881436425,1,2558,1680,-10
12882017523,12882017525,2,1694,1899,-10
12882877154,12882877158,4,1860,1734,-10
12887245761,12887245762,1,2034,1965,-10
12892341392,12892341395,3,1777,1700,-10
12893049723,12893049725,2,1351,1572,-10
12896478086,12896478089,3,1509,1808,-10
12897576753,12897576754,1,2070,1932,-10
12898296342,12898296342,0,2250,2384,-10
12900673461,12900673462,1,1750,2046,-10
12902191680,12902191683,3,1776,1397,-10
12904711002,12904711003,1,1612,1896,-10
12904782099,12904782098,-1,1108,1322,-10
12906310658,12906310661,3,1727,1603,-10
12909363042,12909363043,1,1080,2078,-10
12909773020,12909773021,1,1613,1465,-10
12912043590,12912043591,1,2019,1696,-10
12913112051,12913112054,3,1699,1509,-10
12914130810,12914130813,3,2763,1596,-10
12914367261,12914367262,1,2077,2050,-10
12916082815,12916082815,0,1665,1372,-10
12926114563,12926114565,2,1414,1322,-10
12926986036,12926986033,-3,1184,1956,-10
12927639390,12927639393,3,1230,1527,-10
12929424329,12929424330,1,1262,897,-10
12935445522,12935445522,0,1078,840,-10
12938029255,12938029254,-1,2738,4831,-10
12940144471,12940144474,3,1141,1406,-10
12941590454,12941590458,4,1230,1348,-10
12941753623,12941753627,4,1182,1460,-10
12942080921,12942080922,1,1651,1602,-10
12943023012,12943023014,2,1693,1607,-10
12946419719,12946419722,3,1776,1214,-10
12950248335,12950248337,2,1357,2260,-10
12954017682,12954017680,-2,950,1615,-10
12963509885,12963509890,5,1707,1365,-10
12972839442,12972839461,19,1202,1210,-10
12974531175,12974531180,5,1861,1520,-10
12977670282,12977670283,1,1993,1024,-10
12980911190,12980911192,2,1545,1459,-10
12981473106,12981473109,3,758,973,-10
12982029378,12982029378,0,1260,1746,-10
12982397541,12982397564,23,2603,1471,-10
12985180010,12985180010,0,2503,2154,-10
12985304729,12985304730,1,1436,1323,-10
12987652237,12987652238,1,1779,1371,-10
12992510677,12992510683,6,4650,1746,-10
12993326092,12993326090,-2,1608,1563,-10
12993781058,12993781057,-1,1098,1229,-10
12997431227,12997431230,3,1338,1315,-10
13000027387,13000027390,3,1762,1318,-10
13000673777,13000673780,3,1645,1370,-10
13001721978,13001721981,3,1414,1166,-10
13004675354,13004675356,2,1588,1473,-10
13006579466,13006579467,1,1391,1520,-10
13006744954,13006744956,2,1189,1608,-10
13010539661,13010539661,0,1413,1542,-10
13010932043,13010932043,0,1761,1535,-10
13011007594,13011007600,6,2071,1609,-10
13012133630,13012133633,3,2185,971,-10
13013822473,13013822469,-4,1472,2290,-10
13020661489,13020661491,2,1623,1434,-10
13025330230,13025330235,5,1651,1629,-10
13026003581,13026003583,2,1630,1609,-10
13026916581,13026916582,1,1475,1722,-10
13031847022,13031847023,1,1187,1076,-10
13035663467,13035663469,2,1287,1878,-10
13037295360,13037295364,4,1613,1365,-10
13037756918,13037756919,1,1233,1336,-10
13040653211,13040653215,4,941,1555,-10
13046016935,13046016935,0,1306,1417,-10
13046513509,13046513510,1,1265,1501,-10
13046846221,13046846222,1,1897,1998,-10
13047820906,13047820906,0,1188,1169,-10
13051634906,13051634909,3,1591,1273,-10
13054808659,13054808662,3,1859,1220,-10
13056162050,13056162051,1,1003,1281,-10
13059392489,13059392489,0,1369,2724,-10
13059505067,13059505069,2,882,1058,-10
13060296938,13060296941,3,1687,1571,-10
13060599304,13060599305,1,1752,1462,-10
13061711448,13061711450,2,1117,1348,-10
13063227945,13063227946,1,1291,1578,-10
13066237615,13066237619,4,1766,1545,-10
13067052048,13067052070,22,1300,1519,-10
13068483616,13068483619,3,2212,1553,-10
13071918868,13071918870,2,2339,1344,-10
13080167595,13080167595,0,1586,1799,-10
13082058238,13082058239,1,1395,1899,-10
13082270254,13082270259,5,1259,1141,-10
13082513980,13082513982,2,1684,1336,-10
13087124489,13087124491,2,1962,1022,-10
13088002096,13088002094,-2,1681,1296,-10
13088906830,13088906833,3,1580,1639,-10
13092221741,13092221743,2,1790,1240,-10
13095264610,13095264610,0,1908,1819,-10
13099501343,13099501345,2,1057,1091,-10
13101452702,13101452703,1,1731,1251,-10
13102692046,13102692051,5,2280,1433,-10
13102966687,13102966690,3,1356,1073,-10
13103011539,13103011544,5,835,216,-10
13105237877,13105237879,2,1494,1391,-10
13106428527,13106428529,2,1151,1337,-10
13107899116,13107899115,-1,1477,1526,-10
13108274026,13108274029,3,2103,2281,-10
13115384367,13115384370,3,1810,1376,-10
13118547918,13118547923,5,1258,1022,-10
13121477798,13121477799,1,1427,1373,-10
13121855316,13121855319,3,2137,1928,-10
13122141534,13122141536,2,1813,1346,-10
13123594942,13123594941,-1,1297,1662,-10
13124214664,13124214663,-1,1652,2093,-10
13124313619,13124313603,-16,1393,1460,-10
13124738234,13124738237,3,1692,1200,-10
13127390102,13127390084,-18,1521,1783,-10
13128185709,13128185715,6,3106,1995,-10
13129689139,13129689142,3,1546,1323,-10
13138921970,13138921972,2,1953,2212,-10
13140610484,13140610487,3,1456,1706,-10
13140696757,13140696758,1,2400,1990,-10
13141647992,13141647995,3,1630,1294,-10
13146007174,13146007175,1,1284,1081,-10
13146616310,13146616289,-21,904,653,-10
13146936269,13146936270,1,1602,1913,-10
13147126918,13147126919,1,1277,1515,-10
13148994994,13148994995,1,1042,1240,-10
13150041333,13150041329,-4,1075,3201,-10
13154729801,13154729813,12,15756,40089,-10
13155461238,13155461237,-1,970,1649,-10
13155565375,13155565370,-5,1827,5937,-10
13156099766,13156099766,0,1435,1335,-10
13160224414,13160224414,0,1512,1324,-10
13164794037,13164794038,1,1729,1712,-10
13166479012,13166479014,2,2142,1595,-10
13171840158,13171840159,1,2068,2277,-10
13174642450,13174642453,3,1393,802,-10
13176396854,13176396850,-4,1602,1452,-10
13176663091,13176663093,2,1602,2164,-10
13177209795,13177209795,0,1110,1951,-10
13185953719,13185953723,4,1561,1390,-10
13186488614,13186488615,1,2017,1943,-10
13187157178,13187157179,1,1561,1091,-10
13191046783,13191046783,0,1531,1337,-10
13193524895,13193524897,2,1455,1310,-10
13194495390,13194495394,4,1449,1889,-10
13197131737,13197131741,4,2244,1634,-10
13202313472,13202313473,1,1293,1476,-10
13209926706,13209926710,4,1318,1355,-10
13210561366,13210561367,1,1518,1361,-10
13211880317,13211880318,1,1635,2000,-10
13212593025,13212593027,2,2036,1442,-10
13215670742,13215670744,2,1884,1406,-10
13216919507,13216919510,3,1310,1411,-10
13217119621,13217119623,2,1924,1849,-10
13221754929,13221754929,0,1685,2256,-10
13223120422,13223120421,-1,1662,2121,-10
13223380954,13223380957,3,1590,1408,-10
13225735523,13225735526,3,1403,905,-10
13227306834,13227306814,-20,1321,1950,-10
13229954150,13229954151,1,1883,1194,-10
13230113825,13230113828,3,1314,1867,-10
13234926242,13234926240,-2,2300,2219,-10
13235979241,13235979247,6,62127,102245,-10
13237935344,13237935346,2,1666,1435,-10
13238515582,13238515582,0,1818,2510,-10
13245429253,13245429257,4,1912,1573,-10
13245783327,13245783329,2,1356,1714,-10
13246269584,13246269585,1,1494,1705,-10
13246702171,13246702170,-1,1085,1904,-10
13252082086,13252082086,0,1886,2429,-10
13255839657,13255839657,0,1433,1919,-10
13257550201,13257550202,1,1147,946,-10
13261026031,13261026031,0,1448,1568,-10
13262009477,13262009477,0,1106,1731,-10
13262387982,13262387981,-1,1350,1738,-10
13268339389,13268339390,1,1460,984,-10
13268859345,13268859348,3,1386,1882,-10
13270318847,13270318844,-3,45658,21143,-10
13271039448,13271039450,2,794,1236,-10
13273885970,13273885971,1,2478,1365,-10
13274598890,13274598891,1,1509,2136,-10
13275620519,13275620520,1,1520,1704,-10
13275716594,13275716573,-21,1846,1591,-10
13276529869,13276529883,14,1190,1310,-10
13279747599,13279747601,2,1253,1444,-10
13281969787,13281969787,0,1396,1473,-10
13282267769,13282267759,-10,110,1635,-10
13285548710,13285548711,1,1643,1840,-10
13286283606,13286283610,4,2033,1760,-10
13286970077,13286970079,2,1681,1474,-10
13287960130,13287960111,-19,1515,1263,-10
13297235495,13297235496,1,1647,1385,-10
13297920825,13297920826,1,1685,1382,-10
13301799928,13301799931,3,1299,1326,-10
13302907120,13302907120,0,1471,1594,-10
13307819102,13307819102,0,1399,1001,-10
13307966326,13307966329,3,1875,1087,-10
13308702578,13308702579,1,1343,1531,-10
13310071938,13310071939,1,968,1338,-10
13312187708,13312187710,2,1777,1665,-10
13312964114,13312964115,1,1124,1121,-10
13313112746,13313112750,4,1920,1335,-10
13317981432,13317981435,3,1799,2044,-10
13318722598,13318722598,0,2160,2220,-10
13322249443,13322249442,-1,1408,2530,-10
13324269626,13324269606,-20,19312,42078,-10
13324486462,13324486463,1,1192,1192,-10
13325650531,13325650531,0,1572,1569,-10
13328104238,13328104239,1,1261,1673,-10
13332874454,13332874458,4,1248,1622,-10
13333192536,13333192537,1,1869,1914,-10
13342849263,13342849265,2,1749,1391,-10
13348208903,13348208905,2,1453,1410,-10
13352918138,13352918139,1,1369,2096,-10
13355166545,13355166547,2,1133,1242,-10
13356734270,13356734271,1,1313,1866,-10
13360053006,13360053007,1,1674,1924,-10
13360849948,13360849947,-1,2107,2085,-10
13360891074,13360891076,2,2025,1966,-10
13362740011,13362740016,5,1369,1692,-10
13366666919,13366666922,3,1287,1286,-10
13367945397,13367945398,1,1310,969,-10
13368819806,13368819810,4,1094,1335,-10
13370949083,13370949084,1,1578,1792,-10
13371848893,13371848884,-9,1104,1313,-10
13372677632,13372677632,0,990,1671,-10
13375653633,13375653635,2,1323,1243,-10
13377304935,13377304936,1,1115,1275,-10
13378162984,13378162987,3,1577,1480,-10
13379053467,13379053469,2,1342,1397,-10
13379513569,13379513571,2,1336,1733,-10
13380641643,13380641650,7,4259,1839,-10
13381700653,13381700653,0,1241,1535,-10
13382622379,13382622382,3,1054,1044,-10
13383430457,13383430459,2,1943,2154,-10
13386167142,13386167142,0,2223,2745,-10
13388637225,13388637226,1,1292,1436,-10
13389692810,13389692801,-9,19859,16632,-10
13391635325,13391635325,0,1868,2842,-10
13393811737,13393811738,1,1546,1858,-10
13396236574,13396236576,2,2001,2287,-10
13397879234,13397879231,-3,1415,1212,-10
13399232407,13399232410,3,1550,1754,-10
13402128754,13402128756,2,1853,1475,-10
13402502237,13402502239,2,1621,1473,-10
13403089061,13403089066,5,1287,1446,-10
13403992869,13403992869,0,1561,1503,-10
13404691009,13404691010,1,976,1348,-10
13406176267,13406176272,5,1325,1293,-10
13409537973,13409537981,8,9810,3039,-10
13409876966,13409876966,0,2095,1144,-10
13411636044,13411636046,2,1955,2071,-10
13423386770,13423386771,1,1495,1896,-10
13424193122,13424193124,2,1353,1475,-10
13425681138,13425681140,2,1114,1558,-10
13427474070,13427474073,3,813,1392,-10
13429508899,13429508903,4,1464,1529,-10
13433459442,13433459445,3,1873,1669,-10
13433734114,13433734114,0,1478,1800,-10
13433916001,13433916002,1,1959,1800,-10
13434639879,13434639878,-1,1103,1149,-10
13435156378,13435156376,-2,1451,1273,-10
13436298559,13436298558,-1,1701,2847,-10
13436430607,13436430611,4,1383,1703,-10
13437378997,13437378998,1,1370,1587,-10
13439833277,13439833277,0,1723,1673,-10
13440410238,13440410242,4,1589,1784,-10
13442330359,13442330359,0,1319,1684,-10
13443953482,13443953485,3,2242,1805,-10
13446774353,13446774356,3,1971,2039,-10
13450011669,13450011666,-3,1243,1620,-10
13453034442,13453034446,4,2039,2523,-10
13454885125,13454885127,2,1570,1202,-10
13454953106,13454953107,1,1521,2027,-10
13455071683,13455071685,2,1315,1297,-10
13455488985,13455488988,3,1484,1427,-10
13456219664,13456219666,2,2136,2064,-10
13461251547,13461251550,3,1662,2068,-10
13461357983,13461357983,0,744,677,-10
13464778141,13464778142,1,1716,1821,-10
13464872599,13464872600,1,1161,799,-10
13465819214,13465819218,4,1346,1533,-10
13467240242,13467240242,0,1410,1602,-10
13469396714,13469396716,2,897,1204,-10
13471545455,13471545457,2,1751,2003,-10
13472664747,13472664749,2,1900,1804,-10
13474315858,13474315859,1,1308,1212,-10
13475976843,13475976845,2,1578,1735,-10
13476458638,13476458641,3,1897,1791,-10
13478075631,13478075634,3,1692,1562,-10
13478574473,13478574475,2,2141,1900,-10
13480893622,13480893623,1,1205,1009,-10
13482786436,13482786433,-3,22049,13760,-10
13482897592,13482897593,1,1190,2176,-10
13483612818,13483612822,4,1375,874,-10
13485277531,13485277534,3,1579,1474,-10
13486776105,13486776109,4,1496,1523,-10
13486943325,13486943328,3,1967,2253,-10
13487360162,13487360163,1,1935,1715,-10
13487844366,13487844368,2,1887,1541,-10
13488413335,13488413335,0,2166,1975,-10
13491415775,13491415777,2,1537,1959,-10
13493098758,13493098758,0,805,1198,-10
13493490979,13493490983,4,1452,1245,-10
13498321804,13498321805,1,1841,2180,-10
13503962653,13503962653,0,1887,1904,-10
13504980239,13504980241,2,1394,1182,-10
13510736804,13510736806,2,1321,1411,-10
13512115706,13512115705,-1,1770,1501,-10
13513459829,13513459830,1,1750,1629,-10
13517139659,13517139661,2,995,984,-10
13518252925,13518252926,1,2235,2189,-10
13522288762,13522288762,0,1289,867,-10
13522756174,13522756177,3,1178,1636,-10
13523097515,13523097517,2,1993,1235,-10
13523977801,13523977802,1,1881,1646,-10
13524018188,13524018189,1,1145,1821,-10
13524810762,13524810763,1,1001,986,-10
13525457632,13525457650,18,1108,2102,-10
13527623206,13527623206,0,982,2445,-10
13530246435,13530246437,2,1056,963,-10
13532283308,13532283310,2,1492,1285,-10
13534587414,13534587414,0,2171,2458,-10
13534645221,13534645223,2,1396,1181,-10
13536485965,13536485966,1,1354,1857,-10
13537569234,13537569237,3,1988,1699,-10
13538430170,13538430171,1,1340,1180,-10
13552322974,13552322978,4,1472,1326,-10
13553084793,13553084794,1,1733,1601,-10
13554447314,13554447319,5,1227,1498,-10
13558122350,13558122329,-21,1609,1824,-10
13558299719,13558299718,-1,1436,1996,-10
13561859943,13561859946,3,1934,1312,-10
13564528129,13564528128,-1,1359,1224,-10
13565212679,13565212679,0,3177,10385,-10
13566094557,13566094559,2,1239,963,-10
13566499581,13566499582,1,1140,1444,-10
13570001521,13570001524,3,1306,1251,-10
13571186755,13571186738,-17,814,420,-10
13575179887,13575179889,2,1863,1417,-10
13577152889,13577152889,0,1338,1546,-10
13579479499,13579479499,0,883,889,-10
13583507538,13583507540,2,1504,1241,-10
13588737983,13588737984,1,1433,2261,-10
13590972136,13590972138,2,1459,1638,-10
13594503463,13594503468,5,2158,1822,-10
13599856784,13599856784,0,1592,1706,-10
13601107335,13601107352,17,1446,1304,-10
13603427400,13603427401,1,1270,1370,-10
13603684989,13603684990,1,1603,1496,-10
13604346548,13604346549,1,1385,1330,-10
13604719497,13604719498,1,1354,1178,-10
13604911986,13604911988,2,1451,1938,-10
13606770166,13606770167,1,1925,1259,-10
13613741005,13613741007,2,2428,2293,-10
13613784608,13613784607,-1,1496,1753,-10
13617904651,13617904651,0,1114,1308,-10
13619324281,13619324283,2,1427,1377,-10
13619653351,13619653350,-1,952,1461,-10
13620580987,13620580990,3,1445,1422,-10
13620625001,13620625002,1,1742,1724,-10
13620786936,13620786939,3,1436,1111,-10
13622764925,13622764926,1,2005,1864,-10
13622884970,13622884973,3,1369,1636,-10
13623003474,13623003474,0,878,987,-10
13623295447,13623295446,-1,1431,1350,-10
13623945483,13623945485,2,1612,1825,-10
13626015875,13626015877,2,1767,2670,-10
13628793314,13628793312,-2,1307,1450,-10
13631676072,13631676089,17,567,3289,-10
13635081065,13635081066,1,1137,1346,-10
13635270938,13635270938,0,1233,1536,-10
13636617607,13636617609,2,1142,1513,-10
13638408989,13638408990,1,2680,1947,-10
13639228667,13639228666,-1,21666,17752,-10
13640127346,13640127350,4,2038,2252,-10
13640232454,13640232457,3,1951,1117,-10
13641398122,13641398123,1,1204,1267,-10
13643540234,13643540233,-1,853,856,-10
13645132313,13645132315,2,1223,1431,-10
13647550212,13647550213,1,1350,2087,-10
13650007527,13650007528,1,1297,1649,-10
13655354620,13655354626,6,3495,1569,-10
13656344326,13656344328,2,2116,1750,-10
13656953526,13656953527,1,1655,1725,-10
13657438894,13657438895,1,1579,2470,-10
13658310252,13658310255,3,1745,1276,-10
13659173779,13659173780,1,1831,1703,-10
13660097326,13660097329,3,1796,1660,-10
13661043689,13661043694,5,5312,3825,-10
13662478336,13662478343,7,2766,934,-10
13667731876,13667731877,1,1673,1946,-10
13675391577,13675391577,0,1952,2012,-10
13675637722,13675637725,3,1593,1099,-10
13676015421,13676015423,2,1548,1635,-10
13676470067,13676470071,4,1799,1848,-10
13679141921,13679141923,2,1407,1056,-10
13679579818,13679579818,0,1602,1132,-10
13680576590,13680576592,2,1497,1609,-10
13680634078,13680634080,2,1570,1788,-10
13682573798,13682573801,3,1404,1404,-10
13682927125,13682927127,2,503,1123,-10
13683134815,13683134816,1,1697,2042,-10
13684010814,13684010814,0,1289,1455,-10
13684378715,13684378718,3,734,1272,-10
13685494570,13685494573,3,1900,1740,-10
13688143338,13688143342,4,1518,1087,-10
13688436350,13688436351,1,1733,1749,-10
13689879526,13689879522,-4,727,1294,-10
13691443425,13691443426,1,1637,1500,-10
13692613693,13692613694,1,1317,1336,-10
13695961433,13695961433,0,1194,1398,-10
13697301264,13697301265,1,1447,1757,-10
13699276495,13699276498,3,1954,1327,-10
13699770740,13699770742,2,1115,1390,-10
13700988342,13700988343,1,1546,1372,-10
13709449589,13709449591,2,1723,1261,-10
13711030675,13711030671,-4,1374,1626,-10
13711244666,13711244669,3,1726,1181,-10
13714646904,13714646907,3,1065,792,-10
13716112409,13716112413,4,2110,1635,-10
13723275271,13723275275,4,1184,1673,-10
13725706379,13725706381,2,829,1137,-10
13726544378,13726544378,0,1131,1337,-10
13727813037,13727813030,-7,1927,7790,-10
13730489625,13730489626,1,1873,1306,-10
13731716843,13731716843,0,1490,1321,-10
13732303641,13732303643,2,1496,1678,-10
13734598650,13734598650,0,882,2169,-10
13734917789,13734917794,5,3106,1605,-10
13736887939,13736887943,4,1024,1149,-10
13740148362,13740148358,-4,1085,1214,-10
13741774401,13741774404,3,1622,2012,-10
13744240006,13744240010,4,1104,1029,-10
13746149629,13746149633,4,1741,1346,-10
13748607165,13748607166,1,1299,1054,-10
13749689796,13749689799,3,2108,1781,-10
13750569938,13750569938,0,1649,1975,-10
13750935698,13750935703,5,1606,1568,-10
13754977793,13754977794,1,1655,1469,-10
13755843126,13755843128,2,884,971,-10
13756030780,13756030784,4,1224,1036,-10
13758181398,13758181398,0,1263,1180,-10
13760188518,13760188520,2,1322,1451,-10
13764912898,13764912902,4,1722,908,-10
13764978763,13764978764,1,1441,1543,-10
13767083293,13767083293,0,985,917,-10
13768727731,13768727732,1,1666,1337,-10
13770204010,13770204014,4,1391,1192,-10
13775587242,13775587242,0,1331,1676,-10
13776261209,13776261209,0,2372,1832,-10
13777471547,13777471549,2,1834,1824,-10
13779044304,13779044306,2,1686,1513,-10
13782927970,13782927970,0,1249,1423,-10
13785915650,13785915654,4,1814,1675,-10
13785946409,13785946410,1,1374,1328,-10
13786928124,13786928126,2,1629,1863,-10
13789119037,13789119039,2,1225,1523,-10
13789739018,13789739023,5,1572,1777,-10
13792187820,13792187822,2,1353,1435,-10
13798760262,13798760267,5,2707,1220,-10
13801431639,13801431642,3,931,976,-10
13802518362,13802518365,3,1266,1358,-10
13803443269,13803443270,1,1738,1471,-10
13806341675,13806341676,1,1408,1796,-10
13807242578,13807242578,0,1336,1725,-10
13814176851,13814176855,4,1840,1283,-10
13814472303,13814472307,4,1764,1296,-10
13815642650,13815642659,9,15849,20342,-10
13819746603,13819746605,2,1491,1341,-10
13820296339,13820296333,-6,1361,5391,-10
13821628382,13821628385,3,1817,1981,-10
13822930835,13822930837,2,1276,1909,-10
13824008991,13824008990,-1,1813,1677,-10
13824800809,13824800810,1,1543,1214,-10
13827978309,13827978313,4,2861,2103,-10
13828143386,13828143390,4,2023,1653,-10
13837609815,13837609815,0,1836,2487,-10
13838100603,13838100606,3,1043,1060,-10
13839804385,13839804384,-1,2101,1630,-10
13839986895,13839986904,9,1271,1089,-10
13840302901,13840302902,1,1251,1352,-10
13844692958,13844692959,1,1300,862,-10
13850289041,13850289042,1,951,818,-10
13850487939,13850487941,2,1946,1765,-10
13850554606,13850554611,5,1323,1125,-10
13851909902,13851909905,3,1608,1858,-10
13855127686,13855127687,1,1349,1136,-10
13859021718,13859021718,0,1761,1469,-10
13860624178,13860624176,-2,1311,1922,-10
13867653530,13867653531,1,1822,972,-10
13868577217,13868577219,2,1823,1345,-10
13869281786,13869281787,1,1052,1136,-10
13869819865,13869819866,1,1804,1355,-10
13870813891,13870813896,5,1300,1136,-10
13876541094,13876541097,3,1845,1906,-10
13876754719,13876754721,2,1420,1587,-10
13877563265,13877563266,1,2409,2625,-10
13880032522,13880032511,-11,27539,16629,-10
13883280681,13883280681,0,1579,1513,-10
13883852840,13883852842,2,1640,1499,-10
13886558175,13886558176,1,1417,2262,-10
13887683162,13887683165,3,1287,1657,-10
13890212628,13890212632,4,2073,1425,-10
13890392618,13890392618,0,1780,1803,-10
13890480596,13890480599,3,1996,2244,-10
13892883610,13892883611,1,1560,1473,-10
13896418354,13896418356,2,1731,2208,-10
13897211813,13897211814,1,1891,3213,-10
13899291967,13899291967,0,1106,1586,-10
13902892987,13902892990,3,1247,1105,-10
13907750311,13907750314,3,1754,1363,-10
13909781631,13909781633,2,1278,1463,-10
13914281818,13914281820,2,1926,1533,-10
13916425051,13916425053,2,922,917,-10
13917867823,13917867823,0,1994,1912,-10
13919724571,13919724575,4,1982,1520,-10
13921070333,13921070335,2,1270,1838,-10
13921971473,13921971475,2,1065,1523,-10
13922707298,13922707304,6,1505,1313,-10
13928956694,13928956695,1,1589,1346,-10
13930771386,13930771388,2,1817,1672,-10
13932755310,13932755314,4,1557,1416,-10
13934251343,13934251346,3,1016,1140,-10
13938998601,13938998604,3,1872,1792,-10
13939099874,13939099877,3,1816,1426,-10
13944084970,13944084971,1,922,971,-10
13944334825,13944334826,1,1383,1681,-10
13951249817,13951249817,0,1837,2720,-10
13960768227,13960768229,2,1936,1778,-10
13961940801,13961940805,4,1170,1507,-10
13967794001,13967794004,3,1718,2066,-10
13970249100,13970249094,-6,2977,8639,-10
13971767898,13971767901,3,1422,1474,-10
13971936523,13971936524,1,1815,1539,-10
13973075663,13973075666,3,1375,1367,-10
13973641575,13973641578,3,1518,1866,-10
13974648898,13974648898,0,997,1396,-10
13975438956,13975438974,18,825,1354,-10
13976215478,13976215481,3,1021,1270,-10
13978813194,13978813194,0,1465,1686,-10
13979251280,13979251282,2,1664,1345,-10
13980307282,13980307284,2,1524,1823,-10
13984063594,13984063597,3,1671,1682,-10
13990354327,13990354325,-2,1116,1619,-10
13992088834,13992088835,1,1835,1591,-10
13993933109,13993933111,2,1763,1177,-10
13995220264,13995220266,2,1116,905,-10
13995474321,13995474323,2,1304,1796,-10
14001898945,14001898946,1,1924,1429,-10
14005162771,14005162770,-1,1582,3145,-10
14008695207,14008695207,0,2295,1364,-10
14010640785,14010640787,2,1399,861,-10
14014740263,14014740254,-9,932,1718,-10
14016713878,14016713875,-3,1589,2371,-10
14018247562,14018247561,-1,1875,1835,-10
14020079988,14020079984,-4,19225,17449,-10
14020172261,14020172263,2,1636,1486,-10
14023714601,14023714603,2,994,1227,-10
14024759280,14024759279,-1,1448,1662,-10
14026375741,14026375746,5,1213,1173,-10
14029061574,14029061569,-5,1622,5266,-10
14030500935,14030500938,3,1905,2024,-10
14030992667,14030992673,6,4894,1959,-10
14049239138,14049239142,4,1566,1768,-10
14049568866,14049568866,0,1496,1185,-10
14049608245,14049608253,8,3738,1537,-10
14050188938,14050188941,3,1431,2026,-10
14052533410,14052533414,4,1312,1515,-10
14054359238,14054359241,3,1739,2027,-10
14054429146,14054429152,6,1895,1243,-10
14057990997,14057991000,3,1731,1540,-10
14058464131,14058464134,3,1215,1829,-10
14059312906,14059312909,3,2379,1461,-10
14061282988,14061282988,0,11453,16010,-10
14061707287,14061707294,7,2184,1493,-10
14064400594,14064400595,1,1510,1688,-10
14067715714,14067715715,1,2121,1516,-10
14070080166,14070080164,-2,1126,3524,-10
14071109297,14071109297,0,2104,1719,-10
14073806670,14073806670,0,1276,1671,-10
14080639066,14080639069,3,1319,1448,-10
14084076612,14084076617,5,1119,1214,-10
14084469454,14084469453,-1,843,1470,-10
14086116743,14086116746,3,1782,1526,-10
14088130408,14088130410,2,1708,1368,-10
14088619937,14088619918,-19,1931,1323,-10
14090919098,14090919096,-2,1012,1356,-10
14092857198,14092857201,3,1923,1367,-10
14093031824,14093031821,-3,1514,2463,-10
14093443600,14093443601,1,1733,1760,-10
14094546674,14094546674,0,1397,1622,-10
14097038422,14097038424,2,1169,1125,-10
14099737612,14099737614,2,1981,2547,-10
14099967733,14099967735,2,1696,2333,-10
14102032163,14102032163,0,796,1188,-10
14102489816,14102489819,3,1741,1784,-10
14103237691,14103237693,2,1915,1386,-10
14105577221,14105577222,1,1330,1397,-10
14107937606,14107937608,2,1196,1424,-10
14109168371,14109168374,3,1552,1258,-10
14112817341,14112817343,2,1895,1290,-10
14121754735,14121754737,2,1065,1404,-10
14129306766,14129306771,5,1937,1679,-10
14129617664,14129617667,3,1354,1689,-10
14133028736,14133028739,3,1984,1296,-10
14136937331,14136937332,1,1514,2210,-10
14141510226,14141510230,4,1424,1164,-10
14144327606,14144327604,-2,1675,1864,-10
14148143520,14148143525,5,14346,8614,-10
14149125117,14149125119,2,2610,2306,-10
14150509971,14150509974,3,1805,1286,-10
14151547090,14151547091,1,1632,1794,-10
14156167923,14156167925,2,1664,1332,-10
14160455678,14160455678,0,1540,1705,-10
14161371010,14161371010,0,1476,1537,-10
14164003731,14164003726,-5,2535,6647,-10
14164563665,14164563667,2,1470,1104,-10
14167107605,14167107606,1,1424,946,-10
14167865895,14167865898,3,1653,1427,-10
14168690689,14168690691,2,2111,1636,-10
14170788896,14170788898,2,1067,1185,-10
14171935608,14171935609,1,2042,2449,-10
14174097871,14174097870,-1,1274,1622,-10
14181253745,14181253747,2,1431,1116,-10
14182398378,14182398378,0,1322,1328,-10
14183424554,14183424554,0,1421,1179,-10
14186806206,14186806208,2,1313,1141,-10
14188404429,14188404431,2,1814,1596,-10
14195070677,14195070678,1,1005,1457,-10
14199078355,14199078357,2,1211,1608,-10
14199457800,14199457802,2,1713,2448,-10
14199800718,14199800718,0,1194,1192,-10
14203265014,14203265016,2,1476,1763,-10
14206305744,14206305747,3,1519,1598,-10
14206359833,14206359830,-3,1115,1816,-10
14209505114,14209505115,1,1011,1260,-10
14211139610,14211139613,3,1213,1497,-10
14212995275,14212995278,3,1154,1313,-10
14219698252,14219698257,5,2438,1765,-10
14219933053,14219933054,1,1765,1770,-10
14220603346,14220603353,7,11228,38066,-10
14221469749,14221469743,-6,2504,7459,-10
14222350421,14222350419,-2,1247,1896,-10
14223222638,14223222640,2,1691,1345,-10
14226337310,14226337312,2,1166,1428,-10
14234908315,14234908318,3,1840,2302,-10
14235352553,14235352556,3,1067,1093,-10
14237056857,14237056857,0,1378,2635,-10
14238500822,14238500822,0,949,1308,-10
14241183400,14241183403,3,1276,740,-10
14242422437,14242422437,0,1895,1360,-10
14245226158,14245226159,1,1391,1764,-10
14245767726,14245767727,1,1466,1226,-10
14248487806,14248487811,5,2177,1527,-10
14248567257,14248567259,2,1337,1169,-10
14252612728,14252612730,2,1370,1317,-10
14259508045,14259508046,1,1968,2039,-10
14260475036,14260475036,0,2227,2776,-10
14260860382,14260860385,3,1240,1251,-10
14261571493,14261571496,3,1273,1237,-10
14261691506,14261691511,5,2449,1602,-10
14267023727,14267023727,0,1222,1092,-10
14273702222,14273702223,1,1375,2081,-10
14274481965,14274481967,2,1663,1485,-10
14275257355,14275257359,4,1034,1103,-10
14284623463,14284623465,2,1913,1791,-10
14285773667,14285773669,2,1613,1461,-10
14289350714,14289350717,3,2117,1938,-10
14290666331,14290666325,-6,963,3485,-10
14291614245,14291614248,3,2219,2235,-10
14298233747,14298233749,2,1105,1540,-10
14298476526,14298476526,0,978,1124,-10
14300171436,14300171438,2,1141,1349,-10
14300497954,14300497958,4,1210,2024,-10
14303571002,14303571003,1,1368,1285,-10
14309804510,14309804511,1,1524,1621,-10
14310674948,14310674950,2,1219,1849,-10
14311195785,14311195787,2,950,904,-10
14311634911,14311634909,-2,1303,2050,-10
14312052393,14312052395,2,1051,1417,-10
14313216655,14313216658,3,1554,1666,-10
14315736773,14315736773,0,1438,1594,-10
14317890698,14317890700,2,2054,2252,-10
14318672863,14318672865,2,1485,1504,-10
14318739219,14318739220,1,1141,1275,-10
14320019494,14320019499,5,1858,1230,-10
14320674888,14320674889,1,1419,1436,-10
14320835835,14320835835,0,1189,1348,-10
14321629874,14321629874,0,1803,1667,-10
14322561522,14322561523,1,1428,1536,-10
14323407078,14323407082,4,1738,1258,-10
14324865220,14324865222,2,2182,1963,-10
14327630442,14327630444,2,2052,2216,-10
14329725901,14329725903,2,1616,1996,-10
14330571181,14330571184,3,1287,1804,-10
14330810909,14330810911,2,1237,938,-10
14332292089,14332292089,0,1412,1476,-10
14334873094,14334873096,2,1635,1285,-10
14335486486,14335486488,2,1664,1717,-10
14340921744,14340921746,2,1653,1440,-10
14345166698,14345166701,3,1296,1599,-10
14346037189,14346037191,2,1510,2145,-10
14346340386,14346340386,0,1589,2781,-10
14346974445,14346974449,4,2574,1613,-10
14348431807,14348431806,-1,1748,2080,-10
14349440108,14349440110,2,2184,1358,-10
14352255631,14352255627,-4,1170,1347,-10
14353348202,14353348204,2,1435,1506,-10
14354466643,14354466646,3,1612,1467,-10
14355413014,14355413018,4,1907,1644,-10
14355904702,14355904705,3,1727,2466,-10
14358771501,14358771503,2,1887,1332,-10
14361437566,14361437566,0,1221,1807,-10
14361490402,14361490402,0,1334,1236,-10
14363774910,14363774911,1,1272,1774,-10
14373492400,14373492401,1,1345,1339,-10
14374320105,14374320110,5,3100,1286,-10
14375897482,14375897482,0,950,1706,-10
14376643502,14376643505,3,1411,1421,-10
14376824050,14376824056,6,1350,1535,-10
14377598289,14377598291,2,2329,2353,-10
14377801292,14377801291,-1,1370,2112,-10
14378433845,14378433849,4,2244,1396,-10
14379083937,14379083939,2,1521,1521,-10
14380088589,14380088594,5,5441,24341,-10
14380624736,14380624735,-1,1381,1209,-10
14384145397,14384145394,-3,1577,2824,-10
14386937574,14386937578,4,1015,1024,-10
14387439063,14387439066,3,1514,1811,-10
14390261918,14390261918,0,1090,1603,-10
14392242726,14392242729,3,1525,2016,-10
14394299031,14394299035,4,1836,1179,-10
14395567341,14395567342,1,1446,1405,-10
14400165943,14400165947,4,1319,689,-10
14400751198,14400751202,4,2012,1354,-10
14402700301,14402700302,1,1646,1514,-10
14403625176,14403625181,5,1799,1560,-10
14403902512,14403902513,1,1904,1503,-10
14406634526,14406634530,4,1163,958,-10
14409306991,14409306993,2,1158,1476,-10
14412751501,14412751502,1,2617,3398,-10
14415955119,14415955123,4,3144,1815,-10
14416081970,14416081974,4,1581,1011,-10
14429597688,14429597693,5,1590,1301,-10
14430442565,14430442565,0,527,1484,-10
14430964869,14430964870,1,1021,905,-10
14431760146,14431760148,2,1655,1273,-10
14434328792,14434328791,-1,1007,1290,-10
14436553019,14436553019,0,1780,1887,-10
14438527377,14438527378,1,1011,829,-10
14439840480,14439840482,2,1390,1620,-10
14440478509,14440478509,0,946,1679,-10
14441988174,14441988177,3,1601,1853,-10
14444834406,14444834406,0,1988,1332,-10
14445082594,14445082597,3,1635,1711,-10
14445210208,14445210211,3,1824,1116,-10
14447439471,14447439473,2,1733,1397,-10
14447715405,14447715407,2,1489,1248,-10
14450481926,14450481926,0,1471,1509,-10
14450712959,14450712970,11,1504,1221,-10
14451467861,14451467841,-20,1277,745,-10
14456574738,14456574742,4,1614,1318,-10
14459920994,14459920998,4,1394,1749,-10
14460508743,14460508745,2,1312,1243,-10
14461979973,14461979975,2,1194,1052,-10
14465270946,14465270946,0,1748,3099,-10
14466798726,14466798731,5,1307,1596,-10
14467796086,14467796087,1,1906,1770,-10
14471049665,14471049669,4,2230,1721,-10
14471890573,14471890574,1,2223,1452,-10
14473517981,14473517983,2,1372,1007,-10
14474135594,14474135594,0,1281,1824,-10
14475199925,14475199931,6,3673,1629,-10
14476357446,14476357448,2,2011,1233,-10
14483739886,14483739888,2,1163,1273,-10
14486146247,14486146251,4,1037,1421,-10
14488067769,14488067772,3,897,706,-10
14491317510,14491317529,19,520,413,-10
14493986050,14493986053,3,1495,1821,-10
14497659315,14497659314,-1,1405,1550,-10
14500570027,14500570029,2,1962,1274,-10
14501175685,14501175688,3,1633,1843,-10
14501216194,14501216189,-5,769,3778,-10
14501833513,14501833514,1,1452,1388,-10
14502213673,14502213692,19,1455,1341,-10
14502324022,14502324028,6,1681,1531,-10
14502523027,14502523030,3,1775,1345,-10
14502914557,14502914562,5,2821,1559,-10
14503444149,14503444151,2,1533,1205,-10
14505445081,14505445085,4,1372,2244,-10
14506659591,14506659595,4,1725,1532,-10
14507444558,14507444560,2,1092,1520,-10
14508667554,14508667561,7,5019,2007,-10
14515182021,14515182022,1,1540,1576,-10
14515392916,14515392919,3,1023,978,-10
14521468645,14521468646,1,1602,1443,-10
14524642553,14524642557,4,1451,1317,-10
14528221783,14528221782,-1,1375,1061,-10
14530448449,14530448443,-6,1288,5099,-10
14531737771,14531737773,2,1651,1455,-10
14532298983,14532298964,-19,1124,996,-10
14536714025,14536714028,3,1534,1493,-10
14539967095,14539967094,-1,2869,4526,-10
14540148518,14540148518,0,1647,1607,-10
14544567703,14544567707,4,1317,1473,-10
14546380142,14546380145,3,1189,1205,-10
14546916110,14546916110,0,2913,4134,-10
14550818442,14550818444,2,1241,1353,-10
14552682758,14552682763,5,2051,1628,-10
14558099790,14558099793,3,1968,1484,-10
14558240405,14558240406,1,1502,1647,-10
14558786910,14558786914,4,1526,955,-10
14561240010,14561240010,0,1699,1314,-10
14561833018,14561833020,2,1591,1922,-10
14563892363,14563892366,3,1145,1722,-10
14564546029,14564546031,2,1100,1212,-10
14565440611,14565440614,3,1399,1112,-10
14567172807,14567172801,-6,799,2808,-10
14567577035,14567577038,3,1695,1605,-10
14568182755,14568182758,3,1854,1285,-10
14568642828,14568642829,1,1463,1873,-10
14577812291,14577812293,2,1117,1935,-10
14581399501,14581399503,2,1708,1729,-10
14584520110,14584520117,7,7635,2480,-10
14585762731,14585762730,-1,1689,1880,-10
14585901863,14585901866,3,1830,1640,-10
14586157220,14586157213,-7,33657,118754,-10
14587142086,14587142090,4,2485,1611,-10
14589255000,14589255003,3,1465,930,-10
14590139907,14590139911,4,1070,625,-10
14591179030,14591179031,1,1499,1230,-10
14592856527,14592856530,3,1386,1637,-10
14593398094,14593398094,0,1158,2068,-10
14593732210,14593732210,0,1037,1034,-10
14597436799,14597436802,3,1351,935,-10
14599594080,14599594082,2,1439,1730,-10
14599779734,14599779735,1,2654,3881,-10
14600653645,14600653647,2,1494,1488,-10
14603241474,14603241477,3,1377,1687,-10
14603359947,14603359949,2,1422,1274,-10
14604166090,14604166094,4,1560,1422,-10
14611154946,14611154947,1,1786,1397,-10
14613411938,14613411940,2,1704,1901,-10
14615076407,14615076410,3,1467,1340,-10
14617710121,14617710123,2,1498,1089,-10
14618010530,14618010531,1,1504,1118,-10
14618486326,14618486331,5,831,243,-10
14618666801,14618666801,0,1009,1511,-10
14619330599,14619330602,3,834,1100,-10
14622992445,14622992446,1,1551,1650,-10
14624246322,14624246302,-20,1386,1114,-10
14625996963,14625996964,1,1998,2023,-10
14627987246,14627987249,3,1512,876,-10
14631027073,14631027075,2,1649,921,-10
14631342058,14631342062,4,2029,2408,-10
14632016109,14632016106,-3,1286,1918,-10
14635375767,14635375770,3,1572,1464,-10
14638558260,14638558261,1,1245,1434,-10
14647386485,14647386486,1,1829,2203,-10
14650559887,14650559890,3,2295,2152,-10
14656404390,14656404394,4,1793,1373,-10
14656461457,14656461458,1,1405,1328,-10
14657905858,14657905859,1,1041,1186,-10
14664301962,14664301964,2,1533,1509,-10
14666696957,14666696958,1,1551,1613,-10
14666815427,14666815428,1,1588,1471,-10
14668886136,14668886137,1,1509,1584,-10
14671527724,14671527725,1,1584,1457,-10
14673583785,14673583785,0,1743,1664,-10
14676358918,14676358919,1,1321,1383,-10
14679100719,14679100719,0,2081,1906,-10
14680047874,14680047874,0,1804,1746,-10
14681286958,14681286958,0,1610,1802,-10
14681652914,14681652914,0,1767,1743,-10
14683323450,14683323470,20,1038,1007,-10
14683809975,14683809977,2,2097,2138,-10
14684242158,14684242157,-1,2486,1589,-10
14684907289,14684907285,-4,2636,5766,-10
14687457826,14687457830,4,1540,1287,-10
14688203570,14688203572,2,1542,1582,-10
14688750836,14688750838,2,1438,1301,-10
14689122057,14689122057,0,1546,1263,-10
14690215438,14690215442,4,1762,1209,-10
14691395593,14691395592,-1,1090,1482,-10
14692101796,14692101798,2,2787,2230,-10
14692321267,14692321269,2,1564,1486,-10
14692828895,14692828898,3,1704,1221,-10
14693396514,14693396520,6,931,1292,-10
14695333712,14695333711,-1,2307,2740,-10
14696368720,14696368722,2,1493,1507,-10
14696404255,14696404254,-1,1139,1452,-10
14697583124,14697583125,1,1751,2167,-10
14699175369,14699175369,0,1333,1071,-10
14699773895,14699773894,-1,1437,2082,-10
14701616174,14701616174,0,1333,1859,-10
14701849065,14701849069,4,2510,1817,-10
14704034751,14704034754,3,1667,1601,-10
14706414951,14706414952,1,1557,1271,-10
14706618059,14706618060,1,1533,1561,-10
14711326491,14711326494,3,1670,1787,-10
14713299744,14713299746,2,1652,1641,-10
14714471375,14714471379,4,1776,1784,-10
14715483101,14715483102,1,1642,2024,-10
14716335000,14716335002,2,1843,1600,-10
14717511219,14717511220,1,2024,2888,-10
14728481497,14728481502,5,664,954,-10
14730588270,14730588273,3,1950,1502,-10
14732407126,14732407139,13,1551,1193,-10
14732722043,14732722043,0,1934,1847,-10
14735233910,14735233910,0,1760,1278,-10
14735441699,14735441701,2,1509,1329,-10
14737159795,14737159794,-1,1480,1740,-10
14738651022,14738651023,1,1888,1962,-10
14739812562,14739812563,1,1068,1311,-10
14740379371,14740379350,-21,36,2015,-10
14746321596,14746321594,-2,1550,1610,-10
14749040057,14749040058,1,1191,1575,-10
14750350228,14750350230,2,1566,1369,-10
14750407320,14750407323,3,822,1277,-10
14751117634,14751117631,-3,1407,4062,-10
14751664600,14751664602,2,1301,1566,-10
14752509426,14752509425,-1,1025,1098,-10
14755054861,14755054862,1,1676,1335,-10
14755558292,14755558294,2,1707,2209,-10
14755727867,14755727867,0,1212,1300,-10
14757480024,14757480027,3,1302,1313,-10
14760625919,14760625916,-3,1446,2162,-10
14763895557,14763895559,2,2166,2222,-10
14766298851,14766298853,2,1975,2032,-10
14766640433,14766640434,1,1176,1217,-10
14766797918,14766797918,0,1297,1912,-10
14769212762,14769212768,6,2216,1319,-10
14770175782,14770175786,4,1609,1417,-10
14772888166,14772888166,0,1694,1976,-10
14774677450,14774677452,2,1632,1598,-10
14777107970,14777107971,1,1448,1325,-10
14780886051,14780886049,-2,755,818,-10
14782947674,14782947675,1,1194,1636,-10
14783386486,14783386489,3,1362,1089,-10
14784008898,14784008880,-18,634,210,-10
14784121243,14784121239,-4,1270,1476,-10
14785832006,14785831999,-7,670,1849,-10
14787106962,14787106963,1,910,1397,-10
14787259609,14787259608,-1,1586,2035,-10
14791841955,14791841954,-1,1000,1358,-10
14797844245,14797844248,3,1581,1137,-10
14800200084,14800200088,4,1917,1273,-10
14800849195,14800849197,2,1071,1076,-10
14802011931,14802011934,3,1743,1546,-10
14802760510,14802760510,0,2329,2541,-10
14807974724,14807974726,2,1617,1585,-10
14808605735,14808605735,0,2181,2542,-10
14809253586,14809253589,3,1819,944,-10
14809832071,14809832074,3,2198,2610,-10
14813279546,14813279566,20,1499,1451,-10
14814150265,14814150266,1,1204,1689,-10
14814298092,14814298094,2,1385,1374,-10
14814774146,14814774150,4,2605,2099,-10
14815791450,14815791450,0,1127,1429,-10
14819192760,14819192761,1,1957,1773,-10
14819444613,14819444617,4,1388,1607,-10
14822326905,14822326907,2,1566,1291,-10
14825876224,14825876227,3,1666,2135,-10
14826306182,14826306184,2,992,1248,-10
14826811965,14826811967,2,1193,1147,-10
14827638962,14827638962,0,1421,1582,-10
14828078445,14828078446,1,1193,1545,-10
14829552198,14829552199,1,1561,2286,-10
14830021270,14830021267,-3,1314,1647,-10
14832474558,14832474559,1,2107,1468,-10
14833179841,14833179843,2,1143,1045,-10
14833991940,14833991941,1,1422,1708,-10
14836044972,14836044977,5,2149,1524,-10
14837947938,14837947944,6,2662,1203,-10
14839655656,14839655658,2,1519,1690,-10
14839802849,14839802850,1,965,1176,-10
14841757139,14841757141,2,1280,1592,-10
14842299942,14842299944,2,1905,1759,-10
14842334489,14842334493,4,1785,996,-10
14845452374,14845452376,2,1087,1059,-10
14848911222,14848911223,1,1628,2375,-10
14849155459,14849155461,2,1666,2063,-10
14850426967,14850426968,1,999,1228,-10
14851747346,14851747346,0,3195,2843,-10
14853102450,14853102451,1,1318,1396,-10
14853869834,14853869837,3,2081,2043,-10
14855690929,14855690931,2,1877,1585,-10
14856094839,14856094841,2,2315,1869,-10
14862333543,14862333545,2,1112,1150,-10
14862666701,14862666702,1,1865,1539,-10
14865836988,14865836995,7,3513,1247,-10
14869131825,14869131826,1,1568,1355,-10
14869160131,14869160132,1,1085,1510,-10
14876710835,14876710836,1,1073,1336,-10
14877040207,14877040206,-1,1056,1338,-10
14877932288,14877932290,2,1679,2325,-10
14880837483,14880837486,3,1683,1318,-10
14882539682,14882539685,3,1961,1494,-10
14882765374,14882765353,-21,757,664,-10
14883794007,14883794009,2,1894,1959,-10
14884235458,14884235459,1,1319,1267,-10
14886308879,14886308881,2,1239,1521,-10
14887684078,14887684078,0,1034,2138,-10
14889306068,14889306070,2,1552,1198,-10
14890298887,14890298891,4,1516,1367,-10
14891392263,14891392261,-2,475,1639,-10
14894089134,14894089137,3,2280,1581,-10
14897352237,14897352239,2,1267,1022,-10
14897399106,14897399117,11,209,2340,-10
14899146447,14899146449,2,1442,1744,-10
14901725129,14901725131,2,1560,2032,-10
14902208982,14902208984,2,1386,1729,-10
14904369921,14904369923,2,1657,2254,-10
14909244923,14909244927,4,2127,1264,-10
14913208122,14913208126,4,1161,1603,-10
14914436157,14914436158,1,1395,1193,-10
14915279529,14915279529,0,894,1398,-10
14918385858,14918385860,2,1790,1629,-10
14919319776,14919319778,2,1561,1181,-10
14920379547,14920379550,3,1278,1509,-10
14921333586,14921333589,3,1213,1563,-10
14923682847,14923682850,3,2093,1925,-10
14926497248,14926497250,2,1601,1434,-10
14929462131,14929462127,-4,1026,3375,-10
14929749843,14929749847,4,1423,786,-10
14931792234,14931792235,1,1951,2052,-10
14933786238,14933786239,1,1682,1224,-10
14935357336,14935357326,-10,43765,14346,-10
14935659214,14935659214,0,1457,1492,-10
14936864430,14936864433,3,1376,1327,-10
14937235286,14937235286,0,1336,1800,-10
14939003770,14939003773,3,1289,1368,-10
14940430553,14940430554,1,913,1003,-10
14944669223,14944669222,-1,1284,578,-10
14946944088,14946944091,3,1475,2116,-10
14947378251,14947378254,3,1381,1978,-10
14947585421,14947585422,1,1553,1792,-10
14948541055,14948541055,0,1666,1087,-10
14951690422,14951690428,6,1437,1701,-10
14954497362,14954497363,1,1326,1829,-10
14955391746,14955391747,1,1667,2677,-10
14958658720,14958658721,1,1325,1232,-10
14959432750,14959432750,0,1118,1198,-10
14960744649,14960744651,2,1474,1673,-10
14964037349,14964037351,2,2190,1888,-10
14965055511,14965055510,-1,1001,1388,-10
14966738083,14966738086,3,1462,1584,-10
14969083823,14969083826,3,1882,1759,-10
14969393992,14969393994,2,1097,1210,-10
14970068319,14970068321,2,1481,1040,-10
14977027978,14977027981,3,1975,1373,-10
14980078704,14980078705,1,1478,1882,-10
14980613483,14980613483,0,1040,800,-10
14981245007,14981245009,2,1616,1247,-10
14981416403,14981416410,7,1447,1051,-10
14984119088,14984119090,2,1491,1522,-10
14984637706,14984637706,0,2068,1565,-10
14984929803,14984929805,2,2081,1565,-10
14985232745,14985232755,10,2125,1711,-10
14985393202,14985393203,1,1285,1466,-10
14993492488,14993492489,1,1480,1082,-10
14994554962,14994554963,1,1200,1576,-10
14998456665,14998456668,3,1856,1947,-10
15001170621,15001170624,3,1435,1541,-10
15002045387,15002045390,3,1604,1311,-10
15003991031,15003991030,-1,1380,1724,-10
15006759014,15006759016,2,1152,1330,-10
15008992271,15008992273,2,963,873,-10
15010127489,15010127490,1,1653,1903,-10
15010300606,15010300607,1,891,1770,-10
15011213524,15011213530,6,2768,1433,-10
15011411835,15011411843,8,1853,1619,-10
15012373265,15012373267,2,1630,1427,-10
15015100561,15015100563,2,1606,1557,-10
15016204712,15016204730,18,1583,1528,-10
15018415285,15018415288,3,1721,1718,-10
15020032785,15020032786,1,962,1529,-10
15020378551,15020378552,1,1121,1460,-10
15020904754,15020904756,2,1446,1736,-10
15024693356,15024693359,3,1650,1301,-10
15024916691,15024916688,-3,1045,1590,-10
15026351531,15026351533,2,1111,2077,-10
15028641362,15028641368,6,4176,2487,-10
15032813054,15032813058,4,2077,1477,-10
15033154126,15033154130,4,1754,1196,-10
15033853373,15033853376,3,1936,1439,-10
15036314751,15036314753,2,1617,1552,-10
15037642467,15037642467,0,2158,2119,-10
15039625693,15039625690,-3,1302,3619,-10
15041046202,15041046203,1,2130,1088,-10
15042111379,15042111381,2,1394,1641,-10
15044275582,15044275583,1,1382,1279,-10
15044882342,15044882347,5,1364,1310,-10
15045229369,15045229370,1,2032,1297,-10
15047260292,15047260272,-20,74,516,-10
15047664225,15047664227,2,1623,1857,-10
15049149858,15049149860,2,1332,1340,-10
15056546506,15056546506,0,1531,1284,-10
15057622795,15057622799,4,1193,1071,-10
15058693797,15058693813,16,17499,45470,-10
15060042219,15060042220,1,1699,2124,-10
15061420339,15061420340,1,971,641,-10
15063314409,15063314405,-4,37045,8046,-10
15065297559,15065297559,0,1321,1702,-10
15068368582,15068368584,2,2003,1700,-10
15068971386,15068971386,0,941,1483,-10
15070150161,15070150163,2,1463,1882,-10
15073978088,15073978089,1,1801,1793,-10
15079879029,15079879031,2,1676,1262,-10
15081000682,15081000685,3,2064,1554,-10
15081706224,15081706222,-2,1840,1215,-10
15086256838,15086256838,0,1349,1357,-10
15087107214,15087107217,3,2156,1267,-10
15087577676,15087577677,1,1760,1440,-10
15088204002,15088204006,4,1217,1514,-10
15089991346,15089991346,0,1231,1298,-10
15094233475,15094233478,3,1441,1536,-10
15097582970,15097582979,9,14316,26375,-10
15100105165,15100105169,4,2317,1886,-10
15101018162,15101018167,5,4065,2287,-10
15105779794,15105779798,4,1784,1405,-10
15112716524,15112716525,1,2120,1581,-10
15119325719,15119325738,19,17417,20783,-10
15121110669,15121110671,2,1496,1778,-10
15126017531,15126017534,3,989,1353,-10
15127047488,15127047506,18,467,1519,-10
15129353957,15129353959,2,1898,1291,-10
15136072892,15136072894,2,1623,1577,-10
15136688725,15136688727,2,1782,1600,-10
15139447559,15139447562,3,1370,1525,-10
15148300290,15148300292,2,1964,1473,-10
15152444330,15152444333,3,965,1793,-10
15153644235,15153644238,3,1054,1496,-10
15154038933,15154038935,2,1267,1435,-10
15156987499,15156987503,4,1929,1944,-10
15161892590,15161892598,8,2262,2847,-10
15162098263,15162098266,3,1792,1299,-10
15163884793,15163884794,1,1747,1361,-10
15164610769,15164610770,1,1904,1996,-10
15164811724,15164811725,1,2170,2162,-10
15165810707,15165810722,15,1296,875,-10
15167520177,15167520177,0,1688,1669,-10
15169330983,15169330985,2,1118,1247,-10
15169944825,15169944827,2,1389,1062,-10
15172899222,15172899224,2,1905,2010,-10
15173873118,15173873120,2,1222,1643,-10
15174791831,15174791831,0,1470,1361,-10
15176586030,15176586029,-1,1717,1400,-10
15177512473,15177512474,1,1548,1738,-10
15179311934,15179311936,2,1183,1087,-10
15179652014,15179652014,0,1132,1164,-10
15179981990,15179981987,-3,1096,1991,-10
15183510739,15183510717,-22,655,506,-10
15186074066,15186074068,2,1706,1263,-10
15190550382,15190550383,1,1106,1921,-10
15191600777,15191600778,1,1362,1195,-10
15199162297,15199162302,5,2285,1106,-10
15200192038,15200192039,1,1523,1470,-10
15201779659,15201779664,5,1305,1191,-10
15202147838,15202147842,4,1944,1383,-10
15205175890,15205175891,1,1578,1393,-10
15207520639,15207520641,2,2496,2001,-10
15211591151,15211591150,-1,914,2116,-10
15215681468,15215681470,2,1675,1603,-10
15216615113,15216615115,2,1609,1277,-10
15216741826,15216741825,-1,1543,1893,-10
15217855897,15217855896,-1,1326,1820,-10
15218012242,15218012243,1,2398,1656,-10
15218969706,15218969705,-1,994,1244,-10
15220200759,15220200762,3,1473,1107,-10
15220643247,15220643250,3,3614,3354,-10
15221396007,15221396009,2,1450,1722,-10
15223395814,15223395817,3,1164,1582,-10
15225613307,15225613307,0,1892,1909,-10
15226068346,15226068347,1,1316,1084,-10
15227151694,15227151691,-3,954,2086,-10
15229281634,15229281633,-1,1377,1618,-10
15230683853,15230683857,4,927,1151,-10
15232548332,15232548340,8,4299,1481,-10
15234384875,15234384875,0,2016,1656,-10
15236616498,15236616499,1,1458,1787,-10
15237327581,15237327582,1,1517,1723,-10
15239336787,15239336782,-5,1065,1669,-10
15241797404,15241797406,2,1498,1339,-10
15243495087,15243495089,2,1640,1860,-10
15244335642,15244335646,4,1756,1320,-10
15244609450,15244609451,1,1693,1714,-10
15245443546,15245443549,3,2489,1913,-10
15249405590,15249405589,-1,1220,1494,-10
15250541914,15250541916,2,2110,1749,-10
15251465743,15251465748,5,1823,756,-10
15256422451,15256422450,-1,1030,1520,-10
15257499785,15257499787,2,1499,1862,-10
15261659039,15261659042,3,1981,1911,-10
15266123051,15266123054,3,1331,1656,-10
15268566684,15268566686,2,1496,1959,-10
15271929494,15271929498,4,1688,1180,-10
15277398413,15277398415,2,2120,1597,-10
15277931666,15277931668,2,1321,1246,-10
15279247592,15279247592,0,1634,1892,-10
15281644503,15281644507,4,1881,1422,-10
15285192517,15285192520,3,1298,1046,-10
15285525806,15285525810,4,710,208,-10
15287617609,15287617611,2,1477,1663,-10
15288738771,15288738774,3,1156,1435,-10
15290315089,15290315090,1,1376,1421,-10
15292000735,15292000737,2,1917,1561,-10
15293631491,15293631493,2,2023,1776,-10
15296171900,15296171903,3,1298,1654,-10
15302924838,15302924842,4,1884,1635,-10
15305217014,15305217015,1,1582,1544,-10
15308090214,15308090217,3,1696,1610,-10
15311716987,15311716987,0,1397,1323,-10
15312330930,15312330934,4,2156,1953,-10
15312773554,15312773560,6,1439,1533,-10
15314141478,15314141478,0,1444,880,-10
15315674133,15315674137,4,2150,2253,-10
15320034112,15320034102,-10,1196,981,-10
15320187854,15320187855,1,1248,1538,-10
15325116299,15325116300,1,1363,1587,-10
15326136267,15326136267,0,1409,1215,-10
15326529122,15326529122,0,1235,1727,-10
15328046726,15328046728,2,2266,1851,-10
15328969973,15328969970,-3,1865,3622,-10
15329588512,15329588513,1,2368,1929,-10
15330366553,15330366555,2,1365,1717,-10
15334589443,15334589444,1,1118,1348,-10
15334978307,15334978311,4,1069,1534,-10
15336999327,15336999329,2,1659,2001,-10
15342501209,15342501213,4,1362,1440,-10
15343212758,15343212761,3,1536,1341,-10
15344119332,15344119334,2,2084,1240,-10
15350906969,15350906973,4,1970,2172,-10
15353374998,15353375002,4,1790,1401,-10
15355798099,15355798101,2,882,1247,-10
15356013358,15356013360,2,2048,1563,-10
15357302004,15357302007,3,1240,1419,-10
15358976628,15358976630,2,1498,2020,-10
15360547087,15360547087,0,1205,1527,-10
15363763402,15363763409,7,1655,1051,-10
15364051920,15364051922,2,1476,2002,-10
15365622000,15365622007,7,2748,1282,-10
15365920161,15365920164,3,1118,1566,-10
15367123331,15367123334,3,1323,1384,-10
15369377498,15369377500,2,2054,2081,-10
15373791150,15373791152,2,3216,2731,-10
15373974665,15373974661,-4,938,1543,-10
15374924347,15374924347,0,40480,17998,-10
15382221378,15382221380,2,1440,1678,-10
15383873239,15383873241,2,1304,1582,-10
15386031420,15386031425,5,1043,1010,-10
15386958353,15386958356,3,1696,2061,-10
15392132021,15392132023,2,1453,1700,-10
15392365878,15392365881,3,1152,1812,-10
15394367814,15394367817,3,1247,1421,-10
15394433021,15394433026,5,1732,1566,-10
15396805661,15396805663,2,1896,1702,-10
15397389502,15397389502,0,1093,1906,-10
15405000103,15405000104,1,2124,1314,-10
15406284307,15406284294,-13,1497,1174,-10
15409359777,15409359778,1,1173,941,-10
15410534253,15410534254,1,1195,1113,-10
15410791485,15410791487,2,1627,1435,-10
15411573058,15411573058,0,1512,1692,-10
15413274376,15413274376,0,1678,1754,-10
15414220862,15414220865,3,1515,1677,-10
15416711865,15416711866,1,1406,1536,-10
15418555196,15418555198,2,1368,1177,-10
15422582713,15422582714,1,1422,1985,-10
15422686521,15422686524,3,1568,1329,-10
15425314466,15425314487,21,418,1155,-10
15426177991,15426177989,-2,872,2383,-10
15426996089,15426996099,10,1676,1152,-10
15430197599,15430197602,3,2153,1899,-10
15431445505,15431445507,2,1534,1535,-10
15433555960,15433555964,4,1810,1865,-10
15434017069,15434017074,5,1277,1433,-10
15434160633,15434160636,3,1341,1550,-10
15434403022,15434403008,-14,834,506,-10
15436833718,15436833720,2,2007,2242,-10
15437914817,15437914818,1,1983,1763,-10
15438607641,15438607625,-16,5237,1894,-10
15441723848,15441723850,2,1905,1634,-10
15450443175,15450443176,1,1408,1745,-10
15453404085,15453404079,-6,1104,4931,-10
15462182391,15462182394,3,1008,1125,-10
15463597202,15463597205,3,1967,1209,-10
15471319387,15471319390,3,1976,1892,-10
15477205650,15477205655,5,2020,1591,-10
15478555628,15478555614,-14,968,1185,-10
15480651338,15480651340,2,1568,1619,-10
15480742315,15480742318,3,1515,1579,-10
15483404874,15483404875,1,1669,2129,-10
15484547945,15484547947,2,1273,1656,-10
15486937970,15486937969,-1,3391,11124,-10
15489886513,15489886515,2,2584,1301,-10
15498423393,15498423394,1,1848,1388,-10
15500548839,15500548839,0,1411,1995,-10
15503239012,15503239013,1,1644,1768,-10
15505087239,15505087242,3,1537,1093,-10
15505701610,15505701606,-4,916,2984,-10
15509493239,15509493242,3,1557,1338,-10
15509527654,15509527655,1,2029,1921,-10
15510777354,15510777356,2,1452,1515,-10
15511777211,15511777219,8,1785,1426,-10
15513787534,15513787537,3,1942,1815,-10
15516331435,15516331430,-5,24741,8029,-10
15525245351,15525245351,0,1000,2319,-10
15525973281,15525973285,4,1495,773,-10
15529039762,15529039763,1,1443,1308,-10
15529854105,15529854106,1,1295,2126,-10
15531373141,15531373144,3,2634,1784,-10
15531867431,15531867432,1,1667,2161,-10
15542176957,15542176954,-3,967,2358,-10
15542938860,15542938862,2,1367,1397,-10
15549295641,15549295640,-1,2057,1846,-10
15549689641,15549689641,0,1608,2073,-10
15551223613,15551223616,3,1717,1983,-10
15551312438,15551312444,6,2245,1179,-10
15552499612,15552499605,-7,826,3698,-10
15554086246,15554086246,0,1399,1968,-10
15555203145,15555203143,-2,1401,1893,-10
15557637179,15557637183,4,917,1074,-10
15561200517,15561200518,1,1484,1387,-10
15563049964,15563049964,0,1838,1988,-10
15563375878,15563375877,-1,1220,940,-10
15569047565,15569047586,21,999,809,-10
15570179687,15570179691,4,2110,1585,-10
15570627302,15570627314,12,1243,1545,-10
15574952026,15574952029,3,1494,1626,-10
15577603566,15577603566,0,1002,1221,-10
15578506362,15578506364,2,2313,1844,-10
15581133813,15581133816,3,1440,1410,-10
15582260405,15582260402,-3,48419,16237,-10
15583932668,15583932672,4,1387,1568,-10
15584537754,15584537755,1,1330,1748,-10
15586536496,15586536499,3,1913,1371,-10
15589718102,15589718103,1,2313,3064,-10
15593649510,15593649514,4,1527,1463,-10
15594978320,15594978323,3,1583,1073,-10
15595826257,15595826259,2,1676,1807,-10
15596019790,15596019790,0,1365,1250,-10
15596229406,15596229406,0,1736,1705,-10
15597589424,15597589426,2,1618,1484,-10
15605281513,15605281514,1,1357,1510,-10
15606789649,15606789649,0,1403,1952,-10
15607241938,15607241939,1,1805,1572,-10
15613180697,15613180699,2,1137,837,-10
15613934985,15613934986,1,964,1508,-10
15614021225,15614021225,0,1104,1382,-10
15615293025,15615293026,1,1382,1384,-10
15616759807,15616759806,-1,1476,1241,-10
15617335249,15617335248,-1,1146,1609,-10
15619590285,15619590289,4,3751,3042,-10
15620115993,15620115995,2,1890,1999,-10
15620226017,15620226019,2,1602,2017,-10
15625827338,15625827343,5,1872,1270,-10
15626460198,15626460199,1,1868,2103,-10
15628364448,15628364450,2,1451,1376,-10
15631652438,15631652440,2,1578,1472,-10
15641405825,15641405827,2,929,1237,-10
15641527008,15641527011,3,1609,1364,-10
15644278799,15644278801,2,1636,1410,-10
15644726091,15644726093,2,1994,1325,-10
15649636622,15649636629,7,4285,1559,-10
15651746845,15651746848,3,1572,1833,-10
15657969998,15657969976,-22,1357,1433,-10
15660035262,15660035265,3,1679,1893,-10
15663242558,15663242555,-3,2284,5940,-10
15663343914,15663343915,1,1820,1513,-10
15674045573,15674045583,10,6281,831,-10
15674592434,15674592436,2,1241,1777,-10
15676372718,15676372720,2,1666,1778,-10
15680696375,15680696379,4,1947,1777,-10
15682024805,15682024809,4,1225,1165,-10
15682490597,15682490598,1,1201,1853,-10
15683424216,15683424218,2,1980,1905,-10
15687138470,15687138472,2,1639,1518,-10
15689503237,15689503238,1,1018,1405,-10
15690767054,15690767054,0,45657,18916,-10
15693303892,15693303895,3,2617,940,-10
15694273972,15694273974,2,1985,1681,-10
15694491167,15694491168,1,1765,1534,-10
15695401859,15695401858,-1,1252,1566,-10
15695881859,15695881861,2,1255,1667,-10
15702599436,15702599437,1,1630,1185,-10
15702959825,15702959827,2,1214,1153,-10
15707339396,15707339398,2,1340,1272,-10
15712149562,15712149563,1,1351,1771,-10
15719455722,15719455726,4,2155,1653,-10
15719969668,15719969670,2,1610,1424,-10
15721214156,15721214159,3,1081,1004,-10
15724266984,15724266986,2,1223,1373,-10
15724875627,15724875609,-18,893,1099,-10
15728480254,15728480256,2,1452,1481,-10
15728540530,15728540530,0,1590,1276,-10
15729344349,15729344354,5,1466,1320,-10
15729722374,15729722375,1,1912,1544,-10
15731684846,15731684844,-2,1608,2242,-10
15740605690,15740605688,-2,6760,10063,-10
15743967275,15743967277,2,1891,1436,-10
15745511358,15745511359,1,1708,2398,-10
15745600226,15745600247,21,815,1136,-10
15748429354,15748429354,0,1012,1572,-10
15753250569,15753250572,3,1472,1704,-10
15755010310,15755010313,3,2143,1662,-10
15755889758,15755889760,2,2160,2289,-10
15757466164,15757466157,-7,2921,12921,-10
15757720411,15757720409,-2,1537,1726,-10
15760031234,15760031235,1,1891,1703,-10
15764873254,15764873254,0,1521,1495,-10
15767365435,15767365439,4,1756,1780,-10
15769177458,15769177462,4,1410,1312,-10
15771982248,15771982249,1,2277,1604,-10
15773751513,15773751514,1,1742,1069,-10
15775175055,15775175058,3,2074,1775,-10
15777287110,15777287115,5,1818,1263,-10
15777658015,15777658018,3,1788,1707,-10
15777972843,15777972840,-3,1056,2118,-10
15778229159,15778229160,1,1446,1676,-10
15778369710,15778369710,0,1335,902,-10
15779492157,15779492154,-3,1124,1549,-10
15781574733,15781574738,5,1516,1338,-10
15783591903,15783591906,3,2072,1634,-10
15784658002,15784658006,4,1693,1130,-10
15787832970,15787832974,4,1591,1748,-10
15790178809,15790178807,-2,784,982,-10
15794395470,15794395474,4,2607,1551,-10
15798238444,15798238447,3,1669,2127,-10
15800083306,15800083309,3,2491,1760,-10
15800510119,15800510118,-1,1050,2824,-10
15802914730,15802914731,1,1196,981,-10
15803935556,15803935558,2,1603,1731,-10
15807037830,15807037830,0,1130,935,-10
15808775471,15808775474,3,1422,1404,-10
15810988926,15810988927,1,1079,1077,-10
15813284951,15813284953,2,1227,1684,-10
15818599918,15818599920,2,1470,1864,-10
15818644694,15818644696,2,1894,1299,-10
15818803999,15818804003,4,1609,1038,-10
15823349151,15823349153,2,1106,1448,-10
15824290845,15824290849,4,1764,1391,-10
15825223635,15825223637,2,1992,1794,-10
15826646973,15826646976,3,1617,1736,-10
15827365899,15827365902,3,2199,2132,-10
15832258969,15832258970,1,1526,1125,-10
15832508027,15832508029,2,4424,3443,-10
15836352271,15836352273,2,1722,1492,-10
15836726483,15836726485,2,1669,1278,-10
15838084032,15838084034,2,1253,1724,-10
15838180007,15838180006,-1,1036,1288,-10
15838869667,15838869670,3,1485,2298,-10
15841550179,15841550181,2,1329,894,-10
15841844190,15841844194,4,1831,1514,-10
15843577438,15843577437,-1,1747,1559,-10
15847253676,15847253678,2,1924,1970,-10
15849046276,15849046277,1,1485,1531,-10
15849104805,15849104808,3,1963,1880,-10
15849957288,15849957289,1,1268,1942,-10
15851341657,15851341658,1,1554,1725,-10
15852118002,15852118003,1,857,934,-10
15852743927,15852743947,20,2083,1281,-10
15854493414,15854493415,1,1835,1657,-10
15854931395,15854931398,3,2243,1396,-10
15856463042,15856463043,1,1527,1613,-10
15859703866,15859703874,8,16132,10446,-10
15862589437,15862589434,-3,1437,1752,-10
15864316408,15864316409,1,1444,1181,-10
15864824013,15864824014,1,1648,1460,-10
15867645307,15867645309,2,1626,1907,-10
15869062928,15869062931,3,1667,1925,-10
15871477489,15871477490,1,1147,1027,-10
15874033174,15874033177,3,1659,1390,-10
15875278107,15875278108,1,1884,2259,-10
15881465050,15881465046,-4,1280,2702,-10
15883109671,15883109673,2,1467,1510,-10
15883161308,15883161310,2,1366,985,-10
15884039969,15884039972,3,1430,1911,-10
15884746691,15884746694,3,1613,1296,-10
15885657602,15885657606,4,1344,1342,-10
15893721511,15893721514,3,1782,1443,-10
15894058657,15894058654,-3,1636,3338,-10
15894405722,15894405724,2,1311,1520,-10
15894913409,15894913410,1,1734,1038,-10
15895532410,15895532413,3,1685,1830,-10
15896786635,15896786637,2,1320,1703,-10
15897483561,15897483563,2,1818,1808,-10
15900320541,15900320542,1,1772,1537,-10
15901069183,15901069183,0,1878,1725,-10
15901251473,15901251466,-7,1117,3717,-10
15911078374,15911078373,-1,1186,1986,-10
15911562646,15911562646,0,1206,1324,-10
15912934523,15912934529,6,8548,4157,-10
15916029850,15916029851,1,1645,1537,-10
15916698814,15916698813,-1,1534,1209,-10
15918520165,15918520166,1,1309,1565,-10
15926905083,15926905082,-1,768,1861,-10
15933100849,15933100851,2,2139,1278,-10
15934507398,15934507394,-4,1533,4828,-10
15936656376,15936656378,2,1479,1233,-10
15937087467,15937087468,1,831,1102,-10
15937906523,15937906524,1,1273,1159,-10
15938733395,15938733403,8,1440,779,-10
15945375586,15945375589,3,1833,1277,-10
15946945074,15946945076,2,1414,1687,-10
15947719418,15947719422,4,1424,2041,-10
15948500316,15948500318,2,44306,34596,-10
15951278291,15951278293,2,2054,1496,-10
15953579899,15953579915,16,1557,1404,-10
15954770646,15954770628,-18,1763,1472,-10
15957934002,15957934006,4,4284,3670,-10
15966234583,15966234602,19,648,1342,-10
15967808578,15967808581,3,1350,1239,-10
15970869885,15970869887,2,1494,1560,-10
15974557024,15974557029,5,3462,1486,-10
15974715921,15974715923,2,1094,1104,-10
15977455507,15977455508,1,1760,1619,-10
15979301702,15979301705,3,1963,1875,-10
15980706960,15980706963,3,1663,1674,-10
15980909394,15980909395,1,1591,1533,-10
15986441375,15986441377,2,1782,1432,-10
15987567513,15987567514,1,1862,1805,-10
15988028530,15988028533,3,1266,1432,-10
15988197058,15988197058,0,2920,4973,-10
15994909341,15994909344,3,1730,1989,-10
15997268965,15997268966,1,1538,1412,-10
16000590686,16000590689,3,1149,1177,-10
16003114598,16003114598,0,977,2037,-10
16006423303,16006423306,3,1745,1091,-10
16008201438,16008201442,4,1390,1209,-10
16012636937,16012636937,0,1607,1792,-10
16017757383,16017757383,0,1731,1857,-10
16022988736,16022988739,3,1597,1794,-10
16023770442,16023770437,-5,1483,1423,-10
16023831215,16023831215,0,2948,2266,-10
16023921634,16023921636,2,2103,2005,-10
16024345210,16024345212,2,2095,1573,-10
16026345375,16026345375,0,1158,1010,-10
16026482392,16026482389,-3,23587,15478,-10
16029007931,16029007930,-1,1318,2012,-10
16029282130,16029282122,-8,1425,1492,-10
16030929939,16030929938,-1,1447,1501,-10
16033123206,16033123206,0,1895,1326,-10
16034644781,16034644783,2,1079,1018,-10
16035761019,16035761019,0,1488,1393,-10
16037224142,16037224142,0,1900,2144,-10
16041216076,16041216078,2,1572,1793,-10
16044737638,16044737645,7,4095,1947,-10
16047823549,16047823550,1,1618,1546,-10
16049219239,16049219242,3,1593,1644,-10
16050115193,16050115193,0,1409,1963,-10
16050670407,16050670410,3,2330,1908,-10
16052336517,16052336518,1,1399,1530,-10
16052766462,16052766466,4,1313,1318,-10
16053461385,16053461366,-19,1478,1094,-10
16054371507,16054371502,-5,1110,3585,-10
16055741730,16055741735,5,1958,1210,-10
16056146015,16056146015,0,1848,1830,-10
16056816335,16056816333,-2,1152,1317,-10
16057292179,16057292180,1,2404,2155,-10
16058597898,16058597902,4,2293,1879,-10
16063240546,16063240548,2,1379,1008,-10
16065853407,16065853409,2,1867,1391,-10
16066915141,16066915141,0,986,1471,-10
16067896157,16067896161,4,2090,1882,-10
16068226452,16068226453,1,1907,1971,-10
16072142272,16072142273,1,1699,961,-10
16072228289,16072228291,2,1771,1378,-10
16073234240,16073234240,0,1772,2022,-10
16074514866,16074514866,0,1270,1767,-10
16076881451,16076881446,-5,3271,47316,-10
16077435734,16077435737,3,1174,1694,-10
16078193186,16078193190,4,1490,1308,-10
16082246250,16082246251,1,1409,1404,-10
16082729052,16082729051,-1,1447,1454,-10
16084917330,16084917331,1,1440,1888,-10
16085547581,16085547578,-3,1476,1430,-10
16086312607,16086312610,3,1346,1536,-10
16087862182,16087862183,1,1671,1548,-10
16088723918,16088723920,2,1582,1410,-10
16092820476,16092820483,7,3237,1084,-10
16095456838,16095456839,1,1247,1688,-10
16101666625,16101666624,-1,2365,3217,-10
16102285964,16102285966,2,1460,1647,-10
16104146360,16104146362,2,1622,1647,-10
16107002441,16107002443,2,1727,2262,-10
16107370708,16107370710,2,1145,1680,-10
16107736905,16107736906,1,1171,1728,-10
16108884578,16108884578,0,1889,1620,-10
16109202115,16109202118,3,1286,1444,-10
16110383025,16110383030,5,1973,1826,-10
16114215466,16114215469,3,1262,1886,-10
16115844109,16115844109,0,1779,2248,-10
16116595286,16116595287,1,1961,1668,-10
16117620858,16117620861,3,1395,1295,-10
16119375130,16119375131,1,2194,1636,-10
16119757094,16119757093,-1,1163,1539,-10
16122742989,16122742991,2,2132,1423,-10
16129006833,16129006835,2,1670,1270,-10
16131231883,16131231882,-1,1539,1887,-10
16133958158,16133958158,0,1491,2130,-10
16134040964,16134040965,1,1842,1912,-10
16136281014,16136281016,2,1220,1221,-10
16137094475,16137094476,1,996,1253,-10
16138439426,16138439423,-3,2556,2272,-10
16138559654,16138559654,0,1456,1409,-10
16138878741,16138878742,1,2162,1872,-10
16140142807,16140142810,3,1231,992,-10
16142777061,16142777060,-1,1003,1662,-10
16143948773,16143948775,2,1104,1258,-10
16146643595,16146643597,2,1025,1188,-10
16147386244,16147386249,5,4084,1861,-10
16148283571,16148283574,3,2062,1737,-10
16154541093,16154541094,1,1691,1373,-10
16158498757,16158498757,0,1430,2316,-10
16166457679,16166457680,1,1709,1985,-10
16166806188,16166806189,1,1357,1523,-10
16169393182,16169393186,4,3031,2515,-10
16171435974,16171435974,0,1808,1252,-10
16172342420,16172342422,2,1892,1312,-10
16172774179,16172774182,3,1655,883,-10
16174020307,16174020308,1,2265,1567,-10
16174527307,16174527309,2,1441,1674,-10
16176173419,16176173423,4,2296,1344,-10
16177386951,16177386954,3,1764,1792,-10
16181148003,16181148004,1,957,2259,-10
16186276116,16186276119,3,2029,1085,-10
16186310038,16186310037,-1,1677,1470,-10
16188922372,16188922367,-5,632,2470,-10
16189989873,16189989877,4,2153,1285,-10
16193326877,16193326879,2,1574,1341,-10
16193819948,16193819951,3,1428,1377,-10
16196237810,16196237809,-1,1358,3009,-10
16198826809,16198826811,2,1590,1508,-10
16199168846,16199168847,1,1629,1169,-10
16201854125,16201854130,5,1460,1317,-10
16202919438,16202919417,-21,749,851,-10
16206188842,16206188842,0,1472,1247,-10
16207418205,16207418206,1,1217,1617,-10
16208001509,16208001512,3,2050,1780,-10
16208652890,16208652890,0,1342,1380,-10
16209905438,16209905441,3,1052,611,-10
16210617687,16210617682,-5,1030,1377,-10
16211405085,16211405087,2,1949,1301,-10
16211547793,16211547796,3,1672,1319,-10
16213944941,16213944943,2,1031,1427,-10
16214317730,16214317734,4,1687,1285,-10
16215296777,16215296780,3,1251,1149,-10
16217506486,16217506487,1,1425,1201,-10
16219546125,16219546125,0,1614,1607,-10
16220077483,16220077485,2,1210,1510,-10
16222057170,16222057172,2,1846,1886,-10
16223838843,16223838845,2,2066,1694,-10
16227975598,16227975602,4,1756,1464,-10
16229025652,16229025654,2,1509,1325,-10
16229377046,16229377049,3,2279,2109,-10
16229581530,16229581531,1,2383,2430,-10
16229989073,16229989074,1,1374,1155,-10
16230189325,16230189326,1,2188,1738,-10
16233275680,16233275683,3,2120,1450,-10
16236963306,16236963311,5,1885,1345,-10
16241715942,16241715946,4,1039,842,-10
16243353626,16243353626,0,858,976,-10
16244062085,16244062093,8,3498,1293,-10
16244193732,16244193736,4,1608,1045,-10
16245516196,16245516199,3,1087,1200,-10
16247643868,16247643870,2,1138,1220,-10
16248334648,16248334651,3,1930,1501,-10
16251102510,16251102513,3,1627,1446,-10
16251337371,16251337353,-18,1403,1285,-10
16254022529,16254022531,2,1303,1467,-10
16255791001,16255791006,5,1709,1538,-10
16258709207,16258709214,7,1808,1256,-10
16258866943,16258866942,-1,924,613,-10
16266226118,16266226119,1,1642,1425,-10
16269039710,16269039710,0,1612,1490,-10
16269919208,16269919210,2,1438,1812,-10
16271114254,16271114254,0,1434,1592,-10
16272831579,16272831581,2,1066,1141,-10
16277747958,16277747958,0,1824,1295,-10
16279906037,16279906038,1,1594,1816,-10
16281010061,16281010062,1,1556,1145,-10
16283356191,16283356192,1,1380,1519,-10
16286275770,16286275770,0,1504,1568,-10
16286500005,16286500006,1,1564,1586,-10
16287051007,16287051010,3,1577,1418,-10
16288590022,16288590022,0,1832,1827,-10
16289682724,16289682723,-1,1944,1861,-10
16290048927,16290048928,1,1984,2163,-10
16290819166,16290819167,1,882,764,-10
16294069838,16294069839,1,2076,1442,-10
16294938486,16294938486,0,1561,1411,-10
16296227017,16296227018,1,1782,1434,-10
16300040751,16300040753,2,1336,1383,-10
16301690423,16301690425,2,1692,1740,-10
16303337138,16303337138,0,1942,2146,-10
16309090323,16309090323,0,1431,1229,-10
16310378358,16310378360,2,1031,1392,-10
16312485498,16312485496,-2,824,1616,-10
16315694430,16315694433,3,2455,1363,-10
16317492258,16317492260,2,1206,1724,-10
16318149770,16318149771,1,1960,2222,-10
16321546482,16321546481,-1,782,1114,-10
16333551711,16333551709,-2,1122,1081,-10
16334555117,16334555118,1,1994,2070,-10
16336485790,16336485793,3,1238,1317,-10
16338822007,16338822009,2,1140,1052,-10
16342276712,16342276714,2,1595,1545,-10
16343247073,16343247075,2,983,1208,-10
16344103586,16344103589,3,1767,1413,-10
16349672247,16349672252,5,2090,1620,-10
16357913553,16357913554,1,1666,1106,-10
16360600517,16360600517,0,1386,1630,-10
16365534166,16365534167,1,1149,1523,-10
16366479458,16366479460,2,1577,1358,-10
16371141513,16371141514,1,1141,1791,-10
16373505471,16373505471,0,898,1006,-10
16374840134,16374840135,1,1749,1310,-10
16379574427,16379574430,3,994,1214,-10
16387591182,16387591183,1,1324,1391,-10
16392595966,16392595969,3,1876,1953,-10
16395103319,16395103321,2,1833,2176,-10
16395384879,16395384880,1,1476,1548,-10
16395448679,16395448682,3,1121,1418,-10
16396202125,16396202126,1,1439,1145,-10
16398644578,16398644578,0,1063,1047,-10
16398951478,16398951479,1,1866,1934,-10
16399042142,16399042143,1,1127,1881,-10
16401244081,16401244088,7,2865,1506,-10
16401315991,16401315988,-3,978,2840,-10
16401626010,16401626013,3,1257,1279,-10
16402928942,16402928935,-7,1036,4133,-10
16404172061,16404172064,3,1413,1163,-10
16404366997,16404367000,3,1391,1985,-10
16405164496,16405164498,2,1942,1252,-10
16405722110,16405722112,2,1058,1335,-10
16405976648,16405976649,1,1996,1683,-10
16407415090,16407415092,2,1347,1813,-10
16408040846,16408040847,1,1645,1436,-10
16410832766,16410832767,1,1147,1942,-10
16415255745,16415255747,2,948,1253,-10
16416499913,16416499913,0,1144,1090,-10
16418823891,16418823893,2,2123,1386,-10
16419616879,16419616882,3,1631,2053,-10
16421700074,16421700069,-5,1005,3304,-10
16422905150,16422905151,1,1317,1288,-10
16423284087,16423284089,2,1299,1664,-10
16425121211,16425121214,3,1993,1651,-10
16431909080,16431909081,1,1575,1497,-10
16434228865,16434228866,1,1662,1488,-10
16434415763,16434415763,0,1916,1775,-10
16434510324,16434510334,10,13279,36046,-10
16435707223,16435707228,5,843,1056,-10
16436705615,16436705615,0,779,1084,-10
16438898541,16438898542,1,1460,1021,-10
16442115017,16442115016,-1,1161,1305,-10
16444027192,16444027195,3,1562,1228,-10
16445013494,16445013494,0,1435,1950,-10
16445370405,16445370410,5,2373,966,-10
16446551302,16446551303,1,1535,1436,-10
16447393529,16447393530,1,1321,1557,-10
16449706582,16449706586,4,1821,1844,-10
16450366373,16450366377,4,2249,1483,-10
16451385654,16451385655,1,1603,1343,-10
16451675561,16451675562,1,1314,1438,-10
16454165321,16454165324,3,1488,1619,-10
16459962746,16459962741,-5,2288,7711,-10
16460267442,16460267448,6,1500,1703,-10
16460460577,16460460579,2,831,783,-10
16462747968,16462747969,1,1382,1392,-10
16463325855,16463325858,3,1550,1711,-10
16465858358,16465858358,0,1258,1411,-10
16478865948,16478865943,-5,2810,9088,-10
16479253956,16479253957,1,1561,1571,-10
16480785038,16480785040,2,1922,1496,-10
16483252754,16483252757,3,1672,1396,-10
16487093969,16487093972,3,1785,1795,-10
16488346621,16488346625,4,1447,1002,-10
16488402275,16488402282,7,772,1022,-10
16491274050,16491274050,0,1203,1134,-10
16492061932,16492061934,2,1380,1236,-10
16492645994,16492645995,1,2089,1610,-10
16494098399,16494098401,2,2326,2236,-10
16494973209,16494973210,1,2455,2185,-10
16497800767,16497800769,2,1197,1587,-10
16498078558,16498078570,12,1698,1590,-10
16499886820,16499886823,3,1779,1482,-10
16501719490,16501719490,0,1464,1245,-10
16501793110,16501793111,1,1285,1662,-10
16501984323,16501984327,4,2406,1809,-10
16502933983,16502933980,-3,1731,2514,-10
16504319022,16504319022,0,1287,1498,-10
16506223626,16506223629,3,1549,1141,-10
16507058850,16507058854,4,2041,1714,-10
16508042890,16508042890,0,1523,1947,-10
16510845479,16510845480,1,912,1633,-10
16514853591,16514853597,6,2298,1259,-10
16520605777,16520605778,1,1425,1594,-10
16521199406,16521199409,3,1554,1704,-10
16521516420,16521516422,2,1584,1451,-10
16522176793,16522176792,-1,1152,2040,-10
16523065865,16523065862,-3,1402,2508,-10
16524229836,16524229836,0,1491,889,-10
16525843420,16525843422,2,1718,2112,-10
16529809087,16529809088,1,1192,1238,-10
16531493527,16531493530,3,1879,1456,-10
16531957770,16531957774,4,2870,1308,-10
16541665210,16541665214,4,1911,1275,-10
16544963366,16544963368,2,1624,1654,-10
16545931985,16545931987,2,1547,1532,-10
16547178658,16547178661,3,1928,1260,-10
16548657043,16548657046,3,1744,1584,-10
16548971892,16548971894,2,1592,1252,-10
16550981673,16550981678,5,1982,1391,-10
16552703677,16552703678,1,1420,1735,-10
16557141509,16557141510,1,1070,1173,-10
16558652903,16558652903,0,1070,1537,-10
16561104038,16561104039,1,1474,1640,-10
16561213090,16561213091,1,2120,2062,-10
16561483246,16561483248,2,1908,1640,-10
16562981734,16562981735,1,2089,2305,-10
16563346993,16563346990,-3,1115,1852,-10
16563678084,16563678087,3,1195,1355,-10
16564302936,16564302935,-1,1629,1554,-10
16564989279,16564989280,1,1335,1751,-10
16567112159,16567112162,3,1418,1473,-10
16569031401,16569031403,2,1613,1242,-10
16573806207,16573806210,3,1174,1221,-10
16573981693,16573981676,-17,1717,968,-10
16574034634,16574034635,1,1560,1394,-10
16576061638,16576061642,4,2080,2142,-10
16579315593,16579315594,1,2107,1711,-10
16580333218,16580333219,1,1768,2307,-10
16581833359,16581833362,3,1099,1473,-10
16585654618,16585654622,4,1188,1775,-10
16585774309,16585774310,1,2353,2247,-10
16586516970,16586516974,4,1818,1741,-10
16587696649,16587696652,3,1465,1820,-10
16589603794,16589603798,4,1497,1737,-10
16592240874,16592240878,4,2184,949,-10
16593180178,16593180179,1,2348,1939,-10
16594767258,16594767258,0,1844,1689,-10
16594800486,16594800490,4,1962,1772,-10
16594895965,16594895967,2,1786,1387,-10
16598131967,16598131963,-4,1349,2774,-10
16598751698,16598751699,1,1165,1085,-10
16599098815,16599098834,19,1676,1559,-10
16601196014,16601196015,1,1199,1099,-10
16602552255,16602552255,0,1811,1271,-10
16605040039,16605040039,0,1426,1556,-10
16606674125,16606674125,0,1348,1537,-10
16607959530,16607959533,3,1477,1384,-10
16608110355,16608110370,15,1657,1303,-10
16608716670,16608716673,3,1984,1587,-10
16610925940,16610925942,2,16018,15965,-10
16611195271,16611195273,2,1785,1293,-10
16612355449,16612355450,1,1158,1048,-10
16614758694,16614758698,4,1111,1554,-10
16617674686,16617674686,0,1964,2063,-10
16618942006,16618942006,0,1035,2506,-10
16623393558,16623393562,4,2058,1665,-10
16626579058,16626579061,3,1379,1110,-10
16628366622,16628366626,4,1645,1224,-10
16632864816,16632864812,-4,1684,4692,-10
16636708867,16636708863,-4,1330,1382,-10
16638930281,16638930282,1,1283,1757,-10
16645662028,16645662021,-7,1242,7446,-10
16647550229,16647550229,0,25079,35108,-10
16647777725,16647777725,0,1787,1585,-10
16649634513,16649634514,1,1373,1900,-10
16650438925,16650438929,4,1659,1556,-10
16653342454,16653342455,1,1253,1422,-10
16655049218,16655049222,4,1864,1855,-10
16655142594,16655142597,3,1279,1494,-10
16656617889,16656617890,1,1431,1800,-10
16657277298,16657277302,4,1041,1144,-10
16657406314,16657406313,-1,1381,1670,-10
16658746462,16658746465,3,1814,1155,-10
16660142115,16660142115,0,1429,1426,-10
16665025635,16665025634,-1,847,1308,-10
16668358024,16668358026,2,1310,1320,-10
16668990359,16668990363,4,2066,1817,-10
16671218521,16671218519,-2,1332,1933,-10
16674722332,16674722333,1,1603,1265,-10
16676612503,16676612507,4,2016,1584,-10
16686102414,16686102415,1,1702,1309,-10
16687086450,16687086452,2,1518,1226,-10
16689639978,16689639978,0,921,925,-10
16690097843,16690097844,1,1237,1987,-10
16690189551,16690189547,-4,1838,4030,-10
16691463650,16691463651,1,1157,1203,-10
16692328765,16692328767,2,1228,1089,-10
16694724937,16694724938,1,1705,1639,-10
16694796929,16694796927,-2,910,1993,-10
16696807190,16696807194,4,2060,1284,-10
16700380841,16700380842,1,1282,1801,-10
16708880258,16708880259,1,927,830,-10
16710478769,16710478770,1,1249,1647,-10
16710971354,16710971358,4,2596,1199,-10
16714352842,16714352836,-6,1374,5916,-10
16715706035,16715706035,0,928,994,-10
16716091889,16716091891,2,2697,1964,-10
16716628018,16716628020,2,1862,1817,-10
16717761939,16717761942,3,1125,1380,-10
16726147127,16726147129,2,1327,1400,-10
16728515006,16728515006,0,2225,2027,-10
16735134896,16735134891,-5,1393,1601,-10
16745131702,16745131705,3,1294,1303,-10
16747789057,16747789059,2,1901,2085,-10
16748039705,16748039706,1,1516,1403,-10
16749666669,16749666670,1,1568,1472,-10
16756003790,16756003792,2,1747,1300,-10
16756615489,16756615491,2,1478,1087,-10
16759330939,16759330940,1,880,1050,-10
16766479080,16766479082,2,1126,1139,-10
16768433331,16768433334,3,1424,1169,-10
16769136567,16769136567,0,1183,1464,-10
16772788386,16772788367,-19,2485,2367,-10
16773701207,16773701206,-1,921,1329,-10
16778651773,16778651768,-5,930,1286,-10
16779376739,16779376742,3,1886,1278,-10
16783506341,16783506342,1,1399,1301,-10
16784172919,16784172920,1,1288,1445,-10
16785501138,16785501138,0,1493,1689,-10
16789008449,16789008451,2,1891,1682,-10
16789343445,16789343446,1,1489,1639,-10
16791654861,16791654863,2,1453,1270,-10
16793051678,16793051683,5,3591,1510,-10
16795751859,16795751861,2,2387,2648,-10
16797319333,16797319336,3,2184,1705,-10
16797472598,16797472602,4,1691,1426,-10
16800704501,16800704503,2,1754,1518,-10
16808424857,16808424855,-2,1213,1502,-10
16808645105,16808645105,0,1369,1350,-10
16817381110,16817381115,5,1611,1210,-10
16820072397,16820072398,1,1803,1795,-10
16822052143,16822052142,-1,1370,1474,-10
16822135706,16822135706,0,1182,1402,-10
16825964684,16825964683,-1,1826,2093,-10
16826708568,16826708570,2,1214,1303,-10
16828231553,16828231558,5,2875,1749,-10
16831445565,16831445567,2,1169,1013,-10
16834496846,16834496839,-7,1244,4962,-10
16836142077,16836142077,0,1482,1518,-10
16839756843,16839756843,0,1021,1142,-10
16844968163,16844968158,-5,932,5589,-10
16845387285,16845387288,3,1906,1168,-10
16846269403,16846269406,3,1054,1312,-10
16847195174,16847195177,3,1700,1853,-10
16847769805,16847769806,1,1455,1753,-10
16849438457,16849438459,2,1477,1699,-10
16851520201,16851520202,1,1887,1606,-10
16851644996,16851644998,2,1277,1592,-10
16851917507,16851917508,1,1396,1578,-10
16853046371,16853046374,3,1637,1293,-10
16854754004,16854754006,2,1948,1542,-10
16856245290,16856245275,-15,1598,1376,-10
16856516658,16856516661,3,1833,1279,-10
16857660633,16857660635,2,1411,1337,-10
16859175875,16859175870,-5,1113,3310,-10
16867413238,16867413237,-1,1282,1576,-10
16867575611,16867575613,2,2000,1902,-10
16868600709,16868600710,1,1706,1424,-10
16872548903,16872548902,-1,1960,1648,-10
16872867526,16872867530,4,2093,1298,-10
16873682822,16873682825,3,1506,1565,-10
16875815078,16875815058,-20,957,725,-10
16876315006,16876315007,1,1329,911,-10
16878066445,16878066447,2,1394,1265,-10
16885805957,16885805958,1,1314,1309,-10
16886600179,16886600180,1,1388,1323,-10
16891418993,16891418994,1,1259,1735,-10
16894082256,16894082258,2,1067,1459,-10
16895216345,16895216346,1,1112,1544,-10
16897157507,16897157510,3,1771,1950,-10
16897913037,16897913037,0,1370,1692,-10
16899702209,16899702205,-4,26348,14163,-10
16901500830,16901500834,4,1114,1457,-10
16902542823,16902542822,-1,839,1374,-10
16904723477,16904723482,5,1769,1387,-10
16904854303,16904854304,1,2460,1835,-10
16905023920,16905023923,3,2545,1420,-10
16910791555,16910791555,0,1559,926,-10
16912073807,16912073810,3,1451,1720,-10
16913127909,16913127911,2,1589,1740,-10
16917892218,16917892218,0,1614,1203,-10
16919788117,16919788120,3,1544,1294,-10
16919937585,16919937569,-16,1121,287,-10
16922090957,16922090958,1,1138,2028,-10
16926161785,16926161787,2,1755,1786,-10
16927602751,16927602751,0,1266,1204,-10
16928945738,16928945741,3,1262,1809,-10
16929516999,16929517001,2,1712,1479,-10
16929908379,16929908382,3,1695,1599,-10
16931375114,16931375114,0,1398,1425,-10
16933112334,16933112337,3,1951,2302,-10
16933343828,16933343834,6,4395,1752,-10
16933966854,16933966853,-1,1391,1381,-10
16938363181,16938363183,2,1759,2044,-10
16943280639,16943280642,3,2171,1985,-10
16944780350,16944780353,3,969,1260,-10
16947365893,16947365894,1,1699,1740,-10
16948370023,16948370025,2,1745,1777,-10
16948723577,16948723581,4,1396,1128,-10
16948958830,16948958831,1,1326,1347,-10
16949600206,16949600206,0,2202,1882,-10
16951083132,16951083134,2,1142,1228,-10
16953733150,16953733150,0,1664,1478,-10
16953990017,16953990020,3,1555,1590,-10
16956801191,16956801194,3,1434,1578,-10
16959382517,16959382519,2,1699,1604,-10
16959558106,16959558107,1,1570,1851,-10
16960721890,16960721890,0,1916,1687,-10
16963519357,16963519361,4,1672,1596,-10
16967961753,16967961753,0,1815,1281,-10
16969617497,16969617501,4,2049,1372,-10
16972077061,16972077061,0,1408,1882,-10
16973571144,16973571146,2,1529,1391,-10
16974230075,16974230077,2,1257,1051,-10
16975174811,16975174812,1,1705,1993,-10
16976008281,16976008282,1,1069,1928,-10
16978968442,16978968454,12,103,1256,-10
16979676606,16979676606,0,1475,1578,-10
16980424967,16980424948,-19,9264,2837,-10
16980977108,16980977110,2,1677,2175,-10
16982213082,16982213086,4,1113,962,-10
16983206050,16983206064,14,1497,1210,-10
16985405166,16985405168,2,1518,1602,-10
16985819670,16985819673,3,19219,31095,-10
16987700989,16987700991,2,1642,1123,-10
16987870323,16987870327,4,1169,1749,-10
16990540420,16990540422,2,1477,1620,-10
16991027214,16991027214,0,995,866,-10
16991760042,16991760047,5,1759,1512,-10
16991866361,16991866366,5,1824,1607,-10
16994016727,16994016730,3,1984,2066,-10
16994071260,16994071261,1,2094,1565,-10
16994613912,16994613916,4,3079,2311,-10
16996897310,16996897315,5,3037,1582,-10
16997823650,16997823653,3,1561,1864,-10
16998792151,16998792152,1,1166,1773,-10
17000077381,17000077381,0,1902,2885,-10
17000483119,17000483120,1,1435,1466,-10
17002530326,17002530330,4,1903,1128,-10
17003724431,17003724448,17,1199,1740,-10
17006136018,17006136021,3,1963,1807,-10
17010240211,17010240213,2,1551,1734,-10
17011132370,17011132374,4,1683,1287,-10
17011297569,17011297571,2,1932,1693,-10
17011882872,17011882872,0,2085,2184,-10
17013369465,17013369467,2,1831,1738,-10
17014798066,17014798068,2,1877,1856,-10
17017620038,17017620038,0,1435,1143,-10
17018373902,17018373904,2,1534,2054,-10
17022706130,17022706130,0,1346,998,-10
17026249505,17026249507,2,1645,1254,-10
17026652411,17026652414,3,1523,2111,-10
17028175642,17028175642,0,1634,1432,-10
17028305926,17028305929,3,1445,1169,-10
17032139811,17032139814,3,1363,1704,-10
17034840001,17034839999,-2,1211,2006,-10
17035011288,17035011290,2,1739,1059,-10
17035824481,17035824479,-2,2554,3501,-10
17036476194,17036476195,1,2129,1536,-10
17038021360,17038021366,6,4301,1930,-10
17039308178,17039308176,-2,1095,1365,-10
17041284620,17041284622,2,1662,1345,-10
17041775663,17041775663,0,1496,1989,-10
17045687811,17045687814,3,2005,1805,-10
17046444485,17046444485,0,1869,2057,-10
17046630353,17046630357,4,2770,1640,-10
17047264444,17047264446,2,1635,1514,-10
17047944838,17047944843,5,18510,50765,-10
17051792417,17051792419,2,1743,1871,-10
17054002901,17054002904,3,1653,1493,-10
17054629987,17054629991,4,840,1246,-10
17059039334,17059039335,1,1811,1334,-10
17059507215,17059507211,-4,1014,2416,-10
17061011293,17061011293,0,1050,1078,-10
17061606067,17061606067,0,1050,1483,-10
17062452490,17062452493,3,1256,1117,-10
17063099580,17063099583,3,2363,2857,-10
17064897486,17064897487,1,1174,1350,-10
17066425766,17066425768,2,1256,1629,-10
17070507457,17070507459,2,1508,1647,-10
17071701737,17071701746,9,1786,1247,-10
17071829455,17071829454,-1,2948,4138,-10
17072629404,17072629403,-1,1112,2009,-10
17072673247,17072673249,2,1326,1620,-10
17074758095,17074758099,4,3354,2554,-10
17076331840,17076331842,2,875,841,-10
17079656319,17079656321,2,1332,1632,-10
17079774546,17079774544,-2,1106,2402,-10
17080754250,17080754251,1,2131,1796,-10
17081611778,17081611779,1,842,996,-10
17082462727,17082462726,-1,1319,1100,-10
17082870905,17082870904,-1,935,1593,-10
17084308638,17084308640,2,1614,1633,-10
17089001768,17089001771,3,1766,2061,-10
17089609438,17089609441,3,1902,1433,-10
17090778834,17090778834,0,1629,1579,-10
17091122754,17091122756,2,2507,1696,-10
17091484017,17091484019,2,1433,1345,-10
17093601309,17093601310,1,1497,1328,-10
17097122523,17097122526,3,1465,1160,-10
17098550905,17098550906,1,968,1578,-10
17102518728,17102518729,1,1623,1671,-10
17104545589,17104545591,2,2581,1938,-10
17107319236,17107319237,1,1568,1413,-10
17107384553,17107384555,2,2170,2518,-10
17107732539,17107732541,2,1429,1417,-10
17109246052,17109246054,2,1548,1753,-10
17109393533,17109393538,5,2305,1297,-10
17109541278,17109541278,0,2401,1603,-10
17115956915,17115956919,4,2518,1555,-10
17116600031,17116600033,2,1697,1480,-10
17117115626,17117115627,1,1538,1730,-10
17118876369,17118876371,2,1583,1622,-10
17119169821,17119169823,2,907,1136,-10
17119771889,17119771890,1,969,1476,-10
17120850490,17120850495,5,2068,1213,-10
17121908038,17121908040,2,1519,1772,-10
17123843191,17123843194,3,1911,2139,-10
17125037239,17125037242,3,967,1269,-10
17125279329,17125279323,-6,1099,1473,-10
17125736670,17125736673,3,1800,1274,-10
17125927972,17125927979,7,976,1350,-10
17127471859,17127471861,2,1477,2113,-10
17129418726,17129418731,5,5325,2556,-10
17129591593,17129591590,-3,4753,10435,-10
17130576665,17130576667,2,1743,1442,-10
17134536930,17134536933,3,1834,1550,-10
17137251203,17137251201,-2,1272,1965,-10
17140327305,17140327306,1,1323,1270,-10
17140999630,17140999643,13,1753,1372,-10
17143764368,17143764370,2,1549,1257,-10
17145817591,17145817589,-2,1074,1061,-10
17146464929,17146464930,1,1431,1026,-10
17149253725,17149253726,1,939,1421,-10
17153919635,17153919636,1,1528,1335,-10
17154568883,17154568886,3,1446,1800,-10
17156524838,17156524841,3,1194,1652,-10
17157741902,17157741905,3,2076,1481,-10
17161058917,17161058920,3,1545,1303,-10
17162192804,17162192785,-19,66,753,-10
17171822491,17171822493,2,1607,1719,-10
17172440203,17172440205,2,1413,1144,-10
17174576923,17174576926,3,691,650,-10
17176323915,17176323919,4,1513,979,-10
17176459459,17176459451,-8,1827,9011,-10
17176982078,17176982058,-20,2056,1656,-10
17179297047,17179297049,2,1235,1124,-10
17186159729,17186159731,2,1610,1782,-10
17187561177,17187561178,1,1059,1705,-10
17188723621,17188723614,-7,25375,14428,-10
17189827499,17189827502,3,1202,1776,-10
17191866126,17191866126,0,1436,1938,-10
17192308220,17192308219,-1,1359,2104,-10
17193098389,17193098391,2,1301,1366,-10
17194088635,17194088637,2,1452,1291,-10
17196447233,17196447234,1,1254,931,-10
17197402181,17197402182,1,1056,1095,-10
17201439421,17201439424,3,1709,1539,-10
17211012344,17211012347,3,1912,1669,-10
17212620305,17212620304,-1,1190,1724,-10
17214008698,17214008699,1,1738,1176,-10
17217226709,17217226729,20,1243,1463,-10
17223075069,17223075065,-4,1223,3025,-10
17225117352,17225117335,-17,917,1643,-10
17225219641,17225219642,1,1415,1259,-10
17226342192,17226342195,3,1019,1057,-10
17226797325,17226797327,2,1581,1712,-10
17227487410,17227487413,3,1458,1950,-10
17231457367,17231457371,4,1754,1359,-10
17233631242,17233631242,0,1308,1507,-10
17237483942,17237483943,1,1760,1011,-10
17244248057,17244248057,0,1504,1461,-10
17245942527,17245942530,3,1523,1558,-10
17246227111,17246227106,-5,743,2063,-10
17253811962,17253811966,4,840,843,-10
17254972267,17254972271,4,1638,1442,-10
17255254089,17255254090,1,1361,1527,-10
17259172410,17259172413,3,1765,1385,-10
17261237969,17261237951,-18,1853,1172,-10
17265495497,17265495499,2,1580,1580,-10
17266196474,17266196477,3,1512,1103,-10
17268031310,17268031313,3,13736,11880,-10
17269661147,17269661150,3,1615,1225,-10
17270002008,17270002019,11,2469,971,-10
17270427666,17270427647,-19,24454,26883,-10
17272633275,17272633278,3,989,1346,-10
17275482149,17275482150,1,1201,1090,-10
17276852315,17276852317,2,1684,1199,-10
17278876334,17278876339,5,1967,1841,-10
17279166641,17279166641,0,1874,1607,-10
17281136625,17281136626,1,1987,1732,-10
17281615966,17281615969,3,1784,1372,-10
17281840958,17281840962,4,2409,1034,-10
17289388839,17289388840,1,1611,1883,-10
17289968233,17289968235,2,1653,2043,-10
17293359119,17293359125,6,5156,2603,-10
17296112435,17296112435,0,967,1206,-10
17300500211,17300500215,4,1214,1124,-10
17300876326,17300876326,0,1182,1197,-10
17300904497,17300904492,-5,2070,8135,-10
17301484550,17301484554,4,1317,1345,-10
17303275742,17303275746,4,1685,1841,-10
17306608254,17306608258,4,1534,1157,-10
17307659274,17307659275,1,1654,1533,-10
17313520245,17313520247,2,2016,1271,-10
17314170450,17314170451,1,1956,1926,-10
17318640410,17318640413,3,1578,1579,-10
17320372526,17320372526,0,2084,2021,-10
17322919393,17322919397,4,1826,1310,-10
17323591537,17323591538,1,1859,1770,-10
17325371861,17325371863,2,1536,1420,-10
17325511661,17325511662,1,1189,1438,-10
17328878568,17328878571,3,1912,1332,-10
17329179058,17329179060,2,1682,1770,-10
17333714796,17333714798,2,1646,1292,-10
17335756881,17335756881,0,1458,1592,-10
17336490133,17336490134,1,1443,1372,-10
17344153198,17344153199,1,1091,1083,-10
17345725536,17345725537,1,1671,1814,-10
17353204894,17353204899,5,3009,1099,-10
17355155635,17355155635,0,982,1249,-10
17355300495,17355300496,1,824,859,-10
17358808754,17358808755,1,1338,1614,-10
17359597622,17359597623,1,1258,1899,-10
17362802655,17362802657,2,1304,1326,-10
17362838689,17362838689,0,1998,2124,-10
17363492117,17363492119,2,1916,1887,-10
17363878241,17363878242,1,1196,1909,-10
17365717877,17365717878,1,1906,2010,-10
17371544882,17371544884,2,7088,28257,-10
17373556758,17373556761,3,2188,1306,-10
17374434200,17374434203,3,2280,1861,-10
17378305742,17378305724,-18,607,390,-10
17381853869,17381853866,-3,1463,2171,-10
17382588129,17382588130,1,1520,2347,-10
17387709279,17387709282,3,1316,1567,-10
17388181394,17388181396,2,1341,1273,-10
17389583226,17389583227,1,1170,1210,-10
17393787759,17393787763,4,1474,1466,-10
17395165326,17395165327,1,1625,1518,-10
17396357796,17396357797,1,1095,1421,-10
17399096425,17399096426,1,1977,1239,-10
17401900225,17401900227,2,1131,1542,-10
17401997855,17401997859,4,1272,924,-10
17402874727,17402874728,1,1869,2280,-10
17405952902,17405952887,-15,192,537,-10
17410280285,17410280288,3,1013,1335,-10
17410507184,17410507186,2,1569,1039,-10
17410916666,17410916667,1,1121,1600,-10
17412657234,17412657235,1,1607,1314,-10
17413196013,17413196013,0,1536,1637,-10
17415535830,17415535835,5,1525,1331,-10
17416070490,17416070490,0,1185,1249,-10
17417599333,17417599334,1,1116,1243,-10
17418120476,17418120477,1,2113,1773,-10
17419689945,17419689948,3,1250,1103,-10
17421225531,17421225530,-1,1232,1582,-10
17421978356,17421978359,3,1053,1377,-10
17423767221,17423767222,1,1560,1721,-10
17426903916,17426903918,2,1920,1281,-10
17429911882,17429911878,-4,3408,9484,-10
17434113023,17434113026,3,1552,1366,-10
17434284429,17434284410,-19,1622,866,-10
17436656526,17436656527,1,2040,1288,-10
17441447242,17441447243,1,1562,1549,-10
17441610819,17441610814,-5,1973,6496,-10
17445094050,17445094050,0,1427,1490,-10
17449975778,17449975780,2,2186,1858,-10
17455615051,17455615054,3,1724,1568,-10
17456468872,17456468874,2,1488,1454,-10
17457803954,17457803954,0,1869,2168,-10
17458151658,17458151658,0,1166,1187,-10
17460858518,17460858521,3,1444,1064,-10
17464619641,17464619641,0,1376,1678,-10
17465893450,17465893446,-4,1376,2102,-10
17468584835,17468584835,0,1386,1262,-10
17468912629,17468912632,3,1528,1540,-10
17470079848,17470079849,1,1393,2305,-10
17471076448,17471076469,21,1271,2421,-10
17473788386,17473788385,-1,1005,1344,-10
17475779919,17475779922,3,1714,1889,-10
17477654078,17477654079,1,1670,1988,-10
17481167289,17481167291,2,1712,1866,-10
17481596497,17481596498,1,2020,1428,-10
17482492511,17482492512,1,1878,1783,-10
17482674654,17482674657,3,2198,1349,-10
17483550522,17483550524,2,1100,1959,-10
17483748852,17483748854,2,1666,1263,-10
17484050966,17484050985,19,1434,1491,-10
17485013754,17485013757,3,1914,1279,-10
17485370385,17485370386,1,1366,1615,-10
17486464981,17486464984,3,1612,2050,-10
17487248326,17487248312,-14,1367,1788,-10
17491721724,17491721723,-1,1571,1378,-10
17494709519,17494709522,3,1805,1551,-10
17497362951,17497362954,3,1639,934,-10
17497457374,17497457362,-12,3469,11797,-10
17497719949,17497719949,0,1172,1115,-10
17498071051,17498071058,7,28161,15545,-10
17500303829,17500303830,1,1946,1595,-10
17505120813,17505120815,2,1669,1400,-10
17506052516,17506052517,1,1512,1538,-10
17506220361,17506220363,2,2222,1914,-10
17508354682,17508354683,1,1446,2194,-10
17512607389,17512607390,1,1557,1620,-10
17514781184,17514781187,3,1262,1284,-10
17516214494,17516214497,3,1283,1405,-10
17517956560,17517956562,2,1660,1586,-10
17521283247,17521283246,-1,1467,1357,-10
17524068681,17524068682,1,1765,1594,-10
17524581542,17524581545,3,1653,1614,-10
17525008967,17525008971,4,1608,1329,-10
17525623706,17525623711,5,1748,1428,-10
17526692579,17526692578,-1,1615,1705,-10
17528621850,17528621852,2,1775,1712,-10
17533941828,17533941835,7,2659,1142,-10
17534622016,17534622017,1,1414,1184,-10
17535439564,17535439565,1,1675,2260,-10
17538660960,17538660961,1,1681,1541,-10
17542927062,17542927065,3,2173,1841,-10
17545010993,17545010994,1,1696,1890,-10
17545867333,17545867333,0,1453,1601,-10
17556965805,17556965805,0,983,1530,-10
17557279458,17557279459,1,1121,1125,-10
17558095777,17558095778,1,1461,1240,-10
17561755623,17561755626,3,868,1059,-10
17563754609,17563754610,1,1399,1028,-10
17564644163,17564644161,-2,1393,3652,-10
17564813038,17564813038,0,836,839,-10
17565214318,17565214320,2,1289,1169,-10
17566197122,17566197125,3,1717,1236,-10
17566858873,17566858874,1,1438,1552,-10
17568169989,17568169993,4,2040,1763,-10
17571808251,17571808254,3,720,786,-10
17573953603,17573953605,2,1696,1168,-10
17574815021,17574815025,4,1497,1124,-10
17575304981,17575304985,4,1382,1127,-10
17578385925,17578385929,4,2162,1525,-10
17578923043,17578923027,-16,3939,1713,-10
17580434086,17580434088,2,1685,1801,-10
17580773346,17580773345,-1,1368,1707,-10
17581356712,17581356697,-15,1651,2293,-10
17586208969,17586208971,2,1502,1702,-10
17587139303,17587139302,-1,1026,1236,-10
17588630846,17588630848,2,2199,1842,-10
17591322253,17591322255,2,1766,1467,-10
17594033512,17594033511,-1,1750,2925,-10
17595559290,17595559291,1,1780,1524,-10
17596444677,17596444679,2,1223,1493,-10
17599395838,17599395838,0,1424,1650,-10
17599573489,17599573491,2,1635,1813,-10
17601232638,17601232639,1,1430,1340,-10
17601508394,17601508397,3,20723,37200,-10
17608947525,17608947526,1,2085,1425,-10
17611499210,17611499211,1,1514,1209,-10
17615791207,17615791207,0,1073,982,-10
17616706784,17616706786,2,1844,2167,-10
17617686906,17617686907,1,1436,1714,-10
17619744010,17619744016,6,1364,1465,-10
17622102391,17622102395,4,997,1329,-10
17622753582,17622753583,1,2570,1481,-10
17628584426,17628584428,2,1235,1549,-10
17631979929,17631979935,6,2542,1325,-10
17634987782,17634987784,2,1685,1765,-10
17636395258,17636395259,1,1860,1272,-10
17636831007,17636831009,2,1730,1222,-10
17637752782,17637752783,1,993,836,-10
17638487234,17638487239,5,3320,1803,-10
17639264399,17639264401,2,1034,1381,-10
17640463548,17640463550,2,1517,1230,-10
17640836402,17640836384,-18,17076,29939,-10
17641553826,17641553830,4,1972,1520,-10
17646255358,17646255365,7,2671,886,-10
17650155730,17650155727,-3,1186,1409,-10
17651754116,17651754117,1,2546,1861,-10
17653704305,17653704307,2,1219,1021,-10
17656520194,17656520199,5,3057,1309,-10
17660352870,17660352873,3,1098,1022,-10
17660899688,17660899689,1,1060,910,-10
17661623578,17661623578,0,1968,1288,-10
17662066083,17662066067,-16,1598,1425,-10
17662197229,17662197226,-3,1328,2784,-10
17663630043,17663630046,3,1419,1420,-10
17664345490,17664345489,-1,1379,1092,-10
17664469170,17664469172,2,1963,1740,-10
17664851753,17664851753,0,1754,1677,-10
17667049196,17667049198,2,1876,1587,-10
17668250591,17668250600,9,2003,1124,-10
17670271710,17670271717,7,3565,1352,-10
17670426210,17670426213,3,1526,1659,-10
17673268138,17673268140,2,1628,1332,-10
17676822405,17676822408,3,1474,1483,-10
17676884698,17676884694,-4,1234,2821,-10
17677830627,17677830630,3,1471,1390,-10
17682205953,17682205955,2,1417,1150,-10
17683273547,17683273549,2,1457,1125,-10
17686782693,17686782694,1,1929,1666,-10
17692742634,17692742637,3,1933,1382,-10
17692925479,17692925484,5,2016,1373,-10
17693358010,17693358014,4,1449,1444,-10
17693431750,17693431763,13,1231,1352,-10
17694169562,17694169569,7,3107,1730,-10
17694778234,17694778234,0,1691,1527,-10
17695445038,17695445039,1,2927,2071,-10
17698997697,17698997699,2,1403,1205,-10
17703641461,17703641464,3,1294,1282,-10
17705763400,17705763402,2,1454,1571,-10
17706424397,17706424398,1,1396,1280,-10
17708957293,17708957294,1,1860,2159,-10
17710624100,17710624078,-22,1469,1300,-10
17710770415,17710770427,12,1043,1065,-10
17713300627,17713300631,4,1255,1683,-10
17713406219,17713406200,-19,1089,1412,-10
17715879899,17715879901,2,1066,1066,-10
17715956046,17715956050,4,1210,1333,-10
17719125570,17719125570,0,1411,1673,-10
17719338521,17719338521,0,11984,14326,-10
17720514826,17720514827,1,1588,1266,-10
17721280798,17721280797,-1,1377,1727,-10
17723929321,17723929321,0,1788,2370,-10
17725927175,17725927179,4,1756,1419,-10
17726205289,17726205295,6,27666,33810,-10
17726396559,17726396561,2,1566,1262,-10
17726508486,17726508489,3,1588,1217,-10
17728432766,17728432765,-1,1359,1018,-10
17731433110,17731433117,7,1854,1226,-10
17731809257,17731809250,-7,1783,10069,-10
17738371461,17738371461,0,1465,1410,-10
17745747042,17745747038,-4,1204,3180,-10
17749259108,17749259111,3,1236,1282,-10
17750186930,17750186932,2,2946,2409,-10
17752168197,17752168198,1,1396,1303,-10
17753826902,17753826905,3,1810,1867,-10
17755991233,17755991247,14,15558,34774,-10
17758555033,17758555031,-2,1346,2115,-10
17759470769,17759470771,2,1629,1602,-10
17760938570,17760938574,4,1141,1098,-10
17761695124,17761695122,-2,1088,2489,-10
17762421729,17762421729,0,2225,1673,-10
17765494034,17765494034,0,2148,1574,-10
17769629106,17769629106,0,1510,930,-10
17770402662,17770402664,2,1383,1559,-10
17771703610,17771703614,4,863,910,-10
17776372243,17776372246,3,1280,1933,-10
17776685422,17776685424,2,2192,2204,-10
17777485989,17777485995,6,2558,1270,-10
17778960661,17778960661,0,1263,1984,-10
17781618689,17781618691,2,1338,1504,-10
17785146140,17785146142,2,1704,1573,-10
17785327977,17785327978,1,1433,1704,-10
17786011894,17786011897,3,1727,1363,-10
17787732736,17787732737,1,28119,19033,-10
17787928589,17787928590,1,1396,1302,-10
17789442271,17789442273,2,1477,1187,-10
17793329806,17793329812,6,1236,1107,-10
17794082510,17794082513,3,1708,1582,-10
17797492731,17797492733,2,1632,1856,-10
17797960170,17797960171,1,2026,1871,-10
17800872494,17800872497,3,2235,2072,-10
17801289749,17801289754,5,1192,1232,-10
17804651910,17804651905,-5,1541,3638,-10
17805784849,17805784850,1,1384,1757,-10
17806042946,17806042950,4,1909,1270,-10
17806851498,17806851502,4,1477,1530,-10
17808231589,17808231587,-2,924,899,-10
17812332568,17812332574,6,2592,869,-10
17813892923,17813892923,0,1507,1537,-10
17815568505,17815568506,1,1719,1765,-10
17817344799,17817344799,0,1757,2155,-10
17817811622,17817811623,1,912,818,-10
17825057303,17825057305,2,879,1723,-10
17825828527,17825828528,1,1341,1005,-10
17826194302,17826194312,10,1387,728,-10
17831542290,17831542294,4,1359,1593,-10
17832216181,17832216160,-21,1484,6151,-10
17833180065,17833180065,0,1266,2347,-10
17834125007,17834125010,3,1656,1263,-10
17841516907,17841516909,2,1212,1487,-10
17843230765,17843230770,5,1007,853,-10
17844725322,17844725323,1,2004,2248,-10
17850021794,17850021800,6,4026,2310,-10
17852057290,17852057293,3,1445,1572,-10
17852744723,17852744724,1,1027,1592,-10
17856595450,17856595444,-6,1042,3782,-10
17859054362,17859054362,0,1600,1542,-10
17873787124,17873787126,2,1918,1824,-10
17876563746,17876563751,5,1590,1292,-10
17876771817,17876771821,4,1329,1659,-10
17877505477,17877505478,1,1393,1336,-10
17879515965,17879515974,9,464,184,-10
17880543815,17880543818,3,1439,1536,-10
17880570950,17880570950,0,1102,1516,-10
17881677495,17881677497,2,840,1442,-10
17882055266,17882055266,0,2086,1870,-10
17882345743,17882345743,0,1144,1503,-10
17883253918,17883253919,1,1546,1640,-10
17884066055,17884066058,3,2155,1489,-10
17884699846,17884699847,1,2253,1371,-10
17887671298,17887671300,2,1564,1733,-10
17891510634,17891510634,0,1625,1424,-10
17891720081,17891720083,2,1354,1296,-10
17898239837,17898239838,1,2048,1843,-10
17907861929,17907861935,6,2039,948,-10
17908936291,17908936292,1,1536,2225,-10
17909714233,17909714234,1,1579,912,-10
17913204477,17913204479,2,1470,1929,-10
17914353764,17914353767,3,1955,1213,-10
17919777847,17919777847,0,1639,1805,-10
17926167791,17926167794,3,1550,1251,-10
17926616027,17926616032,5,1877,1719,-10
17928271092,17928271093,1,1862,1514,-10
17928637594,17928637595,1,1601,1701,-10
17929742358,17929742361,3,1246,1572,-10
17934103615,17934103615,0,1482,1812,-10
17935722652,17935722647,-5,1318,4125,-10
17941672343,17941672345,2,1768,1604,-10
17942472177,17942472178,1,1799,1956,-10
17943828974,17943828977,3,1538,1602,-10
17944345957,17944345958,1,1910,2116,-10
17947151233,17947151233,0,1752,2039,-10
17949090644,17949090647,3,1182,1549,-10
17949274151,17949274129,-22,1859,1291,-10
17952046349,17952046346,-3,1178,2119,-10
17953243366,17953243366,0,1585,1874,-10
17954259449,17954259450,1,1701,1815,-10
17955010825,17955010827,2,1610,1465,-10
17955459049,17955459050,1,930,1463,-10
17958449725,17958449730,5,3130,1489,-10
17958874461,17958874458,-3,857,1682,-10
17959380161,17959380144,-17,89,1035,-10
17960722994,17960722994,0,1982,1659,-10
17962893567,17962893567,0,1519,2113,-10
17965947450,17965947451,1,1196,2052,-10
17972619281,17972619282,1,2062,1696,-10
17976093649,17976093651,2,1430,1054,-10
17978410649,17978410652,3,1560,1168,-10
17979284322,17979284325,3,1439,1295,-10
17980797280,17980797281,1,1551,1126,-10
17982081893,17982081895,2,1327,1632,-10
17985616419,17985616420,1,1278,1766,-10
17991745194,17991745196,2,1850,1628,-10
17992465155,17992465156,1,1604,1878,-10
17993213077,17993213078,1,2418,2292,-10
17994131966,17994131968,2,1602,1657,-10
17999234811,17999234813,2,1488,1537,-10
18000910503,18000910506,3,1204,1323,-10
18002469999,18002470000,1,1848,2548,-10
18005272146,18005272146,0,1634,1941,-10
18010071913,18010071915,2,1721,957,-10
18016582448,18016582455,7,3336,1294,-10
18022469703,18022469705,2,1551,1464,-10
18023308494,18023308482,-12,774,641,-10
18027209917,18027209914,-3,1330,2544,-10
18029097847,18029097849,2,1615,1338,-10
18032242574,18032242574,0,1028,1357,-10
18041061454,18041061455,1,874,1216,-10
18043854654,18043854659,5,1102,1029,-10
18046193569,18046193576,7,15618,23037,-10
18051080222,18051080227,5,1430,1265,-10
18052774975,18052774978,3,1626,1427,-10
18053376639,18053376643,4,1251,1180,-10
18060602407,18060602410,3,1271,1414,-10
18066377559,18066377562,3,1155,1500,-10
18069207538,18069207538,0,1433,1742,-10
18070451618,18070451618,0,1940,1645,-10
18071859153,18071859157,4,1392,1357,-10
18074365875,18074365875,0,1600,1904,-10
18076297318,18076297321,3,2451,2083,-10
18078574837,18078574839,2,2022,1285,-10
18080681505,18080681506,1,1564,1494,-10
18082128628,18082128634,6,1450,782,-10
18083867377,18083867390,13,1147,1258,-10
18084138815,18084138826,11,1464,1088,-10
18084631993,18084631995,2,1851,1451,-10
18085635827,18085635829,2,1718,1452,-10
18090995237,18090995241,4,1433,1467,-10
18094741878,18094741882,4,1471,1818,-10
18096624821,18096624822,1,2081,1590,-10
18097319904,18097319906,2,1679,1469,-10
18099705339,18099705338,-1,1368,1653,-10
18101222460,18101222458,-2,1500,1490,-10
18104796930,18104796932,2,1359,1231,-10
18112505646,18112505646,0,1402,1809,-10
18113354965,18113354967,2,1352,1608,-10
18113744994,18113744993,-1,1489,1413,-10
18115409305,18115409308,3,1826,1414,-10
18116009938,18116009943,5,1514,1584,-10
18117745193,18117745197,4,1324,990,-10
18119664490,18119664493,3,1748,1406,-10
18120205526,18120205527,1,1888,1417,-10
18122446161,18122446163,2,1854,1099,-10
18124690376,18124690378,2,2249,1153,-10
18125517376,18125517376,0,972,1430,-10
18129042323,18129042325,2,1780,1305,-10
18130318133,18130318135,2,1728,1275,-10
18133298292,18133298293,1,1252,1387,-10
18134942901,18134942904,3,1396,1758,-10
18136311850,18136311850,0,2210,2270,-10
18136732295,18136732295,0,1189,1774,-10
18138291582,18138291587,5,1322,1244,-10
18140274128,18140274129,1,1746,1458,-10
18141905116,18141905120,4,1392,1447,-10
18143343383,18143343382,-1,1457,1187,-10
18143656227,18143656229,2,1703,2279,-10
18144261215,18144261218,3,1836,1559,-10
18144567290,18144567282,-8,642,1627,-10
18146353194,18146353197,3,1504,1581,-10
18146927399,18146927401,2,1247,1755,-10
18147320990,18147320991,1,1201,1757,-10
18148937995,18148937990,-5,2315,7321,-10
18149484577,18149484579,2,1826,1358,-10
18151416251,18151416253,2,1821,1357,-10
18154756509,18154756511,2,1474,1477,-10
18156915727,18156915730,3,2164,1364,-10
18157202887,18157202882,-5,1088,3336,-10
18163301869,18163301871,2,1457,1206,-10
18164546823,18164546826,3,2280,1056,-10
18169559743,18169559722,-21,1438,1971,-10
18169665159,18169665155,-4,983,1617,-10
18169913566,18169913569,3,1229,1340,-10
18170011335,18170011337,2,2336,1310,-10
18173296911,18173296910,-1,2944,5616,-10
18174255170,18174255174,4,1685,1187,-10
18175238829,18175238830,1,1421,1151,-10
18176437757,18176437755,-2,1200,1006,-10
18177357925,18177357929,4,1799,1436,-10
18181856913,18181856914,1,1319,2329,-10
18184368142,18184368145,3,1966,1934,-10
18184745266,18184745270,4,1542,1608,-10
18185240031,18185240033,2,1632,1624,-10
18186215733,18186215733,0,1620,2500,-10
18186646815,18186646813,-2,1561,1909,-10
18192848645,18192848648,3,1488,1612,-10
18195334903,18195334907,4,1299,1396,-10
18197823801,18197823796,-5,1707,8642,-10
18199744891,18199744890,-1,1374,1743,-10
18200817046,18200817028,-18,1168,960,-10
18206606170,18206606169,-1,1624,1607,-10
18208388908,18208388910,2,1773,1663,-10
18209829751,18209829753,2,1391,1361,-10
18217383919,18217383917,-2,2148,5408,-10
18219707430,18219707430,0,1732,1425,-10
18221222390,18221222394,4,964,892,-10
18221441620,18221441635,15,1617,1502,-10
18224842347,18224842350,3,1876,1710,-10
18227096735,18227096737,2,1055,1651,-10
18232229441,18232229443,2,1574,2126,-10
18232537486,18232537488,2,1234,1536,-10
18235582401,18235582403,2,1339,1628,-10
18237230603,18237230606,3,1057,1045,-10
18239960236,18239960236,0,1142,1883,-10
18240693611,18240693619,8,1363,1227,-10
18240781497,18240781501,4,1587,1838,-10
18243502278,18243502279,1,1931,1410,-10
18245521036,18245521038,2,1351,1654,-10
18252185881,18252185882,1,1673,1446,-10
18252476954,18252476955,1,1510,1667,-10
18253167897,18253167876,-21,1087,1177,-10
18256230162,18256230165,3,2527,1180,-10
18256520776,18256520777,1,1170,1686,-10
18257453293,18257453294,1,1261,1225,-10
18258397449,18258397453,4,1080,1357,-10
18259530649,18259530651,2,954,1595,-10
18261737203,18261737206,3,2106,1432,-10
18262437725,18262437725,0,916,990,-10
18262945585,18262945586,1,1580,1135,-10
18264316518,18264316520,2,1687,1341,-10
18264551773,18264551795,22,1255,1316,-10
18265761326,18265761326,0,1726,1398,-10
18265790431,18265790433,2,1348,1139,-10
18266202019,18266202017,-2,1684,1005,-10
18266444249,18266444251,2,2150,1503,-10
18266971202,18266971205,3,1464,1438,-10
18269968615,18269968618,3,1659,1520,-10
18270171558,18270171561,3,2250,1475,-10
18271282209,18271282211,2,1140,1146,-10
18272244531,18272244537,6,1301,1195,-10
18273520278,18273520279,1,1417,1939,-10
18277931195,18277931196,1,1804,2350,-10
18278732806,18278732810,4,1445,1113,-10
18280087102,18280087103,1,1550,2330,-10
18282489912,18282489914,2,1642,1504,-10
18282756909,18282756916,7,3983,1515,-10
18282896349,18282896328,-21,1422,1439,-10
18283142393,18283142395,2,1985,1749,-10
18283394298,18283394298,0,1375,1324,-10
18286588570,18286588573,3,2058,2073,-10
18289033031,18289033034,3,1736,2294,-10
18289629026,18289629029,3,2355,1745,-10
18289752143,18289752143,0,1311,1300,-10
18290046351,18290046357,6,2311,1989,-10
18291959241,18291959241,0,898,1502,-10
18292853138,18292853142,4,1522,1313,-10
18293402445,18293402442,-3,1380,2545,-10
18294356578,18294356579,1,1450,2302,-10
18300098131,18300098118,-13,1202,1468,-10
18309401481,18309401480,-1,1791,1869,-10
18311270554,18311270557,3,1239,2085,-10
18312279453,18312279453,0,1083,1426,-10
18325895885,18325895885,0,1699,1976,-10
18326506041,18326506042,1,1749,1318,-10
18331648810,18331648810,0,1423,1276,-10
18332760402,18332760404,2,2213,2014,-10
18336719817,18336719819,2,1223,1311,-10
18349088242,18349088245,3,775,1546,-10
18351063010,18351063014,4,2003,2012,-10
18353559595,18353559595,0,1142,2098,-10
18355209773,18355209775,2,992,984,-10
18357246182,18357246185,3,1354,1313,-10
18357977823,18357977824,1,1355,1180,-10
18359539214,18359539215,1,1133,1029,-10
18360527424,18360527426,2,1974,2039,-10
18365747376,18365747377,1,2460,1987,-10
18366748403,18366748401,-2,960,1457,-10
18368978088,18368978091,3,38688,15232,-10
18372890651,18372890653,2,1303,1290,-10
18373466281,18373466283,2,1325,1410,-10
18374276939,18374276943,4,1953,1269,-10
18376760411,18376760391,-20,1457,1156,-10
18379236125,18379236127,2,1465,1230,-10
18382912545,18382912546,1,1694,1397,-10
18393800606,18393800607,1,1456,715,-10
18401278850,18401278850,0,1562,1860,-10
18406074376,18406074382,6,2297,954,-10
18407054754,18407054758,4,2013,1791,-10
18410807870,18410807874,4,2255,1581,-10
18411394225,18411394225,0,1510,1606,-10
18414021887,18414021886,-1,1091,1401,-10
18417056058,18417056061,3,1825,1611,-10
18417725130,18417725133,3,2215,1754,-10
18421014137,18421014139,2,1253,1316,-10
18424219667,18424219670,3,1764,1749,-10
18428357284,18428357285,1,1937,1556,-10
18429448766,18429448748,-18,265,223,-10
18431309646,18431309649,3,1968,1802,-10
18432843286,18432843284,-2,2165,3166,-10
18433846331,18433846332,1,1387,1359,-10
18438398401,18438398403,2,2357,1475,-10
18443321360,18443321362,2,2100,1482,-10
18443889306,18443889307,1,1501,1690,-10
18447334528,18447334529,1,1361,1717,-10
18449939847,18449939847,0,1826,1496,-10
18452248422,18452248427,5,2361,1396,-10
18452294882,18452294886,4,2381,2340,-10
18457450796,18457450793,-3,1522,2938,-10
18462926623,18462926625,2,1996,1642,-10
18467969352,18467969354,2,1378,1097,-10
18471191574,18471191577,3,1278,1626,-10
18472138145,18472138148,3,1512,1508,-10
18473503277,18473503278,1,1273,1525,-10
18481021925,18481021929,4,1553,1324,-10
18482307740,18482307742,2,1823,1224,-10
18483113514,18483113517,3,1300,2617,-10
18486142661,18486142662,1,1138,1006,-10
18487978082,18487978079,-3,822,1104,-10
18491555418,18491555420,2,1969,1237,-10
18492060375,18492060377,2,1960,2225,-10
18504106889,18504106890,1,945,1040,-10
18506818989,18506818990,1,1364,1570,-10
18507838062,18507838061,-1,1046,1178,-10
18516487402,18516487409,7,1412,1268,-10
18516950754,18516950757,3,1422,1621,-10
18517945922,18517945923,1,1433,1752,-10
18518725709,18518725712,3,1487,2190,-10
18521313595,18521313596,1,1692,1504,-10
18523442186,18523442182,-4,4709,11490,-10
18528704147,18528704138,-9,297,1242,-10
18529829239,18529829242,3,1534,1273,-10
18531157644,18531157647,3,1858,1125,-10
18531443049,18531443050,1,1959,1611,-10
18531483866,18531483862,-4,1010,1513,-10
18535277025,18535277022,-3,1982,4875,-10
18537411534,18537411536,2,1631,2054,-10
18537876710,18537876713,3,2721,2516,-10
18540451451,18540451455,4,1464,1251,-10
18541318341,18541318345,4,1697,1378,-10
18544874706,18544874707,1,975,1021,-10
18546346307,18546346309,2,1672,1636,-10
18546907897,18546907898,1,1194,1462,-10
18555506022,18555506025,3,1151,809,-10
18556858879,18556858882,3,1149,1228,-10
18558853354,18558853355,1,1723,2069,-10
18560314878,18560314878,0,1042,1095,-10
18562031726,18562031728,2,1463,1104,-10
18563469298,18563469299,1,1502,1539,-10
18565294036,18565294038,2,2087,2201,-10
18571439043,18571439044,1,1511,1359,-10
18572327369,18572327370,1,1582,1788,-10
18572848490,18572848492,2,1279,1374,-10
18572915410,18572915414,4,1616,1092,-10
18573806774,18573806772,-2,926,1435,-10
18580596428,18580596429,1,1530,1732,-10
18591392224,18591392223,-1,1359,1561,-10
18592851173,18592851176,3,1526,1326,-10
18597411024,18597411026,2,1838,1438,-10
18598840469,18598840470,1,2184,1729,-10
18603014549,18603014571,22,1373,1008,-10
18603246445,18603246447,2,1280,1647,-10
18604353245,18604353246,1,1591,1593,-10
18604389171,18604389174,3,1215,1370,-10
18607740405,18607740406,1,762,1485,-10
18608458133,18608458134,1,1262,1909,-10
18609601334,18609601338,4,1793,1727,-10
18611657902,18611657903,1,1836,1613,-10
18612860835,18612860835,0,1744,1353,-10
18614466608,18614466611,3,2583,1207,-10
18614552031,18614552031,0,1223,1164,-10
18619604393,18619604396,3,1664,1331,-10
18623691514,18623691514,0,1273,2360,-10
18625666106,18625666110,4,1509,1404,-10
18628637755,18628637758,3,1779,1563,-10
18628966957,18628966959,2,881,563,-10
18632605361,18632605362,1,1955,1832,-10
18633137417,18633137417,0,1566,1278,-10
18635585013,18635585014,1,2077,1975,-10
18636324151,18636324153,2,871,1632,-10
18637259033,18637259036,3,1438,1424,-10
18637320855,18637320835,-20,1143,451,-10
18637347683,18637347686,3,1669,1485,-10
18640973733,18640973734,1,1802,953,-10
18641397691,18641397694,3,1487,1124,-10
18644134129,18644134132,3,1733,1272,-10
18644406934,18644406938,4,1499,1188,-10
18646404225,18646404227,2,1629,1471,-10
18648685129,18648685131,2,1808,1484,-10
18656188721,18656188723,2,1382,1378,-10
18657592609,18657592609,0,1489,1451,-10
18659264023,18659264005,-18,1438,1516,-10
18659364926,18659364928,2,1364,1398,-10
18662613172,18662613175,3,1496,1218,-10
18664180666,18664180669,3,1743,1413,-10
18665503730,18665503734,4,2286,1338,-10
18667697924,18667697926,2,1593,2002,-10
18671017895,18671017899,4,1609,1138,-10
18671362102,18671362081,-21,1358,1221,-10
18671924498,18671924497,-1,1296,1296,-10
18671950739,18671950742,3,1359,1236,-10
18672285356,18672285357,1,2083,2043,-10
18672814297,18672814299,2,1189,1554,-10
18674236888,18674236891,3,1929,1328,-10
18675645356,18675645357,1,1776,2011,-10
18676452808,18676452810,2,1839,1298,-10
18676803129,18676803130,1,1277,1465,-10
18678358370,18678358375,5,2098,1489,-10
18681113683,18681113686,3,1331,1202,-10
18681371797,18681371800,3,1208,1432,-10
18683196154,18683196158,4,1535,1340,-10
18683853242,18683853246,4,1425,1554,-10
18683971922,18683971921,-1,1208,1264,-10
18685606374,18685606377,3,1084,1221,-10
18686795722,18686795735,13,420,1150,-10
18688258333,18688258335,2,1660,1898,-10
18689648492,18689648498,6,2191,872,-10
18694205871,18694205872,1,1450,1332,-10
18694617942,18694617946,4,879,1219,-10
18696522797,18696522799,2,13825,11169,-10
18700750936,18700750937,1,1050,1025,-10
18704041455,18704041457,2,906,1308,-10
18704945000,18704945002,2,1009,1033,-10
18709799913,18709799914,1,1286,905,-10
18711362607,18711362610,3,1676,1417,-10
18713317526,18713317525,-1,1271,1964,-10
18717018313,18717018313,0,2034,2046,-10
18717286093,18717286094,1,1565,1391,-10
18717817742,18717817738,-4,1130,2886,-10
18718012577,18718012568,-9,978,4810,-10
18718871941,18718871941,0,2059,1615,-10
18721964741,18721964742,1,789,528,-10
18722668063,18722668065,2,1637,1763,-10
18727270007,18727270010,3,2047,1449,-10
18727428170,18727428172,2,1880,1586,-10
18729875826,18729875831,5,1685,1584,-10
18730435113,18730435114,1,1640,1620,-10
18730518277,18730518281,4,1390,1216,-10
18730656265,18730656265,0,1236,1908,-10
18731171005,18731171008,3,1338,1338,-10
18734410810,18734410810,0,1216,1207,-10
18737334282,18737334285,3,1636,2019,-10
18742406872,18742406875,3,1346,1590,-10
18743444502,18743444507,5,2408,1256,-10
18745286614,18745286610,-4,1163,3101,-10
18745513454,18745513453,-1,1173,1556,-10
18746412187,18746412190,3,1858,1572,-10
18748847162,18748847163,1,1219,1534,-10
18749101422,18749101427,5,1363,1387,-10
18750030799,18750030801,2,1579,1707,-10
18750145103,18750145105,2,1033,1362,-10
18753372783,18753372786,3,1398,1076,-10
18758607381,18758607382,1,1669,1504,-10
18760311898,18760311899,1,1772,1606,-10
18761343962,18761343963,1,820,1195,-10
18762211340,18762211342,2,1871,1861,-10
18762478621,18762478622,1,1793,1141,-10
18765503379,18765503381,2,1780,1442,-10
18767667336,18767667338,2,1260,847,-10
18769062685,18769062685,0,1832,1379,-10
18772624942,18772624958,16,14527,30332,-10
18773683418,18773683418,0,1305,862,-10
18774323218,18774323221,3,1532,1588,-10
18774840827,18774840830,3,2138,2141,-10
18783379086,18783379105,19,240,1648,-10
18783420411,18783420412,1,1790,1792,-10
18784011546,18784011546,0,1357,1387,-10
18789846072,18789846074,2,1599,1564,-10
18791490677,18791490678,1,1365,1057,-10
18792320219,18792320222,3,1473,1103,-10
18793730839,18793730839,0,1160,1504,-10
18795691496,18795691505,9,47631,22821,-10
18800493966,18800493969,3,1681,1508,-10
18800828763,18800828763,0,1263,1867,-10
18802461999,18802462001,2,872,1288,-10
18804113610,18804113610,0,1135,1289,-10
18804546141,18804546163,22,1235,1091,-10
18806668767,18806668766,-1,1272,2621,-10
18808832517,18808832520,3,1642,906,-10
18809148867,18809148870,3,1250,1458,-10
18809567738,18809567737,-1,1845,1941,-10
18811399751,18811399752,1,1351,1283,-10
18815090278,18815090280,2,1365,1456,-10
18815312508,18815312510,2,1179,881,-10
18817442729,18817442730,1,2014,1520,-10
18822605860,18822605863,3,2099,1863,-10
18824362438,18824362441,3,2242,1743,-10
18825694539,18825694541,2,1730,1750,-10
18829794613,18829794614,1,1156,884,-10
18831733830,18831733835,5,1645,1291,-10
18832530065,18832530065,0,1474,1582,-10
18832748521,18832748540,19,1779,1263,-10
18833690839,18833690847,8,3429,1265,-10
18834468670,18834468671,1,1414,1544,-10
18834913910,18834913909,-1,2004,1951,-10
18837038006,18837038009,3,1525,1572,-10
18842475075,18842475075,0,1221,1541,-10
18843294226,18843294229,3,1807,1631,-10
18844200459,18844200463,4,1546,1542,-10
18844274209,18844274209,0,1056,1789,-10
18849572660,18849572663,3,1983,1719,-10
18849821611,18849821612,1,1352,1812,-10
18851799930,18851799934,4,587,921,-10
18851915825,18851915826,1,1659,1636,-10
18853731491,18853731493,2,1720,2295,-10
18856414076,18856414077,1,1557,1369,-10
18865514280,18865514283,3,1172,1048,-10
18866163006,18866163007,1,1094,783,-10
18867574228,18867574231,3,1289,908,-10
18869870853,18869870854,1,1479,1507,-10
18871368672,18871368673,1,1819,1488,-10
18872754698,18872754698,0,1462,1916,-10
18875306894,18875306897,3,1660,1577,-10
18876401730,18876401731,1,1620,1324,-10
18877259658,18877259661,3,1634,1722,-10
18877358267,18877358273,6,890,1106,-10
18882443731,18882443728,-3,1173,2687,-10
18883626215,18883626212,-3,625,1973,-10
18887522597,18887522598,1,1208,2012,-10
18888099737,18888099739,2,1392,1407,-10
18889404406,18889404406,0,1856,1592,-10
18895040240,18895040241,1,1285,1803,-10
18895321997,18895321977,-20,1562,781,-10
18896558458,18896558459,1,1718,1614,-10
18898434979,18898434979,0,1723,1487,-10
18899990429,18899990431,2,44482,4104,-10
18900911963,18900911966,3,1392,1268,-10
18901245163,18901245166,3,1595,1777,-10
18902177247,18902177247,0,1291,1649,-10
18903291109,18903291109,0,1268,1806,-10
18904489790,18904489790,0,1989,1417,-10
18906980041,18906980037,-4,1357,2678,-10
18912174316,18912174318,2,1643,1520,-10
18913677130,18913677129,-1,1094,1626,-10
18914112741,18914112743,2,1369,1852,-10
18914379570,18914379571,1,1852,26578,-10
18916516193,18916516190,-3,1662,1700,-10
18917263321,18917263321,0,1604,1266,-10
18920496669,18920496669,0,1374,1456,-10
18928312807,18928312807,0,1433,1221,-10
18929801441,18929801443,2,1670,1399,-10
18930178810,18930178810,0,1904,2025,-10
18930454660,18930454661,1,2089,1229,-10
18939464663,18939464664,1,1878,2457,-10
18941195279,18941195283,4,1292,1266,-10
18945643272,18945643274,2,2361,1917,-10
18948954582,18948954582,0,2578,1576,-10
18949728090,18949728093,3,1851,1614,-10
18950514527,18950514530,3,1954,1600,-10
18950636235,18950636239,4,1668,1397,-10
18953544071,18953544071,0,1204,2334,-10
18956548243,18956548243,0,1178,1882,-10
18957486277,18957486279,2,1880,1479,-10
18959863103,18959863105,2,1908,2138,-10
18962369895,18962369897,2,1891,2004,-10
18962693459,18962693463,4,2081,1593,-10
18963191830,18963191830,0,938,1390,-10
18964707057,18964707058,1,1906,1452,-10
18968476178,18968476178,0,1225,1485,-10
18975202442,18975202446,4,1116,836,-10
18976062883,18976062888,5,2945,1701,-10
18978815482,18978815483,1,1482,1365,-10
18980769516,18980769516,0,1482,2062,-10
18983501356,18983501358,2,1502,1421,-10
18984008176,18984008178,2,1856,1180,-10
18985262722,18985262724,2,1133,1560,-10
18988990279,18988990283,4,1096,1310,-10
18990974446,18990974450,4,1140,1921,-10
18992113442,18992113445,3,2391,1949,-10
18993423189,18993423192,3,1538,1658,-10
18995049847,18995049847,0,1245,1434,-10
18996620729,18996620731,2,1284,935,-10
18996985723,18996985726,3,1154,1599,-10
18997497955,18997497951,-4,1588,1416,-10
18999144039,18999144039,0,1745,1546,-10
19005644673,19005644676,3,2054,1494,-10
19010134265,19010134267,2,1677,1269,-10
19010277465,19010277465,0,1299,1359,-10
19012306542,19012306542,0,1293,901,-10
19015323933,19015323937,4,1784,1683,-10
19017756038,19017756039,1,1144,1445,-10
19018594526,19018594525,-1,1347,1804,-10
19018666140,19018666142,2,1472,1581,-10
19022813454,19022813457,3,1595,1263,-10
19023127410,19023127412,2,4111,3004,-10
19023276883,19023276884,1,1244,1064,-10
19025516126,19025516126,0,1652,1550,-10
19025583419,19025583424,5,1652,938,-10
19026330466,19026330465,-1,2385,3546,-10
19031134701,19031134699,-2,1544,2100,-10
19031579230,19031579235,5,2022,2022,-10
19031604722,19031604723,1,1922,1773,-10
19032134018,19032134021,3,1437,1347,-10
19032693865,19032693855,-10,1284,1118,-10
19033032914,19033032915,1,1321,1744,-10
19035397990,19035397993,3,1899,2107,-10
19035755906,19035755908,2,1342,1176,-10
19036990660,19036990682,22,1527,1595,-10
19042816579,19042816582,3,1645,1876,-10
19043548957,19043548958,1,1630,2022,-10
19044575505,19044575507,2,1279,1376,-10
19045139980,19045139981,1,1295,1931,-10
19046680549,19046680551,2,1305,1692,-10
19047404415,19047404414,-1,1076,1223,-10
19048536021,19048536022,1,1955,1443,-10
19048712637,19048712642,5,3766,1613,-10
19048743894,19048743895,1,1171,1211,-10
19049915353,19049915355,2,1665,1512,-10
19049953343,19049953347,4,2051,1428,-10
19050905020,19050905022,2,1467,1768,-10
19054948262,19054948263,1,1305,1352,-10
19055947280,19055947282,2,1651,1084,-10
19056262790,19056262797,7,3713,1638,-10
19056402243,19056402245,2,1814,1957,-10
19057442390,19057442390,0,1425,1745,-10
19057887676,19057887678,2,1766,1532,-10
19060877815,19060877818,3,1504,1222,-10
19061236775,19061236779,4,1865,1652,-10
19062327898,19062327899,1,1428,1244,-10
19065436142,19065436162,20,1643,1258,-10
19066572624,19066572626,2,2147,1344,-10
19069734354,19069734357,3,1591,1984,-10
19070439894,19070439894,0,1294,1335,-10
19070538479,19070538456,-23,1288,1190,-10
19072372275,19072372278,3,1426,1618,-10
19074740557,19074740558,1,1118,1003,-10
19076577162,19076577166,4,620,729,-10
19077780362,19077780366,4,1666,1676,-10
19082436102,19082436105,3,2135,1516,-10
19084850773,19084850774,1,2148,1935,-10
19086714491,19086714492,1,1651,2359,-10
19090760425,19090760427,2,1583,1707,-10
19096180854,19096180859,5,1698,1438,-10
19097415401,19097415402,1,2019,2924,-10
19097995677,19097995681,4,1166,1140,-10
19098808557,19098808558,1,1576,2203,-10
19100234395,19100234399,4,3087,1937,-10
19104425653,19104425654,1,1932,1846,-10
19104484417,19104484411,-6,757,3417,-10
19105192653,19105192654,1,1746,1462,-10
19111290467,19111290470,3,1660,1166,-10
19111946042,19111946037,-5,939,1325,-10
19113032318,19113032317,-1,1813,1612,-10
19116115017,19116115018,1,1708,1323,-10
19117389861,19117389862,1,1491,1336,-10
19117870616,19117870630,14,13010,47983,-10
19118667942,19118667945,3,2019,1637,-10
19124145915,19124145908,-7,2763,16016,-10
19124426417,19124426417,0,1582,1196,-10
19126570402,19126570406,4,1122,1384,-10
19129360908,19129360911,3,1256,1615,-10
19136252758,19136252759,1,1478,1611,-10
19139221114,19139221115,1,1682,2096,-10
19139565967,19139565971,4,2018,1275,-10
19140422696,19140422698,2,2229,2227,-10
19141075770,19141075771,1,1318,1411,-10
19141412742,19141412742,0,1639,2475,-10
19143868306,19143868307,1,1323,1022,-10
19150381515,19150381517,2,2296,2273,-10
19152148628,19152148630,2,1735,1636,-10
19159247542,19159247542,0,1688,1608,-10
19159964409,19159964411,2,1530,1596,-10
19169177425,19169177425,0,2239,2636,-10
19177442482,19177442477,-5,1589,4708,-10
19177830619,19177830622,3,828,823,-10
19178459089,19178459090,1,1604,1466,-10
19178930822,19178930823,1,939,911,-10
19180385378,19180385379,1,1611,1719,-10
19181807384,19181807386,2,1797,1395,-10
19183001277,19183001278,1,1449,1407,-10
19183471513,19183471515,2,1725,1441,-10
19184603933,19184603935,2,1373,1517,-10
19184728005,19184728009,4,1831,1697,-10
19187243205,19187243206,1,2449,2250,-10
19187368358,19187368360,2,1947,1812,-10
19188474757,19188474757,0,964,1066,-10
19190085013,19190085014,1,1406,1080,-10
19198026042,19198026041,-1,1124,1118,-10
19198667742,19198667746,4,1371,1141,-10
19200830708,19200830710,2,2235,1663,-10
19201143286,19201143286,0,1452,1444,-10
19202911469,19202911470,1,1343,1551,-10
19209996632,19209996634,2,1503,1317,-10
19210291290,19210291292,2,1370,1702,-10
19212334402,19212334405,3,1195,1405,-10
19212670082,19212670077,-5,2178,8003,-10
19215462106,19215462106,0,1801,1650,-10
19215580231,19215580232,1,2379,2348,-10
19216151818,19216151818,0,1270,2400,-10
19223801423,19223801423,0,2035,1892,-10
19223935454,19223935456,2,1258,1401,-10
19226703913,19226703913,0,1638,1561,-10
19228673251,19228673252,1,2135,1732,-10
19231689498,19231689498,0,1397,1139,-10
19232764719,19232764722,3,1994,1707,-10
19233760870,19233760874,4,2629,1575,-10
19238745630,19238745631,1,1386,1824,-10
19240795340,19240795338,-2,148,9021,-10
19241271680,19241271682,2,1686,1435,-10
19243198768,19243198770,2,1289,1145,-10
19244471315,19244471320,5,1169,1170,-10
19245041554,19245041556,2,1112,1179,-10
19246017666,19246017644,-22,1764,1478,-10
19247826274,19247826277,3,1567,1522,-10
19249109550,19249109551,1,1469,1558,-10
19249627269,19249627272,3,1162,1125,-10
19252539457,19252539459,2,1783,1281,-10
19254284399,19254284401,2,1446,875,-10
19257309078,19257309080,2,1645,1382,-10
19258691750,19258691751,1,1783,1622,-10
19258870465,19258870466,1,1313,1216,-10
19260474000,19260474002,2,1413,862,-10
19265946055,19265946055,0,971,1017,-10
19265980695,19265980698,3,1968,994,-10
19267576482,19267576485,3,1762,1771,-10
19269476281,19269476282,1,1572,1804,-10
19270510974,19270510978,4,1199,1758,-10
19275867246,19275867246,0,1746,1475,-10
19276333594,19276333594,0,1196,1488,-10
19277538645,19277538646,1,2261,1913,-10
19280592036,19280592038,2,1886,1385,-10
19282890538,19282890539,1,846,1260,-10
19284073381,19284073384,3,1309,1600,-10
19284659635,19284659634,-1,1096,1641,-10
19284838166,19284838169,3,1206,1483,-10
19285139402,19285139402,0,1565,1240,-10
19285399890,19285399895,5,1725,1797,-10
19291272125,19291272126,1,1511,1343,-10
19291531394,19291531395,1,1275,1331,-10
19292386031,19292386031,0,948,1568,-10
19296204957,19296204959,2,1065,986,-10
19296363347,19296363350,3,1529,965,-10
19296647631,19296647633,2,1261,910,-10
19298242195,19298242197,2,1496,1913,-10
19303936882,19303936883,1,1733,1442,-10
19304347626,19304347627,1,905,1202,-10
19305659769,19305659770,1,1403,1592,-10
19307608545,19307608549,4,1001,1555,-10
19309726727,19309726708,-19,948,1531,-10
19314359083,19314359087,4,1479,1580,-10
19326947237,19326947238,1,1375,1089,-10
19327338739,19327338741,2,1395,1903,-10
19330019011,19330019015,4,1777,1521,-10
19331649921,19331649923,2,1674,1015,-10
19333605662,19333605663,1,1036,797,-10
19335126832,19335126833,1,1307,1299,-10
19338593433,19338593435,2,1854,1563,-10
19339646146,19339646146,0,974,1374,-10
19340373932,19340373934,2,1741,1517,-10
19342045867,19342045866,-1,1160,1168,-10
19342139286,19342139289,3,1788,1379,-10
19342816929,19342816931,2,1782,1659,-10
19345358474,19345358474,0,1734,1232,-10
19345615313,19345615315,2,1826,1574,-10
19346412339,19346412338,-1,866,2092,-10
19352239193,19352239195,2,2099,1702,-10
19353128921,19353128922,1,1169,1321,-10
19359282446,19359282443,-3,1263,2695,-10
19362695630,19362695631,1,1512,1334,-10
19364858851,19364858858,7,3007,1114,-10
19365366971,19365366972,1,1853,1660,-10
19370028697,19370028698,1,1521,1572,-10
19372288197,19372288198,1,1317,1687,-10
19374006354,19374006357,3,1457,1405,-10
19374601777,19374601779,2,1394,1752,-10
19375596579,19375596582,3,1313,1145,-10
19379393171,19379393172,1,1726,1607,-10
19380970920,19380970922,2,1766,1119,-10
19384663044,19384663042,-2,2402,3250,-10
19385504622,19385504625,3,1614,1827,-10
19386121940,19386121942,2,1563,1624,-10
19387842421,19387842431,10,9998,27408,-10
19388894390,19388894391,1,1361,1649,-10
19390525665,19390525666,1,1484,1316,-10
19391902707,19391902710,3,1293,1472,-10
19392776302,19392776305,3,1338,2073,-10
19395557558,19395557555,-3,1176,1807,-10
19401032030,19401032031,1,1581,1659,-10
19401550779,19401550781,2,1538,1348,-10
19403955491,19403955493,2,1482,1564,-10
19404034837,19404034838,1,2006,1786,-10
19404683181,19404683183,2,1229,1303,-10
19405304899,19405304900,1,1373,1072,-10
19410570870,19410570876,6,1906,1326,-10
19414560123,19414560125,2,1187,1220,-10
19414616304,19414616327,23,671,993,-10
19415820034,19415820035,1,6367,7118,-10
19416261417,19416261418,1,1602,1540,-10
19418515850,19418515850,0,1641,1606,-10
19419891515,19419891515,0,2478,4169,-10
19425782030,19425782031,1,1031,1798,-10
19426662764,19426662765,1,2107,1912,-10
19429898418,19429898422,4,1331,1060,-10
19431040278,19431040278,0,1061,1773,-10
19431347308,19431347304,-4,998,1056,-10
19432713113,19432713116,3,1896,2090,-10
19435870659,19435870639,-20,1470,1120,-10
19437823366,19437823367,1,1590,1616,-10
19438099600,19438099601,1,1853,1740,-10
19439720816,19439720818,2,1684,1307,-10
19440324367,19440324362,-5,1568,5623,-10
19442908385,19442908386,1,1540,1620,-10
19443254927,19443254930,3,1352,1437,-10
19443452006,19443452005,-1,1712,1835,-10
19443573318,19443573321,3,23706,34997,-10
19448172835,19448172837,2,1474,1276,-10
19449617806,19449617802,-4,1616,3531,-10
19449757607,19449757608,1,1787,1644,-10
19450457710,19450457709,-1,1169,1380,-10
19454907858,19454907859,1,1917,1721,-10
19458275174,19458275177,3,1333,1792,-10
19459633317,19459633317,0,1207,1790,-10
19460791947,19460791954,7,4439,2286,-10
19462689709,19462689708,-1,1300,1111,-10
19463391768,19463391768,0,1679,1689,-10
19464636345,19464636348,3,1874,1314,-10
19466666777,19466666779,2,1044,1699,-10
19467514854,19467514854,0,1158,1398,-10
19468485009,19468485011,2,2391,1565,-10
19470157758,19470157758,0,2502,1867,-10
19470999155,19470999168,13,387,213,-10
19472284358,19472284360,2,1570,1516,-10
19476200162,19476200163,1,1717,1836,-10
19477346275,19477346277,2,1339,1822,-10
19479445578,19479445578,0,1466,1274,-10
19480177252,19480177255,3,1337,848,-10
19480675307,19480675309,2,1741,1369,-10
19482098693,19482098695,2,1074,1330,-10
19484137474,19484137475,1,1511,1841,-10
19486258566,19486258566,0,1555,2422,-10
19487173105,19487173105,0,1583,1661,-10
19489449109,19489449112,3,1753,2205,-10
19490544701,19490544707,6,2929,1695,-10
19491015603,19491015606,3,1091,1571,-10
19491656902,19491656903,1,1344,1370,-10
19493005385,19493005387,2,1643,1292,-10
19497672794,19497672796,2,1629,1607,-10
19499130596,19499130598,2,2001,1259,-10
19500702866,19500702863,-3,1540,2476,-10
19501877270,19501877273,3,1599,1434,-10
19502391315,19502391317,2,1629,1391,-10
19502532173,19502532174,1,2347,1900,-10
19502690624,19502690626,2,2218,1722,-10
19503804278,19503804279,1,1478,2063,-10
19504592445,19504592445,0,1512,1333,-10
19506086107,19506086107,0,1616,1281,-10
19507969736,19507969739,3,1532,1203,-10
19510327239,19510327242,3,1765,1563,-10
19513273410,19513273411,1,1256,858,-10
19513664723,19513664721,-2,1060,1038,-10
19518348559,19518348561,2,1448,1078,-10
19523431713,19523431715,2,1149,1134,-10
19525239819,19525239822,3,1799,847,-10
19525283428,19525283429,1,929,1426,-10
19528105847,19528105847,0,1540,2109,-10
19531110578,19531110574,-4,821,2327,-10
19531399659,19531399639,-20,1354,1166,-10
19541898355,19541898357,2,1958,1724,-10
19544439406,19544439409,3,1130,699,-10
19548970718,19548970712,-6,3576,9677,-10
19552772804,19552772806,2,1306,1706,-10
19553689295,19553689297,2,1715,1464,-10
19555650369,19555650370,1,1807,1620,-10
19556005315,19556005315,0,1254,1006,-10
19557386714,19557386714,0,1582,1579,-10
19561959823,19561959825,2,2302,1943,-10
19565062210,19565062210,0,1595,1514,-10
19567006574,19567006577,3,1451,1422,-10
19578822067,19578822069,2,1483,1576,-10
19579022079,19579022082,3,2508,1908,-10
19579706605,19579706610,5,1558,1390,-10
19580470043,19580470042,-1,1051,784,-10
19582459882,19582459886,4,1058,1294,-10
19582566189,19582566191,2,1675,1324,-10
19583273769,19583273770,1,1813,1802,-10
19587726985,19587726988,3,1799,1395,-10
19597947737,19597947737,0,1673,1615,-10
19600023694,19600023696,2,1444,1597,-10
19602479126,19602479127,1,1442,1991,-10
19603445579,19603445581,2,1389,1302,-10
19607446894,19607446898,4,1807,1630,-10
19607637763,19607637765,2,914,896,-10
19608122929,19608122931,2,1285,993,-10
19611792536,19611792527,-9,16033,27993,-10
19614173803,19614173806,3,1568,1025,-10
19615200349,19615200353,4,3270,1372,-10
19618296240,19618296241,1,1604,1876,-10
19619786284,19619786287,3,1729,1681,-10
19620237258,19620237262,4,2162,1503,-10
19622653529,19622653530,1,1217,1066,-10
19624628623,19624628625,2,1324,1355,-10
19626758506,19626758506,0,1735,1604,-10
19628294721,19628294724,3,1283,1204,-10
19629370686,19629370686,0,1003,1111,-10
19631233704,19631233709,5,2390,1831,-10
19632516115,19632516117,2,1618,1989,-10
19632617034,19632617036,2,1333,922,-10
19634391338,19634391340,2,1733,2237,-10
19639031722,19639031723,1,1465,1216,-10
19642627224,19642627223,-1,1212,1394,-10
19642785074,19642785077,3,2124,1330,-10
19645219146,19645219147,1,1452,1432,-10
19646419865,19646419862,-3,1037,1765,-10
19650025662,19650025665,3,2193,1656,-10
19654280785,19654280784,-1,1530,2258,-10
19654386017,19654386019,2,1426,1939,-10
19658363815,19658363817,2,1621,2081,-10
19663897305,19663897304,-1,2010,2128,-10
19668593941,19668593922,-19,965,1289,-10
19674358093,19674358095,2,1402,1770,-10
19674997678,19674997683,5,2460,1286,-10
19676943503,19676943506,3,2048,2132,-10
19680698489,19680698495,6,1306,1034,-10
19683427238,19683427238,0,1484,1844,-10
19683536367,19683536355,-12,50746,14380,-10
19684955794,19684955794,0,994,1876,-10
19685081243,19685081242,-1,1090,1195,-10
19686122647,19686122650,3,1397,1239,-10
19691383974,19691383976,2,1582,1659,-10
19694222655,19694222658,3,951,879,-10
19694540654,19694540661,7,5160,1876,-10
19696341283,19696341284,1,2344,2842,-10
19703090518,19703090521,3,1755,1945,-10
19704951186,19704951190,4,1755,1752,-10
19705966304,19705966305,1,1245,1327,-10
19706659722,19706659722,0,1191,1249,-10
19706941293,19706941294,1,1941,1411,-10
19709509822,19709509823,1,1818,1979,-10
19709751653,19709751654,1,1229,1245,-10
19710621897,19710621898,1,1796,2327,-10
19713032550,19713032529,-21,72,1201,-10
19713431085,19713431090,5,1670,1323,-10
19716137442,19716137442,0,1234,2059,-10
19716167430,19716167429,-1,1515,2327,-10
19717409014,19717409017,3,1410,1372,-10
19720153421,19720153421,0,1187,1013,-10
19721629058,19721629059,1,1491,1519,-10
19721755068,19721755070,2,1256,1498,-10
19722499156,19722499179,23,2936,1745,-10
19728479944,19728479946,2,1495,1719,-10
19734817818,19734817822,4,1126,1347,-10
19738167599,19738167602,3,1402,1626,-10
19739073521,19739073523,2,1730,1615,-10
19739597702,19739597702,0,530,812,-10
19754081862,19754081842,-20,1380,1661,-10
19755860626,19755860628,2,1188,1302,-10
19756726338,19756726340,2,1606,1462,-10
19756988198,19756988201,3,1782,1746,-10
19761209396,19761209389,-7,969,5524,-10
19762335889,19762335898,9,7598,32767,-10
19762707268,19762707269,1,1801,1152,-10
19766168254,19766168234,-20,1412,1114,-10
19767827307,19767827309,2,1819,1425,-10
19767897502,19767897505,3,2082,1823,-10
19769987854,19769987857,3,1563,1283,-10
19773148058,19773148061,3,1554,1304,-10
19773839986,19773839987,1,1692,1702,-10
19777691193,19777691195,2,1981,1611,-10
19779029926,19779029927,1,1618,1104,-10
19781861293,19781861294,1,1586,1154,-10
19784461806,19784461809,3,1439,1353,-10
19786992266,19786992266,0,815,857,-10
19790018943,19790018945,2,1795,1478,-10
19801275279,19801275281,2,1316,1273,-10
19803186059,19803186062,3,887,995,-10
19807029825,19807029827,2,1146,1306,-10
19808521326,19808521328,2,1321,1704,-10
19808558518,19808558520,2,1170,1622,-10
19809882102,19809882108,6,2474,1647,-10
19817141594,19817141597,3,1494,1679,-10
19817546182,19817546182,0,1780,1173,-10
19818298739,19818298741,2,1785,2037,-10
19818665216,19818665213,-3,1150,2365,-10
19821762007,19821762009,2,1796,1858,-10
19823697446,19823697449,3,1578,1320,-10
19826502290,19826502291,1,1376,1224,-10
19827893749,19827893750,1,1606,1511,-10
19828714042,19828714044,2,1045,1166,-10
19830739526,19830739529,3,1901,1738,-10
19831668901,19831668901,0,1462,1615,-10
19832923040,19832923042,2,1245,1186,-10
19835156410,19835156411,1,448,398,-10
19837031053,19837031058,5,2483,916,-10
19839183251,19839183250,-1,1010,1378,-10
19839870927,19839870927,0,1803,1820,-10
19841739414,19841739411,-3,4509,6662,-10
19843445550,19843445551,1,1565,1336,-10
19844449003,19844449003,0,1342,1506,-10
19845902312,19845902314,2,1256,1237,-10
19847037488,19847037487,-1,1619,2412,-10
19849129724,19849129726,2,9141,8713,-10
19849948858,19849948862,4,3314,1966,-10
19851000664,19851000665,1,1735,1571,-10
19851872002,19851872005,3,976,1410,-10
19852113091,19852113093,2,1106,1342,-10
19852886995,19852886999,4,989,1436,-10
19854292897,19854292902,5,3997,1774,-10
19854944342,19854944345,3,1531,1712,-10
19857041902,19857041903,1,1358,1359,-10
19860377845,19860377846,1,929,854,-10
19864070901,19864070903,2,1254,1276,-10
19865223292,19865223295,3,1749,1587,-10
19865727685,19865727685,0,892,824,-10
19867001822,19867001823,1,2077,2028,-10
19867926013,19867926015,2,1677,2041,-10
19873828183,19873828169,-14,1168,1392,-10
19875383456,19875383457,1,1858,1939,-10
19876312687,19876312692,5,2021,1684,-10
19876455463,19876455463,0,915,1066,-10
19878571606,19878571607,1,1434,972,-10
19879281436,19879281441,5,1964,745,-10
19883296295,19883296298,3,1568,2226,-10
19885573070,19885573070,0,1740,1784,-10
19886295797,19886295797,0,1660,1657,-10
19887613617,19887613620,3,2032,1150,-10
19888464589,19888464590,1,1780,1545,-10
19888494791,19888494791,0,1746,1993,-10
19892124704,19892124706,2,2011,1624,-10
19893114086,19893114082,-4,947,2527,-10
19894224532,19894224533,1,2039,2178,-10
19896280307,19896280311,4,1851,1761,-10
19896636400,19896636403,3,1488,1085,-10
19897358505,19897358506,1,1616,1673,-10
19899072300,19899072307,7,1737,1094,-10
19899732398,19899732399,1,1857,1536,-10
19899871307,19899871307,0,1420,2755,-10
19903270897,19903270900,3,1819,1498,-10
19904226856,19904226857,1,1361,2000,-10
19906335300,19906335301,1,1214,1262,-10
19908639302,19908639305,3,2366,1651,-10
19910119083,19910119083,0,1588,2121,-10
19910495869,19910495869,0,844,1197,-10
19916303263,19916303265,2,1749,1466,-10
19916593346,19916593349,3,1845,2041,-10
19919953627,19919953630,3,1506,1501,-10
19923798527,19923798526,-1,1288,1525,-10
19924371310,19924371311,1,1806,2190,-10
19926135357,19926135359,2,1531,2294,-10
19926440622,19926440623,1,1291,838,-10
19927741370,19927741371,1,1381,1576,-10
19928682835,19928682835,0,1451,2142,-10
19929096134,19929096135,1,1125,1549,-10
19933033933,19933033938,5,1491,1343,-10
19934499785,19934499778,-7,1434,1426,-10
19936481205,19936481207,2,1494,1700,-10
19939905562,19939905563,1,1707,1973,-10
19940162466,19940162469,3,1373,1598,-10
19944788969,19944788971,2,1920,1943,-10
19945503959,19945503961,2,1291,1352,-10
19947514462,19947514463,1,1634,1861,-10
19948906726,19948906727,1,2008,1697,-10
19949431797,19949431798,1,1454,1864,-10
19952171844,19952171847,3,1950,1219,-10
19953538959,19953538963,4,1652,1310,-10
19955985394,19955985398,4,3798,2045,-10
19956368758,19956368760,2,1836,1338,-10
19958697420,19958697420,0,1241,2184,-10
19961415266,19961415267,1,1468,1301,-10
19962407513,19962407515,2,1584,1436,-10
19962535394,19962535398,4,1603,1787,-10
19965803845,19965803845,0,1465,1603,-10
19967792534,19967792534,0,1520,2451,-10
19967848139,19967848146,7,3182,1124,-10
19968274046,19968274047,1,893,1412,-10
19970564030,19970564033,3,1853,1951,-10
19970673545,19970673546,1,1764,1930,-10
19972469498,19972469501,3,1668,1896,-10
19975278653,19975278654,1,984,1086,-10
19976145369,19976145370,1,2175,2141,-10
19977357576,19977357577,1,1598,1205,-10
19978610262,19978610254,-8,924,4905,-10
19982106618,19982106621,3,523,853,-10
19984551173,19984551174,1,1801,1334,-10
19989632693,19989632694,1,1940,2002,-10
19994436414,19994436417,3,1609,1717,-10
19995070601,19995070606,5,1540,1237,-10
20000364162,20000364151,-11,10022,26755,-10
20005271290,20005271294,4,2042,974,-10
20006705167,20006705169,2,1327,1355,-10
20009483384,20009483386,2,4146,2760,-10
20012294942,20012294947,5,1994,1035,-10
20012341214,20012341194,-20,1431,1422,-10
20014845298,20014845301,3,1910,2160,-10
20016181522,20016181522,0,1164,1608,-10
20017981353,20017981352,-1,1256,2102,-10
20018168788,20018168787,-1,2102,2736,-10
20018277810,20018277813,3,1594,2408,-10
20018798074,20018798074,0,1322,900,-10
20023239847,20023239848,1,1049,1220,-10
20026528555,20026528558,3,1324,1432,-10
20027543102,20027543082,-20,1128,401,-10
20033127362,20033127365,3,1760,1482,-10
20035109802,20035109803,1,1553,1394,-10
20035152702,20035152705,3,2004,1047,-10
20036652922,20036652925,3,2268,2155,-10
20037691772,20037691770,-2,1478,1685,-10
20040185758,20040185761,3,1238,1439,-10
20043180734,20043180738,4,1225,1377,-10
20044030162,20044030165,3,1770,1648,-10
20044930099,20044930100,1,1514,1584,-10
20045206889,20045206893,4,1414,1538,-10
20045403109,20045403112,3,1743,1242,-10
20045994695,20045994694,-1,1351,1789,-10
20047033907,20047033909,2,1300,1432,-10
20048476295,20048476298,3,1747,1827,-10
20049101338,20049101339,1,1426,1276,-10
20049450745,20049450746,1,1498,1203,-10
20052302772,20052302772,0,1489,1997,-10
20052554891,20052554907,16,752,644,-10
20052731039,20052731039,0,1832,1881,-10
20053624192,20053624194,2,1590,1772,-10
20057518019,20057518018,-1,1168,1376,-10
20059089401,20059089397,-4,655,2834,-10
20059179573,20059179577,4,1413,1542,-10
20059914900,20059914901,1,1974,1687,-10
20063856300,20063856299,-1,1505,1652,-10
20066005766,20066005766,0,1435,1328,-10
20066436046,20066436049,3,1624,1024,-10
20068758182,20068758183,1,1139,1309,-10
20070525525,20070525530,5,1826,1486,-10
20071326841,20071326843,2,1472,1705,-10
20073661866,20073661869,3,1447,1547,-10
20074940146,20074940148,2,1317,1464,-10
20075882651,20075882653,2,1543,1838,-10
20076825059,20076825062,3,1795,1433,-10
20077791722,20077791723,1,1803,1242,-10
20081136203,20081136202,-1,1008,2379,-10
20083088253,20083088253,0,1572,1478,-10
20084778567,20084778567,0,1232,1317,-10
20085165924,20085165924,0,1171,1703,-10
20087018482,20087018487,5,1645,1205,-10
20087352117,20087352120,3,905,1582,-10
20090053937,20090053940,3,1063,1517,-10
20090391434,20090391429,-5,1050,3317,-10
20091395441,20091395439,-2,907,676,-10
20092812626,20092812633,7,6017,1742,-10
20096242622,20096242622,0,1841,1096,-10
20096645842,20096645846,4,1563,1469,-10
20098036921,20098036926,5,1615,1574,-10
20098936224,20098936226,2,1250,1830,-10
20107381885,20107381885,0,1087,1372,-10
20111993069,20111993071,2,1949,1475,-10
20115964987,20115964987,0,1072,1022,-10
20117201742,20117201742,0,1317,1623,-10
20119739551,20119739554,3,1116,1296,-10
20121338139,20121338142,3,1333,1517,-10
20121395890,20121395890,0,1085,1169,-10
20123517454,20123517453,-1,1412,1287,-10
20123834503,20123834505,2,1454,1509,-10
20124424282,20124424283,1,1116,1278,-10
20127695174,20127695178,4,1131,1110,-10
20128157227,20128157215,-12,666,541,-10
20132267976,20132267979,3,1078,1665,-10
20133343919,20133343922,3,1601,1494,-10
20134576798,20134576779,-19,798,792,-10
20139014705,20139014707,2,2144,2026,-10
20143839961,20143839964,3,2008,1872,-10
20146392486,20146392489,3,2381,1954,-10
20146979140,20146979142,2,1340,1194,-10
20147685067,20147685069,2,2090,1595,-10
20154479607,20154479610,3,1378,1501,-10
20155459841,20155459840,-1,2010,3652,-10
20156366712,20156366714,2,1942,1711,-10
20156965575,20156965574,-1,1086,1468,-10
20163053174,20163053177,3,1130,1142,-10
20163816483,20163816484,1,1738,1674,-10
20164182239,20164182239,0,1876,2028,-10
20166449421,20166449423,2,1024,1351,-10
20181309106,20181309110,4,1531,1316,-10
20183011402,20183011409,7,4499,2545,-10
20184151546,20184151549,3,1548,1617,-10
20184298609,20184298610,1,1055,1127,-10
20189726043,20189726050,7,2972,1317,-10
20191173652,20191173653,1,1007,1391,-10
20194612760,20194612755,-5,793,1818,-10
20195342004,20195342006,2,2427,1363,-10
20195501019,20195501003,-16,1493,952,-10
20197041890,20197041890,0,1271,1167,-10
20197565034,20197565037,3,1280,1186,-10
20197643138,20197643155,17,1312,1664,-10
20200514227,20200514230,3,1904,1467,-10
20203008102,20203008123,21,2053,1613,-10
20206176711,20206176715,4,2228,1670,-10
20206236265,20206236268,3,2672,1909,-10
20209520870,20209520873,3,1300,1021,-10
20218523737,20218523739,2,829,1021,-10
20224997295,20224997297,2,1539,2127,-10
20226030810,20226030810,0,1150,1130,-10
20231882649,20231882654,5,1360,1071,-10
20234060987,20234060989,2,1443,1300,-10
20234313462,20234313463,1,1633,1452,-10
20238438325,20238438327,2,1202,1194,-10
20243349683,20243349682,-1,1662,1158,-10
20246836746,20246836749,3,1135,1130,-10
20249098952,20249098970,18,1206,1543,-10
20249590615,20249590618,3,1857,1526,-10
20250725483,20250725486,3,1851,1737,-10
20252837422,20252837423,1,1262,1426,-10
20256279162,20256279165,3,2003,1127,-10
20257102184,20257102188,4,1317,1300,-10
20258837821,20258837825,4,2361,947,-10
20258887071,20258887072,1,1543,1295,-10
20260240145,20260240146,1,1893,1277,-10
20262785086,20262785086,0,1668,1932,-10
20264105566,20264105569,3,916,1027,-10
20266558169,20266558172,3,1302,1325,-10
20269730762,20269730763,1,1168,1058,-10
20270628989,20270628993,4,2317,1415,-10
20271906345,20271906346,1,1274,1373,-10
20274744221,20274744225,4,1918,1637,-10
20277052110,20277052113,3,1461,1441,-10
20278781029,20278781034,5,1535,1463,-10
20279787578,20279787578,0,742,1058,-10
20280770391,20280770392,1,1832,1856,-10
20283433997,20283433999,2,1249,1957,-10
20283588192,20283588196,4,1664,1030,-10
20284010810,20284010813,3,1475,1970,-10
20284306299,20284306303,4,1460,929,-10
20284631603,20284631606,3,961,1385,-10
20284899454,20284899457,3,1512,2472,-10
20285495503,20285495505,2,1225,1441,-10
20290132477,20290132478,1,1488,1544,-10
20291214771,20291214775,4,1705,1152,-10
20291300334,20291300338,4,1442,1216,-10
20296157997,20296158004,7,1348,1349,-10
20298761364,20298761366,2,1492,1472,-10
20298823993,20298823995,2,2369,2257,-10
20299492654,20299492656,2,2319,1723,-10
20300244207,20300244205,-2,1350,2213,-10
20301055426,20301055427,1,1462,1504,-10
20302737131,20302737132,1,1975,1516,-10
20302978748,20302978750,2,1957,2070,-10
20304104678,20304104681,3,1367,1646,-10
20305281917,20305281919,2,1089,1223,-10
20311136807,20311136807,0,1483,1208,-10
20312944156,20312944143,-13,1291,1537,-10
20314369479,20314369482,3,1421,1736,-10
20314694134,20314694137,3,1571,1549,-10
20315448862,20315448867,5,8373,4166,-10
20317005490,20317005493,3,1629,1476,-10
20318485737,20318485739,2,1346,1659,-10
20318858276,20318858275,-1,1421,1988,-10
20329213348,20329213342,-6,1416,1151,-10
20329774119,20329774120,1,1983,1615,-10
20330173264,20330173277,13,25,764,-10
20335401894,20335401899,5,1622,1353,-10
20336409591,20336409593,2,607,651,-10
20339040957,20339040962,5,1124,646,-10
20345527774,20345527774,0,1542,1764,-10
20347540467,20347540470,3,1036,1399,-10
20347843659,20347843641,-18,1754,1497,-10
20350957448,20350957450,2,2129,1632,-10
20351909779,20351909782,3,2262,1597,-10
20352839403,20352839402,-1,2064,3316,-10
20354264646,20354264648,2,2018,1871,-10
20358697702,20358697702,0,1436,1676,-10
20360169830,20360169818,-12,12650,39561,-10
20361789275,20361789274,-1,1562,1259,-10
20365164523,20365164515,-8,1575,10735,-10
20366465854,20366465857,3,1025,1028,-10
20366827734,20366827735,1,1961,1822,-10
20367580390,20367580390,0,1437,1157,-10
20368724939,20368724938,-1,1060,1420,-10
20372842578,20372842581,3,1299,1021,-10
20373189257,20373189261,4,1282,1301,-10
20379833910,20379833910,0,1276,1310,-10
20380166434,20380166439,5,1899,1402,-10
20390974422,20390974429,7,2931,663,-10
20393107573,20393107573,0,1387,1426,-10
20394136608,20394136611,3,1418,1570,-10
20402247733,20402247734,1,2126,1614,-10
20403181685,20403181688,3,1478,1207,-10
20405466269,20405466273,4,2769,2312,-10
20407221004,20407221002,-2,2765,3809,-10
20408730433,20408730434,1,2553,2073,-10
20409898495,20409898497,2,1422,1570,-10
20411442954,20411442953,-1,1497,2440,-10
20412677449,20412677450,1,1697,1796,-10
20415897298,20415897300,2,1527,1795,-10
20417970182,20417970187,5,2260,1037,-10
20418417032,20418417040,8,651,261,-10
20419731003,20419731002,-1,1377,1850,-10
20419773471,20419773474,3,798,1156,-10
20421069601,20421069603,2,2439,2342,-10
20429234485,20429234489,4,2120,2370,-10
20429862034,20429862033,-1,1364,1341,-10
20431635592,20431635593,1,1084,1271,-10
20435318910,20435318914,4,1427,1288,-10
20435749305,20435749308,3,1742,2024,-10
20437079810,20437079811,1,1470,1583,-10
20443946750,20443946752,2,1884,1539,-10
20444116298,20444116303,5,1557,1497,-10
20445547175,20445547177,2,2277,1634,-10
20449376773,20449376777,4,2321,1525,-10
20450242141,20450242142,1,1349,1408,-10
20453493213,20453493220,7,2201,1348,-10
20455524372,20455524374,2,1152,1708,-10
20456936360,20456936363,3,1553,1785,-10
20457389338,20457389341,3,1227,1066,-10
20460168553,20460168555,2,1323,1767,-10
20462156503,20462156505,2,1205,1152,-10
20462469738,20462469743,5,1443,1031,-10
20465837956,20465837955,-1,1430,1911,-10
20466222373,20466222375,2,2443,1559,-10
20467708784,20467708781,-3,1989,2063,-10
20470573292,20470573295,3,1294,1480,-10
20471683844,20471683851,7,2163,943,-10
20473349705,20473349706,1,2230,1841,-10
20474677706,20474677710,4,1284,1438,-10
20479265854,20479265857,3,1901,1600,-10
20480472153,20480472149,-4,1209,2569,-10
20480645084,20480645083,-1,901,812,-10
20481047739,20481047740,1,2456,2079,-10
20483949342,20483949347,5,1185,897,-10
20484925223,20484925224,1,1065,1305,-10
20485518040,20485518042,2,1529,1128,-10
20488768567,20488768571,4,2129,1557,-10
20489239967,20489239969,2,1422,1754,-10
20490751510,20490751505,-5,669,2018,-10
20491932759,20491932762,3,1787,1645,-10
20497762452,20497762450,-2,1202,1655,-10
20497881665,20497881667,2,1909,2303,-10
20500518897,20500518898,1,1381,1672,-10
20502091599,20502091601,2,1693,2268,-10
20503358585,20503358575,-10,1358,1136,-10
20503893537,20503893539,2,1484,1040,-10
20504314813,20504314815,2,1577,1990,-10
20504930607,20504930609,2,1386,1625,-10
20505365346,20505365347,1,1385,1232,-10
20507545421,20507545422,1,1647,1536,-10
20513887437,20513887440,3,1709,1393,-10
20514660898,20514660899,1,1049,1337,-10
20514891164,20514891165,1,2187,2098,-10
20516493169,20516493170,1,1447,1687,-10
20517330537,20517330541,4,1983,1904,-10
20518009958,20518009953,-5,887,2608,-10
20518120183,20518120183,0,1020,1186,-10
20518394439,20518394441,2,2035,2182,-10
20519816543,20519816546,3,1540,1369,-10
20521580237,20521580240,3,1179,1030,-10
20522113293,20522113295,2,1487,1698,-10
20522321036,20522321043,7,3436,1164,-10
20523197087,20523197090,3,1753,1529,-10
20524859055,20524859055,0,1105,1018,-10
20527000779,20527000782,3,1891,2079,-10
20531201398,20531201398,0,1468,1090,-10
20532530967,20532530970,3,1237,1249,-10
20533755852,20533755853,1,939,1211,-10
20535347514,20535347515,1,1673,2960,-10
20536198359,20536198359,0,1006,996,-10
20543929006,20543929009,3,1684,1905,-10
20548007790,20548007790,0,1554,1451,-10
20549225154,20549225155,1,2192,1678,-10
20550225391,20550225392,1,1444,1479,-10
20551035223,20551035227,4,1484,1256,-10
20556661272,20556661274,2,1457,1977,-10
20558847691,20558847693,2,984,861,-10
20561395071,20561395051,-20,1484,1360,-10
20563646411,20563646413,2,1981,1939,-10
20570137180,20570137182,2,1865,1860,-10
20570923806,20570923807,1,1310,1187,-10
20574221346,20574221343,-3,888,2601,-10
20575096094,20575096099,5,2041,1554,-10
20576075987,20576075990,3,1187,1290,-10
20576964133,20576964134,1,1399,1764,-10
20579030374,20579030375,1,1839,1567,-10
20579675702,20579675704,2,1477,1160,-10
20580264730,20580264730,0,1321,1558,-10
20581443595,20581443596,1,1779,1392,-10
20582028345,20582028347,2,1243,1653,-10
20584427822,20584427825,3,1605,1462,-10
20587843418,20587843425,7,6226,2165,-10
20588225074,20588225074,0,1676,2099,-10
20588555272,20588555273,1,1734,2388,-10
20589619571,20589619576,5,1572,1043,-10
20589736616,20589736619,3,1416,1759,-10
20591591134,20591591134,0,1491,1331,-10
20592734718,20592734710,-8,2041,10178,-10
20592946727,20592946730,3,2103,2034,-10
20593704884,20593704888,4,1909,1813,-10
20597123973,20597123975,2,1586,1054,-10
20602810602,20602810598,-4,1593,4310,-10
20603803470,20603803475,5,1296,1070,-10
20606467598,20606467618,20,1248,869,-10
20609409952,20609409954,2,1678,1860,-10
20612730667,20612730669,2,1452,973,-10
20615199101,20615199104,3,2030,1354,-10
20622479466,20622479466,0,2036,2329,-10
20622825208,20622825211,3,1825,1365,-10
20625329833,20625329834,1,1608,2178,-10
20629770789,20629770792,3,1376,1985,-10
20630706293,20630706295,2,1394,1530,-10
20630930862,20630930864,2,2110,1878,-10
20631729486,20631729487,1,2232,1246,-10
20633888007,20633888008,1,1670,1549,-10
20638426958,20638426958,0,1052,1891,-10
20640568097,20640568101,4,1349,1448,-10
20641905202,20641905203,1,1304,1739,-10
20642777031,20642777033,2,1917,1766,-10
20644129041,20644129045,4,2125,1676,-10
20645558891,20645558893,2,2073,1906,-10
20647759036,20647759037,1,1756,1880,-10
20647909474,20647909474,0,1447,1843,-10
20651895790,20651895790,0,1559,1208,-10
20656115049,20656115052,3,1791,1791,-10
20660050317,20660050319,2,1783,1585,-10
20660141086,20660141089,3,1420,1093,-10
20660519899,20660519899,0,2092,1500,-10
20661895754,20661895758,4,1733,1336,-10
20662346217,20662346223,6,3278,1425,-10
20668113315,20668113316,1,1652,1696,-10
20668490494,20668490494,0,1165,964,-10
20669050372,20669050374,2,1652,1718,-10
20669541690,20669541696,6,1936,1473,-10
20672637898,20672637913,15,1445,1508,-10
20673782157,20673782158,1,1425,1107,-10
20676325523,20676325527,4,1774,1587,-10
20682501594,20682501598,4,1616,1467,-10
20684432606,20684432605,-1,1078,1202,-10
20688647939,20688647936,-3,928,2060,-10
20688835089,20688835091,2,1516,1261,-10
20689736140,20689736147,7,9315,24903,-10
20690859531,20690859531,0,1218,1254,-10
20696964148,20696964150,2,2181,1404,-10
20697841598,20697841602,4,2522,1618,-10
20698162607,20698162607,0,1151,962,-10
20701023225,20701023226,1,1548,1470,-10
20704146121,20704146122,1,1698,1810,-10
20704948347,20704948349,2,1829,1896,-10
20705081598,20705081600,2,1023,1190,-10
20715910449,20715910447,-2,1402,2460,-10
20718159242,20718159245,3,1703,1587,-10
20721810226,20721810229,3,1604,1897,-10
20723940573,20723940576,3,4360,3607,-10
20724555334,20724555334,0,1713,1552,-10
20725992694,20725992695,1,1232,1268,-10
20726291618,20726291618,0,1540,1475,-10
20726952386,20726952389,3,1428,1450,-10
20728250820,20728250824,4,2263,1506,-10
20729360025,20729360028,3,1282,1447,-10
20733348094,20733348094,0,1113,1350,-10
20736894807,20736894811,4,1481,1221,-10
20736981971,20736981973,2,1269,1684,-10
20740727338,20740727343,5,1902,1238,-10
20745002401,20745002401,0,1441,1123,-10
20747393750,20747393748,-2,1337,2084,-10
20757210526,20757210530,4,2567,1324,-10
20758036178,20758036180,2,1606,1650,-10
20758977627,20758977627,0,1388,1831,-10
20761343047,20761343048,1,1102,1132,-10
20762477765,20762477766,1,1326,910,-10
20765100873,20765100877,4,2124,2046,-10
20765580853,20765580853,0,1698,1711,-10
20767480382,20767480383,1,870,1165,-10
20769370899,20769370899,0,1284,2229,-10
20770716241,20770716241,0,1329,1775,-10
20771928251,20771928251,0,1053,1894,-10
20777795009,20777795013,4,1922,1107,-10
20778872377,20778872375,-2,1207,2172,-10
20785463958,20785463958,0,1388,1367,-10
20786628222,20786628226,4,1466,971,-10
20787068846,20787068847,1,1315,1929,-10
20788067913,20788067916,3,1959,1641,-10
20791911721,20791911722,1,1171,2243,-10
20793856412,20793856413,1,1222,1245,-10
20794912577,20794912578,1,1616,1730,-10
20803568735,20803568737,2,2107,2258,-10
20808184969,20808184970,1,1467,1624,-10
20814914777,20814914786,9,6169,1389,-10
20817781315,20817781316,1,2108,1812,-10
20818568079,20818568084,5,2927,1145,-10
20819409117,20819409117,0,1751,1712,-10
20824764709,20824764715,6,1339,1016,-10
20826275255,20826275269,14,739,1094,-10
20827703821,20827703825,4,1502,1445,-10
20829143380,20829143388,8,15832,39313,-10
20830267854,20830267857,3,1394,1628,-10
20830508906,20830508908,2,2409,2122,-10
20831187230,20831187231,1,1918,1907,-10
20836813554,20836813559,5,1194,1113,-10
20837604340,20837604322,-18,178,726,-10
20844227953,20844227957,4,1795,1343,-10
20846228030,20846228031,1,1124,1597,-10
20847340450,20847340451,1,1352,1662,-10
20847807085,20847807087,2,1547,1505,-10
20850278280,20850278282,2,1355,1316,-10
20851556658,20851556661,3,1581,1915,-10
20851926669,20851926676,7,5351,1593,-10
20852367446,20852367447,1,1046,1194,-10
20853842226,20853842226,0,1227,1556,-10
20853939506,20853939500,-6,23075,12377,-10
20857028242,20857028243,1,1758,1093,-10
20857446538,20857446539,1,865,1150,-10
20857822993,20857822994,1,1528,1534,-10
20860006568,20860006569,1,1351,1873,-10
20860286410,20860286411,1,1420,909,-10
20862379925,20862379927,2,1492,1638,-10
20864453558,20864453563,5,710,1011,-10
20865778606,20865778610,4,1133,1065,-10
20868703419,20868703418,-1,875,1197,-10
20872251959,20872251957,-2,972,1494,-10
20872653222,20872653227,5,1423,1422,-10
20875352775,20875352778,3,1463,1361,-10
20877654152,20877654150,-2,1004,1813,-10
20878637808,20878637809,1,1330,1312,-10
20882251609,20882251610,1,1498,1075,-10
20886251814,20886251815,1,2205,1472,-10
20887429582,20887429584,2,1223,1080,-10
20889681446,20889681446,0,10234,12833,-10
20894924282,20894924282,0,1478,993,-10
20895230986,20895230987,1,948,1359,-10
20895655240,20895655241,1,1667,1525,-10
20896382817,20896382819,2,1921,1791,-10
20897696075,20897696074,-1,1618,1402,-10
20898582394,20898582397,3,1081,1276,-10
20899621082,20899621084,2,1346,1477,-10
20901314075,20901314078,3,1035,1146,-10
20904124377,20904124377,0,1400,2032,-10
20906545574,20906545577,3,1654,1529,-10
20907047539,20907047538,-1,1519,1810,-10
20908946237,20908946238,1,1395,1560,-10
20910785130,20910785130,0,1530,1596,-10
20910951481,20910951483,2,1145,1271,-10
20911380602,20911380604,2,1023,1048,-10
20912059767,20912059748,-19,1292,1716,-10
20917777380,20917777384,4,1024,1247,-10
20920161278,20920161278,0,1259,1383,-10
20923449823,20923449825,2,1721,1334,-10
20923824733,20923824738,5,2817,1581,-10
20926757822,20926757824,2,1532,2077,-10
20932005520,20932005522,2,1391,1550,-10
20933377286,20933377287,1,1732,1673,-10
20935622731,20935622731,0,1369,1638,-10
20938314892,20938314893,1,1616,1534,-10
20938883263,20938883264,1,1968,1752,-10
20940907699,20940907701,2,2220,2135,-10
20944534236,20944534240,4,1604,1712,-10
20946657866,20946657866,0,2221,2355,-10
20948053717,20948053710,-7,1085,4615,-10
20950652270,20950652272,2,1181,1666,-10
20951725033,20951725026,-7,1842,2131,-10
20953627192,20953627195,3,1300,876,-10
20954888886,20954888887,1,1698,1540,-10
20955583511,20955583514,3,1273,1266,-10
20955927557,20955927558,1,2320,1918,-10
20956184837,20956184840,3,1817,1815,-10
20957392953,20957392954,1,847,1677,-10
20962061477,20962061476,-1,1862,2121,-10
20965128637,20965128637,0,1714,1247,-10
20965425822,20965425824,2,1422,1339,-10
20968379562,20968379566,4,1758,1591,-10
20968523559,20968523537,-22,889,1047,-10
20970966068,20970966071,3,2030,2198,-10
20973850026,20973850028,2,1524,1811,-10
20974049685,20974049686,1,1776,1475,-10
20974176127,20974176138,11,1712,1530,-10
20974326001,20974326019,18,1106,763,-10
20975827795,20975827798,3,1787,1685,-10
20979088730,20979088734,4,1517,1590,-10
20980689454,20980689454,0,1419,1531,-10
20982212281,20982212284,3,1269,1258,-10
20986147612,20986147615,3,1240,1287,-10
20988716031,20988716034,3,1406,1316,-10
20989965171,20989965170,-1,1559,2137,-10
20994238566,20994238570,4,1640,1223,-10
20994405732,20994405735,3,1847,1341,-10
20996277020,20996277025,5,1902,1661,-10
20997143726,20997143726,0,1320,1283,-10
20999863515,20999863516,1,1716,1721,-10
21000643669,21000643670,1,1246,1245,-10
21002386534,21002386538,4,1697,1487,-10
21003499504,21003499505,1,1954,1662,-10
21007616633,21007616635,2,1169,1505,-10
21008307896,21008307898,2,1369,1320,-10
21009664754,21009664755,1,1872,1530,-10
21009959334,21009959337,3,1994,1918,-10
21010111705,21010111706,1,1184,1633,-10
21013242773,21013242775,2,1518,1684,-10
21013352181,21013352183,2,1553,1391,-10
21014911481,21014911483,2,1213,1424,-10
21015358529,21015358529,0,1600,2256,-10
21015596101,21015596103,2,787,791,-10
21019175482,21019175483,1,1418,1682,-10
21023214419,21023214421,2,1607,1802,-10
21024606658,21024606658,0,1372,1581,-10
21025678977,21025678978,1,1670,1242,-10
21028780395,21028780397,2,1303,1803,-10
21032143586,21032143588,2,1462,1654,-10
21032958005,21032958007,2,1540,1412,-10
21033071641,21033071660,19,882,2238,-10
21033116446,21033116448,2,1242,1341,-10
21033665982,21033665983,1,1600,1731,-10
21035681152,21035681153,1,1109,1363,-10
21035779126,21035779127,1,1648,1415,-10
21036585594,21036585597,3,1491,1698,-10
21037583758,21037583759,1,1274,1777,-10
21041878357,21041878358,1,1429,1323,-10
21045342922,21045342923,1,915,1523,-10
21045983854,21045983857,3,1161,1349,-10
21046581498,21046581500,2,2212,1521,-10
21048372729,21048372731,2,1665,1823,-10
21048475373,21048475374,1,1798,1726,-10
21051392481,21051392481,0,2391,2514,-10
21051486784,21051486786,2,1756,1113,-10
21055542913,21055542914,1,1259,1742,-10
21056002557,21056002556,-1,1908,2138,-10
21056959519,21056959521,2,712,711,-10
21057466895,21057466898,3,1612,1588,-10
21059315761,21059315765,4,1737,1536,-10
21060880515,21060880518,3,1411,1209,-10
21062809501,21062809505,4,2721,2035,-10
21063127038,21063127040,2,697,1037,-10
21063958138,21063958141,3,1167,1010,-10
21070845310,21070845311,1,1185,1640,-10
21072104765,21072104766,1,4505,17061,-10
21072970039,21072970042,3,1555,1254,-10
21074182300,21074182302,2,1474,1784,-10
21074731976,21074731979,3,1488,1523,-10
21075615587,21075615590,3,1873,1514,-10
21077811560,21077811561,1,1719,1911,-10
21079763124,21079763124,0,2078,2134,-10
21081368038,21081368042,4,1883,2161,-10
21081916226,21081916228,2,2097,1487,-10
21084207307,21084207308,1,1460,1072,-10
21086943782,21086943784,2,1455,2174,-10
21091883518,21091883519,1,565,659,-10
21092224687,21092224697,10,1191,1184,-10
21093867977,21093867979,2,1050,1466,-10
21095718875,21095718878,3,1777,1538,-10
21097293066,21097293062,-4,1068,3326,-10
21099389649,21099389650,1,1600,1477,-10
21105792762,21105792764,2,1726,1136,-10
21106402246,21106402248,2,1035,1378,-10
21107053732,21107053733,1,1726,2111,-10
21107786148,21107786150,2,1619,1318,-10
21108374886,21108374891,5,1220,1107,-10
21109844102,21109844104,2,1693,1525,-10
21113257417,21113257417,0,1667,1153,-10
21114018937,21114018938,1,1887,1783,-10
21114862371,21114862373,2,1055,1070,-10
21118250833,21118250835,2,1582,2211,-10
21118481150,21118481153,3,1235,1477,-10
21128533858,21128533860,2,1207,1326,-10
21131123210,21131123210,0,2056,2407,-10
21131325505,21131325505,0,1148,1561,-10
21132266882,21132266883,1,2949,1539,-10
21139547180,21139547183,3,2116,1585,-10
21144423187,21144423189,2,1568,1713,-10
21145576595,21145576598,3,1698,1085,-10
21147131596,21147131619,23,997,1101,-10
21152998328,21152998328,0,1284,1894,-10
21153357306,21153357307,1,1149,1681,-10
21155738286,21155738287,1,1360,1449,-10
21156712954,21156712957,3,2148,1910,-10
21157521498,21157521498,0,1339,1627,-10
21157654462,21157654482,20,1281,1436,-10
21158528955,21158528958,3,1197,1324,-10
21159435081,21159435082,1,1837,1757,-10
21163115587,21163115587,0,1626,1467,-10
21164308597,21164308597,0,1805,895,-10
21172819514,21172819518,4,6516,4490,-10
21175294879,21175294882,3,1481,1790,-10
21175685878,21175685878,0,1656,1449,-10
21180152078,21180152079,1,1608,2099,-10
21181791885,21181791889,4,1622,1362,-10
21184470871,21184470873,2,1335,1627,-10
21185612550,21185612551,1,1631,1861,-10
21185900425,21185900447,22,1303,2098,-10
21188932632,21188932634,2,1729,1293,-10
21190285186,21190285187,1,1531,1684,-10
21192516709,21192516711,2,1630,1739,-10
21195608241,21195608238,-3,1332,3631,-10
21199399370,21199399370,0,991,1828,-10
21200319529,21200319530,1,1655,1836,-10
21201565426,21201565428,2,835,923,-10
21203121860,21203121862,2,1885,1528,-10
21204106727,21204106727,0,1007,1946,-10
21204673278,21204673278,0,932,1697,-10
21205881379,21205881382,3,1536,1423,-10
21205968425,21205968418,-7,1282,1454,-10
21211076484,21211076486,2,1487,1411,-10
21211945694,21211945695,1,1194,1433,-10
21212251205,21212251207,2,1783,1397,-10
21217001514,21217001534,20,837,1679,-10
21218893557,21218893557,0,1706,2272,-10
21221677861,21221677864,3,2345,2303,-10
21222030070,21222030070,0,1440,1474,-10
21226745163,21226745166,3,1589,1327,-10
21226839761,21226839762,1,1474,1525,-10
21227194593,21227194597,4,847,1228,-10
21230001838,21230001841,3,2098,2094,-10
21234386286,21234386286,0,1810,2431,-10
21235904386,21235904387,1,1438,1626,-10
21236436074,21236436075,1,1148,1149,-10
21238903137,21238903134,-3,833,2086,-10
21241057270,21241057271,1,906,1762,-10
21243168739,21243168741,2,1502,1793,-10
21243495410,21243495413,3,1840,1780,-10
21244849484,21244849486,2,1663,1256,-10
21245521595,21245521601,6,1771,1076,-10
21251093621,21251093623,2,2326,1631,-10
21252440154,21252440157,3,1530,2283,-10
21253796361,21253796363,2,1144,973,-10
21255163941,21255163942,1,1358,1556,-10
21255458490,21255458487,-3,1192,1828,-10
21259866353,21259866356,3,2166,2022,-10
21261177774,21261177775,1,3628,1449,-10
21266669598,21266669601,3,1717,1233,-10
21267225842,21267225841,-1,1095,1362,-10
21268797378,21268797382,4,1384,1516,-10
21269675163,21269675162,-1,1233,1408,-10
21269900273,21269900277,4,2658,1736,-10
21275615529,21275615530,1,1749,1547,-10
21278432012,21278432015,3,1830,1242,-10
21279070897,21279070899,2,1220,1797,-10
21279494341,21279494343,2,1419,790,-10
21280496601,21280496604,3,1440,1273,-10
21282355909,21282355910,1,1223,775,-10
21283138121,21283138123,2,1310,1498,-10
21285084431,21285084435,4,2093,2166,-10
21286374181,21286374186,5,1381,1201,-10
21289185905,21289185905,0,1884,2491,-10
21291392062,21291392063,1,1346,1429,-10
21291910530,21291910534,4,2699,1181,-10
21293568133,21293568135,2,1419,1335,-10
21294152075,21294152077,2,1855,1844,-10
21295869851,21295869850,-1,1606,1431,-10
21298264934,21298264936,2,1501,1990,-10
21305302007,21305302010,3,2333,1814,-10
21308467792,21308467793,1,1785,1807,-10
21309357336,21309357355,19,1397,967,-10
21315194493,21315194495,2,1618,1252,-10
21317505148,21317505150,2,2048,1570,-10
21318553489,21318553491,2,1554,1907,-10
21319512806,21319512809,3,1863,1529,-10
21320182739,21320182741,2,1442,1512,-10
21323635367,21323635369,2,1100,1366,-10
21323857665,21323857667,2,1742,1431,-10
21325344283,21325344287,4,1528,1272,-10
21325757166,21325757171,5,2030,1752,-10
21326171569,21326171569,0,1496,1608,-10
21326437800,21326437799,-1,989,1222,-10
21328567209,21328567210,1,1617,1216,-10
21332862557,21332862557,0,1187,1605,-10
21333392409,21333392410,1,1654,1516,-10
21336662581,21336662582,1,1960,2270,-10
21336884442,21336884446,4,2491,1524,-10
21340303778,21340303778,0,1303,1610,-10
21345180298,21345180300,2,3307,2005,-10
21345747931,21345747935,4,1372,920,-10
21347869076,21347869078,2,1406,1887,-10
21348415915,21348415914,-1,1114,1297,-10
21349043433,21349043440,7,2052,1641,-10
21349709185,21349709186,1,1309,1971,-10
21351553741,21351553743,2,1449,1545,-10
21355917301,21355917302,1,952,1067,-10
21357143823,21357143822,-1,1381,1263,-10
21360392111,21360392113,2,1416,1585,-10
21363326671,21363326673,2,1600,1281,-10
21364947981,21364947982,1,2477,2123,-10
21365008786,21365008786,0,1618,1899,-10
21365173873,21365173876,3,1951,1587,-10
21365750974,21365750955,-19,2419,1657,-10
21369333619,21369333621,2,1787,2103,-10
21370528960,21370528960,0,1849,1308,-10
21371475760,21371475779,19,1472,1629,-10
21371857907,21371857910,3,1168,1532,-10
21372329082,21372329084,2,1451,1556,-10
21372808145,21372808146,1,1308,1188,-10
21374739882,21374739881,-1,1918,1737,-10
21378881935,21378881937,2,1078,963,-10
21379999587,21379999589,2,1821,2072,-10
21383869273,21383869275,2,1083,1384,-10
21384445639,21384445637,-2,1158,1930,-10
21386171428,21386171430,2,2360,1433,-10
21387571599,21387571602,3,1004,1136,-10
21394241540,21394241542,2,1985,1634,-10
21395906678,21395906681,3,1525,1494,-10
21397187955,21397187958,3,1804,1656,-10
21402760367,21402760373,6,1881,1935,-10
21406273757,21406273759,2,1333,1675,-10
21407371702,21407371703,1,753,1052,-10
21408535155,21408535159,4,1321,1812,-10
21409355998,21409356000,2,1549,1608,-10
21409961341,21409961346,5,3118,1574,-10
21411595802,21411595804,2,1894,1991,-10
21412128085,21412128089,4,1849,1188,-10
21416112788,21416112789,1,1737,1520,-10
21417402014,21417402009,-5,1074,10459,-10
21418213658,21418213659,1,962,1474,-10
21418712450,21418712453,3,1329,1406,-10
21420723081,21420723083,2,1177,700,-10
21423275258,21423275262,4,1570,1392,-10
21424174047,21424174050,3,1158,1548,-10
21426649296,21426649298,2,1543,1436,-10
21429694253,21429694253,0,1221,1008,-10
21433670786,21433670795,9,2688,925,-10
21434347791,21434347812,21,748,271,-10
21435589974,21435589973,-1,1820,2931,-10
21438159528,21438159530,2,1662,1810,-10
21443251737,21443251738,1,1457,1671,-10
21444007342,21444007344,2,2149,2117,-10
21452437133,21452437134,1,1857,1703,-10
21453733792,21453733793,1,1393,1388,-10
21454334702,21454334706,4,1045,1572,-10
21454872533,21454872535,2,637,695,-10
21457760257,21457760258,1,1259,1801,-10
21459378713,21459378713,0,3351,3905,-10
21459887201,21459887202,1,1121,1197,-10
21463136086,21463136086,0,1651,2360,-10
21467449301,21467449303,2,1348,1137,-10
21470279905,21470279910,5,1477,1372,-10
21470383289,21470383290,1,1813,1441,-10
21470703505,21470703522,17,2685,1045,-10
21472327226,21472327226,0,1565,1170,-10
21473299457,21473299458,1,1014,1487,-10
21474018740,21474018739,-1,1602,1493,-10
21474429786,21474429787,1,1518,1305,-10
21474932225,21474932230,5,2949,1629,-10
21479500485,21479500486,1,1815,971,-10
21482910033,21482910034,1,1558,1124,-10
21491091314,21491091309,-5,1384,4835,-10
21492410238,21492410242,4,1958,1169,-10
21492965034,21492965048,14,2144,1695,-10
21493762221,21493762222,1,1348,1231,-10
21495125453,21495125454,1,2006,1883,-10
21495727469,21495727469,0,1340,1213,-10
21497753047,21497753049,2,1712,1657,-10
21500081765,21500081767,2,1459,1339,-10
21500273315,21500273317,2,1796,1417,-10
21501459411,21501459413,2,1272,1273,-10
21501936600,21501936602,2,1328,1413,-10
21504758253,21504758255,2,1738,1470,-10
21506003261,21506003262,1,2280,1813,-10
21507457497,21507457499,2,1644,1083,-10
21509705413,21509705407,-6,1515,5947,-10
21510837944,21510837937,-7,1677,4899,-10
21512197821,21512197822,1,793,1032,-10
21521603202,21521603203,1,1579,1469,-10
21522261494,21522261495,1,1257,1484,-10
21522849438,21522849442,4,1992,2171,-10
21524291374,21524291374,0,1053,1090,-10
21528045652,21528045653,1,1690,1164,-10
21529162414,21529162418,4,1255,942,-10
21529819450,21529819454,4,1818,1506,-10
21530271571,21530271572,1,2299,2179,-10
21532828466,21532828467,1,2069,1579,-10
21532873951,21532873953,2,1816,1411,-10
21534541695,21534541697,2,1533,1226,-10
21535073746,21535073749,3,1772,1745,-10
21535380815,21535380817,2,1398,1894,-10
21535932445,21535932445,0,1308,1735,-10
21536293784,21536293787,3,1433,1576,-10
21536996150,21536996155,5,5849,4097,-10
21538469912,21538469913,1,2080,1622,-10
21539327659,21539327662,3,1791,1705,-10
21539556729,21539556734,5,3651,1543,-10
21539938549,21539938551,2,1691,1396,-10
21544114001,21544114002,1,2042,2891,-10
21546585991,21546585993,2,2351,1767,-10
21547780261,21547780263,2,1327,1815,-10
21547884016,21547884018,2,1592,1538,-10
21550006047,21550006050,3,2078,2314,-10
21550420054,21550420055,1,1304,1341,-10
21550668852,21550668855,3,1856,1667,-10
21550713322,21550713315,-7,1035,992,-10
21553904794,21553904795,1,1651,1395,-10
21555048230,21555048230,0,1729,1605,-10
21555860238,21555860237,-1,2255,3015,-10
21555893992,21555893995,3,3018,1755,-10
21556311595,21556311597,2,2197,1191,-10
21560123657,21560123659,2,1453,1421,-10
21562870785,21562870787,2,1755,1354,-10
21564042159,21564042155,-4,1109,1181,-10
21565745638,21565745650,12,669,209,-10
21566890927,21566890930,3,993,1508,-10
21568465904,21568465926,22,1794,1528,-10
21569156895,21569156896,1,1579,1799,-10
21570164201,21570164205,4,1907,1075,-10
21572107465,21572107466,1,1916,1469,-10
21572559791,21572559793,2,1420,1623,-10
21574775780,21574775777,-3,1144,1235,-10
21576686154,21576686156,2,1772,1606,-10
21577023545,21577023549,4,1609,1422,-10
21579134842,21579134844,2,1380,1448,-10
21580000566,21580000569,3,1035,1515,-10
21581299571,21581299571,0,1817,1582,-10
21586549522,21586549525,3,1200,937,-10
21589884291,21589884286,-5,1898,6478,-10
21592439572,21592439573,1,1148,1574,-10
21593256494,21593256496,2,2057,1917,-10
21595008564,21595008565,1,1342,1458,-10
21596460230,21596460226,-4,505,3292,-10
21603125752,21603125750,-2,1253,1283,-10
21603208162,21603208163,1,1378,888,-10
21605157850,21605157853,3,1524,2118,-10
21607736219,21607736225,6,1476,1258,-10
21608090391,21608090394,3,1206,1519,-10
21610025543,21610025546,3,1602,1729,-10
21610852094,21610852097,3,3362,2012,-10
21614669725,21614669726,1,1509,1718,-10
21615507238,21615507239,1,2535,2162,-10
21617490232,21617490233,1,1709,1485,-10
21617940020,21617940024,4,1979,1334,-10
21618111227,21618111230,3,2407,1869,-10
21619962323,21619962327,4,1746,1270,-10
21620155807,21620155806,-1,1281,1626,-10
21622969952,21622969953,1,1752,1785,-10
21625211361,21625211364,3,1989,1972,-10
21625911652,21625911653,1,1584,1309,-10
21627719661,21627719662,1,1009,1351,-10
21629663528,21629663539,11,237,613,-10
21632683734,21632683734,0,964,1009,-10
21633167739,21633167742,3,1416,1801,-10
21633548321,21633548321,0,1338,960,-10
21634449328,21634449331,3,1301,1360,-10
21634906411,21634906428,17,1467,5299,-10
21636510471,21636510474,3,2036,1839,-10
21636792735,21636792738,3,1929,1836,-10
21636991931,21636991933,2,2006,1390,-10
21637215286,21637215282,-4,1524,4546,-10
21637867354,21637867339,-15,2813,1308,-10
21640923661,21640923662,1,1985,1427,-10
21641482477,21641482467,-10,1058,1234,-10
21642934526,21642934528,2,1595,1640,-10
21643740680,21643740681,1,2023,1295,-10
21646004090,21646004091,1,1818,2331,-10
21647577398,21647577401,3,1756,1366,-10
21648202718,21648202721,3,1594,1465,-10
21648595890,21648595895,5,1238,1120,-10
21653088203,21653088205,2,1617,2000,-10
21655493011,21655493014,3,990,591,-10
21656488021,21656488023,2,1740,1306,-10
21658698006,21658698009,3,2204,1954,-10
21661664727,21661664730,3,1048,1691,-10
21661721396,21661721389,-7,24,712,-10
21662121968,21662121968,0,1566,1474,-10
21663367273,21663367273,0,1598,1928,-10
21668383561,21668383564,3,1288,1304,-10
21669182218,21669182219,1,1328,976,-10
21669848830,21669848834,4,1750,1420,-10
21670505798,21670505801,3,1163,1562,-10
21670780736,21670780738,2,1457,1595,-10
21672270314,21672270296,-18,1216,814,-10
21672709631,21672709629,-2,441,1754,-10
21673298394,21673298393,-1,1002,1796,-10
21679380029,21679380030,1,1181,1194,-10
21680836889,21680836884,-5,814,2876,-10
21681397215,21681397216,1,1198,1269,-10
21684259235,21684259235,0,1408,1282,-10
21689451554,21689451556,2,1084,2130,-10
21689793897,21689793899,2,1365,1655,-10
21691326000,21691326003,3,1589,1908,-10
21693692050,21693692050,0,1647,1411,-10
21696279332,21696279335,3,1372,1092,-10
21699012639,21699012641,2,1687,1505,-10
21701008459,21701008459,0,1241,1471,-10
21703545194,21703545198,4,1818,1086,-10
21704610413,21704610415,2,1506,1151,-10
21705224666,21705224667,1,1636,1712,-10
21707299672,21707299678,6,1819,2005,-10
21707881565,21707881566,1,1386,1811,-10
21709604418,21709604421,3,1903,1446,-10
21710166071,21710166074,3,1208,1392,-10
21710564340,21710564354,14,160,1109,-10
21710854902,21710854904,2,1546,1593,-10
21713172822,21713172822,0,2067,2450,-10
21717283514,21717283511,-3,1119,3389,-10
21720518395,21720518397,2,1258,1707,-10
21720572477,21720572478,1,1378,1808,-10
21721750987,21721750991,4,1013,1305,-10
21722023563,21722023568,5,861,822,-10
21722202986,21722202970,-16,635,315,-10
21724841458,21724841460,2,1426,1503,-10
21733797177,21733797180,3,1406,1161,-10
21738218166,21738218169,3,1198,1059,-10
21741476122,21741476122,0,1554,1231,-10
21746229563,21746229567,4,1076,1515,-10
21746335667,21746335661,-6,1221,2006,-10
21746850476,21746850479,3,1237,1697,-10
21748733141,21748733143,2,1667,1358,-10
21750024045,21750024046,1,1617,1428,-10
21751364114,21751364115,1,1751,1753,-10
21755159921,21755159926,5,1232,1418,-10
21755514567,21755514566,-1,1415,1500,-10
21759922479,21759922479,0,1396,1151,-10
21760119439,21760119443,4,629,163,-10
21763075178,21763075178,0,832,967,-10
21764972178,21764972179,1,2161,2532,-10
21765385466,21765385466,0,1363,1628,-10
21773505779,21773505781,2,1366,1574,-10
21773653967,21773653968,1,1130,1343,-10
21775730656,21775730658,2,826,1174,-10
21776608531,21776608531,0,1814,1224,-10
21777722625,21777722625,0,1213,1275,-10
21779567673,21779567676,3,2239,1323,-10
21787326210,21787326211,1,1454,1447,-10
21789114684,21789114686,2,1555,1606,-10
21790193936,21790193938,2,1579,2092,-10
21792312967,21792312969,2,2088,1647,-10
21792611247,21792611250,3,1378,1517,-10
21794944586,21794944587,1,1263,1823,-10
21796486074,21796486077,3,1729,920,-10
21797378971,21797378973,2,1544,1313,-10
21799629017,21799629018,1,2011,1725,-10
21800265255,21800265256,1,906,1209,-10
21803194666,21803194668,2,1693,1879,-10
21806022359,21806022360,1,1187,1176,-10
21806350165,21806350169,4,1687,1098,-10
21809630962,21809630962,0,638,1693,-10
21810880437,21810880438,1,2348,1996,-10
21815789994,21815789997,3,1712,1238,-10
21817732655,21817732654,-1,1164,2464,-10
21818157751,21818157755,4,1820,1021,-10
21819385697,21819385698,1,1874,1830,-10
21820680844,21820680846,2,1033,1430,-10
21824768789,21824768790,1,1540,1315,-10
21824908027,21824908031,4,3361,2083,-10
21825360575,21825360577,2,1294,1370,-10
21827003027,21827003030,3,1874,2362,-10
21828143594,21828143601,7,1970,1885,-10
21831651351,21831651352,1,1204,1675,-10
21832022435,21832022437,2,1215,1651,-10
21832447458,21832447459,1,1991,1438,-10
21833394624,21833394627,3,1174,1677,-10
21833677211,21833677213,2,1393,1300,-10
21836151519,21836151526,7,6503,1380,-10
21845076977,21845076978,1,1953,1494,-10
21848973861,21848973862,1,1332,1585,-10
21850517207,21850517209,2,1428,1740,-10
21853408182,21853408183,1,1544,1781,-10
21857095298,21857095299,1,1167,1791,-10
21860036103,21860036106,3,2036,1908,-10
21860702601,21860702603,2,1035,1094,-10
21864843941,21864843941,0,1550,1444,-10
21867110046,21867110046,0,1072,1751,-10
21868048977,21868048978,1,1745,1754,-10
21871990305,21871990326,21,1651,2588,-10
21873062888,21873062894,6,2544,1290,-10
21873858641,21873858643,2,1782,1907,-10
21879343489,21879343490,1,1516,1869,-10
21882663879,21882663882,3,1781,1361,-10
21884761825,21884761825,0,1780,2230,-10
21884920723,21884920726,3,1119,1366,-10
21886083127,21886083127,0,1160,662,-10
21888993917,21888993917,0,1010,1145,-10
21892785123,21892785125,2,1213,1266,-10
21893904261,21893904263,2,739,1019,-10
21896934231,21896934227,-4,1052,2919,-10
21899052246,21899052250,4,1247,1214,-10
21901135514,21901135518,4,1403,1460,-10
21902103146,21902103146,0,1588,2549,-10
21903541344,21903541339,-5,1433,4721,-10
21904727152,21904727154,2,2044,1757,-10
21907144519,21907144521,2,1464,2273,-10
21908450866,21908450862,-4,2101,3975,-10
21910037587,21910037589,2,1502,1682,-10
21910162187,21910162190,3,1480,1270,-10
21911105651,21911105652,1,1620,1784,-10
21912831811,21912831811,0,1596,1331,-10
21913792777,21913792782,5,1450,1418,-10
21917136982,21917136983,1,1509,1319,-10
21920049817,21920049817,0,2235,1392,-10
21920839924,21920839927,3,1257,1191,-10
21924770651,21924770653,2,1171,1361,-10
21928051319,21928051321,2,2468,3232,-10
21932081638,21932081617,-21,1561,1364,-10
21932125926,21932125929,3,1250,1250,-10
21932869817,21932869820,3,1829,1656,-10
21934026793,21934026796,3,1410,1924,-10
21934542565,21934542565,0,1345,1716,-10
21937461859,21937461862,3,1781,1405,-10
21940632078,21940632078,0,1163,1393,-10
21941870969,21941870973,4,1361,1554,-10
21945882091,21945882092,1,2058,1832,-10
21946215366,21946215370,4,2364,1933,-10
21950897854,21950897855,1,1528,1312,-10
21951299274,21951299277,3,1388,1612,-10
21951482962,21951482955,-7,1058,3754,-10
21953501569,21953501571,2,1332,1970,-10
21954129651,21954129650,-1,1826,1807,-10
21954483657,21954483659,2,2027,1808,-10
21958996303,21958996306,3,1311,1521,-10
21960670826,21960670828,2,1430,1820,-10
21961995167,21961995167,0,827,1049,-10
21963916835,21963916838,3,1469,1467,-10
21968270761,21968270762,1,1418,1251,-10
21970162950,21970162951,1,1340,1594,-10
21973522614,21973522617,3,1852,1980,-10
21974591662,21974591662,0,1583,1370,-10
21976387507,21976387513,6,2727,1852,-10
21978112451,21978112454,3,1263,1253,-10
21979325594,21979325597,3,1428,1874,-10
21982127278,21982127286,8,2965,2476,-10
21984344967,21984344967,0,1657,1998,-10
21984836814,21984836817,3,1348,1399,-10
21986203365,21986203365,0,1653,1765,-10
21991200767,21991200766,-1,18300,23733,-10
21994428469,21994428471,2,1718,1700,-10
21994798640,21994798642,2,1759,1716,-10
22002328520,22002328521,1,2098,1813,-10
22005473122,22005473121,-1,1452,1982,-10
22011662557,22011662559,2,1662,1616,-10
22012652006,22012652007,1,1770,1526,-10
22012847854,22012847849,-5,728,4268,-10
22013407460,22013407457,-3,24710,55729,-10
22013901709,22013901711,2,1646,1642,-10
22014101222,22014101224,2,1551,1327,-10
22017864543,22017864546,3,1216,1318,-10
22021050235,22021050238,3,2010,1590,-10
22027649074,22027649079,5,2419,2128,-10
22027974600,22027974603,3,1926,2051,-10
22029501114,22029501117,3,1897,1604,-10
22030004348,22030004350,2,1689,1794,-10
22030419654,22030419656,2,1796,1296,-10
22030495448,22030495451,3,1975,1107,-10
22033536945,22033536947,2,1973,1557,-10
22035661776,22035661777,1,1605,1787,-10
22038394126,22038394131,5,3470,1769,-10
22038924370,22038924375,5,1309,1716,-10
22039460166,22039460170,4,1709,1604,-10
22041330731,22041330710,-21,1769,1775,-10
22050082115,22050082115,0,1106,1326,-10
22053601476,22053601478,2,1549,1229,-10
22053785198,22053785199,1,3763,4207,-10
22054118128,22054118129,1,1466,1520,-10
22054880478,22054880485,7,4208,2056,-10
22055047757,22055047756,-1,1979,2349,-10
22056441426,22056441429,3,1384,983,-10
22058358157,22058358158,1,1689,1529,-10
22058809281,22058809283,2,1208,1136,-10
22061234290,22061234272,-18,1397,1279,-10
22062516206,22062516208,2,1924,1685,-10
22065501297,22065501276,-21,4775,1439,-10
22065828302,22065828305,3,1136,1156,-10
22066942984,22066942986,2,1943,1400,-10
22069371172,22069371174,2,1383,1687,-10
22070481055,22070481053,-2,1263,2329,-10
22070592177,22070592172,-5,2486,6083,-10
22073633864,22073633870,6,2096,1478,-10
22075054777,22075054780,3,1449,1125,-10
22077008294,22077008299,5,1918,1325,-10
22078190472,22078190475,3,1913,1734,-10
22079821190,22079821191,1,1306,1331,-10
22086952830,22086952833,3,1330,1569,-10
22090309898,22090309903,5,1790,1248,-10
22090516027,22090516024,-3,23736,78217,-10
22091301616,22091301619,3,1482,1135,-10
22095096548,22095096549,1,1784,1809,-10
22095668466,22095668467,1,1850,2207,-10
22098918549,22098918551,2,1142,1443,-10
22102835027,22102835027,0,1492,2084,-10
22103465234,22103465237,3,1108,1205,-10
22103872460,22103872462,2,1240,748,-10
22104305560,22104305562,2,955,22502,-10
22105672468,22105672470,2,1625,1375,-10
22108468818,22108468820,2,1696,1468,-10
22114259057,22114259060,3,1820,1664,-10
22116772406,22116772409,3,1550,1557,-10
22118915682,22118915686,4,2052,1397,-10
22119614311,22119614311,0,1819,1788,-10
22120672807,22120672809,2,1725,1305,-10
22133414235,22133414235,0,1040,693,-10
22143475961,22143475963,2,1530,1336,-10
22144030756,22144030755,-1,1350,1911,-10
22145982670,22145982670,0,1978,2241,-10
22152892671,22152892673,2,1983,1821,-10
22156074795,22156074796,1,1710,2473,-10
22159324408,22159324411,3,2213,1580,-10
22160967500,22160967502,2,1637,1398,-10
22162687578,22162687581,3,916,1264,-10
22163521724,22163521728,4,1256,1357,-10
22165133390,22165133393,3,952,1377,-10
22168829948,22168829950,2,1352,1390,-10
22169326726,22169326731,5,1814,1809,-10
22171887917,22171887918,1,1658,1600,-10
22172176236,22172176238,2,1995,1954,-10
22173147202,22173147203,1,1015,969,-10
22176125471,22176125471,0,1207,1951,-10
22177097246,22177097232,-14,522,240,-10
22177984198,22177984199,1,2007,1614,-10
22178148905,22178148907,2,1719,1508,-10
22178784546,22178784547,1,1391,1511,-10
22178967858,22178967854,-4,21994,10497,-10
22180494783,22180494787,4,1555,1810,-10
22182038954,22182038956,2,2208,2129,-10
22182524755,22182524770,15,12634,44552,-10
22183474310,22183474314,4,1254,1325,-10
22183827947,22183827949,2,1575,1753,-10
22187571063,22187571063,0,1351,1855,-10
22187971602,22187971604,2,1569,1380,-10
22188432614,22188432616,2,1175,949,-10
22191248107,22191248110,3,1726,1660,-10
22195796129,22195796129,0,1350,1935,-10
22196783609,22196783612,3,2318,1802,-10
22197539416,22197539418,2,1278,2171,-10
22199031478,22199031470,-8,1574,1531,-10
22203640654,22203640654,0,1358,1728,-10
22204105306,22204105311,5,669,1052,-10
22207859654,22207859657,3,2064,1844,-10
22208234867,22208234869,2,1075,717,-10
22209274866,22209274866,0,1197,1660,-10
22209587349,22209587351,2,1125,1291,-10
22213503635,22213503632,-3,1555,2597,-10
22214303965,22214303967,2,1207,1017,-10
22218386619,22218386622,3,1385,1414,-10
22223585386,22223585389,3,1988,2235,-10
22226236709,22226236711,2,1706,1810,-10
22228101507,22228101511,4,1622,1221,-10
22235228806,22235228808,2,1567,1480,-10
22235552741,22235552743,2,1092,1222,-10
22237901031,22237901032,1,1355,947,-10
22245210562,22245210564,2,1544,1258,-10
22247568162,22247568162,0,1758,2014,-10
22249226722,22249226723,1,1248,939,-10
22250738263,22250738266,3,1813,1356,-10
22252776114,22252776114,0,1817,1568,-10
22253091803,22253091803,0,1255,1393,-10
22254728523,22254728523,0,1300,1248,-10
22255041331,22255041330,-1,1427,1317,-10
22256288957,22256288973,16,796,381,-10
22256915153,22256915150,-3,1744,2594,-10
22257185806,22257185810,4,1085,1039,-10
22261101945,22261101946,1,1236,1576,-10
22263231439,22263231442,3,1453,1153,-10
22263601666,22263601666,0,1455,1332,-10
22264274149,22264274154,5,851,841,-10
22269951197,22269951199,2,1218,1608,-10
22271219950,22271219949,-1,1861,1702,-10
22271307232,22271307233,1,2055,1903,-10
22272160037,22272160039,2,2127,1836,-10
22274384589,22274384591,2,1654,1474,-10
22276055165,22276055167,2,1642,1560,-10
22276584030,22276584032,2,1784,1656,-10
22280188551,22280188554,3,1964,2082,-10
22282385368,22282385371,3,1408,1256,-10
22282505833,22282505835,2,1750,2009,-10
22283439791,22283439793,2,1259,1637,-10
22285866013,22285866016,3,1295,1223,-10
22286291165,22286291171,6,1409,1142,-10
22287102530,22287102533,3,1809,1062,-10
22290562637,22290562639,2,1377,1145,-10
22290778311,22290778314,3,1667,1170,-10
22293055641,22293055642,1,1361,1572,-10
22295182270,22295182270,0,1456,1699,-10
22296385767,22296385768,1,1541,1254,-10
22296939883,22296939879,-4,1679,5544,-10
22298884556,22298884560,4,2408,1971,-10
22299935199,22299935192,-7,1001,4398,-10
22301312422,22301312400,-22,1496,1677,-10
22301549725,22301549726,1,1833,1737,-10
22306066430,22306066431,1,2232,1483,-10
22307011206,22307011209,3,1710,1696,-10
22307791111,22307791092,-19,1422,1229,-10
22310089395,22310089398,3,1162,938,-10
22314717714,22314717715,1,1535,2155,-10
22317505283,22317505285,2,1842,1796,-10
22317538504,22317538506,2,2057,1435,-10
22318488273,22318488275,2,1824,1769,-10
22319208354,22319208354,0,1688,1663,-10
22320302767,22320302770,3,1940,1878,-10
22323199856,22323199862,6,9927,23874,-10
22324430205,22324430208,3,1345,1221,-10
22326561331,22326561333,2,1328,1726,-10
22326961319,22326961325,6,4196,1721,-10
22327629767,22327629767,0,1569,2167,-10
22328493077,22328493073,-4,883,3767,-10
22330426849,22330426852,3,1795,1580,-10
22331341897,22331341898,1,1949,1416,-10
22331657053,22331657055,2,2301,2237,-10
22332606811,22332606814,3,2043,1636,-10
22334616066,22334616071,5,1755,1371,-10
22336195702,22336195703,1,1169,1518,-10
22336293165,22336293160,-5,19144,14665,-10
22338569778,22338569781,3,1512,1638,-10
22342235634,22342235642,8,1725,1587,-10
22344752408,22344752410,2,1673,2071,-10
22345921754,22345921755,1,1774,1549,-10
22349392935,22349392938,3,1653,1500,-10
22352592853,22352592856,3,1730,1464,-10
22354225205,22354225207,2,1370,1711,-10
22354825591,22354825593,2,1624,1616,-10
22359021767,22359021776,9,11372,42096,-10
22363101998,22363102001,3,1403,1712,-10
22364272029,22364272029,0,1378,2032,-10
22366068592,22366068591,-1,918,2105,-10
22369303475,22369303477,2,1087,1269,-10
22373629346,22373629350,4,1702,1642,-10
22374712218,22374712220,2,1404,1338,-10
22376109003,22376109003,0,1188,1076,-10
22382293858,22382293861,3,1378,1478,-10
22384381522,22384381526,4,1022,831,-10
22386680296,22386680296,0,1016,1240,-10
22389323837,22389323838,1,1542,1336,-10
22392588974,22392588977,3,1070,1002,-10
22393464785,22393464778,-7,1178,3222,-10
22396270779,22396270782,3,1896,2254,-10
22401000894,22401000896,2,1950,1780,-10
22404106084,22404106085,1,1681,1495,-10
22405305150,22405305153,3,1713,1385,-10
22407457949,22407457951,2,1905,1617,-10
22408505711,22408505712,1,1675,1530,-10
22411721929,22411721931,2,1179,1247,-10
22413223837,22413223838,1,1865,2101,-10
22413597362,22413597368,6,1952,1255,-10
22419946290,22419946290,0,1072,1408,-10
22422906158,22422906158,0,896,1302,-10
22424914743,22424914743,0,1244,1020,-10
22427820693,22427820695,2,1366,1499,-10
22429154937,22429154937,0,2070,1566,-10
22430260409,22430260410,1,1468,1750,-10
22432559951,22432559953,2,1505,1615,-10
22432887085,22432887086,1,1772,1954,-10
22433801023,22433801022,-1,1419,1542,-10
22438381310,22438381310,0,1123,1506,-10
22441883297,22441883298,1,916,906,-10
22455164219,22455164219,0,1710,1919,-10
22455337630,22455337633,3,1709,1440,-10
22455726459,22455726441,-18,1235,1201,-10
22456460273,22456460274,1,1695,1251,-10
22458165394,22458165394,0,1120,1670,-10
22459393026,22459393027,1,1527,1549,-10
22459636805,22459636806,1,1359,1382,-10
22459774461,22459774462,1,1500,1680,-10
22462514066,22462514067,1,1982,1396,-10
22463302858,22463302859,1,1552,1430,-10
22463704846,22463704849,3,1569,1512,-10
22464130214,22464130215,1,1049,838,-10
22468468194,22468468197,3,1908,1731,-10
22471388997,22471388998,1,1432,1358,-10
22473698899,22473698902,3,1322,1604,-10
22473760194,22473760195,1,1234,1616,-10
22475449046,22475449049,3,1689,1578,-10
22476782453,22476782456,3,2279,1239,-10
22482607869,22482607872,3,1856,1578,-10
22483057677,22483057679,2,2780,2345,-10
22483684039,22483684041,2,1426,1528,-10
22484091109,22484091110,1,2060,1531,-10
22490490403,22490490390,-13,47263,9578,-10
22490703901,22490703903,2,1626,1597,-10
22496744883,22496744886,3,1866,1005,-10
22497872863,22497872862,-1,1520,1706,-10
22498904505,22498904491,-14,3900,12439,-10
22502984582,22502984584,2,1237,1186,-10
22505101310,22505101311,1,1593,1587,-10
22505677002,22505677004,2,1491,1639,-10
22508426742,22508426743,1,1605,1509,-10
22509650907,22509650910,3,2002,2096,-10
22514480350,22514480355,5,1714,1195,-10
22519182543,22519182543,0,1525,1730,-10
22520282361,22520282365,4,1835,1271,-10
22520525883,22520525890,7,3342,1528,-10
22521521050,22521521055,5,1413,1349,-10
22522014494,22522014497,3,1894,1630,-10
22524258200,22524258199,-1,1861,1742,-10
22524373303,22524373306,3,1956,1217,-10
22526667743,22526667745,2,1419,1906,-10
22527632042,22527632042,0,1709,830,-10
22528675858,22528675862,4,1221,1270,-10
22529878683,22529878683,0,790,778,-10
22532413324,22532413326,2,1618,1050,-10
22532705908,22532705922,14,1081,4747,-10
22532931500,22532931501,1,1702,1487,-10
22535673155,22535673157,2,1964,1736,-10
22544695477,22544695479,2,1342,1164,-10
22547586440,22547586443,3,1410,1216,-10
22548232870,22548232873,3,1930,1719,-10
22549637854,22549637858,4,1700,1293,-10
22553790665,22553790666,1,1384,1820,-10
22554407026,22554407031,5,1563,1113,-10
22556362869,22556362870,1,1531,1738,-10
22558623334,22558623334,0,1581,1672,-10
22559703473,22559703475,2,1434,2042,-10
22560535470,22560535474,4,1387,1394,-10
22562087921,22562087922,1,1426,1458,-10
22567424198,22567424201,3,1599,1090,-10
22568649264,22568649266,2,1520,1399,-10
22570129055,22570129058,3,1411,1946,-10
22572137824,22572137827,3,1520,1107,-10
22580846197,22580846198,1,1684,1231,-10
22582569201,22582569204,3,1922,1908,-10
22583629950,22583629951,1,1559,1233,-10
22584802030,22584802031,1,1327,1428,-10
22586102261,22586102267,6,1854,1058,-10
22587740654,22587740654,0,2058,2036,-10
22588027348,22588027350,2,1303,1325,-10
22590537987,22590537987,0,1395,1604,-10
22595437812,22595437815,3,1610,1632,-10
22595773230,22595773231,1,1505,1818,-10
22597156106,22597156109,3,1729,1300,-10
22599982514,22599982517,3,2116,1858,-10
22600599946,22600599947,1,1286,1175,-10
22601383004,22601383008,4,926,1149,-10
22601857614,22601857617,3,1874,1240,-10
22601963121,22601963118,-3,1552,1672,-10
22602647007,22602647026,19,1298,1417,-10
22609802628,22609802630,2,1743,1579,-10
22616193061,22616193063,2,2460,2311,-10
22616385788,22616385791,3,857,971,-10
22617462339,22617462338,-1,1049,1837,-10
22622119959,22622119961,2,867,1921,-10
22625835527,22625835530,3,2298,1907,-10
22626581441,22626581442,1,1724,1988,-10
22628725290,22628725294,4,1069,1247,-10
22631946274,22631946277,3,1216,1507,-10
22635164657,22635164657,0,1445,1534,-10
22636563518,22636563521,3,1682,1256,-10
22639086609,22639086607,-2,1559,2517,-10
22641675640,22641675641,1,1260,1753,-10
22643320951,22643320951,0,1936,1821,-10
22645525195,22645525198,3,1914,1434,-10
22647144774,22647144775,1,1648,1296,-10
22647976138,22647976143,5,2585,1446,-10
22651228243,22651228245,2,1550,1645,-10
22652205836,22652205837,1,1279,1582,-10
22653031138,22653031140,2,1567,2005,-10
22656615404,22656615422,18,1077,1390,-10
22659011180,22659011182,2,1361,1576,-10
22659664337,22659664341,4,1717,1391,-10
22660880837,22660880838,1,1310,1586,-10
22668829312,22668829313,1,1575,1365,-10
22670114135,22670114138,3,2253,1134,-10
22670370730,22670370733,3,1659,1915,-10
22671582713,22671582715,2,1907,1632,-10
22672587065,22672587066,1,1821,1395,-10
22675067923,22675067925,2,1295,1172,-10
22676424581,22676424586,5,1784,967,-10
22679086793,22679086794,1,1296,1317,-10
22681147041,22681147042,1,1599,1299,-10
22683120876,22683120879,3,2004,1772,-10
22685475594,22685475594,0,1466,1440,-10
22686809725,22686809725,0,2238,1377,-10
22691218374,22691218379,5,1463,1155,-10
22692646535,22692646533,-2,1206,2247,-10
22692870714,22692870717,3,2035,1498,-10
22696771607,22696771609,2,1329,1606,-10
22696812351,22696812354,3,1045,1129,-10
22699259496,22699259497,1,1257,1453,-10
22702220755,22702220758,3,1292,1933,-10
22703786798,22703786795,-3,1160,914,-10
22708924278,22708924282,4,1899,1891,-10
22709623755,22709623758,3,1501,1985,-10
22710466810,22710466814,4,1431,1861,-10
22711391681,22711391684,3,1082,1041,-10
22712467979,22712467962,-17,1439,1244,-10
22712983671,22712983672,1,1983,1834,-10
22713759182,22713759184,2,1272,1264,-10
22716864747,22716864749,2,2115,2280,-10
22717856241,22717856243,2,1699,1612,-10
22720303578,22720303581,3,1729,1916,-10
22723095790,22723095790,0,2027,1298,-10
22723863733,22723863714,-19,631,882,-10
22724052274,22724052274,0,1488,1657,-10
22727216713,22727216710,-3,1021,1893,-10
22727644102,22727644103,1,1468,1730,-10
22728227002,22728227003,1,1457,2300,-10
22729389261,22729389263,2,1363,1144,-10
22730688729,22730688736,7,3480,1757,-10
22733068349,22733068354,5,2236,1320,-10
22739384289,22739384291,2,746,1557,-10
22746700894,22746700894,0,1799,1687,-10
22747829197,22747829195,-2,1432,2563,-10
22748059712,22748059705,-7,21,1869,-10
22750021546,22750021547,1,1240,1386,-10
22750819723,22750819725,2,2014,997,-10
22751775775,22751775777,2,1274,1393,-10
22752784445,22752784447,2,1434,1260,-10
22754149597,22754149600,3,1735,1399,-10
22754436402,22754436402,0,1293,1428,-10
22754494773,22754494775,2,1077,1230,-10
22754700941,22754700941,0,2262,2241,-10
22756529452,22756529453,1,2029,2303,-10
22757244598,22757244603,5,6319,4039,-10
22758044671,22758044670,-1,4631,7793,-10
22758097367,22758097367,0,1469,1441,-10
22761904378,22761904374,-4,1027,1513,-10
22768078406,22768078407,1,1098,1122,-10
22772755724,22772755726,2,1912,2334,-10
22774098322,22774098324,2,1420,2242,-10
22775746822,22775746820,-2,1218,1476,-10
22778597931,22778597930,-1,1255,1071,-10
22779227972,22779227974,2,1849,1373,-10
22780375733,22780375733,0,1376,1667,-10
22781063650,22781063649,-1,1315,2307,-10
22784680837,22784680839,2,2170,1850,-10
22790767034,22790767036,2,1712,1951,-10
22791044501,22791044502,1,1596,2158,-10
22794529050,22794529054,4,1750,1662,-10
22795693260,22795693265,5,1818,2052,-10
22796639607,22796639610,3,1078,940,-10
22799522891,22799522894,3,2175,2587,-10
22802637114,22802637116,2,1956,1491,-10
22804533105,22804533106,1,1702,1361,-10
22806058054,22806058057,3,1713,1272,-10
22807676046,22807676061,15,14401,29372,-10
22811746349,22811746350,1,1814,1634,-10
22813243458,22813243461,3,1492,1310,-10
22815659414,22815659415,1,1276,1524,-10
22817339337,22817339338,1,1676,1940,-10
22818485945,22818485946,1,1793,1447,-10
22820636515,22820636516,1,1545,1478,-10
22821424318,22821424321,3,1268,1112,-10
22824766254,22824766255,1,2047,1312,-10
22827744601,22827744607,6,6580,2502,-10
22829027447,22829027450,3,1275,1812,-10
22830990738,22830990741,3,982,1058,-10
22838294613,22838294615,2,1197,1503,-10
22839609493,22839609498,5,1729,1558,-10
22840001967,22840001967,0,1730,1756,-10
22842143951,22842143955,4,1943,1825,-10
22842279881,22842279883,2,1471,1210,-10
22844068071,22844068070,-1,1301,1699,-10
22850042163,22850042167,4,2267,1340,-10
22851857685,22851857685,0,1355,1341,-10
22852992713,22852992716,3,1522,1406,-10
22853728470,22853728470,0,780,1507,-10
22855475504,22855475505,1,1695,1525,-10
22856683747,22856683747,0,1137,1574,-10
22857146375,22857146378,3,1533,1444,-10
22858523277,22858523279,2,1437,1762,-10
22858782469,22858782471,2,1542,1370,-10
22860240728,22860240730,2,2180,1140,-10
22863408338,22863408340,2,1799,1525,-10
22866031449,22866031450,1,1742,1378,-10
22867843717,22867843718,1,1713,1431,-10
22868716590,22868716594,4,1114,1499,-10
22869663391,22869663391,0,1180,1158,-10
22871959406,22871959409,3,1633,1435,-10
22873777505,22873777507,2,2177,1554,-10
22874510770,22874510773,3,1850,1474,-10
22876251159,22876251159,0,1553,1880,-10
22877406673,22877406675,2,2681,2103,-10
22877592185,22877592188,3,1157,1661,-10
22878921353,22878921354,1,1304,1611,-10
22879332130,22879332133,3,1666,1422,-10
22879998451,22879998454,3,1282,1453,-10
22883348981,22883348960,-21,1005,1193,-10
22884945160,22884945162,2,1177,1515,-10
22885714965,22885714970,5,2557,1302,-10
22887436327,22887436330,3,1705,1236,-10
22896036027,22896036029,2,1172,1074,-10
22897516954,22897516950,-4,1029,1737,-10
22897971263,22897971262,-1,1294,1540,-10
22898793516,22898793517,1,1416,1345,-10
22900597521,22900597523,2,1698,1387,-10
22902898086,22902898088,2,1315,1300,-10
22908608501,22908608503,2,1541,1694,-10
22910617981,22910617981,0,1607,1777,-10
22913490747,22913490747,0,1340,978,-10
22915247518,22915247522,4,1491,1215,-10
22916132779,22916132782,3,873,1176,-10
22917806768,22917806772,4,2261,1689,-10
22920276695,22920276697,2,1597,1574,-10
22920567533,22920567530,-3,1294,3513,-10
22923017260,22923017253,-7,1563,10011,-10
22923900151,22923900150,-1,1801,2318,-10
22925967982,22925967984,2,1266,1326,-10
22927271646,22927271648,2,1758,1867,-10
22927511841,22927511844,3,1271,886,-10
22930293026,22930293029,3,1177,1188,-10
22935162966,22935162966,0,1499,1513,-10
22935309385,22935309386,1,1215,885,-10
22936166269,22936166271,2,2190,1583,-10
22941923180,22941923181,1,1883,1644,-10
22942569602,22942569606,4,2641,1250,-10
22943707993,22943707994,1,1490,1926,-10
22945789005,22945789006,1,1680,1626,-10
22949291036,22949291038,2,1954,1823,-10
22953364983,22953364985,2,1178,1466,-10
22954567703,22954567706,3,640,887,-10
22954721902,22954721905,3,1528,1377,-10
22956479314,22956479317,3,1460,1157,-10
22956533646,22956533628,-18,978,980,-10
22957954799,22957954801,2,1412,1581,-10
22958195891,22958195889,-2,1201,2703,-10
22962573836,22962573838,2,1961,2161,-10
22964452726,22964452726,0,1953,2045,-10
22966078392,22966078391,-1,1733,1077,-10
22968161342,22968161346,4,2124,1438,-10
22968751959,22968751961,2,1520,1541,-10
22969178075,22969178075,0,1369,1900,-10
22970642571,22970642567,-4,766,1913,-10
22970912225,22970912227,2,1599,1469,-10
22971947793,22971947797,4,1496,1383,-10
22976153178,22976153178,0,2172,2142,-10
22977123062,22977123066,4,945,1422,-10
22977623757,22977623761,4,1557,1564,-10
22977698807,22977698809,2,1457,1217,-10
22983044097,22983044100,3,1692,2017,-10
22987234594,22987234594,0,1889,1983,-10
22987632805,22987632806,1,1653,1673,-10
22990683589,22990683592,3,1812,2057,-10
22991445714,22991445716,2,1319,2095,-10
22994243529,22994243530,1,1431,1447,-10
22998788769,22998788768,-1,861,699,-10
22999590858,22999590858,0,1940,2281,-10
23001218855,23001218857,2,1196,1360,-10
23002431797,23002431799,2,1448,1608,-10
23010207051,23010207050,-1,1246,2657,-10
23012138591,23012138591,0,1150,1427,-10
23013684757,23013684756,-1,1958,1989,-10
23013835669,23013835671,2,958,1042,-10
23014161169,23014161171,2,1117,1228,-10
23019097290,23019097292,2,1524,1571,-10
23020059774,23020059775,1,1261,1766,-10
23020384612,23020384615,3,3742,1738,-10
23020550565,23020550566,1,1444,1379,-10
23022994579,23022994582,3,1830,1548,-10
23025997858,23025997861,3,1472,1797,-10
23026157246,23026157246,0,1703,1736,-10
23027706770,23027706773,3,1010,1236,-10
23030095713,23030095714,1,1651,1682,-10
23031052325,23031052326,1,1880,1620,-10
23032670877,23032670870,-7,1181,1781,-10
23032864883,23032864885,2,1299,2091,-10
23033397770,23033397770,0,2164,2159,-10
23034291644,23034291645,1,973,1235,-10
23036270051,23036270054,3,1536,1982,-10
23037493839,23037493842,3,1293,1528,-10
23042445386,23042445385,-1,1084,1938,-10
23043886151,23043886150,-1,1168,1656,-10
23044567702,23044567703,1,1506,1539,-10
23044922047,23044922045,-2,1258,1501,-10
23045242567,23045242569,2,1402,1629,-10
23046467658,23046467661,3,2001,1851,-10
23051291406,23051291410,4,1968,1927,-10
23051495331,23051495333,2,1650,2178,-10
23055782041,23055782042,1,1004,1036,-10
23060810614,23060810615,1,1291,1158,-10
23060941789,23060941784,-5,1351,5408,-10
23064959451,23064959451,0,1745,1319,-10
23065158709,23065158688,-21,1431,1209,-10
23066114685,23066114685,0,877,893,-10
23071958578,23071958579,1,1492,1506,-10
23072153462,23072153480,18,1658,1147,-10
23072757231,23072757230,-1,1319,1612,-10
23072948605,23072948607,2,1779,2104,-10
23073758579,23073758579,0,1627,2302,-10
23075905239,23075905239,0,1112,1290,-10
23077370974,23077370977,3,1686,1141,-10
23077489282,23077489286,4,2406,2396,-10
23077803426,23077803427,1,1443,1307,-10
23081399697,23081399699,2,1725,1574,-10
23081796346,23081796349,3,1817,1931,-10
23082533010,23082533026,16,1253,1357,-10
23082757863,23082757865,2,1546,1478,-10
23086007577,23086007578,1,1444,1339,-10
23087399275,23087399277,2,1524,1506,-10
23087745659,23087745662,3,1998,1720,-10
23088138593,23088138608,15,1124,1483,-10
23088746063,23088746063,0,1411,1920,-10
23088860633,23088860635,2,1871,1455,-10
23093786779,23093786778,-1,1149,1747,-10
23097017481,23097017484,3,1735,1640,-10
23097404821,23097404824,3,1289,1396,-10
23098976739,23098976741,2,1376,1353,-10
23099411199,23099411201,2,1648,1295,-10
23099655169,23099655170,1,1878,1881,-10
23099862366,23099862367,1,1055,1290,-10
23104606802,23104606797,-5,1209,3345,-10
23105787846,23105787845,-1,1559,2956,-10
23110583663,23110583665,2,1493,1374,-10
23110965328,23110965330,2,2029,2255,-10
23111057829,23111057829,0,1266,1475,-10
23112693281,23112693281,0,1605,1631,-10
23116417340,23116417341,1,1377,1938,-10
23117555906,23117555907,1,1734,1396,-10
23121981274,23121981273,-1,1131,1765,-10
23124976366,23124976370,4,1962,1484,-10
23127649681,23127649685,4,1678,2250,-10
23128134416,23128134422,6,1706,1352,-10
23135295587,23135295588,1,1584,1365,-10
23135596014,23135595996,-18,3994,1899,-10
23136030970,23136030971,1,1662,1685,-10
23137651466,23137651469,3,1838,1135,-10
23138098456,23138098458,2,1775,1748,-10
23139267569,23139267571,2,1838,2326,-10
23147364749,23147364752,3,1467,1606,-10
23150280475,23150280479,4,1995,1154,-10
23153175269,23153175272,3,1343,1741,-10
23154907849,23154907852,3,1469,1487,-10
23158899403,23158899405,2,1348,1321,-10
23161403003,23161403003,0,915,1891,-10
23162170237,23162170238,1,1045,890,-10
23163244776,23163244779,3,2111,1649,-10
23163455439,23163455436,-3,18408,21146,-10
23164604951,23164604949,-2,1045,1595,-10
23165481045,23165481050,5,2326,1651,-10
23167986263,23167986266,3,2207,1734,-10
23174378817,23174378831,14,1451,1404,-10
23177873346,23177873345,-1,1372,1968,-10
23179380738,23179380737,-1,33257,75431,-10
23179887979,23179887978,-1,1350,1565,-10
23180151433,23180151435,2,910,1693,-10
23181658930,23181658933,3,1796,1663,-10
23182590543,23182590545,2,1544,1251,-10
23183360891,23183360873,-18,741,210,-10
23184024361,23184024363,2,1588,1541,-10
23184341295,23184341293,-2,874,2373,-10
23184989074,23184989095,21,819,1251,-10
23186207858,23186207861,3,861,1442,-10
23186577498,23186577501,3,2574,2042,-10
23190944152,23190944144,-8,1500,1911,-10
23193576782,23193576782,0,1339,1560,-10
23195938335,23195938338,3,1333,1235,-10
23200805658,23200805660,2,1276,835,-10
23203952494,23203952495,1,2853,2245,-10
23213120909,23213120911,2,1664,1359,-10
23216786963,23216786964,1,2145,1875,-10
23217018735,23217018736,1,1087,1095,-10
23220223830,23220223833,3,2034,1602,-10
23222239836,23222239835,-1,1437,1379,-10
23223112507,23223112507,0,1663,1268,-10
23224023182,23224023184,2,2065,1599,-10
23225879282,23225879282,0,1528,1240,-10
23226295129,23226295130,1,1870,2381,-10
23227723126,23227723127,1,1864,1894,-10
23228823990,23228823994,4,1758,1884,-10
23229551669,23229551670,1,958,1121,-10
23231236245,23231236246,1,1598,1651,-10
23232718428,23232718432,4,2737,2037,-10
23233315488,23233315491,3,1319,1899,-10
23235881558,23235881558,0,1257,1818,-10
23236327061,23236327063,2,1864,1515,-10
23237919102,23237919105,3,1534,1135,-10
23241234406,23241234407,1,1390,1471,-10
23241754236,23241754238,2,1997,1818,-10
23245977662,23245977662,0,1345,1970,-10
23246833601,23246833610,9,14970,23665,-10
23249893023,23249893024,1,1474,2163,-10
23250581419,23250581428,9,5335,1722,-10
23255857150,23255857150,0,1724,1708,-10
23259372514,23259372503,-11,46155,14034,-10
23263369910,23263369911,1,1324,1722,-10
23263553648,23263553650,2,1411,1327,-10
23266613898,23266613899,1,1300,1377,-10
23267176867,23267176871,4,2383,1455,-10
23268286159,23268286158,-1,23305,22304,-10
23271202460,23271202474,14,546,1337,-10
23275715398,23275715398,0,1296,2122,-10
23280960468,23280960471,3,1423,1408,-10
23282894140,23282894141,1,1776,1349,-10
23285311670,23285311671,1,2069,1314,-10
23285635185,23285635188,3,2020,1460,-10
23287445656,23287445653,-3,1297,3354,-10
23288417467,23288417467,0,963,2226,-10
23289121086,23289121090,4,1257,1495,-10
23292296006,23292296009,3,1367,1847,-10
23296397790,23296397792,2,1771,1808,-10
23298632920,23298632923,3,1461,1633,-10
23302661901,23302661902,1,980,1305,-10
23303710857,23303710861,4,1351,1493,-10
23304554471,23304554472,1,1399,1383,-10
23305086590,23305086591,1,1769,1582,-10
23305612034,23305612033,-1,1037,1590,-10
23308345765,23308345768,3,1594,2506,-10
23311558020,23311558014,-6,1703,1995,-10
23313924902,23313924906,4,751,1104,-10
23316008461,23316008458,-3,1052,1018,-10
23316910987,23316910990,3,1332,1217,-10
23317782272,23317782275,3,2312,1611,-10
23321028793,23321028797,4,2189,1336,-10
23324634726,23324634730,4,1149,962,-10
23326549837,23326549837,0,1655,1489,-10
23327667845,23327667845,0,1019,1721,-10
23328043167,23328043169,2,2217,2108,-10
23332944972,23332944973,1,1816,1881,-10
23333333793,23333333796,3,1323,1541,-10
23334654134,23334654135,1,1515,1580,-10
23334842193,23334842197,4,1753,2127,-10
23338912207,23338912208,1,1269,1484,-10
23339678870,23339678873,3,1072,1247,-10
23341505189,23341505191,2,1622,1462,-10
23352286057,23352286059,2,1444,1385,-10
23354253686,23354253687,1,1678,1723,-10
23372056090,23372056093,3,1357,1735,-10
23372279652,23372279650,-2,877,1481,-10
23374270575,23374270575,0,1678,1779,-10
23383693629,23383693622,-7,905,3762,-10
23384225553,23384225554,1,1480,1679,-10
23385558951,23385558956,5,1863,1584,-10
23388295053,23388295056,3,1559,1695,-10
23389840198,23389840199,1,1831,1346,-10
23389973712,23389973715,3,1173,1020,-10
23390015372,23390015373,1,2048,1550,-10
23390543379,23390543381,2,1350,1505,-10
23394510958,23394510961,3,1866,1410,-10
23397496695,23397496695,0,1097,1349,-10
23398551047,23398551047,0,1284,2149,-10
23399639816,23399639818,2,1399,1487,-10
23399858959,23399858963,4,2404,1275,-10
23400954593,23400954596,3,1719,1629,-10
23405075583,23405075589,6,1303,890,-10
23405253382,23405253382,0,1645,1359,-10
23408017120,23408017121,1,1536,1544,-10
23409005995,23409005997,2,1990,1934,-10
23410864211,23410864212,1,1536,1331,-10
23411355375,23411355378,3,1665,1305,-10
23414096823,23414096825,2,1533,1634,-10
23421366059,23421366064,5,1235,1131,-10
23421511432,23421511451,19,210,456,-10
23423927869,23423927870,1,1405,1474,-10
23424698581,23424698581,0,2298,1616,-10
23425027647,23425027647,0,1251,1205,-10
23427152686,23427152689,3,1381,1648,-10
23427216730,23427216730,0,1458,1486,-10
23427635394,23427635394,0,1832,1363,-10
23427772186,23427772185,-1,1345,1154,-10
23434898136,23434898137,1,1691,1142,-10
23436281065,23436281068,3,1877,1960,-10
23448164890,23448164892,2,1023,1644,-10
23448236818,23448236820,2,1713,1411,-10
23450240982,23450240984,2,1673,1220,-10
23454077903,23454077906,3,1238,1043,-10
23455952471,23455952474,3,2042,1650,-10
23458895657,23458895658,1,2035,1721,-10
23460540150,23460540170,20,1707,1266,-10
23463030747,23463030748,1,653,665,-10
23466202151,23466202154,3,2236,1614,-10
23468253536,23468253537,1,1465,2153,-10
23471443630,23471443635,5,1638,1706,-10
23472564017,23472564023,6,3461,1321,-10
23473266707,23473266714,7,1368,1579,-10
23478779286,23478779288,2,1444,1654,-10
23482161749,23482161753,4,1570,1278,-10
23484463518,23484463517,-1,1501,1398,-10
23485617441,23485617443,2,1562,1182,-10
23486095470,23486095474,4,1347,1472,-10
23486184138,23486184143,5,2787,1510,-10
23486515074,23486515073,-1,1379,1262,-10
23491906182,23491906183,1,1655,2503,-10
23495820397,23495820400,3,1516,1882,-10
23496207532,23496207533,1,1264,1376,-10
23498599861,23498599865,4,1716,1490,-10
23501369734,23501369734,0,949,995,-10
23501585922,23501585923,1,989,878,-10
23503897662,23503897665,3,1530,1453,-10
23506289928,23506289930,2,1240,1382,-10
23509816425,23509816426,1,1807,1854,-10
23513790565,23513790568,3,1498,1968,-10
23514338475,23514338478,3,1275,1235,-10
23514648414,23514648415,1,1098,1505,-10
23516289628,23516289632,4,1716,1166,-10
23517329142,23517329146,4,2197,1633,-10
23521743733,23521743734,1,1025,1047,-10
23523379235,23523379231,-4,18967,7724,-10
23523699625,23523699624,-1,1373,2391,-10
23529492940,23529492942,2,1399,1181,-10
23530126656,23530126673,17,824,772,-10
23531324169,23531324173,4,2218,1788,-10
23534462976,23534462986,10,17721,27517,-10
23534613345,23534613349,4,1393,1324,-10
23535171581,23535171580,-1,1343,2260,-10
23536091645,23536091642,-3,607,1768,-10
23541719679,23541719675,-4,1933,4358,-10
23542018797,23542018799,2,1528,1470,-10
23542228627,23542228627,0,1584,1406,-10
23542341309,23542341309,0,1530,1791,-10
23543137838,23543137837,-1,3172,5381,-10
23543948904,23543948905,1,1804,1211,-10
23544765886,23544765888,2,1888,2154,-10
23546455975,23546455978,3,2484,2363,-10
23550082854,23550082847,-7,430,184,-10
23551172244,23551172242,-2,1704,1582,-10
23552274766,23552274767,1,2757,3565,-10
23553106360,23553106378,18,1693,4950,-10
23555277393,23555277395,2,1646,1646,-10
23556237656,23556237654,-2,23323,13522,-10
23560814495,23560814501,6,2175,1600,-10
23563236202,23563236204,2,1827,1948,-10
23563659458,23563659457,-1,1411,1999,-10
23566921962,23566921965,3,1306,1649,-10
23570081571,23570081574,3,1906,1164,-10
23574047290,23574047291,1,1142,1181,-10
23575736811,23575736810,-1,735,1144,-10
23577908209,23577908210,1,2243,2041,-10
23579027962,23579027963,1,929,880,-10
23581340141,23581340142,1,1486,1413,-10
23581813647,23581813650,3,1727,1445,-10
23582916530,23582916510,-20,613,463,-10
23587905083,23587905087,4,1228,1212,-10
23588423713,23588423715,2,1587,1492,-10
23589063875,23589063876,1,1214,1616,-10
23589817894,23589817893,-1,1147,1593,-10
23594156551,23594156553,2,1992,1841,-10
23597434415,23597434421,6,4314,1367,-10
23601817043,23601817046,3,1882,1346,-10
23601950895,23601950894,-1,1748,1239,-10
23607284470,23607284469,-1,1330,1701,-10
23609525027,23609525024,-3,1165,1908,-10
23617161655,23617161658,3,908,1167,-10
23617610310,23617610312,2,1141,1650,-10
23617798374,23617798378,4,1301,1256,-10
23617959489,23617959494,5,1542,1611,-10
23618548068,23618548070,2,1342,1378,-10
23619515411,23619515413,2,1005,1592,-10
23622808942,23622808944,2,975,1752,-10
23623902579,23623902574,-5,1101,3724,-10
23625304634,23625304654,20,1269,2031,-10
23627076545,23627076545,0,1711,968,-10
23628053201,23628053202,1,2160,1933,-10
23629496076,23629496078,2,993,1132,-10
23631587083,23631587083,0,1584,1397,-10
23633492023,23633492018,-5,580,1504,-10
23641074747,23641074749,2,1120,1773,-10
23642021407,23642021409,2,1158,1439,-10
23646924761,23646924763,2,889,930,-10
23647288181,23647288181,0,1803,1737,-10
23647979450,23647979454,4,1869,1542,-10
23656978138,23656978142,4,1410,1778,-10
23660239743,23660239750,7,6710,2913,-10
23660725392,23660725392,0,1012,1716,-10
23662306944,23662306947,3,1529,1654,-10
23662831521,23662831522,1,1519,2479,-10
23665325669,23665325670,1,1592,1526,-10
23667717335,23667717337,2,1715,1019,-10
23668353431,23668353433,2,1363,1734,-10
23669266050,23669266054,4,1793,863,-10
23672193354,23672193358,4,1586,1551,-10
23673113034,23673113037,3,948,1270,-10
23673658957,23673658961,4,1615,1455,-10
23673983455,23673983457,2,2052,1556,-10
23675310850,23675310853,3,953,1257,-10
23675990994,23675990994,0,1597,1081,-10
23678581980,23678581981,1,1517,1516,-10
23679082822,23679082823,1,2776,2893,-10
23680524415,23680524414,-1,1901,1823,-10
23681152251,23681152253,2,1384,1113,-10
23682550227,23682550229,2,1303,1537,-10
23684607760,23684607761,1,1445,1359,-10
23685906802,23685906804,2,1530,1386,-10
23686934849,23686934850,1,2113,2031,-10
23689340947,23689340946,-1,1477,1853,-10
23690228638,23690228639,1,1778,1086,-10
23697691932,23697691934,2,2484,2002,-10
23698628255,23698628258,3,2005,1555,-10
23699094810,23699094810,0,1461,1371,-10
23701584943,23701584944,1,1226,1690,-10
23702313119,23702313120,1,1993,2016,-10
23702440049,23702440053,4,1900,1624,-10
23705978174,23705978177,3,1633,1416,-10
23708990717,23708990719,2,2299,1760,-10
23709666076,23709666078,2,2310,1711,-10
23710955270,23710955271,1,1743,1772,-10
23713992306,23713992309,3,1992,1542,-10
23714626604,23714626606,2,1884,1302,-10
23715071730,23715071726,-4,1002,3113,-10
23717476367,23717476370,3,1402,1538,-10
23719797784,23719797789,5,1146,1181,-10
23721302403,23721302418,15,1284,1397,-10
23723057332,23723057335,3,1615,2031,-10
23728272926,23728272926,0,1166,1509,-10
23729327380,23729327383,3,2248,1825,-10
23729857958,23729857958,0,1714,2204,-10
23731212664,23731212666,2,1724,1671,-10
23738069305,23738069306,1,1293,1771,-10
23738897373,23738897375,2,867,704,-10
23740089581,23740089574,-7,1570,6955,-10
23742333373,23742333374,1,1236,1499,-10
23743413847,23743413849,2,949,980,-10
23748775438,23748775439,1,1823,1586,-10
23751471746,23751471751,5,7372,2395,-10
23752135431,23752135434,3,2411,1786,-10
23752519007,23752519010,3,1586,1575,-10
23753505771,23753505772,1,922,1528,-10
23757624947,23757624950,3,1349,1267,-10
23760966887,23760966890,3,894,803,-10
23762546272,23762546275,3,1579,1465,-10
23767975921,23767975923,2,1499,1634,-10
23768885578,23768885575,-3,1223,1733,-10
23769527626,23769527628,2,1834,1383,-10
23769653614,23769653614,0,887,1079,-10
23769847602,23769847604,2,2205,2160,-10
23770671312,23770671316,4,2398,1438,-10
23771629571,23771629570,-1,1927,1969,-10
23776128762,23776128763,1,1179,1473,-10
23777792982,23777792984,2,1270,1664,-10
23778382256,23778382254,-2,1458,1532,-10
23780256073,23780256078,5,2262,1449,-10
23782053587,23782053589,2,1685,1925,-10
23783821105,23783821106,1,1089,1769,-10
23785057929,23785057930,1,1487,1502,-10
23786515379,23786515374,-5,2205,7299,-10
23786825198,23786825200,2,1457,1757,-10
23788103068,23788103069,1,1517,1965,-10
23789899611,23789899610,-1,1243,2747,-10
23790507143,23790507134,-9,473,2198,-10
23792087191,23792087190,-1,1445,1797,-10
23795464649,23795464647,-2,1393,1823,-10
23795662628,23795662646,18,1262,1219,-10
23802007987,23802007989,2,1481,1234,-10
23802737687,23802737687,0,1348,1549,-10
23802875111,23802875113,2,1633,1361,-10
23803158598,23803158602,4,1418,1250,-10
23803565061,23803565063,2,1127,1039,-10
23808009114,23808009117,3,1427,1713,-10
23808169267,23808169254,-13,775,1192,-10
23818986806,23818986809,3,1687,1503,-10
23819336579,23819336581,2,1366,1705,-10
23820866353,23820866353,0,1337,1137,-10
23828770405,23828770406,1,1313,1901,-10
23831518729,23831518733,4,1752,2028,-10
23831979226,23831979227,1,528,583,-10
23834264095,23834264098,3,969,1585,-10
23834324361,23834324346,-15,1329,1699,-10
23835171512,23835171499,-13,1317,1224,-10
23835499828,23835499833,5,1912,1566,-10
23835560369,23835560371,2,1030,1503,-10
23836702030,23836702031,1,2133,2192,-10
23837161113,23837161118,5,1279,1299,-10
23838831673,23838831675,2,2136,1640,-10
23841924858,23841924858,0,1570,1191,-10
23842699046,23842699047,1,1501,1323,-10
23843172846,23843172849,3,2122,2291,-10
23843499651,23843499651,0,1846,1242,-10
23846465949,23846465971,22,1614,1224,-10
23847170359,23847170362,3,1343,1672,-10
23848351327,23848351329,2,1384,1581,-10
23854401118,23854401124,6,1586,1189,-10
23855574821,23855574822,1,1396,1501,-10
23858368990,23858368991,1,1396,1291,-10
23862834674,23862834674,0,1159,1509,-10
23863433391,23863433395,4,1685,1086,-10
23863563036,23863563018,-18,821,911,-10
23869249106,23869249109,3,1702,1849,-10
23872585510,23872585492,-18,1599,1517,-10
23872667688,23872667691,3,1921,1640,-10
23874145134,23874145135,1,1940,1876,-10
23875494119,23875494121,2,1777,1659,-10
23877826393,23877826394,1,1269,923,-10
23878146522,23878146529,7,1372,1057,-10
23880471037,23880471039,2,2201,1955,-10
23885881233,23885881233,0,1471,1407,-10
23887812946,23887812945,-1,1245,1275,-10
23888228199,23888228201,2,1891,1431,-10
23889501769,23889501770,1,1591,1617,-10
23889977083,23889977083,0,1686,1952,-10
23890860985,23890860987,2,1644,1633,-10
23891137268,23891137271,3,1534,1549,-10
23893116056,23893116060,4,3912,1989,-10
23894420054,23894420056,2,1302,1175,-10
23894920755,23894920757,2,1617,1280,-10
23896569893,23896569896,3,1632,1326,-10
23898207990,23898207990,0,1705,1378,-10
23899334405,23899334405,0,868,1214,-10
23900612635,23900612638,3,1246,1215,-10
23901187257,23901187259,2,1603,1021,-10
23902466782,23902466783,1,1144,1451,-10
23903327083,23903327087,4,1352,1486,-10
23903608914,23903608915,1,1810,1283,-10
23904434614,23904434632,18,1484,1201,-10
23905169164,23905169167,3,1647,1145,-10
23909581601,23909581598,-3,1065,2680,-10
23912093922,23912093923,1,1488,1452,-10
23913676389,23913676390,1,1237,1597,-10
23915063851,23915063854,3,1481,1457,-10
23915237842,23915237843,1,1689,1695,-10
23919349858,23919349859,1,1336,1824,-10
23919728034,23919728034,0,1860,1587,-10
23919793091,23919793099,8,1354,1458,-10
23921260026,23921260027,1,1262,1914,-10
23923872756,23923872755,-1,1679,1503,-10
23924594381,23924594384,3,2262,1990,-10
23924849339,23924849338,-1,1358,1783,-10
23926862646,23926862648,2,1572,1775,-10
23931593158,23931593158,0,1649,1299,-10
23932660122,23932660102,-20,974,883,-10
23933237315,23933237311,-4,985,2776,-10
23935609553,23935609556,3,1528,1379,-10
23936229943,23936229944,1,1570,1667,-10
23938737603,23938737605,2,2297,1777,-10
23943396655,23943396657,2,1253,1502,-10
23947648259,23947648259,0,1017,583,-10
23948028734,23948028736,2,2288,1569,-10
23949397113,23949397113,0,936,1540,-10
23951047698,23951047700,2,1308,1083,-10
23955911634,23955911634,0,1573,1789,-10
23957724615,23957724618,3,2199,1499,-10
23958603162,23958603167,5,1565,1435,-10
23960957651,23960957654,3,1794,1451,-10
23962497911,23962497906,-5,2365,6856,-10
23962887592,23962887595,3,1748,1681,-10
23963244765,23963244771,6,1687,1002,-10
23963305916,23963305897,-19,1592,1747,-10
23968702685,23968702698,13,1006,886,-10
23969864786,23969864784,-2,1696,2086,-10
23969957137,23969957139,2,1748,858,-10
23974502719,23974502722,3,1929,1775,-10
23980452983,23980452987,4,2246,1653,-10
23982746640,23982746637,-3,1130,2458,-10
23985019647,23985019648,1,1208,1284,-10
23985412949,23985412950,1,1906,2041,-10
23988895257,23988895251,-6,3609,4771,-10
23989456874,23989456878,4,1284,1653,-10
23991278494,23991278498,4,1606,1597,-10
23992636861,23992636865,4,1911,2122,-10
23995275561,23995275562,1,2176,1949,-10
23996065909,23996065911,2,1054,1406,-10
23996509463,23996509465,2,1478,1577,-10
23996947107,23996947102,-5,277,4680,-10
23999524561,23999524563,2,1314,1580,-10
24005167178,24005167178,0,1537,1936,-10
24010194168,24010194170,2,1275,1234,-10
24011802922,24011802925,3,1490,1295,-10
24013303155,24013303157,2,1656,1552,-10
24014348903,24014348897,-6,2039,7440,-10
24015693024,24015693026,2,1778,1599,-10
24017391772,24017391776,4,1322,1357,-10
24018506581,24018506583,2,3117,2714,-10
24019860882,24019860885,3,1409,1532,-10
24020231284,24020231286,2,2051,2343,-10
24025708202,24025708203,1,752,921,-10
24026289863,24026289865,2,1167,1734,-10
24028068814,24028068814,0,1505,1472,-10
24031132402,24031132405,3,1630,1594,-10
24035052654,24035052655,1,2041,1508,-10
24038199781,24038199783,2,1621,1602,-10
24040296642,24040296643,1,1400,1220,-10
24041180096,24041180099,3,1631,1133,-10
24043433337,24043433341,4,1919,2067,-10
24044137266,24044137266,0,1541,984,-10
24044440666,24044440670,4,1381,1978,-10
24044676491,24044676491,0,1228,1134,-10
24046018267,24046018269,2,1247,1467,-10
24046928499,24046928500,1,2818,2031,-10
24047106898,24047106898,0,924,1368,-10
24050498969,24050498969,0,1908,1389,-10
24050560259,24050560244,-15,1445,1001,-10
24050864307,24050864309,2,1884,1878,-10
24051475882,24051475886,4,1422,1365,-10
24054553506,24054553507,1,1561,1551,-10
24054643329,24054643327,-2,1167,1317,-10
24056413973,24056413978,5,1155,1496,-10
24057260250,24057260254,4,2368,1440,-10
24058847727,24058847722,-5,670,2355,-10
24059160848,24059160848,0,1294,1793,-10
24067722065,24067722066,1,1110,1321,-10
24071015426,24071015431,5,1757,1422,-10
24071359282,24071359283,1,1328,1206,-10
24074444779,24074444781,2,1358,1398,-10
24075027079,24075027090,11,1448,1378,-10
24077283621,24077283624,3,1517,1197,-10
24078306338,24078306341,3,1616,1888,-10
24078509244,24078509245,1,1436,913,-10
24079627470,24079627471,1,2235,2180,-10
24080423240,24080423243,3,1782,968,-10
24082254797,24082254799,2,2353,2394,-10
24082602845,24082602845,0,2044,1841,-10
24083050821,24083050822,1,1777,1858,-10
24083836801,24083836802,1,1694,1438,-10
24084423810,24084423829,19,1399,1457,-10
24086283306,24086283308,2,1679,1635,-10
24086740243,24086740244,1,730,880,-10
24091226401,24091226402,1,1284,1644,-10
24091517725,24091517726,1,929,1748,-10
24096097289,24096097289,0,2142,1742,-10
24098131554,24098131555,1,1909,1559,-10
24098960789,24098960791,2,1584,1317,-10
24101087929,24101087931,2,2190,1620,-10
24103013831,24103013831,0,2263,1708,-10
24105949721,24105949722,1,1909,1560,-10
24109399048,24109399056,8,1372,1172,-10
24113544946,24113544950,4,1350,1279,-10
24123566440,24123566441,1,1304,1369,-10
24127282033,24127282029,-4,1599,3421,-10
24131175784,24131175786,2,1649,1537,-10
24131887798,24131887801,3,2280,1628,-10
24132595183,24132595186,3,1751,1805,-10
24132901326,24132901308,-18,927,1154,-10
24133539941,24133539944,3,1488,1742,-10
24135746826,24135746825,-1,1065,1147,-10
24136773229,24136773230,1,1653,1447,-10
24140632887,24140632892,5,2078,1445,-10
24141590536,24141590537,1,1448,1082,-10
24142480856,24142480859,3,1867,1497,-10
24145631555,24145631556,1,1310,1425,-10
24146421380,24146421382,2,2054,1768,-10
24151474827,24151474831,4,1878,652,-10
24157339081,24157339083,2,1679,1448,-10
24157677219,24157677222,3,1709,1747,-10
24158757313,24158757314,1,1835,1674,-10
24160829469,24160829470,1,1652,1578,-10
24162719263,24162719265,2,1799,1742,-10
24164441305,24164441314,9,13505,29808,-10
24166812082,24166812083,1,1841,1441,-10
24167277789,24167277788,-1,1493,2279,-10
24169421210,24169421210,0,967,1484,-10
24169736463,24169736465,2,1762,1681,-10
24175206240,24175206242,2,1391,1119,-10
24177146966,24177146970,4,1466,1316,-10
24181378239,24181378239,0,1387,1089,-10
24182523018,24182523022,4,1107,1606,-10
24184161182,24184161184,2,1087,895,-10
24185506159,24185506162,3,1372,1538,-10
24191585102,24191585106,4,1163,986,-10
24192473166,24192473167,1,1204,1240,-10
24193932517,24193932530,13,933,1129,-10
24198640387,24198640391,4,4255,2316,-10
24200864725,24200864729,4,2462,1144,-10
24202101147,24202101146,-1,893,1120,-10
24206177635,24206177629,-6,1103,1136,-10
24207138795,24207138797,2,1616,1240,-10
24209289295,24209289295,0,1196,1361,-10
24211198606,24211198606,0,1613,2194,-10
24213408367,24213408365,-2,1216,1615,-10
24218848962,24218848964,2,2233,1671,-10
24220784126,24220784121,-5,1778,6651,-10
24222156426,24222156421,-5,1786,6004,-10
24222333238,24222333240,2,1678,1737,-10
24226214595,24226214596,1,1535,1558,-10
24227779747,24227779749,2,1469,1634,-10
24229309194,24229309194,0,1369,1509,-10
24230575626,24230575628,2,2265,1909,-10
24231681900,24231681905,5,1281,1118,-10
24232867598,24232867600,2,2083,1760,-10
24234234535,24234234539,4,1555,1194,-10
24240037697,24240037699,2,2200,1592,-10
24242176403,24242176406,3,1823,2488,-10
24244548638,24244548642,4,1720,1549,-10
24244836978,24244836982,4,1199,1488,-10
24247145161,24247145164,3,1571,1308,-10
24248771337,24248771339,2,1719,1345,-10
24249397783,24249397786,3,1459,1751,-10
24250095582,24250095585,3,1393,1286,-10
24251350551,24251350552,1,2013,1774,-10
24253971317,24253971318,1,1516,2107,-10
24255666471,24255666474,3,2589,1755,-10
24259613030,24259613027,-3,1395,1906,-10
24260346042,24260346041,-1,1292,1242,-10
24260752070,24260752070,0,1593,882,-10
24262060686,24262060667,-19,1364,1225,-10
24262315914,24262315915,1,1106,1121,-10
24262775571,24262775585,14,1661,1314,-10
24262925082,24262925086,4,3138,1662,-10
24266451034,24266451037,3,1305,1387,-10
24269108590,24269108591,1,1651,1416,-10
24270733088,24270733090,2,1100,1174,-10
24273683827,24273683806,-21,1139,1234,-10
24276703038,24276703040,2,1209,1574,-10
24277156142,24277156122,-20,873,274,-10
24283177661,24283177663,2,1153,1322,-10
24291187269,24291187270,1,1573,2467,-10
24298054057,24298054058,1,1905,1983,-10
24298418989,24298418990,1,1646,1800,-10
24299379396,24299379401,5,1975,1407,-10
24300494856,24300494857,1,1938,1827,-10
24301564171,24301564174,3,1286,1297,-10
24301590306,24301590309,3,2033,1749,-10
24302374369,24302374370,1,993,1377,-10
24306106453,24306106454,1,1333,1196,-10
24306516441,24306516421,-20,450,822,-10
24308523002,24308523006,4,1600,1835,-10
24310495288,24310495288,0,1785,1413,-10
24310814336,24310814336,0,1879,1835,-10
24313246681,24313246681,0,1273,1847,-10
24314049466,24314049466,0,1886,1682,-10
24314553328,24314553330,2,1396,2076,-10
24317902026,24317902027,1,1725,1415,-10
24318117005,24318117013,8,1250,1213,-10
24320513355,24320513359,4,1259,1410,-10
24320788457,24320788456,-1,1043,961,-10
24323629045,24323629049,4,2090,1192,-10
24324037467,24324037465,-2,1248,1365,-10
24324170419,24324170423,4,1047,852,-10
24325971041,24325971042,1,2302,1684,-10
24326555789,24326555795,6,2037,766,-10
24329155459,24329155467,8,3339,1040,-10
24330485781,24330485782,1,1653,1858,-10
24330886410,24330886413,3,1752,1448,-10
24332183837,24332183839,2,1030,1152,-10
24336763275,24336763279,4,1547,1281,-10
24337084321,24337084322,1,1339,1824,-10
24337606074,24337606074,0,1340,1528,-10
24340285279,24340285283,4,1519,1356,-10
24345747308,24345747310,2,1857,1810,-10
24347661732,24347661736,4,1128,1508,-10
24350063231,24350063234,3,1621,1477,-10
24352537528,24352537530,2,1349,1169,-10
24353935718,24353935713,-5,3872,11859,-10
24354164898,24354164898,0,1413,981,-10
24355799836,24355799838,2,1246,1250,-10
24356500607,24356500607,0,1804,2496,-10
24356805919,24356805919,0,1128,1371,-10
24362013635,24362013636,1,1776,2154,-10
24362046170,24362046170,0,1241,1803,-10
24376534059,24376534053,-6,993,2303,-10
24377038981,24377038983,2,3459,11436,-10
24379436715,24379436714,-1,477,929,-10
24379938019,24379938020,1,2193,1740,-10
24381792131,24381792133,2,743,955,-10
24383810599,24383810602,3,1083,1258,-10
24385351866,24385351868,2,4133,3329,-10
24385394037,24385394037,0,1400,1493,-10
24388952744,24388952745,1,1332,1618,-10
24392446291,24392446292,1,1799,2100,-10
24392962949,24392962950,1,1688,1508,-10
24396173438,24396173439,1,1786,1286,-10
24396638846,24396638844,-2,1169,1436,-10
24397301678,24397301680,2,1377,2093,-10
24400550698,24400550694,-4,1117,1557,-10
24401780166,24401780165,-1,1795,2038,-10
24402263929,24402263931,2,1159,1333,-10
24403204450,24403204471,21,2152,1779,-10
24405458162,24405458166,4,1554,1291,-10
24406222100,24406222101,1,1030,1908,-10
24409577338,24409577337,-1,1916,1914,-10
24413051991,24413051993,2,1208,1463,-10
24415094298,24415094279,-19,1502,2919,-10
24416542430,24416542431,1,1167,1346,-10
24419311138,24419311139,1,1692,1774,-10
24419372167,24419372170,3,1297,901,-10
24422378563,24422378564,1,1546,1595,-10
24426120823,24426120820,-3,2634,4973,-10
24426362121,24426362123,2,2290,2300,-10
24429253753,24429253756,3,1410,1575,-10
24429733605,24429733587,-18,1757,1998,-10
24429910501,24429910506,5,1976,1343,-10
24431811357,24431811359,2,1812,1179,-10
24433028509,24433028513,4,1512,1623,-10
24436010030,24436010031,1,1539,1162,-10
24436263774,24436263778,4,668,260,-10
24436537982,24436537990,8,5077,1894,-10
24436903718,24436903720,2,2257,1976,-10
24436965815,24436965817,2,1721,1490,-10
24437135526,24437135526,0,1258,1582,-10
24439808800,24439808801,1,1481,1599,-10
24440210686,24440210687,1,1793,1652,-10
24443873662,24443873662,0,2438,2215,-10
24446250359,24446250361,2,1536,1872,-10
24446857258,24446857258,0,1226,2125,-10
24447256457,24447256458,1,1076,1582,-10
24454950410,24454950413,3,1607,1705,-10
24455323874,24455323878,4,991,1363,-10
24460102629,24460102630,1,1296,1448,-10
24462998705,24462998698,-7,864,3013,-10
24468124623,24468124625,2,2003,1671,-10
24469795827,24469795827,0,1391,1737,-10
24471229771,24471229750,-21,2020,1722,-10
24472082005,24472082007,2,1217,1392,-10
24475610482,24475610483,1,1181,939,-10
24477548254,24477548255,1,1219,861,-10
24478742760,24478742759,-1,1694,1835,-10
24479392128,24479392124,-4,1246,1561,-10
24479704417,24479704421,4,1481,1817,-10
24480721342,24480721321,-21,1845,1746,-10
24483906501,24483906502,1,1568,1657,-10
24487104277,24487104278,1,1573,1107,-10
24488221368,24488221370,2,1283,1233,-10
24490310007,24490309997,-10,8239,17543,-10
24490409962,24490409964,2,2333,1486,-10
24492168776,24492168795,19,14989,28410,-10
24492936857,24492936863,6,4211,1526,-10
24493655540,24493655543,3,1740,1469,-10
24495672730,24495672734,4,2173,1479,-10
24495765294,24495765297,3,1485,1882,-10
24500191289,24500191290,1,1386,1602,-10
24501089875,24501089878,3,1063,1196,-10
24504776214,24504776218,4,2376,1647,-10
24506570974,24506570975,1,1674,1675,-10
24510021179,24510021176,-3,1701,3113,-10
24510127730,24510127734,4,1370,1287,-10
24513035328,24513035330,2,1838,1975,-10
24513142919,24513142922,3,2138,1709,-10
24513771832,24513771825,-7,1380,5612,-10
24516283098,24516283099,1,2027,2100,-10
24517934610,24517934613,3,1341,1745,-10
24520771353,24520771357,4,1678,1566,-10
24522165395,24522165397,2,1505,1531,-10
24523478025,24523478032,7,188,1717,-10
24529570658,24529570658,0,2041,2451,-10
24530733634,24530733637,3,1284,1295,-10
24531572759,24531572759,0,1971,1546,-10
24532777490,24532777492,2,2031,1933,-10
24533737600,24533737602,2,1601,1516,-10
24536491687,24536491689,2,1703,1442,-10
24537463020,24537463022,2,1546,1322,-10
24539347981,24539347981,0,3255,3550,-10
24539795052,24539795055,3,1412,1136,-10
24540828962,24540828962,0,1585,1754,-10
24541079302,24541079302,0,1612,1718,-10
24541503625,24541503621,-4,832,3042,-10
24543497661,24543497663,2,1827,1866,-10
24543626200,24543626201,1,1598,1593,-10
24546357440,24546357439,-1,1245,1145,-10
24549141604,24549141606,2,1469,1466,-10
24552277245,24552277246,1,1387,1394,-10
24553047337,24553047339,2,1277,1369,-10
24554285247,24554285246,-1,932,786,-10
24556524371,24556524373,2,1258,742,-10
24558392425,24558392426,1,1706,1514,-10
24560283469,24560283474,5,2742,1490,-10
24560831966,24560831967,1,2078,1606,-10
24562281855,24562281858,3,1266,1371,-10
24562850793,24562850796,3,1212,1328,-10
24565023410,24565023410,0,1289,1854,-10
24565620030,24565620029,-1,1213,2454,-10
24566588742,24566588746,4,1442,1463,-10
24567341775,24567341779,4,1568,1310,-10
24568811178,24568811181,3,1791,1551,-10
24570265674,24570265677,3,1905,1568,-10
24571266589,24571266590,1,2596,1812,-10
24575934498,24575934498,0,1228,1434,-10
24577031281,24577031281,0,1743,1550,-10
24582454065,24582454067,2,1198,1055,-10
24584322723,24584322726,3,2593,1567,-10
24586490023,24586490026,3,1646,1479,-10
24589359954,24589359956,2,1292,1466,-10
24589889651,24589889653,2,1850,1138,-10
24595601102,24595601106,4,1364,733,-10
24595920643,24595920642,-1,829,1926,-10
24599829921,24599829923,2,40389,20321,-10
24602540280,24602540282,2,2489,1880,-10
24604511150,24604511150,0,1430,1505,-10
24608798966,24608798969,3,1319,1245,-10
24608878606,24608878625,19,978,1695,-10
24608956738,24608956745,7,1641,1475,-10
24609636990,24609636994,4,1171,1303,-10
24611090102,24611090102,0,1215,1381,-10
24619549030,24619549031,1,1325,1870,-10
24623835558,24623835561,3,1830,1778,-10
24626513494,24626513494,0,1334,1523,-10
24629661462,24629661463,1,1559,1813,-10
24630212678,24630212678,0,1761,1611,-10
24636673958,24636673961,3,1328,1316,-10
24636794000,24636794002,2,1252,1399,-10
24639273898,24639273882,-16,1549,593,-10
24640195639,24640195641,2,913,921,-10
24641015482,24641015485,3,37204,34623,-10
24643054815,24643054816,1,1034,1488,-10
24645129492,24645129495,3,1693,1627,-10
24645290554,24645290555,1,1194,1639,-10
24647628874,24647628876,2,1870,1767,-10
24648435629,24648435629,0,1310,1281,-10
24649885121,24649885121,0,1568,1758,-10
24652749130,24652749135,5,4577,1006,-10
24654122713,24654122716,3,1564,1626,-10
24655276446,24655276440,-6,2243,6881,-10
24655819530,24655819536,6,1243,1290,-10
24659310139,24659310138,-1,660,922,-10
24660968590,24660968592,2,1285,1276,-10
24669340421,24669340421,0,1737,2836,-10
24671507466,24671507467,1,1462,1250,-10
24674226953,24674226951,-2,1399,1878,-10
24675021602,24675021603,1,1652,1703,-10
24676933441,24676933445,4,1636,1437,-10
24677645807,24677645810,3,1469,1586,-10
24680953839,24680953842,3,1482,1502,-10
24681570745,24681570748,3,1413,1815,-10
24681907966,24681907967,1,1525,1408,-10
24681970992,24681970992,0,1638,1516,-10
24691123606,24691123615,9,1542,871,-10
24694718371,24694718371,0,1503,1541,-10
24696829233,24696829216,-17,1962,2065,-10
24701114933,24701114936,3,1645,1095,-10
24704836494,24704836497,3,2528,1872,-10
24707040350,24707040352,2,1833,1496,-10
24707323188,24707323190,2,1724,1351,-10
24712082457,24712082458,1,979,1360,-10
24712749377,24712749395,18,1195,1336,-10
24719558989,24719558987,-2,1095,1403,-10
24721968700,24721968702,2,2569,2020,-10
24723255466,24723255470,4,1228,1417,-10
24723472417,24723472418,1,1865,2414,-10
24723513769,24723513771,2,1603,1590,-10
24724330732,24724330739,7,2322,1261,-10
24727910134,24727910138,4,1460,1187,-10
24732631226,24732631226,0,936,1123,-10
24735885798,24735885800,2,1210,1262,-10
24745377212,24745377214,2,1829,1684,-10
24745743963,24745743965,2,1648,2027,-10
24746941866,24746941869,3,1388,1658,-10
24748833381,24748833382,1,1693,2317,-10
24749682965,24749682966,1,1398,1864,-10
24750811122,24750811120,-2,1683,2518,-10
24752126323,24752126324,1,2147,2149,-10
24755544666,24755544667,1,1945,1179,-10
24761310883,24761310886,3,1428,978,-10
24763009912,24763009914,2,2033,1456,-10
24764202187,24764202189,2,2200,1729,-10
24764650065,24764650066,1,1563,1283,-10
24767063908,24767063910,2,1467,1548,-10
24767871226,24767871225,-1,1409,1224,-10
24773037729,24773037730,1,1072,855,-10
24775680521,24775680523,2,1444,1484,-10
24776562022,24776562025,3,991,1385,-10
24778567723,24778567725,2,1423,1915,-10
24779898827,24779898828,1,1398,1415,-10
24785402004,24785402014,10,14751,19938,-10
24787447945,24787447947,2,1544,1269,-10
24788831012,24788831019,7,1331,1213,-10
24793023731,24793023735,4,941,1100,-10
24795569898,24795569897,-1,1216,1853,-10
24797845670,24797845670,0,1353,1328,-10
24799650079,24799650078,-1,794,894,-10
24801886657,24801886656,-1,2990,4849,-10
24811922239,24811922241,2,1625,1847,-10
24815256763,24815256766,3,2527,2067,-10
24818448975,24818448974,-1,1386,1870,-10
24819088117,24819088119,2,1519,1066,-10
24821305601,24821305601,0,1295,1446,-10
24826899055,24826899058,3,1844,1346,-10
24828649150,24828649153,3,1697,1600,-10
24829938602,24829938601,-1,2246,4126,-10
24830180551,24830180553,2,1358,1749,-10
24830253967,24830253971,4,1681,1362,-10
24831698078,24831698082,4,1384,1658,-10
24833056800,24833056797,-3,1059,2833,-10
24834309061,24834309060,-1,1482,1233,-10
24835459089,24835459091,2,1606,1342,-10
24839158416,24839158409,-7,1175,1036,-10
24840627100,24840627102,2,1578,1393,-10
24841152865,24841152867,2,1758,1934,-10
24841650713,24841650716,3,2078,2064,-10
24841724185,24841724187,2,2256,1517,-10
24842391743,24842391747,4,1778,1448,-10
24843015079,24843015079,0,1448,1369,-10
24843336967,24843336969,2,1214,1532,-10
24845381525,24845381526,1,1477,1511,-10
24848653475,24848653478,3,1635,1231,-10
24849006090,24849006091,1,1470,1360,-10
24851699147,24851699149,2,2434,1475,-10
24854636642,24854636639,-3,1151,2426,-10
24855628590,24855628597,7,45,2581,-10
24856319952,24856319954,2,1414,1480,-10
24858895817,24858895818,1,1434,1588,-10
24860074964,24860074967,3,1879,1969,-10
24861160621,24861160623,2,1518,1332,-10
24862040747,24862040748,1,1328,1507,-10
24862752370,24862752375,5,2006,1669,-10
24863578383,24863578386,3,1897,1496,-10
24863677427,24863677429,2,1437,988,-10
24864378499,24864378513,14,14378,5560,-10
24865213590,24865213590,0,1639,2119,-10
24870844594,24870844596,2,1619,1780,-10
24870938399,24870938403,4,1211,1238,-10
24873190713,24873190715,2,1280,2089,-10
24874168638,24874168639,1,1199,1913,-10
24875329660,24875329663,3,1052,1457,-10
24876041778,24876041777,-1,1108,1539,-10
24878723869,24878723870,1,2055,1754,-10
24880085874,24880085876,2,1890,2132,-10
24881805839,24881805841,2,1484,1495,-10
24882883857,24882883861,4,1476,2022,-10
24883309978,24883309972,-6,831,1858,-10
24883449597,24883449600,3,2223,1817,-10
24885720749,24885720755,6,2197,1190,-10
24889159592,24889159591,-1,1558,1539,-10
24898095805,24898095807,2,976,913,-10
24898493314,24898493317,3,1599,1740,-10
24900543070,24900543074,4,1646,1624,-10
24900812334,24900812334,0,1351,1155,-10
24901708670,24901708666,-4,5063,13802,-10
24902135910,24902135912,2,1533,1581,-10
24903134255,24903134254,-1,999,1717,-10
24916775045,24916775047,2,900,1347,-10
24918392981,24918392982,1,1396,1691,-10
24924071994,24924071991,-3,2577,5842,-10
24925111378,24925111379,1,1251,1438,-10
24925428037,24925428038,1,1694,2358,-10
24930616421,24930616423,2,1500,1219,-10
24931259034,24931259037,3,1224,1208,-10
24932798237,24932798233,-4,3310,5561,-10
24934009481,24934009480,-1,1069,1705,-10
24934106188,24934106189,1,1156,1363,-10
24936072190,24936072185,-5,1460,4299,-10
24936761815,24936761818,3,1059,1226,-10
24937719827,24937719831,4,1650,1833,-10
24939817386,24939817389,3,1782,1705,-10
24940281765,24940281767,2,1122,1473,-10
24942907022,24942907024,2,9836,52823,-10
24944363385,24944363388,3,1484,1492,-10
24944736113,24944736118,5,1178,1133,-10
24949337503,24949337505,2,1397,1379,-10
24949827510,24949827513,3,1350,1293,-10
24951257163,24951257165,2,1310,1588,-10
24955320502,24955320503,1,1012,1186,-10
24955346258,24955346259,1,1643,1365,-10
24957613657,24957613659,2,1591,1285,-10
24957952489,24957952494,5,3741,1680,-10
24961640162,24961640164,2,1639,1584,-10
24965139752,24965139754,2,1560,1150,-10
24965544095,24965544097,2,1703,1538,-10
24966658677,24966658679,2,1184,1480,-10
24967401675,24967401678,3,1310,1377,-10
24967827437,24967827417,-20,1368,1176,-10
24968368246,24968368251,5,1774,1223,-10
24970071645,24970071652,7,3134,1262,-10
24973863471,24973863473,2,1281,1174,-10
24974431390,24974431390,0,1486,1646,-10
24974947854,24974947857,3,1684,2214,-10
24976561845,24976561844,-1,1864,2166,-10
24979646200,24979646202,2,1770,2212,-10
24980508041,24980508043,2,2015,1696,-10
24980551569,24980551570,1,1860,1495,-10
24980592978,24980592978,0,1639,1228,-10
24981407491,24981407493,2,2082,2092,-10
24982288155,24982288156,1,2211,1392,-10
24983580540,24983580541,1,1650,1561,-10
24986424910,24986424913,3,1548,1243,-10
24991211006,24991211007,1,1396,1652,-10
24996765941,24996765942,1,1638,1543,-10
24997082500,24997082502,2,1923,1319,-10
24997863293,24997863295,2,2233,1503,-10
25002651137,25002651138,1,1695,1091,-10
25007688142,25007688144,2,1100,1389,-10
25008521246,25008521245,-1,861,1953,-10
25011105174,25011105178,4,1765,1837,-10
25015712421,25015712422,1,1306,1317,-10
25015754979,25015754979,0,1083,1343,-10
25015850731,25015850734,3,1612,1811,-10
25016098345,25016098351,6,3663,1513,-10
25019121570,25019121570,0,1497,1664,-10
25019492580,25019492585,5,3570,2578,-10
25020364414,25020364417,3,1651,1392,-10
25021481154,25021481149,-5,2516,9842,-10
25022143594,25022143596,2,1075,975,-10
25023492407,25023492411,4,944,1070,-10
25029257563,25029257563,0,1671,2163,-10
25029500967,25029500970,3,1186,1372,-10
25030907365,25030907366,1,1161,1052,-10
25031656728,25031656730,2,1879,1580,-10
25032610318,25032610304,-14,1472,1725,-10
25035480712,25035480695,-17,1380,881,-10
25036023462,25036023463,1,966,861,-10
25038362500,25038362523,23,665,658,-10
25039241551,25039241555,4,1620,1546,-10
25039387841,25039387842,1,1787,1204,-10
25041830998,25041831002,4,1332,1031,-10
25042004304,25042004306,2,1661,1851,-10
25042331143,25042331139,-4,1746,5008,-10
25042370952,25042370954,2,1863,2058,-10
25043114699,25043114697,-2,829,1909,-10
25047447906,25047447910,4,872,658,-10
25049901771,25049901776,5,2857,1664,-10
25051824834,25051824835,1,1124,538,-10
25054707758,25054707758,0,759,1312,-10
25056259913,25056259918,5,2283,1301,-10
25056380854,25056380856,2,1710,1554,-10
25057876158,25057876161,3,1242,1463,-10
25058871659,25058871661,2,1124,1420,-10
25059517815,25059517819,4,1261,1364,-10
25060856894,25060856896,2,1134,1904,-10
25062679278,25062679281,3,1499,1492,-10
25066926331,25066926330,-1,1672,1189,-10
25070298754,25070298754,0,1286,1555,-10
25072236936,25072236937,1,1861,1617,-10
25075067570,25075067578,8,2979,1130,-10
25075233539,25075233542,3,1259,1949,-10
25075461001,25075460998,-3,619,1029,-10
25076160175,25076160178,3,1734,1432,-10
25080280154,25080280158,4,1662,1684,-10
25080486693,25080486694,1,1450,1378,-10
25082873557,25082873540,-17,2900,1866,-10
25086489094,25086489096,2,1409,1429,-10
25089308231,25089308232,1,1645,1983,-10
25089552317,25089552338,21,512,393,-10
25090498255,25090498258,3,1540,1017,-10
25092335798,25092335799,1,2620,2241,-10
25094582375,25094582375,0,1554,1383,-10
25095187046,25095187047,1,1765,2094,-10
25096600672,25096600674,2,1332,1685,-10
25096643355,25096643357,2,1384,1719,-10
25097247953,25097247954,1,1322,1592,-10
25098752845,25098752849,4,1177,1365,-10
25100653541,25100653541,0,1030,1437,-10
25101384108,25101384109,1,1206,1170,-10
25102111910,25102111913,3,2755,3191,-10
25103652704,25103652693,-11,48982,9142,-10
25103938870,25103938873,3,2637,2085,-10
25104409594,25104409597,3,2221,1638,-10
25105552374,25105552377,3,1058,1568,-10
25110693633,25110693634,1,974,1060,-10
25112673981,25112673982,1,2153,1669,-10
25114698495,25114698496,1,2291,1685,-10
25117486425,25117486426,1,1400,1069,-10
25120143982,25120143988,6,5231,2757,-10
25126057029,25126057033,4,1959,2141,-10
25134572354,25134572356,2,1528,1734,-10
25136299030,25136299030,0,750,926,-10
25136500350,25136500354,4,1994,1413,-10
25138913019,25138913022,3,2214,1981,-10
25141206457,25141206458,1,1929,1589,-10
25141734523,25141734527,4,1687,1361,-10
25142688688,25142688690,2,1224,1493,-10
25143760280,25143760288,8,3342,1453,-10
25146077033,25146077037,4,1914,1510,-10
25148200739,25148200738,-1,974,1146,-10
25151049314,25151049315,1,1687,1586,-10
25152143156,25152143156,0,1681,1828,-10
25154446607,25154446618,11,11053,45600,-10
25154967218,25154967221,3,963,815,-10
25155544579,25155544582,3,2195,1568,-10
25156371307,25156371309,2,996,1433,-10
25159234190,25159234191,1,1758,2420,-10
25159586618,25159586620,2,2025,1926,-10
25160461665,25160461669,4,2145,1639,-10
25160516814,25160516793,-21,1610,1607,-10
25161511045,25161511046,1,1594,1623,-10
25164612074,25164612074,0,1234,1240,-10
25173382471,25173382474,3,1080,1358,-10
25176079179,25176079180,1,2265,1581,-10
25176624198,25176624201,3,1577,1729,-10
25179910390,25179910392,2,1953,1798,-10
25181495297,25181495299,2,2293,1559,-10
25182060061,25182060062,1,1448,1281,-10
25191173857,25191173859,2,1195,1672,-10
25193670277,25193670277,0,1543,1311,-10
25193955893,25193955894,1,1818,1591,-10
25195226950,25195226953,3,1621,2121,-10
25197982333,25197982333,0,1646,1032,-10
25198994202,25198994204,2,2041,1515,-10
25199187516,25199187520,4,7879,36394,-10
25200443409,25200443409,0,1584,1878,-10
25201506409,25201506412,3,1486,1452,-10
25204329394,25204329398,4,1593,1396,-10
25207345486,25207345488,2,1222,1021,-10
25213701175,25213701179,4,826,724,-10
25214847784,25214847786,2,2221,1894,-10
25215949474,25215949475,1,1932,1624,-10
25219456838,25219456841,3,1568,1294,-10
25219734999,25219734979,-20,1168,1553,-10
25223074905,25223074902,-3,1927,1615,-10
25223227482,25223227484,2,1681,1525,-10
25224235486,25224235487,1,1470,1036,-10
25228276574,25228276582,8,2717,1320,-10
25229448071,25229448073,2,1207,1499,-10
25230749242,25230749245,3,1357,1359,-10
25232109226,25232109225,-1,21278,29385,-10
25232861588,25232861577,-11,281,1975,-10
25241433475,25241433477,2,2233,1418,-10
25242442873,25242442873,0,1845,2011,-10
25242510148,25242510151,3,1494,1133,-10
25242669958,25242669960,2,1467,1457,-10
25244134299,25244134300,1,989,901,-10
25245728385,25245728382,-3,1239,2878,-10
25246584637,25246584640,3,2066,1503,-10
25249277105,25249277106,1,1240,1386,-10
25250999225,25250999228,3,1692,1093,-10
25256769296,25256769298,2,1559,1572,-10
25258252491,25258252494,3,1794,2049,-10
25258948377,25258948378,1,1822,1544,-10
25259018186,25259018194,8,3043,1118,-10
25262148311,25262148314,3,1779,1766,-10
25263744543,25263744543,0,8696,9208,-10
25263944683,25263944683,0,1066,1443,-10
25267053569,25267053573,4,2422,1353,-10
25268048497,25268048499,2,1836,1160,-10
25273307964,25273307966,2,1591,1475,-10
25275500862,25275500860,-2,2160,5478,-10
25277618652,25277618654,2,1390,1645,-10
25279111211,25279111213,2,1377,1066,-10
25286959550,25286959550,0,1011,1045,-10
25290300450,25290300453,3,1562,1934,-10
25291969675,25291969678,3,985,1175,-10
25292695329,25292695329,0,2343,2007,-10
25293111267,25293111273,6,4253,1370,-10
25294863940,25294863943,3,1194,1355,-10
25295214681,25295214681,0,2089,1993,-10
25295583632,25295583633,1,2075,1733,-10
25295743444,25295743462,18,2,2301,-10
25297231007,25297231011,4,2178,1489,-10
25297889844,25297889846,2,1305,1307,-10
25301285316,25301285318,2,1325,1205,-10
25302333299,25302333309,10,16991,19341,-10
25304589642,25304589645,3,2319,1835,-10
25307999300,25307999302,2,1650,1360,-10
25308994795,25308994795,0,1388,1452,-10
25314008527,25314008530,3,663,902,-10
25314578044,25314578042,-2,1717,1999,-10
25315318638,25315318641,3,2090,1800,-10
25317017117,25317017118,1,1805,1606,-10
25317799142,25317799145,3,1994,2103,-10
25323825019,25323825020,1,1831,1957,-10
25324408942,25324408945,3,1419,1367,-10
25327511306,25327511306,0,1960,1950,-10
25327837200,25327837203,3,1544,1192,-10
25330715962,25330715965,3,1185,846,-10
25331772326,25331772327,1,1652,1073,-10
25335670078,25335670078,0,1462,1623,-10
25337902120,25337902118,-2,2111,3241,-10
25339933436,25339933438,2,1021,1410,-10
25350129609,25350129610,1,1969,1618,-10
25350842163,25350842166,3,1090,1372,-10
25359145793,25359145795,2,1095,1811,-10
25363777189,25363777191,2,1666,1821,-10
25364545366,25364545367,1,1672,2082,-10
25364765590,25364765591,1,1870,1988,-10
25365488414,25365488415,1,1615,2011,-10
25365697697,25365697702,5,2160,1253,-10
25365993231,25365993211,-20,760,970,-10
25367310199,25367310201,2,1143,1145,-10
25367548993,25367548995,2,1226,1169,-10
25368465626,25368465644,18,825,1817,-10
25371499011,25371499014,3,1572,1881,-10
25374528759,25374528761,2,1722,1459,-10
25374787529,25374787527,-2,916,2744,-10
25377164250,25377164250,0,1424,1412,-10
25379472150,25379472153,3,1388,1391,-10
25380715425,25380715427,2,1668,1698,-10
25381256426,25381256411,-15,1096,1588,-10
25382999118,25382999118,0,988,2110,-10
25383751945,25383751947,2,980,903,-10
25385126036,25385126040,4,2751,1851,-10
25385717695,25385717695,0,1621,1317,-10
25387639920,25387639906,-14,1610,2227,-10
25388440660,25388440661,1,1272,1303,-10
25390933350,25390933351,1,837,958,-10
25391120733,25391120712,-21,1252,756,-10
25391566137,25391566138,1,2003,1227,-10
25395564597,25395564598,1,1691,2174,-10
25397577337,25397577359,22,1763,1769,-10
25398630845,25398630847,2,1089,901,-10
25401233215,25401233216,1,1638,2140,-10
25402382887,25402382890,3,1525,1106,-10
25403538762,25403538765,3,2354,1716,-10
25404409171,25404409173,2,2010,2258,-10
25406470834,25406470838,4,1370,1226,-10
25409102995,25409102998,3,2434,1649,-10
25411609161,25411609163,2,1467,2107,-10
25412868895,25412868895,0,1859,2075,-10
25414115230,25414115227,-3,1204,1904,-10
25415334626,25415334630,4,1181,1145,-10
25420058854,25420058850,-4,1362,3251,-10
25422625534,25422625536,2,1426,2080,-10
25423948884,25423948887,3,1202,1553,-10
25426643201,25426643202,1,1338,1487,-10
25430513555,25430513562,7,2630,1464,-10
25430917973,25430917974,1,1804,1345,-10
25433099937,25433099938,1,1011,1217,-10
25435201027,25435201029,2,2109,2107,-10
25436859987,25436859990,3,1519,1434,-10
25438107530,25438107531,1,1727,1158,-10
25439156421,25439156424,3,1189,1440,-10
25440255885,25440255888,3,2627,2127,-10
25442799262,25442799263,1,1151,987,-10
25448330714,25448330714,0,1128,897,-10
25451736404,25451736402,-2,1340,1401,-10
25452470405,25452470409,4,632,1427,-10
25455615437,25455615438,1,2200,2221,-10
25457047824,25457047826,2,1525,1378,-10
25457148751,25457148754,3,1820,1758,-10
25459477359,25459477358,-1,1067,1379,-10
25466620913,25466620915,2,1235,1031,-10
25467013784,25467013784,0,1904,2488,-10
25468132144,25468132146,2,2309,1699,-10
25475526683,25475526677,-6,2342,7043,-10
25478272970,25478272970,0,1122,1176,-10
25478535595,25478535593,-2,1359,2057,-10
25488179715,25488179715,0,1021,1758,-10
25490498468,25490498471,3,1420,1337,-10
25491714147,25491714145,-2,1233,2393,-10
25492437805,25492437808,3,1275,1875,-10
25497123985,25497123986,1,1320,1544,-10
25497718649,25497718651,2,1462,1312,-10
25499206949,25499206950,1,1461,1283,-10
25500425834,25500425834,0,2001,1473,-10
25501732747,25501732741,-6,1113,5188,-10
25502579616,25502579619,3,2337,1556,-10
25503268087,25503268089,2,2097,1528,-10
25505219160,25505219162,2,1541,1583,-10
25509426720,25509426725,5,20636,20522,-10
25513950589,25513950589,0,1742,1837,-10
25515609100,25515609104,4,1803,1991,-10
25516916826,25516916827,1,1267,888,-10
25517197842,25517197845,3,1590,1986,-10
25518039902,25518039899,-3,1449,2975,-10
25518201445,25518201448,3,1259,1321,-10
25518539054,25518539054,0,1778,2333,-10
25518927732,25518927734,2,2013,2143,-10
25519021609,25519021610,1,1424,1418,-10
25521062369,25521062371,2,1574,1549,-10
25521937869,25521937873,4,1389,2142,-10
25524217322,25524217326,4,1993,1389,-10
25526453354,25526453356,2,1804,1946,-10
25528841628,25528841628,0,983,1341,-10
25531369346,25531369348,2,1029,1121,-10
25532409702,25532409704,2,1692,1336,-10
25536205152,25536205153,1,1553,1137,-10
25536485721,25536485722,1,1720,1106,-10
25537728243,25537728246,3,2459,1313,-10
25539289873,25539289876,3,2016,3020,-10
25539771682,25539771684,2,1767,1737,-10
25541048106,25541048106,0,1499,1225,-10
25542536764,25542536765,1,1314,1108,-10
25543669744,25543669747,3,1742,1991,-10
25545141601,25545141604,3,1010,1118,-10
25546527485,25546527484,-1,48,905,-10
25548733946,25548733948,2,1532,1379,-10
25550297957,25550297959,2,1650,1572,-10
25551571971,25551571973,2,1509,1736,-10
25552559609,25552559611,2,1621,1724,-10
25552946686,25552946693,7,1016,1002,-10
25553769711,25553769715,4,1260,1531,-10
25557247430,25557247434,4,1598,1489,-10
25559958688,25559958690,2,1589,1555,-10
25560536459,25560536458,-1,888,1702,-10
25560876395,25560876396,1,1292,2167,-10
25562997655,25562997647,-8,2356,1758,-10
25563256798,25563256800,2,1368,1424,-10
25566006201,25566006206,5,3225,2213,-10
25567210810,25567210810,0,1455,1302,-10
25574071950,25574071953,3,1693,1869,-10
25574255583,25574255577,-6,1351,3368,-10
25574390921,25574390921,0,1350,2463,-10
25579743627,25579743629,2,1638,1651,-10
25580574311,25580574311,0,1263,1262,-10
25582005341,25582005343,2,1221,1263,-10
25582414229,25582414229,0,3025,3185,-10
25582652939,25582652938,-1,970,1273,-10
25587661650,25587661641,-9,1618,10489,-10
25587844829,25587844837,8,16243,22226,-10
25591265235,25591265238,3,1344,1168,-10
25594353103,25594353105,2,1529,1347,-10
25595133120,25595133125,5,2110,1750,-10
25595383082,25595383085,3,2022,1702,-10
25600011402,25600011404,2,1349,1575,-10
25600312734,25600312735,1,1663,1781,-10
25603418110,25603418110,0,1281,1134,-10
25604059334,25604059338,4,2145,2100,-10
25604883136,25604883138,2,1871,878,-10
25606215142,25606215160,18,820,235,-10
25607696149,25607696150,1,1861,1181,-10
25608307835,25608307837,2,1454,1315,-10
25609484510,25609484515,5,848,811,-10
25610786251,25610786253,2,1465,1476,-10
25610844594,25610844595,1,2035,1786,-10
25610972287,25610972286,-1,1792,1320,-10
25611917150,25611917152,2,1722,1643,-10
25617282670,25617282670,0,1417,1642,-10
25620080167,25620080170,3,714,937,-10
25620915898,25620915902,4,1189,1629,-10
25622851555,25622851550,-5,1365,3388,-10
25627549178,25627549178,0,1662,1296,-10
25628207269,25628207269,0,1079,1909,-10
25630802765,25630802766,1,1514,1226,-10
25631105390,25631105390,0,1599,1810,-10
25631621089,25631621090,1,1551,1312,-10
25633088402,25633088404,2,1570,1290,-10
25635373750,25635373751,1,1186,1262,-10
25636367128,25636367130,2,1364,1147,-10
25637885250,25637885250,0,1683,2255,-10
25639234893,25639234894,1,1234,1421,-10
25639580383,25639580386,3,1019,819,-10
25639695778,25639695778,0,1339,1384,-10
25640747173,25640747174,1,1767,1845,-10
25641465851,25641465852,1,1624,1418,-10
25642694721,25642694718,-3,1880,2221,-10
25645295799,25645295801,2,1174,1256,-10
25646122523,25646122526,3,1189,1853,-10
25649002665,25649002666,1,1523,1756,-10
25649161570,25649161561,-9,1541,587,-10
25650786805,25650786802,-3,926,2190,-10
25651904115,25651904117,2,1158,1572,-10
25654663070,25654663050,-20,948,912,-10
25654882387,25654882391,4,1616,1808,-10
25655540859,25655540861,2,1066,1845,-10
25655910283,25655910290,7,6154,2052,-10
25658755552,25658755553,1,1259,1304,-10
25659629651,25659629655,4,1230,1715,-10
25660756001,25660756000,-1,766,1519,-10
25665156225,25665156231,6,734,844,-10
25666470393,25666470394,1,1862,2089,-10
25668186834,25668186836,2,1765,1554,-10
25668522431,25668522426,-5,1654,2909,-10
25668591937,25668591938,1,1428,1511,-10
25669393255,25669393260,5,11871,35902,-10
25669435657,25669435662,5,1983,1839,-10
25669732650,25669732651,1,1344,1066,-10
25671341111,25671341111,0,876,1583,-10
25671748095,25671748095,0,1830,1694,-10
25671889582,25671889582,0,1320,1150,-10
25675118703,25675118704,1,1303,1666,-10
25675738850,25675738852,2,1727,1921,-10
25676782014,25676782015,1,1767,1654,-10
25679135962,25679135979,17,630,946,-10
25679689959,25679689961,2,1713,1828,-10
25683244998,25683244999,1,1556,1546,-10
25683362002,25683362003,1,558,907,-10
25691656791,25691656790,-1,1503,1701,-10
25692893106,25692893109,3,1647,1432,-10
25694319921,25694319925,4,1312,1557,-10
25696951477,25696951479,2,1447,1894,-10
25699266085,25699266087,2,1525,1293,-10
25699666710,25699666711,1,1765,1743,-10
25700039441,25700039442,1,2099,1692,-10
25705099188,25705099189,1,1572,1877,-10
25705704775,25705704776,1,1027,1226,-10
25707425245,25707425248,3,1979,1815,-10
25709389818,25709389819,1,1868,1655,-10
25709953212,25709953214,2,1605,1412,-10
25712511251,25712511246,-5,1067,2619,-10
25718673359,25718673363,4,1257,1287,-10
25721254823,25721254823,0,1515,1260,-10
25721900058,25721900079,21,800,769,-10
25722854641,25722854642,1,1088,1412,-10
25727273023,25727273027,4,1175,1673,-10
25732933517,25732933520,3,1130,1056,-10
25734049085,25734049090,5,1941,1395,-10
25735115062,25735115064,2,1851,2034,-10
25739513300,25739513302,2,1169,1171,-10
25748952778,25748952778,0,1424,1344,-10
25749550398,25749550401,3,1608,1754,-10
25751998906,25751998922,16,1661,962,-10
25755249556,25755249559,3,1868,2294,-10
25755969451,25755969453,2,1061,1494,-10
25759417681,25759417683,2,972,1135,-10
25762886780,25762886782,2,1664,1568,-10
25763408141,25763408142,1,1466,1982,-10
25765192670,25765192674,4,1468,1240,-10
25765698773,25765698775,2,1445,1345,-10
25767247077,25767247082,5,1888,1015,-10
25772696485,25772696479,-6,1589,5627,-10
25772958878,25772958881,3,2635,1714,-10
25775210676,25775210680,4,1997,1577,-10
25777070698,25777070703,5,1902,1748,-10
25777644899,25777644902,3,1220,1674,-10
25777907671,25777907678,7,3864,2064,-10
25784996376,25784996378,2,998,993,-10
25787246083,25787246087,4,1173,1182,-10
25788948117,25788948119,2,1386,2027,-10
25789946758,25789946762,4,1814,1841,-10
25790287637,25790287638,1,1480,1797,-10
25793424443,25793424444,1,1305,1475,-10
25794739006,25794739011,5,2100,1551,-10
25798812725,25798812721,-4,1753,2961,-10
25799497522,25799497523,1,2114,2651,-10
25799585642,25799585645,3,1143,924,-10
25800600962,25800600964,2,1349,1406,-10
25801087373,25801087375,2,1201,1877,-10
25802503117,25802503119,2,1323,1794,-10
25805422018,25805422020,2,1271,1557,-10
25808753375,25808753374,-1,1534,1359,-10
25810790247,25810790246,-1,1587,1299,-10
25818502102,25818502106,4,1929,1405,-10
25819001538,25819001541,3,1071,1573,-10
25820713577,25820713578,1,1729,1687,-10
25820906285,25820906291,6,2362,1189,-10
25821204451,25821204453,2,943,1259,-10
25824072267,25824072246,-21,2245,1628,-10
25825192421,25825192423,2,1832,1618,-10
25827681963,25827681963,0,1259,1510,-10
25828215399,25828215402,3,1229,1290,-10
25830535163,25830535169,6,1034,1137,-10
25831552950,25831552953,3,1806,1507,-10
25837067806,25837067807,1,1858,1754,-10
25837752002,25837752005,3,1002,1249,-10
25838777969,25838777970,1,1017,1011,-10
25839959269,25839959274,5,2216,1208,-10
25840551506,25840551505,-1,1391,1530,-10
25842080554,25842080558,4,1182,782,-10
25844826773,25844826775,2,1718,1878,-10
25845239745,25845239743,-2,1240,2123,-10
25845710957,25845710959,2,1724,1336,-10
25848047902,25848047903,1,1741,1582,-10
25850062098,25850062103,5,2539,995,-10
25850592469,25850592471,2,1100,1380,-10
25852637286,25852637286,0,1308,1234,-10
25853214826,25853214829,3,1771,1341,-10
25854634292,25854634294,2,1325,1217,-10
25854831308,25854831310,2,1335,1209,-10
25855196565,25855196564,-1,1456,1567,-10
25857762833,25857762834,1,1799,1838,-10
25858729559,25858729561,2,1231,1215,-10
25863909888,25863909887,-1,1631,1685,-10
25866885810,25866885811,1,1215,1121,-10
25869166859,25869166863,4,1669,1567,-10
25870160879,25870160885,6,6622,2511,-10
25874024977,25874024983,6,3589,2042,-10
25880688501,25880688502,1,1865,1324,-10
25881210135,25881210138,3,1356,1488,-10
25894961834,25894961836,2,2154,1840,-10
25896661617,25896661618,1,1643,1885,-10
25902318827,25902318829,2,1556,1829,-10
25903801633,25903801635,2,1528,1490,-10
25907575161,25907575161,0,2206,2453,-10
25907931081,25907931083,2,1842,1483,-10
25908058057,25908058064,7,1341,1287,-10
25910802590,25910802592,2,1166,813,-10
25914428790,25914428791,1,2491,2217,-10
25919980822,25919980825,3,1621,1206,-10
25921595219,25921595219,0,1749,2398,-10
25922424502,25922424505,3,1263,1609,-10
25925761515,25925761515,0,1118,864,-10
25926826665,25926826666,1,1372,1442,-10
25927651193,25927651194,1,1420,1337,-10
25928518734,25928518735,1,1517,1848,-10
25930163518,25930163522,4,1289,1210,-10
25932282394,25932282398,4,1781,1652,-10
25934842664,25934842663,-1,1095,934,-10
25935613120,25935613122,2,1536,1394,-10
25940802872,25940802873,1,1846,1609,-10
25943235186,25943235187,1,1115,783,-10
25944784753,25944784750,-3,535,1355,-10
25947517747,25947517749,2,2113,1288,-10
25952458831,25952458826,-5,1530,1862,-10
25956520171,25956520166,-5,1112,3792,-10
25961552037,25961552038,1,1191,1439,-10
25963252853,25963252854,1,2175,1456,-10
25966207277,25966207277,0,956,1283,-10
25968644983,25968644983,0,1611,1724,-10
25969108907,25969108911,4,1109,984,-10
25970271268,25970271266,-2,957,604,-10
25970892685,25970892686,1,1456,1217,-10
25972281354,25972281354,0,1911,1306,-10
25974292405,25974292410,5,1730,1482,-10
25977995264,25977995266,2,1477,1200,-10
25978745287,25978745290,3,893,1116,-10
25979881232,25979881234,2,1383,1635,-10
25980375634,25980375635,1,1756,1363,-10
25980536138,25980536141,3,1686,1471,-10
25981772165,25981772166,1,1405,1975,-10
25983725473,25983725474,1,1326,1724,-10
25985624377,25985624377,0,1752,1058,-10
25986432400,25986432400,0,1218,1933,-10
25987420963,25987420965,2,1429,1124,-10
25987612502,25987612503,1,1356,1516,-10
25992385607,25992385608,1,1497,1585,-10
25993450078,25993450082,4,2526,2179,-10
25993674514,25993674517,3,2099,1623,-10
25993734025,25993734028,3,1438,1438,-10
25995285199,25995285201,2,1775,1620,-10
25999208663,25999208657,-6,920,4035,-10
26000202954,26000202954,0,1168,1925,-10
26007643038,26007643042,4,1454,1364,-10
26015119897,26015119900,3,1098,1380,-10
26018734909,26018734913,4,1788,1069,-10
26020359172,26020359174,2,1493,1756,-10
26020558546,26020558547,1,1576,1931,-10
26022339470,26022339471,1,2017,1629,-10
26025774810,26025774813,3,1947,1598,-10
26027911637,26027911639,2,1291,1216,-10
26032362711,26032362714,3,1851,1646,-10
26036880586,26036880598,12,13136,51845,-10
26038530484,26038530486,2,1446,1419,-10
26039752279,26039752280,1,1803,1547,-10
26040164691,26040164697,6,10340,27166,-10
26049115166,26049115166,0,1165,1048,-10
26049808051,26049808050,-1,1350,1442,-10
26049884435,26049884434,-1,2545,4997,-10
26051608124,26051608125,1,1551,2215,-10
26051931210,26051931210,0,1846,1859,-10
26053105694,26053105695,1,1863,1607,-10
26054910950,26054910953,3,1792,1214,-10
26056245202,26056245202,0,818,1541,-10
26056625031,26056625048,17,683,964,-10
26057235019,26057235020,1,1260,1481,-10
26062264926,26062264930,4,1675,2144,-10
26067000662,26067000663,1,1633,1833,-10
26071033502,26071033502,0,1396,1794,-10
26071582966,26071582962,-4,782,891,-10
26073456611,26073456615,4,1473,1554,-10
26074114137,26074114139,2,2005,1551,-10
26074293158,26074293159,1,1021,970,-10
26077281142,26077281145,3,2025,1523,-10
26077400260,26077400261,1,31231,19766,-10
26077649615,26077649617,2,2408,1537,-10
26078544437,26078544439,2,947,1073,-10
26078867278,26078867278,0,1681,1382,-10
26081996842,26081996845,3,1946,1524,-10
26082308390,26082308394,4,1495,1567,-10
26083592047,26083592046,-1,1497,2044,-10
26086896643,26086896645,2,1220,1189,-10
26086924309,26086924310,1,1958,1745,-10
26090176334,26090176334,0,1375,1624,-10
26090977340,26090977342,2,1262,1044,-10
26091556444,26091556446,2,1273,1452,-10
26091668070,26091668073,3,1059,1577,-10
26093880104,26093880106,2,1500,997,-10
26094813850,26094813851,1,1891,1782,-10
26098148649,26098148652,3,2411,1680,-10
26101480953,26101480957,4,2212,1814,-10
26104162058,26104162061,3,930,746,-10
26107700041,26107700043,2,1725,1522,-10
26108237494,26108237498,4,1960,1766,-10
26109082834,26109082836,2,1840,1340,-10
26109797074,26109797075,1,1698,1498,-10
26110954154,26110954157,3,1441,1617,-10
26111213085,26111213090,5,1308,1359,-10
26117111482,26117111487,5,1252,1588,-10
26117848991,26117848993,2,1419,1736,-10
26119108153,26119108154,1,1620,2157,-10
26120681175,26120681178,3,1616,1471,-10
26120920417,26120920420,3,1268,1690,-10
26121873362,26121873365,3,1731,1565,-10
26122904778,26122904781,3,1813,1398,-10
26127760657,26127760658,1,1830,1490,-10
26127842357,26127842357,0,1127,1280,-10
26128332986,26128332973,-13,1892,1797,-10
26131759054,26131759033,-21,45,479,-10
26131942986,26131942991,5,1894,1809,-10
26137325818,26137325820,2,1620,1836,-10
26138523337,26138523338,1,1517,1349,-10
26140772058,26140772058,0,1308,2146,-10
26141690735,26141690736,1,1547,1715,-10
26143431414,26143431414,0,1028,988,-10
26144966987,26144966987,0,1408,1291,-10
26149491749,26149491750,1,1556,1774,-10
26151193008,26151193010,2,840,1269,-10
26151604783,26151604786,3,1389,1484,-10
26152907849,26152907850,1,1998,2176,-10
26153673955,26153673955,0,2235,2511,-10
26154137734,26154137734,0,1170,1898,-10
26157586061,26157586065,4,1154,1178,-10
26159486580,26159486582,2,1719,1843,-10
26160988926,26160988922,-4,997,1632,-10
26161338563,26161338570,7,2312,1567,-10
26166086310,26166086309,-1,1179,964,-10
26168256854,26168256854,0,1570,2499,-10
26173364210,26173364216,6,2935,1404,-10
26175140266,26175140269,3,1549,1683,-10
26177004838,26177004841,3,1341,1587,-10
26180408855,26180408857,2,1436,1201,-10
26184728350,26184728353,3,1717,1662,-10
26186403109,26186403114,5,2568,1500,-10
26189327434,26189327435,1,1425,1637,-10
26190747305,26190747310,5,1744,1248,-10
26190772587,26190772590,3,2477,2179,-10
26194348211,26194348213,2,1609,1720,-10
26196411304,26196411307,3,1535,1323,-10
26201497366,26201497368,2,1865,2385,-10
26206038687,26206038689,2,2203,1802,-10
26214158514,26214158516,2,1762,1639,-10
26216027358,26216027362,4,3107,2545,-10
26216358801,26216358801,0,98218,59495,-10
26217031025,26217031026,1,1915,1401,-10
26217216285,26217216286,1,2190,1773,-10
26218330362,26218330367,5,1247,1399,-10
26224753164,26224753166,2,1566,1258,-10
26226041603,26226041606,3,1804,1604,-10
26227205683,26227205684,1,1227,1652,-10
26227333915,26227333916,1,1381,1434,-10
26227507595,26227507601,6,1606,1039,-10
26229010176,26229010178,2,1519,1615,-10
26229821498,26229821500,2,1806,1852,-10
26232096863,26232096867,4,953,1196,-10
26233913570,26233913571,1,1733,2149,-10
26236823159,26236823161,2,966,941,-10
26237659658,26237659661,3,1762,1373,-10
26245229661,26245229664,3,2099,1877,-10
26245367473,26245367473,0,1904,1384,-10
26245637151,26245637163,12,1154,1252,-10
26246160022,26246160024,2,1626,1582,-10
26246186812,26246186833,21,1350,1443,-10
26248444902,26248444907,5,1271,949,-10
26249632721,26249632727,6,3803,1561,-10
26251109779,26251109781,2,1099,1766,-10
26251296397,26251296394,-3,5062,9021,-10
26252410589,26252410590,1,1337,1045,-10
26255137059,26255137054,-5,788,2107,-10
26255568601,26255568622,21,1139,1091,-10
26255598786,26255598771,-15,1330,1657,-10
26255932615,26255932611,-4,1324,1860,-10
26256616227,26256616204,-23,1347,1344,-10
26258070766,26258070766,0,1345,1423,-10
26258306059,26258306057,-2,1234,2388,-10
26263056341,26263056344,3,1783,1986,-10
26264922240,26264922243,3,1059,1195,-10
26267721721,26267721723,2,1488,1557,-10
26269861582,26269861583,1,1310,2074,-10
26270553906,26270553908,2,2139,1383,-10
26275827706,26275827707,1,1368,1536,-10
26277612638,26277612639,1,1641,1669,-10
26278102814,26278102815,1,1495,1701,-10
26278660222,26278660226,4,1769,1593,-10
26284101887,26284101889,2,1125,1653,-10
26284153114,26284153129,15,1110,1369,-10
26286049977,26286049978,1,1386,1298,-10
26286304622,26286304630,8,4764,1925,-10
26287116200,26287116204,4,1446,1535,-10
26287626246,26287626250,4,908,909,-10
26288046248,26288046251,3,1242,1346,-10
26288514059,26288514062,3,2022,1796,-10
26288846302,26288846302,0,1249,991,-10
26289912572,26289912573,1,2009,1838,-10
26291577935,26291577936,1,1823,2922,-10
26294341446,26294341447,1,1451,1684,-10
26296724301,26296724302,1,1487,1487,-10
26299761806,26299761810,4,663,1115,-10
26300749126,26300749128,2,2861,2180,-10
26308547241,26308547242,1,1119,1011,-10
26309694606,26309694609,3,1451,1941,-10
26310253065,26310253066,1,1563,1542,-10
26310544546,26310544548,2,1404,1640,-10
26312152683,26312152685,2,1848,1752,-10
26314909952,26314909955,3,1839,1562,-10
26315114217,26315114203,-14,932,856,-10
26315375470,26315375475,5,1695,1670,-10
26315724781,26315724783,2,1374,1807,-10
26315767583,26315767585,2,1495,1311,-10
26316346528,26316346529,1,1462,1682,-10
26316612653,26316612654,1,1756,1423,-10
26318643297,26318643299,2,1257,1203,-10
26322578834,26322578835,1,1388,1574,-10
26322814201,26322814203,2,1555,1639,-10
26324578063,26324578066,3,968,1351,-10
26325684145,26325684146,1,1758,1813,-10
26327481847,26327481847,0,2000,1519,-10
26328772958,26328772960,2,1647,1890,-10
26329422301,26329422300,-1,32215,78898,-10
26329481749,26329481751,2,1632,1499,-10
26335105767,26335105769,2,2009,1520,-10
26337230338,26337230341,3,1407,977,-10
26338543814,26338543818,4,1987,1732,-10
26341517359,26341517360,1,1088,1304,-10
26342658153,26342658149,-4,826,1475,-10
26342789550,26342789551,1,1449,1483,-10
26344777245,26344777246,1,1348,1277,-10
26344925314,26344925317,3,1628,1149,-10
26348370687,26348370693,6,2760,963,-10
26349168324,26349168324,0,2186,2200,-10
26349319998,26349320000,2,1645,1538,-10
26349609134,26349609137,3,1478,1444,-10
26349993949,26349993948,-1,1688,1463,-10
26351356066,26351356067,1,1415,1486,-10
26351511861,26351511863,2,1379,1045,-10
26352919619,26352919619,0,1178,1061,-10
26353775547,26353775550,3,1345,1515,-10
26357487847,26357487849,2,1449,1449,-10
26359177811,26359177814,3,1746,1858,-10
26359260185,26359260188,3,2093,1319,-10
26361020368,26361020373,5,1559,1550,-10
26362765923,26362765926,3,2250,1505,-10
26364173810,26364173810,0,1944,2260,-10
26369207677,26369207679,2,1278,1893,-10
26372250367,26372250363,-4,870,2719,-10
26374251548,26374251550,2,1343,1271,-10
26374460262,26374460265,3,1487,1074,-10
26375664945,26375664945,0,1423,1561,-10
26379463391,26379463398,7,1172,1074,-10
26380005510,26380005505,-5,725,1570,-10
26383749862,26383749867,5,3622,2104,-10
26384339365,26384339366,1,1194,1713,-10
26388531073,26388531070,-3,61396,90059,-10
26389196761,26389196762,1,1610,1344,-10
26389766712,26389766713,1,1711,1312,-10
26391409098,26391409101,3,1169,1381,-10
26394268938,26394268940,2,1274,2050,-10
26395864611,26395864613,2,1279,1123,-10
26396003675,26396003692,17,1675,1101,-10
26399232296,26399232300,4,4966,23458,-10
26401357305,26401357308,3,1719,2044,-10
26403933198,26403933199,1,1008,1275,-10
26405228735,26405228735,0,1561,1106,-10
26406753249,26406753254,5,1197,974,-10
26410613212,26410613215,3,1969,1265,-10
26413895151,26413895155,4,2584,1686,-10
26415420217,26415420218,1,1767,1654,-10
26415671447,26415671449,2,867,831,-10
26417812529,26417812532,3,1800,1425,-10
26422499145,26422499146,1,1573,1750,-10
26428703943,26428703945,2,1208,1325,-10
26430279686,26430279694,8,5291,1970,-10
26430492262,26430492258,-4,1998,2861,-10
26437739506,26437739491,-15,1019,1246,-10
26441941037,26441941039,2,2222,1905,-10
26442245909,26442245912,3,1894,1947,-10
26444443581,26444443582,1,1442,1564,-10
26445975082,26445975085,3,1469,2041,-10
26446118049,26446118051,2,1590,1172,-10
26446732604,26446732610,6,6190,2102,-10
26447173657,26447173659,2,2169,2360,-10
26448713562,26448713565,3,1248,1620,-10
26449256646,26449256647,1,1073,1360,-10
26455456099,26455456101,2,1134,1255,-10
26456747155,26456747149,-6,946,2410,-10
26457714260,26457714262,2,2088,1576,-10
26459263820,26459263822,2,2022,1588,-10
26459900153,26459900155,2,1159,1471,-10
26460010670,26460010671,1,1027,1089,-10
26460678804,26460678815,11,1218,1819,-10
26463298417,26463298420,3,1592,2034,-10
26476429271,26476429273,2,1492,1840,-10
26477084310,26477084310,0,1143,1597,-10
26477174377,26477174383,6,3347,1127,-10
26478240061,26478240060,-1,1509,2441,-10
26478502186,26478502190,4,1368,1314,-10
26480016305,26480016308,3,2136,1596,-10
26481996651,26481996653,2,1552,1728,-10
26482539109,26482539110,1,1623,1263,-10
26483633326,26483633327,1,1454,1472,-10
26487776279,26487776284,5,1708,1289,-10
26490299302,26490299305,3,1386,2044,-10
26490539907,26490539889,-18,304,849,-10
26492746901,26492746894,-7,2148,8696,-10
26495415951,26495415954,3,1617,1340,-10
26497885043,26497885045,2,2099,1905,-10
26499030903,26499030906,3,1901,1276,-10
26500367747,26500367749,2,1377,1284,-10
26503096101,26503096100,-1,1041,1013,-10
26504729679,26504729682,3,1510,1312,-10
26504921777,26504921789,12,849,1339,-10
26507238597,26507238598,1,2753,1883,-10
26509440676,26509440678,2,1360,1413,-10
26511677094,26511677096,2,1358,1576,-10
26514068412,26514068415,3,2291,1788,-10
26519120105,26519120107,2,1651,1893,-10
26522240225,26522240227,2,1236,1335,-10
26523998441,26523998442,1,1519,1125,-10
26524876459,26524876460,1,1173,1485,-10
26526492566,26526492567,1,1558,1498,-10
26526796830,26526796834,4,1597,1745,-10
26530298845,26530298846,1,1723,1480,-10
26531549136,26531549138,2,1477,1331,-10
26532681551,26532681554,3,1357,906,-10
26533623645,26533623656,11,15734,49185,-10
26537898497,26537898502,5,3142,1326,-10
26540819267,26540819266,-1,1532,1645,-10
26541120980,26541120978,-2,1172,2320,-10
26541890365,26541890366,1,1223,1053,-10
26543086192,26543086193,1,1381,1704,-10
26543621571,26543621578,7,3397,1454,-10
26546005326,26546005331,5,1851,1587,-10
26548419862,26548419863,1,1476,1621,-10
26556183522,26556183525,3,1772,1359,-10
26557477237,26557477239,2,1391,1734,-10
26559404597,26559404599,2,1383,1283,-10
26560036010,26560036012,2,2138,1628,-10
26561114895,26561114897,2,1172,1278,-10
26568390678,26568390678,0,2229,2818,-10
26569122754,26569122757,3,1298,1842,-10
26571196390,26571196395,5,1517,1620,-10
26572871592,26572871596,4,1929,1940,-10
26573040494,26573040497,3,1726,1785,-10
26573808906,26573808906,0,1543,1380,-10
26577464792,26577464796,4,2093,1697,-10
26579323447,26579323450,3,2188,2332,-10
26581009026,26581009030,4,1344,1227,-10
26581790473,26581790473,0,1592,1221,-10
26582967983,26582967977,-6,923,4278,-10
26586981227,26586981229,2,1240,845,-10
26590935945,26590935947,2,1244,1322,-10
26591223905,26591223906,1,1640,1409,-10
26592136564,26592136566,2,2071,1387,-10
26595728179,26595728179,0,2038,2117,-10
26599199761,26599199764,3,1744,2013,-10
26600041894,26600041896,2,1119,1675,-10
26601304651,26601304647,-4,1396,2101,-10
26601750398,26601750400,2,1648,1917,-10
26602743513,26602743518,5,1728,1660,-10
26603561464,26603561467,3,1928,1810,-10
26604088520,26604088522,2,1073,839,-10
26607437869,26607437871,2,1690,1466,-10
26607724377,26607724378,1,1638,1081,-10
26607980755,26607980756,1,1205,1185,-10
26608352224,26608352228,4,1906,1769,-10
26610871708,26610871708,0,1814,1560,-10
26612120386,26612120388,2,2311,1787,-10
26612356377,26612356378,1,1496,2016,-10
26616716940,26616716942,2,1925,1993,-10
26617509366,26617509367,1,2131,2427,-10
26618447143,26618447141,-2,1161,1216,-10
26619044861,26619044871,10,1518,1265,-10
26619924162,26619924166,4,1698,1662,-10
26623701577,26623701579,2,1183,1482,-10
26625167934,26625167937,3,1623,1316,-10
26626947686,26626947690,4,1607,1612,-10
26627720582,26627720586,4,1754,1160,-10
26629364851,26629364851,0,1318,1028,-10
26632158021,26632158024,3,1684,1436,-10
26632316882,26632316882,0,2035,2074,-10
26637196685,26637196683,-2,1729,1446,-10
26637965678,26637965679,1,906,1044,-10
26639646188,26639646191,3,1461,991,-10
26639957822,26639957823,1,1794,1623,-10
26642817748,26642817751,3,1330,1485,-10
26644340581,26644340584,3,2216,1490,-10
26644665425,26644665428,3,1383,1618,-10
26647489282,26647489283,1,1451,1468,-10
26648638776,26648638776,0,1885,1615,-10
26649149928,26649149928,0,1294,1426,-10
26649994991,26649994992,1,1215,1321,-10
26651487650,26651487656,6,1632,1828,-10
26654673347,26654673350,3,1451,1369,-10
26654946882,26654946886,4,1940,1288,-10
26662318551,26662318553,2,1898,1666,-10
26662807513,26662807514,1,1260,1026,-10
26665584327,26665584329,2,1837,1281,-10
26665865634,26665865637,3,2577,1720,-10
26669218690,26669218682,-8,1456,8297,-10
26671877385,26671877386,1,1458,1995,-10
26672303543,26672303542,-1,1375,2226,-10
26673072905,26673072907,2,1477,1437,-10
26676878205,26676878207,2,1817,2476,-10
26680948134,26680948136,2,1572,1697,-10
26682033662,26682033646,-16,1169,1136,-10
26682361139,26682361142,3,1513,1492,-10
26682753274,26682753269,-5,819,4188,-10
26683518857,26683518858,1,1006,1144,-10
26684231596,26684231598,2,1332,978,-10
26684904241,26684904242,1,1651,2050,-10
26686852025,26686852027,2,1837,1735,-10
26690045373,26690045377,4,1990,1453,-10
26692847637,26692847638,1,1439,1120,-10
26695474911,26695474915,4,1359,1539,-10
26696736195,26696736198,3,1197,1274,-10
26697048141,26697048124,-17,1408,1351,-10
26698034223,26698034226,3,1608,2387,-10
26698422139,26698422140,1,1499,1713,-10
26699040646,26699040647,1,1272,1407,-10
26708322750,26708322753,3,1916,2070,-10
26713377290,26713377285,-5,1118,3658,-10
26713755938,26713755943,5,19741,11735,-10
26717061326,26717061327,1,1425,1065,-10
26717559530,26717559538,8,2308,1427,-10
26718891376,26718891377,1,1503,1488,-10
26721571461,26721571460,-1,1231,2025,-10
26733651196,26733651200,4,1427,1359,-10
26737105287,26737105281,-6,1275,1519,-10
26739404326,26739404327,1,1325,712,-10
26739502183,26739502198,15,7056,54570,-10
26742877813,26742877815,2,1787,1642,-10
26747488929,26747488931,2,955,1074,-10
26749942755,26749942758,3,1941,1612,-10
26750152294,26750152295,1,1324,1482,-10
26750411083,26750411078,-5,1387,1243,-10
26752888221,26752888221,0,1358,2287,-10
26758999907,26758999910,3,1794,1467,-10
26764467598,26764467600,2,1380,1275,-10
26766243718,26766243721,3,2005,1377,-10
26767533540,26767533520,-20,1770,1159,-10
26768013569,26768013570,1,1345,1234,-10
26770355537,26770355539,2,2495,2028,-10
26771326115,26771326117,2,1245,1118,-10
26773295442,26773295445,3,1667,1628,-10
26773836282,26773836282,0,1305,1805,-10
26774106595,26774106596,1,1967,1781,-10
26775218187,26775218189,2,1590,2638,-10
26776011139,26776011142,3,1460,1585,-10
26777365440,26777365441,1,1279,1288,-10
26780455417,26780455419,2,1764,935,-10
26781206374,26781206377,3,1725,1264,-10
26788175149,26788175149,0,1408,1164,-10
26788859990,26788859992,2,1449,2014,-10
26790471146,26790471145,-1,1510,1219,-10
26793429642,26793429643,1,1399,1460,-10
26795171853,26795171854,1,2393,2038,-10
26795619003,26795619006,3,1226,1168,-10
26797182662,26797182665,3,1872,1845,-10
26798808506,26798808504,-2,2361,3017,-10
26800922802,26800922809,7,5245,2612,-10
26802459274,26802459275,1,1598,1965,-10
26803179598,26803179601,3,1857,1646,-10
26803927731,26803927734,3,1040,1203,-10
26807297454,26807297456,2,1349,1392,-10
26809092505,26809092507,2,1779,1951,-10
26814963718,26814963717,-1,1441,1487,-10
26815465702,26815465701,-1,1584,2292,-10
26815978698,26815978699,1,3772,3684,-10
26817444527,26817444530,3,1090,991,-10
26818778621,26818778621,0,1196,1953,-10
26826520870,26826520870,0,1284,2274,-10
26830722814,26830722815,1,1588,1717,-10
26832519694,26832519695,1,1503,2325,-10
26836413229,26836413230,1,1518,1945,-10
26837935682,26837935685,3,1755,1384,-10
26841236919,26841236922,3,1054,1033,-10
26841708630,26841708630,0,1342,2690,-10
26842274290,26842274290,0,1381,1473,-10
26847109431,26847109431,0,1778,1729,-10
26855552511,26855552512,1,1588,1395,-10
26856356881,26856356882,1,1389,1940,-10
26859604456,26859604458,2,1663,1811,-10
26860015139,26860015142,3,1214,1355,-10
26861205640,26861205643,3,1274,1029,-10
26861380466,26861380466,0,1859,1607,-10
26861700098,26861700100,2,1678,1740,-10
26862414567,26862414565,-2,1067,1440,-10
26863240430,26863240432,2,1812,2117,-10
26863307869,26863307868,-1,1619,1394,-10
26864143041,26864143044,3,1444,1688,-10
26867004162,26867004165,3,1454,1112,-10
26867189171,26867189173,2,1344,1194,-10
26868364946,26868364966,20,1010,1337,-10
26870577170,26870577172,2,2117,1592,-10
26871146306,26871146306,0,1301,1357,-10
26873401563,26873401566,3,1854,1751,-10
26878834813,26878834814,1,1301,1246,-10
26882103601,26882103603,2,1684,1279,-10
26884601271,26884601275,4,1394,955,-10
26884726342,26884726345,3,1280,1198,-10
26885515047,26885515050,3,1429,1700,-10
26885986939,26885986941,2,1525,1294,-10
26886342034,26886342037,3,1428,1355,-10
26892594138,26892594138,0,1792,2077,-10
26893030348,26893030350,2,1461,1519,-10
26894175569,26894175570,1,1666,1757,-10
26897162262,26897162266,4,1491,1419,-10
26904455065,26904455067,2,1297,1167,-10
26905350961,26905350962,1,1907,2082,-10
26908599158,26908599161,3,1765,1770,-10
26908709355,26908709358,3,1324,1692,-10
26913596214,26913596214,0,1698,1617,-10
26919224909,26919224912,3,2077,1395,-10
26921123261,26921123262,1,1602,1831,-10
26921299506,26921299509,3,1327,1691,-10
26921789510,26921789510,0,1433,1232,-10
26922441642,26922441643,1,1244,1394,-10
26923038069,26923038070,1,1496,1503,-10
26923826875,26923826866,-9,749,504,-10
26928499798,26928499801,3,844,909,-10
26933081749,26933081751,2,1777,1387,-10
26934724283,26934724286,3,1626,1794,-10
26935915877,26935915857,-20,2133,1304,-10
26936387674,26936387675,1,1380,1558,-10
26936547461,26936547466,5,1770,751,-10
26937829945,26937829946,1,3023,3556,-10
26941148546,26941148549,3,1817,1284,-10
26948673334,26948673338,4,1499,2066,-10
26949074629,26949074631,2,1392,1580,-10
26949130801,26949130806,5,2182,1285,-10
26951565584,26951565580,-4,2052,6050,-10
26957772054,26957772056,2,930,1352,-10
26961675562,26961675565,3,1403,1338,-10
26963870135,26963870146,11,1651,1339,-10
26965028663,26965028665,2,1349,1315,-10
26967716646,26967716650,4,3146,1371,-10
26973382291,26973382292,1,1404,1920,-10
26974613780,26974613782,2,1064,1216,-10
26974716878,26974716879,1,1397,1105,-10
26977208293,26977208294,1,1647,1466,-10
26977477666,26977477669,3,1554,1526,-10
26979442812,26979442813,1,1971,1577,-10
26981472366,26981472367,1,2052,1761,-10
26983183017,26983183019,2,1475,1507,-10
26989360578,26989360578,0,1592,1313,-10
26993117917,26993117919,2,640,1005,-10
26994370952,26994370953,1,1417,1634,-10
26995773795,26995773798,3,1182,1383,-10
26996479601,26996479597,-4,1803,9618,-10
26998799741,26998799745,4,1184,1470,-10
27001972342,27001972344,2,2028,1475,-10
27003631439,27003631442,3,1809,1473,-10
27004546330,27004546331,1,2157,1869,-10
27004699415,27004699419,4,1147,1440,-10
27006565438,27006565438,0,1368,1449,-10
27008146635,27008146638,3,2102,2689,-10
27008356514,27008356519,5,5374,2972,-10
27011375244,27011375245,1,1447,1421,-10
27013024553,27013024557,4,1421,1588,-10
27014837691,27014837691,0,837,1404,-10
27017862785,27017862787,2,1440,1203,-10
27022217662,27022217666,4,1952,1960,-10
27024589458,27024589459,1,1297,1838,-10
27025194545,27025194549,4,2138,1855,-10
27025436721,27025436700,-21,1565,1404,-10
27026953658,27026953661,3,1542,1612,-10
27028552513,27028552514,1,1614,1284,-10
27029594409,27029594410,1,1399,2295,-10
27032523966,27032523970,4,2178,2127,-10
27033625721,27033625723,2,1355,1246,-10
27034132721,27034132722,1,1326,1412,-10
27038572948,27038572950,2,1451,1069,-10
27043338357,27043338359,2,1630,1757,-10
27044360650,27044360654,4,2430,1927,-10
27044839149,27044839147,-2,1981,3053,-10
27045879325,27045879327,2,1423,1394,-10
27046102943,27046102945,2,1547,1534,-10
27048031519,27048031522,3,1561,1567,-10
27048799082,27048799085,3,1654,1189,-10
27054283106,27054283109,3,2221,2048,-10
27056153109,27056153111,2,1748,1199,-10
27058953802,27058953803,1,1501,1087,-10
27059048356,27059048338,-18,1751,1105,-10
27060187045,27060187045,0,1640,1016,-10
27063287867,27063287871,4,1841,2007,-10
27063485245,27063485244,-1,35508,18294,-10
27063668833,27063668838,5,1969,1481,-10
27064998758,27064998759,1,2111,2325,-10
27067082761,27067082762,1,1821,1629,-10
27072493870,27072493873,3,1846,1972,-10
27076507951,27076507951,0,1513,1455,-10
27078325097,27078325097,0,1206,1638,-10
27081479024,27081479026,2,1641,1278,-10
27088135221,27088135223,2,1779,1419,-10
27089588023,27089588026,3,1786,1453,-10
27096744006,27096744016,10,10961,43799,-10
27099342201,27099342203,2,1255,1619,-10
27099654321,27099654323,2,1650,1847,-10
27105539135,27105539138,3,1253,1344,-10
27106883802,27106883805,3,1252,1535,-10
27107703218,27107703219,1,1341,1480,-10
27109840950,27109840955,5,2267,1510,-10
27110993195,27110993194,-1,1515,1893,-10
27111511333,27111511332,-1,774,2163,-10
27112636466,27112636471,5,1398,1161,-10
27113304334,27113304335,1,1279,1449,-10
27113614580,27113614582,2,1658,1431,-10
27113798698,27113798699,1,1462,1956,-10
27118582698,27118582697,-1,1009,2186,-10
27121089015,27121089014,-1,1351,1449,-10
27134589085,27134589086,1,1343,1713,-10
27136436129,27136436134,5,1182,1103,-10
27136864915,27136864917,2,1412,1478,-10
27137139564,27137139565,1,1537,1857,-10
27139828761,27139828762,1,1474,1372,-10
27140049970,27140049975,5,1715,1298,-10
27141219325,27141219327,2,1077,1401,-10
27145857105,27145857107,2,852,825,-10
27147128833,27147128835,2,1756,2058,-10
27147171283,27147171285,2,921,1117,-10
27148255014,27148255009,-5,2008,5420,-10
27149270099,27149270101,2,1690,1355,-10
27152447541,27152447534,-7,2074,6805,-10
27156434322,27156434325,3,1276,1616,-10
27156870211,27156870210,-1,1476,1818,-10
27158108211,27158108214,3,1089,813,-10
27158436522,27158436527,5,1355,1309,-10
27160043395,27160043394,-1,1296,1617,-10
27161487266,27161487267,1,1969,1669,-10
27162843722,27162843724,2,1432,1448,-10
27163702703,27163702704,1,1199,1726,-10
27169183423,27169183423,0,1089,1175,-10
27170342428,27170342427,-1,1799,1743,-10
27170735274,27170735278,4,1505,1218,-10
27172688821,27172688823,2,2070,1451,-10
27173040240,27173040242,2,1473,1147,-10
27173840735,27173840738,3,2023,1629,-10
27175196197,27175196198,1,1235,1286,-10
27176627554,27176627555,1,1187,1564,-10
27176891722,27176891701,-21,1345,1928,-10
27178624070,27178624074,4,2306,1488,-10
27178776708,27178776709,1,1291,2272,-10
27180878405,27180878407,2,1018,1394,-10
27182593816,27182593814,-2,1961,1790,-10
27184306176,27184306170,-6,866,2063,-10
27185734946,27185734947,1,1071,1124,-10
27187465582,27187465584,2,1359,1269,-10
27191457651,27191457654,3,868,1286,-10
27191875260,27191875263,3,1493,1276,-10
27195046661,27195046662,1,1877,1394,-10
27195801085,27195801087,2,1394,1259,-10
27199946777,27199946782,5,2898,1545,-10
27200024758,27200024758,0,1534,1462,-10
27201049364,27201049367,3,1637,1461,-10
27201378861,27201378867,6,2768,1256,-10
27201990782,27201990774,-8,1215,1323,-10
27203010562,27203010542,-20,1324,1428,-10
27204443054,27204443057,3,1887,1318,-10
27207290119,27207290119,0,1606,1406,-10
27208369066,27208369067,1,1692,1685,-10
27209462623,27209462627,4,1639,1129,-10
27209869588,27209869589,1,1985,1704,-10
27212729799,27212729799,0,1221,1335,-10
27213510976,27213510977,1,1115,1121,-10
27219071033,27219071034,1,1256,1089,-10
27224497050,27224497034,-16,1107,820,-10
27225892682,27225892685,3,1729,1443,-10
27226667294,27226667295,1,1481,1499,-10
27230224248,27230224249,1,1421,1603,-10
27230954242,27230954242,0,1844,2111,-10
27233075725,27233075727,2,1241,1071,-10
27233638962,27233638965,3,823,1111,-10
27234457626,27234457628,2,2142,1553,-10
27234883675,27234883678,3,852,1216,-10
27235510969,27235510964,-5,2408,7679,-10
27236464587,27236464590,3,1235,1190,-10
27236601857,27236601861,4,1489,1276,-10
27237637753,27237637754,1,1562,1521,-10
27239127674,27239127678,4,1677,1320,-10
27240697370,27240697374,4,1470,1011,-10
27242712119,27242712119,0,1116,1572,-10
27243244277,27243244279,2,1475,1473,-10
27245623127,27245623127,0,1244,1645,-10
27247471584,27247471587,3,1394,1341,-10
27249074201,27249074202,1,1341,1402,-10
27249985965,27249985966,1,1672,1146,-10
27251352347,27251352353,6,1800,1497,-10
27254711963,27254711966,3,2283,2013,-10
27255728329,27255728327,-2,1098,2024,-10
27256440463,27256440466,3,1734,2178,-10
27259892558,27259892560,2,2031,1848,-10
27262941894,27262941899,5,1695,1684,-10
27265934415,27265934417,2,1773,2051,-10
27266924911,27266924913,2,1227,1162,-10
27268192318,27268192319,1,2015,1788,-10
27269582009,27269582010,1,1619,1905,-10
27271697627,27271697628,1,1474,1659,-10
27272803332,27272803333,1,1742,1407,-10
27279062015,27279062020,5,1562,1563,-10
27280682842,27280682845,3,1983,1681,-10
27283623142,27283623146,4,1481,1445,-10
27285006769,27285006771,2,1706,1741,-10
27285608267,27285608267,0,1206,1554,-10
27286091115,27286091115,0,1478,1641,-10
27286277744,27286277739,-5,1363,3973,-10
27286338078,27286338076,-2,2398,4883,-10
27287836021,27287836022,1,2162,1952,-10
27292012741,27292012720,-21,713,405,-10
27295156004,27295156003,-1,1386,1890,-10
27297136043,27297136043,0,1564,1334,-10
27299930527,27299930525,-2,19862,83475,-10
27303895899,27303895902,3,1305,2065,-10
27304745405,27304745406,1,1141,1587,-10
27306007354,27306007356,2,1632,1761,-10
27307337770,27307337774,4,1111,1815,-10
27308972487,27308972490,3,1450,1339,-10
27312046095,27312046095,0,1656,1386,-10
27315353341,27315353341,0,1413,1401,-10
27316259214,27316259221,7,1338,1259,-10
27317365299,27317365301,2,1546,1420,-10
27318116786,27318116789,3,1571,1286,-10
27320491219,27320491221,2,1177,1596,-10
27321665258,27321665261,3,1548,1356,-10
27323015842,27323015845,3,2448,2182,-10
27324730621,27324730621,0,1439,1159,-10
27327182256,27327182258,2,1777,1712,-10
27328818755,27328818758,3,2602,1303,-10
27329714622,27329714642,20,1096,776,-10
27330131354,27330131353,-1,1584,2238,-10
27334275367,27334275367,0,1225,1602,-10
27336238998,27336239001,3,1680,1710,-10
27339328297,27339328302,5,709,504,-10
27341083198,27341083199,1,1248,1365,-10
27348290758,27348290759,1,1660,1959,-10
27348749923,27348749926,3,1345,1289,-10
27353539985,27353539986,1,887,1381,-10
27360131650,27360131653,3,1367,1456,-10
27361566022,27361566022,0,1706,2016,-10
27363826375,27363826378,3,1565,1265,-10
27364946825,27364946829,4,1868,1329,-10
27365062727,27365062729,2,1695,1841,-10
27367291995,27367291998,3,1668,2260,-10
27367356490,27367356491,1,1430,1720,-10
27369932595,27369932598,3,1408,1243,-10
27369961657,27369961658,1,1353,1229,-10
27372970441,27372970446,5,1766,1100,-10
27374177318,27374177322,4,1408,1736,-10
27374963079,27374963080,1,1170,1086,-10
27382226781,27382226775,-6,2417,6543,-10
27384529091,27384529091,0,918,617,-10
27386591976,27386591977,1,2377,2281,-10
27386765311,27386765311,0,1347,1445,-10
27388781338,27388781341,3,1333,1779,-10
27390547142,27390547147,5,1900,1830,-10
27390910650,27390910653,3,1301,1528,-10
27396482491,27396482495,4,885,932,-10
27396760576,27396760567,-9,1665,1689,-10
27398741584,27398741586,2,1334,1372,-10
27401157287,27401157291,4,1201,1155,-10
27402368286,27402368288,2,1459,1168,-10
27404335561,27404335564,3,1246,1436,-10
27405545151,27405545155,4,1591,1419,-10
27405571116,27405571118,2,872,1260,-10
27408795847,27408795846,-1,1087,1144,-10
27410945132,27410945133,1,2120,1768,-10
27411068221,27411068224,3,1741,1704,-10
27413266618,27413266621,3,1246,1107,-10
27418701093,27418701094,1,1687,1655,-10
27422775332,27422775334,2,1446,1609,-10
27423515161,27423515162,1,1792,1498,-10
27427945961,27427945962,1,1610,1251,-10
27431341618,27431341621,3,1524,1264,-10
27431968268,27431968270,2,1649,1255,-10
27435724695,27435724694,-1,1429,2115,-10
27436862189,27436862191,2,1110,989,-10
27438466994,27438466999,5,2045,2283,-10
27446495345,27446495345,0,1718,1170,-10
27448612925,27448612927,2,1801,1277,-10
27450332876,27450332878,2,1423,1445,-10
27450414917,27450414918,1,1329,1327,-10
27453250258,27453250259,1,1845,2220,-10
27457093610,27457093614,4,1713,1751,-10
27457351854,27457351855,1,778,1087,-10
27458903677,27458903678,1,1235,1212,-10
27462580585,27462580586,1,1562,2125,-10
27462909314,27462909317,3,1760,1463,-10
27463637861,27463637863,2,1461,1645,-10
27465507805,27465507806,1,1201,1234,-10
27472917654,27472917657,3,1182,1224,-10
27474162895,27474162894,-1,1736,1952,-10
27474380050,27474380053,3,1751,1530,-10
27477501105,27477501105,0,1529,1281,-10
27481017585,27481017587,2,1722,1335,-10
27485035938,27485035938,0,1083,1369,-10
27485420086,27485420090,4,3160,2399,-10
27485576646,27485576649,3,1462,1168,-10
27496940650,27496940650,0,1568,1219,-10
27498384607,27498384606,-1,1418,2972,-10
27500133402,27500133396,-6,919,5884,-10
27506725718,27506725721,3,1699,1960,-10
27507729828,27507729829,1,1828,1973,-10
27507835374,27507835378,4,1048,1276,-10
27508457962,27508457953,-9,1324,1429,-10
27509641585,27509641586,1,1932,1399,-10
27511032462,27511032458,-4,1013,3256,-10
27511167856,27511167858,2,1500,1310,-10
27518632326,27518632327,1,1338,1420,-10
27518976070,27518976071,1,973,920,-10
27520850252,27520850253,1,1475,1980,-10
27522955959,27522955957,-2,2347,5035,-10
27523180696,27523180696,0,1617,1546,-10
27525048894,27525048894,0,1529,1134,-10
27530530325,27530530328,3,2723,1439,-10
27534134807,27534134814,7,6102,2452,-10
27535410886,27535410890,4,1793,1726,-10
27536191986,27536191988,2,1365,1332,-10
27539434202,27539434204,2,1522,1723,-10
27540992288,27540992290,2,1297,2221,-10
27541935726,27541935721,-5,2417,5102,-10
27547140277,27547140281,4,1677,1260,-10
27548001222,27548001222,0,1715,1271,-10
27551901903,27551901903,0,1357,1955,-10
27556995950,27556995954,4,1830,1487,-10
27557626527,27557626505,-22,875,1377,-10
27567153353,27567153354,1,1813,1623,-10
27569702960,27569702962,2,1649,1492,-10
27573193487,27573193489,2,993,1025,-10
27573534330,27573534331,1,1238,1277,-10
27573650163,27573650163,0,1468,1169,-10
27575370621,27575370623,2,1674,1820,-10
27578000324,27578000327,3,1976,1690,-10
27578728664,27578728665,1,1906,1995,-10
27579857484,27579857487,3,1524,1293,-10
27582193541,27582193542,1,1221,1483,-10
27582727485,27582727466,-19,1561,1739,-10
27587199037,27587199041,4,1460,1157,-10
27587566349,27587566351,2,972,1609,-10
27590311453,27590311455,2,1387,1302,-10
27593351909,27593351911,2,1772,1363,-10
27593912413,27593912414,1,932,857,-10
27597105549,27597105552,3,2485,1308,-10
27600684833,27600684834,1,1515,1867,-10
27601026903,27601026902,-1,1134,1119,-10
27603912497,27603912499,2,1822,1929,-10
27607391555,27607391559,4,2946,1430,-10
27607584492,27607584496,4,1169,1136,-10
27614716537,27614716538,1,1733,1386,-10
27615602396,27615602397,1,1207,1764,-10
27616976861,27616976862,1,1632,1629,-10
27617393935,27617393938,3,1702,1655,-10
27621282604,27621282607,3,1593,1976,-10
27623036712,27623036714,2,1691,1449,-10
27626405615,27626405614,-1,1428,2019,-10
27630068890,27630068894,4,1662,1629,-10
27630688945,27630688946,1,1886,1557,-10
27632560558,27632560561,3,1404,1199,-10
27634936665,27634936667,2,1689,1582,-10
27635493489,27635493491,2,1711,1008,-10
27642043535,27642043538,3,2257,2067,-10
27645657133,27645657133,0,1110,1086,-10
27647034695,27647034697,2,1088,1025,-10
27647869526,27647869538,12,1768,1085,-10
27649967510,27649967514,4,2703,1723,-10
27650564358,27650564362,4,1297,1843,-10
27651601345,27651601347,2,1761,1443,-10
27651915385,27651915389,4,1813,1889,-10
27653402432,27653402433,1,1434,1392,-10
27655153349,27655153350,1,1630,2035,-10
27658104095,27658104097,2,1127,1214,-10
27660185065,27660185066,1,1256,930,-10
27663576842,27663576843,1,1571,1343,-10
27663763733,27663763734,1,889,1966,-10
27666137078,27666137078,0,1200,1226,-10
27667889973,27667889974,1,1529,1155,-10
27668160430,27668160430,0,1294,1526,-10
27671628689,27671628691,2,1085,1410,-10
27675154409,27675154409,0,1037,1234,-10
27678714464,27678714466,2,1978,1499,-10
27679898785,27679898787,2,1522,1943,-10
27684591583,27684591583,0,1257,1634,-10
27687594462,27687594463,1,1159,1366,-10
27688116700,27688116701,1,1194,1592,-10
27689611565,27689611566,1,1894,2149,-10
27691699691,27691699692,1,1557,1495,-10
27692728906,27692728908,2,1330,1752,-10
27693976914,27693976915,1,1970,1342,-10
27697318639,27697318642,3,2305,1781,-10
27698076424,27698076425,1,1379,1412,-10
27698753862,27698753867,5,1156,1212,-10
27705279655,27705279656,1,1397,1337,-10
27709999851,27709999863,12,10374,45202,-10
27713629476,27713629474,-2,1199,1320,-10
27714531633,27714531627,-6,1605,1059,-10
27715054755,27715054757,2,1832,1498,-10
27719192823,27719192826,3,1256,1004,-10
27721272549,27721272549,0,1543,1745,-10
27729120769,27729120772,3,1249,1077,-10
27731244653,27731244655,2,1631,1615,-10
27731880238,27731880242,4,2197,1184,-10
27733626137,27733626139,2,1109,840,-10
27735544341,27735544343,2,1685,1628,-10
27741099466,27741099466,0,1231,1115,-10
27745853426,27745853429,3,1788,1632,-10
27746727573,27746727576,3,1482,1537,-10
27749231571,27749231576,5,1228,1158,-10
27750182243,27750182247,4,1335,1385,-10
27752399295,27752399293,-2,1947,2043,-10
27752717489,27752717491,2,2106,1678,-10
27753236127,27753236108,-19,988,1543,-10
27757737263,27757737267,4,1941,1343,-10
27759610569,27759610572,3,1613,1632,-10
27763244625,27763244642,17,119,6995,-10
27765135051,27765135053,2,1272,1690,-10
27766292902,27766292906,4,1177,1431,-10
27767874147,27767874147,0,1284,1742,-10
27770548258,27770548262,4,1191,1225,-10
27770994875,27770994875,0,1292,1818,-10
27773723086,27773723089,3,1716,2079,-10
27776599452,27776599455,3,1769,1521,-10
27778786823,27778786824,1,1656,1808,-10
27779939885,27779939906,21,1347,1682,-10
27780712260,27780712257,-3,1432,1530,-10
27781044223,27781044202,-21,1424,1152,-10
27782158010,27782158012,2,1399,2045,-10
27786431964,27786431962,-2,1482,1655,-10
27787539263,27787539261,-2,1327,1484,-10
27792309312,27792309314,2,1545,1314,-10
27795591040,27795591042,2,1623,1887,-10
27799972830,27799972833,3,1673,2420,-10
27800386518,27800386519,1,1235,872,-10
27810084970,27810084972,2,1393,1107,-10
27811464015,27811464014,-1,1461,1274,-10
27812206555,27812206553,-2,2005,4561,-10
27813312568,27813312570,2,1561,1557,-10
27816703272,27816703273,1,2135,2332,-10
27820913636,27820913642,6,2007,1393,-10
27822802732,27822802734,2,1269,1157,-10
27824745521,27824745523,2,2203,2588,-10
27826680597,27826680600,3,1887,1876,-10
27827964008,27827964009,1,1515,1348,-10
27829828717,27829828713,-4,1581,5026,-10
27830499753,27830499757,4,1382,1582,-10
27833451754,27833451754,0,1017,808,-10
27836306361,27836306362,1,1599,2096,-10
27836704928,27836704927,-1,1275,1228,-10
27838396578,27838396578,0,1308,2500,-10
27838758173,27838758175,2,1401,1712,-10
27839888338,27839888343,5,848,1023,-10
27841195930,27841195923,-7,699,4204,-10
27841393638,27841393641,3,866,1465,-10
27849653171,27849653172,1,1520,1668,-10
27850525878,27850525881,3,2003,1569,-10
27851504650,27851504650,0,1307,2053,-10
27852592313,27852592313,0,1803,1554,-10
27853764891,27853764894,3,2276,1272,-10
27853838890,27853838894,4,1892,1714,-10
27855740015,27855740018,3,1652,1603,-10
27861462783,27861462783,0,1265,1858,-10
27863389920,27863389922,2,1348,1628,-10
27864670816,27864670818,2,1494,1393,-10
27867856123,27867856127,4,1799,1087,-10
27868123457,27868123460,3,2070,2059,-10
27870241226,27870241226,0,1520,1250,-10
27870300214,27870300195,-19,1822,1325,-10
27871142502,27871142505,3,1614,1608,-10
27871406495,27871406497,2,1436,1697,-10
27871618138,27871618141,3,1451,1465,-10
27874741402,27874741405,3,1267,1591,-10
27875502382,27875502385,3,2477,2081,-10
27879343525,27879343526,1,1641,1758,-10
27880359862,27880359861,-1,2304,2835,-10
27880506202,27880506206,4,1646,1406,-10
27880857434,27880857436,2,1571,1685,-10
27884869711,27884869711,0,1492,1865,-10
27887759330,27887759334,4,1169,1422,-10
27888502162,27888502165,3,881,1041,-10
27890436297,27890436297,0,1455,1740,-10
27890919574,27890919574,0,1701,2090,-10
27891497813,27891497811,-2,1927,3629,-10
27895595769,27895595772,3,1575,1487,-10
27898939718,27898939721,3,1997,1581,-10
27901670881,27901670883,2,1492,1555,-10
27904319398,27904319399,1,1148,966,-10
27907816966,27907816969,3,2266,1140,-10
27909623742,27909623742,0,2066,1662,-10
27910469859,27910469862,3,1601,757,-10
27910660645,27910660646,1,1406,1934,-10
27914184638,27914184645,7,2546,1164,-10
27914390358,27914390361,3,866,1449,-10
27915249513,27915249513,0,1412,2025,-10
27916118205,27916118209,4,1240,1458,-10
27917237973,27917237971,-2,1525,1898,-10
27919514079,27919514078,-1,1224,2031,-10
27919696114,27919696118,4,1296,1692,-10
27919963117,27919963119,2,1477,1109,-10
27922537489,27922537493,4,1144,1192,-10
27925218491,27925218493,2,1243,1464,-10
27929976609,27929976611,2,1624,1861,-10
27931963962,27931963963,1,1053,1417,-10
27934262572,27934262575,3,4120,2763,-10
27934496273,27934496278,5,1277,1241,-10
27937249293,27937249290,-3,1495,2822,-10
27944855903,27944855910,7,11211,34001,-10
27948353987,27948353987,0,1420,1087,-10
27949276281,27949276283,2,1812,2248,-10
27951643291,27951643293,2,1744,1333,-10
27953885179,27953885179,0,1890,1650,-10
27954370611,27954370614,3,1825,1417,-10
27959064253,27959064258,5,1658,1913,-10
27960248220,27960248223,3,1567,1713,-10
27962989659,27962989661,2,1276,1578,-10
27964278228,27964278226,-2,17472,10255,-10
27964544198,27964544216,18,1151,1049,-10
27966615299,27966615302,3,1073,1216,-10
27968013586,27968013587,1,2160,2225,-10
27968406891,27968406895,4,1489,1529,-10
27975547053,27975547056,3,2576,2003,-10
27976066697,27976066699,2,1319,1291,-10
27997893953,27997893954,1,991,843,-10
28000168142,28000168145,3,1615,1388,-10
28000310023,28000310026,3,2181,1771,-10
28000987117,28000987114,-3,1134,2263,-10
28001223776,28001223777,1,1268,1365,-10
28005892527,28005892526,-1,1181,2356,-10
28006123110,28006123111,1,2124,1505,-10
28006515778,28006515780,2,1759,2279,-10
28008665604,28008665610,6,2516,2114,-10
28009106497,28009106498,1,1886,2194,-10
28009220230,28009220232,2,1787,1739,-10
28009949036,28009949040,4,2440,2019,-10
28010583997,28010584002,5,4314,1687,-10
28011330650,28011330653,3,1662,1504,-10
28015136022,28015136022,0,1139,1152,-10
28018097177,28018097178,1,1584,1543,-10
28021895962,28021895965,3,1414,992,-10
28023135921,28023135923,2,1955,1760,-10
28023396366,28023396365,-1,1362,1621,-10
28026050162,28026050165,3,1629,1183,-10
28026330262,28026330265,3,2268,1460,-10
28029834177,28029834178,1,1518,1998,-10
28032024435,28032024437,2,2185,1528,-10
28033037174,28033037173,-1,1476,2671,-10
28033269703,28033269705,2,1242,1307,-10
28036823885,28036823886,1,905,590,-10
28037712791,28037712796,5,1547,1118,-10
28038984736,28038984737,1,1607,1375,-10
28044261835,28044261835,0,821,1023,-10
28045060782,28045060779,-3,1008,2622,-10
28046254795,28046254795,0,1643,1257,-10
28047344687,28047344690,3,3145,1951,-10
28052106705,28052106706,1,1690,1576,-10
28052682230,28052682231,1,2041,1359,-10
28053989586,28053989588,2,1524,1068,-10
28057300966,28057300969,3,2021,1405,-10
28057602307,28057602288,-19,1440,1389,-10
28057809982,28057809985,3,1194,1730,-10
28058921548,28058921550,2,1768,1950,-10
28060643178,28060643178,0,1828,2044,-10
28062155757,28062155759,2,1293,1707,-10
28063577354,28063577354,0,1742,2152,-10
28063965553,28063965554,1,1839,1856,-10
28066269339,28066269338,-1,1347,1798,-10
28072277884,28072277883,-1,1383,1151,-10
28080479125,28080479125,0,1630,1629,-10
28081340049,28081340050,1,1639,1832,-10
28086192816,28086192820,4,1679,1288,-10
28089359290,28089359287,-3,830,1331,-10
28089609783,28089609781,-2,1495,1738,-10
28091269979,28091269981,2,2010,1770,-10
28092725039,28092725042,3,1472,1432,-10
28093747417,28093747420,3,2026,1170,-10
28095167182,28095167183,1,821,1883,-10
28095552601,28095552604,3,1350,1371,-10
28097794896,28097794897,1,1941,1779,-10
28098748879,28098748882,3,1255,1088,-10
28101899136,28101899137,1,1372,1360,-10
28106684719,28106684722,3,1675,1285,-10
28106869793,28106869795,2,1609,1854,-10
28110503734,28110503739,5,2588,1204,-10
28112230053,28112230055,2,1449,1113,-10
28112641999,28112642003,4,1775,1288,-10
28113059051,28113059055,4,1104,1645,-10
28117608238,28117608242,4,2250,2034,-10
28117988669,28117988670,1,1742,1901,-10
28120982815,28120982817,2,1376,1332,-10
28121227685,28121227685,0,1591,1485,-10
28124230093,28124230099,6,1835,1029,-10
28127636186,28127636179,-7,1088,607,-10
28128813181,28128813182,1,1038,1257,-10
28131153019,28131153021,2,1938,1813,-10
28131683942,28131683943,1,1305,1302,-10
28131984701,28131984702,1,1620,1658,-10
28134589656,28134589658,2,1492,1770,-10
28136600015,28136600018,3,1304,1759,-10
28137476415,28137476417,2,945,1286,-10
28144149134,28144149137,3,1344,2065,-10
28145272122,28145272124,2,1779,2036,-10
28145655030,28145655031,1,1393,955,-10
28145803555,28145803561,6,1457,1284,-10
28145974171,28145974177,6,1117,1137,-10
28147001338,28147001339,1,1722,1827,-10
28147612229,28147612230,1,1601,1426,-10
28148908362,28148908365,3,1455,1634,-10
28152113926,28152113927,1,23691,22770,-10
28153517954,28153517957,3,2417,1828,-10
28154884250,28154884251,1,1946,1484,-10
28155443602,28155443603,1,1457,1711,-10
28155557276,28155557279,3,1596,1822,-10
28155714023,28155714022,-1,1562,1346,-10
28157422760,28157422762,2,1810,2090,-10
28159233965,28159233965,0,1206,1847,-10
28161187766,28161187761,-5,1566,6256,-10
28161993038,28161993040,2,1766,1410,-10
28166198686,28166198664,-22,1487,1119,-10
28169845263,28169845266,3,1533,1615,-10
28169884143,28169884145,2,1520,1484,-10
28172232841,28172232843,2,841,1446,-10
28172312631,28172312634,3,1526,1256,-10
28172814759,28172814761,2,1582,1346,-10
28173593494,28173593495,1,1249,2079,-10
28173933083,28173933086,3,1456,1382,-10
28175134177,28175134178,1,1586,1656,-10
28175676666,28175676666,0,1175,1236,-10
28176124676,28176124679,3,2114,1742,-10
28178092756,28178092753,-3,2087,2231,-10
28178567158,28178567158,0,1829,1345,-10
28179079009,28179079012,3,1444,1578,-10
28179959998,28179960002,4,1360,1334,-10
28181606371,28181606373,2,1072,950,-10
28184009859,28184009853,-6,65630,57525,-10
28187736772,28187736774,2,1450,1562,-10
28189905413,28189905418,5,1394,1305,-10
28190386738,28190386740,2,1299,1072,-10
28190772890,28190772890,0,1374,1345,-10
28193414835,28193414838,3,1717,1395,-10
28194582102,28194582102,0,1786,1278,-10
28194799023,28194799023,0,1643,1817,-10
28200263850,28200263849,-1,1646,2403,-10
28205603329,28205603333,4,1231,1481,-10
28207143150,28207143151,1,2188,1871,-10
28207715212,28207715210,-2,1538,1809,-10
28209636199,28209636202,3,1410,1483,-10
28210695634,28210695635,1,1759,1714,-10
28214088230,28214088232,2,1797,1841,-10
28216099440,28216099441,1,1864,2429,-10
28216314563,28216314565,2,1427,1824,-10
28218739574,28218739577,3,1314,1262,-10
28220513291,28220513294,3,2164,2036,-10
28220680122,28220680127,5,1333,1107,-10
28222209842,28222209842,0,1493,1101,-10
28223732305,28223732300,-5,23240,9678,-10
28228094538,28228094538,0,1256,1266,-10
28229213615,28229213618,3,1737,1259,-10
28230583429,28230583431,2,2164,1592,-10
28234462894,28234462895,1,758,1255,-10
28237064526,28237064529,3,1345,1136,-10
28240465082,28240465085,3,1271,1599,-10
28243015906,28243015907,1,41351,20785,-10
28249540647,28249540650,3,1703,1960,-10
28249967293,28249967295,2,1686,1648,-10
28252450077,28252450078,1,1526,1834,-10
28252784970,28252784973,3,1153,1605,-10
28255087830,28255087833,3,2029,1652,-10
28256025467,28256025469,2,1334,1456,-10
28256765881,28256765883,2,1397,1135,-10
28258601776,28258601776,0,1845,1496,-10
28263655437,28263655439,2,1189,1206,-10
28268939192,28268939194,2,1913,1852,-10
28278014346,28278014347,1,1838,1787,-10
28280651297,28280651301,4,2022,1308,-10
28283019351,28283019365,14,14135,46078,-10
28285698779,28285698781,2,1891,1797,-10
28286497335,28286497338,3,1613,1952,-10
28289933123,28289933126,3,2095,1675,-10
28292832835,28292832837,2,1368,1512,-10
28296556242,28296556242,0,1179,1874,-10
28297000847,28297000849,2,1928,1532,-10
28297335715,28297335717,2,1572,1817,-10
28297433413,28297433415,2,1549,1438,-10
28299524615,28299524615,0,1100,1196,-10
28302784599,28302784601,2,1912,1119,-10
28304735267,28304735269,2,1195,1433,-10
28305689837,28305689840,3,1304,667,-10
28305891542,28305891544,2,1804,1423,-10
28306485077,28306485079,2,1347,1696,-10
28306925757,28306925753,-4,1970,3924,-10
28307410841,28307410841,0,1573,1710,-10
28310178798,28310178799,1,1093,1293,-10
28313541477,28313541477,0,1692,2331,-10
28329735641,28329735646,5,2213,1376,-10
28332771810,28332771811,1,1359,1710,-10
28332908033,28332908037,4,1247,1323,-10
28333784798,28333784801,3,1352,1582,-10
28335336084,28335336083,-1,1648,2785,-10
28336052187,28336052192,5,1155,1145,-10
28336267618,28336267622,4,1876,1566,-10
28336339563,28336339568,5,1042,1515,-10
28340225123,28340225123,0,832,1082,-10
28344826976,28344826977,1,1648,1477,-10
28347587914,28347587917,3,1816,1498,-10
28349454454,28349454454,0,1362,1580,-10
28351276842,28351276846,4,2041,1471,-10
28356186171,28356186174,3,1335,1281,-10
28356549663,28356549664,1,2573,1692,-10
28357231568,28357231570,2,1456,1377,-10
28358082555,28358082553,-2,941,1720,-10
28358224383,28358224384,1,1904,1687,-10
28360875795,28360875795,0,890,1498,-10
28363033890,28363033891,1,1468,1491,-10
28364420120,28364420121,1,1283,1076,-10
28366380547,28366380551,4,2159,1254,-10
28367430923,28367430922,-1,1668,1267,-10
28369370671,28369370673,2,1741,1312,-10
28370629213,28370629214,1,1047,1322,-10
28371148066,28371148067,1,1565,1486,-10
28372399954,28372399956,2,1484,1825,-10
28373304403,28373304405,2,2557,1889,-10
28375354051,28375354050,-1,1730,1645,-10
28376445285,28376445289,4,3915,2460,-10
28379838171,28379838173,2,1249,1200,-10
28381296893,28381296893,0,1247,1689,-10
28382600634,28382600636,2,1615,1472,-10
28383772894,28383772897,3,1135,1590,-10
28386706313,28386706314,1,1443,1276,-10
28391130851,28391130855,4,1748,1889,-10
28392208827,28392208830,3,1440,1359,-10
28393078845,28393078845,0,1709,1827,-10
28399010898,28399010897,-1,1248,1123,-10
28400085097,28400085098,1,1742,1841,-10
28402180113,28402180114,1,1941,1753,-10
28412771366,28412771366,0,1930,2854,-10
28414919473,28414919475,2,888,1241,-10
28418886054,28418886057,3,1566,1795,-10
28419559990,28419559990,0,1311,1532,-10
28420506450,28420506451,1,1665,1542,-10
28420997590,28420997594,4,1168,1072,-10
28422346866,28422346849,-17,33462,17034,-10
28424155088,28424155086,-2,1007,2237,-10
28424605315,28424605315,0,962,836,-10
28425537098,28425537101,3,2050,2042,-10
28427161935,28427161938,3,1281,1524,-10
28427697665,28427697667,2,1805,1805,-10
28434335819,28434335822,3,2371,2014,-10
28436406417,28436406420,3,1485,1680,-10
28438118054,28438118054,0,1316,1505,-10
28438472651,28438472656,5,1799,1477,-10
28438829558,28438829562,4,1430,1338,-10
28440408718,28440408717,-1,1715,1997,-10
28441379034,28441379035,1,1978,2123,-10
28443810928,28443810930,2,1994,1907,-10
28444631881,28444631881,0,1809,1771,-10
28446863984,28446863983,-1,1646,1864,-10
28451865904,28451865906,2,2110,1495,-10
28452946843,28452946844,1,1670,2127,-10
28453353181,28453353186,5,1056,1305,-10
28454510391,28454510400,9,39575,16742,-10
28455394462,28455394457,-5,1132,3518,-10
28455771382,28455771383,1,1969,1784,-10
28456936896,28456936902,6,1593,1266,-10
28458578325,28458578325,0,1202,1568,-10
28459512621,28459512622,1,878,559,-10
28460251377,28460251379,2,1381,1758,-10
28463104785,28463104786,1,1275,1575,-10
28465261954,28465261938,-16,1481,1042,-10
28465869530,28465869533,3,1461,1853,-10
28465981715,28465981718,3,1573,1418,-10
28471173078,28471173076,-2,1605,1199,-10
28474641601,28474641603,2,703,919,-10
28475205799,28475205802,3,925,1049,-10
28475488826,28475488827,1,2278,1217,-10
28476561969,28476561974,5,1189,1215,-10
28476654394,28476654411,17,776,3575,-10
28477439453,28477439449,-4,1877,4454,-10
28479705485,28479705488,3,1476,1405,-10
28480579141,28480579142,1,1398,1197,-10
28483462459,28483462461,2,1359,1059,-10
28485866040,28485866040,0,1394,1346,-10
28487133426,28487133425,-1,1723,1789,-10
28488997054,28488997055,1,2094,1512,-10
28491468418,28491468421,3,1784,1711,-10
28494299681,28494299681,0,1844,1881,-10
28494477020,28494476998,-22,1111,1440,-10
28498692130,28498692131,1,1790,1099,-10
28499454124,28499454125,1,1223,1951,-10
28499693339,28499693339,0,886,1759,-10
28502373227,28502373229,2,1780,2346,-10
28503945771,28503945774,3,4490,15577,-10
28504035541,28504035542,1,1884,1667,-10
28506877125,28506877127,2,2126,2010,-10
28508295098,28508295102,4,3136,2023,-10
28509863558,28509863562,4,1260,1497,-10
28511294706,28511294714,8,2814,1290,-10
28513144257,28513144260,3,1257,1141,-10
28513420086,28513420090,4,1625,1568,-10
28513448337,28513448336,-1,1346,2234,-10
28513801639,28513801642,3,886,1323,-10
28513894935,28513894933,-2,1831,3146,-10
28514322804,28514322805,1,1809,1448,-10
28518332626,28518332629,3,2031,1133,-10
28526462827,28526462829,2,1599,1741,-10
28528018675,28528018673,-2,1357,1110,-10
28528507475,28528507480,5,925,1319,-10
28531556726,28531556728,2,1745,2182,-10
28531723234,28531723235,1,2173,2010,-10
28532205906,28532205907,1,1103,911,-10
28535488709,28535488711,2,1715,1283,-10
28537239658,28537239662,4,1280,1967,-10
28539326184,28539326187,3,1613,1351,-10
28542858830,28542858831,1,2035,1446,-10
28544795051,28544795055,4,1219,1059,-10
28554179206,28554179209,3,2041,633,-10
28554452077,28554452079,2,1886,1596,-10
28554626774,28554626775,1,2034,1945,-10
28557993964,28557993967,3,1828,1803,-10
28558930513,28558930514,1,1237,1513,-10
28559427797,28559427799,2,1375,1335,-10
28564843813,28564843822,9,2066,1721,-10
28566627314,28566627315,1,1369,2046,-10
28568943255,28568943258,3,1457,1344,-10
28571293698,28571293699,1,1191,1179,-10
28575148985,28575148985,0,1991,1452,-10
28576555125,28576555126,1,1239,1268,-10
28581405743,28581405743,0,1447,1344,-10
28581758264,28581758273,9,1204,1240,-10
28582134754,28582134756,2,994,2227,-10
28585586025,28585586025,0,2075,1400,-10
28585769357,28585769359,2,1459,1074,-10
28586360071,28586360073,2,1528,1563,-10
28592008092,28592008093,1,1327,1887,-10
28594489155,28594489158,3,1215,1586,-10
28595080377,28595080378,1,1393,1716,-10
28595832223,28595832224,1,1999,1573,-10
28598211183,28598211186,3,1572,1297,-10
28599273718,28599273721,3,1893,1678,-10
28599375270,28599375264,-6,628,340,-10
28599864943,28599864933,-10,1263,939,-10
28602440740,28602440741,1,1483,1567,-10
28604566346,28604566347,1,1484,1908,-10
28610490191,28610490192,1,1572,1535,-10
28611756062,28611756065,3,1807,1387,-10
28612657778,28612657780,2,1564,2104,-10
28612817838,28612817839,1,1098,1528,-10
28613497273,28613497260,-13,1653,1434,-10
28614193491,28614193493,2,1725,1307,-10
28616837211,28616837209,-2,892,1888,-10
28617324856,28617324860,4,1456,1206,-10
28619801306,28619801309,3,1399,1623,-10
28620544964,28620544947,-17,739,337,-10
28622024682,28622024685,3,973,908,-10
28625136286,28625136289,3,1228,1803,-10
28628407546,28628407548,2,1615,1704,-10
28634276094,28634276095,1,1285,1286,-10
28638303550,28638303549,-1,1503,2013,-10
28639352227,28639352245,18,1080,2089,-10
28642121271,28642121273,2,1924,2014,-10
28646372063,28646372063,0,2054,1700,-10
28647448991,28647448995,4,1878,1360,-10
28652740446,28652740448,2,1982,1844,-10
28653381373,28653381377,4,1471,1673,-10
28654369741,28654369742,1,863,1194,-10
28656639591,28656639591,0,1439,1142,-10
28659371718,28659371720,2,1343,1395,-10
28660720634,28660720637,3,1320,1329,-10
28662937390,28662937390,0,1016,1374,-10
28664688513,28664688515,2,17849,12268,-10
28666685610,28666685614,4,1491,1219,-10
28667426718,28667426719,1,770,1608,-10
28668020580,28668020583,3,1921,1265,-10
28668454622,28668454624,2,1968,1975,-10
28669977826,28669977830,4,1521,1014,-10
28670204050,28670204051,1,2023,1352,-10
28672818367,28672818369,2,1324,1920,-10
28678912900,28678912902,2,978,854,-10
28680256402,28680256406,4,786,1562,-10
28680817706,28680817707,1,1145,1252,-10
28686440345,28686440347,2,1400,1638,-10
28686879093,28686879090,-3,2535,5170,-10
28687598082,28687598085,3,1586,1013,-10
28690005197,28690005198,1,2914,3725,-10
28690046866,28690046870,4,1922,1188,-10
28693056642,28693056647,5,1162,1242,-10
28694259252,28694259254,2,1423,1395,-10
28696517754,28696517757,3,1152,1180,-10
28698900301,28698900301,0,1841,1709,-10
28699302818,28699302821,3,1213,1375,-10
28699461973,28699461976,3,2529,1587,-10
28705051285,28705051286,1,2155,1620,-10
28705305655,28705305649,-6,893,3074,-10
28712728006,28712728007,1,1364,1236,-10
28713913851,28713913853,2,1285,1321,-10
28714771554,28714771557,3,1639,1368,-10
28716076583,28716076590,7,2490,950,-10
28718569963,28718569965,2,1318,2026,-10
28721687218,28721687218,0,1107,1522,-10
28723470150,28723470151,1,1781,2073,-10
28727866307,28727866307,0,1908,1969,-10
28728459459,28728459458,-1,2619,3880,-10
28729607534,28729607539,5,1246,1032,-10
28730336467,28730336469,2,1623,1370,-10
28730735379,28730735381,2,1216,1426,-10
28732502138,28732502139,1,2189,2339,-10
28733378871,28733378873,2,1858,1414,-10
28733907275,28733907278,3,2524,1760,-10
28734776382,28734776384,2,1183,1849,-10
28739481798,28739481797,-1,1672,1266,-10
28739576169,28739576172,3,1584,1428,-10
28742378031,28742378034,3,2027,1478,-10
28742701625,28742701618,-7,1456,6376,-10
28744517677,28744517678,1,892,1473,-10
28744813254,28744813257,3,1803,1421,-10
28745372677,28745372681,4,2659,2213,-10
28745904672,28745904671,-1,1523,1106,-10
28746949762,28746949763,1,1555,1319,-10
28748879346,28748879349,3,1953,1596,-10
28749439833,28749439838,5,15001,37268,-10
28750371272,28750371274,2,1025,856,-10
28751410399,28751410399,0,1882,2340,-10
28754895386,28754895390,4,2121,2438,-10
28755855833,28755855837,4,1745,1385,-10
28756770010,28756770014,4,1867,1646,-10
28758955291,28758955297,6,2910,1677,-10
28760280288,28760280287,-1,1379,2296,-10
28761735874,28761735874,0,1275,1524,-10
28767409671,28767409678,7,2162,1349,-10
28768129517,28768129519,2,2302,1797,-10
28771868370,28771868372,2,1463,1715,-10
28776585975,28776585978,3,1538,1829,-10
28777369939,28777369938,-1,939,2034,-10
28777411437,28777411438,1,1362,1605,-10
28777454170,28777454173,3,1113,1412,-10
28782517924,28782517925,1,1164,1241,-10
28783961713,28783961715,2,1470,1421,-10
28784286774,28784286773,-1,1237,1054,-10
28789572435,28789572438,3,1591,1527,-10
28789860083,28789860086,3,1690,1873,-10
28790208634,28790208628,-6,1239,4820,-10
28793151646,28793151645,-1,1464,2345,-10
28793849144,28793849145,1,1737,1207,-10
28795344856,28795344857,1,1226,1111,-10
28798075509,28798075511,2,1684,1456,-10
28802910251,28802910252,1,1427,1558,-10
28806758551,28806758554,3,1971,1926,-10
28810530761,28810530763,2,1798,905,-10
28811446125,28811446123,-2,1165,3053,-10
28811518867,28811518871,4,399,2775,-10
28812982877,28812982890,13,1919,935,-10
28813139932,28813139934,2,1766,1395,-10
28813987107,28813987110,3,1312,1193,-10
28818701990,28818701991,1,1344,1620,-10
28819844277,28819844280,3,1975,1534,-10
28824852761,28824852763,2,1447,1379,-10
28832026583,28832026586,3,1163,1570,-10
28832797398,28832797406,8,7900,1516,-10
28832862049,28832862051,2,1541,2324,-10
28833255498,28833255498,0,1459,2100,-10
28837108667,28837108670,3,1729,1752,-10
28837415122,28837415128,6,5296,2430,-10
28837510658,28837510659,1,1063,1274,-10
28840001861,28840001861,0,1154,1783,-10
28841105788,28841105791,3,2014,1850,-10
28846718001,28846718002,1,1124,1465,-10
28847836138,28847836139,1,1621,1915,-10
28850008438,28850008447,9,4632,1264,-10
28852040645,28852040643,-2,1538,2109,-10
28867578380,28867578384,4,1273,999,-10
28867838934,28867838922,-12,11752,43235,-10
28869056633,28869056634,1,1575,1404,-10
28869135070,28869135072,2,1306,1552,-10
28870734635,28870734631,-4,1199,2753,-10
28873223074,28873223075,1,2044,1604,-10
28877106533,28877106534,1,1459,1644,-10
28881605722,28881605720,-2,880,1731,-10
28884005811,28884005810,-1,1327,1342,-10
28886226692,28886226693,1,1285,960,-10
28888569258,28888569258,0,1090,1010,-10
28888904398,28888904398,0,2086,2278,-10
28889712738,28889712740,2,1377,1560,-10
28894783532,28894783534,2,2111,1361,-10
28896949087,28896949090,3,1590,1781,-10
28896977243,28896977244,1,1390,905,-10
28898142338,28898142341,3,1621,1220,-10
28901486089,28901486089,0,1195,1279,-10
28901587374,28901587378,4,1057,1036,-10
28904055245,28904055246,1,1589,1934,-10
28904848034,28904848038,4,2015,1905,-10
28908194418,28908194421,3,874,1407,-10
28909546053,28909546053,0,1364,1984,-10
28910249677,28910249659,-18,1558,1619,-10
28910621382,28910621364,-18,2282,1834,-10
28912697148,28912697147,-1,1379,1238,-10
28913202914,28913202914,0,2093,2634,-10
28913484878,28913484879,1,811,1485,-10
28917763998,28917763999,1,2371,1653,-10
28919116423,28919116423,0,1319,1746,-10
28919468715,28919468718,3,1392,1251,-10
28923101213,28923101215,2,1197,1139,-10
28926336451,28926336454,3,2263,1975,-10
28929701593,28929701594,1,1287,1253,-10
28930905567,28930905571,4,1657,1737,-10
28932614930,28932614933,3,1710,1859,-10
28933797730,28933797733,3,1267,1825,-10
28934849927,28934849931,4,1426,1157,-10
28935134901,28935134883,-18,1336,1050,-10
28935507176,28935507177,1,2114,2272,-10
28936007529,28936007530,1,1717,1547,-10
28936582662,28936582662,0,1159,1126,-10
28937493538,28937493542,4,1102,1238,-10
28938910171,28938910173,2,2167,2495,-10
28939709121,28939709125,4,1860,1388,-10
28940029753,28940029758,5,5077,2223,-10
28942153985,28942153987,2,1524,1889,-10
28943052369,28943052370,1,1703,1955,-10
28943931449,28943931450,1,1332,1508,-10
28945650229,28945650230,1,1523,1080,-10
28947624720,28947624722,2,1902,1540,-10
28948064588,28948064589,1,1509,1579,-10
28949902797,28949902797,0,2130,2225,-10
28950197124,28950197125,1,1445,1686,-10
28952300434,28952300433,-1,1953,1705,-10
28954204429,28954204421,-8,749,4887,-10
28955024543,28955024546,3,1093,1497,-10
28957206265,28957206266,1,1807,2106,-10
28957238745,28957238745,0,1084,1103,-10
28957518632,28957518631,-1,1879,1504,-10
28958257011,28958257013,2,1406,1387,-10
28959905350,28959905352,2,1925,1825,-10
28961943553,28961943546,-7,931,4804,-10
28966214979,28966214983,4,1468,1333,-10
28966359510,28966359511,1,1300,1304,-10
28967209934,28967209936,2,1920,1675,-10
28967896289,28967896294,5,1456,1505,-10
28968164665,28968164670,5,1381,1310,-10
28969592526,28969592527,1,1386,1424,-10
28974119891,28974119893,2,1679,1573,-10
28974791531,28974791534,3,1877,2292,-10
28976136211,28976136211,0,1104,1099,-10
28978900362,28978900358,-4,1075,2650,-10
28979357478,28979357477,-1,1162,1630,-10
28980458986,28980458987,1,1740,1235,-10
28980755510,28980755511,1,1392,1629,-10
28983525950,28983525949,-1,1331,1197,-10
28985017406,28985017409,3,1229,1581,-10
28987251427,28987251427,0,1058,934,-10
28987282593,28987282595,2,1675,1363,-10
28990265017,28990265015,-2,2265,5185,-10
28990655350,28990655350,0,1832,2189,-10
28990828653,28990828656,3,2188,1583,-10
28993168638,28993168637,-1,1694,1884,-10
28995054193,28995054194,1,990,1352,-10
28997404354,28997404357,3,1451,1345,-10
28997835540,28997835543,3,1295,1244,-10
28998770443,28998770445,2,1398,1232,-10
29001267232,29001267233,1,1768,1466,-10
29003424596,29003424617,21,1503,1392,-10
29006533313,29006533315,2,1250,1295,-10
29014436673,29014436674,1,2049,1887,-10
29015355072,29015355073,1,932,1265,-10
29017699434,29017699435,1,1295,1104,-10
29018408011,29018408017,6,2198,1568,-10
29018980806,29018980809,3,1842,1669,-10
29021299694,29021299682,-12,16292,42610,-10
29021860121,29021860118,-3,2237,4512,-10
29025027238,29025027244,6,3162,1528,-10
29026614405,29026614408,3,1741,1776,-10
29027097306,29027097306,0,1634,1587,-10
29027380828,29027380827,-1,1268,1389,-10
29032467274,29032467274,0,1490,1346,-10
29033779958,29033779957,-1,1327,1818,-10
29034877947,29034877949,2,1355,1681,-10
29036196546,29036196553,7,1307,1629,-10
29037921082,29037921083,1,1745,1907,-10
29040454009,29040454003,-6,40435,9407,-10
29041094937,29041094940,3,1106,1158,-10
29042559185,29042559187,2,1320,1608,-10
29043648259,29043648261,2,1900,1170,-10
29043801069,29043801069,0,1027,1778,-10
29047709790,29047709774,-16,1577,1317,-10
29048754033,29048754034,1,1743,1958,-10
29049819390,29049819393,3,2059,2429,-10
29050386481,29050386483,2,1494,1992,-10
29055744513,29055744517,4,1127,1266,-10
29056451834,29056451836,2,1652,1883,-10
29056848614,29056848597,-17,1241,1137,-10
29058999291,29058999294,3,1687,2002,-10
29059216111,29059216115,4,1887,1078,-10
29061562359,29061562362,3,2292,1040,-10
29063365933,29063365937,4,2041,1490,-10
29066394058,29066394059,1,1478,1452,-10
29067303529,29067303530,1,1759,1387,-10
29070070437,29070070438,1,1701,1231,-10
29071040849,29071040852,3,2101,1968,-10
29075164183,29075164182,-1,1612,1807,-10
29075346346,29075346347,1,1497,1286,-10
29078052250,29078052250,0,1457,1535,-10
29079443269,29079443270,1,1743,1670,-10
29080405244,29080405247,3,2112,2121,-10
29080970612,29080970614,2,2197,1602,-10
29084258898,29084258901,3,1619,1271,-10
29085108486,29085108490,4,1838,1469,-10
29088866253,29088866254,1,1544,2260,-10
29088997697,29088997690,-7,269,1908,-10
29090534426,29090534427,1,1325,1305,-10
29093531503,29093531498,-5,49157,20632,-10
29095051130,29095051133,3,1421,1336,-10
29098774155,29098774154,-1,1140,1228,-10
29099248130,29099248111,-19,5067,5044,-10
29104373515,29104373516,1,1580,1352,-10
29104427894,29104427899,5,1672,1045,-10
29106772181,29106772183,2,1842,1327,-10
29107870615,29107870622,7,6297,3804,-10
29109235949,29109235950,1,1395,1145,-10
29111981954,29111981957,3,2111,1273,-10
29112053950,29112053950,0,1370,1336,-10
29112153906,29112153889,-17,880,1523,-10
29113837929,29113837930,1,888,1178,-10
29114237766,29114237765,-1,1524,1604,-10
29115867681,29115867682,1,1711,1432,-10
29115919362,29115919367,5,2137,995,-10
29119071098,29119071101,3,1317,1845,-10
29119315011,29119314998,-13,1152,1467,-10
29120482095,29120482096,1,1560,1686,-10
29123988259,29123988258,-1,1788,1923,-10
29129399462,29129399463,1,1000,1068,-10
29130962637,29130962639,2,864,902,-10
29134891306,29134891309,3,1424,1895,-10
29143462236,29143462240,4,2179,1830,-10
29144254010,29144254010,0,1776,2273,-10
29144336123,29144336125,2,1107,930,-10
29147017318,29147017318,0,1804,1595,-10
29151589743,29151589746,3,1107,1363,-10
29152635820,29152635824,4,1691,1404,-10
29153980385,29153980390,5,2723,1038,-10
29154327979,29154327981,2,995,1125,-10
29156785750,29156785753,3,1449,1200,-10
29161064743,29161064746,3,1923,1742,-10
29163992742,29163992743,1,1624,1318,-10
29164320323,29164320326,3,1607,1324,-10
29164712959,29164712960,1,773,1272,-10
29167433382,29167433385,3,1290,1084,-10
29169132338,29169132341,3,1559,1563,-10
29169585562,29169585579,17,1135,1207,-10
29170881363,29170881366,3,1631,1325,-10
29176006572,29176006577,5,2439,1651,-10
29177008410,29177008413,3,1318,1366,-10
29177548720,29177548712,-8,1127,5358,-10
29179850375,29179850378,3,1895,1916,-10
29187996091,29187996093,2,999,1195,-10
29188067979,29188067981,2,1333,1633,-10
29191894974,29191894977,3,2318,3121,-10
29194358614,29194358615,1,1679,1931,-10
29195727219,29195727216,-3,1344,2560,-10
29195968446,29195968449,3,1263,1957,-10
29198764466,29198764469,3,2520,1872,-10
29200392610,29200392610,0,1531,1966,-10
29202468534,29202468538,4,1911,1577,-10
29203040185,29203040191,6,3401,1819,-10
29205905558,29205905561,3,1508,1654,-10
29209587965,29209587969,4,2360,1445,-10
29211572407,29211572407,0,1052,1068,-10
29212951938,29212951942,4,4594,3282,-10
29215163698,29215163695,-3,2198,5088,-10
29219664217,29219664219,2,1423,1037,-10
29223189591,29223189595,4,2334,2492,-10
29224277066,29224277066,0,1949,1381,-10
29225669689,29225669690,1,1418,1259,-10
29226147305,29226147297,-8,663,1343,-10
29228136403,29228136405,2,1421,2056,-10
29228909247,29228909226,-21,1663,1380,-10
29230953006,29230953006,0,1003,1948,-10
29232670870,29232670874,4,1729,1098,-10
29235110854,29235110854,0,1616,1449,-10
29242787513,29242787513,0,1861,1369,-10
29246075734,29246075735,1,829,602,-10
29250723386,29250723389,3,1359,1619,-10
29252591940,29252591943,3,1768,1594,-10
29257505190,29257505191,1,1286,2063,-10
29258530128,29258530130,2,1363,1716,-10
29260502846,29260502849,3,1457,1321,-10
29260803658,29260803660,2,1584,1687,-10
29262193343,29262193343,0,1780,2109,-10
29262345838,29262345839,1,1851,1502,-10
29262946551,29262946553,2,1015,1166,-10
29264987597,29264987598,1,2508,1884,-10
29267802766,29267802770,4,1947,1446,-10
29268611798,29268611799,1,29698,30520,-10
29271093515,29271093516,1,2060,1892,-10
29277069735,29277069737,2,1447,1823,-10
29278476026,29278476030,4,1748,1660,-10
29279658575,29279658571,-4,1366,1823,-10
29282008347,29282008345,-2,894,1129,-10
29283089303,29283089307,4,1734,2255,-10
29287508425,29287508428,3,1257,1847,-10
29287674228,29287674230,2,1730,1475,-10
29288909043,29288909045,2,1363,1659,-10
29292224686,29292224687,1,1764,1213,-10
29293204869,29293204870,1,1305,1171,-10
29295577983,29295577985,2,1722,1545,-10
29302523468,29302523470,2,1274,1386,-10
29304071005,29304071006,1,1633,1523,-10
29311478819,29311478813,-6,705,3161,-10
29312498601,29312498602,1,1209,1228,-10
29313611770,29313611770,0,850,1304,-10
29315953910,29315953910,0,1414,1634,-10
29320246450,29320246450,0,1482,1906,-10
29324541662,29324541662,0,1410,941,-10
29324969102,29324969105,3,1358,1822,-10
29331928966,29331928963,-3,1649,2599,-10
29332078037,29332078037,0,1443,1750,-10
29333153659,29333153659,0,875,1788,-10
29335300415,29335300418,3,1716,989,-10
29335778416,29335778418,2,1614,1797,-10
29337212594,29337212595,1,1526,1616,-10
29337798782,29337798781,-1,1050,1048,-10
29343445786,29343445790,4,3733,2629,-10
29348945807,29348945809,2,1557,1265,-10
29349067027,29349067033,6,930,914,-10
29350143326,29350143327,1,1723,1409,-10
29351019277,29351019297,20,1121,1086,-10
29351927472,29351927475,3,2521,2123,-10
29354208694,29354208693,-1,3070,4528,-10
29355758573,29355758574,1,1147,1450,-10
29356131806,29356131811,5,1346,2102,-10
29360850086,29360850090,4,1514,1570,-10
29364724597,29364724597,0,2281,2293,-10
29364944027,29364944030,3,1117,1632,-10
29368104181,29368104185,4,1588,1489,-10
29371185439,29371185440,1,1660,2033,-10
29373660434,29373660434,0,1400,1777,-10
29374935345,29374935350,5,1446,979,-10
29376865132,29376865133,1,1314,1063,-10
29377211841,29377211844,3,1680,2050,-10
29378823277,29378823284,7,10930,32274,-10
29379283775,29379283775,0,1699,1444,-10
29382114169,29382114171,2,1905,2278,-10
29384523591,29384523592,1,1790,1638,-10
29384886849,29384886850,1,1443,1647,-10
29385493434,29385493438,4,1749,1063,-10
29387244230,29387244231,1,1241,989,-10
29391018223,29391018227,4,954,620,-10
29392680554,29392680555,1,1097,1346,-10
29393068801,29393068802,1,1111,1739,-10
29397084643,29397084645,2,2031,2153,-10
29397945806,29397945810,4,1761,1277,-10
29398188119,29398188139,20,1620,1551,-10
29400685796,29400685797,1,1894,2519,-10
29403392108,29403392110,2,954,1606,-10
29404209346,29404209349,3,1970,1960,-10
29405273102,29405273104,2,2085,1487,-10
29405833769,29405833770,1,1886,1765,-10
29406114822,29406114822,0,1325,1580,-10
29406522173,29406522174,1,1194,1340,-10
29406682010,29406682013,3,1150,1293,-10
29409716394,29409716395,1,1398,1048,-10
29416760090,29416760092,2,1387,1292,-10
29417593214,29417593216,2,1473,2567,-10
29418190445,29418190446,1,980,1424,-10
29418840374,29418840375,1,1721,1458,-10
29424140890,29424140902,12,1412,640,-10
29425501037,29425501043,6,3831,1874,-10
29428217183,29428217186,3,2001,1728,-10
29428812351,29428812358,7,3660,2228,-10
29429384374,29429384374,0,1663,1623,-10
29431192315,29431192330,15,10679,45401,-10
29433626434,29433626433,-1,897,1323,-10
29435129245,29435129247,2,1679,2194,-10
29439961677,29439961685,8,5856,2580,-10
29440199816,29440199813,-3,1044,1518,-10
29442849477,29442849478,1,1380,1091,-10
29443064251,29443064253,2,1678,1652,-10
29444477392,29444477394,2,725,958,-10
29445200403,29445200407,4,1055,1248,-10
29446055963,29446055965,2,1093,876,-10
29448005990,29448005989,-1,1296,1615,-10
29448953537,29448953537,0,1122,1248,-10
29450633216,29450633217,1,1444,1073,-10
29451741091,29451741093,2,1805,1222,-10
29452564110,29452564121,11,754,117,-10
29453961866,29453961866,0,1846,1684,-10
29454736418,29454736418,0,1430,1922,-10
29457074050,29457074045,-5,904,1953,-10
29457959875,29457959877,2,1563,1973,-10
29461182058,29461182064,6,1674,1326,-10
29461462522,29461462525,3,1624,1751,-10
29463332520,29463332517,-3,1646,1953,-10
29466638829,29466638835,6,1442,768,-10
29466698428,29466698430,2,971,1111,-10
29468918206,29468918208,2,1482,1334,-10
29469039261,29469039240,-21,1216,1721,-10
29473907027,29473907028,1,1428,1827,-10
29475054513,29475054514,1,1592,1529,-10
29475153284,29475153285,1,1676,2073,-10
29475556277,29475556280,3,1650,2328,-10
29477456146,29477456147,1,1351,1269,-10
29480011658,29480011666,8,4103,2444,-10
29480665641,29480665643,2,1379,1734,-10
29481835203,29481835202,-1,1124,2804,-10
29484888616,29484888618,2,1556,1407,-10
29490107106,29490107111,5,1638,1349,-10
29492299366,29492299367,1,1597,1328,-10
29494136090,29494136091,1,1767,1169,-10
29496133136,29496133137,1,1502,1284,-10
29497353558,29497353560,2,2179,2004,-10
29498366346,29498366349,3,1236,1421,-10
29499399669,29499399673,4,1797,1418,-10
29499515831,29499515812,-19,2830,1839,-10
29502963230,29502963234,4,1624,1769,-10
29505083688,29505083691,3,1412,1098,-10
29505283079,29505283082,3,1000,1089,-10
29506086674,29506086675,1,1395,1388,-10
29506972483,29506972485,2,827,1581,-10
29507170177,29507170177,0,2040,2363,-10
29511812133,29511812134,1,1446,1447,-10
29512313442,29512313445,3,1698,1829,-10
29512775072,29512775073,1,1271,1203,-10
29515951790,29515951791,1,1029,994,-10
29518014121,29518014123,2,1733,1202,-10
29518252454,29518252453,-1,957,1480,-10
29518890458,29518890454,-4,899,2981,-10
29519207760,29519207751,-9,1442,1609,-10
29520014735,29520014732,-3,710,1600,-10
29520531030,29520531031,1,2078,1967,-10
29521138596,29521138599,3,2126,1514,-10
29524025243,29524025250,7,1743,1633,-10
29524523277,29524523278,1,1306,1421,-10
29525327286,29525327286,0,1495,1660,-10
29530497710,29530497713,3,2020,1426,-10
29534437648,29534437650,2,30610,21537,-10
29541249068,29541249069,1,1852,1693,-10
29541787885,29541787886,1,958,1132,-10
29548702322,29548702323,1,2157,1796,-10
29550960094,29550960101,7,2562,1483,-10
29561914766,29561914769,3,1239,1008,-10
29562319591,29562319586,-5,1651,5180,-10
29566049595,29566049590,-5,1213,3747,-10
29569301257,29569301260,3,1988,1245,-10
29569630847,29569630849,2,1940,1860,-10
29569916534,29569916537,3,1391,1806,-10
29571909154,29571909152,-2,1253,1198,-10
29572862060,29572862062,2,1941,1473,-10
29578911247,29578911267,20,1105,1230,-10
29582445369,29582445369,0,1124,1514,-10
29583143089,29583143091,2,1269,2300,-10
29584642369,29584642372,3,12507,26613,-10
29584956682,29584956686,4,1099,543,-10
29585925680,29585925682,2,1855,1734,-10
29589152137,29589152139,2,1882,1223,-10
29593457467,29593457467,0,1824,1475,-10
29594190217,29594190218,1,1929,1552,-10
29600173654,29600173653,-1,1894,2286,-10
29601282831,29601282833,2,1410,1506,-10
29602178103,29602178105,2,1764,1294,-10
29602217461,29602217462,1,1701,1220,-10
29602968349,29602968354,5,2761,1536,-10
29603985922,29603985923,1,2075,1411,-10
29605024459,29605024461,2,1171,1428,-10
29605865153,29605865153,0,1714,1797,-10
29614906774,29614906774,0,2016,1619,-10
29617653586,29617653586,0,2065,1483,-10
29618169599,29618169596,-3,1547,2729,-10
29618915493,29618915496,3,2027,1602,-10
29619747222,29619747225,3,1567,1642,-10
29623816334,29623816334,0,1596,1954,-10
29624851813,29624851815,2,1606,1448,-10
29630709878,29630709880,2,1174,1879,-10
29630948418,29630948419,1,1135,1004,-10
29632187944,29632187947,3,2446,1852,-10
29637294966,29637294965,-1,1014,2671,-10
29638329992,29638329995,3,823,1373,-10
29638998242,29638998244,2,1677,1945,-10
29640806662,29640806665,3,1796,1406,-10
29641510514,29641510520,6,2694,1943,-10
29645270089,29645270090,1,1692,1670,-10
29649508626,29649508626,0,1714,2001,-10
29649826023,29649826025,2,2093,1729,-10
29649908829,29649908832,3,1498,1461,-10
29650171385,29650171386,1,1658,1752,-10
29650443162,29650443163,1,868,970,-10
29652557887,29652557887,0,1372,1826,-10
29654713486,29654713487,1,1796,2084,-10
29655772823,29655772823,0,1842,2724,-10
29657073657,29657073662,5,1851,1661,-10
29658908063,29658908063,0,1096,1151,-10
29660750773,29660750776,3,1844,1347,-10
29661687925,29661687905,-20,1396,1549,-10
29663694090,29663694097,7,1317,1476,-10
29664236810,29664236811,1,23765,19958,-10
29665416874,29665416875,1,1685,2112,-10
29668459261,29668459264,3,2230,1539,-10
29668799327,29668799328,1,1183,1957,-10
29672701533,29672701534,1,1444,1181,-10
29678867503,29678867499,-4,1505,3357,-10
29679278099,29679278099,0,1447,1802,-10
29679878870,29679878874,4,1549,1059,-10
29679998557,29679998565,8,6042,2477,-10
29680153804,29680153806,2,1725,1685,-10
29680438046,29680438051,5,1383,1441,-10
29681087334,29681087333,-1,53857,47650,-10
29684527865,29684527866,1,2052,1951,-10
29687094417,29687094420,3,1553,1268,-10
29688092469,29688092471,2,1220,1577,-10
29691957149,29691957150,1,1943,1103,-10
29695643839,29695643842,3,1139,1091,-10
29698301825,29698301829,4,1078,1164,-10
29699194502,29699194506,4,1390,1059,-10
29705798159,29705798161,2,1487,2252,-10
29709833832,29709833831,-1,1376,1214,-10
29711790252,29711790252,0,1788,2453,-10
29712854015,29712854018,3,1879,1448,-10
29716586650,29716586653,3,1280,1545,-10
29717104955,29717104957,2,1373,1669,-10
29717657291,29717657292,1,1859,1413,-10
29717851944,29717851946,2,1922,2016,-10
29718503053,29718503054,1,1291,1268,-10
29720355993,29720355998,5,1547,1096,-10
29720492598,29720492600,2,1395,1209,-10
29722613633,29722613642,9,1826,1328,-10
29723617102,29723617105,3,1141,1356,-10
29723994936,29723994916,-20,19,1312,-10
29727268796,29727268775,-21,1658,1269,-10
29727523334,29727523337,3,1397,2149,-10
29729715933,29729715935,2,1596,1181,-10
29736088297,29736088303,6,1829,1300,-10
29737544182,29737544183,1,1466,1696,-10
29739981807,29739981811,4,2438,1464,-10
29744334069,29744334067,-2,1401,3008,-10
29744985791,29744985794,3,2045,1937,-10
29745018950,29745018950,0,1088,1524,-10
29745818572,29745818574,2,1673,1693,-10
29750328889,29750328892,3,2147,2574,-10
29750527946,29750527941,-5,974,3575,-10
29755380174,29755380179,5,1729,1410,-10
29755490095,29755490074,-21,2190,2353,-10
29755993161,29755993150,-11,1234,906,-10
29757087351,29757087349,-2,757,1310,-10
29757538922,29757538923,1,1540,1494,-10
29758555200,29758555201,1,1740,1409,-10
29759140107,29759140109,2,1354,1845,-10
29760086633,29760086635,2,1507,1253,-10
29761122306,29761122310,4,1272,1400,-10
29761163036,29761163042,6,78210,30916,-10
29763179538,29763179538,0,1837,1694,-10
29766165686,29766165691,5,1392,1355,-10
29769328082,29769328082,0,1476,1611,-10
29769379494,29769379514,20,1862,1272,-10
29769807691,29769807693,2,1528,1512,-10
29771869966,29771869955,-11,1244,1381,-10
29775481074,29775481075,1,2296,2103,-10
29776227494,29776227490,-4,1141,1855,-10
29777034407,29777034409,2,1709,1763,-10
29777433526,29777433528,2,1759,1832,-10
29778182119,29778182123,4,1899,1266,-10
29778342795,29778342799,4,1436,1249,-10
29779194677,29779194679,2,1140,1487,-10
29788167081,29788167082,1,1264,1404,-10
29788667168,29788667182,14,511,2915,-10
29790058191,29790058186,-5,1137,1413,-10
29791738410,29791738412,2,1812,1706,-10
29792927758,29792927761,3,1592,1625,-10
29795682081,29795682083,2,1302,1425,-10
29800916335,29800916349,14,93,4399,-10
29805320327,29805320328,1,1541,1526,-10
29806020102,29806020105,3,2082,2386,-10
29807083995,29807083998,3,2027,1639,-10
29809091097,29809091100,3,1662,1418,-10
29817344231,29817344232,1,1647,1085,-10
29818350857,29818350859,2,1603,1732,-10
29820640122,29820640126,4,1563,1643,-10
29825576866,29825576869,3,1516,1378,-10
29827977777,29827977778,1,1271,1828,-10
29834571564,29834571567,3,1849,1266,-10
29834620323,29834620325,2,1529,1185,-10
29835494488,29835494490,2,1050,1349,-10
29835864166,29835864169,3,1844,1914,-10
29836161549,29836161551,2,1808,1331,-10
29841185974,29841185979,5,1642,1028,-10
29842947330,29842947331,1,1569,1686,-10
29846243513,29846243514,1,1622,1445,-10
29853963043,29853963045,2,1932,1290,-10
29855092159,29855092161,2,2052,2211,-10
29856300222,29856300226,4,1600,1436,-10
29856809797,29856809798,1,1325,980,-10
29857967181,29857967182,1,1571,1185,-10
29858337841,29858337839,-2,1339,1791,-10
29870316830,29870316834,4,1208,1489,-10
29870396423,29870396424,1,2049,2218,-10
29872159237,29872159238,1,1533,1481,-10
29872224526,29872224529,3,2473,1888,-10
29875307876,29875307879,3,1141,1414,-10
29877842002,29877842005,3,1479,1703,-10
29880304931,29880304934,3,1882,1162,-10
29883608662,29883608665,3,1446,1495,-10
29883907182,29883907186,4,2089,1567,-10
29884044167,29884044167,0,1440,2424,-10
29884811906,29884811903,-3,2631,4295,-10
29885244153,29885244152,-1,1310,960,-10
29891501287,29891501291,4,685,702,-10
29893960882,29893960899,17,600,1837,-10
29895166543,29895166545,2,1583,1363,-10
29897813118,29897813119,1,1321,1062,-10
29899809484,29899809486,2,1753,1145,-10
29900420724,29900420726,2,1395,1428,-10
29904593405,29904593402,-3,1469,1503,-10
29904619110,29904619110,0,1280,1715,-10
29905499011,29905499011,0,927,946,-10
29905729160,29905729163,3,1964,1308,-10
29908686347,29908686350,3,1126,1270,-10
29912250642,29912250643,1,2017,1779,-10
29912993554,29912993557,3,1115,1023,-10
29916054450,29916054450,0,1431,1231,-10
29917126373,29917126373,0,1606,2243,-10
29918980575,29918980577,2,2280,1729,-10
29921578043,29921578043,0,1482,2210,-10
29922556130,29922556131,1,1142,1156,-10
29924012245,29924012246,1,1382,1600,-10
29925091543,29925091546,3,1619,1211,-10
29927952028,29927952030,2,1426,1273,-10
29928962691,29928962694,3,1756,2497,-10
29935912930,29935912932,2,1954,1404,-10
29936761969,29936761972,3,1362,1534,-10
29943786314,29943786315,1,1367,1199,-10
29944362260,29944362261,1,1316,1186,-10
29947949018,29947949020,2,1328,1406,-10
29950330077,29950330079,2,2075,1656,-10
29955166885,29955166886,1,1566,1625,-10
29955412549,29955412550,1,1350,1652,-10
29958314065,29958314066,1,1200,1600,-10
29963404705,29963404705,0,1371,1310,-10
29965574367,29965574370,3,1468,1682,-10
29967184325,29967184326,1,1299,1336,-10
29967432421,29967432422,1,2032,1424,-10
29967601980,29967601982,2,1639,1537,-10
29969858550,29969858550,0,1245,1413,-10
29971469656,29971469660,4,1167,1109,-10
29972997307,29972997308,1,1601,1263,-10
29979950147,29979950149,2,1602,2114,-10
29980506379,29980506382,3,1496,2013,-10
29981621625,29981621627,2,1831,1725,-10
29983139278,29983139281,3,1760,2013,-10
29985256946,29985256949,3,2388,1893,-10
29987075971,29987075974,3,1194,802,-10
29988005090,29988005093,3,1986,2230,-10
29988759199,29988759202,3,1977,1591,-10
29996556227,29996556229,2,1192,946,-10
29999690271,29999690273,2,1757,1354,-10
30000799818,30000799818,0,1211,1893,-10
30002298994,30002298996,2,1079,1063,-10
30003776323,30003776324,1,1463,1985,-10
30007527903,30007527907,4,1820,1942,-10
30007960297,30007960300,3,1371,1556,-10
30008562419,30008562435,16,1926,2157,-10
30019267291,30019267292,1,1459,1384,-10
30023938693,30023938695,2,1786,1354,-10
30025474094,30025474099,5,3470,3050,-10
30027010934,30027010935,1,1705,1124,-10
30030354407,30030354410,3,2011,1562,-10
30031565129,30031565130,1,1035,1453,-10
30031661215,30031661217,2,1614,1313,-10
30032092830,30032092834,4,2293,1397,-10
30035116494,30035116500,6,2926,1738,-10
30035544429,30035544431,2,1022,939,-10
30037369507,30037369515,8,4537,2083,-10
30038978749,30038978753,4,1655,1240,-10
30045001090,30045001091,1,1484,1766,-10
30045300723,30045300729,6,3465,977,-10
30046842158,30046842161,3,1409,1351,-10
30052714433,30052714435,2,1782,2172,-10
30052958125,30052958126,1,1977,1588,-10
30053100833,30053100837,4,1170,1391,-10
30053884164,30053884166,2,1522,1341,-10
30054515693,30054515694,1,1278,1503,-10
30055698050,30055698051,1,2006,1701,-10
30061037890,30061037889,-1,1622,1832,-10
30062672857,30062672860,3,54391,40949,-10
30063165522,30063165525,3,1381,1606,-10
30064332748,30064332751,3,1426,1014,-10
30065975575,30065975578,3,1100,1623,-10
30069219877,30069219878,1,1145,1797,-10
30071047132,30071047134,2,1397,1045,-10
30073252906,30073252906,0,1482,1576,-10
30073465889,30073465892,3,1502,920,-10
30074152972,30074152975,3,1696,1766,-10
30076344235,30076344239,4,2118,1754,-10
30077444069,30077444062,-7,1279,5346,-10
30079393933,30079393934,1,1362,1827,-10
30080576988,30080576990,2,1879,1515,-10
30082164388,30082164387,-1,3725,4070,-10
30082955013,30082955014,1,1194,1294,-10
30088085885,30088085887,2,1045,669,-10
30090011951,30090011959,8,4469,1138,-10
30090320084,30090320088,4,2327,1505,-10
30093914484,30093914485,1,1435,2277,-10
30095609180,30095609184,4,7956,32169,-10
30099724855,30099724857,2,2096,2032,-10
30100830695,30100830701,6,2294,1128,-10
30101570760,30101570762,2,1584,1352,-10
30115080722,30115080723,1,966,1711,-10
30115712860,30115712860,0,1669,1036,-10
30119480818,30119480819,1,1456,1098,-10
30119672097,30119672098,1,1450,1461,-10
30120615945,30120615947,2,2209,2187,-10
30121101344,30121101346,2,1455,1257,-10
30121834279,30121834281,2,1782,1236,-10
30123324857,30123324858,1,1591,1373,-10
30124322446,30124322446,0,1555,1514,-10
30126548773,30126548774,1,1519,1731,-10
30128219019,30128219022,3,1404,1615,-10
30128373438,30128373452,14,4320,13698,-10
30129518861,30129518864,3,1824,1509,-10
30134685854,30134685854,0,1832,2168,-10
30137608579,30137608583,4,5317,3123,-10
30138433778,30138433783,5,1592,1346,-10
30139811512,30139811514,2,1602,2034,-10
30139981013,30139981017,4,1678,1604,-10
30143586494,30143586497,3,1718,2146,-10
30145634601,30145634603,2,1254,1157,-10
30145731031,30145731032,1,1357,1193,-10
30149836489,30149836490,1,1873,1786,-10
30150717402,30150717404,2,1909,1746,-10
30152724830,30152724830,0,1016,1416,-10
30154186755,30154186759,4,1223,1181,-10
30154312270,30154312251,-19,952,697,-10
30156281519,30156281498,-21,52,2198,-10
30157633531,30157633532,1,1209,1123,-10
30163372166,30163372159,-7,1095,3885,-10
30164227080,30164227082,2,1538,1325,-10
30165802907,30165802914,7,1933,1265,-10
30167234337,30167234341,4,2014,1371,-10
30170045762,30170045762,0,3049,2160,-10
30170782401,30170782402,1,1571,1241,-10
30173788030,30173788035,5,1556,1767,-10
30176112690,30176112692,2,1601,1301,-10
30177158178,30177158178,0,1279,1268,-10
30177885579,30177885581,2,2551,2050,-10
30178052502,30178052502,0,1820,1594,-10
30179062332,30179062346,14,1122,1374,-10
30180243643,30180243645,2,1234,1140,-10
30181836533,30181836534,1,1588,1827,-10
30182956885,30182956886,1,1542,1664,-10
30183069185,30183069187,2,1859,2666,-10
30184324213,30184324217,4,1840,2267,-10
30184459910,30184459912,2,1179,1170,-10
30184826582,30184826582,0,1496,1971,-10
30185614422,30185614410,-12,1415,1954,-10
30185713049,30185713051,2,1451,1324,-10
30192005175,30192005186,11,862,76,-10
30198725947,30198725949,2,1742,1828,-10
30199207839,30199207841,2,1167,1525,-10
30202318726,30202318730,4,1962,1769,-10
30202827533,30202827539,6,1822,1136,-10
30205797450,30205797450,0,1572,2066,-10
30207246230,30207246230,0,966,1300,-10
30207337698,30207337698,0,1810,1595,-10
30208411872,30208411874,2,1293,1333,-10
30209140614,30209140618,4,1832,1856,-10
30210698997,30210698999,2,1565,1513,-10
30211132282,30211132282,0,1020,1481,-10
30211446693,30211446696,3,1439,1323,-10
30214738657,30214738656,-1,1818,1966,-10
30215243335,30215243336,1,1504,2191,-10
30217441923,30217441926,3,1520,1372,-10
30218094807,30218094811,4,705,705,-10
30225679403,30225679406,3,1764,1681,-10
30228835293,30228835294,1,1744,1390,-10
30229148344,30229148346,2,1541,1719,-10
30230787384,30230787385,1,1557,1834,-10
30232696543,30232696549,6,1493,1186,-10
30235406767,30235406770,3,1365,1440,-10
30235852426,30235852427,1,1610,1327,-10
30237612464,30237612465,1,2310,2553,-10
30239935473,30239935473,0,1194,1754,-10
30245515901,30245515903,2,1290,1390,-10
30247024193,30247024189,-4,1297,1250,-10
30248526723,30248526725,2,2289,1469,-10
30252685592,30252685595,3,1320,1351,-10
30253566525,30253566525,0,1310,1520,-10
30258110953,30258110954,1,2032,1775,-10
30262673439,30262673443,4,1329,1135,-10
30264710609,30264710610,1,2159,2487,-10
30267840641,30267840643,2,1951,1921,-10
30271746165,30271746167,2,1158,1135,-10
30272795349,30272795350,1,1576,1338,-10
30273223339,30273223341,2,1410,1441,-10
30273558157,30273558158,1,894,1204,-10
30273835719,30273835721,2,1948,2529,-10
30279028091,30279028095,4,1781,1370,-10
30281941325,30281941332,7,2668,1376,-10
30282488410,30282488411,1,857,1059,-10
30282575447,30282575452,5,988,1225,-10
30282882426,30282882428,2,1641,1596,-10
30283001294,30283001298,4,1555,1417,-10
30285831141,30285831142,1,1632,1506,-10
30289321070,30289321071,1,1283,836,-10
30291139990,30291139993,3,1241,1111,-10
30292038713,30292038714,1,1710,1941,-10
30293660486,30293660487,1,1433,1541,-10
30294635075,30294635080,5,19433,21866,-10
30295340579,30295340582,3,1239,1764,-10
30296367398,30296367401,3,1901,1551,-10
30297122283,30297122285,2,2179,1946,-10
30297593443,30297593445,2,1530,1495,-10
30298762251,30298762252,1,1528,1348,-10
30299994861,30299994867,6,1802,1809,-10
30303324734,30303324736,2,1742,1409,-10
30307249438,30307249439,1,1126,1194,-10
30310129636,30310129633,-3,1529,1450,-10
30315052441,30315052443,2,821,1184,-10
30318352498,30318352498,0,977,1093,-10
30322522563,30322522566,3,1654,1017,-10
30323058137,30323058136,-1,989,1865,-10
30323369238,30323369237,-1,1200,1132,-10
30323400522,30323400522,0,1607,1521,-10
30324475263,30324475258,-5,956,2605,-10
30325716809,30325716811,2,1753,1435,-10
30327851475,30327851476,1,1659,1212,-10
30329438605,30329438606,1,1654,1254,-10
30331559949,30331559950,1,1174,1709,-10
30333230133,30333230135,2,1411,1588,-10
30333375890,30333375890,0,2516,2006,-10
30333615119,30333615121,2,1984,1883,-10
30335718416,30335718415,-1,1631,2086,-10
30338508798,30338508802,4,1729,1071,-10
30341649533,30341649533,0,2053,2005,-10
30341941390,30341941393,3,1680,1365,-10
30343543483,30343543483,0,1887,1796,-10
30346322843,30346322842,-1,1669,1789,-10
30347601465,30347601444,-21,1696,1374,-10
30349731806,30349731809,3,1259,1794,-10
30350285847,30350285847,0,1742,2253,-10
30352728648,30352728650,2,1895,1496,-10
30353699025,30353699026,1,1666,1523,-10
30354664699,30354664702,3,1052,879,-10
30354763064,30354763073,9,15860,22757,-10
30355187603,30355187607,4,2450,1704,-10
30357159302,30357159310,8,1387,1768,-10
30362103290,30362103290,0,1690,1644,-10
30367677773,30367677775,2,1592,1671,-10
30371163986,30371163986,0,1185,1084,-10
30373157578,30373157581,3,1085,1068,-10
30375413914,30375413915,1,1243,1376,-10
30375865370,30375865372,2,1794,1734,-10
30376138554,30376138555,1,2015,1638,-10
30377399696,30377399696,0,1506,1456,-10
30378364686,30378364688,2,1660,1871,-10
30380556132,30380556135,3,2525,1801,-10
30387079267,30387079267,0,748,811,-10
30387973659,30387973639,-20,22020,27028,-10
30389466090,30389466092,2,1595,1376,-10
30392993702,30392993703,1,1346,1207,-10
30394406727,30394406726,-1,1457,1695,-10
30394439303,30394439302,-1,1168,1600,-10
30395650874,30395650875,1,932,1034,-10
30396499198,30396499198,0,2329,1974,-10
30397919957,30397919959,2,2052,1586,-10
30398284955,30398284957,2,1605,1714,-10
30398703350,30398703350,0,1489,1784,-10
30400261049,30400261046,-3,1191,2418,-10
30401714550,30401714552,2,3402,1863,-10
30403366463,30403366467,4,2287,1311,-10
30404508631,30404508632,1,1434,1737,-10
30406170504,30406170503,-1,1622,1302,-10
30406688632,30406688635,3,2065,1334,-10
30408549971,30408549972,1,1673,1439,-10
30410433608,30410433609,1,1827,1418,-10
30412483139,30412483141,2,1347,1322,-10
30413091946,30413091947,1,1135,1709,-10
30414065285,30414065287,2,1811,1909,-10
30414458155,30414458155,0,1324,1327,-10
30414685445,30414685450,5,1985,1722,-10
30415897926,30415897928,2,2201,2207,-10
30416650114,30416650114,0,1876,1693,-10
30417284221,30417284226,5,2158,1025,-10
30419249282,30419249283,1,1090,1338,-10
30420158151,30420158151,0,1194,1374,-10
30422246942,30422246943,1,1820,1249,-10
30426937462,30426937465,3,1326,1739,-10
30427028766,30427028767,1,1624,1871,-10
30429889250,30429889254,4,2154,1332,-10
30431292763,30431292774,11,867,942,-10
30431365886,30431365888,2,1896,1282,-10
30432475449,30432475451,2,1705,1781,-10
30435114682,30435114677,-5,2785,7303,-10
30435999118,30435999112,-6,1552,6700,-10
30440310452,30440310454,2,1325,1789,-10
30440512998,30440513002,4,4386,3126,-10
30441627855,30441627855,0,1598,1057,-10
30442509788,30442509789,1,1659,1705,-10
30444235205,30444235206,1,1521,1893,-10
30447147442,30447147445,3,1130,1376,-10
30452311077,30452311079,2,1149,1374,-10
30456307306,30456307307,1,1661,1403,-10
30456988623,30456988625,2,1272,1582,-10
30457923613,30457923613,0,1457,1153,-10
30458321397,30458321398,1,1855,1635,-10
30458507147,30458507149,2,2068,1661,-10
30458549207,30458549208,1,1779,1759,-10
30463313699,30463313702,3,1439,1415,-10
30465038226,30465038229,3,1198,1090,-10
30466651137,30466651142,5,2195,1627,-10
30471200021,30471200023,2,1417,1748,-10
30471589127,30471589132,5,1734,1474,-10
30472536998,30472536999,1,1512,1804,-10
30474269678,30474269679,1,1993,2302,-10
30474299186,30474299189,3,1544,1497,-10
30475305732,30475305734,2,1877,1607,-10
30476236554,30476236558,4,1519,1304,-10
30478707685,30478707686,1,1500,1054,-10
30479150995,30479150998,3,1023,1168,-10
30479361789,30479361791,2,2066,1429,-10
30484171782,30484171785,3,2598,1761,-10
30484732966,30484732968,2,1599,1502,-10
30485275979,30485275980,1,1257,1365,-10
30486653574,30486653577,3,1601,1864,-10
30487155670,30487155663,-7,778,5057,-10
30488198975,30488198979,4,925,890,-10
30488367106,30488367109,3,1816,2181,-10
30488567262,30488567262,0,1234,2016,-10
30489190606,30489190608,2,1622,1212,-10
30489757430,30489757430,0,1526,1517,-10
30490112422,30490112425,3,1312,1749,-10
30491007022,30491007023,1,1967,1482,-10
30494964706,30494964707,1,1988,1237,-10
30495901994,30495901997,3,1207,1080,-10
30498253691,30498253695,4,1904,1227,-10
30503156209,30503156211,2,1431,1613,-10
30505139525,30505139526,1,982,1233,-10
30506674482,30506674485,3,1319,1657,-10
30507116678,30507116680,2,1336,1719,-10
30507614866,30507614867,1,1292,1720,-10
30507846865,30507846867,2,1397,1687,-10
30509511109,30509511108,-1,1566,1387,-10
30511965889,30511965893,4,4232,2549,-10
30515518881,30515518883,2,1634,1453,-10
30515769148,30515769150,2,1104,1383,-10
30516488494,30516488495,1,1577,1417,-10
30517944582,30517944582,0,1526,1595,-10
30520367246,30520367246,0,937,1183,-10
30521342482,30521342484,2,1559,1431,-10
30522633246,30522633253,7,3014,1225,-10
30524113257,30524113259,2,1641,1249,-10
30526604302,30526604303,1,1470,1306,-10
30529595218,30529595217,-1,1366,960,-10
30529896356,30529896359,3,1986,1980,-10
30533763963,30533763966,3,981,1224,-10
30535700854,30535700860,6,3360,1600,-10
30536177525,30536177526,1,2303,1557,-10
30537579246,30537579249,3,1438,1363,-10
30537878993,30537878995,2,1462,2147,-10
30538567749,30538567752,3,1498,1499,-10
30539005457,30539005458,1,1742,1168,-10
30540281361,30540281361,0,2038,2094,-10
30540436417,30540436420,3,1956,2004,-10
30540777209,30540777213,4,1625,1314,-10
30541164731,30541164735,4,1971,1534,-10
30544016177,30544016174,-3,864,2115,-10
30544224043,30544224063,20,850,956,-10
30552411333,30552411330,-3,936,1852,-10
30553323158,30553323161,3,1252,1515,-10
30555088755,30555088754,-1,1098,1301,-10
30557350390,30557350392,2,1733,1416,-10
30559234966,30559234972,6,1583,1510,-10
30559289558,30559289570,12,1192,1527,-10
30562419873,30562419873,0,1952,1490,-10
30563094662,30563094667,5,1841,1826,-10
30564320673,30564320678,5,1731,819,-10
30564388717,30564388717,0,1494,1623,-10
30569478142,30569478145,3,1216,1528,-10
30569617443,30569617446,3,2395,2086,-10
30571535858,30571535862,4,2234,2116,-10
30572075926,30572075927,1,1532,1538,-10
30575791542,30575791542,0,1565,1515,-10
30579549074,30579549078,4,2799,1409,-10
30580494343,30580494345,2,1575,1348,-10
30580852813,30580852815,2,1553,1529,-10
30582727427,30582727430,3,1351,1386,-10
30583880762,30583880764,2,1352,1493,-10
30584024706,30584024709,3,1375,1184,-10
30586223315,30586223317,2,1562,1071,-10
30589287536,30589287540,4,868,953,-10
30594370644,30594370648,4,1740,1386,-10
30596071008,30596071010,2,1771,1111,-10
30596777631,30596777633,2,1735,2016,-10
30598049547,30598049548,1,2147,1637,-10
30598562471,30598562467,-4,1079,2891,-10
30599336842,30599336842,0,1148,1424,-10
30600292168,30600292170,2,1256,1408,-10
30601088179,30601088182,3,1381,1618,-10
30608302982,30608302982,0,1533,1170,-10
30608726234,30608726236,2,1830,2270,-10
30610322469,30610322453,-16,1517,732,-10
30615071277,30615071278,1,1729,1417,-10
30616950702,30616950702,0,1404,1285,-10
30618104710,30618104710,0,1247,1286,-10
30619095390,30619095394,4,1175,1288,-10
30621062999,30621063003,4,883,1327,-10
30622713810,30622713814,4,2967,1385,-10
30626106319,30626106323,4,1113,1595,-10
30626922748,30626922751,3,1436,1603,-10
30628695756,30628695758,2,1571,1910,-10
30630876433,30630876441,8,4048,1190,-10
30633734878,30633734872,-6,1136,3243,-10
30635512709,30635512711,2,1794,1522,-10
30637407059,30637407059,0,988,1438,-10
30638866250,30638866251,1,1853,1292,-10
30639538898,30639538897,-1,1128,1654,-10
30640631783,30640631787,4,1519,1359,-10
30641748326,30641748327,1,1569,1461,-10
30642011297,30642011297,0,988,1125,-10
30643397029,30643397031,2,1506,1302,-10
30643683855,30643683854,-1,1083,1251,-10
30647694707,30647694706,-1,1411,1620,-10
30650566178,30650566179,1,1450,1400,-10
30654500462,30654500471,9,6658,38165,-10
30654726481,30654726482,1,1545,1601,-10
30655092225,30655092226,1,1942,1690,-10
30655291498,30655291501,3,1560,1198,-10
30658270247,30658270246,-1,1161,1666,-10
30658734123,30658734127,4,1656,1388,-10
30666403953,30666403953,0,1797,1573,-10
30667293029,30667293031,2,1447,1318,-10
30667411495,30667411515,20,1579,1581,-10
30671232826,30671232827,1,1459,2063,-10
30672485323,30672485323,0,1274,1300,-10
30672886997,30672887001,4,1951,1678,-10
30681961056,30681961062,6,1305,1511,-10
30683156231,30683156231,0,1584,2053,-10
30683987985,30683987986,1,1481,1664,-10
30691491953,30691491954,1,2026,2116,-10
30694763126,30694763130,4,1847,1625,-10
30696480863,30696480865,2,1754,1692,-10
30697206622,30697206623,1,1648,1790,-10
30698093993,30698093994,1,1882,1127,-10
30699055653,30699055656,3,1952,1613,-10
30701036327,30701036327,0,1093,1306,-10
30701154493,30701154501,8,5246,2163,-10
30703534494,30703534494,0,2175,2121,-10
30703784431,30703784433,2,1010,1622,-10
30708554534,30708554539,5,1334,1108,-10
30709929027,30709929042,15,318,330,-10
30711442083,30711442085,2,1401,1689,-10
30712200791,30712200793,2,2268,1972,-10
30712755934,30712755929,-5,1062,3093,-10
30713893136,30713893140,4,2960,1547,-10
30716990545,30716990546,1,2401,1655,-10
30717405631,30717405634,3,1166,1174,-10
30718802610,30718802615,5,1294,1623,-10
30718832794,30718832795,1,1890,1860,-10
30720195793,30720195796,3,2288,1766,-10
30720520154,30720520155,1,1695,1800,-10
30722809009,30722809010,1,1421,1617,-10
30722900054,30722900056,2,994,1462,-10
30726192736,30726192741,5,2446,1263,-10
30727575644,30727575645,1,1757,1930,-10
30730057001,30730057004,3,1487,1620,-10
30730385269,30730385251,-18,969,1320,-10
30730610552,30730610545,-7,90,2924,-10
30730990019,30730990009,-10,1096,1658,-10
30732152512,30732152514,2,1461,1584,-10
30735574309,30735574308,-1,1353,1710,-10
30738848220,30738848220,0,1533,1548,-10
30744599410,30744599412,2,1277,1325,-10
30745515230,30745515233,3,1310,1367,-10
30749989341,30749989342,1,986,883,-10
30750387502,30750387502,0,1749,1569,-10
30751711969,30751711971,2,1218,810,-10
30754515074,30754515078,4,2105,1342,-10
30756244412,30756244414,2,1282,1082,-10
30760048980,30760048981,1,1613,1611,-10
30765661135,30765661137,2,1046,934,-10
30765967776,30765967777,1,1645,1559,-10
30767565323,30767565323,0,1356,996,-10
30767905381,30767905384,3,1265,1382,-10
30768302946,30768302933,-13,1556,1167,-10
30769216906,30769216925,19,590,2664,-10
30773197052,30773197055,3,1292,981,-10
30773514166,30773514171,5,746,627,-10
30775413602,30775413603,1,988,803,-10
30777058966,30777058967,1,837,1225,-10
30778207986,30778207985,-1,1583,1327,-10
30778890385,30778890389,4,1446,1333,-10
30778919336,30778919336,0,1810,1730,-10
30779470539,30779470547,8,1630,1030,-10
30782217242,30782217243,1,1527,1631,-10
30786764093,30786764093,0,1511,1530,-10
30787780149,30787780151,2,1612,1542,-10
30788083152,30788083153,1,1791,1607,-10
30788393932,30788393936,4,2002,1315,-10
30789705211,30789705211,0,1377,1132,-10
30794384003,30794384005,2,1445,1440,-10
30795424638,30795424639,1,1320,1449,-10
30795788299,30795788301,2,1801,1513,-10
30798212482,30798212482,0,1814,1383,-10
30801335642,30801335646,4,1958,1721,-10
30807381045,30807381046,1,1609,1241,-10
30810474171,30810474173,2,1886,1532,-10
30812114896,30812114896,0,1703,1868,-10
30814785397,30814785397,0,913,2441,-10
30819260471,30819260474,3,1634,1176,-10
30825982277,30825982281,4,2130,1558,-10
30826011222,30826011201,-21,1867,1302,-10
30826986648,30826986650,2,2091,1499,-10
30827652223,30827652226,3,1251,1638,-10
30829028735,30829028738,3,3321,3776,-10
30829480213,30829480218,5,1170,1023,-10
30829736078,30829736081,3,1562,1269,-10
30831352191,30831352191,0,884,882,-10
30834579310,30834579314,4,1226,1314,-10
30834862157,30834862159,2,1433,1504,-10
30839538127,30839538128,1,2055,2028,-10
30840400422,30840400425,3,1630,1849,-10
30841769938,30841769942,4,1469,1478,-10
30843497131,30843497133,2,1730,1676,-10
30843706533,30843706534,1,1263,1139,-10
30845829044,30845829042,-2,1504,1028,-10
30847597947,30847597950,3,1417,1095,-10
30850928687,30850928681,-6,1122,3393,-10
30851789942,30851789946,4,1338,1141,-10
30852436680,30852436682,2,1816,1556,-10
30853785513,30853785516,3,2545,2140,-10
30861756435,30861756437,2,1148,1401,-10
30863231191,30863231193,2,2045,1382,-10
30863987151,30863987151,0,1281,1516,-10
30866810863,30866810864,1,1378,1510,-10
30867249978,30867249981,3,1575,1704,-10
30869458822,30869458825,3,1826,1376,-10
30874574295,30874574297,2,1407,1492,-10
30876183358,30876183361,3,1532,1532,-10
30876834230,30876834244,14,2933,1144,-10
30884680700,30884680705,5,3722,1962,-10
30885309103,30885309102,-1,1361,1406,-10
30885795225,30885795227,2,1524,1855,-10
30886645963,30886645966,3,2015,1405,-10
30889125241,30889125244,3,1850,1408,-10
30889714412,30889714413,1,1537,1621,-10
30890051106,30890051127,21,485,422,-10
30890975244,30890975248,4,2099,1132,-10
30892497766,30892497765,-1,1425,1675,-10
30894736519,30894736521,2,1892,1726,-10
30896713006,30896713001,-5,1072,1596,-10
30907476775,30907476779,4,1629,1544,-10
30911412314,30911412320,6,1434,1376,-10
30917120937,30917120938,1,1874,1260,-10
30921741781,30921741786,5,2001,1349,-10
30924711598,30924711601,3,1712,1565,-10
30925125018,30925125018,0,1141,1524,-10
30927027386,30927027387,1,1812,1438,-10
30927923210,30927923215,5,3140,1299,-10
30933823250,30933823254,4,1082,1514,-10
30936004966,30936004967,1,1518,1354,-10
30936781250,30936781251,1,1254,1512,-10
30937423950,30937423950,0,1256,1775,-10
30938427530,30938427530,0,1508,1599,-10
30941078065,30941078066,1,1041,1945,-10
30942343655,30942343659,4,1695,1350,-10
30942467483,30942467485,2,1711,1173,-10
30943831722,30943831722,0,1670,2267,-10
30951221006,30951221010,4,2290,1832,-10
30954068173,30954068179,6,1727,1194,-10
30954977534,30954977533,-1,1317,1572,-10
30955881909,30955881914,5,1291,1949,-10
30956926766,30956926770,4,1308,1445,-10
30957744996,30957744997,1,1685,1652,-10
30960277649,30960277651,2,1352,1379,-10
30960790081,30960790083,2,1119,967,-10
30969411367,30969411368,1,1531,1718,-10
30973467533,30973467524,-9,116,4382,-10
30973862203,30973862210,7,1729,1840,-10
30974943185,30974943187,2,1781,1442,-10
30975738602,30975738604,2,1549,1643,-10
30977917301,30977917304,3,1591,1281,-10
30984020782,30984020787,5,1676,1167,-10
30985233765,30985233767,2,1284,958,-10
30985787862,30985787863,1,1325,1357,-10
30986705279,30986705283,4,1002,1099,-10
30995126132,30995126135,3,1622,1347,-10
30996769775,30996769778,3,1532,1434,-10
30997685158,30997685162,4,2091,1285,-10
30998894141,30998894145,4,1386,1117,-10
30999986343,30999986340,-3,1156,1790,-10
31001193026,31001193027,1,1186,1549,-10
31005400026,31005400031,5,1952,977,-10
31006346776,31006346777,1,1810,1882,-10
31011568916,31011568919,3,1173,1732,-10
31012865215,31012865217,2,1859,1446,-10
31013608998,31013609001,3,1510,1686,-10
31017968798,31017968802,4,1314,1255,-10
31018606614,31018606613,-1,1059,2042,-10
31019179639,31019179639,0,1163,1164,-10
31020529317,31020529318,1,1322,1532,-10
31022377426,31022377429,3,1727,1517,-10
31022866727,31022866730,3,1750,1416,-10
31026713679,31026713681,2,1940,2350,-10
31027988516,31027988518,2,1510,1409,-10
31031604533,31031604534,1,1773,1509,-10
31035699725,31035699727,2,1462,1209,-10
31042622997,31042623000,3,1649,1561,-10
31043129113,31043129114,1,1500,1595,-10
31043905718,31043905722,4,1534,1301,-10
31045652331,31045652331,0,1573,1354,-10
31046669244,31046669242,-2,1374,2362,-10
31052490617,31052490619,2,1423,1911,-10
31053722650,31053722651,1,1182,1700,-10
31063256908,31063256911,3,1905,1376,-10
31065659488,31065659490,2,1736,1391,-10
31066916639,31066916619,-20,20885,26896,-10
31070496413,31070496418,5,1805,1316,-10
31070525183,31070525187,4,1334,1321,-10
31071916401,31071916402,1,683,1070,-10
31075356817,31075356817,0,1279,1733,-10
31078825107,31078825110,3,1526,1445,-10
31079735622,31079735642,20,2010,1931,-10
31080477750,31080477747,-3,1343,1101,-10
31087826848,31087826849,1,1518,1975,-10
31088286465,31088286464,-1,1766,2218,-10
31088471745,31088471747,2,1458,1170,-10
31094759230,31094759231,1,2022,1298,-10
31100219334,31100219335,1,1227,844,-10
31101859222,31101859223,1,1617,1779,-10
31106130483,31106130486,3,1521,1544,-10
31106903786,31106903788,2,1845,1409,-10
31108969254,31108969255,1,1204,1350,-10
31109034475,31109034475,0,937,1147,-10
31115435684,31115435685,1,2792,2785,-10
31118678841,31118678845,4,1796,2092,-10
31119252748,31119252751,3,1785,1222,-10
31121591782,31121591784,2,1210,1702,-10
31121864214,31121864215,1,1698,1500,-10
31126383028,31126383031,3,1532,1654,-10
31126924466,31126924466,0,1728,1611,-10
31127744195,31127744194,-1,1000,1558,-10
31130449723,31130449726,3,1529,1783,-10
31130933127,31130933134,7,2028,1024,-10
31131771039,31131771042,3,1965,1300,-10
31133434776,31133434778,2,1733,1684,-10
31137895762,31137895766,4,1863,1735,-10
31141315563,31141315566,3,1588,1328,-10
31145914789,31145914795,6,1971,1594,-10
31146786447,31146786449,2,1386,1274,-10
31149732630,31149732633,3,1426,1562,-10
31151690619,31151690621,2,2034,1953,-10
31155392431,31155392434,3,1303,1892,-10
31155766135,31155766137,2,1568,1903,-10
31157813772,31157813773,1,909,1104,-10
31158116314,31158116315,1,1425,1263,-10
31160057199,31160057200,1,1678,2078,-10
31162024867,31162024871,4,1374,885,-10
31162472522,31162472539,17,1479,1403,-10
31165576181,31165576183,2,1415,953,-10
31169371322,31169371325,3,1418,1038,-10
31172400183,31172400183,0,1655,2136,-10
31174402950,31174402950,0,1025,1460,-10
31174737907,31174737909,2,1777,1786,-10
31175681638,31175681643,5,1851,1201,-10
31176028577,31176028582,5,1148,1044,-10
31176260197,31176260198,1,1755,1751,-10
31176348328,31176348329,1,1804,1464,-10
31180221322,31180221323,1,1018,1393,-10
31182841781,31182841786,5,1294,1589,-10
31183627137,31183627127,-10,185,674,-10
31184855467,31184855467,0,1643,2198,-10
31186815779,31186815781,2,1334,1025,-10
31188704263,31188704267,4,2412,1739,-10
31190001843,31190001844,1,1383,1349,-10
31191020625,31191020628,3,2243,2089,-10
31192508307,31192508308,1,2428,2178,-10
31193178421,31193178423,2,1050,870,-10
31193341150,31193341153,3,1882,1239,-10
31194716966,31194716970,4,2024,1167,-10
31197633522,31197633526,4,1756,1352,-10
31198071032,31198071029,-3,1594,1589,-10
31202228953,31202228954,1,1669,1675,-10
31206191431,31206191434,3,2122,1496,-10
31210581622,31210581624,2,1511,1363,-10
31211983455,31211983450,-5,1136,5539,-10
31212203897,31212203899,2,1994,1619,-10
31213636734,31213636738,4,1747,1256,-10
31217868379,31217868380,1,1096,1062,-10
31219400443,31219400446,3,1472,1029,-10
31220884282,31220884285,3,1463,1305,-10
31223282260,31223282260,0,2618,2164,-10
31229850828,31229850831,3,1795,1676,-10
31230498796,31230498799,3,1835,1242,-10
31230625973,31230625974,1,887,1082,-10
31236065931,31236065930,-1,1817,1489,-10
31236099854,31236099844,-10,498,395,-10
31237088413,31237088414,1,1375,1576,-10
31239113294,31239113296,2,1905,1519,-10
31239225177,31239225181,4,3178,2802,-10
31243314774,31243314777,3,1664,1727,-10
31245544831,31245544830,-1,650,1347,-10
31245624108,31245624110,2,1077,706,-10
31247749067,31247749070,3,2145,1765,-10
31249520002,31249519997,-5,954,1868,-10
31252692214,31252692209,-5,2463,8752,-10
31255068373,31255068375,2,1708,1418,-10
31256334129,31256334131,2,1499,2036,-10
31256804150,31256804151,1,1528,1731,-10
31260061034,31260061034,0,1290,1913,-10
31262798570,31262798571,1,1874,1394,-10
31265429223,31265429225,2,1532,1764,-10
31270334890,31270334893,3,1340,1710,-10
31270466393,31270466394,1,1810,1924,-10
31273651150,31273651154,4,1594,1723,-10
31275132573,31275132573,0,1480,1697,-10
31275656888,31275656890,2,1544,1674,-10
31277406048,31277406050,2,1511,1428,-10
31277573511,31277573513,2,1038,1040,-10
31281233954,31281233955,1,1804,1258,-10
31283049134,31283049138,4,1721,1981,-10
31284058517,31284058519,2,1412,2033,-10
31286062913,31286062917,4,1487,1722,-10
31288832170,31288832175,5,1691,1026,-10
31290924057,31290924059,2,1364,1599,-10
31293213727,31293213732,5,3092,1524,-10
31294197079,31294197080,1,942,1836,-10
31295010769,31295010769,0,1128,1475,-10
31298458681,31298458684,3,1344,1486,-10
31302249941,31302249941,0,1319,1507,-10
31306957069,31306957072,3,1896,1464,-10
31313532148,31313532150,2,1543,2068,-10
31314014583,31314014568,-15,473,395,-10
31320393806,31320393808,2,1862,1980,-10
31320674005,31320674004,-1,1004,1288,-10
31320812090,31320812085,-5,1304,2834,-10
31321102897,31321102898,1,1369,1120,-10
31328940283,31328940285,2,2334,1515,-10
31329109695,31329109698,3,1378,1034,-10
31329792708,31329792721,13,2169,8276,-10
31330703544,31330703546,2,1305,806,-10
31330795398,31330795400,2,2245,24503,-10
31331876058,31331876058,0,964,869,-10
31333042557,31333042558,1,1763,1202,-10
31341553674,31341553679,5,1637,1423,-10
31343149690,31343149694,4,1708,1652,-10
31344886302,31344886306,4,2224,1414,-10
31346345014,31346345015,1,1326,1007,-10
31352940572,31352940571,-1,1367,1467,-10
31354091625,31354091628,3,1455,1030,-10
31355464456,31355464459,3,1870,1598,-10
31355964751,31355964751,0,812,1013,-10
31357514814,31357514815,1,1140,1390,-10
31359065974,31359065975,1,1518,1459,-10
31359363539,31359363546,7,1349,1370,-10
31359431858,31359431859,1,1365,1241,-10
31360557223,31360557223,0,1303,1691,-10
31364581867,31364581870,3,1592,1444,-10
31364830345,31364830346,1,1266,1101,-10
31368035428,31368035433,5,1346,902,-10
31370397873,31370397874,1,1490,1249,-10
31371711602,31371711604,2,1478,1704,-10
31374183000,31374183007,7,71,1257,-10
31374627005,31374627010,5,1116,1963,-10
31377952691,31377952694,3,1743,1103,-10
31384437623,31384437623,0,1270,1353,-10
31386209837,31386209850,13,5605,41561,-10
31386500501,31386500502,1,1540,1945,-10
31387561619,31387561620,1,997,1236,-10
31393768094,31393768094,0,1212,1883,-10
31396790935,31396790926,-9,378,3,-10
31397378294,31397378298,4,1673,1432,-10
31401727490,31401727490,0,1868,1533,-10
31401928757,31401928777,20,1860,1363,-10
31405050607,31405050608,1,1814,1897,-10
31409447775,31409447775,0,1303,1255,-10
31414975694,31414975697,3,1823,1802,-10
31415683158,31415683161,3,1570,1496,-10
31415814179,31415814180,1,1783,1291,-10
31419651007,31419651010,3,1783,1179,-10
31423127874,31423127874,0,3134,4025,-10
31423914226,31423914227,1,1814,1450,-10
31424280640,31424280642,2,1560,1595,-10
31425900497,31425900498,1,1768,1787,-10
31426639339,31426639345,6,962,1240,-10
31430600313,31430600315,2,1245,1349,-10
31432868658,31432868662,4,1251,1075,-10
31433143327,31433143329,2,1254,985,-10
31433691851,31433691853,2,685,1055,-10
31433732290,31433732291,1,1835,1624,-10
31435662418,31435662421,3,2281,2065,-10
31438079842,31438079845,3,1295,1030,-10
31440115567,31440115566,-1,1892,1190,-10
31440642485,31440642487,2,1621,1663,-10
31441707386,31441707388,2,1695,1817,-10
31442127161,31442127162,1,1042,1411,-10
31443367271,31443367271,0,1608,1361,-10
31444572718,31444572723,5,1474,1602,-10
31449374822,31449374824,2,2305,1236,-10
31451420523,31451420526,3,1931,1429,-10
31453404735,31453404739,4,1684,1679,-10
31453528902,31453528903,1,1658,1597,-10
31459968748,31459968750,2,1432,1230,-10
31460722306,31460722306,0,1015,1430,-10
31463356382,31463356383,1,1087,1248,-10
31466092358,31466092360,2,891,770,-10
31466986574,31466986574,0,1364,1962,-10
31467070226,31467070225,-1,1300,1294,-10
31469022086,31469022085,-1,1153,1370,-10
31469658942,31469658922,-20,1409,1424,-10
31471018965,31471018966,1,1866,1350,-10
31471097378,31471097379,1,1523,1175,-10
31475610977,31475610980,3,1929,1546,-10
31476621837,31476621839,2,1600,1170,-10
31479023682,31479023682,0,1486,1381,-10
31484940871,31484940874,3,811,1476,-10
31486289271,31486289272,1,2414,2245,-10
31487610793,31487610794,1,1273,1538,-10
31488413650,31488413651,1,1215,1098,-10
31488777214,31488777215,1,1448,1011,-10
31494148426,31494148427,1,1864,1597,-10
31500895866,31500895869,3,1233,1189,-10
31501479934,31501479937,3,1443,1118,-10
31502450490,31502450496,6,2777,1205,-10
31506744899,31506744903,4,2496,1473,-10
31508081181,31508081182,1,1834,1652,-10
31515050215,31515050218,3,1902,1700,-10
31515657900,31515657899,-1,1517,2103,-10
31515776943,31515776946,3,1244,1293,-10
31516092905,31516092906,1,1284,1650,-10
31519367279,31519367283,4,3206,1793,-10
31520342766,31520342758,-8,781,835,-10
31522511367,31522511369,2,1024,1395,-10
31527547186,31527547186,0,1234,1928,-10
31531563506,31531563506,0,1633,1639,-10
31534833485,31534833485,0,3851,5108,-10
31539578293,31539578295,2,1701,1476,-10
31542943721,31542943723,2,1755,1321,-10
31547915389,31547915391,2,1410,1236,-10
31550085110,31550085110,0,1434,1245,-10
31555151262,31555151262,0,1703,1235,-10
31556351354,31556351359,5,1218,1523,-10
31558086079,31558086083,4,1195,1246,-10
31562895609,31562895610,1,1501,1285,-10
31568006403,31568006406,3,1775,1663,-10
31569459221,31569459222,1,1717,1356,-10
31572085941,31572085939,-2,1651,2109,-10
31578359390,31578359393,3,2155,1820,-10
31579002007,31579002010,3,1199,1131,-10
31581692553,31581692555,2,979,1448,-10
31583789527,31583789527,0,1759,1552,-10
31585323689,31585323690,1,1509,2483,-10
31587542438,31587542439,1,1661,1881,-10
31588012118,31588012121,3,1988,1816,-10
31589084022,31589084023,1,1644,2231,-10
31589515302,31589515305,3,1755,1697,-10
31595153482,31595153485,3,1269,1324,-10
31595684531,31595684535,4,1850,1488,-10
31598580413,31598580414,1,934,1306,-10
31599635494,31599635497,3,1945,2050,-10
31599870377,31599870378,1,1594,991,-10
31600340160,31600340162,2,1377,1817,-10
31601198894,31601198896,2,1724,1493,-10
31602934702,31602934703,1,1624,1225,-10
31603866495,31603866496,1,1467,1917,-10
31604264289,31604264291,2,1378,1441,-10
31604596354,31604596356,2,1818,1611,-10
31605681445,31605681447,2,1991,1506,-10
31606220439,31606220439,0,1910,1417,-10
31606833014,31606833017,3,805,736,-10
31612376874,31612376878,4,2659,1799,-10
31613051387,31613051389,2,1682,1292,-10
31614955830,31614955833,3,1798,1860,-10
31616429389,31616429395,6,1408,1161,-10
31616614154,31616614169,15,1753,1880,-10
31617911591,31617911589,-2,1094,1567,-10
31619172537,31619172540,3,1982,1475,-10
31623741004,31623741005,1,1018,1082,-10
31624935724,31624935713,-11,1236,1361,-10
31625579874,31625579874,0,1261,1125,-10
31630057002,31630057004,2,1579,1330,-10
31631682110,31631682114,4,1516,1427,-10
31631736506,31631736510,4,1356,1337,-10
31632634091,31632634095,4,2338,1622,-10
31639879691,31639879699,8,2654,967,-10
31642456508,31642456511,3,1703,1572,-10
31646844412,31646844411,-1,1168,851,-10
31650391729,31650391729,0,1747,1551,-10
31650625746,31650625752,6,881,893,-10
31655472070,31655472071,1,1427,947,-10
31656530792,31656530797,5,3402,2236,-10
31656693531,31656693533,2,1448,1616,-10
31657637806,31657637810,4,1410,1048,-10
31658352723,31658352727,4,1320,1012,-10
31658474279,31658474279,0,1155,1016,-10
31659426082,31659426086,4,1653,1588,-10
31659813525,31659813527,2,1524,1544,-10
31660941822,31660941824,2,1375,1392,-10
31662761800,31662761802,2,1763,1513,-10
31663948804,31663948804,0,1545,1712,-10
31664013909,31664013912,3,1468,1817,-10
31665189357,31665189352,-5,25612,11752,-10
31666763953,31666763954,1,1243,1921,-10
31669006456,31669006451,-5,1066,1459,-10
31669873673,31669873674,1,2403,1969,-10
31670043689,31670043689,0,1316,1233,-10
31670116643,31670116645,2,1505,1707,-10
31670195205,31670195205,0,2269,1854,-10
31670454379,31670454379,0,659,885,-10
31670665891,31670665890,-1,1187,2239,-10
31674217313,31674217314,1,1464,1161,-10
31675453605,31675453609,4,1632,1544,-10
31677410698,31677410701,3,1668,1697,-10
31677754817,31677754819,2,1235,1377,-10
31678767707,31678767709,2,1256,1167,-10
31682863939,31682863947,8,3314,1414,-10
31683227714,31683227714,0,1126,1933,-10
31688772018,31688772013,-5,1039,1132,-10
31689010090,31689010093,3,1093,1715,-10
31689994205,31689994206,1,1654,1192,-10
31692195585,31692195587,2,1129,2065,-10
31692321282,31692321282,0,1206,1457,-10
31693027953,31693027955,2,1745,1077,-10
31693240458,31693240453,-5,1159,3330,-10
31701338611,31701338613,2,2035,1571,-10
31702073053,31702073036,-17,1383,633,-10
31708395375,31708395375,0,1262,1208,-10
31713088807,31713088812,5,1817,1029,-10
31720900281,31720900282,1,1640,1426,-10
31721023619,31721023614,-5,1285,1837,-10
31722017314,31722017317,3,1637,1754,-10
31726468395,31726468397,2,1149,1352,-10
31735517137,31735517134,-3,1385,4126,-10
31736141063,31736141071,8,1342,1525,-10
31736964694,31736964695,1,1722,1529,-10
31737278605,31737278609,4,1535,1363,-10
31738052936,31738052939,3,1637,1344,-10
31740798431,31740798437,6,2561,1395,-10
31741683830,31741683831,1,1909,1395,-10
31743461580,31743461583,3,1469,2014,-10
31745841235,31745841236,1,1120,1206,-10
31747278639,31747278642,3,1382,1413,-10
31758071070,31758071074,4,9093,18150,-10
31760319725,31760319725,0,1617,1470,-10
31764168478,31764168481,3,1578,1484,-10
31764897687,31764897689,2,1293,1870,-10
31769558881,31769558883,2,1019,1558,-10
31771760019,31771760021,2,1579,1552,-10
31771885699,31771885699,0,1271,1179,-10
31773120892,31773120893,1,1477,1232,-10
31777667658,31777667661,3,2169,1514,-10
31778755145,31778755143,-2,1382,1341,-10
31781738409,31781738411,2,1265,1499,-10
31783603867,31783603869,2,1463,1328,-10
31786725909,31786725911,2,1528,1664,-10
31789421295,31789421297,2,1353,1372,-10
31791563286,31791563289,3,1618,1561,-10
31794426159,31794426140,-19,1201,930,-10
31796047547,31796047548,1,1682,1880,-10
31800800621,31800800623,2,2066,1968,-10
31802079546,31802079550,4,2174,993,-10
31805183412,31805183414,2,958,1052,-10
31806174723,31806174722,-1,992,1505,-10
31807802305,31807802308,3,1566,1355,-10
31808097085,31808097089,4,1687,1711,-10
31810827048,31810827049,1,745,994,-10
31811456283,31811456283,0,1446,1703,-10
31813522107,31813522112,5,1003,1102,-10
31816723909,31816723909,0,1745,2490,-10
31816858819,31816858820,1,1823,1898,-10
31816930428,31816930411,-17,2204,1549,-10
31817083781,31817083783,2,1417,1636,-10
31818398415,31818398418,3,1816,1267,-10
31819689150,31819689163,13,1135,1684,-10
31820974449,31820974453,4,2080,1881,-10
31832325067,31832325070,3,952,968,-10
31833709517,31833709519,2,1425,1175,-10
31837063283,31837063285,2,573,722,-10
31838381038,31838381039,1,1609,1364,-10
31842184419,31842184425,6,1011,1312,-10
31844084358,31844084361,3,1518,1488,-10
31845025205,31845025197,-8,19508,20695,-10
31847756198,31847756202,4,2351,1631,-10
31850506679,31850506683,4,2062,1178,-10
31851213454,31851213455,1,1133,1515,-10
31851630499,31851630499,0,1281,1761,-10
31854824551,31854824556,5,2004,999,-10
31860412209,31860412210,1,1196,1496,-10
31862382785,31862382786,1,1546,2257,-10
31866873873,31866873874,1,1476,1596,-10
31877621623,31877621617,-6,744,1723,-10
31880837042,31880837042,0,1156,2187,-10
31881073949,31881073953,4,1801,1534,-10
31885082279,31885082282,3,1375,1690,-10
31886778506,31886778506,0,1793,1717,-10
31887476210,31887476209,-1,1107,1304,-10
31889993965,31889993966,1,1074,1653,-10
31891526815,31891526814,-1,1048,989,-10
31894753919,31894753921,2,1060,1129,-10
31897381767,31897381767,0,1301,1261,-10
31899026897,31899026898,1,1459,1765,-10
31902916407,31902916409,2,1357,1416,-10
31904485864,31904485865,1,1919,1668,-10
31906088914,31906088916,2,2021,1850,-10
31910018199,31910018200,1,1496,1326,-10
31910795203,31910795205,2,1672,1469,-10
31912535357,31912535357,0,1360,1841,-10
31915732806,31915732811,5,2088,1679,-10
31923647049,31923647050,1,780,928,-10
31927141296,31927141299,3,1026,1215,-10
31929767497,31929767499,2,2034,1954,-10
31929871409,31929871409,0,1361,1062,-10
31930989190,31930989192,2,2050,1485,-10
31931316917,31931316917,0,1657,1986,-10
31931855302,31931855303,1,962,1430,-10
31933541449,31933541452,3,1474,1386,-10
31934532736,31934532738,2,1965,1605,-10
31936475282,31936475282,0,1770,1570,-10
31938852824,31938852826,2,1704,1568,-10
31942864644,31942864646,2,1421,1161,-10
31943827570,31943827573,3,1809,1663,-10
31947223645,31947223646,1,1419,1361,-10
31950121834,31950121837,3,1663,1305,-10
31950765570,31950765573,3,1727,2030,-10
31953730497,31953730500,3,1751,877,-10
31955562767,31955562770,3,1800,1984,-10
31956294651,31956294653,2,1319,1525,-10
31958154566,31958154571,5,2932,1688,-10
31960850669,31960850670,1,1835,1978,-10
31962794998,31962795000,2,2031,1471,-10
31964432026,31964432026,0,1537,1460,-10
31969351773,31969351774,1,1184,1666,-10
31973487734,31973487735,1,1210,1430,-10
31973691295,31973691298,3,1458,932,-10
31975066270,31975066270,0,12372,16807,-10
31979611965,31979611966,1,32961,29296,-10
31982962076,31982962083,7,2408,1420,-10
31983707042,31983707042,0,939,1315,-10
31983927579,31983927586,7,1769,1741,-10
31987243674,31987243679,5,2309,1182,-10
31988555390,31988555389,-1,928,1294,-10
31989656887,31989656890,3,951,1287,-10
31991199610,31991199611,1,1409,1300,-10
31993404765,31993404767,2,1802,875,-10
31994667580,31994667581,1,1543,1832,-10
31997945814,31997945818,4,2124,1466,-10
32004691303,32004691305,2,1220,1406,-10
32008263717,32008263719,2,1763,1678,-10
32008544955,32008544957,2,874,1281,-10
32009528171,32009528165,-6,947,1805,-10
32011559946,32011559946,0,1453,1452,-10
32012050934,32012050937,3,1360,1739,-10
32012947043,32012947045,2,1227,1295,-10
32013690281,32013690282,1,1372,1935,-10
32022424054,32022424059,5,2533,1420,-10
32023873202,32023873206,4,2057,1561,-10
32024883218,32024883220,2,1522,1657,-10
32026910153,32026910155,2,902,1092,-10
32029467245,32029467246,1,1268,909,-10
32030017866,32030017872,6,2155,839,-10
32031620623,32031620623,0,920,1437,-10
32034417406,32034417407,1,1381,973,-10
32035979159,32035979160,1,1520,1489,-10
32037316274,32037316277,3,1525,1900,-10
32040515257,32040515259,2,1428,1030,-10
32041827859,32041827862,3,1839,1435,-10
32042914767,32042914772,5,1057,1157,-10
32046044791,32046044792,1,2080,1677,-10
32046620736,32046620738,2,1687,1327,-10
32047540480,32047540483,3,1096,1404,-10
32048724729,32048724730,1,1624,1793,-10
32050531558,32050531554,-4,1234,3713,-10
32050612826,32050612831,5,1403,1409,-10
32051289049,32051289049,0,956,1146,-10
32052439989,32052439990,1,2054,1932,-10
32053964543,32053964547,4,1252,1645,-10
32054051753,32054051757,4,1668,1217,-10
32059650121,32059650125,4,1148,1459,-10
32060655228,32060655230,2,2253,1658,-10
32062758109,32062758107,-2,1230,1989,-10
32064222570,32064222574,4,1385,1048,-10
32067571055,32067571061,6,1851,1286,-10
32073123969,32073123971,2,1725,990,-10
32075424308,32075424310,2,1286,1262,-10
32075545257,32075545259,2,1716,1555,-10
32077657411,32077657414,3,1985,1222,-10
32077920669,32077920670,1,2176,1968,-10
32078588575,32078588576,1,1170,2285,-10
32079434821,32079434822,1,1294,1353,-10
32081851626,32081851629,3,1563,1431,-10
32084733750,32084733750,0,1958,1362,-10
32085115128,32085115126,-2,2220,1560,-10
32086007249,32086007251,2,1047,1071,-10
32091627698,32091627701,3,1662,1389,-10
32092329515,32092329517,2,1915,2120,-10
32095933271,32095933270,-1,1304,1430,-10
32096392813,32096392817,4,1690,1131,-10
32096803780,32096803782,2,1574,1637,-10
32097039041,32097039041,0,1670,1818,-10
32098845357,32098845359,2,1689,1825,-10
32101011771,32101011775,4,1433,1508,-10
32101918337,32101918339,2,1422,1269,-10
32102683623,32102683626,3,1851,1753,-10
32104487041,32104487043,2,1729,1139,-10
32104985046,32104985046,0,1445,846,-10
32111841414,32111841416,2,2166,1563,-10
32114838080,32114838083,3,822,1144,-10
32116325766,32116325745,-21,2220,1676,-10
32118878489,32118878492,3,1507,1554,-10
32120082332,32120082332,0,1218,1256,-10
32122909061,32122909062,1,1445,1304,-10
32123431679,32123431681,2,1160,1289,-10
32123468728,32123468730,2,1751,1673,-10
32124945319,32124945321,2,1206,1345,-10
32126373315,32126373315,0,1275,1362,-10
32130359490,32130359493,3,1288,1600,-10
32134698159,32134698160,1,1831,1225,-10
32134939259,32134939244,-15,1214,1078,-10
32138636062,32138636063,1,2303,2276,-10
32140684645,32140684646,1,1835,1730,-10
32141160945,32141160947,2,1187,1443,-10
32142059602,32142059608,6,1735,1554,-10
32142958772,32142958774,2,1059,1538,-10
32146776386,32146776387,1,2461,1702,-10
32148380391,32148380395,4,2321,1716,-10
32150029917,32150029918,1,2133,2657,-10
32150185910,32150185917,7,12941,4584,-10
32150380585,32150380588,3,2016,1578,-10
32151104947,32151104946,-1,1092,2180,-10
32153522497,32153522497,0,1758,1875,-10
32162708461,32162708463,2,2130,2160,-10
32163286703,32163286706,3,1116,1791,-10
32165008475,32165008465,-10,915,5569,-10
32166166031,32166166035,4,2120,1571,-10
32166692303,32166692306,3,1341,1241,-10
32167517491,32167517501,10,3015,595,-10
32171413697,32171413698,1,1836,1268,-10
32171490531,32171490533,2,1313,2111,-10
32175416303,32175416306,3,1447,881,-10
32175501049,32175501050,1,1729,2222,-10
32175774742,32175774745,3,1678,1396,-10
32176284127,32176284129,2,1389,1781,-10
32178298285,32178298288,3,1549,2140,-10
32178569443,32178569444,1,1509,1626,-10
32183654435,32183654437,2,1850,1580,-10
32188011657,32188011659,2,1384,1488,-10
32188043123,32188043125,2,1556,2016,-10
32189550828,32189550831,3,1293,1297,-10
32194685232,32194685234,2,1471,1665,-10
32196195217,32196195221,4,766,1085,-10
32200132175,32200132152,-23,76,3368,-10
32201220398,32201220402,4,1017,1302,-10
32201777585,32201777578,-7,1276,1355,-10
32202419585,32202419587,2,1725,1903,-10
32204235046,32204235047,1,1166,1192,-10
32204956034,32204956037,3,2217,1391,-10
32206217628,32206217630,2,1600,1619,-10
32208154338,32208154342,4,2300,1676,-10
32208285746,32208285748,2,1315,1632,-10
32209710394,32209710387,-7,1561,1640,-10
32209898201,32209898203,2,1672,1838,-10
32211968271,32211968274,3,1140,1118,-10
32214393081,32214393084,3,1441,1562,-10
32216164930,32216164935,5,1812,1540,-10
32217238869,32217238873,4,1531,1643,-10
32217534915,32217534915,0,982,1024,-10
32219408994,32219408996,2,1714,1601,-10
32220571262,32220571242,-20,1089,962,-10
32220669205,32220669209,4,1597,2392,-10
32220716853,32220716854,1,1235,947,-10
32222971077,32222971079,2,1409,1359,-10
32223230061,32223230062,1,1785,1955,-10
32224454169,32224454171,2,1748,1429,-10
32224508435,32224508437,2,1901,1892,-10
32225183277,32225183280,3,1523,1426,-10
32225295545,32225295544,-1,1826,1381,-10
32230057674,32230057676,2,1570,1427,-10
32231978281,32231978282,1,888,1289,-10
32234001502,32234001503,1,1102,973,-10
32235261763,32235261764,1,1835,2444,-10
32238861913,32238861912,-1,4279,10105,-10
32239703967,32239703971,4,2382,1071,-10
32242342741,32242342740,-1,1312,1570,-10
32243384539,32243384543,4,1353,1995,-10
32244663638,32244663637,-1,1695,1688,-10
32245335370,32245335371,1,1612,1644,-10
32245751078,32245751082,4,1699,1756,-10
32247264003,32247264006,3,1032,712,-10
32249581026,32249581026,0,1234,2489,-10
32253319468,32253319470,2,1398,1256,-10
32254921878,32254921857,-21,1788,801,-10
32255560268,32255560267,-1,1017,1340,-10
32258368960,32258368962,2,1496,1805,-10
32258638640,32258638635,-5,1080,2766,-10
32259513708,32259513711,3,1735,1230,-10
32262640355,32262640349,-6,1622,1825,-10
32263106154,32263106155,1,1943,1217,-10
32268788243,32268788245,2,1611,1444,-10
32274052443,32274052444,1,1866,1386,-10
32274543710,32274543713,3,1299,1425,-10
32279101671,32279101671,0,1781,1998,-10
32280068787,32280068789,2,1568,1447,-10
32280584413,32280584416,3,1426,1424,-10
32283192690,32283192692,2,2311,1470,-10
32283550129,32283550139,10,7411,34077,-10
32283638491,32283638490,-1,1658,1370,-10
32284083589,32284083590,1,1734,1119,-10
32285765666,32285765668,2,1672,2231,-10
32287989069,32287989074,5,1995,1747,-10
32289097781,32289097786,5,2264,998,-10
32292927681,32292927681,0,1108,1391,-10
32293398474,32293398474,0,1804,1908,-10
32293455579,32293455583,4,1632,1527,-10
32300334574,32300334574,0,1466,1262,-10
32301037053,32301037056,3,1799,1783,-10
32302615710,32302615711,1,1564,1966,-10
32302982286,32302982288,2,1524,1683,-10
32303544210,32303544210,0,918,1977,-10
32306289002,32306288997,-5,907,2168,-10
32308761749,32308761749,0,1497,860,-10
32308813559,32308813560,1,1815,1745,-10
32309841774,32309841769,-5,1199,3050,-10
32310444477,32310444478,1,1493,1444,-10
32313210879,32313210879,0,1969,2402,-10
32316108944,32316108946,2,1736,1525,-10
32320509968,32320509970,2,1576,1634,-10
32322905346,32322905349,3,2407,1948,-10
32323112393,32323112394,1,1799,1669,-10
32323999227,32323999229,2,1034,857,-10
32327198806,32327198806,0,483,1497,-10
32329505950,32329505951,1,2284,1566,-10
32331276557,32331276562,5,3475,1825,-10
32331871655,32331871655,0,1035,1372,-10
32338067878,32338067876,-2,1309,1615,-10
32345220163,32345220165,2,2052,2406,-10
32347101649,32347101653,4,1834,1428,-10
32347522812,32347522814,2,2252,1802,-10
32348039902,32348039905,3,1255,1193,-10
32348762628,32348762630,2,977,1245,-10
32350945992,32350945994,2,1653,1592,-10
32353387913,32353387914,1,2254,1860,-10
32354791153,32354791154,1,1331,1004,-10
32359515230,32359515231,1,1275,1172,-10
32360287287,32360287290,3,1515,1317,-10
32360868147,32360868149,2,1537,1860,-10
32361361389,32361361390,1,1707,1789,-10
32361976373,32361976371,-2,2045,3448,-10
32363245969,32363245969,0,1460,1175,-10
32364470340,32364470343,3,1754,1439,-10
32364770447,32364770450,3,1947,1826,-10
32365864100,32365864102,2,1746,1670,-10
32366795120,32366795125,5,2130,1467,-10
32369408009,32369408012,3,1612,1695,-10
32370113816,32370113818,2,875,1241,-10
32371427862,32371427865,3,1185,1278,-10
32372428430,32372428429,-1,1646,1718,-10
32374594814,32374594817,3,1389,1285,-10
32374668106,32374668109,3,1607,1453,-10
32376080180,32376080181,1,1905,1372,-10
32379336482,32379336485,3,1951,1493,-10
32380503091,32380503094,3,1144,1708,-10
32384687971,32384687974,3,1412,1653,-10
32385167554,32385167557,3,1821,1856,-10
32386055746,32386055748,2,1707,1154,-10
32386440075,32386440060,-15,864,776,-10
32387794198,32387794197,-1,1619,2094,-10
32390663942,32390663945,3,1532,1329,-10
32394421163,32394421165,2,837,755,-10
32395365408,32395365400,-8,11153,15583,-10
32395704959,32395704962,3,1410,1391,-10
32396715359,32396715361,2,1909,1318,-10
32399612919,32399612924,5,1496,1072,-10
32406175486,32406175490,4,1400,1337,-10
32407717506,32407717505,-1,1500,1497,-10
32408507737,32408507740,3,1421,1664,-10
32409820716,32409820715,-1,1094,1467,-10
32411450838,32411450840,2,1367,1732,-10
32415185575,32415185580,5,12138,17461,-10
32415239401,32415239403,2,1369,979,-10
32416695322,32416695324,2,1688,1561,-10
32418200594,32418200593,-1,961,1194,-10
32420780397,32420780398,1,1343,1261,-10
32422904966,32422904965,-1,37879,27181,-10
32423183628,32423183646,18,1086,1201,-10
32429052869,32429052871,2,1304,1554,-10
32433930774,32433930777,3,949,1182,-10
32434729731,32434729732,1,1558,1649,-10
32435647305,32435647305,0,2043,3648,-10
32438685030,32438685030,0,1648,1084,-10
32438789293,32438789306,13,2276,1420,-10
32441176328,32441176331,3,1681,1537,-10
32441938422,32441938424,2,2300,1725,-10
32442882850,32442882853,3,1032,1561,-10
32443334906,32443334907,1,1617,1370,-10
32443717823,32443717822,-1,1858,1894,-10
32444399374,32444399374,0,1532,1506,-10
32445665174,32445665174,0,1034,1444,-10
32446097290,32446097294,4,1407,1404,-10
32446364706,32446364721,15,1368,1213,-10
32448418405,32448418408,3,1633,1217,-10
32450914585,32450914589,4,1279,1262,-10
32451393911,32451393914,3,1167,1737,-10
32451526870,32451526873,3,1252,1380,-10
32452783164,32452783167,3,1285,1155,-10
32453846059,32453846058,-1,1520,2462,-10
32453872458,32453872464,6,2382,1262,-10
32455979222,32455979223,1,1830,1914,-10
32456294246,32456294254,8,1462,778,-10
32456521608,32456521612,4,1208,930,-10
32458270486,32458270486,0,1518,1531,-10
32464394777,32464394779,2,1478,1660,-10
32470632503,32470632497,-6,1070,4052,-10
32471574226,32471574230,4,1239,1038,-10
32473097710,32473097714,4,1523,1409,-10
32473360613,32473360612,-1,1067,1422,-10
32474540569,32474540571,2,1150,1042,-10
32475502862,32475502863,1,1534,1452,-10
32475609347,32475609345,-2,1245,1875,-10
32478138924,32478138924,0,1503,3111,-10
32479358605,32479358609,4,2483,2319,-10
32481181094,32481181076,-18,1280,1842,-10
32482378586,32482378585,-1,1186,2335,-10
32482435395,32482435397,2,1886,2187,-10
32482879531,32482879539,8,2894,1055,-10
32483144906,32483144909,3,2010,1613,-10
32485894039,32485894041,2,1412,1112,-10
32486664274,32486664275,1,1625,1679,-10
32489734526,32489734525,-1,1154,1359,-10
32490773358,32490773363,5,1740,1288,-10
32493136233,32493136234,1,2221,1508,-10
32493449306,32493449316,10,1552,1529,-10
32494043169,32494043170,1,2056,1834,-10
32497996573,32497996574,1,1767,2033,-10
32500750366,32500750368,2,2024,1696,-10
32506405090,32506405092,2,8075,17088,-10
32511629375,32511629377,2,2049,1458,-10
32513538029,32513538030,1,2527,2115,-10
32514879425,32514879426,1,1147,1405,-10
32517624038,32517624038,0,1267,1423,-10
32520445990,32520445991,1,987,998,-10
32522693690,32522693709,19,962,1347,-10
32523310254,32523310255,1,1577,1224,-10
32526410870,32526410870,0,1686,1052,-10
32526568125,32526568136,11,1078,296,-10
32526691340,32526691342,2,1690,1776,-10
32528296925,32528296926,1,1872,2311,-10
32528525545,32528525546,1,858,847,-10
32533656186,32533656189,3,1259,2128,-10
32533907540,32533907543,3,1495,1240,-10
32539189846,32539189849,3,1577,1440,-10
32539535844,32539535856,12,1307,1600,-10
32542465294,32542465300,6,2051,1799,-10
32545846424,32545846426,2,856,742,-10
32546529513,32546529513,0,1666,2166,-10
32549495515,32549495515,0,1572,1618,-10
32550869578,32550869579,1,1257,1176,-10
32550961346,32550961347,1,1374,1435,-10
32558840796,32558840798,2,1866,1487,-10
32567218658,32567218669,11,18729,26490,-10
32567899554,32567899559,5,1652,869,-10
32575148083,32575148086,3,1751,1349,-10
32578276526,32578276526,0,1545,1309,-10
32579614038,32579614041,3,1583,1498,-10
32580954149,32580954150,1,1149,1594,-10
32584432030,32584432032,2,2560,2046,-10
32586978077,32586978081,4,1244,1148,-10
32588606399,32588606402,3,1237,1133,-10
32590826846,32590826852,6,4202,1345,-10
32591075865,32591075866,1,1586,1424,-10
32591446318,32591446319,1,1753,1327,-10
32592435945,32592435946,1,1388,1742,-10
32592837434,32592837419,-15,1079,568,-10
32594624458,32594624458,0,1067,1729,-10
32596964366,32596964366,0,1539,1333,-10
32599346548,32599346547,-1,1617,1915,-10
32599505197,32599505202,5,2563,1128,-10
32599995213,32599995235,22,601,1074,-10
32602018834,32602018835,1,1610,1189,-10
32604146524,32604146526,2,1195,1616,-10
32604882140,32604882141,1,1905,1336,-10
32605638665,32605638667,2,1576,1258,-10
32606362850,32606362850,0,2274,2040,-10
32608382995,32608382994,-1,898,1651,-10
32612526859,32612526862,3,1449,1747,-10
32614646404,32614646406,2,1958,1976,-10
32618378035,32618378038,3,1743,1267,-10
32620978953,32620978954,1,1880,1187,-10
32626390388,32626390389,1,1514,1749,-10
32628060386,32628060386,0,2550,3378,-10
32632034010,32632034014,4,1628,1986,-10
32633472554,32633472554,0,1613,1625,-10
32636171057,32636171059,2,2011,1620,-10
32636429531,32636429531,0,1631,1620,-10
32638583082,32638583083,1,1612,1544,-10
32639042999,32639043001,2,1603,2071,-10
32641059845,32641059848,3,2288,1827,-10
32642257961,32642257964,3,2238,1484,-10
32646047431,32646047431,0,1357,1113,-10
32647480341,32647480342,1,1444,1904,-10
32652015236,32652015237,1,1010,1151,-10
32652853494,32652853497,3,1856,1335,-10
32653638498,32653638499,1,1477,1795,-10
32656983338,32656983340,2,1354,1364,-10
32657945310,32657945297,-13,284,2095,-10
32657991965,32657991967,2,2012,1456,-10
32660944309,32660944311,2,1828,1043,-10
32662882733,32662882734,1,1762,1423,-10
32668801959,32668801962,3,1753,1394,-10
32671979835,32671979838,3,1761,1153,-10
32674209467,32674209469,2,1614,1481,-10
32674936239,32674936241,2,1516,1611,-10
32675185240,32675185242,2,1832,1450,-10
32675362086,32675362087,1,1796,1685,-10
32677483909,32677483910,1,1575,1807,-10
32677793690,32677793693,3,1647,1110,-10
32678944642,32678944643,1,1444,1151,-10
32682967470,32682967474,4,850,1343,-10
32686745630,32686745630,0,1107,1570,-10
32688068290,32688068271,-19,1191,1556,-10
32689201915,32689201918,3,1838,1211,-10
32689421802,32689421803,1,1265,1200,-10
32692004069,32692004070,1,1624,1285,-10
32692419031,32692419038,7,2469,1072,-10
32694357869,32694357869,0,1800,1585,-10
32694752385,32694752376,-9,9997,15287,-10
32694889426,32694889431,5,1190,1099,-10
32696228528,32696228531,3,1392,1646,-10
32698296832,32698296834,2,1111,1544,-10
32701787801,32701787802,1,2067,2303,-10
32702247249,32702247250,1,1492,1988,-10
32702386574,32702386579,5,2417,2133,-10
32703067121,32703067122,1,1187,1701,-10
32704470481,32704470482,1,1852,1825,-10
32706773414,32706773393,-21,1395,829,-10
32707514936,32707514938,2,889,1713,-10
32709225073,32709225073,0,38159,17827,-10
32709465097,32709465100,3,2287,2010,-10
32709993534,32709993533,-1,1062,1892,-10
32716778993,32716778997,4,1640,1580,-10
32718506659,32718506658,-1,2382,3836,-10
32720276497,32720276499,2,1031,1144,-10
32723743190,32723743193,3,1387,1365,-10
32726329201,32726329202,1,1616,1281,-10
32729734325,32729734328,3,1125,1256,-10
32733037437,32733037435,-2,1632,1519,-10
32735013533,32735013537,4,1837,1325,-10
32735462954,32735462956,2,1433,1654,-10
32737590375,32737590377,2,2552,1397,-10
32737935230,32737935232,2,1071,1300,-10
32742581238,32742581238,0,1320,1020,-10
32743837247,32743837247,0,1793,1749,-10
32745324010,32745324007,-3,1013,2154,-10
32746510863,32746510865,2,1450,1466,-10
32748116503,32748116505,2,1178,1175,-10
32749601552,32749601553,1,1255,1689,-10
32749733337,32749733334,-3,589,1337,-10
32752563425,32752563425,0,1011,1218,-10
32756355966,32756355969,3,921,1161,-10
32756630652,32756630653,1,1666,1478,-10
32761547541,32761547544,3,1062,926,-10
32761846285,32761846287,2,1756,1602,-10
32762092418,32762092419,1,1285,1491,-10
32768638975,32768638978,3,2442,1236,-10
32768891371,32768891373,2,1213,1240,-10
32771248019,32771248021,2,1536,1475,-10
32772650790,32772650782,-8,783,5375,-10
32773791456,32773791457,1,2094,2149,-10
32774446143,32774446139,-4,912,2936,-10
32775994661,32775994663,2,1813,1817,-10
32782524397,32782524398,1,1506,1397,-10
32784281337,32784281339,2,1186,1089,-10
32784417401,32784417403,2,1377,1312,-10
32785910078,32785910082,4,1458,1552,-10
32786802848,32786802850,2,1372,1351,-10
32787306823,32787306800,-23,2150,1907,-10
32788427371,32788427370,-1,1203,2037,-10
32799981843,32799981846,3,1543,1490,-10
32800118502,32800118502,0,1459,1343,-10
32803207037,32803207039,2,2003,1801,-10
32805573112,32805573115,3,1393,1259,-10
32807167597,32807167603,6,2456,1118,-10
32808478027,32808478030,3,1054,1569,-10
32813164834,32813164838,4,1836,1446,-10
32813462669,32813462670,1,1325,1847,-10
32817491517,32817491521,4,1595,1506,-10
32819972557,32819972558,1,1869,1561,-10
32824121994,32824121999,5,1409,1367,-10
32827868402,32827868403,1,1666,1977,-10
32833744241,32833744240,-1,1659,2922,-10
32835185976,32835185978,2,1415,1169,-10
32837419438,32837419442,4,1823,1679,-10
32849432666,32849432669,3,1499,1722,-10
32851609794,32851609798,4,1159,1173,-10
32851931585,32851931585,0,1295,1547,-10
32857287774,32857287770,-4,1330,2843,-10
32859217398,32859217397,-1,1004,2500,-10
32859870934,32859870935,1,1850,1856,-10
32860746072,32860746091,19,1853,1089,-10
32861289601,32861289603,2,2962,2614,-10
32861317626,32861317626,0,2462,2398,-10
32861787014,32861787018,4,910,1212,-10
32862553200,32862553204,4,1254,1073,-10
32866149685,32866149686,1,1939,1762,-10
32866669475,32866669477,2,1629,1573,-10
32866916731,32866916730,-1,1233,1466,-10
32868988232,32868988233,1,1944,1480,-10
32873807080,32873807081,1,1718,1819,-10
32876774180,32876774183,3,2347,1867,-10
32883457586,32883457587,1,3142,3638,-10
32891182090,32891182094,4,1895,1767,-10
32892252071,32892252070,-1,1687,1519,-10
32895653247,32895653226,-21,1933,1773,-10
32897920839,32897920838,-1,666,1117,-10
32902140266,32902140267,1,1110,1588,-10
32905678912,32905678915,3,1525,1147,-10
32908273346,32908273347,1,1491,1783,-10
32910864045,32910864049,4,1946,1557,-10
32912572659,32912572660,1,2179,1894,-10
32919474762,32919474762,0,1998,1831,-10
32921468167,32921468169,2,1650,1451,-10
32923471720,32923471722,2,1257,1400,-10
32928093304,32928093306,2,1325,1714,-10
32933094976,32933094963,-13,960,1514,-10
32933724776,32933724779,3,1726,1176,-10
32935715425,32935715429,4,1109,1370,-10
32938091430,32938091431,1,1447,1246,-10
32939171430,32939171431,1,2185,1592,-10
32939559305,32939559308,3,1209,1163,-10
32941868226,32941868227,1,1410,1484,-10
32945879590,32945879590,0,2738,5215,-10
32947983541,32947983545,4,1154,1127,-10
32952185810,32952185811,1,1507,1564,-10
32952517498,32952517499,1,1749,1534,-10
32953008629,32953008629,0,1447,1600,-10
32959679030,32959679035,5,993,772,-10
32960458375,32960458376,1,1464,1450,-10
32966750775,32966750777,2,1553,2045,-10
32967910586,32967910585,-1,557,910,-10
32968538110,32968538110,0,1345,1492,-10
32972477560,32972477565,5,1548,1321,-10
32974008985,32974008989,4,2101,1364,-10
32974953959,32974953961,2,1704,1794,-10
32975806541,32975806547,6,6427,2768,-10
32977420780,32977420782,2,1216,1428,-10
32978944551,32978944553,2,1750,1999,-10
32983002964,32983002966,2,2365,1370,-10
32986096669,32986096673,4,3663,3381,-10
32986827955,32986827947,-8,1072,1886,-10
32987186765,32987186767,2,1618,1529,-10
32988689239,32988689243,4,1786,1940,-10
32989002282,32989002285,3,1889,1633,-10
32992238878,32992238880,2,1389,1723,-10
32993228378,32993228379,1,1418,1168,-10
32995627897,32995627896,-1,1180,1626,-10
32997650790,32997650787,-3,1759,3542,-10
32999097061,32999097062,1,1533,1487,-10
33000291579,33000291582,3,539,698,-10
33003888463,33003888469,6,6125,2055,-10
33004085793,33004085794,1,1511,1080,-10
33004488181,33004488173,-8,23308,49548,-10
33005770961,33005770964,3,1910,1687,-10
33006729900,33006729903,3,1899,1492,-10
33007446630,33007446632,2,2184,1669,-10
33010758254,33010758254,0,1132,1281,-10
33013469014,33013469017,3,1475,1358,-10
33016306545,33016306547,2,1075,1695,-10
33022709710,33022709715,5,1229,878,-10
33026506586,33026506588,2,1756,1688,-10
33032972914,33032972915,1,1615,1382,-10
33033295074,33033295075,1,1668,1752,-10
33034322824,33034322827,3,1725,1299,-10
33034454610,33034454610,0,1381,1325,-10
33034561512,33034561528,16,874,408,-10
33035469194,33035469196,2,1452,1712,-10
33037980458,33037980461,3,1663,1259,-10
33039512846,33039512847,1,1630,1521,-10
33040942425,33040942425,0,1756,1519,-10
33041018043,33041018042,-1,1628,1262,-10
33043057243,33043057247,4,1176,1344,-10
33043980889,33043980887,-2,1003,2049,-10
33049080666,33049080670,4,953,1405,-10
33049116863,33049116863,0,924,1186,-10
33050262209,33050262210,1,1246,1078,-10
33050769865,33050769866,1,1733,1580,-10
33055834086,33055834087,1,1174,1278,-10
33056320694,33056320696,2,1403,2070,-10
33058144708,33058144712,4,1350,1025,-10
33060176698,33060176700,2,1756,1652,-10
33061778071,33061778074,3,1512,1881,-10
33063059793,33063059795,2,1171,1481,-10
33064036521,33064036522,1,1586,1331,-10
33065035481,33065035486,5,723,980,-10
33065268563,33065268546,-17,1009,1540,-10
33066266966,33066266950,-16,3016,1581,-10
33068833519,33068833522,3,2054,1411,-10
33071897199,33071897213,14,7133,53349,-10
33074580838,33074580840,2,1978,2300,-10
33074898018,33074898017,-1,907,1109,-10
33075483603,33075483598,-5,2165,6808,-10
33082470972,33082470974,2,1296,1127,-10
33086010826,33086010827,1,2021,2240,-10
33087153279,33087153283,4,2095,1756,-10
33089226447,33089226447,0,1441,1419,-10
33091254854,33091254857,3,1201,1269,-10
33094682386,33094682386,0,1537,1489,-10
33095545624,33095545628,4,1571,1742,-10
33095671555,33095671561,6,3449,1206,-10
33097892454,33097892457,3,1560,1907,-10
33098373579,33098373583,4,1778,1974,-10
33101038902,33101038904,2,1204,1634,-10
33103273592,33103273593,1,1506,1520,-10
33104439689,33104439688,-1,1442,1198,-10
33104607925,33104607929,4,1411,1597,-10
33105321670,33105321673,3,1352,1339,-10
33106960777,33106960778,1,1089,1245,-10
33110369055,33110369054,-1,1490,3530,-10
33110594157,33110594162,5,1610,1712,-10
33111056372,33111056374,2,1561,1589,-10
33112389063,33112389066,3,1152,1528,-10
33112589867,33112589871,4,1345,1127,-10
33112800333,33112800335,2,1720,1921,-10
33113828375,33113828375,0,1880,1500,-10
33114985823,33114985826,3,1713,1551,-10
33117635527,33117635530,3,902,1325,-10
33119451374,33119451375,1,2055,1503,-10
33120270802,33120270805,3,1710,1964,-10
33120810691,33120810692,1,1458,1888,-10
33121534560,33121534562,2,912,1360,-10
33124104426,33124104427,1,1865,1702,-10
33128607863,33128607865,2,1697,1781,-10
33129358821,33129358824,3,1807,1632,-10
33131788551,33131788551,0,703,1077,-10
33133892900,33133892901,1,1099,1017,-10
33136026389,33136026392,3,1206,1501,-10
33138935546,33138935545,-1,1376,1699,-10
33145836546,33145836548,2,1469,1701,-10
33147964709,33147964709,0,1532,1792,-10
33151497215,33151497215,0,1447,992,-10
33154168837,33154168837,0,2190,2509,-10
33158663022,33158663022,0,2155,1298,-10
33160296025,33160296027,2,1484,1095,-10
33161969129,33161969130,1,1728,1650,-10
33164894117,33164894123,6,5231,2027,-10
33168140293,33168140293,0,1817,1552,-10
33170253981,33170253984,3,1348,1122,-10
33171269649,33171269653,4,2264,1267,-10
33171532017,33171532019,2,1084,1300,-10
33171652666,33171652664,-2,1375,1623,-10
33174002282,33174002278,-4,1654,1855,-10
33174220668,33174220671,3,1758,2007,-10
33175761112,33175761117,5,2597,1744,-10
33178595807,33178595809,2,1543,1565,-10
33179888450,33179888450,0,1573,1489,-10
33185867616,33185867618,2,2164,1612,-10
33186732363,33186732361,-2,2011,3942,-10
33187777199,33187777201,2,1343,906,-10
33187829033,33187829033,0,939,1124,-10
33188269890,33188269893,3,1337,1632,-10
33189722146,33189722147,1,2923,2224,-10
33193087405,33193087407,2,1556,1320,-10
33193611453,33193611437,-16,559,693,-10
33197574786,33197574789,3,2163,1471,-10
33198523759,33198523757,-2,1136,933,-10
33200390509,33200390510,1,1794,1384,-10
33206235411,33206235414,3,2164,1480,-10
33207306606,33207306610,4,1590,1418,-10
33208804798,33208804803,5,1628,831,-10
33212333331,33212333333,2,1152,1313,-10
33212898305,33212898307,2,1660,1512,-10
33214961026,33214961029,3,1547,1694,-10
33216066964,33216066966,2,1262,1372,-10
33218811526,33218811527,1,1940,2005,-10
33219035966,33219035968,2,1987,1370,-10
33224446430,33224446437,7,7566,1934,-10
33225173987,33225173987,0,725,1245,-10
33229236519,33229236519,0,1598,1289,-10
33229697511,33229697513,2,1647,1872,-10
33229839794,33229839795,1,1778,1601,-10
33230248395,33230248398,3,1869,1574,-10
33232622157,33232622154,-3,2546,4929,-10
33238590972,33238590974,2,1631,1569,-10
33241635586,33241635589,3,1644,1718,-10
33247851386,33247851391,5,1481,984,-10
33251388086,33251388087,1,1672,1201,-10
33258780087,33258780091,4,1281,1640,-10
33259597402,33259597403,1,1675,1688,-10
33260678003,33260678001,-2,1307,1086,-10
33266287178,33266287182,4,1807,2058,-10
33267041329,33267041330,1,1399,1122,-10
33267108127,33267108127,0,1515,2053,-10
33268133894,33268133898,4,1923,1656,-10
33270189731,33270189735,4,1281,1367,-10
33271075378,33271075381,3,1768,1584,-10
33272797681,33272797684,3,1647,2149,-10
33273226602,33273226604,2,1566,1608,-10
33273551258,33273551259,1,1225,1418,-10
33275595351,33275595353,2,1302,1641,-10
33275680565,33275680566,1,1074,1500,-10
33278980338,33278980338,0,1461,1259,-10
33279056305,33279056306,1,1844,1670,-10
33280326721,33280326722,1,1763,1451,-10
33289165382,33289165384,2,2114,2272,-10
33289712130,33289712134,4,914,992,-10
33290605735,33290605737,2,1644,1731,-10
33298991085,33298991086,1,1325,1890,-10
33299364009,33299364012,3,1299,1264,-10
33303210810,33303210812,2,1043,1788,-10
33303564517,33303564517,0,1963,2288,-10
33306774357,33306774358,1,1265,1788,-10
33307004570,33307004569,-1,1255,1259,-10
33310625078,33310625078,0,1192,1425,-10
33313194963,33313194963,0,1671,2596,-10
33313895673,33313895675,2,1220,1681,-10
33315889435,33315889438,3,870,1315,-10
33316859923,33316859925,2,1762,1698,-10
33318166326,33318166327,1,919,1523,-10
33318572306,33318572308,2,2639,2258,-10
33323031977,33323031978,1,1501,2052,-10
33326724389,33326724394,5,1725,1532,-10
33327118599,33327118602,3,1516,1212,-10
33328887071,33328887070,-1,1328,1872,-10
33329647236,33329647238,2,1521,1750,-10
33331102348,33331102351,3,1605,1806,-10
33332530006,33332530006,0,947,1161,-10
33335659899,33335659901,2,2162,1585,-10
33336477981,33336477982,1,1708,1491,-10
33337020575,33337020573,-2,604,1651,-10
33339939571,33339939575,4,1490,1398,-10
33340442357,33340442358,1,1778,1772,-10
33342683134,33342683136,2,1167,1528,-10
33345079264,33345079266,2,1637,1839,-10
33345238783,33345238785,2,1451,1468,-10
33348025779,33348025781,2,1862,2075,-10
33349233689,33349233693,4,1365,1191,-10
33354990345,33354990348,3,1357,1314,-10
33358016365,33358016360,-5,1608,7225,-10
33358108078,33358108081,3,1296,1625,-10
33358449566,33358449548,-18,1453,1428,-10
33365279411,33365279412,1,1469,1801,-10
33368523146,33368523150,4,1006,1151,-10
33370256207,33370256213,6,10510,28752,-10
33370414126,33370414130,4,1425,1246,-10
33374166897,33374166892,-5,992,3695,-10
33374653115,33374653094,-21,1463,1366,-10
33378820048,33378820049,1,1823,1967,-10
33381424987,33381424987,0,1644,1244,-10
33381525397,33381525399,2,1410,1422,-10
33381877213,33381877215,2,1662,1500,-10
33383318514,33383318516,2,1167,1247,-10
33385574758,33385574755,-3,1392,2154,-10
33389887953,33389887954,1,1816,1936,-10
33393076968,33393076972,4,1834,1784,-10
33395817842,33395817845,3,1980,1386,-10
33396563007,33396563007,0,9286,14011,-10
33398995250,33398995253,3,1802,1523,-10
33400318339,33400318338,-1,1588,1011,-10
33400792375,33400792376,1,1433,1314,-10
33402360642,33402360642,0,1906,2257,-10
33404236420,33404236422,2,1417,1575,-10
33405116382,33405116382,0,1125,1857,-10
33405691778,33405691778,0,1861,1450,-10
33406989726,33406989733,7,8423,2280,-10
33407208509,33407208516,7,2288,974,-10
33407992674,33407992674,0,1939,2519,-10
33408791755,33408791753,-2,1042,1220,-10
33410618745,33410618747,2,1120,1456,-10
33411395738,33411395739,1,1636,1208,-10
33412343129,33412343130,1,1392,1169,-10
33415091551,33415091554,3,2117,1973,-10
33416196557,33416196560,3,2246,1289,-10
33417819905,33417819906,1,1079,1621,-10
33418491741,33418491744,3,2125,1840,-10
33419810390,33419810390,0,1650,1493,-10
33420703483,33420703484,1,1522,1677,-10
33423538710,33423538712,2,1220,1516,-10
33423573822,33423573824,2,1788,1289,-10
33425844988,33425844990,2,1457,1836,-10
33426566959,33426566962,3,1608,1401,-10
33426845424,33426845426,2,1655,1239,-10
33428479757,33428479761,4,1272,1331,-10
33429048363,33429048365,2,2038,2128,-10
33429223048,33429223052,4,1621,1199,-10
33430143397,33430143399,2,1704,1404,-10
33430332342,33430332352,10,12036,40949,-10
33431677022,33431677025,3,794,794,-10
33433650490,33433650488,-2,836,2497,-10
33433793642,33433793644,2,1695,1301,-10
33435828693,33435828695,2,1105,1217,-10
33436612053,33436612045,-8,1219,3637,-10
33444330241,33444330241,0,1386,1178,-10
33455086838,33455086838,0,1999,1516,-10
33456430838,33456430842,4,1074,1165,-10
33458939126,33458939128,2,1419,1658,-10
33462117757,33462117756,-1,921,1348,-10
33468152293,33468152295,2,808,906,-10
33470531433,33470531419,-14,1440,1922,-10
33471274958,33471274959,1,1679,1728,-10
33473988339,33473988340,1,1525,2431,-10
33474318121,33474318122,1,1720,1503,-10
33474862562,33474862563,1,730,1097,-10
33475853638,33475853643,5,1526,1196,-10
33477133775,33477133776,1,2049,1262,-10
33477715151,33477715152,1,1342,1054,-10
33478928122,33478928123,1,1560,1468,-10
33483247192,33483247195,3,2111,2628,-10
33483895506,33483895513,7,3325,1562,-10
33484776124,33484776127,3,1576,1351,-10
33489240610,33489240611,1,1952,1257,-10
33489972654,33489972657,3,1382,1177,-10
33491734558,33491734559,1,1829,2257,-10
33493504046,33493504048,2,1371,1180,-10
33493667267,33493667273,6,1255,1335,-10
33496001222,33496001223,1,1116,1168,-10
33501469494,33501469498,4,1949,1645,-10
33502451678,33502451683,5,1395,1489,-10
33506287869,33506287872,3,1585,1535,-10
33508933102,33508933106,4,1884,1131,-10
33509743106,33509743105,-1,1488,1528,-10
33512141601,33512141606,5,4205,2120,-10
33512853617,33512853618,1,1908,2058,-10
33514736994,33514736996,2,2067,1455,-10
33514838077,33514838056,-21,635,509,-10
33514883821,33514883822,1,14585,16352,-10
33515686555,33515686557,2,1349,1609,-10
33516727723,33516727703,-20,1148,1511,-10
33517758264,33517758265,1,1799,1734,-10
33519969924,33519969938,14,2580,121,-10
33520219890,33520219902,12,1572,1576,-10
33523827635,33523827637,2,1029,1135,-10
33524352131,33524352133,2,2152,1880,-10
33525917169,33525917171,2,1298,1587,-10
33529272093,33529272094,1,1951,2152,-10
33530893049,33530893051,2,1107,1028,-10
33532442300,33532442301,1,1372,1377,-10
33535083571,33535083577,6,2317,1789,-10
33536903546,33536903550,4,1257,1062,-10
33537216811,33537216810,-1,1251,1574,-10
33537888926,33537888929,3,1801,1554,-10
33538254962,33538254963,1,1328,1662,-10
33539702891,33539702894,3,1214,1006,-10
33543124518,33543124522,4,1592,1029,-10
33543339403,33543339403,0,1520,1565,-10
33545321990,33545321993,3,1321,1477,-10
33545930157,33545930176,19,1291,1254,-10
33548676143,33548676147,4,1944,2224,-10
33548898554,33548898555,1,597,1187,-10
33550959650,33550959654,4,1441,1626,-10
33554717842,33554717844,2,1688,1155,-10
33555083626,33555083625,-1,1254,1965,-10
33555351975,33555351978,3,1694,1719,-10
33555695308,33555695310,2,1718,2325,-10
33557423661,33557423662,1,1408,1705,-10
33558318900,33558318918,18,1387,1800,-10
33559155391,33559155387,-4,960,2155,-10
33562496058,33562496061,3,2340,2210,-10
33563266010,33563266014,4,2369,1326,-10
33563924150,33563924155,5,1997,1655,-10
33564196738,33564196739,1,2030,1769,-10
33564666311,33564666314,3,3128,4088,-10
33564876577,33564876580,3,1476,1099,-10
33572854834,33572854835,1,1139,1229,-10
33581506747,33581506751,4,1819,2032,-10
33582462835,33582462839,4,1894,1185,-10
33582752550,33582752554,4,1881,1134,-10
33584238695,33584238698,3,1033,1129,-10
33584440534,33584440512,-22,1327,1617,-10
33588426226,33588426230,4,1347,1355,-10
33594402471,33594402473,2,1295,1444,-10
33595708706,33595708708,2,1549,1288,-10
33597153726,33597153730,4,920,1314,-10
33598923148,33598923150,2,1203,1638,-10
33599856734,33599856732,-2,2758,4274,-10
33599920193,33599920198,5,5634,3470,-10
33601108523,33601108525,2,1526,2188,-10
33606018686,33606018687,1,1575,1436,-10
33607183685,33607183686,1,1658,1008,-10
33610022947,33610022946,-1,1637,1942,-10
33611210235,33611210235,0,1329,1352,-10
33615357678,33615357681,3,1287,973,-10
33616153117,33616153111,-6,1810,6581,-10
33618321665,33618321665,0,1412,1603,-10
33620278973,33620278974,1,1971,1607,-10
33623388450,33623388451,1,1355,1814,-10
33624191448,33624191445,-3,1130,924,-10
33626122998,33626123005,7,8333,2747,-10
33626160417,33626160418,1,1547,1868,-10
33626589249,33626589252,3,2196,1874,-10
33627666111,33627666114,3,1913,1828,-10
33631726358,33631726362,4,2687,1933,-10
33632055590,33632055571,-19,1756,1081,-10
33633065533,33633065534,1,1682,1420,-10
33640830274,33640830279,5,3625,1586,-10
33641394983,33641394985,2,1535,1597,-10
33647671201,33647671203,2,1674,1582,-10
33649998691,33649998693,2,1689,1725,-10
33651756219,33651756220,1,862,1800,-10
33656595344,33656595346,2,1150,1021,-10
33657840926,33657840927,1,1535,1932,-10
33659304890,33659304890,0,1533,1742,-10
33660045522,33660045526,4,1841,1304,-10
33663480510,33663480513,3,2096,1598,-10
33664307016,33664307018,2,1655,2233,-10
33665680546,33665680547,1,1018,1711,-10
33667331346,33667331350,4,2337,1607,-10
33667398829,33667398833,4,959,1328,-10
33671877075,33671877076,1,1250,1674,-10
33672267346,33672267346,0,1412,1924,-10
33674768181,33674768182,1,1106,1917,-10
33679808304,33679808306,2,1978,1729,-10
33680064645,33680064645,0,907,585,-10
33681123217,33681123217,0,1793,2825,-10
33681434391,33681434391,0,1842,1764,-10
33682531803,33682531805,2,1505,1282,-10
33683901989,33683901991,2,1300,1367,-10
33686066314,33686066313,-1,2176,2518,-10
33690339246,33690339246,0,1078,1526,-10
33691834141,33691834141,0,1271,1512,-10
33694005702,33694005706,4,1609,1526,-10
33695009569,33695009554,-15,1120,260,-10
33695438829,33695438829,0,1473,1675,-10
33697514711,33697514714,3,1231,954,-10
33699820438,33699820441,3,2287,1490,-10
33700598418,33700598419,1,1283,1344,-10
33705688397,33705688398,1,1141,1358,-10
33706682810,33706682801,-9,1137,1527,-10
33710981121,33710981124,3,1433,985,-10
33711051549,33711051562,13,1478,1436,-10
33716910305,33716910305,0,1419,1680,-10
33719001955,33719001956,1,1255,1201,-10
33723716359,33723716361,2,1544,1544,-10
33725872843,33725872845,2,1632,1776,-10
33727590042,33727590046,4,2269,1591,-10
33728580918,33728580923,5,2119,1639,-10
33728690966,33728690967,1,1380,1677,-10
33731634670,33731634674,4,2122,1522,-10
33731696506,33731696509,3,1805,1335,-10
33732998714,33732998713,-1,1404,2002,-10
33733754602,33733754606,4,1921,1039,-10
33734746112,33734746115,3,1007,920,-10
33735408846,33735408846,0,1139,1383,-10
33741669878,33741669879,1,1873,2244,-10
33745409790,33745409794,4,1515,1347,-10
33746085309,33746085311,2,1371,1695,-10
33753298824,33753298823,-1,1456,1444,-10
33754230478,33754230478,0,1645,1535,-10
33756984382,33756984383,1,1174,1056,-10
33757385074,33757385077,3,1005,979,-10
33757873910,33757873913,3,1544,1758,-10
33759329490,33759329493,3,1721,1472,-10
33760282814,33760282793,-21,1420,945,-10
33762122777,33762122774,-3,1134,2436,-10
33762182564,33762182566,2,1415,1575,-10
33762990203,33762990204,1,1875,1784,-10
33766103690,33766103690,0,1673,1391,-10
33770173990,33770173993,3,1997,1816,-10
33771390729,33771390729,0,1391,2447,-10
33771475242,33771475246,4,1534,1528,-10
33773851356,33773851357,1,1274,1372,-10
33774315131,33774315133,2,1228,1467,-10
33778573927,33778573930,3,1973,1977,-10
33778742444,33778742447,3,1749,1924,-10
33778929621,33778929616,-5,2288,6169,-10
33781595785,33781595786,1,878,1274,-10
33782517395,33782517401,6,3452,1512,-10
33785076150,33785076154,4,1652,1607,-10
33785414225,33785414240,15,2770,1179,-10
33787277925,33787277926,1,1672,1440,-10
33793744910,33793744910,0,1143,1889,-10
33796861234,33796861216,-18,2204,1636,-10
33798056940,33798056944,4,2141,1200,-10
33800873486,33800873491,5,1685,898,-10
33801795826,33801795833,7,1233,1394,-10
33804011737,33804011738,1,1903,1449,-10
33805124479,33805124481,2,1834,1786,-10
33806677284,33806677285,1,1791,1719,-10
33808500855,33808500857,2,1226,1541,-10
33808716497,33808716495,-2,1154,1337,-10
33813991771,33813991769,-2,1484,1654,-10
33816485654,33816485656,2,1661,1610,-10
33817720823,33817720825,2,1718,1904,-10
33827361563,33827361562,-1,27504,21045,-10
33833257269,33833257280,11,396,791,-10
33838432504,33838432506,2,2202,2018,-10
33838512650,33838512652,2,1608,1453,-10
33844706294,33844706295,1,1800,1899,-10
33846095995,33846095997,2,1796,1557,-10
33846894514,33846894497,-17,1083,1043,-10
33847519575,33847519575,0,1139,1415,-10
33850072826,33850072827,1,1239,1404,-10
33850325155,33850325157,2,1516,1436,-10
33851157802,33851157807,5,1804,868,-10
33851530835,33851530835,0,1557,1514,-10
33853279170,33853279170,0,796,1151,-10
33854955287,33854955290,3,1433,1311,-10
33855208239,33855208242,3,1528,1798,-10
33855434290,33855434291,1,2253,1553,-10
33856291198,33856291198,0,2433,2780,-10
33857186464,33857186466,2,1510,1704,-10
33859723958,33859723958,0,1246,1894,-10
33860567453,33860567454,1,1527,1575,-10
33861545254,33861545257,3,1107,1642,-10
33861620310,33861620310,0,1629,1558,-10
33864334489,33864334483,-6,1935,6721,-10
33867377222,33867377229,7,2298,1624,-10
33869597462,33869597463,1,1991,1395,-10
33875091457,33875091458,1,1765,2361,-10
33875856797,33875856799,2,1656,1971,-10
33877420603,33877420605,2,1122,1235,-10
33878540494,33878540489,-5,629,2941,-10
33879081181,33879081183,2,1437,2206,-10
33884719344,33884719347,3,1413,1136,-10
33885556666,33885556671,5,1823,1498,-10
33889333082,33889333085,3,1563,1099,-10
33890988238,33890988240,2,1753,1320,-10
33892833593,33892833594,1,1938,1627,-10
33893175462,33893175463,1,1343,1277,-10
33894870954,33894870956,2,1150,1105,-10
33896015515,33896015502,-13,1406,1525,-10
33896405986,33896405990,4,2217,1294,-10
33898005838,33898005839,1,657,914,-10
33899825525,33899825526,1,1141,1232,-10
33901110687,33901110691,4,1602,1627,-10
33901850273,33901850275,2,1917,1369,-10
33902747526,33902747527,1,1978,2047,-10
33903407968,33903407972,4,2661,959,-10
33905877114,33905877115,1,2063,1586,-10
33907270524,33907270525,1,1712,1898,-10
33912745558,33912745560,2,1292,1851,-10
33913122022,33913122022,0,1532,1264,-10
33913206362,33913206379,17,1520,1547,-10
33913403966,33913403969,3,1277,1515,-10
33914586151,33914586154,3,1240,1797,-10
33916574003,33916574006,3,1243,1094,-10
33918150015,33918150018,3,1835,1225,-10
33919278873,33919278865,-8,1120,1097,-10
33919985942,33919985945,3,1401,1557,-10
33920616807,33920616811,4,2264,905,-10
33921898878,33921898883,5,2323,1639,-10
33922783894,33922783895,1,1340,1218,-10
33923229754,33923229757,3,1502,1895,-10
33927837308,33927837312,4,1557,1183,-10
33929865640,33929865642,2,1884,2077,-10
33930705502,33930705504,2,1240,1586,-10
33931852451,33931852454,3,1551,1383,-10
33932052965,33932052966,1,1023,1496,-10
33932348303,33932348301,-2,1019,2201,-10
33933655695,33933655690,-5,1412,4039,-10
33937661093,33937661072,-21,1700,1059,-10
33944864891,33944864893,2,2056,1985,-10
33945078133,33945078134,1,1604,943,-10
33945906921,33945906922,1,1603,1008,-10
33948034722,33948034722,0,1878,1892,-10
33948096912,33948096915,3,1949,1564,-10
33949834073,33949834074,1,1398,1322,-10
33951139538,33951139541,3,1443,1765,-10
33951292680,33951292680,0,1268,1451,-10
33952478890,33952478902,12,1152,1078,-10
33952762130,33952762130,0,1411,1406,-10
33954497038,33954497038,0,1453,979,-10
33954632050,33954632050,0,1229,1220,-10
33956689850,33956689852,2,1393,1414,-10
33957207945,33957207947,2,1888,1465,-10
33959902469,33959902472,3,1298,1729,-10
33961208201,33961208202,1,842,1206,-10
33961596333,33961596334,1,2141,1989,-10
33962253266,33962253270,4,1912,1433,-10
33967657086,33967657089,3,1209,1232,-10
33972275702,33972275704,2,2109,2108,-10
33972833819,33972833821,2,1895,1786,-10
33974205427,33974205427,0,963,1591,-10
33974371529,33974371529,0,1316,1706,-10
33976678289,33976678290,1,2389,1806,-10
33977507665,33977507665,0,2054,1825,-10
33978437482,33978437482,0,1571,1918,-10
33979421450,33979421453,3,768,1159,-10
33979797046,33979797048,2,1347,1017,-10
33982532798,33982532799,1,1011,1717,-10
33984455550,33984455552,2,1887,1574,-10
33985417034,33985417035,1,1759,1403,-10
33986050495,33986050495,0,1191,1830,-10
33986647137,33986647134,-3,909,1398,-10
33987124867,33987124865,-2,1237,3573,-10
33988731689,33988731693,4,2526,1797,-10
33989670676,33989670679,3,1496,1440,-10
33991073670,33991073673,3,1369,1966,-10
33991816717,33991816715,-2,1448,1699,-10
33991851925,33991851926,1,1226,1254,-10
33999855214,33999855215,1,1489,1909,-10
33999896578,33999896581,3,1514,1492,-10
34000395723,34000395729,6,4144,2035,-10
34003310702,34003310704,2,1485,1583,-10
34004812659,34004812655,-4,719,2160,-10
34008025720,34008025722,2,1432,1411,-10
34014306151,34014306149,-2,1038,1209,-10
34014378989,34014378992,3,2145,1634,-10
34016355618,34016355618,0,1374,1567,-10
34017230970,34017230981,11,1364,1692,-10
34017260025,34017260043,18,1413,1796,-10
34019528886,34019528889,3,1713,1517,-10
34027888594,34027888599,5,2305,1304,-10
34029143283,34029143286,3,1763,1331,-10
34030371139,34030371142,3,1952,1785,-10
34030686218,34030686219,1,1472,1038,-10
34032695428,34032695430,2,851,1689,-10
34033597514,34033597515,1,1198,1077,-10
34034742739,34034742739,0,1331,2080,-10
34035330382,34035330382,0,1039,1734,-10
34036699458,34036699460,2,1488,2525,-10
34037861684,34037861689,5,1412,1081,-10
34042344833,34042344840,7,8371,35774,-10
34043385886,34043385888,2,1830,1484,-10
34047974417,34047974422,5,5151,2797,-10
34048927257,34048927259,2,1879,1575,-10
34049713234,34049713239,5,1867,1769,-10
34052836938,34052836939,1,1430,1470,-10
34053755225,34053755227,2,1251,1516,-10
34055311917,34055311920,3,1966,1342,-10
34055826742,34055826744,2,2190,2345,-10
34056349355,34056349357,2,2249,1876,-10
34062577570,34062577574,4,2176,1503,-10
34064962699,34064962702,3,1039,963,-10
34075407543,34075407544,1,2013,2286,-10
34075831912,34075831911,-1,1621,1399,-10
34077158475,34077158476,1,1427,1927,-10
34081524323,34081524324,1,1817,1735,-10
34083885258,34083885259,1,1960,2292,-10
34088038918,34088038913,-5,860,2010,-10
34091628716,34091628722,6,3616,1050,-10
34093245370,34093245373,3,1623,1532,-10
34097791521,34097791522,1,1950,1532,-10
34099081630,34099081634,4,1671,1140,-10
34101577086,34101577090,4,1635,1469,-10
34102018244,34102018247,3,1193,1163,-10
34102045544,34102045547,3,1201,1296,-10
34105495168,34105495163,-5,1447,3934,-10
34107862631,34107862634,3,1112,998,-10
34108139199,34108139192,-7,1823,7241,-10
34108900966,34108900968,2,1229,1208,-10
34112104326,34112104327,1,1314,1959,-10
34116608175,34116608179,4,2031,1820,-10
34120605797,34120605808,11,859,935,-10
34123073342,34123073345,3,1335,1323,-10
34124373509,34124373513,4,1332,1371,-10
34125189086,34125189087,1,950,846,-10
34125978701,34125978703,2,2125,1666,-10
34127213502,34127213502,0,1456,1457,-10
34127361361,34127361359,-2,1119,2008,-10
34128916919,34128916914,-5,1086,3292,-10
34130769836,34130769837,1,2402,1910,-10
34134459674,34134459681,7,1729,1211,-10
34134568474,34134568476,2,1816,1638,-10
34135225175,34135225179,4,3153,1615,-10
34136919984,34136919987,3,2324,1747,-10
34137545997,34137545998,1,1665,1351,-10
34138979281,34138979283,2,1158,1415,-10
34140269278,34140269282,4,1890,1973,-10
34142618750,34142618750,0,1653,1733,-10
34143121257,34143121256,-1,1052,1222,-10
34147179965,34147179965,0,1926,2178,-10
34147796329,34147796311,-18,679,1011,-10
34148576863,34148576867,4,1943,1030,-10
34149424590,34149424587,-3,1113,2421,-10
34149617520,34149617519,-1,1206,1003,-10
34150265770,34150265773,3,1726,1291,-10
34152234499,34152234500,1,1250,1129,-10
34152932282,34152932283,1,1428,1754,-10
34156146751,34156146753,2,1141,1154,-10
34156784371,34156784370,-1,960,2056,-10
34157058001,34157058002,1,1413,1758,-10
34159104684,34159104679,-5,795,1666,-10
34159621725,34159621727,2,1992,1882,-10
34163030887,34163030866,-21,936,707,-10
34163198636,34163198638,2,1193,1478,-10
34166653379,34166653381,2,1768,1444,-10
34168070535,34168070535,0,1329,1002,-10
34168443816,34168443818,2,1266,1160,-10
34168705238,34168705242,4,1484,1431,-10
34172176255,34172176257,2,1847,2076,-10
34172316158,34172316160,2,1515,1368,-10
34172614985,34172614986,1,1480,1399,-10
34173243039,34173243039,0,1316,1668,-10
34176129791,34176129794,3,1216,1529,-10
34180095030,34180095031,1,1205,1471,-10
34181993201,34181993201,0,757,1155,-10
34182952637,34182952638,1,1500,1373,-10
34185456897,34185456893,-4,1153,3384,-10
34187240167,34187240165,-2,875,1902,-10
34189992566,34189992566,0,1293,1922,-10
34191659286,34191659293,7,2920,1339,-10
34193256521,34193256522,1,1516,976,-10
34194634259,34194634263,4,1084,1208,-10
34195624863,34195624866,3,1532,1654,-10
34208440366,34208440368,2,1680,1131,-10
34208965183,34208965193,10,12311,40125,-10
34218116435,34218116439,4,1952,1827,-10
34224677805,34224677806,1,2250,1413,-10
34231883330,34231883331,1,1419,1503,-10
34235754233,34235754234,1,1650,1766,-10
34237053848,34237053850,2,1403,1331,-10
34238262591,34238262593,2,1255,1728,-10
34239138310,34239138311,1,1724,1818,-10
34241188750,34241188754,4,1758,1847,-10
34241830262,34241830262,0,1483,1855,-10
34243142414,34243142415,1,1059,1221,-10
34243916719,34243916723,4,1513,1175,-10
34244007046,34244007049,3,1167,1826,-10
34246582305,34246582305,0,1904,1241,-10
34247542406,34247542408,2,1987,1689,-10
34248534693,34248534690,-3,1406,1437,-10
34249478845,34249478846,1,1428,1461,-10
34250777811,34250777813,2,1289,1501,-10
34252029030,34252029037,7,4656,1921,-10
34252603757,34252603759,2,1542,1404,-10
34255926049,34255926050,1,1676,2231,-10
34256502371,34256502373,2,1891,1303,-10
34256566769,34256566769,0,1339,1073,-10
34257602138,34257602140,2,1351,1290,-10
34259616593,34259616593,0,1213,1502,-10
34260428883,34260428882,-1,1097,1695,-10
34263704942,34263704943,1,1888,1195,-10
34266553299,34266553301,2,1251,1957,-10
34269726669,34269726673,4,2165,1932,-10
34270751930,34270751934,4,1276,1395,-10
34281215430,34281215432,2,1305,1060,-10
34282827193,34282827194,1,1733,2434,-10
34283514714,34283514717,3,1329,1731,-10
34284953981,34284953979,-2,1228,2942,-10
34288480999,34288481002,3,2017,2220,-10
34293558990,34293558991,1,1392,1672,-10
34293756002,34293756021,19,8,2685,-10
34297405045,34297405047,2,1727,1180,-10
34298423738,34298423741,3,1519,1115,-10
34298684791,34298684792,1,1194,2034,-10
34302876141,34302876143,2,1306,1683,-10
34305956162,34305956166,4,6848,4364,-10
34308266498,34308266501,3,1390,1102,-10
34310046016,34310046019,3,1584,1220,-10
34312008356,34312008357,1,1615,1513,-10
34312906678,34312906679,1,1911,1738,-10
34317645388,34317645391,3,2672,2457,-10
34318147726,34318147724,-2,1331,1747,-10
34320190696,34320190697,1,1568,1973,-10
34321065287,34321065287,0,1006,795,-10
34325185579,34325185582,3,1585,1501,-10
34326053570,34326053573,3,1369,1376,-10
34326882570,34326882571,1,1278,1511,-10
34328222350,34328222353,3,1774,1752,-10
34329354447,34329354446,-1,769,1466,-10
34330294875,34330294875,0,1636,1910,-10
34331340155,34331340158,3,1334,1391,-10
34334958961,34334958963,2,1420,1408,-10
34335501609,34335501623,14,1568,1387,-10
34336881970,34336881967,-3,1275,1139,-10
34337680066,34337680067,1,910,1041,-10
34340856998,34340857002,4,1769,1170,-10
34341614406,34341614408,2,1827,779,-10
34344001014,34344001015,1,1427,1992,-10
34345137754,34345137751,-3,902,2173,-10
34346704677,34346704676,-1,1342,1779,-10
34350266718,34350266720,2,1320,2201,-10
34350307071,34350307072,1,1746,1698,-10
34351269133,34351269134,1,1670,1460,-10
34354696698,34354696701,3,1735,2132,-10
34357540201,34357540199,-2,1118,1991,-10
34360302081,34360302086,5,1054,1127,-10
34360558118,34360558122,4,1421,1377,-10
34362074816,34362074816,0,1062,1245,-10
34363117166,34363117165,-1,1297,1468,-10
34363886061,34363886065,4,1722,1197,-10
34367889785,34367889786,1,858,942,-10
34369311425,34369311426,1,1809,1957,-10
34371186467,34371186469,2,1390,1505,-10
34372128037,34372128038,1,1586,1567,-10
34374236264,34374236267,3,1888,956,-10
34377125662,34377125664,2,1867,1669,-10
34377695166,34377695168,2,1556,1411,-10
34379992114,34379992117,3,1492,1550,-10
34382573765,34382573766,1,2113,1825,-10
34385945818,34385945798,-20,923,381,-10
34392414893,34392414894,1,1254,1017,-10
34392507859,34392507859,0,739,867,-10
34397259584,34397259587,3,1475,1669,-10
34397405835,34397405837,2,1281,1054,-10
34399367708,34399367716,8,13916,30370,-10
34399972942,34399972943,1,1344,1120,-10
34401721955,34401721952,-3,1157,2034,-10
34405472469,34405472471,2,1768,1008,-10
34405510798,34405510798,0,1640,1416,-10
34407011769,34407011770,1,1675,1357,-10
34408466585,34408466585,0,21597,31552,-10
34409994838,34409994841,3,1873,1416,-10
34410314641,34410314642,1,1485,1572,-10
34412535945,34412535946,1,1972,1516,-10
34413477021,34413477021,0,1453,1299,-10
34416039019,34416039021,2,1317,1339,-10
34416722934,34416722938,4,1243,1235,-10
34423887286,34423887287,1,723,1004,-10
34425897093,34425897101,8,2539,982,-10
34426022396,34426022402,6,658,246,-10
34436163726,34436163725,-1,1821,2416,-10
34440447717,34440447719,2,1436,1850,-10
34443154421,34443154423,2,2165,1347,-10
34444371208,34444371206,-2,1438,1635,-10
34444432290,34444432290,0,1377,1309,-10
34445369462,34445369465,3,1731,1905,-10
34445710115,34445710114,-1,1346,1328,-10
34450293069,34450293072,3,1736,1872,-10
34452005805,34452005806,1,1069,1219,-10
34455075265,34455075267,2,1137,1034,-10
34456662903,34456662905,2,840,1100,-10
34459002249,34459002250,1,1574,1345,-10
34459165107,34459165091,-16,1247,1267,-10
34459924458,34459924459,1,1919,1945,-10
34460578676,34460578678,2,1669,1506,-10
34462517435,34462517439,4,1349,1122,-10
34465376366,34465376368,2,2003,1889,-10
34465607315,34465607318,3,844,1178,-10
34468982511,34468982491,-20,1539,1656,-10
34471579302,34471579303,1,1690,1686,-10
34471607319,34471607323,4,1318,1007,-10
34473524349,34473524348,-1,1742,1610,-10
34475146701,34475146702,1,1712,2233,-10
34477691450,34477691453,3,1600,1831,-10
34477848722,34477848722,0,1068,1848,-10
34479653782,34479653779,-3,1882,4576,-10
34484900506,34484900501,-5,1120,4039,-10
34487443802,34487443803,1,1470,1176,-10
34489621341,34489621345,4,1907,1988,-10
34491007803,34491007804,1,1952,1755,-10
34493080038,34493080042,4,1412,1314,-10
34494040468,34494040461,-7,1983,12296,-10
34494118341,34494118344,3,1477,1635,-10
34494207750,34494207751,1,977,831,-10
34496561654,34496561656,2,1413,1484,-10
34497492006,34497492009,3,1816,1443,-10
34499241580,34499241573,-7,1404,5497,-10
34499613570,34499613570,0,1391,1256,-10
34500259403,34500259404,1,1528,905,-10
34503409673,34503409673,0,1508,1195,-10
34505429513,34505429514,1,1164,1489,-10
34511303965,34511303966,1,1398,1261,-10
34517899167,34517899168,1,1167,1196,-10
34518276246,34518276253,7,1460,1338,-10
34522215422,34522215424,2,1213,1245,-10
34523980451,34523980453,2,1927,1494,-10
34524354850,34524354853,3,1177,1745,-10
34524544065,34524544068,3,1595,1305,-10
34526283474,34526283471,-3,769,2101,-10
34528719129,34528719131,2,1839,1655,-10
34530244522,34530244524,2,973,1155,-10
34533598051,34533598050,-1,1371,2049,-10
34536441582,34536441583,1,1105,1528,-10
34537429743,34537429745,2,1865,1420,-10
34538422361,34538422364,3,971,1204,-10
34539810795,34539810798,3,1633,1745,-10
34543484771,34543484769,-2,787,1540,-10
34543593468,34543593471,3,1996,1366,-10
34545035838,34545035840,2,1494,1572,-10
34545879703,34545879706,3,1462,1337,-10
34546226386,34546226387,1,1921,2086,-10
34548751234,34548751235,1,846,1108,-10
34549497046,34549497043,-3,1118,3197,-10
34554016168,34554016170,2,1795,1593,-10
34560632983,34560632986,3,1569,1751,-10
34561190190,34561190194,4,1901,1682,-10
34561837943,34561837942,-1,1759,1594,-10
34565746856,34565746859,3,1591,1159,-10
34567119058,34567119060,2,1396,1851,-10
34567794163,34567794167,4,1539,1088,-10
34568601410,34568601410,0,2385,1792,-10
34569356967,34569356970,3,1106,1034,-10
34576518126,34576518128,2,1578,1677,-10
34578594790,34578594794,4,1166,1156,-10
34582553904,34582553910,6,6779,3148,-10
34584485570,34584485573,3,2794,2956,-10
34585185916,34585185918,2,1653,2035,-10
34585548294,34585548299,5,1866,1660,-10
34587566877,34587566877,0,1358,1447,-10
34587621486,34587621489,3,1977,1719,-10
34587816192,34587816175,-17,2858,2471,-10
34589594938,34589594942,4,1544,1205,-10
34593729872,34593729874,2,1733,1889,-10
34593860829,34593860831,2,1080,1214,-10
34594270292,34594270293,1,1352,1321,-10
34594620445,34594620445,0,778,722,-10
34597632002,34597632007,5,1778,1215,-10
34598177788,34598177789,1,1610,1753,-10
34607450112,34607450108,-4,28077,16068,-10
34609139218,34609139219,1,1616,1286,-10
34609220596,34609220603,7,1778,1137,-10
34610179273,34610179275,2,905,1579,-10
34611163722,34611163723,1,1294,1489,-10
34611458767,34611458771,4,1268,1712,-10
34612146295,34612146296,1,1804,1840,-10
34615172803,34615172803,0,1388,1051,-10
34615471475,34615471477,2,1825,1509,-10
34616376558,34616376547,-11,1497,1554,-10
34617578902,34617578904,2,788,1149,-10
34618509543,34618509545,2,1558,1461,-10
34628797453,34628797454,1,1262,1866,-10
34629288086,34629288086,0,1194,1110,-10
34632080967,34632080965,-2,1271,1511,-10
34632228105,34632228108,3,836,1328,-10
34635922981,34635922983,2,1702,1478,-10
34637244634,34637244630,-4,2088,5219,-10
34638153030,34638153032,2,1614,1706,-10
34641123770,34641123771,1,724,866,-10
34641285318,34641285319,1,1099,929,-10
34645260438,34645260437,-1,1534,1863,-10
34645748957,34645748961,4,1438,971,-10
34647095789,34647095790,1,1438,1150,-10
34647394015,34647394017,2,2123,1604,-10
34647933590,34647933606,16,14505,53817,-10
34650668350,34650668354,4,1704,1619,-10
34652598450,34652598452,2,1653,1355,-10
34652788001,34652788003,2,1284,1184,-10
34655370025,34655370027,2,1121,1539,-10
34656070429,34656070430,1,1452,1486,-10
34656906407,34656906409,2,1757,1503,-10
34660473801,34660473802,1,1787,1551,-10
34660708961,34660708963,2,1245,1986,-10
34662910670,34662910674,4,1892,2083,-10
34668063030,34668063032,2,1966,1295,-10
34668660803,34668660806,3,1273,1883,-10
34669676953,34669676954,1,1680,1762,-10
34672267589,34672267591,2,1346,1393,-10
34673393021,34673393021,0,1632,1557,-10
34673702497,34673702505,8,2467,1117,-10
34675231584,34675231585,1,1330,1539,-10
34675614121,34675614123,2,1592,1564,-10
34676005316,34676005318,2,1714,1514,-10
34676375123,34676375127,4,1568,1408,-10
34676546794,34676546794,0,1765,2030,-10
34676957173,34676957173,0,1245,1704,-10
34685470572,34685470570,-2,1400,2248,-10
34687147934,34687147935,1,1792,2112,-10
34693651779,34693651780,1,1627,1587,-10
34696965828,34696965827,-1,1323,2047,-10
34699232497,34699232499,2,1985,1759,-10
34699744761,34699744762,1,1410,1615,-10
34701396497,34701396498,1,1637,1161,-10
34709673043,34709673049,6,2493,1490,-10
34712321275,34712321277,2,1077,1199,-10
34716777749,34716777751,2,1136,1444,-10
34717215347,34717215351,4,1408,1575,-10
34718333622,34718333625,3,1270,1525,-10
34720276942,34720276943,1,2296,1988,-10
34727200123,34727200123,0,1096,1333,-10
34732223746,34732223748,2,1369,1768,-10
34735135262,34735135266,4,1626,1477,-10
34735860282,34735860283,1,1029,1686,-10
34739579435,34739579437,2,1045,630,-10
34742794102,34742794107,5,1423,2004,-10
34745769108,34745769114,6,2765,1487,-10
34748336417,34748336418,1,2219,1595,-10
34748803046,34748803049,3,1466,1602,-10
34749207005,34749207010,5,1875,1441,-10
34750972679,34750972682,3,1413,1771,-10
34753194980,34753194985,5,1119,1124,-10
34757016032,34757016034,2,1517,1803,-10
34757611768,34757611770,2,1890,1967,-10
34758462086,34758462087,1,1478,1075,-10
34759956973,34759956974,1,1385,932,-10
34762898246,34762898247,1,1554,1693,-10
34767341733,34767341735,2,981,823,-10
34768819162,34768819165,3,1697,1664,-10
34769072425,34769072427,2,1477,1321,-10
34770116995,34770116994,-1,1230,1336,-10
34772310706,34772310708,2,924,1599,-10
34782473117,34782473121,4,1967,1008,-10
34785648078,34785648081,3,2046,1797,-10
34786134022,34786134021,-1,1640,1890,-10
34788014825,34788014825,0,1660,1321,-10
34788857401,34788857403,2,1282,958,-10
34791975313,34791975317,4,1394,1246,-10
34792593081,34792593084,3,1651,1023,-10
34793184218,34793184221,3,1590,1346,-10
34793490637,34793490638,1,1854,1224,-10
34795313774,34795313778,4,1840,1936,-10
34795858057,34795858059,2,1564,1684,-10
34798727451,34798727454,3,2024,1612,-10
34804052825,34804052823,-2,1447,1470,-10
34804532529,34804532531,2,1656,1567,-10
34809403824,34809403826,2,1736,1703,-10
34809568731,34809568734,3,2115,1863,-10
34812775437,34812775441,4,1833,1404,-10
34815745622,34815745622,0,2002,1393,-10
34816938053,34816938054,1,1357,1291,-10
34818017554,34818017559,5,1020,1160,-10
34818733222,34818733225,3,1346,1381,-10
34824200834,34824200835,1,1237,1374,-10
34827907613,34827907612,-1,1542,2168,-10
34833021126,34833021127,1,1975,1692,-10
34837343029,34837343031,2,1283,1867,-10
34839975431,34839975430,-1,1345,2965,-10
34843207849,34843207850,1,1459,1461,-10
34843719206,34843719206,0,1684,1236,-10
34844173926,34844173928,2,1846,1591,-10
34846344170,34846344173,3,1397,1665,-10
34848478509,34848478510,1,1739,1792,-10
34850058722,34850058722,0,1249,1040,-10
34851231178,34851231180,2,1574,2390,-10
34851275401,34851275403,2,1477,1306,-10
34856650618,34856650621,3,1362,1866,-10
34861278260,34861278261,1,1266,1270,-10
34862780941,34862780943,2,802,1426,-10
34865288033,34865288034,1,1622,1523,-10
34866401174,34866401170,-4,1348,2810,-10
34868302294,34868302296,2,2014,1795,-10
34868914259,34868914260,1,1560,1486,-10
34869379792,34869379793,1,1480,1525,-10
34871664137,34871664139,2,1156,968,-10
34875093250,34875093255,5,1122,968,-10
34876159146,34876159147,1,1701,1646,-10
34876622139,34876622143,4,1106,1328,-10
34876939450,34876939429,-21,2,197,-10
34882343614,34882343617,3,1869,1866,-10
34884075578,34884075578,0,1344,1247,-10
34890951968,34890951970,2,1044,1966,-10
34892245017,34892245018,1,1175,1240,-10
34893279622,34893279627,5,1805,908,-10
34897017368,34897017370,2,2214,1872,-10
34897738847,34897738849,2,1295,905,-10
34899416857,34899416860,3,1932,2135,-10
34901747426,34901747429,3,1792,1757,-10
34902594372,34902594373,1,1703,1818,-10
34904023974,34904023983,9,15571,18611,-10
34904493011,34904493013,2,1133,1506,-10
34904600433,34904600432,-1,1491,1594,-10
34909267408,34909267409,1,1438,2121,-10
34912011110,34912011110,0,1462,1217,-10
34913649754,34913649758,4,1431,1021,-10
34915277970,34915277968,-2,1318,2297,-10
34917613415,34917613417,2,1578,1330,-10
34918717671,34918717675,4,1324,1399,-10
34919874205,34919874209,4,1763,1141,-10
34920030458,34920030472,14,631,290,-10
34920780543,34920780545,2,1515,1829,-10
34923471265,34923471265,0,1310,1401,-10
34924752006,34924752006,0,1652,1616,-10
34924791040,34924791042,2,1376,1736,-10
34926839411,34926839412,1,1265,1116,-10
34928524906,34928524911,5,2223,1247,-10
34931011590,34931011595,5,2050,1150,-10
34934208242,34934208243,1,1359,1430,-10
34938275929,34938275930,1,1592,1477,-10
34941759510,34941759512,2,1692,1687,-10
34942714412,34942714408,-4,1674,2473,-10
34949491062,34949491064,2,2271,2516,-10
34950200415,34950200416,1,1596,1745,-10
34950634410,34950634414,4,1973,1727,-10
34952399761,34952399762,1,1776,1461,-10
34952462282,34952462283,1,400,610,-10
34957618889,34957618890,1,1309,1577,-10
34958022065,34958022068,3,1685,1092,-10
34958835814,34958835814,0,1258,1623,-10
34960166596,34960166599,3,1201,1407,-10
34964204679,34964204682,3,1235,1189,-10
34964629322,34964629325,3,1464,958,-10
34965091912,34965091913,1,1728,1397,-10
34965796128,34965796130,2,1303,1285,-10
34965972093,34965972095,2,1508,1653,-10
34968086623,34968086624,1,1726,1513,-10
34968618062,34968618068,6,15619,15998,-10
34970496409,34970496411,2,1687,1426,-10
34974442234,34974442237,3,1397,1555,-10
34978406552,34978406554,2,979,1019,-10
34987819759,34987819762,3,2095,2171,-10
34989181549,34989181550,1,1315,1505,-10
34990446396,34990446397,1,1332,1679,-10
34990963130,34990963137,7,2109,1485,-10
34994403685,34994403681,-4,1695,5147,-10
34999108618,34999108620,2,1416,1477,-10
35001821270,35001821272,2,855,1615,-10
35002956833,35002956833,0,1858,1785,-10
35004176149,35004176152,3,3167,2366,-10
35005509723,35005509726,3,1453,1616,-10
35006497304,35006497302,-2,979,1464,-10
35009608951,35009608951,0,973,896,-10
35009965221,35009965223,2,1913,1140,-10
35013234635,35013234638,3,1817,1418,-10
35016672981,35016672983,2,1509,1439,-10
35017129202,35017129206,4,2069,1430,-10
35029589952,35029589954,2,1657,1560,-10
35033539941,35033539943,2,1753,1615,-10
35034075718,35034075721,3,1493,1472,-10
35034197296,35034197297,1,1376,1266,-10
35036195242,35036195241,-1,1879,1985,-10
35037016221,35037016209,-12,960,1091,-10
35037337595,35037337575,-20,17676,41957,-10
35038571526,35038571527,1,1453,1364,-10
35039831616,35039831619,3,1666,1393,-10
35040203862,35040203883,21,2024,1572,-10
35041370419,35041370421,2,861,956,-10
35041912735,35041912738,3,1252,2009,-10
35042512878,35042512879,1,1445,1612,-10
35043312627,35043312629,2,1095,1450,-10
35046042483,35046042486,3,1646,1071,-10
35047547502,35047547498,-4,1442,2538,-10
35048606746,35048606751,5,1457,1234,-10
35050468782,35050468783,1,2132,2317,-10
35051500439,35051500441,2,1114,1567,-10
35053417701,35053417702,1,2277,2104,-10
35055297042,35055297041,-1,1016,1665,-10
35055454911,35055454915,4,1760,1808,-10
35060887385,35060887385,0,1279,1846,-10
35061598046,35061598050,4,1394,1363,-10
35063616847,35063616848,1,1318,1742,-10
35066339311,35066339311,0,1814,2102,-10
35066613192,35066613194,2,1562,1203,-10
35076223147,35076223147,0,26277,22591,-10
35076325587,35076325590,3,1645,2025,-10
35077878980,35077878986,6,3859,1590,-10
35080551200,35080551202,2,1662,1791,-10
35082573397,35082573398,1,1989,1739,-10
35085155008,35085155010,2,2012,1463,-10
35085378249,35085378247,-2,1214,1849,-10
35089536064,35089536067,3,3113,2938,-10
35091102453,35091102454,1,1503,1419,-10
35092165078,35092165078,0,1988,1681,-10
35095753386,35095753385,-1,1397,1335,-10
35096531181,35096531181,0,1094,1445,-10
35096892547,35096892539,-8,1365,1295,-10
35098057026,35098057027,1,1157,1198,-10
35098754981,35098754988,7,1810,1422,-10
35100708370,35100708375,5,1031,1108,-10
35102335530,35102335508,-22,1582,1373,-10
35105751283,35105751284,1,1866,2241,-10
35110582706,35110582706,0,1419,1505,-10
35111414648,35111414650,2,1362,1677,-10
35117211638,35117211640,2,1571,1424,-10
35117265231,35117265234,3,1272,1365,-10
35118479405,35118479402,-3,1149,1774,-10
35124119346,35124119345,-1,1094,1413,-10
35132003922,35132003922,0,981,1191,-10
35132231832,35132231851,19,1475,1659,-10
35132955270,35132955271,1,1670,2124,-10
35140226174,35140226174,0,1179,773,-10
35140292451,35140292453,2,1778,2106,-10
35140436485,35140436488,3,1467,1630,-10
35143815080,35143815080,0,1565,1574,-10
35145113703,35145113704,1,1568,2133,-10
35146038222,35146038223,1,1994,1325,-10
35149893707,35149893710,3,666,1339,-10
35153197317,35153197319,2,2334,2067,-10
35158573665,35158573665,0,1555,1562,-10
35161798123,35161798127,4,1459,1610,-10
35163975309,35163975311,2,1398,1267,-10
35165549203,35165549202,-1,1026,1656,-10
35166335940,35166335942,2,1539,1596,-10
35166376773,35166376761,-12,1585,373,-10
35167696879,35167696879,0,1615,1699,-10
35169586150,35169586153,3,1879,1945,-10
35170425575,35170425577,2,1644,1521,-10
35177165251,35177165254,3,1108,1286,-10
35177890566,35177890569,3,1278,1144,-10
35178444066,35178444066,0,1227,1391,-10
35178929006,35178929007,1,1165,1485,-10
35179147677,35179147678,1,1876,1683,-10
35180429518,35180429521,3,1573,1007,-10
35181358590,35181358593,3,2310,1636,-10
35181643307,35181643311,4,2440,1794,-10
35185284267,35185284267,0,1744,1444,-10
35186002851,35186002851,0,897,1075,-10
35191406406,35191406409,3,2183,1409,-10
35193310756,35193310758,2,2244,2087,-10
35195816816,35195816817,1,1804,1912,-10
35200762156,35200762153,-3,986,1855,-10
35202634993,35202634994,1,1880,2286,-10
35205028995,35205028988,-7,43846,20567,-10
35205363918,35205363919,1,1642,1608,-10
35208094312,35208094318,6,4386,1073,-10
35209029765,35209029770,5,3065,1940,-10
35209843076,35209843069,-7,1579,5874,-10
35210045758,35210045758,0,1325,1456,-10
35215891387,35215891389,2,1918,2318,-10
35220534693,35220534696,3,1579,1705,-10
35221817191,35221817194,3,1217,1019,-10
35222114393,35222114393,0,1560,2162,-10
35227084810,35227084813,3,1433,1462,-10
35230820049,35230820050,1,1684,1068,-10
35232245259,35232245262,3,1576,1715,-10
35233829749,35233829750,1,1362,875,-10
35238847001,35238847002,1,1075,1285,-10
35246022233,35246022236,3,1651,1220,-10
35247850296,35247850299,3,1604,1575,-10
35250815121,35250815119,-2,1225,1201,-10
35252178450,35252178450,0,1852,1591,-10
35253931958,35253931962,4,1698,2011,-10
35254522049,35254522051,2,3215,2522,-10
35254600418,35254600421,3,1238,1413,-10
35255113388,35255113391,3,1772,1543,-10
35255798829,35255798831,2,1570,1230,-10
35259141966,35259141968,2,1891,2361,-10
35259451954,35259451954,0,1496,1400,-10
35260824802,35260824805,3,1227,1760,-10
35263378289,35263378292,3,1679,1314,-10
35266507806,35266507808,2,1767,1775,-10
35266974178,35266974182,4,1891,1082,-10
35269200394,35269200399,5,1739,1374,-10
35269669101,35269669101,0,1328,1865,-10
35270435054,35270435055,1,1138,1008,-10
35272389017,35272389018,1,1732,1565,-10
35274605254,35274605256,2,1154,1731,-10
35276689771,35276689770,-1,1403,1583,-10
35277489350,35277489354,4,1628,1180,-10
35278884593,35278884595,2,1911,1345,-10
35281480909,35281480910,1,1410,1568,-10
35282296775,35282296777,2,1913,2069,-10
35282444530,35282444532,2,1223,1105,-10
35282871293,35282871293,0,940,1717,-10
35283699283,35283699284,1,1542,1807,-10
35284264566,35284264569,3,1245,1522,-10
35292134969,35292134974,5,1752,1180,-10
35296419214,35296419213,-1,1609,1682,-10
35296459558,35296459558,0,1340,1569,-10
35296759346,35296759349,3,1406,1749,-10
35297884722,35297884726,4,1599,1506,-10
35300233193,35300233195,2,1605,1246,-10
35302201783,35302201782,-1,2737,3732,-10
35303156943,35303156946,3,1283,1154,-10
35303696765,35303696767,2,2264,1175,-10
35306793419,35306793419,0,1608,1677,-10
35307251068,35307251069,1,1744,1709,-10
35312015608,35312015610,2,1278,1537,-10
35313307133,35313307134,1,1484,2078,-10
35314454834,35314454838,4,1604,1275,-10
35315023396,35315023419,23,1400,1214,-10
35315967226,35315967226,0,1507,1088,-10
35315996392,35315996395,3,998,1600,-10
35316336591,35316336591,0,1019,724,-10
35320155508,35320155510,2,1261,1089,-10
35322471586,35322471565,-21,1009,1247,-10
35322534828,35322534833,5,2578,1408,-10
35326412926,35326412926,0,1388,1638,-10
35326779154,35326779157,3,2094,1603,-10
35327486065,35327486066,1,1495,1579,-10
35327569425,35327569427,2,1273,1293,-10
35332974567,35332974569,2,1963,1583,-10
35333426913,35333426915,2,1432,1376,-10
35333889822,35333889826,4,1904,1732,-10
35339740687,35339740688,1,1144,1494,-10
35344790408,35344790410,2,1837,1470,-10
35352501269,35352501268,-1,1667,1609,-10
35352898721,35352898723,2,1876,1668,-10
35356894549,35356894548,-1,1150,1577,-10
35357224106,35357224109,3,1853,1465,-10
35359020149,35359020151,2,1002,1439,-10
35359234694,35359234695,1,1658,1386,-10
35361813830,35361813826,-4,1239,3095,-10
35362893092,35362893094,2,2366,1722,-10
35364261598,35364261576,-22,1401,1493,-10
35365103093,35365103098,5,1216,1372,-10
35366010589,35366010591,2,1726,1403,-10
35366758159,35366758160,1,1242,1800,-10
35367036034,35367036034,0,1049,1991,-10
35369531962,35369531962,0,1456,1542,-10
35373101901,35373101899,-2,1487,2699,-10
35374030314,35374030315,1,1199,1323,-10
35375501418,35375501419,1,1980,2321,-10
35379510130,35379510132,2,1377,1588,-10
35386281989,35386281994,5,2080,1534,-10
35390483227,35390483231,4,1160,1243,-10
35391940126,35391940128,2,1466,1531,-10
35393730994,35393730997,3,1941,1503,-10
35394884061,35394884062,1,1038,931,-10
35397952214,35397952217,3,2065,1367,-10
35399784989,35399784994,5,2042,1084,-10
35400842553,35400842555,2,1291,1003,-10
35402224879,35402224883,4,2042,1937,-10
35403134618,35403134621,3,1415,1858,-10
35404444679,35404444677,-2,1294,1736,-10
35405219318,35405219320,2,1398,1596,-10
35406015444,35406015449,5,3590,2123,-10
35406976043,35406976045,2,1541,1261,-10
35407057716,35407057718,2,1375,1697,-10
35408552120,35408552122,2,2309,1943,-10
35410041519,35410041518,-1,1150,1335,-10
35417141109,35417141110,1,1733,1740,-10
35419830918,35419830913,-5,857,1680,-10
35420193190,35420193193,3,1736,1080,-10
35421957486,35421957485,-1,1637,2450,-10
35423498997,35423499002,5,1765,1329,-10
35425912557,35425912558,1,1152,1049,-10
35427717512,35427717514,2,1348,1767,-10
35428198675,35428198678,3,1412,1784,-10
35431504523,35431504525,2,1586,1736,-10
35431812146,35431812149,3,1705,1963,-10
35431886802,35431886805,3,1108,1191,-10
35433733882,35433733882,0,1484,1488,-10
35436742858,35436742855,-3,1331,1535,-10
35436956802,35436956803,1,1871,1266,-10
35438468985,35438468990,5,3205,1670,-10
35450281272,35450281272,0,1319,2102,-10
35452843575,35452843575,0,1006,1026,-10
35454772425,35454772428,3,1326,1950,-10
35457385906,35457385911,5,2113,1254,-10
35460382214,35460382218,4,1680,1884,-10
35461372319,35461372322,3,1728,1171,-10
35463667023,35463667024,1,1276,1639,-10
35463807652,35463807654,2,2026,1158,-10
35464050467,35464050466,-1,1388,1087,-10
35466203414,35466203418,4,1261,1329,-10
35467495958,35467495961,3,2012,1569,-10
35468449378,35468449379,1,1826,1570,-10
35469880575,35469880576,1,1091,1136,-10
35473553396,35473553398,2,1943,1384,-10
35474635277,35474635281,4,2012,1876,-10
35477697385,35477697386,1,1165,1078,-10
35479614465,35479614467,2,1591,1535,-10
35481191805,35481191807,2,1622,1517,-10
35482025525,35482025526,1,1720,1453,-10
35484063822,35484063804,-18,1590,1573,-10
35486212999,35486213001,2,1046,1213,-10
35486398626,35486398640,14,1265,1131,-10
35487502109,35487502111,2,1492,1481,-10
35490405130,35490405133,3,1149,927,-10
35503452955,35503452955,0,1393,1357,-10
35506378940,35506378942,2,2363,1356,-10
35506960180,35506960175,-5,940,1856,-10
35507033940,35507033939,-1,1436,1229,-10
35513597681,35513597673,-8,548,2419,-10
35516418993,35516418994,1,1584,1358,-10
35516779362,35516779365,3,1628,1392,-10
35518140329,35518140329,0,2303,1732,-10
35518286832,35518286834,2,1456,1776,-10
35519768471,35519768473,2,1361,1537,-10
35522825308,35522825311,3,1550,1750,-10
35525312181,35525312181,0,1517,1952,-10
35525702677,35525702680,3,1340,1601,-10
35526622577,35526622576,-1,1581,2154,-10
35530487356,35530487359,3,2028,2014,-10
35533480040,35533480041,1,1493,2192,-10
35536316985,35536316986,1,1548,945,-10
35536755335,35536755337,2,1674,2048,-10
35537484453,35537484454,1,1256,1691,-10
35538625828,35538625831,3,2598,1476,-10
35539777653,35539777656,3,2945,1811,-10
35547902190,35547902193,3,1148,1777,-10
35548300506,35548300505,-1,1269,1585,-10
35549385237,35549385238,1,1973,1593,-10
35553798906,35553798907,1,1150,1794,-10
35556110763,35556110765,2,2289,1308,-10
35563061849,35563061853,4,1999,1063,-10
35564304426,35564304427,1,1338,1339,-10
35565633782,35565633783,1,2566,2346,-10
35570347854,35570347855,1,1682,1348,-10
35572490331,35572490334,3,1549,1017,-10
35574959479,35574959473,-6,861,2629,-10
35576318890,35576318893,3,1698,1895,-10
35578793319,35578793323,4,2346,1795,-10
35578924246,35578924247,1,1453,1636,-10
35580809406,35580809407,1,1461,1712,-10
35582568510,35582568511,1,1889,1612,-10
35585046979,35585046977,-2,856,1869,-10
35587846295,35587846273,-22,1486,1631,-10
35590017826,35590017826,0,1522,1591,-10
35590806667,35590806669,2,1077,1159,-10
35592062713,35592062712,-1,1435,1711,-10
35595133656,35595133658,2,1321,1337,-10
35597994713,35597994715,2,1469,1394,-10
35601410212,35601410215,3,843,995,-10
35602227698,35602227702,4,1192,1062,-10
35603029031,35603029034,3,1091,942,-10
35605610571,35605610568,-3,958,2400,-10
35608573799,35608573799,0,1593,1661,-10
35608711542,35608711545,3,2043,1479,-10
35609447774,35609447774,0,1333,2163,-10
35611220066,35611220067,1,1331,1489,-10
35612634366,35612634367,1,1061,1404,-10
35616969121,35616969123,2,930,1005,-10
35620117836,35620117841,5,1248,1173,-10
35622068035,35622068031,-4,18511,59056,-10
35622431542,35622431538,-4,2019,6995,-10
35624672815,35624672818,3,1282,1688,-10
35625382189,35625382192,3,2670,2360,-10
35630913935,35630913937,2,1010,952,-10
35632014849,35632014847,-2,1237,1054,-10
35633717790,35633717789,-1,1323,1838,-10
35635933929,35635933929,0,1308,1419,-10
35641601302,35641601305,3,1344,1193,-10
35645007600,35645007602,2,1675,1500,-10
35645087935,35645087936,1,1421,1646,-10
35645411328,35645411329,1,1407,2161,-10
35645878702,35645878703,1,2636,1923,-10
35649379641,35649379644,3,2158,1895,-10
35649970634,35649970635,1,1752,1901,-10
35651322866,35651322865,-1,1833,1606,-10
35651641386,35651641388,2,2001,1668,-10
35652382122,35652382127,5,1621,1583,-10
35653012877,35653012879,2,1640,1180,-10
35654527339,35654527345,6,1678,1135,-10
35657298611,35657298615,4,1589,1632,-10
35664942641,35664942643,2,1153,1700,-10
35668968432,35668968431,-1,1591,2192,-10
35669323778,35669323778,0,954,699,-10
35670790941,35670790941,0,2069,1971,-10
35671523222,35671523226,4,12383,24399,-10
35671611073,35671611074,1,1215,1053,-10
35673412571,35673412570,-1,1108,1722,-10
35674585411,35674585417,6,1228,1776,-10
35677406723,35677406726,3,1922,1765,-10
35677948161,35677948170,9,11431,38339,-10
35681030153,35681030156,3,2148,1856,-10
35681057390,35681057392,2,1790,1629,-10
35683338022,35683338023,1,1804,2112,-10
35683620647,35683620647,0,752,1280,-10
35684876177,35684876179,2,2112,1877,-10
35686757437,35686757438,1,2009,1311,-10
35689459590,35689459594,4,1141,1521,-10
35692073786,35692073803,17,14315,53057,-10
35692667416,35692667421,5,1410,1744,-10
35693139362,35693139362,0,1759,1690,-10
35694974773,35694974775,2,1224,1222,-10
35699455106,35699455110,4,1874,1400,-10
35699567102,35699567101,-1,1481,1511,-10
35703804765,35703804767,2,1306,1288,-10
35711374642,35711374645,3,2196,2183,-10
35711491438,35711491444,6,2843,1785,-10
35712535473,35712535476,3,1630,1675,-10
35717683132,35717683134,2,1601,1988,-10
35724169606,35724169607,1,1215,1316,-10
35725274387,35725274389,2,816,677,-10
35728663938,35728663939,1,1447,1668,-10
35728918462,35728918463,1,1114,1028,-10
35729622257,35729622255,-2,1279,1616,-10
35732638534,35732638537,3,1623,1427,-10
35733136975,35733136976,1,1405,1408,-10
35733706240,35733706241,1,1310,1438,-10
35735476557,35735476559,2,1308,1391,-10
35735720804,35735720806,2,1565,1566,-10
35739382346,35739382349,3,909,1700,-10
35739569846,35739569853,7,1916,1316,-10
35740611744,35740611741,-3,1277,3106,-10
35741224539,35741224522,-17,1018,824,-10
35741936390,35741936390,0,1508,2424,-10
35744648445,35744648449,4,1794,1487,-10
35745535155,35745535158,3,1754,1758,-10
35752115162,35752115163,1,1699,1382,-10
35754331380,35754331382,2,1047,1523,-10
35755996730,35755996733,3,1671,1316,-10
35756624334,35756624329,-5,1199,6104,-10
35758162801,35758162803,2,1799,2075,-10
35759868093,35759868095,2,1572,1245,-10
35760261273,35760261274,1,1884,1759,-10
35761422222,35761422226,4,892,1153,-10
35762868034,35762868034,0,2501,1975,-10
35765341370,35765341374,4,1808,1331,-10
35767208365,35767208368,3,1565,1168,-10
35769641782,35769641782,0,1999,1511,-10
35771857184,35771857185,1,967,1475,-10
35779521829,35779521831,2,1387,1907,-10
35779834192,35779834191,-1,1382,1534,-10
35786383209,35786383210,1,1757,1319,-10
35787489243,35787489245,2,1356,1620,-10
35788708404,35788708407,3,1023,900,-10
35789979857,35789979857,0,1132,2348,-10
35792064977,35792064979,2,1245,1950,-10
35793363521,35793363522,1,1617,1461,-10
35796127689,35796127699,10,7697,36047,-10
35796574602,35796574604,2,2228,1366,-10
35797294207,35797294209,2,1372,1185,-10
35797658522,35797658525,3,1887,1591,-10
35798650122,35798650122,0,2637,2675,-10
35801641964,35801641965,1,1784,991,-10
35801866945,35801866948,3,1819,1292,-10
35803448863,35803448865,2,1454,1964,-10
35804736185,35804736185,0,1816,1413,-10
35805316354,35805316357,3,1168,1472,-10
35808824539,35808824541,2,1713,1587,-10
35810071329,35810071325,-4,1770,5256,-10
35812184280,35812184281,1,2155,1771,-10
35812966019,35812966020,1,1423,1656,-10
35815524354,35815524356,2,1609,1490,-10
35817349082,35817349085,3,1630,1104,-10
35818338425,35818338428,3,1477,1396,-10
35822510779,35822510780,1,1662,1489,-10
35823689325,35823689327,2,1426,1604,-10
35825488014,35825488013,-1,1412,1472,-10
35827285046,35827285047,1,1983,1869,-10
35828354685,35828354685,0,1680,1869,-10
35834787817,35834787819,2,994,1656,-10
35836272212,35836272216,4,1269,1106,-10
35838184170,35838184168,-2,854,1831,-10
35839685584,35839685589,5,2858,1372,-10
35840941711,35840941712,1,1316,1864,-10
35841744416,35841744418,2,1224,1058,-10
35842492050,35842492051,1,1593,2022,-10
35846799704,35846799710,6,2333,1370,-10
35852072956,35852072957,1,2328,2043,-10
35853264668,35853264668,0,1521,999,-10
35854140700,35854140703,3,2243,1821,-10
35857280367,35857280366,-1,1637,1679,-10
35857506282,35857506285,3,1653,1779,-10
35860136406,35860136407,1,1132,1212,-10
35860950366,35860950367,1,1414,1311,-10
35861957674,35861957675,1,1767,1967,-10
35862875819,35862875822,3,1012,1230,-10
35865315525,35865315526,1,1651,2179,-10
35867060778,35867060779,1,1079,1005,-10
35872918563,35872918563,0,2214,1487,-10
35873014229,35873014230,1,1652,1216,-10
35874419742,35874419743,1,1660,1334,-10
35881184955,35881184955,0,1356,1136,-10
35882244815,35882244813,-2,1565,1932,-10
35886023890,35886023892,2,2405,2545,-10
35891634587,35891634589,2,948,1208,-10
35893017887,35893017887,0,865,855,-10
35896267685,35896267686,1,1363,1728,-10
35902933214,35902933214,0,1776,1390,-10
35903640773,35903640772,-1,1379,2674,-10
35904082283,35904082287,4,1440,1231,-10
35904810062,35904810065,3,2962,1475,-10
35905848691,35905848694,3,1457,1285,-10
35907101454,35907101455,1,1928,1537,-10
35907970190,35907970193,3,1602,1660,-10
35908029183,35908029163,-20,1093,621,-10
35915704750,35915704752,2,1699,1688,-10
35916666942,35916666943,1,1481,1812,-10
35919608418,35919608418,0,1539,1719,-10
35922853486,35922853478,-8,1519,9424,-10
35923536702,35923536699,-3,1058,2444,-10
35926469951,35926469951,0,1062,1366,-10
35928608942,35928608944,2,1977,1992,-10
35931633419,35931633421,2,1319,1087,-10
35932676605,35932676607,2,2438,2354,-10
35934511913,35934511914,1,1319,1591,-10
35938207527,35938207530,3,1391,1830,-10
35940036504,35940036510,6,2888,1366,-10
35940167225,35940167229,4,4312,3007,-10
35943440881,35943440883,2,1469,1551,-10
35943836781,35943836782,1,1595,1502,-10
35943979714,35943979717,3,1731,1440,-10
35944605335,35944605336,1,1948,2202,-10
35945180522,35945180522,0,925,780,-10
35953138862,35953138862,0,774,1151,-10
35957007040,35957007043,3,1408,1696,-10
35957570807,35957570810,3,1977,1759,-10
35966198393,35966198395,2,1604,858,-10
35967475614,35967475615,1,1684,1285,-10
35971590290,35971590295,5,1793,1787,-10
35973375503,35973375501,-2,1206,3099,-10
35975177748,35975177751,3,1342,1429,-10
35981918770,35981918774,4,1890,1461,-10
35982078847,35982078850,3,1899,1762,-10
35982108260,35982108261,1,1545,1815,-10
35982338174,35982338174,0,1635,963,-10
35984475693,35984475694,1,1784,1662,-10
35985276150,35985276152,2,2109,2227,-10
35985682028,35985682046,18,638,1447,-10
35986179373,35986179377,4,1105,1490,-10
35988554393,35988554393,0,1564,1810,-10
35990089451,35990089455,4,2412,1610,-10
35990712069,35990712071,2,1196,980,-10
35993960370,35993960374,4,2351,2207,-10
35994426835,35994426838,3,2057,1920,-10
35996807363,35996807366,3,2015,1705,-10
36001381088,36001381090,2,1989,1585,-10
36003186784,36003186786,2,1563,1896,-10
36006140202,36006140203,1,1090,1074,-10
36010134558,36010134559,1,797,836,-10
36010930777,36010930782,5,3063,1481,-10
36013204523,36013204525,2,1504,1138,-10
36015439268,36015439271,3,1954,1759,-10
36017824666,36017824670,4,1539,1228,-10
36018643379,36018643382,3,1990,1475,-10
36023169437,36023169439,2,1577,1277,-10
36024401914,36024401920,6,2492,1277,-10
36026560396,36026560398,2,1494,1116,-10
36027343739,36027343721,-18,1460,1826,-10
36029763571,36029763572,1,1768,1707,-10
36031014729,36031014729,0,1865,1851,-10
36032059655,36032059656,1,1577,2252,-10
36033061966,36033061968,2,1227,1471,-10
36033761077,36033761075,-2,1187,1385,-10
36034390348,36034390355,7,3211,1196,-10
36034564522,36034564523,1,1523,1735,-10
36035385510,36035385511,1,1601,1579,-10
36035447957,36035447957,0,1489,1181,-10
36035495860,36035495860,0,1645,1497,-10
36035926367,36035926348,-19,1048,1002,-10
36036918459,36036918461,2,1921,1609,-10
36038424375,36038424367,-8,2141,7481,-10
36039657540,36039657542,2,2033,2072,-10
36040146058,36040146061,3,1949,2116,-10
36042495718,36042495716,-2,1296,2106,-10
36043889577,36043889585,8,3631,1889,-10
36045135477,36045135478,1,1337,1307,-10
36045858612,36045858615,3,1644,1619,-10
36049757622,36049757622,0,1643,1539,-10
36052277386,36052277391,5,6174,24307,-10
36053382380,36053382379,-1,1389,1653,-10
36053516942,36053516942,0,1576,1490,-10
36053754793,36053754794,1,1650,1771,-10
36053839673,36053839676,3,1315,1167,-10
36055765005,36055765007,2,1601,1678,-10
36055929009,36055929006,-3,2085,4335,-10
36055988228,36055988227,-1,2362,2089,-10
36059100639,36059100642,3,1689,1170,-10
36068593838,36068593841,3,1124,1055,-10
36072008425,36072008426,1,1437,1563,-10
36073327330,36073327330,0,1403,1054,-10
36074109750,36074109746,-4,1515,5634,-10
36074276658,36074276662,4,1569,1503,-10
36076459503,36076459505,2,1690,2308,-10
36077056303,36077056306,3,980,850,-10
36079171602,36079171605,3,1281,1942,-10
36079222775,36079222795,20,1003,1481,-10
36080500059,36080500061,2,1157,1796,-10
36082341371,36082341370,-1,1339,1167,-10
36084110610,36084110614,4,1502,1597,-10
36085518834,36085518834,0,1988,1375,-10
36088614666,36088614666,0,1499,1160,-10
36092135729,36092135731,2,1651,1282,-10
36097471441,36097471442,1,1357,1272,-10
36100958875,36100958877,2,1721,1656,-10
36102277898,36102277898,0,1375,1659,-10
36104408010,36104408009,-1,1717,1295,-10
36106496203,36106496202,-1,1541,1371,-10
36112507215,36112507218,3,1388,1425,-10
36114445086,36114445087,1,1521,1527,-10
36122633930,36122633932,2,1896,1657,-10
36126245074,36126245074,0,2178,2171,-10
36128378673,36128378674,1,1818,1904,-10
36128561606,36128561606,0,1687,2024,-10
36131865550,36131865551,1,1436,1270,-10
36131961705,36131961708,3,1990,1760,-10
36132782160,36132782164,4,1731,1562,-10
36133164861,36133164840,-21,1761,1895,-10
36134204737,36134204737,0,1353,1385,-10
36137567639,36137567639,0,1477,1636,-10
36142205734,36142205732,-2,1326,2300,-10
36151026357,36151026359,2,1813,1667,-10
36152391370,36152391375,5,1304,1282,-10
36152533954,36152533954,0,1272,1810,-10
36155472418,36155472420,2,1524,1474,-10
36157624278,36157624281,3,1910,1960,-10
36160787654,36160787656,2,2446,1861,-10
36161279797,36161279801,4,17598,35262,-10
36161498360,36161498362,2,1679,1784,-10
36162943817,36162943818,1,1954,1749,-10
36163074062,36163074067,5,1648,1416,-10
36163583557,36163583559,2,1465,2037,-10
36164881163,36164881165,2,1532,1169,-10
36165006475,36165006475,0,1369,1384,-10
36169183778,36169183781,3,611,1249,-10
36170248907,36170248909,2,1563,1313,-10
36171293383,36171293383,0,1370,1338,-10
36174524376,36174524377,1,1162,972,-10
36175531972,36175531974,2,2543,1919,-10
36175944132,36175944132,0,1069,1821,-10
36176561520,36176561535,15,909,1652,-10
36178015513,36178015515,2,1686,1662,-10
36184234105,36184234106,1,1817,1653,-10
36185594767,36185594769,2,1954,1469,-10
36190030026,36190030026,0,2141,1677,-10
36190351298,36190351301,3,1546,1279,-10
36190381725,36190381724,-1,1422,2207,-10
36193576671,36193576673,2,1543,1425,-10
36199133546,36199133548,2,1956,2005,-10
36201787757,36201787760,3,1307,1170,-10
36203904302,36203904306,4,1664,1403,-10
36209116393,36209116393,0,1642,2145,-10
36211783672,36211783674,2,1686,1454,-10
36212156690,36212156690,0,1731,1370,-10
36217656723,36217656724,1,1386,1347,-10
36219911423,36219911430,7,2356,1271,-10
36220665433,36220665414,-19,1380,1731,-10
36222056502,36222056502,0,1705,1759,-10
36222684959,36222684961,2,818,1492,-10
36226988313,36226988318,5,2105,1311,-10
36228214068,36228214068,0,1004,979,-10
36239089033,36239089033,0,1049,1190,-10
36239815846,36239815845,-1,1658,1702,-10
36241982291,36241982290,-1,940,1697,-10
36244664454,36244664454,0,1485,1587,-10
36247390393,36247390395,2,2240,2156,-10
36249704425,36249704427,2,1333,1339,-10
36251872061,36251872061,0,1464,1416,-10
36252282022,36252282024,2,1593,1426,-10
36252529740,36252529743,3,2916,1973,-10
36252633199,36252633201,2,1134,1532,-10
36253269489,36253269495,6,1540,1145,-10
36256080167,36256080169,2,1542,1750,-10
36257361399,36257361401,2,847,1174,-10
36257794642,36257794660,18,1250,1674,-10
36264182313,36264182309,-4,1167,2796,-10
36264386104,36264386105,1,1471,1536,-10
36264800094,36264800105,11,1550,1465,-10
36265563441,36265563442,1,1355,1242,-10
36266728142,36266728141,-1,2372,2167,-10
36268591778,36268591781,3,1957,1691,-10
36270129217,36270129221,4,2210,1472,-10
36274215687,36274215695,8,5219,1430,-10
36276337175,36276337177,2,1265,1108,-10
36276707087,36276707090,3,1155,946,-10
36277836549,36277836532,-17,815,217,-10
36278865912,36278865916,4,3096,2172,-10
36280224367,36280224352,-15,31624,18256,-10
36285897646,36285897630,-16,4404,2031,-10
36285931009,36285931024,15,1397,1160,-10
36286546737,36286546739,2,1733,1163,-10
36287140830,36287140830,0,988,1517,-10
36288872933,36288872935,2,1413,1637,-10
36293528795,36293528797,2,1304,1176,-10
36293613112,36293613115,3,1248,1375,-10
36295440859,36295440861,2,1655,1703,-10
36298821876,36298821877,1,916,1379,-10
36300819202,36300819205,3,1412,1454,-10
36302062735,36302062739,4,1787,1201,-10
36303186075,36303186078,3,1563,1620,-10
36305803265,36305803266,1,1176,1196,-10
36310907740,36310907741,1,1174,1360,-10
36311718882,36311718883,1,1391,925,-10
36313277815,36313277818,3,1366,1848,-10
36314579230,36314579231,1,1493,1293,-10
36315840381,36315840383,2,2116,1454,-10
36317477281,36317477283,2,1416,1442,-10
36317596105,36317596107,2,1973,2011,-10
36318721650,36318721655,5,1797,1214,-10
36321684666,36321684667,1,1615,1136,-10
36321963215,36321963216,1,1393,1282,-10
36322555074,36322555083,9,1086,959,-10
36322797223,36322797223,0,1370,1257,-10
36326511962,36326511965,3,1808,1463,-10
36330424807,36330424809,2,1354,1516,-10
36330525798,36330525801,3,2219,2035,-10
36332664914,36332664918,4,1640,1250,-10
36336125928,36336125911,-17,31,1103,-10
36340873426,36340873426,0,565,1355,-10
36342400973,36342400973,0,1522,1239,-10
36348723643,36348723644,1,1014,1570,-10
36350145712,36350145715,3,2269,2045,-10
36351448097,36351448100,3,2213,1384,-10
36354406418,36354406422,4,1333,1549,-10
36359314666,36359314669,3,1349,1636,-10
36366957998,36366957998,0,749,1607,-10
36367145023,36367145030,7,3477,1746,-10
36368882404,36368882405,1,1641,1595,-10
36373184858,36373184857,-1,1380,1684,-10
36373631075,36373631082,7,2773,1214,-10
36374036562,36374036563,1,2128,2073,-10
36374959973,36374959975,2,1437,1149,-10
36375393271,36375393274,3,2210,1771,-10
36375560018,36375560018,0,886,1504,-10
36377059509,36377059512,3,2292,2095,-10
36381432627,36381432628,1,2259,2008,-10
36381636789,36381636790,1,1701,1878,-10
36382004815,36382004819,4,1991,1506,-10
36382363250,36382363248,-2,762,1026,-10
36385191986,36385191989,3,1759,1733,-10
36386463486,36386463486,0,1408,1516,-10
36388872795,36388872798,3,1683,1664,-10
36393178920,36393178921,1,1174,1224,-10
36393209720,36393209721,1,1320,1084,-10
36395554277,36395554278,1,2245,1727,-10
36396057446,36396057445,-1,1184,1551,-10
36396698111,36396698114,3,1695,1361,-10
36400707004,36400707006,2,1325,1608,-10
36401105289,36401105291,2,1394,1394,-10
36401862102,36401862105,3,1856,1375,-10
36402871986,36402871987,1,2321,1844,-10
36403834086,36403834086,0,1347,1458,-10
36405273930,36405273932,2,1112,1697,-10
36406227010,36406227013,3,1779,1672,-10
36407155367,36407155369,2,1644,1633,-10
36408519771,36408519776,5,2097,1638,-10
36410208748,36410208749,1,1607,2114,-10
36412165177,36412165178,1,2090,1517,-10
36414058818,36414058803,-15,13908,31127,-10
36417353633,36417353633,0,1176,1648,-10
36423086630,36423086641,11,1022,846,-10
36425020505,36425020506,1,1316,1456,-10
36425384291,36425384295,4,1276,1575,-10
36428811323,36428811325,2,1611,1509,-10
36429266287,36429266289,2,1730,1673,-10
36429580834,36429580841,7,3485,1225,-10
36430790965,36430790967,2,1780,1296,-10
36430949401,36430949404,3,928,1388,-10
36433252294,36433252295,1,1048,999,-10
36433769058,36433769058,0,1595,1250,-10
36435557002,36435557002,0,1291,1538,-10
36436233470,36436233470,0,2138,2258,-10
36436506146,36436506147,1,1797,1304,-10
36437604881,36437604874,-7,1972,9131,-10
36441191982,36441191982,0,1635,1578,-10
36443311025,36443311033,8,14587,19434,-10
36444633913,36444633915,2,1430,1168,-10
36446690583,36446690584,1,1778,1576,-10
36446855115,36446855117,2,2106,1631,-10
36449266982,36449266982,0,1116,1356,-10
36451080134,36451080135,1,2253,2957,-10
36452703647,36452703650,3,2242,2559,-10
36454149366,36454149365,-1,1546,2593,-10
36457001722,36457001722,0,1400,1387,-10
36459715414,36459715416,2,1830,1337,-10
36460579941,36460579942,1,1380,1201,-10
36462539034,36462539036,2,1283,1393,-10
36463571622,36463571619,-3,3520,9834,-10
36467471786,36467471786,0,2571,2327,-10
36467608231,36467608233,2,1697,1531,-10
36468880458,36468880458,0,1370,1227,-10
36470821606,36470821606,0,1084,1774,-10
36471127924,36471127924,0,1753,1722,-10
36471391938,36471391939,1,1860,1503,-10
36474785133,36474785134,1,1412,1437,-10
36477702623,36477702626,3,1985,2296,-10
36478865170,36478865174,4,6275,31700,-10
36480605051,36480605054,3,2237,2044,-10
36482127750,36482127753,3,1783,1493,-10
36483322357,36483322358,1,1988,1310,-10
36483665621,36483665622,1,34082,43511,-10
36485079075,36485079078,3,1770,2104,-10
36487640834,36487640841,7,2342,1221,-10
36487752864,36487752865,1,1259,1880,-10
36490299905,36490299906,1,1511,1230,-10
36492058561,36492058562,1,1256,1554,-10
36493956170,36493956171,1,1365,1836,-10
36495362256,36495362258,2,2135,1669,-10
36501988929,36501988934,5,2462,1679,-10
36504260670,36504260674,4,1596,1571,-10
36505161686,36505161679,-7,1204,4619,-10
36505485333,36505485335,2,1594,879,-10
36508395818,36508395818,0,1323,1708,-10
36511552407,36511552411,4,1568,1576,-10
36513991499,36513991501,2,1836,1615,-10
36514150410,36514150412,2,1205,1929,-10
36515347001,36515347004,3,1848,1300,-10
36522025165,36522025166,1,1890,1955,-10
36525094318,36525094320,2,1173,1151,-10
36529045238,36529045242,4,1390,1060,-10
36529821119,36529821114,-5,971,4574,-10
36531410429,36531410430,1,2156,1866,-10
36537149576,36537149580,4,1644,1192,-10
36540000087,36540000091,4,872,836,-10
36547944373,36547944375,2,2107,1605,-10
36548678370,36548678371,1,2355,2087,-10
36550515718,36550515711,-7,1024,6368,-10
36552905199,36552905203,4,1358,1508,-10
36554454067,36554454070,3,1956,2741,-10
36557824877,36557824881,4,1565,1480,-10
36560471707,36560471711,4,1795,1344,-10
36560869206,36560869206,0,1333,1509,-10
36561038830,36561038809,-21,1760,1449,-10
36567107063,36567107064,1,1098,1525,-10
36567912755,36567912757,2,13132,10716,-10
36570662296,36570662297,1,1639,1484,-10
36573052686,36573052688,2,1903,1826,-10
36575107475,36575107482,7,3088,1137,-10
36576078116,36576078119,3,1958,1750,-10
36577186766,36577186767,1,1650,1682,-10
36578429077,36578429082,5,1052,1632,-10
36582216057,36582216058,1,1560,1815,-10
36589300630,36589300634,4,2004,1324,-10
36590528494,36590528494,0,1905,2004,-10
36596809648,36596809652,4,1129,836,-10
36598426089,36598426091,2,1876,2040,-10
36600946494,36600946506,12,1414,1202,-10
36601107183,36601107185,2,1553,1523,-10
36603897476,36603897481,5,1728,1494,-10
36605342493,36605342494,1,1666,1904,-10
36606663442,36606663445,3,1318,1834,-10
36607632391,36607632390,-1,1167,1094,-10
36609126441,36609126463,22,407,481,-10
36609463073,36609463076,3,1171,1697,-10
36612695262,36612695263,1,1350,1347,-10
36613224283,36613224286,3,1213,2107,-10
36614169122,36614169121,-1,2119,2367,-10
36616714893,36616714895,2,1091,1499,-10
36618992456,36618992462,6,2689,1175,-10
36620249353,36620249354,1,1355,1440,-10
36620826154,36620826155,1,1564,1303,-10
36621407810,36621407811,1,1071,691,-10
36624568824,36624568828,4,1187,2090,-10
36626195442,36626195445,3,1734,1606,-10
36626308134,36626308134,0,899,827,-10
36630683846,36630683847,1,1103,1266,-10
36634804079,36634804082,3,487,740,-10
36636695625,36636695621,-4,1999,4146,-10
36637179189,36637179189,0,1217,1354,-10
36642165535,36642165554,19,1245,1386,-10
36643603998,36643603999,1,1753,1597,-10
36644729943,36644729944,1,1500,2052,-10
36646508710,36646508713,3,2256,1922,-10
36647212437,36647212438,1,1163,1821,-10
36648512306,36648512306,0,1908,1968,-10
36650134982,36650134986,4,1627,1131,-10
36650959146,36650959141,-5,1231,3808,-10
36652945661,36652945667,6,2143,1475,-10
36653932022,36653932022,0,1083,1214,-10
36654443736,36654443738,2,1218,1937,-10
36655640975,36655640977,2,1921,1769,-10
36656509465,36656509466,1,879,1052,-10
36664099363,36664099365,2,1456,1712,-10
36666747741,36666747738,-3,1688,5733,-10
36666914431,36666914433,2,1682,1294,-10
36667531109,36667531114,5,7608,4544,-10
36668754859,36668754861,2,905,1364,-10
36669097315,36669097310,-5,787,1073,-10
36671350081,36671350081,0,1884,2648,-10
36671524307,36671524307,0,1021,800,-10
36671797458,36671797467,9,11813,28321,-10
36672463991,36672463988,-3,879,4034,-10
36677556976,36677556978,2,1897,1876,-10
36682848266,36682848268,2,1331,1394,-10
36684036815,36684036817,2,1050,1596,-10
36687975481,36687975482,1,1229,1656,-10
36689222519,36689222520,1,1268,1874,-10
36689920094,36689920099,5,2082,1070,-10
36690850646,36690850638,-8,3080,13031,-10
36691252108,36691252115,7,4346,953,-10
36691762388,36691762389,1,1479,2032,-10
36693271475,36693271478,3,1553,1287,-10
36693776830,36693776830,0,2417,1749,-10
36693842918,36693842921,3,1697,1877,-10
36696233494,36696233497,3,1413,945,-10
36697182290,36697182291,1,1326,1108,-10
36698370558,36698370560,2,1770,1984,-10
36698446094,36698446097,3,1911,2048,-10
36703367742,36703367743,1,1844,1488,-10
36704774309,36704774309,0,1393,1545,-10
36705806989,36705806989,0,1633,1941,-10
36707151694,36707151698,4,1306,1101,-10
36708961158,36708961159,1,1437,1098,-10
36711213472,36711213475,3,913,937,-10
36712130523,36712130539,16,1632,1453,-10
36715610963,36715610966,3,1244,1445,-10
36717604651,36717604655,4,1357,1330,-10
36718316585,36718316588,3,1597,1567,-10
36722746100,36722746099,-1,1599,1244,-10
36723198087,36723198088,1,1406,1460,-10
36723626852,36723626854,2,1255,1016,-10
36725910729,36725910733,4,1363,1344,-10
36728247465,36728247466,1,25412,89438,-10
36731089603,36731089603,0,1432,1201,-10
36731230061,36731230062,1,1685,1835,-10
36732223433,36732223430,-3,1171,2398,-10
36733552189,36733552190,1,1202,1489,-10
36733944773,36733944773,0,1523,1400,-10
36737057247,36737057247,0,1087,1204,-10
36738066431,36738066433,2,1702,1546,-10
36742187157,36742187158,1,1573,1549,-10
36742949622,36742949624,2,1689,1591,-10
36743530882,36743530890,8,18767,22671,-10
36743717092,36743717093,1,1615,1635,-10
36745751808,36745751806,-2,1917,2311,-10
36746476301,36746476302,1,1530,1445,-10
36752331280,36752331279,-1,1438,1459,-10
36754730546,36754730552,6,10615,36355,-10
36757858272,36757858275,3,1260,1135,-10
36760255019,36760255019,0,3016,4704,-10
36761127951,36761127953,2,1687,1487,-10
36764114312,36764114296,-16,1138,1166,-10
36764913119,36764913120,1,1564,1453,-10
36766118227,36766118208,-19,2143,1266,-10
36766316339,36766316342,3,1483,1422,-10
36767647757,36767647763,6,3253,960,-10
36768065817,36768065819,2,1749,1616,-10
36772232575,36772232578,3,1145,1391,-10
36774313826,36774313828,2,1789,1788,-10
36776290776,36776290774,-2,1638,1979,-10
36776903832,36776903832,0,1660,1336,-10
36777097631,36777097632,1,1481,1608,-10
36778633751,36778633757,6,1878,1661,-10
36780608769,36780608771,2,1498,1344,-10
36780887982,36780887964,-18,1424,677,-10
36783831854,36783831854,0,1565,1494,-10
36791092869,36791092872,3,1361,1800,-10
36792005120,36792005122,2,1735,1717,-10
36793410142,36793410142,0,1240,1292,-10
36794118630,36794118642,12,1207,1347,-10
36795502282,36795502288,6,1828,1161,-10
36796019049,36796019050,1,1730,1303,-10
36796384425,36796384427,2,1089,1003,-10
36796897064,36796897065,1,1613,1427,-10
36797317122,36797317109,-13,1583,1702,-10
36801793755,36801793757,2,1487,1498,-10
36804186235,36804186238,3,1888,1532,-10
36805753167,36805753169,2,1556,2377,-10
36806480529,36806480531,2,1281,1253,-10
36808787850,36808787853,3,1206,1644,-10
36812223482,36812223483,1,965,1001,-10
36816819073,36816819074,1,1838,1485,-10
36820350255,36820350256,1,2089,2581,-10
36820413421,36820413422,1,1445,1577,-10
36820439573,36820439576,3,2102,2047,-10
36824860039,36824860046,7,1782,1111,-10
36825695150,36825695151,1,1133,1301,-10
36826630995,36826630996,1,1952,1955,-10
36827476146,36827476147,1,2007,1852,-10
36837446162,36837446162,0,1687,1812,-10
36839154825,36839154827,2,1579,1982,-10
36842580365,36842580367,2,1286,1608,-10
36842627433,36842627427,-6,21750,15718,-10
36844550688,36844550693,5,1400,1288,-10
36845307766,36845307764,-2,1019,2865,-10
36849269544,36849269547,3,3122,2721,-10
36850372151,36850372147,-4,1903,5356,-10
36857015642,36857015643,1,1937,2231,-10
36857813546,36857813546,0,1427,1250,-10
36860082426,36860082428,2,1894,1318,-10
36861603070,36861603072,2,1251,2040,-10
36864288806,36864288810,4,1934,1839,-10
36869967924,36869967926,2,1828,1311,-10
36870029359,36870029336,-23,1202,748,-10
36874804646,36874804648,2,1421,1566,-10
36881343421,36881343428,7,6244,3186,-10
36881996992,36881996994,2,1622,1663,-10
36883278618,36883278617,-1,1461,2992,-10
36884884139,36884884142,3,1070,1218,-10
36885415231,36885415232,1,1642,1914,-10
36886706013,36886706014,1,1172,1116,-10
36888959621,36888959620,-1,738,878,-10
36890030354,36890030357,3,1458,1134,-10
36890258787,36890258788,1,1258,1753,-10
36892579767,36892579767,0,1040,1270,-10
36892734638,36892734640,2,1340,1669,-10
36896215424,36896215427,3,2015,1565,-10
36897273299,36897273277,-22,2201,2073,-10
36898670972,36898670973,1,2503,2323,-10
36900362978,36900362979,1,1394,1346,-10
36902170141,36902170142,1,1725,1928,-10
36902356299,36902356302,3,1549,1314,-10
36903126664,36903126666,2,1651,1495,-10
36903786100,36903786104,4,1254,886,-10
36904276722,36904276736,14,1680,1495,-10
36904835501,36904835498,-3,1229,2165,-10
36907920657,36907920661,4,2060,1273,-10
36909090029,36909090032,3,1499,1523,-10
36910020064,36910020046,-18,747,355,-10
36913193207,36913193203,-4,516,2486,-10
36915422692,36915422693,1,1587,1484,-10
36916855803,36916855805,2,1606,1868,-10
36917187227,36917187228,1,913,1069,-10
36921813602,36921813606,4,1363,990,-10
36924295531,36924295533,2,1494,1353,-10
36924982534,36924982532,-2,40994,21134,-10
36925979646,36925979648,2,1446,896,-10
36927873226,36927873230,4,1661,2081,-10
36928576366,36928576362,-4,1104,1673,-10
36930003761,36930003752,-9,561,1517,-10
36930354329,36930354331,2,1163,1644,-10
36930747518,36930747519,1,1764,1437,-10
36931422920,36931422922,2,2027,1509,-10
36931538254,36931538257,3,862,1337,-10
36933598648,36933598650,2,1372,1556,-10
36934539814,36934539813,-1,1302,1956,-10
36934984810,36934984815,5,2092,1438,-10
36936752446,36936752450,4,1575,1423,-10
36938553208,36938553209,1,1065,1192,-10
36940393018,36940393022,4,1605,1932,-10
36940709286,36940709290,4,2408,2071,-10
36941265281,36941265283,2,1441,1244,-10
36945338975,36945338975,0,1124,1433,-10
36945373273,36945373275,2,1699,1553,-10
36946468406,36946468409,3,1150,1276,-10
36952011442,36952011447,5,1843,1668,-10
36954517847,36954517849,2,1377,1655,-10
36954865918,36954865919,1,2306,2134,-10
36955421407,36955421401,-6,1048,6580,-10
36955684530,36955684533,3,1605,1643,-10
36955911574,36955911575,1,1520,1507,-10
36957176622,36957176624,2,2011,1772,-10
36960518370,36960518374,4,1684,2041,-10
36960673205,36960673209,4,1445,1799,-10
36962467859,36962467861,2,1338,1516,-10
36965977341,36965977342,1,1984,1909,-10
36966452881,36966452884,3,1501,1400,-10
36966680186,36966680187,1,1412,1499,-10
36974480754,36974480755,1,802,919,-10
36976990373,36976990374,1,1146,1588,-10
36980587514,36980587514,0,1429,1977,-10
36981110422,36981110430,8,5076,2028,-10
36981317156,36981317158,2,1269,1594,-10
36984294601,36984294599,-2,1525,2260,-10
36987572243,36987572247,4,1400,1481,-10
36989473147,36989473153,6,2390,1379,-10
36994885317,36994885318,1,1433,1666,-10
36995117442,36995117444,2,1476,1577,-10
36996706215,36996706216,1,1425,1642,-10
36997625606,36997625610,4,1861,1694,-10
37003513825,37003513829,4,1672,1210,-10
37006328839,37006328842,3,1704,1348,-10
37008863833,37008863836,3,1893,1267,-10
37008981210,37008981210,0,1759,1615,-10
37009677414,37009677426,12,982,754,-10
37010003861,37010003865,4,2397,1854,-10
37010925702,37010925702,0,1254,1447,-10
37013021093,37013021093,0,689,1642,-10
37014486664,37014486662,-2,1626,1721,-10
37016099111,37016099113,2,1582,1337,-10
37016850614,37016850618,4,2354,1276,-10
37018954754,37018954771,17,1301,1059,-10
37020600994,37020600996,2,1572,1279,-10
37025150753,37025150757,4,1564,1382,-10
37025391607,37025391609,2,859,1537,-10
37028798356,37028798358,2,1333,1287,-10
37028917467,37028917468,1,1803,1346,-10
37030059205,37030059207,2,1782,1486,-10
37031475708,37031475710,2,1657,1542,-10
37035131721,37035131723,2,1353,1549,-10
37039603696,37039603678,-18,1369,1344,-10
37042341043,37042341046,3,2315,2010,-10
37045398962,37045398962,0,1140,1907,-10
37045864015,37045864017,2,1558,1426,-10
37046340005,37046340007,2,950,1345,-10
37051544754,37051544742,-12,1941,1836,-10
37056442005,37056442007,2,1656,1662,-10
37058811967,37058811966,-1,1961,1992,-10
37060502707,37060502703,-4,1518,3141,-10
37061561390,37061561390,0,937,1459,-10
37062052930,37062052932,2,2464,2640,-10
37062264758,37062264759,1,1582,1629,-10
37063054650,37063054651,1,2312,1361,-10
37063124955,37063124961,6,3429,1424,-10
37064153594,37064153594,0,1544,1529,-10
37070717390,37070717393,3,1425,1408,-10
37071035727,37071035707,-20,729,1303,-10
37072843947,37072843949,2,1102,1344,-10
37076109074,37076109077,3,1312,1520,-10
37076480878,37076480877,-1,1245,2007,-10
37080159090,37080159091,1,1636,1547,-10
37083174306,37083174307,1,1267,1029,-10
37083582797,37083582797,0,901,997,-10
37084766415,37084766417,2,1887,1812,-10
37086230451,37086230457,6,1334,1294,-10
37089722292,37089722294,2,2075,1579,-10
37090047084,37090047086,2,1558,1752,-10
37090770210,37090770212,2,1440,1452,-10
37093495094,37093495094,0,1735,1663,-10
37095792746,37095792746,0,1459,1453,-10
37097139006,37097139008,2,2552,1911,-10
37099127062,37099127057,-5,1032,3331,-10
37099588623,37099588626,3,1617,1206,-10
37101241410,37101241411,1,1398,1104,-10
37101448423,37101448421,-2,1133,1854,-10
37106220393,37106220406,13,921,1135,-10
37107558919,37107558920,1,1307,921,-10
37112469763,37112469763,0,1080,1808,-10
37112918118,37112918121,3,1628,1427,-10
37115890112,37115890114,2,1636,1531,-10
37126338561,37126338564,3,1669,1271,-10
37127393094,37127393098,4,1829,1342,-10
37127800935,37127800939,4,1232,1083,-10
37127842693,37127842672,-21,1613,1283,-10
37134074256,37134074258,2,1485,1854,-10
37136990276,37136990277,1,1676,1830,-10
37141054618,37141054620,2,1469,1213,-10
37141168243,37141168246,3,1847,1144,-10
37141348570,37141348569,-1,1216,1090,-10
37144546971,37144546975,4,1860,1432,-10
37146466057,37146466058,1,1797,2167,-10
37146608862,37146608863,1,1149,2142,-10
37150290395,37150290394,-1,1601,1976,-10
37151182627,37151182630,3,1507,1262,-10
37151548756,37151548759,3,1924,1538,-10
37153235250,37153235251,1,793,1471,-10
37153747607,37153747611,4,1505,698,-10
37153914897,37153914918,21,1824,1523,-10
37154088311,37154088314,3,1949,1580,-10
37155260695,37155260697,2,1005,981,-10
37155983707,37155983698,-9,1744,1810,-10
37156886836,37156886838,2,1404,1278,-10
37160281187,37160281190,3,1182,1474,-10
37161176070,37161176074,4,1132,1271,-10
37162556765,37162556765,0,1326,1964,-10
37165796863,37165796869,6,955,1232,-10
37166878560,37166878562,2,1378,1751,-10
37168469192,37168469195,3,1575,1191,-10
37168906278,37168906257,-21,1220,565,-10
37174723315,37174723313,-2,850,1335,-10
37175990791,37175990789,-2,1176,2203,-10
37179505711,37179505714,3,1485,1109,-10
37182075316,37182075314,-2,1603,1953,-10
37182580395,37182580398,3,1494,1512,-10
37185176946,37185176947,1,1674,1533,-10
37185819063,37185819064,1,1302,1221,-10
37189645380,37189645379,-1,2149,1789,-10
37190708298,37190708301,3,1133,1265,-10
37190997510,37190997509,-1,1484,1979,-10
37192360773,37192360776,3,1908,1300,-10
37195051826,37195051827,1,1090,1167,-10
37195631979,37195631983,4,114,1030,-10
37203072294,37203072298,4,1399,1265,-10
37203767380,37203767382,2,1554,1332,-10
37204668066,37204668068,2,1172,1690,-10
37205562206,37205562205,-1,1556,1635,-10
37207745090,37207745090,0,1523,1604,-10
37211255893,37211255894,1,1795,1295,-10
37211536052,37211536053,1,1363,1422,-10
37211583114,37211583114,0,1581,1974,-10
37215881566,37215881571,5,2121,1112,-10
37219453113,37219453114,1,1207,1626,-10
37221721676,37221721673,-3,1687,1607,-10
37223248489,37223248490,1,1640,1399,-10
37224097050,37224097054,4,1492,1068,-10
37224630879,37224630881,2,1703,1687,-10
37227281372,37227281373,1,1413,1671,-10
37230695643,37230695647,4,990,1034,-10
37232840417,37232840419,2,1300,1378,-10
37233102808,37233102811,3,1441,1154,-10
37233511995,37233511996,1,1484,1466,-10
37234486987,37234486988,1,988,1127,-10
37235125558,37235125561,3,1585,1778,-10
37235155754,37235155754,0,1559,1479,-10
37235397059,37235397061,2,2227,1849,-10
37237051825,37237051831,6,3856,1782,-10
37241393199,37241393206,7,10762,25222,-10
37241516419,37241516417,-2,1525,3686,-10
37241764086,37241764084,-2,912,3070,-10
37242557940,37242557941,1,1581,986,-10
37245841060,37245841064,4,1662,1600,-10
37254398542,37254398542,0,994,1511,-10
37255714007,37255714008,1,1898,1847,-10
37260164755,37260164756,1,1566,1482,-10
37263663823,37263663826,3,1487,1161,-10
37263963275,37263963277,2,1269,1812,-10
37265671552,37265671553,1,1653,1781,-10
37270863214,37270863217,3,1679,1673,-10
37273496171,37273496173,2,2374,1445,-10
37276145113,37276145115,2,1271,1528,-10
37277194333,37277194336,3,1595,1765,-10
37278203077,37278203079,2,1372,908,-10
37279298658,37279298658,0,1406,1466,-10
37280834241,37280834243,2,1589,1390,-10
37286515466,37286515471,5,1814,1544,-10
37287478587,37287478589,2,1274,1906,-10
37288807238,37288807241,3,861,974,-10
37289780957,37289780961,4,1190,1430,-10
37292481373,37292481376,3,1520,1449,-10
37296669314,37296669316,2,1460,1082,-10
37296859182,37296859183,1,1537,1720,-10
37297692837,37297692843,6,2049,1384,-10
37298779055,37298779057,2,1330,1308,-10
37300490302,37300490304,2,1995,2335,-10
37301486475,37301486477,2,1206,1359,-10
37305721521,37305721523,2,1272,1175,-10
37306054496,37306054498,2,1427,1590,-10
37306116431,37306116429,-2,1552,1206,-10
37307711071,37307711072,1,1375,1417,-10
37308460450,37308460453,3,1525,1364,-10
37310067760,37310067764,4,6593,23657,-10
37310538154,37310538157,3,1670,1577,-10
37310589526,37310589530,4,1655,1608,-10
37311978333,37311978335,2,912,1086,-10
37312848825,37312848826,1,1979,1481,-10
37315094789,37315094792,3,1394,1687,-10
37317826174,37317826177,3,1869,1750,-10
37322499190,37322499192,2,2218,1891,-10
37323275182,37323275185,3,1650,1458,-10
37324034641,37324034642,1,1369,1323,-10
37324527007,37324527010,3,1677,2021,-10
37327489455,37327489456,1,1624,1352,-10
37327631928,37327631934,6,5397,3454,-10
37330339769,37330339772,3,1884,1149,-10
37331632105,37331632107,2,740,1450,-10
37331748529,37331748529,0,1482,1672,-10
37332738406,37332738409,3,1802,1715,-10
37333011403,37333011407,4,1946,1837,-10
37333648275,37333648278,3,1603,1501,-10
37334309164,37334309167,3,1880,1860,-10
37336381546,37336381547,1,1236,1399,-10
37336641371,37336641374,3,2584,1603,-10
37339895591,37339895594,3,2015,2335,-10
37341461050,37341461050,0,1700,1304,-10
37342377933,37342377937,4,1158,1410,-10
37344638516,37344638516,0,1768,1927,-10
37346148374,37346148379,5,1254,1563,-10
37346652588,37346652590,2,2080,1515,-10
37353763018,37353763020,2,1724,1865,-10
37354210546,37354210548,2,1133,899,-10
37359629226,37359629227,1,1157,1898,-10
37359846363,37359846363,0,1046,1815,-10
37361184903,37361184906,3,1479,1767,-10
37361782602,37361782604,2,1289,1453,-10
37362635900,37362635902,2,1358,1457,-10
37368185076,37368185079,3,1640,1872,-10
37369301662,37369301667,5,1576,1371,-10
37370345453,37370345452,-1,1734,2824,-10
37371674533,37371674534,1,1479,1729,-10
37374427565,37374427565,0,1332,1364,-10
37377253643,37377253643,0,1320,1180,-10
37379437590,37379437591,1,1294,1545,-10
37380058339,37380058339,0,1689,1908,-10
37381964721,37381964725,4,1695,1320,-10
37384015572,37384015572,0,2175,2963,-10
37384975379,37384975363,-16,1220,1160,-10
37386543555,37386543554,-1,1109,1757,-10
37387211142,37387211145,3,916,1248,-10
37392301031,37392301033,2,1491,1579,-10
37393798130,37393798130,0,1535,1628,-10
37395982435,37395982439,4,1519,1479,-10
37397468729,37397468731,2,1290,1567,-10
37398021830,37398021831,1,1466,1446,-10
37398687698,37398687699,1,1592,1851,-10
37406015580,37406015582,2,1274,1615,-10
37406500380,37406500383,3,1638,1600,-10
37409910782,37409910782,0,2069,2083,-10
37413951350,37413951353,3,997,1226,-10
37414933017,37414933018,1,1368,1374,-10
37416849522,37416849523,1,1441,1541,-10
37417896893,37417896894,1,1068,860,-10
37419174439,37419174441,2,1735,1716,-10
37420139507,37420139511,4,515,459,-10
37422581782,37422581783,1,1061,821,-10
37427127282,37427127282,0,1615,1335,-10
37429700163,37429700163,0,793,1355,-10
37433379487,37433379487,0,765,1411,-10
37433536638,37433536640,2,977,1013,-10
37438413151,37438413151,0,2892,2980,-10
37438795126,37438795127,1,2172,1471,-10
37439261290,37439261291,1,1250,1430,-10
37440478391,37440478391,0,984,1277,-10
37442713716,37442713717,1,2437,1910,-10
37444543801,37444543811,10,9017,37286,-10
37446325906,37446325907,1,1385,1671,-10
37452185926,37452185926,0,1181,1708,-10
37454528082,37454528083,1,1951,2069,-10
37457634109,37457634108,-1,1339,1853,-10
37458861077,37458861078,1,2094,1933,-10
37462949633,37462949637,4,1463,1511,-10
37463615237,37463615239,2,1736,1438,-10
37464083612,37464083613,1,1937,1823,-10
37464600398,37464600401,3,800,1560,-10
37468532834,37468532839,5,1875,1661,-10
37469446643,37469446646,3,977,1456,-10
37470335269,37470335269,0,1910,1307,-10
37471036191,37471036186,-5,965,2935,-10
37473741298,37473741294,-4,203,855,-10
37478291731,37478291733,2,1728,1457,-10
37478616714,37478616717,3,1549,1741,-10
37479670762,37479670763,1,1455,1615,-10
37480082692,37480082695,3,1519,1685,-10
37482211517,37482211516,-1,1485,1570,-10
37482415742,37482415746,4,1690,1530,-10
37482767665,37482767667,2,1096,739,-10
37487211618,37487211619,1,1573,1524,-10
37488708290,37488708293,3,1738,2020,-10
37490080777,37490080780,3,1153,1138,-10
37495858195,37495858197,2,1386,1816,-10
37495923238,37495923241,3,2056,1541,-10
37498953446,37498953428,-18,1785,1339,-10
37499357217,37499357218,1,973,1480,-10
37501247614,37501247609,-5,766,2588,-10
37501868132,37501868122,-10,1842,1568,-10
37504164866,37504164871,5,6685,18645,-10
37504853893,37504853894,1,1327,1478,-10
37505023862,37505023862,0,1456,1896,-10
37505740802,37505740805,3,1676,2114,-10
37507797041,37507797042,1,1655,2552,-10
37508042622,37508042625,3,1101,1606,-10
37508837494,37508837477,-17,620,317,-10
37509853411,37509853422,11,1306,1351,-10
37510140994,37510140996,2,1357,1626,-10
37511120383,37511120387,4,1049,1381,-10
37513128269,37513128269,0,1351,1604,-10
37513290645,37513290646,1,1499,1954,-10
37513353587,37513353586,-1,1338,511,-10
37513902248,37513902250,2,1371,1191,-10
37516850018,37516850021,3,1170,1645,-10
37518266484,37518266491,7,3227,1291,-10
37522237793,37522237795,2,1034,1470,-10
37523518987,37523518990,3,1799,1684,-10
37526199410,37526199412,2,1786,1674,-10
37528095151,37528095157,6,2753,1462,-10
37528739731,37528739730,-1,2189,3287,-10
37530090409,37530090410,1,2482,1899,-10
37530798123,37530798125,2,1300,1040,-10
37532892430,37532892430,0,1459,1487,-10
37535751887,37535751886,-1,1047,1650,-10
37537262600,37537262605,5,247,1453,-10
37537543615,37537543618,3,1905,1623,-10
37537811023,37537811001,-22,1074,410,-10
37538903285,37538903287,2,1855,1676,-10
37540253661,37540253662,1,1417,2529,-10
37540855075,37540855077,2,2084,1732,-10
37542565959,37542565963,4,1325,1066,-10
37545931453,37545931456,3,1307,1432,-10
37548820346,37548820349,3,1775,1499,-10
37549869678,37549869679,1,1554,1239,-10
37550439838,37550439840,2,1498,1649,-10
37550779047,37550779050,3,1644,1632,-10
37550977795,37550977780,-15,1118,1628,-10
37554935222,37554935223,1,1676,1726,-10
37557033095,37557033096,1,1243,990,-10
37557607812,37557607813,1,1404,1120,-10
37558573962,37558573962,0,979,711,-10
37562721141,37562721141,0,1386,1099,-10
37564092591,37564092595,4,1739,1345,-10
37567608153,37567608155,2,1706,1811,-10
37568297128,37568297126,-2,1214,2136,-10
37570022338,37570022340,2,1563,1624,-10
37570365578,37570365579,1,1120,1127,-10
37572531479,37572531478,-1,1087,1600,-10
37576274776,37576274778,2,1684,1689,-10
37576729536,37576729538,2,1549,1205,-10
37579123627,37579123629,2,1714,2292,-10
37583478702,37583478707,5,1330,1481,-10
37588658130,37588658149,19,714,956,-10
37595080095,37595080098,3,2127,1461,-10
37602087275,37602087252,-23,1869,1009,-10
37602918793,37602918796,3,3573,2164,-10
37605236917,37605236910,-7,33953,14632,-10
37608125964,37608125966,2,2144,1612,-10
37609735238,37609735241,3,1493,1113,-10
37613857174,37613857174,0,1222,1511,-10
37614882572,37614882573,1,1310,1218,-10
37619834834,37619834837,3,1551,1205,-10
37624063589,37624063587,-2,1455,2173,-10
37624120029,37624120031,2,2121,1202,-10
37627704546,37627704550,4,1465,1403,-10
37629948334,37629948335,1,1714,1548,-10
37633214678,37633214677,-1,1525,1588,-10
37633581011,37633581015,4,1958,1679,-10
37636088041,37636088041,0,1450,1371,-10
37638704245,37638704247,2,1221,1424,-10
37639895051,37639895053,2,1980,1695,-10
37643969397,37643969398,1,1507,1685,-10
37644151905,37644151906,1,1762,1288,-10
37644669343,37644669324,-19,1049,1220,-10
37645067254,37645067256,2,1933,1467,-10
37645401540,37645401542,2,1813,1984,-10
37647196110,37647196114,4,2112,1185,-10
37648488254,37648488257,3,1510,1590,-10
37649428165,37649428169,4,1091,1596,-10
37650444271,37650444274,3,1671,1634,-10
37654805870,37654805871,1,1715,1541,-10
37655764184,37655764186,2,1767,1847,-10
37659513730,37659513731,1,1227,1103,-10
37661406646,37661406649,3,1968,1783,-10
37662081876,37662081875,-1,840,600,-10
37664390692,37664390691,-1,1634,1889,-10
37665761926,37665761929,3,1494,2031,-10
37666077313,37666077302,-11,1290,1295,-10
37666894423,37666894425,2,1697,2113,-10
37667991743,37667991742,-1,1592,1524,-10
37668537031,37668537038,7,2039,1094,-10
37671079445,37671079446,1,1301,1467,-10
37672049228,37672049231,3,1459,1517,-10
37672113187,37672113187,0,1689,1651,-10
37674203774,37674203775,1,1659,1301,-10
37677615545,37677615538,-7,1264,8910,-10
37678057798,37678057801,3,1842,2074,-10
37678458855,37678458859,4,1079,931,-10
37680248277,37680248279,2,1452,1156,-10
37680438445,37680438438,-7,1034,1471,-10
37681132567,37681132569,2,1507,1026,-10
37683343454,37683343458,4,1968,1626,-10
37683848913,37683848915,2,1438,1050,-10
37685744399,37685744402,3,1344,1369,-10
37693468972,37693468994,22,5226,14953,-10
37694733599,37694733599,0,990,1824,-10
37695222078,37695222077,-1,1932,2401,-10
37696525306,37696525308,2,1369,1361,-10
37699880097,37699880100,3,1429,1498,-10
37700568386,37700568393,7,7402,2475,-10
37706379986,37706379987,1,1707,1418,-10
37708027482,37708027486,4,1995,1248,-10
37708425682,37708425686,4,1934,2145,-10
37709234253,37709234252,-1,1603,1433,-10
37712354477,37712354479,2,1979,1527,-10
37714491633,37714491634,1,2114,1660,-10
37716711266,37716711268,2,1664,2263,-10
37717134482,37717134490,8,3780,1119,-10
37717221754,37717221752,-2,1538,2466,-10
37719443054,37719443055,1,1242,1102,-10
37722645650,37722645651,1,1659,1333,-10
37727954878,37727954881,3,1585,1930,-10
37728093978,37728093982,4,1681,1414,-10
37730931797,37730931800,3,2418,1796,-10
37735026157,37735026156,-1,1738,1916,-10
37739212107,37739212109,2,2692,2030,-10
37741221952,37741221955,3,1674,1558,-10
37743848874,37743848878,4,2358,1440,-10
37744076602,37744076611,9,984,1020,-10
37744935371,37744935374,3,1348,987,-10
37747012602,37747012605,3,1561,1110,-10
37749775023,37749775027,4,1484,1335,-10
37750588222,37750588223,1,3096,2691,-10
37750638828,37750638830,2,1468,1623,-10
37755855418,37755855421,3,1290,1298,-10
37762506401,37762506400,-1,1399,2291,-10
37762745288,37762745290,2,2093,1465,-10
37764916806,37764916809,3,2162,2277,-10
37767514840,37767514842,2,1537,1693,-10
37769939886,37769939889,3,1592,1873,-10
37770316378,37770316381,3,1365,1560,-10
37779768383,37779768385,2,1319,1248,-10
37783025854,37783025858,4,1984,2162,-10
37783331117,37783331121,4,1464,1665,-10
37784753854,37784753857,3,1588,1416,-10
37787835738,37787835719,-19,1363,1777,-10
37789037298,37789037299,1,1780,2106,-10
37793720413,37793720421,8,9014,44033,-10
37795654497,37795654502,5,1844,1250,-10
37796015978,37796015978,0,1558,1498,-10
37796629075,37796629080,5,1536,1129,-10
37799894534,37799894536,2,1871,1882,-10
37801117771,37801117769,-2,3799,9491,-10
37801366532,37801366535,3,1370,1019,-10
37801797234,37801797238,4,1822,1349,-10
37804238418,37804238426,8,5029,1270,-10
37804495494,37804495495,1,1135,1299,-10
37807044081,37807044083,2,1201,1765,-10
37808893661,37808893661,0,2044,1720,-10
37810100921,37810100923,2,2049,3098,-10
37810457346,37810457350,4,1436,1315,-10
37811091794,37811091801,7,2826,1231,-10
37812757388,37812757391,3,1376,1349,-10
37815525601,37815525602,1,1824,1853,-10
37817622314,37817622320,6,4394,2529,-10
37819985221,37819985222,1,2065,1845,-10
37823564530,37823564533,3,1379,1896,-10
37824591666,37824591666,0,1961,1708,-10
37825076777,37825076797,20,806,1000,-10
37825345084,37825345089,5,2103,1438,-10
37826736539,37826736539,0,633,826,-10
37827542494,37827542497,3,1327,1633,-10
37834381509,37834381509,0,1293,1914,-10
37835171281,37835171283,2,2164,1989,-10
37837535862,37837535863,1,1561,1406,-10
37837643601,37837643598,-3,1027,1927,-10
37838295623,37838295625,2,1629,1210,-10
37839613932,37839613935,3,2142,1470,-10
37841248081,37841248082,1,1449,1365,-10
37843958818,37843958813,-5,887,2482,-10
37847077362,37847077363,1,1282,1505,-10
37850074595,37850074596,1,1716,1205,-10
37853445517,37853445519,2,1270,1874,-10
37855147262,37855147261,-1,1997,1610,-10
37860802497,37860802499,2,1891,1306,-10
37861009843,37861009844,1,2059,2080,-10
37861881258,37861881259,1,2379,1933,-10
37862037138,37862037139,1,1173,1739,-10
37863288878,37863288879,1,1657,1562,-10
37864202425,37864202427,2,1468,1204,-10
37865032707,37865032705,-2,1258,2071,-10
37866802024,37866802021,-3,1218,1773,-10
37870194253,37870194255,2,1297,1374,-10
37872822462,37872822463,1,1332,2189,-10
37875686370,37875686371,1,851,730,-10
37886799081,37886799082,1,1295,1396,-10
37886960782,37886960785,3,966,1660,-10
37888185758,37888185759,1,1315,1177,-10
37890899230,37890899230,0,1322,829,-10
37892046186,37892046189,3,2099,2650,-10
37897148486,37897148488,2,1286,1321,-10
37899458918,37899458922,4,1875,1325,-10
37902276589,37902276589,0,1886,1846,-10
37902331589,37902331570,-19,1013,651,-10
37904276315,37904276314,-1,1913,1970,-10
37904482509,37904482509,0,1466,2050,-10
37908651225,37908651240,15,761,305,-10
37909107742,37909107743,1,1412,1420,-10
37911392084,37911392086,2,1699,1757,-10
37911802943,37911802942,-1,1864,2137,-10
37915894863,37915894865,2,985,1703,-10
37919684558,37919684561,3,1167,1310,-10
37930148134,37930148152,18,1803,1010,-10
37931476725,37931476728,3,1370,842,-10
37932722090,37932722091,1,1614,1521,-10
37934987522,37934987521,-1,1316,1412,-10
37938413685,37938413686,1,1266,2359,-10
37939675814,37939675817,3,2190,2108,-10
37941650992,37941650993,1,1619,1655,-10
37943928002,37943928002,0,1845,1348,-10
37945166993,37945166995,2,2491,1292,-10
37948434306,37948434307,1,1511,1023,-10
37954564389,37954564390,1,1826,1844,-10
37959975087,37959975087,0,1352,1065,-10
37960743819,37960743822,3,1355,1247,-10
37961568856,37961568857,1,1400,1631,-10
37963998599,37963998599,0,1373,1173,-10
37964054835,37964054835,0,1626,2144,-10
37967473088,37967473090,2,1569,1431,-10
37972117596,37972117598,2,1849,1886,-10
37973020607,37973020609,2,1190,1527,-10
37975505941,37975505937,-4,20448,48508,-10
37975816294,37975816294,0,1353,991,-10
37977349494,37977349499,5,1380,1379,-10
37981636790,37981636783,-7,1115,3872,-10
37988226925,37988226925,0,1354,1437,-10
37989460376,37989460377,1,1334,1588,-10
37992593636,37992593639,3,1413,1324,-10
37992952770,37992952770,0,1105,2172,-10
37994220812,37994220814,2,1804,2118,-10
37994745485,37994745486,1,929,824,-10
38001207880,38001207877,-3,1156,2503,-10
38004519961,38004519963,2,1272,1622,-10
38010950055,38010950055,0,1587,1288,-10
38013169576,38013169575,-1,3664,11761,-10
38013552888,38013552890,2,1196,1142,-10
38014585351,38014585351,0,766,1230,-10
38016556389,38016556394,5,2070,1461,-10
38017687303,38017687306,3,1071,1530,-10
38020179190,38020179191,1,1085,878,-10
38023058015,38023058019,4,1034,1294,-10
38023379252,38023379254,2,1553,1169,-10
38024037149,38024037150,1,1501,1238,-10
38027573084,38027573087,3,1574,1585,-10
38027926686,38027926687,1,1902,1998,-10
38028447242,38028447242,0,1416,1372,-10
38032993285,38032993286,1,1421,1510,-10
38035510848,38035510846,-2,948,1726,-10
38037418090,38037418094,4,1641,1498,-10
38037465846,38037465846,0,1424,1440,-10
38038255458,38038255458,0,1863,2508,-10
38038923602,38038923596,-6,1096,3962,-10
38041281838,38041281841,3,1503,1820,-10
38042210722,38042210725,3,1253,2468,-10
38044209714,38044209718,4,1503,1118,-10
38044365505,38044365507,2,1932,2072,-10
38048221266,38048221267,1,1564,1486,-10
38049113308,38049113310,2,1484,1225,-10
38055669161,38055669163,2,1372,1369,-10
38065637678,38065637679,1,1203,1447,-10
38066690442,38066690446,4,2583,1665,-10
38071124306,38071124309,3,1401,1837,-10
38075353791,38075353793,2,2120,1150,-10
38076286791,38076286791,0,1866,4340,-10
38076890430,38076890437,7,6912,2851,-10
38080920595,38080920598,3,1130,1338,-10
38082575753,38082575754,1,1480,1346,-10
38083579075,38083579075,0,1603,1415,-10
38084690325,38084690318,-7,1118,4974,-10
38085361586,38085361586,0,1755,1426,-10
38087141273,38087141274,1,1659,1127,-10
38089041101,38089041102,1,1641,1449,-10
38094778396,38094778401,5,2764,1724,-10
38097398668,38097398669,1,1419,1390,-10
38099372470,38099372471,1,2108,2200,-10
38099767562,38099767565,3,1269,1517,-10
38102241360,38102241362,2,1144,1413,-10
38103903107,38103903111,4,1611,2043,-10
38104428766,38104428767,1,1361,1747,-10
38105815115,38105815110,-5,948,3201,-10
38112348226,38112348228,2,2270,2220,-10
38116876723,38116876717,-6,36212,14242,-10
38117099170,38117099170,0,1280,1206,-10
38119351961,38119351965,4,2039,1777,-10
38120863248,38120863250,2,1191,1425,-10
38122806321,38122806319,-2,1179,1937,-10
38123462479,38123462481,2,1620,1520,-10
38124285535,38124285515,-20,728,995,-10
38130243025,38130243027,2,1300,1217,-10
38130373419,38130373433,14,109,1510,-10
38132355357,38132355359,2,1892,1292,-10
38134057989,38134057990,1,1222,1021,-10
38137703118,38137703118,0,1597,1813,-10
38138119701,38138119699,-2,1184,1530,-10
38140891020,38140891022,2,1282,1042,-10
38142340115,38142340117,2,1503,1317,-10
38143524693,38143524690,-3,1833,1165,-10
38145816110,38145816113,3,1532,1419,-10
38147317832,38147317833,1,2234,1784,-10
38149873641,38149873645,4,2122,1548,-10
38152516791,38152516794,3,1951,1302,-10
38158225159,38158225161,2,1610,1469,-10
38158530377,38158530383,6,1372,1370,-10
38159804361,38159804362,1,1848,2134,-10
38163212043,38163212037,-6,678,1409,-10
38165503848,38165503850,2,1514,964,-10
38166743556,38166743559,3,1186,1237,-10
38169551904,38169551906,2,1683,1055,-10
38172085898,38172085899,1,1256,1757,-10
38175245858,38175245850,-8,1380,9649,-10
38179617228,38179617231,3,1455,1745,-10
38180110522,38180110525,3,2286,1366,-10
38180654213,38180654214,1,1462,1452,-10
38181155680,38181155682,2,1575,1243,-10
38182755831,38182755835,4,1793,1035,-10
38187162559,38187162561,2,1031,1566,-10
38188895929,38188895931,2,1236,1493,-10
38190383422,38190383425,3,1678,1269,-10
38193068286,38193068287,1,822,1189,-10
38194530602,38194530605,3,999,1174,-10
38195189957,38195189960,3,1661,1528,-10
38195715189,38195715190,1,1476,1986,-10
38199235039,38199235042,3,1536,1664,-10
38200821085,38200821088,3,2175,1885,-10
38203935251,38203935253,2,1350,1563,-10
38204156869,38204156891,22,1926,1016,-10
38209416462,38209416457,-5,1891,6307,-10
38209943445,38209943447,2,2131,1945,-10
38210734583,38210734586,3,2474,1420,-10
38213169942,38213169945,3,1155,1066,-10
38215163715,38215163703,-12,1167,1420,-10
38216752773,38216752773,0,1371,1695,-10
38218371730,38218371730,0,1563,1814,-10
38218549745,38218549745,0,1505,1734,-10
38219366246,38219366247,1,1168,1783,-10
38222892022,38222892023,1,2048,1876,-10
38223533818,38223533819,1,1662,1477,-10
38224510733,38224510734,1,2252,1752,-10
38225053766,38225053770,4,2137,1384,-10
38227640859,38227640866,7,5592,1484,-10
38229065462,38229065462,0,1325,1279,-10
38231852627,38231852629,2,1459,1507,-10
38232462607,38232462609,2,1485,1032,-10
38232977761,38232977759,-2,1332,1885,-10
38236438350,38236438351,1,1085,1489,-10
38237475718,38237475717,-1,2241,1843,-10
38237719458,38237719458,0,1285,1483,-10
38239656656,38239656672,16,109,1114,-10
38239683967,38239683970,3,1119,1467,-10
38239910875,38239910891,16,1833,1003,-10
38241092355,38241092354,-1,1502,901,-10
38243812035,38243812035,0,2131,1947,-10
38244850952,38244850953,1,1533,1740,-10
38245718776,38245718775,-1,1541,2140,-10
38248727842,38248727846,4,1070,1191,-10
38251890231,38251890234,3,1513,1299,-10
38260849282,38260849285,3,2087,1634,-10
38262723758,38262723758,0,1357,1401,-10
38267419712,38267419711,-1,1327,2328,-10
38269833973,38269833975,2,2170,1670,-10
38272234067,38272234062,-5,1803,3862,-10
38272312795,38272312791,-4,1790,4502,-10
38272966845,38272966846,1,1555,1867,-10
38274149915,38274149918,3,1661,1582,-10
38275019094,38275019098,4,1936,1393,-10
38278382126,38278382130,4,824,1067,-10
38283003089,38283003091,2,1670,1294,-10
38284193964,38284193968,4,1711,1385,-10
38285584546,38285584547,1,2043,1950,-10
38288491913,38288491917,4,2076,1859,-10
38289726903,38289726912,9,12553,24736,-10
38290026170,38290026171,1,1345,1332,-10
38294618188,38294618189,1,1893,1782,-10
38297585289,38297585306,17,1638,1185,-10
38298692578,38298692583,5,926,901,-10
38301328444,38301328447,3,1374,1083,-10
38302094991,38302094994,3,1027,1334,-10
38302128399,38302128378,-21,1379,597,-10
38302166498,38302166499,1,1322,1017,-10
38305049375,38305049379,4,729,983,-10
38308286898,38308286902,4,2082,1757,-10
38312116088,38312116087,-1,1482,2686,-10
38312217654,38312217659,5,2262,3538,-10
38316702055,38316702058,3,1125,1435,-10
38320416002,38320416003,1,1604,1620,-10
38321459813,38321459813,0,1321,1635,-10
38324800782,38324800782,0,1070,1632,-10
38327105238,38327105241,3,1734,1602,-10
38327410112,38327410108,-4,1071,1405,-10
38329694657,38329694657,0,750,1545,-10
38330941873,38330941875,2,1922,1693,-10
38332694235,38332694236,1,918,976,-10
38334855841,38334855842,1,1538,1637,-10
38335262537,38335262533,-4,1414,3427,-10
38337996242,38337996244,2,2562,2256,-10
38340614043,38340614041,-2,1158,1376,-10
38341242677,38341242684,7,5769,2317,-10
38342070370,38342070374,4,3073,2430,-10
38343169282,38343169283,1,1573,1250,-10
38343832497,38343832498,1,1572,1254,-10
38343970329,38343970325,-4,2228,6105,-10
38349907689,38349907690,1,1249,844,-10
38351498414,38351498416,2,1528,1429,-10
38354062277,38354062276,-1,1102,1604,-10
38354789518,38354789521,3,1801,1202,-10
38356628585,38356628586,1,2041,1678,-10
38361653387,38361653386,-1,1442,1480,-10
38361837983,38361837987,4,1820,1208,-10
38363280927,38363280910,-17,533,396,-10
38366758991,38366758993,2,1287,1632,-10
38366950726,38366950729,3,2187,1692,-10
38368156131,38368156135,4,1146,1432,-10
38370296034,38370296038,4,3446,2150,-10
38370585103,38370585099,-4,805,2967,-10
38374353054,38374353057,3,1461,1692,-10
38376526570,38376526573,3,1643,1682,-10
38377022255,38377022257,2,1422,1827,-10
38377255789,38377255800,11,1776,1363,-10
38378017309,38378017311,2,1914,1472,-10
38378981100,38378981103,3,1392,1013,-10
38381473799,38381473802,3,1372,1451,-10
38383126495,38383126497,2,1412,1360,-10
38383347144,38383347147,3,1290,1185,-10
38388080474,38388080476,2,1334,1131,-10
38388178103,38388178082,-21,2142,1632,-10
38389313742,38389313740,-2,1452,1604,-10
38389853416,38389853417,1,1428,1646,-10
38393722225,38393722226,1,1222,1508,-10
38394385700,38394385699,-1,1309,1666,-10
38394763506,38394763506,0,1534,1235,-10
38400661719,38400661721,2,1691,1858,-10
38404317067,38404317070,3,1393,1245,-10
38406014308,38406014311,3,1658,1536,-10
38406483664,38406483666,2,1673,1306,-10
38406985936,38406985959,23,20738,1097,-10
38409490898,38409490899,1,1657,1117,-10
38412720138,38412720142,4,1600,1155,-10
38412872687,38412872687,0,572,588,-10
38412998522,38412998523,1,1478,2057,-10
38413666983,38413666983,0,1078,1228,-10
38417098246,38417098246,0,1331,1543,-10
38420675206,38420675208,2,1653,1517,-10
38422924685,38422924686,1,1061,1081,-10
38423974039,38423974043,4,2046,1819,-10
38427066926,38427066927,1,1408,1596,-10
38428406126,38428406128,2,1849,1731,-10
38430489525,38430489527,2,1700,1174,-10
38434607278,38434607279,1,1507,1344,-10
38435029706,38435029708,2,1730,1679,-10
38436183259,38436183262,3,1364,954,-10
38438293026,38438293027,1,1091,1029,-10
38439923062,38439923065,3,1726,1348,-10
38444899000,38444899003,3,1451,1386,-10
38446721196,38446721198,2,2286,1918,-10
38448564063,38448564066,3,1854,1118,-10
38448802466,38448802469,3,2133,2113,-10
38450858565,38450858567,2,2063,2214,-10
38452963088,38452963091,3,1880,1255,-10
38453546998,38453546999,1,1368,1892,-10
38454007230,38454007234,4,1417,1248,-10
38456311909,38456311911,2,1602,1678,-10
38456988979,38456988982,3,1285,1625,-10
38460686590,38460686592,2,1534,1635,-10
38461117186,38461117187,1,1502,1454,-10
38461720598,38461720602,4,1763,1891,-10
38462547381,38462547383,2,1037,1524,-10
38466876976,38466876978,2,1487,1810,-10
38467246311,38467246314,3,1181,1314,-10
38467553514,38467553509,-5,1203,3461,-10
38471442338,38471442331,-7,1049,3137,-10
38474840866,38474840869,3,1239,1245,-10
38475089213,38475089214,1,1820,1569,-10
38476882908,38476882910,2,1833,1498,-10
38478255105,38478255109,4,1768,2139,-10
38481522629,38481522630,1,2539,2301,-10
38482266291,38482266294,3,1974,1782,-10
38482402483,38482402486,3,1755,1907,-10
38482804836,38482804830,-6,2159,5214,-10
38483206777,38483206775,-2,830,2551,-10
38483442714,38483442717,3,1116,1293,-10
38483963749,38483963749,0,1619,1886,-10
38484452313,38484452315,2,1316,1457,-10
38485725610,38485725611,1,1459,1066,-10
38486949047,38486949050,3,1393,1200,-10
38487408526,38487408530,4,893,1609,-10
38492653501,38492653503,2,1500,1307,-10
38493562002,38493562006,4,1842,1720,-10
38498908936,38498908942,6,2482,1056,-10
38499677587,38499677584,-3,963,2449,-10
38501108633,38501108634,1,1687,1797,-10
38510008670,38510008671,1,1602,1706,-10
38514381761,38514381761,0,2190,2292,-10
38520450982,38520450984,2,2229,1913,-10
38522267902,38522267905,3,1131,1196,-10
38522595227,38522595227,0,1831,1305,-10
38525617109,38525617111,2,1577,2343,-10
38526476189,38526476190,1,1320,1300,-10
38527393367,38527393346,-21,1218,1505,-10
38529672205,38529672206,1,2323,1281,-10
38529723620,38529723622,2,1878,2317,-10
38529799885,38529799887,2,1762,1256,-10
38530185605,38530185588,-17,2575,1893,-10
38530316097,38530316098,1,1526,1874,-10
38535857904,38535857905,1,1387,1597,-10
38536572106,38536572106,0,1427,1402,-10
38536986137,38536986138,1,2289,1905,-10
38538911839,38538911841,2,1432,1537,-10
38539616005,38539616006,1,979,1293,-10
38540850117,38540850118,1,1684,2218,-10
38544857735,38544857743,8,1723,1382,-10
38545783469,38545783471,2,1714,1565,-10
38547786301,38547786304,3,1930,2131,-10
38550293551,38550293529,-22,544,503,-10
38551775846,38551775846,0,1176,1788,-10
38552679203,38552679206,3,2658,1240,-10
38552998812,38552998813,1,1485,1865,-10
38553159491,38553159493,2,1030,999,-10
38557725759,38557725758,-1,644,1439,-10
38559053545,38559053546,1,1583,1365,-10
38560566475,38560566474,-1,829,1200,-10
38562884666,38562884667,1,22110,23208,-10
38563627843,38563627844,1,1602,1386,-10
38566323657,38566323659,2,1481,1240,-10
38569376992,38569376993,1,1839,1830,-10
38569416703,38569416712,9,1319,1494,-10
38570555935,38570555937,2,1076,885,-10
38570884654,38570884650,-4,899,4020,-10
38575636831,38575636833,2,1161,2158,-10
38576325674,38576325675,1,1139,1568,-10
38577347976,38577347978,2,1681,1445,-10
38577659415,38577659393,-22,1928,2271,-10
38577778917,38577778918,1,1463,1788,-10
38579002521,38579002522,1,1381,2058,-10
38579332794,38579332795,1,1159,1098,-10
38580956242,38580956241,-1,1211,1535,-10
38583548830,38583548832,2,1806,1461,-10
38585450505,38585450505,0,1619,1744,-10
38589934891,38589934893,2,1430,1800,-10
38590460079,38590460079,0,1237,1925,-10
38590739697,38590739698,1,1469,995,-10
38591334838,38591334840,2,1735,1886,-10
38595871522,38595871522,0,1567,1299,-10
38597281213,38597281213,0,1622,2644,-10
38598568166,38598568169,3,1439,2041,-10
38601364351,38601364354,3,1275,1234,-10
38606539753,38606539754,1,2043,1356,-10
38607405605,38607405607,2,1299,1484,-10
38608329195,38608329197,2,1098,1018,-10
38608584746,38608584740,-6,1586,1837,-10
38611451602,38611451601,-1,1157,1688,-10
38612951350,38612951353,3,1798,1726,-10
38613430018,38613430020,2,2395,2221,-10
38614666763,38614666763,0,1652,1163,-10
38615307772,38615307774,2,1593,826,-10
38617013275,38617013280,5,1837,1456,-10
38618574585,38618574585,0,1760,1734,-10
38621737535,38621737537,2,2047,1681,-10
38625108251,38625108253,2,2121,1782,-10
38628476506,38628476509,3,2077,1409,-10
38629114054,38629114056,2,1332,1395,-10
38630751019,38630751020,1,2039,1616,-10
38630857532,38630857535,3,1517,1505,-10
38645330514,38645330517,3,1972,1723,-10
38650868057,38650868060,3,2283,2268,-10
38651043001,38651043004,3,904,1506,-10
38652249042,38652249047,5,5653,3856,-10
38654347497,38654347498,1,1637,1201,-10
38655305205,38655305202,-3,1358,2112,-10
38656000050,38656000052,2,1348,1810,-10
38656187797,38656187798,1,2083,1701,-10
38657455342,38657455331,-11,309,3530,-10
38657909881,38657909882,1,2315,1704,-10
38658233905,38658233909,4,1554,1533,-10
38658586401,38658586401,0,1630,2145,-10
38660180779,38660180780,1,1681,1514,-10
38660497022,38660497027,5,2268,880,-10
38662306265,38662306273,8,5155,1462,-10
38667045003,38667044999,-4,1926,6774,-10
38671773188,38671773190,2,1666,1631,-10
38677939984,38677939985,1,1045,1673,-10
38678143131,38678143146,15,877,1001,-10
38681487277,38681487278,1,1478,1573,-10
38684371366,38684371369,3,2070,1980,-10
38690093939,38690093941,2,1448,1271,-10
38690895061,38690895063,2,1948,1923,-10
38692000402,38692000403,1,996,974,-10
38692390191,38692390193,2,1534,1871,-10
38694801643,38694801642,-1,1527,1522,-10
38695304791,38695304795,4,1907,1891,-10
38695366557,38695366560,3,1403,1064,-10
38698519331,38698519334,3,1604,1395,-10
38700272874,38700272877,3,1459,2166,-10
38702146505,38702146497,-8,1160,1669,-10
38704291730,38704291730,0,1507,1707,-10
38704333148,38704333145,-3,1612,3567,-10
38704985422,38704985423,1,1208,1677,-10
38705667738,38705667735,-3,1099,3532,-10
38706035338,38706035339,1,2104,2152,-10
38709757586,38709757586,0,1184,1885,-10
38711884454,38711884458,4,1370,1404,-10
38716046717,38716046719,2,1355,1831,-10
38718256961,38718256961,0,1948,2232,-10
38720308818,38720308818,0,1734,2085,-10
38721998582,38721998585,3,1340,1515,-10
38722366172,38722366173,1,1430,1552,-10
38726083032,38726083034,2,9819,6665,-10
38731197070,38731197074,4,1212,992,-10
38731972863,38731972864,1,1571,2052,-10
38733795966,38733795967,1,1545,1899,-10
38734058895,38734058898,3,2284,1778,-10
38736052594,38736052597,3,2359,1425,-10
38741778574,38741778573,-1,4916,8986,-10
38743206583,38743206584,1,2339,2181,-10
38744291988,38744291990,2,1545,1549,-10
38749255958,38749255961,3,2634,1485,-10
38751317781,38751317783,2,1812,2136,-10
38751685103,38751685106,3,2445,1868,-10
38751938468,38751938474,6,2508,1564,-10
38754099266,38754099246,-20,1553,2088,-10
38755040172,38755040176,4,1897,1772,-10
38758928377,38758928378,1,1835,1773,-10
38760044305,38760044311,6,2868,1325,-10
38767118757,38767118759,2,1489,1488,-10
38768833949,38768833950,1,1591,1646,-10
38768925154,38768925158,4,1880,1563,-10
38769895770,38769895771,1,1337,958,-10
38771967514,38771967515,1,1121,992,-10
38774083670,38774083674,4,1874,1675,-10
38774123517,38774123519,2,1441,1782,-10
38775836877,38775836882,5,1756,1274,-10
38776157411,38776157414,3,2073,1241,-10
38776636645,38776636645,0,1091,1326,-10
38777449739,38777449732,-7,1062,892,-10
38780638538,38780638541,3,1962,1274,-10
38784357741,38784357742,1,1295,1105,-10
38790001600,38790001603,3,1467,1939,-10
38790656210,38790656212,2,1711,1651,-10
38791917161,38791917164,3,1697,1381,-10
38796850812,38796850813,1,1526,2051,-10
38798724466,38798724466,0,1788,1753,-10
38799512824,38799512826,2,1367,1675,-10
38800303133,38800303135,2,1936,1574,-10
38801915169,38801915174,5,1183,1158,-10
38808782584,38808782585,1,1498,1687,-10
38811883877,38811883877,0,1086,1676,-10
38813172647,38813172646,-1,2072,2073,-10
38817751273,38817751275,2,1313,1207,-10
38818374602,38818374600,-2,1548,2495,-10
38819992734,38819992735,1,2138,1497,-10
38827791077,38827791079,2,1797,1084,-10
38828990479,38828990479,0,1434,2075,-10
38830322970,38830322971,1,1368,1491,-10
38832575343,38832575344,1,832,1250,-10
38835920098,38835920102,4,1439,1492,-10
38835992888,38835992888,0,1833,1559,-10
38839479338,38839479335,-3,1252,3393,-10
38843475066,38843475068,2,1657,1997,-10
38849639678,38849639679,1,1655,2018,-10
38850032783,38850032785,2,1702,1732,-10
38853197482,38853197483,1,1280,1379,-10
38854348276,38854348279,3,1378,1210,-10
38854872049,38854872050,1,1695,1722,-10
38859759510,38859759506,-4,1174,1675,-10
38865240243,38865240242,-1,1376,1928,-10
38865268805,38865268810,5,3412,1979,-10
38866681555,38866681558,3,1542,1878,-10
38868047051,38868047051,0,1948,1890,-10
38868803579,38868803582,3,1617,1580,-10
38869427523,38869427526,3,1040,1056,-10
38869486735,38869486736,1,1956,1649,-10
38872090712,38872090714,2,1765,1524,-10
38875552707,38875552709,2,876,1221,-10
38876173810,38876173811,1,1467,2063,-10
38876212919,38876212922,3,1017,847,-10
38877520349,38877520349,0,1879,2394,-10
38878129029,38878129030,1,1765,1394,-10
38879035431,38879035433,2,1348,1696,-10
38880592491,38880592493,2,1321,1460,-10
38881461507,38881461507,0,25357,20001,-10
38884571109,38884571112,3,2194,1843,-10
38886871732,38886871734,2,1727,1535,-10
38890196370,38890196371,1,1803,1554,-10
38892721658,38892721660,2,1317,2000,-10
38896123622,38896123622,0,1101,1586,-10
38896495546,38896495546,0,1680,1488,-10
38897151393,38897151394,1,1669,1467,-10
38897958026,38897958029,3,3113,1607,-10
38899702711,38899702714,3,2123,2053,-10
38900042098,38900042103,5,1095,1531,-10
38901524082,38901524075,-7,3433,11961,-10
38906253622,38906253624,2,1375,1653,-10
38908141651,38908141654,3,1356,1566,-10
38911435370,38911435371,1,1894,2075,-10
38913075693,38913075692,-1,1461,1731,-10
38913470729,38913470731,2,1037,1170,-10
38914665802,38914665804,2,1423,1625,-10
38915250018,38915250019,1,835,667,-10
38917376852,38917376853,1,1623,1676,-10
38921355111,38921355111,0,1554,2280,-10
38924873739,38924873741,2,1919,1559,-10
38936245674,38936245675,1,2208,1877,-10
38936785362,38936785363,1,1612,1395,-10
38937066522,38937066526,4,1573,1317,-10
38938056013,38938056017,4,872,1170,-10
38946531494,38946531498,4,1343,1314,-10
38947644162,38947644171,9,1403,944,-10
38950100241,38950100245,4,1704,1692,-10
38951875548,38951875551,3,1141,1141,-10
38953186263,38953186267,4,1902,1305,-10
38958974050,38958974051,1,1111,1016,-10
38959181014,38959181019,5,1705,1520,-10
38961478245,38961478246,1,1618,1784,-10
38964655321,38964655323,2,3103,3463,-10
38968734625,38968734626,1,1524,2030,-10
38971332721,38971332721,0,2114,1810,-10
38973470027,38973470029,2,1384,1405,-10
38977450310,38977450313,3,1421,1108,-10
38978135390,38978135391,1,1616,1328,-10
38979730275,38979730278,3,1846,1648,-10
38981935571,38981935571,0,1102,1217,-10
38982962292,38982962295,3,2559,1778,-10
38985220500,38985220501,1,2121,1583,-10
38986519549,38986519555,6,1181,977,-10
38986806653,38986806666,13,1261,1204,-10
38990381246,38990381264,18,640,852,-10
38995473632,38995473633,1,1266,1309,-10
38999321121,38999321126,5,1305,887,-10
38999451661,38999451662,1,2449,1591,-10
39001832306,39001832313,7,10993,37555,-10
39004311735,39004311743,8,4436,1213,-10
39005077094,39005077095,1,1642,1342,-10
39006460795,39006460798,3,3212,1837,-10
39011300469,39011300470,1,1684,1437,-10
39015200736,39015200738,2,1723,1520,-10
39016061988,39016061994,6,2286,1510,-10
39016523514,39016523516,2,1132,1611,-10
39021760739,39021760741,2,1035,1700,-10
39028334257,39028334257,0,1204,1501,-10
39032260046,39032260046,0,2723,3981,-10
39034588957,39034588958,1,1543,1405,-10
39034700959,39034700961,2,2049,1458,-10
39037434148,39037434146,-2,1064,2139,-10
39038011446,39038011448,2,1522,1259,-10
39040720870,39040720872,2,1691,1416,-10
39042353553,39042353555,2,1061,965,-10
39042607683,39042607686,3,1216,1562,-10
39044736822,39044736825,3,1207,1570,-10
39044850063,39044850083,20,1427,1537,-10
39046047650,39046047653,3,1741,2357,-10
39047650690,39047650691,1,1212,2040,-10
39048175649,39048175651,2,1543,1148,-10
39050353775,39050353777,2,1797,1642,-10
39051709602,39051709603,1,914,1426,-10
39052670734,39052670719,-15,1143,1039,-10
39057063967,39057063969,2,1439,1725,-10
39058575857,39058575862,5,1908,1284,-10
39059347801,39059347802,1,1885,2412,-10
39060806358,39060806362,4,1289,1280,-10
39061786519,39061786520,1,1658,1066,-10
39065911829,39065911830,1,1988,2002,-10
39066799239,39066799241,2,1675,1825,-10
39069588290,39069588294,4,1230,1587,-10
39070790112,39070790114,2,1887,1887,-10
39071086234,39071086237,3,1260,1988,-10
39071766865,39071766866,1,1359,1662,-10
39074242349,39074242351,2,946,1278,-10
39075132478,39075132477,-1,1518,1692,-10
39075209409,39075209413,4,1294,1365,-10
39079519084,39079519087,3,1824,1527,-10
39082647140,39082647141,1,1936,1582,-10
39089133486,39089133487,1,1847,1972,-10
39089409965,39089409968,3,1017,1811,-10
39089681418,39089681418,0,1872,1463,-10
39089717702,39089717703,1,1371,1652,-10
39094025427,39094025427,0,1733,1391,-10
39094951101,39094951104,3,1260,1548,-10
39097203830,39097203830,0,1829,2143,-10
39099990727,39099990728,1,1252,1504,-10
39104393919,39104393922,3,2000,1345,-10
39104696089,39104696104,15,1431,1532,-10
39109432070,39109432070,0,1794,1617,-10
39112321420,39112321421,1,1666,1549,-10
39112727407,39112727408,1,2030,1721,-10
39113574810,39113574812,2,1418,1538,-10
39113760994,39113760978,-16,1417,508,-10
39114150302,39114150307,5,1896,1363,-10
39115303296,39115303298,2,2046,1897,-10
39116699925,39116699926,1,1298,1691,-10
39116835421,39116835420,-1,1262,1661,-10
39121229535,39121229537,2,1423,1339,-10
39121403288,39121403290,2,1261,1002,-10
39124715378,39124715378,0,1507,2083,-10
39126395247,39126395249,2,1956,1894,-10
39129480638,39129480622,-16,1565,1551,-10
39132098627,39132098627,0,1077,1409,-10
39133850504,39133850505,1,1854,1726,-10
39142649546,39142649546,0,2221,1851,-10
39147418757,39147418750,-7,2219,7121,-10
39147597824,39147597826,2,2256,1846,-10
39149089903,39149089903,0,443,827,-10
39152421250,39152421252,2,1749,1662,-10
39153877449,39153877449,0,1694,1699,-10
39158322374,39158322375,1,1700,1890,-10
39161082844,39161082854,10,15055,24642,-10
39161649041,39161649042,1,1665,1148,-10
39162078715,39162078715,0,1489,1344,-10
39163094894,39163094897,3,963,1334,-10
39163731945,39163731947,2,1856,1189,-10
39164112247,39164112224,-23,1287,815,-10
39165421177,39165421158,-19,2048,1503,-10
39169375067,39169375070,3,1035,1750,-10
39173674924,39173674926,2,1738,1594,-10
39174796575,39174796578,3,1747,1557,-10
39174848266,39174848266,0,1078,1491,-10
39177468725,39177468727,2,1480,1261,-10
39179246528,39179246531,3,1294,1055,-10
39182280744,39182280746,2,2407,1481,-10
39186583737,39186583735,-2,993,1702,-10
39190326226,39190326228,2,1736,1638,-10
39191719043,39191719045,2,1145,1379,-10
39194024444,39194024445,1,1364,1933,-10
39194309298,39194309299,1,1474,1201,-10
39195058310,39195058305,-5,750,10350,-10
39196978843,39196978841,-2,1743,2602,-10
39197636899,39197636879,-20,24155,28735,-10
39199085424,39199085428,4,1539,863,-10
39201249008,39201249006,-2,1033,1472,-10
39202652991,39202652993,2,1363,1875,-10
39204534719,39204534722,3,1590,1623,-10
39206736817,39206736818,1,1748,1586,-10
39206914607,39206914607,0,865,1341,-10
39209186851,39209186854,3,1895,1461,-10
39209920346,39209920349,3,1397,1620,-10
39210286349,39210286352,3,1679,1747,-10
39220229090,39220229091,1,1916,1815,-10
39220674231,39220674233,2,1496,1875,-10
39224746785,39224746787,2,1953,1762,-10
39225161344,39225161347,3,1467,2095,-10
39227337894,39227337897,3,1195,1522,-10
39232877015,39232877013,-2,2448,3905,-10
39232987635,39232987637,2,1637,1707,-10
39236358917,39236358919,2,1269,1730,-10
39236904137,39236904141,4,1873,1636,-10
39240756797,39240756798,1,1221,1206,-10
39241433909,39241433906,-3,1576,1667,-10
39242314753,39242314757,4,1848,1409,-10
39244242786,39244242787,1,1326,1540,-10
39248433155,39248433159,4,1222,2080,-10
39250702007,39250702010,3,1577,1139,-10
39253073666,39253073674,8,3082,1190,-10
39254382371,39254382365,-6,1943,6629,-10
39256996458,39256996459,1,1368,1651,-10
39257385050,39257385055,5,2129,1909,-10
39257614993,39257614994,1,970,1296,-10
39261068069,39261068069,0,1568,1384,-10
39261985261,39261985262,1,1287,1278,-10
39262136867,39262136871,4,1541,1275,-10
39262179855,39262179860,5,1356,908,-10
39265825993,39265825996,3,1858,1851,-10
39266500836,39266500839,3,1923,1300,-10
39267519387,39267519390,3,1568,1293,-10
39269506245,39269506247,2,1808,1973,-10
39270984986,39270984987,1,1117,1178,-10
39271103157,39271103158,1,2057,2256,-10
39275378484,39275378486,2,1305,1555,-10
39276959145,39276959148,3,1807,1583,-10
39279334920,39279334918,-2,1742,2050,-10
39281750107,39281750108,1,1790,2048,-10
39286110265,39286110266,1,1298,1662,-10
39286390270,39286390272,2,1617,1353,-10
39286590857,39286590859,2,1606,1308,-10
39287588373,39287588374,1,1344,1441,-10
39294212868,39294212870,2,1501,1860,-10
39295764162,39295764155,-7,1009,5425,-10
39297480722,39297480727,5,1376,1242,-10
39302795163,39302795165,2,1606,1881,-10
39308252697,39308252698,1,1500,1063,-10
39309178009,39309178011,2,1405,1146,-10
39314114321,39314114326,5,2615,2039,-10
39316087078,39316087081,3,1397,1738,-10
39316711905,39316711906,1,1037,1514,-10
39318254911,39318254913,2,1341,1081,-10
39320928418,39320928421,3,2043,2116,-10
39321899265,39321899265,0,1959,1132,-10
39326150338,39326150337,-1,1608,2167,-10
39330191725,39330191722,-3,1405,2438,-10
39331689939,39331689940,1,2372,2997,-10
39332176446,39332176447,1,1617,1269,-10
39332629567,39332629570,3,1935,1178,-10
39333511117,39333511139,22,1480,1393,-10
39334654994,39334654993,-1,3585,4314,-10
39338657808,39338657811,3,1249,1343,-10
39338922459,39338922463,4,1286,1803,-10
39339434729,39339434732,3,1374,1536,-10
39341618045,39341618046,1,832,1129,-10
39342202791,39342202795,4,1379,1185,-10
39343066846,39343066849,3,1341,1713,-10
39345297573,39345297573,0,1447,1410,-10
39346752327,39346752329,2,1646,1463,-10
39347334222,39347334222,0,1530,1023,-10
39347468364,39347468365,1,1694,1982,-10
39349189963,39349189965,2,2274,2110,-10
39349588074,39349588077,3,1388,1243,-10
39350288503,39350288503,0,1328,1564,-10
39350691766,39350691770,4,1402,1509,-10
39352193250,39352193272,22,1705,1624,-10
39352413722,39352413726,4,1251,1381,-10
39354284994,39354284996,2,1638,2029,-10
39355572670,39355572689,19,1404,1328,-10
39356128118,39356128120,2,1106,1086,-10
39358478962,39358478964,2,1818,1604,-10
39360528329,39360528330,1,1498,1677,-10
39364497151,39364497150,-1,1025,1277,-10
39367612893,39367612895,2,1956,1701,-10
39369562469,39369562467,-2,1623,1739,-10
39370847643,39370847644,1,1200,2291,-10
39371291607,39371291610,3,3810,3359,-10
39378764510,39378764512,2,1749,1560,-10
39382172874,39382172875,1,1702,1594,-10
39383409366,39383409368,2,1314,1575,-10
39387286865,39387286866,1,2164,1780,-10
39388312699,39388312701,2,1963,1694,-10
39389072150,39389072153,3,2011,1749,-10
39392839412,39392839414,2,1673,1696,-10
39397981401,39397981405,4,1337,1056,-10
39398312463,39398312465,2,1235,1616,-10
39398825011,39398825009,-2,686,1004,-10
39405199259,39405199261,2,1379,1627,-10
39406309872,39406309873,1,1803,1658,-10
39408242393,39408242397,4,1727,1023,-10
39410183912,39410183915,3,1461,2001,-10
39411183216,39411183216,0,1406,1171,-10
39412458099,39412458101,2,1202,1856,-10
39415535637,39415535638,1,1187,1224,-10
39417269397,39417269397,0,1675,2004,-10
39418532226,39418532220,-6,2302,8191,-10
39420084248,39420084249,1,1739,1377,-10
39420236697,39420236704,7,1600,1626,-10
39421238528,39421238532,4,9287,6697,-10
39422721025,39422721026,1,1587,1696,-10
39423217145,39423217146,1,1313,979,-10
39423270236,39423270240,4,1054,1487,-10
39425681686,39425681689,3,1340,1529,-10
39428899885,39428899890,5,3058,1152,-10
39429341517,39429341518,1,1992,1612,-10
39431324109,39431324111,2,1786,1770,-10
39431414544,39431414545,1,1555,1403,-10
39434780338,39434780342,4,1493,1381,-10
39435875381,39435875384,3,2444,1974,-10
39436036392,39436036395,3,1794,1420,-10
39438717909,39438717911,2,2331,1606,-10
39441911618,39441911620,2,1128,1500,-10
39442308254,39442308260,6,2509,1509,-10
39442758698,39442758702,4,1660,1861,-10
39442981742,39442981739,-3,1082,2197,-10
39445683417,39445683419,2,1477,1842,-10
39445839061,39445839063,2,1778,2134,-10
39448137773,39448137774,1,1998,1442,-10
39448538630,39448538641,11,1734,1754,-10
39449237506,39449237507,1,1238,1187,-10
39455035296,39455035298,2,1929,1494,-10
39455290334,39455290335,1,1164,1500,-10
39456014673,39456014690,17,1090,1294,-10
39459081666,39459081669,3,1739,1686,-10
39463128719,39463128720,1,1617,1513,-10
39466411504,39466411505,1,1584,1232,-10
39467142840,39467142842,2,1931,1389,-10
39471067334,39471067335,1,1343,1462,-10
39473381873,39473381874,1,1671,1588,-10
39473735797,39473735798,1,1570,1598,-10
39474834697,39474834697,0,1756,2104,-10
39475973017,39475973020,3,1387,1442,-10
39479779564,39479779563,-1,1223,857,-10
39480909366,39480909369,3,2408,1937,-10
39486136298,39486136299,1,1737,1257,-10
39490738998,39490739000,2,1819,1378,-10
39493996138,39493996139,1,1325,1434,-10
39496629724,39496629726,2,1868,1701,-10
39504838043,39504838043,0,1465,1899,-10
39505076249,39505076250,1,1107,1274,-10
39507502295,39507502297,2,1867,1697,-10
39508471878,39508471878,0,1388,1594,-10
39509473455,39509473459,4,922,1024,-10
39509958958,39509958958,0,1454,2017,-10
39513910397,39513910401,4,2537,1730,-10
39514092879,39514092879,0,1678,1878,-10
39516278595,39516278595,0,1420,2267,-10
39517209763,39517209757,-6,1325,7268,-10
39523783458,39523783460,2,1430,1758,-10
39525791042,39525791042,0,1297,1735,-10
39527313673,39527313674,1,1934,1679,-10
39529956379,39529956379,0,1705,1497,-10
39534986317,39534986318,1,1201,1925,-10
39538244217,39538244221,4,1511,1288,-10
39543973106,39543973107,1,1580,1723,-10
39544119255,39544119259,4,1800,1484,-10
39544762244,39544762246,2,1386,1091,-10
39546201316,39546201314,-2,1305,3164,-10
39550902212,39550902214,2,1771,1730,-10
39554184579,39554184583,4,1647,1594,-10
39555996417,39555996420,3,1468,1548,-10
39558217078,39558217066,-12,1416,1174,-10
39559172479,39559172482,3,1545,1826,-10
39559256527,39559256507,-20,1136,1008,-10
39561800307,39561800301,-6,1858,9506,-10
39563252050,39563252053,3,2271,2110,-10
39564148531,39564148534,3,1952,1488,-10
39571406507,39571406509,2,1236,1392,-10
39572210266,39572210269,3,1462,1399,-10
39578118650,39578118650,0,1816,1706,-10
39578213025,39578213025,0,1317,1861,-10
39578327686,39578327686,0,1516,1718,-10
39579582310,39579582316,6,919,893,-10
39582666704,39582666706,2,1594,1482,-10
39583118619,39583118621,2,1275,1685,-10
39585117258,39585117263,5,667,521,-10
39585789005,39585789007,2,1514,1294,-10
39586206466,39586206467,1,1846,1523,-10
39588840582,39588840585,3,1279,1576,-10
39590765387,39590765388,1,1633,1464,-10
39593556311,39593556315,4,1326,1392,-10
39593721118,39593721121,3,1585,2043,-10
39594382153,39594382153,0,1203,1375,-10
39595994819,39595994817,-2,1543,1437,-10
39602686772,39602686775,3,1358,2028,-10
39604518758,39604518758,0,1265,2535,-10
39610050050,39610050053,3,1426,1339,-10
39611668806,39611668808,2,1560,1497,-10
39613001154,39613001156,2,1817,1784,-10
39614383998,39614384002,4,1549,1374,-10
39614728913,39614728915,2,1491,1933,-10
39617590289,39617590293,4,1522,1664,-10
39618960970,39618960972,2,1295,1269,-10
39620012211,39620012210,-1,1036,2316,-10
39622847280,39622847281,1,2133,1514,-10
39627182934,39627182936,2,1459,1036,-10
39627886137,39627886138,1,1557,1611,-10
39629777042,39629777044,2,1509,1640,-10
39632113098,39632113104,6,1658,1575,-10
39632549766,39632549769,3,2056,1403,-10
39633870468,39633870468,0,1205,1328,-10
39636019021,39636019027,6,2937,1015,-10
39636515952,39636515961,9,15647,17294,-10
39637145790,39637145794,4,2051,1904,-10
39639955082,39639955082,0,830,1100,-10
39642740231,39642740234,3,1250,1375,-10
39644462724,39644462724,0,1578,1323,-10
39646468409,39646468410,1,1103,1250,-10
39648389045,39648389046,1,1818,2128,-10
39649253022,39649253023,1,1510,1088,-10
39653985860,39653985862,2,1565,2116,-10
39654931597,39654931601,4,1942,1322,-10
39655315185,39655315193,8,1288,1362,-10
39658965633,39658965634,1,1198,1470,-10
39660654485,39660654484,-1,1333,1695,-10
39664919473,39664919472,-1,1306,1509,-10
39667131550,39667131552,2,1581,1817,-10
39668020863,39668020866,3,1406,933,-10
39669618427,39669618430,3,1439,1546,-10
39676201028,39676201014,-14,986,1445,-10
39676366412,39676366395,-17,853,1578,-10
39678935646,39678935649,3,1613,1411,-10
39681194877,39681194875,-2,1313,988,-10
39683736341,39683736344,3,1405,1888,-10
39686872520,39686872526,6,4077,1374,-10
39687276927,39687276930,3,1263,1824,-10
39688970458,39688970461,3,1773,1889,-10
39689602686,39689602690,4,950,991,-10
39693173002,39693173002,0,1958,1791,-10
39697528954,39697528954,0,1342,2084,-10
39698480978,39698480980,2,1130,1716,-10
39702285301,39702285303,2,1383,1511,-10
39704051174,39704051179,5,5581,2395,-10
39705041210,39705041211,1,1506,1660,-10
39708832934,39708832935,1,1555,1536,-10
39709953783,39709953785,2,1784,1379,-10
39710109983,39710110001,18,1042,1917,-10
39711320595,39711320598,3,2618,2118,-10
39713644882,39713644884,2,1975,1872,-10
39716500658,39716500659,1,1433,1490,-10
39717403405,39717403409,4,2046,1646,-10
39720202247,39720202249,2,1765,1115,-10
39723112948,39723112950,2,2282,1868,-10
39727659326,39727659327,1,2209,2299,-10
39729535866,39729535860,-6,1723,8480,-10
39730335423,39730335425,2,1162,1604,-10
39730674331,39730674331,0,2066,1501,-10
39731712666,39731712666,0,1656,1583,-10
39732563071,39732563073,2,1482,1552,-10
39733160556,39733160557,1,1358,2102,-10
39739332769,39739332770,1,1334,1943,-10
39739449964,39739449966,2,2244,2144,-10
39741362670,39741362671,1,1416,1222,-10
39742101593,39742101594,1,1318,919,-10
39742464711,39742464688,-23,1339,1640,-10
39745893191,39745893191,0,1370,1449,-10
39746083643,39746083646,3,1914,1149,-10
39746774689,39746774689,0,2437,2345,-10
39747148319,39747148321,2,1850,1696,-10
39748600954,39748600960,6,1869,1157,-10
39750043421,39750043421,0,1696,1182,-10
39752988086,39752988089,3,1731,1592,-10
39754889926,39754889927,1,1242,1476,-10
39755923882,39755923872,-10,1441,1476,-10
39757982317,39757982319,2,1491,1087,-10
39760062891,39760062874,-17,1314,1028,-10
39760624434,39760624443,9,1030,1255,-10
39762467020,39762467021,1,1710,1676,-10
39767816034,39767816035,1,887,1272,-10
39772074151,39772074154,3,1306,1860,-10
39773364870,39773364873,3,1514,1515,-10
39776750845,39776750850,5,2692,1152,-10
39780265285,39780265279,-6,938,6086,-10
39785231257,39785231258,1,1877,1459,-10
39785678753,39785678753,0,1137,1241,-10
39786796077,39786796096,19,1729,1640,-10
39788364385,39788364392,7,4128,2010,-10
39791530193,39791530195,2,1569,2337,-10
39791661789,39791661792,3,2179,1704,-10
39793416490,39793416491,1,1608,1254,-10
39794184593,39794184590,-3,1041,1834,-10
39797481616,39797481618,2,1738,1783,-10
39800962423,39800962424,1,1243,1275,-10
39801143427,39801143429,2,1306,1858,-10
39802456454,39802456458,4,1741,1300,-10
39805397462,39805397463,1,2110,1293,-10
39806603814,39806603817,3,1809,2053,-10
39809215067,39809215070,3,1078,1348,-10
39810436013,39810436014,1,1873,1954,-10
39811365297,39811365299,2,2307,1968,-10
39811928245,39811928248,3,1194,1457,-10
39813088306,39813088301,-5,1630,6030,-10
39814598755,39814598757,2,1233,1586,-10
39814985908,39814985906,-2,1702,3051,-10
39815179092,39815179094,2,2084,2150,-10
39816531185,39816531186,1,1000,1397,-10
39818622942,39818622942,0,1443,1716,-10
39826613997,39826613999,2,2120,1561,-10
39835740571,39835740572,1,1384,1397,-10
39836521550,39836521550,0,1788,1766,-10
39838220761,39838220762,1,1549,1583,-10
39838387965,39838387971,6,3117,1141,-10
39843772475,39843772478,3,1823,1615,-10
39844476557,39844476557,0,1473,1944,-10
39844959373,39844959375,2,1899,1499,-10
39848252537,39848252541,4,4726,2836,-10
39848915821,39848915822,1,1511,1772,-10
39848964591,39848964593,2,1311,1435,-10
39852810674,39852810656,-18,1939,1347,-10
39855904355,39855904357,2,1480,1391,-10
39857806152,39857806154,2,1993,1343,-10
39865739481,39865739483,2,1550,1409,-10
39866988554,39866988559,5,2065,1643,-10
39867303282,39867303285,3,2484,1566,-10
39872226067,39872226066,-1,2256,3676,-10
39875179231,39875179233,2,1599,1787,-10
39876015055,39876015058,3,1387,960,-10
39876944591,39876944593,2,2277,2002,-10
39884933414,39884933417,3,1962,1485,-10
39885002102,39885002083,-19,1754,969,-10
39886433225,39886433227,2,723,770,-10
39887305938,39887305938,0,1366,1405,-10
39896442249,39896442257,8,6812,1266,-10
39896617247,39896617250,3,1690,1467,-10
39896693334,39896693335,1,1091,1444,-10
39897778762,39897778761,-1,1415,1460,-10
39897827942,39897827942,0,1533,2078,-10
39900549015,39900549018,3,1715,1752,-10
39901258007,39901258010,3,2384,2181,-10
39901474811,39901474813,2,1027,1110,-10
39902540949,39902540950,1,1574,1330,-10
39903967510,39903967514,4,1719,1712,-10
39905118391,39905118391,0,1859,1744,-10
39908722766,39908722769,3,1948,1419,-10
39910062390,39910062390,0,1603,1563,-10
39914462876,39914462877,1,1256,1469,-10
39915492162,39915492165,3,1943,2240,-10
39919979898,39919979887,-11,3665,11671,-10
39921267075,39921267077,2,1429,1432,-10
39923638326,39923638327,1,1437,1817,-10
39925172327,39925172327,0,1365,1149,-10
39926234466,39926234457,-9,1779,1242,-10
39926438378,39926438379,1,1532,2822,-10
39931659467,39931659464,-3,1139,3594,-10
39933652922,39933652922,0,1001,1180,-10
39935508798,39935508801,3,1385,1657,-10
39935925608,39935925611,3,1804,1957,-10
39938084470,39938084466,-4,760,2022,-10
39939342971,39939342972,1,1750,2104,-10
39941696138,39941696139,1,1636,1118,-10
39943342519,39943342520,1,1069,998,-10
39948959000,39948959002,2,1309,859,-10
39949517507,39949517510,3,1379,1599,-10
39949640350,39949640351,1,1398,1604,-10
39949929705,39949929706,1,1618,1522,-10
39956377230,39956377230,0,718,1075,-10
39957008866,39957008867,1,1536,1242,-10
39958720468,39958720469,1,1449,1362,-10
39960270859,39960270862,3,1608,1729,-10
39962367170,39962367170,0,1744,1432,-10
39968568801,39968568803,2,1330,1632,-10
39972219663,39972219664,1,35594,42338,-10
39973219070,39973219069,-1,2414,2037,-10
39973891865,39973891867,2,1443,1178,-10
39975651374,39975651374,0,1909,1446,-10
39975849382,39975849379,-3,1450,3726,-10
39976072222,39976072224,2,2019,1398,-10
39980299477,39980299478,1,2081,2120,-10
39982484063,39982484065,2,1391,2370,-10
39982749519,39982749523,4,1312,1236,-10
39983166694,39983166697,3,2045,1567,-10
39985433122,39985433125,3,2125,1879,-10
39987837611,39987837616,5,2225,1620,-10
39988617961,39988617961,0,1769,2912,-10
39991436108,39991436111,3,2136,1197,-10
39992246114,39992246113,-1,1460,1928,-10
39994064587,39994064582,-5,1021,1084,-10
39995202749,39995202751,2,1703,1881,-10
40000038210,40000038210,0,1645,1728,-10
40001985939,40001985942,3,1043,848,-10
40002535105,40002535108,3,1755,1732,-10
40004844028,40004844033,5,1863,1250,-10
40005310394,40005310377,-17,1448,824,-10
40009472798,40009472799,1,1471,1590,-10
40011469429,40011469430,1,1207,1443,-10
40019501662,40019501665,3,1148,1374,-10
40020697614,40020697615,1,1383,1633,-10
40022071442,40022071442,0,1046,1595,-10
40024623474,40024623474,0,1145,1199,-10
40029378461,40029378464,3,1636,1484,-10
40036143146,40036143149,3,1706,1498,-10
40037940923,40037940925,2,1285,1981,-10
40039347814,40039347815,1,1924,2113,-10
40042861153,40042861155,2,1825,1582,-10
40043646257,40043646267,10,11542,21494,-10
40044682294,40044682297,3,1942,1835,-10
40046957454,40046957457,3,1735,1444,-10
40048309638,40048309638,0,1416,1293,-10
40051614683,40051614682,-1,1527,2286,-10
40052161689,40052161690,1,1506,1295,-10
40052625113,40052625116,3,1153,1394,-10
40055640323,40055640318,-5,795,2371,-10
40059259047,40059259045,-2,1677,1933,-10
40059792647,40059792649,2,1592,1236,-10
40060444007,40060443987,-20,610,845,-10
40061966324,40061966325,1,1444,1372,-10
40065364366,40065364367,1,1315,1421,-10
40065420970,40065420974,4,1923,1306,-10
40066251873,40066251875,2,1434,1787,-10
40066846557,40066846559,2,1066,1360,-10
40067536129,40067536146,17,1572,1404,-10
40070402938,40070402941,3,1263,1697,-10
40070815022,40070815022,0,1883,1660,-10
40072779040,40072779041,1,2076,1644,-10
40074950962,40074950963,1,1116,1137,-10
40075459229,40075459225,-4,1012,2220,-10
40082165045,40082165048,3,1529,1797,-10
40084884943,40084884945,2,1510,1735,-10
40091183045,40091183047,2,1507,2260,-10
40095073601,40095073602,1,1556,1310,-10
40100730710,40100730711,1,1202,1691,-10
40101184200,40101184205,5,1642,1336,-10
40105111005,40105111006,1,1307,1566,-10
40105275613,40105275619,6,1117,1103,-10
40109546437,40109546439,2,1148,1508,-10
40110611255,40110611258,3,2060,1435,-10
40112000509,40112000510,1,1778,1677,-10
40112158932,40112158933,1,2268,2580,-10
40113636251,40113636255,4,1603,1324,-10
40114728167,40114728169,2,1238,1816,-10
40119507539,40119507542,3,1656,1733,-10
40126052726,40126052727,1,2148,1881,-10
40126301930,40126301934,4,1618,1237,-10
40126609833,40126609835,2,1478,1284,-10
40128162367,40128162371,4,2524,2442,-10
40128566879,40128566880,1,1876,1611,-10
40130030838,40130030838,0,1978,2199,-10
40130977310,40130977314,4,1328,1386,-10
40132304415,40132304420,5,2172,1178,-10
40134387853,40134387854,1,1833,1824,-10
40136577427,40136577426,-1,1518,1614,-10
40138238860,40138238863,3,1728,1500,-10
40138757549,40138757550,1,1746,1776,-10
40142195929,40142195930,1,2060,2355,-10
40143314949,40143314949,0,927,1198,-10
40145596278,40145596279,1,1898,1842,-10
40151428169,40151428173,4,1147,1300,-10
40152000114,40152000110,-4,1229,1310,-10
40152642529,40152642530,1,1390,1714,-10
40155333245,40155333246,1,1156,1410,-10
40160532470,40160532471,1,1337,1419,-10
40162070947,40162070945,-2,1216,2328,-10
40162880206,40162880209,3,1231,1015,-10
40165347450,40165347451,1,1333,996,-10
40166417461,40166417464,3,1447,1338,-10
40169660218,40169660218,0,1246,1547,-10
40171292598,40171292600,2,1050,1190,-10
40173635847,40173635851,4,1630,1665,-10
40174283558,40174283555,-3,1482,5256,-10
40176924568,40176924568,0,1375,1780,-10
40178537585,40178537586,1,1405,1625,-10
40179711346,40179711346,0,1938,1569,-10
40180075946,40180075949,3,1286,1183,-10
40182438194,40182438195,1,1169,1572,-10
40185067721,40185067723,2,1222,1594,-10
40185476850,40185476852,2,1399,1624,-10
40186141171,40186141175,4,1161,1328,-10
40188619847,40188619848,1,1439,1872,-10
40189449249,40189449248,-1,1811,1940,-10
40193486718,40193486718,0,1355,2262,-10
40197368844,40197368837,-7,58,2555,-10
40197591270,40197591271,1,1522,2087,-10
40203382914,40203382915,1,1509,1489,-10
40207014973,40207014974,1,2231,2299,-10
40209931259,40209931261,2,1925,1762,-10
40216135287,40216135289,2,1647,2011,-10
40218398498,40218398500,2,1969,1526,-10
40218581473,40218581476,3,1649,1565,-10
40223248030,40223248037,7,9688,3857,-10
40224031540,40224031543,3,1505,1178,-10
40229108697,40229108695,-2,956,874,-10
40232202619,40232202619,0,974,672,-10
40232511082,40232511088,6,467,364,-10
40233281318,40233281321,3,1722,1598,-10
40234204726,40234204726,0,1081,1239,-10
40235103489,40235103490,1,2033,1591,-10
40237694722,40237694722,0,1739,1507,-10
40239843755,40239843758,3,1025,977,-10
40249191017,40249190998,-19,2010,1342,-10
40251471104,40251471104,0,1310,1138,-10
40253647541,40253647542,1,1560,1619,-10
40261788649,40261788629,-20,1604,1388,-10
40265223409,40265223410,1,1628,2294,-10
40266515510,40266515513,3,1290,1762,-10
40266874045,40266874046,1,1686,1832,-10
40266988118,40266988117,-1,1178,1563,-10
40267234265,40267234267,2,1467,1028,-10
40268111279,40268111279,0,1548,1337,-10
40269873401,40269873402,1,1744,1899,-10
40273168341,40273168341,0,1726,1547,-10
40275055248,40275055250,2,1738,1753,-10
40277122034,40277122033,-1,1460,1848,-10
40279090739,40279090741,2,1623,1169,-10
40285690529,40285690531,2,1398,988,-10
40288135555,40288135559,4,1927,1608,-10
40289981206,40289981208,2,1835,1886,-10
40295041442,40295041445,3,1498,1304,-10
40299409267,40299409267,0,1004,1447,-10
40301976743,40301976745,2,1758,1533,-10
40303354182,40303354183,1,1377,1514,-10
40304234633,40304234636,3,1566,2058,-10
40309713699,40309713700,1,818,1742,-10
40313729259,40313729263,4,1432,952,-10
40320741654,40320741655,1,998,1068,-10
40321001182,40321001181,-1,1767,2227,-10
40321212160,40321212183,23,1349,2205,-10
40327418623,40327418626,3,1306,1081,-10
40333027245,40333027245,0,1174,1969,-10
40333628580,40333628581,1,2473,1763,-10
40334702705,40334702709,4,1687,1326,-10
40335396523,40335396522,-1,954,1308,-10
40337493706,40337493710,4,1607,1393,-10
40339927410,40339927409,-1,1090,2259,-10
40342726711,40342726696,-15,5717,2698,-10
40351353818,40351353818,0,1799,1842,-10
40357918327,40357918331,4,925,893,-10
40362437937,40362437939,2,1832,1162,-10
40362961799,40362961803,4,1344,1264,-10
40363502812,40363502835,23,1377,1173,-10
40363656538,40363656552,14,1452,1416,-10
40372578283,40372578284,1,1048,1366,-10
40373570833,40373570818,-15,827,1330,-10
40376123992,40376123994,2,1346,1175,-10
40377977446,40377977443,-3,1281,992,-10
40378426823,40378426824,1,1535,1709,-10
40380969572,40380969575,3,1756,1601,-10
40382745051,40382745055,4,1486,947,-10
40384929283,40384929285,2,3290,1795,-10
40385636505,40385636486,-19,1434,1509,-10
40386321758,40386321760,2,1850,1369,-10
40388126341,40388126341,0,1479,1893,-10
40390724177,40390724198,21,1137,1451,-10
40392224084,40392224086,2,1737,1101,-10
40393936040,40393936042,2,2039,1428,-10
40397159841,40397159842,1,1470,1426,-10
40398395777,40398395799,22,676,862,-10
40402488354,40402488354,0,1496,1461,-10
40403795604,40403795606,2,1378,2122,-10
40409297150,40409297153,3,1168,987,-10
40411695514,40411695517,3,2690,1796,-10
40419025735,40419025736,1,1139,2095,-10
40424065478,40424065482,4,1567,1425,-10
40432042937,40432042939,2,1268,1828,-10
40432075899,40432075898,-1,977,1696,-10
40432333679,40432333682,3,1897,1552,-10
40432456287,40432456288,1,1387,1191,-10
40435293642,40435293634,-8,1276,4670,-10
40435392313,40435392315,2,1381,1674,-10
40435550847,40435550847,0,1022,949,-10
40437061825,40437061826,1,1751,1872,-10
40438765280,40438765282,2,1870,1647,-10
40440803825,40440803826,1,830,1381,-10
40440920549,40440920550,1,1765,1396,-10
40441523466,40441523470,4,1201,1794,-10
40441920022,40441920025,3,1507,1416,-10
40442439606,40442439609,3,1590,1228,-10
40444391009,40444391012,3,812,1017,-10
40447262030,40447262034,4,1593,1284,-10
40448105536,40448105535,-1,1322,1354,-10
40449692286,40449692289,3,1487,1311,-10
40451557955,40451557959,4,2229,1601,-10
40453583081,40453583080,-1,2152,3703,-10
40455133786,40455133787,1,1346,1631,-10
40456870066,40456870067,1,1055,1729,-10
40458980612,40458980612,0,1363,1611,-10
40459429366,40459429372,6,2278,1292,-10
40462882038,40462882040,2,1206,1510,-10
40467877597,40467877599,2,1531,1214,-10
40469913168,40469913172,4,1577,1575,-10
40470518591,40470518593,2,1342,1598,-10
40471352631,40471352634,3,579,948,-10
40473047420,40473047422,2,2294,2368,-10
40473685094,40473685099,5,1248,1098,-10
40477983339,40477983342,3,1856,1393,-10
40478034374,40478034377,3,1881,1404,-10
40478803227,40478803229,2,1211,1075,-10
40487326313,40487326316,3,2025,2361,-10
40489213424,40489213427,3,1376,1377,-10
40489448676,40489448679,3,1495,1328,-10
40490424130,40490424130,0,1325,1763,-10
40493782815,40493782817,2,1233,1695,-10
40495958806,40495958809,3,1230,1016,-10
40497802459,40497802463,4,1402,1135,-10
40498995768,40498995771,3,1929,1143,-10
40503650943,40503650946,3,1757,1156,-10
40503936700,40503936713,13,1546,1477,-10
40505491092,40505491095,3,1948,2080,-10
40505588686,40505588686,0,22187,9567,-10
40511488251,40511488253,2,1734,1891,-10
40513470512,40513470514,2,1050,1734,-10
40523758299,40523758298,-1,1271,1483,-10
40525462726,40525462730,4,1324,1590,-10
40526933160,40526933160,0,1420,1834,-10
40527884573,40527884575,2,1318,989,-10
40530061130,40530061130,0,1762,1635,-10
40530452549,40530452552,3,1513,1568,-10
40531135391,40531135393,2,2011,1134,-10
40531490107,40531490109,2,1755,1933,-10
40531986885,40531986886,1,2053,1997,-10
40532084409,40532084411,2,2638,1748,-10
40533012909,40533012909,0,1175,1168,-10
40534135845,40534135846,1,1139,1308,-10
40536082650,40536082651,1,1654,1186,-10
40538862137,40538862139,2,1947,1492,-10
40545256713,40545256715,2,1850,1687,-10
40549838826,40549838830,4,2157,2002,-10
40550164846,40550164846,0,1186,1421,-10
40551728532,40551728534,2,1818,1825,-10
40553418147,40553418148,1,1257,1731,-10
40553894906,40553894890,-16,525,1582,-10
40554798972,40554798974,2,2559,1732,-10
40555892862,40555892863,1,1639,1986,-10
40556076097,40556076100,3,1836,1717,-10
40560962275,40560962281,6,2300,1380,-10
40561702338,40561702339,1,1464,1387,-10
40562296726,40562296747,21,1110,1210,-10
40568093541,40568093542,1,1179,1860,-10
40571894247,40571894250,3,976,1815,-10
40572613266,40572613270,4,1044,1295,-10
40573837249,40573837251,2,1642,1795,-10
40574064914,40574064918,4,1572,1135,-10
40574717698,40574717700,2,1803,1445,-10
40575294495,40575294497,2,1556,1395,-10
40575958090,40575958092,2,1070,2045,-10
40576875389,40576875392,3,1365,1830,-10
40576923609,40576923611,2,2224,1745,-10
40579269041,40579269043,2,1889,1513,-10
40579923175,40579923179,4,1102,1310,-10
40580586465,40580586468,3,1662,2147,-10
40582354283,40582354283,0,1882,1680,-10
40584485510,40584485512,2,1555,2053,-10
40584663417,40584663419,2,1146,1764,-10
40585385783,40585385782,-1,1492,2056,-10
40590635511,40590635511,0,1692,2011,-10
40591999566,40591999565,-1,1522,1392,-10
40593081234,40593081233,-1,815,932,-10
40596672630,40596672633,3,1489,1746,-10
40597041698,40597041701,3,1207,1458,-10
40599412101,40599412104,3,1815,1286,-10
40604719452,40604719454,2,1646,1195,-10
40607563333,40607563335,2,1549,1908,-10
40609117654,40609117657,3,1857,1806,-10
40610452282,40610452295,13,14062,30443,-10
40612145968,40612145970,2,1481,1144,-10
40615284478,40615284480,2,1911,1411,-10
40618356807,40618356809,2,2287,2034,-10
40624775992,40624775993,1,2368,2158,-10
40625718274,40625718277,3,1772,1489,-10
40626611573,40626611573,0,1239,1594,-10
40628670628,40628670631,3,1290,1620,-10
40629986083,40629986086,3,837,774,-10
40630022298,40630022298,0,1169,1226,-10
40633506492,40633506494,2,1300,1393,-10
40635380010,40635380013,3,1190,1043,-10
40636365037,40636365041,4,1494,1911,-10
40640840275,40640840277,2,1587,2478,-10
40641332530,40641332523,-7,33187,14052,-10
40642280266,40642280266,0,1468,1552,-10
40642307924,40642307925,1,2064,1571,-10
40645358828,40645358830,2,1225,1149,-10
40648796043,40648796042,-1,1613,2135,-10
40649306494,40649306495,1,1301,1043,-10
40652004664,40652004666,2,1369,1291,-10
40655072109,40655072107,-2,1440,2608,-10
40655929946,40655929942,-4,1136,2786,-10
40657267351,40657267370,19,1414,1397,-10
40660140849,40660140853,4,1989,1903,-10
40662732022,40662732022,0,1347,1364,-10
40664005469,40664005471,2,1247,1146,-10
40664554177,40664554178,1,1431,1115,-10
40667551635,40667551638,3,1314,1318,-10
40667639632,40667639633,1,1475,1667,-10
40672576518,40672576521,3,1283,1589,-10
40676691788,40676691790,2,1345,1474,-10
40679651634,40679651635,1,1487,1427,-10
40681177986,40681177987,1,1783,1380,-10
40684786839,40684786841,2,1610,1429,-10
40685142601,40685142603,2,1257,1301,-10
40687807326,40687807328,2,1411,1343,-10
40688438208,40688438209,1,1684,1228,-10
40689381622,40689381622,0,1687,1616,-10
40694943597,40694943602,5,1510,1981,-10
40695163066,40695163069,3,1692,1415,-10
40697062027,40697062030,3,2174,1640,-10
40698311251,40698311252,1,1064,1067,-10
40699937243,40699937246,3,1929,1808,-10
40700255405,40700255402,-3,1565,1458,-10
40700540562,40700540566,4,1557,2129,-10
40700740414,40700740417,3,1079,1267,-10
40702390552,40702390554,2,1536,1820,-10
40703735768,40703735769,1,1377,1460,-10
40706360780,40706360781,1,1894,1135,-10
40707155123,40707155125,2,1892,1432,-10
40709532321,40709532323,2,1195,1200,-10
40709743114,40709743115,1,1563,1576,-10
40710537341,40710537341,0,1007,1171,-10
40711820429,40711820430,1,2195,1650,-10
40712916181,40712916194,13,1233,1266,-10
40714833214,40714833225,11,14823,31995,-10
40716234739,40716234741,2,1323,1157,-10
40716504107,40716504107,0,1029,1134,-10
40717487720,40717487723,3,1685,1818,-10
40717984155,40717984158,3,864,854,-10
40720333288,40720333290,2,1540,1366,-10
40720756247,40720756249,2,1410,1145,-10
40723774017,40723774018,1,1201,1483,-10
40724158545,40724158546,1,1994,1977,-10
40726517111,40726517111,0,1731,1384,-10
40727546549,40727546550,1,1721,1808,-10
40727664010,40727664011,1,2121,1686,-10
40728459239,40728459242,3,1171,1241,-10
40741497163,40741497170,7,8286,2617,-10
40742573614,40742573613,-1,1193,2230,-10
40743714275,40743714279,4,1763,1433,-10
40743918565,40743918566,1,1983,1405,-10
40748329174,40748329181,7,3747,1539,-10
40757974105,40757974105,0,1818,2123,-10
40758430698,40758430703,5,1488,1051,-10
40760436591,40760436593,2,1908,1964,-10
40764957835,40764957839,4,1555,751,-10
40769422299,40769422302,3,2142,2101,-10
40771586015,40771586018,3,1220,725,-10
40775007080,40775007083,3,1217,1198,-10
40778879234,40778879239,5,1092,1708,-10
40779329946,40779329947,1,1529,1055,-10
40779545361,40779545366,5,1722,1411,-10
40781963403,40781963414,11,1914,1665,-10
40782547889,40782547890,1,1313,1570,-10
40785775984,40785775985,1,1627,1475,-10
40787748195,40787748197,2,1730,1828,-10
40792208162,40792208156,-6,1850,8508,-10
40792913525,40792913528,3,1301,1644,-10
40796139224,40796139226,2,1429,1101,-10
40799031150,40799031155,5,2816,1816,-10
40800179143,40800179152,9,11929,40726,-10
40800917030,40800917034,4,1717,1757,-10
40802727379,40802727382,3,1242,1287,-10
40804958678,40804958682,4,1562,1704,-10
40810566097,40810566102,5,1767,1512,-10
40811000046,40811000049,3,1127,1444,-10
40811035141,40811035162,21,1408,1555,-10
40811915625,40811915626,1,1524,1337,-10
40812970542,40812970543,1,1804,1406,-10
40813182445,40813182446,1,1271,1236,-10
40815228959,40815228957,-2,1101,2566,-10
40816100418,40816100421,3,1658,1668,-10
40817139337,40817139344,7,3904,1952,-10
40817202429,40817202434,5,1677,1274,-10
40818160143,40818160146,3,1943,2571,-10
40818498098,40818498099,1,1288,1261,-10
40819457923,40819457923,0,1797,1709,-10
40822053986,40822053986,0,1653,1512,-10
40822097563,40822097568,5,2066,2225,-10
40823363653,40823363657,4,1624,1046,-10
40824557301,40824557301,0,1136,1814,-10
40824938988,40824938979,-9,855,3793,-10
40826574371,40826574374,3,1132,1138,-10
40830233130,40830233133,3,1929,1475,-10
40833123974,40833123975,1,1590,1115,-10
40839171390,40839171394,4,1460,2005,-10
40841569851,40841569853,2,1830,1988,-10
40843624814,40843624814,0,1505,1559,-10
40845415728,40845415730,2,1654,1522,-10
40846174173,40846174174,1,2193,1830,-10
40846399254,40846399255,1,2159,1443,-10
40848033111,40848033112,1,1308,1653,-10
40848292578,40848292577,-1,1468,1744,-10
40848919115,40848919115,0,841,619,-10
40850574942,40850574943,1,2210,2622,-10
40850626806,40850626807,1,1683,1338,-10
40854195854,40854195853,-1,1301,1025,-10
40860204606,40860204610,4,1636,1160,-10
40861835829,40861835829,0,1279,1764,-10
40863247109,40863247110,1,1604,2055,-10
40864826347,40864826348,1,1914,1719,-10
40865538429,40865538430,1,1552,1821,-10
40865796084,40865796086,2,788,1270,-10
40866694908,40866694910,2,1613,1211,-10
40869628868,40869628870,2,1842,1413,-10
40869910513,40869910517,4,1135,939,-10
40873300434,40873300439,5,1165,1702,-10
40873371957,40873371957,0,1745,2619,-10
40875778122,40875778125,3,1624,1559,-10
40879817402,40879817401,-1,1262,1297,-10
40881043452,40881043455,3,40,787,-10
40882201879,40882201883,4,1740,1985,-10
40882289577,40882289582,5,1547,1271,-10
40882994977,40882994979,2,1152,1040,-10
40886778627,40886778621,-6,2635,6426,-10
40893348290,40893348291,1,799,1250,-10
40895068190,40895068190,0,972,950,-10
40896493937,40896493939,2,1126,1431,-10
40902322342,40902322343,1,1363,1540,-10
40905890647,40905890650,3,2113,1268,-10
40906579474,40906579476,2,1294,1323,-10
40906623369,40906623366,-3,1161,2257,-10
40908811637,40908811634,-3,1431,1736,-10
40909706013,40909706013,0,1548,1375,-10
40914820961,40914820961,0,1454,1703,-10
40921970726,40921970729,3,1773,1936,-10
40923364089,40923364090,1,1488,1764,-10
40924842450,40924842453,3,1639,1486,-10
40925981403,40925981403,0,1698,1239,-10
40926167313,40926167313,0,1675,1667,-10
40926681002,40926681005,3,1803,2054,-10
40928816503,40928816499,-4,1211,2557,-10
40930686898,40930686899,1,1490,1440,-10
40931313778,40931313780,2,1621,1299,-10
40931385765,40931385769,4,1992,1204,-10
40937346248,40937346251,3,1356,1528,-10
40938830774,40938830777,3,1326,1429,-10
40943762212,40943762215,3,1585,988,-10
40944026389,40944026390,1,1314,1282,-10
40946288123,40946288126,3,1152,1354,-10
40947760003,40947759999,-4,28141,9425,-10
40950904995,40950904994,-1,911,963,-10
40951966867,40951966870,3,2505,2454,-10
40952009342,40952009343,1,1303,1571,-10
40959722444,40959722446,2,1988,1715,-10
40960343463,40960343465,2,2611,1408,-10
40961703390,40961703395,5,1665,1538,-10
40962685546,40962685549,3,1500,1187,-10
40962899520,40962899524,4,1695,1799,-10
40965873898,40965873902,4,1750,1646,-10
40971464918,40971464920,2,1828,1584,-10
40974303738,40974303743,5,2144,1055,-10
40975285767,40975285765,-2,1517,2181,-10
40980023415,40980023416,1,2106,2028,-10
40980661838,40980661842,4,1802,1816,-10
40981907184,40981907185,1,1415,1537,-10
40983286701,40983286701,0,1530,1586,-10
40983312071,40983312074,3,1570,1392,-10
40984842457,40984842457,0,1532,1893,-10
40989260695,40989260695,0,552,1000,-10
40991156818,40991156820,2,1640,1589,-10
40991561887,40991561867,-20,2083,1641,-10
40991681581,40991681581,0,1438,2058,-10
40997642074,40997642074,0,1864,1661,-10
40998514640,40998514642,2,996,1923,-10
40999872452,40999872450,-2,21999,14764,-10
41000753815,41000753817,2,1508,1611,-10
41003052026,41003052032,6,6082,2673,-10
41004193253,41004193257,4,2030,1729,-10
41006163967,41006163970,3,2273,2391,-10
41007132733,41007132734,1,1149,1173,-10
41011664217,41011664222,5,2647,1929,-10
41013215095,41013215094,-1,1024,1533,-10
41014605289,41014605293,4,1667,1107,-10
41021672663,41021672664,1,868,1400,-10
41022071141,41022071145,4,1060,1177,-10
41025628127,41025628129,2,1913,1490,-10
41026089667,41026089669,2,2038,2199,-10
41026554542,41026554542,0,1428,1712,-10
41028791616,41028791618,2,1803,2006,-10
41032286546,41032286546,0,2049,2801,-10
41032979242,41032979244,2,1513,1583,-10
41033427267,41033427274,7,1498,1351,-10
41035234198,41035234201,3,1548,1516,-10
41037470894,41037470897,3,1598,1215,-10
41038522803,41038522800,-3,1165,1760,-10
41041337750,41041337752,2,1552,1448,-10
41043394426,41043394427,1,1889,1817,-10
41048388478,41048388481,3,1377,1580,-10
41052851402,41052851406,4,1361,1041,-10
41056273189,41056273188,-1,596,1877,-10
41057681671,41057681673,2,1092,1162,-10
41058827453,41058827454,1,1540,1664,-10
41059459985,41059459986,1,1159,1396,-10
41061701291,41061701293,2,1604,1380,-10
41063242026,41063242026,0,1553,1907,-10
41063681285,41063681287,2,1210,1124,-10
41066395807,41066395808,1,1743,1650,-10
41066608882,41066608886,4,1105,1341,-10
41067285653,41067285656,3,1548,1276,-10
41068970914,41068970915,1,1398,1283,-10
41069074793,41069074794,1,1845,1615,-10
41072771758,41072771759,1,1737,1921,-10
41073461437,41073461439,2,1535,1528,-10
41075818794,41075818797,3,1981,1656,-10
41076427899,41076427900,1,1251,1514,-10
41077554545,41077554525,-20,2055,1315,-10
41078068714,41078068715,1,2054,1789,-10
41078199622,41078199624,2,1319,1353,-10
41078743942,41078743943,1,1539,1103,-10
41078906463,41078906441,-22,1994,1017,-10
41080479993,41080480010,17,1143,1206,-10
41081642017,41081642023,6,5460,2395,-10
41083732074,41083732075,1,1949,1702,-10
41084127473,41084127474,1,2080,1610,-10
41084740275,41084740278,3,1724,1681,-10
41084867765,41084867767,2,1485,1773,-10
41086287280,41086287302,22,400,631,-10
41091731802,41091731808,6,1866,1778,-10
41092854698,41092854700,2,1369,1744,-10
41093452579,41093452579,0,971,2008,-10
41096933398,41096933400,2,1950,1431,-10
41100168582,41100168586,4,2100,1178,-10
41100520571,41100520572,1,1331,1670,-10
41102699615,41102699617,2,1554,1357,-10
41104027546,41104027548,2,1368,2140,-10
41106901606,41106901617,11,13841,46626,-10
41107900121,41107900123,2,1596,1826,-10
41108909753,41108909755,2,1726,1395,-10
41112355900,41112355902,2,1457,1547,-10
41117139422,41117139426,4,1278,934,-10
41120469880,41120469882,2,1511,2095,-10
41122841041,41122841044,3,1730,1640,-10
41123652308,41123652310,2,2507,1689,-10
41130537344,41130537346,2,1253,1352,-10
41130674330,41130674332,2,1328,1296,-10
41131203989,41131203989,0,1131,1328,-10
41133110038,41133110040,2,1941,2155,-10
41134649435,41134649430,-5,912,2804,-10
41134771588,41134771585,-3,1583,1742,-10
41136569666,41136569667,1,1075,1337,-10
41142284281,41142284281,0,1511,1345,-10
41145149591,41145149593,2,718,1141,-10
41146072497,41146072501,4,1799,1453,-10
41149646195,41149646197,2,1836,1582,-10
41151039818,41151039822,4,1907,1629,-10
41151350746,41151350749,3,1549,1035,-10
41151712850,41151712853,3,1955,1803,-10
41152534315,41152534316,1,1685,1645,-10
41154517903,41154517905,2,2203,1870,-10
41160638339,41160638344,5,1488,1248,-10
41161320951,41161320953,2,1758,1665,-10
41165457820,41165457822,2,1461,860,-10
41167460975,41167460977,2,1060,1306,-10
41169016821,41169016822,1,1509,1552,-10
41169615844,41169615845,1,1557,2319,-10
41170781825,41170781828,3,1680,1721,-10
41174966746,41174966747,1,1628,1815,-10
41175675833,41175675834,1,1714,2086,-10
41176215978,41176215978,0,780,1395,-10
41176649932,41176649932,0,1241,1195,-10
41177982927,41177982930,3,1178,1286,-10
41178601658,41178601658,0,1539,1374,-10
41180018191,41180018193,2,1396,1600,-10
41180414362,41180414363,1,1736,1295,-10
41184845862,41184845863,1,2093,1654,-10
41193760850,41193760851,1,1354,1264,-10
41196820916,41196820911,-5,772,3496,-10
41198642373,41198642377,4,1346,1488,-10
41200366518,41200366516,-2,1038,1477,-10
41202427482,41202427484,2,1641,1482,-10
41203904557,41203904558,1,2074,1387,-10
41208025285,41208025286,1,1903,1623,-10
41215748803,41215748806,3,1497,1362,-10
41218619926,41218619930,4,1768,1577,-10
41224572129,41224572130,1,1365,1494,-10
41226619098,41226619100,2,1753,2208,-10
41227828085,41227828087,2,1814,2108,-10
41229071731,41229071734,3,1921,1527,-10
41229181409,41229181411,2,877,1322,-10
41229760373,41229760375,2,1483,870,-10
41230609970,41230609967,-3,1329,2566,-10
41230657481,41230657484,3,1335,1286,-10
41230743938,41230743940,2,1982,1874,-10
41233049055,41233049059,4,1134,1269,-10
41234580711,41234580714,3,1033,1320,-10
41236921641,41236921637,-4,892,2180,-10
41239997297,41239997300,3,1879,1682,-10
41241038254,41241038255,1,1673,2329,-10
41242537106,41242537106,0,1912,1609,-10
41250099581,41250099583,2,1786,1660,-10
41250677985,41250677990,5,1365,1596,-10
41251402387,41251402389,2,744,1173,-10
41257407656,41257407659,3,1143,1145,-10
41259509260,41259509262,2,1258,1547,-10
41260761415,41260761397,-18,2787,1132,-10
41260927903,41260927904,1,1976,1939,-10
41262296809,41262296802,-7,1384,4226,-10
41263217158,41263217159,1,2127,1797,-10
41266743189,41266743193,4,1081,1732,-10
41271412801,41271412802,1,1695,1853,-10
41271858609,41271858610,1,2081,1936,-10
41272117852,41272117854,2,1631,1496,-10
41272887922,41272887923,1,1451,1561,-10
41274098755,41274098757,2,1497,1312,-10
41278797617,41278797618,1,1272,841,-10
41279588860,41279588865,5,2077,1130,-10
41279728742,41279728761,19,1719,1231,-10
41282958488,41282958493,5,3263,2040,-10
41284156963,41284156965,2,1147,1827,-10
41285562709,41285562711,2,1129,982,-10
41285946734,41285946730,-4,1341,194,-10
41290121030,41290121031,1,1203,1440,-10
41291525956,41291525958,2,1371,1789,-10
41295467401,41295467406,5,1646,1418,-10
41298584062,41298584065,3,1333,1570,-10
41299404091,41299404092,1,1147,1601,-10
41300721303,41300721306,3,1414,1650,-10
41301948502,41301948506,4,1693,1270,-10
41302260746,41302260749,3,1757,1642,-10
41303291382,41303291388,6,11780,23643,-10
41304958591,41304958593,2,755,1397,-10
41307318773,41307318774,1,2549,4106,-10
41308289545,41308289563,18,1476,1477,-10
41308749692,41308749682,-10,1473,1300,-10
41309352034,41309352035,1,1623,1688,-10
41311615625,41311615630,5,1046,1120,-10
41312313898,41312313892,-6,2143,7243,-10
41312389766,41312389768,2,1112,1761,-10
41312620342,41312620347,5,1491,1690,-10
41313922474,41313922478,4,835,876,-10
41321122914,41321122916,2,2101,1778,-10
41326253085,41326253086,1,1418,901,-10
41328330286,41328330286,0,1279,1736,-10
41329872542,41329872543,1,1900,1928,-10
41331773029,41331773030,1,1523,2051,-10
41331887626,41331887617,-9,1028,1373,-10
41332350206,41332350210,4,1820,1266,-10
41333326190,41333326178,-12,23678,14779,-10
41335154657,41335154650,-7,1121,3264,-10
41338720336,41338720339,3,1629,1496,-10
41339960645,41339960647,2,1743,1554,-10
41342379287,41342379290,3,2185,1478,-10
41343278161,41343278164,3,2762,1537,-10
41350149551,41350149555,4,1239,1101,-10
41353036945,41353036949,4,2269,2134,-10
41354165491,41354165494,3,2030,1715,-10
41355852216,41355852218,2,2004,1740,-10
41359403067,41359403069,2,1429,1496,-10
41359658807,41359658809,2,5792,26336,-10
41361126806,41361126810,4,1074,790,-10
41363094149,41363094150,1,1225,1247,-10
41365251603,41365251603,0,1722,1925,-10
41365743827,41365743830,3,2243,1975,-10
41365885729,41365885730,1,981,1042,-10
41366227268,41366227272,4,1164,1455,-10
41368326192,41368326189,-3,660,1909,-10
41371028461,41371028467,6,3612,1486,-10
41371370703,41371370681,-22,751,381,-10
41374205432,41374205434,2,1578,2173,-10
41375729576,41375729583,7,2950,1063,-10
41376375825,41376375827,2,1609,1185,-10
41376766294,41376766297,3,1431,1408,-10
41378210586,41378210592,6,1577,1344,-10
41378863907,41378863908,1,1094,1088,-10
41380377314,41380377315,1,1598,1560,-10
41382663933,41382663934,1,929,1650,-10
41385600851,41385600854,3,1467,1474,-10
41387619506,41387619512,6,7186,38888,-10
41388256832,41388256835,3,1399,1332,-10
41389581794,41389581796,2,2109,1600,-10
41391608686,41391608687,1,1534,1648,-10
41398904827,41398904828,1,1391,1493,-10
41398986384,41398986385,1,1459,1537,-10
41399650355,41399650355,0,1289,869,-10
41401602261,41401602262,1,1181,1507,-10
41402291345,41402291347,2,2155,1601,-10
41402795529,41402795532,3,1500,1827,-10
41404282453,41404282454,1,1496,1746,-10
41411022998,41411022997,-1,1370,1770,-10
41414935137,41414935127,-10,1413,1655,-10
41416356417,41416356418,1,1360,1461,-10
41417211728,41417211726,-2,824,1226,-10
41418405584,41418405586,2,1019,1206,-10
41419823719,41419823721,2,1868,1949,-10
41422235714,41422235717,3,1466,1818,-10
41424700996,41424700998,2,1807,1135,-10
41427241552,41427241557,5,1902,1449,-10
41429234021,41429234024,3,1492,1660,-10
41429999214,41429999214,0,1253,1582,-10
41430666369,41430666369,0,1499,1920,-10
41432787529,41432787531,2,1704,1129,-10
41434709347,41434709342,-5,1445,3283,-10
41439072166,41439072170,4,1393,1386,-10
41441018929,41441018930,1,1413,1226,-10
41451589537,41451589539,2,1780,1220,-10
41452509081,41452509082,1,1228,1398,-10
41455732927,41455732930,3,1086,1174,-10
41458387405,41458387407,2,1913,1312,-10
41459126837,41459126838,1,1477,1340,-10
41460155486,41460155490,4,1509,1782,-10
41460607631,41460607631,0,808,1043,-10
41465097184,41465097186,2,1891,1748,-10
41466359759,41466359761,2,1354,1445,-10
41470236971,41470236970,-1,504,825,-10
41470853226,41470853224,-2,1258,1700,-10
41472141115,41472141118,3,1633,1592,-10
41472941188,41472941200,12,1494,1491,-10
41475136723,41475136726,3,1180,990,-10
41477393651,41477393654,3,901,835,-10
41477543916,41477543915,-1,1089,1509,-10
41478728800,41478728802,2,1786,1322,-10
41479397117,41479397120,3,1521,1610,-10
41479580895,41479580899,4,2131,2169,-10
41480309813,41480309794,-19,1489,1689,-10
41483418726,41483418727,1,1323,1532,-10
41484123067,41484123068,1,1659,1529,-10
41488443717,41488443719,2,1154,1461,-10
41488691264,41488691268,4,2252,1610,-10
41489344462,41489344469,7,2884,1658,-10
41491871617,41491871625,8,3168,1438,-10
41492166874,41492166879,5,1896,1509,-10
41493040174,41493040177,3,1581,1768,-10
41494733750,41494733753,3,776,961,-10
41506520266,41506520269,3,2175,2065,-10
41506905569,41506905571,2,1800,1227,-10
41506989726,41506989738,12,1059,745,-10
41511808439,41511808442,3,945,1170,-10
41511907067,41511907069,2,1286,1281,-10
41515229191,41515229193,2,1157,1288,-10
41517232188,41517232204,16,361,1359,-10
41519973757,41519973767,10,10229,35085,-10
41520282676,41520282677,1,1647,1351,-10
41520491621,41520491640,19,1803,1844,-10
41520812737,41520812739,2,1806,1335,-10
41522936829,41522936829,0,1678,1339,-10
41525110195,41525110198,3,1973,1567,-10
41532922835,41532922839,4,2225,1402,-10
41534818618,41534818618,0,1696,1541,-10
41538311821,41538311823,2,1792,1958,-10
41539547421,41539547423,2,1188,1563,-10
41541224857,41541224858,1,756,941,-10
41542220265,41542220265,0,1125,1518,-10
41543285886,41543285888,2,1545,1674,-10
41543744586,41543744587,1,2243,1795,-10
41548739123,41548739125,2,2038,2163,-10
41550390453,41550390454,1,1690,1424,-10
41551921745,41551921747,2,1787,2086,-10
41552586385,41552586386,1,1282,1282,-10
41552850848,41552850849,1,1568,1993,-10
41553410809,41553410813,4,1746,1978,-10
41555944093,41555944100,7,4792,1498,-10
41557602110,41557602111,1,1737,1892,-10
41558699549,41558699556,7,2260,1214,-10
41559014789,41559014790,1,1518,1649,-10
41562835655,41562835657,2,1705,1472,-10
41563647508,41563647511,3,1368,1862,-10
41570330504,41570330506,2,1431,1597,-10
41570973093,41570973107,14,906,90,-10
41572798974,41572798973,-1,1979,1557,-10
41574439633,41574439634,1,1193,1615,-10
41577218281,41577218282,1,1644,2249,-10
41579115385,41579115385,0,2130,2227,-10
41579315874,41579315878,4,2081,1767,-10
41581871517,41581871518,1,1347,1366,-10
41586211955,41586211958,3,1384,1778,-10
41586420364,41586420363,-1,1544,1880,-10
41588077933,41588077947,14,14492,37423,-10
41589470870,41589470871,1,1745,2021,-10
41590191385,41590191383,-2,1192,2481,-10
41594479514,41594479513,-1,1420,2762,-10
41595243997,41595243998,1,733,896,-10
41596640535,41596640536,1,1925,2352,-10
41597264032,41597264033,1,1595,1320,-10
41602635687,41602635688,1,622,909,-10
41606913499,41606913500,1,2124,1924,-10
41607601213,41607601217,4,1762,1257,-10
41607868315,41607868314,-1,1153,1026,-10
41610136303,41610136302,-1,1449,891,-10
41613171622,41613171629,7,3306,1699,-10
41613639345,41613639346,1,1717,1327,-10
41615529110,41615529112,2,944,675,-10
41626663096,41626663098,2,1844,1534,-10
41627097826,41627097829,3,1795,1590,-10
41630831622,41630831625,3,1532,1653,-10
41632126914,41632126917,3,1282,1657,-10
41633252314,41633252317,3,978,1381,-10
41634860509,41634860510,1,1645,1427,-10
41637237678,41637237686,8,2001,1185,-10
41638192974,41638192974,0,1578,1908,-10
41638992602,41638992604,2,1311,1306,-10
41640770838,41640770840,2,1982,1869,-10
41643494959,41643494961,2,1210,1364,-10
41645745534,41645745537,3,1017,1086,-10
41648067831,41648067835,4,1581,1367,-10
41650801528,41650801548,20,1000,882,-10
41650890375,41650890379,4,1923,1357,-10
41654701323,41654701322,-1,1513,1033,-10
41662925981,41662925982,1,1198,1602,-10
41662985233,41662985238,5,2727,1278,-10
41664622938,41664622939,1,1599,1613,-10
41666588534,41666588530,-4,774,2775,-10
41670119491,41670119495,4,1811,1718,-10
41672016575,41672016576,1,1429,1027,-10
41672224628,41672224629,1,1777,1656,-10
41679011793,41679011805,12,400,3968,-10
41679859649,41679859652,3,1970,1324,-10
41681471098,41681471102,4,1648,1441,-10
41683423401,41683423405,4,1396,1328,-10
41685431756,41685431766,10,280,1247,-10
41686939673,41686939675,2,2002,1852,-10
41689837671,41689837673,2,1525,1921,-10
41691086075,41691086078,3,1511,1666,-10
41691347718,41691347720,2,1945,2060,-10
41695298622,41695298617,-5,676,2711,-10
41698256426,41698256428,2,1530,1486,-10
41698612579,41698612582,3,1451,1766,-10
41699688733,41699688734,1,1671,1413,-10
41700312971,41700312973,2,1254,1340,-10
41705873710,41705873714,4,2176,1468,-10
41706881791,41706881794,3,1896,1634,-10
41710632934,41710632934,0,1705,1781,-10
41711867558,41711867560,2,2049,1542,-10
41712394425,41712394418,-7,1954,7578,-10
41717700990,41717700992,2,1193,1445,-10
41718415978,41718415980,2,1637,1690,-10
41720619401,41720619403,2,1558,1391,-10
41720906169,41720906170,1,2023,2062,-10
41722927241,41722927242,1,1532,1780,-10
41725749063,41725749064,1,1142,1923,-10
41726636038,41726636038,0,1161,1881,-10
41727777157,41727777158,1,1985,1108,-10
41727950181,41727950182,1,1338,1540,-10
41729289655,41729289655,0,1280,1393,-10
41736278334,41736278336,2,1354,1832,-10
41736844878,41736844879,1,1875,1259,-10
41738928470,41738928472,2,2431,1312,-10
41743264403,41743264405,2,1603,1317,-10
41744637473,41744637474,1,1813,1320,-10
41744901366,41744901367,1,1549,2010,-10
41746902954,41746902954,0,1309,1383,-10
41750364125,41750364127,2,1797,1379,-10
41757093406,41757093409,3,950,882,-10
41758410395,41758410397,2,1296,1078,-10
41760203342,41760203342,0,1405,1581,-10
41763504978,41763504983,5,22270,24616,-10
41768067846,41768067848,2,1745,1698,-10
41769147305,41769147306,1,1065,934,-10
41773781986,41773781987,1,1664,1753,-10
41775623710,41775623712,2,1311,1471,-10
41781256582,41781256583,1,2134,1871,-10
41787466850,41787466854,4,1480,1407,-10
41787914919,41787914920,1,1788,1716,-10
41788076677,41788076676,-1,1832,1255,-10
41793554490,41793554490,0,1449,824,-10
41796559173,41796559175,2,1461,1315,-10
41799693022,41799693023,1,1734,1552,-10
41799988989,41799988986,-3,1507,2538,-10
41800593905,41800593908,3,1870,1401,-10
41803177850,41803177853,3,1012,1274,-10
41803802200,41803802202,2,1662,1603,-10
41804661375,41804661378,3,1451,1486,-10
41806880385,41806880387,2,1812,1669,-10
41811364863,41811364865,2,2234,1444,-10
41811553085,41811553082,-3,1462,2501,-10
41811668944,41811668943,-1,2002,1689,-10
41812092435,41812092435,0,1848,1411,-10
41814385993,41814385993,0,1526,1984,-10
41815870513,41815870514,1,1683,1569,-10
41817181841,41817181843,2,1427,1456,-10
41817485967,41817485968,1,1517,1797,-10
41817868809,41817868811,2,1807,1518,-10
41818459130,41818459133,3,1173,1060,-10
41818756926,41818756927,1,1557,1972,-10
41820475986,41820475991,5,1247,1025,-10
41821552974,41821552963,-11,914,330,-10
41823654227,41823654236,9,1435,1304,-10
41825316051,41825316045,-6,1127,2047,-10
41825755114,41825755114,0,1245,2755,-10
41833395859,41833395855,-4,2015,5621,-10
41838877675,41838877679,4,1221,1616,-10
41838981042,41838981044,2,1552,1550,-10
41843109745,41843109747,2,2097,1633,-10
41843842482,41843842486,4,1627,1142,-10
41845724899,41845724906,7,10765,37051,-10
41846292577,41846292561,-16,1052,2496,-10
41847023024,41847023025,1,1747,1667,-10
41851723030,41851723031,1,1845,2085,-10
41852015079,41852015082,3,1725,1197,-10
41854847557,41854847557,0,1333,1537,-10
41857568636,41857568635,-1,1656,1237,-10
41857957169,41857957171,2,1511,1451,-10
41864243483,41864243483,0,1554,1670,-10
41864363657,41864363654,-3,1300,2720,-10
41866589742,41866589746,4,1589,1401,-10
41869087012,41869087014,2,952,1325,-10
41873226933,41873226933,0,896,1385,-10
41874677727,41874677727,0,1305,1494,-10
41882950801,41882950805,4,1539,1535,-10
41884416418,41884416421,3,2186,1674,-10
41887067949,41887067949,0,1321,1460,-10
41890300941,41890300944,3,1487,1448,-10
41890575881,41890575880,-1,2018,2386,-10
41891079411,41891079414,3,1203,803,-10
41891112120,41891112114,-6,1440,1217,-10
41892958680,41892958682,2,1408,1046,-10
41893400673,41893400677,4,1851,1551,-10
41894201269,41894201270,1,1383,1462,-10
41897480542,41897480543,1,1554,1076,-10
41899664057,41899664058,1,1502,1457,-10
41900479808,41900479809,1,1999,1721,-10
41903405173,41903405195,22,1475,1756,-10
41904534285,41904534286,1,1801,1752,-10
41905708491,41905708493,2,1404,1415,-10
41912772961,41912772961,0,1766,2198,-10
41915488142,41915488145,3,1414,1510,-10
41919726742,41919726745,3,911,1140,-10
41921740526,41921740527,1,1627,1319,-10
41923236038,41923236037,-1,976,2414,-10
41926651034,41926651039,5,2120,1588,-10
41928018143,41928018147,4,752,606,-10
41929302127,41929302129,2,1497,1842,-10
41940785870,41940785872,2,1485,1475,-10
41944158220,41944158222,2,1566,1393,-10
41947367653,41947367654,1,1361,1340,-10
41951129143,41951129145,2,2144,2413,-10
41952189476,41952189474,-2,1233,4522,-10
41954884281,41954884282,1,1668,1436,-10
41955592099,41955592101,2,1749,1369,-10
41966115802,41966115802,0,1085,1502,-10
41970945350,41970945353,3,1680,1458,-10
41971091950,41971091971,21,1192,904,-10
41973833120,41973833122,2,1849,2161,-10
41974829329,41974829331,2,1621,1988,-10
41974927020,41974927023,3,1803,1533,-10
41977758743,41977758743,0,1675,2256,-10
41979729049,41979729050,1,2242,1571,-10
41980431875,41980431879,4,1055,1511,-10
41980596966,41980596969,3,1488,1091,-10
41984887098,41984887118,20,678,235,-10
41988790226,41988790229,3,1475,1374,-10
41989174972,41989174974,2,1767,1519,-10
41992531393,41992531393,0,1233,1480,-10
41995001019,41995001023,4,1501,1192,-10
41997721341,41997721342,1,1954,1574,-10
41999060100,41999060102,2,1468,1792,-10
42002116241,42002116242,1,1184,1474,-10
42004188999,42004189001,2,1462,1317,-10
42004371690,42004371690,0,1212,1558,-10
42008886112,42008886115,3,2341,1627,-10
42010776500,42010776501,1,1164,1435,-10
42012500609,42012500611,2,993,1279,-10
42012974717,42012974721,4,1938,1568,-10
42014005884,42014005887,3,618,787,-10
42015478375,42015478377,2,1580,2009,-10
42017185058,42017185059,1,1102,1663,-10
42018889422,42018889422,0,1404,2126,-10
42026473899,42026473901,2,1598,1247,-10
42029241789,42029241790,1,1117,1466,-10
42030966270,42030966273,3,1320,959,-10
42032138562,42032138563,1,1432,1558,-10
42033630762,42033630762,0,1182,1770,-10
42034062609,42034062611,2,1429,1769,-10
42035049051,42035049053,2,1468,1936,-10
42037121480,42037121480,0,1452,1376,-10
42037764958,42037764953,-5,2304,8477,-10
42038362230,42038362230,0,1250,1366,-10
42038431511,42038431513,2,1428,1978,-10
42042691553,42042691554,1,1410,1944,-10
42045302395,42045302397,2,1675,2218,-10
42045592464,42045592465,1,1757,965,-10
42046105012,42046105014,2,1411,1106,-10
42048009354,42048009355,1,1577,1403,-10
42048349838,42048349842,4,1596,1587,-10
42048997590,42048997591,1,810,1077,-10
42051909546,42051909549,3,1418,1588,-10
42054078094,42054078096,2,1965,1709,-10
42056825275,42056825278,3,1466,1204,-10
42061533705,42061533708,3,1960,1514,-10
42064539419,42064539423,4,1095,1806,-10
42068734574,42068734575,1,1419,1277,-10
42071561373,42071561375,2,1908,2018,-10
42071668713,42071668714,1,1343,1171,-10
42072470203,42072470203,0,1144,1917,-10
42074412168,42074412170,2,1122,2006,-10
42074853894,42074853892,-2,1045,1441,-10
42078663374,42078663377,3,1382,1413,-10
42079708287,42079708291,4,1486,1404,-10
42079978309,42079978307,-2,2202,4426,-10
42080565133,42080565134,1,37036,34977,-10
42081558793,42081558794,1,1356,1474,-10
42081606883,42081606886,3,1403,1361,-10
42085535602,42085535603,1,1343,1558,-10
42087397418,42087397420,2,1599,1350,-10
42089368344,42089368345,1,1123,1352,-10
42089627853,42089627855,2,2085,1084,-10
42092131868,42092131868,0,1417,1617,-10
42095838342,42095838336,-6,925,2340,-10
42098426869,42098426891,22,1143,1090,-10
42110478330,42110478334,4,1954,1677,-10
42112649864,42112649867,3,2215,1607,-10
42113925587,42113925589,2,1200,1364,-10
42117080381,42117080383,2,1404,1399,-10
42118724005,42118724007,2,1695,1597,-10
42119512738,42119512738,0,1401,1183,-10
42120392715,42120392718,3,1717,1415,-10
42125877277,42125877281,4,1273,1298,-10
42127621426,42127621429,3,2004,1693,-10
42129016472,42129016474,2,2046,2388,-10
42129688929,42129688931,2,761,1033,-10
42133879517,42133879518,1,1469,1748,-10
42135187568,42135187570,2,1602,1463,-10
42137373901,42137373902,1,1575,1708,-10
42139537313,42139537314,1,1565,1512,-10
42146190032,42146190034,2,1230,946,-10
42148333620,42148333620,0,1487,1987,-10
42148412210,42148412212,2,1157,1364,-10
42149198206,42149198185,-21,1129,1374,-10
42151233687,42151233693,6,1216,1010,-10
42153075096,42153075099,3,1653,2044,-10
42156170408,42156170410,2,1575,1594,-10
42157427978,42157427981,3,1614,1559,-10
42159876268,42159876269,1,2272,1543,-10
42163541577,42163541580,3,1456,1146,-10
42164296642,42164296636,-6,1572,6366,-10
42169747498,42169747499,1,1478,1904,-10
42172563223,42172563223,0,1684,1739,-10
42173826778,42173826777,-1,1580,2455,-10
42174291758,42174291757,-1,1663,1376,-10
42176547015,42176547017,2,1045,1417,-10
42178915907,42178915910,3,1597,1420,-10
42180127618,42180127623,5,1086,1582,-10
42183950047,42183950050,3,1703,1999,-10
42184220805,42184220806,1,1693,1775,-10
42185056697,42185056693,-4,1352,2207,-10
42185419945,42185419947,2,1860,1522,-10
42185604873,42185604877,4,1804,1495,-10
42186333275,42186333278,3,1766,1645,-10
42186759331,42186759331,0,1366,1522,-10
42192573515,42192573515,0,1691,1456,-10
42194227767,42194227767,0,1181,981,-10
42194423715,42194423718,3,1373,1120,-10
42195336712,42195336719,7,1897,1047,-10
42199715104,42199715084,-20,1281,1264,-10
42200563046,42200563046,0,1930,1943,-10
42202231738,42202231742,4,1674,1705,-10
42211434304,42211434306,2,2021,2113,-10
42215998772,42215998773,1,1659,1928,-10
42222508650,42222508651,1,1334,1263,-10
42223082666,42223082666,0,1219,769,-10
42223226623,42223226623,0,1355,1656,-10
42224495758,42224495760,2,2270,1865,-10
42227614583,42227614585,2,1531,1224,-10
42227644908,42227644908,0,894,1325,-10
42228227289,42228227291,2,862,630,-10
42229561015,42229561019,4,1761,1337,-10
42232925187,42232925192,5,1558,1102,-10
42235659927,42235659928,1,1347,1511,-10
42235686966,42235686977,11,1811,1714,-10
42238108907,42238108906,-1,26815,45902,-10
42238530859,42238530859,0,1183,1938,-10
42244202446,42244202449,3,1369,2199,-10
42244405890,42244405892,2,1377,1737,-10
42245116039,42245116042,3,1570,1291,-10
42246743947,42246743950,3,2080,1363,-10
42248322543,42248322545,2,1805,2040,-10
42250268650,42250268653,3,1142,1639,-10
42255887601,42255887602,1,2056,1742,-10
42259604566,42259604574,8,3015,1485,-10
42263452538,42263452539,1,1263,1115,-10
42265736850,42265736852,2,1646,1421,-10
42271692829,42271692830,1,1115,1130,-10
42273174562,42273174565,3,1381,1492,-10
42273625690,42273625693,3,1269,1713,-10
42275555036,42275555038,2,1169,1194,-10
42276291430,42276291430,0,1923,1734,-10
42278752890,42278752892,2,2004,2499,-10
42279277349,42279277353,4,1962,2349,-10
42279523182,42279523185,3,1336,1762,-10
42280029328,42280029330,2,1770,1958,-10
42286533701,42286533703,2,1421,1301,-10
42290733519,42290733522,3,1985,1274,-10
42294808550,42294808554,4,800,905,-10
42297202611,42297202614,3,2070,1794,-10
42298114786,42298114789,3,960,1336,-10
42307538975,42307538978,3,1698,1545,-10
42308675544,42308675546,2,1385,1429,-10
42313179803,42313179806,3,1733,1343,-10
42317148699,42317148699,0,1741,1356,-10
42317799965,42317799966,1,1223,1913,-10
42318304192,42318304194,2,1593,1691,-10
42319279985,42319279990,5,1709,1222,-10
42320501034,42320501035,1,1419,1390,-10
42320751314,42320751317,3,1630,1956,-10
42321026945,42321026947,2,1399,1646,-10
42322153478,42322153482,4,2308,2325,-10
42322223057,42322223058,1,1547,1255,-10
42324803581,42324803583,2,1294,1261,-10
42331645943,42331645947,4,2965,1483,-10
42333256646,42333256647,1,948,1286,-10
42335931191,42335931193,2,1489,1892,-10
42337692716,42337692718,2,2228,1683,-10
42339648826,42339648826,0,1485,1323,-10
42344905321,42344905323,2,2509,1826,-10
42345927174,42345927176,2,1387,1505,-10
42346840625,42346840625,0,1087,2172,-10
42351964526,42351964527,1,1780,1578,-10
42352049979,42352049981,2,877,1528,-10
42352982433,42352982434,1,1803,1369,-10
42354739297,42354739299,2,2044,1474,-10
42358018494,42358018496,2,808,1165,-10
42360544134,42360544134,0,2295,1972,-10
42365820095,42365820096,1,1484,1397,-10
42367498219,42367498220,1,892,1384,-10
42369243613,42369243615,2,1415,939,-10
42374997009,42374997013,4,1720,1301,-10
42375384707,42375384707,0,1171,1470,-10
42376380280,42376380281,1,1595,1374,-10
42378198694,42378198695,1,1287,1144,-10
42379778917,42379778918,1,1611,1555,-10
42381352238,42381352242,4,2241,1948,-10
42383893581,42383893582,1,1577,1376,-10
42385331796,42385331799,3,1350,874,-10
42386808662,42386808664,2,1232,1315,-10
42391442229,42391442231,2,1494,1832,-10
42392139104,42392139106,2,2014,1530,-10
42396083586,42396083586,0,1625,991,-10
42396259486,42396259489,3,1365,1520,-10
42398535055,42398535066,11,1348,1742,-10
42407485014,42407485017,3,980,1336,-10
42409451418,42409451418,0,28145,36061,-10
42412127862,42412127863,1,1309,1205,-10
42413343730,42413343732,2,1609,1353,-10
42415578299,42415578301,2,1329,1265,-10
42422379614,42422379615,1,2128,2456,-10
42422492127,42422492130,3,1755,1764,-10
42422767558,42422767560,2,1951,1761,-10
42423182798,42423182800,2,1160,1423,-10
42423835075,42423835078,3,973,1016,-10
42426013810,42426013811,1,1161,1315,-10
42426332513,42426332514,1,1629,1244,-10
42428294563,42428294565,2,1668,1626,-10
42430649592,42430649594,2,1883,2235,-10
42430951959,42430951959,0,470,1005,-10
42432499757,42432499757,0,1172,1172,-10
42434134177,42434134178,1,979,1651,-10
42436910985,42436910964,-21,2181,2003,-10
42438371346,42438371349,3,2107,1806,-10
42441414358,42441414362,4,1613,1025,-10
42441943643,42441943645,2,2045,1930,-10
42443819814,42443819815,1,1230,1441,-10
42453835968,42453835965,-3,945,1122,-10
42455293926,42455293928,2,1132,1235,-10
42455830822,42455830823,1,7609,8414,-10
42456348189,42456348191,2,1996,1585,-10
42456600695,42456600697,2,1704,1970,-10
42458460138,42458460146,8,3680,1103,-10
42460122608,42460122609,1,18886,12052,-10
42462506234,42462506238,4,1949,1929,-10
42463009945,42463009942,-3,4091,7078,-10
42463349547,42463349547,0,1633,1545,-10
42463917501,42463917505,4,1699,1369,-10
42469336914,42469336917,3,1330,1692,-10
42473365659,42473365660,1,1550,1008,-10
42475386171,42475386175,4,2190,1312,-10
42478006194,42478006195,1,1294,1369,-10
42480460045,42480460046,1,1325,1369,-10
42482638634,42482638634,0,1371,1494,-10
42485841319,42485841322,3,1819,1654,-10
42486447789,42486447791,2,1463,1556,-10
42488351224,42488351226,2,1653,1515,-10
42493145450,42493145450,0,1518,2161,-10
42493634683,42493634686,3,2052,1685,-10
42495304784,42495304784,0,1574,1594,-10
42498981958,42498981959,1,2021,1741,-10
42499842977,42499842975,-2,1299,2140,-10
42500492985,42500492985,0,1590,1699,-10
42500525430,42500525434,4,1497,1181,-10
42501232970,42501232971,1,1678,1644,-10
42501596825,42501596813,-12,106,1446,-10
42501721769,42501721770,1,1568,1462,-10
42502242929,42502242932,3,2111,2255,-10
42502295750,42502295750,0,1534,1645,-10
42503645986,42503645990,4,1630,1108,-10
42508038862,42508038865,3,1671,1398,-10
42509717933,42509717935,2,940,966,-10
42509812338,42509812339,1,1001,1214,-10
42510392226,42510392226,0,1244,1375,-10
42511227931,42511227931,0,1972,1924,-10
42511609259,42511609261,2,1129,979,-10
42513304147,42513304150,3,2047,2314,-10
42514940286,42514940287,1,1487,1457,-10
42517849341,42517849343,2,1405,1722,-10
42519485821,42519485801,-20,446,452,-10
42520703047,42520703051,4,1542,1854,-10
42520746470,42520746474,4,1240,1530,-10
42521933498,42521933501,3,1538,1454,-10
42522939661,42522939661,0,2424,1599,-10
42525877359,42525877360,1,1688,1341,-10
42531577942,42531577943,1,1904,1669,-10
42532698784,42532698787,3,2388,1750,-10
42532837443,42532837443,0,1282,1779,-10
42534538803,42534538804,1,1918,2577,-10
42538975899,42538975906,7,5028,2166,-10
42539251198,42539251202,4,1524,2101,-10
42539316622,42539316622,0,1491,1768,-10
42540980338,42540980339,1,1363,1801,-10
42541772959,42541772967,8,3845,1696,-10
42541883900,42541883912,12,2399,1987,-10
42542083351,42542083349,-2,1591,2524,-10
42542540766,42542540769,3,1922,2074,-10
42543155658,42543155662,4,4653,3293,-10
42543432183,42543432183,0,1094,949,-10
42549265399,42549265399,0,1960,1403,-10
42549636373,42549636373,0,1395,1974,-10
42549711431,42549711433,2,1482,1579,-10
42550108838,42550108841,3,2378,2066,-10
42554741460,42554741462,2,997,1141,-10
42557187730,42557187732,2,1838,1588,-10
42557875782,42557875786,4,1803,1388,-10
42561290632,42561290634,2,1713,1889,-10
42561348799,42561348803,4,1807,1360,-10
42562119797,42562119798,1,1272,1113,-10
42562996459,42562996460,1,1595,1609,-10
42563917029,42563917030,1,1725,1936,-10
42565416744,42565416745,1,1541,1525,-10
42565529713,42565529710,-3,1366,1651,-10
42567816848,42567816848,0,1550,2342,-10
42575819806,42575819810,4,1700,1267,-10
42578010490,42578010497,7,21133,54511,-10
42580326314,42580326313,-1,1993,2275,-10
42580784909,42580784911,2,1818,1619,-10
42583622325,42583622318,-7,426,1413,-10
42587735421,42587735423,2,1858,1672,-10
42587811320,42587811322,2,1365,1390,-10
42589588541,42589588542,1,854,1316,-10
42590594141,42590594123,-18,1564,1929,-10
42594854341,42594854346,5,2367,1139,-10
42596063670,42596063673,3,1671,1538,-10
42596308033,42596308035,2,1151,1366,-10
42596679346,42596679349,3,1421,1553,-10
42598200909,42598200909,0,1243,1250,-10
42602953807,42602953809,2,2281,2087,-10
42604444154,42604444155,1,1582,1918,-10
42604749729,42604749736,7,37037,15901,-10
42606707194,42606707192,-2,1797,2903,-10
42606812003,42606812005,2,1806,1753,-10
42606915818,42606915818,0,1977,1411,-10
42607192786,42607192786,0,1126,1261,-10
42609110738,42609110738,0,1140,1127,-10
42612868530,42612868532,2,1745,2250,-10
42613471788,42613471785,-3,1227,1244,-10
42618360406,42618360407,1,1721,1287,-10
42622994391,42622994389,-2,1216,1382,-10
42624204898,42624204900,2,1054,1050,-10
42629505009,42629505006,-3,1545,5048,-10
42629678398,42629678400,2,1467,1428,-10
42632211346,42632211346,0,1547,1307,-10
42633675666,42633675666,0,1474,1543,-10
42634653152,42634653154,2,1209,1530,-10
42635353265,42635353268,3,1466,2135,-10
42636525509,42636525513,4,2754,1881,-10
42637230395,42637230394,-1,1658,1322,-10
42640869926,42640869929,3,1352,1153,-10
42641748766,42641748754,-12,10672,40238,-10
42642775093,42642775094,1,1173,1449,-10
42645251549,42645251550,1,1590,941,-10
42646210341,42646210341,0,1199,1900,-10
42651659891,42651659892,1,1430,1045,-10
42652108666,42652108667,1,1744,1249,-10
42654406747,42654406749,2,1572,1585,-10
42660042713,42660042717,4,1996,1636,-10
42662435926,42662435929,3,1925,1464,-10
42663296149,42663296153,4,1567,1251,-10
42664840720,42664840742,22,2162,2438,-10
42671270046,42671270047,1,1777,1420,-10
42673643941,42673643942,1,1436,1366,-10
42674813818,42674813810,-8,1627,1609,-10
42674839093,42674839097,4,1234,1329,-10
42675229007,42675229010,3,1149,1340,-10
42675361121,42675361130,9,1256,1056,-10
42682617722,42682617724,2,1963,1522,-10
42682986495,42682986495,0,1213,1476,-10
42685824746,42685824747,1,1428,1349,-10
42685901753,42685901755,2,1638,1436,-10
42687104886,42687104887,1,1125,1173,-10
42687830490,42687830493,3,1182,1576,-10
42695933074,42695933075,1,1327,1492,-10
42697287572,42697287553,-19,1432,1395,-10
42699033491,42699033493,2,1625,1532,-10
42700788310,42700788311,1,1509,1361,-10
42701364955,42701364959,4,1335,1435,-10
42704936825,42704936826,1,1164,1427,-10
42706391278,42706391279,1,1762,1805,-10
42706752374,42706752378,4,1732,1370,-10
42709335918,42709335919,1,1238,1029,-10
42710226219,42710226223,4,1560,1192,-10
42710751467,42710751470,3,1089,1050,-10
42719075390,42719075390,0,1460,948,-10
42727326211,42727326211,0,2180,1514,-10
42727817882,42727817883,1,1297,1501,-10
42730147937,42730147938,1,1395,1441,-10
42735672070,42735672075,5,2698,1191,-10
42736775698,42736775703,5,4583,3137,-10
42739430416,42739430421,5,2137,1679,-10
42739628854,42739628854,0,1451,2011,-10
42741256118,42741256119,1,2526,1435,-10
42750223878,42750223881,3,1880,1643,-10
42750419005,42750419007,2,1114,1607,-10
42752749979,42752749981,2,1771,1682,-10
42753889287,42753889291,4,1827,2151,-10
42754246978,42754246978,0,1634,2229,-10
42760791626,42760791626,0,1687,2028,-10
42762387526,42762387528,2,1480,1337,-10
42768982559,42768982558,-1,1368,1482,-10
42769559391,42769559395,4,1578,1968,-10
42769961593,42769961594,1,2342,2022,-10
42778949772,42778949773,1,1323,1665,-10
42783312523,42783312524,1,1164,2044,-10
42783357094,42783357097,3,1505,1109,-10
42783454218,42783454219,1,1783,1352,-10
42784218011,42784218013,2,1972,1867,-10
42791542126,42791542126,0,1159,1012,-10
42793659085,42793659085,0,1281,1850,-10
42797511196,42797511192,-4,1557,1192,-10
42799812226,42799812228,2,2235,2258,-10
42806488830,42806488831,1,1457,1861,-10
42809330692,42809330694,2,1524,1561,-10
42811343871,42811343875,4,1115,828,-10
42812015030,42812015033,3,1393,938,-10
42817191838,42817191840,2,1918,1640,-10
42817437893,42817437894,1,1309,1007,-10
42820555934,42820555933,-1,1281,1673,-10
42821805494,42821805496,2,1827,1403,-10
42821936686,42821936687,1,2332,2119,-10
42822498076,42822498069,-7,2300,9647,-10
42822862446,42822862441,-5,1508,4843,-10
42835981952,42835981952,0,1462,1826,-10
42838595605,42838595603,-2,23657,7204,-10
42838892002,42838892003,1,1765,1441,-10
42838989141,42838989142,1,1410,1428,-10
42839933923,42839933925,2,1771,1806,-10
42840907747,42840907750,3,1127,1040,-10
42843088474,42843088474,0,1521,1396,-10
42844353455,42844353455,0,1770,1516,-10
42846915739,42846915737,-2,1698,2067,-10
42847523426,42847523428,2,1210,1029,-10
42850885220,42850885220,0,1331,1778,-10
42852668802,42852668801,-1,1451,1691,-10
42853404313,42853404315,2,2282,1634,-10
42856787405,42856787405,0,1350,1611,-10
42857833683,42857833682,-1,1057,1822,-10
42860765732,42860765733,1,1370,1747,-10
42861310777,42861310778,1,1602,1910,-10
42862524732,42862524739,7,2489,1225,-10
42864739610,42864739611,1,2395,2058,-10
42868446974,42868446976,2,1515,1397,-10
42879083238,42879083242,4,1496,2083,-10
42885348767,42885348770,3,1143,1118,-10
42885719363,42885719365,2,2322,1457,-10
42893191111,42893191113,2,2271,1945,-10
42894321986,42894321989,3,1125,1164,-10
42894637937,42894637941,4,1489,962,-10
42896962065,42896962066,1,1478,1766,-10
42897630647,42897630642,-5,1036,3602,-10
42899096219,42899096223,4,1322,1510,-10
42900534931,42900534927,-4,526,1447,-10
42901438258,42901438261,3,1340,1637,-10
42904942755,42904942758,3,1161,1288,-10
42905644054,42905644059,5,1276,1325,-10
42914676215,42914676218,3,1947,1598,-10
42916723646,42916723647,1,1644,1378,-10
42919174134,42919174135,1,1319,1615,-10
42919525838,42919525841,3,1520,1753,-10
42919937062,42919937063,1,1875,1950,-10
42922732018,42922732018,0,1446,2137,-10
42930006707,42930006702,-5,1986,3488,-10
42931948315,42931948318,3,1362,1503,-10
42934954307,42934954309,2,1745,1423,-10
42938468256,42938468257,1,2034,2328,-10
42940909109,42940909113,4,1203,1105,-10
42944171737,42944171738,1,1956,2353,-10
42945516042,42945516043,1,2216,2139,-10
42946741363,42946741363,0,1906,1692,-10
42950792561,42950792564,3,1549,2221,-10
42954760771,42954760773,2,1328,1342,-10
42955805638,42955805638,0,1439,1783,-10
42959044565,42959044566,1,1527,1149,-10
42959920581,42959920581,0,1414,1669,-10
42961308258,42961308258,0,1290,1965,-10
42961600780,42961600764,-16,1132,1234,-10
42962169094,42962169095,1,1062,907,-10
42967878461,42967878464,3,1968,1880,-10
42972181130,42972181134,4,2178,1592,-10
42975619912,42975619902,-10,146,665,-10
42977201735,42977201735,0,1268,1568,-10
42978117002,42978117002,0,1961,1566,-10
42980350496,42980350498,2,1164,1074,-10
42983942217,42983942218,1,1575,1477,-10
42985160629,42985160630,1,1458,1715,-10
42985504639,42985504641,2,1987,2102,-10
42986025618,42986025621,3,1512,1495,-10
42986287005,42986287004,-1,1797,1607,-10
42987303393,42987303391,-2,1234,2534,-10
42988283037,42988283038,1,1295,1015,-10
42996697679,42996697681,2,1178,1229,-10
42997388559,42997388560,1,1660,2197,-10
42997909092,42997909095,3,1466,969,-10
42998687426,42998687425,-1,838,1929,-10
43001831333,43001831336,3,1653,1733,-10
43003962326,43003962329,3,1720,1972,-10
43004082573,43004082593,20,875,332,-10
43005656541,43005656541,0,1212,2127,-10
43008960806,43008960810,4,1320,1348,-10
43011308701,43011308702,1,1385,1345,-10
43015568024,43015568026,2,1663,1573,-10
43016486950,43016486955,5,4981,2357,-10
43021198371,43021198370,-1,664,1140,-10
43025392370,43025392370,0,1624,1750,-10
43027612389,43027612394,5,1867,1118,-10
43028320041,43028320044,3,1254,969,-10
43032928358,43032928359,1,1353,1954,-10
43033154131,43033154133,2,1590,1298,-10
43034103344,43034103345,1,2102,1632,-10
43035302262,43035302263,1,1869,1237,-10
43040476839,43040476842,3,1201,1423,-10
43041735902,43041735904,2,1143,1323,-10
43043482897,43043482898,1,1228,1372,-10
43049733593,43049733594,1,2171,2079,-10
43050924605,43050924606,1,1425,2007,-10
43052825054,43052825043,-11,11475,29066,-10
43053503331,43053503331,0,1117,1216,-10
43053634458,43053634459,1,850,670,-10
43056229438,43056229441,3,1519,1670,-10
43057476534,43057476535,1,1283,1284,-10
43059001590,43059001591,1,1704,1280,-10
43061195107,43061195109,2,1337,1396,-10
43062345095,43062345096,1,1352,1709,-10
43066377957,43066377958,1,1592,1651,-10
43068900655,43068900655,0,1218,1052,-10
43069250605,43069250603,-2,2067,2473,-10
43070886713,43070886716,3,999,1401,-10
43073881175,43073881178,3,2283,2142,-10
43077202276,43077202278,2,1601,1935,-10
43079033959,43079033960,1,1905,939,-10
43080583128,43080583131,3,1649,1375,-10
43081497470,43081497471,1,2232,2298,-10
43084246906,43084246909,3,1590,1873,-10
43086812621,43086812622,1,1356,1382,-10
43087738110,43087738113,3,1683,1374,-10
43091138473,43091138474,1,1571,2223,-10
43092521198,43092521198,0,1047,1054,-10
43094324969,43094324969,0,1512,1574,-10
43094547821,43094547823,2,2012,1659,-10
43096449946,43096449941,-5,1040,1437,-10
43096881254,43096881257,3,1902,2302,-10
43097284106,43097284107,1,959,1275,-10
43098125055,43098125056,1,1347,2018,-10
43101611347,43101611349,2,1585,1763,-10
43101752659,43101752663,4,2283,1288,-10
43104642683,43104642694,11,502,2382,-10
43113492793,43113492795,2,1415,1184,-10
43117742505,43117742509,4,2974,2367,-10
43121307531,43121307534,3,1404,1269,-10
43121342309,43121342311,2,1611,1972,-10
43123657599,43123657598,-1,1965,1215,-10
43124354338,43124354339,1,1328,1255,-10
43124630886,43124630889,3,1825,1709,-10
43125651515,43125651518,3,994,1166,-10
43130948302,43130948305,3,1648,1746,-10
43133851631,43133851633,2,1387,2123,-10
43136791457,43136791458,1,1940,2137,-10
43138315824,43138315825,1,1516,1414,-10
43138733610,43138733613,3,1229,1477,-10
43139106021,43139106022,1,1626,1876,-10
43143299323,43143299327,4,1559,1389,-10
43144158390,43144158391,1,1291,1941,-10
43144594742,43144594743,1,1180,1569,-10
43147796183,43147796185,2,1798,1559,-10
43148006839,43148006838,-1,1247,2138,-10
43154752740,43154752741,1,1434,1150,-10
43155588137,43155588139,2,1506,1513,-10
43156777647,43156777650,3,1708,1056,-10
43159282699,43159282700,1,1076,1859,-10
43163386169,43163386170,1,1659,1214,-10
43164193197,43164193199,2,1501,1374,-10
43164543246,43164543247,1,1654,1495,-10
43170266613,43170266618,5,1284,1417,-10
43172167402,43172167404,2,1805,1872,-10
43173827603,43173827602,-1,1029,661,-10
43175677978,43175677983,5,2085,1418,-10
43176238251,43176238254,3,1338,1339,-10
43176411957,43176411938,-19,944,1183,-10
43179418709,43179418712,3,2361,1862,-10
43181428765,43181428766,1,1510,1322,-10
43182407093,43182407094,1,1998,1361,-10
43183456023,43183456025,2,1433,1400,-10
43186466238,43186466243,5,2592,719,-10
43189233259,43189233257,-2,1388,1252,-10
43189427145,43189427147,2,1243,1619,-10
43192757289,43192757289,0,1297,1722,-10
43194182026,43194182028,2,1772,2265,-10
43194228934,43194228926,-8,906,4142,-10
43202597787,43202597787,0,1218,1309,-10
43205162329,43205162330,1,1614,1723,-10
43206525438,43206525441,3,1346,1328,-10
43206644613,43206644615,2,1975,1393,-10
43209379513,43209379513,0,1597,1282,-10
43209693005,43209693009,4,5036,2824,-10
43211301685,43211301687,2,2067,1676,-10
43211346638,43211346639,1,1685,2193,-10
43211710007,43211710010,3,1815,1547,-10
43212269966,43212269967,1,1633,2157,-10
43219026199,43219026202,3,1837,1263,-10
43222390490,43222390491,1,1745,1160,-10
43232393613,43232393617,4,1601,1547,-10
43235419114,43235419118,4,1340,1426,-10
43238244295,43238244294,-1,957,729,-10
43238707454,43238707467,13,1709,1404,-10
43243482713,43243482713,0,1633,2252,-10
43244365762,43244365762,0,1789,1935,-10
43246068826,43246068828,2,1485,1516,-10
43246893632,43246893634,2,1550,1253,-10
43248406486,43248406483,-3,1845,3758,-10
43249511408,43249511409,1,1562,1532,-10
43253196167,43253196169,2,1655,1680,-10
43253326039,43253326042,3,1690,1790,-10
43253384633,43253384635,2,1063,1844,-10
43254294149,43254294150,1,1295,1435,-10
43258779207,43258779208,1,1502,1833,-10
43262813857,43262813858,1,744,692,-10
43263052316,43263052318,2,1178,1307,-10
43265583202,43265583207,5,1575,1412,-10
43269985903,43269985903,0,1542,1380,-10
43272179046,43272179050,4,823,1252,-10
43275798191,43275798190,-1,1304,1330,-10
43279405633,43279405635,2,2104,1160,-10
43281142809,43281142809,0,1345,1421,-10
43283441174,43283441174,0,1689,2068,-10
43284977585,43284977578,-7,1209,5286,-10
43289899155,43289899157,2,1778,1684,-10
43290103981,43290103983,2,1979,1607,-10
43294610336,43294610337,1,2022,2543,-10
43297005610,43297005614,4,1537,1467,-10
43300597407,43300597410,3,911,1261,-10
43303796089,43303796090,1,1539,1339,-10
43304949406,43304949407,1,1550,1250,-10
43306527818,43306527819,1,1763,1584,-10
43307479940,43307479938,-2,1457,1673,-10
43310288429,43310288430,1,1252,1766,-10
43311691134,43311691135,1,866,1154,-10
43312886793,43312886797,4,1881,1537,-10
43315177486,43315177489,3,1619,1362,-10
43315270527,43315270529,2,1148,1024,-10
43317479394,43317479394,0,1540,2087,-10
43321218366,43321218364,-2,1049,2310,-10
43323607773,43323607777,4,14340,10496,-10
43324385994,43324385994,0,1430,1471,-10
43325924364,43325924367,3,1203,1319,-10
43326148239,43326148243,4,2350,1810,-10
43331166101,43331166103,2,2221,1652,-10
43332647493,43332647495,2,1962,1389,-10
43333688116,43333688119,3,1952,1439,-10
43336622214,43336622215,1,825,1573,-10
43338586306,43338586308,2,1275,1292,-10
43343327534,43343327535,1,1259,1485,-10
43343380069,43343380069,0,1770,1620,-10
43347191279,43347191283,4,1513,1088,-10
43350643363,43350643366,3,1209,1445,-10
43353113810,43353113812,2,1003,1436,-10
43353770646,43353770649,3,1642,1185,-10
43355381430,43355381435,5,1512,1062,-10
43356256101,43356256108,7,3816,1648,-10
43357944294,43357944294,0,1825,1983,-10
43358367690,43358367695,5,1475,1272,-10
43359499433,43359499434,1,1008,1415,-10
43360663195,43360663197,2,1088,1441,-10
43362441146,43362441148,2,1031,1525,-10
43363108790,43363108793,3,1363,2020,-10
43363845945,43363845946,1,1396,1540,-10
43364690354,43364690358,4,1995,1687,-10
43369138064,43369138066,2,1539,1776,-10
43370778773,43370778777,4,1276,1484,-10
43374148071,43374148073,2,1447,1418,-10
43375261662,43375261666,4,989,1278,-10
43375669981,43375669983,2,1212,1463,-10
43375824819,43375824822,3,1351,1201,-10
43379542128,43379542130,2,1348,1447,-10
43380291438,43380291438,0,1245,1406,-10
43381552778,43381552779,1,5958,8285,-10
43382261803,43382261805,2,2243,1838,-10
43382762845,43382762847,2,1900,1603,-10
43384127568,43384127570,2,1092,1553,-10
43384280640,43384280625,-15,1213,3683,-10
43387479104,43387479104,0,1247,1282,-10
43389505834,43389505836,2,1743,1685,-10
43390228937,43390228939,2,1597,1978,-10
43391636021,43391636021,0,1637,2294,-10
43395809045,43395809050,5,2273,1338,-10
43396736462,43396736462,0,1299,1837,-10
43398402734,43398402734,0,1617,1586,-10
43400190321,43400190321,0,1011,2111,-10
43401133198,43401133200,2,972,1677,-10
43401760016,43401760019,3,1764,1526,-10
43403486423,43403486424,1,1531,1472,-10
43404660503,43404660499,-4,849,1730,-10
43406074891,43406074890,-1,900,1417,-10
43407840418,43407840420,2,1809,1811,-10
43408484900,43408484902,2,1146,1432,-10
43413535244,43413535242,-2,1079,1674,-10
43417364509,43417364514,5,2456,1772,-10
43419822318,43419822321,3,1240,1301,-10
43421714201,43421714204,3,2120,1547,-10
43422912696,43422912697,1,1915,2338,-10
43426603369,43426603371,2,2104,1584,-10
43426927643,43426927647,4,1540,1348,-10
43427841024,43427841025,1,1563,1447,-10
43430867764,43430867766,2,2328,1731,-10
43434091232,43434091236,4,2115,1325,-10
43437905457,43437905458,1,2107,1956,-10
43439062701,43439062705,4,2045,1510,-10
43439187591,43439187592,1,1956,1728,-10
43440614198,43440614200,2,2322,1562,-10
43442992588,43442992590,2,2343,2548,-10
43445894193,43445894194,1,1827,1964,-10
43446180510,43446180490,-20,2265,1775,-10
43447459454,43447459459,5,2049,1449,-10
43449526096,43449526098,2,1544,1719,-10
43450220403,43450220406,3,1276,1590,-10
43454397596,43454397598,2,1783,1813,-10
43455001105,43455001105,0,1834,1469,-10
43455619872,43455619874,2,2146,1234,-10
43460645849,43460645850,1,1252,1803,-10
43463316561,43463316562,1,1833,2236,-10
43465388533,43465388547,14,14182,48765,-10
43467647199,43467647202,3,1560,1611,-10
43472427418,43472427417,-1,994,2437,-10
43472479919,43472479920,1,1117,1387,-10
43472645490,43472645493,3,1161,1298,-10
43476475486,43476475486,0,1412,1320,-10
43477205967,43477205969,2,1837,1522,-10
43477997717,43477997719,2,1144,1649,-10
43478263324,43478263317,-7,1622,1986,-10
43480500829,43480500831,2,1837,1780,-10
43481983994,43481983997,3,1700,1811,-10
43483037159,43483037163,4,2095,1384,-10
43483328818,43483328812,-6,1386,5173,-10
43486037057,43486037057,0,2081,2371,-10
43488812570,43488812570,0,1544,1578,-10
43491916218,43491916219,1,1129,1887,-10
43495009043,43495009045,2,1484,1659,-10
43498042744,43498042747,3,1622,1759,-10
43498401251,43498401234,-17,1027,904,-10
43502036013,43502036017,4,1121,654,-10
43502196410,43502196415,5,2560,1429,-10
43503253327,43503253325,-2,1056,1872,-10
43503326415,43503326419,4,3038,1927,-10
43503841609,43503841613,4,2007,1355,-10
43508234414,43508234417,3,1586,1329,-10
43509939977,43509939979,2,2453,2566,-10
43514034203,43514034208,5,3124,1722,-10
43514459465,43514459466,1,1107,1390,-10
43515051307,43515051310,3,1860,1493,-10
43516589086,43516589090,4,1888,1177,-10
43520449876,43520449878,2,1682,1195,-10
43521263884,43521263889,5,1577,1165,-10
43523205185,43523205185,0,1363,1425,-10
43523821058,43523821062,4,912,1342,-10
43524259082,43524259083,1,1081,1159,-10
43530523918,43530523919,1,1544,1680,-10
43531245162,43531245164,2,1629,1833,-10
43532408287,43532408289,2,1683,1711,-10
43535369629,43535369628,-1,1415,1417,-10
43536442362,43536442362,0,952,1226,-10
43538663758,43538663774,16,1741,2338,-10
43541977436,43541977438,2,1453,1479,-10
43544692882,43544692885,3,1153,1564,-10
43547655145,43547655146,1,1545,2285,-10
43552946390,43552946393,3,1996,2035,-10
43554438995,43554438997,2,2545,1772,-10
43554575033,43554575051,18,1893,1959,-10
43558395891,43558395893,2,1097,1238,-10
43560761239,43560761243,4,1847,1393,-10
43561461042,43561461046,4,2300,2074,-10
43563685050,43563685051,1,1939,1371,-10
43566805784,43566805783,-1,1693,1933,-10
43570716978,43570716978,0,987,1954,-10
43571926092,43571926093,1,1428,1307,-10
43572545090,43572545093,3,1605,2621,-10
43575996569,43575996570,1,1744,1481,-10
43579657680,43579657683,3,1620,1231,-10
43580782202,43580782204,2,2011,1312,-10
43589610798,43589610802,4,1529,1687,-10
43590444436,43590444437,1,1664,1683,-10
43596142845,43596142846,1,1314,1835,-10
43603859649,43603859651,2,1737,1311,-10
43604907494,43604907492,-2,1232,1629,-10
43606481029,43606481029,0,4271,25454,-10
43611372045,43611372046,1,2795,3199,-10
43612292983,43612292983,0,860,1106,-10
43614214882,43614214882,0,1755,1952,-10
43621491819,43621491821,2,1564,1076,-10
43622182219,43622182218,-1,1455,1193,-10
43622835284,43622835284,0,1416,1776,-10
43624597386,43624597383,-3,1007,1498,-10
43632316264,43632316251,-13,70,417,-10
43637230182,43637230184,2,1465,1458,-10
43637347431,43637347437,6,3723,2215,-10
43637892733,43637892738,5,1562,1465,-10
43638745286,43638745288,2,1379,1235,-10
43639008436,43639008433,-3,1180,1974,-10
43641264281,43641264284,3,1024,892,-10
43643894370,43643894372,2,1550,1387,-10
43645467613,43645467613,0,1262,1393,-10
43646914296,43646914296,0,1181,1831,-10
43648002846,43648002847,1,1833,1692,-10
43648985338,43648985340,2,1453,1925,-10
43649173582,43649173585,3,1744,1271,-10
43649609498,43649609502,4,1360,1638,-10
43650913139,43650913142,3,1579,1854,-10
43651359507,43651359509,2,1081,1624,-10
43651617144,43651617149,5,16219,28518,-10
43651929404,43651929405,1,8063,17197,-10
43653663466,43653663466,0,1060,1345,-10
43653762141,43653762143,2,1462,1359,-10
43657198486,43657198487,1,1349,1360,-10
43658629087,43658629088,1,2146,2027,-10
43660722666,43660722668,2,1185,1219,-10
43661599789,43661599790,1,1024,1224,-10
43664731290,43664731293,3,2085,1692,-10
43667433753,43667433754,1,986,1022,-10
43669321033,43669321035,2,1071,1135,-10
43675941911,43675941912,1,1111,1093,-10
43676978545,43676978547,2,2080,1538,-10
43678489115,43678489099,-16,1221,1406,-10
43680985078,43680985082,4,1846,1922,-10
43681402154,43681402155,1,1545,988,-10
43682052731,43682052733,2,1475,1937,-10
43682919014,43682919018,4,1686,1244,-10
43684265228,43684265228,0,1310,1319,-10
43686113814,43686113817,3,1535,1825,-10
43686649572,43686649574,2,1793,1969,-10
43689562163,43689562166,3,1720,1357,-10
43691413695,43691413697,2,1605,1897,-10
43695829439,43695829441,2,1215,1484,-10
43696655202,43696655209,7,2091,1516,-10
43700626098,43700626093,-5,1123,4674,-10
43703193602,43703193603,1,1595,1332,-10
43705427812,43705427815,3,2241,2076,-10
43708521533,43708521535,2,1947,2025,-10
43711200533,43711200538,5,1822,901,-10
43711267541,43711267543,2,1852,1562,-10
43714176715,43714176715,0,1269,1437,-10
43716922023,43716922026,3,671,575,-10
43717623721,43717623721,0,1351,1455,-10
43718381545,43718381549,4,2130,1445,-10
43719876850,43719876853,3,1787,2109,-10
43724783350,43724783351,1,1131,1478,-10
43727947039,43727947024,-15,2184,1707,-10
43729820737,43729820738,1,2179,2160,-10
43730515494,43730515494,0,1297,1030,-10
43731186836,43731186840,4,1181,1221,-10
43731853288,43731853297,9,1174,1192,-10
43737590670,43737590674,4,1937,1291,-10
43737906485,43737906486,1,1689,1382,-10
43740109711,43740109711,0,1353,1218,-10
43744231299,43744231302,3,1239,1449,-10
43746950017,43746950019,2,1406,1212,-10
43750441320,43750441319,-1,1510,1435,-10
43753799234,43753799234,0,1422,1459,-10
43756412247,43756412250,3,1383,818,-10
43760094393,43760094394,1,1966,1536,-10
43764686523,43764686526,3,1772,1127,-10
43764780153,43764780155,2,1308,1902,-10
43765851606,43765851607,1,1291,1264,-10
43768679014,43768679017,3,1205,1414,-10
43775285946,43775285949,3,1991,1212,-10
43779759737,43779759745,8,2976,1004,-10
43779853803,43779853802,-1,535,1531,-10
43782310977,43782310978,1,1664,1625,-10
43783937767,43783937769,2,1506,1543,-10
43784184258,43784184263,5,1235,867,-10
43785528426,43785528427,1,1679,1742,-10
43786076389,43786076383,-6,1224,3721,-10
43786861388,43786861390,2,936,1076,-10
43787329389,43787329393,4,1811,1603,-10
43787558559,43787558563,4,848,777,-10
43791239680,43791239681,1,1797,1508,-10
43792894980,43792894981,1,1688,1777,-10
43797861202,43797861203,1,1817,1591,-10
43801899089,43801899108,19,1758,1463,-10
43803103751,43803103752,1,1695,2130,-10
43803913969,43803913971,2,1288,1116,-10
43809416365,43809416366,1,1469,1974,-10
43809970678,43809970680,2,1842,1709,-10
43810396898,43810396900,2,1686,1534,-10
43813375324,43813375326,2,1710,1221,-10
43813668535,43813668538,3,948,1234,-10
43819070712,43819070717,5,1888,1120,-10
43820666365,43820666365,0,1304,1014,-10
43824433140,43824433141,1,2664,2542,-10
43828754386,43828754388,2,1559,1353,-10
43834613982,43834613984,2,1886,2247,-10
43841772120,43841772122,2,1180,855,-10
43843035519,43843035522,3,1898,1406,-10
43852222786,43852222787,1,927,1655,-10
43852461273,43852461275,2,987,1040,-10
43853007462,43853007463,1,1645,1817,-10
43855247988,43855247986,-2,1992,1658,-10
43860567131,43860567129,-2,1083,2951,-10
43861019788,43861019790,2,1832,1397,-10
43863272944,43863272946,2,1297,1440,-10
43865140455,43865140458,3,1552,1283,-10
43866901509,43866901510,1,1655,1393,-10
43868622791,43868622793,2,1642,2083,-10
43870543406,43870543406,0,1809,1655,-10
43871749451,43871749453,2,1060,811,-10
43878070545,43878070548,3,1391,1267,-10
43879865527,43879865530,3,920,1314,-10
43880754155,43880754155,0,1731,2204,-10
43881638390,43881638395,5,1527,1440,-10
43884347424,43884347425,1,1653,2385,-10
43890901597,43890901601,4,1035,1255,-10
43893898073,43893898079,6,6394,22542,-10
43895075991,43895075991,0,1129,1304,-10
43896977970,43896977971,1,1609,2592,-10
43900422013,43900422014,1,1616,1923,-10
43904041499,43904041501,2,1683,1363,-10
43909477023,43909477020,-3,2389,5598,-10
43910190781,43910190782,1,1773,1954,-10
43912886585,43912886577,-8,35968,14752,-10
43915932494,43915932497,3,1544,2236,-10
43916867270,43916867273,3,1757,1726,-10
43918234434,43918234434,0,826,2241,-10
43920476830,43920476833,3,1559,1878,-10
43920807254,43920807258,4,1649,947,-10
43924141375,43924141374,-1,1290,941,-10
43926145518,43926145518,0,1512,1675,-10
43928345117,43928345119,2,1206,1213,-10
43931273631,43931273633,2,2011,1506,-10
43931576092,43931576093,1,1733,2001,-10
43932346422,43932346417,-5,2142,4884,-10
43934653077,43934653081,4,1583,1838,-10
43934734822,43934734823,1,1689,1551,-10
43936844089,43936844093,4,1898,1025,-10
43939451854,43939451855,1,1609,1841,-10
43941574353,43941574355,2,1257,944,-10
43942163784,43942163783,-1,1223,1433,-10
43944485439,43944485441,2,2053,1582,-10
43947463535,43947463538,3,1319,1477,-10
43949015600,43949015601,1,1637,1697,-10
43950133731,43950133734,3,1848,1473,-10
43951068583,43951068584,1,1849,1708,-10
43952125645,43952125648,3,1381,1266,-10
43953669760,43953669765,5,2039,1414,-10
43955763458,43955763459,1,2277,1747,-10
43956137497,43956137500,3,2212,2053,-10
43956600117,43956600117,0,1467,1420,-10
43957069405,43957069386,-19,1951,1369,-10
43957405257,43957405258,1,1584,1095,-10
43960381858,43960381858,0,2272,2047,-10
43961775634,43961775651,17,1552,1459,-10
43962134269,43962134271,2,1482,1163,-10
43962887606,43962887612,6,2038,1416,-10
43963680961,43963680966,5,2399,1337,-10
43965210479,43965210479,0,1271,1103,-10
43966044818,43966044822,4,1745,1434,-10
43972010789,43972010784,-5,1950,4315,-10
43972523293,43972523294,1,3068,3668,-10
43973458236,43973458242,6,3104,1739,-10
43974195540,43974195543,3,52815,22589,-10
43976034189,43976034190,1,1703,1617,-10
43976139386,43976139389,3,1878,1307,-10
43978948671,43978948674,3,1400,1489,-10
43981050540,43981050541,1,2406,1929,-10
43982840437,43982840438,1,1264,1325,-10
43983336311,43983336314,3,2302,1823,-10
43992943231,43992943235,4,1355,1021,-10
43993164087,43993164106,19,1594,1343,-10
43997743782,43997743783,1,1937,1668,-10
44000020045,44000020046,1,1790,2012,-10
44003029089,44003029091,2,1110,1515,-10
44004497058,44004497059,1,1426,1641,-10
44009016869,44009016870,1,1131,1283,-10
44010011286,44010011289,3,1551,1690,-10
44010068974,44010068977,3,1270,962,-10
44011963637,44011963639,2,1444,1410,-10
44023236082,44023236086,4,1101,1458,-10
44025491326,44025491332,6,972,940,-10
44027108480,44027108479,-1,1628,1398,-10
44028832551,44028832554,3,1698,1915,-10
44029250657,44029250657,0,1414,1064,-10
44030228629,44030228631,2,1775,1312,-10
44031910830,44031910832,2,2209,1675,-10
44032706215,44032706217,2,2075,1919,-10
44033711882,44033711886,4,1358,1555,-10
44034511002,44034511004,2,1638,1197,-10
44035812699,44035812700,1,2191,2217,-10
44040191797,44040191800,3,1020,1429,-10
44041305926,44041305930,4,1492,1170,-10
44042934721,44042934723,2,1618,1819,-10
44044752622,44044752626,4,1046,1349,-10
44049163541,44049163544,3,2852,1896,-10
44049366094,44049366095,1,1786,2213,-10
44050459231,44050459235,4,1512,1567,-10
44051505951,44051505954,3,1102,1369,-10
44054031571,44054031573,2,1277,1034,-10
44060915557,44060915559,2,1242,1162,-10
44061485143,44061485146,3,1611,1561,-10
44062567429,44062567429,0,2059,1610,-10
44064946394,44064946397,3,1452,1361,-10
44067756559,44067756543,-16,1825,1292,-10
44072629697,44072629699,2,2288,1927,-10
44072760723,44072760723,0,1258,1696,-10
44074712021,44074712023,2,2041,2354,-10
44074923149,44074923154,5,1258,1198,-10
44076929556,44076929576,20,1409,1692,-10
44079156206,44079156209,3,1219,1630,-10
44079812218,44079812218,0,1187,1319,-10
44080916961,44080916942,-19,1455,1227,-10
44085108302,44085108303,1,1095,1156,-10
44085310245,44085310233,-12,3617,10934,-10
44087193043,44087193046,3,1267,1439,-10
44092275552,44092275554,2,1484,1219,-10
44096989378,44096989378,0,1206,1554,-10
44097990467,44097990444,-23,31,1032,-10
44099588977,44099588970,-7,861,4642,-10
44105332413,44105332414,1,1589,2028,-10
44106181448,44106181450,2,1671,1656,-10
44108472032,44108472034,2,1191,1213,-10
44109360738,44109360741,3,1625,1324,-10
44110789404,44110789405,1,1376,2511,-10
44113451304,44113451306,2,2043,1713,-10
44116712972,44116712970,-2,1451,1647,-10
44118857551,44118857554,3,1037,1067,-10
44119020439,44119020441,2,1667,1570,-10
44119170711,44119170713,2,764,1346,-10
44122776670,44122776671,1,1348,1879,-10
44123251888,44123251890,2,1646,1663,-10
44123721539,44123721538,-1,1702,1963,-10
44130970300,44130970301,1,2139,1885,-10
44131871121,44131871122,1,1406,1336,-10
44131938297,44131938299,2,1953,1456,-10
44132692129,44132692131,2,1575,1051,-10
44132969578,44132969581,3,1715,1456,-10
44133132267,44133132269,2,2291,2117,-10
44136293821,44136293817,-4,1766,3891,-10
44136854730,44136854730,0,977,1941,-10
44137151841,44137151838,-3,1278,1939,-10
44138355051,44138355053,2,1414,1405,-10
44140638154,44140638159,5,3669,1964,-10
44142587450,44142587453,3,1628,1733,-10
44145523149,44145523150,1,1590,2454,-10
44146469857,44146469858,1,825,1247,-10
44146798706,44146798709,3,1412,1481,-10
44150837300,44150837302,2,1696,1556,-10
44154815938,44154815942,4,2133,1398,-10
44155134153,44155134158,5,2000,1691,-10
44156240883,44156240885,2,1774,1443,-10
44156605465,44156605467,2,1623,1780,-10
44156780343,44156780346,3,738,626,-10
44157972594,44157972595,1,1942,1826,-10
44162201346,44162201342,-4,1139,1388,-10
44165431972,44165431975,3,2369,1714,-10
44168198926,44168198927,1,1021,1049,-10
44169351837,44169351838,1,1830,1496,-10
44173457106,44173457105,-1,1171,1166,-10
44175418554,44175418571,17,1679,2200,-10
44175817927,44175817930,3,1615,1824,-10
44176666770,44176666771,1,1642,1844,-10
44176953442,44176953442,0,1352,1102,-10
44179120486,44179120489,3,1609,1597,-10
44183736054,44183736055,1,1441,1342,-10
44184558123,44184558126,3,1582,920,-10
44192505822,44192505822,0,1455,1825,-10
44194814307,44194814308,1,2305,1838,-10
44195619177,44195619179,2,1742,1835,-10
44196537024,44196537026,2,1907,1921,-10
44197555230,44197555233,3,1163,1757,-10
44199285458,44199285458,0,1307,1803,-10
44200657345,44200657348,3,1523,1529,-10
44200989201,44200989221,20,764,1599,-10
44201625074,44201625077,3,1564,1287,-10
44201762794,44201762794,0,1832,2069,-10
44203934744,44203934747,3,1905,1518,-10
44205812954,44205812957,3,1373,1827,-10
44206491977,44206491978,1,1218,1134,-10
44218295823,44218295818,-5,1197,2561,-10
44225788754,44225788755,1,1514,1388,-10
44227187114,44227187116,2,1440,1637,-10
44231714800,44231714801,1,1440,1314,-10
44233864479,44233864479,0,1674,2291,-10
44235840562,44235840565,3,1258,1449,-10
44237480329,44237480334,5,2724,909,-10
44237525923,44237525925,2,2183,2021,-10
44239266202,44239266195,-7,1252,4368,-10
44241201782,44241201783,1,2059,2001,-10
44246052787,44246052790,3,1931,1785,-10
44249150688,44249150687,-1,1636,1255,-10
44252807955,44252807957,2,1555,1391,-10
44254679243,44254679245,2,1588,1505,-10
44256938749,44256938750,1,1361,1310,-10
44260105698,44260105699,1,1040,929,-10
44261087600,44261087602,2,1754,1431,-10
44268984898,44268984905,7,6440,2167,-10
44271420589,44271420590,1,1434,1869,-10
44274877641,44274877642,1,1255,1847,-10
44275934599,44275934602,3,1490,1124,-10
44276461280,44276461281,1,1597,1693,-10
44277504713,44277504716,3,1329,1549,-10
44279163522,44279163543,21,1141,1159,-10
44280067359,44280067359,0,1185,1963,-10
44281823255,44281823258,3,1245,1071,-10
44286845166,44286845165,-1,1677,2120,-10
44288646209,44288646213,4,1349,1543,-10
44290626913,44290626915,2,1442,1244,-10
44291736783,44291736790,7,1206,1054,-10
44293426093,44293426094,1,1314,1482,-10
44295217350,44295217353,3,1102,1401,-10
44301131634,44301131639,5,1326,1155,-10
44301574038,44301574040,2,1367,1437,-10
44302051265,44302051279,14,688,2725,-10
44311830517,44311830521,4,1960,1322,-10
44312222938,44312222939,1,1501,1282,-10
44312654666,44312654672,6,920,1280,-10
44314616473,44314616475,2,1655,1134,-10
44316352313,44316352316,3,1669,1250,-10
44316472933,44316472913,-20,1585,1454,-10
44316511613,44316511617,4,1938,1715,-10
44316654142,44316654141,-1,1543,1710,-10
44317148273,44317148273,0,1647,1954,-10
44317509610,44317509610,0,1803,959,-10
44318365605,44318365607,2,1594,1350,-10
44318946354,44318946353,-1,1280,2321,-10
44320806670,44320806671,1,1424,1915,-10
44321291885,44321291886,1,1574,1588,-10
44322721340,44322721342,2,1496,1207,-10
44324123051,44324123051,0,1521,1689,-10
44325192290,44325192295,5,1024,979,-10
44325766373,44325766378,5,1258,1025,-10
44326486714,44326486714,0,1046,986,-10
44328030978,44328030979,1,1654,1340,-10
44331562627,44331562626,-1,1958,2532,-10
44333814858,44333814858,0,1679,1243,-10
44334542976,44334542978,2,832,1048,-10
44338106561,44338106562,1,963,1740,-10
44341898911,44341898913,2,996,1146,-10
44345559572,44345559556,-16,1165,1469,-10
44346270175,44346270178,3,1582,1819,-10
44346836403,44346836407,4,1253,1313,-10
44348275530,44348275535,5,1501,1495,-10
44349503832,44349503825,-7,987,3361,-10
44351896647,44351896651,4,1100,1075,-10
44354903125,44354903128,3,1438,1739,-10
44357655115,44357655116,1,676,584,-10
44358790376,44358790378,2,5925,4925,-10
44361905582,44361905586,4,2222,1722,-10
44362412485,44362412488,3,1779,2335,-10
44363144551,44363144550,-1,1471,1746,-10
44363807064,44363807063,-1,765,920,-10
44365873433,44365873434,1,1092,1772,-10
44366796118,44366796119,1,1358,1360,-10
44367139362,44367139363,1,1860,1804,-10
44369878153,44369878154,1,1993,1315,-10
44370798038,44370798042,4,2487,1374,-10
44371982688,44371982690,2,1235,1373,-10
44373096826,44373096826,0,1503,812,-10
44373927543,44373927545,2,2090,1724,-10
44375446058,44375446058,0,1095,1316,-10
44375766877,44375766878,1,955,1051,-10
44376721987,44376721989,2,1192,1543,-10
44376808266,44376808262,-4,2228,5367,-10
44380347178,44380347181,3,990,1269,-10
44381660388,44381660389,1,1534,1515,-10
44382858747,44382858749,2,1279,1847,-10
44383826146,44383826146,0,2005,2089,-10
44383886295,44383886301,6,7214,6930,-10
44386016899,44386016901,2,1210,1473,-10
44388545107,44388545109,2,1260,1489,-10
44391229830,44391229830,0,1231,1631,-10
44391415438,44391415435,-3,1226,1753,-10
44391575456,44391575459,3,1330,1203,-10
44396980010,44396980011,1,983,718,-10
44401464630,44401464631,1,1147,1582,-10
44402495665,44402495668,3,1245,1435,-10
44402670614,44402670618,4,2132,1637,-10
44408151506,44408151507,1,2363,2229,-10
44409817537,44409817538,1,1574,1508,-10
44411651415,44411651410,-5,1621,3174,-10
44414303866,44414303868,2,1743,1247,-10
44418529241,44418529246,5,1605,1667,-10
44418764329,44418764330,1,1937,1993,-10
44419045478,44419045478,0,1148,1001,-10
44420733085,44420733084,-1,1151,1260,-10
44423340099,44423340104,5,1921,1283,-10
44424341673,44424341672,-1,2935,3543,-10
44426058129,44426058131,2,653,926,-10
44427341061,44427341061,0,1485,1155,-10
44428791251,44428791254,3,702,741,-10
44433052977,44433052978,1,40475,18311,-10
44433690302,44433690305,3,1694,1571,-10
44434089154,44434089156,2,1696,1491,-10
44438060321,44438060324,3,1052,1277,-10
44438218074,44438218088,14,1655,2084,-10
44438964091,44438964093,2,1723,1595,-10
44439023606,44439023587,-19,1188,432,-10
44443377543,44443377543,0,1296,1508,-10
44445495049,44445495054,5,1492,1772,-10
44445946887,44445946891,4,2287,1625,-10
44449308780,44449308782,2,1400,1346,-10
44450937143,44450937144,1,1280,1454,-10
44455203059,44455203058,-1,1264,1173,-10
44455423880,44455423903,23,29153,8176,-10
44461268414,44461268407,-7,1380,5882,-10
44461319957,44461319959,2,1075,957,-10
44462819158,44462819162,4,1643,1093,-10
44466875678,44466875682,4,988,633,-10
44468927806,44468927806,0,1798,1614,-10
44470437570,44470437570,0,1011,1628,-10
44474095002,44474095005,3,2290,1762,-10
44474122196,44474122197,1,1627,1225,-10
44475666614,44475666617,3,1430,1705,-10
44475869975,44475869974,-1,1369,2263,-10
44476247093,44476247094,1,1617,2029,-10
44479006773,44479006774,1,1042,810,-10
44480082902,44480082904,2,2121,2210,-10
44483961325,44483961325,0,1887,1793,-10
44485837251,44485837254,3,951,1034,-10
44485968248,44485968250,2,1945,1564,-10
44486096814,44486096821,7,4451,1737,-10
44487110118,44487110122,4,1876,1386,-10
44488416488,44488416490,2,1730,1929,-10
44489410130,44489410134,4,1897,1555,-10
44507745245,44507745244,-1,1550,2546,-10
44508523425,44508523427,2,1043,924,-10
44510692574,44510692575,1,1264,1545,-10
44513796673,44513796673,0,1097,1609,-10
44514112991,44514112993,2,1129,1920,-10
44517814622,44517814625,3,1388,1254,-10
44522041249,44522041251,2,1970,1723,-10
44525759256,44525759260,4,1913,1665,-10
44530576450,44530576450,0,1971,1876,-10
44531343200,44531343203,3,1991,1520,-10
44532089505,44532089505,0,1247,1225,-10
44535867516,44535867518,2,2274,2293,-10
44537208976,44537208979,3,1771,1392,-10
44537782477,44537782471,-6,997,4756,-10
44539550874,44539550875,1,1098,1733,-10
44540620513,44540620519,6,2674,895,-10
44543087254,44543087254,0,1350,2013,-10
44544759795,44544759798,3,933,1154,-10
44545497576,44545497578,2,1291,1585,-10
44545534945,44545534936,-9,1599,1467,-10
44547779779,44547779782,3,1451,1666,-10
44550489725,44550489727,2,1409,1371,-10
44551237042,44551237044,2,2190,1754,-10
44551944381,44551944382,1,1949,1964,-10
44554247042,44554247043,1,1624,1803,-10
44556380559,44556380558,-1,1089,1475,-10
44558424510,44558424510,0,1074,1274,-10
44559679369,44559679370,1,1592,1501,-10
44562838655,44562838658,3,1392,1350,-10
44563918431,44563918435,4,1532,1505,-10
44565526017,44565526017,0,1720,1523,-10
44568294601,44568294603,2,786,1056,-10
44573763412,44573763414,2,1467,1566,-10
44577274731,44577274731,0,1253,2540,-10
44578403820,44578403821,1,1581,1199,-10
44579420232,44579420235,3,1964,1714,-10
44579943525,44579943530,5,1911,1410,-10
44584357990,44584357991,1,2045,1628,-10
44585906218,44585906221,3,1136,1143,-10
44588662958,44588662961,3,1856,1433,-10
44588845954,44588845958,4,1641,1104,-10
44591777247,44591777250,3,1753,2126,-10
44594726586,44594726587,1,1759,2483,-10
44596402094,44596402094,0,1763,1223,-10
44604790301,44604790303,2,1312,1191,-10
44607143338,44607143342,4,1573,1408,-10
44608214387,44608214391,4,1486,1572,-10
44614528890,44614528894,4,1698,1455,-10
44616483115,44616483114,-1,1639,1681,-10
44618142701,44618142702,1,1390,1544,-10
44620581826,44620581826,0,1321,1616,-10
44622444457,44622444458,1,799,973,-10
44625323274,44625323275,1,1062,1263,-10
44625465067,44625465065,-2,22447,11511,-10
44626035302,44626035306,4,2403,1462,-10
44627334430,44627334430,0,1435,1689,-10
44631729317,44631729318,1,1869,1160,-10
44632208110,44632208111,1,1611,1701,-10
44632817320,44632817322,2,2145,1674,-10
44632981186,44632981185,-1,1211,1876,-10
44634511648,44634511650,2,2127,1743,-10
44635344162,44635344163,1,971,1190,-10
44635557852,44635557851,-1,1907,2138,-10
44636833653,44636833656,3,1608,1667,-10
44637372871,44637372872,1,1375,1893,-10
44637875859,44637875861,2,2399,2021,-10
44638731150,44638731152,2,1610,1723,-10
44639282431,44639282433,2,1504,1639,-10
44645093414,44645093415,1,1788,1120,-10
44647435997,44647435999,2,1452,1168,-10
44648005393,44648005395,2,1744,1354,-10
44648824971,44648824971,0,2219,1613,-10
44649949967,44649949970,3,1223,1381,-10
44650669546,44650669545,-1,1804,2123,-10
44653799827,44653799829,2,1619,2286,-10
44668928799,44668928801,2,1514,1040,-10
44672323449,44672323450,1,1512,1193,-10
44674998397,44674998399,2,893,1108,-10
44675228784,44675228786,2,1726,1492,-10
44677762397,44677762399,2,1357,1914,-10
44678294822,44678294825,3,1217,1846,-10
44680896506,44680896507,1,1022,763,-10
44686761035,44686761038,3,999,1123,-10
44689666894,44689666899,5,839,1002,-10
44690262183,44690262183,0,1613,1939,-10
44693669182,44693669184,2,1300,1418,-10
44699137670,44699137671,1,1235,1381,-10
44701937355,44701937357,2,2024,2323,-10
44702970637,44702970639,2,891,1083,-10
44705719418,44705719418,0,1546,1637,-10
44708161258,44708161260,2,1641,1347,-10
44708982326,44708982329,3,2451,1577,-10
44709216385,44709216389,4,2091,1405,-10
44710762834,44710762837,3,2030,2327,-10
44711459813,44711459818,5,2513,1454,-10
44716687851,44716687851,0,1224,1526,-10
44718434183,44718434186,3,1808,1950,-10
44720077926,44720077930,4,1831,1480,-10
44721157698,44721157714,16,1272,789,-10
44723377253,44723377255,2,2158,1613,-10
44723725437,44723725438,1,2589,3530,-10
44723892279,44723892278,-1,1739,2173,-10
44724747461,44724747463,2,1438,1736,-10
44734542323,44734542327,4,2332,1375,-10
44736011442,44736011445,3,2036,1338,-10
44737179695,44737179698,3,1054,818,-10
44739276088,44739276089,1,1332,1462,-10
44739897104,44739897106,2,1633,1027,-10
44744718257,44744718260,3,2013,1801,-10
44745986511,44745986511,0,1501,1538,-10
44746448773,44746448774,1,1348,1634,-10
44748132923,44748132918,-5,799,1117,-10
44748829058,44748829060,2,1739,1318,-10
44749850368,44749850369,1,1498,1718,-10
44750439763,44750439764,1,1139,1400,-10
44755380215,44755380219,4,1928,1302,-10
44756980210,44756980210,0,1283,1483,-10
44758401374,44758401377,3,1781,1386,-10
44760317765,44760317750,-15,576,696,-10
44762612846,44762612853,7,2606,1037,-10
44762707975,44762707973,-2,952,1584,-10
44766254737,44766254737,0,1215,2053,-10
44770179370,44770179373,3,1781,1994,-10
44777101712,44777101712,0,1536,1850,-10
44779955949,44779955951,2,2541,1886,-10
44781586745,44781586746,1,1101,1278,-10
44782804147,44782804151,4,1092,1607,-10
44783949094,44783949098,4,1061,1122,-10
44785031495,44785031497,2,1284,1480,-10
44786149716,44786149723,7,5,1364,-10
44787611403,44787611406,3,1531,1405,-10
44791684011,44791684014,3,2151,1766,-10
44798939229,44798939231,2,1680,1286,-10
44799870241,44799870243,2,2281,1113,-10
44800867328,44800867330,2,1204,1409,-10
44801019740,44801019743,3,1894,1252,-10
44801868530,44801868546,16,1318,1278,-10
44805145515,44805145517,2,1692,1165,-10
44806520877,44806520883,6,3043,1348,-10
44808069137,44808069140,3,2256,1395,-10
44811883032,44811883032,0,1614,2436,-10
44823947605,44823947605,0,908,1100,-10
44824753703,44824753706,3,627,858,-10
44831167466,44831167468,2,852,1268,-10
44833404158,44833404157,-1,1537,1968,-10
44836890297,44836890301,4,1498,1424,-10
44839021345,44839021345,0,1482,1823,-10
44841743910,44841743910,0,2064,1866,-10
44842334999,44842335002,3,1390,2177,-10
44843555402,44843555406,4,1447,1367,-10
44845736084,44845736086,2,1976,1751,-10
44846253709,44846253711,2,1773,2090,-10
44846534442,44846534443,1,1949,1503,-10
44848870479,44848870481,2,2039,1902,-10
44849795415,44849795417,2,1573,1331,-10
44850618600,44850618606,6,1711,1105,-10
44851527534,44851527536,2,1749,970,-10
44852701122,44852701130,8,3851,1273,-10
44855685388,44855685390,2,1286,1677,-10
44856100032,44856100032,0,1533,2019,-10
44856365019,44856365020,1,1713,1439,-10
44856514471,44856514475,4,1520,1209,-10
44856884318,44856884321,3,1539,1208,-10
44859964342,44859964333,-9,956,5825,-10
44860371693,44860371694,1,1514,1410,-10
44864528996,44864528999,3,2136,1700,-10
44864723059,44864723062,3,1996,1779,-10
44864899686,44864899689,3,1051,1500,-10
44866633574,44866633576,2,2006,1800,-10
44866837605,44866837606,1,1844,1614,-10
44869919210,44869919213,3,1281,1247,-10
44878910107,44878910108,1,1909,1741,-10
44879088239,44879088259,20,1489,1399,-10
44881482682,44881482682,0,1698,1765,-10
44883136210,44883136215,5,1205,1552,-10
44886555950,44886555951,1,1541,1855,-10
44886864500,44886864507,7,2450,853,-10
44889247597,44889247598,1,1598,1348,-10
44889382289,44889382288,-1,1164,1149,-10
44890442633,44890442636,3,1806,1831,-10
44891248770,44891248774,4,1904,1886,-10
44894953929,44894953930,1,1623,1379,-10
44897033934,44897033934,0,2198,2007,-10
44897534146,44897534147,1,1242,1340,-10
44901694819,44901694820,1,2139,2205,-10
44903650546,44903650547,1,1356,1293,-10
44905490972,44905490974,2,1237,2034,-10
44907434695,44907434698,3,1896,1635,-10
44910022530,44910022530,0,1354,1740,-10
44911446385,44911446387,2,1239,1348,-10
44913642706,44913642701,-5,1439,3838,-10
44913914981,44913914982,1,996,1365,-10
44919468083,44919468086,3,1273,1170,-10
44922538574,44922538571,-3,1433,1443,-10
44925740044,44925740045,1,1320,1338,-10
44925843171,44925843169,-2,885,1837,-10
44926645550,44926645551,1,1211,1157,-10
44927590337,44927590338,1,1504,1378,-10
44929858827,44929858830,3,1213,1677,-10
44930954470,44930954473,3,1596,1067,-10
44933093442,44933093447,5,2490,1295,-10
44934094314,44934094314,0,1350,1624,-10
44934340339,44934340343,4,1283,1707,-10
44934564830,44934564831,1,1473,1661,-10
44934608563,44934608576,13,1252,1318,-10
44935714646,44935714643,-3,1694,1465,-10
44939092285,44939092284,-1,1149,1435,-10
44939407093,44939407094,1,1829,1705,-10
44939594894,44939594898,4,1715,1308,-10
44940964588,44940964591,3,1483,1476,-10
44941988999,44941988998,-1,691,1079,-10
44943817949,44943817953,4,2054,2296,-10
44944938022,44944938017,-5,513,1815,-10
44945541577,44945541579,2,1681,1372,-10
44946596443,44946596445,2,1425,1729,-10
44947752485,44947752490,5,2299,1479,-10
44947896052,44947896035,-17,1724,2028,-10
44948511545,44948511546,1,1442,1331,-10
44954612336,44954612337,1,1584,1679,-10
44959740028,44959740030,2,1778,1410,-10
44962046533,44962046536,3,1642,1346,-10
44962374150,44962374160,10,1178,1070,-10
44965176278,44965176281,3,1470,1511,-10
44965687790,44965687792,2,1089,1908,-10
44969979689,44969979692,3,1201,1643,-10
44972680560,44972680562,2,1287,1662,-10
44980042922,44980042922,0,1288,1557,-10
44982277079,44982277080,1,1753,1215,-10
44982922622,44982922625,3,1452,1271,-10
44985776087,44985776087,0,1234,1472,-10
44987547475,44987547478,3,1333,1715,-10
44989362834,44989362836,2,1391,1260,-10
44990156078,44990156057,-21,1354,866,-10
44991785648,44991785649,1,702,858,-10
44995053558,44995053562,4,1969,1620,-10
44996219602,44996219605,3,1745,1560,-10
44996966107,44996966109,2,1292,925,-10
44997109199,44997109219,20,1281,1603,-10
44998042759,44998042758,-1,1024,1804,-10
44998627436,44998627435,-1,1812,1373,-10
45000114621,45000114625,4,1620,1619,-10
45000660445,45000660438,-7,1185,4448,-10
45001757379,45001757382,3,1327,1428,-10
45003801513,45003801515,2,1333,1428,-10
45004005443,45004005442,-1,825,1093,-10
45011112297,45011112299,2,1214,1435,-10
45012811369,45012811372,3,1466,1535,-10
45017079935,45017079938,3,2004,1902,-10
45018183322,45018183326,4,1359,928,-10
45029273466,45029273470,4,1668,575,-10
45031532894,45031532895,1,1765,1634,-10
45032967382,45032967382,0,1027,1705,-10
45034844090,45034844090,0,1494,1834,-10
45035034919,45035034922,3,1250,1168,-10
45038047118,45038047117,-1,1369,1616,-10
45039703429,45039703428,-1,1049,1574,-10
45043892522,45043892524,2,2144,1950,-10
45045864239,45045864239,0,953,1614,-10
45046750010,45046750014,4,2245,1649,-10
45047013382,45047013384,2,1287,1042,-10
45050977994,45050977994,0,1227,2210,-10
45052829073,45052829072,-1,1089,2064,-10
45060248629,45060248630,1,2027,1467,-10
45061612831,45061612833,2,1426,1629,-10
45063038667,45063038669,2,926,1104,-10
45065087538,45065087537,-1,1729,1626,-10
45066248947,45066248949,2,1414,1475,-10
45069623782,45069623784,2,1759,2166,-10
45071934915,45071934917,2,1483,1717,-10
45072109104,45072109106,2,1965,1611,-10
45072576051,45072576053,2,1644,1582,-10
45076638518,45076638518,0,1833,1431,-10
45077759737,45077759737,0,1307,1482,-10
45082111993,45082111998,5,2617,935,-10
45082881467,45082881470,3,1552,1437,-10
45083607226,45083607222,-4,1710,4449,-10
45086244475,45086244474,-1,982,1539,-10
45111075360,45111075368,8,1478,2042,-10
45112868130,45112868119,-11,62714,55852,-10
45114394155,45114394158,3,974,1497,-10
45114982771,45114982766,-5,1701,7043,-10
45115308609,45115308612,3,1492,1375,-10
45115471074,45115471075,1,887,796,-10
45116907761,45116907762,1,1199,1584,-10
45117683671,45117683672,1,1614,1229,-10
45119609981,45119609985,4,2932,1172,-10
45120060805,45120060810,5,1763,925,-10
45120412896,45120412898,2,1690,1463,-10
45124674134,45124674137,3,1435,1503,-10
45124717698,45124717698,0,1342,1363,-10
45130366537,45130366539,2,1360,1293,-10
45133674835,45133674835,0,1171,2052,-10
45135242870,45135242871,1,1849,2231,-10
45136665717,45136665718,1,1123,1735,-10
45137059396,45137059399,3,1461,1417,-10
45137314680,45137314681,1,1559,1325,-10
45139497487,45139497488,1,1987,1562,-10
45139713326,45139713326,0,1148,1302,-10
45142091447,45142091446,-1,1274,1808,-10
45143787158,45143787176,18,1571,1477,-10
45145029326,45145029328,2,1970,2328,-10
45146400785,45146400786,1,1717,1453,-10
45149517463,45149517467,4,1084,1275,-10
45150117385,45150117390,5,3030,1329,-10
45150206318,45150206320,2,1460,1691,-10
45151725525,45151725525,0,1270,1992,-10
45152043821,45152043823,2,1136,684,-10
45154143981,45154143985,4,1327,1217,-10
45161025582,45161025582,0,1610,1911,-10
45161204614,45161204615,1,943,1766,-10
45162108337,45162108339,2,2792,2331,-10
45164126593,45164126599,6,1991,1030,-10
45165307160,45165307156,-4,642,1762,-10
45166289046,45166289047,1,1491,1606,-10
45168969209,45168969211,2,1374,1382,-10
45169552950,45169552955,5,1102,943,-10
45171036605,45171036606,1,1502,1297,-10
45172386986,45172386990,4,2296,1190,-10
45174146275,45174146277,2,1291,1049,-10
45188530449,45188530454,5,2070,1226,-10
45190182351,45190182354,3,1387,1470,-10
45191711766,45191711768,2,1377,1645,-10
45193495740,45193495743,3,1503,2053,-10
45194838702,45194838703,1,1060,1299,-10
45194892450,45194892451,1,6353,6906,-10
45196932791,45196932792,1,1302,1931,-10
45197197241,45197197238,-3,1211,2637,-10
45199034622,45199034623,1,1776,2510,-10
45201151790,45201151794,4,2484,1624,-10
45202650185,45202650187,2,1624,1607,-10
45204383510,45204383514,4,1212,1786,-10
45205610426,45205610430,4,1329,2067,-10
45210763907,45210763908,1,1337,1691,-10
45213574569,45213574570,1,1768,1646,-10
45213898837,45213898841,4,1451,1473,-10
45219398857,45219398858,1,1477,1171,-10
45223488035,45223488037,2,1852,1375,-10
45223616135,45223616137,2,1526,1056,-10
45224188039,45224188043,4,1453,1245,-10
45226166062,45226166063,1,1264,1684,-10
45231250898,45231250899,1,1276,1351,-10
45234729300,45234729301,1,1271,1200,-10
45235847891,45235847886,-5,1355,1775,-10
45236838902,45236838903,1,1124,1497,-10
45238169091,45238169102,11,2197,1003,-10
45239905592,45239905593,1,2114,2098,-10
45246152993,45246152997,4,2127,894,-10
45246192457,45246192473,16,1489,1364,-10
45248013667,45248013669,2,1764,1160,-10
45248821242,45248821246,4,1630,1820,-10
45249792369,45249792373,4,7071,5077,-10
45251733034,45251733036,2,1658,1522,-10
45253318044,45253318046,2,1574,1237,-10
45253468549,45253468552,3,1157,1407,-10
45254332819,45254332819,0,1914,2347,-10
45255566633,45255566635,2,1920,1802,-10
45256443613,45256443615,2,2374,2198,-10
45258105434,45258105434,0,1117,1551,-10
45258410762,45258410762,0,1173,1026,-10
45259308650,45259308651,1,1681,2322,-10
45260604171,45260604172,1,1584,1817,-10
45261901552,45261901553,1,1628,1528,-10
45267529134,45267529137,3,1483,2344,-10
45268361333,45268361335,2,1781,1943,-10
45269078897,45269078898,1,1403,1930,-10
45270923565,45270923562,-3,631,2622,-10
45272271822,45272271821,-1,1168,1166,-10
45274267863,45274267866,3,1345,1916,-10
45276033574,45276033574,0,1722,2024,-10
45277727182,45277727184,2,1228,1999,-10
45279057227,45279057228,1,1276,1911,-10
45279294419,45279294420,1,2000,1518,-10
45279517290,45279517307,17,1343,1135,-10
45283063516,45283063519,3,2162,1841,-10
45283627889,45283627891,2,1444,1531,-10
45283902730,45283902733,3,1378,1256,-10
45285158345,45285158344,-1,1209,1416,-10
45285496948,45285496953,5,1717,1641,-10
45287325409,45287325408,-1,1468,1934,-10
45289952149,45289952151,2,1451,1213,-10
45290272997,45290273001,4,49484,25239,-10
45290810227,45290810229,2,1301,1638,-10
45293558593,45293558595,2,2332,850,-10
45294663967,45294663957,-10,99,3954,-10
45300059032,45300059035,3,2800,2188,-10
45300615559,45300615562,3,1793,1292,-10
45301810625,45301810626,1,1684,1696,-10
45302818111,45302818112,1,1658,1837,-10
45303497790,45303497793,3,1926,1481,-10
45305124546,45305124549,3,1529,1767,-10
45305742339,45305742341,2,1949,1330,-10
45306042457,45306042459,2,1600,1330,-10
45306549930,45306549934,4,1665,1495,-10
45310271634,45310271637,3,1556,1652,-10
45314468903,45314468906,3,1844,1450,-10
45315450858,45315450861,3,1593,1267,-10
45317864174,45317864178,4,1416,1517,-10
45318435819,45318435821,2,1765,1651,-10
45320097714,45320097716,2,1679,1519,-10
45321518942,45321518944,2,1873,1927,-10
45335250646,45335250651,5,2219,1078,-10
45335745337,45335745339,2,1203,1428,-10
45337513670,45337513671,1,1444,2398,-10
45338805582,45338805582,0,1745,1808,-10
45341148602,45341148604,2,2644,2369,-10
45345324846,45345324847,1,1362,1781,-10
45346130128,45346130130,2,1202,1487,-10
45349927092,45349927097,5,2213,1298,-10
45350407519,45350407506,-13,30246,13608,-10
45357644635,45357644638,3,1795,1688,-10
45357764101,45357764102,1,1243,1506,-10
45359064919,45359064922,3,1976,1643,-10
45359934171,45359934165,-6,986,2900,-10
45360233241,45360233241,0,1264,1466,-10
45360932828,45360932829,1,1728,2370,-10
45362678210,45362678214,4,2679,1294,-10
45366572990,45366572991,1,1598,1659,-10
45367107990,45367107993,3,1900,1144,-10
45369508586,45369508586,0,1811,1365,-10
45372775462,45372775464,2,1623,1283,-10
45373912550,45373912556,6,1270,1608,-10
45376732189,45376732191,2,1510,1266,-10
45377682590,45377682587,-3,4703,9986,-10
45378298087,45378298086,-1,1100,1264,-10
45378693672,45378693671,-1,1606,1186,-10
45380407117,45380407137,20,17,928,-10
45381192944,45381192967,23,802,1250,-10
45383273398,45383273398,0,1654,1659,-10
45387385854,45387385855,1,1533,1929,-10
45387743502,45387743502,0,1644,1817,-10
45388954451,45388954452,1,959,1160,-10
45389419294,45389419295,1,1982,1645,-10
45393239812,45393239812,0,1577,1707,-10
45393534604,45393534606,2,1427,1673,-10
45396759220,45396759222,2,1418,984,-10
45400730881,45400730883,2,1755,1476,-10
45401977598,45401977599,1,1814,1443,-10
45402069413,45402069393,-20,1468,1568,-10
45405265487,45405265489,2,1582,1271,-10
45405446496,45405446499,3,1277,1662,-10
45405990837,45405990838,1,1655,1355,-10
45406465032,45406465048,16,1589,1264,-10
45407958971,45407958952,-19,1492,1501,-10
45408500955,45408500951,-4,1113,2243,-10
45410104973,45410104976,3,1696,1359,-10
45411898418,45411898420,2,1787,1856,-10
45412554333,45412554335,2,1811,1433,-10
45413066523,45413066523,0,3656,3877,-10
45416758988,45416758986,-2,1195,2187,-10
45417228811,45417228814,3,1954,1797,-10
45419069929,45419069926,-3,2955,6033,-10
45422212659,45422212659,0,1231,997,-10
45424493062,45424493063,1,1335,1842,-10
45428507372,45428507366,-6,979,3822,-10
45432198662,45432198654,-8,1075,4688,-10
45433922095,45433922098,3,1301,1426,-10
45441033461,45441033467,6,2241,1129,-10
45441216583,45441216561,-22,1035,1410,-10
45441308682,45441308680,-2,1452,2124,-10
45447799257,45447799259,2,2276,2340,-10
45449274064,45449274067,3,1426,1545,-10
45451009982,45451009994,12,11214,46927,-10
45455067287,45455067290,3,1794,1344,-10
45459088751,45459088752,1,838,1321,-10
45460076301,45460076303,2,1576,1320,-10
45463999758,45463999759,1,1896,1804,-10
45464107884,45464107887,3,852,1313,-10
45467196766,45467196769,3,2236,1582,-10
45469631200,45469631202,2,1611,1504,-10
45471282758,45471282759,1,1787,1915,-10
45471355017,45471355020,3,1510,1384,-10
45475067245,45475067252,7,5380,2181,-10
45475900766,45475900768,2,1306,1703,-10
45480495977,45480495981,4,1693,1463,-10
45481235594,45481235598,4,999,1591,-10
45485180987,45485180989,2,1459,1896,-10
45485324597,45485324598,1,1584,1885,-10
45486176655,45486176657,2,1576,1449,-10
45487425901,45487425903,2,2035,1567,-10
45487893239,45487893241,2,1377,1398,-10
45492341123,45492341124,1,1520,2005,-10
45496423198,45496423201,3,1420,1309,-10
45497370008,45497370008,0,1408,1962,-10
45497427129,45497427130,1,1520,1331,-10
45498610138,45498610140,2,1209,2069,-10
45500773011,45500773014,3,1844,1761,-10
45501651670,45501651671,1,1478,1477,-10
45507787737,45507787738,1,1623,1497,-10
45512634767,45512634766,-1,1254,2050,-10
45513467304,45513467306,2,1868,1794,-10
45519866329,45519866331,2,1896,1818,-10
45520342230,45520342233,3,1396,1200,-10
45525564254,45525564255,1,1693,1369,-10
45525639007,45525639007,0,987,1074,-10
45525796990,45525796993,3,1939,1513,-10
45526910699,45526910702,3,1662,1703,-10
45533506028,45533506030,2,1629,1183,-10
45536197387,45536197391,4,1914,1560,-10
45536737086,45536737089,3,1011,912,-10
45537432749,45537432750,1,913,1141,-10
45541400421,45541400423,2,1934,2080,-10
45542549914,45542549917,3,1260,1517,-10
45544723396,45544723397,1,1840,1437,-10
45553466269,45553466271,2,12869,50629,-10
45553901540,45553901542,2,1137,1425,-10
45558908677,45558908679,2,1754,1299,-10
45560522314,45560522315,1,1683,1963,-10
45562345693,45562345694,1,1302,1763,-10
45566801089,45566801089,0,1334,1645,-10
45567053256,45567053250,-6,1462,1350,-10
45567911175,45567911177,2,1167,1822,-10
45572511262,45572511265,3,1895,1538,-10
45572699582,45572699584,2,1010,887,-10
45574218608,45574218610,2,1929,2197,-10
45574244582,45574244583,1,2071,1474,-10
45575785997,45575785997,0,1646,1460,-10
45577059425,45577059427,2,1819,1748,-10
45577323883,45577323883,0,1077,896,-10
45581369889,45581369890,1,886,1844,-10
45586376210,45586376213,3,1441,1433,-10
45589622850,45589622850,0,1705,2010,-10
45589914130,45589914134,4,1935,1350,-10
45590698262,45590698264,2,1957,2226,-10
45592065627,45592065631,4,1887,1036,-10
45594988416,45594988419,3,1488,1040,-10
45595725253,45595725256,3,1812,1944,-10
45598237413,45598237414,1,1726,1828,-10
45598771755,45598771758,3,1052,1824,-10
45601708767,45601708771,4,1710,883,-10
45602121181,45602121160,-21,1313,1285,-10
45602773210,45602773210,0,1829,1877,-10
45604366747,45604366750,3,1714,1738,-10
45608495655,45608495657,2,1257,1179,-10
45609090605,45609090606,1,1580,2123,-10
45609688967,45609688968,1,828,964,-10
45609795712,45609795715,3,1102,848,-10
45618109715,45618109715,0,1219,1265,-10
45621077698,45621077701,3,1713,1670,-10
45622806065,45622806066,1,1105,1237,-10
45623261049,45623261052,3,1750,1882,-10
45624151730,45624151735,5,1605,1832,-10
45628976507,45628976509,2,1407,1380,-10
45629008321,45629008322,1,1532,1229,-10
45629335334,45629335334,0,1495,1558,-10
45629859004,45629859005,1,1342,1493,-10
45631636447,45631636448,1,1486,1383,-10
45632236539,45632236539,0,1375,1888,-10
45632637018,45632637019,1,1478,1791,-10
45634069996,45634069997,1,1305,1304,-10
45635240514,45635240517,3,1412,1442,-10
45636187972,45636187975,3,1443,1084,-10
45638071210,45638071211,1,1265,1931,-10
45639831550,45639831550,0,1590,1927,-10
45641006262,45641006263,1,996,1211,-10
45641462455,45641462453,-2,784,1090,-10
45643980154,45643980157,3,1417,1525,-10
45646830035,45646830037,2,1849,1050,-10
45647238407,45647238409,2,1679,1441,-10
45649696062,45649696064,2,2018,1666,-10
45657383051,45657383055,4,1553,2002,-10
45660261803,45660261783,-20,1143,1204,-10
45661200444,45661200443,-1,1091,1221,-10
45663945450,45663945452,2,951,928,-10
45664605354,45664605355,1,1429,997,-10
45665758736,45665758738,2,1301,2008,-10
45671783667,45671783670,3,1783,1619,-10
45682581861,45682581866,5,1432,1057,-10
45683954146,45683954150,4,1302,1498,-10
45685656643,45685656647,4,4217,1974,-10
45686327425,45686327427,2,1852,1499,-10
45688889427,45688889431,4,1793,1117,-10
45691048185,45691048187,2,1310,1311,-10
45692516062,45692516066,4,1395,989,-10
45695347110,45695347121,11,14294,36365,-10
45696292855,45696292861,6,4362,2560,-10
45697097195,45697097196,1,1492,1549,-10
45697856821,45697856823,2,1159,977,-10
45698665277,45698665279,2,1418,1727,-10
45702712181,45702712183,2,1109,2144,-10
45708813321,45708813322,1,1757,1682,-10
45710057730,45710057731,1,1634,1634,-10
45711440943,45711440946,3,1442,1391,-10
45713390670,45713390670,0,1801,1525,-10
45714078017,45714078017,0,1895,1704,-10
45714163146,45714163141,-5,1283,2180,-10
45717625750,45717625750,0,1744,1774,-10
45720375865,45720375870,5,6463,1915,-10
45720519522,45720519524,2,1660,1526,-10
45722014057,45722014058,1,907,876,-10
45723570254,45723570258,4,1347,1444,-10
45727535883,45727535886,3,1337,1981,-10
45731185171,45731185178,7,4649,1544,-10
45731584945,45731584946,1,1550,1408,-10
45732625140,45732625136,-4,1134,3431,-10
45733813493,45733813494,1,1740,1672,-10
45734168261,45734168262,1,1673,1408,-10
45734264151,45734264152,1,1478,1556,-10
45740419279,45740419281,2,1510,1232,-10
45741478562,45741478564,2,1650,1066,-10
45741800271,45741800274,3,1370,1624,-10
45743634225,45743634221,-4,1072,2709,-10
45745310870,45745310872,2,1505,1748,-10
45747750813,45747750814,1,1328,2016,-10
45748849078,45748849082,4,1657,1136,-10
45749733523,45749733524,1,2165,1614,-10
45749991847,45749991849,2,1975,2036,-10
45750135243,45750135242,-1,1563,1921,-10
45750977665,45750977666,1,1184,1413,-10
45754195632,45754195633,1,1816,1965,-10
45756124413,45756124412,-1,1668,1573,-10
45756464093,45756464094,1,1407,1988,-10
45757059404,45757059406,2,1326,1439,-10
45760934464,45760934466,2,1781,1939,-10
45761427792,45761427794,2,1348,1446,-10
45763066134,45763066138,4,1113,1027,-10
45764551666,45764551669,3,2163,1950,-10
45765132673,45765132671,-2,1996,2688,-10
45768955443,45768955445,2,1165,1136,-10
45769582297,45769582299,2,1487,1571,-10
45774456221,45774456223,2,1489,1574,-10
45775038103,45775038107,4,1180,1167,-10
45775911418,45775911422,4,1508,1927,-10
45776069454,45776069454,0,37847,17965,-10
45777526864,45777526866,2,1810,1328,-10
45778899097,45778899098,1,1419,1220,-10
45780109110,45780109111,1,1705,1573,-10
45780342787,45780342789,2,995,1195,-10
45785260782,45785260783,1,1451,1479,-10
45787808502,45787808503,1,1344,1667,-10
45788818369,45788818370,1,1622,1708,-10
45791653890,45791653890,0,1723,1805,-10
45791706485,45791706487,2,1714,1660,-10
45791965938,45791965941,3,2764,2397,-10
45794310197,45794310198,1,1608,1371,-10
45796045693,45796045695,2,1854,1550,-10
45797219009,45797219008,-1,1627,1876,-10
45798072103,45798072105,2,1812,1795,-10
45800767329,45800767329,0,1016,1564,-10
45801115370,45801115370,0,1630,1342,-10
45802630986,45802630987,1,1280,1187,-10
45804236099,45804236102,3,1340,1210,-10
45804887131,45804887133,2,1753,1374,-10
45806094128,45806094129,1,1106,1543,-10
45807924793,45807924794,1,1458,1395,-10
45807988973,45807988995,22,1816,1435,-10
45813738221,45813738222,1,1460,1470,-10
45814090559,45814090562,3,1217,1221,-10
45815366294,45815366296,2,1934,1729,-10
45816390337,45816390339,2,1003,1193,-10
45820483198,45820483195,-3,1881,4750,-10
45821974675,45821974679,4,1573,1171,-10
45822496762,45822496766,4,1369,1018,-10
45823188529,45823188525,-4,1253,1396,-10
45823427510,45823427514,4,1510,1704,-10
45824911794,45824911795,1,688,1344,-10
45826642902,45826642904,2,3294,2944,-10
45827679470,45827679475,5,1315,1312,-10
45831766097,45831766100,3,1833,1483,-10
45832482438,45832482451,13,4912,51689,-10
45834311746,45834311750,4,2012,1782,-10
45837386390,45837386395,5,1436,1335,-10
45838109618,45838109618,0,1170,1554,-10
45838602150,45838602151,1,1824,1617,-10
45839495276,45839495274,-2,1511,1743,-10
45840481073,45840481077,4,1720,1481,-10
45841541235,45841541239,4,2640,2000,-10
45842815082,45842815079,-3,1141,3009,-10
45844916737,45844916739,2,1330,1329,-10
45848966130,45848966132,2,1786,1521,-10
45849204618,45849204622,4,1397,1595,-10
45850732138,45850732135,-3,2058,3395,-10
45855135743,45855135745,2,1409,1616,-10
45857800925,45857800926,1,1319,1254,-10
45863763371,45863763371,0,1431,1728,-10
45864306094,45864306096,2,1410,1900,-10
45867606653,45867606659,6,45875,19791,-10
45869262437,45869262442,5,1034,867,-10
45870829229,45870829237,8,3734,1293,-10
45876784447,45876784449,2,1638,1242,-10
45877081093,45877081096,3,1768,1317,-10
45877401550,45877401551,1,1394,1481,-10
45877780385,45877780398,13,763,4718,-10
45877914483,45877914484,1,1952,1762,-10
45877942139,45877942141,2,1787,1993,-10
45882428202,45882428191,-11,3661,10434,-10
45882853457,45882853465,8,7814,2434,-10
45885018743,45885018744,1,1339,1352,-10
45885284406,45885284407,1,2042,1187,-10
45885703510,45885703511,1,1965,1788,-10
45886228954,45886228955,1,975,1148,-10
45887194633,45887194635,2,1998,1789,-10
45887251957,45887251958,1,1712,1978,-10
45889402830,45889402829,-1,2164,2236,-10
45890059111,45890059111,0,1440,1067,-10
45890521739,45890521741,2,1694,1092,-10
45891382225,45891382226,1,1489,1438,-10
45892497830,45892497830,0,1440,1473,-10
45898534017,45898534018,1,1540,2058,-10
45911195683,45911195685,2,1421,1539,-10
45912732382,45912732383,1,1619,1615,-10
45915256386,45915256389,3,2107,1265,-10
45916350934,45916350936,2,1632,1397,-10
45916491891,45916491894,3,1510,1250,-10
45917000298,45917000298,0,33219,18788,-10
45917266011,45917266012,1,2503,2411,-10
45920455320,45920455322,2,1506,1218,-10
45920572755,45920572754,-1,770,1488,-10
45920678237,45920678237,0,1400,1460,-10
45922042749,45922042753,4,1623,1520,-10
45923349181,45923349183,2,1095,1257,-10
45929297392,45929297391,-1,1181,994,-10
45930093482,45930093483,1,1073,1542,-10
45930237603,45930237606,3,1886,1605,-10
45931425021,45931425022,1,1484,1549,-10
45931779526,45931779527,1,1035,1039,-10
45934167917,45934167921,4,1590,1628,-10
45935277226,45935277227,1,1538,1486,-10
45936927850,45936927853,3,2112,1847,-10
45937258551,45937258554,3,1991,1673,-10
45937643991,45937643992,1,1257,1219,-10
45937869261,45937869262,1,1689,1550,-10
45940425795,45940425802,7,6830,2905,-10
45941702359,45941702359,0,2041,1942,-10
45943294823,45943294823,0,1236,1064,-10
45944675427,45944675429,2,1683,1910,-10
45949497489,45949497491,2,2321,1667,-10
45950365239,45950365243,4,1535,31603,-10
45951649874,45951649878,4,2807,1665,-10
45960116940,45960116940,0,1989,1629,-10
45967689110,45967689111,1,1507,2286,-10
45970941218,45970941211,-7,1821,8115,-10
45973208733,45973208734,1,2076,1739,-10
45973324182,45973324183,1,1140,1184,-10
45974729657,45974729659,2,1944,1874,-10
45979396828,45979396830,2,1531,1179,-10
45979968114,45979968115,1,1893,1620,-10
45980137381,45980137382,1,2265,2284,-10
45981679280,45981679281,1,1817,2216,-10
45984743118,45984743119,1,1047,1236,-10
45987400654,45987400655,1,1479,1067,-10
45989775187,45989775190,3,1696,1980,-10
45990586451,45990586447,-4,1780,5163,-10
45991568713,45991568714,1,2075,2195,-10
45991797994,45991797997,3,1077,927,-10
45994127263,45994127263,0,1781,1535,-10
45995817353,45995817355,2,1331,1160,-10
45997034794,45997034794,0,1478,1449,-10
45998985098,45998985099,1,1813,2071,-10
45999098512,45999098514,2,1402,1308,-10
45999728549,45999728549,0,1639,1691,-10
46000080511,46000080511,0,1068,1250,-10
46000948114,46000948115,1,1750,1598,-10
46002407890,46002407893,3,1933,2249,-10
46004395322,46004395323,1,1021,1293,-10
46006000441,46006000442,1,1447,1855,-10
46007703795,46007703795,0,2171,1614,-10
46008337382,46008337386,4,1692,1087,-10
46009436996,46009436997,1,1726,1733,-10
46010561400,46010561403,3,1454,1369,-10
46013588609,46013588611,2,1269,1650,-10
46014954998,46014954997,-1,1370,1836,-10
46016521901,46016521902,1,1245,1493,-10
46017718915,46017718917,2,1480,1116,-10
46020573982,46020573962,-20,666,886,-10
46021366229,46021366229,0,1863,2889,-10
46029555050,46029555052,2,1447,1387,-10
46033228248,46033228250,2,1767,1406,-10
46033938757,46033938763,6,2843,1252,-10
46036626971,46036626974,3,1944,1710,-10
46037802701,46037802701,0,1333,1223,-10
46038459856,46038459858,2,1327,1263,-10
46043402477,46043402477,0,1699,1932,-10
46043635102,46043635105,3,1618,1806,-10
46045312630,46045312624,-6,1270,6263,-10
46047361851,46047361850,-1,1519,2110,-10
46051914357,46051914358,1,1906,1466,-10
46052351090,46052351091,1,1389,1483,-10
46057795417,46057795423,6,2780,1563,-10
46060952091,46060952090,-1,1700,1729,-10
46065195704,46065195707,3,1511,1672,-10
46065892386,46065892387,1,2068,2212,-10
46067317147,46067317153,6,2234,1728,-10
46070240609,46070240610,1,1279,1427,-10
46071515340,46071515343,3,1525,1446,-10
46075663801,46075663802,1,1803,2208,-10
46075940584,46075940584,0,1732,1437,-10
46080551074,46080551076,2,1423,1448,-10
46081944285,46081944288,3,1467,1376,-10
46083975422,46083975423,1,2178,1870,-10
46084830001,46084830000,-1,3663,4383,-10
46090364383,46090364384,1,1070,1149,-10
46094729942,46094729946,4,2351,1319,-10
46095005304,46095005303,-1,1568,1651,-10
46098317958,46098317958,0,1513,1290,-10
46099050865,46099050871,6,1740,1019,-10
46100662778,46100662781,3,1446,1712,-10
46100755330,46100755329,-1,1335,2002,-10
46101828792,46101828793,1,1397,1572,-10
46106563581,46106563583,2,1286,1106,-10
46112627275,46112627277,2,2520,2110,-10
46113278385,46113278385,0,1473,951,-10
46113505427,46113505427,0,1421,1119,-10
46114125423,46114125424,1,1314,1228,-10
46114877959,46114877957,-2,1230,1125,-10
46117082049,46117082051,2,2329,2039,-10
46121309990,46121309989,-1,1918,1918,-10
46121387454,46121387436,-18,1705,1497,-10
46121799474,46121799476,2,1498,1879,-10
46122235297,46122235298,1,1778,2402,-10
46124924107,46124924109,2,1685,1888,-10
46125687691,46125687694,3,934,1325,-10
46130825609,46130825612,3,1178,2087,-10
46131904032,46131904034,2,1394,1909,-10
46132214366,46132214366,0,999,2271,-10
46133811817,46133811819,2,1385,1341,-10
46137613197,46137613191,-6,1064,2179,-10
46137901954,46137901955,1,1512,1578,-10
46145961579,46145961582,3,971,1561,-10
46146000065,46146000067,2,1802,1619,-10
46147054118,46147054120,2,1752,1247,-10
46147980792,46147980789,-3,1261,2144,-10
46150474702,46150474706,4,1425,1551,-10
46151057118,46151057118,0,1229,1430,-10
46152287202,46152287204,2,2052,1120,-10
46154503245,46154503245,0,991,2212,-10
46159931689,46159931691,2,1045,1147,-10
46165987206,46165987209,3,1356,1565,-10
46166930841,46166930841,0,1406,1411,-10
46167186593,46167186594,1,1423,979,-10
46169143658,46169143661,3,1673,1280,-10
46171832906,46171832907,1,1318,1372,-10
46174950269,46174950271,2,1635,1622,-10
46177720863,46177720859,-4,1272,3905,-10
46178556502,46178556511,9,13144,22921,-10
46178599922,46178599921,-1,951,2155,-10
46178735155,46178735155,0,1538,1342,-10
46180123713,46180123714,1,1501,1288,-10
46182064389,46182064391,2,1286,1186,-10
46184654374,46184654375,1,1415,1341,-10
46190399352,46190399353,1,2192,2072,-10
46194685821,46194685823,2,1619,1544,-10
46197928210,46197928211,1,1819,1438,-10
46198718696,46198718698,2,1128,774,-10
46202728365,46202728366,1,1230,1479,-10
46206379701,46206379703,2,992,1597,-10
46208920517,46208920518,1,1633,946,-10
46209301158,46209301158,0,1521,1852,-10
46210425742,46210425744,2,1182,1507,-10
46215047954,46215047957,3,1695,1675,-10
46217440915,46217440917,2,1737,1874,-10
46217779238,46217779240,2,1849,1646,-10
46218823355,46218823357,2,1524,1355,-10
46219621556,46219621551,-5,1198,1455,-10
46220650998,46220651000,2,2012,1348,-10
46221162351,46221162353,2,1430,1335,-10
46222111293,46222111296,3,1615,1506,-10
46224449899,46224449901,2,1411,1556,-10
46225465931,46225465932,1,1254,1729,-10
46226341762,46226341763,1,1286,1374,-10
46227785453,46227785456,3,1543,2055,-10
46228832202,46228832205,3,1741,1367,-10
46230461014,46230461015,1,1482,1660,-10
46231968990,46231968991,1,1346,1594,-10
46234280181,46234280182,1,1942,2662,-10
46235094268,46235094270,2,1531,2076,-10
46235576446,46235576448,2,1564,1350,-10
46242649663,46242649663,0,1128,1304,-10
46243920143,46243920147,4,1054,1178,-10
46246002982,46246002986,4,1637,1765,-10
46247916883,46247916888,5,1558,1382,-10
46248081815,46248081819,4,987,1095,-10
46249712494,46249712495,1,1782,1578,-10
46250467023,46250467027,4,2196,2094,-10
46253164938,46253164941,3,1672,1724,-10
46257863839,46257863841,2,1158,1503,-10
46258577945,46258577948,3,2250,2194,-10
46258939742,46258939744,2,1692,1904,-10
46261287706,46261287707,1,1239,1299,-10
46274112666,46274112669,3,2427,1573,-10
46275625138,46275625145,7,1762,903,-10
46275915858,46275915857,-1,975,1158,-10
46277347359,46277347360,1,1064,1166,-10
46280651624,46280651625,1,2258,1977,-10
46283232598,46283232594,-4,5600,15513,-10
46284006602,46284006603,1,761,1058,-10
46285805259,46285805258,-1,481,646,-10
46289032978,46289032979,1,1422,1729,-10
46293870607,46293870607,0,1898,1655,-10
46294174018,46294174021,3,1010,1403,-10
46296414799,46296414801,2,1715,1311,-10
46299825298,46299825301,3,1732,1909,-10
46302276083,46302276081,-2,1425,2192,-10
46302749426,46302749428,2,1688,1467,-10
46305760901,46305760903,2,1293,1663,-10
46307435029,46307435030,1,1444,1316,-10
46310381598,46310381595,-3,43860,20060,-10
46313733719,46313733721,2,1420,1824,-10
46313975276,46313975256,-20,1560,1060,-10
46314071402,46314071406,4,1074,1818,-10
46315075694,46315075694,0,1526,1744,-10
46324667254,46324667257,3,2086,2093,-10
46325193702,46325193711,9,13989,23812,-10
46326122041,46326122044,3,1115,1070,-10
46337808234,46337808234,0,1076,1448,-10
46339219858,46339219860,2,1159,893,-10
46341697750,46341697753,3,1806,1545,-10
46345801168,46345801170,2,1762,1724,-10
46348048178,46348048180,2,2274,1575,-10
46351171290,46351171292,2,1573,1772,-10
46351396866,46351396886,20,1582,2718,-10
46352030571,46352030575,4,757,1793,-10
46352226563,46352226566,3,2129,2000,-10
46353192499,46353192501,2,1222,1318,-10
46357262558,46357262562,4,1526,1625,-10
46358181116,46358181117,1,1807,1583,-10
46358518879,46358518882,3,1936,1296,-10
46359452825,46359452825,0,1721,1616,-10
46360823233,46360823233,0,2576,2241,-10
46364461491,46364461493,2,2306,1471,-10
46364525277,46364525278,1,1688,1420,-10
46364939301,46364939303,2,1215,1134,-10
46373995969,46373995974,5,770,1278,-10
46374438961,46374438964,3,4469,2966,-10
46377148894,46377148895,1,1196,1114,-10
46381064460,46381064463,3,1934,1226,-10
46384409757,46384409761,4,2681,1760,-10
46387186660,46387186662,2,1249,1094,-10
46388883249,46388883255,6,1908,1235,-10
46390515906,46390515908,2,2406,1632,-10
46392293277,46392293274,-3,1194,2171,-10
46400981142,46400981149,7,2593,1388,-10
46401496586,46401496589,3,1382,1379,-10
46409503680,46409503682,2,956,1114,-10
46411472366,46411472369,3,1182,1640,-10
46413698651,46413698653,2,1709,1950,-10
46414875129,46414875129,0,2021,2107,-10
46418445298,46418445299,1,1865,1588,-10
46418866352,46418866350,-2,1200,1853,-10
46419592140,46419592155,15,1181,1404,-10
46420271702,46420271701,-1,1210,1340,-10
46421569147,46421569149,2,1204,946,-10
46423686548,46423686549,1,1322,1092,-10
46426975981,46426975982,1,2045,1887,-10
46428428905,46428428912,7,1088,1556,-10
46428805282,46428805284,2,1636,1344,-10
46430915498,46430915503,5,1800,1870,-10
46431416634,46431416635,1,1593,1344,-10
46433652667,46433652670,3,1664,1300,-10
46434266380,46434266384,4,2835,1605,-10
46434671289,46434671289,0,923,2077,-10
46435616236,46435616238,2,2240,2057,-10
46440286318,46440286320,2,1407,1818,-10
46442038861,46442038862,1,2076,2043,-10
46444258032,46444258031,-1,1234,1900,-10
46444582413,46444582414,1,1992,1681,-10
46444976041,46444976042,1,1581,1738,-10
46445974377,46445974379,2,1567,924,-10
46447666702,46447666702,0,1802,2385,-10
46450116282,46450116274,-8,2046,10906,-10
46452169866,46452169867,1,1783,2323,-10
46452901318,46452901314,-4,1548,4700,-10
46454727686,46454727692,6,11116,5175,-10
46456316908,46456316911,3,1479,1422,-10
46458390546,46458390549,3,1690,1597,-10
46460010795,46460010798,3,1814,1701,-10
46460909718,46460909722,4,2102,1647,-10
46463198714,46463198715,1,1814,1727,-10
46468685133,46468685134,1,1537,1825,-10
46469906519,46469906520,1,1645,1551,-10
46473143488,46473143490,2,1428,1275,-10
46473353134,46473353134,0,1873,1733,-10
46473650163,46473650141,-22,1718,1654,-10
46474547701,46474547705,4,2368,2194,-10
46476481755,46476481757,2,1735,1728,-10
46476522094,46476522097,3,2146,1308,-10
46476651771,46476651773,2,1522,1365,-10
46478748059,46478748062,3,1882,1317,-10
46488109744,46488109746,2,1800,2185,-10
46490509874,46490509870,-4,2340,6630,-10
46495346917,46495346918,1,1299,1090,-10
46497756438,46497756443,5,2789,1017,-10
46497951304,46497951304,0,1940,1577,-10
46501146069,46501146070,1,1784,1454,-10
46502468581,46502468582,1,1395,1744,-10
46503411187,46503411189,2,2101,1971,-10
46504662782,46504662785,3,2269,1948,-10
46506972496,46506972497,1,1712,2440,-10
46510011313,46510011315,2,1273,1370,-10
46511272748,46511272750,2,1447,1309,-10
46512106135,46512106138,3,1891,1727,-10
46513702422,46513702425,3,1789,1758,-10
46515113807,46515113807,0,896,369,-10
46515187717,46515187696,-21,1419,1357,-10
46518715990,46518715991,1,2070,2338,-10
46521641956,46521641957,1,1644,1441,-10
46522589969,46522589971,2,1685,1535,-10
46525031329,46525031329,0,34072,46832,-10
46527318592,46527318595,3,1169,1138,-10
46527942831,46527942808,-23,434,554,-10
46529548616,46529548618,2,1623,1351,-10
46532897979,46532897984,5,1518,1486,-10
46534598417,46534598418,1,1708,1682,-10
46535226194,46535226194,0,1218,1563,-10
46539944165,46539944166,1,1560,1913,-10
46540890553,46540890555,2,3890,2815,-10
46547524616,46547524619,3,2479,1950,-10
46548595115,46548595116,1,1361,1553,-10
46548681850,46548681849,-1,1219,1829,-10
46551096798,46551096801,3,1863,1407,-10
46552010513,46552010516,3,2058,1485,-10
46554016690,46554016694,4,1639,1644,-10
46561178109,46561178111,2,1234,863,-10
46564001728,46564001730,2,972,1262,-10
46568468428,46568468428,0,1707,2369,-10
46568980030,46568980030,0,1359,1471,-10
46569090555,46569090559,4,1550,923,-10
46572584223,46572584240,17,1843,1085,-10
46573713558,46573713561,3,1370,1451,-10
46578083453,46578083455,2,1575,1280,-10
46578353746,46578353747,1,1547,1374,-10
46578944651,46578944667,16,926,1337,-10
46582049708,46582049709,1,1512,1619,-10
46584629250,46584629253,3,1715,2352,-10
46585031094,46585031096,2,1584,1816,-10
46588212714,46588212715,1,1891,1397,-10
46588857639,46588857641,2,1303,1357,-10
46592257501,46592257503,2,1123,1175,-10
46593571613,46593571613,0,1089,1196,-10
46594546979,46594546978,-1,1498,2168,-10
46594973933,46594973937,4,1503,1215,-10
46596870840,46596870842,2,915,1817,-10
46597317074,46597317089,15,213,1518,-10
46599789195,46599789198,3,1195,1617,-10
46606302115,46606302118,3,1191,1157,-10
46606732116,46606732118,2,1858,1948,-10
46609179367,46609179370,3,1614,970,-10
46612031913,46612031915,2,1437,1788,-10
46614710711,46614710713,2,1367,1785,-10
46617089765,46617089766,1,1804,1265,-10
46620192831,46620192816,-15,1118,1155,-10
46621736788,46621736790,2,2061,2177,-10
46623929877,46623929879,2,1839,1232,-10
46624240219,46624240223,4,913,946,-10
46625687126,46625687125,-1,2292,3149,-10
46629584441,46629584443,2,1772,1504,-10
46629905716,46629905719,3,1860,1410,-10
46631259627,46631259627,0,1684,1912,-10
46633852426,46633852426,0,1068,1382,-10
46634271055,46634271059,4,2170,1432,-10
46635158205,46635158206,1,1259,942,-10
46639138288,46639138289,1,1772,1901,-10
46641174350,46641174355,5,1390,1554,-10
46643585202,46643585203,1,1453,1290,-10
46644721993,46644721995,2,2277,1745,-10
46645058276,46645058274,-2,1463,1799,-10
46647196893,46647196895,2,1537,1412,-10
46651402910,46651402912,2,2348,2246,-10
46653785700,46653785702,2,1582,1436,-10
46654745969,46654745973,4,1729,1819,-10
46655559042,46655559043,1,1770,1497,-10
46656306127,46656306130,3,1495,1451,-10
46656925553,46656925557,4,2488,1687,-10
46661345512,46661345514,2,2358,1638,-10
46665662885,46665662886,1,1843,1313,-10
46670456527,46670456529,2,1607,1666,-10
46670483410,46670483415,5,1913,1500,-10
46676048057,46676048063,6,2716,1058,-10
46677306284,46677306286,2,1267,1586,-10
46679736983,46679736971,-12,1388,1375,-10
46687652659,46687652662,3,2113,1195,-10
46693138005,46693138006,1,2486,1559,-10
46697464968,46697464970,2,1442,1684,-10
46699615079,46699615082,3,1894,2368,-10
46700562690,46700562691,1,1412,1477,-10
46701103613,46701103615,2,1243,969,-10
46702826493,46702826495,2,1825,2097,-10
46704019345,46704019346,1,1101,1094,-10
46705030237,46705030238,1,1687,1284,-10
46709439497,46709439499,2,1669,1016,-10
46711772610,46711772613,3,1198,1621,-10
46711833956,46711833980,24,2035,1511,-10
46712699129,46712699131,2,1270,1669,-10
46715779542,46715779543,1,1740,1301,-10
46726497490,46726497494,4,1365,1291,-10
46727079314,46727079315,1,1226,1317,-10
46730000482,46730000483,1,1130,1675,-10
46731229951,46731229951,0,2005,1740,-10
46732102585,46732102585,0,1268,1155,-10
46732534837,46732534841,4,1749,1839,-10
46732717442,46732717446,4,1223,1235,-10
46735222158,46735222164,6,1718,994,-10
46737351514,46737351515,1,1276,1154,-10
46740870146,46740870149,3,1594,1533,-10
46742905793,46742905795,2,2091,1871,-10
46743762488,46743762490,2,1244,1493,-10
46744521209,46744521211,2,1738,1976,-10
46745811087,46745811096,9,8626,39850,-10
46746740913,46746740913,0,872,1409,-10
46747753074,46747753077,3,959,1546,-10
46749818939,46749818939,0,2313,2280,-10
46750382277,46750382277,0,2090,1314,-10
46753311966,46753311962,-4,1674,1926,-10
46754761850,46754761851,1,1453,1475,-10
46756045521,46756045521,0,1827,1594,-10
46756319253,46756319253,0,1295,1948,-10
46756966413,46756966414,1,1449,1693,-10
46758062357,46758062358,1,1425,1647,-10
46758326606,46758326606,0,1570,1311,-10
46760793587,46760793589,2,2358,1864,-10
46761230622,46761230622,0,1543,2088,-10
46765697634,46765697637,3,1350,1790,-10
46773135492,46773135493,1,2209,2044,-10
46773459360,46773459363,3,1226,874,-10
46775420338,46775420339,1,1495,1914,-10
46775676110,46775676115,5,1450,1585,-10
46775752450,46775752451,1,1692,2307,-10
46775906565,46775906563,-2,1324,1666,-10
46778782387,46778782388,1,1410,1107,-10
46779444550,46779444552,2,2094,2093,-10
46781038843,46781038845,2,1680,1664,-10
46784990957,46784990959,2,1316,1756,-10
46786558582,46786558583,1,1019,1849,-10
46788317400,46788317399,-1,1463,1955,-10
46789296677,46789296679,2,1169,1053,-10
46792110788,46792110790,2,2607,2576,-10
46794172090,46794172090,0,1435,1185,-10
46794802966,46794802967,1,1415,1141,-10
46798035532,46798035535,3,1167,1518,-10
46801158821,46801158822,1,1558,1963,-10
46803326055,46803326057,2,1615,1313,-10
46806183013,46806183015,2,1410,1798,-10
46806601349,46806601351,2,1749,1285,-10
46809899877,46809899883,6,2036,888,-10
46811195304,46811195306,2,1471,1680,-10
46821576403,46821576403,0,1650,1927,-10
46821610018,46821610022,4,1314,779,-10
46822372045,46822372046,1,1378,1395,-10
46825502887,46825502889,2,1075,947,-10
46826598621,46826598623,2,1923,1718,-10
46826669694,46826669699,5,1632,1488,-10
46829450293,46829450294,1,1718,1477,-10
46830382607,46830382611,4,1022,1127,-10
46833046784,46833046783,-1,1877,1256,-10
46836367206,46836367209,3,989,1118,-10
46836852519,46836852521,2,2013,1684,-10
46840228600,46840228603,3,1415,1049,-10
46842555402,46842555382,-20,1578,1261,-10
46846461338,46846461340,2,2366,1209,-10
46849664993,46849664995,2,1401,1645,-10
46854640542,46854640545,3,2066,1657,-10
46859477964,46859477964,0,1501,1849,-10
46861275632,46861275634,2,1584,1234,-10
46863929322,46863929323,1,2202,1813,-10
46865292072,46865292076,4,1656,1623,-10
46866500146,46866500148,2,1729,1469,-10
46869653627,46869653632,5,1282,1685,-10
46872338332,46872338336,4,2061,1331,-10
46873393158,46873393161,3,1512,1372,-10
46873861747,46873861749,2,1170,1680,-10
46874799101,46874799102,1,1597,1595,-10
46875532576,46875532579,3,2119,1509,-10
46876785832,46876785834,2,1241,936,-10
46877176311,46877176314,3,2110,1475,-10
46877912433,46877912434,1,1653,1764,-10
46879254124,46879254126,2,1469,1278,-10
46879626902,46879626906,4,1192,1211,-10
46880578433,46880578434,1,2006,2340,-10
46881381561,46881381565,4,1947,1154,-10
46881458503,46881458481,-22,1157,1931,-10
46881719930,46881719908,-22,1368,1834,-10
46881842905,46881842905,0,1275,1847,-10
46882161521,46882161523,2,1405,1181,-10
46882409082,46882409087,5,1671,1419,-10
46882750937,46882750938,1,697,884,-10
46884253063,46884253066,3,2164,1911,-10
46885442854,46885442855,1,1148,910,-10
46885814816,46885814818,2,1527,1628,-10
46886871559,46886871563,4,1508,1476,-10
46887178954,46887178955,1,2398,2097,-10
46887454225,46887454231,6,3290,1258,-10
46889465062,46889465063,1,1635,1872,-10
46890456030,46890456034,4,1864,1346,-10
46893672766,46893672767,1,1691,1306,-10
46895965506,46895965507,1,1221,1019,-10
46897093122,46897093126,4,1936,2128,-10
46899825449,46899825454,5,796,670,-10
46900788053,46900788053,0,1566,1863,-10
46901810994,46901810994,0,1390,1052,-10
46902076321,46902076322,1,1305,1331,-10
46903714753,46903714756,3,1746,1648,-10
46903993906,46903993907,1,1165,1393,-10
46906090379,46906090385,6,1571,1368,-10
46906488289,46906488293,4,2715,1163,-10
46906961430,46906961431,1,1211,2364,-10
46908854745,46908854746,1,1647,1660,-10
46911606225,46911606226,1,1570,1627,-10
46913370812,46913370818,6,7063,2505,-10
46913594853,46913594854,1,1803,1771,-10
46922547949,46922547952,3,1562,1149,-10
46924997593,46924997593,0,1679,1374,-10
46927099911,46927099907,-4,1038,926,-10
46928736890,46928736893,3,1749,1807,-10
46932772816,46932772817,1,875,735,-10
46933170452,46933170454,2,1353,1326,-10
46936435600,46936435600,0,1924,2459,-10
46937746489,46937746491,2,2038,1771,-10
46942463279,46942463281,2,1492,1893,-10
46946442059,46946442057,-2,24420,17679,-10
46948989618,46948989614,-4,1857,5079,-10
46950800766,46950800768,2,1648,1261,-10
46952433189,46952433190,1,1412,1328,-10
46956993090,46956993093,3,2033,1949,-10
46958409834,46958409834,0,1258,1677,-10
46963417930,46963417931,1,1423,1393,-10
46963777146,46963777146,0,1480,1556,-10
46964628064,46964628065,1,1676,1430,-10
46966587002,46966587005,3,1824,1728,-10
46966942842,46966942842,0,1403,1758,-10
46967874485,46967874486,1,2059,2365,-10
46968430439,46968430446,7,2887,1431,-10
46977308003,46977307996,-7,599,2598,-10
46977420887,46977420865,-22,1713,1097,-10
46977802694,46977802696,2,2531,2137,-10
46978105870,46978105867,-3,1351,3549,-10
46979158998,46979158999,1,1840,1581,-10
46979774225,46979774229,4,1369,1135,-10
46981747962,46981747966,4,2578,1803,-10
46983540100,46983540098,-2,1566,2617,-10
46985682726,46985682718,-8,1247,2365,-10
46986166984,46986166981,-3,1162,1116,-10
46989203674,46989203677,3,1620,1826,-10
46989989045,46989989025,-20,1134,1221,-10
46990548627,46990548625,-2,965,1364,-10
46994337337,46994337335,-2,1193,2157,-10
46994743104,46994743100,-4,938,1703,-10
46995052467,46995052466,-1,1453,1765,-10
46997029366,46997029369,3,1257,1888,-10
46999391109,46999391114,5,2203,1160,-10
47000728071,47000728074,3,1796,1821,-10
47002443915,47002443918,3,1090,1332,-10
47006653985,47006653987,2,1819,1261,-10
47009867618,47009867620,2,2088,1175,-10
47012158060,47012158063,3,1286,1494,-10
47013126485,47013126488,3,1691,1504,-10
47013718506,47013718509,3,1431,1485,-10
47014717148,47014717129,-19,1501,1690,-10
47017962356,47017962360,4,1545,1494,-10
47019090077,47019090082,5,1730,919,-10
47021002950,47021002951,1,1189,1080,-10
47023935930,47023935930,0,2049,1824,-10
47024148345,47024148346,1,1864,1316,-10
47028258065,47028258067,2,1552,1316,-10
47032254035,47032254038,3,844,1147,-10
47033064781,47033064781,0,1378,1690,-10
47035165764,47035165759,-5,1560,6107,-10
47043179897,47043179898,1,687,952,-10
47046924711,47046924714,3,1004,1398,-10
47053213245,47053213245,0,854,1244,-10
47054172345,47054172346,1,1525,1399,-10
47054687594,47054687597,3,1448,1382,-10
47055353454,47055353455,1,1585,2019,-10
47057962202,47057962203,1,1477,1422,-10
47059986325,47059986326,1,1178,1316,-10
47060046312,47060046313,1,1654,1505,-10
47061835668,47061835668,0,17937,7190,-10
47062472380,47062472379,-1,1299,1466,-10
47063401443,47063401446,3,1670,1160,-10
47063711215,47063711219,4,1189,1777,-10
47065511713,47065511715,2,1124,1226,-10
47066789945,47066789945,0,1306,1621,-10
47067043533,47067043534,1,1619,1432,-10
47068458831,47068458831,0,1732,1957,-10
47077259157,47077259158,1,1722,1780,-10
47078573829,47078573831,2,1224,2190,-10
47080168381,47080168383,2,1583,1654,-10
47083389125,47083389126,1,1913,2048,-10
47084754643,47084754644,1,872,1705,-10
47086323298,47086323299,1,1682,2246,-10
47090725665,47090725665,0,1469,1185,-10
47092063415,47092063418,3,1075,1392,-10
47094158446,47094158447,1,1112,998,-10
47095057154,47095057154,0,1363,2028,-10
47096534480,47096534479,-1,1365,1713,-10
47097975838,47097975838,0,2113,1585,-10
47102046350,47102046354,4,1548,2116,-10
47102177529,47102177530,1,1395,1405,-10
47105149048,47105149050,2,1218,1636,-10
47106378898,47106378903,5,1412,1532,-10
47106734425,47106734423,-2,1771,1951,-10
47107915395,47107915398,3,1118,1500,-10
47109262488,47109262486,-2,2,1385,-10
47111981961,47111981961,0,1215,1003,-10
47112639739,47112639740,1,1421,1124,-10
47116666597,47116666594,-3,1155,2188,-10
47118825513,47118825526,13,13002,46748,-10
47119716086,47119716089,3,1120,1540,-10
47120053607,47120053611,4,1961,2149,-10
47123201068,47123201071,3,2103,1533,-10
47124790874,47124790875,1,1166,939,-10
47128727311,47128727310,-1,1292,1412,-10
47129172419,47129172419,0,1077,1729,-10
47130011392,47130011396,4,3743,1433,-10
47135782837,47135782838,1,879,1359,-10
47140099238,47140099239,1,1440,1748,-10
47141790176,47141790178,2,1587,1469,-10
47142635294,47142635299,5,2992,1148,-10
47142760839,47142760842,3,1058,964,-10
47143291813,47143291794,-19,1504,996,-10
47145931413,47145931416,3,1638,1308,-10
47146788071,47146788073,2,988,1475,-10
47148181985,47148181986,1,1576,936,-10
47153535965,47153535968,3,1539,1850,-10
47153940003,47153940002,-1,1268,1393,-10
47154985803,47154985802,-1,1159,2555,-10
47156157174,47156157178,4,1002,1171,-10
47160563010,47160563014,4,1308,2090,-10
47161233785,47161233790,5,2320,970,-10
47162001731,47162001730,-1,1437,2011,-10
47164056180,47164056178,-2,1311,2156,-10
47164891854,47164891856,2,2285,2133,-10
47166440866,47166440868,2,1213,1110,-10
47175612157,47175612160,3,1688,1216,-10
47176033706,47176033723,17,1298,1478,-10
47182975786,47182975789,3,1558,1815,-10
47183893595,47183893595,0,623,1034,-10
47184801443,47184801443,0,1497,1403,-10
47189652546,47189652548,2,1547,1833,-10
47192451729,47192451730,1,1771,1530,-10
47192610303,47192610303,0,1503,1829,-10
47195567763,47195567766,3,1863,2062,-10
47196140765,47196140766,1,1103,1188,-10
47197314769,47197314771,2,858,727,-10
47198528830,47198528832,2,1351,1660,-10
47199457295,47199457298,3,1929,1966,-10
47204177820,47204177816,-4,2121,6205,-10
47204854243,47204854244,1,1583,1567,-10
47208107448,47208107446,-2,1539,1233,-10
47211419204,47211419207,3,1772,1267,-10
47211798680,47211798682,2,1746,1849,-10
47212654090,47212654094,4,1560,1587,-10
47213690105,47213690106,1,1703,1504,-10
47216272152,47216272155,3,1740,1285,-10
47217338224,47217338225,1,1675,1506,-10
47217692946,47217692949,3,1998,1817,-10
47218519222,47218519224,2,1239,2061,-10
47219250711,47219250714,3,1199,1147,-10
47220065601,47220065603,2,1503,1640,-10
47221242925,47221242926,1,1337,1271,-10
47223706377,47223706378,1,1289,1539,-10
47226401734,47226401738,4,1853,1570,-10
47229588181,47229588183,2,1395,1600,-10
47230509233,47230509234,1,1777,1811,-10
47231224412,47231224414,2,1244,1670,-10
47231688130,47231688134,4,1445,1455,-10
47231890203,47231890188,-15,1077,533,-10
47232274686,47232274688,2,2156,2058,-10
47235050091,47235050094,3,2733,2918,-10
47235382940,47235382943,3,1752,1873,-10
47242679530,47242679530,0,1033,991,-10
47243542608,47243542609,1,1785,1526,-10
47254223130,47254223133,3,2020,2173,-10
47255268014,47255268017,3,996,1857,-10
47256765703,47256765702,-1,1966,1110,-10
47256792121,47256792123,2,1846,1866,-10
47258070389,47258070390,1,1874,1796,-10
47259141394,47259141396,2,1627,1333,-10
47260595948,47260595966,18,1352,1366,-10
47261525855,47261525855,0,1034,1851,-10
47264926562,47264926566,4,2499,1632,-10
47268665558,47268665562,4,1115,1617,-10
47270847386,47270847390,4,1839,1591,-10
47271764918,47271764919,1,1100,1293,-10
47273336099,47273336102,3,1550,1978,-10
47274712187,47274712187,0,1793,1615,-10
47276763205,47276763206,1,1572,1753,-10
47277542502,47277542503,1,2169,1516,-10
47280312314,47280312315,1,1374,1583,-10
47281149339,47281149339,0,1891,1832,-10
47282209570,47282209572,2,1661,1034,-10
47283010874,47283010873,-1,1093,1494,-10
47283366194,47283366200,6,1909,1769,-10
47285225259,47285225260,1,1228,1334,-10
47286257189,47286257190,1,1925,908,-10
47288185330,47288185330,0,1531,1980,-10
47290510905,47290510910,5,1484,1375,-10
47292134491,47292134493,2,1729,1692,-10
47294001626,47294001628,2,1192,963,-10
47294653652,47294653650,-2,976,1231,-10
47296714067,47296714070,3,1718,998,-10
47300937035,47300937038,3,1372,1552,-10
47303573545,47303573546,1,1216,1313,-10
47306021751,47306021753,2,1856,1810,-10
47307850473,47307850475,2,1475,1339,-10
47311222783,47311222784,1,1391,442,-10
47312102708,47312102711,3,1801,1459,-10
47312486701,47312486701,0,1190,1291,-10
47315203736,47315203736,0,1677,2000,-10
47319468519,47319468524,5,2790,1800,-10
47320691112,47320691115,3,2316,1743,-10
47320842329,47320842330,1,2315,1568,-10
47321368278,47321368279,1,1681,1833,-10
47324975281,47324975282,1,1441,963,-10
47325171115,47325171116,1,1337,1977,-10
47329855021,47329855026,5,1673,1598,-10
47331576031,47331576033,2,1466,795,-10
47333902517,47333902514,-3,2138,5370,-10
47334348614,47334348617,3,1857,1814,-10
47334388190,47334388196,6,885,199,-10
47336688540,47336688542,2,1634,1919,-10
47339408940,47339408940,0,1392,1960,-10
47347998458,47347998464,6,1710,1621,-10
47348372293,47348372310,17,1540,891,-10
47349582514,47349582517,3,1803,1816,-10
47350708229,47350708231,2,3553,18457,-10
47357012187,47357012190,3,1776,1323,-10
47357700770,47357700771,1,2082,1920,-10
47358206584,47358206586,2,1319,1673,-10
47361379175,47361379178,3,1577,1388,-10
47361829713,47361829715,2,1332,1858,-10
47364438793,47364438797,4,2524,1180,-10
47370161018,47370161019,1,1557,1517,-10
47371650498,47371650502,4,953,1032,-10
47372251421,47372251419,-2,1591,2173,-10
47372310498,47372310503,5,2312,1784,-10
47372687078,47372687079,1,1406,1212,-10
47382845414,47382845417,3,1559,1645,-10
47385146608,47385146606,-2,1609,1742,-10
47388443011,47388443004,-7,1751,12188,-10
47389337998,47389337999,1,1578,1762,-10
47390426974,47390426977,3,1070,1600,-10
47391899306,47391899303,-3,1858,2727,-10
47397228814,47397228817,3,1598,2134,-10
47398497234,47398497236,2,1999,1573,-10
47404895590,47404895593,3,1921,1899,-10
47405342006,47405342009,3,1595,2213,-10
47406003324,47406003325,1,1321,2199,-10
47408367818,47408367815,-3,2112,5368,-10
47409370266,47409370262,-4,1085,2277,-10
47414222683,47414222687,4,2106,1751,-10
47425870955,47425870961,6,1878,1106,-10
47430751731,47430751734,3,1335,1355,-10
47436130130,47436130134,4,3772,1750,-10
47438095261,47438095261,0,1565,1231,-10
47439172751,47439172753,2,1033,1321,-10
47439809559,47439809574,15,13905,26844,-10
47440718278,47440718281,3,1517,1353,-10
47440813456,47440813459,3,1725,1657,-10
47440949548,47440949556,8,2716,47672,-10
47444915518,47444915523,5,2536,1243,-10
47445385933,47445385929,-4,1032,2487,-10
47446992753,47446992756,3,1361,1595,-10
47447163005,47447163006,1,1525,1363,-10
47447742212,47447742213,1,1733,1501,-10
47456182207,47456182205,-2,1747,2327,-10
47458137985,47458137988,3,1835,1723,-10
47458352236,47458352239,3,1811,2308,-10
47458513325,47458513326,1,2850,2012,-10
47458670873,47458670875,2,1314,1218,-10
47458739745,47458739749,4,1296,1245,-10
47460596245,47460596246,1,1140,1141,-10
47461888462,47461888465,3,2053,1593,-10
47464244363,47464244362,-1,1398,2154,-10
47465478234,47465478235,1,1069,1172,-10
47470678377,47470678378,1,1537,1512,-10
47473013961,47473013962,1,1677,1870,-10
47474845069,47474845074,5,1767,1714,-10
47475759512,47475759513,1,1579,1420,-10
47484814911,47484814911,0,1210,1402,-10
47489684236,47489684241,5,5088,2868,-10
47490700798,47490700799,1,1432,1291,-10
47494770896,47494770898,2,1468,1676,-10
47500647509,47500647513,4,2016,1171,-10
47503439762,47503439765,3,1774,1177,-10
47505705679,47505705682,3,1795,1380,-10
47506130425,47506130428,3,2019,1574,-10
47506371274,47506371273,-1,1508,1930,-10
47506801598,47506801602,4,1265,1269,-10
47507442750,47507442752,2,1888,1723,-10
47508844440,47508844442,2,1520,1530,-10
47509818257,47509818255,-2,1566,2100,-10
47510797863,47510797862,-1,798,1569,-10
47511704353,47511704354,1,2143,1408,-10
47512476220,47512476223,3,848,1181,-10
47513722115,47513722115,0,1795,2022,-10
47514199933,47514199934,1,1662,1529,-10
47514577839,47514577840,1,1003,1252,-10
47515235530,47515235510,-20,716,1880,-10
47518194666,47518194665,-1,1401,2151,-10
47519315860,47519315861,1,1915,2552,-10
47520296603,47520296604,1,2235,2263,-10
47521747908,47521747910,2,2129,1468,-10
47524456222,47524456225,3,1626,1266,-10
47528516583,47528516585,2,1579,1568,-10
47531230623,47531230627,4,1750,1653,-10
47535380815,47535380819,4,1612,783,-10
47537667638,47537667640,2,1330,2109,-10
47537988988,47537988990,2,1359,1730,-10
47538372117,47538372118,1,1530,1723,-10
47539351357,47539351360,3,1456,1109,-10
47540342846,47540342846,0,1723,2396,-10
47541661302,47541661296,-6,658,5633,-10
47542112865,47542112867,2,1359,1564,-10
47543233559,47543233559,0,1523,1523,-10
47544045175,47544045177,2,1331,1192,-10
47544390371,47544390369,-2,1555,1247,-10
47548135913,47548135915,2,1953,1626,-10
47550405565,47550405566,1,1777,1710,-10
47553836323,47553836325,2,1341,1566,-10
47561066230,47561066233,3,1090,1094,-10
47563245960,47563245962,2,1081,1335,-10
47564629473,47564629474,1,1850,1671,-10
47564914334,47564914338,4,1713,1916,-10
47566274474,47566274476,2,2062,1657,-10
47569833478,47569833482,4,1778,1788,-10
47572395613,47572395633,20,1761,1813,-10
47573829263,47573829266,3,771,1203,-10
47574922351,47574922353,2,1441,1611,-10
47579014894,47579014896,2,1370,1696,-10
47582962134,47582962136,2,1477,1375,-10
47584796386,47584796390,4,1431,1579,-10
47588359753,47588359759,6,2379,1089,-10
47589542612,47589542614,2,1813,2177,-10
47589793037,47589793039,2,1425,1684,-10
47589951521,47589951525,4,2049,2251,-10
47591717958,47591717961,3,1420,1724,-10
47593046211,47593046210,-1,1410,2072,-10
47595037481,47595037483,2,2415,1666,-10
47595224497,47595224498,1,1806,1344,-10
47595576723,47595576717,-6,1290,4745,-10
47597245287,47597245290,3,1325,1219,-10
47597922538,47597922538,0,1287,1372,-10
47598577955,47598577954,-1,5,1239,-10
47599941017,47599941016,-1,1498,2082,-10
47600986106,47600986107,1,3290,2502,-10
47601785620,47601785621,1,1944,1163,-10
47601821928,47601821928,0,1897,1979,-10
47602109251,47602109254,3,2230,1723,-10
47603845614,47603845614,0,2015,1682,-10
47607350218,47607350218,0,1358,1440,-10
47610752970,47610752972,2,1502,1604,-10
47614539649,47614539650,1,1346,1187,-10
47615744394,47615744398,4,1088,1234,-10
47618443568,47618443567,-1,1621,1162,-10
47619430538,47619430538,0,1653,1457,-10
47620507401,47620507402,1,870,1036,-10
47621969943,47621969944,1,2209,1903,-10
47626699823,47626699826,3,1611,1827,-10
47628047679,47628047678,-1,1575,1448,-10
47630107037,47630107038,1,1187,1669,-10
47631145559,47631145564,5,4529,2768,-10
47634293615,47634293619,4,1490,1642,-10
47634646454,47634646462,8,3475,1099,-10
47635044215,47635044215,0,1311,1144,-10
47639149910,47639149914,4,1706,1615,-10
47641162778,47641162779,1,1438,1520,-10
47645887210,47645887201,-9,1581,1365,-10
47646615346,47646615349,3,1824,1533,-10
47647481365,47647481363,-2,1093,1318,-10
47647819739,47647819716,-23,1637,1633,-10
47648931175,47648931177,2,1480,1493,-10
47649346661,47649346644,-17,1239,1310,-10
47651554003,47651554006,3,1054,1630,-10
47651722166,47651722146,-20,1037,448,-10
47652217614,47652217618,4,1513,1449,-10
47655445437,47655445438,1,1934,1529,-10
47660365787,47660365789,2,1682,1321,-10
47661985501,47661985502,1,1678,1229,-10
47663869160,47663869162,2,1370,1069,-10
47664677338,47664677339,1,1227,1362,-10
47667975245,47667975246,1,1689,1139,-10
47671060145,47671060147,2,1327,1601,-10
47672044158,47672044156,-2,2246,3442,-10
47672717638,47672717634,-4,1547,3598,-10
47677645306,47677645311,5,1927,1676,-10
47677831080,47677831075,-5,1426,4797,-10
47680157863,47680157862,-1,2794,9295,-10
47681031855,47681031856,1,1513,1409,-10
47685545670,47685545670,0,1215,1305,-10
47690623286,47690623290,4,1346,1885,-10
47693384454,47693384455,1,1518,1314,-10
47696785997,47696785997,0,1297,1601,-10
47701375091,47701375093,2,1017,1784,-10
47702002687,47702002688,1,1827,1650,-10
47704845538,47704845541,3,1523,1562,-10
47707449114,47707449115,1,1362,1768,-10
47707587801,47707587809,8,5503,1558,-10
47710503446,47710503449,3,5761,22539,-10
47711592877,47711592879,2,1490,1691,-10
47711673038,47711673042,4,1833,1465,-10
47713603749,47713603750,1,1189,1350,-10
47714826954,47714826950,-4,1106,1030,-10
47716697390,47716697393,3,2112,1492,-10
47717553931,47717553934,3,1523,1457,-10
47721928597,47721928595,-2,1045,1545,-10
47726065618,47726065619,1,1788,1703,-10
47728823404,47728823404,0,1497,1373,-10
47732383142,47732383147,5,4542,3416,-10
47732875454,47732875455,1,2003,1661,-10
47733238817,47733238819,2,1221,1269,-10
47734011977,47734011975,-2,2552,5177,-10
47734434154,47734434155,1,1358,1220,-10
47745318939,47745318943,4,1074,1163,-10
47746299621,47746299627,6,1926,937,-10
47752728900,47752728902,2,1172,1786,-10
47757242682,47757242683,1,1430,1663,-10
47759901826,47759901826,0,1348,1046,-10
47760372362,47760372346,-16,1464,875,-10
47762446931,47762446936,5,2413,1531,-10
47762483739,47762483732,-7,732,309,-10
47762548158,47762548157,-1,1754,1985,-10
47763343793,47763343793,0,1215,1541,-10
47768089222,47768089226,4,1213,1254,-10
47770350326,47770350330,4,1864,1732,-10
47773324114,47773324115,1,1930,1690,-10
47774801944,47774801947,3,1651,1426,-10
47775338074,47775338075,1,1944,1560,-10
47776727546,47776727547,1,1720,1572,-10
47777435318,47777435312,-6,1951,9723,-10
47781234825,47781234826,1,1313,1173,-10
47785571244,47785571244,0,1042,1454,-10
47787045877,47787045879,2,1301,1381,-10
47788181543,47788181544,1,1549,2250,-10
47789292303,47789292292,-11,34714,14945,-10
47792882577,47792882578,1,1290,1658,-10
47793479953,47793479956,3,1203,1197,-10
47793666845,47793666846,1,1658,1372,-10
47793785695,47793785703,8,12693,21712,-10
47794672578,47794672579,1,1406,855,-10
47794726954,47794726955,1,1269,1846,-10
47795527467,47795527470,3,1855,1629,-10
47797157168,47797157171,3,1282,1783,-10
47798669829,47798669830,1,1467,1775,-10
47801872409,47801872415,6,3136,1920,-10
47802930044,47802930047,3,763,699,-10
47804618339,47804618339,0,1349,1463,-10
47805033454,47805033454,0,1112,1430,-10
47807171791,47807171790,-1,1263,2440,-10
47808906526,47808906526,0,1546,1129,-10
47812085978,47812085978,0,1090,1482,-10
47813149990,47813149991,1,1168,1748,-10
47813829769,47813829769,0,1518,1924,-10
47815301415,47815301415,0,1919,1979,-10
47818279278,47818279279,1,1342,1146,-10
47818802114,47818802118,4,2271,2261,-10
47818915090,47818915092,2,2232,1860,-10
47820348862,47820348866,4,1032,1274,-10
47822270763,47822270764,1,1444,1465,-10
47824450753,47824450754,1,1016,1404,-10
47824817116,47824817119,3,1641,1580,-10
47827426733,47827426733,0,1445,1155,-10
47827985391,47827985393,2,1571,1690,-10
47828375469,47828375471,2,1530,1275,-10
47829849350,47829849350,0,1749,2314,-10
47831742871,47831742871,0,761,1374,-10
47832753479,47832753482,3,1981,1829,-10
47833047695,47833047696,1,2006,1430,-10
47834532720,47834532722,2,1401,1480,-10
47835141246,47835141246,0,1233,1366,-10
47836866778,47836866778,0,28251,15967,-10
47837805747,47837805750,3,816,1156,-10
47838609525,47838609524,-1,1040,1918,-10
47839728945,47839728945,0,1207,859,-10
47840247014,47840247015,1,1427,1358,-10
47842925521,47842925522,1,2328,2381,-10
47849563802,47849563802,0,1034,1826,-10
47852678095,47852678097,2,1449,1246,-10
47854449771,47854449773,2,1357,2092,-10
47855645813,47855645814,1,1335,1287,-10
47861804813,47861804817,4,1566,2005,-10
47862562393,47862562397,4,1837,1724,-10
47863263981,47863263985,4,1817,1651,-10
47863426611,47863426615,4,1739,1340,-10
47863505721,47863505737,16,1684,1376,-10
47868677259,47868677260,1,1565,1880,-10
47868720298,47868720301,3,1587,1696,-10
47870544877,47870544874,-3,1752,2614,-10
47874664270,47874664273,3,2056,1773,-10
47875806349,47875806350,1,2039,1578,-10
47879294972,47879294972,0,1973,1423,-10
47880814579,47880814581,2,1118,1852,-10
47881171918,47881171920,2,1472,1661,-10
47883232005,47883232007,2,1181,1165,-10
47884825453,47884825455,2,1460,1455,-10
47885441430,47885441433,3,1679,1815,-10
47888710553,47888710555,2,1932,2136,-10
47889221963,47889221967,4,1833,1274,-10
47890394631,47890394631,0,1939,1856,-10
47893917656,47893917653,-3,1519,3054,-10
47896181287,47896181288,1,1795,1602,-10
47903487762,47903487764,2,1579,1401,-10
47905250639,47905250641,2,1887,1850,-10
47907375370,47907375374,4,2408,2515,-10
47910505638,47910505638,0,1749,1744,-10
47911642959,47911642961,2,1226,1318,-10
47915041327,47915041328,1,2037,2123,-10
47918768404,47918768407,3,2397,1721,-10
47918886792,47918886795,3,1275,1716,-10
47926883445,47926883446,1,1860,1103,-10
47928297715,47928297715,0,1532,1844,-10
47929761395,47929761397,2,1846,1558,-10
47930805675,47930805675,0,1044,1753,-10
47930878875,47930878876,1,1878,1502,-10
47932741858,47932741859,1,1644,1333,-10
47933070307,47933070310,3,1547,1404,-10
47936683249,47936683250,1,1455,1421,-10
47939303346,47939303346,0,1370,1622,-10
47940344476,47940344474,-2,1250,1394,-10
47942552106,47942552107,1,1247,1379,-10
47944146678,47944146682,4,1422,1385,-10
47945035392,47945035392,0,1630,1922,-10
47945178702,47945178702,0,1358,1073,-10
47947484460,47947484458,-2,1155,1382,-10
47948019445,47948019446,1,1531,1507,-10
47949230682,47949230687,5,3721,2596,-10
47951769229,47951769221,-8,1511,7431,-10
47952006245,47952006248,3,2035,1600,-10
47953379893,47953379895,2,1492,1168,-10
47954373609,47954373610,1,1824,2068,-10
47955204157,47955204160,3,1834,1391,-10
47956117657,47956117660,3,1434,1101,-10
47957312410,47957312417,7,2777,1357,-10
47959527406,47959527409,3,1694,1576,-10
47961374077,47961374085,8,1590,1077,-10
47961819498,47961819501,3,2019,1388,-10
47964502567,47964502571,4,1449,1560,-10
47967228374,47967228376,2,1744,1578,-10
47968681545,47968681545,0,1834,1460,-10
47973935883,47973935885,2,1268,1633,-10
47975839693,47975839694,1,2524,1700,-10
47976207471,47976207470,-1,791,781,-10
47980514994,47980514997,3,1501,1654,-10
47981641333,47981641334,1,2267,2547,-10
47984071707,47984071710,3,1365,1056,-10
47987645093,47987645093,0,2111,1574,-10
47989315830,47989315834,4,1474,1075,-10
47989726254,47989726258,4,1901,913,-10
47990043769,47990043766,-3,932,961,-10
47990117191,47990117194,3,1415,1770,-10
47991787603,47991787605,2,1783,1684,-10
47993821168,47993821170,2,1854,1256,-10
47997661067,47997661070,3,1193,1012,-10
47998522627,47998522628,1,1425,1862,-10
47999177101,47999177103,2,1959,2147,-10
48001428646,48001428646,0,1433,1901,-10
48006033262,48006033263,1,1836,1878,-10
48006189921,48006189922,1,1337,1414,-10
48017857198,48017857201,3,1218,1430,-10
48017913388,48017913394,6,3063,2768,-10
48023084286,48023084291,5,2652,1388,-10
48023120059,48023120061,2,1560,1470,-10
48024030374,48024030382,8,3483,1752,-10
48025304052,48025304054,2,1332,1644,-10
48033295046,48033295048,2,1503,2145,-10
48033839090,48033839091,1,1436,2327,-10
48034119697,48034119698,1,1186,1490,-10
48035416697,48035416699,2,1630,1418,-10
48038967532,48038967533,1,1689,1169,-10
48040114530,48040114532,2,1353,1631,-10
48040301981,48040301982,1,2350,2080,-10
48041207313,48041207316,3,1803,1391,-10
48047121711,48047121713,2,1624,1849,-10
48050844779,48050844783,4,639,563,-10
48053212483,48053212486,3,1460,1759,-10
48055315256,48055315258,2,1047,1318,-10
48056901216,48056901218,2,1798,1786,-10
48059024902,48059024907,5,1433,1001,-10
48060021854,48060021856,2,1914,2661,-10
48060497221,48060497220,-1,1264,1357,-10
48064662245,48064662247,2,1127,1747,-10
48065238218,48065238218,0,2281,1663,-10
48067778878,48067778882,4,1693,989,-10
48068922190,48068922190,0,1503,1368,-10
48069557614,48069557593,-21,763,1181,-10
48071714421,48071714423,2,1863,1927,-10
48071894194,48071894195,1,2251,1833,-10
48072839646,48072839644,-2,1282,2103,-10
48074949830,48074949831,1,1354,1282,-10
48079013798,48079013799,1,1385,1779,-10
48080475630,48080475630,0,869,1578,-10
48081687734,48081687734,0,932,1430,-10
48082948130,48082948130,0,919,1089,-10
48087954219,48087954213,-6,1114,3252,-10
48093266675,48093266682,7,3250,986,-10
48099342266,48099342267,1,2694,2345,-10
48103755722,48103755726,4,1757,1161,-10
48105042822,48105042823,1,1135,1529,-10
48105407533,48105407536,3,1512,1342,-10
48108829193,48108829200,7,1727,1442,-10
48112441165,48112441168,3,1977,1308,-10
48113076665,48113076668,3,2223,1653,-10
48114252554,48114252558,4,1899,1432,-10
48119683056,48119683058,2,2262,1418,-10
48122521489,48122521492,3,1297,1296,-10
48124521465,48124521464,-1,1112,1619,-10
48126818219,48126818223,4,2351,1585,-10
48127764522,48127764523,1,1157,1076,-10
48128751457,48128751460,3,1526,1743,-10
48135394466,48135394467,1,1435,1887,-10
48137824553,48137824555,2,1777,1137,-10
48138106497,48138106498,1,1897,1763,-10
48138332991,48138332993,2,2029,1298,-10
48140349358,48140349361,3,2164,2214,-10
48145739459,48145739462,3,849,842,-10
48146318363,48146318380,17,183,1720,-10
48149324597,48149324601,4,1711,1098,-10
48149574206,48149574206,0,1927,1599,-10
48151857352,48151857355,3,1460,1571,-10
48152433728,48152433730,2,1248,1702,-10
48153073898,48153073899,1,1050,1235,-10
48153796153,48153796154,1,2155,2362,-10
48156376007,48156376009,2,1513,1147,-10
48156625099,48156625104,5,1786,1545,-10
48158143535,48158143536,1,1868,1886,-10
48158578734,48158578735,1,1486,1170,-10
48159691842,48159691842,0,1210,1422,-10
48163623466,48163623470,4,2549,1293,-10
48167161518,48167161519,1,1960,1858,-10
48167514472,48167514474,2,1480,1781,-10
48170125226,48170125221,-5,1509,4093,-10
48170289255,48170289258,3,2277,1810,-10
48171130636,48171130638,2,1858,1640,-10
48172356383,48172356386,3,1376,1545,-10
48172469462,48172469464,2,1369,1278,-10
48178381345,48178381338,-7,1841,7009,-10
48178737214,48178737217,3,1343,1751,-10
48179680289,48179680290,1,1442,1213,-10
48180195082,48180195086,4,1506,1424,-10
48180849437,48180849439,2,2436,1628,-10
48181948345,48181948346,1,1934,1380,-10
48185587935,48185587939,4,1043,1355,-10
48186757321,48186757323,2,1639,1609,-10
48186809013,48186809015,2,33800,15959,-10
48187228343,48187228348,5,1373,998,-10
48188437142,48188437142,0,1713,1294,-10
48192028843,48192028849,6,755,981,-10
48195368657,48195368656,-1,1279,1383,-10
48196247187,48196247189,2,1546,1195,-10
48200368137,48200368138,1,1772,1906,-10
48200926623,48200926626,3,1545,1401,-10
48202283630,48202283608,-22,1914,1586,-10
48204599611,48204599614,3,1174,1652,-10
48206649385,48206649386,1,1186,1496,-10
48209951388,48209951390,2,1791,1433,-10
48212880132,48212880134,2,1820,2038,-10
48213300660,48213300661,1,1692,1387,-10
48215686437,48215686439,2,2321,1250,-10
48216143835,48216143826,-9,1047,2562,-10
48216302564,48216302567,3,1837,1102,-10
48218032394,48218032397,3,1970,1675,-10
48218825712,48218825714,2,2030,1804,-10
48222484765,48222484770,5,2066,1498,-10
48223046401,48223046401,0,912,2047,-10
48223413634,48223413641,7,1069,972,-10
48225819865,48225819867,2,1246,855,-10
48229589022,48229589023,1,1431,1776,-10
48230846140,48230846143,3,2066,1447,-10
48233692378,48233692379,1,1397,1678,-10
48234168711,48234168713,2,1772,1633,-10
48235936774,48235936775,1,1245,1550,-10
48237308538,48237308539,1,2302,1385,-10
48237749364,48237749348,-16,1208,1297,-10
48238339093,48238339094,1,1793,1864,-10
48240420061,48240420062,1,1540,1920,-10
48241192266,48241192267,1,1204,1974,-10
48250845602,48250845597,-5,1814,5405,-10
48252253395,48252253397,2,1041,2068,-10
48253914107,48253914110,3,1854,1783,-10
48254387181,48254387183,2,2168,1993,-10
48256197112,48256197111,-1,1655,1835,-10
48256548052,48256548054,2,969,1080,-10
48259164393,48259164395,2,1866,1381,-10
48260283601,48260283603,2,1024,1509,-10
48260539769,48260539770,1,1530,1076,-10
48261331711,48261331718,7,7409,2833,-10
48262856322,48262856323,1,1799,1312,-10
48263093948,48263093949,1,971,1719,-10
48269529866,48269529866,0,1058,1383,-10
48271244906,48271244908,2,1276,1581,-10
48272522749,48272522752,3,1878,1744,-10
48278210918,48278210918,0,1557,1521,-10
48280404326,48280404345,19,1819,1366,-10
48281889888,48281889889,1,1096,1763,-10
48283225385,48283225386,1,1487,1712,-10
48293326578,48293326581,3,1376,1350,-10
48294713132,48294713134,2,1282,937,-10
48299100729,48299100732,3,1756,1206,-10
48300580873,48300580873,0,1334,1599,-10
48300787970,48300787972,2,917,1212,-10
48305461406,48305461409,3,1756,1346,-10
48309362082,48309362085,3,1718,1588,-10
48315123797,48315123799,2,1564,1795,-10
48318018325,48318018326,1,1347,1570,-10
48319607404,48319607406,2,2026,1791,-10
48322590943,48322590945,2,1062,1623,-10
48324157128,48324157131,3,1166,1904,-10
48325362842,48325362844,2,1154,1518,-10
48327792896,48327792899,3,2060,1583,-10
48328558889,48328558891,2,1681,1201,-10
48331078741,48331078742,1,1619,1283,-10
48331251871,48331251873,2,1479,1992,-10
48338445460,48338445462,2,1757,1750,-10
48342755983,48342755985,2,1629,1820,-10
48342798916,48342798918,2,1497,1597,-10
48344157589,48344157590,1,1842,1455,-10
48344907122,48344907119,-3,57989,30418,-10
48345507955,48345507958,3,1738,1630,-10
48350607075,48350607078,3,1011,1468,-10
48351670449,48351670451,2,1184,846,-10
48351778950,48351778953,3,1315,1061,-10
48351994012,48351994014,2,1693,1450,-10
48352857170,48352857173,3,1834,1377,-10
48353218189,48353218192,3,1765,1466,-10
48355801425,48355801429,4,1129,1186,-10
48359630691,48359630692,1,2245,2011,-10
48364429085,48364429088,3,2231,1879,-10
48364941188,48364941190,2,1326,947,-10
48366109907,48366109916,9,1502,1295,-10
48366292573,48366292574,1,1505,1408,-10
48367205926,48367205929,3,1784,1410,-10
48369571365,48369571367,2,1601,1411,-10
48372483014,48372483017,3,1805,1696,-10
48375304017,48375304018,1,1555,1332,-10
48378987742,48378987746,4,4090,2672,-10
48379419851,48379419855,4,1614,1363,-10
48385072865,48385072866,1,1375,1360,-10
48389068299,48389068301,2,1829,1849,-10
48390829733,48390829734,1,1875,1426,-10
48391578888,48391578891,3,1763,1546,-10
48392103735,48392103738,3,1762,1593,-10
48393800143,48393800138,-5,1264,3666,-10
48394046718,48394046721,3,961,1267,-10
48398710802,48398710801,-1,1139,1714,-10
48399799211,48399799210,-1,1261,1303,-10
48402078694,48402078694,0,1416,1706,-10
48403052811,48403052814,3,1593,1044,-10
48403935947,48403935945,-2,1746,2672,-10
48405350193,48405350194,1,1668,1655,-10
48406764810,48406764810,0,1776,1434,-10
48406802498,48406802498,0,1625,1399,-10
48408614353,48408614355,2,1555,1797,-10
48410585778,48410585781,3,1783,1385,-10
48411546439,48411546439,0,953,1383,-10
48411943797,48411943795,-2,2270,4268,-10
48412239481,48412239483,2,1515,1451,-10
48414461918,48414461918,0,1231,1076,-10
48416348293,48416348291,-2,1446,2819,-10
48417339286,48417339280,-6,1266,4845,-10
48417378282,48417378285,3,1371,1480,-10
48420275742,48420275744,2,2015,2136,-10
48425751450,48425751449,-1,1822,1617,-10
48427018789,48427018791,2,1404,1856,-10
48430259913,48430259914,1,1741,1506,-10
48431147846,48431147849,3,1897,1742,-10
48431536077,48431536078,1,1025,1023,-10
48435768403,48435768402,-1,1345,2030,-10
48437255795,48437255798,3,1437,1911,-10
48437501690,48437501692,2,1680,1555,-10
48438035579,48438035578,-1,1545,2542,-10
48438772001,48438772003,2,3068,2407,-10
48442291651,48442291653,2,1618,1563,-10
48444013370,48444013369,-1,1458,2507,-10
48444437505,48444437507,2,1551,1779,-10
48445093050,48445093052,2,2077,2231,-10
48447687985,48447687986,1,1664,2012,-10
48455103542,48455103543,1,1809,1477,-10
48455440101,48455440096,-5,990,2726,-10
48456638446,48456638448,2,1975,2157,-10
48458029861,48458029861,0,9156,13344,-10
48459141690,48459141693,3,1583,1557,-10
48462323050,48462323054,4,1367,1264,-10
48463023273,48463023252,-21,1309,1330,-10
48464759805,48464759804,-1,1677,1237,-10
48466555891,48466555893,2,1209,900,-10
48475873321,48475873322,1,1446,1483,-10
48476566887,48476566889,2,1218,1209,-10
48476711661,48476711683,22,1198,1315,-10
48476839624,48476839625,1,2372,2185,-10
48478567368,48478567370,2,1269,1056,-10
48479219029,48479219030,1,1132,1923,-10
48487461582,48487461584,2,1972,1533,-10
48488874377,48488874379,2,1842,1810,-10
48492400482,48492400483,1,1574,1303,-10
48495792681,48495792681,0,1601,1696,-10
48497717626,48497717627,1,1354,1624,-10
48498376169,48498376169,0,1267,1855,-10
48498921196,48498921196,0,958,1304,-10
48503118485,48503118486,1,1414,1898,-10
48506539793,48506539793,0,1980,1678,-10
48509769001,48509769004,3,1598,1445,-10
48512369897,48512369899,2,1175,984,-10
48516777245,48516777248,3,2016,1355,-10
48518018914,48518018917,3,1440,1685,-10
48521030675,48521030675,0,1699,1455,-10
48524329526,48524329525,-1,1820,1544,-10
48524381523,48524381525,2,1919,1628,-10
48527390893,48527390896,3,1144,1554,-10
48528357287,48528357290,3,1279,1450,-10
48530611211,48530611210,-1,696,940,-10
48531215746,48531215745,-1,1338,1138,-10
48535060961,48535060963,2,1361,1277,-10
48535962605,48535962608,3,1946,1637,-10
48536036268,48536036270,2,1541,1723,-10
48537449086,48537449090,4,1410,1294,-10
48537658859,48537658859,0,1949,1476,-10
48539062794,48539062795,1,1842,1613,-10
48540798158,48540798159,1,1190,1663,-10
48542462821,48542462822,1,1151,1523,-10
48544088370,48544088368,-2,21289,21873,-10
48547863933,48547863935,2,1661,1804,-10
48549183027,48549183029,2,1476,1576,-10
48550000380,48550000381,1,1137,1821,-10
48550226265,48550226287,22,1379,1179,-10
48550327300,48550327301,1,1939,1463,-10
48552620518,48552620518,0,921,1066,-10
48553438414,48553438423,9,9531,39066,-10
48554602072,48554602073,1,1290,1274,-10
48555986902,48555986906,4,1620,1652,-10
48556446454,48556446434,-20,1865,1628,-10
48557531733,48557531735,2,1340,956,-10
48557974022,48557974023,1,1085,1138,-10
48558191486,48558191488,2,1689,1742,-10
48558502345,48558502360,15,1999,1562,-10
48558563743,48558563745,2,1735,1820,-10
48558598054,48558598055,1,1389,1663,-10
48558701527,48558701531,4,1586,1203,-10
48563955820,48563955821,1,1270,1655,-10
48568401106,48568401109,3,1921,1642,-10
48570594921,48570594922,1,1967,1409,-10
48574243884,48574243885,1,1373,1433,-10
48581219255,48581219259,4,2057,1085,-10
48590466554,48590466559,5,1011,1216,-10
48592073332,48592073335,3,1321,1273,-10
48594247223,48594247225,2,1419,1522,-10
48596065426,48596065429,3,1161,1604,-10
48598293488,48598293489,1,1212,1388,-10
48599362106,48599362100,-6,2281,6853,-10
48605148497,48605148498,1,1439,1904,-10
48607288198,48607288201,3,2303,1833,-10
48610885020,48610885021,1,611,1108,-10
48612140918,48612140922,4,847,1357,-10
48614808427,48614808428,1,1943,1918,-10
48619878046,48619878046,0,846,1363,-10
48622612321,48622612322,1,1437,1591,-10
48622932096,48622932098,2,2450,1834,-10
48624308843,48624308841,-2,2244,3098,-10
48625604776,48625604779,3,1635,1520,-10
48629448385,48629448387,2,1392,1446,-10
48631568957,48631568960,3,1519,1528,-10
48632552747,48632552747,0,1176,1921,-10
48637961186,48637961190,4,1487,1192,-10
48638883080,48638883078,-2,1752,1914,-10
48643841695,48643841698,3,1148,1284,-10
48646225173,48646225175,2,1075,1422,-10
48649197162,48649197163,1,1394,1321,-10
48659293931,48659293935,4,1078,1413,-10
48660615734,48660615740,6,1416,1165,-10
48661681829,48661681831,2,1484,1322,-10
48665009342,48665009342,0,1856,1546,-10
48667062598,48667062602,4,2057,1815,-10
48669088530,48669088531,1,1597,1438,-10
48672754941,48672754942,1,1959,1693,-10
48678924827,48678924829,2,5275,5205,-10
48683329121,48683329122,1,1170,1182,-10
48686045314,48686045315,1,1939,2175,-10
48688399390,48688399392,2,1461,1932,-10
48688959165,48688959164,-1,1246,1195,-10
48691399638,48691399633,-5,1378,2819,-10
48691989704,48691989705,1,1756,1405,-10
48692462293,48692462294,1,1653,1525,-10
48693086744,48693086730,-14,1371,1882,-10
48693478082,48693478085,3,966,1174,-10
48694619223,48694619221,-2,1079,1431,-10
48695891583,48695891584,1,1324,1609,-10
48700197426,48700197428,2,1996,1783,-10
48700280041,48700280042,1,1125,1530,-10
48701043415,48701043415,0,1144,1375,-10
48705043929,48705043931,2,889,1280,-10
48707506700,48707506701,1,2511,2221,-10
48709174112,48709174113,1,1903,1178,-10
48709613500,48709613501,1,1652,2204,-10
48709826038,48709826041,3,1222,1297,-10
48713057689,48713057690,1,1272,1648,-10
48713963932,48713963934,2,980,2309,-10
48715171299,48715171277,-22,1074,3790,-10
48717552067,48717552069,2,1270,1122,-10
48718235756,48718235757,1,1701,1471,-10
48724838855,48724838857,2,1615,1160,-10
48726027058,48726027059,1,2055,2207,-10
48728036262,48728036258,-4,987,2525,-10
48733801550,48733801555,5,1378,1418,-10
48736401434,48736401434,0,1850,1875,-10
48739112202,48739112203,1,1709,1760,-10
48740715169,48740715171,2,1086,1745,-10
48741808120,48741808121,1,1566,1534,-10
48741862338,48741862343,5,1743,1359,-10
48742078217,48742078219,2,1394,1322,-10
48742233137,48742233135,-2,546,8580,-10
48744391617,48744391618,1,1420,1271,-10
48747652046,48747652049,3,1925,1953,-10
48747743674,48747743657,-17,2689,1635,-10
48749774767,48749774767,0,1454,1427,-10
48750907918,48750907919,1,1705,1645,-10
48751466771,48751466775,4,2043,1894,-10
48753236667,48753236670,3,1953,1684,-10
48753578231,48753578231,0,1481,2122,-10
48754252330,48754252336,6,8068,38262,-10
48755771433,48755771433,0,1782,1363,-10
48757504853,48757504855,2,1518,1567,-10
48757735737,48757735738,1,1419,1787,-10
48760446048,48760446050,2,1912,2397,-10
48760938167,48760938170,3,1667,1772,-10
48761071123,48761071124,1,1405,1395,-10
48764202464,48764202466,2,2063,1682,-10
48765559369,48765559370,1,1704,1233,-10
48767081814,48767081816,2,3857,3675,-10
48767280340,48767280343,3,1923,1869,-10
48767325382,48767325384,2,1783,1795,-10
48768653358,48768653362,4,1555,1423,-10
48768980092,48768980094,2,2124,1519,-10
48769547531,48769547534,3,1653,1523,-10
48774010614,48774010612,-2,966,1505,-10
48774141161,48774141161,0,1520,1817,-10
48774989409,48774989410,1,1885,1604,-10
48775169023,48775169004,-19,488,302,-10
48776241270,48776241273,3,1174,1233,-10
48778230402,48778230406,4,2151,1959,-10
48782500414,48782500418,4,1510,1175,-10
48787604517,48787604519,2,1271,1019,-10
48795495574,48795495576,2,1404,1460,-10
48797222138,48797222138,0,1593,1476,-10
48801330030,48801330032,2,1482,1133,-10
48801916750,48801916754,4,2653,1885,-10
48802882101,48802882104,3,1443,1615,-10
48805288937,48805288938,1,1104,1253,-10
48808932358,48808932359,1,1180,1202,-10
48811659552,48811659553,1,1774,1413,-10
48812339863,48812339881,18,1882,1199,-10
48813911753,48813911754,1,2445,1752,-10
48814458156,48814458157,1,1308,1368,-10
48815231515,48815231524,9,10908,45499,-10
48815382456,48815382436,-20,1503,1590,-10
48815417666,48815417667,1,927,1145,-10
48815992940,48815992942,2,1360,1173,-10
48817409237,48817409237,0,1085,809,-10
48820540895,48820540897,2,927,1109,-10
48822347437,48822347436,-1,1500,1435,-10
48826128570,48826128568,-2,1638,1827,-10
48828352868,48828352869,1,1541,1703,-10
48830914541,48830914542,1,1534,2012,-10
48831256674,48831256677,3,1446,1171,-10
48833804042,48833804047,5,1201,1382,-10
48834675139,48834675138,-1,2395,3661,-10
48835927550,48835927552,2,1771,1879,-10
48836049748,48836049749,1,1220,1145,-10
48836114331,48836114345,14,431,1663,-10
48839728357,48839728359,2,1341,959,-10
48843728445,48843728447,2,1668,1472,-10
48845091370,48845091374,4,1548,1607,-10
48845879670,48845879671,1,1282,1361,-10
48847477567,48847477570,3,1443,1251,-10
48847635564,48847635567,3,866,1450,-10
48847984181,48847984181,0,1564,1504,-10
48857340895,48857340874,-21,1695,1048,-10
48858489125,48858489126,1,2009,2079,-10
48859363602,48859363605,3,1485,1521,-10
48859611142,48859611162,20,1286,1529,-10
48860999278,48860999281,3,1073,869,-10
48864913366,48864913370,4,2120,1504,-10
48869452504,48869452505,1,1883,1991,-10
48877476745,48877476747,2,2187,1399,-10
48878214491,48878214490,-1,1604,1909,-10
48883980998,48883981002,4,1461,1294,-10
48886078869,48886078869,0,860,1382,-10
48887527167,48887527167,0,1637,1099,-10
48888515507,48888515510,3,1370,1266,-10
48888612496,48888612498,2,2368,2256,-10
48891833331,48891833333,2,1294,1532,-10
48892429399,48892429399,0,1783,2082,-10
48894547388,48894547389,1,1377,1030,-10
48895508534,48895508536,2,948,1097,-10
48898478739,48898478741,2,1360,1594,-10
48901202177,48901202179,2,1695,2081,-10
48901686465,48901686468,3,2093,1618,-10
48902342029,48902342034,5,1285,1588,-10
48902704918,48902704939,21,2072,1502,-10
48902994711,48902994690,-21,884,1081,-10
48912371416,48912371418,2,1283,1391,-10
48913023326,48913023326,0,735,815,-10
48915938950,48915938953,3,1539,1104,-10
48916480441,48916480447,6,3793,1884,-10
48916763157,48916763159,2,1520,1387,-10
48917418564,48917418560,-4,2179,5677,-10
48922546758,48922546759,1,1671,1209,-10
48923303693,48923303696,3,1489,1802,-10
48927865169,48927865172,3,1852,1327,-10
48933744227,48933744231,4,2119,1789,-10
48935835933,48935835936,3,1447,1336,-10
48937290642,48937290642,0,1736,1640,-10
48943706314,48943706317,3,1203,1832,-10
48945605894,48945605897,3,1034,1460,-10
48946344282,48946344281,-1,1435,1940,-10
48953743899,48953743893,-6,1028,3377,-10
48955468553,48955468556,3,913,805,-10
48958360994,48958360994,0,1845,1231,-10
48960117510,48960117513,3,1858,1459,-10
48960659158,48960659161,3,1461,1669,-10
48962692095,48962692093,-2,1600,1997,-10
48969128959,48969128961,2,1285,1634,-10
48969313063,48969313064,1,2105,1782,-10
48970489989,48970489990,1,1408,1574,-10
48973963683,48973963689,6,1494,1199,-10
48981913994,48981913994,0,1896,1875,-10
48982142013,48982142014,1,1617,1357,-10
48983067360,48983067365,5,6467,22077,-10
48985007904,48985007907,3,1733,1221,-10
48987119554,48987119558,4,1458,1575,-10
48991627516,48991627518,2,1307,1300,-10
48991933730,48991933733,3,1296,1298,-10
48995643378,48995643382,4,1742,1946,-10
48996802976,48996802978,2,1686,1095,-10
48999857203,48999857205,2,1284,1421,-10
49004346224,49004346226,2,1413,994,-10
49005172498,49005172498,0,1044,1543,-10
49006066185,49006066191,6,1577,1535,-10
49010772117,49010772118,1,1716,1558,-10
49012093107,49012093103,-4,347,914,-10
49012397369,49012397370,1,1020,1659,-10
49015502150,49015502159,9,1805,1767,-10
49017651335,49017651336,1,1474,1614,-10
49020735063,49020735066,3,1566,1616,-10
49022013766,49022013771,5,1567,1350,-10
49023142430,49023142434,4,3972,2220,-10
49024585808,49024585811,3,1605,1803,-10
49024747113,49024747114,1,1080,1271,-10
49028260659,49028260660,1,1000,1685,-10
49029465997,49029465998,1,1677,1339,-10
49030245022,49030245018,-4,1284,4070,-10
49030752865,49030752866,1,2044,1298,-10
49033962751,49033962750,-1,1104,2008,-10
49034842471,49034842473,2,1496,1675,-10
49036915152,49036915153,1,2040,2200,-10
49041748033,49041748034,1,2000,1413,-10
49041970417,49041970418,1,2232,1952,-10
49046521163,49046521165,2,1367,1413,-10
49048224482,49048224486,4,2174,1405,-10
49048642276,49048642274,-2,974,1733,-10
49048707100,49048707101,1,1670,2118,-10
49051156038,49051156041,3,1219,1043,-10
49051634167,49051634169,2,1016,1631,-10
49052637357,49052637354,-3,1656,1862,-10
49057030114,49057030114,0,1622,1787,-10
49060207803,49060207805,2,1550,1929,-10
49064509825,49064509825,0,1386,1867,-10
49065720595,49065720597,2,1234,1195,-10
49066924394,49066924397,3,1593,1426,-10
49073451378,49073451378,0,1558,1835,-10
49079727274,49079727275,1,1508,1421,-10
49081199933,49081199934,1,1691,1440,-10
49084444312,49084444297,-15,1057,1324,-10
49089624742,49089624747,5,1840,898,-10
49091763054,49091763053,-1,1383,1329,-10
49093045789,49093045792,3,1831,1280,-10
49095454490,49095454493,3,1715,1655,-10
49097067538,49097067539,1,1494,2008,-10
49104573250,49104573254,4,1114,1448,-10
49109112021,49109112022,1,2191,1802,-10
49111792594,49111792596,2,2050,1530,-10
49117339485,49117339486,1,1310,1025,-10
49118585440,49118585442,2,1714,1352,-10
49119152920,49119152921,1,2150,1648,-10
49119434418,49119434421,3,790,832,-10
49121804811,49121804813,2,2071,1810,-10
49123534655,49123534657,2,2002,1999,-10
49126592423,49126592426,3,1430,1278,-10
49127003362,49127003364,2,2180,1748,-10
49129892026,49129892027,1,1398,1518,-10
49131417342,49131417342,0,1473,1560,-10
49133055996,49133055998,2,1391,1846,-10
49136225461,49136225458,-3,1240,2357,-10
49137558710,49137558713,3,2041,1936,-10
49137874028,49137874031,3,1304,1248,-10
49138485054,49138485054,0,1563,1105,-10
49143143353,49143143353,0,1519,1574,-10
49145312051,49145312053,2,1552,1486,-10
49147190367,49147190366,-1,871,959,-10
49147946570,49147946574,4,1407,1426,-10
49148062822,49148062826,4,1592,1498,-10
49149426555,49149426556,1,1535,1539,-10
49153505234,49153505235,1,1475,1484,-10
49153613983,49153613983,0,1880,1577,-10
49156833442,49156833445,3,1613,2050,-10
49158144217,49158144219,2,1825,2386,-10
49158649117,49158649121,4,2693,1185,-10
49162807365,49162807366,1,1713,1796,-10
49163212549,49163212550,1,1835,1890,-10
49164310210,49164310210,0,2006,2520,-10
49165481430,49165481433,3,998,1401,-10
49167477231,49167477234,3,1659,1795,-10
49169476843,49169476850,7,8505,2155,-10
49172655475,49172655478,3,1961,1826,-10
49173765938,49173765940,2,1151,965,-10
49182606200,49182606200,0,1506,1876,-10
49183030531,49183030534,3,1757,1306,-10
49185069823,49185069826,3,1619,1357,-10
49186314221,49186314201,-20,1299,530,-10
49187227754,49187227755,1,1598,1528,-10
49187376174,49187376177,3,1560,1508,-10
49187615471,49187615483,12,1547,1072,-10
49189984924,49189984928,4,1339,1298,-10
49192345447,49192345446,-1,1167,1507,-10
49199865572,49199865573,1,2934,3099,-10
49201937356,49201937359,3,1804,1886,-10
49203717211,49203717210,-1,1214,1476,-10
49208841431,49208841434,3,1231,1161,-10
49209326383,49209326384,1,1455,2138,-10
49210437791,49210437790,-1,1097,1858,-10
49212770722,49212770726,4,1893,1519,-10
49218457498,49218457501,3,1226,1374,-10
49221745882,49221745895,13,9380,38318,-10
49226303784,49226303785,1,1572,1813,-10
49227743599,49227743600,1,1298,1854,-10
49227915282,49227915286,4,1448,1347,-10
49228764793,49228764789,-4,1417,4047,-10
49232501032,49232501033,1,1306,2213,-10
49236293957,49236293959,2,1708,1501,-10
49236840046,49236840067,21,1284,1504,-10
49240071341,49240071334,-7,4048,14363,-10
49240251404,49240251406,2,1095,1653,-10
49245871147,49245871149,2,2663,2910,-10
49248501365,49248501366,1,1555,1171,-10
49254721804,49254721807,3,1900,1871,-10
49255306150,49255306150,0,33004,36063,-10
49258315269,49258315271,2,2255,2350,-10
49260602741,49260602741,0,4485,6536,-10
49260883943,49260883946,3,1659,1620,-10
49260909125,49260909127,2,1637,1254,-10
49260922682,49260922683,1,146,6,-10
49263785235,49263785237,2,1712,1968,-10
49265163172,49265163173,1,2371,1476,-10
49266237198,49266237198,0,1912,970,-10
49267383565,49267383566,1,1577,1288,-10
49267996927,49267996931,4,3021,1348,-10
49270107013,49270107016,3,1094,1632,-10
49272003559,49272003561,2,1345,1331,-10
49272664658,49272664659,1,1577,1475,-10
49275205669,49275205668,-1,1985,1928,-10
49278237530,49278237534,4,2005,1758,-10
49281211130,49281211131,1,1468,1425,-10
49282369114,49282369117,3,1792,2023,-10
49288920226,49288920227,1,1673,1531,-10
49289256598,49289256618,20,1324,1613,-10
49289545513,49289545513,0,1606,1521,-10
49289966438,49289966448,10,1316,1221,-10
49290757015,49290757017,2,1358,1724,-10
49292617518,49292617518,0,990,1021,-10
49292951433,49292951434,1,1170,1259,-10
49293904805,49293904806,1,1792,1815,-10
49295724819,49295724820,1,1164,1285,-10
49299439938,49299439939,1,1446,1567,-10
49302582174,49302582174,0,1347,1182,-10
49304436266,49304436266,0,733,1207,-10
49307327262,49307327263,1,1756,1245,-10
49308277294,49308277298,4,2222,1834,-10
49313273094,49313273105,11,1117,1263,-10
49315251750,49315251751,1,1235,1381,-10
49317142047,49317142050,3,1782,1744,-10
49320103108,49320103109,1,1889,1526,-10
49321154925,49321154928,3,2231,1516,-10
49322500889,49322500890,1,1741,992,-10
49323805002,49323805002,0,1059,1442,-10
49324401386,49324401389,3,1598,1180,-10
49325173962,49325173963,1,1120,1765,-10
49325646975,49325646979,4,1364,1859,-10
49326087686,49326087688,2,1817,1557,-10
49326783024,49326783026,2,1764,1596,-10
49328169654,49328169657,3,2099,1536,-10
49331882534,49331882534,0,1392,1315,-10
49335597951,49335597953,2,1420,1593,-10
49336334036,49336334039,3,1707,1202,-10
49344281950,49344281952,2,1540,924,-10
49346675598,49346675599,1,1713,1582,-10
49349649311,49349649314,3,1079,1349,-10
49352655520,49352655523,3,1195,923,-10
49353435137,49353435139,2,1271,1251,-10
49357831200,49357831189,-11,956,1195,-10
49361194537,49361194539,2,1995,1867,-10
49363532981,49363532983,2,1857,1571,-10
49364563527,49364563528,1,1615,1229,-10
49366962002,49366962003,1,1428,1515,-10
49372013746,49372013747,1,1407,1567,-10
49372463981,49372463982,1,1677,1525,-10
49374013949,49374013952,3,1398,1369,-10
49374248548,49374248554,6,2818,1024,-10
49374508611,49374508613,2,1729,1704,-10
49376181666,49376181668,2,1546,1876,-10
49377136545,49377136548,3,1917,1681,-10
49378370893,49378370894,1,1539,2321,-10
49380979529,49380979533,4,1411,1141,-10
49395922122,49395922125,3,1211,1567,-10
49401296531,49401296532,1,1394,2114,-10
49402300081,49402300082,1,2112,1728,-10
49403360621,49403360627,6,2258,854,-10
49404586757,49404586759,2,1848,1495,-10
49406310479,49406310485,6,3916,1576,-10
49406415830,49406415830,0,1390,1600,-10
49407537177,49407537173,-4,1008,4026,-10
49407702114,49407702117,3,1885,1585,-10
49414480865,49414480870,5,2419,1727,-10
49415835613,49415835615,2,1232,1514,-10
49416984349,49416984359,10,12586,21407,-10
49417139852,49417139853,1,1974,2227,-10
49418045699,49418045698,-1,1363,1884,-10
49418787304,49418787308,4,1844,825,-10
49421871489,49421871489,0,1470,2331,-10
49424107675,49424107677,2,1112,1650,-10
49425451213,49425451213,0,1769,2883,-10
49425783346,49425783350,4,1373,1793,-10
49426678298,49426678302,4,2044,1293,-10
49429924157,49429924158,1,1474,1800,-10
49430707878,49430707878,0,1557,1941,-10
49431379130,49431379130,0,1498,1541,-10
49431501841,49431501843,2,1665,1716,-10
49434206961,49434206962,1,1786,1426,-10
49439073079,49439073082,3,1497,1201,-10
49439702754,49439702755,1,1763,2033,-10
49443428851,49443428851,0,1725,1749,-10
49443892693,49443892695,2,1742,1616,-10
49444297928,49444297931,3,2025,1802,-10
49446447050,49446447050,0,575,804,-10
49448867474,49448867476,2,1891,1577,-10
49449465362,49449465364,2,1578,1488,-10
49449868719,49449868729,10,1323,1159,-10
49450405896,49450405888,-8,1467,1927,-10
49456314734,49456314737,3,1626,1352,-10
49457029138,49457029139,1,1510,1792,-10
49458866206,49458866206,0,1198,1457,-10
49459642545,49459642547,2,1634,1829,-10
49460533747,49460533748,1,1026,1158,-10
49460823765,49460823766,1,1724,1240,-10
49461397233,49461397235,2,1938,1542,-10
49465476894,49465476897,3,1311,1290,-10
49467425327,49467425330,3,1268,1484,-10
49467957459,49467957459,0,1117,1594,-10
49468290790,49468290790,0,1354,2278,-10
49468841354,49468841349,-5,562,813,-10
49469091917,49469091918,1,1431,1445,-10
49469711735,49469711741,6,1587,1190,-10
49472872689,49472872693,4,1165,1403,-10
49480649627,49480649614,-13,1194,1373,-10
49481080929,49481080922,-7,51,2402,-10
49481694187,49481694191,4,1708,1743,-10
49483982788,49483982790,2,1281,1472,-10
49489938186,49489938187,1,1038,1099,-10
49492457332,49492457335,3,1704,1157,-10
49496714111,49496714116,5,2472,1790,-10
49502535682,49502535669,-13,1425,1690,-10
49503076617,49503076610,-7,840,1610,-10
49512754970,49512754972,2,1600,1882,-10
49513351749,49513351750,1,1214,1746,-10
49515335697,49515335699,2,1362,1101,-10
49517341590,49517341570,-20,735,306,-10
49518660433,49518660434,1,1215,1339,-10
49522567269,49522567270,1,1334,1558,-10
49523128009,49523128010,1,1314,2067,-10
49523180164,49523180165,1,1884,1945,-10
49526428320,49526428322,2,998,1265,-10
49535594766,49535594766,0,1079,1620,-10
49540309040,49540309046,6,2202,1322,-10
49541286291,49541286294,3,1585,1689,-10
49547058866,49547058871,5,3167,1803,-10
49552288038,49552288042,4,1779,1205,-10
49552349947,49552349948,1,1427,1873,-10
49552796163,49552796163,0,1335,1477,-10
49554255247,49554255250,3,1735,1512,-10
49556542320,49556542321,1,1395,1609,-10
49557394860,49557394862,2,1308,1811,-10
49557859129,49557859130,1,1626,2624,-10
49558496150,49558496150,0,1159,1557,-10
49561129538,49561129538,0,1276,1672,-10
49561892838,49561892841,3,1961,1798,-10
49562801225,49562801227,2,1603,1918,-10
49565629490,49565629494,4,1775,1484,-10
49566644236,49566644250,14,11443,44833,-10
49570850628,49570850629,1,1383,1350,-10
49571485106,49571485110,4,2244,1563,-10
49574842285,49574842286,1,2012,2678,-10
49583341737,49583341738,1,1969,1904,-10
49583472015,49583472017,2,1646,1308,-10
49587165969,49587165973,4,1640,1573,-10
49587267352,49587267371,19,2416,1101,-10
49587734350,49587734351,1,1522,952,-10
49590352949,49590352951,2,1791,1967,-10
49591312469,49591312471,2,2086,1338,-10
49591442534,49591442537,3,1411,2167,-10
49591933848,49591933849,1,2259,1952,-10
49596213004,49596213006,2,1997,1659,-10
49602310377,49602310378,1,1676,1436,-10
49602613632,49602613631,-1,1350,1520,-10
49605373433,49605373433,0,1847,2183,-10
49606227845,49606227846,1,763,664,-10
49609280482,49609280477,-5,897,3268,-10
49613824357,49613824358,1,1668,1234,-10
49614729123,49614729125,2,1129,1265,-10
49618671707,49618671709,2,1693,1799,-10
49619112073,49619112075,2,1460,1303,-10
49619643603,49619643602,-1,1420,1632,-10
49622484026,49622484028,2,2075,1638,-10
49624034186,49624034189,3,1617,1618,-10
49624772643,49624772645,2,1190,1338,-10
49629596355,49629596359,4,1665,1338,-10
49630827906,49630827910,4,1597,1797,-10
49631003688,49631003706,18,1545,1611,-10
49635209089,49635209094,5,1383,1691,-10
49635436776,49635436781,5,3350,1527,-10
49635618160,49635618162,2,1565,1346,-10
49638914370,49638914373,3,1742,1699,-10
49641059206,49641059208,2,1486,1474,-10
49642983666,49642983668,2,1405,1400,-10
49644573363,49644573366,3,2225,1310,-10
49646628873,49646628874,1,1202,1291,-10
49648063378,49648063381,3,1686,1791,-10
49650698416,49650698419,3,1327,1000,-10
49651538867,49651538874,7,2497,800,-10
49652231102,49652231104,2,1510,1174,-10
49655035056,49655035056,0,1022,1320,-10
49656897669,49656897672,3,1531,1643,-10
49661706809,49661706811,2,1328,2013,-10
49662357670,49662357670,0,1359,1682,-10
49663370574,49663370578,4,1132,1249,-10
49666692529,49666692534,5,1860,1128,-10
49667292718,49667292718,0,1914,1646,-10
49667830764,49667830766,2,1558,1119,-10
49668732720,49668732722,2,2532,2073,-10
49669676446,49669676446,0,1506,2404,-10
49673857793,49673857795,2,1402,1941,-10
49674059236,49674059237,1,1290,1105,-10
49674618646,49674618651,5,1742,1379,-10
49677205326,49677205326,0,1242,1468,-10
49683480683,49683480685,2,2218,1609,-10
49685036286,49685036286,0,1898,1588,-10
49687668793,49687668794,1,1518,1680,-10
49688059671,49688059674,3,2005,1408,-10
49689594037,49689594038,1,1464,1948,-10
49691209098,49691209101,3,1668,1960,-10
49692070408,49692070411,3,1975,1634,-10
49696150477,49696150481,4,1954,1461,-10
49698025621,49698025626,5,1643,1155,-10
49700989722,49700989724,2,1134,1894,-10
49703054722,49703054726,4,1765,1487,-10
49703700548,49703700561,13,10841,47269,-10
49703949247,49703949250,3,1345,1930,-10
49706265227,49706265222,-5,1138,4746,-10
49707521838,49707521838,0,2889,1593,-10
49708421038,49708421039,1,1959,1682,-10
49709074570,49709074570,0,804,1446,-10
49709991833,49709991833,0,1163,1346,-10
49711501586,49711501593,7,1365,1509,-10
49712142347,49712142350,3,1574,1434,-10
49714684207,49714684209,2,1459,1097,-10
49715031173,49715031174,1,1364,1092,-10
49715647222,49715647226,4,1661,1230,-10
49718477978,49718477979,1,1409,1105,-10
49719689771,49719689769,-2,1299,1194,-10
49724875473,49724875475,2,1530,1005,-10
49726100014,49726100017,3,928,1429,-10
49727134364,49727134361,-3,1033,2868,-10
49728604005,49728604005,0,1364,1439,-10
49729489530,49729489533,3,1995,1813,-10
49732178676,49732178679,3,2300,1640,-10
49734859352,49734859354,2,2081,1620,-10
49735153129,49735153134,5,1117,1161,-10
49735646421,49735646423,2,1706,1191,-10
49735873693,49735873695,2,1393,1272,-10
49740388632,49740388621,-11,2249,1886,-10
49741540017,49741540019,2,1713,1467,-10
49742562339,49742562342,3,1226,1270,-10
49743030679,49743030683,4,1349,1313,-10
49743407185,49743407191,6,4571,747,-10
49745484483,49745484485,2,1707,1605,-10
49745844758,49745844761,3,1514,1518,-10
49749700287,49749700291,4,1235,1387,-10
49752634166,49752634169,3,1642,933,-10
49754218579,49754218578,-1,847,1309,-10
49754530423,49754530423,0,1405,1601,-10
49758440408,49758440398,-10,148,1190,-10
49758535422,49758535424,2,2456,1726,-10
49762118043,49762118045,2,957,1161,-10
49762229378,49762229378,0,1538,1711,-10
49764429455,49764429457,2,1596,1752,-10
49765526335,49765526334,-1,883,1122,-10
49767306156,49767306156,0,1432,1354,-10
49769219317,49769219318,1,1430,1570,-10
49777760706,49777760709,3,2669,1540,-10
49780471630,49780471630,0,1916,1641,-10
49780935003,49780935006,3,2104,1584,-10
49781318078,49781318078,0,1578,1698,-10
49789684018,49789684022,4,1785,2025,-10
49789823616,49789823618,2,1140,1293,-10
49790799948,49790799950,2,1306,1477,-10
49794330788,49794330790,2,1684,1399,-10
49794622377,49794622379,2,1904,1522,-10
49795523440,49795523442,2,1667,1912,-10
49797732992,49797732993,1,1503,1806,-10
49801056561,49801056561,0,1490,1866,-10
49809048002,49809048002,0,1090,1584,-10
49815417080,49815417081,1,1279,1616,-10
49817638007,49817638006,-1,1309,1672,-10
49825061323,49825061325,2,1413,1617,-10
49825239426,49825239427,1,1938,1467,-10
49826845002,49826845006,4,1205,1307,-10
49827299167,49827299170,3,1813,1136,-10
49827430728,49827430729,1,1517,1653,-10
49827507545,49827507545,0,1436,1130,-10
49827895929,49827895936,7,1208,709,-10
49830753206,49830753209,3,1752,1503,-10
49831984462,49831984462,0,1320,1097,-10
49835058364,49835058366,2,1547,1802,-10
49836337421,49836337427,6,2040,814,-10
49841708574,49841708574,0,1250,1595,-10
49842955896,49842955897,1,996,1229,-10
49844471665,49844471667,2,1554,1516,-10
49845483877,49845483881,4,1694,1646,-10
49847913789,49847913778,-11,821,1076,-10
49854227581,49854227582,1,1400,1659,-10
49854929212,49854929214,2,2452,2204,-10
49855920842,49855920843,1,1184,1144,-10
49857249057,49857249058,1,1517,1341,-10
49861364375,49861364378,3,1752,1434,-10
49861788255,49861788255,0,1206,1042,-10
49866664545,49866664545,0,1260,1946,-10
49868842883,49868842886,3,1219,1375,-10
49868946258,49868946261,3,1357,1267,-10
49870538384,49870538386,2,1872,1467,-10
49871728299,49871728302,3,985,1660,-10
49872320941,49872320942,1,1103,1240,-10
49879263266,49879263270,4,1642,1043,-10
49879829748,49879829749,1,1491,1453,-10
49883451090,49883451085,-5,1086,1024,-10
49891246079,49891246080,1,1537,1357,-10
49891709277,49891709279,2,1652,1575,-10
49891829276,49891829274,-2,2150,2204,-10
49893835728,49893835731,3,1543,1407,-10
49894078366,49894078367,1,1606,1182,-10
49899461458,49899461453,-5,1146,3204,-10
49900762658,49900762659,1,2021,1136,-10
49904299770,49904299770,0,1498,1756,-10
49908264455,49908264459,4,1423,1471,-10
49909130198,49909130194,-4,1165,882,-10
49910824963,49910824965,2,1690,1683,-10
49911651134,49911651127,-7,2073,7904,-10
49912903973,49912903973,0,1283,1801,-10
49914158324,49914158327,3,1484,1355,-10
49917122177,49917122180,3,3220,2996,-10
49917624397,49917624399,2,1566,1429,-10
49919278312,49919278302,-10,959,1456,-10
49919468445,49919468445,0,1945,1860,-10
49920885078,49920885081,3,1794,1763,-10
49922712428,49922712429,1,1556,1833,-10
49924330778,49924330782,4,1683,1588,-10
49930068633,49930068635,2,1383,1581,-10
49931745391,49931745395,4,1206,1223,-10
49932287929,49932287929,0,1471,2195,-10
49932329186,49932329188,2,1584,1792,-10
49932666663,49932666666,3,1270,1347,-10
49937023730,49937023732,2,1073,867,-10
49938649166,49938649167,1,843,955,-10
49939309858,49939309860,2,1922,1644,-10
49940183265,49940183265,0,1290,1525,-10
49942797477,49942797478,1,1775,2114,-10
49948359853,49948359853,0,1357,1165,-10
49952168645,49952168647,2,1694,2545,-10
49952997469,49952997469,0,772,1484,-10
49955722480,49955722482,2,1984,1704,-10
49956839552,49956839554,2,1656,1466,-10
49957497018,49957497019,1,1275,1586,-10
49959699767,49959699770,3,991,884,-10
49960295131,49960295133,2,1302,1292,-10
49966073013,49966073017,4,1479,1636,-10
49966698103,49966698106,3,2107,1842,-10
49967347890,49967347891,1,1654,1669,-10
49970835402,49970835403,1,1715,1541,-10
49971079211,49971079211,0,1530,1603,-10
49976219436,49976219438,2,1075,975,-10
49977975277,49977975279,2,1833,2014,-10
49979129405,49979129407,2,1620,1025,-10
49980467002,49980466987,-15,1473,1216,-10
49980524542,49980524544,2,2253,2241,-10
49980871620,49980871619,-1,1249,1595,-10
49981697989,49981697992,3,2127,1003,-10
49986558140,49986558142,2,1753,1515,-10
49988530726,49988530727,1,1640,1239,-10
49991342270,49991342274,4,2292,1523,-10
49991451534,49991451535,1,1182,884,-10
49994620775,49994620774,-1,1424,1425,-10
49994992584,49994992581,-3,1458,2781,-10
49996172017,49996172019,2,1334,1452,-10
50003736267,50003736270,3,1917,2044,-10
50004298650,50004298654,4,1685,794,-10
50004420234,50004420228,-6,1067,3089,-10
50005979787,50005979790,3,977,1087,-10
50006593749,50006593751,2,1570,1758,-10
50008756006,50008756026,20,132,4517,-10
50009824724,50009824737,13,630,2254,-10
50010341543,50010341546,3,2208,1575,-10
50014914059,50014914067,8,2133,1070,-10
50019584901,50019584902,1,1675,1643,-10
50021260301,50021260304,3,1265,1776,-10
50022573714,50022573715,1,1330,802,-10
50025497054,50025497058,4,2085,1422,-10
50027921950,50027921954,4,1709,1256,-10
50028099591,50028099580,-11,588,452,-10
50033466153,50033466153,0,1337,1711,-10
50035649574,50035649574,0,1640,1791,-10
50036828246,50036828249,3,1383,1146,-10
50041975264,50041975266,2,1378,1600,-10
50043315041,50043315042,1,2131,1701,-10
50045742053,50045742054,1,1390,1465,-10
50045796890,50045796870,-20,1337,1179,-10
50049471750,50049471752,2,942,941,-10
50050904324,50050904325,1,1719,1514,-10
50051238161,50051238162,1,1535,1345,-10
50051989221,50051989223,2,1270,1359,-10
50052223075,50052223069,-6,1417,5650,-10
50052995763,50052995765,2,1867,1694,-10
50053113730,50053113732,2,1846,1065,-10
50053545934,50053545936,2,1254,1231,-10
50055151204,50055151206,2,1083,1499,-10
50058029141,50058029143,2,1593,1465,-10
50058472998,50058472995,-3,1350,2325,-10
50059100658,50059100658,0,1529,1740,-10
50066299893,50066299895,2,1391,851,-10
50067174506,50067174503,-3,1630,2272,-10
50067447746,50067447741,-5,913,2059,-10
50068556554,50068556533,-21,1470,1117,-10
50069130977,50069130978,1,1249,930,-10
50069534204,50069534223,19,1218,1235,-10
50070376689,50070376689,0,1789,1414,-10
50075259796,50075259798,2,1268,1419,-10
50077768691,50077768694,3,2100,1856,-10
50079892814,50079892796,-18,1307,1735,-10
50080576894,50080576897,3,3017,1878,-10
50083591741,50083591745,4,2167,1636,-10
50092096766,50092096769,3,1884,1946,-10
50092802549,50092802550,1,1539,1194,-10
50094016669,50094016671,2,1047,1376,-10
50096845663,50096845666,3,1663,1145,-10
50098499990,50098499989,-1,1643,1622,-10
50098644002,50098644002,0,1892,1656,-10
50099226128,50099226127,-1,3085,3961,-10
50102046127,50102046130,3,2588,1550,-10
50104583338,50104583340,2,1945,1360,-10
50104683576,50104683578,2,1336,1140,-10
50104896449,50104896433,-16,5041,1766,-10
50106046225,50106046226,1,1340,2405,-10
50109592984,50109592986,2,1784,1769,-10
50110863987,50110863989,2,1783,1700,-10
50112006813,50112006814,1,2402,2246,-10
50114496655,50114496658,3,1435,1153,-10
50115681041,50115681045,4,1620,1216,-10
50117614469,50117614470,1,1283,1400,-10
50118565258,50118565258,0,1563,1794,-10
50119401815,50119401817,2,1319,1095,-10
50121736525,50121736527,2,1292,1537,-10
50125752981,50125752982,1,1636,1710,-10
50127800747,50127800747,0,1528,1438,-10
50128616677,50128616679,2,882,783,-10
50129526908,50129526909,1,1441,1891,-10
50132527098,50132527102,4,1457,1435,-10
50134448790,50134448792,2,1569,1565,-10
50135487242,50135487246,4,1377,1171,-10
50136286145,50136286146,1,1832,2459,-10
50137494342,50137494346,4,1969,1836,-10
50137877822,50137877825,3,1646,1774,-10
50140588490,50140588490,0,2131,2185,-10
50144682882,50144682885,3,3177,1996,-10
50147710307,50147710309,2,1226,1531,-10
50147891576,50147891578,2,1737,1270,-10
50148332013,50148332014,1,1520,1448,-10
50150582837,50150582839,2,1845,1618,-10
50152278132,50152278133,1,2571,2363,-10
50154941383,50154941385,2,1326,1630,-10
50154997109,50154997109,0,1364,2012,-10
50155039753,50155039775,22,1192,1557,-10
50158740258,50158740261,3,1399,1330,-10
50158907566,50158907570,4,1589,1336,-10
50161536255,50161536258,3,1885,1858,-10
50163163115,50163163118,3,1561,1755,-10
50163558618,50163558620,2,1223,1750,-10
50165293936,50165293936,0,1569,1776,-10
50166489865,50166489868,3,1050,1391,-10
50166822773,50166822774,1,1415,1367,-10
50168581878,50168581882,4,1660,1694,-10
50169325085,50169325088,3,1778,2127,-10
50173759141,50173759142,1,1764,1857,-10
50174342552,50174342554,2,958,785,-10
50175772910,50175772911,1,22469,25861,-10
50178023305,50178023309,4,2145,1363,-10
50179446696,50179446701,5,3019,2060,-10
50180187262,50180187266,4,2293,1978,-10
50182240847,50182240852,5,1291,1054,-10
50186299058,50186299069,11,14401,23557,-10
50186483850,50186483850,0,1524,1536,-10
50187003451,50187003453,2,750,713,-10
50191076151,50191076152,1,1446,1612,-10
50191628058,50191628058,0,1178,1321,-10
50194915096,50194915097,1,1686,1623,-10
50195795930,50195795935,5,1814,1393,-10
50197363479,50197363482,3,1358,1363,-10
50197821925,50197821926,1,1440,1880,-10
50197922374,50197922378,4,1643,1475,-10
50199614553,50199614554,1,1467,1092,-10
50202597965,50202597952,-13,23334,18445,-10
50204769923,50204769925,2,1446,1297,-10
50206768851,50206768853,2,1670,1414,-10
50208336578,50208336579,1,1826,1722,-10
50208534001,50208534006,5,1184,1320,-10
50208680490,50208680492,2,1157,1366,-10
50208857763,50208857764,1,1590,1576,-10
50214599294,50214599297,3,749,1071,-10
50217868942,50217868945,3,1452,1083,-10
50220429739,50220429741,2,1767,1526,-10
50221877144,50221877146,2,1918,1154,-10
50224389925,50224389926,1,1424,1993,-10
50225187639,50225187640,1,1199,1543,-10
50227173033,50227173033,0,1536,1608,-10
50227371077,50227371058,-19,2028,2403,-10
50228815683,50228815682,-1,1692,1876,-10
50230899177,50230899169,-8,425,4190,-10
50234248757,50234248759,2,1700,1601,-10
50234818105,50234818106,1,1278,1804,-10
50236747823,50236747825,2,1168,1568,-10
50240262361,50240262363,2,1333,1654,-10
50240952301,50240952303,2,1261,1274,-10
50241571179,50241571178,-1,1064,1459,-10
50246076218,50246076219,1,1064,1690,-10
50249666886,50249666889,3,2308,1243,-10
50249732324,50249732326,2,2009,1589,-10
50253351850,50253351852,2,1696,1868,-10
50255349859,50255349863,4,1267,1358,-10
50256041964,50256041965,1,974,925,-10
50256751503,50256751507,4,1236,1343,-10
50257022415,50257022410,-5,2450,7558,-10
50259175927,50259175926,-1,965,1115,-10
50259502219,50259502222,3,1920,1523,-10
50260628406,50260628409,3,1662,1918,-10
50261637497,50261637492,-5,1374,4634,-10
50262745697,50262745698,1,1425,1424,-10
50263639094,50263639095,1,1228,1489,-10
50263678161,50263678163,2,1516,1321,-10
50268514958,50268514959,1,2119,1298,-10
50275050646,50275050647,1,1595,1189,-10
50277693763,50277693765,2,1272,1823,-10
50278065591,50278065595,4,1890,1262,-10
50279570178,50279570182,4,1248,1415,-10
50279682083,50279682089,6,1410,1370,-10
50280792047,50280792042,-5,78,3346,-10
50281189407,50281189410,3,1439,1234,-10
50281408786,50281408789,3,892,1527,-10
50282160562,50282160562,0,1395,1784,-10
50283048673,50283048674,1,1301,1385,-10
50285450238,50285450242,4,1282,1265,-10
50286980333,50286980333,0,1533,1901,-10
50287549350,50287549351,1,1330,1214,-10
50287965663,50287965662,-1,1543,1294,-10
50288423239,50288423259,20,538,571,-10
50290387162,50290387162,0,1426,1493,-10
50290562672,50290562667,-5,813,905,-10
50291444094,50291444095,1,1551,1710,-10
50292431820,50292431806,-14,1514,2294,-10
50293261142,50293261143,1,1237,1597,-10
50295456435,50295456438,3,2207,2216,-10
50298636325,50298636326,1,1659,1542,-10
50298682434,50298682436,2,1449,1446,-10
50299941195,50299941195,0,1053,711,-10
50300102244,50300102252,8,13860,23953,-10
50301446159,50301446161,2,1605,1389,-10
50302579846,50302579848,2,1483,1234,-10
50305214610,50305214613,3,2299,1713,-10
50307686162,50307686160,-2,1149,1701,-10
50309902806,50309902809,3,1534,1349,-10
50310652597,50310652603,6,1326,1258,-10
50310905134,50310905128,-6,1050,4322,-10
50313448970,50313448963,-7,1430,8581,-10
50314227711,50314227715,4,1427,1472,-10
50320059317,50320059318,1,1535,1387,-10
50324154041,50324154044,3,1356,1512,-10
50329034015,50329034014,-1,1778,1503,-10
50330073417,50330073418,1,1429,1699,-10
50330680819,50330680819,0,1501,1851,-10
50335416158,50335416159,1,1399,1584,-10
50337037099,50337037102,3,1457,1395,-10
50338311389,50338311390,1,1045,1688,-10
50341321222,50341321224,2,1519,1630,-10
50343607209,50343607210,1,2198,2007,-10
50344912418,50344912421,3,1932,1893,-10
50348462581,50348462581,0,1122,1456,-10
50351106929,50351106930,1,1342,1261,-10
50351526206,50351526185,-21,2835,775,-10
50354052841,50354052844,3,1372,1479,-10
50357089157,50357089158,1,1100,1510,-10
50357893915,50357893918,3,1352,875,-10
50361897410,50361897414,4,1971,2361,-10
50366793519,50366793521,2,1399,1753,-10
50368172951,50368172950,-1,1724,1666,-10
50368376726,50368376720,-6,1496,4760,-10
50370957361,50370957362,1,1837,1918,-10
50372670819,50372670823,4,1713,1491,-10
50373610254,50373610257,3,988,1331,-10
50374833312,50374833313,1,1571,1851,-10
50376264869,50376264868,-1,1794,1417,-10
50376520997,50376520998,1,1704,1539,-10
50377328146,50377328150,4,1823,1348,-10
50381511123,50381511127,4,2029,1357,-10
50381758870,50381758874,4,2274,1944,-10
50382422491,50382422472,-19,1356,1088,-10
50384476590,50384476592,2,937,952,-10
50385603569,50385603571,2,1850,1550,-10
50385637098,50385637098,0,1377,1244,-10
50390559429,50390559431,2,2157,2160,-10
50392058531,50392058533,2,1429,1918,-10
50393791407,50393791409,2,1877,1372,-10
50394857987,50394857994,7,1418,1562,-10
50395204196,50395204215,19,2091,1961,-10
50399608953,50399608956,3,1310,840,-10
50405863814,50405863817,3,1521,1824,-10
50408980476,50408980474,-2,47998,20550,-10
50409427926,50409427922,-4,855,4806,-10
50413888096,50413888096,0,1506,1381,-10
50421014621,50421014640,19,1451,1260,-10
50425748320,50425748340,20,1160,928,-10
50426211051,50426211034,-17,1133,688,-10
50429186649,50429186650,1,1668,1594,-10
50429970861,50429970865,4,1522,1166,-10
50430382465,50430382466,1,2205,2031,-10
50430409877,50430409879,2,1392,1793,-10
50432973921,50432973919,-2,3748,17920,-10
50436644445,50436644446,1,1448,1382,-10
50437607394,50437607395,1,1674,1890,-10
50437836822,50437836822,0,1527,2399,-10
50438195985,50438195978,-7,2080,11991,-10
50443124187,50443124189,2,1521,1839,-10
50443268647,50443268648,1,1684,1610,-10
50443493961,50443493963,2,1781,1743,-10
50444228568,50444228569,1,1515,1327,-10
50445370773,50445370774,1,1116,1796,-10
50448440917,50448440918,1,1393,1682,-10
50448528830,50448528832,2,2091,2157,-10
50455086041,50455086042,1,1857,1449,-10
50456664855,50456664858,3,1375,1697,-10
50458488037,50458488037,0,1603,1616,-10
50460839085,50460839086,1,2532,2067,-10
50461828994,50461828996,2,2153,1867,-10
50462444403,50462444406,3,1594,1307,-10
50464831274,50464831278,4,1881,2436,-10
50465223477,50465223478,1,2185,2390,-10
50467544157,50467544158,1,1410,1442,-10
50469315075,50469315079,4,1144,1370,-10
50470116820,50470116823,3,2248,1983,-10
50471188408,50471188409,1,1465,1839,-10
50471679866,50471679866,0,1327,910,-10
50476507200,50476507202,2,1256,1648,-10
50477434936,50477434943,7,26696,28077,-10
50479911793,50479911794,1,1238,1542,-10
50480935486,50480935487,1,1512,1630,-10
50482670044,50482670046,2,1615,1669,-10
50483675019,50483675012,-7,1130,7496,-10
50489319337,50489319340,3,1599,1611,-10
50489580841,50489580844,3,1923,2091,-10
50489870159,50489870160,1,1636,1634,-10
50492155355,50492155356,1,1640,1690,-10
50499190725,50499190727,2,1464,1864,-10
50503149938,50503149939,1,1059,1663,-10
50506077548,50506077547,-1,1418,2009,-10
50506567629,50506567631,2,1481,1048,-10
50508996727,50508996726,-1,1440,1895,-10
50513642750,50513642750,0,1545,1495,-10
50515219934,50515219936,2,1813,2159,-10
50520779278,50520779280,2,1728,1542,-10
50523389121,50523389121,0,1874,1865,-10
50530175839,50530175837,-2,1321,1852,-10
50532468373,50532468374,1,1671,1327,-10
50533912308,50533912310,2,1720,2099,-10
50534497669,50534497671,2,1818,1620,-10
50535560754,50535560756,2,1800,1520,-10
50538233733,50538233734,1,1448,1123,-10
50541677029,50541677032,3,1459,1261,-10
50542858002,50542858004,2,1500,1492,-10
50543295174,50543295177,3,1901,956,-10
50545050393,50545050397,4,1307,1567,-10
50547924118,50547924122,4,2059,1180,-10
50549583261,50549583262,1,1505,1629,-10
50551798700,50551798703,3,1862,1244,-10
50552631973,50552631974,1,1814,1651,-10
50559618514,50559618516,2,1702,1334,-10
50563331960,50563331961,1,1577,1580,-10
50568543824,50568543825,1,2109,1708,-10
50571007284,50571007286,2,1473,907,-10
50571425698,50571425701,3,1909,1787,-10
50573088383,50573088393,10,11204,30345,-10
50578026397,50578026398,1,1149,1155,-10
50579968501,50579968502,1,1475,1743,-10
50580086406,50580086399,-7,814,3965,-10
50580790093,50580790094,1,1757,1974,-10
50581569346,50581569348,2,1090,1464,-10
50585111921,50585111916,-5,1364,2632,-10
50587624246,50587624250,4,1053,1074,-10
50588847873,50588847875,2,1657,1765,-10
50589170205,50589170207,2,2094,1702,-10
50589616439,50589616442,3,1464,1385,-10
50590972781,50590972786,5,2773,1665,-10
50591749844,50591749841,-3,638,1892,-10
50593816847,50593816842,-5,1101,2616,-10
50598474616,50598474618,2,2122,1247,-10
50599779843,50599779844,1,1070,1521,-10
50601240446,50601240448,2,975,1114,-10
50602169469,50602169472,3,1338,1528,-10
50603744751,50603744754,3,1566,1316,-10
50604313447,50604313448,1,1560,1481,-10
50606197187,50606197182,-5,1367,1261,-10
50609569762,50609569763,1,2019,1714,-10
50610459799,50610459802,3,2290,1356,-10
50614285521,50614285523,2,1583,2166,-10
50617519874,50617519875,1,1051,1041,-10
50619035010,50619035010,0,2284,2158,-10
50622370592,50622370590,-2,1400,1836,-10
50624123636,50624123640,4,2118,1942,-10
50637721645,50637721649,4,1474,1424,-10
50639926680,50639926679,-1,1609,1447,-10
50641010855,50641010857,2,1460,1790,-10
50641401259,50641401261,2,1126,1469,-10
50643239365,50643239368,3,1472,1565,-10
50643628160,50643628161,1,1374,1063,-10
50648559881,50648559897,16,85,1782,-10
50651027077,50651027081,4,1420,1271,-10
50653168167,50653168165,-2,1096,1960,-10
50654919383,50654919385,2,1925,2010,-10
50656252194,50656252194,0,1455,1252,-10
50658958841,50658958843,2,1764,1287,-10
50660532777,50660532778,1,1604,2062,-10
50662474082,50662474077,-5,938,3849,-10
50664265289,50664265269,-20,1393,878,-10
50669220014,50669220014,0,1243,1375,-10
50670210974,50670210975,1,1616,1385,-10
50671476858,50671476862,4,1406,1168,-10
50671706546,50671706549,3,1215,1278,-10
50672435352,50672435350,-2,185,1419,-10
50673774896,50673774896,0,1290,2142,-10
50681898077,50681898077,0,1332,1356,-10
50683132504,50683132506,2,1052,1158,-10
50684566720,50684566724,4,1478,1450,-10
50684823902,50684823882,-20,1213,1291,-10
50685503843,50685503846,3,1361,973,-10
50687224430,50687224429,-1,1698,2412,-10
50692488338,50692488341,3,1973,1740,-10
50699888764,50699888765,1,1521,1045,-10
50702890313,50702890315,2,1949,1982,-10
50706565490,50706565492,2,2091,1444,-10
50706972811,50706972813,2,1367,1397,-10
50708720132,50708720133,1,1400,1386,-10
50711259529,50711259531,2,1833,1482,-10
50713319810,50713319814,4,1870,1573,-10
50716547722,50716547724,2,1272,1619,-10
50717163774,50717163774,0,1685,1197,-10
50718667882,50718667882,0,1034,1331,-10
50729348113,50729348113,0,1679,1376,-10
50731223106,50731223107,1,1577,1562,-10
50734692503,50734692506,3,1569,1479,-10
50736243107,50736243098,-9,910,1627,-10
50736765810,50736765814,4,1347,1894,-10
50741424306,50741424310,4,1451,1307,-10
50743235875,50743235874,-1,1723,2690,-10
50747102599,50747102602,3,1312,1742,-10
50748732645,50748732650,5,2477,823,-10
50750346509,50750346512,3,1632,1475,-10
50758629875,50758629877,2,1657,1778,-10
50763684807,50763684806,-1,1532,1659,-10
50764128458,50764128459,1,1013,1284,-10
50765070106,50765070108,2,1519,1424,-10
50765453442,50765453448,6,2487,1352,-10
50768563535,50768563532,-3,858,2036,-10
50771709151,50771709149,-2,1176,3525,-10
50772176782,50772176786,4,1350,1314,-10
50779755369,50779755372,3,1439,947,-10
50780111018,50780111020,2,1814,2074,-10
50781115862,50781115863,1,1232,835,-10
50785553430,50785553432,2,1542,1237,-10
50786045417,50786045419,2,1688,1805,-10
50790729326,50790729327,1,1513,1662,-10
50792094707,50792094708,1,1367,1812,-10
50794093868,50794093870,2,2469,1952,-10
50795163623,50795163624,1,1898,1354,-10
50796540879,50796540879,0,873,1252,-10
50797773915,50797773917,2,1335,1178,-10
50798261429,50798261431,2,1285,1316,-10
50798788110,50798788113,3,1880,2123,-10
50799701823,50799701824,1,1089,1419,-10
50800614616,50800614639,23,1032,1560,-10
50801063202,50801063203,1,2327,1672,-10
50803105246,50803105249,3,1589,1935,-10
50803523753,50803523754,1,1633,1615,-10
50806491866,50806491866,0,1478,1284,-10
50808346070,50808346072,2,2170,1868,-10
50811936176,50811936178,2,1922,1837,-10
50814114368,50814114370,2,1814,1280,-10
50814139735,50814139737,2,1060,1195,-10
50814620278,50814620277,-1,2122,2953,-10
50814682365,50814682366,1,1709,1964,-10
50815196230,50815196225,-5,1126,4073,-10
50815716132,50815716133,1,2003,1544,-10
50815897178,50815897180,2,1747,1192,-10
50819019526,50819019527,1,1662,1230,-10
50820212274,50820212278,4,1974,1576,-10
50820671359,50820671357,-2,1726,3254,-10
50822951034,50822951037,3,2043,1572,-10
50823435378,50823435377,-1,1351,1969,-10
50824044007,50824044011,4,1153,870,-10
50824979347,50824979349,2,1293,2015,-10
50825819922,50825819924,2,1382,1575,-10
50828028113,50828028115,2,1717,1526,-10
50829449825,50829449829,4,1576,1252,-10
50830104052,50830104053,1,1371,1780,-10
50831118709,50831118711,2,1492,1643,-10
50835257442,50835257443,1,1385,1525,-10
50837536298,50837536301,3,2265,1354,-10
50837734884,50837734887,3,2171,1243,-10
50840151389,50840151391,2,1188,1794,-10
50840415286,50840415287,1,1554,1495,-10
50841275789,50841275789,0,1776,2152,-10
50841443787,50841443790,3,2152,1492,-10
50842514315,50842514318,3,1686,1374,-10
50843027532,50843027555,23,1598,1534,-10
50844318510,50844318513,3,1579,1351,-10
50844486595,50844486597,2,2200,1673,-10
50844891513,50844891516,3,1390,1560,-10
50850097278,50850097279,1,1090,1458,-10
50851027403,50851027405,2,1614,1676,-10
50857538035,50857538038,3,1751,2210,-10
50859822874,50859822874,0,1253,1004,-10
50860749079,50860749079,0,989,1635,-10
50863000915,50863000918,3,2324,2378,-10
50868292329,50868292335,6,6638,2976,-10
50870251083,50870251085,2,1705,1327,-10
50871064272,50871064271,-1,1608,1125,-10
50876130598,50876130599,1,1214,1464,-10
50877225131,50877225138,7,3299,1338,-10
50878712855,50878712856,1,1802,1656,-10
50879885507,50879885510,3,1544,1654,-10
50882806598,50882806600,2,1121,1750,-10
50890430554,50890430555,1,1650,1754,-10
50894140095,50894140098,3,1622,1612,-10
50898099374,50898099377,3,1943,1477,-10
50906282431,50906282434,3,1874,1797,-10
50906817676,50906817694,18,1117,3070,-10
50908005291,50908005293,2,1342,1517,-10
50908813774,50908813778,4,1622,1402,-10
50910799989,50910799992,3,965,973,-10
50913470834,50913470832,-2,1287,2116,-10
50915055462,50915055463,1,1061,811,-10
50917462894,50917462897,3,1691,1136,-10
50920880662,50920880664,2,1344,1275,-10
50924302559,50924302561,2,1540,1434,-10
50929377026,50929377027,1,1555,1248,-10
50930150812,50930150813,1,1834,1596,-10
50930863151,50930863151,0,1172,1462,-10
50932276559,50932276560,1,2155,2267,-10
50933107145,50933107146,1,1824,1645,-10
50933724737,50933724740,3,1604,1188,-10
50934792670,50934792672,2,964,1085,-10
50935807020,50935807022,2,1621,1595,-10
50938198087,50938198086,-1,1114,1333,-10
50938399070,50938399072,2,1509,1761,-10
50943110710,50943110703,-7,1299,1388,-10
50946427458,50946427461,3,1236,1885,-10
50946465860,50946465881,21,1433,1313,-10
50946825245,50946825247,2,2046,1853,-10
50954433838,50954433839,1,893,977,-10
50957246859,50957246858,-1,1458,1727,-10
50957523072,50957523071,-1,1513,1961,-10
50957579654,50957579655,1,1782,1416,-10
50959977390,50959977394,4,2214,1644,-10
50961494181,50961494184,3,1792,1287,-10
50968424342,50968424345,3,1388,1653,-10
50968940771,50968940752,-19,588,721,-10
50970013839,50970013839,0,1465,2112,-10
50971051848,50971051849,1,1945,2598,-10
50971179377,50971179379,2,1073,1587,-10
50971296611,50971296613,2,1325,1968,-10
50976690416,50976690415,-1,1781,2436,-10
50977280858,50977280862,4,2019,1608,-10
50980604701,50980604703,2,1620,1287,-10
50981265942,50981265944,2,1827,2389,-10
50981577303,50981577299,-4,422,411,-10
50982152066,50982152050,-16,690,367,-10
50982238749,50982238750,1,1666,1630,-10
50989682429,50989682435,6,1766,918,-10
50991946479,50991946483,4,1593,1653,-10
50998341651,50998341657,6,2057,1152,-10
51000902434,51000902434,0,1852,1973,-10
51001512935,51001512936,1,1656,1687,-10
51007600271,51007600273,2,1074,1198,-10
51012629720,51012629722,2,1788,1813,-10
51013069421,51013069423,2,898,1296,-10
51013183107,51013183087,-20,1235,1429,-10
51015701203,51015701203,0,1703,1950,-10
51016257890,51016257890,0,1454,1039,-10
51016824948,51016824951,3,1783,1444,-10
51017881443,51017881445,2,2193,1992,-10
51020517954,51020517947,-7,1012,4254,-10
51024221871,51024221874,3,1693,1170,-10
51025243497,51025243497,0,1581,1676,-10
51030984304,51030984307,3,1901,1427,-10
51031317502,51031317506,4,1211,1302,-10
51032364090,51032364092,2,1851,2509,-10
51036632662,51036632669,7,1900,1763,-10
51036946530,51036946526,-4,1171,3327,-10
51041214935,51041214938,3,1348,1044,-10
51043810019,51043810018,-1,1245,1117,-10
51044256450,51044256450,0,1292,2123,-10
51044557762,51044557764,2,1498,1896,-10
51045434170,51045434173,3,1366,1389,-10
51048022377,51048022380,3,1286,1554,-10
51049947089,51049947087,-2,1275,2137,-10
51050165406,51050165407,1,1143,1476,-10
51058893453,51058893454,1,1164,1476,-10
51060262850,51060262850,0,1155,1484,-10
51064972278,51064972282,4,1947,2012,-10
51065750653,51065750657,4,1258,1076,-10
51068099002,51068099002,0,1354,1953,-10
51073140677,51073140678,1,1771,1610,-10
51074124521,51074124521,0,1461,2156,-10
51078636167,51078636167,0,1336,1611,-10
51080825850,51080825852,2,1672,1202,-10
51084209954,51084209955,1,1304,1440,-10
51090642421,51090642426,5,1057,1100,-10
51091021718,51091021699,-19,1991,3376,-10
51091599451,51091599452,1,1707,1439,-10
51091648213,51091648195,-18,1832,721,-10
51096111354,51096111358,4,1479,1499,-10
51101724832,51101724835,3,1526,1202,-10
51103081019,51103081022,3,1040,1191,-10
51103346282,51103346282,0,1816,1509,-10
51103495166,51103495166,0,1175,2059,-10
51103602609,51103602611,2,1567,1597,-10
51105913270,51105913276,6,2079,2365,-10
51106245515,51106245512,-3,1613,3458,-10
51111108354,51111108358,4,2082,2159,-10
51112214519,51112214522,3,1495,1404,-10
51113291449,51113291448,-1,2355,2454,-10
51114888406,51114888406,0,1403,1474,-10
51115858168,51115858170,2,1678,957,-10
51116411809,51116411810,1,1251,1515,-10
51116623902,51116623902,0,1771,1580,-10
51121130003,51121130003,0,1567,1469,-10
51122169674,51122169674,0,1787,2057,-10
51123896589,51123896590,1,1463,1961,-10
51123961437,51123961439,2,1741,995,-10
51124339099,51124339102,3,1851,1285,-10
51124626705,51124626707,2,1323,1080,-10
51126230337,51126230339,2,1846,1373,-10
51127885308,51127885309,1,1561,1525,-10
51130678325,51130678326,1,977,1050,-10
51131402649,51131402649,0,1254,1223,-10
51134504388,51134504390,2,2079,1445,-10
51136585038,51136585040,2,938,2011,-10
51137396135,51137396137,2,1647,1453,-10
51141629114,51141629118,4,1968,1426,-10
51141990846,51141990847,1,1260,1686,-10
51142062774,51142062774,0,1999,1708,-10
51142603003,51142603004,1,1395,1999,-10
51143604703,51143604707,4,963,1078,-10
51147053355,51147053357,2,2001,2213,-10
51148735437,51148735440,3,1311,1609,-10
51150728456,51150728459,3,1448,1721,-10
51154654510,51154654510,0,1908,1715,-10
51158433314,51158433315,1,1074,1689,-10
51160371690,51160371693,3,1174,1817,-10
51161409302,51161409280,-22,1669,1779,-10
51162754454,51162754457,3,1901,1474,-10
51165831274,51165831277,3,1053,1178,-10
51167413351,51167413351,0,1722,1582,-10
51167742778,51167742777,-1,1232,1997,-10
51172327378,51172327379,1,2119,1834,-10
51172359869,51172359872,3,1327,1438,-10
51173789815,51173789818,3,1180,1525,-10
51175547166,51175547169,3,1942,2539,-10
51178194690,51178194690,0,1580,1581,-10
51178444748,51178444725,-23,784,842,-10
51179887102,51179887104,2,1005,1716,-10
51182461286,51182461288,2,2079,1923,-10
51183308386,51183308386,0,2546,2223,-10
51188869544,51188869549,5,2496,1613,-10
51190811370,51190811370,0,1481,1485,-10
51193597469,51193597470,1,1300,982,-10
51194905401,51194905399,-2,874,1227,-10
51196434229,51196434230,1,2020,2079,-10
51197500302,51197500303,1,1679,1332,-10
51198376179,51198376186,7,25792,56518,-10
51199389178,51199389176,-2,36434,69488,-10
51204070005,51204070000,-5,1563,6980,-10
51207530313,51207530314,1,965,1361,-10
51208912056,51208912058,2,1786,1575,-10
51209320805,51209320787,-18,1021,574,-10
51209662538,51209662554,16,1033,4828,-10
51211025448,51211025449,1,1262,1795,-10
51212753404,51212753405,1,1275,1279,-10
51213195049,51213195051,2,1954,879,-10
51214241524,51214241525,1,1520,1932,-10
51216426323,51216426325,2,1417,2239,-10
51217673245,51217673245,0,2014,1168,-10
51222390726,51222390729,3,1205,1342,-10
51224681599,51224681602,3,1416,1617,-10
51225935562,51225935563,1,1478,1387,-10
51228556829,51228556831,2,1795,1908,-10
51232479278,51232479282,4,2346,1737,-10
51232603625,51232603627,2,1646,1643,-10
51235178002,51235178003,1,1397,1078,-10
51236356298,51236356298,0,1244,1369,-10
51238386258,51238386259,1,1312,1458,-10
51242125209,51242125211,2,1737,1076,-10
51246157849,51246157852,3,2161,1646,-10
51246574766,51246574771,5,1443,1485,-10
51253407477,51253407477,0,1821,1167,-10
51253984070,51253984071,1,1314,1831,-10
51264371908,51264371910,2,1249,1464,-10
51267614757,51267614758,1,1361,2166,-10
51269713347,51269713351,4,1652,1483,-10
51272712010,51272712013,3,1570,1845,-10
51280812039,51280812039,0,828,1048,-10
51281105737,51281105738,1,1375,2128,-10
51283499535,51283499535,0,1509,1672,-10
51284837016,51284837018,2,1281,1706,-10
51285476938,51285476942,4,1381,1606,-10
51285773952,51285773954,2,1339,1361,-10
51286121489,51286121493,4,1798,1586,-10
51293164666,51293164669,3,1758,1437,-10
51296898200,51296898204,4,2143,1615,-10
51299930570,51299930571,1,1027,1271,-10
51307353546,51307353546,0,1298,2144,-10
51307494592,51307494594,2,918,1030,-10
51307834417,51307834418,1,1394,1482,-10
51311682022,51311682024,2,1238,1644,-10
51312980765,51312980768,3,1582,1641,-10
51319688595,51319688595,0,2038,1966,-10
51319988195,51319988198,3,1791,1323,-10
51320633602,51320633602,0,1457,1709,-10
51323630013,51323630014,1,1062,2526,-10
51324397992,51324397985,-7,1709,4543,-10
51326740012,51326740014,2,1461,1278,-10
51330156562,51330156564,2,1601,2118,-10
51334819702,51334819703,1,1257,1769,-10
51337111587,51337111586,-1,1103,975,-10
51340367240,51340367241,1,1235,1591,-10
51340947246,51340947250,4,1341,1554,-10
51342302911,51342302911,0,1737,1740,-10
51342530408,51342530409,1,1482,1593,-10
51343439586,51343439588,2,1521,1589,-10
51353669998,51353670001,3,1941,1733,-10
51355562533,51355562537,4,2203,1405,-10
51357021681,51357021681,0,1762,2337,-10
51357732777,51357732779,2,1640,1647,-10
51358371882,51358371885,3,2028,1296,-10
51359584026,51359584029,3,1137,1050,-10
51364956063,51364956069,6,6403,2106,-10
51370704916,51370704918,2,1379,1105,-10
51371684819,51371684821,2,1274,1118,-10
51372233994,51372234011,17,1244,1200,-10
51372668789,51372668793,4,1253,1044,-10
51373084134,51373084135,1,1615,1724,-10
51373573602,51373573603,1,1057,1332,-10
51377368118,51377368123,5,1651,1046,-10
51378473906,51378473906,0,1422,1390,-10
51379543585,51379543585,0,2255,2621,-10
51381664299,51381664301,2,1612,2249,-10
51383625686,51383625690,4,1220,1328,-10
51389323873,51389323878,5,1539,1792,-10
51391434390,51391434395,5,4255,1688,-10
51394355290,51394355290,0,1646,2060,-10
51395735397,51395735398,1,1652,1301,-10
51395779146,51395779150,4,1508,1202,-10
51396649367,51396649369,2,1667,1347,-10
51396979697,51396979696,-1,1458,2281,-10
51398655482,51398655484,2,1654,1578,-10
51401042398,51401042399,1,1479,1322,-10
51402011725,51402011726,1,1693,2087,-10
51403098632,51403098634,2,2366,1175,-10
51405832192,51405832195,3,1153,1295,-10
51408597642,51408597643,1,1327,1397,-10
51408731901,51408731903,2,1828,1358,-10
51410138412,51410138414,2,1671,1768,-10
51410366439,51410366442,3,1373,1556,-10
51411107879,51411107882,3,2175,1823,-10
51411442887,51411442897,10,12173,21520,-10
51413147833,51413147838,5,1604,1445,-10
51413273637,51413273641,4,1575,1232,-10
51415135345,51415135347,2,1301,1130,-10
51421105169,51421105171,2,1695,1187,-10
51426572254,51426572256,2,1779,1269,-10
51427869238,51427869239,1,1096,1518,-10
51430020252,51430020254,2,1415,1025,-10
51431821510,51431821514,4,1574,777,-10
51434430097,51434430101,4,1891,1776,-10
51435403135,51435403138,3,1460,1710,-10
51442288526,51442288527,1,943,1281,-10
51445612418,51445612420,2,39280,37670,-10
51447365945,51447365949,4,1455,1293,-10
51448230837,51448230842,5,3215,1503,-10
51449389618,51449389620,2,1283,1341,-10
51454162479,51454162462,-17,1657,1064,-10
51457451738,51457451742,4,1267,1449,-10
51463038934,51463038935,1,1368,1334,-10
51465667034,51465667036,2,2351,2242,-10
51469797909,51469797912,3,1544,1439,-10
51470149838,51470149839,1,1666,1430,-10
51472341288,51472341288,0,1802,2042,-10
51473455713,51473455714,1,2797,1873,-10
51474214259,51474214261,2,1579,1459,-10
51474791297,51474791297,0,1466,1582,-10
51476777994,51476777994,0,1505,1162,-10
51477396861,51477396862,1,1357,1917,-10
51481870398,51481870402,4,2698,1331,-10
51482163955,51482163956,1,1457,1958,-10
51482708702,51482708705,3,920,1092,-10
51484814117,51484814122,5,1783,983,-10
51485059217,51485059219,2,1681,1184,-10
51485178691,51485178694,3,1597,1532,-10
51487000455,51487000458,3,934,1245,-10
51488121995,51488121999,4,1349,1591,-10
51489405063,51489405066,3,1102,1446,-10
51489969094,51489969098,4,1814,1555,-10
51491069449,51491069453,4,1275,1847,-10
51495044385,51495044387,2,1558,1333,-10
51496841413,51496841414,1,1052,1426,-10
51498687533,51498687533,0,1351,1532,-10
51499317862,51499317866,4,625,1634,-10
51501915320,51501915319,-1,1673,2145,-10
51503201233,51503201237,4,1269,1295,-10
51505316098,51505316098,0,1125,1269,-10
51508183002,51508182995,-7,1156,3723,-10
51509635364,51509635366,2,1380,1268,-10
51511951199,51511951198,-1,1198,1633,-10
51512013591,51512013591,0,951,1279,-10
51514025743,51514025745,2,1417,2207,-10
51514644265,51514644269,4,1941,1723,-10
51518662740,51518662742,2,1888,2499,-10
51519222270,51519222273,3,1699,1903,-10
51520192345,51520192346,1,1358,1210,-10
51522016581,51522016581,0,1443,1566,-10
51524547935,51524547936,1,1226,1555,-10
51527176052,51527176052,0,1505,1346,-10
51532160598,51532160590,-8,1808,12858,-10
51532848531,51532848534,3,1845,1474,-10
51540934333,51540934331,-2,1016,1662,-10
51544009413,51544009405,-8,1164,4608,-10
51547265666,51547265669,3,1360,1391,-10
51551669628,51551669630,2,2158,1148,-10
51552992643,51552992647,4,2032,1308,-10
51554236585,51554236586,1,1933,1749,-10
51558875602,51558875605,3,2369,1817,-10
51559714992,51559714982,-10,25244,15413,-10
51563576014,51563576018,4,1685,1835,-10
51567107243,51567107245,2,1526,1172,-10
51567143708,51567143710,2,1254,1183,-10
51568013622,51568013622,0,999,1213,-10
51569171657,51569171658,1,2205,2476,-10
51569962056,51569962058,2,950,1403,-10
51571686917,51571686919,2,2013,2181,-10
51574549078,51574549078,0,1598,1810,-10
51579253469,51579253471,2,1835,1988,-10
51581064514,51581064514,0,1395,1632,-10
51592050166,51592050167,1,657,793,-10
51592887094,51592887092,-2,1975,1771,-10
51593634839,51593634839,0,1309,1310,-10
51594119603,51594119603,0,1545,2409,-10
51597984002,51597984005,3,1126,1496,-10
51599567766,51599567785,19,1768,1826,-10
51604304969,51604304972,3,831,1213,-10
51607359289,51607359289,0,1124,1284,-10
51607862272,51607862274,2,2470,1373,-10
51612134536,51612134538,2,2199,1854,-10
51615116981,51615116982,1,1687,1255,-10
51620712287,51620712287,0,862,1193,-10
51622707801,51622707803,2,1158,1766,-10
51625613522,51625613523,1,1245,1691,-10
51625913069,51625913071,2,1303,1441,-10
51627018094,51627018095,1,1138,1546,-10
51627142934,51627142938,4,1867,1176,-10
51627211990,51627211990,0,1819,1613,-10
51627908477,51627908491,14,12102,45709,-10
51628877019,51628877023,4,1696,1654,-10
51629532089,51629532091,2,1285,1241,-10
51635369052,51635369054,2,2033,1759,-10
51635940476,51635940487,11,9631,30719,-10
51637981796,51637981794,-2,2241,4119,-10
51638479701,51638479702,1,1517,1452,-10
51639470286,51639470289,3,1064,1067,-10
51639615673,51639615669,-4,1464,5952,-10
51641528549,51641528561,12,1242,1659,-10
51641720416,51641720418,2,2077,2051,-10
51646121704,51646121705,1,930,1278,-10
51648249141,51648249139,-2,1422,1639,-10
51650571222,51650571223,1,1355,1295,-10
51652749698,51652749694,-4,19046,44367,-10
51652825990,51652825992,2,1537,1708,-10
51654236519,51654236521,2,1017,1290,-10
51657101344,51657101344,0,1247,2249,-10
51657727163,51657727162,-1,1627,2168,-10
51658286403,51658286403,0,1334,1471,-10
51659039562,51659039562,0,1084,1400,-10
51659590910,51659590913,3,2482,1620,-10
51660359814,51660359815,1,1517,1326,-10
51660523350,51660523353,3,896,1518,-10
51665003999,51665003999,0,1275,1246,-10
51668631022,51668631027,5,24244,25249,-10
51670791049,51670791050,1,1746,1481,-10
51673396633,51673396636,3,1138,1543,-10
51678980306,51678980306,0,1466,1296,-10
51679951047,51679951049,2,1143,1109,-10
51680188403,51680188405,2,1552,2173,-10
51683112107,51683112107,0,1493,1178,-10
51683755089,51683755090,1,1323,1194,-10
51683925246,51683925241,-5,1322,6849,-10
51684722719,51684722723,4,9408,6360,-10
51684771535,51684771529,-6,1243,5935,-10
51685928499,51685928493,-6,1090,4272,-10
51687408565,51687408567,2,1354,1369,-10
51688210038,51688210042,4,1355,1259,-10
51689067816,51689067820,4,1708,1427,-10
51689611043,51689611058,15,1911,1491,-10
51690374395,51690374397,2,1641,1937,-10
51694024429,51694024431,2,1710,2095,-10
51695283809,51695283820,11,1326,1626,-10
51696593329,51696593330,1,1799,1685,-10
51696922330,51696922330,0,1272,1181,-10
51697232710,51697232712,2,1684,1227,-10
51700667190,51700667195,5,1634,1437,-10
51701893601,51701893602,1,1165,1091,-10
51704496863,51704496860,-3,1456,2275,-10
51706786169,51706786170,1,1748,1539,-10
51708838910,51708838911,1,2390,2401,-10
51711259355,51711259358,3,1691,1390,-10
51715821186,51715821190,4,1826,1749,-10
51715877962,51715877965,3,1809,1533,-10
51715908762,51715908763,1,1023,1533,-10
51721659429,51721659430,1,1390,1401,-10
51724831060,51724831063,3,1067,1125,-10
51727530345,51727530351,6,2932,1099,-10
51727789605,51727789606,1,1310,1313,-10
51736834330,51736834331,1,1340,1477,-10
51737521578,51737521581,3,1129,1100,-10
51738275157,51738275159,2,2002,1598,-10
51740587085,51740587086,1,1625,1649,-10
51740661273,51740661274,1,1270,1122,-10
51741076986,51741076987,1,1443,1198,-10
51742075312,51742075314,2,1816,1890,-10
51745011330,51745011335,5,5225,3287,-10
51745284206,51745284209,3,1694,2167,-10
51745664320,51745664316,-4,965,3590,-10
51746727577,51746727579,2,1472,1298,-10
51747955392,51747955392,0,2055,2055,-10
51747992094,51747992097,3,1605,1339,-10
51749285384,51749285386,2,1847,1570,-10
51755072998,51755073002,4,1837,1346,-10
51755834950,51755834953,3,1329,1791,-10
51755950095,51755950098,3,1034,1192,-10
51756328582,51756328586,4,1293,1280,-10
51756934434,51756934437,3,1893,1490,-10
51757355754,51757355754,0,1584,1949,-10
51760101418,51760101422,4,1242,1572,-10
51760564761,51760564758,-3,1052,2572,-10
51763219970,51763219970,0,1490,2186,-10
51763545249,51763545255,6,3426,1303,-10
51765532037,51765532038,1,1462,1061,-10
51766674038,51766674040,2,1873,1370,-10
51767211630,51767211634,4,1753,1359,-10
51768474515,51768474515,0,1413,1914,-10
51776443391,51776443389,-2,1147,1854,-10
51776991024,51776991022,-2,900,2059,-10
51777875446,51777875446,0,1622,1463,-10
51779442852,51779442854,2,1867,1948,-10
51783012062,51783012066,4,2208,1055,-10
51785569558,51785569559,1,1029,1422,-10
51786252754,51786252754,0,1105,1064,-10
51788617767,51788617767,0,1130,1064,-10
51788865751,51788865752,1,1992,2194,-10
51789069940,51789069934,-6,1466,2888,-10
51789470915,51789470914,-1,1220,1340,-10
51796092906,51796092911,5,2150,956,-10
51796356428,51796356427,-1,1273,1777,-10
51797159414,51797159414,0,1587,1626,-10
51797402329,51797402329,0,1436,1026,-10
51797874366,51797874369,3,2087,1589,-10
51797921960,51797921958,-2,1600,2148,-10
51799374603,51799374606,3,1383,1586,-10
51799474906,51799474906,0,1147,1160,-10
51801211729,51801211733,4,1492,1497,-10
51803642633,51803642633,0,3519,3475,-10
51805548399,51805548401,2,1552,1584,-10
51810503085,51810503085,0,1447,1301,-10
51811519160,51811519161,1,2155,1742,-10
51812396909,51812396911,2,2153,2049,-10
51813931764,51813931765,1,1811,3023,-10
51814761469,51814761470,1,1305,968,-10
51816256762,51816256766,4,1989,1367,-10
51817996611,51817996611,0,1479,2292,-10
51818895702,51818895701,-1,1329,1911,-10
51819349747,51819349747,0,1172,1116,-10
51822979511,51822979518,7,14201,27428,-10
51823594726,51823594729,3,1512,2205,-10
51826804381,51826804373,-8,1778,1544,-10
51828730461,51828730463,2,1990,1373,-10
51829921877,51829921893,16,1583,1774,-10
51835650346,51835650347,1,1648,1629,-10
51840106715,51840106716,1,1122,1602,-10
51845129050,51845129052,2,884,1345,-10
51847390734,51847390737,3,2356,1581,-10
51852522370,51852522373,3,1653,1809,-10
51853454646,51853454625,-21,75,1403,-10
51855172497,51855172499,2,1374,2191,-10
51856326956,51856326961,5,4483,1927,-10
51858528044,51858528046,2,1984,1152,-10
51860333522,51860333522,0,1086,898,-10
51861374175,51861374176,1,1853,2040,-10
51861956431,51861956427,-4,2572,7466,-10
51863777633,51863777634,1,1264,1211,-10
51864161330,51864161333,3,1024,1292,-10
51870919854,51870919857,3,1718,1719,-10
51872958269,51872958270,1,1262,1731,-10
51874506743,51874506746,3,1348,1053,-10
51877073690,51877073694,4,1040,1826,-10
51878472475,51878472481,6,1299,1079,-10
51879111955,51879111958,3,1810,1432,-10
51880895002,51880895005,3,1427,1503,-10
51883966134,51883966142,8,2161,1113,-10
51885116462,51885116462,0,1090,1377,-10
51890725213,51890725214,1,1348,1684,-10
51899213063,51899213063,0,667,1931,-10
51903624473,51903624478,5,5659,2921,-10
51906743892,51906743899,7,3234,1200,-10
51908748048,51908748050,2,1307,1633,-10
51909609110,51909609109,-1,1203,1788,-10
51911968879,51911968885,6,3798,1372,-10
51916902651,51916902630,-21,1785,2175,-10
51917765794,51917765795,1,1584,1802,-10
51918770350,51918770353,3,1638,2043,-10
51921209125,51921209126,1,1369,1784,-10
51921833367,51921833362,-5,1906,6770,-10
51921914581,51921914585,4,2516,1456,-10
51922545047,51922545049,2,1290,1690,-10
51923580990,51923580990,0,1818,1506,-10
51924823157,51924823155,-2,1640,1605,-10
51925546013,51925546017,4,815,950,-10
51928891323,51928891325,2,1600,1342,-10
51929806274,51929806268,-6,8543,13344,-10
51931787636,51931787638,2,1213,1267,-10
51943987089,51943987091,2,1785,1730,-10
51944264120,51944264122,2,1380,1334,-10
51945564201,51945564201,0,1422,1484,-10
51947345783,51947345787,4,927,837,-10
51948464759,51948464762,3,1533,1485,-10
51948865730,51948865731,1,1378,1299,-10
51953637251,51953637253,2,1936,1494,-10
51960086954,51960086951,-3,1431,1703,-10
51961703062,51961703064,2,1966,1443,-10
51963803381,51963803378,-3,1671,1985,-10
51964500853,51964500854,1,1411,1321,-10
51969635864,51969635862,-2,1267,2207,-10
51971237624,51971237623,-1,1272,2015,-10
51971797778,51971797766,-12,11436,38345,-10
51980768711,51980768714,3,1256,1961,-10
51985002800,51985002803,3,1133,1650,-10
51985162575,51985162578,3,1107,1193,-10
51985700140,51985700141,1,1835,2308,-10
51986329727,51986329728,1,1771,1495,-10
51988613394,51988613394,0,2056,1826,-10
51988931134,51988931137,3,1749,1574,-10
51989050030,51989050010,-20,1014,1083,-10
51990319750,51990319754,4,1093,1637,-10
51991574782,51991574787,5,1260,1079,-10
51991957891,51991957894,3,1534,1710,-10
51992089069,51992089071,2,1413,1758,-10
51992709473,51992709475,2,1225,1125,-10
51992743561,51992743562,1,1437,1782,-10
51993513341,51993513342,1,939,728,-10
51993701028,51993701029,1,1666,1271,-10
51995722663,51995722682,19,1070,3264,-10
51997706933,51997706935,2,1182,1272,-10
51998334833,51998334841,8,1242,908,-10
51999271681,51999271682,1,1486,1976,-10
52003301979,52003301983,4,1759,1442,-10
52003525665,52003525667,2,1356,1638,-10
52005850754,52005850758,4,1054,809,-10
52008564478,52008564481,3,1311,1649,-10
52009816006,52009816010,4,1275,1298,-10
52011495038,52011495044,6,3126,2224,-10
52012081062,52012081063,1,1371,1661,-10
52013342710,52013342712,2,1892,1258,-10
52017577565,52017577566,1,1672,1544,-10
52018022748,52018022751,3,1275,1281,-10
52019413423,52019413426,3,980,761,-10
52022915324,52022915327,3,1432,1397,-10
52023063569,52023063570,1,1679,1585,-10
52029986919,52029986913,-6,1572,6486,-10
52032067454,52032067457,3,1681,1521,-10
52032955746,52032955748,2,1481,2019,-10
52035884022,52035884024,2,1266,1282,-10
52043210542,52043210553,11,46,1726,-10
52045266396,52045266397,1,1959,1763,-10
52047477334,52047477330,-4,1235,1578,-10
52048020734,52048020739,5,1989,1580,-10
52051067057,52051067057,0,8604,9427,-10
52058619837,52058619817,-20,1150,2125,-10
52060472899,52060472896,-3,1354,1608,-10
52062675446,52062675447,1,1008,1083,-10
52064966257,52064966258,1,1272,1902,-10
52067216238,52067216239,1,943,1142,-10
52068900228,52068900231,3,1207,1558,-10
52069409875,52069409877,2,1925,1683,-10
52070944580,52070944582,2,1670,1803,-10
52073951710,52073951713,3,1751,1255,-10
52077619937,52077619937,0,1333,1789,-10
52077647654,52077647657,3,1059,1303,-10
52077929919,52077929899,-20,1080,131,-10
52078486633,52078486634,1,1749,1615,-10
52078626011,52078626013,2,1243,1684,-10
52079832479,52079832473,-6,26936,15823,-10
52080107597,52080107594,-3,1217,3113,-10
52083439198,52083439198,0,1817,1380,-10
52085308890,52085308890,0,2140,1403,-10
52091081081,52091081082,1,1762,1271,-10
52092413697,52092413689,-8,1744,4315,-10
52092903818,52092903821,3,972,1073,-10
52096787801,52096787805,4,1193,1345,-10
52096980757,52096980758,1,14911,14913,-10
52097467322,52097467324,2,1039,1910,-10
52099715740,52099715742,2,1203,1040,-10
52101060725,52101060726,1,1713,1629,-10
52102135830,52102135831,1,1963,1490,-10
52102515082,52102515084,2,1711,1310,-10
52102545271,52102545249,-22,713,622,-10
52105486958,52105486961,3,1200,1521,-10
52106859891,52106859895,4,1416,1502,-10
52107441133,52107441133,0,1869,1871,-10
52111751699,52111751699,0,1506,1965,-10
52114573492,52114573494,2,1815,1478,-10
52114603111,52114603111,0,1262,1699,-10
52117957809,52117957812,3,2305,1917,-10
52119149996,52119149996,0,1877,2593,-10
52120516739,52120516743,4,2438,1645,-10
52123268491,52123268494,3,1624,1752,-10
52127236069,52127236071,2,1628,1367,-10
52127790306,52127790309,3,1425,969,-10
52128319446,52128319450,4,1762,1704,-10
52129694207,52129694209,2,1901,1915,-10
52130299943,52130299944,1,2998,3484,-10
52131308756,52131308759,3,1277,1721,-10
52131838809,52131838811,2,681,803,-10
52133574862,52133574863,1,1761,1583,-10
52133705570,52133705574,4,2819,1281,-10
52134696489,52134696491,2,1065,1000,-10
52138903465,52138903468,3,1033,1633,-10
52141926951,52141926951,0,1846,2454,-10
52144445101,52144445101,0,1508,1743,-10
52145316203,52145316202,-1,1144,1119,-10
52147501645,52147501647,2,1663,1821,-10
52147973306,52147973311,5,1994,1149,-10
52148339445,52148339446,1,1667,1415,-10
52151164722,52151164725,3,2155,1862,-10
52152797306,52152797310,4,1967,1612,-10
52153781699,52153781701,2,1474,1753,-10
52155774386,52155774386,0,1371,1293,-10
52161356547,52161356551,4,1545,1284,-10
52161794295,52161794297,2,2103,1581,-10
52163716130,52163716131,1,1828,1781,-10
52165975881,52165975861,-20,1162,1295,-10
52166929674,52166929676,2,1549,1963,-10
52170680315,52170680309,-6,1101,3840,-10
52171124297,52171124301,4,1685,1474,-10
52171317106,52171317088,-18,1752,704,-10
52175088124,52175088125,1,2187,2041,-10
52175664524,52175664523,-1,1170,1794,-10
52179248837,52179248839,2,1300,1624,-10
52182109039,52182109035,-4,1158,2755,-10
52184349709,52184349712,3,2072,1630,-10
52185867875,52185867879,4,1499,1611,-10
52188548757,52188548757,0,1356,1459,-10
52191372821,52191372824,3,1518,1493,-10
52192283508,52192283510,2,1819,1536,-10
52193856741,52193856745,4,1709,1432,-10
52197683239,52197683242,3,1426,1434,-10
52199776090,52199776089,-1,1258,1403,-10
52205232098,52205232098,0,1935,2059,-10
52207037707,52207037710,3,1781,1587,-10
52215120113,52215120117,4,1594,1573,-10
52215222921,52215222922,1,881,1286,-10
52216106723,52216106726,3,1340,1503,-10
52216142382,52216142360,-22,1571,1604,-10
52216580039,52216580039,0,1479,1772,-10
52219129631,52219129634,3,1993,2055,-10
52220348086,52220348087,1,1408,1970,-10
52222991045,52222991047,2,656,1400,-10
52225912323,52225912324,1,2001,2251,-10
52226552029,52226552029,0,1358,1648,-10
52227432822,52227432825,3,2148,1415,-10
52234619065,52234619066,1,945,1594,-10
52234850127,52234850128,1,2036,1453,-10
52237154002,52237154005,3,1359,1079,-10
52237311546,52237311546,0,1129,1616,-10
52244102314,52244102309,-5,3255,14258,-10
52245071058,52245071062,4,1965,1500,-10
52246952357,52246952358,1,1549,1255,-10
52249681967,52249681967,0,1358,1162,-10
52249998190,52249998193,3,2043,2034,-10
52254295438,52254295441,3,2040,1628,-10
52258325641,52258325641,0,1319,1514,-10
52262071226,52262071226,0,1660,2057,-10
52267242259,52267242259,0,912,1279,-10
52270631253,52270631254,1,1840,1115,-10
52275558785,52275558787,2,1564,1450,-10
52279203330,52279203333,3,1607,1467,-10
52279342498,52279342506,8,3019,1489,-10
52282019475,52282019477,2,1101,1307,-10
52288197466,52288197477,11,18694,23693,-10
52290679073,52290679074,1,1715,1643,-10
52291861071,52291861072,1,1359,2193,-10
52293298399,52293298401,2,1982,1745,-10
52293668001,52293668002,1,1749,2122,-10
52296567750,52296567753,3,2139,1419,-10
52299501357,52299501359,2,1273,1257,-10
52304136273,52304136274,1,1750,1280,-10
52304400115,52304400116,1,1615,1563,-10
52305105823,52305105826,3,1518,1382,-10
52307017955,52307017957,2,1512,1499,-10
52309293698,52309293702,4,1429,1314,-10
52309790771,52309790771,0,1359,1603,-10
52318294671,52318294675,4,1555,1344,-10
52319559386,52319559389,3,1607,1442,-10
52321155655,52321155654,-1,1617,1424,-10
52321360165,52321360167,2,1479,1871,-10
52325621501,52325621502,1,1606,1564,-10
52330805285,52330805277,-8,881,1217,-10
52337363087,52337363086,-1,1819,1634,-10
52337451927,52337451921,-6,991,3735,-10
52338133174,52338133175,1,2014,2306,-10
52340811728,52340811729,1,1125,1398,-10
52345429839,52345429841,2,1368,1796,-10
52346247982,52346247983,1,1285,1848,-10
52348712487,52348712490,3,1558,1425,-10
52353776725,52353776733,8,12788,28130,-10
52355466528,52355466527,-1,1089,1181,-10
52358056648,52358056650,2,1785,1804,-10
52359629214,52359629215,1,1489,2267,-10
52363330040,52363330041,1,1957,1476,-10
52364182174,52364182174,0,1454,1420,-10
52364990365,52364990366,1,1927,1787,-10
52365214181,52365214183,2,1715,2074,-10
52365902098,52365902099,1,1429,1411,-10
52366833159,52366833159,0,1496,1782,-10
52368681058,52368681060,2,1646,1432,-10
52370044506,52370044505,-1,1563,1808,-10
52371234258,52371234258,0,1443,1384,-10
52371435719,52371435722,3,1779,1555,-10
52379228995,52379229001,6,1237,1430,-10
52379474135,52379474114,-21,1017,1223,-10
52380914182,52380914185,3,1539,1770,-10
52381118074,52381118077,3,1881,1585,-10
52382568177,52382568177,0,1795,1838,-10
52387599866,52387599867,1,1350,1766,-10
52389129726,52389129726,0,1422,1505,-10
52390563377,52390563399,22,1776,1317,-10
52392141958,52392141959,1,1606,1957,-10
52400267998,52400268000,2,1286,1326,-10
52404078728,52404078731,3,1678,1887,-10
52407636607,52407636609,2,1410,1501,-10
52407895793,52407895796,3,1602,1449,-10
52411591858,52411591860,2,1683,1347,-10
52413117018,52413117019,1,1702,1223,-10
52420160856,52420160858,2,1219,1243,-10
52422933020,52422933014,-6,1633,7987,-10
52424558918,52424558918,0,1268,1278,-10
52430228652,52430228652,0,2067,2241,-10
52434539515,52434539515,0,1028,1043,-10
52434813379,52434813383,4,2371,1704,-10
52435126361,52435126362,1,1559,2084,-10
52436825973,52436825978,5,1615,1347,-10
52439045014,52439045015,1,1394,1948,-10
52441948624,52441948625,1,1293,1598,-10
52442372038,52442372039,1,1793,1490,-10
52443192544,52443192546,2,2805,2950,-10
52444465095,52444465097,2,1666,1299,-10
52444691079,52444691081,2,1324,1413,-10
52445971669,52445971674,5,1443,1207,-10
52446758854,52446758857,3,1656,1642,-10
52447541905,52447541906,1,1444,2003,-10
52448212274,52448212275,1,1547,1308,-10
52450886002,52450886001,-1,1556,1535,-10
52453097106,52453097105,-1,2146,2886,-10
52454507411,52454507410,-1,962,1268,-10
52456433238,52456433238,0,826,848,-10
52457529562,52457529565,3,1049,1316,-10
52459148702,52459148703,1,1256,1207,-10
52463208666,52463208669,3,1374,1710,-10
52463591029,52463591030,1,2059,1771,-10
52464414717,52464414718,1,1397,1479,-10
52467138537,52467138537,0,2061,2021,-10
52467501473,52467501474,1,1138,1173,-10
52467529157,52467529158,1,2094,2283,-10
52468418430,52468418434,4,1366,1279,-10
52474111603,52474111603,0,1075,1932,-10
52475505089,52475505092,3,2158,1800,-10
52477050454,52477050457,3,1158,1549,-10
52482350146,52482350148,2,1408,1370,-10
52483868635,52483868634,-1,814,1491,-10
52484416962,52484416965,3,1943,1212,-10
52486276995,52486276996,1,1688,1299,-10
52486360989,52486360990,1,1751,1603,-10
52490052088,52490052089,1,2186,1968,-10
52493745663,52493745663,0,1378,1412,-10
52496482802,52496482803,1,1743,2304,-10
52496875992,52496875998,6,3185,1302,-10
52499842173,52499842177,4,1346,1115,-10
52502343271,52502343274,3,1399,1341,-10
52503233461,52503233462,1,2408,1319,-10
52503665366,52503665364,-2,1351,3016,-10
52510598591,52510598590,-1,2364,3234,-10
52513677746,52513677748,2,1828,1743,-10
52516697829,52516697829,0,934,1108,-10
52518072993,52518072993,0,1342,1654,-10
52520220526,52520220527,1,825,1745,-10
52520597191,52520597194,3,1841,1124,-10
52525468716,52525468718,2,5069,24144,-10
52531445979,52531445981,2,1716,1498,-10
52531524262,52531524243,-19,1385,1584,-10
52531860233,52531860237,4,1445,1445,-10
52532302038,52532302041,3,2182,1915,-10
52534023606,52534023608,2,1254,1381,-10
52535065965,52535065966,1,2007,1708,-10
52539739415,52539739417,2,1145,1040,-10
52539981900,52539981903,3,1299,1793,-10
52545813873,52545813874,1,1262,1798,-10
52546150382,52546150383,1,1032,1293,-10
52551731266,52551731267,1,1576,1339,-10
52552732403,52552732405,2,1238,1615,-10
52553207241,52553207242,1,1535,1081,-10
52554533736,52554533737,1,2037,1610,-10
52556793318,52556793323,5,4304,2617,-10
52557030051,52557030053,2,975,1043,-10
52557533478,52557533481,3,1723,1597,-10
52558979834,52558979836,2,1412,1232,-10
52561149297,52561149314,17,1123,1536,-10
52562208954,52562208954,0,1142,2100,-10
52564074340,52564074346,6,4555,1323,-10
52574419271,52574419270,-1,1746,2726,-10
52574641465,52574641467,2,1427,1548,-10
52576146214,52576146214,0,1542,1226,-10
52579222154,52579222155,1,1426,1743,-10
52582871808,52582871811,3,1366,1377,-10
52583327530,52583327530,0,1208,1657,-10
52584190645,52584190646,1,1919,1747,-10
52586146508,52586146511,3,1127,1559,-10
52588776350,52588776354,4,735,606,-10
52590800217,52590800221,4,1618,1615,-10
52592875342,52592875344,2,1940,1202,-10
52597210715,52597210716,1,921,1158,-10
52604993698,52604993701,3,2206,2014,-10
52605860454,52605860458,4,1417,1407,-10
52606322973,52606322974,1,1695,1453,-10
52607095878,52607095877,-1,1243,1193,-10
52609195769,52609195770,1,1330,1547,-10
52609382157,52609382162,5,1561,1463,-10
52611443326,52611443328,2,1803,1562,-10
52613349759,52613349762,3,1832,1458,-10
52613465882,52613465884,2,1424,1179,-10
52613798390,52613798393,3,1577,1365,-10
52617204715,52617204718,3,1474,1329,-10
52617809959,52617809971,12,10704,32657,-10
52617918203,52617918206,3,1165,1280,-10
52618601784,52618601784,0,1941,2139,-10
52619716971,52619716974,3,1840,1696,-10
52621241901,52621241905,4,1110,1711,-10
52621858777,52621858773,-4,917,2124,-10
52624175819,52624175823,4,1219,1058,-10
52626381106,52626381109,3,1138,1261,-10
52629990491,52629990492,1,1367,1785,-10
52631338586,52631338587,1,1752,1516,-10
52633332591,52633332593,2,1607,1907,-10
52634859729,52634859731,2,1552,1256,-10
52638470977,52638470981,4,1892,2105,-10
52641017323,52641017323,0,1334,1747,-10
52641431930,52641431932,2,1865,1572,-10
52642912001,52642912003,2,1509,1566,-10
52646118753,52646118755,2,1390,1929,-10
52646288522,52646288523,1,1631,1447,-10
52651960852,52651960854,2,1302,2123,-10
52653557760,52653557762,2,1816,1823,-10
52654844808,52654844798,-10,1678,1506,-10
52657529711,52657529712,1,1409,1093,-10
52658725875,52658725874,-1,1569,1593,-10
52660352166,52660352169,3,1104,1401,-10
52661564457,52661564457,0,977,758,-10
52665998205,52665998210,5,1169,1259,-10
52668390633,52668390631,-2,1545,1929,-10
52669037590,52669037592,2,1975,1920,-10
52669283764,52669283767,3,1905,1892,-10
52673782037,52673782038,1,1235,1354,-10
52675975809,52675975810,1,1058,1368,-10
52676992735,52676992716,-19,1710,1208,-10
52678913932,52678913954,22,1667,1470,-10
52680511981,52680511983,2,1700,1297,-10
52682214599,52682214601,2,2055,2051,-10
52686380751,52686380754,3,1686,1124,-10
52689333603,52689333604,1,1658,1816,-10
52689543430,52689543433,3,1368,1495,-10
52690051017,52690051019,2,1231,1392,-10
52695696255,52695696258,3,1539,1702,-10
52699946709,52699946710,1,1909,1477,-10
52701749138,52701749138,0,1181,1628,-10
52702012330,52702012334,4,1735,1511,-10
52704143621,52704143622,1,772,1218,-10
52708282955,52708282965,10,36251,76099,-10
52709608474,52709608469,-5,1009,2975,-10
52710220505,52710220509,4,1846,2039,-10
52710664622,52710664621,-1,1410,1696,-10
52716615455,52716615459,4,1913,1096,-10
52717971209,52717971210,1,1315,1688,-10
52719890682,52719890677,-5,1060,2873,-10
52720247300,52720247301,1,1481,1577,-10
52723866602,52723866603,1,1960,1330,-10
52724041270,52724041271,1,1381,1163,-10
52725441062,52725441064,2,1153,1525,-10
52725655580,52725655583,3,1316,1056,-10
52727450875,52727450874,-1,1065,1759,-10
52729225093,52729225094,1,1371,2067,-10
52730059622,52730059622,0,1377,1554,-10
52730169299,52730169302,3,1200,1017,-10
52730492383,52730492382,-1,4271,7480,-10
52733307420,52733307426,6,2547,1064,-10
52737187456,52737187459,3,2175,913,-10
52738728586,52738728588,2,2191,2402,-10
52742107350,52742107352,2,1682,2226,-10
52744026103,52744026106,3,1888,1597,-10
52744451005,52744451026,21,1344,1623,-10
52747972318,52747972321,3,1354,1681,-10
52748489535,52748489538,3,1943,1503,-10
52751033962,52751033965,3,1905,2032,-10
52752489557,52752489560,3,2089,2769,-10
52755735029,52755735031,2,1576,1924,-10
52756745637,52756745638,1,1921,1952,-10
52757388175,52757388175,0,860,1178,-10
52762904851,52762904853,2,2027,1093,-10
52767242221,52767242227,6,1314,1296,-10
52768175244,52768175252,8,1290,1361,-10
52769909998,52769909998,0,1307,1493,-10
52774168174,52774168173,-1,1474,1735,-10
52775192302,52775192302,0,1790,1791,-10
52777689123,52777689122,-1,1310,1709,-10
52779191853,52779191857,4,2389,1973,-10
52781287959,52781287960,1,1366,1223,-10
52781856167,52781856169,2,2456,1736,-10
52783762890,52783762893,3,2092,1957,-10
52786820321,52786820325,4,1855,2179,-10
52787636192,52787636191,-1,1258,2863,-10
52787678848,52787678851,3,1375,1599,-10
52791055137,52791055138,1,1798,1635,-10
52791132043,52791132047,4,2383,1541,-10
52799052634,52799052637,3,2064,1991,-10
52806461790,52806461790,0,1552,1630,-10
52811660397,52811660399,2,2187,1775,-10
52812192958,52812192962,4,1250,903,-10
52818519715,52818519717,2,2373,1698,-10
52822723325,52822723326,1,1261,1243,-10
52824622144,52824622145,1,1360,1726,-10
52825629510,52825629512,2,1302,1756,-10
52825723700,52825723702,2,2101,1721,-10
52827571303,52827571306,3,1749,1254,-10
52829742318,52829742312,-6,1670,5493,-10
52832052360,52832052361,1,1540,1492,-10
52832806337,52832806338,1,1449,1076,-10
52835050908,52835050910,2,953,1344,-10
52840598257,52840598257,0,1757,2463,-10
52841377341,52841377342,1,1260,1348,-10
52849250526,52849250530,4,1472,1844,-10
52849759502,52849759502,0,1558,1308,-10
52850528094,52850528099,5,1360,1161,-10
52851641586,52851641589,3,1330,1426,-10
52852143773,52852143775,2,1964,1499,-10
52853925710,52853925711,1,1769,1954,-10
52855083706,52855083708,2,1739,1999,-10
52855284578,52855284563,-15,1329,1141,-10
52857296121,52857296123,2,1810,1707,-10
52860776065,52860776068,3,1714,1677,-10
52862173824,52862173825,1,1822,1758,-10
52862444459,52862444458,-1,1098,1082,-10
52866067165,52866067169,4,1658,1009,-10
52867727705,52867727706,1,1665,1167,-10
52868555421,52868555422,1,1210,1553,-10
52870249271,52870249268,-3,2254,4410,-10
52876125571,52876125576,5,963,958,-10
52881180583,52881180583,0,1086,1032,-10
52881504167,52881504167,0,729,894,-10
52882755086,52882755087,1,3522,3251,-10
52883977241,52883977241,0,1336,1233,-10
52884094616,52884094619,3,2038,1652,-10
52887551517,52887551520,3,2004,2078,-10
52888742062,52888742066,4,2421,1796,-10
52891550850,52891550853,3,1756,1641,-10
52892357577,52892357579,2,2026,1963,-10
52893533445,52893533449,4,2743,1571,-10
52893980437,52893980438,1,1777,1431,-10
52894739947,52894739950,3,1833,1904,-10
52894962293,52894962296,3,1156,1411,-10
52895835303,52895835304,1,1160,1750,-10
52900038369,52900038370,1,1266,1662,-10
52902543869,52902543870,1,1617,1713,-10
52904321918,52904321932,14,1591,1622,-10
52906693123,52906693126,3,1213,1395,-10
52909804639,52909804652,13,1530,1208,-10
52911964961,52911964969,8,1230,602,-10
52913213887,52913213886,-1,1755,1048,-10
52918433853,52918433855,2,1641,1225,-10
52921447481,52921447481,0,1767,2054,-10
52927482594,52927482598,4,1896,1498,-10
52930181037,52930181039,2,990,1279,-10
52939044318,52939044319,1,1499,1627,-10
52941774794,52941774794,0,1358,1716,-10
52944326337,52944326339,2,1413,1384,-10
52945046534,52945046534,0,1378,1583,-10
52945776291,52945776293,2,943,1131,-10
52948461328,52948461330,2,1417,1808,-10
52953919323,52953919322,-1,1773,1467,-10
52957649355,52957649356,1,1448,1326,-10
52959700314,52959700315,1,1390,1276,-10
52961171703,52961171705,2,930,1850,-10
52964500300,52964500306,6,1344,1024,-10
52966636805,52966636807,2,1844,1189,-10
52966930074,52966930074,0,2713,1936,-10
52968936159,52968936158,-1,1302,1233,-10
52973127578,52973127581,3,1477,1728,-10
52973452779,52973452779,0,1676,1268,-10
52975716523,52975716526,3,1399,1447,-10
52976477367,52976477369,2,823,1091,-10
52977260769,52977260767,-2,1171,1683,-10
52977952036,52977952042,6,2334,1359,-10
52979197789,52979197790,1,1974,1652,-10
52980813867,52980813869,2,1143,1239,-10
52981449578,52981449578,0,1525,1227,-10
52985549004,52985549004,0,1389,1120,-10
52987928851,52987928858,7,5434,2031,-10
52988311768,52988311779,11,1608,1355,-10
52991967546,52991967546,0,2745,2205,-10
52992214947,52992214946,-1,951,2373,-10
52994326090,52994326090,0,1599,2147,-10
52995134585,52995134587,2,1983,1717,-10
52998125358,52998125358,0,1551,1858,-10
52998369163,52998369171,8,7047,34954,-10
53000226396,53000226399,3,1141,869,-10
53003220194,53003220195,1,1340,2011,-10
53008306802,53008306807,5,1228,361,-10
53008910144,53008910140,-4,1375,166,-10
53010293856,53010293866,10,1608,1418,-10
53014484679,53014484681,2,2071,1257,-10
53014957514,53014957515,1,2078,2098,-10
53015801958,53015801960,2,12745,19086,-10
53017539801,53017539795,-6,1290,4085,-10
53022219830,53022219833,3,1070,1812,-10
53022261856,53022261859,3,1609,1709,-10
53024502054,53024502059,5,2145,1409,-10
53026478958,53026478958,0,1578,1817,-10
53028486523,53028486525,2,1352,1460,-10
53028548815,53028548818,3,1038,1255,-10
53029375482,53029375483,1,1032,1439,-10
53030703971,53030703978,7,3453,901,-10
53033799479,53033799477,-2,1279,1881,-10
53034612464,53034612465,1,1407,1567,-10
53034937318,53034937325,7,1521,1189,-10
53035480030,53035480030,0,1022,1682,-10
53037958790,53037958794,4,1198,1213,-10
53038697393,53038697394,1,2314,1749,-10
53049890653,53049890654,1,1646,1302,-10
53053376817,53053376819,2,1214,1497,-10
53054171502,53054171483,-19,1355,1734,-10
53058642341,53058642344,3,1673,1804,-10
53058981654,53058981650,-4,576,2076,-10
53060633757,53060633760,3,1739,1694,-10
53063075513,53063075514,1,1025,1728,-10
53065149866,53065149867,1,1441,1803,-10
53065449873,53065449874,1,1155,874,-10
53067704411,53067704415,4,1524,953,-10
53070531356,53070531354,-2,1595,3141,-10
53073453328,53073453331,3,1326,1443,-10
53074301482,53074301484,2,1695,1435,-10
53075443510,53075443511,1,1642,1846,-10
53076112058,53076112062,4,1472,1587,-10
53079888146,53079888148,2,1536,1913,-10
53080733345,53080733337,-8,1100,1449,-10
53083467723,53083467726,3,2058,1521,-10
53083775661,53083775666,5,2076,1149,-10
53086411771,53086411773,2,1681,1464,-10
53086531906,53086531910,4,1742,1369,-10
53086687348,53086687350,2,1675,1875,-10
53089206944,53089206946,2,1795,2000,-10
53092424467,53092424468,1,1141,1237,-10
53096063599,53096063598,-1,1908,1631,-10
53096594461,53096594459,-2,1300,2344,-10
53101664017,53101664022,5,2861,1517,-10
53113251554,53113251556,2,2535,2001,-10
53113990687,53113990690,3,1938,1807,-10
53116946127,53116946130,3,1670,1724,-10
53118475548,53118475534,-14,5784,40838,-10
53119325010,53119325014,4,1721,1414,-10
53123295351,53123295356,5,1638,836,-10
53125695767,53125695767,0,1372,1708,-10
53126202064,53126202064,0,1762,2383,-10
53129619498,53129619497,-1,1307,1915,-10
53132669117,53132669122,5,840,1007,-10
53133078867,53133078869,2,2304,1936,-10
53138018027,53138018030,3,1466,2199,-10
53140254706,53140254708,2,1491,1590,-10
53144398660,53144398662,2,1560,1563,-10
53148394286,53148394286,0,1363,1552,-10
53149347641,53149347642,1,1609,1357,-10
53149969974,53149969982,8,8065,2362,-10
53150327814,53150327815,1,2039,2086,-10
53150372347,53150372348,1,1462,1655,-10
53152768593,53152768594,1,995,900,-10
53153496087,53153496088,1,1456,1384,-10
53154029625,53154029604,-21,2037,1180,-10
53154821797,53154821798,1,1598,1648,-10
53157255050,53157255055,5,1198,1084,-10
53160022083,53160022087,4,3136,2270,-10
53160086462,53160086463,1,1799,2336,-10
53160232217,53160232219,2,1034,1033,-10
53165215930,53165215932,2,1017,1073,-10
53166943882,53166943885,3,1298,1576,-10
53170553254,53170553253,-1,1703,2002,-10
53170605556,53170605558,2,1454,1601,-10
53171219608,53171219609,1,1524,1226,-10
53171811140,53171811142,2,1461,1918,-10
53177628268,53177628270,2,1906,1800,-10
53179628724,53179628724,0,1312,1692,-10
53182831733,53182831733,0,956,1359,-10
53183138026,53183138027,1,1911,1568,-10
53183949477,53183949480,3,1246,1269,-10
53184700357,53184700357,0,1402,1872,-10
53187694522,53187694525,3,2300,1770,-10
53188000114,53188000116,2,1605,1874,-10
53189703562,53189703565,3,821,948,-10
53189968737,53189968739,2,645,1394,-10
53194244958,53194244953,-5,1351,3947,-10
53194312643,53194312643,0,932,933,-10
53195802285,53195802284,-1,1730,2239,-10
53198226547,53198226550,3,1635,1473,-10
53202887162,53202887162,0,1505,1598,-10
53203703987,53203703987,0,1862,2638,-10
53206098182,53206098182,0,1569,1294,-10
53209258294,53209258308,14,1189,1299,-10
53210030014,53210029996,-18,766,485,-10
53212109661,53212109662,1,1671,1594,-10
53214842373,53214842375,2,1808,1207,-10
53220817282,53220817283,1,1250,1618,-10
53224744381,53224744384,3,1364,1246,-10
53227773437,53227773439,2,1257,1283,-10
53228508262,53228508265,3,1635,1838,-10
53230616447,53230616428,-19,1159,1405,-10
53231463560,53231463569,9,1506,1738,-10
53237837974,53237837969,-5,1375,4924,-10
53238325237,53238325238,1,1094,1708,-10
53244788787,53244788787,0,1214,1193,-10
53245359058,53245359059,1,1540,1748,-10
53246929090,53246929092,2,1476,1561,-10
53247193160,53247193163,3,881,1755,-10
53249570258,53249570259,1,2096,1856,-10
53251435813,53251435818,5,1959,1054,-10
53252144749,53252144753,4,1830,1500,-10
53253439262,53253439263,1,1204,2016,-10
53253690355,53253690355,0,1186,1058,-10
53254549466,53254549473,7,3462,1271,-10
53254838812,53254838813,1,1745,1984,-10
53254921297,53254921302,5,1540,1396,-10
53260458774,53260458775,1,1450,1555,-10
53265198712,53265198710,-2,1339,2310,-10
53266314096,53266314098,2,1657,1443,-10
53270704569,53270704576,7,7354,2709,-10
53270756511,53270756513,2,985,1160,-10
53271859933,53271859934,1,2305,2424,-10
53272896315,53272896311,-4,695,1089,-10
53273788482,53273788482,0,1494,1236,-10
53278310058,53278310060,2,1939,2174,-10
53282461590,53282461591,1,1223,1478,-10
53285256362,53285256363,1,1034,1404,-10
53286888293,53286888296,3,1167,1434,-10
53287927763,53287927763,0,1796,2116,-10
53291390129,53291390131,2,1210,1464,-10
53293433182,53293433185,3,1946,1158,-10
53295109102,53295109102,0,1483,1577,-10
53295690959,53295690958,-1,1548,1766,-10
53296641074,53296641076,2,1384,1424,-10
53298229975,53298229977,2,1522,1438,-10
53301472522,53301472523,1,1491,1748,-10
53302463930,53302463933,3,1283,1434,-10
53303764983,53303764962,-21,1192,886,-10
53305677295,53305677297,2,2476,2444,-10
53310569589,53310569592,3,1147,1093,-10
53312701350,53312701351,1,1596,1740,-10
53316660430,53316660433,3,1173,1451,-10
53318195459,53318195465,6,2145,1525,-10
53318951577,53318951581,4,1587,1058,-10
53324433572,53324433573,1,1157,1872,-10
53325928257,53325928258,1,788,1386,-10
53327320864,53327320869,5,1947,1300,-10
53329185906,53329185912,6,2130,1666,-10
53329405878,53329405879,1,1751,1594,-10
53331525020,53331525023,3,1698,1291,-10
53332192336,53332192338,2,1396,1255,-10
53332935934,53332935935,1,1418,1629,-10
53333229165,53333229169,4,1578,1171,-10
53335080026,53335080029,3,2030,1328,-10
53335746066,53335746069,3,1298,1109,-10
53336840395,53336840397,2,1462,1560,-10
53339715194,53339715195,1,1720,1379,-10
53340524338,53340524339,1,1938,1253,-10
53342138351,53342138352,1,1376,1412,-10
53342212038,53342212039,1,1770,1740,-10
53344157093,53344157074,-19,962,1038,-10
53347256250,53347256251,1,1463,1290,-10
53350682723,53350682725,2,1274,994,-10
53355176482,53355176485,3,973,1427,-10
53357415862,53357415864,2,1135,1324,-10
53358799324,53358799323,-1,2143,1928,-10
53359056495,53359056498,3,1159,1546,-10
53359578521,53359578539,18,402,892,-10
53360851950,53360851949,-1,1630,1411,-10
53362778903,53362778905,2,1218,1610,-10
53363939400,53363939401,1,1317,1712,-10
53364771237,53364771239,2,1360,1228,-10
53367493635,53367493639,4,880,1366,-10
53369569165,53369569169,4,1997,1672,-10
53372596993,53372596994,1,1586,1718,-10
53375327605,53375327605,0,1555,1828,-10
53376570483,53376570479,-4,1896,5085,-10
53378549414,53378549419,5,1612,1457,-10
53381292402,53381292406,4,2379,1744,-10
53381731150,53381731153,3,2427,1887,-10
53382182170,53382182170,0,1397,1401,-10
53382313363,53382313366,3,1980,1902,-10
53382592176,53382592179,3,1155,1724,-10
53384627081,53384627081,0,2123,2210,-10
53387723682,53387723683,1,1331,1103,-10
53388866223,53388866226,3,1400,1466,-10
53391955966,53391955971,5,1225,692,-10
53395231099,53395231102,3,1955,2267,-10
53397262102,53397262102,0,1237,1341,-10
53397580587,53397580590,3,1858,1946,-10
53398694247,53398694250,3,1709,1580,-10
53399684166,53399684167,1,1222,1077,-10
53400560165,53400560167,2,1856,1835,-10
53402474477,53402474478,1,1470,1457,-10
53402679247,53402679250,3,637,929,-10
53405848242,53405848242,0,1261,1564,-10
53407450881,53407450885,4,1934,1436,-10
53410659970,53410659970,0,1173,1404,-10
53411775245,53411775246,1,1228,1591,-10
53412081576,53412081579,3,1894,1367,-10
53415715045,53415715047,2,2084,1505,-10
53426291547,53426291550,3,813,1256,-10
53427886139,53427886139,0,1722,1659,-10
53430842529,53430842532,3,1329,1671,-10
53431891042,53431891043,1,1774,1445,-10
53432187710,53432187711,1,2048,959,-10
53435029772,53435029774,2,2989,2670,-10
53435907980,53435907982,2,1942,2196,-10
53440379489,53440379495,6,818,796,-10
53441970093,53441970097,4,1747,1243,-10
53442493507,53442493511,4,1122,1070,-10
53445830442,53445830443,1,1647,1305,-10
53446372957,53446372959,2,1439,1109,-10
53446875501,53446875496,-5,1665,3820,-10
53448475143,53448475145,2,1128,1204,-10
53448789482,53448789483,1,915,1071,-10
53453280673,53453280676,3,1552,1296,-10
53455561851,53455561853,2,1708,1361,-10
53457530286,53457530290,4,2159,1717,-10
53458020057,53458020058,1,1495,1244,-10
53467889487,53467889489,2,1206,1460,-10
53470987818,53470987818,0,1176,1274,-10
53484443010,53484443015,5,2383,851,-10
53486384881,53486384884,3,1118,1131,-10
53489493572,53489493574,2,1236,1026,-10
53492387540,53492387542,2,1724,2063,-10
53492474068,53492474069,1,1884,2302,-10
53494782027,53494782026,-1,1998,1826,-10
53498186989,53498186991,2,1406,1817,-10
53499338101,53499338103,2,1587,1117,-10
53499989130,53499989132,2,1688,1969,-10
53500131360,53500131362,2,1218,1247,-10
53501745421,53501745421,0,971,1461,-10
53509628950,53509628952,2,1857,1673,-10
53509932551,53509932552,1,1304,1479,-10
53510490737,53510490757,20,986,2719,-10
53512247346,53512247346,0,1392,1083,-10
53513349440,53513349442,2,2248,1390,-10
53516327318,53516327319,1,1726,1751,-10
53517099084,53517099087,3,1068,790,-10
53521590243,53521590245,2,1256,1519,-10
53531876218,53531876218,0,1590,1384,-10
53533811065,53533811066,1,1557,1301,-10
53534627907,53534627910,3,1207,1507,-10
53538338048,53538338048,0,1848,1684,-10
53539400098,53539400100,2,1559,2186,-10
53539813591,53539813574,-17,943,1375,-10
53541749509,53541749510,1,1627,1619,-10
53546620811,53546620815,4,2332,1569,-10
53547412004,53547412002,-2,1234,1702,-10
53549143734,53549143733,-1,1429,1752,-10
53554044199,53554044202,3,1135,1269,-10
53558390635,53558390638,3,1595,1248,-10
53559339537,53559339539,2,1428,1298,-10
53560313682,53560313685,3,1481,1843,-10
53562236755,53562236758,3,1974,983,-10
53562361422,53562361432,10,1640,1529,-10
53566308129,53566308133,4,2419,1497,-10
53566606934,53566606938,4,2178,1889,-10
53566802765,53566802767,2,1839,1829,-10
53567934921,53567934925,4,1743,1491,-10
53569502142,53569502143,1,1052,1360,-10
53571880114,53571880115,1,1791,1405,-10
53573947378,53573947377,-1,1685,1432,-10
53574694129,53574694130,1,1602,2008,-10
53575656039,53575656042,3,1195,1318,-10
53577068565,53577068566,1,1220,897,-10
53581942643,53581942644,1,812,1021,-10
53584343350,53584343352,2,1331,1342,-10
53586395629,53586395629,0,1290,1204,-10
53591272365,53591272366,1,1361,1461,-10
53596262154,53596262157,3,1841,1712,-10
53597652808,53597652812,4,2335,1945,-10
53597871095,53597871097,2,1754,1565,-10
53599430453,53599430454,1,1498,1839,-10
53599612972,53599612991,19,826,632,-10
53601812430,53601812434,4,1877,1469,-10
53602696085,53602696088,3,1360,1294,-10
53603641470,53603641473,3,1621,1940,-10
53604962297,53604962299,2,1833,1909,-10
53606677010,53606677013,3,1376,1351,-10
53607236491,53607236490,-1,1542,2126,-10
53619089841,53619089841,0,1382,1130,-10
53620196768,53620196770,2,1506,1170,-10
53620765151,53620765151,0,1093,1751,-10
53620972021,53620972023,2,1844,1370,-10
53621114479,53621114458,-21,930,747,-10
53621985242,53621985245,3,1532,1436,-10
53623974914,53623974909,-5,1227,1950,-10
53624735546,53624735543,-3,835,1992,-10
53625402958,53625402961,3,1657,1541,-10
53629317208,53629317210,2,1694,1731,-10
53633909691,53633909686,-5,1378,4436,-10
53634500262,53634500263,1,1284,1401,-10
53636904516,53636904535,19,1406,964,-10
53637510309,53637510302,-7,1326,5462,-10
53637656406,53637656409,3,1232,1346,-10
53638128106,53638128109,3,1988,1479,-10
53640338146,53640338147,1,2091,2098,-10
53641691661,53641691662,1,1217,1095,-10
53644601966,53644601967,1,1908,1546,-10
53646272522,53646272525,3,7772,5431,-10
53647516362,53647516364,2,1711,1653,-10
53649146758,53649146761,3,1375,1649,-10
53649728698,53649728702,4,1093,1566,-10
53652584071,53652584075,4,994,1301,-10
53653154525,53653154525,0,1274,1645,-10
53655134745,53655134747,2,1646,1587,-10
53656745114,53656745114,0,1246,1560,-10
53658340011,53658340010,-1,1192,1592,-10
53659070182,53659070185,3,1367,1191,-10
53660618217,53660618211,-6,1360,1172,-10
53662440762,53662440765,3,1508,2107,-10
53662643099,53662643103,4,1886,931,-10
53663970262,53663970263,1,1616,1866,-10
53664783140,53664783141,1,1923,2248,-10
53665372823,53665372825,2,2262,2440,-10
53665857076,53665857078,2,948,1449,-10
53667743633,53667743633,0,1099,1418,-10
53671377677,53671377678,1,1247,1621,-10
53672799132,53672799135,3,2163,1807,-10
53674115059,53674115063,4,1119,898,-10
53682763848,53682763851,3,1839,1127,-10
53687487378,53687487382,4,1053,883,-10
53688416962,53688416966,4,1614,1471,-10
53689723858,53689723860,2,1574,2250,-10
53691096777,53691096779,2,1228,1701,-10
53691685451,53691685453,2,1536,1601,-10
53695979329,53695979329,0,1187,1554,-10
53697219780,53697219783,3,2070,1340,-10
53708166283,53708166285,2,1636,1474,-10
53710609119,53710609120,1,1662,2046,-10
53711946807,53711946808,1,1018,1869,-10
53714350391,53714350391,0,1325,1111,-10
53715691627,53715691630,3,1194,868,-10
53716690825,53716690827,2,2340,2185,-10
53717393381,53717393384,3,1642,1437,-10
53721041691,53721041687,-4,1553,5018,-10
53722283038,53722283039,1,1214,1042,-10
53723296271,53723296271,0,1406,1520,-10
53725037030,53725037031,1,1200,1522,-10
53725533979,53725533985,6,2387,1521,-10
53725591535,53725591535,0,1486,2069,-10
53727862738,53727862741,3,1518,1870,-10
53730780481,53730780483,2,1505,1504,-10
53731952737,53731952739,2,1289,1119,-10
53734755045,53734755047,2,1336,1986,-10
53738120869,53738120874,5,1712,1153,-10
53739500143,53739500142,-1,2016,1704,-10
53744363392,53744363393,1,1386,1554,-10
53746080890,53746080872,-18,1823,1491,-10
53746703777,53746703781,4,1277,1517,-10
53748455378,53748455382,4,1214,1137,-10
53748628073,53748628075,2,1908,1537,-10
53750997275,53750997278,3,1389,1348,-10
53752338652,53752338652,0,1761,1394,-10
53753414755,53753414758,3,1189,939,-10
53753501147,53753501149,2,1557,1604,-10
53757113767,53757113771,4,2051,1418,-10
53758969924,53758969924,0,1249,1800,-10
53772985306,53772985306,0,766,1413,-10
53774412382,53774412383,1,1502,1738,-10
53774634594,53774634594,0,2337,3358,-10
53776641068,53776641070,2,1423,2016,-10
53777364227,53777364227,0,1174,1284,-10
53781730528,53781730538,10,1828,1619,-10
53783656678,53783656679,1,1783,1948,-10
53784281391,53784281394,3,1582,1452,-10
53788348516,53788348516,0,1585,1373,-10
53789143311,53789143309,-2,1001,1917,-10
53791074538,53791074540,2,1720,1161,-10
53795455321,53795455322,1,2921,2465,-10
53795743506,53795743507,1,1728,1858,-10
53800727747,53800727751,4,2219,2244,-10
53801749377,53801749376,-1,1517,2019,-10
53803323839,53803323837,-2,1356,2305,-10
53803772202,53803772205,3,1519,1329,-10
53806879344,53806879346,2,1505,1353,-10
53814425782,53814425785,3,1664,1594,-10
53817006295,53817006297,2,3506,3314,-10
53817327267,53817327270,3,1996,1694,-10
53824747199,53824747200,1,1984,1387,-10
53828341583,53828341586,3,1848,1902,-10
53828985937,53828985941,4,1536,1602,-10
53830953905,53830953908,3,1658,1471,-10
53834088428,53834088430,2,1258,1071,-10
53836803171,53836803172,1,1502,1336,-10
53837611603,53837611605,2,1656,2024,-10
53843939038,53843939040,2,1613,1580,-10
53847253793,53847253795,2,1875,1558,-10
53850475134,53850475138,4,2068,1678,-10
53851531897,53851531898,1,1613,1905,-10
53854204331,53854204331,0,1188,1669,-10
53856471662,53856471667,5,1852,1506,-10
53857261016,53857261015,-1,1334,1627,-10
53858911528,53858911529,1,1241,1059,-10
53859397849,53859397850,1,1591,1498,-10
53862247817,53862247833,16,2815,1520,-10
53864856694,53864856697,3,1042,1251,-10
53867612938,53867612941,3,1736,1702,-10
53867751462,53867751441,-21,1935,1594,-10
53870501090,53870501094,4,1027,1378,-10
53871944431,53871944435,4,2451,1553,-10
53872059101,53872059080,-21,2678,955,-10
53872579425,53872579426,1,1662,1591,-10
53877559316,53877559318,2,1386,1482,-10
53881862058,53881862058,0,1752,1671,-10
53885378930,53885378931,1,1845,1578,-10
53885804397,53885804398,1,2365,1758,-10
53889796118,53889796119,1,1884,1567,-10
53890889455,53890889457,2,1845,1437,-10
53895448393,53895448393,0,1005,1700,-10
53897373029,53897373034,5,4971,2463,-10
53897974430,53897974431,1,1810,3196,-10
53898637422,53898637425,3,1454,1780,-10
53906748528,53906748530,2,1994,1406,-10
53907743503,53907743505,2,1182,1409,-10
53909254182,53909254184,2,1402,1230,-10
53911661613,53911661613,0,1465,1348,-10
53914281210,53914281213,3,1096,1485,-10
53921055047,53921055048,1,1371,1513,-10
53922731938,53922731938,0,1423,1606,-10
53923133774,53923133774,0,1720,1387,-10
53923533424,53923533426,2,1344,1298,-10
53923796029,53923796030,1,1395,1726,-10
53927606965,53927606967,2,1338,1410,-10
53928842866,53928842867,1,1140,1472,-10
53933345628,53933345630,2,1506,1178,-10
53935826249,53935826251,2,1849,1934,-10
53937373585,53937373587,2,1603,1704,-10
53939019379,53939019384,5,1900,1611,-10
53939110421,53939110422,1,1469,1833,-10
53942214862,53942214862,0,1481,1306,-10
53943852164,53943852166,2,1806,1677,-10
53946299478,53946299482,4,1721,1397,-10
53946541110,53946541091,-19,1318,1408,-10
53950713485,53950713487,2,1604,1683,-10
53953722598,53953722600,2,1755,1842,-10
53958832869,53958832872,3,1053,1889,-10
53960818698,53960818698,0,1464,1765,-10
53962814104,53962814106,2,1303,1553,-10
53964439442,53964439444,2,1482,1350,-10
53966726585,53966726589,4,4171,2366,-10
53969383763,53969383765,2,1342,1437,-10
53971610581,53971610577,-4,1475,5338,-10
53977882458,53977882452,-6,1344,3527,-10
53979063426,53979063431,5,1529,1901,-10
53981338739,53981338741,2,1343,1530,-10
53985126137,53985126133,-4,697,1683,-10
53985910354,53985910354,0,1504,1966,-10
53986306299,53986306301,2,1266,1632,-10
53987428997,53987428999,2,1653,2001,-10
53987558551,53987558554,3,1396,1278,-10
53991231177,53991231180,3,1214,1865,-10
53992295918,53992295922,4,1457,1213,-10
53994954496,53994954497,1,2414,2994,-10
53995925692,53995925694,2,1839,1828,-10
53998034350,53998034350,0,1785,1361,-10
54002424378,54002424376,-2,1396,2514,-10
54010111626,54010111629,3,1517,1845,-10
54013001350,54013001352,2,1547,1980,-10
54013200324,54013200327,3,1921,1532,-10
54016503302,54016503303,1,1431,1634,-10
54021314993,54021314994,1,1376,1457,-10
54024119017,54024119018,1,1702,1567,-10
54024760463,54024760467,4,2118,1396,-10
54025003394,54025003394,0,1405,1477,-10
54025060118,54025060120,2,1920,1256,-10
54026695622,54026695625,3,1582,1098,-10
54027750043,54027750063,20,821,867,-10
54040068762,54040068765,3,951,220,-10
54043366218,54043366219,1,1463,1361,-10
54049110911,54049110912,1,1184,1892,-10
54049320149,54049320154,5,1374,1287,-10
54054095167,54054095169,2,1362,1440,-10
54055084912,54055084916,4,1452,1146,-10
54058768849,54058768849,0,2451,3743,-10
54058881520,54058881523,3,1593,1952,-10
54066677930,54066677931,1,558,700,-10
54068340126,54068340129,3,1731,1072,-10
54069054933,54069054935,2,1870,1708,-10
54072318200,54072318206,6,3095,1333,-10
54075060404,54075060401,-3,1091,1895,-10
54076049611,54076049630,19,754,4256,-10
54076679139,54076679140,1,1661,1283,-10
54078532818,54078532826,8,1061,1217,-10
54078588846,54078588867,21,859,1022,-10
54079165487,54079165488,1,1789,1799,-10
54090570173,54090570175,2,1719,1834,-10
54091837307,54091837306,-1,651,2098,-10
54094190022,54094190025,3,1356,1551,-10
54094492421,54094492423,2,1406,1336,-10
54097450747,54097450749,2,1507,1498,-10
54099524738,54099524740,2,5815,17656,-10
54106025054,54106025057,3,1662,1837,-10
54107136223,54107136227,4,1286,1459,-10
54110285721,54110285723,2,1421,1110,-10
54110922956,54110922956,0,1463,1572,-10
54112891715,54112891710,-5,1628,4441,-10
54112922699,54112922701,2,1214,1072,-10
54115093445,54115093446,1,1344,1190,-10
54116710265,54116710267,2,2219,1897,-10
54116943628,54116943629,1,2081,2082,-10
54119454330,54119454334,4,1024,1281,-10
54120266638,54120266641,3,1918,2116,-10
54120383395,54120383397,2,1647,1838,-10
54121952263,54121952258,-5,1013,3876,-10
54122219037,54122219040,3,1543,1508,-10
54122583645,54122583647,2,1279,1344,-10
54125453346,54125453348,2,1181,1435,-10
54128373420,54128373420,0,1393,1408,-10
54135786601,54135786603,2,1472,1715,-10
54135875577,54135875579,2,1539,1891,-10
54138336394,54138336396,2,1963,1607,-10
54138413957,54138413958,1,1412,1191,-10
54148306137,54148306138,1,1267,1625,-10
54151874238,54151874238,0,1399,1875,-10
54157579549,54157579550,1,2217,1939,-10
54158312381,54158312382,1,1477,1454,-10
54162755770,54162755774,4,1657,1477,-10
54165641835,54165641842,7,4658,966,-10
54167155505,54167155506,1,1545,1454,-10
54174850835,54174850835,0,1881,1357,-10
54175334311,54175334313,2,2265,1432,-10
54181632795,54181632795,0,1658,1764,-10
54181703978,54181703981,3,2123,1658,-10
54183604165,54183604166,1,1628,1653,-10
54185179691,54185179693,2,1687,1764,-10
54186253858,54186253862,4,1411,1365,-10
54186441506,54186441507,1,1483,1659,-10
54193167754,54193167755,1,2159,1812,-10
54198230082,54198230085,3,1823,1978,-10
54199569876,54199569879,3,1870,1410,-10
54200595433,54200595438,5,1749,1149,-10
54205220832,54205220843,11,13238,30429,-10
54206025130,54206025131,1,1535,1249,-10
54207913691,54207913695,4,2193,1772,-10
54208145507,54208145507,0,1374,1765,-10
54212139806,54212139809,3,1003,1445,-10
54216279210,54216279213,3,2041,1843,-10
54216866770,54216866771,1,1518,1207,-10
54224672385,54224672386,1,1748,2309,-10
54225309601,54225309605,4,1117,1498,-10
54225919774,54225919774,0,1813,1979,-10
54228814374,54228814375,1,1121,1078,-10
54229625026,54229625030,4,1823,1999,-10
54230294669,54230294671,2,1662,1223,-10
54233385476,54233385480,4,1725,1476,-10
54235080338,54235080341,3,1532,1463,-10
54236382861,54236382865,4,1944,1930,-10
54238407830,54238407831,1,1562,1467,-10
54242413539,54242413542,3,1978,1664,-10
54244449600,54244449604,4,1344,1362,-10
54245201100,54245201095,-5,2501,6878,-10
54245445649,54245445651,2,1768,1438,-10
54248846171,54248846170,-1,1072,2287,-10
54251506243,54251506244,1,1366,987,-10
54255318591,54255318594,3,1497,1524,-10
54258357050,54258357051,1,1199,1014,-10
54261408487,54261408489,2,1166,1279,-10
54263958162,54263958165,3,1294,1636,-10
54269693169,54269693171,2,1816,1443,-10
54271503425,54271503425,0,1528,1002,-10
54276204833,54276204829,-4,1401,3844,-10
54276329658,54276329648,-10,1392,1242,-10
54277006834,54277006834,0,1810,1603,-10
54277160134,54277160131,-3,1615,2236,-10
54279151666,54279151666,0,1663,1286,-10
54279277959,54279277976,17,1273,1384,-10
54282867814,54282867815,1,1778,1418,-10
54283232986,54283232989,3,1798,1685,-10
54283762270,54283762267,-3,1261,1561,-10
54286366665,54286366665,0,1418,1014,-10
54288358241,54288358243,2,1191,1364,-10
54289515778,54289515782,4,692,713,-10
54290380506,54290380507,1,1472,1190,-10
54290591546,54290591550,4,1954,1625,-10
54291178236,54291178237,1,1923,1952,-10
54292551020,54292551022,2,1321,1727,-10
54292964536,54292964537,1,13033,16166,-10
54293433745,54293433747,2,1708,1740,-10
54299038781,54299038784,3,831,1209,-10
54299498789,54299498791,2,1253,942,-10
54300355094,54300355097,3,2015,1798,-10
54306128653,54306128634,-19,1159,1572,-10
54309240641,54309240643,2,1322,1109,-10
54315251041,54315251042,1,1270,1340,-10
54318064465,54318064464,-1,1889,1611,-10
54320754730,54320754734,4,1364,1469,-10
54322177137,54322177135,-2,1428,2381,-10
54326277826,54326277821,-5,914,3361,-10
54327355366,54327355366,0,1726,2111,-10
54328342745,54328342742,-3,748,1771,-10
54329099365,54329099367,2,1000,1532,-10
54330679587,54330679566,-21,1354,1743,-10
54332056810,54332056812,2,1149,1283,-10
54333139600,54333139601,1,1641,1497,-10
54347432456,54347432459,3,1689,1630,-10
54350288087,54350288090,3,1959,1772,-10
54350368124,54350368131,7,1530,1615,-10
54350722885,54350722886,1,1555,1627,-10
54351977075,54351977077,2,1957,1748,-10
54353392674,54353392675,1,1475,1870,-10
54355716665,54355716667,2,1871,2012,-10
54356491882,54356491885,3,1338,1761,-10
54357806604,54357806607,3,1575,1381,-10
54359007806,54359007807,1,1896,1296,-10
54360458839,54360458842,3,2418,2324,-10
54361934882,54361934881,-1,1116,1472,-10
54363227474,54363227474,0,2477,1476,-10
54363912985,54363912986,1,2394,1967,-10
54364988673,54364988674,1,1441,1104,-10
54365889510,54365889512,2,1813,1495,-10
54367088501,54367088502,1,1241,1410,-10
54374808279,54374808278,-1,2183,3949,-10
54378959641,54378959645,4,1228,1501,-10
54380035066,54380035066,0,1305,1505,-10
54381285893,54381285889,-4,1692,1747,-10
54385687342,54385687342,0,1819,1652,-10
54386130631,54386130630,-1,1110,1353,-10
54388309949,54388309951,2,1419,1471,-10
54389708981,54389708982,1,1228,1779,-10
54394439992,54394439994,2,1148,1371,-10
54401709512,54401709515,3,1483,1279,-10
54407770996,54407771001,5,1730,1050,-10
54408513467,54408513473,6,19334,49402,-10
54409923315,54409923298,-17,2033,1707,-10
54410339671,54410339674,3,1907,1129,-10
54410595394,54410595396,2,2342,2205,-10
54412059810,54412059814,4,4272,2669,-10
54414373547,54414373553,6,2672,1792,-10
54415093061,54415093062,1,1395,1727,-10
54417447990,54417447990,0,1620,1719,-10
54418576838,54418576842,4,1201,1513,-10
54418988801,54418988791,-10,934,1141,-10
54419319507,54419319511,4,1165,926,-10
54422769181,54422769183,2,1951,1486,-10
54426383130,54426383136,6,1189,1716,-10
54426754394,54426754395,1,2564,1827,-10
54426989677,54426989678,1,1854,1329,-10
54428873887,54428873891,4,1825,1386,-10
54435794100,54435794102,2,1031,926,-10
54436437582,54436437583,1,1315,1088,-10
54438897082,54438897085,3,1596,1476,-10
54442016023,54442016020,-3,927,2077,-10
54443970873,54443970876,3,2202,2040,-10
54444842923,54444842924,1,1416,2281,-10
54447381989,54447381990,1,2157,2046,-10
54447908197,54447908198,1,2143,2169,-10
54452794901,54452794883,-18,1277,715,-10
54453250166,54453250172,6,927,1069,-10
54454610312,54454610315,3,1533,1485,-10
54456560165,54456560167,2,1147,1258,-10
54458571090,54458571091,1,1299,1584,-10
54460930190,54460930189,-1,2496,4129,-10
54461560818,54461560818,0,1537,1251,-10
54462603864,54462603865,1,1177,1370,-10
54463599121,54463599122,1,1461,1230,-10
54473545838,54473545841,3,1392,1811,-10
54474653188,54474653189,1,1693,2062,-10
54477147137,54477147135,-2,1875,3467,-10
54478551330,54478551331,1,1058,829,-10
54478683663,54478683642,-21,1230,1627,-10
54478970923,54478970924,1,1628,1402,-10
54480639051,54480639053,2,1592,2106,-10
54485030942,54485030946,4,2187,1122,-10
54485125818,54485125819,1,1518,1267,-10
54489590313,54489590314,1,1534,1328,-10
54490269722,54490269722,0,1299,2297,-10
54491574316,54491574315,-1,1432,1306,-10
54492333590,54492333590,0,1224,1597,-10
54495854374,54495854377,3,1534,1485,-10
54496439022,54496439023,1,1855,1374,-10
54502127562,54502127562,0,962,1095,-10
54503927614,54503927613,-1,1737,2412,-10
54506572987,54506572988,1,2167,1898,-10
54508257596,54508257596,0,1076,1523,-10
54514249744,54514249745,1,1454,1036,-10
54515598865,54515598867,2,2322,2015,-10
54516354065,54516354067,2,1675,1914,-10
54520919243,54520919245,2,905,1016,-10
54522422954,54522422957,3,1888,1529,-10
54522640981,54522640985,4,1176,1251,-10
54523859442,54523859446,4,1748,2010,-10
54524021820,54524021821,1,1281,1734,-10
54526819987,54526819988,1,1619,1716,-10
54527519338,54527519342,4,1377,1687,-10
54532700098,54532700100,2,1505,1655,-10
54532885183,54532885162,-21,859,677,-10
54535659987,54535659990,3,1522,1279,-10
54535960106,54535960110,4,52405,30186,-10
54539596489,54539596489,0,1427,1372,-10
54542275686,54542275692,6,4563,2658,-10
54543577073,54543577073,0,2028,1618,-10
54545481589,54545481591,2,1812,1852,-10
54545629388,54545629395,7,5635,31350,-10
54546103426,54546103429,3,1281,1093,-10
54547893752,54547893754,2,2338,2030,-10
54549444240,54549444241,1,1795,2016,-10
54549515893,54549515895,2,813,966,-10
54553070920,54553070921,1,1020,1640,-10
54556415878,54556415880,2,1304,1555,-10
54557089782,54557089781,-1,2119,2175,-10
54560132647,54560132650,3,1298,1517,-10
54562440371,54562440374,3,2305,2673,-10
54563970550,54563970553,3,1465,1448,-10
54565606248,54565606248,0,1055,1621,-10
54565938168,54565938170,2,1351,1468,-10
54570170891,54570170894,3,1176,1724,-10
54571699078,54571699078,0,1084,1556,-10
54577121114,54577121115,1,1203,1716,-10
54578814804,54578814798,-6,1299,4293,-10
54579265320,54579265322,2,1032,1456,-10
54587716207,54587716209,2,1918,1367,-10
54588617021,54588617020,-1,1197,1992,-10
54591282821,54591282822,1,1771,2114,-10
54593348794,54593348794,0,1269,1328,-10
54594121265,54594121262,-3,2047,5080,-10
54594521012,54594521014,2,2280,2193,-10
54594617055,54594617057,2,1542,1365,-10
54597519086,54597519086,0,1629,1773,-10
54604675501,54604675504,3,1647,1246,-10
54605220891,54605220890,-1,1350,1491,-10
54609340923,54609340927,4,1682,1896,-10
54610294971,54610294975,4,1394,1583,-10
54611091662,54611091664,2,1903,1864,-10
54614734840,54614734841,1,1037,1104,-10
54616769812,54616769814,2,1390,1440,-10
54621941530,54621941535,5,3409,1976,-10
54622021868,54622021869,1,1764,1707,-10
54622504288,54622504291,3,1544,1442,-10
54622998563,54622998565,2,1389,1274,-10
54624712293,54624712285,-8,36870,12753,-10
54626072315,54626072315,0,1117,1306,-10
54626749253,54626749254,1,1365,1866,-10
54628210829,54628210825,-4,1370,4128,-10
54632239715,54632239714,-1,1087,1481,-10
54638099526,54638099522,-4,1158,1736,-10
54642354365,54642354366,1,1441,1431,-10
54646065637,54646065639,2,928,1179,-10
54646257518,54646257519,1,1453,1462,-10
54647242254,54647242254,0,1156,962,-10
54651925428,54651925431,3,2584,2138,-10
54652412034,54652412035,1,1457,1462,-10
54653696014,54653696014,0,1636,1593,-10
54655022422,54655022423,1,1346,1675,-10
54657473178,54657473179,1,1848,2713,-10
54660226377,54660226377,0,1022,1538,-10
54661499239,54661499242,3,1642,1886,-10
54665222178,54665222181,3,1620,1438,-10
54668174697,54668174701,4,1584,1596,-10
54671732963,54671732967,4,830,1257,-10
54672541530,54672541530,0,1553,1515,-10
54674410440,54674410442,2,2360,1747,-10
54676865858,54676865858,0,24724,22078,-10
54677010339,54677010338,-1,1426,1572,-10
54677801113,54677801118,5,1723,1290,-10
54679310382,54679310387,5,989,1588,-10
54683401178,54683401180,2,1960,1574,-10
54684602806,54684602807,1,1444,1550,-10
54686166358,54686166362,4,2283,1388,-10
54687078661,54687078664,3,2126,1322,-10
54687507054,54687507055,1,1845,1643,-10
54688823350,54688823353,3,1141,1219,-10
54692384383,54692384387,4,1690,1071,-10
54693184009,54693184010,1,1393,1761,-10
54695381962,54695381966,4,1792,1371,-10
54699088366,54699088366,0,1267,1849,-10
54699572063,54699572064,1,1122,1906,-10
54699946630,54699946631,1,1983,1454,-10
54700557589,54700557590,1,1314,1539,-10
54700695084,54700695085,1,1218,1654,-10
54702527976,54702527978,2,1223,1038,-10
54702598822,54702598822,0,1706,1435,-10
54705618742,54705618747,5,2409,1672,-10
54711825061,54711825058,-3,1112,2196,-10
54714915570,54714915565,-5,720,1274,-10
54720903727,54720903730,3,1041,1091,-10
54721480730,54721480734,4,958,836,-10
54721684630,54721684610,-20,1509,1050,-10
54722242049,54722242054,5,697,931,-10
54722847217,54722847218,1,1200,1361,-10
54723261290,54723261287,-3,1352,1140,-10
54724675646,54724675646,0,1517,1955,-10
54726769022,54726769022,0,1603,1196,-10
54727987233,54727987232,-1,1414,999,-10
54728901512,54728901514,2,1484,1854,-10
54729185952,54729185952,0,1485,1711,-10
54731443779,54731443780,1,1361,1540,-10
54733684338,54733684338,0,1376,985,-10
54734103019,54734103020,1,2410,2064,-10
54738422706,54738422707,1,1504,2111,-10
54739788188,54739788190,2,1462,1632,-10
54742521993,54742521995,2,1782,1493,-10
54747352621,54747352623,2,2100,2250,-10
54754643967,54754643971,4,2104,1733,-10
54755747265,54755747270,5,2094,1305,-10
54758246030,54758246034,4,633,509,-10
54759772039,54759772031,-8,652,3308,-10
54761890870,54761890870,0,1273,1115,-10
54765684483,54765684485,2,1184,972,-10
54770684549,54770684551,2,1907,1932,-10
54773654372,54773654374,2,1736,1311,-10
54781504513,54781504513,0,1035,1578,-10
54782250689,54782250690,1,1357,1301,-10
54784809946,54784809951,5,2205,2241,-10
54786557206,54786557210,4,2149,1619,-10
54786813737,54786813738,1,1866,1386,-10
54786930842,54786930840,-2,1626,1411,-10
54788234977,54788234979,2,1715,1672,-10
54789433092,54789433094,2,1576,1501,-10
54790972904,54790972905,1,2354,2274,-10
54796473938,54796473920,-18,765,417,-10
54799243145,54799243146,1,1133,1348,-10
54800922171,54800922172,1,1226,1529,-10
54803998542,54803998546,4,1554,1096,-10
54806879985,54806879988,3,1914,1427,-10
54808028818,54808028817,-1,1685,2530,-10
54809303766,54809303771,5,3096,1509,-10
54809705764,54809705766,2,1207,1474,-10
54814336158,54814336157,-1,899,2282,-10
54817419291,54817419292,1,1677,2244,-10
54825056400,54825056407,7,16339,18319,-10
54825344076,54825344074,-2,1368,2131,-10
54827191530,54827191531,1,1723,1607,-10
54827252404,54827252404,0,1454,1779,-10
54827414301,54827414302,1,1799,1760,-10
54834496580,54834496581,1,1845,1165,-10
54834953062,54834953062,0,1157,1288,-10
54839805010,54839805011,1,1539,1273,-10
54839871799,54839871801,2,1678,1517,-10
54843935827,54843935829,2,1170,943,-10
54846700648,54846700650,2,1995,1821,-10
54850667916,54850667917,1,1243,1654,-10
54850951225,54850951226,1,1962,1928,-10
54851721614,54851721618,4,1586,1637,-10
54854361529,54854361510,-19,1454,1740,-10
54855619809,54855619810,1,1891,1875,-10
54858563017,54858563018,1,1258,1884,-10
54859559891,54859559893,2,2231,2209,-10
54861393418,54861393419,1,1042,1601,-10
54862570539,54862570534,-5,1282,3247,-10
54862604661,54862604662,1,2356,1605,-10
54867012140,54867012143,3,1311,1129,-10
54878552157,54878552162,5,2524,1775,-10
54879116788,54879116795,7,1812,1332,-10
54879761545,54879761546,1,1592,1465,-10
54887312054,54887312056,2,1686,1640,-10
54887753570,54887753570,0,1173,1792,-10
54891558746,54891558749,3,1534,1404,-10
54892647939,54892647938,-1,1457,1047,-10
54893476483,54893476487,4,2340,1201,-10
54895400116,54895400117,1,1422,1638,-10
54896988951,54896988944,-7,34587,16425,-10
54899066934,54899066935,1,2249,2712,-10
54899894565,54899894567,2,1478,1541,-10
54904196522,54904196522,0,2613,2377,-10
54904469175,54904469176,1,1658,1854,-10
54906279272,54906279274,2,1357,1562,-10
54913870221,54913870222,1,2492,2267,-10
54914470335,54914470336,1,1798,1760,-10
54915553989,54915553989,0,1558,1448,-10
54915617165,54915617177,12,1611,1426,-10
54917334770,54917334771,1,1365,1398,-10
54918653981,54918654002,21,2088,1733,-10
54919390053,54919390054,1,2204,1426,-10
54919745118,54919745118,0,1629,2264,-10
54920313689,54920313691,2,1698,1525,-10
54920360698,54920360701,3,1842,2110,-10
54923675111,54923675113,2,1237,1604,-10
54924272443,54924272444,1,1210,1952,-10
54926920405,54926920407,2,1704,1311,-10
54927022054,54927022056,2,1410,2266,-10
54928128216,54928128218,2,1647,1519,-10
54929242850,54929242850,0,1281,1098,-10
54930069394,54930069393,-1,1426,2302,-10
54931743557,54931743559,2,1973,1874,-10
54935317859,54935317861,2,1774,1868,-10
54936835486,54936835491,5,1752,1685,-10
54937730625,54937730630,5,1163,1217,-10
54938884472,54938884457,-15,1304,1455,-10
54943431951,54943431953,2,1389,2203,-10
54945177821,54945177823,2,1418,975,-10
54950994034,54950994036,2,1687,1745,-10
54951975140,54951975141,1,1667,1694,-10
54954113564,54954113567,3,1134,1273,-10
54954648737,54954648740,3,1437,1625,-10
54958169773,54958169778,5,8362,23424,-10
54958750577,54958750578,1,1696,1711,-10
54960399050,54960399054,4,1366,1242,-10
54965273900,54965273902,2,1376,1297,-10
54965481813,54965481814,1,1625,2117,-10
54971598163,54971598164,1,1472,1344,-10
54972301479,54972301481,2,1578,1679,-10
54973381719,54973381721,2,1441,1607,-10
54974828901,54974828902,1,1422,1087,-10
54975364258,54975364260,2,1642,1643,-10
54976363761,54976363767,6,6632,2913,-10
54976735690,54976735694,4,1600,1394,-10
54980265469,54980265470,1,1293,1718,-10
54980668512,54980668512,0,1552,1614,-10
54982114890,54982114890,0,1681,2215,-10
54982454902,54982454902,0,1712,1355,-10
54985764054,54985764056,2,2285,2111,-10
54988157857,54988157862,5,2421,1735,-10
54992557617,54992557615,-2,1446,1389,-10
54994687637,54994687638,1,1519,1372,-10
54998229220,54998229222,2,1278,1604,-10
54998917669,54998917670,1,1675,2144,-10
55000868645,55000868646,1,2150,1636,-10
55001937928,55001937929,1,1668,1522,-10
55003418642,55003418642,0,1578,1855,-10
55005941861,55005941863,2,1341,1198,-10
55011339927,55011339929,2,1423,1793,-10
55013066577,55013066578,1,840,1146,-10
55013140483,55013140485,2,1767,1526,-10
55014766646,55014766648,2,1736,2430,-10
55021211705,55021211708,3,1585,1900,-10
55032287310,55032287312,2,1535,1287,-10
55032462841,55032462841,0,1508,1520,-10
55038072420,55038072420,0,1149,1459,-10
55039564645,55039564646,1,1754,1138,-10
55045096189,55045096191,2,1802,1949,-10
55047643639,55047643642,3,1765,1236,-10
55050026006,55050026006,0,1421,1408,-10
55052112580,55052112581,1,1822,2011,-10
55052270965,55052270966,1,1583,1202,-10
55053947917,55053947917,0,2079,1635,-10
55054773114,55054773115,1,1346,1713,-10
55060268125,55060268126,1,2130,2136,-10
55060412999,55060413002,3,1164,1328,-10
55063010459,55063010461,2,928,1267,-10
55065500175,55065500174,-1,985,1494,-10
55067447081,55067447082,1,1593,1552,-10
55069457746,55069457745,-1,1679,1328,-10
55071140882,55071140885,3,1490,1601,-10
55071746641,55071746643,2,1762,2132,-10
55072960133,55072960136,3,1434,1599,-10
55074876063,55074876055,-8,797,2864,-10
55086240465,55086240466,1,1701,1309,-10
55086531199,55086531179,-20,1454,1290,-10
55091221902,55091221902,0,1275,1875,-10
55093228125,55093228126,1,1242,1531,-10
55093808472,55093808478,6,3247,1670,-10
55097026492,55097026494,2,1752,2041,-10
55098899998,55098899998,0,1812,1508,-10
55102518903,55102518908,5,1833,1422,-10
55106985706,55106985708,2,2490,1876,-10
55107358883,55107358883,0,1451,1798,-10
55108832748,55108832765,17,1405,1531,-10
55109993557,55109993559,2,1261,1503,-10
55110455064,55110455060,-4,1758,4809,-10
55111844186,55111844188,2,1093,1352,-10
55113993051,55113993058,7,2154,1055,-10
55117917532,55117917534,2,2272,1853,-10
55124757787,55124757786,-1,1640,1884,-10
55125003192,55125003194,2,1744,1700,-10
55128166634,55128166634,0,1134,958,-10
55129386704,55129386703,-1,1906,1519,-10
55129698034,55129698036,2,2102,2040,-10
55129890533,55129890537,4,782,1205,-10
55130383443,55130383442,-1,1860,1713,-10
55133142369,55133142371,2,1428,1441,-10
55133174386,55133174388,2,2514,2051,-10
55133255573,55133255575,2,1383,1637,-10
55135950542,55135950542,0,1823,1663,-10
55141100297,55141100300,3,1890,1964,-10
55145062986,55145062991,5,1978,1235,-10
55146200789,55146200791,2,1343,1493,-10
55155997386,55155997406,20,947,1278,-10
55157130588,55157130590,2,1708,1662,-10
55159573455,55159573455,0,856,1456,-10
55160217557,55160217561,4,1619,1861,-10
55162837788,55162837790,2,1535,2010,-10
55164166133,55164166134,1,1324,1098,-10
55165659929,55165659931,2,1595,2008,-10
55169377685,55169377685,0,2313,2226,-10
55174481178,55174481177,-1,1846,2619,-10
55179121197,55179121209,12,8269,51975,-10
55179956269,55179956270,1,1442,1524,-10
55179987102,55179987108,6,1572,1434,-10
55186017774,55186017776,2,1148,1522,-10
55186235078,55186235082,4,1144,576,-10
55190071449,55190071450,1,1786,1158,-10
55190737298,55190737294,-4,1165,2065,-10
55200710709,55200710709,0,1594,2459,-10
55201933594,55201933589,-5,992,3386,-10
55202293186,55202293188,2,1610,2151,-10
55203091554,55203091555,1,1657,1786,-10
55208492605,55208492605,0,1593,1921,-10
55214779074,55214779078,4,1520,1236,-10
55215187439,55215187437,-2,1028,1737,-10
55216272718,55216272720,2,1435,1688,-10
55216849628,55216849631,3,1819,1784,-10
55219056394,55219056393,-1,1459,1784,-10
55219677176,55219677178,2,1238,1953,-10
55225682044,55225682046,2,2079,1658,-10
55226910365,55226910369,4,1795,1375,-10
55232916495,55232916492,-3,1348,1888,-10
55232947058,55232947061,3,1396,1701,-10
55234059114,55234059114,0,1513,1051,-10
55235776402,55235776403,1,1479,1376,-10
55236131278,55236131279,1,2252,1680,-10
55236454959,55236454961,2,1414,1273,-10
55237905542,55237905546,4,1767,1579,-10
55240185609,55240185621,12,1524,1442,-10
55243526788,55243526790,2,1359,1973,-10
55244874213,55244874215,2,1182,1588,-10
55246005317,55246005319,2,1120,1456,-10
55248581550,55248581550,0,2029,1564,-10
55250592532,55250592537,5,1727,1473,-10
55251128415,55251128417,2,2586,2331,-10
55253716893,55253716896,3,1708,1392,-10
55256239208,55256239210,2,1615,1552,-10
55259841091,55259841091,0,952,1534,-10
55262396461,55262396462,1,1206,1370,-10
55266140318,55266140319,1,1511,1563,-10
55267844220,55267844205,-15,850,1228,-10
55273451759,55273451761,2,1898,1781,-10
55274418835,55274418835,0,1267,1705,-10
55274730042,55274730026,-16,1055,962,-10
55275299938,55275299938,0,1660,1617,-10
55277493704,55277493706,2,1600,1291,-10
55278777550,55278777553,3,1842,1403,-10
55279935887,55279935886,-1,1435,3022,-10
55283580626,55283580629,3,1776,1289,-10
55284624547,55284624550,3,1704,1178,-10
55284684630,55284684633,3,1473,1246,-10
55284885164,55284885165,1,1753,2221,-10
55285833635,55285833634,-1,1841,1670,-10
55292763633,55292763637,4,2003,1421,-10
55293492081,55293492083,2,1663,1634,-10
55295270985,55295270987,2,1523,1245,-10
55296664859,55296664862,3,1029,1168,-10
55297238810,55297238811,1,1204,768,-10
55297671202,55297671202,0,1508,1699,-10
55298576558,55298576537,-21,1272,1712,-10
55299583270,55299583271,1,1093,1422,-10
55300130081,55300130084,3,1909,1699,-10
55300273260,55300273243,-17,1532,2125,-10
55304881824,55304881825,1,1256,1132,-10
55306830089,55306830092,3,1579,1371,-10
55307781865,55307781867,2,1105,1271,-10
55310895102,55310895102,0,1229,1506,-10
55312045647,55312045649,2,1161,1334,-10
55312894553,55312894537,-16,1405,1892,-10
55313871379,55313871378,-1,1380,1508,-10
55317727404,55317727408,4,1535,1022,-10
55317878475,55317878477,2,1453,1501,-10
55318066800,55318066803,3,1819,2044,-10
55318730447,55318730450,3,1151,1289,-10
55320099413,55320099414,1,2151,2549,-10
55320127034,55320127034,0,1393,1589,-10
55324203362,55324203362,0,1487,2373,-10
55324512133,55324512135,2,1914,1126,-10
55325016451,55325016453,2,1876,1615,-10
55328931370,55328931372,2,2066,1767,-10
55332571902,55332571904,2,2315,1682,-10
55333703401,55333703403,2,1752,1455,-10
55335617028,55335617030,2,1246,1775,-10
55336452914,55336452909,-5,11756,54541,-10
55337259545,55337259549,4,1642,1509,-10
55339260467,55339260469,2,1153,1502,-10
55343808310,55343808312,2,2036,1836,-10
55344168614,55344168616,2,1493,1533,-10
55347110580,55347110581,1,1505,1776,-10
55350002754,55350002754,0,1818,1370,-10
55354071902,55354071883,-19,951,904,-10
55354515787,55354515789,2,1528,1548,-10
55354784771,55354784772,1,1354,1551,-10
55364827388,55364827390,2,1603,1094,-10
55370097957,55370097950,-7,1165,4693,-10
55370748767,55370748768,1,1237,1580,-10
55371099724,55371099717,-7,1438,8571,-10
55373484036,55373484038,2,1833,2000,-10
55374609234,55374609235,1,1662,1710,-10
55377216562,55377216565,3,2193,1635,-10
55378248917,55378248929,12,4853,1164,-10
55380225153,55380225160,7,28089,56560,-10
55383706806,55383706809,3,1518,1435,-10
55384597359,55384597363,4,1340,1157,-10
55387933878,55387933893,15,1355,1449,-10
55389552367,55389552370,3,2048,1429,-10
55392044790,55392044792,2,1245,1895,-10
55394764204,55394764206,2,1313,1039,-10
55403978506,55403978507,1,1147,1599,-10
55406262923,55406262922,-1,1667,1366,-10
55406694307,55406694313,6,1762,1397,-10
55408423101,55408423103,2,1676,1879,-10
55409939192,55409939195,3,1428,1106,-10
55413452602,55413452606,4,1567,1454,-10
55414068324,55414068320,-4,1034,2168,-10
55416935978,55416935981,3,1491,1594,-10
55418923330,55418923331,1,1642,1341,-10
55420936248,55420936253,5,2907,1376,-10
55423304388,55423304390,2,1462,1404,-10
55424070093,55424070094,1,1298,1312,-10
55424754466,55424754467,1,1817,1520,-10
55426153084,55426153067,-17,952,401,-10
55430106428,55430106429,1,1841,1927,-10
55432697953,55432697953,0,1484,1581,-10
55435239541,55435239543,2,1741,1346,-10
55436465702,55436465706,4,2366,1821,-10
55438238550,55438238554,4,1260,1398,-10
55438737376,55438737378,2,1284,1131,-10
55449845399,55449845399,0,2012,1222,-10
55451662335,55451662340,5,1475,1443,-10
55453423150,55453423153,3,1174,1417,-10
55458373962,55458373965,3,2074,1531,-10
55461450107,55461450112,5,2130,1529,-10
55462095493,55462095495,2,1364,1657,-10
55464046454,55464046456,2,1349,1703,-10
55465306139,55465306141,2,2485,1382,-10
55467188777,55467188778,1,1675,1528,-10
55468457529,55468457530,1,1568,1488,-10
55468629824,55468629824,0,1742,1888,-10
55471843125,55471843121,-4,1250,1771,-10
55472490232,55472490223,-9,1811,1620,-10
55473161458,55473161461,3,1379,1150,-10
55476799166,55476799167,1,1735,1368,-10
55478046130,55478046131,1,2190,1786,-10
55478174046,55478174027,-19,1759,1577,-10
55478598961,55478598962,1,1633,1822,-10
55480003810,55480003812,2,1758,1693,-10
55480819090,55480819087,-3,2918,5152,-10
55481101440,55481101447,7,6298,2039,-10
55485035685,55485035685,0,1044,1446,-10
55485182154,55485182155,1,1532,1143,-10
55486893606,55486893611,5,1873,1494,-10
55487383275,55487383280,5,581,170,-10
55487493761,55487493759,-2,19689,51727,-10
55488261143,55488261145,2,1849,842,-10
55489658658,55489658659,1,1908,1601,-10
55489699389,55489699390,1,1614,1818,-10
55492845591,55492845595,4,1408,1677,-10
55494748018,55494748021,3,1725,1198,-10
55496276611,55496276613,2,1356,2241,-10
55497369076,55497369079,3,3258,2735,-10
55498569136,55498569130,-6,1748,1313,-10
55504579774,55504579778,4,1304,934,-10
55506587626,55506587626,0,1258,1663,-10
55506827765,55506827766,1,1430,1787,-10
55508082009,55508082010,1,906,1519,-10
55509054568,55509054571,3,1647,1665,-10
55509305872,55509305875,3,1576,1047,-10
55510153602,55510153602,0,1290,874,-10
55511527458,55511527458,0,977,1465,-10
55512594698,55512594698,0,1195,1358,-10
55515539004,55515539006,2,1715,1846,-10
55519102601,55519102602,1,1436,1895,-10
55522153278,55522153278,0,1416,1610,-10
55523159301,55523159301,0,1950,1717,-10
55525701027,55525701026,-1,1097,1582,-10
55528785964,55528785966,2,1774,2019,-10
55530943843,55530943841,-2,1410,2018,-10
55532268630,55532268624,-6,862,3493,-10
55536299549,55536299551,2,1439,1624,-10
55545274331,55545274327,-4,1102,4637,-10
55546914923,55546914923,0,1541,1808,-10
55552222217,55552222218,1,18202,8079,-10
55553628733,55553628734,1,974,1538,-10
55556783544,55556783547,3,2158,1137,-10
55556863474,55556863474,0,2227,1567,-10
55559055945,55559055946,1,1481,1830,-10
55563962182,55563962186,4,1516,1353,-10
55567346753,55567346758,5,1310,1226,-10
55569854492,55569854492,0,1749,2275,-10
55570308273,55570308274,1,1829,1906,-10
55572178070,55572178071,1,1308,1382,-10
55575176990,55575176989,-1,1891,1404,-10
55576969089,55576969091,2,1445,1404,-10
55580632235,55580632237,2,2018,1498,-10
55581497630,55581497632,2,2117,1781,-10
55582593963,55582593964,1,1685,1544,-10
55586317745,55586317747,2,2534,2149,-10
55586390153,55586390154,1,1556,1633,-10
55596579958,55596579964,6,1560,1305,-10
55597221449,55597221456,7,1259,1503,-10
55600448146,55600448150,4,1756,1459,-10
55607417037,55607417034,-3,1980,3422,-10
55615565234,55615565237,3,5460,26023,-10
55616205584,55616205587,3,1678,1452,-10
55616620321,55616620322,1,1505,1814,-10
55617753075,55617753078,3,1126,1517,-10
55620431517,55620431519,2,1529,1802,-10
55622625850,55622625854,4,1637,1471,-10
55623599140,55623599139,-1,1404,1883,-10
55625878562,55625878563,1,1291,1154,-10
55629121302,55629121303,1,1691,1752,-10
55629756958,55629756960,2,20493,26110,-10
55631130954,55631130959,5,1967,1295,-10
55632315750,55632315744,-6,1009,3832,-10
55639644121,55639644121,0,1249,2070,-10
55646005105,55646005099,-6,1462,4461,-10
55648827845,55648827846,1,1879,1465,-10
55652937332,55652937333,1,1620,1476,-10
55657233063,55657233061,-2,637,1028,-10
55657798930,55657798930,0,1372,1161,-10
55659830322,55659830322,0,1506,1288,-10
55663047713,55663047721,8,8277,2419,-10
55668074913,55668074914,1,1603,1326,-10
55668312577,55668312586,9,1333,1375,-10
55668607116,55668607118,2,1500,1664,-10
55668942393,55668942393,0,1581,1619,-10
55670806342,55670806342,0,1434,1664,-10
55672018046,55672018049,3,1663,1751,-10
55673151686,55673151686,0,1524,1445,-10
55676032861,55676032862,1,1066,1703,-10
55676314850,55676314852,2,1750,1452,-10
55683815698,55683815701,3,1489,1460,-10
55684319538,55684319539,1,1262,1412,-10
55684384597,55684384597,0,1502,2417,-10
55690094437,55690094439,2,1273,1903,-10
55691106950,55691106951,1,2185,1724,-10
55691629235,55691629234,-1,1386,1415,-10
55691981129,55691981134,5,2743,957,-10
55692544149,55692544151,2,1391,1467,-10
55694291147,55694291151,4,3226,2141,-10
55694437562,55694437563,1,1982,1811,-10
55694472706,55694472708,2,1980,1726,-10
55699355879,55699355878,-1,1354,1570,-10
55701514509,55701514497,-12,1775,1461,-10
55702615603,55702615586,-17,1937,2234,-10
55707013735,55707013730,-5,55,644,-10
55708297913,55708297914,1,1756,1947,-10
55710768504,55710768506,2,1535,1698,-10
55712351131,55712351134,3,1193,1505,-10
55717604450,55717604453,3,1468,1473,-10
55717665870,55717665870,0,1613,1832,-10
55722374118,55722374118,0,1421,1031,-10
55727267346,55727267348,2,986,1732,-10
55727662190,55727662191,1,1111,1267,-10
55730208619,55730208621,2,1946,1130,-10
55734629610,55734629610,0,1395,1866,-10
55734983455,55734983457,2,1320,1453,-10
55739439087,55739439087,0,1248,1349,-10
55740823686,55740823690,4,1656,1321,-10
55741974978,55741974981,3,1686,1397,-10
55742946101,55742946103,2,1270,1672,-10
55752121994,55752121997,3,1692,1269,-10
55754952772,55754952774,2,1642,1237,-10
55756704449,55756704459,10,1379,959,-10
55762327018,55762327019,1,1918,1526,-10
55765769166,55765769174,8,3866,1537,-10
55768855911,55768855910,-1,1411,1613,-10
55773091165,55773091167,2,1978,2020,-10
55774286308,55774286309,1,1782,1842,-10
55776558030,55776558031,1,2103,1940,-10
55781102684,55781102684,0,2202,1638,-10
55787168126,55787168130,4,960,1502,-10
55788149810,55788149812,2,1572,1670,-10
55791477510,55791477514,4,1834,1557,-10
55792569662,55792569662,0,1252,1407,-10
55797013191,55797013185,-6,1801,4455,-10
55797392310,55797392311,1,1609,1459,-10
55798557283,55798557290,7,1915,1815,-10
55800103691,55800103695,4,2640,1959,-10
55800295641,55800295642,1,2192,1857,-10
55802430461,55802430463,2,1399,1802,-10
55803346350,55803346350,0,1913,2323,-10
55806644387,55806644387,0,1092,1585,-10
55810657838,55810657838,0,1753,1072,-10
55815745962,55815745963,1,1455,1396,-10
55820198770,55820198770,0,1327,1368,-10
55822948079,55822948081,2,1677,1643,-10
55823819745,55823819746,1,1560,1345,-10
55825060168,55825060169,1,1605,1289,-10
55827129663,55827129662,-1,771,1194,-10
55827858193,55827858197,4,1777,792,-10
55829654558,55829654558,0,1508,2432,-10
55831824866,55831824869,3,1324,1222,-10
55832879391,55832879374,-17,1086,991,-10
55833763370,55833763377,7,726,1425,-10
55835011969,55835011969,0,1618,1622,-10
55839177146,55839177143,-3,875,1243,-10
55840928418,55840928419,1,1588,1242,-10
55842362664,55842362666,2,1531,2016,-10
55843110536,55843110539,3,1930,1958,-10
55843764471,55843764474,3,2189,1574,-10
55846980314,55846980309,-5,869,1811,-10
55847543863,55847543865,2,1302,1309,-10
55848166339,55848166341,2,2045,2034,-10
55851499091,55851499089,-2,1459,2400,-10
55857867242,55857867244,2,1579,1647,-10
55859720139,55859720141,2,1847,1286,-10
55860926651,55860926655,4,1439,1002,-10
55864233279,55864233280,1,1734,1206,-10
55867519187,55867519188,1,1637,1455,-10
55868345766,55868345766,0,1288,1306,-10
55871675141,55871675142,1,2109,2277,-10
55872703565,55872703566,1,1978,1628,-10
55873692247,55873692249,2,1528,1474,-10
55875549798,55875549798,0,2207,1849,-10
55876091313,55876091314,1,1632,1937,-10
55876446548,55876446547,-1,62962,59325,-10
55881453842,55881453846,4,2710,1816,-10
55881790974,55881790975,1,1810,1045,-10
55886523813,55886523815,2,1488,1356,-10
55887516535,55887516538,3,1024,1209,-10
55892144357,55892144358,1,1604,1723,-10
55893333694,55893333697,3,1163,1608,-10
55893637098,55893637101,3,1221,1518,-10
55896600420,55896600422,2,1391,1773,-10
55901749950,55901749953,3,2081,1532,-10
55906945891,55906945891,0,1059,1444,-10
55912394236,55912394239,3,1793,1582,-10
55914825283,55914825285,2,1502,1182,-10
55915366398,55915366401,3,1375,1770,-10
55920905395,55920905398,3,1133,1237,-10
55921742122,55921742120,-2,1177,2718,-10
55926544387,55926544386,-1,1078,1340,-10
55926982554,55926982558,4,1525,1701,-10
55927339906,55927339891,-15,818,276,-10
55930352949,55930352951,2,1692,2077,-10
55931514820,55931514822,2,1522,1398,-10
55934671618,55934671620,2,2040,1871,-10
55939357133,55939357137,4,1966,1487,-10
55945026126,55945026125,-1,1202,1340,-10
55945376958,55945376960,2,1481,1146,-10
55946805967,55946805950,-17,1054,1370,-10
55947707674,55947707677,3,848,1131,-10
55950866402,55950866409,7,4165,1482,-10
55959380746,55959380756,10,1739,1679,-10
55959748477,55959748457,-20,1472,966,-10
55960220006,55960220006,0,1528,1102,-10
55960738190,55960738191,1,1515,1557,-10
55962509158,55962509157,-1,967,1849,-10
55969052107,55969052109,2,1279,1835,-10
55971739047,55971739048,1,1931,1606,-10
55973046295,55973046295,0,1382,1174,-10
55973123410,55973123410,0,2412,2124,-10
55973631155,55973631160,5,1382,1309,-10
55974860482,55974860461,-21,1072,993,-10
55977772607,55977772609,2,1468,1551,-10
55978053924,55978053926,2,1170,1120,-10
55978985249,55978985251,2,1760,1210,-10
55979411215,55979411214,-1,1376,1356,-10
55979569233,55979569232,-1,1493,1460,-10
55979814049,55979814052,3,1714,1695,-10
55980471834,55980471835,1,1477,1659,-10
55983459690,55983459694,4,1273,1587,-10
55987334370,55987334374,4,1199,1023,-10
55989208442,55989208443,1,1112,954,-10
55991377587,55991377588,1,1261,1783,-10
55993104366,55993104368,2,1175,1406,-10
55994774518,55994774522,4,1985,1556,-10
55995328274,55995328275,1,2095,2024,-10
55996687597,55996687599,2,1471,1575,-10
55998446223,55998446225,2,2358,1685,-10
55998945783,55998945785,2,1382,2082,-10
56008642182,56008642185,3,1568,1512,-10
56009116405,56009116406,1,2188,1575,-10
56011287954,56011287953,-1,1666,1780,-10
56013047535,56013047534,-1,1051,1333,-10
56016554501,56016554502,1,1421,1645,-10
56016688343,56016688339,-4,1271,2510,-10
56020752982,56020752984,2,1947,1311,-10
56021816215,56021816218,3,1333,1276,-10
56022361581,56022361584,3,1221,1174,-10
56024028618,56024028622,4,1075,1442,-10
56027302777,56027302779,2,1957,1981,-10
56028546612,56028546613,1,1396,1590,-10
56028724738,56028724738,0,1184,1608,-10
56029157806,56029157808,2,2297,2170,-10
56029433963,56029433965,2,2174,1824,-10
56033784594,56033784598,4,1399,1298,-10
56035499156,56035499176,20,1200,1564,-10
56036722806,56036722807,1,1335,1574,-10
56036748651,56036748649,-2,1984,1571,-10
56037805422,56037805425,3,2439,2206,-10
56038488265,56038488266,1,1512,1739,-10
56040733703,56040733701,-2,2993,3705,-10
56042914309,56042914310,1,1148,874,-10
56044776708,56044776710,2,1332,1616,-10
56049241070,56049241071,1,1221,1961,-10
56049644570,56049644570,0,1629,1760,-10
56050050136,56050050143,7,32951,28241,-10
56054951122,56054951122,0,1527,1465,-10
56055357581,56055357581,0,1636,1335,-10
56059706038,56059706042,4,1565,1340,-10
56060261237,56060261241,4,2452,2387,-10
56060432623,56060432625,2,1081,1112,-10
56064394937,56064394936,-1,2079,1696,-10
56067186951,56067186954,3,1611,1684,-10
56069650418,56069650421,3,1524,1515,-10
56071626545,56071626545,0,1407,1158,-10
56079163621,56079163621,0,1367,2059,-10
56080446883,56080446886,3,1156,1242,-10
56084704782,56084704782,0,1677,1847,-10
56086821128,56086821130,2,1196,1030,-10
56089902403,56089902399,-4,1493,3241,-10
56090041110,56090041113,3,2009,1459,-10
56092286747,56092286755,8,2819,1207,-10
56093116132,56093116134,2,823,907,-10
56094803817,56094803819,2,909,1367,-10
56095435926,56095435929,3,1526,1244,-10
56095872042,56095872045,3,1607,1339,-10
56096164106,56096164106,0,1463,1753,-10
56097372209,56097372211,2,1114,1040,-10
56102801670,56102801674,4,1506,1072,-10
56105220936,56105220938,2,1286,1644,-10
56105412784,56105412789,5,1859,1071,-10
56107053765,56107053767,2,2120,1694,-10
56107688006,56107688009,3,1554,1640,-10
56107973565,56107973569,4,1703,1678,-10
56112309885,56112309864,-21,2071,1503,-10
56113993719,56113993721,2,866,843,-10
56114873026,56114873026,0,1562,1105,-10
56116968078,56116968079,1,1260,1378,-10
56117752921,56117752925,4,1254,1495,-10
56120473985,56120473989,4,1475,1280,-10
56123844404,56123844406,2,1740,1678,-10
56128213474,56128213474,0,1167,1540,-10
56131294428,56131294432,4,2291,1934,-10
56134306061,56134306059,-2,1402,1685,-10
56137659740,56137659742,2,971,1482,-10
56138273875,56138273854,-21,1692,1696,-10
56142287285,56142287290,5,1604,1799,-10
56147366298,56147366298,0,1319,1998,-10
56148757266,56148757267,1,1483,1765,-10
56150902894,56150902897,3,1927,1914,-10
56151424706,56151424711,5,812,997,-10
56152342322,56152342323,1,1351,1418,-10
56160353718,56160353720,2,1039,1270,-10
56164624841,56164624847,6,3091,1004,-10
56166402569,56166402570,1,1114,1295,-10
56167616157,56167616157,0,1193,1415,-10
56168437108,56168437110,2,2007,1731,-10
56168786601,56168786605,4,1100,1916,-10
56176619595,56176619595,0,1143,1265,-10
56178982694,56178982703,9,14037,24609,-10
56182507205,56182507213,8,5518,1552,-10
56185724823,56185724824,1,1556,1884,-10
56186956041,56186956042,1,1737,2060,-10
56189021321,56189021329,8,11134,34960,-10
56189713832,56189713834,2,2047,1574,-10
56190185055,56190185058,3,1617,1135,-10
56194508192,56194508193,1,2128,1713,-10
56198317039,56198317041,2,1157,1707,-10
56202285829,56202285832,3,1601,1567,-10
56204241422,56204241425,3,967,1092,-10
56205140306,56205140309,3,1927,1446,-10
56206985628,56206985631,3,1599,1482,-10
56209172597,56209172600,3,1413,1558,-10
56210409942,56210409945,3,1578,1229,-10
56212336973,56212336974,1,1923,2008,-10
56215679109,56215679107,-2,1137,2454,-10
56219503090,56219503085,-5,1304,2039,-10
56220399511,56220399514,3,1077,1324,-10
56220688903,56220688906,3,2160,1704,-10
56220885473,56220885476,3,1154,983,-10
56223598454,56223598456,2,1291,1941,-10
56223809214,56223809218,4,1504,1204,-10
56225460123,56225460126,3,1907,1492,-10
56227236477,56227236479,2,1995,1876,-10
56227773163,56227773165,2,1540,1709,-10
56229501311,56229501314,3,1607,1503,-10
56231630115,56231630118,3,1528,1663,-10
56233271042,56233271042,0,1496,1700,-10
56235085058,56235085060,2,1322,1636,-10
56236993202,56236993203,1,1256,1106,-10
56237368060,56237368060,0,1405,2039,-10
56239136198,56239136198,0,936,1457,-10
56245036332,56245036334,2,1748,2113,-10
56246449685,56246449685,0,880,830,-10
56247740797,56247740800,3,1605,1559,-10
56247854743,56247854745,2,2605,1502,-10
56248194753,56248194755,2,1787,1789,-10
56249607868,56249607870,2,1085,970,-10
56251281908,56251281909,1,2034,2213,-10
56252629854,56252629855,1,1629,1559,-10
56254435827,56254435831,4,1372,1442,-10
56255784891,56255784896,5,11081,22444,-10
56256464718,56256464718,0,1340,1476,-10
56261894697,56261894699,2,1211,1171,-10
56262333404,56262333420,16,1649,1531,-10
56263712015,56263712019,4,1193,1491,-10
56263932511,56263932514,3,2205,2259,-10
56273522884,56273522883,-1,1876,1701,-10
56283709819,56283709824,5,1731,1900,-10
56284024145,56284024147,2,959,1587,-10
56295604537,56295604539,2,1697,1418,-10
56295766377,56295766379,2,1694,1270,-10
56299048117,56299048121,4,1526,1381,-10
56300210181,56300210185,4,1262,941,-10
56306140019,56306140023,4,2648,1263,-10
56307058599,56307058598,-1,1571,1460,-10
56311920598,56311920602,4,1623,1716,-10
56312312181,56312312184,3,1601,1831,-10
56313180523,56313180523,0,1499,2242,-10
56314009005,56314009010,5,1616,1195,-10
56314893030,56314893030,0,1486,1325,-10
56315961898,56315961905,7,8656,3210,-10
56316264982,56316264977,-5,1608,5996,-10
56322623176,56322623177,1,1287,1579,-10
56326852617,56326852619,2,1348,1665,-10
56331238233,56331238234,1,1474,1203,-10
56333309697,56333309698,1,1454,1335,-10
56339579998,56339580002,4,1216,1590,-10
56340597657,56340597662,5,1478,1356,-10
56341108244,56341108245,1,1505,1506,-10
56341243963,56341243967,4,2093,1469,-10
56341396395,56341396399,4,1533,1367,-10
56345785998,56345786001,3,1607,1366,-10
56346435231,56346435234,3,1438,1588,-10
56346791246,56346791225,-21,593,643,-10
56347910822,56347910825,3,1443,1436,-10
56352550451,56352550453,2,2159,1844,-10
56353101351,56353101355,4,1616,1090,-10
56353373806,56353373815,9,2355,1114,-10
56354629042,56354629043,1,1461,1497,-10
56355572941,56355572938,-3,1006,2488,-10
56357063177,56357063178,1,1419,1240,-10
56359868014,56359868017,3,1099,1640,-10
56363003175,56363003177,2,2045,1674,-10
56363068928,56363068929,1,1725,1519,-10
56371240408,56371240409,1,1079,1089,-10
56373345951,56373345954,3,2001,1620,-10
56374061610,56374061613,3,1440,1468,-10
56376033162,56376033162,0,1396,1676,-10
56376862663,56376862665,2,1503,1331,-10
56378308079,56378308082,3,2214,1972,-10
56379688837,56379688841,4,1495,1648,-10
56380434009,56380434011,2,1633,1141,-10
56381727970,56381727974,4,17601,10359,-10
56382616917,56382616914,-3,23704,54129,-10
56383162359,56383162362,3,1285,1278,-10
56385269443,56385269441,-2,1023,1150,-10
56390322263,56390322263,0,1087,1178,-10
56393691231,56393691231,0,1293,2118,-10
56397323782,56397323786,4,1249,1327,-10
56402626151,56402626149,-2,2005,2420,-10
56403546377,56403546382,5,2035,2125,-10
56405266178,56405266168,-10,2351,34473,-10
56406791313,56406791315,2,1379,1078,-10
56407187312,56407187313,1,1319,2206,-10
56414047737,56414047743,6,2535,1056,-10
56417553856,56417553859,3,1370,1199,-10
56418210066,56418210068,2,1252,1694,-10
56418638277,56418638277,0,1727,1694,-10
56420094131,56420094133,2,1067,1350,-10
56420735242,56420735244,2,1500,2096,-10
56424910526,56424910530,4,1739,1427,-10
56426255405,56426255406,1,1239,1728,-10
56430710510,56430710530,20,1129,1298,-10
56431193089,56431193091,2,1740,1310,-10
56431569269,56431569273,4,2108,1284,-10
56431924035,56431924029,-6,4816,16078,-10
56433057787,56433057785,-2,1335,2338,-10
56435531825,56435531828,3,1672,1690,-10
56436836548,56436836549,1,1431,1749,-10
56437944572,56437944574,2,1387,1374,-10
56441426517,56441426518,1,2037,2242,-10
56445200974,56445200977,3,1830,1973,-10
56446389703,56446389701,-2,1232,1567,-10
56446985204,56446985206,2,1705,1444,-10
56449582027,56449582027,0,948,1005,-10
56450189473,56450189488,15,1383,1217,-10
56453356270,56453356273,3,1716,1250,-10
56453870630,56453870633,3,1371,1162,-10
56455834470,56455834470,0,1125,1122,-10
56456872018,56456872018,0,2038,1700,-10
56461765974,56461765977,3,1999,1709,-10
56466830288,56466830290,2,1464,1679,-10
56471940425,56471940427,2,1097,1089,-10
56473048163,56473048165,2,2332,1770,-10
56474059725,56474059725,0,1398,1501,-10
56475878839,56475878839,0,2137,2142,-10
56476554442,56476554444,2,1320,971,-10
56478771539,56478771541,2,1961,2242,-10
56479354772,56479354775,3,879,1082,-10
56481094020,56481094023,3,1211,1208,-10
56487501185,56487501185,0,1624,1400,-10
56490886293,56490886294,1,1514,1536,-10
56494543035,56494543038,3,1380,1721,-10
56496611910,56496611893,-17,693,386,-10
56498683647,56498683649,2,1429,1351,-10
56499065661,56499065663,2,1522,2267,-10
56500525392,56500525393,1,1263,2051,-10
56504263490,56504263493,3,1217,1237,-10
56504675097,56504675091,-6,1966,6410,-10
56510259490,56510259490,0,1224,1293,-10
56513176387,56513176388,1,1109,1647,-10
56513722895,56513722893,-2,2664,3892,-10
56515847769,56515847770,1,1508,1288,-10
56516779874,56516779876,2,1188,956,-10
56519956041,56519956042,1,1866,1969,-10
56521151161,56521151163,2,1004,1414,-10
56522543593,56522543595,2,1879,1812,-10
56525645140,56525645143,3,1956,1545,-10
56532748590,56532748594,4,1400,1514,-10
56538573098,56538573101,3,1506,1368,-10
56541168758,56541168762,4,1617,1549,-10
56543134324,56543134325,1,1480,1735,-10
56543995784,56543995786,2,1554,1751,-10
56548261133,56548261134,1,1336,1588,-10
56554779749,56554779750,1,966,1184,-10
56555971629,56555971630,1,966,1102,-10
56558973917,56558973919,2,1754,1017,-10
56560627031,56560627033,2,1281,1975,-10
56561453299,56561453299,0,1436,1616,-10
56561783810,56561783811,1,1712,1500,-10
56562265194,56562265193,-1,685,1202,-10
56566311246,56566311249,3,1691,1899,-10
56567350783,56567350787,4,1827,1690,-10
56573790288,56573790295,7,1561,1251,-10
56576262182,56576262182,0,1230,1851,-10
56577955488,56577955487,-1,974,1337,-10
56578050555,56578050558,3,1506,1368,-10
56579496258,56579496262,4,2318,1945,-10
56581219075,56581219077,2,1385,1684,-10
56582779720,56582779722,2,1780,1727,-10
56583293158,56583293160,2,1593,1909,-10
56584146471,56584146472,1,1648,1882,-10
56585079814,56585079817,3,2067,1761,-10
56585622182,56585622186,4,1871,1383,-10
56586042555,56586042559,4,1306,1029,-10
56588060979,56588060982,3,1516,1315,-10
56588654162,56588654163,1,1926,1464,-10
56588787638,56588787640,2,2043,1854,-10
56590195699,56590195701,2,1620,1227,-10
56592587527,56592587530,3,1755,1604,-10
56593392409,56593392412,3,1918,1307,-10
56596042922,56596042925,3,1653,1500,-10
56597434901,56597434902,1,1408,1699,-10
56598482416,56598482418,2,1378,1415,-10
56604162210,56604162211,1,1245,1911,-10
56607428781,56607428784,3,949,1637,-10
56608266822,56608266822,0,1551,1311,-10
56609300390,56609300387,-3,1430,1922,-10
56610595476,56610595477,1,1281,1265,-10
56610951408,56610951418,10,2031,1322,-10
56613760151,56613760153,2,3599,3484,-10
56615342539,56615342542,3,1360,1333,-10
56615457850,56615457845,-5,1137,2902,-10
56616795202,56616795182,-20,950,533,-10
56617794055,56617794057,2,1956,1737,-10
56618219066,56618219069,3,1722,1602,-10
56618738442,56618738445,3,1321,1021,-10
56621144755,56621144755,0,1193,1535,-10
56623445937,56623445938,1,1807,1145,-10
56624112333,56624112335,2,961,1679,-10
56633545254,56633545258,4,2225,1310,-10
56634763950,56634763952,2,1688,1125,-10
56636276165,56636276166,1,1331,1366,-10
56636565696,56636565690,-6,796,2272,-10
56637474010,56637474011,1,1395,1372,-10
56637699574,56637699574,0,1399,1494,-10
56640435970,56640435973,3,1526,1772,-10
56642896285,56642896287,2,1143,1131,-10
56643024343,56643024324,-19,1161,1575,-10
56646037671,56646037670,-1,1429,1461,-10
56646181881,56646181878,-3,20683,55359,-10
56648520654,56648520658,4,972,1270,-10
56656820561,56656820562,1,1209,1278,-10
56658690250,56658690249,-1,6537,10162,-10
56660294650,56660294644,-6,2110,5462,-10
56661115023,56661115025,2,2101,1870,-10
56664552989,56664552990,1,1747,1520,-10
56667574666,56667574670,4,1984,1741,-10
56667716443,56667716449,6,7958,2819,-10
56668559039,56668559042,3,1825,1484,-10
56670886326,56670886330,4,2216,975,-10
56672557583,56672557586,3,2501,2053,-10
56677731214,56677731216,2,1554,1807,-10
56678272011,56678272011,0,1078,2375,-10
56680163664,56680163666,2,1550,1778,-10
56683998320,56683998321,1,1675,1483,-10
56685942582,56685942582,0,1872,1608,-10
56689440701,56689440704,3,1745,1665,-10
56689857385,56689857387,2,2076,1380,-10
56691259977,56691259981,4,1185,943,-10
56692016003,56692016005,2,1239,1137,-10
56694806318,56694806319,1,1502,1606,-10
56695342957,56695342955,-2,1570,1699,-10
56695984666,56695984668,2,1748,1785,-10
56699888626,56699888623,-3,311,2342,-10
56701294015,56701294009,-6,3081,12444,-10
56702328357,56702328358,1,1462,1399,-10
56703000401,56703000404,3,1450,1484,-10
56704947646,56704947647,1,2027,1269,-10
56704995084,56704995085,1,1476,1911,-10
56706871335,56706871338,3,1377,1256,-10
56713207085,56713207087,2,2001,1862,-10
56713855039,56713855038,-1,1595,1760,-10
56714110894,56714110896,2,1745,1952,-10
56714974453,56714974454,1,925,1263,-10
56715448255,56715448254,-1,759,1811,-10
56720620889,56720620893,4,801,899,-10
56725397757,56725397759,2,1399,1354,-10
56731406701,56731406704,3,1595,2056,-10
56734180111,56734180114,3,1528,1270,-10
56735091609,56735091610,1,2217,1418,-10
56736425618,56736425614,-4,835,1844,-10
56736904258,56736904261,3,1773,1482,-10
56739219918,56739219923,5,1861,1486,-10
56739707729,56739707731,2,2334,1944,-10
56740400158,56740400162,4,1112,1271,-10
56744476715,56744476709,-6,1853,8184,-10
56748545866,56748545856,-10,1191,1192,-10
56749030450,56749030452,2,1535,1447,-10
56751137209,56751137191,-18,1537,1448,-10
56757683287,56757683283,-4,725,2128,-10
56758976057,56758976058,1,2230,2488,-10
56759679470,56759679474,4,2920,1582,-10
56759708323,56759708325,2,1694,1525,-10
56760303918,56760303929,11,1373,1401,-10
56761634457,56761634459,2,2037,2049,-10
56762311123,56762311125,2,1499,1617,-10
56762613670,56762613690,20,703,951,-10
56763207034,56763207042,8,555,410,-10
56764225416,56764225419,3,1700,1892,-10
56764414937,56764414938,1,1287,1488,-10
56767948253,56767948258,5,2200,1252,-10
56770231281,56770231282,1,1688,1430,-10
56771197882,56771197885,3,1542,968,-10
56773939657,56773939659,2,1479,1190,-10
56776093589,56776093590,1,1363,1265,-10
56779191210,56779191211,1,1447,1707,-10
56780342190,56780342190,0,1271,1705,-10
56781907159,56781907160,1,1302,1416,-10
56781945579,56781945581,2,1029,1397,-10
56784342857,56784342859,2,1560,2012,-10
56786227570,56786227571,1,1058,1470,-10
56789529113,56789529114,1,979,1208,-10
56789732494,56789732495,1,1232,988,-10
56790698818,56790698822,4,1202,1527,-10
56791528653,56791528655,2,2005,1790,-10
56792016782,56792016785,3,1676,1477,-10
56794621754,56794621755,1,1584,1674,-10
56794697094,56794697098,4,1513,1240,-10
56798373301,56798373302,1,1105,964,-10
56798868912,56798868912,0,1456,2319,-10
56799091562,56799091559,-3,1437,1392,-10
56799376712,56799376714,2,2044,1768,-10
56803450446,56803450446,0,1328,2186,-10
56805981418,56805981422,4,1604,1201,-10
56810711218,56810711221,3,1436,1450,-10
56811745615,56811745617,2,1850,1645,-10
56817434675,56817434682,7,4148,1514,-10
56818061426,56818061426,0,2009,1733,-10
56819432113,56819432113,0,1612,1262,-10
56820067234,56820067236,2,1640,1619,-10
56825883158,56825883164,6,1328,1206,-10
56826956353,56826956354,1,2621,1958,-10
56833641186,56833641186,0,1205,1154,-10
56836766915,56836766919,4,1725,1487,-10
56837345110,56837345115,5,1708,1742,-10
56838681343,56838681342,-1,818,1767,-10
56839306034,56839306034,0,2136,2028,-10
56840059705,56840059706,1,1448,2194,-10
56840245123,56840245123,0,2130,1542,-10
56845498397,56845498398,1,1928,1985,-10
56845683888,56845683884,-4,1194,1051,-10
56848577278,56848577281,3,1733,1274,-10
56848884930,56848884930,0,2426,2056,-10
56849544238,56849544241,3,1792,1327,-10
56849743614,56849743614,0,925,865,-10
56852018614,56852018615,1,1344,1590,-10
56852225469,56852225469,0,1681,1507,-10
56853380610,56853380611,1,1739,1819,-10
56853837481,56853837482,1,1422,1479,-10
56856481742,56856481742,0,1761,1462,-10
56858409729,56858409732,3,1462,1501,-10
56864291966,56864291966,0,1416,1822,-10
56865014399,56865014401,2,1444,1599,-10
56867109718,56867109717,-1,1499,1195,-10
56867233957,56867233961,4,1821,1193,-10
56872434479,56872434481,2,1531,2110,-10
56878964687,56878964690,3,1104,1127,-10
56879925717,56879925717,0,1746,1748,-10
56880778538,56880778543,5,3767,2740,-10
56881242665,56881242669,4,1153,1237,-10
56882310419,56882310422,3,1181,1002,-10
56882423645,56882423627,-18,973,1032,-10
56883738125,56883738130,5,1188,846,-10
56887910544,56887910547,3,1290,889,-10
56888921072,56888921078,6,46865,20836,-10
56889551010,56889551012,2,2191,2236,-10
56890010686,56890010689,3,1724,1687,-10
56894745643,56894745643,0,2192,1457,-10
56896771740,56896771737,-3,2039,1454,-10
56897144338,56897144340,2,1467,1745,-10
56897713660,56897713663,3,2060,1551,-10
56904834245,56904834249,4,1497,738,-10
56905468570,56905468575,5,2262,1939,-10
56906233499,56906233494,-5,1055,2815,-10
56911149682,56911149682,0,1602,2411,-10
56911563043,56911563040,-3,37353,43830,-10
56916227938,56916227943,5,2085,1391,-10
56921012679,56921012680,1,1944,1669,-10
56921831811,56921831814,3,1580,1515,-10
56926454838,56926454841,3,1986,1334,-10
56926767724,56926767725,1,1243,1310,-10
56931202758,56931202762,4,958,1725,-10
56935006829,56935006831,2,1454,1854,-10
56942108655,56942108658,3,1515,1317,-10
56942642471,56942642464,-7,32869,12363,-10
56943129134,56943129137,3,1925,1699,-10
56943686027,56943686027,0,1656,1760,-10
56945082985,56945082986,1,1290,1309,-10
56945196885,56945196886,1,1873,1866,-10
56948147710,56948147710,0,977,1950,-10
56948650474,56948650473,-1,1026,1037,-10
56958768789,56958768790,1,1616,1786,-10
56959030079,56959030077,-2,1325,1556,-10
56960020345,56960020347,2,1674,1801,-10
56963363270,56963363273,3,1508,1347,-10
56964746190,56964746193,3,1726,1417,-10
56966224555,56966224557,2,1924,2448,-10
56967969456,56967969459,3,1372,1364,-10
56968904850,56968904853,3,1092,1404,-10
56973955871,56973955873,2,1879,1699,-10
56975240738,56975240739,1,914,1200,-10
56977577562,56977577562,0,1284,1535,-10
56980319586,56980319591,5,4917,1392,-10
56982468173,56982468174,1,1812,2389,-10
56987431482,56987431483,1,1286,1391,-10
56989385934,56989385926,-8,1581,1284,-10
56989779093,56989779094,1,1270,1357,-10
56990814630,56990814631,1,1050,1402,-10
56992390346,56992390350,4,1616,1115,-10
56995368012,56995368014,2,1478,1497,-10
56995661026,56995661007,-19,1317,1295,-10
56997742458,56997742459,1,1218,1615,-10
57000282728,57000282729,1,1777,1669,-10
57003709146,57003709146,0,1858,2216,-10
57004923085,57004923085,0,1176,1446,-10
57006528062,57006528064,2,1281,1822,-10
57008008009,57008008010,1,2507,2359,-10
57008597760,57008597758,-2,1255,2003,-10
57016748005,57016748007,2,2096,1914,-10
57021147089,57021147090,1,1528,1043,-10
57021786438,57021786441,3,1895,1282,-10
57022264315,57022264317,2,1171,1182,-10
57024538781,57024538783,2,1519,1311,-10
57026998010,57026998006,-4,2030,4204,-10
57028778158,57028778160,2,2091,2037,-10
57031652844,57031652845,1,1447,1715,-10
57033682830,57033682831,1,960,1179,-10
57035938284,57035938289,5,23172,20359,-10
57036274884,57036274885,1,2005,1684,-10
57036914896,57036914890,-6,872,3684,-10
57039917406,57039917415,9,2989,1604,-10
57040376897,57040376901,4,2059,1577,-10
57042246031,57042246034,3,1679,1336,-10
57043160891,57043160893,2,645,1044,-10
57044905676,57044905678,2,1858,1257,-10
57045918070,57045918073,3,1854,1471,-10
57049411464,57049411465,1,1742,1461,-10
57053685296,57053685298,2,1937,1596,-10
57056250298,57056250299,1,1124,1021,-10
57060769653,57060769654,1,1089,1063,-10
57067002443,57067002447,4,1782,1943,-10
57067499898,57067499902,4,10074,17859,-10
57069028074,57069028076,2,1146,1078,-10
57069977228,57069977235,7,2418,1374,-10
57075825409,57075825388,-21,1963,1553,-10
57077580318,57077580319,1,1474,1832,-10
57084405809,57084405810,1,1858,1164,-10
57089549743,57089549743,0,1567,1798,-10
57090024917,57090024919,2,1308,1214,-10
57091726642,57091726645,3,1431,1524,-10
57098620406,57098620401,-5,921,2311,-10
57100243621,57100243622,1,1646,1206,-10
57104375421,57104375421,0,1342,1854,-10
57105994658,57105994661,3,1853,1795,-10
57109222172,57109222174,2,2038,2134,-10
57111380260,57111380262,2,1688,1508,-10
57115160771,57115160771,0,1349,1680,-10
57121110603,57121110605,2,1301,1402,-10
57122930690,57122930693,3,1084,974,-10
57123601726,57123601718,-8,941,1355,-10
57125624747,57125624727,-20,1537,1536,-10
57127050659,57127050662,3,4117,2716,-10
57128067145,57128067146,1,1405,794,-10
57128612438,57128612442,4,912,1414,-10
57132026338,57132026339,1,959,1414,-10
57133215442,57133215444,2,1429,1086,-10
57135652296,57135652297,1,1158,1666,-10
57135720926,57135720926,0,1487,1403,-10
57137435541,57137435542,1,1758,1333,-10
57143691842,57143691842,0,1772,1803,-10
57143813541,57143813543,2,2039,1509,-10
57146324728,57146324730,2,1804,1625,-10
57147153534,57147153536,2,1520,1547,-10
57150328130,57150328131,1,1771,2201,-10
57151497226,57151497227,1,1689,1952,-10
57151639831,57151639832,1,1616,1746,-10
57151964577,57151964569,-8,1542,1427,-10
57152174450,57152174450,0,1704,1487,-10
57153363954,57153363960,6,2471,1186,-10
57155807188,57155807182,-6,1106,1463,-10
57158706442,57158706444,2,1484,1223,-10
57162249058,57162249062,4,1596,1694,-10
57162415781,57162415783,2,1715,1418,-10
57164177783,57164177786,3,1708,2091,-10
57164568946,57164568949,3,1360,1478,-10
57167869187,57167869190,3,2002,1957,-10
57167970710,57167970713,3,1155,1250,-10
57168237534,57168237536,2,1464,1807,-10
57168398301,57168398302,1,1076,1240,-10
57168688977,57168688979,2,1964,1239,-10
57169141815,57169141816,1,1732,2003,-10
57171092827,57171092830,3,1877,1334,-10
57171844432,57171844437,5,2098,1760,-10
57173355352,57173355355,3,1487,1347,-10
57175661490,57175661494,4,1702,1986,-10
57177811143,57177811146,3,1896,1334,-10
57182296372,57182296376,4,1291,1348,-10
57184000154,57184000156,2,1633,1117,-10
57187147543,57187147547,4,2152,1364,-10
57188680767,57188680771,4,1501,1303,-10
57189416566,57189416575,9,3587,1207,-10
57189566027,57189566030,3,1483,1069,-10
57195233582,57195233584,2,1979,1671,-10
57197690070,57197690075,5,2172,1294,-10
57198838611,57198838610,-1,1012,1633,-10
57200130081,57200130082,1,1495,1375,-10
57204111633,57204111634,1,1958,2543,-10
57206753756,57206753758,2,1653,1861,-10
57209680459,57209680458,-1,1587,2053,-10
57210845834,57210845834,0,1584,1508,-10
57213720167,57213720168,1,1451,1849,-10
57215139269,57215139271,2,1603,2300,-10
57215422253,57215422255,2,1827,1574,-10
57217907446,57217907448,2,1595,1655,-10
57220517794,57220517797,3,1720,1248,-10
57228517978,57228517981,3,1814,1437,-10
57230572179,57230572178,-1,1446,1044,-10
57231062617,57231062618,1,1844,2232,-10
57234297738,57234297739,1,1425,1725,-10
57236083629,57236083631,2,1334,1209,-10
57236945490,57236945490,0,1134,1186,-10
57237238746,57237238747,1,2450,2008,-10
57238113074,57238113078,4,1278,1361,-10
57244728330,57244728331,1,1119,2301,-10
57244798749,57244798752,3,1519,1628,-10
57246272887,57246272884,-3,1476,2811,-10
57247780632,57247780634,2,1934,1986,-10
57248508586,57248508587,1,1028,1448,-10
57249083681,57249083681,0,1571,1762,-10
57249470207,57249470206,-1,729,1374,-10
57250809205,57250809205,0,1658,1830,-10
57250897185,57250897184,-1,1150,2159,-10
57255342443,57255342453,10,11989,33337,-10
57257607305,57257607304,-1,1355,1773,-10
57258820769,57258820771,2,1380,1698,-10
57261311074,57261311075,1,1806,1361,-10
57266302800,57266302802,2,1749,1350,-10
57271677703,57271677706,3,1194,1559,-10
57280049203,57280049205,2,1960,1478,-10
57280407609,57280407610,1,1617,1919,-10
57281042877,57281042882,5,1341,1113,-10
57286210258,57286210260,2,1529,2011,-10
57286999227,57286999227,0,1743,2022,-10
57288732694,57288732696,2,1759,1515,-10
57290322851,57290322854,3,1571,1156,-10
57292315982,57292315985,3,1966,2183,-10
57292886286,57292886287,1,1219,1695,-10
57292957870,57292957870,0,1405,1312,-10
57295614697,57295614699,2,1846,1592,-10
57295858968,57295858969,1,1699,1630,-10
57299231866,57299231870,4,1272,1361,-10
57301197185,57301197185,0,1647,2197,-10
57301292485,57301292487,2,1397,1219,-10
57302010402,57302010406,4,1812,1500,-10
57302206206,57302206219,13,1001,1753,-10
57302948242,57302948244,2,1754,1777,-10
57304461045,57304461038,-7,1294,3542,-10
57307465166,57307465168,2,1613,1652,-10
57309087826,57309087829,3,1733,1785,-10
57312871542,57312871543,1,1956,1699,-10
57315442140,57315442143,3,2093,1575,-10
57315552569,57315552574,5,8256,3801,-10
57317524935,57317524933,-2,1071,2925,-10
57321742201,57321742201,0,1946,1408,-10
57322196588,57322196589,1,1644,1333,-10
57326013259,57326013262,3,1804,1741,-10
57326735691,57326735690,-1,1160,1160,-10
57329575226,57329575229,3,2073,1183,-10
57329786645,57329786646,1,1256,1455,-10
57331102172,57331102178,6,13613,22656,-10
57335058282,57335058282,0,1506,1686,-10
57335164841,57335164845,4,1654,1982,-10
57335669913,57335669917,4,2664,1450,-10
57338900146,57338900146,0,1698,1640,-10
57346193865,57346193866,1,1640,1703,-10
57347234758,57347234760,2,1868,1716,-10
57351378938,57351378940,2,1348,1293,-10
57354429617,57354429615,-2,1891,2299,-10
57354974274,57354974273,-1,1645,1247,-10
57355573414,57355573419,5,10129,53012,-10
57356976227,57356976230,3,1344,1285,-10
57359296892,57359296893,1,929,1806,-10
57361517618,57361517618,0,2130,1897,-10
57363125023,57363125025,2,1916,1522,-10
57368983891,57368983894,3,1924,1665,-10
57372882771,57372882757,-14,1478,2172,-10
57373838908,57373838910,2,1725,1632,-10
57374316462,57374316465,3,1634,1684,-10
57375655762,57375655767,5,1709,1682,-10
57375685310,57375685310,0,1504,1314,-10
57376716518,57376716519,1,1767,2449,-10
57379993519,57379993522,3,1466,1278,-10
57386435584,57386435586,2,973,1332,-10
57387345983,57387345968,-15,902,314,-10
57388037064,57388037066,2,1412,1581,-10
57392446082,57392446080,-2,915,1667,-10
57395753983,57395753985,2,1641,1610,-10
57399222262,57399222263,1,1416,1260,-10
57400303212,57400303213,1,1604,2055,-10
57400691181,57400691185,4,1946,1480,-10
57401344424,57401344425,1,1574,1754,-10
57405855819,57405855822,3,1511,2020,-10
57410094634,57410094634,0,1586,1833,-10
57410636178,57410636181,3,1291,1162,-10
57411637774,57411637775,1,2493,2190,-10
57413142702,57413142706,4,2043,1060,-10
57413381275,57413381278,3,1531,1439,-10
57413653667,57413653669,2,1642,1349,-10
57414097660,57414097662,2,1868,3100,-10
57415867972,57415867975,3,1297,1309,-10
57416096757,57416096760,3,1519,1810,-10
57418232578,57418232579,1,1668,1446,-10
57422748558,57422748559,1,1230,1161,-10
57423447590,57423447590,0,2423,2221,-10
57425582235,57425582244,9,1300,1194,-10
57425672532,57425672554,22,1439,1012,-10
57428270763,57428270766,3,1345,1862,-10
57429063483,57429063482,-1,737,1986,-10
57430372471,57430372473,2,2393,1409,-10
57431581107,57431581096,-11,3606,1369,-10
57431748085,57431748086,1,1464,1339,-10
57432392490,57432392488,-2,1442,2087,-10
57435774637,57435774637,0,1274,1139,-10
57440563921,57440563922,1,1389,1543,-10
57442252174,57442252175,1,1643,1260,-10
57444707522,57444707524,2,1663,1645,-10
57445661303,57445661299,-4,1021,2329,-10
57448702435,57448702438,3,1335,1191,-10
57449051092,57449051096,4,1006,1056,-10
57449989995,57449989998,3,1411,1851,-10
57452021049,57452021053,4,1377,1308,-10
57454011021,57454011023,2,1444,1600,-10
57455343853,57455343850,-3,1623,3201,-10
57457114367,57457114373,6,1766,1413,-10
57459962021,57459962026,5,1840,2134,-10
57463888196,57463888197,1,1222,1027,-10
57465477214,57465477215,1,2155,1630,-10
57465596146,57465596149,3,1410,1606,-10
57468474861,57468474863,2,1380,1493,-10
57469471190,57469471193,3,1121,1185,-10
57473265906,57473265908,2,1628,1826,-10
57474935186,57474935187,1,1721,1828,-10
57477693883,57477693883,0,1066,1536,-10
57478075971,57478075985,14,442,374,-10
57480453705,57480453707,2,1415,1793,-10
57481782993,57481782994,1,1499,1755,-10
57482753207,57482753209,2,1253,1910,-10
57486555471,57486555473,2,1734,2524,-10
57493768619,57493768619,0,1145,1222,-10
57495274792,57495274793,1,1505,1168,-10
57499229598,57499229600,2,1929,2207,-10
57499346648,57499346649,1,1202,1617,-10
57500217507,57500217511,4,1120,1656,-10
57500772995,57500772998,3,1535,1219,-10
57501326465,57501326467,2,1641,1506,-10
57501893624,57501893626,2,1458,962,-10
57504045975,57504045978,3,1504,1490,-10
57506984322,57506984323,1,1638,1177,-10
57509376568,57509376570,2,1742,1563,-10
57513646173,57513646174,1,1987,1934,-10
57514696222,57514696224,2,1560,1501,-10
57519977076,57519977074,-2,1027,1993,-10
57520951817,57520951818,1,916,963,-10
57523004361,57523004365,4,1707,1415,-10
57523667050,57523667057,7,1533,1111,-10
57523843915,57523843918,3,2050,1957,-10
57526066685,57526066685,0,1512,2012,-10
57526926303,57526926302,-1,74,791,-10
57529675389,57529675389,0,1674,1173,-10
57536870655,57536870654,-1,890,1812,-10
57541617470,57541617469,-1,1281,2244,-10
57542727766,57542727770,4,2348,1568,-10
57546946323,57546946326,3,1099,1141,-10
57549085815,57549085818,3,2630,1945,-10
57549540406,57549540404,-2,1406,2366,-10
57550309898,57550309892,-6,1357,4252,-10
57551307386,57551307381,-5,34742,8173,-10
57557802506,57557802506,0,1837,1964,-10
57557856744,57557856744,0,1373,1385,-10
57558632772,57558632777,5,2964,1804,-10
57558932777,57558932779,2,2022,1424,-10
57559409593,57559409595,2,1035,975,-10
57560408846,57560408849,3,1770,1799,-10
57563930070,57563930074,4,1393,1765,-10
57564057249,57564057247,-2,1531,970,-10
57566953303,57566953297,-6,978,4428,-10
57568096671,57568096649,-22,1565,1356,-10
57572682789,57572682789,0,1277,1617,-10
57576802002,57576802001,-1,1834,1911,-10
57579539393,57579539385,-8,1021,1248,-10
57580187141,57580187123,-18,1012,1511,-10
57582201279,57582201282,3,1812,1071,-10
57582456361,57582456360,-1,1851,1702,-10
57584602144,57584602138,-6,1033,806,-10
57584962472,57584962478,6,7164,2810,-10
57586634031,57586634034,3,1614,1644,-10
57587342710,57587342714,4,45610,33662,-10
57589854015,57589854018,3,1124,929,-10
57590041267,57590041270,3,1242,1278,-10
57590627390,57590627384,-6,1765,6057,-10
57592674374,57592674374,0,1367,1650,-10
57594017130,57594017134,4,1685,1408,-10
57594531973,57594531975,2,1336,1875,-10
57594855145,57594855147,2,1667,1426,-10
57595179085,57595179088,3,1861,1882,-10
57595598946,57595598949,3,1528,1921,-10
57603440886,57603440884,-2,1398,2263,-10
57604199975,57604199977,2,1583,1589,-10
57608293166,57608293170,4,1207,1673,-10
57610001946,57610001947,1,1255,1197,-10
57612231407,57612231409,2,1835,1944,-10
57612258394,57612258395,1,1940,1538,-10
57612828314,57612828314,0,1477,1820,-10
57612925220,57612925222,2,1018,1272,-10
57618772433,57618772434,1,1737,1679,-10
57624528207,57624528210,3,993,1053,-10
57626747067,57626747046,-21,1627,1528,-10
57629550034,57629550033,-1,1381,1769,-10
57630599446,57630599451,5,3266,1736,-10
57631323839,57631323843,4,1106,959,-10
57632318162,57632318163,1,1632,1661,-10
57635346934,57635346936,2,1677,1378,-10
57638125496,57638125499,3,1497,1325,-10
57641589336,57641589338,2,1983,1747,-10
57641848803,57641848802,-1,1142,1252,-10
57643135670,57643135670,0,1436,1441,-10
57644394008,57644394003,-5,1561,1716,-10
57645150838,57645150838,0,1231,2006,-10
57654091557,57654091559,2,1663,1703,-10
57654618610,57654618611,1,1802,1896,-10
57664742904,57664742906,2,1520,1207,-10
57666093560,57666093562,2,1263,1262,-10
57666746990,57666746990,0,883,1648,-10
57668763189,57668763193,4,1804,1838,-10
57668822126,57668822127,1,1502,1880,-10
57671689482,57671689487,5,1264,1812,-10
57673080310,57673080309,-1,1296,1807,-10
57674050330,57674050331,1,1350,1654,-10
57677340222,57677340223,1,1574,1143,-10
57677516039,57677516042,3,2008,1697,-10
57679297449,57679297451,2,1987,1758,-10
57679786706,57679786710,4,1280,1348,-10
57681003386,57681003385,-1,1127,1360,-10
57683112358,57683112362,4,1819,1820,-10
57683868246,57683868248,2,1474,1328,-10
57686417188,57686417189,1,2117,1403,-10
57687346570,57687346573,3,1107,1422,-10
57697960362,57697960364,2,1304,943,-10
57700267461,57700267466,5,1395,945,-10
57702112690,57702112694,4,2425,1833,-10
57702721870,57702721880,10,1958,1800,-10
57705277158,57705277157,-1,1938,1462,-10
57707120009,57707120009,0,1247,1555,-10
57711275299,57711275301,2,1227,833,-10
57712429219,57712429221,2,1014,1630,-10
57713735990,57713735983,-7,2953,11679,-10
57715763758,57715763761,3,1819,1993,-10
57717141137,57717141138,1,1987,1802,-10
57717894011,57717894010,-1,2129,2587,-10
57718130278,57718130278,0,1627,1311,-10
57721531966,57721531966,0,891,1173,-10
57725416377,57725416379,2,911,829,-10
57729006693,57729006694,1,1377,1277,-10
57731450324,57731450327,3,1389,1144,-10
57732171919,57732171922,3,1733,1727,-10
57733969300,57733969306,6,2173,900,-10
57735507201,57735507205,4,1246,1414,-10
57737494278,57737494277,-1,1741,1417,-10
57741554611,57741554613,2,1402,1751,-10
57743846463,57743846467,4,2035,1370,-10
57746387637,57746387638,1,1185,1779,-10
57747503547,57747503549,2,960,1265,-10
57748137302,57748137305,3,1448,1200,-10
57749319434,57749319436,2,1367,1360,-10
57752872812,57752872813,1,2388,1776,-10
57753803394,57753803393,-1,1221,1486,-10
57758341059,57758341060,1,1820,2084,-10
57759868079,57759868083,4,1357,1221,-10
57760116902,57760116906,4,1892,1287,-10
57761837461,57761837464,3,1455,1210,-10
57764403632,57764403642,10,9900,36620,-10
57764518392,57764518394,2,1159,1371,-10
57765309344,57765309347,3,1595,1515,-10
57768264366,57768264367,1,1536,2271,-10
57768785877,57768785879,2,1913,1531,-10
57769044888,57769044889,1,1488,1797,-10
57769826327,57769826330,3,1575,783,-10
57770951480,57770951480,0,1675,1687,-10
57772586403,57772586406,3,1188,780,-10
57774025473,57774025479,6,1964,1268,-10
57775351592,57775351594,2,1673,1129,-10
57778560953,57778560954,1,1546,1471,-10
57779488631,57779488633,2,1145,1185,-10
57780062205,57780062207,2,1006,1074,-10
57782132793,57782132794,1,1187,2152,-10
57782264279,57782264273,-6,1501,4751,-10
57782305732,57782305734,2,1651,1509,-10
57782641075,57782641077,2,1801,2007,-10
57784004894,57784004895,1,1740,2285,-10
57784358750,57784358751,1,1909,1399,-10
57787804957,57787804958,1,1448,1202,-10
57791837673,57791837676,3,2215,1943,-10
57792219126,57792219104,-22,1713,1410,-10
57792381903,57792381907,4,1635,1738,-10
57792590878,57792590881,3,1634,1579,-10
57800616114,57800616116,2,1796,1007,-10
57804798791,57804798793,2,1293,903,-10
57805203994,57805203994,0,1405,1234,-10
57806306152,57806306154,2,2041,1773,-10
57807560587,57807560586,-1,1717,1638,-10
57811143213,57811143204,-9,1741,1314,-10
57812124250,57812124252,2,1834,1432,-10
57812655366,57812655370,4,3403,2683,-10
57815402266,57815402269,3,1933,2591,-10
57815937663,57815937666,3,1646,1513,-10
57816932245,57816932248,3,1550,1474,-10
57821083888,57821083891,3,1535,1234,-10
57821441093,57821441094,1,1226,1144,-10
57823149884,57823149884,0,1732,1862,-10
57823644105,57823644107,2,1169,1269,-10
57826335952,57826335932,-20,653,378,-10
57829860770,57829860771,1,1435,1544,-10
57831658692,57831658694,2,1484,1846,-10
57832187832,57832187833,1,1537,1392,-10
57832566786,57832566789,3,2007,1896,-10
57835009562,57835009566,4,1762,1654,-10
57835275543,57835275546,3,1627,1832,-10
57842402972,57842402974,2,1429,1531,-10
57845303982,57845303982,0,1023,936,-10
57847787583,57847787586,3,1976,1487,-10
57848076338,57848076342,4,1638,1324,-10
57848335310,57848335323,13,1833,1335,-10
57849108230,57849108227,-3,835,2269,-10
57855552027,57855552021,-6,1590,3837,-10
57857480982,57857480986,4,1391,766,-10
57858715673,57858715676,3,1948,1811,-10
57858846578,57858846594,16,1833,1320,-10
57863054538,57863054540,2,2310,2562,-10
57863679522,57863679523,1,1612,2220,-10
57864539053,57864539053,0,1426,1616,-10
57867890290,57867890294,4,1812,1759,-10
57868314395,57868314396,1,1387,1602,-10
57869800721,57869800728,7,3438,1406,-10
57870061922,57870061922,0,1566,2147,-10
57872111925,57872111929,4,1026,1651,-10
57873436528,57873436530,2,1551,1400,-10
57874437279,57874437279,0,1607,1759,-10
57875750365,57875750367,2,1779,1418,-10
57876121522,57876121525,3,1642,1907,-10
57877252822,57877252825,3,2055,1709,-10
57882435083,57882435082,-1,1206,1124,-10
57883898577,57883898577,0,1679,1554,-10
57884179562,57884179548,-14,1575,1357,-10
57886830397,57886830396,-1,1211,1508,-10
57887497858,57887497862,4,2270,1431,-10
57890661406,57890661407,1,1238,1128,-10
57891867253,57891867254,1,1719,1758,-10
57892645108,57892645107,-1,1132,2040,-10
57893077310,57893077315,5,2143,1132,-10
57893320777,57893320766,-11,1127,730,-10
57895393229,57895393231,2,1996,1530,-10
57895842003,57895842005,2,1701,1776,-10
57896150078,57896150078,0,2249,1430,-10
57901287589,57901287591,2,1026,1580,-10
57905556184,57905556185,1,1674,2278,-10
57905961333,57905961334,1,1509,1078,-10
57906806543,57906806545,2,1540,2224,-10
57908076366,57908076368,2,1568,1184,-10
57908215838,57908215841,3,2148,1978,-10
57910070967,57910070970,3,1432,1634,-10
57910372914,57910372917,3,1933,2596,-10
57910872201,57910872203,2,2035,1766,-10
57916715770,57916715770,0,1488,2071,-10
57921348362,57921348364,2,1465,1810,-10
57925332161,57925332165,4,1616,1445,-10
57925613142,57925613143,1,1179,1625,-10
57929849378,57929849379,1,1596,1404,-10
57932207162,57932207165,3,1375,1257,-10
57936115025,57936115026,1,2306,2107,-10
57936443777,57936443780,3,3553,3751,-10
57938548477,57938548478,1,1967,1990,-10
57941202737,57941202739,2,1658,1044,-10
57944789493,57944789495,2,1623,1198,-10
57945864425,57945864427,2,1067,1132,-10
57948037403,57948037406,3,1303,1162,-10
57951353559,57951353561,2,2050,1594,-10
57955040482,57955040485,3,1630,1231,-10
57955194408,57955194410,2,1565,1627,-10
57957126549,57957126551,2,1971,1618,-10
57962387818,57962387818,0,1429,1767,-10
57963405106,57963405110,4,2113,1470,-10
57964488071,57964488071,0,1137,1569,-10
57966629734,57966629735,1,1990,1920,-10
57966715181,57966715182,1,1196,1453,-10
57968042829,57968042833,4,1359,1488,-10
57974964090,57974964091,1,2177,1809,-10
57975157291,57975157292,1,1527,1610,-10
57977934353,57977934355,2,1852,1179,-10
57978789618,57978789622,4,1605,1724,-10
57979919693,57979919698,5,1238,1397,-10
57982061066,57982061064,-2,2061,3854,-10
57982508466,57982508468,2,1489,1422,-10
57982777261,57982777267,6,1959,1050,-10
57983722897,57983722898,1,1803,1907,-10
57987235946,57987235938,-8,1161,5053,-10
57987589479,57987589482,3,1297,1483,-10
57988818094,57988818093,-1,1464,1704,-10
57989017356,57989017358,2,2038,1839,-10
57990078025,57990078032,7,2722,1221,-10
57990960706,57990960709,3,1359,1620,-10
57991125281,57991125284,3,1612,1022,-10
57992902237,57992902238,1,1567,1531,-10
57994145616,57994145614,-2,1471,1292,-10
57995446866,57995446868,2,1395,1639,-10
57996616092,57996616094,2,2355,1685,-10
57998915965,57998915969,4,1928,1540,-10
58007151600,58007151602,2,2614,1956,-10
58008095902,58008095922,20,1485,2100,-10
58011042821,58011042822,1,2031,1745,-10
58012476066,58012476066,0,1676,1974,-10
58020186090,58020186091,1,1149,1452,-10
58022058042,58022058041,-1,1580,1833,-10
58022219158,58022219159,1,1381,1791,-10
58022579901,58022579902,1,2178,1800,-10
58028793790,58028793790,0,1398,1664,-10
58029123694,58029123696,2,2172,2292,-10
58029246045,58029246024,-21,1670,1703,-10
58030606633,58030606631,-2,1135,1305,-10
58033419745,58033419745,0,1590,2545,-10
58034212946,58034212947,1,1396,1207,-10
58040185102,58040185103,1,1615,1949,-10
58043291045,58043291046,1,1187,1191,-10
58043600297,58043600299,2,1244,1393,-10
58044202253,58044202255,2,814,1140,-10
58047774519,58047774520,1,1772,1746,-10
58051494647,58051494645,-2,485,1011,-10
58054229395,58054229395,0,1113,1384,-10
58055874358,58055874363,5,1511,1048,-10
58056829559,58056829562,3,1623,1251,-10
58058188046,58058188050,4,1537,1105,-10
58059227460,58059227461,1,1558,1491,-10
58063165946,58063165948,2,1142,1840,-10
58069984051,58069984054,3,1135,1417,-10
58072731197,58072731198,1,1926,1618,-10
58074830851,58074830853,2,1119,1702,-10
58075009070,58075009051,-19,2019,676,-10
58076142366,58076142370,4,2442,1676,-10
58078642072,58078642091,19,494,988,-10
58079734290,58079734294,4,2024,1584,-10
58080816843,58080816846,3,1091,1612,-10
58081275117,58081275119,2,1957,1861,-10
58081942878,58081942881,3,1559,1377,-10
58084509166,58084509165,-1,1682,1785,-10
58090438023,58090438026,3,1721,1616,-10
58092742670,58092742673,3,1741,1757,-10
58093411573,58093411574,1,1184,1552,-10
58094143111,58094143105,-6,2965,14212,-10
58094512050,58094512050,0,1657,1360,-10
58097118666,58097118668,2,1285,2102,-10
58099968765,58099968767,2,785,1171,-10
58101165731,58101165735,4,1051,1124,-10
58103228058,58103228060,2,1847,1143,-10
58103374186,58103374194,8,1820,1545,-10
58109407350,58109407353,3,1251,1894,-10
58110818807,58110818802,-5,1007,4084,-10
58115999770,58115999771,1,1552,1573,-10
58118349049,58118349048,-1,1461,1429,-10
58118943947,58118943924,-23,1303,1150,-10
58122650102,58122650121,19,683,1621,-10
58125362145,58125362147,2,1733,1444,-10
58126313430,58126313430,0,1307,1892,-10
58127336141,58127336131,-10,1075,1280,-10
58128754391,58128754391,0,1613,1238,-10
58129708385,58129708387,2,1468,1707,-10
58131541601,58131541601,0,1289,2071,-10
58132747870,58132747873,3,1665,1675,-10
58134829510,58134829515,5,1487,1072,-10
58136252082,58136252084,2,1564,1463,-10
58139202231,58139202231,0,1314,1333,-10
58140630500,58140630502,2,1748,2318,-10
58142186718,58142186722,4,1369,1214,-10
58142614826,58142614810,-16,1683,1588,-10
58143432020,58143432021,1,1577,1516,-10
58143985682,58143985683,1,1488,1517,-10
58144837401,58144837405,4,1322,2068,-10
58145930753,58145930754,1,2274,1998,-10
58148175493,58148175494,1,1689,1156,-10
58148498438,58148498442,4,3853,2626,-10
58149644447,58149644451,4,1747,1103,-10
58158494347,58158494350,3,3030,1929,-10
58159149360,58159149378,18,17148,36768,-10
58160974996,58160975010,14,1537,1226,-10
58162449441,58162449442,1,1699,2296,-10
58164116310,58164116311,1,1134,1042,-10
58166871108,58166871109,1,2000,1510,-10
58167849910,58167849913,3,729,1673,-10
58170127508,58170127509,1,1249,1472,-10
58170769385,58170769386,1,1906,1688,-10
58175840758,58175840761,3,1792,1450,-10
58177043487,58177043489,2,1733,1575,-10
58178512931,58178512931,0,2128,2017,-10
58180104155,58180104158,3,1474,1081,-10
58182054594,58182054594,0,1434,1662,-10
58183429622,58183429623,1,1149,1061,-10
58183565834,58183565838,4,1674,1439,-10
58184501885,58184501890,5,15045,9673,-10
58186738287,58186738289,2,1509,1178,-10
58186918681,58186918700,19,1871,1457,-10
58187481607,58187481609,2,1430,1394,-10
58188112179,58188112183,4,2262,1786,-10
58188227709,58188227714,5,2103,1545,-10
58188388590,58188388590,0,1476,1838,-10
58190770185,58190770186,1,1988,2534,-10
58191477493,58191477495,2,1279,1147,-10
58192264175,58192264176,1,1129,930,-10
58197625533,58197625534,1,1556,1434,-10
58199312266,58199312266,0,1229,1707,-10
58199949234,58199949238,4,2220,1430,-10
58200353002,58200353008,6,742,515,-10
58200874043,58200874041,-2,2064,2268,-10
58201344684,58201344687,3,1852,1781,-10
58206571605,58206571607,2,1599,1623,-10
58210081420,58210081421,1,2387,1430,-10
58213031431,58213031434,3,2196,1956,-10
58213245000,58213245010,10,1805,1675,-10
58214342151,58214342153,2,1937,1510,-10
58218187130,58218187134,4,2317,2061,-10
58221826630,58221826631,1,1874,2122,-10
58222448010,58222448010,0,1583,2526,-10
58224051944,58224051944,0,1689,1315,-10
58224346961,58224346962,1,1533,1188,-10
58225211128,58225211142,14,275,1027,-10
58225300823,58225300825,2,708,1160,-10
58226813674,58226813675,1,1306,1787,-10
58227842674,58227842654,-20,1751,1666,-10
58229981777,58229981779,2,772,1260,-10
58232243849,58232243851,2,1707,1753,-10
58232427265,58232427261,-4,1879,2860,-10
58236143541,58236143543,2,1447,2021,-10
58237478323,58237478325,2,1214,1394,-10
58237994979,58237994981,2,1541,1288,-10
58243312486,58243312485,-1,1185,1585,-10
58249165656,58249165663,7,1338,1404,-10
58251879742,58251879721,-21,928,909,-10
58251911963,58251911969,6,39237,20621,-10
58252128375,58252128378,3,2306,1545,-10
58254332640,58254332640,0,1437,1457,-10
58259386231,58259386234,3,1100,1081,-10
58261132635,58261132637,2,1698,1404,-10
58266371670,58266371671,1,2070,1371,-10
58266487918,58266487899,-19,1670,1726,-10
58268102503,58268102503,0,1231,1503,-10
58269511746,58269511750,4,1824,1042,-10
58269845002,58269845003,1,1461,1635,-10
58271351899,58271351900,1,1344,1713,-10
58272190623,58272190603,-20,1282,1686,-10
58273722828,58273722828,0,1429,1398,-10
58274117112,58274117114,2,1503,1608,-10
58281306125,58281306128,3,1176,1689,-10
58284998086,58284998086,0,1412,1370,-10
58286132057,58286132060,3,2628,1748,-10
58289146978,58289146979,1,1379,2026,-10
58290982104,58290982106,2,1676,1530,-10
58291276626,58291276629,3,1589,1731,-10
58291759442,58291759441,-1,1186,1507,-10
58299211881,58299211882,1,1707,1765,-10
58299264302,58299264302,0,1840,1998,-10
58300530726,58300530727,1,1117,1062,-10
58303434925,58303434926,1,1281,1375,-10
58305861669,58305861670,1,1378,1495,-10
58306325758,58306325759,1,678,1133,-10
58307083413,58307083413,0,1350,1647,-10
58309537113,58309537114,1,1506,1511,-10
58313652112,58313652115,3,1718,2246,-10
58315997042,58315997042,0,1338,2042,-10
58316311662,58316311663,1,1194,1048,-10
58320591082,58320591084,2,1397,1692,-10
58322058955,58322058964,9,915,931,-10
58323581033,58323581034,1,1362,1651,-10
58326135501,58326135502,1,1637,1346,-10
58326649363,58326649366,3,1331,1512,-10
58328122638,58328122638,0,1408,2210,-10
58328887779,58328887781,2,1312,1819,-10
58337360345,58337360350,5,2455,1459,-10
58339392726,58339392718,-8,1985,8195,-10
58339679881,58339679883,2,1103,1153,-10
58341609451,58341609452,1,1216,1358,-10
58341662495,58341662498,3,1594,874,-10
58348347157,58348347158,1,3021,2813,-10
58348487822,58348487821,-1,1555,1916,-10
58349802009,58349802010,1,1960,1305,-10
58350032906,58350032907,1,1424,1274,-10
58351737571,58351737573,2,1725,1667,-10
58353651809,58353651810,1,765,1361,-10
58354658007,58354658010,3,1067,893,-10
58355158190,58355158191,1,2130,2428,-10
58357084767,58357084770,3,1819,1694,-10
58360539882,58360539882,0,1243,1568,-10
58366504909,58366504912,3,1579,1385,-10
58368104011,58368104015,4,1806,2053,-10
58369599459,58369599452,-7,753,383,-10
58369890344,58369890346,2,2236,1724,-10
58370654105,58370654109,4,1734,1353,-10
58371309333,58371309339,6,3076,1467,-10
58371662748,58371662749,1,1410,1355,-10
58374659070,58374659070,0,1369,2215,-10
58375114190,58375114193,3,1116,1531,-10
58378473680,58378473682,2,1241,1211,-10
58379835281,58379835282,1,2148,2080,-10
58382610767,58382610768,1,1679,1764,-10
58383138873,58383138875,2,2814,1434,-10
58383581728,58383581729,1,1453,2182,-10
58384224914,58384224914,0,1703,1581,-10
58390249304,58390249306,2,1266,1326,-10
58391361141,58391361142,1,1698,1437,-10
58393467674,58393467674,0,1777,2030,-10
58394941077,58394941078,1,1064,899,-10
58397761297,58397761300,3,1779,1566,-10
58399283974,58399283974,0,1829,1230,-10
58399328463,58399328470,7,1791,896,-10
58403630435,58403630438,3,2342,1331,-10
58404640351,58404640331,-20,1557,1579,-10
58405620590,58405620593,3,2173,1844,-10
58406684354,58406684357,3,1685,1759,-10
58408493514,58408493493,-21,1896,1789,-10
58411657471,58411657471,0,1363,1200,-10
58414459022,58414459025,3,2288,1441,-10
58415981430,58415981432,2,1278,2028,-10
58417384405,58417384405,0,1414,1236,-10
58419467977,58419467982,5,2401,1595,-10
58422638394,58422638394,0,1955,1714,-10
58426609893,58426609891,-2,1529,1682,-10
58429285542,58429285545,3,1683,1671,-10
58429901362,58429901365,3,1835,1286,-10
58430904734,58430904734,0,1249,1233,-10
58436177991,58436177997,6,1890,1227,-10
58439045946,58439045947,1,1826,1868,-10
58439482966,58439482972,6,2372,1546,-10
58439796379,58439796378,-1,1680,1988,-10
58441242153,58441242154,1,1276,1212,-10
58441517727,58441517733,6,3297,1856,-10
58443192736,58443192738,2,1755,1193,-10
58443966786,58443966806,20,909,1358,-10
58446253639,58446253641,2,2524,1711,-10
58446385069,58446385070,1,1651,1559,-10
58449672813,58449672814,1,2156,1207,-10
58452910606,58452910607,1,1791,1623,-10
58453497533,58453497534,1,1803,1730,-10
58455142388,58455142392,4,1827,1513,-10
58457495469,58457495471,2,1367,1480,-10
58457615878,58457615878,0,1804,1632,-10
58459430191,58459430194,3,1227,1360,-10
58462181564,58462181557,-7,1595,5848,-10
58462986903,58462986907,4,1432,1416,-10
58463402942,58463402944,2,1884,1534,-10
58464941510,58464941512,2,1914,1792,-10
58468278745,58468278746,1,1699,1383,-10
58472619330,58472619329,-1,876,1404,-10
58472742699,58472742702,3,1565,1918,-10
58480822530,58480822532,2,1285,1452,-10
58481218476,58481218478,2,1641,1732,-10
58483032058,58483032060,2,923,1782,-10
58484516861,58484516865,4,1392,1164,-10
58485119193,58485119194,1,1173,1776,-10
58487317045,58487317048,3,2056,1556,-10
58489579770,58489579772,2,1308,1570,-10
58492737858,58492737862,4,1939,1266,-10
58493246353,58493246354,1,1447,1895,-10
58494387030,58494387031,1,1231,842,-10
58495572309,58495572310,1,1599,1472,-10
58500785889,58500785892,3,2233,2041,-10
58502060938,58502060940,2,1570,1633,-10
58502126861,58502126864,3,1819,2218,-10
58505713183,58505713185,2,1395,1542,-10
58508251806,58508251809,3,1180,1525,-10
58510064320,58510064321,1,1866,1631,-10
58512245240,58512245235,-5,1212,2738,-10
58512291406,58512291408,2,1214,1020,-10
58516495277,58516495290,13,1469,1461,-10
58516887359,58516887359,0,1732,1392,-10
58518336321,58518336323,2,1618,1147,-10
58521075285,58521075286,1,1486,1390,-10
58522053655,58522053653,-2,1431,1916,-10
58522091451,58522091444,-7,1385,1327,-10
58535767381,58535767382,1,1738,1394,-10
58536968815,58536968816,1,1350,1283,-10
58537814809,58537814809,0,2339,1597,-10
58538749998,58538749998,0,991,1000,-10
58542245026,58542245026,0,1544,1432,-10
58543507668,58543507671,3,1270,1349,-10
58545903779,58545903774,-5,1056,4209,-10
58546262038,58546262041,3,1685,953,-10
58549238171,58549238152,-19,2300,1733,-10
58549376010,58549376012,2,1409,1410,-10
58554114807,58554114810,3,2035,1855,-10
58556903591,58556903597,6,2133,1713,-10
58558347931,58558347935,4,2154,1463,-10
58569699756,58569699762,6,1780,1321,-10
58572944713,58572944715,2,1862,2328,-10
58572976406,58572976410,4,1164,979,-10
58577426714,58577426716,2,2443,1735,-10
58578304637,58578304638,1,1829,1907,-10
58579350774,58579350776,2,1802,1646,-10
58579713122,58579713126,4,1169,1384,-10
58581004705,58581004702,-3,874,1607,-10
58581777306,58581777305,-1,1698,2928,-10
58582328422,58582328428,6,2208,1830,-10
58584887313,58584887315,2,1773,1318,-10
58588190067,58588190067,0,1701,1742,-10
58588459649,58588459650,1,1051,1604,-10
58589993038,58589993040,2,1147,1706,-10
58590047257,58590047245,-12,988,683,-10
58593033802,58593033802,0,1584,2079,-10
58594090792,58594090807,15,1524,1653,-10
58594866724,58594866733,9,1889,1498,-10
58597490645,58597490649,4,682,1082,-10
58599530333,58599530335,2,2288,1954,-10
58604430929,58604430931,2,2312,2109,-10
58608311745,58608311746,1,1578,1456,-10
58619221226,58619221226,0,1839,1287,-10
58619733208,58619733217,9,1435,1530,-10
58621438417,58621438419,2,1257,1207,-10
58621955182,58621955184,2,1764,1879,-10
58623295817,58623295818,1,1542,1127,-10
58623457476,58623457479,3,1877,2095,-10
58624945559,58624945562,3,2020,1639,-10
58627386216,58627386218,2,1842,1441,-10
58627430404,58627430401,-3,621,1741,-10
58628646678,58628646680,2,1836,1673,-10
58630538926,58630538930,4,1446,1812,-10
58633950402,58633950402,0,1620,2208,-10
58634281062,58634281064,2,1861,2456,-10
58636566829,58636566831,2,1415,1529,-10
58637752993,58637752995,2,1383,2216,-10
58642370544,58642370547,3,1514,974,-10
58642505666,58642505669,3,1121,1651,-10
58644129631,58644129635,4,2584,1716,-10
58645374583,58645374582,-1,1923,1973,-10
58645419228,58645419230,2,1494,1361,-10
58645625930,58645625930,0,1898,1575,-10
58647588607,58647588611,4,1970,1751,-10
58650793654,58650793655,1,2310,1576,-10
58651686803,58651686806,3,1746,1487,-10
58654639306,58654639310,4,1683,1299,-10
58656159869,58656159870,1,1580,1358,-10
58656772734,58656772734,0,1902,1416,-10
58657128930,58657128933,3,1490,1271,-10
58659380726,58659380727,1,1539,1451,-10
58661259330,58661259332,2,1560,1473,-10
58662439968,58662439982,14,2445,1194,-10
58663017429,58663017443,14,1280,1505,-10
58663468058,58663468059,1,1387,1407,-10
58666485990,58666485993,3,1690,2103,-10
58673698331,58673698330,-1,1169,1531,-10
58675645959,58675645959,0,1155,1183,-10
58680362166,58680362169,3,1648,1667,-10
58682038293,58682038294,1,1208,1228,-10
58689516086,58689516089,3,4758,5086,-10
58693173113,58693173125,12,1203,1023,-10
58698100570,58698100575,5,1720,1351,-10
58699594586,58699594590,4,926,881,-10
58699885360,58699885362,2,1554,1832,-10
58701647685,58701647687,2,1849,1381,-10
58703902106,58703902109,3,1532,1382,-10
58704726687,58704726687,0,1459,2160,-10
58704945327,58704945329,2,1728,1831,-10
58705256335,58705256339,4,1922,1632,-10
58705803919,58705803918,-1,1354,1907,-10
58705982070,58705982072,2,1936,1542,-10
58707974274,58707974275,1,1658,1705,-10
58708296160,58708296164,4,2500,1625,-10
58712071562,58712071565,3,1522,1035,-10
58714937511,58714937514,3,3040,2967,-10
58719999681,58719999683,2,1574,1520,-10
58724521535,58724521538,3,1708,1634,-10
58728009141,58728009146,5,1706,1173,-10
58728503150,58728503150,0,1577,1698,-10
58730841158,58730841166,8,4462,1693,-10
58732950149,58732950151,2,1656,1498,-10
58733281780,58733281802,22,1641,1716,-10
58733966349,58733966343,-6,522,2902,-10
58734195565,58734195569,4,1419,1342,-10
58739831198,58739831200,2,1132,929,-10
58741500903,58741500904,1,2284,2569,-10
58743501390,58743501390,0,1466,1474,-10
58745510949,58745510948,-1,17072,9207,-10
58749497149,58749497148,-1,1306,1282,-10
58750929070,58750929073,3,1439,1574,-10
58754984404,58754984405,1,1201,1234,-10
58755872265,58755872267,2,1630,1959,-10
58757562670,58757562670,0,2178,1932,-10
58757984350,58757984351,1,1550,845,-10
58758455953,58758455957,4,2377,1549,-10
58759161597,58759161579,-18,1183,1752,-10
58759661595,58759661598,3,1353,1706,-10
58760526795,58760526797,2,1672,1832,-10
58760557207,58760557210,3,1743,1621,-10
58762351194,58762351194,0,1294,1544,-10
58764928707,58764928711,4,1957,1884,-10
58766157580,58766157584,4,2195,2236,-10
58766877622,58766877623,1,1446,1172,-10
58768560649,58768560650,1,679,883,-10
58773021770,58773021772,2,1893,1719,-10
58773361215,58773361219,4,1638,1476,-10
58774189883,58774189890,7,5676,2683,-10
58776788519,58776788519,0,1657,1673,-10
58779646180,58779646181,1,2153,2021,-10
58780923409,58780923407,-2,1195,1500,-10
58786814550,58786814553,3,1294,1276,-10
58790067689,58790067690,1,1501,1708,-10
58795529050,58795529051,1,1401,1790,-10
58796367978,58796367971,-7,865,4602,-10
58798567090,58798567094,4,1052,1014,-10
58799992895,58799992897,2,1737,1462,-10
58801600369,58801600372,3,2161,1258,-10
58805719784,58805719784,0,1294,1409,-10
58809923459,58809923462,3,2289,1180,-10
58812875324,58812875329,5,2486,1108,-10
58813038662,58813038662,0,1641,1395,-10
58814221023,58814221026,3,1083,724,-10
58815961466,58815961469,3,1438,1183,-10
58818065064,58818065066,2,1029,1737,-10
58821386781,58821386773,-8,745,669,-10
58821704417,58821704416,-1,1548,1476,-10
58822509202,58822509204,2,1404,1806,-10
58825833616,58825833618,2,1070,1003,-10
58826279118,58826279128,10,1407,945,-10
58829558470,58829558472,2,4449,25840,-10
58832248082,58832248081,-1,1640,1652,-10
58833742241,58833742242,1,1493,1540,-10
58833862126,58833862131,5,1909,1321,-10
58835626670,58835626672,2,1168,954,-10
58836438515,58836438517,2,1139,1523,-10
58839069614,58839069617,3,1883,2172,-10
58841149714,58841149719,5,1869,1395,-10
58843203953,58843203954,1,1267,1531,-10
58844545825,58844545827,2,1915,1677,-10
58844866770,58844866763,-7,1516,8050,-10
58846297653,58846297655,2,1513,1636,-10
58849359497,58849359498,1,1452,1364,-10
58850214802,58850214805,3,1665,1516,-10
58851341946,58851341948,2,1885,1568,-10
58852573576,58852573577,1,1537,1325,-10
58855998125,58855998126,1,1713,2413,-10
58857945626,58857945629,3,1760,1570,-10
58859369131,58859369131,0,1593,1398,-10
58865194341,58865194345,4,1054,1346,-10
58866298855,58866298856,1,2730,3979,-10
58866444940,58866444939,-1,957,1061,-10
58869608791,58869608794,3,1652,1227,-10
58870547954,58870547940,-14,894,482,-10
58873061575,58873061576,1,1262,1716,-10
58874769626,58874769626,0,1645,1405,-10
58875415529,58875415533,4,1464,1499,-10
58875718557,58875718558,1,1759,987,-10
58877353637,58877353642,5,2298,914,-10
58878161639,58878161641,2,898,1034,-10
58880382897,58880382897,0,1317,1793,-10
58881223830,58881223830,0,1620,1757,-10
58882684920,58882684920,0,1560,2186,-10
58885684825,58885684826,1,1542,1528,-10
58888274666,58888274667,1,1302,1521,-10
58888747075,58888747077,2,1914,1751,-10
58897191088,58897191111,23,1355,1351,-10
58898159710,58898159710,0,1632,2202,-10
58898911685,58898911689,4,2046,1144,-10
58901907361,58901907363,2,1713,1437,-10
58906172083,58906172086,3,1802,1611,-10
58907701273,58907701275,2,1577,1205,-10
58908774848,58908774845,-3,2194,5389,-10
58910716490,58910716491,1,1788,1620,-10
58911963266,58911963269,3,1559,1674,-10
58913808692,58913808693,1,1094,1083,-10
58915021386,58915021391,5,2388,1417,-10
58917349846,58917349846,0,1821,1808,-10
58919618203,58919618206,3,1702,1656,-10
58920349932,58920349939,7,1234,1399,-10
58926255851,58926255853,2,2029,1776,-10
58931315970,58931315970,0,1529,1306,-10
58933006595,58933006597,2,24028,18537,-10
58933993630,58933993633,3,1500,1142,-10
58934804090,58934804096,6,1379,1325,-10
58935816362,58935816341,-21,1326,1150,-10
58937971684,58937971680,-4,5110,14150,-10
58939151243,58939151249,6,1789,940,-10
58940353982,58940353982,0,1263,2133,-10
58943320319,58943320323,4,1705,1441,-10
58943549422,58943549422,0,1196,1281,-10
58945274388,58945274390,2,1732,1898,-10
58945450425,58945450426,1,1554,1262,-10
58945714115,58945714112,-3,1414,2651,-10
58947935806,58947935810,4,1322,1320,-10
58948700350,58948700353,3,1044,1141,-10
58949452230,58949452230,0,1098,1440,-10
58949526182,58949526185,3,3155,3540,-10
58951389306,58951389307,1,1929,1506,-10
58953079929,58953079930,1,2323,1479,-10
58956416511,58956416514,3,1841,2032,-10
58959035430,58959035434,4,1565,1614,-10
58959227126,58959227134,8,6963,1297,-10
58961950796,58961950794,-2,1286,1405,-10
58964479455,58964479455,0,1384,1696,-10
58966116559,58966116563,4,1327,1061,-10
58966356093,58966356097,4,2116,1711,-10
58966770425,58966770426,1,1339,1484,-10
58966830499,58966830499,0,1073,1268,-10
58966975101,58966975103,2,1517,1700,-10
58970973429,58970973430,1,2398,1289,-10
58971115098,58971115098,0,1595,1416,-10
58972318293,58972318294,1,1446,1386,-10
58974444293,58974444294,1,1476,1373,-10
58978047844,58978047851,7,1758,1008,-10
58979958553,58979958556,3,1155,1407,-10
58982192519,58982192523,4,1627,1211,-10
58982548591,58982548609,18,1157,1521,-10
58982841269,58982841271,2,1169,1474,-10
58983073549,58983073551,2,1896,1329,-10
58983474526,58983474526,0,1127,1161,-10
58983818898,58983818890,-8,1173,1617,-10
58986314600,58986314601,1,1547,1663,-10
58987942647,58987942650,3,2260,1853,-10
58990570278,58990570279,1,1594,1547,-10
58990653646,58990653647,1,1525,1889,-10
58992239246,58992239246,0,1754,2037,-10
58995082666,58995082669,3,1657,1314,-10
58996150457,58996150460,3,1436,1823,-10
59001522769,59001522770,1,1575,1667,-10
59001878449,59001878446,-3,1472,2185,-10
59002903427,59002903428,1,951,924,-10
59003012954,59003012957,3,1962,1501,-10
59006341314,59006341318,4,1346,1300,-10
59007707874,59007707859,-15,1370,1381,-10
59008006481,59008006485,4,1565,1363,-10
59015700406,59015700408,2,1664,1671,-10
59016550444,59016550465,21,1917,1682,-10
59017391802,59017391805,3,1578,1645,-10
59017803340,59017803343,3,1584,1959,-10
59018631003,59018631001,-2,930,2519,-10
59021745733,59021745734,1,1164,1607,-10
59024687806,59024687810,4,1792,1556,-10
59025028672,59025028674,2,1554,1536,-10
59028013711,59028013709,-2,1823,3809,-10
59031019027,59031019030,3,1360,1828,-10
59031917731,59031917730,-1,1483,1779,-10
59032096910,59032096914,4,1527,1364,-10
59036206417,59036206419,2,1263,1065,-10
59036967204,59036967199,-5,1217,3649,-10
59037547372,59037547374,2,1163,1175,-10
59039352929,59039352931,2,1393,899,-10
59041230772,59041230774,2,1192,1638,-10
59042751647,59042751651,4,2130,1373,-10
59043118252,59043118232,-20,1244,1410,-10
59043730822,59043730826,4,1104,1433,-10
59044725561,59044725561,0,1268,1582,-10
59047714481,59047714479,-2,17494,9270,-10
59048983211,59048983211,0,1277,2034,-10
59051566303,59051566305,2,2336,1592,-10
59052673522,59052673525,3,1161,1154,-10
59057148103,59057148106,3,1917,2686,-10
59057786773,59057786778,5,1485,1559,-10
59058277206,59058277207,1,1759,1245,-10
59058913922,59058913927,5,2316,1440,-10
59059048364,59059048365,1,28215,26585,-10
59065723186,59065723191,5,2167,1379,-10
59065823743,59065823722,-21,1909,2078,-10
59069591602,59069591602,0,1744,1837,-10
59074702346,59074702348,2,1444,1567,-10
59076021292,59076021294,2,1215,1586,-10
59078253619,59078253619,0,1452,1513,-10
59078279790,59078279800,10,1066,751,-10
59082188423,59082188424,1,1101,1653,-10
59084307351,59084307351,0,1368,1979,-10
59086934987,59086934989,2,1105,789,-10
59088499235,59088499236,1,1931,2251,-10
59088526341,59088526342,1,1647,1275,-10
59094616983,59094616986,3,1829,2096,-10
59095765307,59095765310,3,2055,1283,-10
59099977377,59099977374,-3,1122,2027,-10
59101895906,59101895907,1,872,1417,-10
59102459470,59102459473,3,1420,1632,-10
59102604332,59102604333,1,1020,1448,-10
59106017315,59106017307,-8,31296,11564,-10
59109641802,59109641801,-1,1873,1562,-10
59115528738,59115528737,-1,1813,1515,-10
59116140311,59116140305,-6,365,6753,-10
59116512290,59116512292,2,1469,1448,-10
59116689850,59116689858,8,3548,1546,-10
59116912267,59116912269,2,1383,1503,-10
59117545289,59117545289,0,1185,1510,-10
59118623734,59118623738,4,1739,1610,-10
59119229588,59119229590,2,1424,1721,-10
59120743169,59120743170,1,1591,1762,-10
59120901853,59120901858,5,2501,1677,-10
59124341010,59124341010,0,1503,1311,-10
59125864557,59125864560,3,1995,1247,-10
59127095812,59127095814,2,1464,1675,-10
59127574938,59127574938,0,1246,1225,-10
59128602258,59128602261,3,1843,1698,-10
59132206475,59132206478,3,1507,1987,-10
59134844573,59134844578,5,1656,1429,-10
59135034414,59135034417,3,1535,1296,-10
59135919710,59135919710,0,978,1506,-10
59138250787,59138250790,3,1824,1580,-10
59139302574,59139302595,21,6388,9206,-10
59141224639,59141224638,-1,969,2149,-10
59143254406,59143254402,-4,1648,1487,-10
59144691440,59144691443,3,1983,2070,-10
59147715002,59147715004,2,1574,1923,-10
59148672514,59148672517,3,2580,1907,-10
59150759595,59150759597,2,1133,1076,-10
59151155322,59151155323,1,2194,1801,-10
59155548740,59155548742,2,2154,1495,-10
59158026892,59158026891,-1,1062,1377,-10
59158639391,59158639395,4,1967,1652,-10
59160464367,59160464370,3,1544,1563,-10
59161034783,59161034778,-5,1547,4262,-10
59163094247,59163094249,2,1720,1356,-10
59163201278,59163201279,1,1052,1118,-10
59170554010,59170554014,4,2247,1369,-10
59174612213,59174612216,3,1660,1478,-10
59175857681,59175857683,2,1242,1745,-10
59178654774,59178654774,0,1062,1704,-10
59178808571,59178808572,1,2210,2320,-10
59179273711,59179273706,-5,1131,3165,-10
59179362214,59179362216,2,1211,1467,-10
59180952442,59180952447,5,1579,1162,-10
59182751540,59182751541,1,2583,1756,-10
59183145036,59183145037,1,1645,1912,-10
59189135921,59189135927,6,1872,1188,-10
59194080366,59194080361,-5,2362,8119,-10
59195378345,59195378347,2,1271,1275,-10
59198978818,59198978821,3,1508,1432,-10
59199212072,59199212075,3,1681,993,-10
59200209213,59200209215,2,2034,1236,-10
59200288145,59200288147,2,1784,1321,-10
59201590300,59201590302,2,2239,1831,-10
59201624042,59201624038,-4,1148,1375,-10
59203752902,59203752894,-8,1788,4821,-10
59204282225,59204282226,1,1285,2063,-10
59206078902,59206078902,0,1653,2248,-10
59211805602,59211805602,0,1929,1685,-10
59214313094,59214313098,4,1827,1515,-10
59214997367,59214997369,2,1803,1335,-10
59216475985,59216475986,1,1082,1710,-10
59219358334,59219358336,2,1142,804,-10
59220214111,59220214114,3,1749,1687,-10
59221673416,59221673418,2,1325,1724,-10
59222585866,59222585868,2,1784,1937,-10
59227284484,59227284488,4,1152,1727,-10
59228163962,59228163965,3,1737,1795,-10
59230246452,59230246454,2,1593,1773,-10
59233414942,59233414943,1,1115,1400,-10
59234428928,59234428931,3,1525,1356,-10
59237373520,59237373523,3,1798,1283,-10
59240978687,59240978686,-1,1533,2172,-10
59241995305,59241995301,-4,1334,1612,-10
59243060125,59243060126,1,1487,1963,-10
59248045679,59248045685,6,1696,1512,-10
59248132041,59248132042,1,1519,860,-10
59253155575,59253155578,3,1385,1179,-10
59254641734,59254641737,3,1270,1846,-10
59254865136,59254865138,2,2121,2248,-10
59256511945,59256511947,2,1247,1362,-10
59260148333,59260148335,2,2200,1651,-10
59262184140,59262184142,2,1286,1497,-10
59267077702,59267077705,3,1070,1661,-10
59271018509,59271018512,3,1932,1299,-10
59275120085,59275120088,3,1637,1939,-10
59276355467,59276355468,1,1765,1739,-10
59279480559,59279480560,1,1037,1683,-10
59283828998,59283829000,2,1234,1976,-10
59285957199,59285957202,3,1597,1398,-10
59286050131,59286050130,-1,829,1445,-10
59290031810,59290031811,1,2106,1749,-10
59290579332,59290579333,1,1796,1402,-10
59291608222,59291608222,0,1370,1356,-10
59293963642,59293963640,-2,2083,2639,-10
59295956894,59295956878,-16,1450,1837,-10
59298078918,59298078920,2,1800,2491,-10
59300039595,59300039597,2,1497,1319,-10
59302569489,59302569496,7,958,1162,-10
59303836020,59303836024,4,1856,1150,-10
59308028813,59308028814,1,1379,1228,-10
59311211550,59311211551,1,1323,1083,-10
59313619142,59313619142,0,1573,1558,-10
59318605516,59318605521,5,2995,1181,-10
59328605992,59328605992,0,1759,1772,-10
59330408076,59330408079,3,1484,1626,-10
59330883517,59330883520,3,1448,1068,-10
59333056293,59333056294,1,1872,1852,-10
59333653676,59333653677,1,1537,1208,-10
59335524767,59335524770,3,982,990,-10
59337404669,59337404673,4,1924,1515,-10
59340963555,59340963557,2,1465,1802,-10
59342132518,59342132520,2,1747,1943,-10
59344714246,59344714252,6,1890,1366,-10
59347228678,59347228680,2,2033,1147,-10
59348655342,59348655344,2,1464,1399,-10
59353102229,59353102230,1,1903,1763,-10
59355460610,59355460614,4,1388,1680,-10
59358602647,59358602649,2,1793,1729,-10
59363399370,59363399373,3,2023,1444,-10
59368642654,59368642655,1,1901,1847,-10
59377225542,59377225546,4,1757,1171,-10
59381067319,59381067321,2,1275,1949,-10
59384264042,59384264046,4,1466,1898,-10
59389937738,59389937742,4,2345,1819,-10
59390051683,59390051666,-17,878,684,-10
59390403230,59390403234,4,4243,2570,-10
59393404522,59393404526,4,1719,982,-10
59396588610,59396588611,1,1483,1876,-10
59397831470,59397831470,0,1115,1780,-10
59400229867,59400229869,2,1509,799,-10
59403135812,59403135812,0,1967,1854,-10
59404957013,59404957014,1,1622,1144,-10
59406357331,59406357333,2,2150,1974,-10
59409744681,59409744683,2,1774,1660,-10
59410388744,59410388744,0,1130,1474,-10
59414088378,59414088378,0,793,1390,-10
59415814966,59415814970,4,3177,3685,-10
59419065349,59419065349,0,2009,2551,-10
59419754494,59419754495,1,1021,1585,-10
59422170618,59422170620,2,1316,1438,-10
59425800216,59425800215,-1,1125,1589,-10
59426907606,59426907609,3,1971,1988,-10
59429276428,59429276433,5,1350,1203,-10
59430123775,59430123754,-21,1401,2085,-10
59430241365,59430241367,2,2030,1213,-10
59432779943,59432779946,3,1527,1544,-10
59434191609,59434191610,1,1448,1877,-10
59441821786,59441821790,4,2006,1121,-10
59442169377,59442169380,3,1673,1661,-10
59444881945,59444881943,-2,2015,3778,-10
59448425225,59448425226,1,1801,1381,-10
59450862460,59450862458,-2,1160,1777,-10
59453537302,59453537301,-1,1614,2570,-10
59453751790,59453751793,3,2086,2125,-10
59454680633,59454680629,-4,1280,1140,-10
59459183961,59459183962,1,1335,1475,-10
59462871365,59462871371,6,4435,1643,-10
59464319931,59464319934,3,2317,1360,-10
59466967991,59466967994,3,886,830,-10
59469537787,59469537787,0,1943,2845,-10
59474817639,59474817637,-2,657,701,-10
59479381763,59479381766,3,1295,865,-10
59480203946,59480203949,3,1750,1825,-10
59480494361,59480494359,-2,1026,2064,-10
59481501066,59481501069,3,1493,1672,-10
59485791078,59485791079,1,1960,1888,-10
59487088622,59487088625,3,1324,2020,-10
59489198114,59489198115,1,1213,1126,-10
59490760884,59490760885,1,1432,1417,-10
59505743581,59505743582,1,2015,1369,-10
59507644518,59507644519,1,1607,1624,-10
59510035578,59510035573,-5,866,4901,-10
59511895042,59511895041,-1,1653,1325,-10
59513840681,59513840682,1,1905,1269,-10
59514034859,59514034855,-4,1893,4424,-10
59515912306,59515912306,0,1875,1523,-10
59516685643,59516685642,-1,1036,1313,-10
59519054958,59519054959,1,1569,1561,-10
59522225283,59522225287,4,1978,1536,-10
59525275263,59525275265,2,1427,1113,-10
59526599952,59526599954,2,1528,1697,-10
59528394306,59528394308,2,1557,2006,-10
59529152556,59529152560,4,2132,1001,-10
59530139900,59530139900,0,1231,1734,-10
59531295354,59531295362,8,3510,1391,-10
59533971913,59533971915,2,1685,2066,-10
59534521030,59534521036,6,2449,1350,-10
59539207198,59539207203,5,2012,1536,-10
59541385365,59541385367,2,2340,2165,-10
59542802043,59542802044,1,1585,1611,-10
59542949736,59542949738,2,1384,1585,-10
59543664799,59543664801,2,1308,1473,-10
59549157197,59549157198,1,1206,1075,-10
59550456780,59550456785,5,2447,1464,-10
59551444870,59551444873,3,1561,1409,-10
59551514942,59551514941,-1,1524,2293,-10
59558256129,59558256130,1,1513,1596,-10
59559154842,59559154857,15,1146,1508,-10
59564087014,59564087016,2,1519,1363,-10
59564317985,59564317986,1,1674,1615,-10
59565579418,59565579421,3,1093,1697,-10
59570096517,59570096518,1,1446,1178,-10
59580086495,59580086497,2,1991,1707,-10
59583065063,59583065065,2,1363,1523,-10
59584081371,59584081373,2,1860,2207,-10
59586056769,59586056770,1,2033,1135,-10
59592050339,59592050342,3,1196,1445,-10
59592198719,59592198722,3,1551,1452,-10
59594322722,59594322726,4,2291,1724,-10
59594842690,59594842692,2,1627,1511,-10
59595794562,59595794561,-1,889,887,-10
59597125153,59597125153,0,1419,2158,-10
59597254294,59597254288,-6,41471,17525,-10
59602995862,59602995862,0,1916,1911,-10
59606570029,59606570033,4,2069,1694,-10
59608171244,59608171248,4,1756,1364,-10
59610118167,59610118161,-6,1209,4262,-10
59612478729,59612478732,3,999,866,-10
59614189583,59614189583,0,1855,1519,-10
59617060478,59617060480,2,2324,1962,-10
59617143378,59617143381,3,1621,2292,-10
59618774285,59618774291,6,2862,1423,-10
59620580797,59620580799,2,1576,1568,-10
59621558576,59621558578,2,2085,1567,-10
59623309337,59623309340,3,1252,1824,-10
59624960677,59624960679,2,1624,1578,-10
59625435326,59625435329,3,1176,1348,-10
59629090271,59629090270,-1,1410,1366,-10
59630299095,59630299096,1,1366,1491,-10
59632581029,59632581030,1,1786,1862,-10
59633823127,59633823129,2,1306,1431,-10
59637338058,59637338062,4,943,940,-10
59638940362,59638940363,1,2217,2140,-10
59641893950,59641893953,3,994,1040,-10
59645984170,59645984169,-1,932,1562,-10
59652608061,59652608063,2,3332,3372,-10
59654734401,59654734402,1,1813,1695,-10
59655950234,59655950236,2,1691,1543,-10
59656505770,59656505773,3,4018,2510,-10
59657507591,59657507593,2,1866,1656,-10
59658595313,59658595313,0,1275,1659,-10
59659146731,59659146733,2,1419,1690,-10
59660470545,59660470546,1,1331,1613,-10
59660538601,59660538602,1,1384,1580,-10
59663554001,59663554000,-1,2312,2213,-10
59664912517,59664912519,2,1225,1657,-10
59666045068,59666045069,1,1673,2122,-10
59666187495,59666187506,11,1170,1209,-10
59669774103,59669774106,3,1771,2203,-10
59671232497,59671232498,1,1526,1863,-10
59672749066,59672749069,3,2049,1732,-10
59674316086,59674316086,0,1542,1308,-10
59676117734,59676117738,4,2072,1565,-10
59678772435,59678772428,-7,877,2655,-10
59679972714,59679972715,1,1305,1253,-10
59683095553,59683095554,1,1325,1965,-10
59683630277,59683630279,2,1387,1170,-10
59685929262,59685929265,3,1210,1666,-10
59688374262,59688374265,3,2410,2353,-10
59689812151,59689812145,-6,656,1239,-10
59690639646,59690639646,0,1543,1781,-10
59692476751,59692476751,0,1339,1017,-10
59693743270,59693743271,1,1683,1634,-10
59696254465,59696254463,-2,1189,1689,-10
59703111873,59703111874,1,1973,1219,-10
59703690296,59703690297,1,1411,1813,-10
59705016937,59705016938,1,1516,1748,-10
59706237205,59706237206,1,1838,1335,-10
59707434075,59707434078,3,2030,1742,-10
59707767431,59707767435,4,1833,1732,-10
59711688553,59711688555,2,1689,1879,-10
59711954867,59711954871,4,1552,1763,-10
59712868373,59712868373,0,1200,2002,-10
59714411493,59714411497,4,1837,1192,-10
59721373156,59721373158,2,1829,1689,-10
59721626642,59721626643,1,1441,1254,-10
59722050823,59722050844,21,1708,1478,-10
59722506436,59722506438,2,1958,1209,-10
59723799117,59723799119,2,1593,1577,-10
59725176154,59725176154,0,1263,1505,-10
59726991712,59726991718,6,1891,1521,-10
59729335530,59729335526,-4,1393,1907,-10
59729949414,59729949416,2,1306,1795,-10
59730310366,59730310369,3,1794,1578,-10
59731547313,59731547314,1,1680,1899,-10
59732142009,59732142010,1,1258,946,-10
59736442465,59736442467,2,2404,2287,-10
59739857606,59739857607,1,1441,1686,-10
59739903715,59739903717,2,891,879,-10
59743220216,59743220217,1,3481,2881,-10
59746120951,59746120954,3,1714,1052,-10
59746239557,59746239538,-19,1562,1063,-10
59746810204,59746810223,19,1236,1454,-10
59747873213,59747873215,2,1366,1467,-10
59753424302,59753424303,1,1363,1722,-10
59754918863,59754918863,0,1591,1167,-10
59755171540,59755171541,1,1410,1314,-10
59758682514,59758682520,6,2335,1294,-10
59760153004,59760153003,-1,724,701,-10
59760871559,59760871563,4,1096,1245,-10
59765805576,59765805577,1,1949,1311,-10
59768752559,59768752561,2,1414,1186,-10
59770120970,59770120969,-1,1433,1650,-10
59770697006,59770697010,4,1554,1470,-10
59773316118,59773316118,0,979,889,-10
59774034671,59774034672,1,1292,1270,-10
59774310854,59774310855,1,1515,1093,-10
59777850685,59777850688,3,1877,1777,-10
59779822755,59779822756,1,1200,1494,-10
59782124506,59782124506,0,1470,1686,-10
59784090574,59784090575,1,1209,1371,-10
59786886289,59786886291,2,1784,1305,-10
59788011257,59788011262,5,5116,2384,-10
59794891883,59794891886,3,1063,994,-10
59796442910,59796442929,19,1606,1305,-10
59798948030,59798948030,0,1241,962,-10
59800355390,59800355390,0,898,1725,-10
59801787561,59801787564,3,1550,1686,-10
59802122195,59802122197,2,1392,1627,-10
59809176321,59809176323,2,1802,1721,-10
59815179534,59815179535,1,1987,1739,-10
59821564061,59821564059,-2,1084,1379,-10
59822531952,59822531973,21,1000,3420,-10
59823103990,59823103993,3,1522,1404,-10
59830321182,59830321184,2,1588,1992,-10
59831167338,59831167339,1,1258,1256,-10
59832969562,59832969561,-1,20629,7009,-10
59834122111,59834122114,3,1700,1727,-10
59837217981,59837217981,0,1821,1794,-10
59844497645,59844497647,2,1506,1474,-10
59849126116,59849126117,1,1591,1838,-10
59850563689,59850563690,1,1008,922,-10
59851269827,59851269830,3,2314,1818,-10
59851424370,59851424371,1,1526,2019,-10
59856980079,59856980079,0,1710,2138,-10
59861857886,59861857888,2,1359,1694,-10
59863420745,59863420746,1,1896,1671,-10
59871128509,59871128510,1,1616,1292,-10
59871699810,59871699804,-6,1342,4118,-10
59872994615,59872994614,-1,1507,1708,-10
59874012443,59874012441,-2,1215,1042,-10
59875319922,59875319925,3,1951,2242,-10
59877658574,59877658577,3,1262,1254,-10
59878182427,59878182427,0,1481,1322,-10
59880319351,59880319355,4,1472,1027,-10
59882955833,59882955833,0,1284,1454,-10
59883233486,59883233485,-1,1246,1432,-10
59888738616,59888738618,2,1964,1301,-10
59892878178,59892878183,5,1454,1445,-10
59895682327,59895682327,0,1352,1561,-10
59895987334,59895987338,4,1308,1464,-10
59897248045,59897248045,0,1436,1428,-10
59898178162,59898178166,4,2203,1024,-10
59898873223,59898873228,5,1684,1712,-10
59898957939,59898957921,-18,840,760,-10
59902323709,59902323712,3,1867,1479,-10
59903931886,59903931887,1,2444,2265,-10
59909094797,59909094798,1,1830,1429,-10
59910520102,59910520103,1,2295,1334,-10
59911420181,59911420183,2,1393,1216,-10
59912417942,59912417943,1,1569,1626,-10
59917843012,59917843014,2,2180,1640,-10
59922578971,59922578970,-1,1498,2276,-10
59923135371,59923135351,-20,1130,681,-10
59924431434,59924431433,-1,1409,1376,-10
59932618886,59932618886,0,1576,1891,-10
59936742803,59936742808,5,1498,1524,-10
59939846756,59939846757,1,7580,8840,-10
59943047870,59943047850,-20,1492,1426,-10
59944555838,59944555838,0,2052,1446,-10
59945548426,59945548426,0,1055,1117,-10
59948501498,59948501500,2,1432,1764,-10
59950096321,59950096327,6,5727,1756,-10
59950931813,59950931814,1,2268,2280,-10
59954394262,59954394263,1,1545,1408,-10
59954436542,59954436523,-19,1319,1438,-10
59954714645,59954714645,0,1677,1562,-10
59954906379,59954906385,6,1906,1220,-10
59957464075,59957464078,3,1486,1378,-10
59958244341,59958244340,-1,1542,1652,-10
59959248936,59959248934,-2,2110,4808,-10
59960453994,59960453994,0,1390,1812,-10
59961178586,59961178587,1,1867,1567,-10
59962622935,59962622947,12,1476,1286,-10
59974262086,59974262086,0,1968,1410,-10
59975316505,59975316506,1,1793,1886,-10
59978652726,59978652726,0,896,1474,-10
59979061653,59979061654,1,1546,1555,-10
59985184498,59985184502,4,1566,1576,-10
59990142403,59990142404,1,812,1787,-10
59992922242,59992922243,1,1544,1722,-10
59993548580,59993548583,3,1634,1275,-10
59995598314,59995598317,3,1076,1317,-10
59995871695,59995871699,4,1865,1727,-10
59995944815,59995944825,10,1542,1633,-10
59997414686,59997414691,5,5463,2625,-10
59999024918,59999024919,1,1134,917,-10
59999949373,59999949377,4,1801,1918,-10
60003190350,60003190356,6,3253,2137,-10
60006266339,60006266342,3,1856,1182,-10
60008630986,60008630988,2,1637,1620,-10
60009517955,60009517958,3,1281,1110,-10
60014633219,60014633222,3,1782,1956,-10
60015222450,60015222453,3,1733,1416,-10
60015367716,60015367719,3,1777,1938,-10
60017591114,60017591118,4,2606,2008,-10
60019765534,60019765537,3,1513,981,-10
60020609852,60020609857,5,2413,950,-10
60022098141,60022098142,1,1543,1982,-10
60022747457,60022747462,5,2220,1439,-10
60023017386,60023017387,1,1564,1577,-10
60026179310,60026179309,-1,2191,1632,-10
60027725858,60027725859,1,1249,1732,-10
60031158282,60031158282,0,1613,1228,-10
60035979718,60035979718,0,1700,1438,-10
60037567811,60037567813,2,1645,1547,-10
60040692670,60040692672,2,2216,1814,-10
60040751971,60040751967,-4,923,1995,-10
60041449245,60041449246,1,1400,1559,-10
60045559922,60045559925,3,1256,1365,-10
60049739624,60049739625,1,1771,1474,-10
60051852631,60051852633,2,1293,1372,-10
60052812118,60052812119,1,1739,1186,-10
60061583834,60061583835,1,2000,2142,-10
60061746201,60061746206,5,2340,1346,-10
60063215461,60063215475,14,13635,51957,-10
60063302486,60063302478,-8,1414,6662,-10
60064243007,60064243011,4,1766,1332,-10
60065038598,60065038599,1,1528,1454,-10
60065972400,60065972403,3,2851,1348,-10
60066519068,60066519066,-2,1367,3650,-10
60068840330,60068840331,1,1392,1009,-10
60073064158,60073064155,-3,699,1804,-10
60073327138,60073327139,1,1371,1179,-10
60076152673,60076152674,1,1533,1956,-10
60077245166,60077245172,6,1332,2155,-10
60088720792,60088720815,23,1601,1117,-10
60090632900,60090632902,2,1383,1400,-10
60091839038,60091839038,0,1976,1404,-10
60091873764,60091873767,3,2300,1653,-10
60091965438,60091965439,1,1357,1472,-10
60093116027,60093116029,2,4456,2987,-10
60093785217,60093785218,1,1461,2061,-10
60096835681,60096835683,2,1527,1870,-10
60099876910,60099876914,4,1172,1247,-10
60104586280,60104586278,-2,1500,2128,-10
60105890981,60105890983,2,1645,2250,-10
60106235474,60106235474,0,1518,1247,-10
60109833857,60109833860,3,1295,1404,-10
60110457163,60110457166,3,1492,1264,-10
60112114230,60112114230,0,1651,1573,-10
60113174218,60113174218,0,1238,1228,-10
60117168709,60117168714,5,1367,1570,-10
60117646642,60117646643,1,1877,1807,-10
60120067877,60120067878,1,1938,2422,-10
60129360710,60129360710,0,1190,955,-10
60130237465,60130237465,0,1562,2273,-10
60131650374,60131650355,-19,1082,1940,-10
60132687487,60132687487,0,1056,1111,-10
60133598617,60133598619,2,1377,1434,-10
60134852243,60134852246,3,1451,1384,-10
60135102317,60135102319,2,1243,1336,-10
60136865283,60136865290,7,2458,1552,-10
60137048851,60137048854,3,1344,1820,-10
60138311603,60138311604,1,1308,1232,-10
60140985389,60140985390,1,1736,1569,-10
60141552537,60141552538,1,1890,1856,-10
60141904225,60141904226,1,951,1578,-10
60143617237,60143617242,5,1692,1459,-10
60144108297,60144108299,2,1709,1831,-10
60145507578,60145507582,4,1616,1488,-10
60147354584,60147354585,1,1904,1958,-10
60156479275,60156479277,2,974,1157,-10
60156554907,60156554909,2,1607,1496,-10
60156749659,60156749662,3,1401,1314,-10
60157005749,60157005755,6,4235,1416,-10
60166945067,60166945064,-3,25819,20593,-10
60183464514,60183464514,0,1338,1504,-10
60184594230,60184594230,0,1852,2066,-10
60184841947,60184841946,-1,1342,1929,-10
60188015594,60188015598,4,1552,1209,-10
60190744870,60190744870,0,1137,1914,-10
60195868994,60195868995,1,1671,1597,-10
60196756060,60196756047,-13,1088,1579,-10
60198208400,60198208385,-15,513,698,-10
60199595114,60199595117,3,2130,1464,-10
60199778913,60199778932,19,1389,1300,-10
60201830477,60201830478,1,1511,1564,-10
60203413877,60203413879,2,1180,1516,-10
60205070369,60205070371,2,2222,1631,-10
60210491477,60210491481,4,1021,1805,-10
60211185589,60211185593,4,1915,1670,-10
60218129572,60218129575,3,1891,1260,-10
60221805491,60221805493,2,1490,1640,-10
60224810813,60224810814,1,1578,1674,-10
60226853937,60226853939,2,1625,1803,-10
60232138673,60232138675,2,1583,1060,-10
60234349884,60234349887,3,1901,1635,-10
60235212581,60235212585,4,1966,1290,-10
60235244547,60235244550,3,1762,1483,-10
60236436429,60236436431,2,1146,1240,-10
60237229425,60237229427,2,1704,1572,-10
60237420333,60237420336,3,1359,1878,-10
60241086820,60241086821,1,1500,1769,-10
60242445662,60242445662,0,1592,1634,-10
60243295234,60243295239,5,1275,865,-10
60243672366,60243672367,1,1293,1424,-10
60245317891,60245317894,3,1497,1372,-10
60248919246,60248919249,3,1897,1585,-10
60249809147,60249809147,0,1158,1671,-10
60250045718,60250045720,2,2332,2505,-10
60250641357,60250641363,6,5383,2658,-10
60253985985,60253985982,-3,1137,2993,-10
60256016195,60256016192,-3,985,1895,-10
60257940667,60257940661,-6,1413,6173,-10
60261038300,60261038299,-1,1321,1402,-10
60265744612,60265744614,2,1472,1572,-10
60268092454,60268092454,0,1591,1507,-10
60273544502,60273544502,0,1357,1869,-10
60273921346,60273921345,-1,1743,1914,-10
60275488838,60275488838,0,1938,1477,-10
60276060129,60276060132,3,2337,2221,-10
60278622117,60278622118,1,1885,1878,-10
60280141807,60280141809,2,1579,2436,-10
60280325909,60280325910,1,1765,1896,-10
60286474545,60286474547,2,1661,1657,-10
60289261549,60289261552,3,1371,1609,-10
60289570078,60289570081,3,1495,1720,-10
60289877666,60289877668,2,1729,1811,-10
60291928915,60291928918,3,1006,1619,-10
60295220888,60295220891,3,2173,1741,-10
60297318540,60297318541,1,2025,1159,-10
60298724614,60298724614,0,1663,1943,-10
60300459202,60300459202,0,1262,861,-10
60302096458,60302096459,1,2027,1754,-10
60304687833,60304687833,0,1798,2070,-10
60307001166,60307001169,3,1151,1533,-10
60307447193,60307447195,2,1601,1437,-10
60309130829,60309130830,1,1759,1813,-10
60310868330,60310868333,3,1146,1347,-10
60311578712,60311578713,1,1877,2258,-10
60312622227,60312622232,5,1029,1203,-10
60313350533,60313350534,1,1712,2057,-10
60314042154,60314042155,1,1487,1779,-10
60315686454,60315686455,1,950,1562,-10
60316782931,60316782932,1,1446,1177,-10
60320137751,60320137739,-12,1353,1570,-10
60322573923,60322573921,-2,1191,1665,-10
60322705969,60322705971,2,2059,1160,-10
60326257598,60326257599,1,1190,1330,-10
60328932966,60328932966,0,1383,2266,-10
60334855590,60334855595,5,1589,1928,-10
60339239843,60339239844,1,1319,1581,-10
60341116913,60341116914,1,1699,1539,-10
60342376650,60342376650,0,1588,1421,-10
60345893614,60345893615,1,1329,1388,-10
60346898815,60346898818,3,1139,2286,-10
60348103348,60348103351,3,1393,1226,-10
60348993496,60348993500,4,3818,1747,-10
60349022274,60349022274,0,1412,1502,-10
60351649049,60351649051,2,1687,2277,-10
60357079882,60357079884,2,1420,1356,-10
60357423972,60357423973,1,807,1284,-10
60357975559,60357975557,-2,1276,1739,-10
60361131754,60361131755,1,1332,1673,-10
60362910758,60362910761,3,1219,1534,-10
60363821188,60363821189,1,1592,1610,-10
60364153059,60364153058,-1,1171,1474,-10
60366196509,60366196514,5,1107,1195,-10
60367423530,60367423544,14,36232,15742,-10
60367552829,60367552830,1,1113,1582,-10
60367843445,60367843446,1,1338,1532,-10
60371839385,60371839387,2,954,1093,-10
60374080310,60374080309,-1,1263,1613,-10
60376934274,60376934277,3,1224,1305,-10
60381917633,60381917630,-3,1955,4016,-10
60385738483,60385738483,0,1582,2271,-10
60389066366,60389066366,0,1248,2256,-10
60390001090,60390001091,1,1548,1220,-10
60393478407,60393478406,-1,1067,1355,-10
60397467405,60397467407,2,1298,1693,-10
60401261335,60401261338,3,2095,1891,-10
60402512119,60402512122,3,1231,1464,-10
60405340703,60405340705,2,1451,1111,-10
60405761329,60405761337,8,2268,1114,-10
60410018346,60410018346,0,2048,1584,-10
60416080731,60416080733,2,1974,2010,-10
60420723618,60420723617,-1,55765,48922,-10
60422138332,60422138333,1,1521,1744,-10
60427139957,60427139959,2,2213,1451,-10
60429227340,60429227340,0,45062,27935,-10
60430309439,60430309436,-3,824,1360,-10
60436005166,60436005168,2,1570,1567,-10
60439423806,60439423800,-6,850,3067,-10
60442668824,60442668827,3,2277,1569,-10
60443974973,60443974977,4,38437,30206,-10
60444623984,60444623986,2,1553,1602,-10
60447442569,60447442571,2,946,1138,-10
60449901523,60449901525,2,1182,1605,-10
60450144943,60450144946,3,949,1292,-10
60451787458,60451787461,3,1598,1364,-10
60454103877,60454103878,1,1430,1671,-10
60454129170,60454129173,3,1051,1094,-10
60454142730,60454142732,2,5,32,-10
60456308461,60456308463,2,1668,1666,-10
60464845333,60464845334,1,1435,1299,-10
60466642698,60466642704,6,1836,1164,-10
60466997588,60466997591,3,1398,1180,-10
60470583283,60470583263,-20,1033,809,-10
60470687086,60470687088,2,1718,1411,-10
60472228487,60472228488,1,1357,1838,-10
60474494285,60474494282,-3,1556,3846,-10
60475973758,60475973756,-2,1423,2203,-10
60476801019,60476801022,3,1584,1400,-10
60480869273,60480869274,1,1459,1519,-10
60482020828,60482020828,0,987,1450,-10
60484220450,60484220450,0,1238,1273,-10
60490486336,60490486337,1,1015,1536,-10
60493196790,60493196793,3,2093,1491,-10
60498295125,60498295127,2,1227,1772,-10
60500711303,60500711294,-9,34249,13352,-10
60501104475,60501104476,1,2289,3282,-10
60502078326,60502078326,0,1466,2003,-10
60505722970,60505722969,-1,1571,1687,-10
60506139305,60506139306,1,1125,1514,-10
60509854607,60509854608,1,1736,1364,-10
60509907854,60509907856,2,2006,1554,-10
60510421303,60510421306,3,2339,1551,-10
60510768789,60510768792,3,1379,1418,-10
60512468986,60512468989,3,1473,1689,-10
60515367296,60515367301,5,2410,1559,-10
60519040998,60519040998,0,1288,1465,-10
60519643998,60519643998,0,1169,1574,-10
60522442049,60522442054,5,1995,1526,-10
60523710528,60523710530,2,1453,1160,-10
60525171301,60525171303,2,2002,1657,-10
60525347654,60525347656,2,845,1587,-10
60526635092,60526635094,2,968,1167,-10
60530061830,60530061831,1,1891,1296,-10
60531032414,60531032417,3,1830,1726,-10
60532130082,60532130084,2,1775,1145,-10
60532994981,60532994983,2,1796,1787,-10
60534184776,60534184780,4,2836,1698,-10
60534287001,60534287002,1,1275,1418,-10
60537576180,60537576177,-3,1658,3430,-10
60538804698,60538804703,5,22214,25319,-10
60539691233,60539691234,1,1713,1493,-10
60540899333,60540899332,-1,1321,1525,-10
60541282841,60541282842,1,1487,1650,-10
60542420643,60542420645,2,1931,2269,-10
60543223412,60543223414,2,2014,2159,-10
60544398766,60544398767,1,1892,1801,-10
60546591816,60546591819,3,1792,1548,-10
60547915858,60547915861,3,3053,3122,-10
60548561128,60548561131,3,1745,1623,-10
60550071663,60550071666,3,1121,760,-10
60553306557,60553306560,3,1700,1820,-10
60553629929,60553629935,6,5531,2191,-10
60557077909,60557077910,1,1520,1535,-10
60559560236,60559560237,1,1101,942,-10
60559708623,60559708629,6,3364,2146,-10
60564258626,60564258625,-1,1289,1473,-10
60565115228,60565115231,3,1552,1327,-10
60565199158,60565199160,2,1445,1603,-10
60568935082,60568935082,0,1551,1750,-10
60571763066,60571763066,0,1491,1962,-10
60571943731,60571943734,3,1423,1154,-10
60573606243,60573606247,4,1253,1199,-10
60580482162,60580482163,1,1472,1528,-10
60582032522,60582032525,3,1109,1168,-10
60582661930,60582661921,-9,3380,15687,-10
60586886794,60586886797,3,1254,1394,-10
60587899238,60587899238,0,1487,1915,-10
60594627270,60594627272,2,1739,2128,-10
60598947015,60598947015,0,816,854,-10
60605820223,60605820223,0,1632,1831,-10
60607672080,60607672082,2,1638,1655,-10
60608499960,60608499962,2,1030,1429,-10
60611451329,60611451329,0,1395,1679,-10
60612723076,60612723078,2,1405,1658,-10
60615318071,60615318071,0,1786,1643,-10
60615928042,60615928034,-8,32,1186,-10
60618921457,60618921460,3,1757,2593,-10
60621149951,60621149949,-2,997,2331,-10
60621461502,60621461503,1,1956,1680,-10
60622847174,60622847176,2,1868,2123,-10
60624657150,60624657154,4,2088,1819,-10
60627928449,60627928454,5,2232,1585,-10
60632779666,60632779667,1,1574,1463,-10
60633101590,60633101592,2,1551,1667,-10
60633363286,60633363285,-1,1334,1647,-10
60635180145,60635180148,3,1521,1182,-10
60637466837,60637466838,1,1249,1137,-10
60639064606,60639064607,1,1315,1200,-10
60640333207,60640333215,8,4201,1960,-10
60641230325,60641230325,0,1149,1338,-10
60644682544,60644682551,7,897,822,-10
60649857431,60649857418,-13,1027,841,-10
60650670834,60650670833,-1,1141,1780,-10
60651632550,60651632553,3,1899,1357,-10
60653715438,60653715438,0,1589,1340,-10
60654104411,60654104412,1,1120,2007,-10
60655783546,60655783548,2,1376,1244,-10
60661097882,60661097884,2,1827,1732,-10
60663460105,60663460101,-4,1079,3489,-10
60666083603,60666083606,3,2117,1748,-10
60667196146,60667196148,2,1459,1635,-10
60669620510,60669620513,3,2307,1655,-10
60671791090,60671791093,3,1593,1918,-10
60672471451,60672471449,-2,34766,18232,-10
60675352249,60675352250,1,1621,1675,-10
60676618071,60676618074,3,1802,1402,-10
60677002163,60677002144,-19,2369,1845,-10
60681319705,60681319707,2,1843,1383,-10
60682383614,60682383614,0,1172,1840,-10
60682835962,60682835965,3,1442,1422,-10
60686044290,60686044292,2,1438,1298,-10
60692960218,60692960226,8,2564,1223,-10
60697708009,60697708010,1,1648,1671,-10
60698253216,60698253230,14,601,4210,-10
60698989395,60698989398,3,1980,1678,-10
60699050614,60699050618,4,718,830,-10
60700763770,60700763772,2,1313,1347,-10
60701055843,60701055847,4,1414,1150,-10
60702582322,60702582322,0,1529,1067,-10
60704700161,60704700161,0,1892,1858,-10
60705119159,60705119159,0,2718,3336,-10
60707580040,60707580039,-1,1395,2507,-10
60709573819,60709573817,-2,1278,1596,-10
60711920354,60711920356,2,1472,1420,-10
60712845930,60712845934,4,1931,1464,-10
60714986134,60714986116,-18,1027,892,-10
60717634870,60717634869,-1,1452,1194,-10
60720124562,60720124565,3,1205,1609,-10
60721569693,60721569694,1,1864,1817,-10
60721713057,60721713058,1,2239,1948,-10
60722948201,60722948203,2,1604,1119,-10
60726170970,60726170973,3,2496,1578,-10
60730327508,60730327511,3,1512,1315,-10
60730669414,60730669414,0,1232,1315,-10
60731441368,60731441369,1,1439,1795,-10
60731550307,60731550288,-19,1610,2144,-10
60734882248,60734882249,1,1851,1579,-10
60737129699,60737129701,2,2189,1721,-10
60738681686,60738681689,3,1429,1173,-10
60741204908,60741204909,1,1738,2061,-10
60742389457,60742389458,1,1276,2115,-10
60744224284,60744224286,2,786,1059,-10
60750457090,60750457094,4,1364,797,-10
60751666911,60751666913,2,1735,2014,-10
60753501666,60753501668,2,1990,1231,-10
60754234653,60754234657,4,2099,1729,-10
60756473831,60756473834,3,1645,1388,-10
60758339435,60758339436,1,1267,1585,-10
60760486474,60760486475,1,1520,1358,-10
60760893542,60760893546,4,1302,1198,-10
60762732414,60762732416,2,1683,1424,-10
60767920156,60767920157,1,1429,1586,-10
60768215215,60768215218,3,1606,1603,-10
60770445030,60770445031,1,1053,1597,-10
60771480765,60771480767,2,1112,1038,-10
60773386810,60773386809,-1,1338,1396,-10
60774472833,60774472823,-10,911,1371,-10
60779603570,60779603572,2,1355,1609,-10
60784056642,60784056647,5,1706,1339,-10
60785200694,60785200695,1,1684,1924,-10
60787772204,60787772205,1,853,1205,-10
60789228253,60789228253,0,1890,2041,-10
60789879727,60789879736,9,62,1344,-10
60792322399,60792322402,3,787,1281,-10
60795472950,60795472951,1,1427,2018,-10
60795563222,60795563223,1,1031,1339,-10
60796289522,60796289526,4,1131,1377,-10
60796754909,60796754910,1,1519,1095,-10
60796862032,60796862034,2,1480,1751,-10
60797040038,60797040035,-3,1168,2439,-10
60798593293,60798593293,0,1303,1011,-10
60802694970,60802694971,1,1157,1303,-10
60802847498,60802847500,2,1454,1655,-10
60805373576,60805373579,3,2327,1228,-10
60805572903,60805572905,2,1582,1461,-10
60807264043,60807264040,-3,35566,20264,-10
60811917509,60811917510,1,1703,1882,-10
60813312626,60813312627,1,1569,1281,-10
60814281233,60814281235,2,1984,2014,-10
60816886974,60816886978,4,972,817,-10
60818189450,60818189453,3,1442,1752,-10
60819630639,60819630638,-1,1235,1279,-10
60821215715,60821215718,3,2539,2532,-10
60823621563,60823621565,2,1749,1307,-10
60824844764,60824844765,1,1495,2302,-10
60831149897,60831149892,-5,1613,6966,-10
60832898785,60832898786,1,2259,1593,-10
60837546537,60837546532,-5,23690,14750,-10
60838017459,60838017462,3,1212,1405,-10
60841745958,60841745961,3,1761,1949,-10
60843643793,60843643796,3,1168,1609,-10
60845022201,60845022203,2,1208,1688,-10
60846324535,60846324535,0,1600,1744,-10
60852371954,60852371954,0,1109,1335,-10
60855266178,60855266181,3,1267,1586,-10
60858426507,60858426505,-2,2845,3114,-10
60866414121,60866414118,-3,27275,7695,-10
60867407151,60867407156,5,1452,1323,-10
60875731447,60875731447,0,1664,1386,-10
60875835214,60875835215,1,1921,1804,-10
60876245526,60876245526,0,1407,1662,-10
60876515404,60876515406,2,1511,1455,-10
60880338960,60880338962,2,1588,1584,-10
60885238079,60885238081,2,1373,1910,-10
60886800581,60886800582,1,1470,1701,-10
60890046550,60890046554,4,1196,1041,-10
60890336486,60890336490,4,1307,1502,-10
60890726922,60890726923,1,1687,1206,-10
60894341758,60894341759,1,1224,1047,-10
60895811718,60895811721,3,1042,1604,-10
60897696979,60897696978,-1,1331,1565,-10
60898024403,60898024407,4,2409,1314,-10
60899371732,60899371734,2,1573,1521,-10
60900871894,60900871886,-8,30644,15441,-10
60903632382,60903632381,-1,1099,1668,-10
60905463227,60905463229,2,1423,1891,-10
60906028717,60906028718,1,1660,2066,-10
60906424023,60906424025,2,1805,2156,-10
60906907090,60906907089,-1,924,1423,-10
60907332753,60907332753,0,1622,1363,-10
60908964169,60908964171,2,1960,1911,-10
60915380342,60915380345,3,1872,2165,-10
60916814556,60916814557,1,1594,2135,-10
60916962821,60916962823,2,1346,906,-10
60918701905,60918701907,2,1669,1367,-10
60921178067,60921178070,3,1528,1524,-10
60921228645,60921228646,1,1762,1640,-10
60921515861,60921515866,5,5158,2013,-10
60928680391,60928680387,-4,1219,2493,-10
60929103222,60929103223,1,1681,1165,-10
60929549757,60929549739,-18,1801,1808,-10
60930078710,60930078689,-21,1501,966,-10
60930375818,60930375819,1,1883,2008,-10
60930942234,60930942235,1,1647,1895,-10
60934040361,60934040363,2,1700,1539,-10
60936738380,60936738398,18,1315,1350,-10
60938968093,60938968095,2,1210,1344,-10
60942112638,60942112648,10,10583,44407,-10
60942590798,60942590795,-3,1664,2889,-10
60945419549,60945419550,1,1747,1497,-10
60947106103,60947106108,5,3161,1272,-10
60947717678,60947717679,1,870,937,-10
60948169243,60948169245,2,1265,1817,-10
60950301331,60950301331,0,973,760,-10
60951129451,60951129454,3,1680,1622,-10
60951339073,60951339074,1,1965,1552,-10
60958261058,60958261059,1,1428,914,-10
60963162730,60963162733,3,1366,1516,-10
60963875603,60963875597,-6,1168,5747,-10
60971470491,60971470491,0,1126,992,-10
60976255606,60976255607,1,3000,4045,-10
60977629067,60977629070,3,1997,1670,-10
60979556989,60979556990,1,1771,1593,-10
60980526458,60980526462,4,1487,1562,-10
60984859962,60984859963,1,1815,1660,-10
60985706960,60985706962,2,1571,1338,-10
60989236350,60989236351,1,995,1198,-10
60993723247,60993723247,0,1226,1425,-10
60997352799,60997352800,1,1246,1067,-10
60999622003,60999622006,3,2663,1580,-10
61006128019,61006128021,2,1437,1200,-10
61008812773,61008812775,2,1724,1559,-10
61009759957,61009759957,0,42767,42067,-10
61016976344,61016976345,1,1285,1113,-10
61017507684,61017507685,1,1344,1034,-10
61019310192,61019310195,3,1892,1874,-10
61020634182,61020634184,2,1691,1418,-10
61026560313,61026560314,1,1353,1190,-10
61027825497,61027825499,2,1676,1958,-10
61028086100,61028086103,3,1941,1606,-10
61029222106,61029222105,-1,1242,1801,-10
61029629026,61029629025,-1,1351,1700,-10
61034309816,61034309818,2,1990,1984,-10
61038073527,61038073530,3,1708,1293,-10
61038525850,61038525854,4,1984,1791,-10
61039522658,61039522662,4,2009,1250,-10
61039802803,61039802798,-5,876,2164,-10
61044637746,61044637746,0,1700,1256,-10
61047895597,61047895598,1,1807,1759,-10
61054247366,61054247365,-1,1293,2006,-10
61057296361,61057296362,1,1130,1136,-10
61057434469,61057434469,0,1342,1898,-10
61061543794,61061543797,3,2066,1365,-10
61064904048,61064904051,3,1252,1080,-10
61066639782,61066639782,0,1259,1244,-10
61067079785,61067079786,1,984,1780,-10
61072141875,61072141879,4,1300,1196,-10
61074301912,61074301914,2,720,969,-10
61082978202,61082978203,1,1382,1825,-10
61083960790,61083960796,6,3421,1956,-10
61086904577,61086904579,2,2722,1822,-10
61087530313,61087530311,-2,1969,1722,-10
61090538110,61090538113,3,1764,1519,-10
61090777635,61090777636,1,1297,1229,-10
61097146884,61097146885,1,1242,1264,-10
61098909961,61098909965,4,1667,1162,-10
61102347729,61102347730,1,1610,911,-10
61104455991,61104455994,3,2148,2109,-10
61104768489,61104768491,2,1341,1090,-10
61106384209,61106384212,3,1168,1556,-10
61108587338,61108587338,0,1944,2619,-10
61112015226,61112015227,1,1746,2086,-10
61112908130,61112908131,1,1384,1691,-10
61113139375,61113139375,0,1759,1549,-10
61113342674,61113342678,4,1613,1255,-10
61114199487,61114199492,5,1506,1462,-10
61116948634,61116948635,1,1748,1361,-10
61118209771,61118209771,0,1424,1526,-10
61123770529,61123770531,2,1507,829,-10
61123858779,61123858797,18,871,1116,-10
61125680773,61125680774,1,1749,1208,-10
61129280139,61129280142,3,2172,2232,-10
61130978941,61130978942,1,2007,2719,-10
61131993398,61131993400,2,1011,1155,-10
61133684678,61133684680,2,1994,2097,-10
61134565462,61134565456,-6,2002,4883,-10
61136207571,61136207574,3,1595,1606,-10
61136289498,61136289500,2,1564,1336,-10
61136647071,61136647075,4,2427,1804,-10
61137023228,61137023229,1,1155,1989,-10
61137744433,61137744436,3,1626,1370,-10
61139151475,61139151486,11,612,220,-10
61140175502,61140175504,2,1184,1978,-10
61144950915,61144950919,4,1244,1808,-10
61146692868,61146692873,5,1176,975,-10
61153170950,61153170951,1,1333,871,-10
61153461071,61153461073,2,1582,1153,-10
61154355293,61154355295,2,1645,1278,-10
61158365159,61158365162,3,971,1216,-10
61164249206,61164249209,3,1245,1389,-10
61173610414,61173610415,1,1347,1567,-10
61176353430,61176353430,0,1741,1325,-10
61178240142,61178240146,4,1850,1037,-10
61180663048,61180663049,1,1513,2234,-10
61181349147,61181349146,-1,1194,1584,-10
61182006551,61182006554,3,1375,1234,-10
61183686769,61183686771,2,1552,1319,-10
61183791575,61183791579,4,1547,1826,-10
61187101811,61187101812,1,1657,1749,-10
61189603526,61189603527,1,1103,966,-10
61192558351,61192558361,10,79,1036,-10
61192675301,61192675301,0,984,1187,-10
61194180725,61194180726,1,1696,1459,-10
61196206988,61196206990,2,1680,1508,-10
61200776073,61200776075,2,956,1170,-10
61203405942,61203405944,2,2510,2323,-10
61208627206,61208627207,1,1856,1293,-10
61209232694,61209232696,2,1914,1978,-10
61212244137,61212244139,2,2168,1162,-10
61214971612,61214971614,2,1470,1573,-10
61223510023,61223510026,3,1301,953,-10
61228142603,61228142605,2,1568,1292,-10
61228645116,61228645119,3,1829,1408,-10
61229539783,61229539781,-2,965,1778,-10
61237935642,61237935643,1,1559,1541,-10
61238189785,61238189791,6,2984,1328,-10
61248812903,61248812906,3,715,1107,-10
61253168150,61253168151,1,1258,1208,-10
61253431796,61253431798,2,1530,1063,-10
61256635172,61256635175,3,1641,1660,-10
61257019691,61257019693,2,2016,1842,-10
61257602589,61257602590,1,1348,2027,-10
61259787258,61259787262,4,1400,1240,-10
61261653826,61261653829,3,1698,1552,-10
61268960424,61268960426,2,1389,1443,-10
61269945177,61269945178,1,997,1145,-10
61273633814,61273633814,0,1402,1436,-10
61273916962,61273916965,3,1455,1290,-10
61275257394,61275257397,3,1679,1678,-10
61276146528,61276146525,-3,7114,11290,-10
61276793509,61276793511,2,1822,1938,-10
61289170726,61289170729,3,1074,1192,-10
61290380560,61290380558,-2,1655,1625,-10
61291708689,61291708690,1,1606,1528,-10
61292085435,61292085436,1,1585,1773,-10
61294296469,61294296474,5,1584,1337,-10
61296161711,61296161710,-1,1895,1777,-10
61297422460,61297422461,1,1687,1868,-10
61300520966,61300520968,2,945,1276,-10
61301904266,61301904268,2,2285,2198,-10
61302463814,61302463817,3,2176,2206,-10
61302698503,61302698502,-1,1355,2397,-10
61305690553,61305690553,0,1308,1473,-10
61307656166,61307656168,2,1826,1414,-10
61309538155,61309538158,3,1327,1750,-10
61310158411,61310158411,0,1391,1513,-10
61310581797,61310581799,2,1644,2130,-10
61313565149,61313565151,2,1496,1484,-10
61318364861,61318364861,0,1123,1633,-10
61318988769,61318988771,2,1597,1403,-10
61319038346,61319038347,1,1687,1355,-10
61321063650,61321063651,1,1966,1359,-10
61324447091,61324447094,3,1755,1433,-10
61325690250,61325690251,1,1672,1330,-10
61326994833,61326994834,1,1484,1321,-10
61327311333,61327311334,1,1699,1139,-10
61327631559,61327631561,2,1245,1832,-10
61329918915,61329918909,-6,800,3130,-10
61332781670,61332781670,0,1641,1447,-10
61341246104,61341246106,2,1515,1167,-10
61345544134,61345544136,2,1686,1693,-10
61346063675,61346063675,0,1244,1517,-10
61346812837,61346812839,2,2012,1890,-10
61347577574,61347577575,1,1335,1799,-10
61349467079,61349467079,0,1485,1582,-10
61351502747,61351502742,-5,806,3393,-10
61353007942,61353007941,-1,941,1951,-10
61363196076,61363196078,2,2340,1737,-10
61363759046,61363759047,1,2185,2107,-10
61365955570,61365955573,3,1152,1542,-10
61366655609,61366655611,2,1423,1073,-10
61370434553,61370434555,2,1744,1449,-10
61373018041,61373018045,4,2746,1026,-10
61374368813,61374368815,2,991,984,-10
61374716923,61374716929,6,1791,1502,-10
61375362955,61375362938,-17,1974,1316,-10
61377475039,61377475043,4,888,574,-10
61380459129,61380459131,2,1000,1633,-10
61381415709,61381415714,5,1270,1044,-10
61382789226,61382789227,1,1623,1152,-10
61389699177,61389699179,2,984,1171,-10
61389837421,61389837420,-1,1175,1262,-10
61390648758,61390648759,1,2661,1719,-10
61393350610,61393350610,0,1355,1636,-10
61393529762,61393529763,1,1335,1231,-10
61394764018,61394764021,3,1512,1369,-10
61399959722,61399959723,1,2187,2114,-10
61401453993,61401453991,-2,1715,1499,-10
61408042546,61408042551,5,1159,1675,-10
61413502600,61413502612,12,12141,49404,-10
61415767628,61415767630,2,1609,1896,-10
61417414147,61417414147,0,1112,1264,-10
61418967719,61418967721,2,2056,1538,-10
61420761527,61420761528,1,1208,1679,-10
61424786106,61424786107,1,1079,1223,-10
61429267982,61429267986,4,1872,1684,-10
61431132535,61431132535,0,1500,1351,-10
61433125642,61433125647,5,1685,1623,-10
61433278219,61433278222,3,1128,1314,-10
61434235060,61434235072,12,1444,1115,-10
61438110725,61438110730,5,2078,1558,-10
61438765199,61438765201,2,1434,1861,-10
61439192616,61439192618,2,2000,1509,-10
61442337414,61442337418,4,1786,1109,-10
61447616825,61447616827,2,1781,1265,-10
61447791349,61447791349,0,1464,1773,-10
61448168362,61448168364,2,2024,1252,-10
61448707657,61448707654,-3,1011,1180,-10
61448886596,61448886599,3,1337,1071,-10
61451292530,61451292536,6,2212,1743,-10
61453421614,61453421610,-4,3485,9179,-10
61455449321,61455449321,0,1663,1895,-10
61457004023,61457004022,-1,1334,1637,-10
61457347009,61457347010,1,1615,1573,-10
61458890787,61458890791,4,1846,1022,-10
61463008103,61463008101,-2,1944,1572,-10
61463964722,61463964726,4,996,1230,-10
61464734690,61464734693,3,2318,1497,-10
61464773236,61464773258,22,1358,1095,-10
61465518230,61465518232,2,1800,2263,-10
61470398226,61470398230,4,1601,1232,-10
61471832814,61471832818,4,1691,1107,-10
61473202880,61473202885,5,1801,905,-10
61473581771,61473581772,1,1965,1595,-10
61480384434,61480384435,1,1466,1521,-10
61480713326,61480713329,3,1302,1448,-10
61481673294,61481673298,4,1622,1428,-10
61481935557,61481935558,1,1764,1740,-10
61486247470,61486247471,1,1581,2194,-10
61486488542,61486488542,0,1590,1622,-10
61488983137,61488983138,1,1316,1566,-10
61489475114,61489475117,3,1611,1562,-10
61490076335,61490076336,1,1272,1553,-10
61494575916,61494575918,2,1699,1543,-10
61495259185,61495259189,4,1819,1913,-10
61496449876,61496449874,-2,1668,1660,-10
61496735267,61496735268,1,1167,1811,-10
61496804122,61496804106,-16,987,1466,-10
61497046294,61497046295,1,1260,1523,-10
61497372785,61497372786,1,2244,1587,-10
61498784166,61498784170,4,976,848,-10
61499656353,61499656354,1,1062,1419,-10
61504013629,61504013631,2,971,1654,-10
61504085417,61504085418,1,1041,1700,-10
61504772453,61504772455,2,1992,1230,-10
61505059163,61505059167,4,1999,1277,-10
61505431534,61505431538,4,1546,1168,-10
61507766602,61507766607,5,2031,2177,-10
61510070658,61510070658,0,1158,1808,-10
61514634906,61514634909,3,1345,1088,-10
61519979323,61519979325,2,8170,8229,-10
61520662697,61520662700,3,1907,1460,-10
61523231171,61523231173,2,1036,1487,-10
61528475903,61528475907,4,2810,1705,-10
61528542862,61528542867,5,3026,1360,-10
61537067415,61537067418,3,1175,1043,-10
61537783650,61537783653,3,1974,1440,-10
61542147041,61542147042,1,1350,1565,-10
61542180478,61542180480,2,1612,1772,-10
61543020642,61543020643,1,1413,1791,-10
61545351186,61545351187,1,1281,1207,-10
61550404092,61550404094,2,958,1577,-10
61557455802,61557455805,3,1340,1662,-10
61558196771,61558196770,-1,2084,4039,-10
61558337752,61558337755,3,27462,22928,-10
61559299904,61559299902,-2,4499,8165,-10
61559445016,61559445018,2,1495,1758,-10
61561492654,61561492657,3,1278,1810,-10
61562691390,61562691393,3,1380,1683,-10
61564963746,61564963748,2,1911,1822,-10
61568752471,61568752471,0,1859,2175,-10
61571419770,61571419774,4,1544,1351,-10
61572186170,61572186170,0,1521,1688,-10
61577856102,61577856103,1,1705,1668,-10
61581385421,61581385422,1,1993,1365,-10
61581482257,61581482260,3,1384,1154,-10
61582499662,61582499663,1,1898,1829,-10
61589196309,61589196316,7,3096,1297,-10
61589756598,61589756599,1,2184,2163,-10
61593113109,61593113107,-2,5285,8453,-10
61599737140,61599737142,2,1401,1833,-10
61602874990,61602874992,2,1979,1790,-10
61603595713,61603595717,4,1197,1600,-10
61604148037,61604148039,2,1502,1428,-10
61606729630,61606729630,0,1162,1148,-10
61607975534,61607975525,-9,94,676,-10
61610184889,61610184891,2,1636,1244,-10
61610595486,61610595486,0,1328,1886,-10
61614726240,61614726241,1,1810,2401,-10
61619152197,61619152190,-7,1007,3097,-10
61619382489,61619382497,8,2729,1910,-10
61620499525,61620499526,1,966,1278,-10
61625727810,61625727802,-8,1322,5560,-10
61630228874,61630228875,1,1935,1812,-10
61630739883,61630739879,-4,805,176,-10
61634427444,61634427447,3,1801,1438,-10
61635705347,61635705347,0,1873,1485,-10
61639446142,61639446145,3,1162,1738,-10
61640373015,61640373018,3,1776,1891,-10
61640561686,61640561690,4,1448,1628,-10
61643477990,61643477991,1,1832,1631,-10
61646740618,61646740618,0,2176,2367,-10
61649473377,61649473377,0,2189,2115,-10
61650183644,61650183646,2,1637,1421,-10
61650570421,61650570422,1,1449,1377,-10
61651003200,61651003203,3,1636,1630,-10
61655368331,61655368333,2,1826,1907,-10
61657861532,61657861531,-1,1287,1066,-10
61659457872,61659457874,2,1673,1414,-10
61659918798,61659918792,-6,1895,10912,-10
61661525243,61661525242,-1,1649,2090,-10
61661843345,61661843347,2,1524,1626,-10
61663537995,61663537997,2,1611,2193,-10
61665738466,61665738470,4,1327,1242,-10
61666705199,61666705203,4,2035,1826,-10
61668786646,61668786647,1,1738,1838,-10
61671237169,61671237171,2,1664,1561,-10
61676508307,61676508309,2,1676,1765,-10
61678388787,61678388791,4,2317,1506,-10
61679118779,61679118782,3,1394,1212,-10
61682831430,61682831433,3,1895,1332,-10
61684307993,61684307995,2,1762,1777,-10
61684799312,61684799314,2,1387,1924,-10
61693741327,61693741330,3,1344,1456,-10
61694775294,61694775298,4,2418,1094,-10
61695563962,61695563963,1,1568,1674,-10
61695608963,61695608951,-12,798,575,-10
61697082160,61697082163,3,1170,1176,-10
61698470520,61698470523,3,1848,1821,-10
61698913188,61698913191,3,1401,1461,-10
61699313297,61699313298,1,1500,1346,-10
61701151429,61701151433,4,1140,1624,-10
61702455594,61702455579,-15,893,2479,-10
61703345161,61703345162,1,1702,1529,-10
61705541857,61705541857,0,2054,1582,-10
61706698022,61706698026,4,1530,1445,-10
61707266403,61707266402,-1,1840,1649,-10
61712615818,61712615819,1,1360,1664,-10
61715147765,61715147766,1,1786,1829,-10
61720614621,61720614623,2,1310,1776,-10
61725734205,61725734207,2,953,1006,-10
61725759538,61725759538,0,1582,1859,-10
61727330601,61727330605,4,2253,1517,-10
61730393082,61730393084,2,1938,1552,-10
61731102659,61731102661,2,1937,1509,-10
61732717165,61732717172,7,5598,2377,-10
61735899487,61735899490,3,1810,1487,-10
61736151058,61736151065,7,3226,1665,-10
61736397680,61736397681,1,1422,1730,-10
61739761215,61739761220,5,8996,20501,-10
61739840344,61739840346,2,1628,1808,-10
61740298939,61740298941,2,1265,1323,-10
61744919541,61744919543,2,1410,1347,-10
61746676369,61746676371,2,1532,1655,-10
61749168970,61749168971,1,1759,1739,-10
61751402345,61751402347,2,1754,1578,-10
61754011142,61754011143,1,1327,1334,-10
61754713142,61754713143,1,1169,1534,-10
61755310147,61755310149,2,1530,1359,-10
61756579310,61756579313,3,1448,1068,-10
61758590589,61758590582,-7,1875,9590,-10
61760160044,61760160063,19,2346,1605,-10
61761362537,61761362539,2,1784,1825,-10
61761471230,61761471231,1,2075,2103,-10
61764491458,61764491459,1,1467,1970,-10
61777180901,61777180898,-3,1577,2312,-10
61780829370,61780829373,3,1856,1601,-10
61781205529,61781205531,2,1530,926,-10
61781232151,61781232153,2,1696,1708,-10
61781801227,61781801226,-1,1119,877,-10
61784674522,61784674523,1,1940,1951,-10
61785143434,61785143434,0,1794,1958,-10
61786720287,61786720285,-2,1033,1506,-10
61787558968,61787558962,-6,1481,3644,-10
61788323619,61788323623,4,1764,1699,-10
61790799414,61790799421,7,12219,18910,-10
61791259673,61791259675,2,1329,1611,-10
61794568752,61794568754,2,1628,1510,-10
61795717103,61795717105,2,1714,1319,-10
61797042842,61797042846,4,1101,1135,-10
61798481954,61798481957,3,1272,1624,-10
61802142456,61802142459,3,14910,6617,-10
61802973307,61802973310,3,1618,1470,-10
61803162479,61803162498,19,1138,1476,-10
61806175817,61806175818,1,1222,1649,-10
61808531642,61808531645,3,1445,1601,-10
61810439007,61810439008,1,1675,1600,-10
61813176011,61813176014,3,1221,1358,-10
61818021614,61818021615,1,1631,1613,-10
61821313474,61821313476,2,1712,1368,-10
61821777074,61821777057,-17,1434,882,-10
61822600680,61822600679,-1,1298,1247,-10
61826706092,61826706094,2,1388,1887,-10
61828244287,61828244287,0,881,1556,-10
61829744164,61829744149,-15,1221,1461,-10
61830897259,61830897263,4,1526,1076,-10
61833612666,61833612686,20,394,1731,-10
61836453103,61836453098,-5,809,4210,-10
61838703394,61838703395,1,1471,1949,-10
61839707740,61839707743,3,1145,1330,-10
61841208433,61841208436,3,1118,1454,-10
61842081309,61842081310,1,1138,1179,-10
61843139318,61843139299,-19,1885,1655,-10
61845879222,61845879225,3,2074,1994,-10
61850255525,61850255527,2,1532,1998,-10
61853284808,61853284809,1,1366,1405,-10
61854622270,61854622270,0,1299,1284,-10
61855779173,61855779174,1,1402,2015,-10
61856912500,61856912500,0,1491,1616,-10
61861049601,61861049601,0,1682,2221,-10
61863309310,61863309303,-7,1079,4671,-10
61865263807,61865263807,0,1153,1534,-10
61871028724,61871028726,2,1136,964,-10
61877199785,61877199786,1,1365,1822,-10
61878640541,61878640542,1,2405,3393,-10
61879090266,61879090269,3,1573,1394,-10
61881637101,61881637102,1,1178,1285,-10
61887338437,61887338443,6,1573,1504,-10
61887506678,61887506659,-19,1316,195,-10
61892984934,61892984938,4,1399,1315,-10
61894990712,61894990714,2,1254,1276,-10
61896952870,61896952870,0,1413,1247,-10
61898002471,61898002473,2,1256,1892,-10
61900112718,61900112718,0,1600,1810,-10
61901078484,61901078498,14,227,2052,-10
61902405000,61902405001,1,1702,2071,-10
61906098491,61906098494,3,1712,991,-10
61906214126,61906214126,0,1157,1648,-10
61906939969,61906939973,4,43048,32702,-10
61907300625,61907300627,2,2064,1921,-10
61908801226,61908801228,2,1420,1193,-10
61911070618,61911070619,1,1916,1783,-10
61915516854,61915516855,1,1125,1227,-10
61918985421,61918985425,4,1209,1302,-10
61919706710,61919706707,-3,685,2484,-10
61920002746,61920002743,-3,1062,1570,-10
61922446559,61922446560,1,1375,1250,-10
61927798347,61927798346,-1,1179,1583,-10
61928589910,61928589912,2,1152,1113,-10
61930690129,61930690130,1,1630,1891,-10
61932358614,61932358615,1,1851,1114,-10
61934082337,61934082338,1,1484,1457,-10
61934872223,61934872225,2,2244,2041,-10
61936498373,61936498374,1,1872,2066,-10
61937402142,61937402144,2,1390,1297,-10
61938505999,61938506000,1,982,2138,-10
61944196067,61944196073,6,1363,1226,-10
61945036681,61945036683,2,1718,1808,-10
61946125718,61946125722,4,1493,1706,-10
61948046793,61948046813,20,746,3513,-10
61948866289,61948866292,3,3817,2864,-10
61953528159,61953528167,8,1580,2090,-10
61954705212,61954705214,2,1748,1571,-10
61956521418,61956521418,0,1502,1893,-10
61958572134,61958572136,2,1180,1803,-10
61959771071,61959771065,-6,1498,5445,-10
61960240034,61960240038,4,1624,1220,-10
61963227189,61963227193,4,1846,1010,-10
61965334469,61965334470,1,1734,1526,-10
61967716406,61967716406,0,1527,1900,-10
61971073729,61971073728,-1,1464,1904,-10
61972012550,61972012549,-1,1150,2527,-10
61974942722,61974942727,5,1277,1693,-10
61975292400,61975292401,1,758,1104,-10
61977646993,61977646995,2,1985,1757,-10
61979319194,61979319194,0,1383,1776,-10
61979766650,61979766652,2,1606,1403,-10
61985428756,61985428759,3,1194,835,-10
61985593635,61985593629,-6,1855,2922,-10
61994138614,61994138614,0,1627,1820,-10
61995734258,61995734259,1,1596,1208,-10
61996321188,61996321207,19,14554,57102,-10
61996408574,61996408574,0,1222,1470,-10
61997566273,61997566275,2,1836,1198,-10
61998211730,61998211733,3,1931,1765,-10
61998706322,61998706323,1,1399,1735,-10
61999496045,61999496047,2,2405,2049,-10
62003141429,62003141430,1,1347,1252,-10
62004725993,62004725994,1,1711,1730,-10
62004801799,62004801804,5,1221,1969,-10
62007165222,62007165222,0,1527,1618,-10
62008604941,62008604943,2,1575,1041,-10
62009403209,62009403209,0,1468,1687,-10
62009691815,62009691793,-22,1765,1551,-10
62011152422,62011152426,4,1552,1437,-10
62013900257,62013900259,2,1737,1533,-10
62016391467,62016391474,7,1800,1003,-10
62021497706,62021497706,0,2297,2025,-10
62025450486,62025450490,4,2039,1552,-10
62026877041,62026877044,3,2194,1682,-10
62027561062,62027561064,2,1599,1702,-10
62029604500,62029604502,2,1854,1352,-10
62035675107,62035675126,19,1500,1251,-10
62039803131,62039803131,0,1194,1088,-10
62040167829,62040167810,-19,117,164,-10
62046114149,62046114145,-4,2165,5047,-10
62047488977,62047488979,2,1680,1622,-10
62047552594,62047552593,-1,1588,1718,-10
62048342405,62048342407,2,2176,2221,-10
62049342939,62049342945,6,1752,1536,-10
62052371397,62052371398,1,1438,1594,-10
62054116589,62054116595,6,23055,35807,-10
62058270570,62058270577,7,3688,1340,-10
62062145139,62062145141,2,896,1370,-10
62063507909,62063507910,1,1149,1710,-10
62070617912,62070617913,1,2169,2026,-10
62071918782,62071918775,-7,1492,6145,-10
62078362461,62078362466,5,14933,10597,-10
62083592113,62083592115,2,1680,1346,-10
62085901003,62085901005,2,1781,1978,-10
62088139568,62088139570,2,1304,1447,-10
62089621678,62089621677,-1,1367,1412,-10
62095018850,62095018849,-1,1413,1106,-10
62095327902,62095327903,1,1340,1056,-10
62095719984,62095719977,-7,1829,1365,-10
62098467598,62098467598,0,1401,1403,-10
62099182205,62099182206,1,1939,2324,-10
62100017253,62100017255,2,1911,1132,-10
62100250190,62100250171,-19,1424,1236,-10
62101072479,62101072478,-1,1467,1179,-10
62102155366,62102155366,0,1660,1320,-10
62104629369,62104629368,-1,1559,2102,-10
62105426543,62105426546,3,1628,1871,-10
62107926922,62107926925,3,1318,1811,-10
62110466666,62110466669,3,2337,2209,-10
62112136390,62112136389,-1,1757,2121,-10
62118110637,62118110638,1,1577,1534,-10
62119752405,62119752407,2,1131,1656,-10
62120279729,62120279730,1,1539,1218,-10
62132258433,62132258435,2,1484,1411,-10
62132311658,62132311643,-15,2746,1699,-10
62135853935,62135853937,2,1403,1592,-10
62136357068,62136357048,-20,1218,1310,-10
62138027919,62138027924,5,1311,1231,-10
62139427478,62139427487,9,8983,27290,-10
62140924471,62140924474,3,1997,1921,-10
62143066446,62143066446,0,1254,1642,-10
62154898076,62154898078,2,1545,1618,-10
62155805829,62155805836,7,3169,1326,-10
62157106001,62157106002,1,1786,1634,-10
62157686634,62157686636,2,1547,1525,-10
62158237211,62158237215,4,1553,1442,-10
62161816722,62161816722,0,1867,1958,-10
62164044001,62164044002,1,1838,1629,-10
62165467219,62165467213,-6,1308,5066,-10
62166587490,62166587492,2,1295,1833,-10
62169266490,62169266495,5,1242,1313,-10
62173405681,62173405683,2,1295,688,-10
62174678602,62174678605,3,1508,1950,-10
62175395360,62175395364,4,1588,1552,-10
62176056026,62176056027,1,1589,1684,-10
62176776702,62176776704,2,1117,1931,-10
62177102914,62177102919,5,1647,1653,-10
62177322138,62177322155,17,1444,1179,-10
62177726537,62177726538,1,1420,1379,-10
62179533979,62179533978,-1,950,1866,-10
62182587582,62182587581,-1,1278,1039,-10
62183982003,62183982003,0,1117,1097,-10
62188488669,62188488666,-3,1777,4323,-10
62188954781,62188954781,0,2008,1905,-10
62190612872,62190612874,2,1389,1505,-10
62192182952,62192182958,6,4135,1863,-10
62194865422,62194865423,1,2274,1962,-10
62195143878,62195143881,3,1473,1580,-10
62195453827,62195453847,20,368,2432,-10
62195667509,62195667511,2,2026,1866,-10
62198366192,62198366193,1,1189,1563,-10
62198499378,62198499379,1,1842,1303,-10
62203441310,62203441310,0,1254,1224,-10
62205228315,62205228319,4,1803,1357,-10
62206784333,62206784337,4,1402,1542,-10
62224848159,62224848163,4,1096,886,-10
62225212949,62225212950,1,2086,1123,-10
62225819205,62225819207,2,1898,1296,-10
62231130265,62231130277,12,1668,1333,-10
62231230334,62231230337,3,1583,1821,-10
62233307927,62233307927,0,14064,26656,-10
62234265187,62234265191,4,1841,1676,-10
62234740326,62234740329,3,1492,1188,-10
62237414544,62237414549,5,1775,2116,-10
62237698149,62237698151,2,1863,1381,-10
62238605678,62238605679,1,1636,1652,-10
62239670631,62239670634,3,1565,1045,-10
62241479273,62241479262,-11,1010,1670,-10
62243806123,62243806123,0,1580,1624,-10
62244971005,62244971007,2,1671,1894,-10
62246200414,62246200415,1,1501,1560,-10
62246270159,62246270159,0,1249,1632,-10
62247468728,62247468730,2,1412,1142,-10
62248289777,62248289778,1,1501,1352,-10
62248965230,62248965231,1,1655,1655,-10
62255327090,62255327090,0,1702,1960,-10
62259273179,62259273182,3,1254,1704,-10
62263801009,62263801009,0,1245,1468,-10
62264551635,62264551639,4,2133,1823,-10
62266749399,62266749402,3,1129,1226,-10
62267293315,62267293318,3,1027,1474,-10
62268450451,62268450452,1,1495,1854,-10
62270442491,62270442493,2,1221,1581,-10
62274736882,62274736882,0,1699,1840,-10
62275282231,62275282232,1,1724,1768,-10
62285614922,62285614902,-20,751,471,-10
62286353957,62286353958,1,1805,1755,-10
62293362934,62293362935,1,1304,1178,-10
62297299443,62297299447,4,2144,1302,-10
62298629850,62298629850,0,1364,1034,-10
62300221233,62300221235,2,1744,1690,-10
62300369578,62300369578,0,1148,1487,-10
62301762238,62301762239,1,1290,1582,-10
62303938990,62303938991,1,1713,2281,-10
62304866865,62304866862,-3,750,990,-10
62307117242,62307117241,-1,1685,1824,-10
62309191022,62309191026,4,1423,1517,-10
62309254314,62309254316,2,1920,1776,-10
62311511437,62311511439,2,1875,1713,-10
62313894132,62313894133,1,1147,1493,-10
62314376814,62314376796,-18,1657,1583,-10
62316809498,62316809499,1,1726,1929,-10
62318186552,62318186554,2,2047,1849,-10
62321747471,62321747474,3,985,924,-10
62321989519,62321989518,-1,733,1117,-10
62323018787,62323018787,0,1383,1078,-10
62323992989,62323992990,1,1105,1349,-10
62324059587,62324059590,3,1705,1350,-10
62324160085,62324160086,1,1943,1773,-10
62326133578,62326133581,3,1832,2029,-10
62327607113,62327607117,4,1282,1321,-10
62328612127,62328612130,3,2041,1582,-10
62329229130,62329229130,0,1556,1793,-10
62332393019,62332393022,3,1455,1189,-10
62333985914,62333985917,3,1415,1993,-10
62336672412,62336672414,2,1619,1842,-10
62337001804,62337001807,3,2021,1669,-10
62338543128,62338543128,0,2064,2922,-10
62343869292,62343869294,2,1602,1329,-10
62349318282,62349318283,1,2008,1939,-10
62350516947,62350516947,0,1236,1923,-10
62350939746,62350939747,1,1543,1380,-10
62352291684,62352291689,5,2036,2051,-10
62353778885,62353778887,2,1696,1680,-10
62354315060,62354315058,-2,1228,1197,-10
62355755245,62355755246,1,1345,1926,-10
62355805020,62355805022,2,1544,1376,-10
62357621033,62357621037,4,1668,1939,-10
62358710259,62358710261,2,1251,1164,-10
62360156682,62360156683,1,1069,1077,-10
62362459902,62362459905,3,1450,1677,-10
62362584547,62362584547,0,838,1579,-10
62364899853,62364899855,2,1579,1904,-10
62369254866,62369254870,4,2121,1557,-10
62369687504,62369687501,-3,747,965,-10
62372568942,62372568943,1,1367,1489,-10
62375366447,62375366450,3,1753,1596,-10
62377083033,62377083034,1,1411,1846,-10
62379811742,62379811744,2,1957,1845,-10
62382625054,62382625048,-6,1855,9223,-10
62386614346,62386614347,1,1953,1652,-10
62387488648,62387488649,1,977,1182,-10
62387991994,62387991994,0,1051,1384,-10
62391642501,62391642501,0,1644,1886,-10
62392078970,62392078973,3,1510,1376,-10
62392515537,62392515553,16,1074,1277,-10
62394854039,62394854046,7,1576,1256,-10
62395055524,62395055523,-1,2188,1614,-10
62395846854,62395846857,3,1640,1165,-10
62397813233,62397813235,2,963,1309,-10
62398326678,62398326679,1,1587,2018,-10
62401016514,62401016516,2,1001,1568,-10
62402265838,62402265839,1,1741,1747,-10
62403687451,62403687457,6,18015,53268,-10
62404143518,62404143519,1,1314,1285,-10
62407715428,62407715429,1,1883,2445,-10
62409930949,62409930950,1,1626,2063,-10
62410780513,62410780514,1,1488,1421,-10
62413057030,62413057034,4,1344,2103,-10
62414898810,62414898810,0,1763,1298,-10
62417860934,62417860935,1,1109,1119,-10
62420965849,62420965851,2,1481,1534,-10
62427547007,62427547010,3,1371,1734,-10
62428919022,62428919025,3,1702,1173,-10
62434268387,62434268388,1,1313,1649,-10
62437209664,62437209666,2,1421,2116,-10
62439097458,62439097459,1,1583,1742,-10
62440115678,62440115683,5,1956,1572,-10
62443261177,62443261179,2,628,675,-10
62443976661,62443976663,2,1777,1691,-10
62444965704,62444965707,3,1875,1294,-10
62446854329,62446854322,-7,1790,4348,-10
62451993091,62451993094,3,1791,1698,-10
62454327247,62454327248,1,1253,1549,-10
62456591936,62456591938,2,2538,2343,-10
62457586942,62457586942,0,2082,4331,-10
62458028238,62458028239,1,1967,1629,-10
62458558020,62458558022,2,1836,1277,-10
62458592489,62458592504,15,1249,1100,-10
62459380506,62459380506,0,1459,1622,-10
62460168170,62460168173,3,1499,1665,-10
62461665538,62461665551,13,14775,37318,-10
62463734758,62463734759,1,1688,1447,-10
62465286383,62465286380,-3,1864,4770,-10
62466260798,62466260801,3,1580,2042,-10
62467139083,62467139076,-7,1586,2057,-10
62469658244,62469658245,1,2157,2200,-10
62477716663,62477716658,-5,1790,8566,-10
62479440463,62479440465,2,2118,2300,-10
62486201473,62486201465,-8,926,3335,-10
62488394040,62488394035,-5,10621,15111,-10
62491079484,62491079485,1,1248,1165,-10
62491455297,62491455278,-19,1820,1346,-10
62492894663,62492894665,2,3505,4125,-10
62501470968,62501470968,0,38573,26622,-10
62502642306,62502642310,4,1313,1681,-10
62503803610,62503803631,21,858,1062,-10
62505667560,62505667562,2,1927,1742,-10
62506911498,62506911499,1,2028,1837,-10
62507197973,62507197977,4,1247,1695,-10
62507668364,62507668365,1,1589,1484,-10
62512889585,62512889591,6,6482,2836,-10
62514405731,62514405721,-10,1058,1095,-10
62514778881,62514778886,5,1229,1256,-10
62521316846,62521316846,0,1378,1341,-10
62521485465,62521485466,1,1247,1625,-10
62522545600,62522545601,1,1433,1420,-10
62523455521,62523455522,1,1945,1963,-10
62524812829,62524812829,0,814,1713,-10
62524952525,62524952519,-6,900,3889,-10
62529361017,62529361023,6,10634,4231,-10
62529647890,62529647875,-15,1279,1392,-10
62531462894,62531462895,1,1952,1792,-10
62531915678,62531915678,0,1715,1320,-10
62532157578,62532157579,1,1203,1335,-10
62532791697,62532791700,3,1412,1645,-10
62538409107,62538409110,3,1824,1946,-10
62546292177,62546292178,1,1613,1749,-10
62548220766,62548220769,3,1302,1273,-10
62548646534,62548646537,3,1528,1608,-10
62552510610,62552510611,1,1042,1805,-10
62554450735,62554450738,3,1417,1621,-10
62557707282,62557707281,-1,1307,1728,-10
62557826777,62557826761,-16,909,1338,-10
62558528190,62558528192,2,1958,1629,-10
62559452209,62559452211,2,667,728,-10
62560371935,62560371938,3,1671,2023,-10
62565124378,62565124382,4,1660,1355,-10
62569344953,62569344957,4,1466,1259,-10
62570243745,62570243746,1,1211,1481,-10
62574343302,62574343297,-5,764,1878,-10
62576268219,62576268222,3,1189,1850,-10
62577901515,62577901518,3,1530,1089,-10
62578503354,62578503357,3,1455,1410,-10
62579820446,62579820446,0,1527,1712,-10
62579898609,62579898611,2,1229,1584,-10
62581377685,62581377686,1,1336,1400,-10
62581567132,62581567112,-20,2636,875,-10
62582709519,62582709521,2,2317,2542,-10
62584106190,62584106190,0,1622,2113,-10
62584208842,62584208843,1,2077,1830,-10
62584689166,62584689170,4,2232,1809,-10
62584761333,62584761335,2,1630,1471,-10
62584898437,62584898458,21,1603,1091,-10
62587566634,62587566632,-2,1156,1595,-10
62588484382,62588484386,4,1973,1603,-10
62589540839,62589540840,1,834,1062,-10
62592596576,62592596577,1,1650,1654,-10
62597004547,62597004544,-3,1608,2112,-10
62597414658,62597414661,3,1595,2273,-10
62598373175,62598373177,2,1470,1586,-10
62599132949,62599132950,1,1808,1305,-10
62600084836,62600084837,1,1248,1461,-10
62600927641,62600927642,1,1169,805,-10
62605140041,62605140041,0,1770,1736,-10
62607682926,62607682927,1,2064,2158,-10
62610439948,62610439941,-7,1215,4374,-10
62610481154,62610481155,1,1260,1434,-10
62616775049,62616775048,-1,1507,1659,-10
62618166857,62618166859,2,1815,1209,-10
62618512794,62618512781,-13,1405,1362,-10
62620491397,62620491399,2,2401,2250,-10
62625302536,62625302538,2,2226,2039,-10
62628998084,62628998086,2,2043,2091,-10
62631423838,62631423840,2,1792,1549,-10
62632780316,62632780318,2,1496,1855,-10
62639893909,62639893910,1,1880,1837,-10
62640003146,62640003149,3,1189,1166,-10
62640690172,62640690195,23,884,1702,-10
62642054685,62642054687,2,1474,1547,-10
62649786076,62649786073,-3,26242,13681,-10
62650577429,62650577434,5,8196,27329,-10
62650679705,62650679707,2,1280,1736,-10
62652339015,62652339018,3,1725,1388,-10
62652891999,62652892000,1,1645,1947,-10
62653997398,62653997401,3,1654,1200,-10
62660685536,62660685537,1,1330,1165,-10
62661820972,62661820973,1,1118,1064,-10
62664393845,62664393849,4,2231,1557,-10
62664629246,62664629249,3,1841,1524,-10
62669728501,62669728504,3,1440,1338,-10
62671532405,62671532406,1,1688,2034,-10
62672067586,62672067589,3,1584,1563,-10
62672998238,62672998239,1,1404,1296,-10
62681421875,62681421870,-5,655,1445,-10
62681743738,62681743738,0,1359,1505,-10
62682614130,62682614132,2,2091,1830,-10
62689270242,62689270243,1,1221,1530,-10
62694400035,62694400035,0,1288,1982,-10
62698180520,62698180522,2,1409,1564,-10
62698834929,62698834931,2,1188,1776,-10
62699446240,62699446242,2,1354,1388,-10
62699706560,62699706555,-5,4003,10261,-10
62705665293,62705665297,4,1193,852,-10
62709474382,62709474384,2,1642,1709,-10
62717478058,62717478056,-2,1472,2467,-10
62724657455,62724657458,3,1438,1063,-10
62724986090,62724986069,-21,1645,1567,-10
62725443330,62725443333,3,1034,1316,-10
62732335105,62732335107,2,2128,2118,-10
62735859044,62735859046,2,1440,1460,-10
62737759750,62737759753,3,1289,1510,-10
62741159351,62741159351,0,1123,1301,-10
62745608541,62745608537,-4,1036,2506,-10
62749340200,62749340202,2,1984,1676,-10
62753683615,62753683614,-1,1254,1239,-10
62757089260,62757089262,2,1625,1354,-10
62759737291,62759737294,3,1737,1015,-10
62768055454,62768055459,5,22313,30747,-10
62769294815,62769294819,4,1286,1505,-10
62769419939,62769419938,-1,1642,1572,-10
62771150074,62771150075,1,1311,1670,-10
62772781024,62772781026,2,1609,1879,-10
62774854084,62774854087,3,2181,1586,-10
62775213835,62775213838,3,1326,1680,-10
62777112898,62777112903,5,1732,861,-10
62778645599,62778645602,3,1341,1838,-10
62779026583,62779026580,-3,861,2627,-10
62784606429,62784606429,0,1537,1487,-10
62785454555,62785454556,1,1269,1351,-10
62787012749,62787012750,1,2219,2269,-10
62787883114,62787883117,3,1059,1338,-10
62794148997,62794148989,-8,1847,9966,-10
62794435535,62794435538,3,1044,968,-10
62801345610,62801345610,0,1746,1807,-10
62803535256,62803535255,-1,979,878,-10
62806686426,62806686425,-1,1414,1982,-10
62809148566,62809148567,1,1172,1179,-10
62809989722,62809989725,3,1551,1348,-10
62811482985,62811482985,0,1771,1775,-10
62814133226,62814133229,3,1172,848,-10
62816071518,62816071519,1,1138,1725,-10
62819012750,62819012751,1,1473,1915,-10
62819223990,62819223991,1,1070,1481,-10
62821861994,62821861996,2,2513,2537,-10
62822706782,62822706785,3,2168,1405,-10
62825514154,62825514155,1,1294,1356,-10
62825744885,62825744889,4,2645,2140,-10
62827352460,62827352459,-1,1821,1506,-10
62827818878,62827818881,3,2028,1381,-10
62828435953,62828435954,1,1902,1143,-10
62830691661,62830691662,1,1752,1598,-10
62833722441,62833722444,3,2052,1674,-10
62836015205,62836015207,2,1463,1693,-10
62836756348,62836756350,2,1624,1244,-10
62837531539,62837531541,2,1505,1659,-10
62839908390,62839908391,1,2335,1645,-10
62842192247,62842192248,1,1693,1443,-10
62844245523,62844245524,1,1597,2011,-10
62844578419,62844578422,3,1298,1683,-10
62845072494,62845072495,1,1599,1557,-10
62855303491,62855303492,1,1120,1583,-10
62855848561,62855848561,0,1444,1318,-10
62859839437,62859839442,5,1609,1726,-10
62860763516,62860763518,2,2018,1520,-10
62863695975,62863695978,3,1194,1416,-10
62864153971,62864153972,1,1805,2095,-10
62865674083,62865674082,-1,1786,1827,-10
62871817833,62871817834,1,1668,1962,-10
62872170810,62872170811,1,1271,816,-10
62872559694,62872559695,1,948,1138,-10
62874487884,62874487887,3,1385,1502,-10
62879709019,62879709021,2,1370,1715,-10
62880361944,62880361946,2,913,916,-10
62881232939,62881232941,2,1448,1397,-10
62889634213,62889634214,1,1719,1523,-10
62889942732,62889942733,1,1402,1458,-10
62890331390,62890331394,4,1547,1553,-10
62897022835,62897022835,0,1735,1942,-10
62898349629,62898349630,1,1688,1608,-10
62901100045,62901100046,1,2114,1605,-10
62905650191,62905650190,-1,1143,1700,-10
62906398886,62906398886,0,1217,1216,-10
62907964138,62907964143,5,1517,705,-10
62910736594,62910736595,1,1610,2055,-10
62912140441,62912140452,11,1395,1362,-10
62916025492,62916025494,2,1782,1244,-10
62916326494,62916326474,-20,1622,1857,-10
62923467618,62923467614,-4,5063,11620,-10
62924371033,62924371034,1,1724,1817,-10
62928588565,62928588566,1,1756,1920,-10
62933151097,62933151098,1,2386,1992,-10
62935895069,62935895069,0,1628,1828,-10
62943995535,62943995538,3,1265,1342,-10
62947065291,62947065294,3,2039,1623,-10
62948123238,62948123239,1,1508,1292,-10
62948501254,62948501256,2,1156,1171,-10
62951638421,62951638423,2,1196,1128,-10
62952145535,62952145516,-19,1148,1837,-10
62953055099,62953055098,-1,1248,1500,-10
62954198229,62954198229,0,1789,1558,-10
62957500306,62957500305,-1,40371,16109,-10
62958085675,62958085673,-2,1883,1991,-10
62959067229,62959067231,2,1330,1978,-10
62961266862,62961266866,4,1103,1307,-10
62968070713,62968070714,1,1619,1912,-10
62971533255,62971533257,2,1577,1502,-10
62971778877,62971778899,22,1293,970,-10
62972238932,62972238934,2,2011,1840,-10
62972951495,62972951497,2,2018,1600,-10
62974114242,62974114245,3,1217,1204,-10
62976106518,62976106519,1,1743,1409,-10
62977818901,62977818902,1,1247,1532,-10
62979521641,62979521642,1,922,900,-10
62986121585,62986121586,1,1194,1761,-10
62988862874,62988862875,1,1707,1676,-10
62989547287,62989547288,1,1700,1836,-10
62992309141,62992309140,-1,1353,2531,-10
62994901206,62994901211,5,1379,1438,-10
62996207458,62996207459,1,1145,966,-10
62997329894,62997329894,0,1521,1783,-10
62997652915,62997652917,2,1008,1327,-10
62998558846,62998558825,-21,1976,1516,-10
62999594637,62999594638,1,1001,1463,-10
63003478551,63003478551,0,1450,1875,-10
63008417798,63008417798,0,1247,1643,-10
63008507793,63008507795,2,1492,1550,-10
63009260275,63009260276,1,1372,1595,-10
63011334024,63011334026,2,368,745,-10
63013597823,63013597825,2,1510,1694,-10
63016342568,63016342565,-3,972,1213,-10
63016703757,63016703761,4,1450,1588,-10
63018349856,63018349859,3,1823,1220,-10
63019708121,63019708126,5,1585,1005,-10
63022665119,63022665122,3,1578,1512,-10
63024092030,63024092032,2,1287,864,-10
63024320806,63024320827,21,1995,1207,-10
63027260366,63027260366,0,1127,1175,-10
63027478983,63027478982,-1,1593,1509,-10
63028336753,63028336754,1,1280,1330,-10
63029239378,63029239379,1,1733,1162,-10
63029375925,63029375929,4,1892,1969,-10
63030343398,63030343398,0,1670,1443,-10
63031015304,63031015304,0,1610,1508,-10
63034722275,63034722277,2,1139,1659,-10
63037479885,63037479877,-8,1789,10971,-10
63043308968,63043308967,-1,1818,1694,-10
63044577262,63044577263,1,1585,1532,-10
63045125818,63045125823,5,1410,1356,-10
63046042406,63046042406,0,1135,1396,-10
63046172569,63046172568,-1,1402,1397,-10
63046499102,63046499102,0,1132,1943,-10
63049824085,63049824085,0,1238,1965,-10
63050312019,63050312023,4,1447,1428,-10
63050983535,63050983536,1,1925,1496,-10
63051756558,63051756560,2,1121,1570,-10
63054573510,63054573510,0,1769,1254,-10
63055510779,63055510779,0,1213,1600,-10
63057887701,63057887697,-4,1440,3336,-10
63060699076,63060699071,-5,1019,5119,-10
63060791034,63060791036,2,1903,1472,-10
63062087847,63062087827,-20,2418,1004,-10
63062125427,63062125429,2,680,996,-10
63066097186,63066097190,4,1970,1007,-10
63071507123,63071507126,3,1688,1509,-10
63072070382,63072070383,1,1427,1298,-10
63074254212,63074254213,1,1785,1657,-10
63076804766,63076804771,5,1148,1586,-10
63078739654,63078739657,3,1183,1365,-10
63079297622,63079297625,3,1805,1672,-10
63081794673,63081794674,1,1574,1925,-10
63088064050,63088064052,2,1072,1412,-10
63088696321,63088696322,1,1349,1232,-10
63091752406,63091752406,0,912,1184,-10
63094182908,63094182911,3,1789,1393,-10
63096625006,63096625006,0,1340,1213,-10
63097628937,63097628938,1,1522,1466,-10
63098068970,63098068974,4,1606,986,-10
63100216938,63100216941,3,1763,1358,-10
63100344992,63100344978,-14,1894,739,-10
63101599623,63101599626,3,1283,1651,-10
63104040262,63104040266,4,2167,1218,-10
63106837340,63106837342,2,1913,2087,-10
63107825205,63107825207,2,2232,1801,-10
63108649249,63108649241,-8,1798,1478,-10
63108853713,63108853719,6,8860,25627,-10
63114656915,63114656917,2,1520,1815,-10
63114714143,63114714145,2,1680,1489,-10
63115886647,63115886649,2,1672,1901,-10
63118290455,63118290457,2,57,1511,-10
63119542353,63119542354,1,1708,2234,-10
63125751726,63125751727,1,1464,1303,-10
63127798360,63127798358,-2,1213,2047,-10
63129402872,63129402871,-1,1190,2269,-10
63132801955,63132801958,3,1948,1876,-10
63133129889,63133129888,-1,1755,1797,-10
63133271370,63133271388,18,659,2633,-10
63135301783,63135301785,2,884,800,-10
63137699278,63137699275,-3,1025,1840,-10
63138361190,63138361193,3,1185,1541,-10
63139584857,63139584859,2,1735,2018,-10
63145173458,63145173459,1,1582,1323,-10
63147840294,63147840294,0,1456,1285,-10
63148000942,63148000922,-20,1166,1345,-10
63150678486,63150678488,2,1376,1404,-10
63151101544,63151101546,2,1948,1797,-10
63154248596,63154248597,1,1561,1931,-10
63154472702,63154472704,2,1249,1133,-10
63154891374,63154891373,-1,1261,1718,-10
63157482285,63157482288,3,1033,1412,-10
63160707272,63160707257,-15,1445,2072,-10
63162312479,63162312486,7,3321,1121,-10
63162630134,63162630137,3,1512,1855,-10
63162739669,63162739670,1,1827,939,-10
63167315123,63167315124,1,1290,1379,-10
63170715151,63170715155,4,28510,39500,-10
63171502383,63171502386,3,2262,1896,-10
63171830110,63171830115,5,1093,1253,-10
63172906509,63172906509,0,1140,1762,-10
63175093484,63175093487,3,2397,1905,-10
63175740926,63175740930,4,1397,1428,-10
63176224894,63176224897,3,1066,1474,-10
63176405913,63176405916,3,1322,1123,-10
63176431662,63176431662,0,1283,1054,-10
63177284328,63177284331,3,1548,1353,-10
63177754147,63177754128,-19,2338,2044,-10
63179925202,63179925203,1,1961,1398,-10
63181994009,63181994009,0,1378,2339,-10
63185273173,63185273174,1,1080,1331,-10
63185756962,63185756962,0,1701,2476,-10
63186906049,63186906050,1,1708,1606,-10
63188144877,63188144877,0,1308,875,-10
63189900848,63189900850,2,964,1439,-10
63192088255,63192088257,2,1658,1669,-10
63192616677,63192616677,0,1767,2174,-10
63192773072,63192773073,1,1690,1523,-10
63193724773,63193724773,0,1578,2044,-10
63197211329,63197211332,3,2161,1637,-10
63199323419,63199323428,9,1705,1347,-10
63201112190,63201112190,0,1209,1626,-10
63201157123,63201157124,1,1421,1459,-10
63202038771,63202038772,1,2096,2388,-10
63203076871,63203076889,18,1239,1433,-10
63204725105,63204725108,3,1586,1659,-10
63204785315,63204785320,5,1233,1110,-10
63206695206,63206695206,0,785,974,-10
63209448722,63209448725,3,1620,1691,-10
63211836402,63211836402,0,1189,1660,-10
63212664269,63212664269,0,1494,1315,-10
63214449591,63214449593,2,1343,1074,-10
63215847192,63215847195,3,1722,1149,-10
63222624277,63222624279,2,1001,799,-10
63226927056,63226927058,2,1708,1678,-10
63227855304,63227855291,-13,1344,1093,-10
63229033405,63229033408,3,1715,1762,-10
63233062145,63233062147,2,1399,1689,-10
63233771728,63233771727,-1,1586,1602,-10
63240753526,63240753525,-1,1792,2721,-10
63248229266,63248229266,0,1924,2111,-10
63249819865,63249819867,2,1680,1548,-10
63250297510,63250297511,1,1402,1522,-10
63251689245,63251689242,-3,789,3207,-10
63252384786,63252384776,-10,1385,1449,-10
63253957869,63253957870,1,1314,1824,-10
63254901066,63254901069,3,1593,1787,-10
63258591005,63258591006,1,1917,1823,-10
63259272883,63259272885,2,1377,1425,-10
63262373117,63262373117,0,1871,2036,-10
63263704826,63263704830,4,1768,1150,-10
63266585079,63266585081,2,355,214,-10
63270931786,63270931786,0,1409,1486,-10
63271550214,63271550215,1,1753,908,-10
63274949505,63274949506,1,2489,2028,-10
63277075986,63277075989,3,1656,1728,-10
63279576022,63279576031,9,16446,34227,-10
63280868147,63280868147,0,1534,1614,-10
63281482710,63281482711,1,1127,1793,-10
63284499528,63284499530,2,1977,1845,-10
63285894770,63285894772,2,1504,1315,-10
63286226085,63286226088,3,1395,1878,-10
63288247218,63288247219,1,1473,1352,-10
63288546041,63288546039,-2,1450,1491,-10
63289659715,63289659709,-6,1604,6448,-10
63294067028,63294067031,3,1709,1895,-10
63299200711,63299200714,3,931,1728,-10
63302428144,63302428145,1,1299,1473,-10
63303567937,63303567939,2,1421,1033,-10
63303948591,63303948591,0,1513,1655,-10
63307864041,63307864040,-1,1557,2086,-10
63307951091,63307951094,3,1699,1513,-10
63310407505,63310407506,1,1206,1743,-10
63311814344,63311814346,2,1424,1758,-10
63313381582,63313381586,4,1854,1568,-10
63315311162,63315311163,1,1949,1626,-10
63315475884,63315475886,2,1435,1519,-10
63317548026,63317548028,2,1147,1510,-10
63320422518,63320422522,4,2336,1959,-10
63322106921,63322106907,-14,2468,1019,-10
63322387166,63322387169,3,1910,1352,-10
63322604490,63322604493,3,2577,2417,-10
63323258317,63323258319,2,2287,1980,-10
63327394151,63327394155,4,1748,1440,-10
63327758807,63327758812,5,2050,1856,-10
63331549715,63331549716,1,2376,1973,-10
63332497056,63332497059,3,1656,1093,-10
63333204266,63333204266,0,1725,1355,-10
63334221786,63334221789,3,2665,1663,-10
63334302945,63334302947,2,1656,1555,-10
63335275174,63335275177,3,1516,1604,-10
63340456921,63340456919,-2,1506,3252,-10
63341678811,63341678814,3,2278,1717,-10
63343588762,63343588780,18,983,1229,-10
63349513785,63349513790,5,1472,991,-10
63349739086,63349739091,5,3317,2396,-10
63349804731,63349804733,2,1132,1703,-10
63352119141,63352119144,3,1527,1901,-10
63352326116,63352326117,1,1326,2693,-10
63357682858,63357682860,2,1752,1845,-10
63358343065,63358343066,1,1646,1615,-10
63363151693,63363151695,2,1464,1096,-10
63366184542,63366184543,1,1377,1319,-10
63369613166,63369613170,4,1579,1239,-10
63378863926,63378863926,0,1662,1700,-10
63382733123,63382733123,0,1118,1256,-10
63385285271,63385285273,2,1035,1449,-10
63385945426,63385945429,3,2114,1787,-10
63386988281,63386988277,-4,858,1547,-10
63389906593,63389906594,1,1435,1696,-10
63390261326,63390261330,4,1716,1284,-10
63393962467,63393962466,-1,982,1227,-10
63394312265,63394312265,0,1628,1150,-10
63396012501,63396012507,6,3050,1785,-10
63396732885,63396732886,1,2134,1801,-10
63397571789,63397571789,0,1241,1734,-10
63401821659,63401821679,20,1140,1264,-10
63402457866,63402457866,0,1501,1798,-10
63403849009,63403849014,5,1575,726,-10
63404409953,63404409954,1,1917,1749,-10
63408619912,63408619913,1,1479,1237,-10
63409557134,63409557135,1,1591,1207,-10
63413027039,63413027037,-2,990,1665,-10
63414608964,63414608966,2,1990,2226,-10
63418417375,63418417377,2,2090,1911,-10
63419308132,63419308132,0,1262,1542,-10
63421682717,63421682719,2,1490,1636,-10
63422893125,63422893132,7,2054,923,-10
63425593149,63425593150,1,1368,960,-10
63430001993,63430001994,1,1675,2046,-10
63430231022,63430231023,1,1705,1267,-10
63431287220,63431287222,2,1621,1428,-10
63434569598,63434569601,3,1325,1282,-10
63435482788,63435482793,5,3069,1397,-10
63435829310,63435829310,0,1249,1740,-10
63442228616,63442228619,3,1335,1076,-10
63444229190,63444229193,3,1389,1989,-10
63444419515,63444419518,3,1979,1811,-10
63448148709,63448148710,1,1244,1363,-10
63450390570,63450390571,1,1760,1249,-10
63451701008,63451701016,8,39497,2609,-10
63453641709,63453641709,0,1685,1526,-10
63459545261,63459545262,1,1622,1461,-10
63464631501,63464631505,4,2211,1772,-10
63476305051,63476305052,1,1735,1304,-10
63478814581,63478814584,3,1485,1611,-10
63482630549,63482630552,3,1690,1240,-10
63487329688,63487329688,0,1790,1390,-10
63489354082,63489354087,5,1266,1090,-10
63493724238,63493724238,0,1789,1887,-10
63493955869,63493955869,0,1628,2034,-10
63495670670,63495670663,-7,990,4064,-10
63498374319,63498374322,3,1074,1190,-10
63500695168,63500695168,0,1542,1935,-10
63501185142,63501185140,-2,974,1454,-10
63504280020,63504280023,3,1462,1574,-10
63507574411,63507574414,3,1025,1165,-10
63508419319,63508419322,3,1048,1636,-10
63511380194,63511380197,3,1910,1531,-10
63512022423,63512022406,-17,1263,1971,-10
63513466549,63513466553,4,1926,2278,-10
63514153053,63514153054,1,1168,1060,-10
63518313028,63518313029,1,1284,1202,-10
63521500271,63521500267,-4,1704,1482,-10
63526936202,63526936203,1,1630,1614,-10
63528540223,63528540223,0,1213,1370,-10
63529980097,63529980099,2,1088,1193,-10
63531373567,63531373554,-13,1562,15957,-10
63532202722,63532202727,5,1162,1658,-10
63532856491,63532856491,0,1569,1219,-10
63534766523,63534766524,1,1709,1374,-10
63536382526,63536382529,3,1845,1283,-10
63539802593,63539802593,0,1585,1434,-10
63540532837,63540532838,1,1539,956,-10
63541682598,63541682599,1,1508,1880,-10
63542032371,63542032375,4,1222,1248,-10
63543504799,63543504804,5,2193,1346,-10
63543970170,63543970167,-3,3467,6860,-10
63544882942,63544882943,1,1858,2152,-10
63544922362,63544922363,1,1559,1581,-10
63546285701,63546285702,1,1733,1634,-10
63546456616,63546456602,-14,1537,818,-10
63548007122,63548007123,1,961,1520,-10
63548724825,63548724826,1,1162,1557,-10
63551670891,63551670882,-9,2166,10471,-10
63559579249,63559579231,-18,4312,3102,-10
63561039266,63561039262,-4,19530,9470,-10
63563972425,63563972429,4,1473,1063,-10
63564020431,63564020451,20,2169,1233,-10
63564842926,63564842930,4,1657,1583,-10
63565293587,63565293589,2,1660,1886,-10
63565702933,63565702937,4,1922,2264,-10
63565996359,63565996338,-21,1540,1689,-10
63567399885,63567399886,1,1525,2196,-10
63568064438,63568064443,5,4372,2304,-10
63569111348,63569111349,1,1742,1468,-10
63570922943,63570922946,3,1574,1155,-10
63571848862,63571848868,6,2265,1363,-10
63577131644,63577131648,4,1473,1231,-10
63579888765,63579888766,1,1971,1603,-10
63580650349,63580650352,3,1355,847,-10
63581439810,63581439813,3,1975,1897,-10
63582228170,63582228173,3,1882,1882,-10
63582564921,63582564923,2,2653,1641,-10
63582620040,63582620042,2,1156,899,-10
63585798122,63585798125,3,1643,1949,-10
63588088895,63588088896,1,1826,1852,-10
63596561705,63596561706,1,1095,1375,-10
63598139730,63598139732,2,1863,1621,-10
63599498357,63599498361,4,22560,19049,-10
63601818846,63601818850,4,1815,1513,-10
63605380794,63605380796,2,1599,1588,-10
63605735169,63605735171,2,1280,1446,-10
63606874091,63606874094,3,2100,1504,-10
63608142353,63608142354,1,1906,2195,-10
63613730808,63613730811,3,1264,1465,-10
63618373588,63618373590,2,1432,1553,-10
63618518309,63618518331,22,1501,1260,-10
63619591665,63619591667,2,1822,1556,-10
63621692053,63621692054,1,1124,1462,-10
63625785004,63625785022,18,1388,1768,-10
63626345384,63626345385,1,2293,2127,-10
63628748125,63628748126,1,1475,1181,-10
63632167283,63632167286,3,1537,1321,-10
63633462094,63633462094,0,967,1399,-10
63634504549,63634504554,5,2643,1352,-10
63634705733,63634705733,0,927,1158,-10
63637834282,63637834286,4,1617,1918,-10
63638694240,63638694241,1,1117,1718,-10
63641427011,63641427011,0,1743,1459,-10
63641619877,63641619880,3,2196,1993,-10
63641879980,63641879981,1,1440,1364,-10
63646530803,63646530806,3,1679,1220,-10
63646737051,63646737054,3,1683,1564,-10
63647370910,63647370915,5,1142,1076,-10
63648696238,63648696241,3,1953,2059,-10
63648857842,63648857845,3,1283,1458,-10
63652348594,63652348597,3,1838,1827,-10
63653662063,63653662065,2,1223,1413,-10
63657933469,63657933471,2,1468,1753,-10
63659182571,63659182572,1,1147,1667,-10
63661552278,63661552282,4,1503,1165,-10
63661594951,63661594929,-22,1807,2424,-10
63663600293,63663600292,-1,1256,1940,-10
63665010148,63665010152,4,1855,2117,-10
63667255851,63667255854,3,2255,1826,-10
63668766967,63668766967,0,1139,1169,-10
63675198325,63675198327,2,1367,1349,-10
63679008921,63679008922,1,1790,1671,-10
63683350372,63683350374,2,1740,1726,-10
63685495489,63685495494,5,1575,1464,-10
63687519750,63687519749,-1,1065,2234,-10
63687903773,63687903775,2,1184,1237,-10
63690113793,63690113794,1,1222,1336,-10
63692503651,63692503653,2,1671,1378,-10
63698507290,63698507292,2,1329,1148,-10
63705294959,63705294960,1,1449,1551,-10
63709519266,63709519267,1,24584,18396,-10
63710264551,63710264554,3,1798,1272,-10
63710482601,63710482601,0,1662,1533,-10
63713273798,63713273799,1,1071,1302,-10
63714375986,63714375989,3,1547,1815,-10
63715030845,63715030846,1,1530,1235,-10
63716051230,63716051227,-3,1022,2967,-10
63719138460,63719138457,-3,1370,1881,-10
63721909474,63721909478,4,1972,1695,-10
63725406796,63725406790,-6,1848,9732,-10
63726797134,63726797138,4,1721,1425,-10
63730962730,63730962733,3,1912,1829,-10
63733620096,63733620098,2,2163,1355,-10
63734043214,63734043213,-1,980,1723,-10
63734433897,63734433907,10,2198,1493,-10
63735977673,63735977675,2,1479,983,-10
63736560118,63736560117,-1,3406,4273,-10
63742160303,63742160306,3,1083,1358,-10
63743490077,63743490075,-2,1549,1311,-10
63746895977,63746895978,1,1484,1659,-10
63747149889,63747149891,2,863,1465,-10
63750634283,63750634282,-1,1143,1623,-10
63753361631,63753361630,-1,1324,1877,-10
63755137873,63755137875,2,2054,2062,-10
63757648598,63757648597,-1,1338,1619,-10
63757982761,63757982763,2,1799,1795,-10
63766156629,63766156631,2,1423,1608,-10
63768603564,63768603566,2,1484,2017,-10
63769762517,63769762518,1,1131,1343,-10
63772037612,63772037618,6,2375,986,-10
63772527391,63772527394,3,1002,1700,-10
63773952043,63773952044,1,1614,1583,-10
63776718401,63776718403,2,1595,943,-10
63783428773,63783428775,2,1723,1109,-10
63783839022,63783839002,-20,2092,1699,-10
63783867294,63783867297,3,1660,1546,-10
63784991461,63784991463,2,1557,1549,-10
63789902637,63789902642,5,2828,1883,-10
63791182367,63791182369,2,2028,1465,-10
63791291402,63791291405,3,1275,1168,-10
63794898850,63794898851,1,1757,1364,-10
63796121940,63796121942,2,2097,2262,-10
63796160277,63796160279,2,1515,2178,-10
63800129006,63800129005,-1,1311,1787,-10
63800549146,63800549146,0,1717,1600,-10
63802415350,63802415353,3,1709,1327,-10
63803525525,63803525526,1,1198,1857,-10
63804277178,63804277171,-7,1443,1217,-10
63805252620,63805252619,-1,1206,1526,-10
63807438659,63807438660,1,1954,1703,-10
63808074566,63808074567,1,1102,1634,-10
63811521788,63811521781,-7,1032,8534,-10
63812690439,63812690442,3,1440,1048,-10
63813980896,63813980898,2,2063,1313,-10
63818512327,63818512329,2,904,980,-10
63822640030,63822640034,4,1696,1773,-10
63825565138,63825565141,3,1697,1703,-10
63826641294,63826641296,2,1058,1325,-10
63833590187,63833590191,4,35082,46136,-10
63836411044,63836411045,1,31026,8436,-10
63844541921,63844541923,2,1642,1248,-10
63848009203,63848009205,2,1867,1637,-10
63848863285,63848863286,1,1195,994,-10
63849579961,63849579965,4,731,939,-10
63852760189,63852760192,3,1086,1377,-10
63856690338,63856690346,8,11994,4318,-10
63858139162,63858139165,3,1250,2026,-10
63861584016,63861584026,10,14494,19337,-10
63863832206,63863832209,3,1749,1447,-10
63869680689,63869680690,1,1446,1327,-10
63874489481,63874489482,1,1736,1871,-10
63879234642,63879234646,4,1628,1260,-10
63879357766,63879357766,0,1695,2289,-10
63882622474,63882622472,-2,1452,2192,-10
63882822690,63882822691,1,1660,1421,-10
63884585135,63884585137,2,819,604,-10
63890580642,63890580643,1,1440,1101,-10
63896296307,63896296308,1,877,819,-10
63899474179,63899474182,3,2309,2024,-10
63901601110,63901601111,1,1635,1599,-10
63901959931,63901959935,4,2293,1562,-10
63902782937,63902782941,4,1632,1303,-10
63906941877,63906941878,1,1798,1333,-10
63910393245,63910393263,18,16317,53558,-10
63910489082,63910489082,0,1139,1394,-10
63914285259,63914285261,2,1445,1326,-10
63916081907,63916081907,0,1414,1470,-10
63916833591,63916833594,3,1529,1588,-10
63917582172,63917582170,-2,1919,2355,-10
63918146606,63918146608,2,1108,1117,-10
63919297919,63919297922,3,1492,1185,-10
63920184315,63920184318,3,2144,1523,-10
63921014655,63921014657,2,1518,1661,-10
63921222467,63921222470,3,2517,1542,-10
63921558351,63921558353,2,891,1411,-10
63925065832,63925065841,9,19891,54062,-10
63931703914,63931703909,-5,680,1840,-10
63934200631,63934200633,2,1938,1588,-10
63935836046,63935836050,4,3688,3282,-10
63940783203,63940783203,0,1230,1425,-10
63940861126,63940861131,5,3475,2575,-10
63942801795,63942801794,-1,2262,1774,-10
63949159914,63949159916,2,1454,2021,-10
63949433333,63949433335,2,2065,1778,-10
63949665973,63949665974,1,1457,1348,-10
63952651174,63952651177,3,2253,2381,-10
63954326966,63954326971,5,1234,1681,-10
63954841888,63954841886,-2,1495,1340,-10
63961208476,63961208481,5,2278,1472,-10
63961279062,63961279067,5,1740,1667,-10
63963559305,63963559310,5,1792,1867,-10
63965064789,63965064790,1,1518,1321,-10
63965697037,63965697037,0,1628,1979,-10
63966342141,63966342142,1,1552,1273,-10
63970864338,63970864338,0,1800,1376,-10
63971893011,63971893009,-2,1449,1834,-10
63976735794,63976735804,10,1880,1431,-10
63977923897,63977923897,0,1499,1801,-10
63978506173,63978506176,3,1788,1143,-10
63980129744,63980129746,2,1618,1243,-10
63981514842,63981514848,6,3120,1441,-10
63988381113,63988381115,2,1004,978,-10
63991132725,63991132726,1,1628,1390,-10
63992700201,63992700202,1,1637,2112,-10
63993381479,63993381480,1,1360,1831,-10
63993422260,63993422266,6,238,1374,-10
63994825924,63994825926,2,1447,1313,-10
63995886893,63995886895,2,1904,1377,-10
63996275862,63996275857,-5,1143,2990,-10
63996479183,63996479184,1,1133,1532,-10
64000423553,64000423555,2,1870,1730,-10
64001305543,64001305558,15,1191,1458,-10
64003222182,64003222183,1,1636,1587,-10
64003424637,64003424638,1,1578,1344,-10
64023088690,64023088691,1,1439,1436,-10
64028694485,64028694488,3,1689,1434,-10
64032612947,64032612948,1,1713,1542,-10
64033491563,64033491565,2,1167,1388,-10
64036527565,64036527555,-10,1516,5196,-10
64038765071,64038765075,4,1277,1374,-10
64041944531,64041944530,-1,9570,14246,-10
64045075866,64045075869,3,1596,1706,-10
64048440081,64048440081,0,1972,1746,-10
64048741316,64048741318,2,1471,1455,-10
64051784575,64051784576,1,2691,2213,-10
64056588486,64056588489,3,1020,1292,-10
64058303556,64058303558,2,1563,1130,-10
64062536010,64062536014,4,1432,1348,-10
64064278194,64064278198,4,2147,1834,-10
64064333715,64064333718,3,1125,1462,-10
64066017302,64066017303,1,2137,2432,-10
64067032977,64067032981,4,1843,2535,-10
64067660477,64067660458,-19,1456,1989,-10
64069782670,64069782672,2,1666,1271,-10
64073478726,64073478726,0,2232,2427,-10
64074825369,64074825371,2,1183,1597,-10
64075103160,64075103162,2,1220,1388,-10
64075323053,64075323046,-7,1621,4806,-10
64076644844,64076644845,1,1498,1080,-10
64076829309,64076829311,2,1722,1592,-10
64078653181,64078653179,-2,1155,2391,-10
64080118234,64080118238,4,1313,1150,-10
64081738841,64081738842,1,1450,1443,-10
64082054995,64082054998,3,2138,2586,-10
64083116694,64083116696,2,1456,1501,-10
64085029484,64085029485,1,1293,1000,-10
64090669620,64090669621,1,1914,1809,-10
64094252846,64094252846,0,1519,1454,-10
64096629614,64096629619,5,1575,983,-10
64098510585,64098510586,1,1207,1667,-10
64101694651,64101694654,3,1450,1296,-10
64103431830,64103431830,0,1738,1602,-10
64106864967,64106864968,1,2195,1634,-10
64107187077,64107187078,1,1434,1215,-10
64112047967,64112047969,2,1360,1526,-10
64113287830,64113287834,4,1728,1494,-10
64115895457,64115895459,2,1638,1562,-10
64118163114,64118163117,3,1574,1392,-10
64119840612,64119840600,-12,1699,1040,-10
64120187818,64120187822,4,1991,1042,-10
64121778361,64121778366,5,4317,2360,-10
64123242022,64123242021,-1,2072,1507,-10
64124969590,64124969590,0,1689,1656,-10
64126755980,64126755983,3,2478,1489,-10
64128049563,64128049563,0,1011,1000,-10
64129831261,64129831262,1,1415,1348,-10
64131390738,64131390737,-1,1196,1714,-10
64134690524,64134690522,-2,1542,1545,-10
64136270034,64136270042,8,3811,1639,-10
64137078955,64137078957,2,1653,1715,-10
64137467535,64137467538,3,1177,1340,-10
64141410439,64141410442,3,1021,1426,-10
64142054628,64142054630,2,1820,1255,-10
64144776669,64144776669,0,1227,1722,-10
64145410722,64145410727,5,1762,1119,-10
64145531861,64145531866,5,2144,1328,-10
64146091898,64146091899,1,1189,2235,-10
64146391537,64146391519,-18,2025,1553,-10
64147584749,64147584750,1,1171,1104,-10
64149214860,64149214861,1,2502,2035,-10
64149831569,64149831571,2,1540,1098,-10
64150229363,64150229366,3,1914,1866,-10
64151303057,64151303057,0,1123,1021,-10
64151512755,64151512755,0,1196,1402,-10
64157277902,64157277902,0,1199,1414,-10
64159770339,64159770343,4,1116,1561,-10
64160439995,64160439996,1,1640,1146,-10
64161075114,64161075116,2,1593,1414,-10
64165385021,64165385023,2,1589,1092,-10
64168449447,64168449451,4,5438,3163,-10
64170325863,64170325866,3,1807,1108,-10
64172536651,64172536651,0,1823,1783,-10
64175614194,64175614195,1,1597,1619,-10
64177474671,64177474673,2,2004,1168,-10
64179815999,64179815998,-1,1689,1596,-10
64180158107,64180158110,3,1045,940,-10
64182716305,64182716310,5,2294,1333,-10
64184437879,64184437898,19,627,1507,-10
64185757679,64185757673,-6,480,1673,-10
64188648805,64188648807,2,1059,1244,-10
64188732525,64188732539,14,1949,1385,-10
64189341380,64189341392,12,1469,1505,-10
64189776978,64189776979,1,1184,1459,-10
64190940317,64190940314,-3,1256,2523,-10
64194419462,64194419458,-4,1004,2178,-10
64200419474,64200419474,0,1537,1720,-10
64200773766,64200773766,0,1791,2325,-10
64201410357,64201410351,-6,1598,7263,-10
64201885051,64201885053,2,1518,1365,-10
64206870710,64206870710,0,1178,1433,-10
64208205238,64208205233,-5,983,5157,-10
64212146990,64212146991,1,1262,1363,-10
64213026902,64213026902,0,924,922,-10
64213509622,64213509623,1,2585,1507,-10
64213648248,64213648251,3,1361,1070,-10
64215446828,64215446830,2,1432,1343,-10
64216109778,64216109778,0,1463,1271,-10
64216724574,64216724576,2,1708,1751,-10
64216753782,64216753785,3,1586,1654,-10
64222144763,64222144766,3,1685,1149,-10
64225444759,64225444762,3,1509,1440,-10
64228661589,64228661593,4,1213,889,-10
64229937570,64229937573,3,2187,1766,-10
64231261814,64231261806,-8,754,1067,-10
64232652178,64232652179,1,714,1018,-10
64236578648,64236578648,0,1705,2120,-10
64238236173,64238236174,1,1798,1675,-10
64239199511,64239199513,2,1331,1511,-10
64240657609,64240657610,1,2343,2041,-10
64243293875,64243293879,4,1443,1358,-10
64244322841,64244322843,2,1084,1120,-10
64245290261,64245290262,1,1499,1100,-10
64247095727,64247095730,3,1700,1536,-10
64247227286,64247227289,3,1528,1835,-10
64248170394,64248170394,0,2006,1573,-10
64250886735,64250886736,1,1771,1601,-10
64253271922,64253271923,1,1314,1113,-10
64253501534,64253501534,0,1124,1665,-10
64255697527,64255697507,-20,1653,1110,-10
64257148294,64257148294,0,797,1353,-10
64257408718,64257408723,5,1659,2038,-10
64260321746,64260321750,4,1642,1569,-10
64260553691,64260553694,3,1730,1415,-10
64261105597,64261105598,1,1572,2222,-10
64262394106,64262394107,1,1100,1102,-10
64265220302,64265220307,5,2466,943,-10
64267377070,64267377070,0,1199,1315,-10
64272239891,64272239893,2,1698,1489,-10
64272987014,64272987032,18,2257,1514,-10
64274450846,64274450839,-7,1025,3306,-10
64275040622,64275040621,-1,1356,1907,-10
64277067989,64277067993,4,1701,1622,-10
64277294591,64277294593,2,1915,2415,-10
64278323087,64278323091,4,1242,1184,-10
64278544265,64278544248,-17,1788,664,-10
64282622825,64282622827,2,1389,1512,-10
64284037603,64284037605,2,1303,1545,-10
64286133467,64286133469,2,1894,1526,-10
64290240682,64290240683,1,1955,1609,-10
64290756154,64290756157,3,978,956,-10
64292073419,64292073421,2,1517,1377,-10
64292877424,64292877426,2,1702,2072,-10
64293698201,64293698191,-10,1169,908,-10
64294568069,64294568048,-21,947,1427,-10
64295167575,64295167574,-1,1310,1656,-10
64295677335,64295677353,18,1517,1606,-10
64295705521,64295705523,2,1308,1317,-10
64297992041,64297992042,1,1604,1444,-10
64299377316,64299377322,6,3111,1757,-10
64302644145,64302644147,2,2622,1537,-10
64306014697,64306014698,1,1290,1527,-10
64308051185,64308051188,3,1549,1613,-10
64308903634,64308903634,0,1387,1237,-10
64309634269,64309634270,1,1942,1816,-10
64320489345,64320489347,2,812,1044,-10
64322495145,64322495148,3,2486,1521,-10
64324903343,64324903346,3,1575,1329,-10
64328880363,64328880366,3,1331,1439,-10
64329167764,64329167767,3,1721,2415,-10
64329315382,64329315386,4,1288,1581,-10
64329685054,64329685056,2,2424,1637,-10
64330029255,64330029258,3,1998,1726,-10
64339528003,64339528004,1,1443,1170,-10
64341914774,64341914775,1,1668,1554,-10
64344067659,64344067660,1,1313,1007,-10
64345612062,64345612065,3,1184,1289,-10
64348133649,64348133651,2,1294,1111,-10
64350075628,64350075630,2,1569,1148,-10
64352179186,64352179180,-6,1710,7549,-10
64352314678,64352314679,1,804,1168,-10
64358752723,64358752726,3,1986,1804,-10
64359041479,64359041482,3,1330,1580,-10
64359656443,64359656445,2,1422,1404,-10
64360328686,64360328687,1,1813,1250,-10
64364419090,64364419093,3,1539,1733,-10
64365739521,64365739519,-2,1487,1995,-10
64366030382,64366030382,0,1950,1684,-10
64367808714,64367808718,4,1108,1028,-10
64370658147,64370658150,3,1343,1584,-10
64372303962,64372303961,-1,1428,1594,-10
64375170065,64375170067,2,1941,1597,-10
64379140478,64379140481,3,1496,2611,-10
64382648402,64382648403,1,2344,1959,-10
64385331063,64385331067,4,1762,1836,-10
64387265749,64387265745,-4,1452,6620,-10
64387356950,64387356951,1,1154,1738,-10
64388670410,64388670414,4,1362,1342,-10
64390321151,64390321152,1,935,1390,-10
64391790977,64391790981,4,694,831,-10
64392160527,64392160529,2,1529,1657,-10
64394164894,64394164896,2,1752,1644,-10
64401403554,64401403557,3,1814,1769,-10
64401711842,64401711846,4,2868,2176,-10
64403367305,64403367306,1,1044,877,-10
64405577643,64405577644,1,2057,2168,-10
64411063421,64411063423,2,1657,1341,-10
64412349070,64412349069,-1,1267,1443,-10
64413484007,64413484007,0,1113,1363,-10
64413759082,64413759084,2,1401,1483,-10
64414723029,64414723030,1,2804,2700,-10
64414869168,64414869168,0,1769,1803,-10
64416017813,64416017818,5,3895,1803,-10
64417583486,64417583486,0,1149,1197,-10
64419318562,64419318568,6,18071,21361,-10
64421469279,64421469282,3,1174,1382,-10
64422458283,64422458284,1,1669,1353,-10
64424414079,64424414078,-1,1369,2498,-10
64426821617,64426821621,4,2037,2345,-10
64429707451,64429707457,6,1189,1147,-10
64438813507,64438813508,1,1429,1716,-10
64440395043,64440395053,10,7762,1128,-10
64441483485,64441483480,-5,1507,4744,-10
64441779011,64441778991,-20,1698,1599,-10
64444680991,64444680993,2,683,649,-10
64452217622,64452217639,17,1838,1508,-10
64452725793,64452725794,1,1757,2134,-10
64457439930,64457439932,2,1462,1445,-10
64460708675,64460708678,3,1928,1385,-10
64461784037,64461784039,2,1846,2078,-10
64465542426,64465542430,4,2176,1402,-10
64466280608,64466280610,2,1949,1409,-10
64466621737,64466621738,1,1662,1001,-10
64467145563,64467145566,3,996,2020,-10
64467180773,64467180775,2,1219,1328,-10
64468611589,64468611590,1,1281,1713,-10
64468809763,64468809766,3,1922,1429,-10
64469142167,64469142169,2,1352,1550,-10
64469857321,64469857323,2,1479,1565,-10
64472876794,64472876790,-4,1097,2917,-10
64472974005,64472974007,2,2239,1551,-10
64474009442,64474009439,-3,1358,1594,-10
64476931002,64476931005,3,1476,1716,-10
64477274636,64477274641,5,2465,1478,-10
64477653213,64477653195,-18,1850,1870,-10
64478472279,64478472280,1,1504,1353,-10
64480256874,64480256877,3,2388,1834,-10
64483440094,64483440097,3,1735,953,-10
64484201561,64484201564,3,1457,1430,-10
64489739890,64489739889,-1,2274,2487,-10
64495708318,64495708318,0,1059,1301,-10
64500304804,64500304806,2,2067,1494,-10
64500623205,64500623207,2,1319,1948,-10
64502540237,64502540238,1,1531,1546,-10
64502872662,64502872667,5,1968,1555,-10
64503171252,64503171253,1,2120,2012,-10
64504288117,64504288118,1,1053,1095,-10
64504648178,64504648178,0,845,1086,-10
64507602675,64507602678,3,1160,812,-10
64508341771,64508341774,3,901,1136,-10
64514448485,64514448486,1,1081,1451,-10
64516912867,64516912871,4,1443,1440,-10
64519571540,64519571543,3,2279,1742,-10
64520141393,64520141390,-3,800,1874,-10
64527619925,64527619927,2,1561,1240,-10
64527953026,64527953028,2,1813,1617,-10
64528294437,64528294440,3,1712,1568,-10
64533700686,64533700690,4,53099,33956,-10
64536369223,64536369224,1,1424,2032,-10
64539185565,64539185566,1,1353,1644,-10
64541777823,64541777825,2,2198,2086,-10
64543085358,64543085362,4,1696,1501,-10
64543960909,64543960911,2,3627,3365,-10
64544961362,64544961364,2,1895,1573,-10
64545514062,64545514062,0,1361,1740,-10
64548492215,64548492218,3,1370,956,-10
64548945766,64548945745,-21,1006,1567,-10
64549086718,64549086721,3,1451,1536,-10
64552078130,64552078130,0,1104,1302,-10
64554395257,64554395250,-7,1100,4910,-10
64558812465,64558812467,2,1872,1728,-10
64560715366,64560715366,0,1236,1412,-10
64561149001,64561149001,0,962,1336,-10
64567504423,64567504425,2,1968,1496,-10
64571164321,64571164322,1,1464,1436,-10
64571935494,64571935495,1,1370,1733,-10
64577176133,64577176136,3,1938,1893,-10
64581058301,64581058303,2,1467,1483,-10
64583597297,64583597298,1,1393,1124,-10
64584963654,64584963659,5,3143,1324,-10
64587131318,64587131321,3,1788,1269,-10
64588592559,64588592562,3,1940,1774,-10
64588725173,64588725182,9,11416,38565,-10
64589179106,64589179108,2,2199,2062,-10
64589590045,64589590050,5,1210,1473,-10
64592348450,64592348452,2,1806,1596,-10
64595771791,64595771791,0,998,913,-10
64598645084,64598645102,18,966,1307,-10
64599657623,64599657622,-1,1779,2895,-10
64604447711,64604447709,-2,1466,1492,-10
64608045914,64608045918,4,1998,1744,-10
64611124813,64611124815,2,2217,1898,-10
64612774121,64612774119,-2,1605,2139,-10
64612829022,64612829025,3,1714,1453,-10
64614957104,64614957107,3,1834,1869,-10
64615638082,64615638085,3,2004,2383,-10
64619982121,64619982123,2,1490,1320,-10
64620278154,64620278154,0,1997,1826,-10
64621956636,64621956637,1,2258,1831,-10
64624404363,64624404366,3,1858,1060,-10
64626649200,64626649197,-3,1474,3375,-10
64627033323,64627033322,-1,1086,1690,-10
64627384153,64627384155,2,1432,1470,-10
64629412958,64629412962,4,1668,1643,-10
64631241738,64631241739,1,1453,1182,-10
64637378830,64637378832,2,1205,2243,-10
64642147634,64642147637,3,1220,1262,-10
64647153129,64647153131,2,2220,2019,-10
64654208594,64654208599,5,2432,1539,-10
64656102777,64656102781,4,1543,1501,-10
64657883571,64657883575,4,1686,1015,-10
64658668157,64658668158,1,1208,1368,-10
64659467459,64659467461,2,1475,1775,-10
64663635029,64663635031,2,1442,1697,-10
64664553066,64664553070,4,789,1211,-10
64666891106,64666891111,5,1340,1687,-10
64673120679,64673120679,0,1655,1727,-10
64674659309,64674659310,1,1389,1621,-10
64678898081,64678898093,12,12329,45827,-10
64681087675,64681087673,-2,1147,2792,-10
64684259779,64684259774,-5,515,2341,-10
64686179882,64686179884,2,2062,1795,-10
64688187454,64688187454,0,22055,26533,-10
64689763109,64689763108,-1,1271,1230,-10
64694372809,64694372811,2,821,1039,-10
64708262326,64708262326,0,1769,2098,-10
64708434647,64708434648,1,1305,1769,-10
64711463841,64711463843,2,1590,1677,-10
64712131777,64712131779,2,1711,1880,-10
64715788653,64715788654,1,1675,1370,-10
64716066101,64716066103,2,1917,1654,-10
64717461398,64717461402,4,1840,1701,-10
64717726039,64717726041,2,2689,1719,-10
64720477819,64720477822,3,896,1158,-10
64721009462,64721009462,0,1245,1494,-10
64721426965,64721426969,4,1229,1293,-10
64722747453,64722747457,4,1337,1581,-10
64723006764,64723006766,2,1776,1850,-10
64723184925,64723184927,2,1819,1872,-10
64724143678,64724143683,5,1665,1617,-10
64724177440,64724177443,3,1824,1847,-10
64726446638,64726446640,2,1369,1823,-10
64728845096,64728845097,1,1610,1461,-10
64729456519,64729456516,-3,2713,5493,-10
64730609470,64730609470,0,1256,1461,-10
64732485890,64732485895,5,3586,1977,-10
64732687879,64732687879,0,1771,1825,-10
64734766025,64734766026,1,1469,1624,-10
64739967536,64739967538,2,1770,2011,-10
64743498255,64743498250,-5,1453,3376,-10
64747432739,64747432742,3,1513,1481,-10
64753133394,64753133397,3,2429,1740,-10
64757478199,64757478198,-1,1230,2111,-10
64760593098,64760593097,-1,34854,47867,-10
64761930453,64761930455,2,1277,1039,-10
64762504881,64762504885,4,1803,1410,-10
64763276463,64763276448,-15,2007,1308,-10
64769065374,64769065381,7,2975,1616,-10
64770040222,64770040222,0,1897,1674,-10
64773854442,64773854446,4,2616,1547,-10
64775208375,64775208377,2,1429,1397,-10
64776914722,64776914726,4,1312,1591,-10
64783245221,64783245223,2,2574,2374,-10
64784135112,64784135114,2,1548,1388,-10
64789339174,64789339177,3,1905,1393,-10
64789792704,64789792707,3,1716,1071,-10
64790961824,64790961826,2,1918,1995,-10
64791442802,64791442802,0,2123,2045,-10
64792664935,64792664939,4,1158,1619,-10
64793109288,64793109290,2,2119,1845,-10
64794489078,64794489078,0,1525,1410,-10
64796620336,64796620336,0,1267,1401,-10
64799536070,64799536074,4,1808,1458,-10
64800543390,64800543392,2,1169,1239,-10
64801340102,64801340105,3,1321,1272,-10
64804747487,64804747491,4,1900,1593,-10
64807779487,64807779487,0,1726,2141,-10
64812046636,64812046639,3,1596,1494,-10
64813947712,64813947714,2,1523,1703,-10
64816872750,64816872745,-5,819,1823,-10
64825216962,64825216962,0,1664,1562,-10
64826653047,64826653047,0,1474,1308,-10
64829543435,64829543438,3,1884,1907,-10
64830600331,64830600334,3,1382,1141,-10
64831964394,64831964398,4,2241,2017,-10
64832217756,64832217758,2,1819,1933,-10
64833253154,64833253160,6,2564,1462,-10
64836415606,64836415609,3,1413,1444,-10
64836782329,64836782329,0,1423,1714,-10
64837030534,64837030537,3,1564,1778,-10
64837674643,64837674643,0,1444,1375,-10
64838397382,64838397382,0,1021,1735,-10
64838559704,64838559705,1,1501,1481,-10
64838640649,64838640650,1,762,933,-10
64841605172,64841605173,1,1813,1720,-10
64845060163,64845060166,3,1309,1254,-10
64846911431,64846911429,-2,906,1432,-10
64847324496,64847324498,2,1088,1451,-10
64848960411,64848960415,4,2586,1554,-10
64849483522,64849483526,4,1936,1441,-10
64850042645,64850042645,0,1521,1117,-10
64853943368,64853943353,-15,1073,1928,-10
64859188213,64859188214,1,1768,1911,-10
64861029934,64861029935,1,1531,1856,-10
64868134023,64868134023,0,1364,1974,-10
64868523782,64868523783,1,1581,1645,-10
64870317133,64870317139,6,1641,624,-10
64872333467,64872333469,2,1544,1604,-10
64872525486,64872525487,1,1416,1100,-10
64873411890,64873411894,4,1800,1316,-10
64873974358,64873974357,-1,1632,1943,-10
64878231957,64878231961,4,1756,1408,-10
64879507779,64879507783,4,2121,1145,-10
64880726283,64880726286,3,1645,1318,-10
64880826218,64880826223,5,1170,1799,-10
64881915071,64881915075,4,1139,1278,-10
64883843718,64883843726,8,14199,25927,-10
64886346064,64886346066,2,2410,1651,-10
64887204287,64887204288,1,1662,1328,-10
64891621634,64891621637,3,1490,2075,-10
64897928918,64897928919,1,1798,1692,-10
64899622337,64899622339,2,1253,1540,-10
64899798897,64899798898,1,1542,1676,-10
64903355198,64903355201,3,1859,2052,-10
64906096147,64906096147,0,1197,1267,-10
64909660489,64909660491,2,1235,1149,-10
64912573773,64912573776,3,1209,972,-10
64913555671,64913555674,3,1598,1727,-10
64913750531,64913750531,0,1073,1378,-10
64919757783,64919757785,2,1947,2255,-10
64920080311,64920080312,1,1918,2139,-10
64920331257,64920331252,-5,1007,1219,-10
64923792152,64923792154,2,1657,1744,-10
64923995928,64923995929,1,1885,1991,-10
64925000354,64925000357,3,1615,2265,-10
64925133535,64925133537,2,1608,1389,-10
64925238739,64925238740,1,1054,932,-10
64926262831,64926262832,1,873,1343,-10
64927816536,64927816539,3,2227,1498,-10
64930352990,64930352990,0,804,1001,-10
64936760743,64936760745,2,1949,1400,-10
64938001831,64938001837,6,3398,1144,-10
64943650947,64943650950,3,1058,1485,-10
64944016443,64944016432,-11,1112,3278,-10
64944122258,64944122250,-8,40,1421,-10
64944294516,64944294518,2,2001,1508,-10
64945518237,64945518238,1,1504,1590,-10
64947064327,64947064329,2,1445,1558,-10
64947812086,64947812085,-1,1496,1511,-10
64954757470,64954757471,1,1557,2080,-10
64958974045,64958974046,1,957,1093,-10
64959969822,64959969824,2,893,758,-10
64961645845,64961645846,1,1033,1065,-10
64962993520,64962993523,3,1651,2420,-10
64969491062,64969491064,2,1738,1351,-10
64969588213,64969588195,-18,2476,1836,-10
64975073785,64975073790,5,1749,1353,-10
64975861952,64975861971,19,1622,1523,-10
64975891677,64975891679,2,1740,1636,-10
64977055907,64977055907,0,954,1888,-10
64977871795,64977871799,4,1603,1178,-10
64978701546,64978701546,0,1543,1838,-10
64983987431,64983987434,3,1796,1340,-10
64985589423,64985589439,16,573,1100,-10
64990162253,64990162254,1,1342,1876,-10
64994971534,64994971534,0,1284,1570,-10
64995699630,64995699634,4,1713,1640,-10
64996802830,64996802831,1,1717,1689,-10
64997182737,64997182735,-2,1685,3249,-10
64998663390,64998663391,1,1644,1343,-10
65005957590,65005957594,4,1885,1443,-10
65006673924,65006673927,3,1457,1503,-10
65006709334,65006709335,1,1730,1249,-10
65011805326,65011805329,3,2992,952,-10
65012358546,65012358548,2,1915,1256,-10
65016358920,65016358923,3,1683,1547,-10
65020001010,65020001011,1,1839,1790,-10
65025838996,65025838998,2,1624,1824,-10
65027315469,65027315470,1,2037,2093,-10
65032267234,65032267237,3,1711,1765,-10
65033360248,65033360251,3,1298,1128,-10
65034535663,65034535665,2,1808,1619,-10
65035976690,65035976693,3,1961,2597,-10
65036718207,65036718209,2,1768,1222,-10
65038084326,65038084328,2,1789,1719,-10
65038295339,65038295342,3,1512,1052,-10
65038888897,65038888899,2,1541,1585,-10
65040309714,65040309713,-1,1499,2905,-10
65040536730,65040536730,0,1444,1700,-10
65042710907,65042710911,4,2013,1325,-10
65046846856,65046846859,3,1937,1237,-10
65047340428,65047340430,2,1527,1639,-10
65049925983,65049925983,0,1981,1780,-10
65053493060,65053493061,1,1320,953,-10
65053797767,65053797770,3,1986,1632,-10
65054611165,65054611166,1,3163,2693,-10
65057770849,65057770850,1,1486,1508,-10
65059730534,65059730538,4,2081,1920,-10
65060262576,65060262577,1,1645,2193,-10
65065478350,65065478353,3,2269,1669,-10
65067340302,65067340303,1,3480,2815,-10
65067494291,65067494293,2,1208,1118,-10
65069835123,65069835126,3,1091,1521,-10
65071796625,65071796630,5,6656,2744,-10
65075121889,65075121890,1,1621,1761,-10
65076109087,65076109086,-1,1428,1618,-10
65076693137,65076693138,1,1724,1352,-10
65077228021,65077228023,2,1424,1607,-10
65078447393,65078447394,1,1876,1794,-10
65078701225,65078701230,5,1469,847,-10
65080769919,65080769923,4,1393,1491,-10
65083911289,65083911291,2,1492,1658,-10
65086531691,65086531692,1,1827,1523,-10
65088581550,65088581550,0,1087,1272,-10
65089613918,65089613922,4,1546,1598,-10
65092078315,65092078318,3,1642,1309,-10
65093663840,65093663842,2,1363,1827,-10
65095208975,65095208974,-1,1507,1539,-10
65096479511,65096479513,2,1735,1655,-10
65097315330,65097315331,1,1512,1858,-10
65104794318,65104794322,4,1452,1322,-10
65105653688,65105653690,2,1592,1268,-10
65105683522,65105683522,0,1224,1459,-10
65107405132,65107405136,4,2217,1651,-10
65108607925,65108607926,1,998,1083,-10
65109069256,65109069256,0,1365,1851,-10
65111156726,65111156727,1,1412,1201,-10
65112224514,65112224517,3,1618,1334,-10
65115292917,65115292900,-17,1754,1691,-10
65115376086,65115376092,6,1841,1771,-10
65116502075,65116502079,4,2021,2053,-10
65119564501,65119564498,-3,1860,3037,-10
65123378261,65123378264,3,1873,1689,-10
65123558581,65123558583,2,1891,1465,-10
65124941061,65124941062,1,2425,2009,-10
65125104224,65125104226,2,1372,999,-10
65125357289,65125357295,6,1476,1231,-10
65127360654,65127360655,1,1536,1021,-10
65132583894,65132583895,1,1381,1519,-10
65135123429,65135123430,1,1722,1318,-10
65136239130,65136239137,7,5146,2174,-10
65136768645,65136768646,1,1629,1813,-10
65138951507,65138951510,3,1600,1582,-10
65139277025,65139277026,1,1863,1466,-10
65140333362,65140333364,2,2202,1791,-10
65142896761,65142896763,2,1787,1497,-10
65143124726,65143124730,4,1659,1473,-10
65146164206,65146164206,0,1304,1511,-10
65148386816,65148386811,-5,1917,4807,-10
65156120765,65156120745,-20,748,998,-10
65159272810,65159272811,1,1548,1442,-10
65160906755,65160906758,3,1570,1246,-10
65163075925,65163075925,0,1378,1194,-10
65164814549,65164814549,0,996,1744,-10
65167996796,65167996797,1,1807,1584,-10
65172365069,65172365071,2,1772,1634,-10
65174189458,65174189458,0,1260,999,-10
65174918823,65174918825,2,1634,1430,-10
65175998182,65175998183,1,1410,1271,-10
65179593929,65179593931,2,1767,1652,-10
65180636398,65180636397,-1,1741,2324,-10
65181349313,65181349314,1,1326,1651,-10
65189773687,65189773690,3,1636,1400,-10
65191879094,65191879101,7,2432,1880,-10
65196464245,65196464246,1,1608,1573,-10
65197004847,65197004849,2,1447,1498,-10
65198416166,65198416165,-1,1008,1792,-10
65204296719,65204296722,3,1343,1470,-10
65208239542,65208239542,0,1129,1753,-10
65209239906,65209239910,4,6335,2231,-10
65212778969,65212778973,4,1630,1714,-10
65213199861,65213199864,3,1277,1538,-10
65219718802,65219718802,0,1477,1550,-10
65221480802,65221480804,2,988,1658,-10
65222979847,65222979852,5,1766,1282,-10
65225264915,65225264916,1,18449,31167,-10
65227362387,65227362385,-2,1186,1387,-10
65229643104,65229643106,2,1226,1322,-10
65229845636,65229845643,7,1354,1102,-10
65230236556,65230236556,0,1627,1801,-10
65230688928,65230688951,23,1631,2201,-10
65233600984,65233600986,2,2029,1978,-10
65237143028,65237143030,2,1039,1352,-10
65241706935,65241706937,2,1950,1413,-10
65242205794,65242205795,1,1333,1409,-10
65242496101,65242496103,2,1508,1293,-10
65243801649,65243801649,0,1694,1699,-10
65244496742,65244496747,5,1277,1131,-10
65246465579,65246465580,1,1212,1887,-10
65250021105,65250021107,2,1194,1614,-10
65251008918,65251008921,3,1460,1757,-10
65253727678,65253727679,1,1530,1289,-10
65254406032,65254406014,-18,245,950,-10
65255227541,65255227543,2,1556,1473,-10
65256087697,65256087698,1,1848,1660,-10
65261031075,65261031075,0,1680,1926,-10
65262729852,65262729854,2,1553,1485,-10
65263047082,65263047087,5,2544,1935,-10
65263730988,65263730991,3,1651,1035,-10
65269530044,65269530045,1,2535,1443,-10
65272478072,65272478077,5,1614,982,-10
65275290237,65275290242,5,1749,2039,-10
65275559127,65275559129,2,1310,1770,-10
65279677049,65279677051,2,1172,1299,-10
65283988950,65283988955,5,2204,1464,-10
65290004461,65290004462,1,1551,1233,-10
65301582732,65301582714,-18,1112,1665,-10
65305435568,65305435570,2,2064,2005,-10
65305509153,65305509155,2,1580,1794,-10
65306475326,65306475327,1,1298,1066,-10
65307304295,65307304297,2,2224,2064,-10
65308995102,65308995106,4,1250,1133,-10
65311629877,65311629878,1,2204,2192,-10
65312369375,65312369377,2,1646,1479,-10
65317687441,65317687446,5,1865,1116,-10
65326122702,65326122702,0,968,1559,-10
65326211281,65326211270,-11,1501,1235,-10
65327164446,65327164449,3,2106,1886,-10
65329206318,65329206318,0,882,918,-10
65330174362,65330174363,1,1035,1535,-10
65332445908,65332445909,1,1800,1530,-10
65332507545,65332507547,2,1153,1503,-10
65332815296,65332815288,-8,3,1208,-10
65333232882,65333232882,0,2139,2763,-10
65333303950,65333303943,-7,1518,4770,-10
65333555011,65333555013,2,1268,1435,-10
65336524501,65336524516,15,46034,23694,-10
65337651044,65337651041,-3,1353,2160,-10
65338126522,65338126522,0,1475,1615,-10
65339073194,65339073197,3,798,900,-10
65339969069,65339969071,2,1494,950,-10
65343799444,65343799438,-6,1569,2186,-10
65346557228,65346557230,2,1170,973,-10
65346859389,65346859390,1,1696,1750,-10
65346979937,65346979939,2,1136,1685,-10
65349553703,65349553706,3,1571,1408,-10
65352807886,65352807892,6,7454,2777,-10
65358379055,65358379057,2,1485,1698,-10
65362244195,65362244196,1,1364,1893,-10
65363069489,65363069490,1,1280,1120,-10
65367157834,65367157835,1,1409,1437,-10
65368531034,65368531051,17,580,348,-10
65369291727,65369291729,2,1776,1601,-10
65370050182,65370050183,1,2018,2361,-10
65373310413,65373310414,1,1693,1565,-10
65375419596,65375419598,2,1762,1414,-10
65384272198,65384272200,2,1552,1799,-10
65385585472,65385585474,2,1115,1066,-10
65391522922,65391522926,4,1610,1459,-10
65393443985,65393443988,3,1334,1034,-10
65395272302,65395272301,-1,1809,1060,-10
65396894030,65396894031,1,1136,1562,-10
65396955430,65396955429,-1,1812,2137,-10
65398159658,65398159670,12,1926,1899,-10
65398959566,65398959583,17,1075,1486,-10
65399113909,65399113914,5,1134,1254,-10
65405470025,65405470025,0,1496,1223,-10
65413255401,65413255402,1,1475,1721,-10
65413996022,65413996026,4,1296,1498,-10
65415910690,65415910689,-1,1336,1354,-10
65417685761,65417685761,0,1772,1359,-10
65420082066,65420082063,-3,569,1453,-10
65420935946,65420935947,1,1567,1447,-10
65424511495,65424511497,2,1552,1129,-10
65425334795,65425334799,4,1190,820,-10
65427086989,65427086990,1,616,1225,-10
65427865858,65427865862,4,1508,1780,-10
65428896010,65428896012,2,2182,1439,-10
65429220358,65429220362,4,1857,1704,-10
65430609382,65430609385,3,2322,1666,-10
65430671344,65430671349,5,1714,1029,-10
65431387390,65431387393,3,1546,1259,-10
65431679110,65431679113,3,1490,1367,-10
65433929266,65433929268,2,1291,1315,-10
65435484046,65435484042,-4,1180,2710,-10
65435594599,65435594601,2,1638,1610,-10
65437030418,65437030423,5,2514,900,-10
65438012423,65438012424,1,1041,1785,-10
65450061190,65450061194,4,2820,2082,-10
65450897170,65450897172,2,1654,1667,-10
65456827953,65456827954,1,1129,1240,-10
65457664559,65457664553,-6,1044,4032,-10
65458722294,65458722298,4,1026,1079,-10
65459351938,65459351918,-20,1146,1023,-10
65462125838,65462125838,0,1479,1708,-10
65465086758,65465086761,3,1524,1320,-10
65465534285,65465534286,1,1295,1240,-10
65468887831,65468887830,-1,616,2090,-10
65469640779,65469640785,6,2496,1983,-10
65471764542,65471764544,2,1929,1521,-10
65473839545,65473839545,0,1220,1726,-10
65475909034,65475909037,3,1893,1445,-10
65477647560,65477647557,-3,921,1862,-10
65477726451,65477726433,-18,935,1290,-10
65479031510,65479031510,0,1429,1187,-10
65481159642,65481159645,3,4089,3291,-10
65487885015,65487885018,3,1911,1687,-10
65490308746,65490308751,5,12743,6583,-10
65490769878,65490769874,-4,1087,3342,-10
65495391023,65495391026,3,1508,1140,-10
65497007145,65497007147,2,1737,1811,-10
65499956302,65499956307,5,2028,1636,-10
65503658223,65503658221,-2,911,1825,-10
65506076254,65506076256,2,1610,1914,-10
65508702417,65508702423,6,2283,1083,-10
65510111533,65510111535,2,1776,1715,-10
65512944481,65512944484,3,1549,1378,-10
65513111585,65513111586,1,1105,1952,-10
65513778550,65513778550,0,12051,14764,-10
65513861017,65513861019,2,1256,1332,-10
65514059210,65514059228,18,1657,1794,-10
65514573991,65514573998,7,2779,1279,-10
65514775050,65514775053,3,1630,1173,-10
65516669392,65516669393,1,1018,1183,-10
65517573889,65517573884,-5,969,3332,-10
65521198002,65521198002,0,1148,1626,-10
65523168939,65523168941,2,1126,1625,-10
65524524424,65524524425,1,1416,1395,-10
65528703867,65528703868,1,1283,1431,-10
65528749030,65528749012,-18,1272,1242,-10
65530379891,65530379893,2,1844,1875,-10
65530595525,65530595527,2,1663,1336,-10
65531183010,65531183013,3,2637,2649,-10
65531954279,65531954283,4,1377,1495,-10
65532002444,65532002447,3,1772,1511,-10
65533201070,65533201071,1,1873,2153,-10
65534473840,65534473844,4,1451,1486,-10
65537140664,65537140674,10,13,2048,-10
65539763483,65539763484,1,903,1635,-10
65541605774,65541605773,-1,2432,2101,-10
65541632157,65541632159,2,1589,1543,-10
65544396154,65544396157,3,1849,1915,-10
65545037208,65545037207,-1,993,1481,-10
65547030443,65547030446,3,828,1323,-10
65549640500,65549640505,5,1285,1257,-10
65550682110,65550682112,2,1552,1954,-10
65551008976,65551008978,2,1452,1428,-10
65551080338,65551080338,0,1764,1643,-10
65552328499,65552328503,4,2184,1377,-10
65553737700,65553737697,-3,1288,1365,-10
65554838558,65554838561,3,1429,1314,-10
65554916639,65554916638,-1,1647,1838,-10
65555279283,65555279282,-1,766,1162,-10
65558084452,65558084454,2,996,1352,-10
65560772893,65560772895,2,2395,2537,-10
65564784662,65564784663,1,1864,1700,-10
65566574592,65566574593,1,1387,1495,-10
65567092779,65567092782,3,1057,1256,-10
65571285814,65571285814,0,1377,2433,-10
65572659664,65572659666,2,1683,2039,-10
65574325093,65574325082,-11,3013,11595,-10
65578138235,65578138234,-1,1330,1651,-10
65580904798,65580904801,3,1412,1291,-10
65581952829,65581952809,-20,1668,1240,-10
65582423707,65582423707,0,969,1184,-10
65589828554,65589828555,1,1438,1599,-10
65591788631,65591788632,1,1634,1605,-10
65593519712,65593519713,1,1336,1645,-10
65594430423,65594430425,2,1698,1819,-10
65600951128,65600951130,2,1993,2240,-10
65601986442,65601986444,2,2115,1560,-10
65603212704,65603212706,2,2300,1677,-10
65605977046,65605977048,2,1789,1760,-10
65607583970,65607583976,6,1490,1071,-10
65609424944,65609424947,3,1278,1830,-10
65614860412,65614860414,2,2248,1216,-10
65617189214,65617189218,4,2492,1314,-10
65617684734,65617684735,1,1165,1420,-10
65621359199,65621359180,-19,1599,1587,-10
65622189059,65622189061,2,2325,1748,-10
65626300590,65626300592,2,1415,1489,-10
65629300867,65629300866,-1,1384,1765,-10
65629353366,65629353367,1,1664,984,-10
65630837250,65630837254,4,1380,1544,-10
65631829325,65631829329,4,1816,1479,-10
65635799147,65635799150,3,1721,1340,-10
65636114602,65636114605,3,1710,1401,-10
65638195941,65638195943,2,941,1126,-10
65638733335,65638733335,0,1393,1521,-10
65641681132,65641681126,-6,26830,13484,-10
65643044402,65643044402,0,1588,1145,-10
65644641010,65644641010,0,1651,1838,-10
65645830705,65645830707,2,1898,1538,-10
65646090843,65646090848,5,4325,2628,-10
65650967065,65650967066,1,1779,1472,-10
65654971918,65654971921,3,1039,1338,-10
65655008083,65655008086,3,1442,1263,-10
65655572087,65655572090,3,1401,1048,-10
65668771858,65668771860,2,1316,1796,-10
65669140267,65669140267,0,969,712,-10
65670065299,65670065277,-22,2016,1826,-10
65674389918,65674389919,1,1170,1377,-10
65679077330,65679077333,3,1320,1398,-10
65679454848,65679454850,2,1530,1631,-10
65681806818,65681806819,1,2951,2608,-10
65686363983,65686363986,3,1684,1408,-10
65690187124,65690187126,2,1250,1617,-10
65693088161,65693088163,2,2524,2152,-10
65694525119,65694525122,3,1861,1954,-10
65694985446,65694985450,4,1895,1853,-10
65695795259,65695795262,3,1231,1208,-10
65696283192,65696283200,8,1255,1248,-10
65697267540,65697267542,2,1735,1336,-10
65698839271,65698839273,2,1387,1701,-10
65699780022,65699780024,2,1585,1526,-10
65700261374,65700261375,1,1439,1601,-10
65702144018,65702144018,0,1328,1981,-10
65703503241,65703503243,2,1508,2063,-10
65705699510,65705699515,5,1577,1433,-10
65709280670,65709280672,2,1730,1545,-10
65713319001,65713319001,0,1951,1688,-10
65714869569,65714869571,2,3362,3772,-10
65715405267,65715405270,3,2121,2033,-10
65716780499,65716780498,-1,1202,1263,-10
65718856782,65718856784,2,1484,1090,-10
65720960763,65720960765,2,1072,1754,-10
65722932339,65722932342,3,1685,1516,-10
65724522386,65724522388,2,1671,1370,-10
65725110034,65725110035,1,1527,1720,-10
65726160570,65726160573,3,2081,1353,-10
65727531449,65727531459,10,13132,20531,-10
65727771952,65727771953,1,1110,1147,-10
65730355224,65730355227,3,1355,1794,-10
65732492897,65732492898,1,1397,1730,-10
65737558230,65737558234,4,2218,1163,-10
65741395753,65741395754,1,1803,1971,-10
65741519986,65741519989,3,1755,1295,-10
65746782738,65746782737,-1,1214,1545,-10
65747412605,65747412627,22,1431,1216,-10
65747846058,65747846060,2,1482,1948,-10
65748867065,65748867066,1,1382,1674,-10
65750119161,65750119163,2,1958,1806,-10
65752497870,65752497870,0,1544,1855,-10
65753565178,65753565178,0,1078,1129,-10
65756331313,65756331316,3,1409,1357,-10
65762356987,65762356990,3,1871,1656,-10
65764203178,65764203180,2,1638,1763,-10
65765882873,65765882873,0,1327,1572,-10
65771118982,65771118985,3,1233,939,-10
65771928225,65771928228,3,1969,1768,-10
65776933443,65776933446,3,2132,2243,-10
65782190987,65782190985,-2,1497,3671,-10
65782251556,65782251557,1,1420,1366,-10
65784641814,65784641818,4,1141,1524,-10
65786988034,65786988036,2,1422,1745,-10
65787242891,65787242891,0,1792,2026,-10
65787517726,65787517729,3,1401,2358,-10
65789869290,65789869291,1,1262,1443,-10
65791011018,65791011018,0,1512,1554,-10
65792194545,65792194546,1,1986,1380,-10
65792830150,65792830154,4,1892,1409,-10
65793475596,65793475595,-1,897,1105,-10
65795200622,65795200625,3,1875,1536,-10
65797370812,65797370813,1,1389,1536,-10
65805600526,65805600527,1,1540,1498,-10
65809856292,65809856295,3,1147,1425,-10
65824901521,65824901522,1,1405,1710,-10
65826623785,65826623786,1,1250,1625,-10
65827211618,65827211621,3,1450,1096,-10
65829777685,65829777687,2,1618,1656,-10
65831174318,65831174318,0,1750,1585,-10
65834956982,65834956982,0,1692,1778,-10
65839590520,65839590523,3,2529,2194,-10
65841633514,65841633516,2,1390,1811,-10
65843432490,65843432490,0,2036,1875,-10
65844533274,65844533277,3,1729,1195,-10
65846581793,65846581793,0,1316,1447,-10
65846954390,65846954393,3,1355,1457,-10
65853026914,65853026918,4,1273,1669,-10
65858342617,65858342619,2,1802,1709,-10
65860216733,65860216738,5,1553,1350,-10
65861183927,65861183928,1,1470,1733,-10
65861449298,65861449301,3,1209,1478,-10
65861513022,65861513023,1,1086,1252,-10
65861640581,65861640582,1,1355,1182,-10
65862468269,65862468272,3,1943,1604,-10
65864112734,65864112736,2,1283,1461,-10
65869736288,65869736291,3,1998,1494,-10
65870741416,65870741418,2,2006,1351,-10
65873302938,65873302940,2,1203,1716,-10
65878287595,65878287594,-1,1782,1281,-10
65879029028,65879029033,5,919,971,-10
65879642163,65879642165,2,2026,1751,-10
65880566662,65880566664,2,1087,1524,-10
65881235870,65881235871,1,1637,1639,-10
65883207342,65883207341,-1,900,1822,-10
65884660810,65884660810,0,1553,1770,-10
65887099234,65887099235,1,733,1432,-10
65889397674,65889397677,3,1064,1556,-10
65890206253,65890206255,2,1663,1696,-10
65891005154,65891005156,2,1971,1863,-10
65891468103,65891468103,0,915,1175,-10
65892642570,65892642573,3,1349,1773,-10
65894844269,65894844269,0,1032,2456,-10
65898690297,65898690299,2,1609,1544,-10
65905121190,65905121185,-5,599,1742,-10
65906011870,65906011873,3,1308,1835,-10
65906099844,65906099846,2,2427,1758,-10
65906546214,65906546218,4,1408,1414,-10
65906756021,65906756020,-1,2805,3449,-10
65910642262,65910642266,4,1655,1395,-10
65910803635,65910803635,0,1506,1135,-10
65910895519,65910895523,4,1294,1264,-10
65911897301,65911897303,2,1638,1799,-10
65915964462,65915964466,4,1891,1299,-10
65917971666,65917971666,0,1130,1272,-10
65918146267,65918146269,2,1410,1619,-10
65918311358,65918311360,2,2098,2231,-10
65919526970,65919526971,1,1439,1394,-10
65926392974,65926392978,4,2069,1358,-10
65928210059,65928210061,2,1231,1679,-10
65928558034,65928558035,1,1191,1182,-10
65935910568,65935910569,1,1907,1503,-10
65939445770,65939445773,3,1906,855,-10
65942727130,65942727131,1,1551,1216,-10
65944997849,65944997854,5,1903,1262,-10
65945433618,65945433621,3,1358,1835,-10
65949711309,65949711314,5,2119,1004,-10
65950397941,65950397942,1,2633,1719,-10
65956977918,65956977922,4,993,1095,-10
65962173897,65962173897,0,1399,1906,-10
65963138329,65963138330,1,1796,1663,-10
65965740338,65965740339,1,1919,2223,-10
65966502603,65966502599,-4,1171,2038,-10
65969421007,65969421014,7,3057,1584,-10
65970097310,65970097314,4,4867,3212,-10
65971247329,65971247330,1,1388,1759,-10
65974596874,65974596887,13,13991,30990,-10
65978220602,65978220605,3,1759,1402,-10
65982507152,65982507154,2,1261,1557,-10
65982579289,65982579291,2,1828,2114,-10
65983856122,65983856122,0,1368,1532,-10
65985364510,65985364511,1,1903,1478,-10
65986945041,65986945042,1,1105,1866,-10
65987702014,65987702017,3,1398,1821,-10
65989266342,65989266348,6,1653,1619,-10
65991502082,65991502085,3,3786,3396,-10
65992555459,65992555458,-1,1473,1520,-10
65993124915,65993124918,3,1485,1364,-10
65995326434,65995326434,0,2029,1624,-10
65997623505,65997623506,1,1230,1842,-10
66001582935,66001582938,3,1387,1094,-10
66002568900,66002568888,-12,20109,14539,-10
66003979486,66003979488,2,1266,1159,-10
66009076182,66009076183,1,2266,2328,-10
66022826859,66022826861,2,1209,1566,-10
66024767492,66024767491,-1,486,1153,-10
66026915317,66026915318,1,1392,1724,-10
66027851829,66027851831,2,1420,1402,-10
66032639062,66032639065,3,2086,1422,-10
66032799094,66032799076,-18,1116,1369,-10
66033104462,66033104462,0,1365,1288,-10
66034066250,66034066250,0,1886,1400,-10
66034998397,66034998401,4,5476,2546,-10
66038996660,66038996660,0,1772,1753,-10
66039262750,66039262745,-5,2009,6001,-10
66039785933,66039785934,1,1622,1651,-10
66040772507,66040772509,2,1414,1867,-10
66044979643,66044979646,3,1752,1598,-10
66051768865,66051768859,-6,655,3219,-10
66052612016,66052612015,-1,1952,2425,-10
66054246057,66054246059,2,1973,1483,-10
66055039189,66055039191,2,1044,1509,-10
66055584174,66055584152,-22,1298,1153,-10
66056460053,66056460050,-3,1497,2289,-10
66057120806,66057120806,0,1137,1150,-10
66058423734,66058423737,3,1669,2195,-10
66062787512,66062787515,3,1437,1453,-10
66063654210,66063654214,4,4102,1638,-10
66066256365,66066256364,-1,1948,1597,-10
66073976618,66073976619,1,1043,902,-10
66075039737,66075039738,1,1604,2320,-10
66075337399,66075337398,-1,996,1240,-10
66075568905,66075568906,1,1548,1969,-10
66076068295,66076068293,-2,1311,2269,-10
66077243530,66077243533,3,1744,1291,-10
66078167389,66078167391,2,1638,1364,-10
66080852374,66080852377,3,1891,1401,-10
66082237273,66082237274,1,1857,1444,-10
66083742157,66083742160,3,1497,1444,-10
66086110285,66086110286,1,2124,2009,-10
66088454726,66088454729,3,1560,1445,-10
66089109125,66089109126,1,1770,1549,-10
66092421890,66092421890,0,2151,2909,-10
66092479446,66092479455,9,5052,1751,-10
66101765738,66101765739,1,1516,1641,-10
66104401184,66104401185,1,2192,2288,-10
66106446057,66106446060,3,2133,1609,-10
66110038578,66110038581,3,1156,1512,-10
66112335546,66112335549,3,1310,1274,-10
66115797939,66115797939,0,1411,1579,-10
66115847594,66115847591,-3,1197,1426,-10
66117396311,66117396310,-1,2175,2210,-10
66123067094,66123067095,1,1446,1594,-10
66123584949,66123584953,4,2616,1694,-10
66125946711,66125946713,2,1509,1850,-10
66128938664,66128938667,3,1477,1948,-10
66130626722,66130626720,-2,1583,2791,-10
66137311198,66137311202,4,1417,1730,-10
66139989151,66139989154,3,1935,1762,-10
66140085463,66140085465,2,1667,1365,-10
66141118503,66141118500,-3,14642,30841,-10
66143912287,66143912289,2,2073,1635,-10
66145154781,66145154782,1,1499,1083,-10
66149107693,66149107695,2,1375,1382,-10
66153158099,66153158094,-5,1162,3648,-10
66155905205,66155905206,1,1543,1727,-10
66157545999,66157546000,1,1800,1996,-10
66162318308,66162318331,23,1345,1664,-10
66165341869,66165341871,2,1476,1666,-10
66166352638,66166352644,6,3279,1832,-10
66167443555,66167443558,3,1970,1473,-10
66170850622,66170850618,-4,1303,2069,-10
66175297249,66175297250,1,1145,1175,-10
66177263248,66177263247,-1,1238,1236,-10
66180751538,66180751542,4,696,1168,-10
66181784610,66181784612,2,1850,1625,-10
66183923854,66183923855,1,1841,1892,-10
66185228123,66185228126,3,1484,1350,-10
66187385323,66187385326,3,951,1251,-10
66188571422,66188571427,5,1010,720,-10
66193105780,66193105781,1,1466,1554,-10
66193812710,66193812711,1,1478,1834,-10
66195179674,66195179675,1,1604,1832,-10
66195592003,66195592003,0,1346,1787,-10
66198820656,66198820659,3,2168,1472,-10
66202108780,66202108779,-1,1210,1608,-10
66202190626,66202190626,0,1691,1846,-10
66203335792,66203335795,3,1985,1300,-10
66203443656,66203443658,2,1906,1987,-10
66204286132,66204286136,4,1952,2000,-10
66205067107,66205067109,2,1399,1352,-10
66206340852,66206340854,2,1378,959,-10
66206618705,66206618707,2,1917,1303,-10
66208091718,66208091719,1,829,1523,-10
66212420990,66212420990,0,1323,2036,-10
66214408155,66214408158,3,1462,1843,-10
66223052205,66223052207,2,1421,1549,-10
66223347090,66223347093,3,1029,970,-10
66226986796,66226986797,1,1032,1180,-10
66228046990,66228046994,4,2163,1746,-10
66229212506,66229212507,1,1287,1329,-10
66229564800,66229564802,2,1446,1651,-10
66231712061,66231712067,6,4068,1525,-10
66237045583,66237045585,2,1689,1745,-10
66237189590,66237189595,5,2428,1510,-10
66238772418,66238772417,-1,1488,1965,-10
66240720007,66240720007,0,2063,2211,-10
66244839902,66244839905,3,1612,1562,-10
66247644802,66247644805,3,1712,1695,-10
66249844548,66249844550,2,1535,1740,-10
66250813390,66250813395,5,2561,1353,-10
66252094934,66252094937,3,2116,2221,-10
66252266719,66252266721,2,1973,2338,-10
66252492994,66252492990,-4,1547,1654,-10
66253466008,66253466009,1,1597,2078,-10
66253874718,66253874714,-4,1147,2612,-10
66255483702,66255483705,3,1772,1585,-10
66256022738,66256022737,-1,1244,1413,-10
66256220603,66256220618,15,1690,981,-10
66256281658,66256281661,3,1317,1864,-10
66258158632,66258158634,2,1629,1697,-10
66258527707,66258527706,-1,953,1840,-10
66259861489,66259861490,1,1128,1000,-10
66260063180,66260063160,-20,1771,1167,-10
66261533255,66261533257,2,1488,1159,-10
66262660427,66262660430,3,1776,1869,-10
66263353731,66263353730,-1,1577,1672,-10
66269479753,66269479755,2,1112,1092,-10
66270165433,66270165435,2,2038,1730,-10
66271144170,66271144175,5,744,813,-10
66273955653,66273955657,4,1345,848,-10
66276976549,66276976555,6,2438,1185,-10
66279781386,66279781392,6,3290,2722,-10
66285682173,66285682168,-5,1643,4853,-10
66286416859,66286416858,-1,1891,1831,-10
66287608654,66287608649,-5,1354,4409,-10
66288581565,66288581566,1,1345,1199,-10
66289202062,66289202065,3,2240,2344,-10
66297014542,66297014545,3,1321,1315,-10
66298271782,66298271785,3,861,1092,-10
66299098214,66299098215,1,1785,1347,-10
66299365617,66299365619,2,1336,1385,-10
66299598636,66299598638,2,2056,1508,-10
66301673070,66301673065,-5,1033,3215,-10
66302997323,66302997324,1,2119,2281,-10
66303870840,66303870840,0,2256,2142,-10
66305404294,66305404293,-1,1555,1816,-10
66306164450,66306164454,4,741,1016,-10
66307884746,66307884746,0,1073,1225,-10
66308243175,66308243178,3,1358,1526,-10
66311709740,66311709744,4,1884,1546,-10
66313377682,66313377685,3,1513,1395,-10
66314441163,66314441167,4,1879,1012,-10
66317110224,66317110227,3,847,867,-10
66318627263,66318627259,-4,1661,1145,-10
66319159556,66319159558,2,1858,1770,-10
66324195303,66324195310,7,5048,1804,-10
66325451155,66325451159,4,2240,1669,-10
66325540387,66325540387,0,931,1625,-10
66326584470,66326584485,15,1285,1739,-10
66327691533,66327691534,1,1653,1935,-10
66327860467,66327860469,2,1373,1628,-10
66334282562,66334282562,0,1496,1696,-10
66337890886,66337890887,1,1505,1422,-10
66342012202,66342012182,-20,1339,1476,-10
66342672601,66342672598,-3,711,1375,-10
66342703350,66342703351,1,1492,1588,-10
66343430256,66343430256,0,1451,1901,-10
66343970878,66343970881,3,1252,1370,-10
66348319518,66348319513,-5,1424,5001,-10
66348566474,66348566476,2,1674,1828,-10
66348939075,66348939078,3,1484,1697,-10
66352527656,66352527658,2,1620,1427,-10
66356820043,66356820046,3,1587,1403,-10
66359050714,66359050714,0,1305,1466,-10
66359410677,66359410676,-1,1154,1819,-10
66360625188,66360625189,1,1821,1876,-10
66363000265,66363000265,0,1550,1284,-10
66363472769,66363472771,2,1655,2313,-10
66366896261,66366896262,1,1322,1223,-10
66370888928,66370888929,1,1575,900,-10
66374097606,66374097608,2,1766,1898,-10
66374427948,66374427949,1,1483,1763,-10
66375458326,66375458323,-3,1349,1944,-10
66375643493,66375643493,0,1068,2041,-10
66376746030,66376746032,2,2084,1896,-10
66380608078,66380608079,1,1756,2003,-10
66385439818,66385439819,1,1092,1002,-10
66386736639,66386736642,3,1970,1609,-10
66395134123,66395134123,0,1410,1447,-10
66398216417,66398216418,1,1141,1719,-10
66400739780,66400739781,1,1058,1182,-10
66402121010,66402121014,4,1611,1171,-10
66405203405,66405203426,21,13229,47833,-10
66406380731,66406380730,-1,1494,1664,-10
66407759258,66407759263,5,1232,1028,-10
66408263798,66408263797,-1,1779,1696,-10
66412726969,66412726970,1,1205,1742,-10
66416165714,66416165718,4,2436,1924,-10
66417410714,66417410718,4,910,1183,-10
66417954441,66417954443,2,1403,1704,-10
66419765203,66419765205,2,1538,848,-10
66420975646,66420975646,0,1263,1471,-10
66425939315,66425939318,3,1025,992,-10
66426323649,66426323650,1,2120,1590,-10
66427788298,66427788298,0,1472,1782,-10
66428557074,66428557077,3,2155,1573,-10
66428817518,66428817520,2,1262,1624,-10
66430023756,66430023757,1,1819,1445,-10
66431327170,66431327175,5,2394,1555,-10
66432937953,66432937957,4,2004,1470,-10
66433739089,66433739092,3,1848,1600,-10
66436663919,66436663922,3,898,1225,-10
66436821968,66436821970,2,1458,2283,-10
66438415382,66438415382,0,1256,1834,-10
66444493423,66444493425,2,1709,2271,-10
66444930327,66444930330,3,2459,1692,-10
66445074035,66445074038,3,1735,1571,-10
66445504313,66445504329,16,2183,1547,-10
66447715762,66447715765,3,1785,2067,-10
66450696112,66450696113,1,1784,1526,-10
66451397938,66451397941,3,2259,2069,-10
66451754833,66451754834,1,2232,2033,-10
66451894725,66451894706,-19,1249,899,-10
66459025740,66459025743,3,1455,1598,-10
66462502866,66462502867,1,2408,1835,-10
66465412916,66465412918,2,1946,1412,-10
66466710625,66466710625,0,1728,2137,-10
66466934679,66466934681,2,1395,1271,-10
66467630001,66467630004,3,1590,1290,-10
66468432116,66468432119,3,876,1367,-10
66470589395,66470589397,2,1552,1220,-10
66475384807,66475384809,2,1463,1856,-10
66476908389,66476908386,-3,1117,1633,-10
66481897390,66481897393,3,1170,1641,-10
66485934365,66485934359,-6,1590,6266,-10
66486059805,66486059806,1,1384,1538,-10
66487185669,66487185673,4,1698,1302,-10
66488622277,66488622280,3,2498,1473,-10
66497432177,66497432178,1,1030,1364,-10
66499197062,66499197065,3,1451,1414,-10
66500575544,66500575546,2,1430,1370,-10
66501036650,66501036653,3,920,1232,-10
66502500505,66502500506,1,1452,1299,-10
66505855114,66505855117,3,1678,1744,-10
66508285773,66508285774,1,1499,1307,-10
66509672185,66509672187,2,1275,1250,-10
66515166328,66515166330,2,1926,1894,-10
66515361099,66515361102,3,1727,1358,-10
66515819522,66515819527,5,1518,1179,-10
66519196675,66519196677,2,1518,1615,-10
66519780757,66519780758,1,1747,1731,-10
66520168426,66520168430,4,1544,1417,-10
66522730782,66522730785,3,1444,1917,-10
66524258475,66524258475,0,1108,1215,-10
66527066231,66527066234,3,1678,1741,-10
66532522550,66532522551,1,1800,1621,-10
66533063626,66533063627,1,1213,952,-10
66534625097,66534625099,2,1325,1607,-10
66537461393,66537461395,2,1825,1298,-10
66538446325,66538446329,4,1494,1379,-10
66540310308,66540310307,-1,1102,1508,-10
66545770727,66545770730,3,1808,2016,-10
66546966014,66546966017,3,1799,1896,-10
66547905050,66547905053,3,1920,1488,-10
66548701108,66548701110,2,1264,1165,-10
66549835240,66549835241,1,1942,1499,-10
66550886555,66550886557,2,948,1713,-10
66553747370,66553747372,2,1740,1146,-10
66563695813,66563695816,3,2050,1826,-10
66564711474,66564711476,2,1595,1317,-10
66565691954,66565691955,1,1769,1602,-10
66566274878,66566274878,0,1205,963,-10
66566767510,66566767510,0,1248,1537,-10
66572306965,66572306966,1,1364,988,-10
66577911021,66577911022,1,1730,1810,-10
66581930834,66581930835,1,1188,1780,-10
66586897237,66586897239,2,2062,1360,-10
66588231150,66588231143,-7,986,4171,-10
66588626058,66588626059,1,1726,1829,-10
66591574287,66591574290,3,1284,1569,-10
66594646690,66594646693,3,1854,1433,-10
66597290982,66597290983,1,806,1264,-10
66597378669,66597378670,1,2559,2298,-10
66601865469,66601865471,2,1286,1271,-10
66603781689,66603781694,5,4851,2436,-10
66604197134,66604197135,1,1125,1088,-10
66605100874,66605100875,1,827,1334,-10
66605877828,66605877829,1,1412,1078,-10
66607892334,66607892338,4,2373,1695,-10
66608984606,66608984609,3,2025,1378,-10
66613679507,66613679510,3,1775,1170,-10
66615556903,66615556904,1,902,1181,-10
66619703391,66619703391,0,1441,1948,-10
66624036768,66624036770,2,2199,2059,-10
66626349731,66626349733,2,1511,1592,-10
66628435150,66628435152,2,1733,1393,-10
66635358913,66635358916,3,13816,9617,-10
66635808675,66635808653,-22,1351,1616,-10
66638650041,66638650041,0,1640,2360,-10
66641754714,66641754715,1,1997,2308,-10
66642401954,66642401957,3,1359,1037,-10
66643010253,66643010256,3,1493,1832,-10
66645690118,66645690119,1,1404,1405,-10
66648026101,66648026107,6,3908,1940,-10
66648226238,66648226238,0,1652,1529,-10
66649062639,66649062640,1,893,1208,-10
66652946621,66652946626,5,1282,1018,-10
66656185414,66656185415,1,946,984,-10
66657416537,66657416539,2,1150,1038,-10
66659751097,66659751098,1,1495,1197,-10
66661359744,66661359750,6,3783,1016,-10
66661548524,66661548526,2,1370,1235,-10
66668096766,66668096769,3,1218,1124,-10
66669078417,66669078418,1,1646,1149,-10
66673168202,66673168206,4,1542,1518,-10
66675328973,66675328976,3,1875,1795,-10
66676164637,66676164641,4,1690,1129,-10
66676647155,66676647154,-1,1318,2337,-10
66678091621,66678091623,2,1477,1399,-10
66679349516,66679349515,-1,1305,1443,-10
66679917419,66679917422,3,1899,1549,-10
66687126905,66687126906,1,1659,1626,-10
66691807271,66691807271,0,1641,1805,-10
66693345146,66693345146,0,1471,1903,-10
66694487821,66694487823,2,1579,1100,-10
66694577837,66694577841,4,1615,1425,-10
66696072139,66696072142,3,2040,1991,-10
66700865998,66700866001,3,1252,1293,-10
66704394672,66704394674,2,1285,1332,-10
66711269751,66711269766,15,1706,883,-10
66713460368,66713460369,1,881,1134,-10
66713906186,66713906189,3,1200,1255,-10
66715387750,66715387753,3,1585,1205,-10
66715794766,66715794771,5,1525,1164,-10
66716690214,66716690220,6,2024,1646,-10
66720134255,66720134257,2,1998,1806,-10
66721481396,66721481398,2,1451,1573,-10
66722452891,66722452890,-1,991,2153,-10
66723167809,66723167810,1,1377,2278,-10
66724851518,66724851521,3,1514,1314,-10
66725868238,66725868236,-2,968,1680,-10
66726271565,66726271566,1,1427,1207,-10
66726500662,66726500669,7,3308,1294,-10
66727856072,66727856071,-1,1249,1483,-10
66728294527,66728294525,-2,1344,2277,-10
66728955312,66728955313,1,1695,1391,-10
66730817518,66730817519,1,1354,1423,-10
66732402898,66732402890,-8,1656,9768,-10
66735835139,66735835122,-17,1183,1450,-10
66739225132,66739225134,2,1877,1604,-10
66739981992,66739981994,2,2085,1752,-10
66741540069,66741540072,3,1800,1439,-10
66742278854,66742278853,-1,2257,2156,-10
66743568737,66743568738,1,1913,1653,-10
66745505821,66745505824,3,1527,1576,-10
66746605822,66746605825,3,2316,1640,-10
66748498643,66748498648,5,2756,1978,-10
66750239658,66750239651,-7,703,2707,-10
66750933761,66750933762,1,1698,1692,-10
66753903415,66753903415,0,1628,1445,-10
66754268495,66754268498,3,1260,1439,-10
66755122410,66755122413,3,1933,1387,-10
66755621955,66755621958,3,1699,1042,-10
66756195833,66756195833,0,2361,1760,-10
66757965659,66757965661,2,1092,1964,-10
66760739830,66760739833,3,967,1275,-10
66764405266,66764405268,2,1656,1388,-10
66764431567,66764431547,-20,1082,1532,-10
66770480094,66770480096,2,1200,1341,-10
66773638625,66773638618,-7,1234,3682,-10
66775157813,66775157818,5,2353,1437,-10
66778156320,66778156322,2,1497,1542,-10
66778297530,66778297530,0,1880,1669,-10
66778533295,66778533295,0,1526,1380,-10
66778892411,66778892414,3,1655,1706,-10
66779317825,66779317827,2,1263,1349,-10
66779457701,66779457722,21,1194,1787,-10
66781643414,66781643414,0,1444,1562,-10
66798141785,66798141778,-7,2868,11087,-10
66798676070,66798676071,1,2176,2018,-10
66802294581,66802294584,3,1762,1657,-10
66802426722,66802426722,0,1497,1664,-10
66806289274,66806289277,3,1716,1924,-10
66808486758,66808486763,5,1166,1169,-10
66810907159,66810907161,2,1314,1371,-10
66811173269,66811173248,-21,1200,1580,-10
66812071802,66812071804,2,1494,1318,-10
66813413246,66813413245,-1,938,1556,-10
66813534386,66813534387,1,1395,1740,-10
66814623099,66814623098,-1,1403,1179,-10
66815848965,66815848965,0,636,621,-10
66822611319,66822611323,4,1763,1638,-10
66825072808,66825072811,3,1161,1388,-10
66828249427,66828249430,3,1410,1020,-10
66829165338,66829165340,2,1314,1596,-10
66831690471,66831690473,2,976,1239,-10
66831839078,66831839079,1,2206,2126,-10
66832219157,66832219158,1,1463,1401,-10
66832957082,66832957086,4,1677,2308,-10
66834588958,66834588962,4,1898,1588,-10
66837676957,66837676958,1,2107,2226,-10
66841657055,66841657051,-4,1067,3529,-10
66842384094,66842384097,3,839,1311,-10
66843751761,66843751764,3,1667,1550,-10
66848983715,66848983718,3,2734,1963,-10
66851291930,66851291931,1,1319,2082,-10
66851453137,66851453138,1,1856,1253,-10
66853852938,66853852941,3,1451,1479,-10
66855604541,66855604546,5,2528,1196,-10
66858053257,66858053258,1,1270,1359,-10
66860577232,66860577234,2,2314,1258,-10
66862366550,66862366553,3,1935,2170,-10
66863104927,66863104926,-1,831,1264,-10
66867665770,66867665773,3,1865,1824,-10
66869721341,66869721341,0,1008,2267,-10
66870850929,66870850928,-1,933,537,-10
66872411214,66872411214,0,1217,1860,-10
66875059959,66875059961,2,868,1348,-10
66876748366,66876748367,1,1108,1316,-10
66880363677,66880363678,1,1348,1362,-10
66886761310,66886761314,4,1321,1100,-10
66887932199,66887932202,3,1473,1549,-10
66889064880,66889064882,2,1493,1794,-10
66894376688,66894376695,7,1742,1241,-10
66898946175,66898946177,2,1524,1628,-10
66899724158,66899724158,0,1564,1333,-10
66900096713,66900096715,2,1035,2113,-10
66900441138,66900441139,1,2,3431,-10
66903555673,66903555676,3,1818,2115,-10
66903692770,66903692771,1,1329,1458,-10
66904275622,66904275626,4,1654,1292,-10
66904560837,66904560816,-21,1777,1695,-10
66904768203,66904768207,4,1748,783,-10
66904969603,66904969586,-17,1614,1200,-10
66905200727,66905200730,3,1506,1612,-10
66905508909,66905508910,1,1476,1430,-10
66909031169,66909031170,1,1873,1592,-10
66911899042,66911899045,3,1375,1473,-10
66916726939,66916726938,-1,1821,1277,-10
66919248568,66919248569,1,1202,1264,-10
66922597637,66922597639,2,1224,1563,-10
66926223716,66926223721,5,2089,975,-10
66927377943,66927377946,3,1481,1410,-10
66930291966,66930291970,4,2170,1633,-10
66935807597,66935807593,-4,2262,6054,-10
66940080648,66940080649,1,1293,1485,-10
66940875909,66940875912,3,1810,1485,-10
66951377791,66951377794,3,2144,1508,-10
66953796215,66953796217,2,1985,1888,-10
66957648229,66957648231,2,1522,1718,-10
66963028727,66963028726,-1,1192,1805,-10
66967972597,66967972600,3,1541,1476,-10
66971394227,66971394230,3,1770,1471,-10
66972612860,66972612863,3,29068,22888,-10
66976003782,66976003783,1,2403,2400,-10
66976739401,66976739401,0,1340,2007,-10
66978642311,66978642313,2,1589,1324,-10
66979875634,66979875634,0,1491,1404,-10
66980996774,66980996777,3,757,934,-10
66981789958,66981789961,3,1752,1576,-10
66984015221,66984015228,7,5613,2438,-10
66984087584,66984087587,3,1012,993,-10
66989001468,66989001474,6,3718,2445,-10
66989235013,66989235015,2,2267,1995,-10
66996148099,66996148098,-1,1843,1693,-10
66996239017,66996239019,2,1075,1307,-10
66997338037,66997338041,4,2029,1386,-10
66999457226,66999457229,3,939,996,-10
67000687917,67000687914,-3,6786,14471,-10
67003391463,67003391466,3,1347,1291,-10
67005863681,67005863683,2,1749,1135,-10
67006626661,67006626663,2,1880,1880,-10
67009178507,67009178509,2,1365,1372,-10
67014452293,67014452293,0,2178,1835,-10
67015771499,67015771495,-4,2093,3619,-10
67019657512,67019657512,0,1030,1426,-10
67020753989,67020753993,4,1364,1592,-10
67021493969,67021493973,4,1226,1331,-10
67023317405,67023317406,1,1045,1629,-10
67026174061,67026174063,2,2283,1994,-10
67026331846,67026331849,3,1365,1467,-10
67028476166,67028476169,3,2295,1990,-10
67032317113,67032317116,3,1966,2144,-10
67035611820,67035611821,1,1734,1531,-10
67037408802,67037408802,0,2125,1918,-10
67039312268,67039312271,3,1437,1352,-10
67046496242,67046496241,-1,943,1065,-10
67047145397,67047145399,2,2186,1340,-10
67048051595,67048051597,2,1587,1728,-10
67050526626,67050526625,-1,1074,1821,-10
67057325560,67057325562,2,1397,1733,-10
67057897723,67057897723,0,1467,1530,-10
67058449447,67058449446,-1,1525,948,-10
67062025322,67062025302,-20,1258,1436,-10
67063190442,67063190450,8,714,471,-10
67064720792,67064720793,1,1273,1476,-10
67066496830,67066496842,12,1799,1619,-10
67066610726,67066610727,1,1702,1094,-10
67072161388,67072161388,0,1699,1784,-10
67074964443,67074964446,3,2205,1512,-10
67075029210,67075029213,3,1395,1472,-10
67078793588,67078793590,2,1242,1161,-10
67082945811,67082945810,-1,1315,1841,-10
67084112165,67084112160,-5,1209,2442,-10
67088596046,67088596047,1,1287,1197,-10
67090570796,67090570798,2,2140,1807,-10
67091463385,67091463387,2,1903,1686,-10
67091509837,67091509839,2,819,772,-10
67092910334,67092910338,4,1452,1862,-10
67092939446,67092939446,0,1508,1469,-10
67102946306,67102946310,4,1741,2167,-10
67103897444,67103897447,3,1760,1445,-10
67105209842,67105209844,2,1619,1497,-10
67108618951,67108618954,3,1117,1522,-10
67110052742,67110052745,3,1606,965,-10
67111420441,67111420443,2,1495,1134,-10
67114401084,67114401086,2,1667,1494,-10
67115016081,67115016086,5,53326,27851,-10
67116340535,67116340535,0,1995,1801,-10
67116440722,67116440722,0,1831,2291,-10
67116853163,67116853163,0,1539,1499,-10
67118286157,67118286159,2,1457,2025,-10
67121514822,67121514825,3,1856,2019,-10
67121545013,67121545015,2,1088,1082,-10
67127839364,67127839357,-7,2187,8233,-10
67128138297,67128138299,2,1484,1646,-10
67128383855,67128383858,3,1572,1464,-10
67129349547,67129349550,3,1395,1276,-10
67130205360,67130205361,1,1897,1280,-10
67133191596,67133191602,6,1367,683,-10
67134320170,67134320173,3,1916,1746,-10
67135625107,67135625111,4,2215,2082,-10
67137149263,67137149264,1,1934,1416,-10
67138621650,67138621651,1,1510,1408,-10
67141354987,67141354989,2,3156,4404,-10
67142407230,67142407232,2,1194,1539,-10
67145534287,67145534289,2,1416,984,-10
67146475526,67146475528,2,1834,1533,-10
67146758239,67146758245,6,2870,1656,-10
67146875841,67146875842,1,1344,1151,-10
67147648794,67147648789,-5,554,3133,-10
67148419182,67148419184,2,1570,1457,-10
67153419774,67153419775,1,1703,1145,-10
67155183720,67155183722,2,2433,1893,-10
67156705459,67156705463,4,1771,1649,-10
67158782321,67158782322,1,1448,1414,-10
67160065829,67160065831,2,1719,1734,-10
67160626480,67160626482,2,2025,1682,-10
67161369338,67161369353,15,1430,1738,-10
67163663589,67163663591,2,1669,1918,-10
67164653069,67164653071,2,1841,2376,-10
67164760063,67164760063,0,1339,1436,-10
67166158490,67166158492,2,2170,1898,-10
67166212294,67166212275,-19,637,485,-10
67166614267,67166614268,1,1075,1626,-10
67166680288,67166680274,-14,1459,1943,-10
67170065677,67170065679,2,1643,1829,-10
67173107266,67173107270,4,980,982,-10
67173683570,67173683574,4,1587,867,-10
67174527751,67174527754,3,1300,1770,-10
67175530390,67175530392,2,1186,1742,-10
67177916930,67177916933,3,1037,1350,-10
67178532923,67178532925,2,1121,1589,-10
67181177326,67181177329,3,1680,2022,-10
67182230463,67182230466,3,1799,931,-10
67183865365,67183865366,1,1363,1680,-10
67186502423,67186502427,4,787,1118,-10
67189555803,67189555805,2,1651,1505,-10
67189776467,67189776467,0,1503,2098,-10
67190371793,67190371794,1,1596,1660,-10
67191348199,67191348202,3,1707,1706,-10
67191492479,67191492478,-1,1146,1999,-10
67191618821,67191618823,2,1583,1544,-10
67192259870,67192259871,1,1732,1343,-10
67192589487,67192589490,3,1824,1631,-10
67195236190,67195236192,2,2224,1713,-10
67198508413,67198508413,0,1468,1289,-10
67199291315,67199291320,5,4141,1908,-10
67200894365,67200894366,1,1229,1302,-10
67208518299,67208518301,2,2023,1231,-10
67209582421,67209582419,-2,1444,1666,-10
67209949173,67209949174,1,1942,1720,-10
67215173517,67215173519,2,1469,1186,-10
67219474302,67219474303,1,1859,1449,-10
67221169842,67221169844,2,1745,1181,-10
67221248101,67221248105,4,1724,1334,-10
67223325221,67223325222,1,1286,1598,-10
67225066033,67225066034,1,1827,1748,-10
67228839226,67228839226,0,1178,1323,-10
67231109751,67231109753,2,1043,1098,-10
67237284839,67237284839,0,1035,820,-10
67239480510,67239480513,3,1922,1382,-10
67241077151,67241077154,3,1172,1394,-10
67244465802,67244465806,4,1692,1608,-10
67244918035,67244918037,2,1514,1212,-10
67245218070,67245218076,6,2130,1290,-10
67245303674,67245303681,7,1062,1274,-10
67247033621,67247033622,1,1482,1624,-10
67255531155,67255531150,-5,2334,6677,-10
67255749917,67255749920,3,1765,1785,-10
67257714503,67257714505,2,1896,1503,-10
67258729734,67258729737,3,1808,1212,-10
67259890207,67259890207,0,1368,1798,-10
67260153617,67260153619,2,1371,1149,-10
67262691973,67262691974,1,1017,929,-10
67266476478,67266476481,3,1393,1480,-10
67270534188,67270534189,1,1778,1627,-10
67272272863,67272272866,3,1078,1222,-10
67276602886,67276602864,-22,1911,1861,-10
67279027366,67279027369,3,1822,1743,-10
67279062271,67279062275,4,1587,1156,-10
67284996335,67284996335,0,1338,1431,-10
67287178261,67287178264,3,2275,1855,-10
67289601229,67289601230,1,1800,1791,-10
67293433931,67293433932,1,1239,2016,-10
67298224895,67298224898,3,1898,1965,-10
67302508250,67302508251,1,1257,1266,-10
67303085979,67303085984,5,1822,1733,-10
67303351765,67303351767,2,2057,2136,-10
67303564799,67303564802,3,2241,1913,-10
67304262818,67304262819,1,1628,1427,-10
67305873340,67305873341,1,1545,1166,-10
67307662363,67307662365,2,1525,1438,-10
67309784507,67309784510,3,1855,1534,-10
67309958963,67309958966,3,1386,1502,-10
67312708023,67312708026,3,1345,1698,-10
67314264537,67314264537,0,1262,1706,-10
67317303150,67317303150,0,1099,1797,-10
67323281287,67323281293,6,1758,1283,-10
67323547838,67323547858,20,1892,1314,-10
67325960185,67325960186,1,1623,1563,-10
67327747291,67327747291,0,1479,1321,-10
67328595534,67328595537,3,1238,1426,-10
67329373661,67329373663,2,2289,2447,-10
67329846142,67329846143,1,1178,1473,-10
67331706774,67331706776,2,1499,1325,-10
67331914124,67331914126,2,1999,2362,-10
67332779578,67332779582,4,1772,1801,-10
67333396463,67333396463,0,2473,2036,-10
67333822202,67333822204,2,1481,1091,-10
67336636358,67336636361,3,1660,1340,-10
67337183281,67337183284,3,2494,1496,-10
67337839387,67337839390,3,1592,1310,-10
67340789301,67340789303,2,1185,1699,-10
67343105700,67343105702,2,1881,1776,-10
67343305091,67343305094,3,2096,1929,-10
67343624175,67343624178,3,2296,1687,-10
67347681026,67347681029,3,1691,2379,-10
67351760477,67351760493,16,5239,795,-10
67352647681,67352647682,1,983,1332,-10
67358052342,67358052343,1,1791,1748,-10
67358632235,67358632237,2,1061,1296,-10
67360366502,67360366504,2,2142,1916,-10
67360632518,67360632496,-22,1526,1666,-10
67362944323,67362944324,1,1286,1918,-10
67366000031,67366000032,1,1839,1752,-10
67366425192,67366425194,2,1486,1452,-10
67368561235,67368561239,4,718,1015,-10
67370205949,67370205951,2,1754,1478,-10
67371198991,67371198996,5,1780,1764,-10
67372481596,67372481598,2,1565,1236,-10
67372923428,67372923426,-2,1388,2050,-10
67373603251,67373603254,3,1911,1641,-10
67376942178,67376942173,-5,853,3284,-10
67379444241,67379444242,1,1187,1433,-10
67382625066,67382625069,3,2206,1571,-10
67386422171,67386422175,4,2901,1629,-10
67393588590,67393588594,4,1551,1321,-10
67399426222,67399426226,4,1959,956,-10
67401364926,67401364926,0,1792,1557,-10
67402726986,67402726992,6,15517,20062,-10
67404486853,67404486857,4,2726,1417,-10
67406415861,67406415863,2,1016,1169,-10
67408755138,67408755139,1,1437,1559,-10
67411172423,67411172426,3,1951,1580,-10
67415240995,67415240997,2,1473,2253,-10
67416854919,67416854922,3,1776,1414,-10
67417455209,67417455210,1,1703,1932,-10
67419997854,67419997854,0,899,1380,-10
67421228488,67421228491,3,1639,1519,-10
67425367985,67425367986,1,1736,1678,-10
67429432027,67429432029,2,2494,2176,-10
67431235479,67431235481,2,1800,1377,-10
67432840229,67432840230,1,1229,1252,-10
67437671243,67437671246,3,1428,1146,-10
67442452280,67442452284,4,1105,1417,-10
67443927486,67443927487,1,1327,1768,-10
67446857730,67446857732,2,3057,2197,-10
67447117452,67447117453,1,1213,1016,-10
67447605433,67447605439,6,1143,1299,-10
67450359650,67450359653,3,1890,1669,-10
67451089382,67451089383,1,1518,1392,-10
67452686581,67452686583,2,2128,1176,-10
67453845899,67453845893,-6,802,2949,-10
67455237169,67455237171,2,1254,1403,-10
67456827694,67456827697,3,1404,1082,-10
67457402189,67457402191,2,1437,1471,-10
67460760213,67460760214,1,1940,1752,-10
67462899407,67462899410,3,2245,1599,-10
67463041773,67463041778,5,1718,908,-10
67463465693,67463465695,2,1939,1888,-10
67467528551,67467528555,4,1885,2079,-10
67470093446,67470093446,0,2323,1875,-10
67471030064,67471030067,3,1403,1479,-10
67473594272,67473594275,3,1421,1447,-10
67474398392,67474398390,-2,1504,1442,-10
67476888734,67476888736,2,1973,1930,-10
67480070577,67480070581,4,1165,912,-10
67484952337,67484952339,2,1739,1507,-10
67486541763,67486541767,4,1471,1648,-10
67489010498,67489010495,-3,1010,1809,-10
67489915253,67489915255,2,1941,1704,-10
67491018847,67491018847,0,913,1302,-10
67491470222,67491470220,-2,935,2042,-10
67495864938,67495864941,3,1363,1073,-10
67497535573,67497535574,1,1672,1846,-10
67497977656,67497977657,1,1229,1564,-10
67499467890,67499467891,1,1960,1461,-10
67500207931,67500207934,3,1902,1710,-10
67509828393,67509828394,1,1204,1916,-10
67511213127,67511213129,2,1284,1916,-10
67513147721,67513147723,2,1409,1060,-10
67518629634,67518629636,2,1924,1675,-10
67519526352,67519526354,2,1862,2093,-10
67520240130,67520240131,1,1992,2036,-10
67520659606,67520659606,0,1232,1450,-10
67524373690,67524373690,0,1496,1069,-10
67524851693,67524851697,4,2357,1938,-10
67525862382,67525862384,2,1859,1491,-10
67527584968,67527584970,2,1293,1136,-10
67528620528,67528620529,1,2358,2357,-10
67533052759,67533052750,-9,620,5292,-10
67535737571,67535737574,3,1593,1515,-10
67536582190,67536582195,5,1422,1722,-10
67538073577,67538073578,1,1335,1374,-10
67538762581,67538762582,1,1664,2052,-10
67541995372,67541995372,0,1177,2044,-10
67546465982,67546465986,4,2212,1318,-10
67546746890,67546746893,3,1512,2632,-10
67547165469,67547165469,0,1986,2579,-10
67548970398,67548970400,2,1918,2065,-10
67551310825,67551310826,1,1181,1200,-10
67553863670,67553863674,4,2006,1590,-10
67554350489,67554350491,2,2109,1618,-10
67558282163,67558282162,-1,1173,1774,-10
67560475030,67560475031,1,1710,1648,-10
67560902094,67560902094,0,1546,1530,-10
67562883257,67562883259,2,1566,1762,-10
67565522414,67565522418,4,1650,927,-10
67567015875,67567015878,3,1301,1241,-10
67569819666,67569819666,0,1426,1669,-10
67572820770,67572820789,19,1240,1216,-10
67573610680,67573610683,3,1741,1786,-10
67573957650,67573957642,-8,1484,2209,-10
67577537922,67577537923,1,1285,748,-10
67578085838,67578085838,0,1250,2233,-10
67580140285,67580140286,1,1598,1874,-10
67582407758,67582407760,2,1418,1102,-10
67582598303,67582598306,3,1659,1913,-10
67582814494,67582814495,1,1182,771,-10
67585844866,67585844869,3,1548,1519,-10
67588691781,67588691782,1,1438,1633,-10
67593885959,67593885962,3,1512,1676,-10
67598934031,67598934031,0,2267,1889,-10
67601271692,67601271694,2,1778,1724,-10
67602520194,67602520197,3,1770,1362,-10
67602878490,67602878488,-2,1210,1440,-10
67606076189,67606076191,2,1468,1798,-10
67606373283,67606373286,3,1604,1796,-10
67606535744,67606535746,2,1556,1548,-10
67607763565,67607763569,4,1236,1519,-10
67608355345,67608355346,1,2047,1800,-10
67610810258,67610810258,0,1106,1658,-10
67618345135,67618345115,-20,626,422,-10
67623193085,67623193087,2,1379,1696,-10
67623414090,67623414096,6,1564,1648,-10
67623876170,67623876174,4,1551,1568,-10
67624035478,67624035479,1,1983,1845,-10
67626608609,67626608610,1,1356,1318,-10
67628986916,67628986917,1,2027,1802,-10
67632698270,67632698273,3,1461,1794,-10
67636136534,67636136536,2,1954,1383,-10
67637127891,67637127894,3,1907,1929,-10
67638582025,67638582026,1,1582,1767,-10
67641101084,67641101087,3,1425,1503,-10
67642971080,67642971081,1,1651,1395,-10
67644493162,67644493164,2,1308,1553,-10
67650708122,67650708122,0,1114,1418,-10
67651625941,67651625944,3,1441,1828,-10
67656001058,67656001058,0,1514,1632,-10
67656904010,67656904002,-8,3361,15725,-10
67657617668,67657617667,-1,1109,1480,-10
67658282414,67658282414,0,1341,1418,-10
67659388850,67659388854,4,1371,1725,-10
67660712004,67660712006,2,1294,1436,-10
67664268575,67664268578,3,1369,1025,-10
67665580721,67665580727,6,2193,1019,-10
67668471794,67668471795,1,1966,1287,-10
67671121939,67671121942,3,1565,1626,-10
67672637327,67672637331,4,1226,1307,-10
67673247201,67673247201,0,1667,1311,-10
67675463314,67675463314,0,1347,1152,-10
67680228025,67680228021,-4,26996,12052,-10
67681789927,67681789931,4,1551,1491,-10
67682728706,67682728706,0,1631,1581,-10
67686070941,67686070944,3,1377,1810,-10
67688091053,67688091056,3,1933,1655,-10
67689231973,67689231975,2,1512,916,-10
67691588785,67691588789,4,3126,1917,-10
67691678846,67691678849,3,1521,1478,-10
67693120896,67693120898,2,1067,798,-10
67695725115,67695725117,2,1630,2307,-10
67696404557,67696404558,1,1823,1677,-10
67697499118,67697499118,0,1280,1189,-10
67698945277,67698945278,1,2381,2084,-10
67706369224,67706369223,-1,802,1086,-10
67706959057,67706959060,3,1467,1800,-10
67708718473,67708718475,2,1579,1697,-10
67709146749,67709146747,-2,1160,2838,-10
67710516595,67710516597,2,1415,1293,-10
67713694103,67713694103,0,1203,1532,-10
67719756015,67719756018,3,1613,2102,-10
67725067901,67725067903,2,1759,1557,-10
67725686015,67725686017,2,1099,1514,-10
67725987722,67725987723,1,1224,826,-10
67726447833,67726447834,1,1262,1396,-10
67727504974,67727504974,0,1771,1435,-10
67728824979,67728824980,1,1337,1691,-10
67731248049,67731248051,2,1660,1208,-10
67731621995,67731621997,2,2202,2057,-10
67732277990,67732277993,3,1343,1673,-10
67735648728,67735648728,0,1447,1318,-10
67737840720,67737840706,-14,1210,1300,-10
67738341574,67738341577,3,1475,1313,-10
67739152357,67739152359,2,1352,1484,-10
67740218644,67740218646,2,1544,1544,-10
67740515567,67740515569,2,1344,1751,-10
67740659280,67740659283,3,1350,1082,-10
67741337774,67741337777,3,259,743,-10
67741743088,67741743090,2,1681,1495,-10
67741836818,67741836820,2,1468,1708,-10
67741975701,67741975682,-19,1634,1290,-10
67744049288,67744049291,3,958,843,-10
67747360977,67747360978,1,2200,1410,-10
67747507209,67747507211,2,2049,1779,-10
67752095443,67752095445,2,1653,1814,-10
67754072773,67754072774,1,1262,1606,-10
67757623875,67757623878,3,1074,882,-10
67759178514,67759178517,3,1825,1633,-10
67768333053,67768333054,1,1931,1572,-10
67770304377,67770304382,5,1306,1442,-10
67773583187,67773583189,2,2166,2102,-10
67774665597,67774665599,2,1843,1462,-10
67775755526,67775755527,1,1470,1260,-10
67776167961,67776167963,2,1286,1096,-10
67781385113,67781385114,1,1691,1860,-10
67783051247,67783051248,1,1542,1605,-10
67783847185,67783847193,8,2004,1066,-10
67784392927,67784392929,2,1673,1699,-10
67784442022,67784442027,5,2560,2031,-10
67787170976,67787170978,2,2223,1634,-10
67787314426,67787314433,7,1409,1059,-10
67787370559,67787370568,9,2059,1257,-10
67789896433,67789896434,1,1924,2412,-10
67794291297,67794291300,3,2114,2289,-10
67799843286,67799843286,0,1186,2061,-10
67802169005,67802169004,-1,1354,1637,-10
67802263074,67802263076,2,1152,1670,-10
67803846330,67803846330,0,1162,1349,-10
67804138355,67804138355,0,1565,1446,-10
67805495154,67805495155,1,1588,1602,-10
67806837732,67806837733,1,1056,1360,-10
67813070027,67813070029,2,2019,1961,-10
67813710042,67813710044,2,969,1280,-10
67815661886,67815661886,0,2139,1165,-10
67816396789,67816396791,2,1657,1488,-10
67823553078,67823553079,1,1365,1777,-10
67824695641,67824695637,-4,1487,3275,-10
67825072455,67825072457,2,1393,1450,-10
67826621153,67826621154,1,1879,1893,-10
67826790158,67826790162,4,2265,1726,-10
67828885249,67828885251,2,1709,1274,-10
67830115289,67830115290,1,2266,1984,-10
67831555894,67831555897,3,1238,2247,-10
67835960082,67835960083,1,1405,1114,-10
67836679647,67836679650,3,1839,1759,-10
67837205497,67837205499,2,2240,1810,-10
67837721186,67837721187,1,1815,1437,-10
67838225518,67838225522,4,2087,1572,-10
67839718650,67839718652,2,1156,1576,-10
67843390838,67843390840,2,1317,1254,-10
67844691601,67844691602,1,1347,1715,-10
67845664547,67845664547,0,1556,1242,-10
67846812741,67846812743,2,919,855,-10
67849286470,67849286471,1,1343,1713,-10
67850783018,67850783017,-1,1615,1539,-10
67851532782,67851532786,4,1631,1981,-10
67853675366,67853675365,-1,1823,1767,-10
67854578385,67854578387,2,1463,1101,-10
67857448095,67857448097,2,1525,1349,-10
67860480392,67860480395,3,2070,1902,-10
67860610401,67860610404,3,1756,1327,-10
67861852954,67861852956,2,1401,1679,-10
67863013888,67863013892,4,1826,1491,-10
67871055030,67871055032,2,2235,2241,-10
67873495831,67873495832,1,1623,1205,-10
67875289961,67875289962,1,1111,1402,-10
67876277061,67876277062,1,2105,1130,-10
67878270678,67878270679,1,1704,2182,-10
67879722366,67879722373,7,1719,1866,-10
67880093782,67880093768,-14,712,88,-10
67880504290,67880504291,1,1743,1497,-10
67881848273,67881848275,2,1923,1294,-10
67882044254,67882044233,-21,1588,1077,-10
67884802429,67884802429,0,871,1154,-10
67886220354,67886220358,4,1217,1239,-10
67887050572,67887050574,2,1545,1489,-10
67888042449,67888042451,2,1921,1210,-10
67888361631,67888361630,-1,1346,2181,-10
67889440637,67889440638,1,1521,1612,-10
67893406550,67893406551,1,1588,1339,-10
67896286777,67896286777,0,1296,1715,-10
67902228358,67902228359,1,1354,1421,-10
67906337920,67906337919,-1,1596,1867,-10
67911226635,67911226632,-3,2060,3633,-10
67914129937,67914129938,1,1695,1915,-10
67914334206,67914334206,0,1003,1157,-10
67916338470,67916338466,-4,823,1222,-10
67918487523,67918487516,-7,1825,5211,-10
67923891798,67923891802,4,13701,11538,-10
67925020121,67925020123,2,1303,1274,-10
67926167405,67926167407,2,1312,1917,-10
67927220641,67927220631,-10,1348,1669,-10
67933692166,67933692169,3,2002,1742,-10
67937499372,67937499375,3,2093,2063,-10
67940100498,67940100498,0,1516,1434,-10
67940189411,67940189413,2,1233,1501,-10
67941400467,67941400482,15,1471,1295,-10
67943738137,67943738140,3,1260,1299,-10
67946030507,67946030512,5,1755,1475,-10
67946534825,67946534827,2,1512,1187,-10
67948659915,67948659918,3,1580,2107,-10
67948861333,67948861333,0,1312,1688,-10
67953696163,67953696153,-10,1249,990,-10
67961310937,67961310938,1,1177,1000,-10
67961841952,67961841953,1,1716,1611,-10
67962120542,67962120546,4,1531,1641,-10
67962737898,67962737903,5,1096,1127,-10
67964213329,67964213331,2,1526,2405,-10
67964534682,67964534685,3,1433,1552,-10
67966880317,67966880319,2,1583,1946,-10
67967146434,67967146435,1,1300,1738,-10
67970637425,67970637426,1,2732,3279,-10
67974442053,67974442053,0,1434,1521,-10
67977825531,67977825531,0,1558,1367,-10
67978309138,67978309140,2,1423,1936,-10
67979275305,67979275306,1,1211,1873,-10
67982381721,67982381719,-2,1003,1742,-10
67983391279,67983391282,3,1508,1646,-10
67985717661,67985717662,1,1117,1032,-10
67989984746,67989984746,0,1426,1492,-10
67992656865,67992656866,1,1606,1410,-10
67994218502,67994218502,0,1142,1221,-10
67997953181,67997953178,-3,806,1028,-10
68001317915,68001317918,3,1774,1215,-10
68002290845,68002290848,3,1095,1345,-10
68004412357,68004412357,0,2163,1678,-10
68005022957,68005022958,1,1629,1223,-10
68005427525,68005427530,5,2704,1493,-10
68009379519,68009379519,0,1492,1992,-10
68011767706,68011767709,3,1301,1359,-10
68012682306,68012682323,17,1843,1475,-10
68017625432,68017625433,1,1612,1248,-10
68018548652,68018548654,2,1436,1359,-10
68023864207,68023864209,2,1669,2382,-10
68025285666,68025285667,1,879,1834,-10
68025660980,68025660982,2,1361,1079,-10
68026254686,68026254689,3,1240,1601,-10
68027286634,68027286636,2,1045,1946,-10
68030369051,68030369052,1,1290,1298,-10
68031191051,68031191054,3,1201,1521,-10
68032254845,68032254845,0,1469,1955,-10
68034910464,68034910466,2,1572,1035,-10
68036580550,68036580551,1,1364,1364,-10
68037134810,68037134810,0,1201,1196,-10
68038288858,68038288852,-6,1681,8078,-10
68040362766,68040362768,2,2118,1862,-10
68043552328,68043552327,-1,973,1675,-10
68043601039,68043601041,2,1934,1274,-10
68049182515,68049182518,3,1471,1085,-10
68049915206,68049915198,-8,1063,889,-10
68051581050,68051581051,1,1251,1224,-10
68056547498,68056547500,2,1521,1310,-10
68061908481,68061908482,1,1307,1648,-10
68063340775,68063340774,-1,893,2047,-10
68065528413,68065528414,1,1996,1610,-10
68067463530,68067463529,-1,1282,1465,-10
68069717634,68069717635,1,998,1318,-10
68077331551,68077331555,4,1663,1395,-10
68082819394,68082819394,0,1827,1835,-10
68085489613,68085489617,4,1953,1588,-10
68086886211,68086886211,0,1388,1433,-10
68086925940,68086925942,2,1185,1193,-10
68093044416,68093044419,3,1537,1115,-10
68095860881,68095860883,2,1346,1675,-10
68097029969,68097029971,2,1897,1391,-10
68101758919,68101758920,1,1622,2148,-10
68102868739,68102868740,1,1499,1673,-10
68104494911,68104494913,2,1005,907,-10
68105046429,68105046437,8,6048,1126,-10
68107018197,68107018198,1,1170,1187,-10
68109417598,68109417598,0,1506,1218,-10
68110031187,68110031186,-1,1379,1780,-10
68113106321,68113106322,1,1543,1707,-10
68113231046,68113231047,1,1500,1959,-10
68115253022,68115253023,1,1397,1616,-10
68115801439,68115801442,3,1378,1661,-10
68122179438,68122179445,7,2597,1582,-10
68125640558,68125640557,-1,1573,2531,-10
68126419726,68126419729,3,1143,1195,-10
68128552490,68128552493,3,1536,1281,-10
68129013109,68129013107,-2,1214,1030,-10
68131000467,68131000469,2,1872,2116,-10
68133288218,68133288218,0,1545,2085,-10
68134219973,68134219974,1,1673,1812,-10
68136611749,68136611738,-11,1068,1011,-10
68137444734,68137444738,4,1363,1152,-10
68140817456,68140817458,2,2004,1681,-10
68141722978,68141722981,3,1643,1582,-10
68142059022,68142059003,-19,1014,938,-10
68142388283,68142388278,-5,2849,7987,-10
68142507242,68142507245,3,1467,1617,-10
68146292937,68146292941,4,1967,1492,-10
68148413235,68148413239,4,1414,935,-10
68149078734,68149078734,0,2107,3761,-10
68151898021,68151898023,2,1427,1103,-10
68152363526,68152363530,4,1727,1410,-10
68169191295,68169191296,1,875,1190,-10
68173572649,68173572650,1,1185,1552,-10
68179131082,68179131079,-3,1261,2451,-10
68179856613,68179856617,4,1918,1345,-10
68180956439,68180956442,3,1064,993,-10
68181204868,68181204870,2,1667,2137,-10
68184243203,68184243202,-1,1568,1870,-10
68185405997,68185405998,1,1732,2139,-10
68186037146,68186037146,0,1538,1247,-10
68187450358,68187450359,1,1734,1416,-10
68191389635,68191389637,2,1320,1802,-10
68193368451,68193368456,5,2104,1636,-10
68195855099,68195855102,3,1583,1037,-10
68197382941,68197382963,22,2057,1464,-10
68198909682,68198909683,1,2109,1772,-10
68204070038,68204070041,3,1104,932,-10
68206875558,68206875561,3,1085,1077,-10
68210848055,68210848055,0,1585,1312,-10
68211433226,68211433230,4,1219,1417,-10
68212862913,68212862921,8,1320,980,-10
68216096478,68216096482,4,1562,1637,-10
68216374138,68216374140,2,2235,2079,-10
68217018082,68217018078,-4,1387,1677,-10
68222573626,68222573604,-22,1224,1255,-10
68223131454,68223131454,0,1109,889,-10
68226301587,68226301587,0,1896,1707,-10
68228046734,68228046741,7,192,7096,-10
68233290909,68233290911,2,1398,1660,-10
68235680810,68235680810,0,1084,1038,-10
68241932590,68241932591,1,1650,1912,-10
68243146218,68243146223,5,1550,1249,-10
68246139278,68246139280,2,2114,1691,-10
68246264312,68246264314,2,1492,1235,-10
68250718584,68250718586,2,1792,1494,-10
68257236225,68257236226,1,1648,1510,-10
68257801666,68257801670,4,1421,1176,-10
68259351236,68259351238,2,711,1392,-10
68260598673,68260598675,2,2442,2172,-10
68261924774,68261924776,2,1135,1866,-10
68265451480,68265451482,2,1246,1108,-10
68265544000,68265544002,2,986,1673,-10
68266446911,68266446913,2,1859,1601,-10
68268575010,68268575014,4,2177,1814,-10
68269550269,68269550272,3,1551,1942,-10
68273266370,68273266375,5,1108,881,-10
68273997810,68273997811,1,1454,1339,-10
68278405625,68278405626,1,1607,1601,-10
68279480305,68279480298,-7,1653,3984,-10
68279954554,68279954555,1,1814,1889,-10
68282559065,68282559064,-1,1011,1552,-10
68285405817,68285405821,4,1990,1765,-10
68294889126,68294889130,4,1649,1510,-10
68296687059,68296687061,2,2048,1673,-10
68301802930,68301802935,5,1112,947,-10
68303200847,68303200849,2,1133,1493,-10
68304838542,68304838543,1,980,974,-10
68304983476,68304983476,0,1469,1808,-10
68309105415,68309105415,0,1414,1379,-10
68310261437,68310261438,1,1373,1473,-10
68310888848,68310888848,0,1655,1687,-10
68312984559,68312984559,0,1064,1521,-10
68313381194,68313381195,1,1283,1165,-10
68321592966,68321592970,4,1864,1442,-10
68325126468,68325126471,3,2980,2827,-10
68335234902,68335234903,1,1441,1376,-10
68336285490,68336285489,-1,1500,1904,-10
68337980304,68337980306,2,1167,1793,-10
68339260581,68339260581,0,2122,1829,-10
68340203682,68340203683,1,1570,1568,-10
68342029481,68342029482,1,1389,1755,-10
68342351911,68342351910,-1,1506,1689,-10
68344277960,68344277963,3,1810,1492,-10
68345580776,68345580777,1,1514,1633,-10
68350444572,68350444573,1,1328,1304,-10
68351762050,68351762055,5,2034,1092,-10
68354966041,68354966046,5,1974,1574,-10
68355001845,68355001827,-18,658,105,-10
68361725529,68361725529,0,1187,1460,-10
68361840598,68361840598,0,1321,1505,-10
68362296911,68362296913,2,943,2030,-10
68363942044,68363942050,6,2883,1507,-10
68364006878,68364006882,4,1598,1886,-10
68365240119,68365240122,3,1694,1739,-10
68368079911,68368079914,3,1914,1772,-10
68375966363,68375966371,8,1806,1218,-10
68376011642,68376011644,2,1433,1684,-10
68377137939,68377137942,3,1936,1488,-10
68381913303,68381913306,3,1707,1416,-10
68382381979,68382381982,3,2012,1596,-10
68386109786,68386109789,3,1975,1518,-10
68388863051,68388863054,3,807,1241,-10
68390673833,68390673828,-5,1150,2808,-10
68396171921,68396171927,6,3827,2041,-10
68397206301,68397206303,2,1953,2353,-10
68399265155,68399265155,0,1778,1610,-10
68401416821,68401416818,-3,682,2541,-10
68401570823,68401570827,4,1522,1271,-10
68402586900,68402586900,0,1703,1747,-10
68403390798,68403390799,1,1149,1284,-10
68404846214,68404846215,1,1510,1466,-10
68406243417,68406243437,20,1745,1915,-10
68413226599,68413226598,-1,1286,1209,-10
68414126196,68414126197,1,1498,1486,-10
68417493100,68417493102,2,1619,873,-10
68420430551,68420430554,3,1600,1323,-10
68424220054,68424220053,-1,3116,6232,-10
68424655494,68424655497,3,1718,1649,-10
68425010748,68425010750,2,1826,1552,-10
68427712675,68427712678,3,1661,962,-10
68428747379,68428747381,2,1607,1721,-10
68428791199,68428791198,-1,996,1814,-10
68433795698,68433795699,1,2054,1540,-10
68442533558,68442533562,4,2229,1501,-10
68445348198,68445348197,-1,1535,2333,-10
68446238226,68446238228,2,1816,1579,-10
68449033297,68449033298,1,1000,1379,-10
68450866286,68450866290,4,1312,1338,-10
68453942063,68453942066,3,1052,1686,-10
68455587902,68455587902,0,1550,1632,-10
68458056518,68458056518,0,1191,1425,-10
68458818219,68458818223,4,1690,1025,-10
68460216552,68460216556,4,1606,1268,-10
68463335629,68463335631,2,1458,1503,-10
68465915942,68465915945,3,1247,1357,-10
68467255245,68467255245,0,1725,1394,-10
68468738933,68468738935,2,2130,1649,-10
68471024028,68471024030,2,1260,1275,-10
68471634759,68471634762,3,1567,1063,-10
68471682938,68471682940,2,1888,1500,-10
68478028441,68478028441,0,1824,1837,-10
68481518711,68481518712,1,1418,1895,-10
68482233502,68482233502,0,1787,1824,-10
68483172791,68483172793,2,1562,1225,-10
68484183445,68484183445,0,1341,1256,-10
68485352797,68485352798,1,1561,1277,-10
68488075582,68488075587,5,1393,1360,-10
68489290076,68489290079,3,1087,1406,-10
68496280360,68496280362,2,1628,1247,-10
68498065889,68498065890,1,970,1095,-10
68500187009,68500187014,5,1419,1196,-10
68500824882,68500824883,1,1567,1569,-10
68500966937,68500966939,2,1395,1416,-10
68504508266,68504508267,1,1858,1382,-10
68505529702,68505529703,1,1136,1561,-10
68508180666,68508180670,4,1647,1613,-10
68513826083,68513826087,4,1168,1107,-10
68514029440,68514029441,1,23259,18392,-10
68514457545,68514457544,-1,1840,1517,-10
68515025703,68515025704,1,1084,1468,-10
68515101789,68515101788,-1,1268,1148,-10
68518515546,68518515549,3,1900,2003,-10
68521785806,68521785809,3,1390,1408,-10
68523339409,68523339413,4,1513,1332,-10
68525062679,68525062678,-1,1068,1728,-10
68534195313,68534195315,2,2216,1821,-10
68536285199,68536285203,4,1895,1753,-10
68537924363,68537924366,3,1565,1555,-10
68539714881,68539714882,1,847,772,-10
68540370863,68540370866,3,2100,1730,-10
68545616881,68545616882,1,1016,870,-10
68547752178,68547752179,1,1727,1546,-10
68548295334,68548295335,1,1212,1747,-10
68549248754,68549248756,2,1859,2097,-10
68549859464,68549859467,3,1644,1892,-10
68551626447,68551626447,0,1943,1692,-10
68552608730,68552608730,0,1252,1182,-10
68555699659,68555699663,4,1269,1060,-10
68556069531,68556069532,1,1139,1693,-10
68556668919,68556668921,2,1114,1222,-10
68557040967,68557040966,-1,1177,1783,-10
68557067543,68557067545,2,1144,930,-10
68558692369,68558692373,4,1867,1785,-10
68562798558,68562798559,1,1870,1907,-10
68564222481,68564222482,1,1871,1972,-10
68564660618,68564660619,1,1370,1587,-10
68565557617,68565557622,5,1510,1780,-10
68574034912,68574034914,2,1850,2018,-10
68585370153,68585370154,1,1398,1305,-10
68586525580,68586525581,1,1948,2099,-10
68588469982,68588469981,-1,1556,3215,-10
68589651201,68589651202,1,1188,1424,-10
68592398522,68592398523,1,1756,1522,-10
68592663427,68592663434,7,4759,1926,-10
68593029222,68593029225,3,989,1375,-10
68598014518,68598014520,2,1222,1797,-10
68598623874,68598623875,1,1930,1950,-10
68600335253,68600335254,1,1438,1245,-10
68600851074,68600851078,4,1219,1679,-10
68602489542,68602489543,1,1505,1554,-10
68602748361,68602748362,1,1807,1949,-10
68604130019,68604130022,3,1941,1330,-10
68604821210,68604821193,-17,31628,46276,-10
68605397576,68605397578,2,1050,1050,-10
68606099169,68606099148,-21,1298,3845,-10
68610759849,68610759849,0,1461,1099,-10
68613415318,68613415318,0,1184,1228,-10
68614761562,68614761562,0,1763,2014,-10
68617257770,68617257771,1,1838,1988,-10
68617308675,68617308674,-1,1305,2209,-10
68623200746,68623200747,1,1510,1836,-10
68623676943,68623676943,0,970,1703,-10
68626547394,68626547395,1,1304,1208,-10
68627254381,68627254362,-19,2086,1575,-10
68632796257,68632796257,0,1700,1545,-10
68633921423,68633921403,-20,1241,1319,-10
68637039061,68637039067,6,1845,1312,-10
68638477220,68638477222,2,1316,1387,-10
68641315768,68641315767,-1,1509,2160,-10
68642481564,68642481563,-1,1618,2699,-10
68643537325,68643537326,1,1700,1987,-10
68644475038,68644475042,4,2178,2052,-10
68645871126,68645871125,-1,13758,18228,-10
68646005222,68646005203,-19,1252,1163,-10
68647494236,68647494250,14,16113,6578,-10
68649659875,68649659879,4,1716,1198,-10
68649873883,68649873881,-2,927,1749,-10
68656568685,68656568686,1,1622,1539,-10
68659569801,68659569805,4,1928,1557,-10
68660857196,68660857195,-1,980,1288,-10
68661391738,68661391741,3,1245,1446,-10
68662681349,68662681330,-19,1849,2410,-10
68663065191,68663065194,3,1871,2164,-10
68663854751,68663854753,2,1201,1581,-10
68664246143,68664246124,-19,1064,682,-10
68667839690,68667839685,-5,1669,1197,-10
68668916921,68668916923,2,1418,1616,-10
68670981505,68670981510,5,1290,1256,-10
68672346947,68672346949,2,1748,1126,-10
68672545518,68672545500,-18,1764,1247,-10
68672920921,68672920922,1,1425,1573,-10
68677502344,68677502346,2,1066,1697,-10
68678340615,68678340619,4,847,598,-10
68679212491,68679212495,4,953,1264,-10
68680631031,68680631033,2,1398,1453,-10
68682205874,68682205875,1,1607,1422,-10
68683344606,68683344611,5,1604,1384,-10
68684044604,68684044605,1,1398,1551,-10
68684156430,68684156435,5,1509,669,-10
68688291493,68688291486,-7,1753,4810,-10
68689999252,68689999251,-1,820,1318,-10
68690796871,68690796871,0,1309,1559,-10
68691802063,68691802066,3,1754,1690,-10
68692038906,68692038907,1,1770,1808,-10
68694355443,68694355446,3,1531,1667,-10
68695549344,68695549346,2,1531,1067,-10
68698282279,68698282279,0,1431,1511,-10
68708601265,68708601269,4,1714,1396,-10
68709607895,68709607898,3,1196,1018,-10
68712990511,68712990512,1,1236,2163,-10
68716480831,68716480833,2,1583,1694,-10
68718993103,68718993103,0,1722,1958,-10
68719364187,68719364187,0,1657,2225,-10
68722739994,68722739998,4,1068,1497,-10
68723153442,68723153445,3,1910,1859,-10
68724072311,68724072314,3,1144,1347,-10
68727439729,68727439729,0,1630,1617,-10
68731523042,68731523042,0,1311,2271,-10
68732163583,68732163586,3,1821,1475,-10
68733198997,68733198999,2,1095,752,-10
68738522354,68738522358,4,1477,2060,-10
68740280562,68740280565,3,1120,1556,-10
68741381756,68741381758,2,1245,1314,-10
68742609819,68742609806,-13,10220,40133,-10
68743125673,68743125679,6,1374,1255,-10
68743800731,68743800732,1,2377,2575,-10
68744687104,68744687106,2,893,1045,-10
68746311549,68746311551,2,1457,1457,-10
68746469058,68746469074,16,787,4716,-10
68746543379,68746543382,3,1785,1781,-10
68750035002,68750035006,4,2234,1676,-10
68753811129,68753811130,1,1573,1022,-10
68758703755,68758703756,1,1813,1363,-10
68761240517,68761240517,0,754,1469,-10
68765818624,68765818617,-7,1742,9697,-10
68766085722,68766085725,3,1524,1315,-10
68772258512,68772258512,0,1055,1238,-10
68775602917,68775602918,1,1085,1755,-10
68777177647,68777177646,-1,1841,2058,-10
68781214199,68781214201,2,1540,1571,-10
68782096393,68782096395,2,1262,993,-10
68782986694,68782986697,3,1746,1547,-10
68786908237,68786908238,1,1244,1092,-10
68788081209,68788081211,2,2305,2261,-10
68789435320,68789435322,2,1944,1628,-10
68791057787,68791057782,-5,1631,4888,-10
68791335835,68791335838,3,1329,1842,-10
68794316454,68794316457,3,1627,1350,-10
68797195841,68797195841,0,1999,2658,-10
68801863931,68801863933,2,1355,1774,-10
68801971793,68801971796,3,1449,1919,-10
68803200839,68803200841,2,1730,2179,-10
68808457824,68808457825,1,1460,2161,-10
68816849062,68816849066,4,1957,1787,-10
68816881973,68816881975,2,1863,1746,-10
68822295629,68822295635,6,1986,1112,-10
68822441526,68822441531,5,1289,1081,-10
68822874138,68822874138,0,1247,2060,-10
68823410024,68823410030,6,4750,1486,-10
68823686394,68823686395,1,1116,1209,-10
68826290867,68826290869,2,1834,1603,-10
68826398113,68826398115,2,1438,1607,-10
68827593347,68827593351,4,1473,1013,-10
68828494774,68828494777,3,34106,30500,-10
68828753901,68828753902,1,952,1099,-10
68837293608,68837293602,-6,1243,4968,-10
68840068484,68840068493,9,412,1649,-10
68841230310,68841230309,-1,1564,1651,-10
68841942494,68841942491,-3,683,1582,-10
68842156569,68842156569,0,1709,1912,-10
68843006627,68843006622,-5,1185,3328,-10
68846834134,68846834136,2,2638,1906,-10
68849175338,68849175339,1,1269,1342,-10
68851041167,68851041168,1,1376,1567,-10
68852418355,68852418360,5,2240,1712,-10
68856066607,68856066609,2,2273,1899,-10
68856496636,68856496637,1,2193,1724,-10
68859268770,68859268770,0,1395,1433,-10
68866081930,68866081931,1,1499,2103,-10
68867209862,68867209864,2,1912,1972,-10
68867363147,68867363150,3,1596,1415,-10
68867933207,68867933210,3,1262,1494,-10
68867980049,68867980035,-14,1287,649,-10
68868385774,68868385774,0,1475,1597,-10
68871948115,68871948118,3,1152,892,-10
68878521433,68878521435,2,1733,1284,-10
68879918518,68879918520,2,1902,1734,-10
68881780856,68881780859,3,1361,1186,-10
68882712466,68882712470,4,2100,1587,-10
68883767331,68883767333,2,1517,1175,-10
68883917781,68883917782,1,1583,2310,-10
68887309281,68887309284,3,1431,1753,-10
68889022362,68889022364,2,2316,2146,-10
68896590637,68896590639,2,1495,1329,-10
68900409783,68900409785,2,1321,1291,-10
68901417805,68901417809,4,1066,1061,-10
68903232088,68903232089,1,1420,1587,-10
68903790642,68903790645,3,1663,1579,-10
68905207853,68905207854,1,1664,2193,-10
68906124447,68906124450,3,1227,1382,-10
68909443118,68909443119,1,936,1723,-10
68911128106,68911128107,1,972,1520,-10
68911244720,68911244719,-1,835,1285,-10
68912510809,68912510809,0,1500,1698,-10
68914531530,68914531533,3,1992,1315,-10
68916667672,68916667674,2,1744,1441,-10
68918278270,68918278273,3,1700,1718,-10
68918454206,68918454210,4,1136,1258,-10
68919318283,68919318285,2,1171,1361,-10
68925606596,68925606598,2,1728,2115,-10
68928764262,68928764263,1,1751,1703,-10
68930064490,68930064491,1,1184,1786,-10
68933690070,68933690072,2,1253,1009,-10
68935337633,68935337634,1,2409,1557,-10
68936203612,68936203613,1,2801,2585,-10
68940974686,68940974690,4,1627,1555,-10
68942365521,68942365525,4,1838,1339,-10
68942609807,68942609809,2,1772,1459,-10
68942836281,68942836274,-7,1022,4184,-10
68944503554,68944503555,1,2213,2174,-10
68947465127,68947465131,4,1431,1861,-10
68951004181,68951004187,6,1553,1417,-10
68951107350,68951107337,-13,1513,1383,-10
68952018179,68952018176,-3,1306,3473,-10
68953083026,68953083028,2,1918,1639,-10
68953182283,68953182280,-3,909,2571,-10
68955852647,68955852651,4,1845,1293,-10
68956346082,68956346082,0,1395,2517,-10
68966051749,68966051749,0,2108,1979,-10
68966704650,68966704652,2,1959,2302,-10
68972971310,68972971311,1,1418,1928,-10
68974070314,68974070314,0,1499,2202,-10
68974319984,68974319987,3,1848,1142,-10
68974531072,68974531075,3,13449,11387,-10
68974876801,68974876809,8,9946,1660,-10
68975079330,68975079333,3,1607,1354,-10
68975515949,68975515953,4,4456,3291,-10
68976461919,68976461899,-20,1520,1121,-10
68977684797,68977684798,1,1995,1242,-10
68978459190,68978459193,3,1252,1621,-10
68982720514,68982720514,0,1648,2164,-10
68984173225,68984173227,2,1220,1167,-10
68986372771,68986372775,4,1624,1287,-10
68987084034,68987084035,1,1389,1191,-10
68987468976,68987468979,3,1355,1117,-10
68993933453,68993933456,3,3099,1786,-10
68996356477,68996356478,1,1899,1592,-10
68998548331,68998548334,3,826,929,-10
69001661159,69001661161,2,1252,1033,-10
69005413917,69005413921,4,1848,1668,-10
69011116413,69011116414,1,1799,2087,-10
69012578195,69012578197,2,1322,1043,-10
69013497426,69013497428,2,1467,1257,-10
69014532653,69014532656,3,2141,1761,-10
69015317791,69015317771,-20,1404,1194,-10
69015684427,69015684414,-13,1308,1506,-10
69017604526,69017604529,3,1799,1564,-10
69020358102,69020358109,7,2539,1835,-10
69022063943,69022063945,2,946,881,-10
69022661963,69022661962,-1,2093,2163,-10
69023037669,69023037669,0,892,1545,-10
69023615753,69023615743,-10,1031,1136,-10
69026175207,69026175211,4,1754,1176,-10
69029100786,69029100785,-1,1197,1722,-10
69029328968,69029328970,2,1256,1409,-10
69032612088,69032612090,2,1585,2223,-10
69033094133,69033094135,2,1531,1227,-10
69033241191,69033241193,2,1829,1484,-10
69036711104,69036711105,1,1266,1787,-10
69039130110,69039130110,0,1588,1518,-10
69044636494,69044636497,3,1393,1725,-10
69048321866,69048321870,4,1206,1534,-10
69049477930,69049477931,1,1853,1900,-10
69053732854,69053732855,1,1672,1261,-10
69054922474,69054922477,3,2529,1456,-10
69058907175,69058907176,1,2248,1968,-10
69059118187,69059118189,2,1272,1559,-10
69060710138,69060710137,-1,1666,2145,-10
69062443542,69062443545,3,1983,1359,-10
69063879299,69063879297,-2,1090,1391,-10
69064646420,69064646421,1,1563,1467,-10
69066400702,69066400704,2,2007,1523,-10
69067200174,69067200175,1,1513,1456,-10
69068101425,69068101440,15,1229,1459,-10
69069645311,69069645313,2,1747,1983,-10
69069743583,69069743586,3,636,881,-10
69078013301,69078013303,2,1362,1353,-10
69078301685,69078301687,2,1514,1420,-10
69079759775,69079759777,2,1593,1496,-10
69084346489,69084346490,1,1526,1308,-10
69084732984,69084732985,1,1314,1192,-10
69085023508,69085023511,3,2395,1783,-10
69085649673,69085649675,2,2004,1766,-10
69086024480,69086024479,-1,18367,13271,-10
69088031827,69088031830,3,937,1102,-10
69099935922,69099935925,3,1906,1688,-10
69101393303,69101393308,5,1657,2022,-10
69103128690,69103128689,-1,648,1554,-10
69105667577,69105667579,2,2226,1771,-10
69106589006,69106589009,3,2527,1301,-10
69108968085,69108968089,4,1473,1294,-10
69109214647,69109214648,1,939,1226,-10
69109834736,69109834735,-1,1316,2111,-10
69111530068,69111530086,18,21,609,-10
69114773343,69114773347,4,2266,1453,-10
69116684428,69116684430,2,1531,1543,-10
69121296569,69121296569,0,1719,1292,-10
69123844462,69123844466,4,1667,1841,-10
69124204403,69124204406,3,1707,1740,-10
69124983435,69124983434,-1,1182,2043,-10
69126001606,69126001609,3,1903,1529,-10
69127072795,69127072787,-8,1122,4747,-10
69128147805,69128147806,1,1587,1274,-10
69134277650,69134277652,2,1932,2045,-10
69134551098,69134551099,1,1871,1844,-10
69135234164,69135234165,1,2375,2317,-10
69135384146,69135384147,1,1605,1183,-10
69135591021,69135591022,1,1473,1413,-10
69135618074,69135618074,0,1541,1138,-10
69137684102,69137684102,0,2362,1971,-10
69139374922,69139374926,4,2265,1743,-10
69144486827,69144486830,3,1279,1393,-10
69145607958,69145607960,2,892,1847,-10
69146510290,69146510294,4,1710,1930,-10
69147796518,69147796519,1,1518,1376,-10
69154677406,69154677408,2,1444,1673,-10
69158464220,69158464222,2,1471,1956,-10
69159689323,69159689323,0,1437,1047,-10
69160635670,69160635673,3,1587,1964,-10
69167768118,69167768118,0,1382,1383,-10
69168689594,69168689599,5,1429,1432,-10
69170747271,69170747273,2,1336,1292,-10
69172085418,69172085418,0,843,800,-10
69173518367,69173518368,1,1258,1364,-10
69176482745,69176482747,2,1471,1281,-10
69177177343,69177177342,-1,1303,998,-10
69178287994,69178287998,4,1562,1441,-10
69178617063,69178617063,0,1645,1661,-10
69180996147,69180996150,3,1741,1504,-10
69186061690,69186061695,5,1257,741,-10
69187381768,69187381771,3,2030,2076,-10
69188301312,69188301315,3,1684,1289,-10
69188622574,69188622581,7,2311,1202,-10
69189228930,69189228925,-5,1349,4314,-10
69189893562,69189893574,12,303,1131,-10
69192355470,69192355467,-3,901,1996,-10
69192675839,69192675840,1,1337,1855,-10
69200892304,69200892299,-5,1980,7102,-10
69201821015,69201821018,3,1272,1391,-10
69203083432,69203083434,2,2625,2275,-10
69203647461,69203647462,1,1633,2062,-10
69205208888,69205208889,1,1482,1667,-10
69208508890,69208508892,2,2252,1777,-10
69213679424,69213679434,10,1228,1304,-10
69213831681,69213831683,2,1441,1423,-10
69214053652,69214053654,2,1856,1789,-10
69215789850,69215789850,0,1796,1342,-10
69218970750,69218970751,1,1363,1456,-10
69220330429,69220330432,3,1799,1512,-10
69220759678,69220759682,4,1496,1300,-10
69224690002,69224690001,-1,1094,2947,-10
69225945321,69225945322,1,997,1384,-10
69226655146,69226655147,1,1021,1245,-10
69229028876,69229028877,1,1891,2077,-10
69229912246,69229912249,3,1715,1749,-10
69233001656,69233001659,3,900,880,-10
69239210045,69239210047,2,1211,1536,-10
69239437536,69239437530,-6,1341,1356,-10
69241604198,69241604200,2,1291,1132,-10
69244446509,69244446510,1,1530,1650,-10
69247871545,69247871542,-3,31493,72297,-10
69249130735,69249130737,2,1919,1884,-10
69255248781,69255248783,2,1509,1715,-10
69257459849,69257459846,-3,1485,3256,-10
69260130157,69260130161,4,1692,1357,-10
69264727352,69264727349,-3,32405,14476,-10
69267051833,69267051837,4,1080,1193,-10
69271872903,69271872906,3,1436,1541,-10
69273947307,69273947310,3,1633,1712,-10
69275121406,69275121408,2,1559,1605,-10
69275170358,69275170362,4,1917,1509,-10
69278569436,69278569438,2,1810,1427,-10
69281091115,69281091114,-1,2087,2931,-10
69284228937,69284228938,1,1321,1073,-10
69287436195,69287436194,-1,1108,1809,-10
69291206870,69291206873,3,2225,1547,-10
69291759719,69291759726,7,2763,1081,-10
69292325517,69292325517,0,1233,1446,-10
69299276262,69299276265,3,2161,1404,-10
69304403146,69304403149,3,1776,2248,-10
69305016202,69305016204,2,1382,1206,-10
69305966135,69305966144,9,1218,1422,-10
69306189724,69306189704,-20,2233,1815,-10
69307189911,69307189910,-1,2053,1854,-10
69310254309,69310254309,0,1845,1586,-10
69315016771,69315016772,1,1198,1521,-10
69315298170,69315298170,0,1575,1434,-10
69315696350,69315696350,0,1490,1316,-10
69317463914,69317463917,3,2152,2116,-10
69321735965,69321735966,1,1843,2120,-10
69321864445,69321864445,0,1453,1599,-10
69322641272,69322641274,2,1932,1378,-10
69325187078,69325187079,1,1748,1436,-10
69326838666,69326838667,1,1415,964,-10
69328186278,69328186279,1,1846,2129,-10
69329623653,69329623653,0,2295,1987,-10
69330230526,69330230528,2,1419,1361,-10
69331229494,69331229497,3,1476,1413,-10
69332423083,69332423086,3,1506,1356,-10
69332576509,69332576509,0,20250,11748,-10
69335005819,69335005822,3,1367,2035,-10
69336680044,69336680046,2,1226,1951,-10
69336858051,69336858049,-2,1286,1828,-10
69337824017,69337824018,1,2325,1983,-10
69342878341,69342878342,1,949,1319,-10
69345545179,69345545183,4,1919,1540,-10
69347122498,69347122499,1,1786,1544,-10
69351819014,69351819012,-2,1474,2082,-10
69352547719,69352547722,3,1185,1056,-10
69357915203,69357915206,3,1645,1747,-10
69367000602,69367000602,0,1460,2050,-10
69374523159,69374523162,3,926,1087,-10
69381548914,69381548915,1,1115,1342,-10
69386405371,69386405373,2,1747,2463,-10
69391466192,69391466203,11,11416,24335,-10
69393653610,69393653611,1,1351,1428,-10
69396198905,69396198906,1,1649,2136,-10
69397395558,69397395559,1,1263,1565,-10
69397539724,69397539710,-14,1670,1522,-10
69398785394,69398785395,1,693,1029,-10
69399875325,69399875326,1,1211,1498,-10
69400586225,69400586221,-4,2813,4741,-10
69400978518,69400978526,8,2719,964,-10
69402656668,69402656674,6,2863,1234,-10
69404655493,69404655499,6,2113,1070,-10
69407805669,69407805671,2,1831,2415,-10
69410878813,69410878815,2,1377,1348,-10
69413712739,69413712743,4,1268,1062,-10
69414104547,69414104549,2,2648,1961,-10
69414672871,69414672871,0,1558,1240,-10
69414951426,69414951430,4,2065,1524,-10
69416694533,69416694535,2,1094,1151,-10
69418599868,69418599867,-1,1705,1724,-10
69420153583,69420153586,3,1696,1574,-10
69420431883,69420431868,-15,1377,943,-10
69423079882,69423079884,2,1671,1912,-10
69424220267,69424220269,2,1778,1734,-10
69424390455,69424390458,3,1230,1177,-10
69429721557,69429721557,0,1358,947,-10
69436203094,69436203094,0,738,1223,-10
69438137066,69438137070,4,1424,1334,-10
69439111183,69439111185,2,1182,1375,-10
69439738427,69439738429,2,1658,1719,-10
69441478461,69441478463,2,1576,1445,-10
69441981392,69441981394,2,1642,1434,-10
69447525969,69447525969,0,919,1323,-10
69449292499,69449292501,2,1472,2181,-10
69449603125,69449603126,1,1507,1360,-10
69450559778,69450559783,5,7432,28957,-10
69451817169,69451817171,2,1317,1568,-10
69453832114,69453832115,1,2042,2215,-10
69454319805,69454319807,2,1478,1823,-10
69454420154,69454420155,1,857,875,-10
69458229725,69458229747,22,1204,3490,-10
69466007603,69466007605,2,1442,1495,-10
69467758843,69467758846,3,1567,1532,-10
69467924855,69467924859,4,1626,1908,-10
69472936433,69472936435,2,1554,1581,-10
69474224709,69474224709,0,1089,1520,-10
69474905602,69474905599,-3,1551,1868,-10
69478168441,69478168462,21,842,1042,-10
69480969885,69480969887,2,1936,2252,-10
69482612071,69482612074,3,1210,1531,-10
69482644342,69482644354,12,1580,1334,-10
69482913497,69482913502,5,1624,1229,-10
69484625702,69484625705,3,1611,2102,-10
69485009306,69485009305,-1,1748,1791,-10
69486789929,69486789931,2,1982,1770,-10
69486878594,69486878599,5,1842,1865,-10
69489335112,69489335106,-6,2370,9254,-10
69490256718,69490256718,0,1877,1983,-10
69491768840,69491768841,1,1081,1303,-10
69494415322,69494415326,4,2343,1449,-10
69494569244,69494569245,1,1331,1946,-10
69496355039,69496355037,-2,796,1606,-10
69497345037,69497345041,4,1698,1290,-10
69498608746,69498608750,4,1471,1329,-10
69502671081,69502671083,2,1817,1799,-10
69503103345,69503103345,0,1495,1866,-10
69503722599,69503722598,-1,1756,1382,-10
69507835207,69507835208,1,1957,1983,-10
69507898062,69507898063,1,1832,2312,-10
69511040533,69511040535,2,1206,1240,-10
69515686379,69515686378,-1,1996,4431,-10
69515841360,69515841363,3,2007,1130,-10
69520558214,69520558215,1,1244,1795,-10
69521119330,69521119331,1,1132,1257,-10
69522493777,69522493779,2,1635,1313,-10
69522603977,69522603983,6,3479,1406,-10
69524299677,69524299679,2,1818,1392,-10
69525342648,69525342654,6,3168,1670,-10
69525433601,69525433603,2,2094,2017,-10
69526002320,69526002322,2,1820,1249,-10
69526798086,69526798090,4,1953,1690,-10
69529669064,69529669066,2,1432,1834,-10
69529835242,69529835246,4,1818,1435,-10
69531450198,69531450202,4,1403,1528,-10
69532270355,69532270358,3,1587,1254,-10
69532883993,69532883994,1,1500,1400,-10
69537414329,69537414330,1,1772,1543,-10
69539812156,69539812158,2,1904,1853,-10
69542389847,69542389847,0,1450,1832,-10
69542521722,69542521706,-16,2245,1710,-10
69550728778,69550728779,1,1581,1505,-10
69552414313,69552414313,0,1306,1632,-10
69552717994,69552717998,4,1606,1724,-10
69555521237,69555521242,5,2188,1717,-10
69557359802,69557359802,0,1175,2082,-10
69557458374,69557458377,3,1447,1293,-10
69558285544,69558285548,4,2242,1970,-10
69558493450,69558493451,1,1454,1272,-10
69561714447,69561714448,1,1324,1403,-10
69562246663,69562246666,3,1957,1593,-10
69562519111,69562519113,2,2444,2044,-10
69564575474,69564575475,1,1219,1447,-10
69564930342,69564930362,20,1673,2028,-10
69566177870,69566177870,0,1138,1769,-10
69566565354,69566565357,3,2100,1732,-10
69567632349,69567632351,2,968,1119,-10
69569198021,69569198022,1,1859,2469,-10
69574110939,69574110941,2,1473,1170,-10
69575316845,69575316849,4,1014,1903,-10
69576216551,69576216531,-20,698,540,-10
69582484678,69582484680,2,1605,1661,-10
69584820346,69584820349,3,2017,1239,-10
69585371070,69585371072,2,8935,8570,-10
69585541693,69585541694,1,1953,1825,-10
69587411697,69587411699,2,2053,1748,-10
69588001142,69588001143,1,1927,1441,-10
69588132861,69588132862,1,1830,2206,-10
69591025363,69591025365,2,1727,1239,-10
69591557165,69591557173,8,9793,2102,-10
69591690069,69591690070,1,1553,1791,-10
69592351422,69592351424,2,1530,1320,-10
69593963387,69593963389,2,1681,1678,-10
69594092396,69594092397,1,1873,1761,-10
69594147887,69594147906,19,1896,1502,-10
69597633205,69597633206,1,1870,2355,-10
69599877999,69599878001,2,1103,1182,-10
69600159138,69600159138,0,1624,1730,-10
69603042778,69603042779,1,854,713,-10
69607690606,69607690614,8,10887,34840,-10
69608580991,69608580992,1,2647,2054,-10
69610003262,69610003265,3,1793,1995,-10
69611644930,69611644931,1,1594,1651,-10
69612037815,69612037816,1,1142,1549,-10
69612484652,69612484658,6,3901,1912,-10
69612623835,69612623838,3,2245,1722,-10
69613123286,69613123288,2,1311,1441,-10
69614758594,69614758594,0,1359,1370,-10
69614828174,69614828174,0,1099,1062,-10
69616470457,69616470461,4,2395,1501,-10
69616858442,69616858442,0,1638,1753,-10
69622387466,69622387468,2,1775,1659,-10
69624224290,69624224292,2,2047,1900,-10
69627792711,69627792713,2,1198,1690,-10
69630912937,69630912945,8,1454,1484,-10
69631356487,69631356487,0,1647,1520,-10
69632752170,69632752173,3,1522,1545,-10
69634330851,69634330854,3,9750,6510,-10
69636003727,69636003730,3,1012,1360,-10
69638723989,69638723990,1,1301,1529,-10
69641202491,69641202498,7,10122,25327,-10
69642102715,69642102715,0,1103,1283,-10
69644827578,69644827579,1,937,1066,-10
69646304166,69646304167,1,1808,2157,-10
69653581583,69653581584,1,1306,1410,-10
69653736039,69653736041,2,1087,1462,-10
69655519624,69655519626,2,1437,1529,-10
69656000802,69656000806,4,1973,1326,-10
69657820222,69657820222,0,1619,1796,-10
69659420613,69659420614,1,1299,1548,-10
69660770118,69660770114,-4,6627,12801,-10
69661902991,69661902994,3,1259,1472,-10
69662853602,69662853603,1,1814,1583,-10
69670134579,69670134581,2,1682,2026,-10
69673738574,69673738575,1,1668,1701,-10
69674796839,69674796841,2,2165,1709,-10
69674867203,69674867198,-5,496,1067,-10
69680198255,69680198256,1,1281,1309,-10
69683458817,69683458818,1,1633,1211,-10
69687609053,69687609053,0,1906,1452,-10
69691593974,69691593975,1,2075,2052,-10
69693000890,69693000894,4,2082,1984,-10
69693501185,69693501190,5,2013,889,-10
69693885755,69693885758,3,1045,1345,-10
69697014477,69697014477,0,1929,1583,-10
69699746894,69699746896,2,1416,1666,-10
69701578416,69701578415,-1,1288,1612,-10
69702182732,69702182731,-1,1539,1958,-10
69702840026,69702840030,4,1165,1701,-10
69705109485,69705109486,1,1385,1885,-10
69707398357,69707398360,3,2425,1781,-10
69708943821,69708943822,1,1339,1246,-10
69711361958,69711361958,0,1741,1676,-10
69713468957,69713468958,1,1586,1517,-10
69713635547,69713635548,1,1341,1750,-10
69716961729,69716961733,4,6506,32775,-10
69717695265,69717695270,5,1936,1263,-10
69722206083,69722206086,3,1258,1733,-10
69723800336,69723800339,3,1612,1500,-10
69725300222,69725300222,0,1517,1226,-10
69729634981,69729634985,4,1653,1595,-10
69744957486,69744957487,1,1557,1492,-10
69746247942,69746247942,0,1581,1614,-10
69748754276,69748754278,2,1405,1408,-10
69751296072,69751296075,3,1796,1265,-10
69754508045,69754508047,2,1442,1406,-10
69759176326,69759176326,0,1472,1627,-10
69760558979,69760558973,-6,1701,6946,-10
69763061438,69763061440,2,2345,1721,-10
69775410109,69775410113,4,1416,1463,-10
69775532445,69775532448,3,1702,1237,-10
69777331009,69777331009,0,1493,1641,-10
69779527878,69779527879,1,1841,1426,-10
69779712258,69779712266,8,1095,1305,-10
69780858005,69780858010,5,11293,5985,-10
69790974854,69790974854,0,639,702,-10
69791854849,69791854850,1,2076,1657,-10
69792511311,69792511313,2,1500,1589,-10
69793146334,69793146334,0,1237,1867,-10
69797947024,69797947026,2,1036,1089,-10
69799173530,69799173531,1,1380,1324,-10
69801157737,69801157739,2,1199,1618,-10
69801523441,69801523443,2,1388,1418,-10
69802175848,69802175851,3,1847,1614,-10
69807133430,69807133434,4,1587,1528,-10
69809265193,69809265194,1,1813,1601,-10
69811236338,69811236343,5,1922,788,-10
69813924976,69813924978,2,2269,1424,-10
69819550059,69819550062,3,1486,1155,-10
69820935453,69820935455,2,1203,1544,-10
69824067890,69824067893,3,1603,1523,-10
69828303277,69828303281,4,812,884,-10
69828943803,69828943801,-2,2736,4417,-10
69830524408,69830524410,2,1372,1232,-10
69833889429,69833889432,3,1667,1412,-10
69835138565,69835138567,2,1765,1328,-10
69838600806,69838600809,3,1559,2375,-10
69850653995,69850653972,-23,1429,1675,-10
69851953200,69851953207,7,2740,828,-10
69855331930,69855331933,3,1241,1673,-10
69858466954,69858466954,0,1544,1939,-10
69858856714,69858856718,4,1663,1362,-10
69859016750,69859016771,21,1113,875,-10
69860577941,69860577943,2,1716,1494,-10
69866525249,69866525250,1,1672,1477,-10
69871127265,69871127267,2,1364,1034,-10
69874105787,69874105789,2,876,865,-10
69876867558,69876867559,1,1418,1259,-10
69877988652,69877988655,3,3022,1333,-10
69880437533,69880437534,1,1877,2581,-10
69883324760,69883324751,-9,867,1153,-10
69883618398,69883618399,1,1563,2298,-10
69885143686,69885143690,4,1152,1311,-10
69885327919,69885327919,0,1637,1268,-10
69887286472,69887286473,1,1522,1555,-10
69890348630,69890348612,-18,773,777,-10
69890427176,69890427171,-5,1195,1681,-10
69892550105,69892550107,2,1920,1359,-10
69894531290,69894531291,1,1700,1949,-10
69900030147,69900030150,3,1303,1545,-10
69903768862,69903768866,4,2107,1568,-10
69907205715,69907205717,2,1809,2226,-10
69908226936,69908226939,3,1614,1303,-10
69908533547,69908533548,1,1725,2175,-10
69910392561,69910392564,3,1701,1689,-10
69913467330,69913467333,3,1391,950,-10
69913995337,69913995338,1,1487,2141,-10
69914499942,69914499945,3,1798,1712,-10
69917627739,69917627734,-5,588,1932,-10
69918673118,69918673119,1,1645,1787,-10
69920949750,69920949750,0,1399,1718,-10
69924034225,69924034233,8,4975,1340,-10
69927561333,69927561334,1,1678,1510,-10
69930550150,69930550151,1,1725,1566,-10
69931394361,69931394364,3,1582,2001,-10
69935711563,69935711562,-1,1938,2726,-10
69937258951,69937258951,0,1861,1817,-10
69939166373,69939166373,0,1367,1701,-10
69940763742,69940763743,1,997,1186,-10
69941549870,69941549874,4,892,1115,-10
69945969779,69945969782,3,1862,1792,-10
69949876635,69949876634,-1,2166,1886,-10
69949983205,69949983208,3,1492,1851,-10
69960603541,69960603545,4,1838,1528,-10
69960750230,69960750211,-19,1569,1240,-10
69965244282,69965244284,2,1379,1013,-10
69970003922,69970003926,4,1290,1602,-10
69972368759,69972368763,4,874,932,-10
69973808918,69973808921,3,1515,786,-10
69975800081,69975800082,1,1123,1014,-10
69975914824,69975914827,3,1642,1469,-10
69976799706,69976799707,1,1832,1638,-10
69977281766,69977281767,1,1520,1284,-10
69980138433,69980138434,1,3715,3745,-10
69982702857,69982702861,4,1438,1140,-10
69984307566,69984307569,3,1259,994,-10
69984771205,69984771200,-5,942,2678,-10
69986044242,69986044245,3,1477,1691,-10
69987590241,69987590244,3,1378,1471,-10
69988773325,69988773325,0,947,1690,-10
69990138538,69990138542,4,1640,2025,-10
69993728801,69993728802,1,1245,1195,-10
69997482589,69997482590,1,1684,1719,-10
69998089651,69998089654,3,2356,2485,-10
70000604879,70000604881,2,1737,1797,-10
70002352438,70002352440,2,2147,1421,-10
70002820658,70002820658,0,1491,2063,-10
70002854886,70002854889,3,1397,1486,-10
70005069384,70005069386,2,1608,1580,-10
70010022358,70010022361,3,2148,2173,-10
70012362535,70012362537,2,1591,2165,-10
70013758940,70013758947,7,2058,890,-10
70014486731,70014486733,2,1649,1247,-10
70017753256,70017753264,8,3416,1347,-10
70020485091,70020485099,8,1769,1342,-10
70022415934,70022415935,1,987,1128,-10
70024023187,70024023188,1,1458,1428,-10
70029748738,70029748741,3,998,1369,-10
70031460657,70031460656,-1,1194,1556,-10
70032290598,70032290599,1,1096,1381,-10
70040325694,70040325674,-20,1516,1673,-10
70045305718,70045305719,1,1580,1639,-10
70048059794,70048059814,20,1786,1951,-10
70048702806,70048702807,1,1869,2533,-10
70049018969,70049018973,4,1239,1099,-10
70049803766,70049803769,3,1982,1722,-10
70050563929,70050563930,1,1360,1326,-10
70054594512,70054594509,-3,1269,2698,-10
70059053621,70059053622,1,1874,1547,-10
70059868375,70059868375,0,1972,1412,-10
70060358049,70060358050,1,2056,1608,-10
70060594126,70060594131,5,2299,1373,-10
70063981398,70063981398,0,1540,1588,-10
70066696851,70066696853,2,1202,1446,-10
70068068557,70068068560,3,1445,1418,-10
70068428097,70068428099,2,2025,1935,-10
70069528909,70069528926,17,475,1521,-10
70075685967,70075685969,2,1123,1077,-10
70079630829,70079630830,1,1564,1455,-10
70081732723,70081732712,-11,1391,1320,-10
70085996295,70085996299,4,1501,1369,-10
70086544947,70086544950,3,1010,1342,-10
70090801867,70090801867,0,1321,877,-10
70092243787,70092243789,2,1470,1827,-10
70093685025,70093685029,4,1416,1404,-10
70094031094,70094031098,4,2670,1715,-10
70094221058,70094221059,1,1809,1371,-10
70095373953,70095373954,1,1635,1254,-10
70097266180,70097266182,2,1599,1304,-10
70100456059,70100456062,3,1430,2247,-10
70102652922,70102652923,1,1541,1526,-10
70106391336,70106391337,1,1841,1693,-10
70107678774,70107678775,1,1646,2002,-10
70112462166,70112462169,3,1254,1503,-10
70112699250,70112699250,0,1366,1184,-10
70112928607,70112928608,1,1349,1805,-10
70116605833,70116605837,4,2402,2787,-10
70116766787,70116766788,1,1859,1772,-10
70124942132,70124942134,2,1821,1458,-10
70125405403,70125405403,0,1622,1715,-10
70130772675,70130772678,3,1725,2290,-10
70132690650,70132690653,3,1227,865,-10
70135400982,70135400982,0,1376,1930,-10
70136727184,70136727185,1,1094,1646,-10
70137169225,70137169226,1,1261,2262,-10
70141644027,70141644029,2,1281,1448,-10
70149417386,70149417386,0,2759,2503,-10
70153836125,70153836127,2,1563,1096,-10
70155281852,70155281852,0,1390,1832,-10
70156104356,70156104354,-2,1370,1308,-10
70158904405,70158904409,4,1508,1357,-10
70160149234,70160149235,1,1244,1826,-10
70163095088,70163095088,0,951,1353,-10
70165296596,70165296599,3,1965,2164,-10
70166532654,70166532657,3,1820,1702,-10
70169264934,70169264936,2,2055,1996,-10
70170551484,70170551488,4,2093,1469,-10
70170678750,70170678751,1,2500,2117,-10
70171351555,70171351558,3,1216,1812,-10
70174910785,70174910790,5,3405,5031,-10
70175209510,70175209510,0,1930,1716,-10
70176238447,70176238451,4,3265,1345,-10
70176762031,70176762033,2,1602,981,-10
70180603457,70180603458,1,1764,1537,-10
70183158495,70183158498,3,1345,1900,-10
70183981456,70183981454,-2,801,1360,-10
70187055377,70187055386,9,5693,1389,-10
70187441141,70187441142,1,1834,1414,-10
70188776395,70188776397,2,1803,1935,-10
70191867737,70191867738,1,2385,1786,-10
70192776390,70192776392,2,1814,1569,-10
70193718042,70193718044,2,1446,2045,-10
70195000110,70195000113,3,1192,944,-10
70196274636,70196274636,0,1625,974,-10
70196993290,70196993291,1,1309,1090,-10
70198312210,70198312210,0,1448,1437,-10
70199481714,70199481715,1,2340,1632,-10
70200168414,70200168416,2,1745,1715,-10
70200823888,70200823891,3,1392,1404,-10
70202433510,70202433511,1,1106,1535,-10
70203373742,70203373744,2,1525,1736,-10
70207053552,70207053553,1,1321,1493,-10
70211852116,70211852120,4,1367,1303,-10
70222644070,70222644075,5,1540,1413,-10
70223617959,70223617958,-1,1644,2248,-10
70228452797,70228452800,3,927,1654,-10
70229799579,70229799581,2,1373,1299,-10
70229977539,70229977541,2,1622,1553,-10
70235718410,70235718413,3,1673,1831,-10
70237517950,70237517947,-3,1914,2527,-10
70239658291,70239658292,1,1394,1545,-10
70240496654,70240496654,0,1462,1124,-10
70242988079,70242988088,9,4025,1965,-10
70247966185,70247966187,2,1614,1289,-10
70252205300,70252205301,1,1906,1894,-10
70255555949,70255555950,1,1199,1276,-10
70256449356,70256449357,1,2032,1982,-10
70259599993,70259599996,3,1553,1336,-10
70260082673,70260082675,2,1538,2290,-10
70261950242,70261950245,3,1962,1838,-10
70262647027,70262647028,1,1948,1962,-10
70265533667,70265533671,4,1543,1178,-10
70266102437,70266102438,1,1699,1470,-10
70267334118,70267334120,2,1820,1475,-10
70267999786,70267999787,1,2124,2041,-10
70273903158,70273903158,0,1124,1207,-10
70274595858,70274595860,2,1599,1544,-10
70275294621,70275294625,4,1407,1501,-10
70276467445,70276467448,3,1597,1575,-10
70283662152,70283662154,2,1686,2279,-10
70286923661,70286923664,3,1031,1232,-10
70289203993,70289203997,4,1685,1353,-10
70290548945,70290548946,1,1536,1622,-10
70291480768,70291480769,1,1476,1740,-10
70292418704,70292418709,5,2241,1403,-10
70294541461,70294541457,-4,1088,2655,-10
70296590999,70296591002,3,1440,893,-10
70297088903,70297088884,-19,1453,1682,-10
70298389460,70298389463,3,1495,1349,-10
70302351396,70302351398,2,1861,1645,-10
70303250736,70303250718,-18,1676,1768,-10
70304971065,70304971069,4,1527,1823,-10
70306102507,70306102510,3,1849,1304,-10
70306747418,70306747421,3,716,1277,-10
70307408794,70307408796,2,1470,1462,-10
70311371830,70311371838,8,2228,933,-10
70312384591,70312384591,0,1996,1600,-10
70314057567,70314057561,-6,1415,4932,-10
70316117033,70316117037,4,1903,1446,-10
70320623537,70320623539,2,1258,1476,-10
70322519584,70322519585,1,2013,1624,-10
70324445225,70324445229,4,1986,1542,-10
70325463914,70325463915,1,1395,1884,-10
70326470829,70326470830,1,1404,1468,-10
70327624206,70327624211,5,1529,1052,-10
70328301868,70328301870,2,1822,2180,-10
70330377773,70330377767,-6,1421,5751,-10
70330611007,70330611002,-5,1681,8951,-10
70331803687,70331803689,2,1725,1190,-10
70332729478,70332729474,-4,1387,4001,-10
70334302313,70334302335,22,508,880,-10
70334548163,70334548167,4,1623,1400,-10
70336163509,70336163510,1,1047,1302,-10
70337583714,70337583715,1,1198,1267,-10
70341211881,70341211882,1,1444,1562,-10
70344320598,70344320603,5,1349,771,-10
70348561121,70348561122,1,1589,2085,-10
70350141801,70350141799,-2,1177,1537,-10
70354781131,70354781133,2,1404,1845,-10
70365509386,70365509389,3,2793,2520,-10
70366851188,70366851199,11,12061,37929,-10
70369750849,70369750843,-6,1082,4884,-10
70371218603,70371218605,2,1391,1574,-10
70372001591,70372001594,3,1348,1231,-10
70373426747,70373426737,-10,881,444,-10
70377112385,70377112386,1,1473,1979,-10
70379453584,70379453589,5,2484,1808,-10
70380480860,70380480862,2,1130,1016,-10
70381423001,70381423002,1,1500,1824,-10
70382975621,70382975621,0,1041,1453,-10
70383568165,70383568172,7,5311,2469,-10
70388391825,70388391826,1,1469,2142,-10
70388665090,70388665092,2,2308,1789,-10
70390548914,70390548914,0,1669,2298,-10
70392099117,70392099119,2,1753,1822,-10
70395731376,70395731377,1,1387,1382,-10
70400190478,70400190477,-1,1423,1630,-10
70400292567,70400292571,4,2180,1415,-10
70404024806,70404024808,2,1444,1788,-10
70404166974,70404166976,2,1653,1531,-10
70404228643,70404228646,3,1926,1945,-10
70408917766,70408917770,4,2101,1103,-10
70411079274,70411079277,3,1549,1068,-10
70414485133,70414485133,0,1590,1351,-10
70417191786,70417191789,3,1435,1527,-10
70417549308,70417549309,1,1431,1331,-10
70419660785,70419660786,1,1462,1802,-10
70419702749,70419702750,1,2053,1581,-10
70420721017,70420721018,1,1440,1507,-10
70420751191,70420751189,-2,1287,1923,-10
70421411741,70421411741,0,1191,1215,-10
70425425326,70425425326,0,1185,1620,-10
70428169277,70428169279,2,1281,1180,-10
70429417125,70429417126,1,1137,1450,-10
70430454698,70430454700,2,1028,1301,-10
70433925284,70433925303,19,1591,1897,-10
70434144396,70434144403,7,3896,2736,-10
70439984878,70439984881,3,1657,1457,-10
70441109707,70441109710,3,1484,1087,-10
70442683682,70442683686,4,1960,1677,-10
70446145109,70446145111,2,1474,1489,-10
70447781855,70447781855,0,1411,1954,-10
70448599329,70448599331,2,1576,1414,-10
70450661121,70450661123,2,1479,1686,-10
70453188087,70453188087,0,1422,1907,-10
70453705941,70453705942,1,2048,1303,-10
70455991775,70455991779,4,1365,1313,-10
70458239942,70458239944,2,1260,1255,-10
70464390953,70464390953,0,1227,1767,-10
70467839348,70467839349,1,1638,1752,-10
70469214216,70469214218,2,1530,1828,-10
70470539785,70470539798,13,14717,41585,-10
70475475864,70475475867,3,1790,2056,-10
70477193407,70477193409,2,1272,1951,-10
70479819603,70479819606,3,1144,1208,-10
70480652178,70480652178,0,1204,1170,-10
70481107521,70481107534,13,526,2550,-10
70483709091,70483709094,3,1839,1020,-10
70485613686,70485613690,4,1957,1603,-10
70488033435,70488033434,-1,1171,2011,-10
70488417989,70488417990,1,1400,996,-10
70490558156,70490558158,2,2368,1708,-10
70490871415,70490871417,2,1340,1574,-10
70496227406,70496227407,1,1603,1358,-10
70496539229,70496539231,2,1554,1744,-10
70498095257,70498095257,0,1484,1690,-10
70498627723,70498627707,-16,1055,860,-10
70498989729,70498989730,1,1249,1932,-10
70501149837,70501149837,0,1965,1760,-10
70502225260,70502225260,0,1542,1123,-10
70503806621,70503806622,1,2032,1737,-10
70505033404,70505033407,3,1616,1643,-10
70505368656,70505368658,2,1876,2454,-10
70508595777,70508595778,1,2377,1464,-10
70509702378,70509702378,0,1283,2278,-10
70510321168,70510321160,-8,1095,1222,-10
70510543370,70510543373,3,1874,1846,-10
70518364015,70518364010,-5,879,4607,-10
70523177334,70523177334,0,1899,2306,-10
70523771475,70523771475,0,1050,1735,-10
70525496803,70525496805,2,1021,1280,-10
70526244635,70526244637,2,1338,1623,-10
70526521463,70526521466,3,2557,1871,-10
70526923690,70526923691,1,1907,1633,-10
70529342142,70529342142,0,1318,947,-10
70531458654,70531458655,1,951,1512,-10
70535298074,70535298077,3,1618,1772,-10
70539483105,70539483109,4,2404,1517,-10
70539753364,70539753367,3,1722,1338,-10
70541122030,70541122033,3,1736,1341,-10
70542581735,70542581734,-1,2432,1742,-10
70542994678,70542994698,20,2100,1682,-10
70548401283,70548401286,3,1748,1692,-10
70549278325,70549278326,1,1625,1306,-10
70550064858,70550064862,4,2096,1896,-10
70552529191,70552529169,-22,1512,1236,-10
70554416410,70554416411,1,805,1153,-10
70554575942,70554575943,1,1680,1631,-10
70555565117,70555565118,1,1483,1369,-10
70560393302,70560393305,3,1870,1783,-10
70560870869,70560870869,0,1458,1231,-10
70561330582,70561330582,0,3668,6070,-10
70561629489,70561629481,-8,739,6092,-10
70562959133,70562959134,1,1736,1642,-10
70564590821,70564590820,-1,1034,1547,-10
70565419550,70565419551,1,1396,1414,-10
70569670019,70569670022,3,1492,1536,-10
70571018662,70571018663,1,1423,1287,-10
70571984078,70571984079,1,2233,1301,-10
70573052166,70573052170,4,2518,2165,-10
70576020818,70576020821,3,1655,1542,-10
70576851838,70576851838,0,1193,1768,-10
70578017663,70578017662,-1,1223,1394,-10
70583073092,70583073094,2,1258,1320,-10
70583991780,70583991781,1,1395,1194,-10
70591463555,70591463555,0,1159,1092,-10
70593973569,70593973569,0,1712,2058,-10
70594925344,70594925345,1,1460,1670,-10
70602875613,70602875614,1,1634,1276,-10
70611225406,70611225410,4,2203,1639,-10
70611582345,70611582346,1,1518,1306,-10
70612456830,70612456827,-3,24342,43409,-10
70614820692,70614820694,2,2130,1649,-10
70615834431,70615834435,4,2127,936,-10
70619130159,70619130162,3,1142,1198,-10
70620068989,70620068990,1,1676,1367,-10
70621247186,70621247189,3,2037,1758,-10
70623190942,70623190947,5,1623,1004,-10
70625433394,70625433395,1,1708,1295,-10
70629932474,70629932476,2,1390,2266,-10
70632106050,70632106051,1,1564,2045,-10
70632283495,70632283498,3,1702,1964,-10
70634917758,70634917758,0,1680,1318,-10
70635328088,70635328088,0,24577,36751,-10
70635708318,70635708322,4,1790,2217,-10
70637189135,70637189138,3,935,1067,-10
70637732254,70637732257,3,1816,1684,-10
70639416716,70639416718,2,1831,1067,-10
70640457082,70640457084,2,1809,1981,-10
70640483418,70640483423,5,1848,1932,-10
70641586611,70641586613,2,1885,1121,-10
70642378922,70642378924,2,1363,1812,-10
70644797381,70644797382,1,2021,2162,-10
70645006045,70645006046,1,1622,1330,-10
70645663459,70645663459,0,961,1282,-10
70646530605,70646530606,1,1157,1031,-10
70649123358,70649123359,1,1880,1921,-10
70652765036,70652765037,1,2067,1415,-10
70655407979,70655407982,3,1640,1932,-10
70656475662,70656475664,2,2069,1886,-10
70658861915,70658861915,0,1515,1494,-10
70659105367,70659105363,-4,1302,1776,-10
70664367647,70664367629,-18,1241,1020,-10
70666368057,70666368057,0,1402,1382,-10
70668299054,70668299055,1,1091,1180,-10
70669353415,70669353417,2,1634,1994,-10
70675638137,70675638138,1,2105,1158,-10
70676149630,70676149630,0,1545,1593,-10
70678338671,70678338675,4,1932,1416,-10
70679821157,70679821159,2,1192,1118,-10
70680604069,70680604072,3,1478,1839,-10
70680850529,70680850517,-12,1312,1513,-10
70684619830,70684619834,4,1323,1219,-10
70688055122,70688055125,3,1669,1632,-10
70689762498,70689762499,1,2199,1386,-10
70690207918,70690207918,0,1447,1276,-10
70691028873,70691028875,2,1641,1548,-10
70691908601,70691908603,2,1265,1430,-10
70693064298,70693064299,1,1781,1730,-10
70694300317,70694300318,1,1518,1530,-10
70695783538,70695783538,0,1863,1517,-10
70696024797,70696024801,4,1373,1875,-10
70696632098,70696632095,-3,55,1271,-10
70698319008,70698319010,2,1320,1546,-10
70699299277,70699299280,3,2033,1732,-10
70700615745,70700615747,2,1258,1194,-10
70700751576,70700751577,1,1245,1092,-10
70702671889,70702671890,1,2309,1719,-10
70708940326,70708940328,2,1442,1686,-10
70709289879,70709289864,-15,1012,483,-10
70710709131,70710709133,2,1747,1314,-10
70712431227,70712431232,5,4180,3227,-10
70713300119,70713300122,3,1652,1510,-10
70714172795,70714172796,1,1235,1329,-10
70716743323,70716743327,4,1315,1152,-10
70719165148,70719165150,2,1672,1375,-10
70720934015,70720934023,8,13598,20902,-10
70723108530,70723108532,2,1180,1407,-10
70729121461,70729121462,1,1966,1132,-10
70729517448,70729517449,1,2091,1550,-10
70730403422,70730403426,4,1053,699,-10
70732109359,70732109362,3,2487,1998,-10
70733808925,70733808929,4,1559,1123,-10
70735406782,70735406786,4,1299,981,-10
70740927273,70740927274,1,953,1502,-10
70743533586,70743533586,0,1791,2123,-10
70745014177,70745014182,5,944,859,-10
70746425954,70746425958,4,2188,1804,-10
70751278169,70751278170,1,1532,1226,-10
70755215086,70755215086,0,1923,1663,-10
70755337645,70755337646,1,1902,1439,-10
70757555544,70757555547,3,1274,1065,-10
70759383386,70759383386,0,1226,1237,-10
70763424377,70763424379,2,1639,1471,-10
70763862187,70763862191,4,1231,1611,-10
70767485563,70767485566,3,1526,1550,-10
70768088266,70768088275,9,7290,1599,-10
70768814793,70768814794,1,1382,1019,-10
70769728150,70769728157,7,4760,2536,-10
70772916926,70772916929,3,1833,1415,-10
70773770374,70773770376,2,1778,1419,-10
70774368135,70774368138,3,1270,1849,-10
70777683015,70777683018,3,2363,1896,-10
70788225146,70788225146,0,1257,1600,-10
70792820502,70792820502,0,1437,1440,-10
70793962277,70793962278,1,2239,1463,-10
70795054189,70795054190,1,1525,1255,-10
70798510834,70798510835,1,1305,1288,-10
70799146574,70799146574,0,1073,1387,-10
70800890599,70800890601,2,1189,1071,-10
70806613094,70806613098,4,1399,1229,-10
70807294963,70807294965,2,1312,1361,-10
70809648688,70809648690,2,1758,1392,-10
70809973070,70809973073,3,1990,2261,-10
70811128030,70811128033,3,1580,1407,-10
70817718841,70817718848,7,4406,1523,-10
70821280190,70821280192,2,1348,1593,-10
70823736300,70823736299,-1,1959,1511,-10
70825908960,70825908959,-1,1065,1752,-10
70826371938,70826371941,3,1739,1160,-10
70827762948,70827762949,1,1452,1926,-10
70828293585,70828293587,2,1478,917,-10
70830831746,70830831746,0,1411,1946,-10
70832339991,70832339993,2,1766,1970,-10
70834926563,70834926566,3,1321,1658,-10
70835309378,70835309381,3,2150,1612,-10
70836382794,70836382796,2,1759,1348,-10
70838882922,70838882922,0,1779,1057,-10
70843984674,70843984675,1,1658,1511,-10
70845028318,70845028318,0,1393,2110,-10
70847938919,70847938922,3,1736,1808,-10
70849415430,70849415434,4,1490,1461,-10
70851644094,70851644097,3,2311,2352,-10
70852211830,70852211848,18,1035,1180,-10
70855967695,70855967697,2,976,1360,-10
70857299337,70857299341,4,1543,1670,-10
70859562590,70859562595,5,3152,1403,-10
70859694866,70859694870,4,1251,1394,-10
70861418654,70861418654,0,1529,1812,-10
70866449525,70866449528,3,1804,1650,-10
70867580814,70867580818,4,2275,2050,-10
70868897086,70868897087,1,1220,1359,-10
70869939653,70869939655,2,1490,1458,-10
70872250243,70872250243,0,1509,1520,-10
70873266682,70873266682,0,1506,1054,-10
70875427594,70875427595,1,1284,1582,-10
70878353763,70878353767,4,2255,1469,-10
70879081467,70879081469,2,1403,1130,-10
70879249263,70879249266,3,1792,1844,-10
70880149567,70880149568,1,1176,1682,-10
70882233880,70882233882,2,1137,1412,-10
70882465346,70882465349,3,1444,1308,-10
70883990734,70883990735,1,2433,1884,-10
70884596020,70884596022,2,1488,1317,-10
70886715745,70886715747,2,1662,1809,-10
70886855134,70886855131,-3,1659,2807,-10
70888910554,70888910555,1,1248,1772,-10
70889345854,70889345855,1,1843,1240,-10
70889469466,70889469466,0,1142,2161,-10
70893081391,70893081390,-1,1252,1188,-10
70894213190,70894213193,3,1377,1550,-10
70896218381,70896218383,2,2159,1989,-10
70900152139,70900152139,0,1866,2000,-10
70901435818,70901435822,4,1112,1204,-10
70902399023,70902399022,-1,1637,1250,-10
70903237379,70903237380,1,1358,1539,-10
70907944476,70907944478,2,1989,1374,-10
70908025380,70908025382,2,1494,1331,-10
70910181407,70910181409,2,1543,2306,-10
70911752765,70911752765,0,1151,1468,-10
70914386536,70914386538,2,1601,1277,-10
70919697091,70919697094,3,1646,1484,-10
70921045651,70921045654,3,2675,2290,-10
70921211953,70921211953,0,1462,1869,-10
70927767190,70927767193,3,2141,1219,-10
70930491959,70930491961,2,2186,2226,-10
70935657794,70935657795,1,1380,1607,-10
70937752425,70937752427,2,1525,1700,-10
70938405367,70938405346,-21,1449,907,-10
70938709144,70938709146,2,1568,1494,-10
70943990775,70943990775,0,1410,1373,-10
70945455539,70945455542,3,1405,1613,-10
70945612399,70945612399,0,2262,2250,-10
70947016507,70947016511,4,2204,1595,-10
70947917694,70947917690,-4,944,2554,-10
70948316144,70948316146,2,1543,1258,-10
70951613831,70951613841,10,1665,1213,-10
70952035686,70952035687,1,1134,1382,-10
70952794851,70952794853,2,1187,1239,-10
70953630202,70953630204,2,1575,2194,-10
70954234771,70954234771,0,1081,1746,-10
70956709948,70956709950,2,1197,822,-10
70957711045,70957711046,1,1120,1517,-10
70958583501,70958583503,2,1111,1468,-10
70960390225,70960390226,1,1910,1335,-10
70961357954,70961357957,3,2007,1516,-10
70962727527,70962727526,-1,1427,2192,-10
70963332302,70963332304,2,1217,1240,-10
70968533597,70968533601,4,1179,1293,-10
70969218775,70969218777,2,1196,1349,-10
70976899826,70976899827,1,1384,926,-10
70985952910,70985952912,2,1499,1880,-10
70987139741,70987139747,6,3565,1522,-10
70990169854,70990169861,7,5826,1671,-10
70991706334,70991706338,4,1901,1354,-10
70992361742,70992361745,3,1466,1320,-10
70993460814,70993460815,1,1541,1613,-10
70994543698,70994543698,0,1529,1600,-10
70997149153,70997149153,0,1872,2309,-10
70999340576,70999340578,2,1791,1171,-10
70999796573,70999796554,-19,2126,2043,-10
71001025866,71001025868,2,1223,1099,-10
71005529806,71005529807,1,1345,1545,-10
71008214657,71008214659,2,2235,2231,-10
71008420683,71008420685,2,3019,2437,-10
71017302754,71017302755,1,1284,1524,-10
71023445459,71023445463,4,1266,1169,-10
71024135678,71024135676,-2,1334,2163,-10
71026558254,71026558257,3,1345,1806,-10
71027511282,71027511286,4,1692,1379,-10
71034888634,71034888637,3,1815,1880,-10
71035575453,71035575455,2,1625,1493,-10
71037750358,71037750359,1,1683,1468,-10
71040065014,71040065016,2,1330,1837,-10
71040434927,71040434930,3,1944,1548,-10
71044037869,71044037871,2,1548,1329,-10
71044911131,71044911136,5,11289,21444,-10
71046662341,71046662343,2,1364,1815,-10
71047804127,71047804128,1,1504,1280,-10
71049595101,71049595101,0,1473,1402,-10
71056349354,71056349353,-1,1022,936,-10
71058117413,71058117415,2,849,1160,-10
71064986763,71064986767,4,1337,1422,-10
71067118721,71067118723,2,2356,2026,-10
71067797557,71067797559,2,1904,1325,-10
71068178206,71068178208,2,1465,1361,-10
71070912710,71070912705,-5,1014,2420,-10
71073495653,71073495654,1,896,1224,-10
71074340686,71074340685,-1,989,1661,-10
71076641650,71076641651,1,1462,1249,-10
71079097203,71079097207,4,656,699,-10
71079608650,71079608652,2,1239,1880,-10
71083102379,71083102383,4,1762,1885,-10
71085371653,71085371655,2,1895,1453,-10
71088540328,71088540331,3,2293,1654,-10
71088952230,71088952233,3,1110,1183,-10
71090640463,71090640466,3,1615,1714,-10
71092129615,71092129615,0,1195,1901,-10
71092910818,71092910818,0,1465,2036,-10
71093770159,71093770162,3,1533,1409,-10
71097616902,71097616905,3,2068,1234,-10
71098266740,71098266742,2,1443,1659,-10
71100998638,71100998640,2,1477,1407,-10
71102777903,71102777908,5,2565,1590,-10
71107129593,71107129594,1,1510,881,-10
71107324478,71107324478,0,1451,1878,-10
71109067273,71109067274,1,1957,1662,-10
71109699799,71109699801,2,1223,1279,-10
71114947058,71114947063,5,1315,1076,-10
71115955712,71115955718,6,2233,1442,-10
71117495783,71117495787,4,1274,1817,-10
71118309222,71118309225,3,762,1207,-10
71118731218,71118731222,4,1600,1184,-10
71123802689,71123802683,-6,1796,5356,-10
71124018760,71124018753,-7,1743,1303,-10
71127427919,71127427922,3,1075,1559,-10
71128851146,71128851147,1,1114,1525,-10
71129003887,71129003872,-15,1534,1485,-10
71130793434,71130793437,3,1342,1148,-10
71132144342,71132144342,0,1808,1790,-10
71134313010,71134313013,3,1775,2011,-10
71135166764,71135166766,2,1727,2011,-10
71136701125,71136701127,2,1402,992,-10
71145776645,71145776648,3,1462,1447,-10
71147628699,71147628701,2,942,1540,-10
71150381429,71150381428,-1,1316,2363,-10
71150848302,71150848305,3,1105,1401,-10
71152817266,71152817269,3,1809,1572,-10
71156474371,71156474372,1,1760,2081,-10
71160853282,71160853283,1,1312,1245,-10
71161997126,71161997127,1,1369,1457,-10
71162648653,71162648653,0,979,1554,-10
71163959655,71163959656,1,1078,1570,-10
71169841798,71169841800,2,1439,2075,-10
71170407251,71170407253,2,1707,1412,-10
71174669485,71174669486,1,1107,1679,-10
71177160434,71177160438,4,1678,2052,-10
71180436523,71180436526,3,2255,1839,-10
71180996207,71180996207,0,1343,2077,-10
71181946941,71181946941,0,1587,1407,-10
71183721715,71183721718,3,1479,1562,-10
71183969421,71183969422,1,1585,1152,-10
71186580082,71186580085,3,1520,1282,-10
71186761126,71186761128,2,2226,1444,-10
71187656674,71187656678,4,1758,1411,-10
71188905266,71188905270,4,1046,1460,-10
71190849183,71190849189,6,1769,1270,-10
71195501559,71195501561,2,1606,1371,-10
71196268686,71196268687,1,1899,1294,-10
71196630230,71196630233,3,1033,1569,-10
71199377726,71199377722,-4,1112,2304,-10
71199542897,71199542902,5,1790,1963,-10
71204456103,71204456105,2,1340,1432,-10
71204662126,71204662126,0,18499,29618,-10
71205351877,71205351878,1,2396,1962,-10
71207640625,71207640627,2,1059,932,-10
71208706439,71208706439,0,1519,2015,-10
71211213367,71211213367,0,1977,1857,-10
71211984079,71211984081,2,1891,2226,-10
71216298037,71216298039,2,1510,1845,-10
71216391392,71216391392,0,9448,13375,-10
71218952663,71218952665,2,1608,1476,-10
71219938835,71219938836,1,994,1359,-10
71223509882,71223509886,4,1518,1976,-10
71226580273,71226580277,4,2544,1487,-10
71227916779,71227916781,2,1335,1575,-10
71230546508,71230546511,3,1920,1087,-10
71230875038,71230875041,3,27762,117233,-10
71235564138,71235564142,4,2995,1701,-10
71240920473,71240920473,0,1245,1432,-10
71241529733,71241529735,2,1549,1628,-10
71241886810,71241886812,2,2037,1502,-10
71245878398,71245878399,1,1919,2495,-10
71246915439,71246915440,1,1407,1471,-10
71248528431,71248528435,4,1293,1299,-10
71251141498,71251141501,3,1671,1622,-10
71259879863,71259879866,3,1683,1455,-10
71264387352,71264387354,2,1227,1440,-10
71265291609,71265291610,1,1487,1165,-10
71265585865,71265585867,2,760,868,-10
71265983466,71265983467,1,1345,1323,-10
71268368544,71268368546,2,1974,2367,-10
71273131371,71273131372,1,1670,2468,-10
71275444834,71275444837,3,1899,1834,-10
71278403349,71278403350,1,1447,2086,-10
71279116773,71279116773,0,1184,1799,-10
71279703129,71279703131,2,1369,1376,-10
71285617669,71285617669,0,1981,1598,-10
71287820308,71287820310,2,1103,1101,-10
71290025469,71290025470,1,1384,1846,-10
71296675828,71296675830,2,1258,1126,-10
71298384600,71298384602,2,2016,1690,-10
71299464114,71299464119,5,1795,1792,-10
71302387430,71302387428,-2,1710,1698,-10
71304629657,71304629657,0,1756,1570,-10
71305856645,71305856646,1,1096,1377,-10
71308311784,71308311786,2,1531,1252,-10
71309985653,71309985654,1,1360,1392,-10
71311975488,71311975486,-2,950,961,-10
71314150730,71314150733,3,1435,1209,-10
71315235733,71315235735,2,1653,2070,-10
71316729049,71316729050,1,1287,1324,-10
71317492874,71317492876,2,1775,1488,-10
71318414545,71318414545,0,1642,1816,-10
71322734242,71322734242,0,1468,1730,-10
71322943128,71322943126,-2,1087,1977,-10
71323149432,71323149434,2,1195,1329,-10
71324811974,71324811974,0,1891,2308,-10
71325197141,71325197143,2,1528,1302,-10
71326211550,71326211553,3,1620,1854,-10
71326476149,71326476151,2,1529,1406,-10
71329144281,71329144279,-2,1594,1191,-10
71329421986,71329421986,0,1797,1417,-10
71330543918,71330543921,3,1184,1332,-10
71332097397,71332097398,1,1093,973,-10
71334484895,71334484898,3,1056,1424,-10
71337766121,71337766121,0,1049,1019,-10
71339779700,71339779701,1,1124,1134,-10
71340604714,71340604717,3,2268,1449,-10
71341157219,71341157221,2,1791,1574,-10
71341833829,71341833830,1,1585,1486,-10
71343968226,71343968225,-1,1217,1481,-10
71345645570,71345645572,2,1554,1589,-10
71347380790,71347380792,2,891,1076,-10
71348289782,71348289802,20,375,501,-10
71353865419,71353865417,-2,2296,4326,-10
71355466054,71355466053,-1,2572,3110,-10
71358886178,71358886180,2,1454,884,-10
71359691123,71359691127,4,1688,1021,-10
71362091325,71362091326,1,1000,1372,-10
71369860653,71369860654,1,1976,1790,-10
71371177021,71371177025,4,2507,1552,-10
71371974730,71371974731,1,1184,1481,-10
71373782130,71373782133,3,1918,1422,-10
71377463225,71377463227,2,1744,1568,-10
71381148982,71381148972,-10,34067,46734,-10
71384381733,71384381735,2,1474,1898,-10
71389355023,71389355025,2,1838,1624,-10
71397357305,71397357307,2,1397,2047,-10
71397597043,71397597046,3,1720,1714,-10
71401748128,71401748132,4,2063,2087,-10
71401964199,71401964197,-2,1051,2220,-10
71402547907,71402547910,3,1775,1698,-10
71406577227,71406577230,3,1799,1715,-10
71407894406,71407894407,1,2014,1967,-10
71409452199,71409452201,2,1760,1489,-10
71410415325,71410415326,1,1303,1708,-10
71411492022,71411492024,2,1300,1328,-10
71413157832,71413157834,2,1665,1390,-10
71414018697,71414018698,1,2136,1869,-10
71415555696,71415555695,-1,1419,1509,-10
71421857694,71421857697,3,2416,1928,-10
71422224334,71422224339,5,2535,1489,-10
71425401809,71425401811,2,1414,1283,-10
71430919854,71430919855,1,1693,2143,-10
71431564891,71431564893,2,1151,1326,-10
71441620522,71441620524,2,2198,1743,-10
71442390563,71442390565,2,861,936,-10
71445023801,71445023802,1,1418,1603,-10
71446819760,71446819761,1,1719,1459,-10
71452855556,71452855558,2,1572,1438,-10
71452963414,71452963418,4,3051,1204,-10
71454725640,71454725641,1,1785,1587,-10
71456035629,71456035631,2,1449,1306,-10
71459625359,71459625358,-1,2119,1598,-10
71461626179,71461626181,2,2057,1973,-10
71463011993,71463011995,2,1016,1062,-10
71464808422,71464808425,3,1417,1756,-10
71466591121,71466591122,1,1125,2406,-10
71470598729,71470598730,1,2077,2030,-10
71473577453,71473577454,1,1584,1722,-10
71474266302,71474266303,1,1684,1329,-10
71478692068,71478692070,2,1565,1469,-10
71480636011,71480636009,-2,1864,2420,-10
71483185766,71483185766,0,1154,1247,-10
71483756162,71483756163,1,1125,1148,-10
71490017530,71490017532,2,1875,1964,-10
71494104030,71494104028,-2,1282,2501,-10
71494323650,71494323652,2,1178,1164,-10
71495023981,71495023983,2,1357,2200,-10
71496117229,71496117230,1,1780,1591,-10
71497473049,71497473050,1,1145,1035,-10
71497761273,71497761274,1,1354,939,-10
71509447210,71509447213,3,1515,617,-10
71514757370,71514757374,4,1344,994,-10
71515668743,71515668745,2,1256,1182,-10
71515822906,71515822907,1,1024,1607,-10
71516250450,71516250451,1,836,1860,-10
71518255986,71518255987,1,2062,1923,-10
71524086655,71524086659,4,2027,1810,-10
71524229369,71524229370,1,1509,1438,-10
71528953456,71528953450,-6,333,2084,-10
71531109860,71531109851,-9,1451,1763,-10
71532683717,71532683719,2,1985,1656,-10
71533246453,71533246453,0,1074,1018,-10
71535799742,71535799741,-1,663,2280,-10
71544766398,71544766392,-6,1070,1496,-10
71548659038,71548659038,0,2609,3125,-10
71550887045,71550887047,2,2099,1624,-10
71551112464,71551112466,2,1719,1835,-10
71559875533,71559875536,3,1742,1715,-10
71560219190,71560219190,0,1707,1867,-10
71562348837,71562348838,1,1326,1383,-10
71563035482,71563035482,0,1947,1946,-10
71563659628,71563659630,2,1932,1878,-10
71566648110,71566648112,2,1543,2388,-10
71567196613,71567196613,0,1761,1764,-10
71570667133,71570667133,0,1901,2233,-10
71571816254,71571816255,1,1173,990,-10
71572389297,71572389299,2,960,817,-10
71573248436,71573248435,-1,1849,1756,-10
71573525638,71573525641,3,1493,1472,-10
71576217486,71576217486,0,1464,1535,-10
71577012919,71577012918,-1,1059,1595,-10
71577526119,71577526122,3,2346,1788,-10
71578176290,71578176291,1,1982,1256,-10
71578604327,71578604329,2,1501,1425,-10
71580186479,71580186482,3,1290,1403,-10
71588691292,71588691292,0,1099,1498,-10
71593161941,71593161934,-7,1377,1384,-10
71593528149,71593528169,20,1640,1347,-10
71594643702,71594643704,2,1725,1471,-10
71595128778,71595128781,3,1862,2127,-10
71595347500,71595347501,1,1430,1462,-10
71598766567,71598766561,-6,1367,4975,-10
71598814654,71598814657,3,2182,2288,-10
71603887083,71603887086,3,1282,1171,-10
71604055847,71604055850,3,2384,1523,-10
71605135926,71605135926,0,1567,1792,-10
71607368238,71607368245,7,3787,1832,-10
71607952839,71607952838,-1,925,1447,-10
71610988514,71610988515,1,1424,1578,-10
71614679481,71614679482,1,1207,1757,-10
71614951469,71614951470,1,1612,1978,-10
71618493019,71618493021,2,1579,1391,-10
71619062478,71619062478,0,1633,1722,-10
71622709595,71622709597,2,1919,1302,-10
71623539990,71623539993,3,1273,1519,-10
71624034087,71624034090,3,1535,1650,-10
71626609415,71626609417,2,1781,1589,-10
71629324822,71629324827,5,1733,2008,-10
71629857673,71629857676,3,1463,1442,-10
71633013083,71633013085,2,1066,1230,-10
71637668033,71637668037,4,1471,1548,-10
71638869683,71638869686,3,1448,1611,-10
71649937255,71649937254,-1,1098,1431,-10
71653196589,71653196588,-1,1781,1437,-10
71653261994,71653261995,1,1441,1444,-10
71654055138,71654055123,-15,981,218,-10
71661355386,71661355389,3,1443,1513,-10
71663222754,71663222755,1,1655,1632,-10
71664977749,71664977751,2,1483,1073,-10
71665942718,71665942721,3,1069,1508,-10
71667432260,71667432262,2,1645,1426,-10
71668167322,71668167325,3,1767,1824,-10
71671132622,71671132619,-3,1102,2524,-10
71672081010,71672081011,1,1582,1412,-10
71672437490,71672437493,3,1375,1395,-10
71673236363,71673236363,0,1683,746,-10
71674744478,71674744481,3,3368,2834,-10
71675120943,71675120947,4,1844,1799,-10
71676633282,71676633281,-1,1344,2625,-10
71678466357,71678466358,1,1607,1178,-10
71678650802,71678650802,0,1266,1456,-10
71679437713,71679437717,4,1599,1685,-10
71679825296,71679825297,1,1296,1446,-10
71681646490,71681646493,3,1993,1871,-10
71682136838,71682136839,1,1577,1177,-10
71682911867,71682911870,3,1511,1485,-10
71683471102,71683471105,3,656,1052,-10
71684063937,71684063938,1,1623,1487,-10
71684748379,71684748382,3,1073,1353,-10
71688976617,71688976618,1,1395,1732,-10
71697189906,71697189907,1,1461,1574,-10
71697702811,71697702810,-1,566,1520,-10
71699245243,71699245242,-1,1560,973,-10
71700197965,71700197967,2,1811,1573,-10
71703392131,71703392133,2,1398,1680,-10
71705418609,71705418611,2,1285,1709,-10
71705872497,71705872501,4,1471,986,-10
71706139081,71706139087,6,4720,2537,-10
71706980357,71706980360,3,1439,1198,-10
71708608559,71708608561,2,1853,1449,-10
71715870170,71715870182,12,14159,22766,-10
71717798419,71717798421,2,1380,1377,-10
71718420822,71718420823,1,1099,1081,-10
71724359294,71724359294,0,1558,1385,-10
71724387981,71724387984,3,1855,1876,-10
71727175014,71727175016,2,1781,1382,-10
71727305897,71727305898,1,1626,1591,-10
71728154089,71728154091,2,1698,1650,-10
71728642363,71728642357,-6,1985,6202,-10
71732218023,71732218030,7,2855,1345,-10
71732522146,71732522150,4,2005,1754,-10
71733753338,71733753334,-4,825,1749,-10
71735448370,71735448372,2,1206,1404,-10
71741888035,71741888028,-7,1837,6861,-10
71744106269,71744106270,1,903,1351,-10
71744384917,71744384913,-4,1366,3243,-10
71746555325,71746555326,1,2297,1814,-10
71751717479,71751717481,2,1971,2457,-10
71756263898,71756263899,1,1571,1066,-10
71763008224,71763008227,3,1752,2009,-10
71764945193,71764945195,2,2096,1954,-10
71768698919,71768698921,2,1182,1121,-10
71773816322,71773816317,-5,867,3564,-10
71777448382,71777448387,5,1518,1781,-10
71777509273,71777509273,0,1654,2143,-10
71778305239,71778305242,3,2156,1088,-10
71778974889,71778974891,2,2001,1251,-10
71780719604,71780719606,2,1763,1657,-10
71784445737,71784445739,2,1627,1325,-10
71788736138,71788736138,0,1537,2006,-10
71788899219,71788899215,-4,1481,2251,-10
71790427133,71790427137,4,1532,1262,-10
71791338561,71791338556,-5,1332,2888,-10
71795654321,71795654325,4,1740,1020,-10
71797002086,71797002088,2,952,1237,-10
71798252984,71798252979,-5,1514,3581,-10
71798983006,71798983009,3,889,1180,-10
71805519104,71805519106,2,1499,1065,-10
71805913158,71805913140,-18,1666,1006,-10
71807636327,71807636330,3,1347,717,-10
71808753398,71808753405,7,1931,670,-10
71808920616,71808920621,5,2206,1617,-10
71809601751,71809601754,3,1443,1358,-10
71810371435,71810371439,4,1418,1426,-10
71811591165,71811591166,1,1509,1371,-10
71813616013,71813616016,3,1942,1897,-10
71817407987,71817407989,2,1732,1556,-10
71818231659,71818231640,-19,618,890,-10
71821365826,71821365827,1,1455,1507,-10
71822660321,71822660323,2,2075,1873,-10
71822713142,71822713143,1,1368,1728,-10
71822980245,71822980246,1,949,1224,-10
71825215997,71825215998,1,1837,1282,-10
71825468417,71825468419,2,1522,1329,-10
71828860299,71828860299,0,1257,1389,-10
71829925730,71829925732,2,1747,1495,-10
71830125404,71830125406,2,1809,1624,-10
71831524976,71831524978,2,1906,1380,-10
71833866429,71833866431,2,2137,2016,-10
71838981639,71838981642,3,1521,1329,-10
71840689665,71840689667,2,1189,1843,-10
71842817541,71842817542,1,871,1180,-10
71845875102,71845875107,5,2277,1253,-10
71846106063,71846106066,3,1199,1138,-10
71847749618,71847749619,1,1477,1511,-10
71848748591,71848748575,-16,285,1407,-10
71852898133,71852898134,1,1403,1725,-10
71854109407,71854109409,2,1737,1678,-10
71856042965,71856042968,3,1288,1937,-10
71856741926,71856741929,3,1499,1297,-10
71858828083,71858828084,1,945,1144,-10
71860427075,71860427078,3,1916,1237,-10
71872904897,71872904901,4,2212,2326,-10
71873467539,71873467543,4,1586,1178,-10
71876180537,71876180537,0,1658,1675,-10
71877215220,71877215213,-7,1144,4009,-10
71882699383,71882699382,-1,1546,1657,-10
71888610410,71888610414,4,1389,1916,-10
71889255755,71889255757,2,2101,2022,-10
71891011449,71891011449,0,1879,1392,-10
71892160982,71892160983,1,997,1477,-10
71893559869,71893559871,2,1378,2095,-10
71894676424,71894676426,2,1359,1630,-10
71896587387,71896587389,2,1488,2196,-10
71897361540,71897361541,1,1700,2062,-10
71901105334,71901105337,3,1891,1057,-10
71902478207,71902478208,1,1195,2186,-10
71905952882,71905952884,2,1701,1262,-10
71908727001,71908727001,0,1382,1984,-10
71910448905,71910448907,2,645,721,-10
71915606185,71915606187,2,1557,1014,-10
71919952487,71919952489,2,1506,1618,-10
71920675162,71920675166,4,1157,1118,-10
71922121929,71922121930,1,1631,1106,-10
71923132711,71923132714,3,2060,1673,-10
71923941555,71923941555,0,1189,1707,-10
71927756730,71927756731,1,1560,1595,-10
71928735294,71928735299,5,3146,2011,-10
71929063084,71929063085,1,1309,1666,-10
71935096759,71935096763,4,1360,1484,-10
71936314985,71936314986,1,1105,1399,-10
71938356981,71938356973,-8,2672,10001,-10
71942945095,71942945095,0,1288,1290,-10
71943000488,71943000504,16,2299,2163,-10
71945138330,71945138329,-1,1926,1614,-10
71947539332,71947539337,5,1320,916,-10
71947860366,71947860386,20,1516,1756,-10
71950815831,71950815834,3,1401,1813,-10
71952261398,71952261393,-5,1591,4105,-10
71954329749,71954329752,3,1821,1267,-10
71957693351,71957693352,1,1708,1691,-10
71958610530,71958610532,2,1514,1798,-10
71959281963,71959281968,5,2010,1109,-10
71960392452,71960392454,2,1449,1470,-10
71967586160,71967586163,3,1843,1019,-10
71970107798,71970107801,3,1640,1464,-10
71970557629,71970557632,3,1085,1556,-10
71972003067,71972003069,2,1053,1220,-10
71979580613,71979580614,1,1005,939,-10
71982150962,71982150966,4,1477,1725,-10
71984584890,71984584893,3,1235,1599,-10
71986087776,71986087764,-12,1470,1491,-10
71988515705,71988515708,3,1408,1256,-10
71989543160,71989543162,2,1584,1701,-10
71989620724,71989620724,0,1687,1603,-10
71990890554,71990890554,0,1101,1542,-10
71993057018,71993057023,5,3164,1704,-10
71993211355,71993211359,4,1143,798,-10
71996641926,71996641926,0,1264,1690,-10
71997656169,71997656169,0,1191,1010,-10
71998882444,71998882446,2,1359,1552,-10
72006424525,72006424527,2,1665,1176,-10
72007933767,72007933769,2,1331,1831,-10
72008326626,72008326624,-2,552,1264,-10
72009594710,72009594712,2,1576,1819,-10
72012958172,72012958174,2,1575,1160,-10
72014779394,72014779401,7,2015,1264,-10
72016422642,72016422649,7,4852,3108,-10
72016764691,72016764690,-1,1407,1473,-10
72017497337,72017497340,3,1391,1942,-10
72017555912,72017555921,9,1140,1058,-10
72020988183,72020988185,2,1889,1906,-10
72024261659,72024261662,3,1506,1391,-10
72025339146,72025339147,1,1651,2378,-10
72026437631,72026437633,2,1570,1634,-10
72033535458,72033535459,1,1138,1137,-10
72033734773,72033734775,2,1962,1935,-10
72034996929,72034996930,1,1113,1085,-10
72037134022,72037134022,0,1319,1548,-10
72037540380,72037540382,2,1518,2089,-10
72038739619,72038739619,0,1357,1806,-10
72038993478,72038993482,4,931,981,-10
72039342466,72039342466,0,1120,1125,-10
72043685835,72043685828,-7,1326,5025,-10
72044073849,72044073851,2,1894,2158,-10
72044210442,72044210444,2,1726,1659,-10
72044904547,72044904542,-5,695,1439,-10
72046983805,72046983807,2,1183,1506,-10
72048287160,72048287163,3,1915,1951,-10
72050363038,72050363039,1,1108,1375,-10
72050772467,72050772472,5,1724,1500,-10
72052028359,72052028359,0,2291,3359,-10
72065498202,72065498204,2,2776,1429,-10
72068549751,72068549749,-2,1180,1801,-10
72071175149,72071175153,4,2320,1695,-10
72078184208,72078184209,1,1371,2107,-10
72079803250,72079803253,3,1433,1240,-10
72080029693,72080029695,2,1687,1723,-10
72080987921,72080987922,1,1466,1541,-10
72081451733,72081451734,1,1360,1457,-10
72087289287,72087289289,2,2068,2272,-10
72087588737,72087588738,1,1334,1294,-10
72088175189,72088175190,1,1996,1680,-10
72089283530,72089283532,2,1585,1518,-10
72092232814,72092232819,5,2911,1468,-10
72097637306,72097637308,2,1401,1655,-10
72098493439,72098493443,4,1883,1516,-10
72098844503,72098844503,0,1201,1718,-10
72101035121,72101035121,0,1434,1988,-10
72103300385,72103300386,1,1560,931,-10
72104426309,72104426313,4,1982,1738,-10
72105009382,72105009379,-3,25789,10216,-10
72105187209,72105187195,-14,1084,814,-10
72106518698,72106518679,-19,1700,1429,-10
72106749374,72106749377,3,1776,1577,-10
72114212621,72114212622,1,1021,1069,-10
72115917090,72115917091,1,1257,1132,-10
72117331525,72117331526,1,1502,1478,-10
72119442916,72119442915,-1,1532,2017,-10
72119806906,72119806906,0,1949,1812,-10
72121873400,72121873403,3,1862,1460,-10
72129823674,72129823670,-4,4186,10119,-10
72136142270,72136142270,0,1594,1661,-10
72136411873,72136411873,0,1334,1546,-10
72137264997,72137264998,1,2253,1637,-10
72142960439,72142960441,2,1435,1985,-10
72142988765,72142988769,4,2437,1607,-10
72144070990,72144070996,6,1991,1329,-10
72145150417,72145150414,-3,1128,2064,-10
72146031599,72146031598,-1,1151,1131,-10
72147338993,72147338994,1,1988,1776,-10
72149284709,72149284710,1,1763,1866,-10
72151670407,72151670402,-5,761,3183,-10
72153683648,72153683651,3,1832,1427,-10
72154232036,72154232037,1,1488,1194,-10
72162377121,72162377121,0,1572,1980,-10
72166747994,72166747994,0,2021,1055,-10
72170125422,72170125420,-2,1021,2414,-10
72171041356,72171041350,-6,1466,5325,-10
72171875848,72171875845,-3,1675,3595,-10
72175244883,72175244860,-23,1197,1120,-10
72175524610,72175524613,3,1886,2482,-10
72175628201,72175628203,2,1676,1494,-10
72175848893,72175848895,2,1877,1297,-10
72177212277,72177212277,0,1513,1171,-10
72180306997,72180306998,1,1645,1399,-10
72182307143,72182307146,3,1151,1386,-10
72182718789,72182718770,-19,1278,1232,-10
72183863727,72183863704,-23,1572,798,-10
72185260977,72185260977,0,931,1473,-10
72186844272,72186844272,0,1553,1873,-10
72188863586,72188863587,1,1252,1694,-10
72189315441,72189315442,1,1367,1447,-10
72189537014,72189537010,-4,983,2818,-10
72190131993,72190132002,9,209,718,-10
72191522564,72191522567,3,2087,1520,-10
72191582990,72191582992,2,1595,1531,-10
72193521262,72193521263,1,1111,1263,-10
72193900921,72193900922,1,1610,2571,-10
72195824005,72195824006,1,1500,1249,-10
72196383919,72196383920,1,1713,1307,-10
72197583893,72197583896,3,18548,26697,-10
72198314700,72198314701,1,1697,1694,-10
72198686352,72198686350,-2,1387,1187,-10
72199339706,72199339703,-3,1078,820,-10
72201083397,72201083398,1,2104,1923,-10
72202712958,72202712954,-4,2911,5907,-10
72207368579,72207368581,2,1713,1520,-10
72207566478,72207566458,-20,1843,1605,-10
72208364720,72208364723,3,1715,1598,-10
72209480908,72209480910,2,1433,1390,-10
72210227546,72210227549,3,2610,1762,-10
72212167594,72212167599,5,1904,1414,-10
72213434723,72213434721,-2,973,1503,-10
72213893291,72213893297,6,290,2571,-10
72216956067,72216956066,-1,1978,2555,-10
72218651342,72218651343,1,1191,1063,-10
72220152118,72220152121,3,1511,1257,-10
72222318148,72222318150,2,1297,1210,-10
72226223608,72226223609,1,1753,1442,-10
72228824451,72228824469,18,910,1267,-10
72230468727,72230468726,-1,1145,1258,-10
72235416045,72235416045,0,1605,1510,-10
72243117142,72243117144,2,3142,3000,-10
72245304024,72245304026,2,1513,1934,-10
72246105337,72246105338,1,916,912,-10
72251032952,72251032953,1,1417,1658,-10
72251476495,72251476496,1,1010,1313,-10
72252259459,72252259458,-1,1313,676,-10
72254716869,72254716870,1,1418,1518,-10
72255364401,72255364403,2,906,1010,-10
72257494060,72257494063,3,1605,1601,-10
72258544271,72258544270,-1,1788,1967,-10
72258577352,72258577357,5,1225,1132,-10
72260986230,72260986238,8,17390,13865,-10
72261636294,72261636298,4,1544,976,-10
72261840708,72261840709,1,1474,1398,-10
72264933379,72264933384,5,2244,1815,-10
72269568925,72269568920,-5,983,3730,-10
72269962481,72269962482,1,1932,1569,-10
72272207334,72272207338,4,1404,1755,-10
72275572939,72275572941,2,1340,1439,-10
72278251306,72278251311,5,2069,1586,-10
72279483715,72279483717,2,1805,1798,-10
72289718474,72289718476,2,1180,1305,-10
72290661123,72290661126,3,2137,2121,-10
72292181387,72292181389,2,1204,1102,-10
72296591725,72296591730,5,1286,1300,-10
72297908857,72297908872,15,1040,1035,-10
72300561761,72300561763,2,1425,1102,-10
72305596163,72305596164,1,1676,2014,-10
72306887217,72306887219,2,1652,1036,-10
72308934973,72308934976,3,2031,1653,-10
72309570868,72309570869,1,1685,1489,-10
72316344103,72316344110,7,7972,2742,-10
72317782222,72317782222,0,1073,1425,-10
72320073693,72320073695,2,2232,1600,-10
72321779853,72321779854,1,1932,1213,-10
72322177890,72322177890,0,1649,2065,-10
72323214647,72323214624,-23,1194,900,-10
72327880511,72327880513,2,1476,1493,-10
72330446661,72330446661,0,1337,1704,-10
72335199742,72335199744,2,1431,1408,-10
72335422353,72335422354,1,1256,1586,-10
72335507002,72335507003,1,1079,1133,-10
72336955437,72336955439,2,1055,1076,-10
72339973533,72339973536,3,1935,1548,-10
72341707839,72341707842,3,1738,1236,-10
72342513086,72342513065,-21,2294,2241,-10
72354734594,72354734595,1,1693,1487,-10
72363247946,72363247947,1,2171,1674,-10
72364089308,72364089310,2,1490,1233,-10
72369992497,72369992502,5,2113,1619,-10
72371022584,72371022581,-3,882,2421,-10
72371406501,72371406502,1,1228,1591,-10
72378321474,72378321473,-1,1510,2342,-10
72379895186,72379895187,1,1409,1399,-10
72381224978,72381224978,0,1377,1515,-10
72381504030,72381504033,3,1974,2023,-10
72382848266,72382848266,0,1782,2377,-10
72384050057,72384050058,1,1698,1214,-10
72384272699,72384272707,8,867,221,-10
72389332146,72389332147,1,1904,1437,-10
72389411269,72389411271,2,1759,1706,-10
72393172385,72393172387,2,1269,1236,-10
72398180078,72398180081,3,1363,957,-10
72405158394,72405158396,2,1632,1515,-10
72406338147,72406338162,15,1133,1282,-10
72408164893,72408164900,7,2373,1302,-10
72408780817,72408780818,1,1972,1726,-10
72409251935,72409251938,3,3631,3684,-10
72413134221,72413134223,2,2026,2350,-10
72415217333,72415217333,0,1567,1400,-10
72415537434,72415537447,13,11674,48151,-10
72415703254,72415703259,5,1375,1191,-10
72419712186,72419712189,3,1484,1290,-10
72421614355,72421614356,1,1627,1446,-10
72421805093,72421805094,1,1449,1787,-10
72422207868,72422207867,-1,61355,59258,-10
72423222389,72423222381,-8,1068,4133,-10
72423366573,72423366575,2,1529,1071,-10
72425825130,72425825133,3,637,1413,-10
72426003150,72426003142,-8,1450,6013,-10
72426172859,72426172862,3,855,1082,-10
72428129726,72428129730,4,2632,1967,-10
72428164710,72428164713,3,1931,2049,-10
72437483498,72437483497,-1,1472,1644,-10
72444169984,72444169981,-3,2439,6178,-10
72444879643,72444879646,3,2227,1885,-10
72446746744,72446746745,1,1178,1359,-10
72448433742,72448433742,0,1333,1877,-10
72448557554,72448557533,-21,1371,1287,-10
72448704080,72448704082,2,1942,1528,-10
72451937564,72451937566,2,2120,1828,-10
72453376040,72453376042,2,1727,1143,-10
72457094349,72457094351,2,2401,2167,-10
72457950550,72457950552,2,1997,1769,-10
72461239267,72461239270,3,1784,1652,-10
72472526090,72472526093,3,1308,1487,-10
72478565176,72478565177,1,1780,990,-10
72479182168,72479182171,3,1440,1271,-10
72479478347,72479478353,6,1592,1368,-10
72482326400,72482326401,1,1153,1158,-10
72485127495,72485127496,1,1613,1166,-10
72486291981,72486291983,2,1202,1265,-10
72489929770,72489929771,1,1657,1673,-10
72490394219,72490394221,2,939,1292,-10
72490896772,72490896754,-18,1324,1206,-10
72491466761,72491466762,1,1101,1275,-10
72494680387,72494680389,2,1320,1263,-10
72497191657,72497191659,2,1188,1821,-10
72500508319,72500508321,2,1596,1957,-10
72505504780,72505504779,-1,1941,1554,-10
72505798359,72505798357,-2,1214,2547,-10
72507434792,72507434794,2,1758,1507,-10
72511389283,72511389282,-1,6696,12977,-10
72511600663,72511600666,3,2121,1896,-10
72512203841,72512203834,-7,92,3322,-10
72513919364,72513919368,4,2520,1117,-10
72515694492,72515694493,1,1927,2096,-10
72516673456,72516673459,3,1863,1454,-10
72517110286,72517110289,3,1239,1074,-10
72518903028,72518903029,1,2393,2083,-10
72519331627,72519331631,4,1437,1365,-10
72522751103,72522751104,1,1944,1403,-10
72523260326,72523260329,3,2495,1539,-10
72524097952,72524097953,1,1869,1985,-10
72525177234,72525177234,0,1230,1519,-10
72525685053,72525685057,4,1585,1221,-10
72525774906,72525774906,0,1273,1877,-10
72529108201,72529108202,1,2069,1864,-10
72531460158,72531460158,0,1865,1999,-10
72534759471,72534759479,8,1925,1045,-10
72535497378,72535497381,3,1484,1295,-10
72536067595,72536067596,1,1471,1836,-10
72536585707,72536585702,-5,1252,2883,-10
72536630256,72536630258,2,1569,1565,-10
72537858396,72537858399,3,2365,1494,-10
72538815262,72538815264,2,1524,1814,-10
72539013050,72539013054,4,1746,1774,-10
72539875229,72539875231,2,1499,1567,-10
72544292499,72544292502,3,1777,1652,-10
72544571699,72544571705,6,2524,1408,-10
72550288158,72550288159,1,1466,1150,-10
72551740103,72551740107,4,1946,1606,-10
72552611226,72552611226,0,1385,1185,-10
72553107534,72553107519,-15,1243,938,-10
72555331764,72555331767,3,1263,1792,-10
72555401786,72555401786,0,1459,1114,-10
72556275092,72556275094,2,1316,1271,-10
72557689552,72557689554,2,1273,1653,-10
72557825290,72557825293,3,1708,1559,-10
72558157023,72558157026,3,1658,1305,-10
72560294503,72560294503,0,1041,1296,-10
72560637034,72560637037,3,1840,1071,-10
72560708921,72560708923,2,1635,1556,-10
72563257357,72563257362,5,3589,1598,-10
72564811507,72564811510,3,887,1214,-10
72568222594,72568222595,1,1123,1055,-10
72574332114,72574332117,3,1467,1020,-10
72575486697,72575486698,1,1379,1541,-10
72576941926,72576941931,5,2247,1639,-10
72578220663,72578220663,0,1371,1324,-10
72580937284,72580937285,1,1602,1317,-10
72582717843,72582717846,3,1553,1333,-10
72585317990,72585317991,1,2053,1922,-10
72585394016,72585394017,1,2250,2132,-10
72586844261,72586844262,1,1502,1947,-10
72588876938,72588876946,8,12315,1376,-10
72589751247,72589751249,2,1414,1456,-10
72589976148,72589976150,2,1432,1404,-10
72591087935,72591087939,4,1203,937,-10
72593525268,72593525250,-18,1608,2003,-10
72593810653,72593810660,7,11038,37058,-10
72596884498,72596884499,1,1139,1082,-10
72599588447,72599588444,-3,1406,4267,-10
72599935024,72599935026,2,1606,1448,-10
72600275346,72600275349,3,1134,1362,-10
72603618949,72603618950,1,1386,1288,-10
72608706836,72608706838,2,2156,2080,-10
72609496770,72609496774,4,1347,1239,-10
72610108455,72610108458,3,1616,1263,-10
72616520648,72616520651,3,1722,1273,-10
72618464210,72618464210,0,1597,1447,-10
72618713455,72618713458,3,907,1451,-10
72619948370,72619948370,0,1743,1341,-10
72621938290,72621938291,1,1129,1292,-10
72627504553,72627504574,21,692,976,-10
72628271998,72628272000,2,1249,1479,-10
72630881140,72630881139,-1,2949,4375,-10
72631575046,72631575047,1,1863,2186,-10
72633576382,72633576383,1,1653,1728,-10
72634411435,72634411437,2,1574,1639,-10
72641790409,72641790413,4,1835,2385,-10
72642420019,72642420001,-18,1456,1288,-10
72645283325,72645283326,1,1567,1302,-10
72646977747,72646977750,3,1911,1603,-10
72647672802,72647672805,3,1360,1633,-10
72649386371,72649386373,2,1749,1864,-10
72650421049,72650421050,1,1979,2535,-10
72651245066,72651245067,1,1799,1405,-10
72652520229,72652520234,5,58526,92504,-10
72652837486,72652837489,3,1834,1424,-10
72654906981,72654906996,15,1006,1643,-10
72655048269,72655048265,-4,2214,5488,-10
72656922645,72656922646,1,6687,7429,-10
72658388195,72658388199,4,1894,1285,-10
72661067858,72661067865,7,3841,1385,-10
72662597535,72662597536,1,1650,1596,-10
72663273134,72663273136,2,1562,1629,-10
72668174810,72668174810,0,2084,2219,-10
72669057462,72669057463,1,1105,1155,-10
72671026013,72671026017,4,1815,1702,-10
72671112549,72671112551,2,1079,1022,-10
72677158419,72677158421,2,1318,1272,-10
72678396278,72678396281,3,1596,1352,-10
72680786143,72680786142,-1,1389,1570,-10
72682800678,72682800684,6,12964,30683,-10
72683520006,72683520006,0,1492,1425,-10
72686508624,72686508626,2,1302,1475,-10
72686567163,72686567163,0,1236,2064,-10
72686648781,72686648782,1,1451,1346,-10
72687970207,72687970209,2,1364,1728,-10
72689205859,72689205862,3,1450,1211,-10
72690730437,72690730441,4,1572,938,-10
72691560899,72691560900,1,881,853,-10
72692748197,72692748200,3,1331,1466,-10
72693930511,72693930513,2,1280,1143,-10
72694310128,72694310129,1,1489,1271,-10
72694835243,72694835243,0,1368,1626,-10
72699383649,72699383650,1,1708,1208,-10
72700171762,72700171763,1,2843,4234,-10
72702767954,72702767948,-6,2062,11627,-10
72707437323,72707437327,4,1567,1415,-10
72708747362,72708747362,0,1222,1648,-10
72711607163,72711607169,6,2164,1226,-10
72713930149,72713930130,-19,1684,1958,-10
72717671292,72717671292,0,1547,2066,-10
72718506018,72718506019,1,1314,1548,-10
72719242404,72719242406,2,1201,867,-10
72720066045,72720066048,3,1813,1354,-10
72721810019,72721810018,-1,1276,1655,-10
72724245278,72724245281,3,1971,1956,-10
72727750457,72727750461,4,1292,1513,-10
72727801074,72727801074,0,1149,1447,-10
72728370980,72728370982,2,1057,1157,-10
72732639059,72732639061,2,5630,25247,-10
72732893469,72732893467,-2,1229,1394,-10
72733554231,72733554234,3,1374,1447,-10
72734399882,72734399885,3,1464,1602,-10
72737534558,72737534561,3,1451,1276,-10
72738229889,72738229890,1,1702,1905,-10
72739893893,72739893895,2,1284,1501,-10
72740576857,72740576876,19,348,457,-10
72744066447,72744066449,2,1610,1476,-10
72750604758,72750604762,4,1979,1529,-10
72751410246,72751410248,2,1970,1182,-10
72751631820,72751631823,3,2036,1624,-10
72755645403,72755645405,2,1379,1146,-10
72760308863,72760308865,2,1730,1583,-10
72767077792,72767077794,2,1670,1613,-10
72767474566,72767474569,3,1455,2202,-10
72768041710,72768041711,1,1347,1365,-10
72769311603,72769311605,2,1904,1599,-10
72770874931,72770874931,0,1475,1284,-10
72774232005,72774232008,3,1501,1434,-10
72774786517,72774786510,-7,1764,5296,-10
72775470277,72775470277,0,1506,1381,-10
72779174330,72779174333,3,1707,1481,-10
72780718306,72780718309,3,1044,1344,-10
72784978923,72784978926,3,2194,1765,-10
72791093606,72791093610,4,1134,1416,-10
72791697553,72791697570,17,1848,1375,-10
72793222093,72793222095,2,1439,1634,-10
72793583566,72793583566,0,1555,1734,-10
72793954805,72793954809,4,1690,1679,-10
72799109572,72799109574,2,1325,1834,-10
72800387181,72800387183,2,2136,1154,-10
72806661730,72806661731,1,2027,1765,-10
72808423249,72808423251,2,1425,1435,-10
72810333722,72810333725,3,1188,1313,-10
72811634781,72811634782,1,1153,1157,-10
72812116859,72812116862,3,1421,1163,-10
72812944301,72812944310,9,936,1513,-10
72813474352,72813474354,2,2060,1721,-10
72815039887,72815039891,4,1601,1266,-10
72815785571,72815785572,1,1634,1207,-10
72815896093,72815896098,5,1525,1048,-10
72817828918,72817828919,1,1431,1411,-10
72822288866,72822288868,2,1697,1533,-10
72823301576,72823301579,3,973,1388,-10
72823838417,72823838419,2,1826,1751,-10
72826904546,72826904550,4,1743,1217,-10
72829825838,72829825839,1,1536,1412,-10
72834824770,72834824770,0,1361,1090,-10
72835151117,72835151120,3,1993,1812,-10
72835801015,72835801017,2,1000,1195,-10
72836317269,72836317270,1,1919,1651,-10
72837157557,72837157554,-3,798,2931,-10
72844372901,72844372902,1,934,879,-10
72844718061,72844718063,2,1522,1368,-10
72845410212,72845410214,2,1954,1458,-10
72845751333,72845751335,2,1201,1672,-10
72847642022,72847642025,3,1584,1472,-10
72850534390,72850534392,2,1228,1773,-10
72850731328,72850731329,1,2002,2004,-10
72862707708,72862707710,2,1858,1196,-10
72863574171,72863574174,3,1227,1179,-10
72873870800,72873870802,2,1386,1387,-10
72877330019,72877330022,3,2054,1640,-10
72880200554,72880200554,0,1928,1417,-10
72881067566,72881067567,1,1873,1746,-10
72884700678,72884700679,1,1850,1481,-10
72884730063,72884730066,3,2248,1648,-10
72889474714,72889474714,0,1131,1107,-10
72891139662,72891139664,2,2005,1331,-10
72898773489,72898773490,1,1555,1465,-10
72900930967,72900930969,2,1523,1471,-10
72903539794,72903539795,1,1799,1609,-10
72904142276,72904142278,2,2032,1640,-10
72905329702,72905329703,1,1864,1861,-10
72905629619,72905629622,3,1872,1953,-10
72910562526,72910562527,1,1765,1486,-10
72910907685,72910907688,3,1872,1640,-10
72914476850,72914476853,3,1436,949,-10
72920891950,72920891954,4,1409,1176,-10
72921751386,72921751386,0,1186,1634,-10
72924807227,72924807231,4,1752,1505,-10
72926855091,72926855091,0,1377,1409,-10
72932147822,72932147824,2,1933,1286,-10
72932231814,72932231814,0,1342,1572,-10
72936216109,72936216119,10,16282,23207,-10
72936947282,72936947284,2,1580,1872,-10
72937386429,72937386431,2,2128,1601,-10
72937951101,72937951099,-2,1079,1951,-10
72938848977,72938848979,2,1004,1266,-10
72939753182,72939753185,3,1613,1630,-10
72941786362,72941786363,1,1151,1535,-10
72942102263,72942102267,4,1795,1186,-10
72942316783,72942316802,19,1036,1632,-10
72949346058,72949346062,4,1466,1697,-10
72951445142,72951445143,1,1219,1542,-10
72952590105,72952590109,4,1449,1925,-10
72953964802,72953964803,1,919,1355,-10
72955518970,72955518972,2,1781,2052,-10
72958811997,72958811998,1,1235,1459,-10
72960065894,72960065895,1,1416,1420,-10
72964970648,72964970654,6,2763,1249,-10
72965079054,72965079056,2,1861,1511,-10
72965913858,72965913859,1,1353,1299,-10
72966626486,72966626489,3,1770,1739,-10
72971375455,72971375456,1,1747,1528,-10
72973228678,72973228681,3,1955,1505,-10
72973613801,72973613802,1,1063,919,-10
72976205494,72976205495,1,1477,1491,-10
72977674418,72977674419,1,1072,1206,-10
72981536858,72981536858,0,1079,998,-10
72982813315,72982813314,-1,1824,2181,-10
72983572649,72983572649,0,1663,2201,-10
72983629490,72983629495,5,1775,1407,-10
72983808838,72983808840,2,1488,1282,-10
72987473068,72987473071,3,2307,1582,-10
72988403213,72988403214,1,2139,1711,-10
72988970802,72988970798,-4,2039,5216,-10
72990012830,72990012834,4,1338,1732,-10
72990971642,72990971636,-6,1092,3811,-10
72991567337,72991567339,2,2111,2095,-10
72992807925,72992807926,1,1055,1518,-10
72994243532,72994243530,-2,986,1413,-10
73002968255,73002968258,3,1583,1484,-10
73008091815,73008091817,2,1103,1972,-10
73009422176,73009422177,1,1371,1458,-10
73009906483,73009906481,-2,1864,2160,-10
73015840454,73015840454,0,1521,1423,-10
73016706795,73016706798,3,1185,1703,-10
73018248374,73018248369,-5,27184,14590,-10
73024082041,73024082041,0,1765,1889,-10
73024994762,73024994762,0,1645,1553,-10
73025733223,73025733224,1,1220,1526,-10
73029143693,73029143695,2,1580,1475,-10
73030228460,73030228461,1,1710,1924,-10
73030708662,73030708659,-3,1252,3272,-10
73031028793,73031028775,-18,32,1447,-10
73034150748,73034150751,3,1471,1229,-10
73044599017,73044599019,2,1447,1455,-10
73045550817,73045550818,1,1758,1732,-10
73047089622,73047089623,1,1625,1560,-10
73048271221,73048271222,1,1467,1519,-10
73051580597,73051580594,-3,1465,2750,-10
73052036328,73052036350,22,1472,3014,-10
73055965180,73055965181,1,1552,1001,-10
73058576586,73058576587,1,1775,1943,-10
73059025580,73059025582,2,1321,2125,-10
73060556654,73060556657,3,1744,1391,-10
73060737342,73060737341,-1,1772,2507,-10
73061360117,73061360117,0,1443,1112,-10
73068373496,73068373497,1,1302,1016,-10
73069929099,73069929104,5,1424,1408,-10
73075563749,73075563752,3,1512,1826,-10
73079953949,73079953951,2,1741,1489,-10
73080189181,73080189182,1,1574,1477,-10
73083726982,73083726985,3,1625,1572,-10
73085561498,73085561501,3,2076,1582,-10
73087251523,73087251522,-1,2213,2119,-10
73087471410,73087471413,3,1086,1145,-10
73089079334,73089079334,0,885,892,-10
73092214562,73092214565,3,2343,1486,-10
73095528734,73095528735,1,1324,1449,-10
73097682990,73097682991,1,1411,1595,-10
73098494448,73098494449,1,1258,1515,-10
73101413159,73101413161,2,1862,1439,-10
73104395148,73104395150,2,1673,1418,-10
73105037659,73105037653,-6,1874,8539,-10
73108131010,73108131013,3,1342,1181,-10
73108579967,73108579970,3,1449,2175,-10
73112721234,73112721233,-1,2380,3858,-10
73114892473,73114892473,0,1879,1898,-10
73116655430,73116655430,0,1178,1403,-10
73117192353,73117192359,6,7200,3385,-10
73118693979,73118693982,3,1496,1345,-10
73119268354,73119268355,1,1840,1620,-10
73119994005,73119994009,4,1762,1260,-10
73120473076,73120473079,3,1315,1164,-10
73123465552,73123465553,1,1477,1182,-10
73129533992,73129533994,2,1832,1347,-10
73130052795,73130052802,7,3311,1190,-10
73131025557,73131025556,-1,1372,2222,-10
73133216737,73133216739,2,1394,1373,-10
73133287414,73133287414,0,948,1267,-10
73138512118,73138512116,-2,1115,1803,-10
73138857713,73138857718,5,1937,1503,-10
73138993858,73138993871,13,13626,40409,-10
73140968429,73140968431,2,1825,1901,-10
73145078822,73145078825,3,1299,1089,-10
73146913684,73146913686,2,1895,1591,-10
73149045943,73149045944,1,2111,2009,-10
73149738302,73149738303,1,1027,1622,-10
73154172537,73154172539,2,2371,1261,-10
73156834161,73156834162,1,1645,1850,-10
73159792823,73159792827,4,1364,1395,-10
73162142921,73162142922,1,1527,1517,-10
73162313298,73162313301,3,2037,2143,-10
73165519922,73165519924,2,1801,1829,-10
73177477819,73177477820,1,1786,1769,-10
73185078183,73185078184,1,1128,1177,-10
73189268343,73189268345,2,2030,1763,-10
73189666910,73189666915,5,962,1306,-10
73190750058,73190750058,0,1601,1538,-10
73194296754,73194296755,1,2255,2677,-10
73197653433,73197653435,2,1517,2650,-10
73197850955,73197850953,-2,2763,4547,-10
73199458925,73199458925,0,1878,1966,-10
73200948168,73200948169,1,1165,1643,-10
73202875298,73202875299,1,1866,2460,-10
73205604836,73205604839,3,2615,1855,-10
73209595741,73209595744,3,1443,1543,-10
73212462463,73212462466,3,1963,1665,-10
73212905061,73212905063,2,1954,1621,-10
73213393825,73213393827,2,1757,1386,-10
73213864189,73213864189,0,873,1332,-10
73221346077,73221346081,4,3650,1435,-10
73221385239,73221385239,0,1499,1497,-10
73221574549,73221574546,-3,1599,3700,-10
73221860774,73221860775,1,1413,1575,-10
73222045495,73222045497,2,1323,1668,-10
73223377102,73223377104,2,1310,921,-10
73228640554,73228640549,-5,1495,3535,-10
73229227431,73229227430,-1,1604,1320,-10
73230090426,73230090429,3,1253,1480,-10
73231525934,73231525934,0,1757,2090,-10
73232216955,73232216958,3,1769,2069,-10
73232828602,73232828606,4,1991,1858,-10
73236147654,73236147656,2,1369,1329,-10
73236368784,73236368781,-3,1735,2301,-10
73237459322,73237459323,1,1948,1345,-10
73239247837,73239247839,2,1436,1859,-10
73239686235,73239686235,0,1799,1791,-10
73240116919,73240116921,2,1339,837,-10
73241753677,73241753678,1,1788,1710,-10
73241845138,73241845139,1,1462,1349,-10
73243132245,73243132247,2,1873,2231,-10
73245531770,73245531769,-1,2920,4770,-10
73246436573,73246436576,3,1478,1663,-10
73246603059,73246603067,8,1503,1327,-10
73254428454,73254428455,1,1498,1458,-10
73254809793,73254809797,4,1665,1467,-10
73255780373,73255780375,2,1692,2386,-10
73257317476,73257317478,2,1170,1431,-10
73260967566,73260967570,4,1237,1557,-10
73265034817,73265034817,0,860,1453,-10
73266373313,73266373315,2,1531,1312,-10
73266705473,73266705475,2,1395,1122,-10
73269512170,73269512171,1,1500,1784,-10
73275654169,73275654173,4,2285,1672,-10
73277169251,73277169249,-2,1177,1540,-10
73277528726,73277528730,4,1274,1075,-10
73277765471,73277765472,1,659,1184,-10
73278680926,73278680928,2,1941,1521,-10
73279067226,73279067211,-15,2781,919,-10
73279285406,73279285408,2,1162,1573,-10
73283531261,73283531262,1,1164,1636,-10
73286248733,73286248735,2,1521,1867,-10
73286778314,73286778317,3,1323,1573,-10
73287639083,73287639085,2,1382,1806,-10
73291675506,73291675505,-1,1197,1637,-10
73295991045,73295991047,2,1596,1726,-10
73297460120,73297460122,2,2228,1467,-10
73299748694,73299748694,0,2456,1854,-10
73301268907,73301268910,3,1333,1501,-10
73301300050,73301300051,1,1215,1183,-10
73305562731,73305562734,3,1240,1211,-10
73308305575,73308305577,2,1080,1367,-10
73308836646,73308836649,3,1280,1811,-10
73313236519,73313236518,-1,1333,1920,-10
73315565131,73315565134,3,1452,772,-10
73316142759,73316142761,2,2256,1333,-10
73317154525,73317154527,2,1444,940,-10
73322155282,73322155285,3,1313,1172,-10
73322187664,73322187666,2,1683,1507,-10
73322260185,73322260184,-1,1799,1800,-10
73325050382,73325050386,4,1859,2106,-10
73325760316,73325760317,1,1682,1039,-10
73327357113,73327357115,2,1593,1901,-10
73331426215,73331426219,4,3270,2134,-10
73336372225,73336372244,19,1869,1395,-10
73339489775,73339489778,3,1662,1435,-10
73339893957,73339893960,3,1676,1549,-10
73340472187,73340472190,3,1160,1527,-10
73340583092,73340583094,2,2066,1888,-10
73342640131,73342640133,2,1999,1407,-10
73343350976,73343350970,-6,1295,7304,-10
73343466947,73343466945,-2,18703,22828,-10
73345877968,73345877968,0,1306,1587,-10
73346410555,73346410557,2,1700,1806,-10
73346664717,73346664718,1,1491,1761,-10
73350855566,73350855572,6,2229,1179,-10
73355411710,73355411710,0,1324,1180,-10
73357804419,73357804422,3,1580,1040,-10
73359191323,73359191326,3,1896,1994,-10
73362489071,73362489073,2,1798,1896,-10
73362585734,73362585737,3,2146,1865,-10
73363574945,73363574950,5,1146,1022,-10
73364214588,73364214589,1,1898,1587,-10
73366501914,73366501916,2,1028,1524,-10
73369585514,73369585515,1,1393,1330,-10
73370285575,73370285595,20,1954,1764,-10
73370613552,73370613554,2,1138,1205,-10
73371407392,73371407393,1,1295,1725,-10
73376046214,73376046218,4,2101,1664,-10
73376411217,73376411217,0,1187,1362,-10
73376511386,73376511388,2,1022,1290,-10
73377805201,73377805205,4,2164,1585,-10
73379690122,73379690125,3,1275,1646,-10
73383737288,73383737290,2,1210,1437,-10
73385357243,73385357247,4,1336,1020,-10
73387417803,73387417804,1,2143,2184,-10
73389630526,73389630527,1,1544,2347,-10
73390013987,73390013990,3,2335,1767,-10
73390482646,73390482649,3,1187,1541,-10
73392514178,73392514182,4,2039,2317,-10
73393076343,73393076345,2,1262,1424,-10
73397349294,73397349274,-20,227,667,-10
73397833018,73397833020,2,2037,1671,-10
73399760679,73399760682,3,1587,1692,-10
73407036976,73407036979,3,972,1017,-10
73408545343,73408545343,0,1643,1997,-10
73409000154,73409000157,3,2263,2151,-10
73414908832,73414908836,4,1410,1425,-10
73415407825,73415407827,2,1758,1244,-10
73417989670,73417989673,3,2095,1617,-10
73418915238,73418915242,4,2693,1521,-10
73419217482,73419217484,2,1241,1829,-10
73421456657,73421456659,2,1834,1993,-10
73422420050,73422420053,3,1704,1333,-10
73422505602,73422505602,0,1707,1678,-10
73425947086,73425947087,1,1115,784,-10
73430015815,73430015817,2,1955,1592,-10
73431669635,73431669635,0,1382,1749,-10
73433902144,73433902145,1,1738,1302,-10
73436159110,73436159118,8,3249,1416,-10
73439305878,73439305880,2,1745,1801,-10
73442207763,73442207766,3,1603,1502,-10
73443364657,73443364658,1,1217,1518,-10
73444305163,73444305144,-19,1278,656,-10
73444341187,73444341189,2,1735,1928,-10
73448775618,73448775615,-3,1325,1106,-10
73449141753,73449141754,1,1954,1727,-10
73449332737,73449332742,5,1203,882,-10
73450906950,73450906955,5,1625,1393,-10
73451327286,73451327289,3,2028,1429,-10
73452966914,73452966918,4,1353,1171,-10
73453006572,73453006587,15,3228,1274,-10
73455774494,73455774496,2,1336,1850,-10
73456532263,73456532263,0,1486,1792,-10
73457054742,73457054743,1,1166,1145,-10
73457865362,73457865365,3,941,1390,-10
73459845953,73459845957,4,2740,1711,-10
73462801868,73462801867,-1,1269,1683,-10
73466164186,73466164188,2,1940,1585,-10
73466262116,73466262119,3,1993,1652,-10
73466883549,73466883551,2,2248,2182,-10
73470598667,73470598667,0,1568,1855,-10
73472915073,73472915076,3,1684,1835,-10
73475986690,73475986684,-6,2102,7531,-10
73476775163,73476775166,3,845,1165,-10
73479095759,73479095757,-2,1596,2584,-10
73479567723,73479567723,0,1017,1459,-10
73482758050,73482758053,3,1104,1557,-10
73486264595,73486264598,3,1085,1658,-10
73488059733,73488059734,1,1092,1257,-10
73488934710,73488934711,1,1285,1430,-10
73490567745,73490567749,4,2656,1911,-10
73493171306,73493171308,2,1108,1459,-10
73494230967,73494230969,2,1958,2006,-10
73494275939,73494275942,3,1077,1045,-10
73497154106,73497154112,6,5510,2464,-10
73497975109,73497975110,1,1654,1461,-10
73501752718,73501752722,4,1871,1712,-10
73503152386,73503152386,0,2578,4006,-10
73508493549,73508493550,1,1679,1302,-10
73512524950,73512524954,4,1256,1201,-10
73513565539,73513565534,-5,1264,4046,-10
73515847426,73515847429,3,1267,1293,-10
73516916037,73516916050,13,305,736,-10
73522820073,73522820054,-19,1881,1353,-10
73528536199,73528536202,3,1551,1644,-10
73528957151,73528957153,2,1959,1817,-10
73528991277,73528991279,2,1095,1491,-10
73538780211,73538780190,-21,1683,1637,-10
73538808493,73538808495,2,1721,2026,-10
73540075297,73540075301,4,921,1175,-10
73540976754,73540976753,-1,1172,1774,-10
73541381902,73541381903,1,1077,966,-10
73542147583,73542147577,-6,770,2609,-10
73542972197,73542972199,2,1975,2078,-10
73543032768,73543032774,6,3491,1290,-10
73547587105,73547587107,2,1742,1373,-10
73551364978,73551364979,1,1147,1463,-10
73552224380,73552224382,2,2324,2572,-10
73553416716,73553416718,2,1716,1498,-10
73553718190,73553718191,1,1488,1399,-10
73555091230,73555091231,1,1609,1588,-10
73556289576,73556289579,3,1207,930,-10
73564850854,73564850859,5,2262,1448,-10
73566987134,73566987135,1,1517,1406,-10
73569866025,73569866029,4,1627,1350,-10
73570719721,73570719722,1,1262,1763,-10
73572356939,73572356943,4,1428,1623,-10
73572467941,73572467944,3,1241,1127,-10
73574984978,73574984984,6,2488,1321,-10
73578275920,73578275921,1,1725,1970,-10
73580365078,73580365081,3,2104,1727,-10
73580634651,73580634654,3,1597,1344,-10
73581969764,73581969767,3,1316,638,-10
73582764681,73582764683,2,1187,1194,-10
73583526855,73583526856,1,935,1142,-10
73584162248,73584162241,-7,2338,5800,-10
73584305046,73584305047,1,1429,1297,-10
73585624427,73585624429,2,1889,1694,-10
73585989557,73585989559,2,1564,1753,-10
73586932213,73586932214,1,1515,1426,-10
73587111966,73587111947,-19,993,1363,-10
73587238273,73587238275,2,1585,1380,-10
73588250346,73588250349,3,1529,1363,-10
73592096368,73592096368,0,1619,1750,-10
73593019823,73593019825,2,1649,1406,-10
73593071316,73593071315,-1,1404,1566,-10
73598133607,73598133610,3,2541,2041,-10
73602911917,73602911920,3,1775,1697,-10
73605828655,73605828655,0,1352,1910,-10
73606557549,73606557549,0,1524,1732,-10
73606687793,73606687813,20,1361,3989,-10
73607913154,73607913161,7,2176,1206,-10
73609031930,73609031932,2,1866,1647,-10
73610570974,73610570974,0,1827,2561,-10
73611595611,73611595612,1,1866,1543,-10
73612538235,73612538236,1,1249,1212,-10
73615984448,73615984449,1,2075,1919,-10
73617248521,73617248522,1,2197,1835,-10
73618016388,73618016392,4,1950,1188,-10
73619091684,73619091687,3,1947,1535,-10
73619333442,73619333444,2,929,1216,-10
73619954626,73619954627,1,1134,1121,-10
73620981675,73620981675,0,1053,1545,-10
73623576371,73623576375,4,1409,1482,-10
73624686724,73624686726,2,1795,2534,-10
73625120402,73625120405,3,1517,1135,-10
73625633093,73625633094,1,1547,1541,-10
73625985211,73625985211,0,1855,2272,-10
73626209322,73626209325,3,2240,1720,-10
73627331873,73627331877,4,1442,1511,-10
73629405209,73629405207,-2,1442,1610,-10
73632746518,73632746519,1,1473,1034,-10
73637260479,73637260483,4,2084,1946,-10
73637828265,73637828268,3,1734,1382,-10
73639844138,73639844138,0,1637,1461,-10
73639943155,73639943158,3,1298,1632,-10
73642928367,73642928367,0,1123,1232,-10
73646786586,73646786590,4,1222,1446,-10
73647756344,73647756346,2,1560,1246,-10
73649796014,73649795994,-20,2136,2231,-10
73652343689,73652343691,2,1719,1594,-10
73652694367,73652694369,2,1325,1350,-10
73658411987,73658411993,6,3496,1173,-10
73661796537,73661796538,1,1547,1434,-10
73664997879,73664997879,0,1432,1657,-10
73667332774,73667332774,0,1904,1680,-10
73668967633,73668967632,-1,1606,2416,-10
73669636414,73669636415,1,1260,1469,-10
73670193795,73670193797,2,1136,1495,-10
73672912072,73672912071,-1,1392,2375,-10
73675117061,73675117062,1,1051,871,-10
73676517247,73676517249,2,1307,1534,-10
73679414022,73679414024,2,1662,1280,-10
73680723123,73680723123,0,2045,1942,-10
73686409549,73686409550,1,1208,1318,-10
73689411654,73689411655,1,1982,2161,-10
73689903941,73689903943,2,1579,1401,-10
73690933415,73690933417,2,1022,844,-10
73692145226,73692145227,1,1825,1993,-10
73695137526,73695137528,2,1335,1704,-10
73696520081,73696520083,2,1953,1887,-10
73696770475,73696770477,2,1222,2034,-10
73696916269,73696916267,-2,1695,2615,-10
73697000261,73697000262,1,2127,1875,-10
73699665661,73699665663,2,959,1341,-10
73701181561,73701181562,1,2180,2608,-10
73703500300,73703500283,-17,877,662,-10
73706679966,73706679976,10,767,517,-10
73709073657,73709073658,1,1140,1373,-10
73713112512,73713112517,5,2052,1294,-10
73713304161,73713304160,-1,946,1365,-10
73715343657,73715343659,2,1694,2041,-10
73721134601,73721134601,0,1894,1151,-10
73721603549,73721603551,2,1846,2129,-10
73722191801,73722191802,1,5212,4699,-10
73722922865,73722922866,1,1008,1232,-10
73724066709,73724066711,2,996,1342,-10
73726220029,73726220031,2,1580,1598,-10
73728261566,73728261566,0,356,1326,-10
73730224443,73730224443,0,1218,1505,-10
73731138396,73731138402,6,2016,1426,-10
73737141484,73737141484,0,18049,9258,-10
73738577773,73738577775,2,887,1749,-10
73739277530,73739277534,4,1724,1663,-10
73739476926,73739476926,0,1298,1746,-10
73741020878,73741020879,1,2201,2126,-10
73742037750,73742037749,-1,1329,1455,-10
73745153306,73745153306,0,1598,1733,-10
73745869677,73745869679,2,1570,1381,-10
73753248550,73753248551,1,1588,1819,-10
73756511286,73756511289,3,1551,1753,-10
73758727859,73758727874,15,9155,49207,-10
73759715204,73759715206,2,1688,1919,-10
73762217695,73762217696,1,2259,1770,-10
73765330859,73765330859,0,1276,1780,-10
73766324251,73766324253,2,2283,2078,-10
73767779954,73767779969,15,1720,1261,-10
73768515285,73768515286,1,1629,1486,-10
73769842854,73769842855,1,1862,1805,-10
73771916097,73771916098,1,1678,1435,-10
73772040791,73772040789,-2,1026,1571,-10
73773651318,73773651320,2,1462,1224,-10
73777151533,73777151533,0,1552,1601,-10
73780610634,73780610634,0,840,1103,-10
73780931514,73780931517,3,1869,2345,-10
73781999819,73781999824,5,1024,1457,-10
73784382066,73784382066,0,1225,1638,-10
73784978438,73784978442,4,1415,1667,-10
73785486168,73785486170,2,1127,1724,-10
73786474725,73786474727,2,1414,1588,-10
73787756449,73787756453,4,1831,1693,-10
73789721005,73789721008,3,1067,1322,-10
73794192872,73794192875,3,2165,1168,-10
73795433718,73795433720,2,2008,2168,-10
73796844490,73796844492,2,1159,1220,-10
73799171294,73799171295,1,2075,1687,-10
73799401539,73799401538,-1,2863,3717,-10
73799603956,73799603960,4,2013,2372,-10
73802383139,73802383141,2,1652,1487,-10
73802479697,73802479698,1,1424,1578,-10
73803437803,73803437802,-1,827,1283,-10
73803898658,73803898663,5,1078,968,-10
73805173149,73805173150,1,986,1353,-10
73809070184,73809070185,1,1911,2251,-10
73809691611,73809691615,4,1880,1514,-10
73817528745,73817528749,4,1934,1288,-10
73817918553,73817918555,2,2286,1702,-10
73818470762,73818470740,-22,1058,372,-10
73820668424,73820668426,2,20697,20366,-10
73824245306,73824245304,-2,1284,1607,-10
73825842933,73825842937,4,1547,1674,-10
73826248489,73826248486,-3,705,3094,-10
73830038021,73830038023,2,1850,1275,-10
73831446588,73831446591,3,2123,1490,-10
73833421809,73833421810,1,6930,6343,-10
73833859166,73833859167,1,1032,1270,-10
73835999302,73835999302,0,1421,1294,-10
73838163159,73838163159,0,2614,1625,-10
73839012618,73839012618,0,1576,1767,-10
73839605031,73839605033,2,2259,1473,-10
73840678402,73840678406,4,1753,1110,-10
73840867622,73840867624,2,1638,1452,-10
73842875982,73842875987,5,2305,1105,-10
73844306060,73844306057,-3,1321,2528,-10
73845108938,73845108940,2,1260,1159,-10
73846010451,73846010453,2,958,1325,-10
73847330567,73847330569,2,1004,1154,-10
73849639399,73849639399,0,1553,1674,-10
73853283779,73853283782,3,1631,1472,-10
73858640029,73858640034,5,1288,1091,-10
73867125278,73867125281,3,946,1001,-10
73870154869,73870154870,1,1388,1518,-10
73870938490,73870938493,3,1824,1304,-10
73871298144,73871298146,2,1316,1390,-10
73872619263,73872619266,3,1015,1292,-10
73874362395,73874362398,3,1463,1510,-10
73879948982,73879948981,-1,1083,1641,-10
73881094533,73881094537,4,2034,1218,-10
73884859345,73884859346,1,2149,1952,-10
73885987341,73885987343,2,1976,1578,-10
73894604417,73894604419,2,1505,1592,-10
73899413686,73899413686,0,1668,1281,-10
73905021471,73905021470,-1,859,1984,-10
73905924010,73905924015,5,2036,1228,-10
73906757944,73906757948,4,2101,1992,-10
73906890479,73906890482,3,1765,1180,-10
73908177102,73908177105,3,1210,997,-10
73911171007,73911171007,0,1353,1312,-10
73912750534,73912750531,-3,1872,4809,-10
73913513108,73913513110,2,1599,1707,-10
73915322482,73915322483,1,1345,1783,-10
73916311347,73916311351,4,1387,1328,-10
73916527905,73916527907,2,1614,1496,-10
73916750341,73916750343,2,1299,2179,-10
73917951779,73917951784,5,1615,1624,-10
73918692098,73918692099,1,1226,1838,-10
73919566593,73919566594,1,8409,7414,-10
73922492306,73922492309,3,1262,1455,-10
73923212327,73923212327,0,1539,1689,-10
73923395878,73923395879,1,1704,1857,-10
73924699338,73924699318,-20,1789,1433,-10
73928389976,73928389976,0,1296,2148,-10
73930676831,73930676835,4,2032,1938,-10
73931551565,73931551569,4,2188,1698,-10
73931864662,73931864663,1,1832,1453,-10
73932965022,73932965025,3,1455,1059,-10
73933416727,73933416728,1,1897,1965,-10
73934062142,73934062145,3,1859,1992,-10
73935108542,73935108542,0,1274,1475,-10
73941333505,73941333506,1,1969,1744,-10
73945139396,73945139397,1,1529,1313,-10
73945758406,73945758409,3,1376,1105,-10
73948732461,73948732462,1,1426,1731,-10
73951257800,73951257795,-5,2002,6573,-10
73955158108,73955158109,1,1225,1904,-10
73956561414,73956561418,4,1744,1640,-10
73958024730,73958024732,2,1362,1852,-10
73959087767,73959087770,3,1409,1721,-10
73959673314,73959673318,4,1585,1324,-10
73962241236,73962241237,1,1522,1747,-10
73964125886,73964125889,3,1254,1062,-10
73965111775,73965111778,3,1643,1692,-10
73972846910,73972846913,3,1419,1610,-10
73975171802,73975171799,-3,19234,45311,-10
73977921970,73977921974,4,1940,1801,-10
73981308678,73981308683,5,1500,1556,-10
73982975490,73982975493,3,1032,1119,-10
73984790537,73984790541,4,1719,1749,-10
73985129593,73985129592,-1,1421,1509,-10
73985471486,73985471488,2,1693,2370,-10
73991984651,73991984651,0,1430,1692,-10
73992790394,73992790394,0,1100,1078,-10
73997452843,73997452846,3,1520,1200,-10
73999604624,73999604627,3,1033,1426,-10
74000435451,74000435450,-1,1102,2235,-10
74002672246,74002672246,0,1836,1438,-10
74002846733,74002846737,4,1664,1613,-10
74005684153,74005684155,2,2047,1955,-10
74006368666,74006368667,1,2162,2146,-10
74008069729,74008069730,1,1558,1851,-10
74008564351,74008564330,-21,1638,1639,-10
74009679440,74009679434,-6,27821,12142,-10
74010412662,74010412665,3,1261,1413,-10
74017059469,74017059473,4,1243,1208,-10
74018411036,74018411028,-8,1210,1966,-10
74019649701,74019649702,1,1999,1846,-10
74022843254,74022843258,4,1401,2133,-10
74024174135,74024174139,4,1452,1917,-10
74025424475,74025424477,2,28665,32226,-10
74025805198,74025805197,-1,1690,1341,-10
74026207534,74026207534,0,1730,1357,-10
74031683935,74031683934,-1,1385,1810,-10
74032556534,74032556537,3,1355,1972,-10
74033251700,74033251702,2,1395,1363,-10
74038282157,74038282159,2,1309,1523,-10
74039811993,74039811993,0,1420,1239,-10
74046073389,74046073388,-1,2021,2284,-10
74047869970,74047869973,3,2120,1566,-10
74048252582,74048252587,5,1004,795,-10
74049630037,74049630034,-3,1460,2552,-10
74050160174,74050160175,1,1290,2039,-10
74054240491,74054240491,0,1346,2208,-10
74058417358,74058417359,1,1287,1224,-10
74061167350,74061167350,0,1137,1037,-10
74061379014,74061379014,0,934,1694,-10
74062576254,74062576255,1,1206,1292,-10
74065107358,74065107359,1,2079,1475,-10
74070978466,74070978468,2,1155,1655,-10
74073526677,74073526678,1,1319,1512,-10
74074784949,74074784953,4,1305,1455,-10
74081368497,74081368498,1,1461,1762,-10
74083411096,74083411099,3,2755,2064,-10
74083477058,74083477058,0,1403,1797,-10
74086448609,74086448612,3,1833,1349,-10
74087438933,74087438935,2,1822,1356,-10
74088354257,74088354258,1,1319,1690,-10
74092497357,74092497357,0,1354,1366,-10
74092640099,74092640101,2,975,1720,-10
74094847101,74094847103,2,1525,1398,-10
74094945618,74094945621,3,1794,1644,-10
74095359432,74095359430,-2,1060,1937,-10
74095466974,74095466979,5,1110,821,-10
74096554081,74096554083,2,997,1040,-10
74098085306,74098085307,1,1323,1474,-10
74098780704,74098780707,3,1948,1734,-10
74100075239,74100075238,-1,1467,1314,-10
74103502043,74103502046,3,1962,1653,-10
74105048672,74105048665,-7,1128,1219,-10
74107725058,74107725058,0,1501,1756,-10
74108304334,74108304339,5,2902,1357,-10
74119134346,74119134347,1,1334,1327,-10
74121979853,74121979854,1,1535,1390,-10
74124346505,74124346507,2,2150,1532,-10
74128372258,74128372258,0,1190,1677,-10
74134523625,74134523627,2,1829,1505,-10
74135076719,74135076722,3,1110,1210,-10
74136714650,74136714651,1,1725,1317,-10
74137598346,74137598355,9,1474,1513,-10
74138815002,74138815002,0,1635,1243,-10
74146481730,74146481731,1,2568,1852,-10
74146891083,74146891086,3,2074,1554,-10
74152730893,74152730892,-1,1259,1613,-10
74154834117,74154834118,1,2046,1241,-10
74156096490,74156096491,1,1033,1196,-10
74157930854,74157930854,0,1164,1018,-10
74158990833,74158990836,3,1262,1236,-10
74159259081,74159259084,3,1258,1199,-10
74159272643,74159272641,-2,153,107,-10
74160671597,74160671599,2,1584,1503,-10
74161298409,74161298410,1,1568,1431,-10
74161642581,74161642583,2,1622,1700,-10
74162450935,74162450935,0,908,1549,-10
74163899078,74163899083,5,2165,1228,-10
74166030262,74166030266,4,1522,1598,-10
74167741820,74167741822,2,1698,1644,-10
74172850057,74172850058,1,1795,1466,-10
74176475871,74176475871,0,1514,1615,-10
74176760487,74176760487,0,1455,1569,-10
74177696594,74177696595,1,1844,1558,-10
74180157651,74180157650,-1,1601,3116,-10
74181658410,74181658410,0,1768,1890,-10
74187129148,74187129150,2,828,1010,-10
74188254695,74188254698,3,1745,1862,-10
74189047962,74189047966,4,1690,1560,-10
74189853348,74189853347,-1,1378,1664,-10
74191185517,74191185519,2,1821,1319,-10
74191707257,74191707258,1,1527,1605,-10
74192089456,74192089460,4,1675,2169,-10
74192331785,74192331786,1,1531,2173,-10
74197547291,74197547294,3,1500,1634,-10
74201957613,74201957613,0,1336,1225,-10
74203936541,74203936542,1,1533,1376,-10
74206926306,74206926307,1,1973,2506,-10
74209810530,74209810531,1,1535,1883,-10
74210315090,74210315089,-1,1191,1576,-10
74213075591,74213075593,2,1363,2184,-10
74214264383,74214264386,3,1384,1629,-10
74219514371,74219514375,4,1295,1232,-10
74220554117,74220554118,1,1391,1361,-10
74222392385,74222392387,2,2564,1916,-10
74222571794,74222571795,1,1672,1684,-10
74225623835,74225623832,-3,1552,2327,-10
74225988434,74225988439,5,2241,1522,-10
74227368566,74227368567,1,1162,1223,-10
74227893866,74227893867,1,1658,1349,-10
74227997958,74227997960,2,859,1204,-10
74231707699,74231707701,2,1186,1588,-10
74234564619,74234564622,3,1144,1660,-10
74241726092,74241726086,-6,1558,9051,-10
74248187712,74248187714,2,1185,1282,-10
74252923985,74252923986,1,1623,2056,-10
74253507977,74253507978,1,1672,1507,-10
74256562838,74256562839,1,1007,1510,-10
74257203189,74257203194,5,32448,25651,-10
74260294952,74260294951,-1,1271,1814,-10
74260961042,74260961045,3,608,558,-10
74263511706,74263511709,3,2127,1644,-10
74263682907,74263682908,1,1752,1581,-10
74270049942,74270049947,5,1103,1394,-10
74273000650,74273000655,5,1421,1437,-10
74277401967,74277401984,17,39864,15706,-10
74278220162,74278220163,1,1774,1767,-10
74279370603,74279370618,15,824,974,-10
74284015161,74284015163,2,1888,2004,-10
74287306994,74287306997,3,1592,1977,-10
74287520784,74287520787,3,1434,989,-10
74290652988,74290652991,3,973,999,-10
74291159585,74291159587,2,1871,1358,-10
74292259000,74292259002,2,1495,1452,-10
74293525890,74293525891,1,1891,1158,-10
74293886972,74293886974,2,1734,1564,-10
74294465769,74294465769,0,1632,1548,-10
74296188842,74296188845,3,1160,1496,-10
74296881382,74296881384,2,1544,1794,-10
74299384123,74299384125,2,1077,1535,-10
74302508118,74302508121,3,1576,1529,-10
74306113539,74306113540,1,1849,2456,-10
74315567569,74315567570,1,2130,1781,-10
74316145854,74316145856,2,1201,1703,-10
74317350683,74317350685,2,1220,1621,-10
74320119891,74320119894,3,1407,1395,-10
74323778723,74323778726,3,1707,1601,-10
74326353834,74326353834,0,1338,1207,-10
74327668797,74327668796,-1,2291,2449,-10
74330750389,74330750390,1,1400,1257,-10
74331459897,74331459886,-11,2318,1850,-10
74332015905,74332015925,20,467,1971,-10
74333977046,74333977055,9,2862,1028,-10
74336254846,74336254840,-6,53971,23568,-10
74336353738,74336353742,4,1803,1314,-10
74342172833,74342172829,-4,2314,6645,-10
74342714486,74342714487,1,1711,2209,-10
74345863491,74345863490,-1,1998,1650,-10
74351959584,74351959586,2,1446,1747,-10
74352070514,74352070514,0,1483,1818,-10
74355332979,74355332981,2,1431,2015,-10
74355843349,74355843350,1,1263,1466,-10
74356025482,74356025482,0,1073,1644,-10
74356976215,74356976219,4,1135,1143,-10
74357566039,74357566041,2,777,1019,-10
74361386221,74361386223,2,1789,1224,-10
74361972893,74361972889,-4,973,2593,-10
74362728974,74362728974,0,1235,1299,-10
74363607630,74363607632,2,1827,1679,-10
74364923287,74364923288,1,1239,1499,-10
74366706858,74366706862,4,1256,1168,-10
74369903106,74369903107,1,1633,1558,-10
74370943320,74370943323,3,1864,1710,-10
74372834306,74372834300,-6,998,4485,-10
74374549574,74374549576,2,1836,1807,-10
74378584887,74378584888,1,1182,1488,-10
74379789673,74379789674,1,1431,1701,-10
74382150364,74382150366,2,951,1286,-10
74382206223,74382206225,2,1330,1632,-10
74382655832,74382655833,1,1436,1153,-10
74383585621,74383585622,1,1178,1255,-10
74385287234,74385287236,2,1770,1601,-10
74386482445,74386482446,1,1529,2085,-10
74387253082,74387253082,0,1307,1042,-10
74391040622,74391040627,5,1370,1243,-10
74394425246,74394425247,1,1115,1303,-10
74396557902,74396557901,-1,1249,1847,-10
74396870623,74396870623,0,915,706,-10
74398344797,74398344797,0,1293,1486,-10
74400432033,74400432034,1,1617,1298,-10
74408327935,74408327939,4,2173,1802,-10
74408761380,74408761376,-4,1275,1394,-10
74409453590,74409453589,-1,1452,1483,-10
74409788389,74409788390,1,3120,2351,-10
74410705702,74410705705,3,1653,1402,-10
74410869549,74410869550,1,1162,1305,-10
74412310430,74412310432,2,1040,1344,-10
74413648442,74413648442,0,1388,1365,-10
74414899878,74414899879,1,1889,1550,-10
74419242205,74419242210,5,1752,1102,-10
74420286204,74420286207,3,1361,1177,-10
74421500622,74421500629,7,3011,1322,-10
74421890170,74421890171,1,1552,1490,-10
74424067965,74424067968,3,1485,1905,-10
74426166606,74426166614,8,3315,1233,-10
74432894241,74432894243,2,1448,1656,-10
74434400935,74434400937,2,1599,1221,-10
74435098321,74435098323,2,1629,1443,-10
74438646178,74438646178,0,1355,1433,-10
74439439509,74439439503,-6,2328,6313,-10
74442900256,74442900257,1,1728,1839,-10
74443061949,74443061950,1,1572,1973,-10
74447500354,74447500358,4,1960,1686,-10
74448071719,74448071721,2,1540,1655,-10
74450624852,74450624854,2,1152,1242,-10
74454204886,74454204888,2,1128,1395,-10
74455878435,74455878436,1,1180,1094,-10
74456038519,74456038520,1,7490,23722,-10
74460827428,74460827430,2,1279,1631,-10
74467879053,74467879059,6,3284,1384,-10
74470733474,74470733478,4,1793,951,-10
74472732906,74472732907,1,1600,1614,-10
74473842352,74473842352,0,1554,1897,-10
74473917615,74473917619,4,836,1167,-10
74475340955,74475340949,-6,886,4204,-10
74476444734,74476444735,1,1519,1379,-10
74478892814,74478892816,2,858,1629,-10
74484905225,74484905228,3,2024,1508,-10
74485849870,74485849875,5,1708,1269,-10
74489027180,74489027182,2,1372,1555,-10
74489514074,74489514074,0,2177,3521,-10
74490638286,74490638287,1,2065,1271,-10
74494606298,74494606301,3,1599,1747,-10
74496845343,74496845346,3,1881,1685,-10
74497358655,74497358651,-4,1399,2749,-10
74499710798,74499710798,0,1644,1532,-10
74500430238,74500430241,3,1254,1631,-10
74501207783,74501207775,-8,977,5333,-10
74503902922,74503902926,4,1851,1314,-10
74505091502,74505091505,3,1495,1381,-10
74505601952,74505601952,0,1358,1322,-10
74506928113,74506928114,1,1844,1465,-10
74510189483,74510189486,3,1319,896,-10
74516211857,74516211862,5,2380,1343,-10
74519685050,74519685052,2,1392,1612,-10
74522104447,74522104447,0,1448,1422,-10
74526789691,74526789693,2,1065,1348,-10
74532157930,74532157930,0,1019,1168,-10
74532827714,74532827718,4,1478,1769,-10
74533136378,74533136372,-6,934,1356,-10
74533715345,74533715347,2,1347,1476,-10
74537475935,74537475937,2,1092,1725,-10
74541825973,74541825973,0,1087,1262,-10
74544485134,74544485136,2,1660,1995,-10
74546280377,74546280376,-1,889,1263,-10
74550861590,74550861594,4,1555,1490,-10
74557161707,74557161710,3,1386,1626,-10
74565374645,74565374645,0,1351,1367,-10
74566010834,74566010835,1,1441,1527,-10
74566107313,74566107314,1,1223,1651,-10
74567784093,74567784094,1,1434,891,-10
74570152370,74570152370,0,1163,1771,-10
74570834520,74570834521,1,1661,1416,-10
74571835657,74571835657,0,1777,1296,-10
74572152593,74572152595,2,1906,1448,-10
74573051978,74573051983,5,3920,2609,-10
74573375477,74573375480,3,1451,1782,-10
74574351774,74574351775,1,1147,1214,-10
74575752525,74575752526,1,1740,1666,-10
74578737404,74578737405,1,1021,1597,-10
74579678196,74579678198,2,2451,1775,-10
74580214837,74580214841,4,1407,1220,-10
74583303459,74583303459,0,2000,2839,-10
74584770586,74584770586,0,1727,1566,-10
74585771923,74585771926,3,1630,1679,-10
74587847322,74587847324,2,1698,1559,-10
74589770333,74589770335,2,1424,1518,-10
74590452648,74590452650,2,995,1440,-10
74593921490,74593921494,4,1547,1373,-10
74595117143,74595117145,2,2446,1916,-10
74596038967,74596038969,2,1597,1447,-10
74599430079,74599430081,2,934,1461,-10
74600073406,74600073406,0,1492,1414,-10
74604680184,74604680182,-2,1531,1660,-10
74608739343,74608739349,6,2657,1075,-10
74609201259,74609201261,2,1194,1532,-10
74611547387,74611547386,-1,916,1534,-10
74612215944,74612215946,2,1449,1689,-10
74613913006,74613913010,4,1395,1267,-10
74616125336,74616125337,1,2064,2040,-10
74618338835,74618338838,3,877,1291,-10
74619792180,74619792181,1,1127,1029,-10
74620914562,74620914563,1,1594,1836,-10
74622067897,74622067899,2,1415,1854,-10
74624568020,74624568021,1,886,1340,-10
74626403645,74626403648,3,2020,1937,-10
74627153251,74627153245,-6,810,2340,-10
74628726674,74628726675,1,1353,1840,-10
74631359981,74631359982,1,2299,1449,-10
74632507295,74632507297,2,1748,1191,-10
74633388357,74633388361,4,1557,1720,-10
74634328521,74634328524,3,1596,1612,-10
74634886565,74634886564,-1,1706,1694,-10
74636943626,74636943626,0,1540,1308,-10
74639059215,74639059218,3,1501,1595,-10
74642167898,74642167902,4,1429,1177,-10
74649826261,74649826263,2,1539,1258,-10
74649983317,74649983319,2,1553,1868,-10
74652188805,74652188806,1,1553,1011,-10
74660468733,74660468735,2,1805,1658,-10
74663714385,74663714393,8,4513,1850,-10
74666637676,74666637679,3,1702,2177,-10
74672156022,74672156014,-8,1307,7427,-10
74674358823,74674358834,11,53,1126,-10
74676397146,74676397146,0,1605,1786,-10
74677841213,74677841215,2,1148,1724,-10
74677912626,74677912626,0,1157,1120,-10
74679371173,74679371175,2,1648,1543,-10
74680538055,74680538056,1,1558,1978,-10
74680624014,74680624019,5,1073,1467,-10
74682066149,74682066149,0,1559,1374,-10
74684246526,74684246527,1,1598,1429,-10
74684885346,74684885348,2,2057,1364,-10
74685239245,74685239245,0,909,1308,-10
74685565569,74685565591,22,1424,1299,-10
74687631528,74687631531,3,1571,1156,-10
74689655346,74689655340,-6,1287,4046,-10
74690195673,74690195677,4,2045,1639,-10
74693460326,74693460330,4,1601,1260,-10
74698270228,74698270230,2,1831,1244,-10
74701884631,74701884634,3,1656,1982,-10
74703825139,74703825142,3,1331,1104,-10
74703950371,74703950373,2,1682,1739,-10
74709580834,74709580835,1,1544,1522,-10
74709669323,74709669309,-14,919,1275,-10
74711249483,74711249481,-2,1593,2442,-10
74712790728,74712790731,3,1850,1629,-10
74719758006,74719758007,1,1323,1571,-10
74725573306,74725573302,-4,2709,6557,-10
74727749754,74727749755,1,1266,1445,-10
74729644064,74729644065,1,1561,1646,-10
74730861492,74730861492,0,2043,1594,-10
74732213438,74732213438,0,882,1248,-10
74734209036,74734209038,2,943,1145,-10
74734594669,74734594670,1,1659,1410,-10
74738297245,74738297247,2,1862,1704,-10
74738985627,74738985627,0,1590,1836,-10
74741815602,74741815603,1,1426,1817,-10
74743481054,74743481057,3,1247,1821,-10
74746586096,74746586098,2,2167,1764,-10
74746762551,74746762554,3,1485,1651,-10
74747521568,74747521569,1,1810,2325,-10
74750857278,74750857279,1,1096,1627,-10
74750918836,74750918838,2,1688,1626,-10
74753650683,74753650686,3,1526,1133,-10
74754192233,74754192234,1,1471,1302,-10
74754604238,74754604242,4,1240,946,-10
74755965250,74755965251,1,1207,1660,-10
74759579211,74759579210,-1,960,1795,-10
74763497527,74763497530,3,1407,1140,-10
74765000074,74765000076,2,1725,1426,-10
74766655847,74766655843,-4,1337,2700,-10
74770407902,74770407903,1,1860,1299,-10
74770467426,74770467441,15,1828,1665,-10
74772754714,74772754718,4,1437,1444,-10
74775490182,74775490182,0,1741,2119,-10
74777543781,74777543781,0,1883,1965,-10
74778260149,74778260150,1,1555,1170,-10
74779858110,74779858110,0,1177,1013,-10
74784885533,74784885531,-2,1319,1234,-10
74786644459,74786644461,2,1776,1795,-10
74786970356,74786970356,0,29764,34934,-10
74788165845,74788165849,4,1322,1485,-10
74789752855,74789752857,2,1610,2243,-10
74791319213,74791319215,2,1745,1592,-10
74792930270,74792930271,1,1744,1862,-10
74793867346,74793867346,0,1337,1123,-10
74793902842,74793902843,1,1039,1382,-10
74796162609,74796162611,2,1609,1468,-10
74798593273,74798593274,1,1637,1935,-10
74800524642,74800524645,3,1550,1767,-10
74801405366,74801405367,1,1276,1111,-10
74801809614,74801809617,3,1321,1854,-10
74802597077,74802597079,2,1792,1645,-10
74804399636,74804399636,0,1481,1796,-10
74806701032,74806701037,5,2117,1165,-10
74807876813,74807876817,4,1953,1351,-10
74811109926,74811109928,2,2723,1883,-10
74812943226,74812943227,1,1199,1714,-10
74813992999,74813993001,2,1217,1480,-10
74815809826,74815809826,0,1583,2320,-10
74816675543,74816675544,1,1680,2065,-10
74819957177,74819957178,1,1050,1166,-10
74820896081,74820896082,1,1887,1685,-10
74821185389,74821185393,4,1549,1262,-10
74822285172,74822285174,2,1172,1404,-10
74825360817,74825360818,1,878,1002,-10
74828823865,74828823867,2,1930,1472,-10
74828981586,74828981572,-14,4681,2068,-10
74830893535,74830893537,2,1628,1493,-10
74832812501,74832812503,2,1786,2184,-10
74833548234,74833548233,-1,1243,1269,-10
74834557546,74834557547,1,1584,1086,-10
74834646207,74834646225,18,1186,1240,-10
74834833331,74834833333,2,1713,1558,-10
74834911030,74834911031,1,2143,1745,-10
74836687443,74836687445,2,1649,1720,-10
74837815967,74837815965,-2,2620,2022,-10
74838518046,74838518046,0,1027,1581,-10
74838890604,74838890605,1,1662,2579,-10
74840178480,74840178483,3,1305,1059,-10
74841677655,74841677657,2,1586,2024,-10
74842188352,74842188357,5,97,868,-10
74848271989,74848271977,-12,863,1426,-10
74850050599,74850050597,-2,1034,1916,-10
74852590870,74852590871,1,1734,1363,-10
74852976067,74852976071,4,1730,1547,-10
74853694331,74853694331,0,1242,1643,-10
74854741213,74854741214,1,1743,1740,-10
74859942026,74859942026,0,1395,1578,-10
74862036906,74862036902,-4,2495,7587,-10
74862545999,74862546001,2,903,835,-10
74863603502,74863603512,10,11452,38427,-10
74872537410,74872537415,5,1753,1389,-10
74873727174,74873727177,3,2001,2241,-10
74879032611,74879032616,5,1039,666,-10
74879610015,74879610014,-1,611,863,-10
74880725773,74880725776,3,1122,1715,-10
74880919566,74880919560,-6,2014,5523,-10
74881504561,74881504563,2,1186,1477,-10
74884525770,74884525773,3,810,1157,-10
74886150572,74886150574,2,1117,1201,-10
74889830247,74889830248,1,1034,1134,-10
74893692477,74893692478,1,1896,2076,-10
74895340698,74895340702,4,1509,1346,-10
74896659298,74896659302,4,1713,2233,-10
74897480825,74897480826,1,1435,1484,-10
74898320779,74898320783,4,1041,1433,-10
74900285591,74900285594,3,1009,1247,-10
74900648683,74900648690,7,1346,855,-10
74901072895,74901072896,1,1461,1377,-10
74903571919,74903571921,2,957,1476,-10
74905242269,74905242271,2,1391,1499,-10
74906442694,74906442695,1,1517,1389,-10
74907023666,74907023660,-6,1171,4215,-10
74909305662,74909305659,-3,1207,2688,-10
74911840473,74911840475,2,1186,1345,-10
74912252830,74912252831,1,1363,1153,-10
74913712557,74913712558,1,1717,1603,-10
74922414546,74922414549,3,2185,1812,-10
74927265809,74927265811,2,1912,1800,-10
74930680664,74930680666,2,1159,1562,-10
74931284153,74931284153,0,1056,1848,-10
74931708162,74931708164,2,1252,1490,-10
74933668210,74933668210,0,1225,2018,-10
74934436649,74934436652,3,1321,1379,-10
74935661221,74935661226,5,2555,1062,-10
74936063343,74936063342,-1,1433,2210,-10
74936536745,74936536746,1,1234,1145,-10
74937734655,74937734638,-17,1813,1677,-10
74942358770,74942358771,1,1097,1115,-10
74947695403,74947695406,3,1458,1153,-10
74947932126,74947932129,3,2179,1658,-10
74949867182,74949867185,3,1157,926,-10
74950666038,74950666040,2,1712,1415,-10
74952573810,74952573812,2,1647,1953,-10
74952836525,74952836544,19,372,1822,-10
74957391947,74957391947,0,1516,1890,-10
74957906439,74957906439,0,1348,2221,-10
74960979574,74960979574,0,1317,1098,-10
74962944305,74962944306,1,1321,1420,-10
74969160023,74969160024,1,732,963,-10
74971432515,74971432511,-4,2301,6108,-10
74971830436,74971830439,3,1323,1295,-10
74976415057,74976415059,2,1750,2316,-10
74979419557,74979419559,2,1439,1687,-10
74980138808,74980138811,3,1506,1596,-10
74981904679,74981904682,3,1206,1282,-10
74984485606,74984485619,13,906,9,-10
74985856686,74985856685,-1,1725,1422,-10
74985953813,74985953813,0,1436,1605,-10
74987490737,74987490734,-3,1484,1589,-10
74994258534,74994258530,-4,25991,11170,-10
74996408811,74996408815,4,2370,1585,-10
74999622961,74999622962,1,1624,1539,-10
75000536765,75000536766,1,1815,1564,-10
75001145297,75001145298,1,1158,1171,-10
75004234551,75004234554,3,1502,1216,-10
75005102113,75005102115,2,2048,1473,-10
75009237598,75009237602,4,1653,1536,-10
75009746887,75009746887,0,1067,1600,-10
75026135755,75026135757,2,1406,1843,-10
75035172937,75035172938,1,1451,1519,-10
75036494715,75036494716,1,1655,1727,-10
75037059763,75037059766,3,1870,1319,-10
75038124031,75038124033,2,1193,1470,-10
75044199946,75044199948,2,1742,2137,-10
75044431726,75044431729,3,1032,1036,-10
75045334558,75045334559,1,1168,1397,-10
75046668710,75046668711,1,935,1164,-10
75047325598,75047325600,2,1822,1571,-10
75048681323,75048681323,0,1741,1724,-10
75048754910,75048754918,8,3756,1944,-10
75052759115,75052759119,4,1610,1735,-10
75055400401,75055400405,4,1046,1407,-10
75057541171,75057541177,6,2525,1736,-10
75060675052,75060675055,3,1486,1366,-10
75062358950,75062358952,2,1334,1981,-10
75063794373,75063794375,2,2407,1608,-10
75067993579,75067993582,3,1613,1334,-10
75068743463,75068743462,-1,1731,2115,-10
75069268685,75069268690,5,2155,1236,-10
75072834391,75072834394,3,806,817,-10
75073886404,75073886409,5,2761,1509,-10
75074244025,75074244026,1,1700,1569,-10
75075528972,75075528973,1,1957,1748,-10
75075669566,75075669567,1,742,747,-10
75078013580,75078013598,18,372,950,-10
75079912192,75079912193,1,1638,2194,-10
75080032215,75080032216,1,1569,1826,-10
75080749270,75080749273,3,1267,1425,-10
75081938263,75081938257,-6,1157,4653,-10
75082457840,75082457842,2,2040,1536,-10
75085144234,75085144230,-4,1121,2062,-10
75088265918,75088265920,2,1598,1115,-10
75089820951,75089820954,3,1433,2015,-10
75092103529,75092103528,-1,819,1764,-10
75095379748,75095379750,2,1858,1825,-10
75096408331,75096408333,2,1863,2199,-10
75096803769,75096803773,4,1680,1651,-10
75098695918,75098695919,1,1310,1136,-10
75102897115,75102897117,2,1297,1145,-10
75104778630,75104778633,3,1389,1729,-10
75106206770,75106206771,1,1331,1169,-10
75107478996,75107478997,1,1477,1392,-10
75108379783,75108379788,5,1221,1326,-10
75111216495,75111216489,-6,1067,2031,-10
75115653736,75115653738,2,1410,1728,-10
75120492946,75120492946,0,1084,1154,-10
75123434513,75123434514,1,1685,2142,-10
75124381100,75124381101,1,2133,1630,-10
75124711057,75124711057,0,1132,1337,-10
75128642925,75128642930,5,1741,1246,-10
75129839413,75129839416,3,1733,1891,-10
75132862658,75132862658,0,890,1919,-10
75134871258,75134871258,0,1688,1802,-10
75139076164,75139076147,-17,1544,1326,-10
75141581658,75141581659,1,1680,1560,-10
75143089871,75143089866,-5,2108,7653,-10
75147088151,75147088151,0,1752,1205,-10
75149886898,75149886899,1,1687,1457,-10
75152600063,75152600066,3,1413,1303,-10
75154723931,75154723933,2,1695,1418,-10
75157647950,75157647951,1,1508,1713,-10
75160336675,75160336680,5,84939,52352,-10
75162128312,75162128313,1,1579,1274,-10
75163483373,75163483374,1,1717,1681,-10
75165987232,75165987235,3,2515,2319,-10
75166028490,75166028491,1,1359,1751,-10
75167777551,75167777553,2,2050,2075,-10
75168141873,75168141873,0,1222,984,-10
75168273147,75168273147,0,1104,1173,-10
75169237884,75169237886,2,1267,986,-10
75173074642,75173074643,1,1338,1422,-10
75173614769,75173614769,0,1738,1002,-10
75175965525,75175965527,2,1330,1474,-10
75176682273,75176682253,-20,1553,2233,-10
75180114397,75180114398,1,1402,1421,-10
75180965398,75180965398,0,1413,1252,-10
75184255006,75184255009,3,1432,1641,-10
75194767283,75194767284,1,803,856,-10
75195139050,75195139051,1,1193,1413,-10
75195876981,75195876985,4,1669,1390,-10
75196509323,75196509326,3,1532,1864,-10
75197192646,75197192649,3,1727,1182,-10
75197896189,75197896191,2,1589,1420,-10
75200405999,75200405998,-1,1493,1813,-10
75202299717,75202299718,1,1307,1349,-10
75203350646,75203350649,3,1129,1047,-10
75205620427,75205620432,5,1658,1012,-10
75206397486,75206397490,4,1742,1114,-10
75211532525,75211532530,5,3275,1322,-10
75211619555,75211619557,2,1980,1556,-10
75216059890,75216059889,-1,1463,1649,-10
75217508169,75217508175,6,7003,1587,-10
75221722998,75221722999,1,1566,1184,-10
75222228923,75222228923,0,2161,2309,-10
75222402650,75222402654,4,1034,1395,-10
75231904806,75231904807,1,1321,1646,-10
75234484346,75234484349,3,4710,3162,-10
75236499058,75236499059,1,1602,1322,-10
75238601610,75238601611,1,921,1286,-10
75238725307,75238725309,2,1049,1737,-10
75238969553,75238969557,4,1652,1850,-10
75241713443,75241713445,2,2610,2023,-10
75242063726,75242063727,1,1994,1494,-10
75242421018,75242421019,1,1279,1246,-10
75247123211,75247123214,3,914,1253,-10
75248310217,75248310221,4,1148,1098,-10
75251950662,75251950658,-4,724,2553,-10
75253190287,75253190286,-1,1409,2331,-10
75254747039,75254747040,1,777,628,-10
75257582045,75257582048,3,809,986,-10
75259415682,75259415685,3,1668,979,-10
75264317914,75264317917,3,2080,1979,-10
75264693307,75264693310,3,1373,1344,-10
75265500013,75265500015,2,2128,2212,-10
75266111534,75266111538,4,1552,945,-10
75269162011,75269162013,2,1547,1655,-10
75271756168,75271756173,5,1920,1487,-10
75277376933,75277376934,1,1436,1728,-10
75283843897,75283843899,2,1593,1730,-10
75286328805,75286328809,4,4847,3729,-10
75286637111,75286637114,3,1451,1161,-10
75290589100,75290589104,4,1717,1055,-10
75292094965,75292094967,2,1536,1449,-10
75293473993,75293473995,2,918,1096,-10
75294931450,75294931450,0,1243,1152,-10
75295157763,75295157763,0,1168,1440,-10
75295265383,75295265386,3,1750,1427,-10
75301087598,75301087601,3,1288,1392,-10
75301361172,75301361175,3,2446,2083,-10
75301612182,75301612185,3,1275,1090,-10
75305764925,75305764928,3,1783,1819,-10
75306662611,75306662615,4,1429,933,-10
75308278263,75308278264,1,1489,1544,-10
75311933004,75311933009,5,2552,1441,-10
75312679642,75312679643,1,1584,1556,-10
75313677831,75313677829,-2,1473,1729,-10
75314862438,75314862432,-6,1960,5615,-10
75315617719,75315617722,3,1570,1114,-10
75320139343,75320139345,2,2012,1209,-10
75320551999,75320551977,-22,544,550,-10
75320756127,75320756127,0,1377,1481,-10
75321251853,75321251856,3,1112,1237,-10
75322455151,75322455154,3,3738,3375,-10
75322882157,75322882159,2,2035,1697,-10
75325097159,75325097162,3,1192,1810,-10
75333316420,75333316421,1,1858,2234,-10
75333417946,75333417948,2,2434,1600,-10
75334053861,75334053862,1,2070,1539,-10
75334873865,75334873867,2,1987,1691,-10
75336244671,75336244671,0,1409,1217,-10
75337155457,75337155460,3,2126,1559,-10
75340129840,75340129842,2,1830,1238,-10
75341377130,75341377130,0,1887,2099,-10
75341763252,75341763250,-2,1588,1790,-10
75341890472,75341890475,3,1393,1587,-10
75343041039,75343041041,2,1377,1416,-10
75349045766,75349045769,3,4746,22301,-10
75353802079,75353802082,3,1335,1428,-10
75357080119,75357080121,2,1366,1854,-10
75359455453,75359455454,1,1853,2502,-10
75359482630,75359482635,5,1535,1667,-10
75361085863,75361085862,-1,1144,1933,-10
75361348528,75361348530,2,1164,1472,-10
75361752350,75361752352,2,1504,1348,-10
75365401228,75365401226,-2,1976,2678,-10
75369537900,75369537903,3,829,1184,-10
75369569314,75369569308,-6,1681,2241,-10
75372316226,75372316226,0,2238,2314,-10
75373805331,75373805334,3,2290,1593,-10
75375716750,75375716752,2,1386,1474,-10
75377618401,75377618403,2,1838,1888,-10
75378685770,75378685770,0,1408,1828,-10
75380478087,75380478089,2,2269,1268,-10
75383305666,75383305670,4,1190,1087,-10
75385524805,75385524806,1,2032,1252,-10
75386914701,75386914702,1,2002,1352,-10
75390280138,75390280144,6,1416,1242,-10
75391528564,75391528566,2,1753,1362,-10
75394171122,75394171122,0,902,1042,-10
75397167879,75397167882,3,1063,1362,-10
75397807855,75397807857,2,1469,1191,-10
75397880305,75397880312,7,1543,1505,-10
75398890339,75398890339,0,1193,1171,-10
75399464367,75399464370,3,1362,1669,-10
75399667433,75399667438,5,2612,1786,-10
75401647018,75401647019,1,1857,1511,-10
75402496842,75402496845,3,1039,1644,-10
75406882765,75406882767,2,1319,665,-10
75407712892,75407712892,0,1443,1708,-10
75408719925,75408719926,1,1557,2369,-10
75410148730,75410148731,1,1280,1500,-10
75412438632,75412438634,2,1652,1137,-10
75418541054,75418541056,2,729,1492,-10
75420546226,75420546228,2,1433,1692,-10
75421801033,75421801035,2,1460,1896,-10
75423258519,75423258522,3,1225,1497,-10
75424323178,75424323178,0,2275,2148,-10
75425276249,75425276250,1,1732,2007,-10
75430779686,75430779688,2,1874,2374,-10
75431092683,75431092682,-1,1118,1911,-10
75433066854,75433066855,1,1879,1383,-10
75435413226,75435413229,3,1445,1440,-10
75436424273,75436424276,3,1085,1629,-10
75438204933,75438204934,1,1881,1707,-10
75440358091,75440358090,-1,1371,2331,-10
75442821327,75442821330,3,1872,1545,-10
75443527475,75443527477,2,1411,1241,-10
75444163357,75444163358,1,1478,737,-10
75447216133,75447216112,-21,759,638,-10
75447946934,75447946935,1,883,957,-10
75448558981,75448558982,1,1671,1592,-10
75451264617,75451264618,1,1436,1503,-10
75452066014,75452066017,3,2350,1924,-10
75452185534,75452185538,4,7375,28235,-10
75452358278,75452358277,-1,959,2039,-10
75454732317,75454732319,2,1127,1064,-10
75460050353,75460050357,4,1208,1301,-10
75461633576,75461633575,-1,2280,3729,-10
75466761799,75466761801,2,1548,1314,-10
75467028999,75467029003,4,1509,1056,-10
75468289382,75468289384,2,1371,1130,-10
75469035887,75469035889,2,1015,924,-10
75471452478,75471452480,2,1627,2053,-10
75471964328,75471964329,1,1831,1420,-10
75474909019,75474909022,3,1950,1330,-10
75476928534,75476928533,-1,1284,1741,-10
75477515041,75477515043,2,1443,1392,-10
75478320078,75478320081,3,1916,1444,-10
75483576630,75483576633,3,1103,1296,-10
75486707794,75486707797,3,1629,1467,-10
75488423568,75488423570,2,1153,1535,-10
75498959410,75498959414,4,2071,1501,-10
75503871553,75503871559,6,3406,1448,-10
75508382003,75508382005,2,1357,1761,-10
75511320582,75511320582,0,1782,1979,-10
75512878529,75512878529,0,1722,1413,-10
75514250401,75514250403,2,1590,1566,-10
75514399409,75514399413,4,1619,1468,-10
75518156078,75518156078,0,1712,1266,-10
75518867412,75518867413,1,2108,2106,-10
75519576076,75519576081,5,1922,1721,-10
75521115739,75521115742,3,2050,1314,-10
75521992850,75521992851,1,1229,1402,-10
75525789426,75525789412,-14,1633,2037,-10
75530949863,75530949865,2,932,1548,-10
75534396570,75534396573,3,1364,1735,-10
75539879133,75539879135,2,1048,943,-10
75542309968,75542309970,2,921,1170,-10
75543641488,75543641486,-2,24674,47002,-10
75543667668,75543667670,2,1974,1639,-10
75547086746,75547086749,3,1448,1585,-10
75547127111,75547127107,-4,1918,5780,-10
75548128726,75548128727,1,1067,1030,-10
75552191921,75552191924,3,1639,1687,-10
75553537486,75553537487,1,1604,1419,-10
75556740259,75556740258,-1,1091,1857,-10
75563383531,75563383533,2,2054,1601,-10
75565933507,75565933508,1,1740,1959,-10
75569200145,75569200149,4,1127,1222,-10
75569551151,75569551158,7,1070,834,-10
75571956670,75571956670,0,3695,4859,-10
75575446378,75575446378,0,1885,1246,-10
75577343196,75577343198,2,1312,1639,-10
75578979962,75578979964,2,1632,1619,-10
75579304644,75579304658,14,1612,1600,-10
75580318764,75580318751,-13,977,1377,-10
75583252063,75583252046,-17,1842,951,-10
75586779421,75586779423,2,1804,1441,-10
75588834215,75588834215,0,1954,2043,-10
75596080502,75596080505,3,1782,1491,-10
75597624410,75597624411,1,1362,1100,-10
75597714405,75597714385,-20,2480,1839,-10
75598440882,75598440885,3,809,1177,-10
75599598954,75599598961,7,4065,1703,-10
75600111818,75600111821,3,1543,1710,-10
75600971478,75600971479,1,1457,1291,-10
75602165222,75602165230,8,1699,992,-10
75602859571,75602859574,3,1798,1536,-10
75602977690,75602977695,5,1728,1363,-10
75603488122,75603488126,4,1752,1498,-10
75603929547,75603929554,7,1229,1120,-10
75604269545,75604269563,18,1270,1539,-10
75604606642,75604606644,2,1609,1379,-10
75608032020,75608032022,2,1548,1740,-10
75611070921,75611070922,1,1542,1874,-10
75614037695,75614037694,-1,1906,1884,-10
75618188513,75618188514,1,1407,1275,-10
75620850261,75620850262,1,2097,1717,-10
75621899898,75621899898,0,1458,1453,-10
75622790628,75622790630,2,1627,1480,-10
75625112209,75625112210,1,1208,1576,-10
75626806574,75626806575,1,1353,1212,-10
75628053336,75628053339,3,3829,1796,-10
75631146793,75631146794,1,1374,1497,-10
75632523134,75632523135,1,1634,1454,-10
75633969232,75633969234,2,1652,1723,-10
75635088360,75635088363,3,1489,1727,-10
75635716976,75635716979,3,1719,1688,-10
75637875163,75637875166,3,1727,1518,-10
75641816106,75641816109,3,1195,1362,-10
75645877170,75645877172,2,1425,1271,-10
75647878454,75647878455,1,1604,1602,-10
75649448969,75649448970,1,1752,1270,-10
75650177198,75650177202,4,2029,2030,-10
75656310420,75656310422,2,1123,1496,-10
75657664301,75657664301,0,1485,1848,-10
75660422603,75660422606,3,1781,1857,-10
75662812918,75662812919,1,1945,1894,-10
75668918050,75668918054,4,1445,1375,-10
75670955874,75670955874,0,1846,2285,-10
75671670638,75671670642,4,1450,1078,-10
75672126382,75672126385,3,2736,2200,-10
75672387121,75672387125,4,1827,1795,-10
75673002236,75673002241,5,667,1024,-10
75677498093,75677498094,1,1364,1874,-10
75680406821,75680406821,0,1739,1208,-10
75680846569,75680846572,3,1717,1940,-10
75686576531,75686576534,3,1582,1247,-10
75687047018,75687047019,1,1758,1825,-10
75691123219,75691123222,3,771,1037,-10
75694723275,75694723276,1,986,1363,-10
75696082887,75696082889,2,1267,1563,-10
75697006361,75697006371,10,1677,1513,-10
75697266712,75697266711,-1,2410,2148,-10
75701884810,75701884811,1,857,987,-10
75702479611,75702479612,1,1664,1725,-10
75704255871,75704255874,3,1502,1244,-10
75705471411,75705471414,3,1771,1636,-10
75706525260,75706525261,1,2183,1943,-10
75708727570,75708727571,1,1549,1744,-10
75712017601,75712017601,0,1443,1094,-10
75714160067,75714160069,2,1239,1607,-10
75715168937,75715168937,0,1368,1895,-10
75717581276,75717581278,2,1733,1859,-10
75724051339,75724051341,2,1568,1676,-10
75729268097,75729268098,1,1477,1765,-10
75729678573,75729678574,1,1292,1164,-10
75730354804,75730354818,14,1766,1389,-10
75730590857,75730590861,4,1571,1374,-10
75731598984,75731598987,3,2038,1643,-10
75732126277,75732126279,2,1177,1439,-10
75735974340,75735974342,2,1626,1399,-10
75736906883,75736906876,-7,2074,10176,-10
75737541396,75737541398,2,1018,1120,-10
75739467735,75739467738,3,1013,1243,-10
75744749861,75744749863,2,1714,1433,-10
75745457826,75745457824,-2,1311,1388,-10
75746131705,75746131706,1,924,855,-10
75748451304,75748451306,2,1368,1557,-10
75749159677,75749159682,5,1174,1274,-10
75751858454,75751858457,3,1551,1775,-10
75754859135,75754859140,5,1786,1692,-10
75754994189,75754994189,0,1122,902,-10
75757520693,75757520695,2,1748,1522,-10
75759136937,75759136940,3,1636,2116,-10
75760853785,75760853789,4,1966,1479,-10
75761283959,75761283960,1,1744,1406,-10
75761682597,75761682598,1,2095,1356,-10
75763281096,75763281098,2,1985,1225,-10
75764484319,75764484314,-5,1353,1686,-10
75765101650,75765101653,3,1598,945,-10
75767098128,75767098126,-2,1263,1593,-10
75767128970,75767128973,3,1778,1539,-10
75770408109,75770408114,5,2506,1071,-10
75770561766,75770561768,2,1678,1999,-10
75771445014,75771445015,1,2019,1412,-10
75771776256,75771776258,2,1610,1534,-10
75772126489,75772126491,2,1051,1250,-10
75774042046,75774042049,3,1415,1708,-10
75775308428,75775308430,2,1545,1645,-10
75777539562,75777539561,-1,1084,1250,-10
75778724575,75778724576,1,1840,1385,-10
75780562733,75780562734,1,1345,1324,-10
75782285606,75782285609,3,1966,1321,-10
75782964275,75782964277,2,2126,1712,-10
75783388406,75783388425,19,2121,950,-10
75785352441,75785352442,1,1273,1804,-10
75785982025,75785982025,0,1355,1399,-10
75787155736,75787155738,2,1422,1450,-10
75791124994,75791124998,4,2209,1660,-10
75792375593,75792375594,1,1755,1880,-10
75794705271,75794705274,3,1906,1323,-10
75798490990,75798490994,4,1680,1443,-10
75803453665,75803453666,1,1350,1473,-10
75803636409,75803636411,2,1658,1524,-10
75807618034,75807618035,1,805,1275,-10
75807796594,75807796610,16,385,2777,-10
75808481439,75808481442,3,1476,1280,-10
75809665591,75809665592,1,1193,1706,-10
75812955473,75812955474,1,1847,1192,-10
75813985210,75813985211,1,1416,1638,-10
75819461099,75819461101,2,2142,2348,-10
75820886707,75820886704,-3,1483,1704,-10
75821764349,75821764363,14,1713,1247,-10
75824310956,75824310959,3,1659,1790,-10
75827379086,75827379087,1,2142,2521,-10
75828572410,75828572410,0,1810,1949,-10
75829879932,75829879932,0,1400,1644,-10
75831580367,75831580367,0,853,1376,-10
75831811063,75831811066,3,1413,1424,-10
75835651690,75835651692,2,1718,1901,-10
75836072485,75836072487,2,1761,1501,-10
75837402723,75837402726,3,1827,1479,-10
75838171495,75838171498,3,1509,1475,-10
75840753661,75840753646,-15,915,1036,-10
75844724932,75844724935,3,2028,1088,-10
75850102630,75850102633,3,1695,1584,-10
75852066982,75852066983,1,1640,1356,-10
75852184529,75852184529,0,1366,1394,-10
75853047182,75853047182,0,2085,1705,-10
75857624189,75857624192,3,1281,1468,-10
75858331888,75858331890,2,1551,1428,-10
75858950935,75858950941,6,3946,2487,-10
75867544589,75867544591,2,1388,1702,-10
75869841027,75869841029,2,1957,2071,-10
75875394940,75875394947,7,24638,26539,-10
75876098039,75876098040,1,1309,1289,-10
75876781414,75876781395,-19,1316,1117,-10
75877082413,75877082414,1,1218,1197,-10
75879656458,75879656460,2,1510,1295,-10
75879894310,75879894323,13,1417,1321,-10
75886727969,75886727970,1,1458,1130,-10
75887459750,75887459750,0,1431,1944,-10
75888426495,75888426498,3,2049,1614,-10
75889522817,75889522822,5,2163,1916,-10
75892183553,75892183555,2,1688,1537,-10
75892779610,75892779612,2,1989,1292,-10
75894482964,75894482965,1,1723,2294,-10
75894964586,75894964586,0,1431,984,-10
75899075982,75899075985,3,1557,1635,-10
75900485366,75900485371,5,4998,2601,-10
75909930569,75909930569,0,1284,1523,-10
75910289722,75910289723,1,3365,4533,-10
75910384639,75910384642,3,2043,2141,-10
75910950052,75910950053,1,1604,1102,-10
75912266689,75912266679,-10,1416,1298,-10
75917771338,75917771339,1,1811,1779,-10
75918794707,75918794706,-1,949,1107,-10
75921859684,75921859686,2,1594,1300,-10
75922490205,75922490207,2,1504,1176,-10
75925559734,75925559730,-4,2960,8517,-10
75928127125,75928127127,2,1147,886,-10
75930483430,75930483433,3,2213,1656,-10
75932131938,75932131938,0,1322,1427,-10
75934114216,75934114217,1,1190,1544,-10
75935123323,75935123325,2,1346,1800,-10
75935714611,75935714610,-1,1145,1333,-10
75936087221,75936087223,2,1856,1376,-10
75937698145,75937698146,1,1522,1158,-10
75938222576,75938222577,1,2488,1432,-10
75940025159,75940025163,4,1654,1494,-10
75942863243,75942863246,3,1585,1794,-10
75945290733,75945290734,1,1313,1502,-10
75948013802,75948013805,3,1407,1653,-10
75950459453,75950459458,5,1636,1367,-10
75951422206,75951422207,1,1338,1066,-10
75954090584,75954090587,3,3779,1789,-10
75957985559,75957985561,2,2045,1565,-10
75964468646,75964468647,1,1307,1651,-10
75965218215,75965218218,3,1054,1275,-10
75968696446,75968696426,-20,1326,1275,-10
75973440096,75973440099,3,2249,2039,-10
75973663036,75973663038,2,1148,1113,-10
75975973313,75975973317,4,2360,1286,-10
75977936794,75977936794,0,1816,2209,-10
75978267617,75978267621,4,1242,1922,-10
75981887150,75981887151,1,1146,2003,-10
75982798941,75982798945,4,2043,2109,-10
75984004675,75984004678,3,1797,1899,-10
75985777207,75985777206,-1,1831,4232,-10
75986686787,75986686789,2,1674,1457,-10
75988263935,75988263937,2,1423,1318,-10
75991455399,75991455403,4,1200,871,-10
75993124278,75993124282,4,1374,1971,-10
75999119589,75999119591,2,1737,1536,-10
76000692774,76000692778,4,1812,1337,-10
76003394761,76003394761,0,1577,1503,-10
76005084161,76005084163,2,1425,1106,-10
76011828035,76011828038,3,1084,1441,-10
76013154058,76013154059,1,1645,1801,-10
76013689850,76013689853,3,1146,1042,-10
76014837467,76014837470,3,1509,1993,-10
76021068658,76021068661,3,1641,1350,-10
76021114145,76021114145,0,1711,1545,-10
76022385214,76022385211,-3,2278,4826,-10
76025601814,76025601817,3,1866,1557,-10
76026863735,76026863734,-1,1455,1827,-10
76027664787,76027664786,-1,1357,1915,-10
76027998190,76027998190,0,1648,1915,-10
76029409680,76029409682,2,1804,1812,-10
76029601117,76029601118,1,2065,2147,-10
76033420090,76033420090,0,1595,1667,-10
76034271298,76034271298,0,1925,1534,-10
76036040028,76036040031,3,2076,1594,-10
76036423453,76036423455,2,967,1534,-10
76036624493,76036624494,1,1180,1658,-10
76039949662,76039949662,0,1033,1605,-10
76044194838,76044194839,1,1122,1650,-10
76046383071,76046383074,3,1301,1112,-10
76052628185,76052628186,1,1472,1256,-10
76054643894,76054643895,1,1435,2035,-10
76058634033,76058634036,3,1427,1196,-10
76059107435,76059107435,0,1200,1357,-10
76064006037,76064006043,6,2812,1344,-10
76065361915,76065361916,1,1147,1357,-10
76066439878,76066439881,3,1800,1066,-10
76070825382,76070825385,3,1559,1906,-10
76074691534,76074691552,18,1581,1324,-10
76075670356,76075670359,3,1617,1585,-10
76077909094,76077909098,4,2517,2179,-10
76079597357,76079597361,4,2008,1155,-10
76081731674,76081731677,3,1656,1437,-10
76083779546,76083779546,0,1710,1415,-10
76084554849,76084554843,-6,594,297,-10
76086771603,76086771606,3,1997,2102,-10
76087448270,76087448276,6,10333,22668,-10
76089601012,76089601015,3,2175,1697,-10
76090673258,76090673261,3,1568,1486,-10
76091740334,76091740336,2,1283,1857,-10
76091842942,76091842946,4,1661,1699,-10
76093314254,76093314249,-5,2007,6900,-10
76093668003,76093667981,-22,1700,1268,-10
76094176525,76094176529,4,793,1086,-10
76095142194,76095142194,0,1955,1310,-10
76097551062,76097551065,3,1241,1621,-10
76098603253,76098603255,2,1228,1812,-10
76102553807,76102553810,3,1487,1251,-10
76106880827,76106880830,3,1220,1254,-10
76111048697,76111048698,1,1923,1929,-10
76114070980,76114070973,-7,1664,8830,-10
76117394966,76117394961,-5,1759,3706,-10
76118256878,76118256879,1,1737,1542,-10
76120268828,76120268810,-18,1866,1429,-10
76123140859,76123140862,3,2431,2162,-10
76123553066,76123553067,1,1806,2244,-10
76124874327,76124874329,2,1872,1815,-10
76128132045,76128132061,16,1440,1241,-10
76131948179,76131948181,2,2292,2416,-10
76132818577,76132818578,1,1585,1719,-10
76134937678,76134937676,-2,1213,2132,-10
76137335759,76137335755,-4,1141,2563,-10
76138158502,76138158503,1,1706,1271,-10
76140160916,76140160922,6,6724,2669,-10
76140922862,76140922863,1,1555,1607,-10
76142115485,76142115485,0,1575,2203,-10
76148398900,76148398901,1,1458,1238,-10
76149755242,76149755242,0,1951,2026,-10
76162755134,76162755134,0,1206,1727,-10
76166008122,76166008100,-22,1178,1305,-10
76166678462,76166678443,-19,1525,1526,-10
76167082874,76167082876,2,2071,2663,-10
76169243463,76169243467,4,1071,1415,-10
76174167290,76174167294,4,1315,1707,-10
76177143078,76177143082,4,2039,2199,-10
76179614954,76179614956,2,885,1303,-10
76183195886,76183195890,4,1833,853,-10
76183275374,76183275368,-6,1974,5334,-10
76184952446,76184952450,4,1811,1419,-10
76186206458,76186206461,3,2013,2068,-10
76192445498,76192445502,4,1826,1687,-10
76195771408,76195771410,2,1345,1676,-10
76198156969,76198156970,1,1839,1544,-10
76200460494,76200460491,-3,1177,1905,-10
76201669310,76201669310,0,1375,1414,-10
76205859333,76205859335,2,2312,1824,-10
76209955063,76209955063,0,1061,1494,-10
76211650359,76211650359,0,1198,1683,-10
76212920371,76212920372,1,1809,1564,-10
76213033901,76213033903,2,736,895,-10
76214497226,76214497230,4,1289,1684,-10
76214976905,76214976907,2,1189,1216,-10
76215845150,76215845153,3,1818,1905,-10
76216784674,76216784675,1,1547,1193,-10
76220448617,76220448619,2,1342,1468,-10
76221110499,76221110500,1,1932,1806,-10
76225787919,76225787920,1,1129,1775,-10
76227261537,76227261539,2,1698,1961,-10
76228887942,76228887941,-1,1989,2106,-10
76230571214,76230571215,1,1200,885,-10
76236681367,76236681370,3,1074,1593,-10
76238776479,76238776481,2,1266,1433,-10
76242629411,76242629411,0,1459,1378,-10
76243973027,76243973029,2,1733,2233,-10
76246102502,76246102502,0,1314,1532,-10
76247217797,76247217797,0,1624,1372,-10
76254477137,76254477138,1,1384,1422,-10
76255465235,76255465234,-1,1202,1635,-10
76257988552,76257988552,0,1493,1842,-10
76261493642,76261493642,0,1426,1387,-10
76263346439,76263346440,1,1332,1364,-10
76264144261,76264144262,1,1663,1937,-10
76264636957,76264636960,3,1926,1329,-10
76269738997,76269738999,2,1540,1186,-10
76273492127,76273492127,0,1385,1234,-10
76274207196,76274207197,1,1832,2010,-10
76275428425,76275428426,1,1698,1569,-10
76278951002,76278951006,4,1405,1625,-10
76280117234,76280117237,3,1956,1332,-10
76280893340,76280893342,2,1389,1288,-10
76282389509,76282389512,3,2318,1646,-10
76282659239,76282659241,2,1294,1712,-10
76283118470,76283118474,4,1418,1565,-10
76283596166,76283596170,4,1860,1634,-10
76285882243,76285882242,-1,1199,1768,-10
76287027173,76287027173,0,32852,46593,-10
76289692390,76289692391,1,1398,1464,-10
76292974386,76292974390,4,1958,1824,-10
76294249101,76294249102,1,1432,2006,-10
76295341497,76295341498,1,1658,1644,-10
76297725505,76297725505,0,26061,18501,-10
76300861829,76300861829,0,1758,1517,-10
76303235002,76303235002,0,1157,1429,-10
76307252194,76307252197,3,1797,1514,-10
76309131302,76309131304,2,1704,1058,-10
76311240126,76311240126,0,1306,1515,-10
76311949485,76311949486,1,1553,1630,-10
76312701497,76312701499,2,1972,1723,-10
76312982378,76312982379,1,1307,1496,-10
76315548278,76315548281,3,1234,1862,-10
76316812646,76316812647,1,1863,1706,-10
76316933082,76316933096,14,1083,1273,-10
76317832847,76317832848,1,1561,1353,-10
76319248930,76319248932,2,1473,1095,-10
76321134071,76321134074,3,2176,1207,-10
76321439298,76321439293,-5,1324,6504,-10
76322064715,76322064719,4,1802,1718,-10
76333245248,76333245251,3,1573,1699,-10
76336427302,76336427304,2,1296,1307,-10
76337622550,76337622552,2,1400,1757,-10
76338141130,76338141133,3,2383,1421,-10
76339809412,76339809414,2,1694,1556,-10
76343951078,76343951080,2,1938,2385,-10
76344763839,76344763840,1,1466,1937,-10
76345588079,76345588083,4,1282,1407,-10
76346393970,76346393971,1,1877,1789,-10
76347288943,76347288946,3,1203,1091,-10
76349097980,76349097983,3,1579,1747,-10
76349124621,76349124622,1,1504,1711,-10
76349569623,76349569601,-22,1358,1375,-10
76350567758,76350567762,4,1670,1389,-10
76352973358,76352973365,7,17288,20218,-10
76353644650,76353644650,0,1268,1888,-10
76353752831,76353752831,0,966,1894,-10
76353962375,76353962378,3,1326,1583,-10
76355468555,76355468556,1,1181,1461,-10
76356602686,76356602687,1,1930,1800,-10
76359106830,76359106831,1,1250,1473,-10
76361811337,76361811338,1,1026,1605,-10
76364836707,76364836707,0,1525,1014,-10
76365164893,76365164893,0,1306,1533,-10
76370919279,76370919282,3,1782,1444,-10
76371643529,76371643530,1,1299,1378,-10
76372479746,76372479750,4,3248,2642,-10
76374932942,76374932944,2,1845,1913,-10
76375306164,76375306158,-6,2457,8327,-10
76380259511,76380259513,2,1565,1957,-10
76381697281,76381697282,1,1313,1671,-10
76382154145,76382154146,1,1182,1424,-10
76383666273,76383666276,3,1757,1462,-10
76384048409,76384048410,1,1306,1182,-10
76387635182,76387635182,0,1231,1618,-10
76395708327,76395708328,1,1764,1843,-10
76401899786,76401899788,2,1834,1137,-10
76403989785,76403989785,0,952,1396,-10
76407431233,76407431232,-1,1575,1834,-10
76408404190,76408404190,0,2046,2443,-10
76411140388,76411140391,3,1525,1339,-10
76413432466,76413432469,3,1413,1559,-10
76413947670,76413947668,-2,1562,1294,-10
76419011334,76419011327,-7,1458,5915,-10
76433555735,76433555738,3,1911,2603,-10
76438238685,76438238686,1,1824,1913,-10
76440122446,76440122447,1,1628,1570,-10
76441009976,76441009976,0,1944,2561,-10
76441264429,76441264434,5,2733,1583,-10
76441412210,76441412211,1,1671,1414,-10
76448169513,76448169515,2,1174,1653,-10
76450605547,76450605551,4,995,1236,-10
76450850862,76450850863,1,1530,1485,-10
76453785585,76453785590,5,5065,1828,-10
76457142311,76457142311,0,1336,1723,-10
76458255367,76458255370,3,1556,1248,-10
76461600979,76461600981,2,1780,2348,-10
76461946682,76461946699,17,1235,1297,-10
76463227883,76463227887,4,1057,1212,-10
76465193464,76465193468,4,1650,1380,-10
76467539255,76467539255,0,1330,1034,-10
76470610651,76470610655,4,1069,819,-10
76472915454,76472915454,0,1717,1770,-10
76473000185,76473000186,1,1681,1591,-10
76474121605,76474121606,1,2103,1697,-10
76474526157,76474526160,3,1217,1037,-10
76477903741,76477903741,0,1278,1462,-10
76479623995,76479623992,-3,1133,2147,-10
76480443130,76480443131,1,1290,1569,-10
76481537296,76481537298,2,1034,1551,-10
76482084306,76482084305,-1,1071,1252,-10
76485253991,76485253990,-1,1821,1565,-10
76487665401,76487665402,1,1277,2399,-10
76489516902,76489516904,2,1450,1473,-10
76492450677,76492450683,6,2713,849,-10
76496176923,76496176927,4,1298,1588,-10
76497334030,76497334033,3,1972,1809,-10
76508778637,76508778637,0,1426,1819,-10
76513136087,76513136088,1,1387,1967,-10
76513970406,76513970402,-4,1100,4004,-10
76518069809,76518069810,1,1655,1661,-10
76524456461,76524456462,1,1959,1390,-10
76525511279,76525511280,1,2525,2919,-10
76527430169,76527430170,1,1565,1235,-10
76528058778,76528058779,1,4010,4152,-10
76528783242,76528783246,4,2470,1871,-10
76531897615,76531897615,0,1089,1065,-10
76533548265,76533548267,2,1490,1171,-10
76534145939,76534145918,-21,899,1804,-10
76535966325,76535966326,1,2098,2303,-10
76537829899,76537829902,3,2100,2101,-10
76538598078,76538598079,1,1548,1228,-10
76542206511,76542206514,3,1377,1254,-10
76542460159,76542460163,4,1454,1347,-10
76544131838,76544131821,-17,1423,1346,-10
76545471689,76545471711,22,1696,1272,-10
76545777742,76545777747,5,1533,886,-10
76546270816,76546270818,2,1549,1293,-10
76547283055,76547283054,-1,1274,2164,-10
76547351335,76547351334,-1,1638,1987,-10
76549603285,76549603290,5,1783,888,-10
76555161058,76555161060,2,1544,1543,-10
76555993549,76555993550,1,1992,1784,-10
76556302765,76556302767,2,1539,1944,-10
76556488205,76556488207,2,1576,1230,-10
76559420305,76559420307,2,1259,1622,-10
76562239650,76562239657,7,2385,1205,-10
76565519286,76565519289,3,1632,1211,-10
76568813570,76568813576,6,2964,1670,-10
76571089475,76571089483,8,5114,1930,-10
76571337045,76571337046,1,1970,1626,-10
76571809346,76571809349,3,1786,1641,-10
76572843344,76572843346,2,1889,1978,-10
76573681235,76573681235,0,1264,812,-10
76577623500,76577623501,1,1818,1699,-10
76582003956,76582003958,2,1939,1445,-10
76585151715,76585151717,2,1406,1145,-10
76590833546,76590833547,1,1378,1496,-10
76591376924,76591376928,4,1170,1247,-10
76591435925,76591435922,-3,1062,2293,-10
76593671022,76593671023,1,1336,1736,-10
76597658362,76597658363,1,830,972,-10
76603067049,76603067050,1,1480,1475,-10
76603178290,76603178290,0,1232,1606,-10
76603852917,76603852918,1,1234,1532,-10
76604418106,76604418103,-3,1061,2668,-10
76604913297,76604913299,2,1323,1417,-10
76610656406,76610656406,0,1213,1381,-10
76613029542,76613029541,-1,651,1463,-10
76613845685,76613845691,6,1559,1424,-10
76614032526,76614032529,3,1755,1478,-10
76615609923,76615609926,3,1776,1413,-10
76620623209,76620623207,-2,1141,1418,-10
76620990247,76620990250,3,1678,1273,-10
76621161184,76621161186,2,1902,1413,-10
76621516270,76621516273,3,2061,1568,-10
76621740418,76621740419,1,712,1272,-10
76622005689,76622005691,2,2313,1851,-10
76626969938,76626969941,3,1392,1518,-10
76628531248,76628531251,3,1809,1584,-10
76629540086,76629540088,2,1929,1746,-10
76632528714,76632528709,-5,665,2663,-10
76636883518,76636883519,1,1943,1687,-10
76637264330,76637264333,3,1312,1384,-10
76639350568,76639350566,-2,1479,1740,-10
76644375513,76644375514,1,1339,1523,-10
76645815311,76645815310,-1,1443,1796,-10
76645933130,76645933131,1,1323,1591,-10
76647704198,76647704203,5,2411,1679,-10
76651435103,76651435101,-2,938,1961,-10
76651717367,76651717370,3,1160,1352,-10
76651867694,76651867688,-6,1045,3141,-10
76657088095,76657088098,3,1146,1240,-10
76665542930,76665542931,1,1493,1174,-10
76666021248,76666021249,1,1698,1733,-10
76666078254,76666078257,3,1889,1639,-10
76667042409,76667042411,2,1260,1088,-10
76667377018,76667377022,4,1152,1157,-10
76671160530,76671160531,1,1603,1651,-10
76671210114,76671210119,5,1092,899,-10
76673557042,76673557043,1,1284,878,-10
76674435155,76674435158,3,1381,1320,-10
76675601171,76675601171,0,1221,1976,-10
76675747983,76675747990,7,4159,1232,-10
76675981028,76675981050,22,2313,1638,-10
76677033767,76677033769,2,1308,1089,-10
76681254863,76681254866,3,2291,1669,-10
76682899503,76682899505,2,1443,1434,-10
76684128718,76684128720,2,1231,1306,-10
76686196888,76686196889,1,1179,1062,-10
76686919486,76686919486,0,1586,2007,-10
76690178130,76690178132,2,1560,1382,-10
76692366145,76692366147,2,962,1316,-10
76693700322,76693700318,-4,1074,3263,-10
76695295095,76695295098,3,1957,1773,-10
76700170706,76700170707,1,1695,1584,-10
76700775006,76700775007,1,1174,1384,-10
76701488534,76701488537,3,2138,1523,-10
76711811458,76711811454,-4,935,2510,-10
76716737267,76716737269,2,1353,1962,-10
76717080296,76717080313,17,264,1444,-10
76720761014,76720761017,3,1745,1279,-10
76721672940,76721672942,2,1743,1930,-10
76722909774,76722909774,0,1316,1573,-10
76727526726,76727526727,1,1005,1444,-10
76727740165,76727740166,1,1634,1491,-10
76727983778,76727983779,1,958,1409,-10
76728408475,76728408476,1,1115,1708,-10
76729673239,76729673241,2,1393,2114,-10
76730216133,76730216134,1,1405,1703,-10
76731188469,76731188467,-2,1775,2513,-10
76731616621,76731616615,-6,1204,3900,-10
76732292843,76732292842,-1,1539,1842,-10
76738680008,76738680010,2,1654,1496,-10
76739561127,76739561128,1,1334,1683,-10
76742637567,76742637569,2,2155,2207,-10
76742678673,76742678674,1,2045,1618,-10
76744231598,76744231603,5,3573,1997,-10
76746693597,76746693599,2,1848,2419,-10
76748096451,76748096453,2,2068,1423,-10
76748546938,76748546941,3,1281,1023,-10
76749190024,76749190023,-1,1302,1281,-10
76750091484,76750091482,-2,1537,1281,-10
76751178659,76751178660,1,1444,2437,-10
76752096254,76752096255,1,1088,2048,-10
76752919793,76752919795,2,897,748,-10
76753806577,76753806581,4,1159,984,-10
76755774306,76755774308,2,1780,1943,-10
76756258567,76756258570,3,1070,1018,-10
76763189486,76763189488,2,1580,1711,-10
76763380929,76763380931,2,1570,1391,-10
76764377095,76764377099,4,2140,1320,-10
76765672239,76765672216,-23,995,1304,-10
76772724029,76772724031,2,1658,1846,-10
76773294421,76773294422,1,1749,1903,-10
76776300562,76776300564,2,1072,1610,-10
76779824385,76779824386,1,1690,1567,-10
76780308510,76780308510,0,1317,1347,-10
76784443546,76784443551,5,821,902,-10
76784557732,76784557734,2,999,1440,-10
76787770813,76787770814,1,1494,2190,-10
76792673758,76792673755,-3,875,2128,-10
76799037213,76799037219,6,1158,1025,-10
76802713047,76802713051,4,1781,1264,-10
76802760518,76802760496,-22,2104,1860,-10
76805732495,76805732495,0,1575,1276,-10
76805941757,76805941760,3,1828,1861,-10
76807697811,76807697814,3,1954,1915,-10
76809202685,76809202679,-6,1205,4165,-10
76812220750,76812220752,2,1319,1748,-10
76813218834,76813218835,1,1405,1714,-10
76814118687,76814118691,4,1453,1600,-10
76814698159,76814698161,2,1611,1892,-10
76815491334,76815491338,4,1737,1700,-10
76817017402,76817017406,4,1526,1488,-10
76818459208,76818459227,19,1279,1282,-10
76820854771,76820854773,2,1657,1966,-10
76823193977,76823193979,2,1422,1243,-10
76829892142,76829892147,5,1547,1328,-10
76830667861,76830667865,4,1780,1627,-10
76836288845,76836288848,3,1970,1215,-10
76837805900,76837805902,2,3148,2219,-10
76838574974,76838574979,5,1193,1562,-10
76840581386,76840581385,-1,1163,1639,-10
76844981502,76844981506,4,1396,1457,-10
76846196062,76846196062,0,1363,1540,-10
76847917529,76847917531,2,1881,1947,-10
76848019269,76848019270,1,1612,1966,-10
76848356042,76848356047,5,1528,1281,-10
76848561459,76848561471,12,760,2486,-10
76849091929,76849091929,0,24275,28300,-10
76849281587,76849281590,3,1722,1798,-10
76850588917,76850588918,1,1407,1850,-10
76851674262,76851674263,1,1645,1022,-10
76851803354,76851803357,3,2159,2027,-10
76856545399,76856545401,2,1856,1527,-10
76860410879,76860410879,0,822,1215,-10
76863403254,76863403260,6,6586,2024,-10
76863577910,76863577916,6,2328,1596,-10
76865534879,76865534882,3,2079,2238,-10
76865731077,76865731078,1,1260,1744,-10
76873885087,76873885091,4,1299,1172,-10
76875979019,76875979015,-4,913,850,-10
76884283215,76884283217,2,1274,1111,-10
76887936327,76887936329,2,1583,1092,-10
76894172429,76894172428,-1,1145,1182,-10
76897496979,76897496980,1,1648,1818,-10
76898610587,76898610587,0,1534,1124,-10
76900792512,76900792512,0,2212,2078,-10
76902303878,76902303881,3,1477,1211,-10
76909453605,76909453607,2,1603,2762,-10
76910701954,76910701955,1,1385,1432,-10
76911188537,76911188540,3,1850,1578,-10
76918363351,76918363349,-2,6742,14517,-10
76920467029,76920467033,4,1568,1833,-10
76922072663,76922072664,1,1841,1544,-10
76922826562,76922826566,4,2365,1621,-10
76923771516,76923771520,4,720,1391,-10
76924504096,76924504097,1,1263,1340,-10
76924566732,76924566732,0,1413,1855,-10
76928467512,76928467514,2,2208,1688,-10
76929395568,76929395570,2,2100,1615,-10
76931368062,76931368066,4,2322,2232,-10
76934456239,76934456242,3,1282,2054,-10
76934513737,76934513739,2,1706,1776,-10
76934726870,76934726869,-1,1137,1615,-10
76937810113,76937810114,1,1042,1153,-10
76938511364,76938511345,-19,2024,1491,-10
76938875521,76938875522,1,1189,1310,-10
76943272977,76943272978,1,1820,2228,-10
76945903982,76945903985,3,1004,1357,-10
76952923154,76952923157,3,1926,1614,-10
76961291725,76961291725,0,1136,2368,-10
76961507171,76961507173,2,2966,2905,-10
76963051559,76963051561,2,1526,1440,-10
76967439187,76967439190,3,1647,1510,-10
76970393682,76970393683,1,1741,1130,-10
76971316842,76971316842,0,1426,1448,-10
76971406485,76971406488,3,1757,1420,-10
76973022551,76973022553,2,1167,1355,-10
76973169498,76973169502,4,1977,1483,-10
76974108471,76974108474,3,1183,1424,-10
76975374278,76975374281,3,1838,1989,-10
76976259666,76976259669,3,1307,1665,-10
76980392031,76980392034,3,1984,955,-10
76983735382,76983735386,4,2524,1648,-10
76984486418,76984486418,0,1396,1609,-10
76984521918,76984521920,2,2224,2307,-10
76984571993,76984571994,1,1956,1360,-10
76989097305,76989097307,2,1192,1134,-10
76992174990,76992174990,0,1756,2017,-10
76995941724,76995941726,2,1435,1026,-10
76996800948,76996800950,2,1377,1772,-10
77001000286,77001000286,0,1608,1464,-10
77002764321,77002764323,2,1768,1694,-10
77008101566,77008101569,3,916,612,-10
77008535722,77008535728,6,1295,1219,-10
77010855843,77010855844,1,1181,1514,-10
77012677037,77012677038,1,1941,1299,-10
77013718152,77013718154,2,1585,1474,-10
77014065686,77014065688,2,1328,1617,-10
77019244949,77019244951,2,1233,1472,-10
77021760356,77021760358,2,1491,2123,-10
77024705383,77024705385,2,1265,1174,-10
77029513502,77029513502,0,1273,926,-10
77030193959,77030193959,0,1686,2251,-10
77031214894,77031214898,4,2094,1701,-10
77034128895,77034128899,4,1295,1454,-10
77035930533,77035930543,10,18615,54514,-10
77037385864,77037385861,-3,1463,2263,-10
77041813009,77041813012,3,5595,5248,-10
77044301426,77044301427,1,990,1113,-10
77044781225,77044781227,2,1798,1564,-10
77050841017,77050841014,-3,1477,1812,-10
77052459369,77052459370,1,1842,1655,-10
77053187998,77053187998,0,1425,1412,-10
77057336790,77057336790,0,1310,1631,-10
77059071758,77059071761,3,2043,1697,-10
77059585718,77059585719,1,1532,1978,-10
77060444422,77060444423,1,1359,1767,-10
77062306370,77062306371,1,1743,1771,-10
77062619242,77062619242,0,2634,1513,-10
77068617855,77068617860,5,2358,1179,-10
77069454446,77069454451,5,3977,2075,-10
77073322139,77073322139,0,1383,1854,-10
77073768696,77073768701,5,3367,1146,-10
77078899077,77078899079,2,1636,1933,-10
77079112598,77079112602,4,1474,1421,-10
77080470788,77080470790,2,1960,1143,-10
77081265418,77081265423,5,2733,1607,-10
77081433505,77081433507,2,1831,2196,-10
77082706300,77082706294,-6,36452,14732,-10
77084529379,77084529382,3,1008,1413,-10
77086626914,77086626918,4,1740,1573,-10
77087603162,77087603165,3,1552,1372,-10
77089104458,77089104459,1,1949,2093,-10
77089361967,77089361972,5,1843,1461,-10
77090925219,77090925220,1,1579,1795,-10
77092315037,77092315039,2,1136,1549,-10
77093072226,77093072229,3,1856,1266,-10
77096494318,77096494321,3,2308,2187,-10
77097500724,77097500700,-24,1234,1817,-10
77098277231,77098277236,5,2295,1684,-10
77098349375,77098349353,-22,1700,1576,-10
77099409070,77099409073,3,1145,1147,-10
77100332339,77100332327,-12,1264,1118,-10
77100500989,77100500992,3,1885,1729,-10
77101283942,77101283942,0,1964,1380,-10
77105429688,77105429691,3,1386,1668,-10
77108592969,77108592971,2,1719,1380,-10
77110257533,77110257535,2,1000,1297,-10
77110796418,77110796419,1,1170,1402,-10
77111599562,77111599562,0,1219,1802,-10
77112925996,77112925998,2,1622,1796,-10
77113281447,77113281448,1,2045,1991,-10
77115346630,77115346632,2,2099,1735,-10
77119758254,77119758255,1,1076,1374,-10
77119791091,77119791105,14,3613,1634,-10
77123046625,77123046627,2,1417,1251,-10
77125118752,77125118744,-8,1340,5221,-10
77126471163,77126471166,3,1810,1471,-10
77127690746,77127690746,0,1407,968,-10
77128319830,77128319831,1,1929,1282,-10
77129723889,77129723894,5,2375,2037,-10
77132286953,77132286954,1,2150,1768,-10
77137872333,77137872334,1,1441,1452,-10
77137982084,77137982103,19,1917,2358,-10
77139514283,77139514282,-1,1116,1115,-10
77140633959,77140633961,2,1743,1424,-10
77151548126,77151548127,1,1662,1080,-10
77153204732,77153204735,3,1573,1847,-10
77153436274,77153436277,3,1566,1693,-10
77156364974,77156364976,2,1419,1628,-10
77157231966,77157231969,3,1410,1337,-10
77159744334,77159744335,1,1600,1225,-10
77160615688,77160615689,1,1581,1673,-10
77161424410,77161424409,-1,1797,1934,-10
77161681673,77161681681,8,3413,1483,-10
77168926376,77168926378,2,1649,1989,-10
77169785247,77169785251,4,1535,1224,-10
77173451644,77173451647,3,1051,1226,-10
77174259035,77174259037,2,905,1788,-10
77174301982,77174301974,-8,2542,6889,-10
77176642097,77176642099,2,2093,1112,-10
77180117482,77180117485,3,1640,1278,-10
77186788214,77186788218,4,1562,1544,-10
77188089694,77188089698,4,2120,1978,-10
77188528292,77188528294,2,1416,1408,-10
77189739297,77189739298,1,1728,1533,-10
77193025798,77193025798,0,1487,1922,-10
77194583664,77194583667,3,1998,1513,-10
77196131963,77196131964,1,1040,1557,-10
77196904403,77196904404,1,2088,2128,-10
77197134251,77197134251,0,1362,1076,-10
77200805362,77200805369,7,5773,2362,-10
77201307184,77201307186,2,1610,1327,-10
77201428113,77201428113,0,1343,1183,-10
77201527786,77201527787,1,1927,1758,-10
77203173129,77203173132,3,2612,1962,-10
77204260645,77204260646,1,1896,1830,-10
77206682863,77206682866,3,1642,1746,-10
77207498559,77207498562,3,2027,1326,-10
77208056309,77208056310,1,1797,1980,-10
77211744926,77211744928,2,1536,925,-10
77215078219,77215078219,0,2401,2516,-10
77215770995,77215770994,-1,1210,1212,-10
77218044385,77218044375,-10,1407,1813,-10
77236861061,77236861063,2,1852,1725,-10
77239603208,77239603213,5,1506,1278,-10
77239842383,77239842383,0,1209,1300,-10
77242161347,77242161346,-1,910,1376,-10
77245717299,77245717300,1,1379,1383,-10
77249492500,77249492501,1,1035,1021,-10
77251634822,77251634823,1,1955,1484,-10
77256703912,77256703914,2,1663,1291,-10
77257041467,77257041471,4,1076,1691,-10
77261398332,77261398331,-1,1456,1798,-10
77268743119,77268743123,4,2180,2328,-10
77269020590,77269020590,0,1678,1934,-10
77269635653,77269635655,2,1815,1419,-10
77271774711,77271774702,-9,1542,1178,-10
77272141385,77272141387,2,1384,1568,-10
77275279264,77275279265,1,1441,1945,-10
77276670412,77276670415,3,1538,1428,-10
77276746839,77276746851,12,1405,1131,-10
77277444094,77277444095,1,1303,1913,-10
77278781094,77278781098,4,1383,1227,-10
77286209798,77286209799,1,2593,2093,-10
77288817111,77288817116,5,4136,1814,-10
77290354681,77290354682,1,1349,1333,-10
77290648630,77290648633,3,1500,1253,-10
77295235133,77295235134,1,2077,1319,-10
77298796679,77298796679,0,1811,1981,-10
77300887874,77300887875,1,1936,1546,-10
77301089089,77301089082,-7,2071,8570,-10
77301287953,77301287955,2,1280,1411,-10
77304435593,77304435595,2,1348,2004,-10
77309465783,77309465785,2,1747,1290,-10
77315841413,77315841415,2,975,1107,-10
77317180910,77317180913,3,1029,1102,-10
77318662194,77318662196,2,803,968,-10
77318699527,77318699522,-5,1539,5185,-10
77321954434,77321954436,2,1671,1376,-10
77323966882,77323966883,1,1064,1734,-10
77326550090,77326550094,4,722,1010,-10
77326774511,77326774512,1,1167,2085,-10
77330532693,77330532694,1,1943,1664,-10
77331677882,77331677885,3,1262,1505,-10
77331812652,77331812655,3,1461,1703,-10
77333483878,77333483881,3,2245,1298,-10
77340317943,77340317934,-9,1144,1595,-10
77341025954,77341025956,2,1190,1355,-10
77344635359,77344635362,3,1831,1747,-10
77348913393,77348913391,-2,2367,3034,-10
77353895384,77353895381,-3,1005,1811,-10
77354332995,77354332997,2,1552,985,-10
77355580023,77355580026,3,1212,1583,-10
77356759279,77356759278,-1,869,1145,-10
77357319166,77357319167,1,1240,1209,-10
77359948374,77359948378,4,1339,1649,-10
77361181543,77361181543,0,1493,1686,-10
77362233737,77362233739,2,1157,1078,-10
77362704358,77362704360,2,1144,1219,-10
77366797237,77366797237,0,1162,1281,-10
77366951533,77366951534,1,1665,1462,-10
77367321071,77367321075,4,1618,1504,-10
77367959914,77367959917,3,1171,1211,-10
77369815195,77369815188,-7,1508,1604,-10
77372047782,77372047783,1,1487,1439,-10
77373953695,77373953698,3,1267,1273,-10
77377611260,77377611262,2,1440,1872,-10
77381665997,77381665999,2,977,1492,-10
77382057719,77382057721,2,1282,1911,-10
77382512518,77382512521,3,1044,1300,-10
77386967091,77386967092,1,1452,1537,-10
77387543614,77387543616,2,1490,2146,-10
77392286517,77392286518,1,1146,1203,-10
77395487458,77395487459,1,1876,1553,-10
77396648760,77396648761,1,1427,1290,-10
77396952687,77396952689,2,1419,1938,-10
77401941982,77401941983,1,1070,1421,-10
77403360810,77403360810,0,1727,2042,-10
77404362950,77404362951,1,1555,1397,-10
77405403710,77405403712,2,1829,1750,-10
77411368280,77411368282,2,1409,1550,-10
77411705806,77411705790,-16,1401,1126,-10
77413692400,77413692404,4,3765,1965,-10
77413864881,77413864882,1,1440,1489,-10
77415450527,77415450529,2,2511,2973,-10
77418433400,77418433401,1,1584,1947,-10
77421043164,77421043166,2,1493,1409,-10
77423158651,77423158650,-1,1316,2067,-10
77424656177,77424656179,2,1690,1844,-10
77427389046,77427389050,4,1073,1185,-10
77427532209,77427532205,-4,753,814,-10
77430662357,77430662359,2,1632,1598,-10
77431907051,77431907053,2,939,1139,-10
77432791931,77432791933,2,1737,1709,-10
77433457688,77433457689,1,1796,2565,-10
77434212782,77434212783,1,1239,1160,-10
77434818462,77434818463,1,993,1475,-10
77437243341,77437243342,1,1241,1284,-10
77441657748,77441657749,1,1479,1727,-10
77444122093,77444122094,1,1478,1496,-10
77447830080,77447830081,1,1804,1563,-10
77450902743,77450902744,1,630,1296,-10
77451265874,77451265878,4,1668,1638,-10
77451630758,77451630759,1,1517,1429,-10
77452556026,77452556029,3,1603,1341,-10
77453176395,77453176403,8,1679,1463,-10
77454352467,77454352468,1,1893,2353,-10
77454400679,77454400680,1,1347,1714,-10
77457068290,77457068296,6,8073,3470,-10
77457682743,77457682738,-5,1197,3546,-10
77458263867,77458263868,1,1431,1323,-10
77458779191,77458779190,-1,1290,2305,-10
77463760226,77463760228,2,1904,1753,-10
77464002257,77464002261,4,1105,1392,-10
77466922109,77466922110,1,1442,1648,-10
77470802262,77470802265,3,1657,1788,-10
77471260587,77471260590,3,1497,1272,-10
77472085861,77472085865,4,1841,2279,-10
77472297857,77472297857,0,1325,1619,-10
77474089701,77474089702,1,1192,1222,-10
77474356981,77474356982,1,1701,1362,-10
77475075146,77475075150,4,1625,1660,-10
77480147399,77480147402,3,1949,1653,-10
77480850161,77480850162,1,1400,1344,-10
77482227645,77482227646,1,1712,1611,-10
77492848064,77492848068,4,2207,1501,-10
77493212049,77493212050,1,2046,2054,-10
77494126500,77494126500,0,1462,1834,-10
77495599843,77495599846,3,1586,1510,-10
77497314619,77497314621,2,1302,1612,-10
77500002611,77500002615,4,1595,1295,-10
77500516522,77500516525,3,1220,1384,-10
77505232213,77505232214,1,1307,1816,-10
77505359297,77505359298,1,1503,1426,-10
77505875913,77505875914,1,1695,1637,-10
77506203722,77506203719,-3,1219,3097,-10
77507412141,77507412142,1,1102,1141,-10
77507838291,77507838293,2,809,1041,-10
77509256495,77509256492,-3,1858,4827,-10
77509536848,77509536850,2,1562,1365,-10
77512921222,77512921224,2,1901,1641,-10
77513650866,77513650871,5,2343,1783,-10
77515729061,77515729063,2,1602,1321,-10
77518878892,77518878895,3,1653,1716,-10
77520261174,77520261177,3,1198,1060,-10
77520932464,77520932467,3,1461,1178,-10
77522190879,77522190877,-2,1012,1634,-10
77522509966,77522509966,0,1266,1701,-10
77526238534,77526238537,3,1460,1555,-10
77531046397,77531046400,3,1733,1733,-10
77534331374,77534331377,3,1629,1574,-10
77535484676,77535484677,1,1529,2196,-10
77541110233,77541110234,1,1665,1643,-10
77543879559,77543879562,3,1643,1430,-10
77544556827,77544556832,5,2347,1134,-10
77545647784,77545647786,2,2323,1623,-10
77546866223,77546866221,-2,1589,1833,-10
77549528170,77549528173,3,1365,1639,-10
77551112301,77551112302,1,1688,1846,-10
77553112261,77553112261,0,1840,2131,-10
77554827075,77554827078,3,1747,2238,-10
77556049615,77556049617,2,1794,1216,-10
77559300628,77559300622,-6,1098,4444,-10
77560889439,77560889442,3,1377,1437,-10
77562058198,77562058199,1,987,1185,-10
77566327451,77566327454,3,1187,1065,-10
77568621257,77568621259,2,1476,1934,-10
77569134679,77569134679,0,1921,1509,-10
77570615983,77570615987,4,1384,871,-10
77571246984,77571246986,2,1688,1794,-10
77572812161,77572812163,2,1918,2122,-10
77575428618,77575428621,3,2053,1803,-10
77575607213,77575607215,2,1540,1639,-10
77575878321,77575878324,3,1710,2036,-10
77581848466,77581848469,3,2018,1876,-10
77583205065,77583205067,2,1537,1357,-10
77584001687,77584001688,1,1594,1417,-10
77587643342,77587643343,1,1193,1619,-10
77589131646,77589131646,0,1273,2312,-10
77589655617,77589655618,1,1588,1412,-10
77592134500,77592134502,2,1155,1145,-10
77592450134,77592450135,1,1442,1413,-10
77593926050,77593926053,3,1212,1644,-10
77597050378,77597050372,-6,39214,17200,-10
77597797798,77597797801,3,2429,2958,-10
77598716010,77598716012,2,1007,1570,-10
77601469435,77601469436,1,1361,2136,-10
77604867109,77604867112,3,1530,1400,-10
77605011028,77605011031,3,1908,1678,-10
77605555054,77605555057,3,1358,1361,-10
77606146686,77606146690,4,2381,1439,-10
77607081861,77607081862,1,1276,1489,-10
77607851479,77607851481,2,1709,1634,-10
77608251637,77608251638,1,803,1302,-10
77610345842,77610345843,1,1546,1255,-10
77610392445,77610392446,1,1399,1667,-10
77612890658,77612890658,0,1285,1046,-10
77613608286,77613608288,2,1740,1353,-10
77615483626,77615483630,4,1281,1348,-10
77616605079,77616605085,6,1961,1218,-10
77632174040,77632174042,2,1062,861,-10
77638171651,77638171656,5,1712,1327,-10
77644469794,77644469796,2,1494,1310,-10
77651089077,77651089078,1,1418,1102,-10
77654197574,77654197576,2,1907,2132,-10
77655303541,77655303544,3,2217,1666,-10
77658790521,77658790523,2,1463,1195,-10
77658907803,77658907805,2,1729,1342,-10
77661273914,77661273915,1,1611,1290,-10
77662168945,77662168946,1,1880,1843,-10
77662329147,77662329150,3,1657,1781,-10
77663434015,77663434015,0,1767,1599,-10
77664081008,77664081009,1,1127,1472,-10
77668578090,77668578091,1,1754,1985,-10
77671801264,77671801266,2,1313,1506,-10
77673290962,77673290965,3,1352,1609,-10
77675120195,77675120195,0,1204,1643,-10
77680844825,77680844818,-7,1862,6114,-10
77681230254,77681230257,3,1069,849,-10
77682953047,77682953049,2,1702,1440,-10
77683886027,77683886026,-1,1583,1209,-10
77684014937,77684014938,1,1880,1499,-10
77688437138,77688437138,0,1217,1363,-10
77689215100,77689215100,0,1297,1441,-10
77694469668,77694469669,1,1972,1894,-10
77700654991,77700654992,1,1320,1575,-10
77701323016,77701323021,5,1930,1105,-10
77704092826,77704092828,2,1437,1452,-10
77704268822,77704268824,2,1329,1155,-10
77706207785,77706207788,3,1841,1744,-10
77706497047,77706497050,3,1335,1014,-10
77708779392,77708779393,1,1086,1131,-10
77709740195,77709740208,13,1534,1431,-10
77713070117,77713070121,4,1731,1465,-10
77715442917,77715442918,1,1309,1575,-10
77719356064,77719356065,1,1431,1481,-10
77723635629,77723635630,1,43941,19166,-10
77725357940,77725357942,2,1356,1464,-10
77727326909,77727326910,1,1622,1221,-10
77727493258,77727493262,4,2058,1214,-10
77732473912,77732473914,2,1954,1473,-10
77732949102,77732949103,1,812,873,-10
77737911598,77737911599,1,1982,1829,-10
77743277658,77743277662,4,1143,1340,-10
77745121826,77745121830,4,1588,1401,-10
77745894313,77745894315,2,1480,1126,-10
77747808679,77747808672,-7,558,3289,-10
77749721022,77749721022,0,1027,875,-10
77750720096,77750720088,-8,102,100,-10
77751065665,77751065667,2,1589,1552,-10
77753324811,77753324812,1,1479,1508,-10
77753387398,77753387396,-2,956,2226,-10
77754173640,77754173643,3,1294,1564,-10
77756077022,77756077024,2,1945,1556,-10
77756977950,77756977951,1,2452,1972,-10
77762117602,77762117602,0,1799,1593,-10
77762484783,77762484782,-1,1638,1982,-10
77768456607,77768456609,2,1784,1809,-10
77771053219,77771053220,1,1189,1589,-10
77771778499,77771778499,0,1619,1336,-10
77771962022,77771962026,4,2113,1643,-10
77773115919,77773115919,0,1712,2113,-10
77773232850,77773232852,2,1118,1484,-10
77773470179,77773470181,2,988,1194,-10
77773645263,77773645266,3,1565,1385,-10
77781921660,77781921661,1,1167,1501,-10
77783227283,77783227301,18,501,1358,-10
77784787579,77784787581,2,1753,1110,-10
77785502215,77785502215,0,1204,1327,-10
77788241143,77788241146,3,2524,2033,-10
77790695567,77790695569,2,1965,1271,-10
77792018415,77792018418,3,1782,1779,-10
77798015906,77798015908,2,1093,1209,-10
77799770890,77799770889,-1,2430,2256,-10
77801065046,77801065046,0,2544,2208,-10
77801671045,77801671045,0,2186,1744,-10
77806051017,77806051020,3,1327,1421,-10
77809704489,77809704485,-4,747,2794,-10
77811181069,77811181070,1,1571,1162,-10
77811675342,77811675343,1,1713,1819,-10
77813574396,77813574397,1,2132,2285,-10
77814803658,77814803658,0,1622,1623,-10
77818660555,77818660557,2,1095,733,-10
77827720973,77827720975,2,1549,1490,-10
77829948298,77829948300,2,1471,1554,-10
77831761078,77831761078,0,2275,1257,-10
77832367182,77832367195,13,2135,1740,-10
77834239307,77834239311,4,2023,1530,-10
77836919469,77836919468,-1,1692,2307,-10
77836972198,77836972202,4,1101,1832,-10
77838980645,77838980647,2,1787,1742,-10
77842182791,77842182795,4,1756,1594,-10
77848761064,77848761062,-2,2282,5470,-10
77852879846,77852879849,3,1613,1722,-10
77856333284,77856333298,14,14941,43228,-10
77856690876,77856690872,-4,1555,3821,-10
77858365546,77858365545,-1,1424,2444,-10
77858916921,77858916922,1,1102,1361,-10
77859832541,77859832543,2,1662,1579,-10
77862338662,77862338666,4,1495,1202,-10
77863112426,77863112430,4,1261,1512,-10
77867515971,77867515977,6,7107,2249,-10
77868666813,77868666815,2,1950,1226,-10
77875327004,77875327004,0,1413,1744,-10
77881077758,77881077758,0,1926,1568,-10
77881144477,77881144480,3,1315,1728,-10
77887977520,77887977522,2,980,1360,-10
77889394214,77889394214,0,1068,1774,-10
77890742722,77890742723,1,1204,1392,-10
77893040814,77893040818,4,1757,1411,-10
77895310542,77895310544,2,1610,1936,-10
77896678841,77896678843,2,1597,1410,-10
77901844955,77901844959,4,2393,1577,-10
77905218910,77905218911,1,1720,1956,-10
77905418317,77905418318,1,1102,1235,-10
77906325413,77906325414,1,2287,2089,-10
77908499621,77908499623,2,2201,2004,-10
77908601765,77908601770,5,1236,1077,-10
77909260494,77909260495,1,2283,2175,-10
77909662989,77909662991,2,1462,1387,-10
77914093643,77914093638,-5,894,2420,-10
77914942453,77914942454,1,1808,1578,-10
77917700606,77917700607,1,967,1371,-10
77919167321,77919167304,-17,1664,1568,-10
77919534645,77919534646,1,2082,2489,-10
77920700679,77920700682,3,1757,2002,-10
77922882210,77922882192,-18,787,516,-10
77923084558,77923084561,3,1354,1515,-10
77924238698,77924238693,-5,801,3401,-10
77925204686,77925204686,0,1560,1470,-10
77933761558,77933761559,1,1663,1572,-10
77934388569,77934388572,3,1987,1555,-10
77935281405,77935281410,5,1480,1568,-10
77936083722,77936083726,4,1394,1297,-10
77937678765,77937678765,0,900,1111,-10
77938662401,77938662403,2,1332,1711,-10
77947704355,77947704349,-6,868,2564,-10
77952754008,77952754009,1,1418,1342,-10
77953975210,77953975211,1,1595,1661,-10
77955218987,77955218990,3,1823,1170,-10
77957097857,77957097857,0,1540,1152,-10
77957274142,77957274147,5,2723,2375,-10
77957859854,77957859858,4,1850,1447,-10
77958663603,77958663607,4,1328,1096,-10
77961976242,77961976243,1,1244,1458,-10
77962270106,77962270106,0,786,1452,-10
77964055005,77964055005,0,1636,1372,-10
77967807129,77967807131,2,1427,1459,-10
77968203202,77968203203,1,923,516,-10
77969257459,77969257462,3,1152,1456,-10
77969574274,77969574275,1,1664,1395,-10
77970601101,77970601104,3,2398,1955,-10
77973087496,77973087498,2,1626,1540,-10
77974762050,77974762050,0,1332,1434,-10
77976037051,77976037055,4,2195,1705,-10
77976863877,77976863882,5,2564,889,-10
77980488870,77980488869,-1,1457,1875,-10
77981140921,77981140923,2,1750,1705,-10
77981571414,77981571411,-3,2116,3382,-10
77985645153,77985645154,1,1173,1595,-10
77985884002,77985884005,3,1936,1640,-10
77987726753,77987726757,4,1831,2033,-10
77989174905,77989174911,6,4321,1708,-10
77991024447,77991024430,-17,592,821,-10
77999839129,77999839130,1,1360,1111,-10
78002629585,78002629586,1,1636,1747,-10
78012561379,78012561381,2,1805,1359,-10
78013548047,78013548049,2,2214,1959,-10
78014073194,78014073197,3,1607,1201,-10
78021478295,78021478297,2,1738,2079,-10
78022077569,78022077574,5,2361,1343,-10
78023522894,78023522898,4,1756,1214,-10
78024029982,78024029983,1,1609,1174,-10
78024211418,78024211420,2,1744,1658,-10
78026225961,78026225963,2,2453,2032,-10
78028699708,78028699706,-2,6184,12426,-10
78029771830,78029771832,2,1746,1960,-10
78031105633,78031105634,1,1439,1912,-10
78032029003,78032029005,2,1328,1703,-10
78032443856,78032443859,3,2039,1727,-10
78034725643,78034725644,1,1447,1220,-10
78036566113,78036566114,1,1699,2070,-10
78036903681,78036903682,1,1242,1150,-10
78038913054,78038913054,0,2137,1502,-10
78039324720,78039324723,3,1691,1692,-10
78039942498,78039942493,-5,1575,7221,-10
78041045910,78041045910,0,1158,1060,-10
78043893319,78043893321,2,1907,1831,-10
78043921277,78043921282,5,1647,1217,-10
78044272446,78044272427,-19,2335,1608,-10
78047645234,78047645237,3,1292,1326,-10
78049732235,78049732238,3,1329,1305,-10
78054760703,78054760702,-1,1854,1796,-10
78055361149,78055361151,2,1986,1176,-10
78055521565,78055521568,3,1808,1119,-10
78055549802,78055549818,16,1326,1127,-10
78060831614,78060831614,0,1299,1690,-10
78064075981,78064075982,1,1176,1142,-10
78064598599,78064598600,1,1716,1526,-10
78066729091,78066729093,2,850,804,-10
78072168322,78072168323,1,1654,1137,-10
78072615517,78072615518,1,1832,1709,-10
78073538894,78073538898,4,1512,1611,-10
78075784328,78075784330,2,974,1085,-10
78078595246,78078595249,3,1030,1190,-10
78081084454,78081084455,1,1474,2397,-10
78081771950,78081771950,0,1764,1920,-10
78083633056,78083633057,1,1273,1236,-10
78083945233,78083945234,1,1235,1543,-10
78090176026,78090176034,8,3582,1630,-10
78092257835,78092257835,0,1363,2013,-10
78092477891,78092477893,2,1540,2143,-10
78093942139,78093942142,3,2210,2356,-10
78095965357,78095965358,1,2041,2151,-10
78098107622,78098107623,1,1603,1106,-10
78099332001,78099331996,-5,1460,3649,-10
78101028561,78101028565,4,1410,1400,-10
78103282389,78103282392,3,1676,951,-10
78104736746,78104736747,1,1806,1417,-10
78107137067,78107137066,-1,1264,1374,-10
78112504834,78112504837,3,1421,1736,-10
78116070595,78116070598,3,1317,1540,-10
78117019282,78117019285,3,2029,1337,-10
78119678560,78119678552,-8,1796,6984,-10
78119719690,78119719691,1,1438,984,-10
78122802970,78122802972,2,828,1312,-10
78124568038,78124568042,4,2488,1611,-10
78126488446,78126488450,4,2047,1196,-10
78126618553,78126618554,1,1515,1422,-10
78127496119,78127496121,2,2050,2284,-10
78127823293,78127823293,0,1612,1864,-10
78131204250,78131204246,-4,1085,4542,-10
78137648597,78137648598,1,1978,2158,-10
78138168926,78138168927,1,821,1110,-10
78139526535,78139526529,-6,1229,4368,-10
78142527566,78142527566,0,1525,1219,-10
78145441915,78145441917,2,1374,1557,-10
78145627926,78145627937,11,1344,1303,-10
78148985429,78148985430,1,2006,1526,-10
78149587414,78149587415,1,1575,1776,-10
78151003408,78151003410,2,1685,1625,-10
78153365577,78153365579,2,1372,1105,-10
78153581884,78153581885,1,1772,1923,-10
78153715148,78153715142,-6,842,3091,-10
78164596057,78164596062,5,1768,1041,-10
78174542311,78174542314,3,1906,1589,-10
78174920718,78174920717,-1,1862,1624,-10
78175592324,78175592327,3,1665,1918,-10
78177603514,78177603514,0,1056,1120,-10
78177798520,78177798522,2,1285,1744,-10
78182122554,78182122559,5,2268,1653,-10
78184803690,78184803694,4,1560,1795,-10
78186604109,78186604111,2,1668,2168,-10
78189251155,78189251159,4,1539,1376,-10
78190822147,78190822148,1,1837,2090,-10
78195619332,78195619332,0,1439,1398,-10
78198610850,78198610852,2,1560,1352,-10
78199841293,78199841293,0,1077,1447,-10
78205334857,78205334860,3,1036,1075,-10
78206050365,78206050370,5,1391,1735,-10
78210221181,78210221181,0,1187,1711,-10
78210435730,78210435735,5,1304,1039,-10
78211081597,78211081599,2,1555,1238,-10
78213719917,78213719918,1,1580,1348,-10
78217540807,78217540810,3,1799,1841,-10
78218920939,78218920940,1,2129,774,-10
78219842190,78219842193,3,1484,1417,-10
78223337589,78223337589,0,1617,2022,-10
78223404057,78223404058,1,1230,1340,-10
78223689782,78223689782,0,1542,1576,-10
78224026859,78224026838,-21,1329,1078,-10
78226344781,78226344783,2,1835,1364,-10
78227274013,78227274013,0,1729,1668,-10
78227513783,78227513786,3,1973,2929,-10
78229589567,78229589569,2,1604,1671,-10
78235545358,78235545363,5,1138,1575,-10
78240815473,78240815477,4,1334,1525,-10
78246841037,78246841038,1,1166,1179,-10
78247502486,78247502482,-4,1531,5427,-10
78248261142,78248261142,0,1655,1892,-10
78248380272,78248380275,3,2335,1158,-10
78248546465,78248546467,2,1953,1810,-10
78248718394,78248718401,7,5202,1445,-10
78249987573,78249987573,0,1598,1520,-10
78251040561,78251040563,2,786,1058,-10
78252449890,78252449891,1,1375,1554,-10
78252767821,78252767826,5,2360,1636,-10
78258230380,78258230384,4,1879,1445,-10
78261369261,78261369263,2,1344,1390,-10
78266678101,78266678104,3,1459,1224,-10
78267072161,78267072154,-7,1254,1349,-10
78268887134,78268887135,1,1003,1000,-10
78273914107,78273914107,0,1093,942,-10
78275735674,78275735676,2,1258,1194,-10
78276851326,78276851327,1,1757,1980,-10
78278523259,78278523278,19,1338,1433,-10
78280495250,78280495251,1,1476,1356,-10
78281370253,78281370256,3,1622,1567,-10
78286428083,78286428081,-2,574,1987,-10
78290675041,78290675043,2,1512,1091,-10
78291681194,78291681197,3,1403,1692,-10
78294436227,78294436229,2,1834,2325,-10
78296366845,78296366849,4,1910,1310,-10
78296907802,78296907802,0,1959,1559,-10
78297088569,78297088570,1,1578,1624,-10
78298810541,78298810543,2,1300,1001,-10
78299351567,78299351570,3,1597,1768,-10
78300899442,78300899446,4,1832,1164,-10
78303169261,78303169262,1,1459,1644,-10
78303328464,78303328467,3,1615,1684,-10
78303821691,78303821685,-6,55,1762,-10
78304362382,78304362383,1,1531,1542,-10
78305018191,78305018194,3,1763,1423,-10
78307768295,78307768297,2,1785,1527,-10
78307827316,78307827316,0,1492,1331,-10
78312679236,78312679238,2,1863,1526,-10
78313233826,78313233827,1,1112,1201,-10
78316726690,78316726691,1,1414,1767,-10
78319512273,78319512274,1,1230,1439,-10
78321865074,78321865075,1,1624,1661,-10
78323315151,78323315154,3,1226,1323,-10
78324572397,78324572398,1,1171,1124,-10
78326123308,78326123310,2,1093,1476,-10
78326173073,78326173075,2,2077,1166,-10
78328401754,78328401755,1,1153,1129,-10
78329124775,78329124778,3,1777,1604,-10
78329693878,78329693882,4,1358,1800,-10
78333651211,78333651215,4,1548,1187,-10
78333741826,78333741827,1,1342,1411,-10
78333860202,78333860218,16,1366,1371,-10
78343572460,78343572457,-3,1062,1385,-10
78346610042,78346610046,4,1204,1123,-10
78347286602,78347286606,4,2001,2334,-10
78350913009,78350913011,2,2114,2054,-10
78351464525,78351464522,-3,22101,14218,-10
78352487757,78352487759,2,1946,1580,-10
78353070634,78353070635,1,1140,1797,-10
78354297767,78354297769,2,1188,1418,-10
78356620346,78356620347,1,1517,1606,-10
78357809376,78357809379,3,1317,1584,-10
78359631215,78359631216,1,1383,1673,-10
78361827062,78361827064,2,1563,1309,-10
78364144026,78364144027,1,2372,1714,-10
78370905473,78370905475,2,2016,1873,-10
78372774542,78372774545,3,935,731,-10
78372909389,78372909392,3,2124,1865,-10
78373317371,78373317374,3,1528,1960,-10
78374648842,78374648844,2,1602,1792,-10
78375275983,78375275985,2,1875,1613,-10
78375406379,78375406381,2,1053,1300,-10
78383413621,78383413622,1,1688,1429,-10
78385540889,78385540891,2,1697,1346,-10
78386807626,78386807630,4,1664,2031,-10
78388019921,78388019922,1,1016,1180,-10
78389197649,78389197646,-3,839,906,-10
78389811354,78389811356,2,1446,1755,-10
78393046274,78393046274,0,1745,1990,-10
78395144935,78395144930,-5,1440,4112,-10
78396751917,78396751919,2,1408,1418,-10
78397280561,78397280557,-4,2075,1460,-10
78397349415,78397349417,2,1929,1527,-10
78399208442,78399208442,0,2087,2102,-10
78399884195,78399884194,-1,2177,1716,-10
78401566080,78401566081,1,1541,1675,-10
78403370646,78403370647,1,2275,2245,-10
78404412516,78404412518,2,1996,1755,-10
78404871618,78404871621,3,1756,2063,-10
78407492301,78407492303,2,1995,2025,-10
78408195914,78408195916,2,1703,1648,-10
78412494182,78412494187,5,2920,1630,-10
78417881528,78417881530,2,2020,2106,-10
78421736701,78421736708,7,5832,2033,-10
78422368345,78422368339,-6,1102,3277,-10
78422551636,78422551653,17,914,842,-10
78433389495,78433389496,1,1640,1639,-10
78434009254,78434009257,3,1243,1702,-10
78434448054,78434448054,0,1633,1036,-10
78436010109,78436010112,3,1464,1278,-10
78440619990,78440619991,1,1843,1256,-10
78441878135,78441878137,2,1155,929,-10
78442594330,78442594333,3,1210,1616,-10
78443611617,78443611610,-7,1345,5936,-10
78445068130,78445068131,1,1441,1292,-10
78449411884,78449411886,2,1693,1893,-10
78449755558,78449755555,-3,26955,49412,-10
78450452947,78450452947,0,1716,2361,-10
78451268938,78451268941,3,1915,1711,-10
78452141347,78452141349,2,1320,1443,-10
78452553481,78452553483,2,1724,1142,-10
78453710800,78453710801,1,1771,1339,-10
78454628386,78454628387,1,1350,1493,-10
78455940757,78455940757,0,992,914,-10
78456812882,78456812883,1,1360,1415,-10
78457020469,78457020470,1,2113,2191,-10
78460836421,78460836421,0,1136,707,-10
78461512837,78461512838,1,1423,1443,-10
78463004091,78463004095,4,1068,1097,-10
78464630274,78464630273,-1,1235,1558,-10
78465216787,78465216788,1,1683,1562,-10
78468462882,78468462885,3,1197,1029,-10
78468800737,78468800738,1,1359,1881,-10
78472919727,78472919730,3,1426,1468,-10
78476348752,78476348754,2,1714,2019,-10
78477910262,78477910264,2,1712,1933,-10
78477969190,78477969192,2,1643,1716,-10
78478812407,78478812408,1,1792,2219,-10
78479035275,78479035275,0,1349,1119,-10
78481307059,78481307062,3,2528,1924,-10
78481774134,78481774134,0,1247,1352,-10
78481994657,78481994654,-3,1198,1132,-10
78483084889,78483084890,1,1447,1334,-10
78493152599,78493152599,0,1851,1522,-10
78501044452,78501044453,1,1795,1501,-10
78501940130,78501940132,2,1254,1310,-10
78502668314,78502668313,-1,1743,1284,-10
78505262330,78505262333,3,1495,1622,-10
78505641782,78505641783,1,10952,15115,-10
78514399235,78514399236,1,1261,1672,-10
78514748814,78514748814,0,932,1031,-10
78515361090,78515361089,-1,1310,2184,-10
78524739361,78524739362,1,1305,1371,-10
78527554141,78527554141,0,1993,1856,-10
78529781214,78529781214,0,1871,1989,-10
78529820755,78529820759,4,1859,1308,-10
78530427737,78530427739,2,1218,1546,-10
78530654583,78530654560,-23,1516,1293,-10
78534059453,78534059443,-10,361,996,-10
78536316126,78536316127,1,1117,1310,-10
78537286438,78537286436,-2,1854,2239,-10
78537498623,78537498626,3,1940,1920,-10
78539237063,78539237065,2,3834,3613,-10
78543905182,78543905183,1,1414,1453,-10
78545677970,78545677971,1,1476,1629,-10
78550918374,78550918378,4,1230,1536,-10
78553597094,78553597098,4,1230,1169,-10
78553858060,78553858061,1,1838,1216,-10
78555366542,78555366548,6,21351,37762,-10
78555510543,78555510545,2,1353,1282,-10
78556528644,78556528627,-17,1629,1330,-10
78559780894,78559780895,1,1880,1669,-10
78560386985,78560386987,2,1855,1744,-10
78560893822,78560893832,10,1409,1124,-10
78563799582,78563799586,4,1326,1330,-10
78564284454,78564284452,-2,1225,1946,-10
78565018197,78565018199,2,1479,1593,-10
78567008846,78567008849,3,1582,1448,-10
78567037259,78567037244,-15,1673,1043,-10
78567416368,78567416369,1,2048,1797,-10
78570397333,78570397335,2,1073,1170,-10
78573369539,78573369546,7,2300,1323,-10
78577027785,78577027781,-4,2087,5758,-10
78577254244,78577254246,2,1016,1062,-10
78577516978,78577516982,4,1584,1510,-10
78578970759,78578970752,-7,1204,6169,-10
78579605447,78579605450,3,2013,2208,-10
78583641565,78583641566,1,1761,1516,-10
78586653434,78586653434,0,2072,2158,-10
78589573530,78589573530,0,1282,1655,-10
78597063084,78597063090,6,4371,2735,-10
78599388327,78599388329,2,1250,1562,-10
78603138478,78603138475,-3,1018,2059,-10
78604509166,78604509167,1,1224,772,-10
78605595754,78605595758,4,2473,1234,-10
78607152363,78607152364,1,1522,2027,-10
78607941874,78607941875,1,1727,1375,-10
78609678247,78609678247,0,1542,1047,-10
78620693498,78620693500,2,1170,1454,-10
78622222849,78622222850,1,1170,1412,-10
78625189156,78625189158,2,1465,1945,-10
78630253563,78630253561,-2,1675,1745,-10
78630607132,78630607130,-2,1432,2406,-10
78632575331,78632575341,10,1925,1458,-10
78634998317,78634998320,3,1711,1572,-10
78635380197,78635380200,3,1986,1795,-10
78635920959,78635920959,0,957,1142,-10
78637149928,78637149930,2,1644,1319,-10
78637596691,78637596694,3,1420,2146,-10
78637845703,78637845707,4,1906,1490,-10
78638937736,78638937737,1,1617,1700,-10
78640020339,78640020336,-3,1284,2724,-10
78640360819,78640360819,0,1385,1399,-10
78642153914,78642153915,1,1228,973,-10
78644204180,78644204182,2,1397,1380,-10
78645794771,78645794755,-16,1112,1417,-10
78646685879,78646685877,-2,1477,2618,-10
78648141886,78648141888,2,857,1194,-10
78648546655,78648546657,2,974,1414,-10
78652662700,78652662686,-14,1184,1638,-10
78654560480,78654560475,-5,858,2623,-10
78654935865,78654935860,-5,904,1537,-10
78656818683,78656818685,2,1931,1433,-10
78657587825,78657587838,13,11491,45272,-10
78658087408,78658087410,2,1813,1955,-10
78661352114,78661352116,2,1560,1350,-10
78663285466,78663285467,1,1268,977,-10
78667049208,78667049211,3,2031,2614,-10
78667284990,78667284993,3,1304,1259,-10
78669983857,78669983858,1,1447,1986,-10
78671100125,78671100126,1,2252,2003,-10
78672418597,78672418599,2,1711,1570,-10
78674257413,78674257415,2,1863,1825,-10
78675641268,78675641271,3,1886,1859,-10
78675846210,78675846212,2,1233,1289,-10
78677316736,78677316738,2,1727,1547,-10
78679907219,78679907221,2,1259,1005,-10
78681497533,78681497546,13,365,1099,-10
78685217738,78685217738,0,1091,2005,-10
78688898947,78688898950,3,1971,1220,-10
78691136437,78691136438,1,1530,1148,-10
78693588930,78693588933,3,1628,1234,-10
78696969434,78696969437,3,1529,1143,-10
78697365679,78697365698,19,1767,1099,-10
78697893769,78697893771,2,1544,1614,-10
78701055485,78701055483,-2,1428,1790,-10
78703213322,78703213324,2,1858,1719,-10
78704122481,78704122482,1,1670,1469,-10
78705904591,78705904591,0,1720,1417,-10
78708297067,78708297069,2,1286,1292,-10
78708362612,78708362614,2,2235,1888,-10
78709873846,78709873850,4,1222,1578,-10
78710435657,78710435660,3,1542,1820,-10
78712200831,78712200835,4,1412,1584,-10
78713211243,78713211246,3,1212,1497,-10
78714385225,78714385226,1,1569,1360,-10
78717924203,78717924206,3,829,1899,-10
78718408599,78718408601,2,1205,1615,-10
78720747610,78720747612,2,1905,1449,-10
78721311229,78721311230,1,1519,1587,-10
78722825609,78722825605,-4,1308,4298,-10
78728981412,78728981413,1,1586,1747,-10
78730868783,78730868783,0,1103,1108,-10
78732657897,78732657900,3,1711,1488,-10
78735060546,78735060547,1,992,924,-10
78739211223,78739211225,2,1045,644,-10
78743005822,78743005825,3,775,1095,-10
78744063026,78744063026,0,1268,1548,-10
78747759359,78747759363,4,1761,1503,-10
78750270767,78750270769,2,1494,1555,-10
78752350614,78752350611,-3,807,2242,-10
78752385099,78752385093,-6,1172,1262,-10
78755393941,78755393945,4,1255,1293,-10
78758864222,78758864226,4,1424,980,-10
78764943037,78764943042,5,1184,1413,-10
78772433214,78772433217,3,1654,1372,-10
78773427995,78773427997,2,1553,1253,-10
78775351449,78775351454,5,5977,2801,-10
78776160230,78776160230,0,1181,1381,-10
78776410378,78776410381,3,1495,1591,-10
78776501771,78776501773,2,1147,1332,-10
78780423365,78780423368,3,1314,1740,-10
78781032345,78781032348,3,1823,1466,-10
78785585669,78785585671,2,1848,1509,-10
78785738134,78785738136,2,1747,2106,-10
78786321855,78786321858,3,1301,1125,-10
78787084616,78787084617,1,1650,1184,-10
78787722498,78787722499,1,1660,1505,-10
78790448261,78790448263,2,1185,1103,-10
78790717206,78790717210,4,2016,2033,-10
78791068952,78791068947,-5,1387,2212,-10
78792951147,78792951149,2,1263,1403,-10
78793364255,78793364257,2,1796,1838,-10
78794053079,78794053078,-1,1242,1525,-10
78796245138,78796245141,3,1462,1400,-10
78799086207,78799086213,6,998,1251,-10
78801525529,78801525529,0,2223,1648,-10
78801959082,78801959084,2,2377,1656,-10
78802798749,78802798749,0,1815,2277,-10
78804250450,78804250454,4,1764,1060,-10
78806884483,78806884486,3,1516,789,-10
78808246549,78808246550,1,1192,1048,-10
78808325516,78808325518,2,1432,1163,-10
78808540534,78808540535,1,1034,1035,-10
78810197858,78810197858,0,1274,1406,-10
78810602226,78810602232,6,2237,1733,-10
78812404638,78812404638,0,1181,1682,-10
78812928926,78812928930,4,1479,1236,-10
78813786405,78813786407,2,1533,1348,-10
78813903854,78813903854,0,1466,1496,-10
78815889176,78815889175,-1,1226,1449,-10
78816850188,78816850189,1,2102,1645,-10
78817234970,78817234970,0,770,792,-10
78818182518,78818182521,3,2140,2331,-10
78820561326,78820561331,5,1411,1705,-10
78827138577,78827138578,1,1345,1240,-10
78828343337,78828343339,2,823,1088,-10
78828852874,78828852874,0,1171,1452,-10
78833929514,78833929515,1,1435,1750,-10
78836102354,78836102354,0,1424,1753,-10
78838755947,78838755952,5,1532,2086,-10
78840763690,78840763691,1,1544,1626,-10
78844106812,78844106810,-2,1532,2556,-10
78844388654,78844388658,4,1208,1926,-10
78844828847,78844828847,0,1433,1838,-10
78844892987,78844892990,3,1338,1543,-10
78846939854,78846939854,0,1237,1138,-10
78847191031,78847191031,0,1211,1485,-10
78849267131,78849267133,2,1087,1229,-10
78851095822,78851095829,7,2139,1126,-10
78851773106,78851773109,3,1944,1864,-10
78853301348,78853301350,2,1700,1276,-10
78854834571,78854834574,3,1446,1622,-10
78854917006,78854917006,0,1392,1639,-10
78855568598,78855568599,1,1691,1456,-10
78863589171,78863589173,2,908,1639,-10
78870892373,78870892374,1,1691,1255,-10
78872818369,78872818370,1,1388,1259,-10
78882260766,78882260769,3,1857,1602,-10
78883554575,78883554576,1,1138,1597,-10
78884839782,78884839764,-18,1722,1396,-10
78888484335,78888484337,2,1608,1208,-10
78889524369,78889524370,1,941,1422,-10
78891399814,78891399816,2,1525,1289,-10
78891905633,78891905635,2,2677,2085,-10
78892013383,78892013386,3,2072,2141,-10
78895417573,78895417574,1,2142,1866,-10
78896238341,78896238343,2,1238,1135,-10
78896831424,78896831426,2,1924,1593,-10
78897043977,78897043981,4,1604,1386,-10
78897506357,78897506338,-19,1166,984,-10
78899304121,78899304123,2,1547,1321,-10
78903293234,78903293235,1,1215,1483,-10
78904220706,78904220709,3,1443,1558,-10
78906904357,78906904353,-4,1052,2530,-10
78907942876,78907942876,0,2126,1893,-10
78909572374,78909572379,5,2119,1340,-10
78910892339,78910892354,15,1653,1033,-10
78917154028,78917154031,3,1727,1768,-10
78918340693,78918340696,3,1690,1727,-10
78919125516,78919125515,-1,1201,1532,-10
78926106485,78926106485,0,1503,2056,-10
78928965010,78928965011,1,883,1400,-10
78929045821,78929045822,1,1796,1154,-10
78930881882,78930881884,2,2057,1782,-10
78930953651,78930953665,14,1772,1151,-10
78932262844,78932262846,2,1412,1677,-10
78935452470,78935452471,1,1396,1618,-10
78937377714,78937377715,1,852,1342,-10
78942363582,78942363586,4,1539,1759,-10
78943762312,78943762314,2,1599,1620,-10
78948207259,78948207261,2,2390,2978,-10
78950647315,78950647319,4,1771,1884,-10
78951926942,78951926943,1,1900,1423,-10
78952708096,78952708081,-15,955,872,-10
78952920705,78952920702,-3,944,2767,-10
78956796114,78956796113,-1,1614,1518,-10
78957991565,78957991566,1,1227,1027,-10
78961954286,78961954291,5,1664,1516,-10
78966124950,78966124953,3,1996,1652,-10
78966345213,78966345214,1,1545,1851,-10
78967790268,78967790269,1,878,2010,-10
78968501821,78968501824,3,1909,1633,-10
78969761461,78969761463,2,1750,1892,-10
78971134739,78971134743,4,1877,1096,-10
78973628216,78973628217,1,1365,1603,-10
78975158325,78975158327,2,1861,1795,-10
78979934561,78979934564,3,1855,1821,-10
78988404774,78988404776,2,1543,1272,-10
78988719936,78988719938,2,2267,2124,-10
78994080357,78994080354,-3,1253,2141,-10
78996321701,78996321703,2,1312,1841,-10
78997056559,78997056561,2,1861,1891,-10
78999370810,78999370811,1,1608,1754,-10
78999572254,78999572263,9,15045,23543,-10
79001033730,79001033735,5,1333,1287,-10
79001600751,79001600754,3,2409,1893,-10
79002011303,79002011304,1,1252,2081,-10
79002594628,79002594628,0,1462,1774,-10
79009251156,79009251159,3,9398,6728,-10
79009422791,79009422769,-22,1490,832,-10
79010326216,79010326223,7,23,841,-10
79011604741,79011604741,0,1751,1985,-10
79011701432,79011701435,3,1209,1057,-10
79012599793,79012599793,0,975,1414,-10
79015679131,79015679134,3,1453,1547,-10
79016517543,79016517542,-1,1833,1950,-10
79017871433,79017871434,1,1977,1948,-10
79017987414,79017987418,4,1848,1539,-10
79019385931,79019385933,2,1521,1474,-10
79022756814,79022756816,2,1292,1878,-10
79026839621,79026839622,1,1184,1124,-10
79027867250,79027867253,3,1562,1454,-10
79032119753,79032119755,2,1583,1494,-10
79032552070,79032552074,4,1445,1693,-10
79033603661,79033603662,1,761,980,-10
79036772718,79036772719,1,1777,1460,-10
79038609009,79038609009,0,1325,1223,-10
79042285518,79042285518,0,1381,1657,-10
79043606965,79043606965,0,860,1578,-10
79044618939,79044618945,6,2714,1048,-10
79045206423,79045206424,1,1272,1127,-10
79045383088,79045383089,1,1235,1343,-10
79046106115,79046106117,2,1151,1494,-10
79047547420,79047547413,-7,2613,5540,-10
79050949303,79050949307,4,1354,1585,-10
79051601589,79051601591,2,1344,1857,-10
79054644305,79054644306,1,1379,1200,-10
79057052911,79057052919,8,2004,960,-10
79058005506,79058005511,5,2214,1239,-10
79058735586,79058735588,2,1100,1689,-10
79060890573,79060890575,2,941,1102,-10
79061521776,79061521777,1,1568,1596,-10
79063993161,79063993163,2,1687,1407,-10
79066360894,79066360899,5,1341,1434,-10
79070540915,79070540918,3,1648,874,-10
79072349978,79072349981,3,1192,1412,-10
79076035295,79076035298,3,1165,1037,-10
79076374455,79076374456,1,1677,2419,-10
79077240428,79077240429,1,1004,1136,-10
79079653487,79079653488,1,2213,2032,-10
79080435386,79080435389,3,1329,863,-10
79084755852,79084755854,2,1214,815,-10
79088559657,79088559653,-4,986,3151,-10
79091729638,79091729634,-4,1439,3085,-10
79091881438,79091881441,3,2335,2500,-10
79092156574,79092156564,-10,539,352,-10
79092480846,79092480845,-1,1307,2252,-10
79093343119,79093343106,-13,1894,1879,-10
79094045377,79094045378,1,1995,2116,-10
79097563687,79097563690,3,1127,981,-10
79098183455,79098183455,0,1246,1663,-10
79101119354,79101119354,0,1423,1419,-10
79102219264,79102219266,2,1492,1668,-10
79102337026,79102337027,1,2310,1836,-10
79102796182,79102796186,4,1337,1574,-10
79105004353,79105004355,2,1373,1207,-10
79105609584,79105609586,2,1540,1788,-10
79113735971,79113735973,2,1379,1560,-10
79117484595,79117484597,2,2137,1427,-10
79126315634,79126315636,2,1575,1562,-10
79126973566,79126973544,-22,1890,1938,-10
79127797154,79127797157,3,1299,1425,-10
79130495545,79130495550,5,1590,1254,-10
79132307168,79132307170,2,1533,1347,-10
79134323969,79134323971,2,1204,1484,-10
79135667651,79135667650,-1,2843,2622,-10
79138630986,79138630987,1,1524,2017,-10
79140485509,79140485510,1,1508,1346,-10
79143386651,79143386653,2,2011,1742,-10
79143856614,79143856594,-20,1428,1845,-10
79146022943,79146022946,3,1416,1460,-10
79147554076,79147554078,2,2301,2469,-10
79153403604,79153403606,2,2035,1943,-10
79155422262,79155422261,-1,4987,9804,-10
79158618825,79158618827,2,983,893,-10
79158817577,79158817578,1,1100,1527,-10
79162128519,79162128519,0,2219,2523,-10
79162357198,79162357199,1,1853,1743,-10
79163176699,79163176701,2,1012,935,-10
79163258245,79163258247,2,1369,1492,-10
79167182810,79167182810,0,1269,1278,-10
79168312178,79168312178,0,1394,1836,-10
79168582165,79168582164,-1,1948,1489,-10
79168855967,79168855970,3,2451,1723,-10
79169073574,79169073578,4,1793,1605,-10
79170354602,79170354603,1,1160,1472,-10
79170920015,79170920010,-5,2347,7468,-10
79171011303,79171011282,-21,1284,1273,-10
79171205266,79171205269,3,966,1529,-10
79172373847,79172373848,1,1584,1448,-10
79176229546,79176229551,5,2266,1113,-10
79176402272,79176402275,3,1692,1216,-10
79176674909,79176674911,2,1658,1661,-10
79180628955,79180628957,2,1734,1534,-10
79181641201,79181641201,0,1478,2037,-10
79183430676,79183430698,22,12255,46325,-10
79184811743,79184811745,2,1315,1681,-10
79187051109,79187051109,0,967,850,-10
79193601602,79193601603,1,1785,1489,-10
79203708163,79203708162,-1,1429,1569,-10
79209276170,79209276173,3,1204,1417,-10
79211610442,79211610443,1,1159,1336,-10
79217228581,79217228582,1,1462,1113,-10
79217720715,79217720718,3,1463,1800,-10
79218354196,79218354198,2,1547,1846,-10
79221097687,79221097687,0,1089,1346,-10
79224379230,79224379211,-19,2148,1841,-10
79226616134,79226616134,0,2171,1959,-10
79227566102,79227566103,1,1805,1009,-10
79230915872,79230915870,-2,1639,2325,-10
79231009643,79231009647,4,2098,1921,-10
79231400278,79231400278,0,1998,1780,-10
79232962999,79232963002,3,2206,1797,-10
79233553108,79233553111,3,1266,1478,-10
79241317003,79241317003,0,1426,1504,-10
79245945661,79245945663,2,2040,1392,-10
79247531138,79247531138,0,1361,1590,-10
79256234619,79256234621,2,1456,1681,-10
79257294797,79257294800,3,2063,1764,-10
79258034642,79258034643,1,1112,1458,-10
79258152696,79258152693,-3,2748,4460,-10
79258279486,79258279493,7,33029,2140,-10
79259783361,79259783358,-3,22019,14996,-10
79260263006,79260263007,1,1338,1556,-10
79262514089,79262514090,1,1482,1343,-10
79264385728,79264385729,1,1356,1473,-10
79267652399,79267652402,3,1952,1817,-10
79269153189,79269153191,2,1492,1041,-10
79271056687,79271056689,2,1391,1329,-10
79271909315,79271909317,2,2079,1403,-10
79272609533,79272609534,1,1304,1513,-10
79273352185,79273352186,1,1136,1293,-10
79275186430,79275186432,2,1855,1961,-10
79275478474,79275478474,0,1354,1768,-10
79280592282,79280592285,3,1874,2028,-10
79284655381,79284655382,1,1202,1522,-10
79286017096,79286017096,0,1246,1964,-10
79286290623,79286290624,1,1359,1135,-10
79288118351,79288118351,0,1029,1493,-10
79291455225,79291455229,4,1625,2128,-10
79291960417,79291960418,1,1720,1745,-10
79294590137,79294590155,18,420,1490,-10
79295193049,79295193052,3,1504,1242,-10
79295240441,79295240450,9,1380,1298,-10
79297198409,79297198413,4,1590,1451,-10
79299168831,79299168834,3,1296,1574,-10
79300246999,79300246999,0,1272,1446,-10
79300742303,79300742305,2,1640,1117,-10
79301834518,79301834522,4,1419,1447,-10
79304514070,79304514071,1,1746,1453,-10
79304693168,79304693170,2,2202,2105,-10
79306759837,79306759839,2,1647,1555,-10
79307946276,79307946280,4,10643,28644,-10
79309058190,79309058190,0,1057,1129,-10
79309518698,79309518699,1,786,1091,-10
79313250612,79313250614,2,1202,1661,-10
79314648380,79314648381,1,1953,1270,-10
79315431205,79315431206,1,1406,1773,-10
79316761839,79316761845,6,2325,916,-10
79319208840,79319208862,22,1592,1298,-10
79320160151,79320160151,0,1562,1752,-10
79321527287,79321527289,2,2174,1634,-10
79322308967,79322308944,-23,1890,1766,-10
79322354269,79322354274,5,2692,1463,-10
79324930570,79324930572,2,1693,1883,-10
79326249773,79326249775,2,1826,1774,-10
79327072591,79327072592,1,1468,1515,-10
79329075277,79329075279,2,945,1098,-10
79330833669,79330833670,1,1847,1777,-10
79333790703,79333790705,2,1771,2058,-10
79339758511,79339758513,2,906,1214,-10
79340474613,79340474615,2,1328,1505,-10
79341704546,79341704545,-1,1182,1799,-10
79347297659,79347297661,2,1442,1414,-10
79349962607,79349962614,7,1001,1151,-10
79351246253,79351246254,1,1502,1693,-10
79353936119,79353936122,3,1576,1588,-10
79361691882,79361691883,1,1481,1234,-10
79362160230,79362160232,2,1656,1634,-10
79367062138,79367062138,0,842,889,-10
79367146889,79367146890,1,1101,1308,-10
79369236409,79369236409,0,1533,1467,-10
79370331609,79370331611,2,1281,914,-10
79371494133,79371494135,2,1526,1292,-10
79374344565,79374344565,0,1429,1731,-10
79375612784,79375612787,3,1127,982,-10
79376318177,79376318178,1,1422,1521,-10
79378750063,79378750067,4,1225,1178,-10
79381382947,79381382948,1,1587,1730,-10
79381873710,79381873713,3,1377,1824,-10
79383876292,79383876296,4,2074,1707,-10
79388103533,79388103535,2,1491,1384,-10
79388896193,79388896194,1,1790,1525,-10
79389340882,79389340886,4,1405,1292,-10
79389859977,79389859978,1,1282,1144,-10
79390277323,79390277323,0,1279,1962,-10
79390876347,79390876347,0,1450,1712,-10
79391436467,79391436471,4,1194,1173,-10
79392288783,79392288785,2,1699,1717,-10
79392543461,79392543461,0,2268,1751,-10
79395086157,79395086158,1,1415,1560,-10
79396068927,79396068930,3,1488,1504,-10
79397468262,79397468264,2,1600,1968,-10
79397959718,79397959723,5,1120,1870,-10
79399298201,79399298203,2,1363,1628,-10
79401486649,79401486649,0,1532,2101,-10
79403088682,79403088684,2,1392,1042,-10
79405230314,79405230318,4,2263,2324,-10
79409203937,79409203939,2,952,827,-10
79409386586,79409386590,4,1722,1845,-10
79409426579,79409426578,-1,1410,2246,-10
79409664031,79409664034,3,1499,1540,-10
79411289490,79411289490,0,2020,1433,-10
79414184281,79414184284,3,1144,1239,-10
79414227527,79414227508,-19,994,782,-10
79417681126,79417681129,3,1195,1490,-10
79419826531,79419826533,2,1432,1423,-10
79423149442,79423149445,3,1698,1235,-10
79423530052,79423530054,2,1747,1561,-10
79425206577,79425206581,4,1107,1831,-10
79426806684,79426806685,1,7095,8721,-10
79427650359,79427650361,2,2128,1731,-10
79429027662,79429027664,2,1513,1349,-10
79429708426,79429708426,0,1666,1523,-10
79431029377,79431029378,1,1718,1863,-10
79432794776,79432794776,0,2037,1943,-10
79434069329,79434069334,5,1564,955,-10
79437784602,79437784605,3,1765,1590,-10
79437813416,79437813419,3,1692,1585,-10
79437954005,79437954007,2,1420,1630,-10
79438393151,79438393153,2,1545,1751,-10
79439531797,79439531798,1,1056,1220,-10
79440203813,79440203815,2,1265,1152,-10
79443240910,79443240914,4,1899,1281,-10
79447095786,79447095786,0,629,894,-10
79450447531,79450447534,3,1438,1306,-10
79454107389,79454107390,1,1724,1650,-10
79455434534,79455434539,5,1474,1338,-10
79456977558,79456977557,-1,1430,2122,-10
79459613993,79459613993,0,1349,1482,-10
79465023954,79465023954,0,1451,2208,-10
79465415546,79465415548,2,1953,1694,-10
79470378107,79470378107,0,1091,1659,-10
79472320280,79472320274,-6,2043,7874,-10
79472365180,79472365183,3,2097,1957,-10
79473781682,79473781684,2,1248,932,-10
79475328755,79475328758,3,2078,1598,-10
79475581877,79475581879,2,1449,1282,-10
79476885968,79476885969,1,1528,1547,-10
79479154430,79479154430,0,1832,2050,-10
79480152606,79480152609,3,1623,1601,-10
79483372130,79483372126,-4,2057,6736,-10
79483665897,79483665899,2,1797,1383,-10
79488363077,79488363082,5,4009,1823,-10
79490044240,79490044246,6,2837,821,-10
79492672199,79492672201,2,1298,1092,-10
79494555163,79494555166,3,1222,1376,-10
79498875298,79498875297,-1,1487,1652,-10
79504752314,79504752318,4,860,1127,-10
79517493011,79517493013,2,1530,1606,-10
79520551902,79520551901,-1,1413,2735,-10
79521556203,79521556204,1,1202,1283,-10
79524661812,79524661814,2,1770,2074,-10
79526008246,79526008246,0,1732,1787,-10
79528796954,79528796947,-7,1331,3742,-10
79537125239,79537125235,-4,24234,11473,-10
79538091790,79538091795,5,4672,2386,-10
79542068223,79542068226,3,761,851,-10
79545624823,79545624825,2,2002,1844,-10
79547820873,79547820876,3,1501,1615,-10
79548576206,79548576207,1,1576,1826,-10
79551610347,79551610350,3,1600,2072,-10
79555229034,79555229037,3,1502,1649,-10
79558187722,79558187726,4,1838,1444,-10
79559080982,79559080984,2,1590,1428,-10
79561196386,79561196385,-1,1909,4242,-10
79574377705,79574377708,3,1115,931,-10
79575361793,79575361799,6,3443,947,-10
79580397794,79580397795,1,1293,1201,-10
79582363134,79582363135,1,1472,2077,-10
79582446419,79582446419,0,1017,1161,-10
79584453654,79584453658,4,2877,1813,-10
79585984353,79585984357,4,2167,1693,-10
79590217255,79590217247,-8,1633,1249,-10
79592695519,79592695523,4,1073,1139,-10
79595787857,79595787857,0,1696,1785,-10
79595956111,79595956111,0,1197,1647,-10
79595999629,79595999630,1,1390,1108,-10
79597009814,79597009833,19,1591,1532,-10
79598936761,79598936762,1,1366,1234,-10
79605997517,79605997519,2,2548,2889,-10
79609420130,79609420131,1,2154,2032,-10
79610235665,79610235665,0,1335,2299,-10
79610395482,79610395483,1,1208,1882,-10
79611105394,79611105398,4,1465,1214,-10
79611740827,79611740830,3,1347,1027,-10
79616297738,79616297742,4,1804,2258,-10
79617389298,79617389300,2,2138,1893,-10
79619163235,79619163237,2,1195,1850,-10
79619913784,79619913786,2,1855,1887,-10
79623865988,79623865990,2,1525,1288,-10
79624673715,79624673718,3,1277,1003,-10
79627592817,79627592818,1,939,1293,-10
79627781211,79627781192,-19,1167,913,-10
79629769769,79629769771,2,1636,1821,-10
79632013533,79632013533,0,1866,2264,-10
79632224362,79632224363,1,1304,1284,-10
79638991394,79638991392,-2,1507,1324,-10
79639874542,79639874544,2,1220,1357,-10
79640469045,79640469048,3,1638,1642,-10
79642741371,79642741373,2,1535,1819,-10
79643462826,79643462838,12,1133,1413,-10
79645702899,79645702901,2,1471,1257,-10
79646168534,79646168536,2,1713,1679,-10
79652424019,79652424020,1,1270,1274,-10
79653271175,79653271174,-1,2019,1423,-10
79656167624,79656167626,2,1481,1942,-10
79656243635,79656243618,-17,1117,1145,-10
79656965003,79656964997,-6,1763,6153,-10
79657275234,79657275242,8,6555,1701,-10
79660545998,79660546002,4,55672,35085,-10
79661769922,79661769922,0,1188,1471,-10
79662711310,79662711313,3,1266,976,-10
79665686378,79665686383,5,2228,1550,-10
79673764586,79673764590,4,1706,1634,-10
79681303777,79681303776,-1,1457,2119,-10
79682332220,79682332222,2,1727,1588,-10
79684059637,79684059638,1,897,1209,-10
79686697484,79686697485,1,1563,1753,-10
79688917803,79688917804,1,1814,1829,-10
79688996471,79688996452,-19,2365,865,-10
79698558094,79698558095,1,2229,1950,-10
79701458643,79701458645,2,1029,1040,-10
79705043693,79705043694,1,5121,4435,-10
79705735138,79705735140,2,22507,21259,-10
79705791354,79705791354,0,1264,1273,-10
79706945086,79706945086,0,2823,3020,-10
79707759813,79707759815,2,1967,1869,-10
79710910477,79710910477,0,1168,1079,-10
79714539199,79714539199,0,1878,2229,-10
79715761369,79715761371,2,1785,1394,-10
79716238243,79716238246,3,1675,1265,-10
79717910682,79717910685,3,1765,1464,-10
79718271485,79718271487,2,1132,1385,-10
79721211635,79721211634,-1,1327,1573,-10
79725989831,79725989825,-6,1554,3050,-10
79726866709,79726866711,2,1314,1742,-10
79728637097,79728637099,2,1628,1234,-10
79730324355,79730324354,-1,1033,1831,-10
79730639161,79730639182,21,1162,1630,-10
79731154059,79731154060,1,2213,2273,-10
79731727490,79731727492,2,1658,1783,-10
79732062572,79732062574,2,1481,1495,-10
79733821435,79733821443,8,3328,1493,-10
79736880251,79736880250,-1,1706,1946,-10
79737559646,79737559650,4,1849,1207,-10
79739451414,79739451415,1,1692,1474,-10
79740555953,79740555951,-2,1314,1412,-10
79742448842,79742448844,2,2204,1763,-10
79744183365,79744183366,1,1499,1458,-10
79750339939,79750339941,2,1496,1532,-10
79751024550,79751024557,7,2707,1012,-10
79753282957,79753282959,2,1461,1004,-10
79754000940,79754000941,1,1393,1426,-10
79755124298,79755124300,2,2202,2218,-10
79755318162,79755318165,3,1121,1519,-10
79756215328,79756215329,1,1462,1373,-10
79756485773,79756485773,0,1401,1811,-10
79758779382,79758779384,2,1358,1413,-10
79759955658,79759955659,1,1485,1803,-10
79760726135,79760726135,0,1061,891,-10
79762990787,79762990790,3,1602,2097,-10
79764975169,79764975170,1,1310,1509,-10
79765738237,79765738240,3,1864,1575,-10
79767028739,79767028741,2,1421,1972,-10
79767265165,79767265166,1,1437,970,-10
79767781774,79767781776,2,1805,1602,-10
79770196127,79770196129,2,1152,1236,-10
79771045800,79771045803,3,1424,1702,-10
79774185773,79774185775,2,1690,1250,-10
79775316411,79775316413,2,1220,2010,-10
79775602383,79775602385,2,1559,1546,-10
79776574500,79776574501,1,1846,1777,-10
79779804010,79779804011,1,1217,1204,-10
79780961661,79780961662,1,1277,1512,-10
79784376531,79784376534,3,2073,1194,-10
79784987940,79784987940,0,1231,1742,-10
79786119379,79786119382,3,2151,1725,-10
79787892635,79787892638,3,1274,1536,-10
79788924628,79788924633,5,7869,22159,-10
79789430505,79789430506,1,1702,1326,-10
79791766452,79791766453,1,1406,1508,-10
79791903753,79791903753,0,1642,1261,-10
79792720711,79792720713,2,1720,955,-10
79794542630,79794542630,0,1632,2214,-10
79794847293,79794847294,1,1241,1473,-10
79795600945,79795600947,2,1890,1391,-10
79797669701,79797669705,4,1147,1266,-10
79800576644,79800576646,2,2223,1989,-10
79800659763,79800659764,1,1314,1184,-10
79807603345,79807603346,1,1703,1619,-10
79808168055,79808168058,3,1393,1615,-10
79808376987,79808376988,1,986,1794,-10
79810059350,79810059352,2,1478,936,-10
79810963124,79810963126,2,1479,1350,-10
79812511638,79812511639,1,1327,1079,-10
79812655382,79812655374,-8,919,4897,-10
79812898953,79812898954,1,1728,1179,-10
79814843864,79814843866,2,1993,1328,-10
79817287997,79817287998,1,1377,1931,-10
79817794333,79817794333,0,951,1613,-10
79820082179,79820082179,0,921,1174,-10
79820824327,79820824331,4,1180,1408,-10
79826656825,79826656826,1,1919,1245,-10
79827719871,79827719873,2,1941,1758,-10
79831040046,79831040047,1,1842,1586,-10
79832455777,79832455779,2,1346,1692,-10
79834075158,79834075158,0,1668,1552,-10
79834116686,79834116684,-2,825,1222,-10
79834325386,79834325387,1,1262,1701,-10
79835583631,79835583634,3,2071,1658,-10
79837039995,79837039997,2,1554,998,-10
79839144302,79839144302,0,996,1177,-10
79840225868,79840225870,2,1275,1069,-10
79841394392,79841394393,1,1986,1755,-10
79845529955,79845529959,4,1433,1567,-10
79854132386,79854132388,2,1522,1455,-10
79854947834,79854947837,3,1188,1524,-10
79858634039,79858634041,2,1614,1514,-10
79861899020,79861899022,2,1160,867,-10
79862108841,79862108851,10,2607,1262,-10
79862389051,79862389052,1,870,957,-10
79867664471,79867664472,1,1507,1488,-10
79868593215,79868593214,-1,1060,1349,-10
79871745919,79871745923,4,2226,1937,-10
79872399245,79872399245,0,2843,4111,-10
79873352209,79873352212,3,2082,2341,-10
79875220877,79875220878,1,1389,1741,-10
79876665613,79876665614,1,1458,1388,-10
79877013542,79877013543,1,2265,1773,-10
79879022041,79879022045,4,2261,1844,-10
79879340242,79879340244,2,656,798,-10
79881090909,79881090908,-1,1177,1416,-10
79883441171,79883441163,-8,1517,1599,-10
79885712558,79885712560,2,1823,1807,-10
79887471923,79887471900,-23,1151,1550,-10
79890065377,79890065378,1,1718,1349,-10
79891455832,79891455831,-1,1499,2240,-10
79893949775,79893949782,7,10062,2239,-10
79895541298,79895541297,-1,1642,1950,-10
79897911920,79897911918,-2,676,1912,-10
79899485182,79899485185,3,1424,1312,-10
79899983786,79899983781,-5,662,3744,-10
79901178401,79901178405,4,1854,1477,-10
79903205007,79903205009,2,1138,768,-10
79904697867,79904697870,3,1335,1451,-10
79908360437,79908360438,1,1882,1467,-10
79908852322,79908852324,2,1834,1720,-10
79910083998,79910084001,3,1526,1122,-10
79911168113,79911168116,3,1903,1227,-10
79911199196,79911199199,3,1426,1075,-10
79912745694,79912745697,3,1136,1148,-10
79914659894,79914659895,1,1405,1472,-10
79917595070,79917595072,2,1545,1619,-10
79922316425,79922316428,3,1128,1969,-10
79927237246,79927237248,2,1922,2179,-10
79928318279,79928318281,2,1114,1162,-10
79928722544,79928722547,3,1692,1600,-10
79931864546,79931864545,-1,840,2088,-10
79932546542,79932546545,3,1510,1370,-10
79933467061,79933467061,0,1884,1762,-10
79942891421,79942891421,0,1632,1516,-10
79943351502,79943351501,-1,1350,2067,-10
79944037470,79944037473,3,916,1369,-10
79949391119,79949391115,-4,1287,3136,-10
79951486287,79951486290,3,1443,1439,-10
79952501656,79952501657,1,1087,1232,-10
79953127255,79953127256,1,1106,1143,-10
79953610693,79953610694,1,1182,1599,-10
79957146298,79957146301,3,1762,1823,-10
79957907874,79957907877,3,2128,1805,-10
79958211824,79958211824,0,1126,1355,-10
79958534566,79958534569,3,880,913,-10
79959221119,79959221119,0,821,1194,-10
79962175808,79962175809,1,2605,2064,-10
79963328894,79963328897,3,1764,1706,-10
79968538686,79968538680,-6,1292,5781,-10
79978801378,79978801379,1,1932,1710,-10
79981618789,79981618783,-6,2671,6617,-10
79983364209,79983364210,1,1408,1939,-10
79984337327,79984337330,3,909,933,-10
79986579645,79986579648,3,2254,1459,-10
79998003430,79998003430,0,2257,1841,-10
79999119050,79999119050,0,1619,2145,-10
79999678372,79999678374,2,42998,19319,-10
80000111189,80000111183,-6,1928,5587,-10
80002815290,80002815272,-18,1546,961,-10
80003158950,80003158950,0,1813,1788,-10
80007956035,80007956035,0,1558,1261,-10
80020408918,80020408922,4,1620,1301,-10
80021623845,80021623848,3,1054,1765,-10
80022499447,80022499443,-4,1637,4266,-10
80023168559,80023168560,1,1857,1391,-10
80025334746,80025334746,0,2043,2282,-10
80030453650,80030453653,3,1804,1962,-10
80031769338,80031769343,5,2279,2195,-10
80033344362,80033344363,1,1653,1547,-10
80036004558,80036004561,3,1603,980,-10
80038127433,80038127426,-7,1301,6787,-10
80042198879,80042198881,2,1610,1823,-10
80043299737,80043299718,-19,1473,1061,-10
80043454542,80043454545,3,1406,1619,-10
80043852909,80043852911,2,1479,1920,-10
80046244098,80046244102,4,1768,1304,-10
80046680361,80046680362,1,2396,1624,-10
80048308307,80048308309,2,2172,2046,-10
80049410286,80049410290,4,1605,1481,-10
80056923880,80056923883,3,1319,1210,-10
80063903083,80063903081,-2,1818,1857,-10
80066335963,80066335967,4,1802,2074,-10
80066405197,80066405199,2,1399,1212,-10
80067302747,80067302751,4,1793,1044,-10
80068949746,80068949745,-1,1375,2027,-10
80071227046,80071227048,2,1660,2020,-10
80071451214,80071451215,1,1645,1379,-10
80073312461,80073312462,1,1935,1389,-10
80081812388,80081812389,1,1097,1302,-10
80084898383,80084898377,-6,1273,5549,-10
80085589511,80085589511,0,1303,1282,-10
80095192871,80095192873,2,1117,1274,-10
80097230051,80097230052,1,2132,1797,-10
80098165274,80098165275,1,1459,1480,-10
80099682410,80099682413,3,1868,1917,-10
80100321271,80100321272,1,1940,2415,-10
80100522217,80100522211,-6,1916,6467,-10
80101423022,80101423025,3,1447,1070,-10
80101921398,80101921400,2,2104,2475,-10
80102359590,80102359590,0,1253,1509,-10
80103634154,80103634157,3,838,1307,-10
80107343298,80107343298,0,1365,1162,-10
80108995101,80108995103,2,1638,1329,-10
80109653673,80109653674,1,1180,1853,-10
80111325692,80111325694,2,1727,1313,-10
80111492761,80111492764,3,1699,1711,-10
80116385781,80116385782,1,1744,1532,-10
80117502798,80117502802,4,1328,1464,-10
80117945093,80117945095,2,1728,1289,-10
80118177399,80118177403,4,1613,1263,-10
80123634783,80123634786,3,1175,1190,-10
80127223012,80127223013,1,1488,1285,-10
80130377643,80130377647,4,2336,1491,-10
80133788423,80133788422,-1,1709,1510,-10
80136853851,80136853858,7,6703,2515,-10
80138331192,80138331186,-6,1230,4303,-10
80138720629,80138720631,2,1098,806,-10
80139254870,80139254874,4,919,1434,-10
80139848282,80139848282,0,1338,845,-10
80141111445,80141111446,1,2094,1975,-10
80142136641,80142136644,3,1466,1298,-10
80146409043,80146409043,0,1591,1273,-10
80147476114,80147476117,3,3470,3163,-10
80149069215,80149069211,-4,1063,2131,-10
80149609333,80149609337,4,1830,1361,-10
80150101580,80150101602,22,1198,1507,-10
80151167047,80151167049,2,1274,1346,-10
80161550098,80161550098,0,1590,1475,-10
80162203961,80162203963,2,1267,1237,-10
80165007026,80165007027,1,1330,1384,-10
80168191930,80168191933,3,1559,1169,-10
80169356701,80169356703,2,1609,1341,-10
80170288641,80170288646,5,3150,2230,-10
80170565006,80170565005,-1,1327,1916,-10
80174283662,80174283663,1,1756,1559,-10
80175627165,80175627163,-2,1651,2541,-10
80177328438,80177328441,3,1488,1740,-10
80181061911,80181061914,3,1611,1673,-10
80181879200,80181879202,2,1461,1346,-10
80185117568,80185117571,3,2181,1362,-10
80188645453,80188645457,4,2030,1419,-10
80192654010,80192654014,4,1491,1568,-10
80194676386,80194676388,2,2127,1444,-10
80200700530,80200700530,0,1259,1454,-10
80202508797,80202508798,1,1170,1401,-10
80206094032,80206094031,-1,1617,1760,-10
80207666398,80207666399,1,1006,1276,-10
80210145345,80210145348,3,2876,2368,-10
80211801594,80211801597,3,1923,1310,-10
80215986582,80215986585,3,2620,1660,-10
80219696752,80219696753,1,1447,1236,-10
80223671975,80223671976,1,1227,1346,-10
80226441369,80226441371,2,1622,1785,-10
80232045482,80232045488,6,1676,1043,-10
80232400650,80232400667,17,2991,1285,-10
80234039615,80234039618,3,2120,1730,-10
80234108344,80234108346,2,1809,1323,-10
80240055566,80240055569,3,1825,2150,-10
80240366345,80240366349,4,2018,2126,-10
80241491085,80241491087,2,1700,1447,-10
80242675701,80242675701,0,1775,2090,-10
80244115887,80244115889,2,1993,2051,-10
80246093153,80246093155,2,2058,2103,-10
80246400347,80246400350,3,1324,1509,-10
80249639762,80249639766,4,1866,1432,-10
80249947102,80249947093,-9,931,1758,-10
80252548283,80252548288,5,2053,1399,-10
80252905438,80252905441,3,1419,1287,-10
80253613202,80253613205,3,2039,1627,-10
80255835142,80255835142,0,1077,1723,-10
80257353077,80257353079,2,1360,1580,-10
80257628295,80257628300,5,1386,1661,-10
80257781760,80257781762,2,1535,1276,-10
80260363477,80260363482,5,1971,1007,-10
80261043554,80261043554,0,1057,1404,-10
80261924812,80261924814,2,1362,965,-10
80263633168,80263633171,3,1709,1211,-10
80263745060,80263745083,23,916,809,-10
80266472734,80266472736,2,1337,1708,-10
80270799179,80270799179,0,1808,1479,-10
80271328645,80271328647,2,1318,1204,-10
80272582515,80272582515,0,1318,1215,-10
80274186354,80274186355,1,1436,1613,-10
80275898126,80275898131,5,951,1276,-10
80278488198,80278488178,-20,810,1277,-10
80284022483,80284022484,1,1646,1512,-10
80285472310,80285472311,1,1717,1502,-10
80286414680,80286414681,1,1647,1948,-10
80287839085,80287839088,3,1399,1642,-10
80293164441,80293164442,1,1030,1491,-10
80293612180,80293612179,-1,1355,2183,-10
80295977088,80295977104,16,190,413,-10
80296145544,80296145546,2,869,1124,-10
80297355522,80297355526,4,1602,1390,-10
80297952401,80297952402,1,1697,1161,-10
80302078617,80302078618,1,1607,2154,-10
80302937553,80302937556,3,1565,1400,-10
80308350072,80308350074,2,1814,1450,-10
80308628579,80308628582,3,1388,1662,-10
80310844594,80310844594,0,1689,2293,-10
80310920917,80310920918,1,1566,1409,-10
80311715620,80311715622,2,1813,1639,-10
80321328157,80321328159,2,1343,1228,-10
80321948024,80321948046,22,161,9361,-10
80322277667,80322277669,2,955,1629,-10
80325546579,80325546581,2,1043,2092,-10
80325608954,80325608956,2,1620,1660,-10
80325707426,80325707427,1,1440,1221,-10
80327923974,80327923975,1,1591,1932,-10
80329067172,80329067171,-1,54988,28410,-10
80329456133,80329456134,1,1460,1677,-10
80329980441,80329980442,1,1917,1428,-10
80330310161,80330310162,1,1648,1387,-10
80332789506,80332789507,1,1306,1247,-10
80333125786,80333125791,5,1771,1246,-10
80334959405,80334959408,3,1756,1818,-10
80336393193,80336393193,0,1965,1797,-10
80337895530,80337895533,3,1574,1225,-10
80338192350,80338192349,-1,1165,1687,-10
80339994570,80339994573,3,2310,1438,-10
80342289476,80342289478,2,1727,1437,-10
80344937405,80344937405,0,1585,1488,-10
80345745685,80345745686,1,1550,1945,-10
80347764431,80347764438,7,2456,969,-10
80352235989,80352235993,4,1437,1365,-10
80353501019,80353501034,15,13545,46511,-10
80354000903,80354000907,4,1163,1054,-10
80355724930,80355724932,2,1554,1895,-10
80358978800,80358978801,1,1687,1924,-10
80362493677,80362493679,2,1543,1117,-10
80363929660,80363929656,-4,2196,7477,-10
80364110351,80364110355,4,1360,1995,-10
80374684967,80374684970,3,1388,1458,-10
80376098876,80376098877,1,2080,1790,-10
80376256354,80376256352,-2,2032,4529,-10
80377234262,80377234258,-4,921,3238,-10
80378730189,80378730191,2,1353,1258,-10
80378945450,80378945451,1,2006,1059,-10
80379784706,80379784709,3,1281,1271,-10
80388248274,80388248280,6,1932,1218,-10
80391483071,80391483071,0,1635,1668,-10
80392613074,80392613076,2,1538,1414,-10
80393509635,80393509637,2,1514,1276,-10
80394369646,80394369651,5,2492,2545,-10
80395711066,80395711067,1,1755,1300,-10
80401103598,80401103602,4,2772,1831,-10
80401305881,80401305876,-5,1062,2294,-10
80401671886,80401671887,1,838,1011,-10
80404420297,80404420299,2,1824,1403,-10
80404517164,80404517171,7,2935,825,-10
80405307950,80405307951,1,1247,1423,-10
80405862258,80405862258,0,1715,1503,-10
80410192593,80410192597,4,2051,1890,-10
80412569678,80412569678,0,1116,1233,-10
80412644738,80412644743,5,1628,1708,-10
80413100185,80413100186,1,1443,1510,-10
80414036991,80414036994,3,2024,1500,-10
80417956697,80417956693,-4,1907,4968,-10
80422562553,80422562554,1,1216,1128,-10
80424027086,80424027087,1,1724,1293,-10
80424315553,80424315552,-1,1045,1649,-10
80427488634,80427488633,-1,2283,1794,-10
80427664298,80427664298,0,1497,2514,-10
80427858247,80427858250,3,1788,1449,-10
80432369733,80432369731,-2,1466,1306,-10
80433328863,80433328865,2,2209,2182,-10
80435026779,80435026781,2,1310,1900,-10
80435651381,80435651382,1,2275,1787,-10
80438355798,80438355801,3,1601,1493,-10
80439882862,80439882863,1,2115,1584,-10
80443252771,80443252775,4,1167,1431,-10
80443418477,80443418478,1,1249,1833,-10
80444776670,80444776670,0,1978,1498,-10
80454762655,80454762661,6,3032,1808,-10
80455163817,80455163819,2,1909,1409,-10
80457677670,80457677674,4,1481,1378,-10
80458272892,80458272893,1,1252,1169,-10
80458553441,80458553442,1,1569,1390,-10
80459047295,80459047298,3,1537,1061,-10
80464224901,80464224907,6,2112,1198,-10
80464449127,80464449130,3,1658,1721,-10
80465265235,80465265230,-5,787,3876,-10
80466328953,80466328954,1,1816,2284,-10
80467206015,80467206014,-1,1411,1236,-10
80467972202,80467972202,0,1554,1141,-10
80470877675,80470877677,2,1625,1601,-10
80471757661,80471757663,2,1760,1664,-10
80471863397,80471863399,2,1773,1035,-10
80471897037,80471897037,0,1163,1371,-10
80472127470,80472127470,0,1655,1740,-10
80473346985,80473346987,2,1227,1687,-10
80476644126,80476644128,2,1591,1407,-10
80477313015,80477313020,5,1132,1125,-10
80477485370,80477485373,3,2290,1546,-10
80481247558,80481247558,0,1851,1604,-10
80487988415,80487988417,2,1984,1669,-10
80490678568,80490678567,-1,1510,1752,-10
80491252154,80491252157,3,1637,1648,-10
80493982138,80493982142,4,1363,1221,-10
80496091317,80496091318,1,2022,1838,-10
80501330346,80501330349,3,1233,1559,-10
80503332888,80503332893,5,2983,2162,-10
80503370831,80503370831,0,1562,1193,-10
80503648350,80503648354,4,1490,1245,-10
80510877258,80510877258,0,897,1371,-10
80514587567,80514587570,3,1276,1148,-10
80517570159,80517570162,3,1474,1475,-10
80521321193,80521321195,2,1648,1536,-10
80524352498,80524352499,1,1133,1282,-10
80524771862,80524771859,-3,1490,2338,-10
80525296206,80525296205,-1,1272,1106,-10
80530548228,80530548230,2,1459,2137,-10
80533976137,80533976139,2,1631,1400,-10
80534939213,80534939217,4,1986,1376,-10
80536696934,80536696934,0,1237,1812,-10
80538818102,80538818103,1,1716,1964,-10
80540128313,80540128314,1,1814,1276,-10
80540863201,80540863202,1,1651,2149,-10
80541416238,80541416239,1,1876,1878,-10
80546922433,80546922436,3,1841,1355,-10
80548574233,80548574236,3,2051,1650,-10
80551562167,80551562170,3,1938,1807,-10
80552979679,80552979667,-12,1140,2095,-10
80554391162,80554391164,2,1484,1181,-10
80556633672,80556633674,2,1328,1154,-10
80557890414,80557890414,0,1720,1563,-10
80561486150,80561486151,1,1886,2084,-10
80562297583,80562297586,3,1589,1455,-10
80562528314,80562528318,4,2413,1374,-10
80565606595,80565606599,4,1747,1598,-10
80570010768,80570010773,5,1890,1551,-10
80570696016,80570696018,2,1525,1317,-10
80572877334,80572877316,-18,556,423,-10
80575528645,80575528646,1,2181,1489,-10
80579331115,80579331117,2,1491,1695,-10
80583740237,80583740239,2,1117,1235,-10
80584297628,80584297631,3,1594,1318,-10
80591030737,80591030739,2,944,914,-10
80591612065,80591612065,0,1427,1365,-10
80592642302,80592642302,0,1434,1735,-10
80592879882,80592879882,0,1350,1240,-10
80593122254,80593122257,3,1695,1924,-10
80594921018,80594921021,3,1683,1239,-10
80595579642,80595579636,-6,678,3452,-10
80595856521,80595856531,10,1410,1151,-10
80597146454,80597146454,0,1676,1868,-10
80598996973,80598996975,2,1947,1526,-10
80600662256,80600662257,1,1291,1516,-10
80602657570,80602657570,0,1960,1830,-10
80610123645,80610123647,2,1067,940,-10
80610358086,80610358098,12,2304,1582,-10
80611389525,80611389523,-2,1343,1906,-10
80616266769,80616266770,1,1692,1389,-10
80618481386,80618481387,1,761,804,-10
80619921725,80619921725,0,1630,1662,-10
80620871170,80620871172,2,1497,2126,-10
80624772138,80624772138,0,1165,1125,-10
80625236644,80625236645,1,1483,1281,-10
80625730829,80625730829,0,26303,34615,-10
80626888574,80626888554,-20,951,1417,-10
80628384669,80628384670,1,961,1010,-10
80628531522,80628531501,-21,1516,1429,-10
80632099355,80632099355,0,1554,1428,-10
80632520987,80632520990,3,1377,1472,-10
80639187878,80639187881,3,1767,1464,-10
80641377182,80641377183,1,1575,1736,-10
80641582910,80641582912,2,1611,1165,-10
80641667502,80641667513,11,1421,1296,-10
80642223128,80642223130,2,1487,1238,-10
80644818421,80644818425,4,1396,1238,-10
80646618325,80646618327,2,1623,1060,-10
80647559499,80647559499,0,1660,1743,-10
80650335814,80650335815,1,1596,1872,-10
80654577542,80654577545,3,1968,1568,-10
80656798910,80656798909,-1,1126,1470,-10
80660632478,80660632492,14,1713,1859,-10
80662126619,80662126621,2,1259,1570,-10
80662313904,80662313906,2,1305,1299,-10
80673390438,80673390441,3,1534,1513,-10
80673979606,80673979606,0,1068,804,-10
80675931341,80675931342,1,1937,1450,-10
80676445646,80676445648,2,1568,1305,-10
80678977285,80678977286,1,1672,1543,-10
80681498928,80681498931,3,1940,1013,-10
80681818249,80681818242,-7,3424,12443,-10
80684280092,80684280093,1,1504,1433,-10
80685423146,80685423146,0,982,941,-10
80685939583,80685939582,-1,1307,1466,-10
80686792551,80686792544,-7,1891,7783,-10
80687445287,80687445290,3,1190,1317,-10
80689826094,80689826097,3,793,1315,-10
80690724982,80690724983,1,1220,1262,-10
80693980925,80693980927,2,1108,1692,-10
80694278426,80694278429,3,1371,1652,-10
80697327422,80697327421,-1,1423,1540,-10
80699289285,80699289284,-1,1281,1838,-10
80705947678,80705947683,5,1201,1122,-10
80708046238,80708046240,2,1568,1524,-10
80712841918,80712841923,5,2114,1196,-10
80714094140,80714094141,1,1836,2137,-10
80714782404,80714782404,0,1885,1977,-10
80716239038,80716239041,3,2100,2018,-10
80719169768,80719169770,2,2114,1742,-10
80720721990,80720721992,2,3946,3182,-10
80724470289,80724470289,0,1348,1707,-10
80724574001,80724574002,1,1603,1644,-10
80726623403,80726623406,3,1756,1557,-10
80727706164,80727706165,1,1961,2171,-10
80731393266,80731393269,3,1554,1225,-10
80737764635,80737764638,3,1670,1321,-10
80740063041,80740063043,2,2043,1459,-10
80740178617,80740178617,0,1216,1317,-10
80743717452,80743717454,2,2188,1820,-10
80752538609,80752538610,1,1971,1653,-10
80758525906,80758525910,4,1607,1357,-10
80759726987,80759726986,-1,1590,1440,-10
80759974650,80759974652,2,1020,1303,-10
80761347094,80761347094,0,2597,2401,-10
80763692699,80763692700,1,1061,1248,-10
80769785117,80769785118,1,1361,1384,-10
80770596750,80770596749,-1,28388,18277,-10
80773573058,80773573058,0,1521,1692,-10
80775717814,80775717815,1,1202,1554,-10
80776893374,80776893380,6,1839,1362,-10
80777526730,80777526732,2,2359,2196,-10
80778390587,80778390590,3,1656,2188,-10
80781461173,80781461178,5,1308,1489,-10
80781732395,80781732394,-1,1474,1870,-10
80781880245,80781880246,1,1692,1994,-10
80782862403,80782862406,3,1712,1541,-10
80785093516,80785093518,2,1624,1499,-10
80786382049,80786382054,5,2178,1807,-10
80787704231,80787704231,0,1509,1643,-10
80789886215,80789886217,2,1782,1637,-10
80794639612,80794639612,0,1650,1975,-10
80795780577,80795780579,2,1051,1159,-10
80796990283,80796990284,1,1561,1545,-10
80798000633,80798000634,1,40,1202,-10
80799814361,80799814362,1,1743,1763,-10
80800652279,80800652281,2,1654,1162,-10
80802120144,80802120146,2,1754,1533,-10
80803386461,80803386463,2,1179,1239,-10
80809519739,80809519730,-9,1711,1666,-10
80809956848,80809956853,5,1440,1016,-10
80811096557,80811096558,1,1673,2317,-10
80811733870,80811733873,3,1091,1522,-10
80812426711,80812426714,3,1143,1151,-10
80813291810,80813291810,0,2503,1540,-10
80814849459,80814849462,3,1372,1384,-10
80816726087,80816726089,2,1808,1537,-10
80819459214,80819459218,4,1788,1509,-10
80819635366,80819635365,-1,1505,1520,-10
80822516117,80822516103,-14,1587,1431,-10
80823061358,80823061361,3,1666,1418,-10
80823367958,80823367962,4,1428,1048,-10
80825542070,80825542073,3,1409,1382,-10
80829558997,80829558999,2,1759,1396,-10
80829879629,80829879629,0,1541,1720,-10
80830317549,80830317551,2,1967,1099,-10
80831502851,80831502853,2,1085,1077,-10
80835277458,80835277461,3,1216,2071,-10
80835722685,80835722685,0,5489,7070,-10
80835947426,80835947425,-1,1835,1421,-10
80840891077,80840891078,1,1338,1218,-10
80841351999,80841352002,3,1518,1686,-10
80842494067,80842494070,3,1192,945,-10
80845233702,80845233706,4,1529,1877,-10
80846149113,80846149115,2,1758,1623,-10
80846933170,80846933173,3,1531,1463,-10
80847653188,80847653190,2,1451,1753,-10
80849604092,80849604094,2,1216,1749,-10
80850587209,80850587211,2,1364,1306,-10
80855516011,80855516010,-1,1098,962,-10
80858295113,80858295116,3,1535,1290,-10
80859501237,80859501246,9,9511,36596,-10
80860207619,80860207625,6,11000,5873,-10
80860250307,80860250308,1,2145,1761,-10
80861702599,80861702601,2,1440,2088,-10
80861850782,80861850786,4,1421,1284,-10
80863311998,80863312002,4,2852,1765,-10
80863487066,80863487066,0,1614,1724,-10
80863562027,80863562031,4,1796,1932,-10
80864955286,80864955286,0,1399,1671,-10
80866225573,80866225575,2,1540,1295,-10
80871290277,80871290281,4,1699,1646,-10
80872662091,80872662095,4,570,321,-10
80874218963,80874218967,4,1484,1469,-10
80875041374,80875041378,4,1171,1254,-10
80876488273,80876488275,2,1082,1039,-10
80878862572,80878862574,2,1163,902,-10
80879336391,80879336404,13,1405,1297,-10
80881473390,80881473394,4,1638,1243,-10
80883788610,80883788613,3,1179,1349,-10
80886126673,80886126666,-7,761,935,-10
80886431298,80886431300,2,818,1183,-10
80887129299,80887129299,0,1128,1183,-10
80891562618,80891562622,4,1769,1121,-10
80896516176,80896516178,2,1894,2051,-10
80897761450,80897761452,2,1533,1910,-10
80897913356,80897913359,3,1278,1234,-10
80898689503,80898689502,-1,1452,1566,-10
80900510345,80900510345,0,1069,1499,-10
80901686660,80901686644,-16,1455,3798,-10
80902907591,80902907582,-9,73,1945,-10
80903428026,80903428030,4,1837,1449,-10
80904986525,80904986525,0,1799,2460,-10
80905966031,80905966037,6,2642,1107,-10
80907286303,80907286306,3,1259,1503,-10
80908259339,80908259342,3,1707,1428,-10
80908791926,80908791928,2,1123,950,-10
80912159222,80912159228,6,1649,1430,-10
80912545969,80912545970,1,2414,1895,-10
80916395710,80916395690,-20,1269,1015,-10
80920058946,80920058943,-3,1706,2302,-10
80920780283,80920780284,1,1761,1635,-10
80923046623,80923046626,3,1306,1471,-10
80924015703,80924015706,3,1863,1531,-10
80924287009,80924287010,1,855,1018,-10
80926586004,80926586008,4,1979,1418,-10
80926908346,80926908346,0,1276,1699,-10
80930148616,80930148617,1,872,1143,-10
80930428765,80930428764,-1,1351,1925,-10
80936737958,80936737961,3,1200,1359,-10
80942235378,80942235380,2,1743,1341,-10
80947192300,80947192303,3,1896,1685,-10
80948208712,80948208714,2,1821,2124,-10
80949807713,80949807715,2,1394,953,-10
80957358759,80957358761,2,1494,2086,-10
80962196929,80962196924,-5,1247,4225,-10
80962553462,80962553462,0,1858,1751,-10
80963970870,80963970872,2,1236,1615,-10
80964231467,80964231469,2,698,792,-10
80969460275,80969460281,6,3674,1331,-10
80970795041,80970795043,2,1476,1749,-10
80971740401,80971740405,4,1252,1460,-10
80975777402,80975777403,1,1245,1273,-10
80976259334,80976259338,4,2579,1394,-10
80978804166,80978804170,4,1726,1718,-10
80978909634,80978909638,4,1087,1291,-10
80979490743,80979490743,0,828,1195,-10
80980589479,80980589480,1,1754,1466,-10
80980713912,80980713921,9,1132,1376,-10
80982084703,80982084704,1,2312,2176,-10
80984361526,80984361533,7,2400,1437,-10
80984481459,80984481461,2,937,845,-10
80985348222,80985348223,1,1247,1322,-10
80988926447,80988926449,2,1899,2100,-10
80990945971,80990945972,1,1774,1523,-10
80993889766,80993889769,3,1871,1728,-10
80999011482,80999011482,0,1995,1931,-10
81004211218,81004211218,0,1535,1895,-10
81010551726,81010551727,1,1978,1591,-10
81011743765,81011743766,1,1363,1498,-10
81014900874,81014900874,0,2188,1586,-10
81020037114,81020037116,2,1438,1327,-10
81020855812,81020855814,2,2057,1800,-10
81023469140,81023469142,2,1506,1516,-10
81025823369,81025823370,1,1609,1588,-10
81028308601,81028308604,3,1261,1518,-10
81029261787,81029261787,0,1465,1915,-10
81032849692,81032849693,1,1729,1730,-10
81032945142,81032945147,5,2042,1178,-10
81033457159,81033457161,2,1541,1346,-10
81034884614,81034884618,4,1666,1329,-10
81038111906,81038111907,1,1653,1585,-10
81039675947,81039675949,2,1319,962,-10
81040098102,81040098106,4,1853,1556,-10
81046011926,81046011929,3,1912,1777,-10
81048270113,81048270093,-20,1452,1891,-10
81050219793,81050219793,0,1502,1350,-10
81050386409,81050386411,2,2057,1856,-10
81051117987,81051117990,3,1123,1523,-10
81057514018,81057514026,8,3287,954,-10
81058212102,81058212106,4,1201,904,-10
81060139200,81060139202,2,1390,1122,-10
81060322686,81060322690,4,1756,1592,-10
81065800717,81065800718,1,1441,1683,-10
81066133347,81066133349,2,629,844,-10
81067248687,81067248687,0,1542,1509,-10
81073532008,81073532009,1,1773,1473,-10
81075555861,81075555863,2,1312,864,-10
81077128579,81077128582,3,1786,1459,-10
81077525339,81077525341,2,1167,1139,-10
81080318362,81080318362,0,1265,1793,-10
81083725459,81083725461,2,1660,1123,-10
81090725345,81090725346,1,1784,1491,-10
81090785321,81090785316,-5,1043,1448,-10
81096472152,81096472154,2,1695,1413,-10
81099476979,81099476979,0,1608,1380,-10
81102512208,81102512210,2,1597,1154,-10
81104552128,81104552137,9,17512,23163,-10
81105576143,81105576146,3,2077,1522,-10
81106230527,81106230530,3,1204,1452,-10
81107913615,81107913618,3,1433,1093,-10
81109847807,81109847806,-1,1083,1039,-10
81113917217,81113917210,-7,741,7358,-10
81116260398,81116260401,3,1807,1845,-10
81116724887,81116724886,-1,1044,2321,-10
81122277488,81122277483,-5,745,1019,-10
81129841933,81129841934,1,1915,1753,-10
81131671954,81131671955,1,1933,1469,-10
81132151991,81132151995,4,1846,1214,-10
81133325719,81133325717,-2,3407,43895,-10
81139094023,81139094022,-1,1352,1351,-10
81139665986,81139665988,2,1364,2146,-10
81143313750,81143313750,0,1500,1660,-10
81144090036,81144090035,-1,1239,1395,-10
81145033319,81145033322,3,24425,17019,-10
81148127907,81148127910,3,1284,1312,-10
81150436195,81150436199,4,1413,1424,-10
81150955088,81150955090,2,1126,1261,-10
81151293461,81151293460,-1,1030,1066,-10
81162553765,81162553766,1,1964,1743,-10
81163163603,81163163604,1,1628,2112,-10
81163589566,81163589568,2,1925,3523,-10
81165849188,81165849191,3,1587,1551,-10
81169988282,81169988288,6,1706,1497,-10
81170039669,81170039674,5,11353,34007,-10
81176471189,81176471191,2,2242,1715,-10
81177214439,81177214440,1,1659,1495,-10
81180952948,81180952949,1,1585,1816,-10
81181316638,81181316639,1,1194,1356,-10
81183590007,81183590014,7,6356,2300,-10
81185357526,81185357529,3,1466,1959,-10
81188778854,81188778865,11,1261,1585,-10
81190074410,81190074410,0,1710,1915,-10
81190826151,81190826150,-1,1507,2950,-10
81193838041,81193838041,0,1409,1710,-10
81196168745,81196168746,1,2587,2140,-10
81206429457,81206429457,0,1396,1749,-10
81208393105,81208393106,1,1521,1516,-10
81210405210,81210405225,15,1431,766,-10
81212535261,81212535265,4,2276,2130,-10
81212795549,81212795550,1,1610,1462,-10
81212883687,81212883686,-1,1456,914,-10
81213959947,81213959945,-2,1196,1662,-10
81215227154,81215227156,2,1301,1371,-10
81216984301,81216984295,-6,1182,2277,-10
81221649209,81221649213,4,4145,25967,-10
81221810348,81221810349,1,1351,1397,-10
81223459238,81223459241,3,942,1427,-10
81225046370,81225046376,6,1478,1614,-10
81225418998,81225418998,0,1474,1686,-10
81228065020,81228065023,3,1537,1095,-10
81230451561,81230451564,3,2044,1367,-10
81232119913,81232119913,0,1645,1330,-10
81235664071,81235664074,3,2252,1831,-10
81236141992,81236141996,4,1417,1999,-10
81236591170,81236591171,1,1138,1126,-10
81237661080,81237661082,2,1778,1692,-10
81240541970,81240541972,2,1948,1901,-10
81247905182,81247905183,1,1866,2079,-10
81251925835,81251925830,-5,1353,1267,-10
81253341782,81253341782,0,1370,1680,-10
81255163302,81255163302,0,1186,1451,-10
81257379586,81257379586,0,1310,1322,-10
81258825706,81258825705,-1,971,2783,-10
81259949534,81259949537,3,1510,1571,-10
81260651126,81260651130,4,1298,923,-10
81267078041,81267078042,1,1480,1838,-10
81267501722,81267501725,3,1914,1621,-10
81269637530,81269637531,1,1581,1194,-10
81280921285,81280921287,2,1448,1539,-10
81285908648,81285908649,1,1545,1243,-10
81287773534,81287773537,3,1509,1745,-10
81288021453,81288021458,5,2017,1224,-10
81294775802,81294775806,4,1874,1475,-10
81294949736,81294949738,2,1391,2155,-10
81300007418,81300007421,3,2009,1492,-10
81303082649,81303082652,3,9686,21140,-10
81305497031,81305497034,3,1879,1479,-10
81308590952,81308590949,-3,1022,1459,-10
81310380108,81310380109,1,1016,1027,-10
81310953911,81310953914,3,38037,27218,-10
81312206789,81312206790,1,1553,1977,-10
81312352860,81312352860,0,1572,1968,-10
81319922581,81319922582,1,1345,1597,-10
81320559375,81320559374,-1,1351,1119,-10
81323093913,81323093915,2,1610,1298,-10
81327002066,81327002068,2,1454,1265,-10
81331722673,81331722675,2,1190,1617,-10
81337489673,81337489677,4,1503,1354,-10
81337749242,81337749241,-1,1077,1605,-10
81339358343,81339358345,2,1810,1733,-10
81342005933,81342005929,-4,1866,4642,-10
81343887798,81343887801,3,1653,1256,-10
81348594247,81348594249,2,2133,1565,-10
81351545275,81351545275,0,1164,1510,-10
81352895214,81352895215,1,1237,1376,-10
81355771151,81355771153,2,1494,1985,-10
81355946855,81355946859,4,2123,1302,-10
81356156279,81356156257,-22,1542,1748,-10
81357245258,81357245259,1,1411,2154,-10
81358591156,81358591157,1,1468,1618,-10
81358839182,81358839185,3,39959,32989,-10
81360405126,81360405125,-1,1918,1916,-10
81362418874,81362418876,2,1777,1867,-10
81363723252,81363723246,-6,1198,1551,-10
81368477006,81368477008,2,1570,1399,-10
81369753863,81369753862,-1,1180,1806,-10
81371139834,81371139835,1,1366,1644,-10
81372861318,81372861321,3,1510,1422,-10
81373720758,81373720762,4,1378,1349,-10
81376530098,81376530098,0,1662,1666,-10
81376743254,81376743257,3,1619,2121,-10
81378611069,81378611075,6,3330,1358,-10
81379740914,81379740916,2,1332,1702,-10
81379854936,81379854937,1,1634,1962,-10
81381758449,81381758453,4,1705,1125,-10
81386687207,81386687207,0,1002,1118,-10
81387360222,81387360226,4,1290,1358,-10
81388141274,81388141277,3,1706,1965,-10
81390703018,81390703018,0,1700,1486,-10
81398480762,81398480762,0,1514,1624,-10
81399928680,81399928683,3,1904,1416,-10
81400144358,81400144360,2,1204,1404,-10
81403126829,81403126831,2,1307,1223,-10
81405373930,81405373933,3,1865,2181,-10
81407089293,81407089294,1,1186,1512,-10
81412291545,81412291547,2,1537,1845,-10
81412679596,81412679598,2,1947,1462,-10
81413105655,81413105658,3,2262,1623,-10
81414937722,81414937726,4,1704,1429,-10
81415756091,81415756093,2,1275,1222,-10
81416043270,81416043270,0,1881,1246,-10
81417605032,81417605034,2,1953,2195,-10
81420000726,81420000718,-8,2419,8518,-10
81420183237,81420183240,3,2192,1773,-10
81423698655,81423698658,3,1921,1735,-10
81427425024,81427425026,2,962,1160,-10
81432662456,81432662459,3,1963,1911,-10
81435740589,81435740595,6,1857,914,-10
81437282351,81437282350,-1,1577,2233,-10
81445434209,81445434211,2,1531,2075,-10
81446662853,81446662855,2,1513,1490,-10
81446872321,81446872323,2,1671,1896,-10
81449307674,81449307674,0,1461,2142,-10
81449960387,81449960389,2,1371,1732,-10
81450431222,81450431223,1,1276,1504,-10
81451101417,81451101417,0,952,1544,-10
81458124249,81458124254,5,1400,1624,-10
81459807014,81459807015,1,1233,1415,-10
81462645912,81462645913,1,1792,1761,-10
81466037349,81466037350,1,1241,1473,-10
81466293754,81466293756,2,1632,1682,-10
81466422741,81466422743,2,1524,1363,-10
81467648801,81467648805,4,1494,1628,-10
81468449801,81468449801,0,1887,1739,-10
81469600762,81469600766,4,1602,1055,-10
81469887788,81469887786,-2,1298,1136,-10
81473244266,81473244266,0,1327,1691,-10
81475100585,81475100586,1,1591,1535,-10
81477359877,81477359878,1,1454,1219,-10
81484440091,81484440094,3,1982,1337,-10
81485412822,81485412831,9,14043,25025,-10
81487357047,81487357050,3,4690,2725,-10
81490821313,81490821317,4,2465,2078,-10
81491325268,81491325271,3,1626,1434,-10
81491430788,81491430789,1,2327,1562,-10
81495205735,81495205738,3,1622,2547,-10
81497670466,81497670469,3,1692,1611,-10
81499882272,81499882274,2,2079,1839,-10
81500067111,81500067114,3,1291,1320,-10
81500608912,81500608914,2,1918,1970,-10
81503781257,81503781258,1,1512,1174,-10
81506601430,81506601411,-19,20328,24686,-10
81509245761,81509245762,1,1434,1186,-10
81509613868,81509613870,2,1664,1727,-10
81512131595,81512131590,-5,786,2845,-10
81517726712,81517726713,1,1546,2265,-10
81518867628,81518867629,1,1588,1723,-10
81519620891,81519620891,0,1058,812,-10
81521150394,81521150395,1,1414,1720,-10
81522203158,81522203159,1,1695,1061,-10
81523023557,81523023558,1,2032,2006,-10
81527281668,81527281675,7,24014,42857,-10
81527408941,81527408942,1,1067,1648,-10
81529411694,81529411695,1,1488,987,-10
81530406771,81530406773,2,1244,1731,-10
81537701081,81537701083,2,1311,1215,-10
81538415738,81538415738,0,1370,1841,-10
81539419868,81539419868,0,548,687,-10
81540425395,81540425411,16,997,1199,-10
81542636156,81542636158,2,1586,1633,-10
81547988533,81547988535,2,2159,1204,-10
81549776859,81549776859,0,1549,1614,-10
81551574938,81551574941,3,1196,1040,-10
81553275754,81553275757,3,1525,1289,-10
81555103221,81555103226,5,2333,1765,-10
81555287990,81555288002,12,1600,1254,-10
81555494902,81555494906,4,1488,1548,-10
81555696535,81555696541,6,4107,2218,-10
81557299845,81557299846,1,1790,2110,-10
81557871116,81557871120,4,1439,1453,-10
81559035618,81559035618,0,2152,2214,-10
81560083755,81560083758,3,1750,1536,-10
81560249637,81560249638,1,1742,1720,-10
81560380279,81560380282,3,1203,931,-10
81562199025,81562199023,-2,1124,1517,-10
81567666392,81567666394,2,1370,1355,-10
81567920966,81567920973,7,2305,1018,-10
81571591011,81571591014,3,1618,1671,-10
81576487230,81576487231,1,1619,1680,-10
81578259969,81578259973,4,1398,1920,-10
81591027344,81591027343,-1,1342,1586,-10
81595603239,81595603242,3,1628,1224,-10
81599960750,81599960752,2,1246,1033,-10
81607317554,81607317555,1,1814,1632,-10
81608464413,81608464416,3,1237,1396,-10
81610232722,81610232703,-19,1966,2129,-10
81610343626,81610343629,3,1133,1317,-10
81612448976,81612448981,5,2434,2059,-10
81612640874,81612640879,5,1642,1251,-10
81615219752,81615219743,-9,1018,1204,-10
81616113066,81616113066,0,1287,1607,-10
81617790636,81617790635,-1,1299,1508,-10
81619629205,81619629205,0,1440,1061,-10
81621852211,81621852215,4,1056,1726,-10
81623232545,81623232546,1,1121,1721,-10
81623707462,81623707463,1,1898,1755,-10
81624613733,81624613734,1,1076,1549,-10
81624681035,81624681038,3,1495,1243,-10
81630900254,81630900255,1,1535,1237,-10
81632034722,81632034726,4,1900,1642,-10
81645048193,81645048173,-20,1078,1389,-10
81646023154,81646023155,1,1454,2482,-10
81646167725,81646167719,-6,1614,7426,-10
81648010937,81648010938,1,2087,1650,-10
81649365622,81649365621,-1,1243,1792,-10
81652315725,81652315730,5,1449,1284,-10
81653406884,81653406887,3,1305,1671,-10
81655163937,81655163939,2,1689,1845,-10
81655834388,81655834390,2,2073,2027,-10
81658794006,81658794007,1,830,1291,-10
81663879195,81663879197,2,1204,1429,-10
81667884530,81667884531,1,1385,1417,-10
81671218582,81671218585,3,1362,1120,-10
81671736418,81671736425,7,1320,764,-10
81672565303,81672565302,-1,986,1614,-10
81678354624,81678354625,1,1788,1904,-10
81678678532,81678678533,1,1358,1303,-10
81680076279,81680076282,3,1357,1336,-10
81681279298,81681279301,3,1528,1428,-10
81681882078,81681882080,2,1505,1724,-10
81682741909,81682741914,5,1328,1601,-10
81683518422,81683518421,-1,1661,1920,-10
81686915158,81686915160,2,1600,1458,-10
81688469113,81688469126,13,872,4671,-10
81691197182,81691197182,0,859,331,-10
81694541284,81694541290,6,3424,1628,-10
81696444880,81696444883,3,1283,1431,-10
81697772691,81697772686,-5,1193,1893,-10
81699029587,81699029581,-6,963,3483,-10
81700486895,81700486896,1,922,1279,-10
81702115644,81702115647,3,1499,1494,-10
81704172297,81704172299,2,1230,1791,-10
81706146570,81706146571,1,1842,2191,-10
81708528510,81708528510,0,1717,1735,-10
81712237385,81712237386,1,1858,2021,-10
81712827359,81712827361,2,2885,3393,-10
81714775777,81714775778,1,1630,1229,-10
81716009282,81716009285,3,1631,1858,-10
81717623758,81717623761,3,1497,1606,-10
81718172721,81718172725,4,2165,1727,-10
81718617297,81718617298,1,1374,1523,-10
81720011425,81720011426,1,1941,1303,-10
81724953937,81724953944,7,7997,2152,-10
81727022172,81727022173,1,1443,1750,-10
81728840038,81728840042,4,1907,1976,-10
81728985210,81728985210,0,885,1377,-10
81730380494,81730380500,6,12214,29261,-10
81731697689,81731697691,2,1411,1169,-10
81734997597,81734997601,4,1565,1563,-10
81736236152,81736236153,1,1400,1796,-10
81737363835,81737363837,2,1554,1297,-10
81737816952,81737816953,1,1679,1437,-10
81740345991,81740345993,2,1513,1952,-10
81740557646,81740557648,2,1990,1697,-10
81740899242,81740899243,1,1660,2538,-10
81741005279,81741005281,2,1438,1253,-10
81741234102,81741234106,4,1202,1514,-10
81745345620,81745345622,2,1914,1516,-10
81747874134,81747874134,0,1566,1599,-10
81750085924,81750085925,1,1374,1445,-10
81753628591,81753628593,2,1373,1136,-10
81755252408,81755252408,0,1232,1113,-10
81756290085,81756290085,0,1245,1354,-10
81760145995,81760145999,4,1296,1020,-10
81760332985,81760332986,1,800,1271,-10
81761233881,81761233888,7,3489,1359,-10
81762209384,81762209386,2,1647,1504,-10
81765571212,81765571213,1,1415,1335,-10
81766503088,81766503091,3,1426,1345,-10
81772338855,81772338858,3,2091,2188,-10
81772759174,81772759174,0,1543,2019,-10
81773028857,81773028858,1,1823,1592,-10
81773368957,81773368959,2,1957,1983,-10
81773745514,81773745513,-1,1345,1342,-10
81774582622,81774582625,3,1286,1278,-10
81776280615,81776280617,2,2258,2144,-10
81778503760,81778503761,1,1607,1396,-10
81778757195,81778757176,-19,1597,1037,-10
81780489930,81780489931,1,1584,1682,-10
81781365672,81781365671,-1,1736,1930,-10
81783933226,81783933227,1,961,1346,-10
81788096339,81788096341,2,1583,1629,-10
81788958050,81788958052,2,1568,1747,-10
81789930713,81789930714,1,1634,1963,-10
81791706779,81791706777,-2,1701,3129,-10
81792193065,81792193065,0,1836,1752,-10
81792963664,81792963665,1,1144,1327,-10
81794395759,81794395762,3,1628,1375,-10
81795515455,81795515456,1,2143,1428,-10
81795922901,81795922905,4,1102,998,-10
81796716325,81796716327,2,1070,1258,-10
81802392617,81802392624,7,1375,1107,-10
81803253290,81803253294,4,1366,1387,-10
81805944433,81805944437,4,2147,1106,-10
81806776224,81806776225,1,1491,1360,-10
81809819307,81809819307,0,1770,1354,-10
81815001228,81815001234,6,9616,27872,-10
81817971960,81817971954,-6,999,2666,-10
81818209002,81818209002,0,1257,1545,-10
81818267822,81818267825,3,1524,1639,-10
81820359326,81820359328,2,1330,1273,-10
81821050946,81821050946,0,1786,2058,-10
81825543095,81825543096,1,1015,1897,-10
81826923051,81826923050,-1,1222,1221,-10
81827909397,81827909398,1,1631,1324,-10
81828397491,81828397493,2,1519,1325,-10
81831092867,81831092866,-1,1906,1575,-10
81832486717,81832486718,1,1457,1660,-10
81834324494,81834324496,2,1793,1911,-10
81835168748,81835168751,3,2587,2050,-10
81835768939,81835768941,2,2093,1951,-10
81836599011,81836599012,1,1545,1993,-10
81840753650,81840753650,0,1057,1209,-10
81842864601,81842864603,2,916,1063,-10
81846251410,81846251414,4,1573,1805,-10
81847618433,81847618435,2,1558,1646,-10
81850603485,81850603479,-6,1278,4725,-10
81852194334,81852194336,2,1434,1337,-10
81853520799,81853520798,-1,2038,2594,-10
81856895694,81856895697,3,1518,1865,-10
81857380671,81857380673,2,1398,1477,-10
81857756634,81857756637,3,2188,1975,-10
81860785573,81860785578,5,2016,1221,-10
81861379236,81861379237,1,1366,1234,-10
81862355690,81862355694,4,2049,1659,-10
81865601230,81865601233,3,2259,1935,-10
81870614286,81870614287,1,1669,1955,-10
81872947459,81872947464,5,1274,901,-10
81874357664,81874357666,2,983,1526,-10
81874966920,81874966928,8,1129,1715,-10
81875237974,81875237974,0,1626,1561,-10
81875584147,81875584150,3,1385,1581,-10
81878208138,81878208138,0,1654,1479,-10
81878840270,81878840272,2,974,1891,-10
81884319780,81884319797,17,790,3184,-10
81885465899,81885465884,-15,1185,998,-10
81893095342,81893095343,1,1398,849,-10
81897274787,81897274787,0,1978,2005,-10
81900697725,81900697727,2,1474,2340,-10
81904192554,81904192555,1,1832,1070,-10
81904447285,81904447286,1,1485,1527,-10
81910365455,81910365455,0,777,1874,-10
81914300409,81914300410,1,1561,1681,-10
81917137831,81917137831,0,1545,2012,-10
81920380691,81920380691,0,994,1518,-10
81921205325,81921205326,1,1417,1690,-10
81921778691,81921778693,2,935,1207,-10
81923430267,81923430268,1,1320,1635,-10
81927847813,81927847814,1,1638,1526,-10
81928469029,81928469031,2,1206,1584,-10
81929193472,81929193473,1,1498,1399,-10
81931634378,81931634380,2,1621,1337,-10
81932056965,81932056970,5,2064,2116,-10
81933393761,81933393764,3,1549,1337,-10
81933665960,81933665963,3,1094,1866,-10
81935926451,81935926454,3,2083,1840,-10
81937014443,81937014443,0,1875,1978,-10
81938644207,81938644211,4,2238,1563,-10
81939200646,81939200649,3,1033,796,-10
81940786397,81940786400,3,1594,1970,-10
81941392030,81941392032,2,1894,2305,-10
81942073535,81942073539,4,717,872,-10
81942442642,81942442657,15,1096,1327,-10
81943389560,81943389562,2,1174,1043,-10
81944622417,81944622398,-19,1611,1478,-10
81946645814,81946645815,1,2359,2094,-10
81950428178,81950428179,1,1626,1772,-10
81952137121,81952137125,4,1773,1326,-10
81953709625,81953709624,-1,1773,1430,-10
81954625259,81954625262,3,1960,1805,-10
81957872649,81957872650,1,1488,1342,-10
81958330590,81958330591,1,929,608,-10
81960043004,81960043006,2,1661,1738,-10
81962385805,81962385794,-11,1887,1491,-10
81963476702,81963476703,1,1435,1961,-10
81965423882,81965423885,3,1980,2151,-10
81965674382,81965674384,2,1499,1458,-10
81967367137,81967367141,4,1133,1742,-10
81967684743,81967684745,2,1621,1380,-10
81967803543,81967803521,-22,811,1647,-10
81969304847,81969304847,0,1513,1410,-10
81971137804,81971137807,3,2414,1285,-10
81971445043,81971445047,4,1789,1428,-10
81979276514,81979276515,1,1571,1162,-10
81981961997,81981961998,1,2366,1959,-10
81983258164,81983258166,2,1236,1157,-10
81987628784,81987628786,2,1767,1372,-10
81987961378,81987961362,-16,752,686,-10
81989939570,81989939570,0,1781,1560,-10
81989967962,81989967964,2,1636,1657,-10
81992660287,81992660290,3,1749,1364,-10
81993231889,81993231890,1,1033,956,-10
81994217778,81994217781,3,1386,1728,-10
81995716470,81995716470,0,1676,3037,-10
81996411793,81996411794,1,1121,1497,-10
82001013819,82001013824,5,1267,717,-10
82003743697,82003743697,0,1431,1551,-10
82004595028,82004595027,-1,1392,1481,-10
82007277425,82007277426,1,2406,1851,-10
82007442766,82007442766,0,1407,1740,-10
82007801061,82007801061,0,1212,1287,-10
82013045148,82013045149,1,1632,1481,-10
82014077278,82014077279,1,1176,2193,-10
82015390381,82015390380,-1,1616,2019,-10
82016020804,82016020806,2,1252,1430,-10
82021284524,82021284526,2,1827,1506,-10
82027270104,82027270104,0,1687,1277,-10
82031841152,82031841153,1,1416,1626,-10
82032168958,82032168959,1,1303,1442,-10
82032315275,82032315278,3,1719,1597,-10
82033930291,82033930299,8,5324,1994,-10
82035508150,82035508152,2,1230,1346,-10
82045111052,82045111054,2,582,1299,-10
82046399622,82046399625,3,1589,1569,-10
82047687646,82047687645,-1,1218,1688,-10
82048155027,82048155029,2,2153,2115,-10
82050656378,82050656380,2,957,1511,-10
82052469133,82052469136,3,1117,1565,-10
82053057646,82053057647,1,1178,1184,-10
82054909104,82054909107,3,1859,1984,-10
82055415647,82055415650,3,1138,1588,-10
82056129157,82056129160,3,1770,2149,-10
82057928906,82057928907,1,1007,1047,-10
82058424508,82058424511,3,2286,1737,-10
82061064655,82061064660,5,3497,1331,-10
82065965501,82065965501,0,1353,1772,-10
82072459644,82072459639,-5,462,1553,-10
82075133558,82075133559,1,1351,1847,-10
82076439841,82076439842,1,1521,1652,-10
82078085059,82078085039,-20,1158,1657,-10
82080974943,82080974945,2,1400,1467,-10
82082806115,82082806118,3,1545,1687,-10
82085377174,82085377177,3,1923,884,-10
82087882460,82087882462,2,1584,1489,-10
82088881719,82088881721,2,1694,1576,-10
82092330994,82092330995,1,1331,1573,-10
82093744971,82093744973,2,1609,1602,-10
82098236372,82098236374,2,1455,1952,-10
82100043399,82100043401,2,1325,1533,-10
82103945277,82103945279,2,1119,1178,-10
82107542447,82107542450,3,1233,1468,-10
82107691134,82107691138,4,1242,1350,-10
82107920514,82107920514,0,1098,1545,-10
82113089885,82113089889,4,2010,1421,-10
82116961876,82116961878,2,1479,1460,-10
82118851111,82118851114,3,1433,1552,-10
82119084744,82119084737,-7,1705,1543,-10
82121799257,82121799257,0,1519,2075,-10
82122240765,82122240767,2,1459,1547,-10
82124952481,82124952482,1,1443,1686,-10
82126613276,82126613278,2,1610,1600,-10
82127419898,82127419897,-1,1284,1983,-10
82129234968,82129234970,2,1514,1381,-10
82129636388,82129636384,-4,1059,2762,-10
82131295117,82131295117,0,1928,2171,-10
82132904237,82132904241,4,1782,1629,-10
82133322528,82133322530,2,1793,2025,-10
82134500485,82134500486,1,1498,1620,-10
82137262933,82137262937,4,1784,1588,-10
82137469431,82137469434,3,2084,1526,-10
82139191154,82139191156,2,1807,1367,-10
82140470798,82140470793,-5,1102,1284,-10
82140827142,82140827124,-18,1887,1438,-10
82145084721,82145084721,0,314,1339,-10
82145949814,82145949815,1,1291,1704,-10
82147082892,82147082894,2,1413,1400,-10
82147996949,82147996950,1,2057,2229,-10
82148497812,82148497807,-5,1368,3700,-10
82149397504,82149397505,1,1445,1375,-10
82154906354,82154906357,3,1295,1667,-10
82159377057,82159377059,2,1521,1228,-10
82159683998,82159683999,1,1125,1262,-10
82162873224,82162873225,1,1508,1620,-10
82164217649,82164217651,2,1959,1901,-10
82164744003,82164744005,2,1804,1251,-10
82170102528,82170102529,1,2188,1497,-10
82170374004,82170374011,7,2469,1227,-10
82177400539,82177400543,4,1317,1459,-10
82177644686,82177644688,2,1952,2452,-10
82178952137,82178952141,4,1563,1633,-10
82180621198,82180621201,3,1693,1690,-10
82181420429,82181420433,4,1089,1391,-10
82182272403,82182272402,-1,1175,1045,-10
82184379547,82184379539,-8,2195,9798,-10
82186764203,82186764206,3,1953,1371,-10
82187709498,82187709501,3,1057,1136,-10
82189364574,82189364573,-1,1050,2138,-10
82189646630,82189646632,2,1391,1336,-10
82189794727,82189794730,3,1238,1317,-10
82190213790,82190213793,3,1528,1217,-10
82190346934,82190346934,0,3118,3782,-10
82191310242,82191310242,0,1476,1199,-10
82191728593,82191728595,2,1561,1265,-10
82194772481,82194772481,0,1602,1837,-10
82195129217,82195129219,2,1370,1361,-10
82198142723,82198142726,3,1073,1528,-10
82200055363,82200055367,4,1570,1589,-10
82201316609,82201316610,1,1861,1986,-10
82205221620,82205221622,2,1833,1785,-10
82208930953,82208930958,5,4817,3102,-10
82209209850,82209209854,4,1903,1633,-10
82210662706,82210662708,2,2049,1571,-10
82211087003,82211087003,0,1551,1425,-10
82213291566,82213291567,1,1403,1123,-10
82214610824,82214610827,3,1199,1733,-10
82214779595,82214779597,2,1470,1594,-10
82216406342,82216406343,1,1721,1419,-10
82217085376,82217085381,5,1987,2057,-10
82217720236,82217720237,1,1482,1500,-10
82219421069,82219421070,1,1583,1432,-10
82219773185,82219773186,1,1337,1351,-10
82222329611,82222329614,3,1618,1906,-10
82223176066,82223176068,2,1032,1253,-10
82223644007,82223644006,-1,1534,1386,-10
82225317778,82225317781,3,642,1179,-10
82225806849,82225806853,4,1316,1375,-10
82230880567,82230880570,3,1141,1515,-10
82231566878,82231566880,2,2083,1925,-10
82232980749,82232980751,2,1442,1089,-10
82238234902,82238234905,3,1308,1382,-10
82239687450,82239687450,0,1477,1921,-10
82243209742,82243209743,1,1728,1476,-10
82244628135,82244628135,0,1679,1435,-10
82246299839,82246299834,-5,2419,6911,-10
82252118582,82252118582,0,2413,2291,-10
82252784361,82252784361,0,1360,1156,-10
82256281285,82256281287,2,2145,1643,-10
82257860112,82257860114,2,1038,1469,-10
82262082809,82262082800,-9,1867,1419,-10
82265615218,82265615222,4,2012,1267,-10
82270051657,82270051662,5,2176,1325,-10
82270904731,82270904734,3,1285,2057,-10
82276308941,82276308942,1,1695,1870,-10
82278407693,82278407686,-7,1051,7387,-10
82282838171,82282838170,-1,1322,2164,-10
82290278684,82290278687,3,1846,1281,-10
82290600265,82290600266,1,2340,1188,-10
82290943874,82290943879,5,1522,2223,-10
82291261379,82291261380,1,1701,1428,-10
82291712409,82291712412,3,1617,1980,-10
82293105485,82293105486,1,1805,1908,-10
82295257230,82295257235,5,1483,1362,-10
82296424102,82296424095,-7,28610,12370,-10
82302210821,82302210821,0,1681,2041,-10
82303136334,82303136335,1,1363,1607,-10
82303291897,82303291899,2,1422,1435,-10
82304250589,82304250590,1,1866,1894,-10
82304480714,82304480714,0,1379,1793,-10
82305692469,82305692471,2,1467,1148,-10
82308298918,82308298919,1,2220,1257,-10
82310904598,82310904598,0,1036,1550,-10
82313119978,82313119979,1,1060,827,-10
82316644727,82316644719,-8,32027,12079,-10
82326487270,82326487270,0,1435,2084,-10
82328031595,82328031597,2,1605,1158,-10
82331163725,82331163725,0,1985,1776,-10
82332266679,82332266681,2,1545,1828,-10
82334086797,82334086798,1,2161,2267,-10
82334661314,82334661315,1,1717,1692,-10
82335120608,82335120610,2,1821,1611,-10
82336026863,82336026866,3,1145,1564,-10
82336345921,82336345923,2,1412,1349,-10
82340124648,82340124651,3,1936,1717,-10
82343189632,82343189635,3,1885,1673,-10
82343411011,82343411012,1,1316,1177,-10
82344336538,82344336539,1,2303,1971,-10
82350450156,82350450158,2,1972,1878,-10
82352129382,82352129385,3,2130,2302,-10
82352804569,82352804572,3,1378,1628,-10
82357819877,82357819879,2,1542,1727,-10
82360378125,82360378125,0,1244,1757,-10
82361540554,82361540556,2,1970,1797,-10
82368065051,82368065051,0,1761,1501,-10
82368400831,82368400834,3,1155,719,-10
82369392294,82369392295,1,1355,1112,-10
82381600475,82381600477,2,2030,1900,-10
82382650713,82382650716,3,1642,1442,-10
82382847105,82382847107,2,1228,1216,-10
82385876486,82385876487,1,1219,1617,-10
82388303336,82388303338,2,952,833,-10
82390722270,82390722271,1,1920,1570,-10
82393418650,82393418629,-21,1163,1546,-10
82396393817,82396393817,0,1607,1392,-10
82396453314,82396453292,-22,1220,5052,-10
82397469685,82397469684,-1,1497,1377,-10
82398577231,82398577232,1,1155,1320,-10
82401933701,82401933702,1,1479,1641,-10
82403255594,82403255597,3,1449,1147,-10
82407028684,82407028687,3,1581,1442,-10
82409365588,82409365591,3,2626,2165,-10
82414188520,82414188525,5,1778,1388,-10
82415816750,82415816752,2,1636,1462,-10
82416515846,82416515846,0,1401,1653,-10
82419781518,82419781518,0,1714,1859,-10
82420202897,82420202898,1,1462,1353,-10
82422529415,82422529416,1,1152,1326,-10
82424199644,82424199651,7,7354,2129,-10
82424769450,82424769451,1,1473,1331,-10
82427172933,82427172933,0,1288,1265,-10
82431531875,82431531877,2,1712,1355,-10
82436503370,82436503374,4,1976,1881,-10
82439000519,82439000522,3,1189,1734,-10
82439610378,82439610381,3,1447,1950,-10
82439957865,82439957861,-4,1319,2648,-10
82442645860,82442645862,2,1251,1158,-10
82443424941,82443424924,-17,1446,1021,-10
82449627799,82449627800,1,1169,1818,-10
82453632971,82453632975,4,1620,1254,-10
82454432535,82454432534,-1,1669,1929,-10
82454809397,82454809399,2,1565,1497,-10
82457256826,82457256829,3,2044,1496,-10
82457872505,82457872505,0,1431,1506,-10
82461218173,82461218173,0,1257,1695,-10
82463378484,82463378482,-2,1337,1729,-10
82464331858,82464331841,-17,698,2322,-10
82465482133,82465482134,1,1450,1719,-10
82467165009,82467165013,4,1367,1782,-10
82468710652,82468710642,-10,279,1268,-10
82471660596,82471660595,-1,1127,1584,-10
82473201318,82473201319,1,1677,1653,-10
82473847353,82473847354,1,1463,1203,-10
82475214492,82475214475,-17,1390,381,-10
82476292924,82476292926,2,1495,1174,-10
82476631991,82476631993,2,1801,2083,-10
82479320767,82479320771,4,1524,1359,-10
82483164459,82483164459,0,1091,2229,-10
82483873810,82483873811,1,2225,1861,-10
82485252197,82485252198,1,1256,1340,-10
82486487546,82486487545,-1,1069,1930,-10
82489537046,82489537048,2,1257,1517,-10
82493703175,82493703178,3,1432,1274,-10
82496141778,82496141782,4,1269,965,-10
82496362017,82496362018,1,1642,1558,-10
82496392099,82496392101,2,1562,1105,-10
82497098781,82497098786,5,1213,442,-10
82503250039,82503250041,2,1675,1758,-10
82505408106,82505408108,2,1648,1179,-10
82507201706,82507201709,3,1708,1395,-10
82509368899,82509368913,14,1842,1563,-10
82509627311,82509627323,12,1766,978,-10
82513595737,82513595738,1,1352,1867,-10
82514785071,82514785071,0,1457,1856,-10
82515971403,82515971406,3,2213,1339,-10
82516272748,82516272750,2,2018,1659,-10
82524184925,82524184927,2,1644,1933,-10
82524383185,82524383187,2,1584,1146,-10
82532164061,82532164061,0,1553,1552,-10
82535359575,82535359577,2,1526,1677,-10
82535994318,82535994314,-4,904,2382,-10
82536553718,82536553721,3,1816,2180,-10
82538494058,82538494059,1,1169,1206,-10
82540201212,82540201214,2,1406,1477,-10
82541986933,82541986937,4,1301,1144,-10
82543206637,82543206639,2,1495,1533,-10
82545250689,82545250693,4,1364,1905,-10
82546411354,82546411360,6,4754,2058,-10
82548870765,82548870767,2,1900,2028,-10
82552420175,82552420174,-1,1295,1568,-10
82553908470,82553908474,4,1857,1660,-10
82554421021,82554421022,1,1374,1199,-10
82560153902,82560153904,2,799,924,-10
82560265721,82560265730,9,17933,53296,-10
82561640454,82561640455,1,1380,1205,-10
82566271177,82566271179,2,1834,1716,-10
82568451705,82568451701,-4,1366,2401,-10
82570891913,82570891913,0,1619,2369,-10
82574157315,82574157315,0,1877,1213,-10
82576453970,82576453970,0,1297,1692,-10
82577177489,82577177491,2,1320,1068,-10
82582061618,82582061619,1,1402,1486,-10
82583519902,82583519902,0,1850,1633,-10
82592545670,82592545670,0,1385,1423,-10
82595589604,82595589605,1,1228,1016,-10
82602509356,82602509341,-15,1038,1133,-10
82605540373,82605540374,1,1029,1341,-10
82606323320,82606323317,-3,1428,3134,-10
82611103685,82611103688,3,1988,1392,-10
82611800474,82611800477,3,974,1536,-10
82614873465,82614873453,-12,23817,14696,-10
82617809411,82617809411,0,1474,1432,-10
82618226337,82618226319,-18,313,18,-10
82619996773,82619996779,6,2779,1469,-10
82621687073,82621687074,1,1551,1624,-10
82625021127,82625021127,0,1198,1186,-10
82626425793,82626425795,2,1899,1768,-10
82626983210,82626983213,3,1598,1826,-10
82627819369,82627819373,4,2101,2125,-10
82628564884,82628564887,3,1886,1540,-10
82629553135,82629553137,2,1059,1788,-10
82631070063,82631070065,2,2343,2388,-10
82631621166,82631621161,-5,727,2011,-10
82632207937,82632207934,-3,1542,1497,-10
82632286994,82632286997,3,1784,1886,-10
82633383913,82633383906,-7,28679,16913,-10
82633751986,82633751988,2,1648,1992,-10
82633779852,82633779848,-4,785,1850,-10
82635036490,82635036492,2,1651,1966,-10
82635062472,82635062473,1,1417,1239,-10
82636396032,82636396035,3,1876,1196,-10
82636562215,82636562217,2,2008,2313,-10
82638097958,82638097959,1,1359,1379,-10
82641693650,82641693652,2,1228,2173,-10
82642016205,82642016207,2,1627,1583,-10
82645895687,82645895689,2,1693,1457,-10
82647477950,82647477949,-1,1629,1672,-10
82649561563,82649561565,2,1474,1983,-10
82654785158,82654785160,2,1286,1478,-10
82658986354,82658986354,0,1043,1349,-10
82659107046,82659107046,0,1203,1642,-10
82659344136,82659344129,-7,1349,1004,-10
82661184350,82661184351,1,2707,2522,-10
82661699270,82661699273,3,1070,1558,-10
82662083658,82662083659,1,1546,1729,-10
82664432548,82664432557,9,6628,826,-10
82672680985,82672680988,3,1034,1348,-10
82675331842,82675331849,7,9676,2574,-10
82676273770,82676273763,-7,1278,4870,-10
82681019174,82681019173,-1,2243,1990,-10
82683314554,82683314557,3,1614,1524,-10
82688859718,82688859720,2,1574,1379,-10
82692052246,82692052251,5,5865,3381,-10
82694326181,82694326183,2,1258,1451,-10
82696109980,82696109982,2,1094,1535,-10
82698982727,82698982727,0,1259,1073,-10
82706173688,82706173692,4,1100,1109,-10
82706994389,82706994394,5,3111,1381,-10
82710772707,82710772714,7,1497,789,-10
82711961361,82711961365,4,1927,1754,-10
82713040206,82713040185,-21,1701,1408,-10
82716609190,82716609191,1,1822,1187,-10
82718114166,82718114167,1,1599,1740,-10
82719987235,82719987237,2,1609,1423,-10
82720639376,82720639379,3,1589,1544,-10
82722391478,82722391481,3,1582,1948,-10
82722782062,82722782063,1,1638,1444,-10
82723179770,82723179771,1,1148,1786,-10
82724646435,82724646436,1,1336,1645,-10
82727186593,82727186595,2,1594,1141,-10
82728235528,82728235528,0,2124,2540,-10
82732158566,82732158566,0,1777,1264,-10
82735752969,82735752973,4,1511,1398,-10
82736001231,82736001233,2,1156,1220,-10
82738130219,82738130222,3,3539,2767,-10
82740388832,82740388837,5,1601,1572,-10
82743410014,82743410013,-1,1119,2749,-10
82743962219,82743962219,0,1212,1413,-10
82744414755,82744414757,2,1499,1390,-10
82749476162,82749476161,-1,1519,1617,-10
82751820358,82751820360,2,1429,1620,-10
82753227586,82753227591,5,1440,1415,-10
82756421154,82756421155,1,2060,1400,-10
82758439893,82758439895,2,1127,1306,-10
82758558607,82758558609,2,1444,1268,-10
82761202897,82761202902,5,2296,1988,-10
82767209678,82767209679,1,1307,1297,-10
82768661760,82768661758,-2,1304,2036,-10
82771816546,82771816544,-2,1602,4558,-10
82781002281,82781002282,1,1426,1516,-10
82781459969,82781459969,0,1358,1911,-10
82781844579,82781844579,0,1600,1897,-10
82785741830,82785741830,0,1184,1323,-10
82786224702,82786224706,4,1570,600,-10
82788147731,82788147734,3,2227,2046,-10
82788184047,82788184049,2,1745,1710,-10
82788902874,82788902877,3,1855,1967,-10
82788974550,82788974562,12,1343,1585,-10
82789099161,82789099162,1,1910,1576,-10
82791503134,82791503145,11,1574,1876,-10
82796142151,82796142154,3,2293,1792,-10
82801369173,82801369176,3,1141,1912,-10
82801617978,82801617979,1,1184,1276,-10
82803243650,82803243649,-1,1701,1514,-10
82805678072,82805678074,2,1321,2083,-10
82807516522,82807516543,21,783,864,-10
82810412267,82810412268,1,3532,4109,-10
82811921317,82811921318,1,1261,1530,-10
82814470555,82814470558,3,1749,1423,-10
82815000718,82815000722,4,23246,22045,-10
82816618278,82816618282,4,1411,1385,-10
82824369107,82824369110,3,1756,1110,-10
82825223430,82825223431,1,1055,922,-10
82827325657,82827325658,1,1647,1657,-10
82827378227,82827378230,3,1892,1460,-10
82827606554,82827606556,2,1971,972,-10
82828900340,82828900342,2,2133,2109,-10
82836736810,82836736813,3,1181,1310,-10
82837902023,82837902026,3,1518,1481,-10
82840391216,82840391218,2,1929,1379,-10
82840795728,82840795737,9,1486,1572,-10
82841329079,82841329082,3,1096,1311,-10
82844249265,82844249267,2,2013,1287,-10
82845375609,82845375613,4,1623,1264,-10
82846956105,82846956090,-15,1005,1543,-10
82847571874,82847571858,-16,1325,2037,-10
82848877102,82848877105,3,1546,1123,-10
82849617331,82849617337,6,2165,1521,-10
82851536512,82851536518,6,1702,1279,-10
82852394537,82852394536,-1,1447,3192,-10
82853351146,82853351153,7,5340,25244,-10
82854697145,82854697146,1,1447,1916,-10
82855886159,82855886162,3,1376,1555,-10
82857562243,82857562246,3,1278,949,-10
82859147195,82859147198,3,1524,2113,-10
82863470986,82863470986,0,2014,1243,-10
82864131911,82864131910,-1,1421,2158,-10
82864898827,82864898829,2,1611,1635,-10
82865685143,82865685144,1,1547,1773,-10
82865861655,82865861658,3,2279,1626,-10
82868089181,82868089185,4,1492,1027,-10
82868545755,82868545756,1,13501,14976,-10
82871210230,82871210235,5,1223,994,-10
82871678324,82871678305,-19,2342,1270,-10
82872510462,82872510462,0,1403,3065,-10
82872633430,82872633432,2,1682,1274,-10
82875501545,82875501546,1,1361,1632,-10
82876039819,82876039821,2,1828,1560,-10
82877604106,82877604107,1,1172,1639,-10
82878295330,82878295333,3,1143,1088,-10
82878950432,82878950434,2,1772,2306,-10
82881953155,82881953154,-1,889,1205,-10
82882465186,82882465195,9,2306,1219,-10
82883926705,82883926707,2,1720,1913,-10
82885091187,82885091192,5,1888,1912,-10
82886368230,82886368230,0,1000,994,-10
82887079541,82887079542,1,1379,1612,-10
82888505529,82888505530,1,1366,1568,-10
82890814439,82890814443,4,1451,1377,-10
82891740813,82891740815,2,1547,1307,-10
82894828432,82894828430,-2,1659,3502,-10
82896927968,82896927970,2,2208,1889,-10
82898662517,82898662519,2,2006,1592,-10
82898795137,82898795139,2,1517,1416,-10
82899238642,82899238643,1,1593,1466,-10
82900136385,82900136386,1,1342,1092,-10
82902836988,82902836989,1,1027,1501,-10
82905265994,82905265995,1,1783,1449,-10
82905924605,82905924606,1,2072,2136,-10
82907079139,82907079119,-20,2019,1681,-10
82908189312,82908189314,2,2114,1130,-10
82908547006,82908547009,3,1550,1770,-10
82910697207,82910697203,-4,760,2652,-10
82910851426,82910851426,0,1075,1519,-10
82913022262,82913022265,3,1408,1656,-10
82917810585,82917810586,1,1072,1098,-10
82918630574,82918630574,0,2026,1475,-10
82918711641,82918711642,1,1507,1239,-10
82924177317,82924177319,2,2002,1344,-10
82924358319,82924358322,3,1729,1635,-10
82925372734,82925372737,3,1293,1558,-10
82926182859,82926182859,0,2295,2168,-10
82926659590,82926659592,2,885,1469,-10
82926866645,82926866647,2,1575,1386,-10
82929040705,82929040710,5,2073,1527,-10
82930313791,82930313795,4,1319,981,-10
82932643360,82932643362,2,2243,1717,-10
82934996989,82934996989,0,1546,1135,-10
82936567819,82936567819,0,1337,1206,-10
82938209303,82938209306,3,1509,1435,-10
82939383787,82939383793,6,5016,1825,-10
82941689958,82941689962,4,1838,1293,-10
82945788603,82945788608,5,1635,1184,-10
82954561353,82954561354,1,1494,1514,-10
82955121111,82955121114,3,2024,1612,-10
82955817696,82955817697,1,1983,1793,-10
82956193909,82956193909,0,1433,1004,-10
82959408387,82959408391,4,1936,2131,-10
82962459678,82962459695,17,1847,1564,-10
82963608029,82963608026,-3,1549,2489,-10
82964420022,82964420022,0,2006,1668,-10
82965415329,82965415330,1,1641,1690,-10
82966988523,82966988524,1,1890,1827,-10
82974421594,82974421595,1,1298,1975,-10
82978667547,82978667547,0,1748,1946,-10
82980758700,82980758701,1,1122,1513,-10
82984441611,82984441610,-1,1173,1165,-10
82990517014,82990517015,1,1469,1451,-10
82993561682,82993561683,1,1580,916,-10
82997141629,82997141631,2,1756,1114,-10
82998542129,82998542131,2,1272,1711,-10
82998633952,82998633955,3,1201,1181,-10
83002238052,83002238053,1,1110,1554,-10
83006256838,83006256838,0,1407,2550,-10
83006850142,83006850144,2,1014,1373,-10
83012154241,83012154242,1,1629,1735,-10
83013658825,83013658826,1,2269,1418,-10
83016153314,83016153318,4,1801,1199,-10
83024418841,83024418843,2,1599,1604,-10
83025113322,83025113323,1,906,935,-10
83026362418,83026362419,1,693,1101,-10
83031158178,83031158181,3,1467,1405,-10
83031411785,83031411787,2,1448,1517,-10
83033706072,83033706071,-1,1575,1385,-10
83038357974,83038357975,1,1494,1668,-10
83038928956,83038928958,2,1979,1901,-10
83042215010,83042215010,0,1470,2055,-10
83043627730,83043627731,1,1794,1380,-10
83051471861,83051471864,3,2416,1618,-10
83053223242,83053223246,4,1504,1715,-10
83053574673,83053574671,-2,1480,1016,-10
83054575819,83054575808,-11,754,267,-10
83054636513,83054636492,-21,1068,1544,-10
83056579527,83056579504,-23,1409,1441,-10
83058244666,83058244669,3,1118,1238,-10
83059741779,83059741783,4,3059,2709,-10
83060237999,83060237999,0,1204,1669,-10
83064687894,83064687898,4,1468,1632,-10
83065656975,83065656976,1,1240,1094,-10
83067941433,83067941433,0,2057,1727,-10
83068968250,83068968249,-1,867,1117,-10
83074303750,83074303752,2,1592,1507,-10
83076243375,83076243377,2,1580,1613,-10
83079224166,83079224167,1,1219,1571,-10
83080051182,83080051183,1,1590,1643,-10
83081852220,83081852222,2,2296,1805,-10
83083738377,83083738380,3,1409,1317,-10
83090835003,83090835005,2,1127,1377,-10
83092700311,83092700310,-1,1043,1733,-10
83093958181,83093958182,1,1551,1019,-10
83094206451,83094206449,-2,779,2412,-10
83095030000,83095029998,-2,793,1778,-10
83095791738,83095791725,-13,1473,1455,-10
83100054749,83100054756,7,1134,1234,-10
83102477487,83102477490,3,1249,1332,-10
83104056186,83104056186,0,1535,1811,-10
83104967741,83104967741,0,1552,1114,-10
83106551354,83106551354,0,1854,1787,-10
83110681434,83110681435,1,1152,1315,-10
83116453062,83116453063,1,2187,1599,-10
83116955374,83116955377,3,1410,1537,-10
83124996990,83124996990,0,1494,1825,-10
83125419233,83125419233,0,1446,1383,-10
83128504373,83128504375,2,2222,1511,-10
83129320386,83129320392,6,1589,1784,-10
83131887062,83131887062,0,1209,2102,-10
83132550926,83132550929,3,1438,1348,-10
83133795525,83133795526,1,1610,1299,-10
83135606403,83135606407,4,2219,2347,-10
83136160489,83136160493,4,1973,1710,-10
83137315852,83137315855,3,1856,1211,-10
83138214493,83138214495,2,1998,1124,-10
83140118803,83140118805,2,1435,1595,-10
83140848462,83140848466,4,1237,1026,-10
83142567920,83142567922,2,1371,1340,-10
83146100853,83146100853,0,1291,968,-10
83146837738,83146837740,2,1452,1602,-10
83147739931,83147739933,2,931,1532,-10
83148855553,83148855539,-14,11,1749,-10
83152631022,83152631017,-5,1009,3587,-10
83152971664,83152971666,2,1819,1976,-10
83153598718,83153598717,-1,1694,1832,-10
83156029506,83156029511,5,3566,2020,-10
83160008173,83160008186,13,1963,1617,-10
83160090909,83160090908,-1,1538,2627,-10
83162003095,83162003099,4,1109,1500,-10
83163181146,83163181147,1,1411,1457,-10
83163769346,83163769349,3,1581,1527,-10
83165230586,83165230589,3,3967,2732,-10
83167469562,83167469568,6,1556,1459,-10
83168003214,83168003214,0,1329,1229,-10
83170414325,83170414327,2,1285,1202,-10
83170690786,83170690786,0,1245,2323,-10
83170862746,83170862767,21,648,1073,-10
83176319799,83176319800,1,1965,1595,-10
83178235482,83178235483,1,1486,1410,-10
83178608375,83178608377,2,1205,1108,-10
83187184703,83187184705,2,1361,1222,-10
83187626674,83187626676,2,1025,1398,-10
83189506883,83189506886,3,1845,1277,-10
83189549731,83189549733,2,1350,1777,-10
83193736147,83193736149,2,1674,1352,-10
83194531821,83194531822,1,2129,2335,-10
83198085087,83198085082,-5,2004,5601,-10
83198884338,83198884337,-1,1385,1073,-10
83203781948,83203781951,3,1024,1094,-10
83204290986,83204290986,0,1615,2238,-10
83207645158,83207645161,3,1503,1392,-10
83215970358,83215970357,-1,1338,2100,-10
83217717227,83217717231,4,1312,1183,-10
83221678334,83221678337,3,1688,1517,-10
83222289046,83222289048,2,2080,2187,-10
83225204331,83225204331,0,1145,2202,-10
83228705575,83228705578,3,2450,1812,-10
83230959486,83230959489,3,1479,1505,-10
83232200995,83232200997,2,1270,1609,-10
83236382790,83236382790,0,1475,1423,-10
83238332341,83238332341,0,1791,1871,-10
83238677134,83238677137,3,1258,1988,-10
83240546711,83240546694,-17,1335,1335,-10
83248685999,83248686001,2,2088,1318,-10
83255594437,83255594440,3,1781,1563,-10
83257070689,83257070689,0,1437,2416,-10
83257676789,83257676789,0,2042,1835,-10
83259230867,83259230871,4,1382,1086,-10
83261402450,83261402454,4,1049,1178,-10
83261983563,83261983566,3,1497,1659,-10
83262366635,83262366636,1,1087,1105,-10
83263571526,83263571526,0,1567,1537,-10
83267137053,83267137058,5,2412,1856,-10
83268167849,83268167854,5,1340,1415,-10
83271502463,83271502465,2,1516,1947,-10
83273589233,83273589239,6,4747,1691,-10
83276218189,83276218191,2,1452,1112,-10
83276674093,83276674094,1,2219,2061,-10
83279221754,83279221755,1,1357,1332,-10
83279738778,83279738778,0,1733,1160,-10
83280268530,83280268531,1,1758,1609,-10
83282140138,83282140139,1,1368,1131,-10
83285203563,83285203567,4,1769,1168,-10
83287514365,83287514367,2,1388,1593,-10
83289149174,83289149178,4,1565,1736,-10
83289355514,83289355515,1,1634,1537,-10
83290803869,83290803870,1,1305,1928,-10
83293146526,83293146527,1,989,1325,-10
83296287078,83296287078,0,996,1479,-10
83296521583,83296521585,2,1405,1229,-10
83296640908,83296640891,-17,2150,1269,-10
83298394768,83298394771,3,1460,1196,-10
83298686056,83298686055,-1,1131,1176,-10
83299611042,83299611039,-3,1144,2026,-10
83302933753,83302933758,5,3401,1402,-10
83306589034,83306589033,-1,1674,1568,-10
83309724649,83309724650,1,1717,1807,-10
83315625081,83315625082,1,2680,1862,-10
83317264126,83317264129,3,1098,1327,-10
83318946752,83318946761,9,1712,1810,-10
83322436785,83322436791,6,5313,2330,-10
83325204234,83325204234,0,1689,1789,-10
83328287967,83328287966,-1,2367,2757,-10
83329886886,83329886888,2,1409,1446,-10
83332789923,83332789925,2,1533,1195,-10
83335488302,83335488305,3,1873,1954,-10
83335911659,83335911653,-6,2895,11751,-10
83336226976,83336226978,2,1432,2243,-10
83338328135,83338328137,2,1369,1223,-10
83340666270,83340666280,10,801,997,-10
83341066906,83341066890,-16,1444,802,-10
83344836783,83344836785,2,3510,3599,-10
83345384700,83345384703,3,1084,732,-10
83346770739,83346770746,7,3154,1589,-10
83347343361,83347343362,1,619,699,-10
83347550624,83347550625,1,1732,1666,-10
83350601466,83350601469,3,1546,1172,-10
83351156375,83351156375,0,1502,1632,-10
83351984864,83351984866,2,1138,1332,-10
83356047519,83356047522,3,2017,1807,-10
83356468273,83356468276,3,1612,2144,-10
83357869051,83357869053,2,1470,1786,-10
83364725987,83364725987,0,1442,1663,-10
83369201763,83369201767,4,2141,1255,-10
83370900402,83370900405,3,2037,1663,-10
83371128953,83371128955,2,1785,1696,-10
83371738260,83371738262,2,1822,1259,-10
83372315625,83372315627,2,2003,2216,-10
83372404518,83372404519,1,1581,1789,-10
83373836693,83373836695,2,1303,1153,-10
83374048642,83374048647,5,1038,1443,-10
83377139997,83377139998,1,981,1600,-10
83379171214,83379171215,1,1448,1399,-10
83379696649,83379696664,15,1197,1843,-10
83380325842,83380325843,1,1886,1567,-10
83382004653,83382004654,1,1441,1584,-10
83383806811,83383806811,0,2115,2057,-10
83385559677,83385559677,0,2085,1992,-10
83385971893,83385971893,0,1081,1377,-10
83393397354,83393397354,0,1449,1609,-10
83396118811,83396118815,4,1856,1366,-10
83397260334,83397260348,14,15225,47246,-10
83398485785,83398485785,0,1441,1749,-10
83400508118,83400508121,3,1595,1603,-10
83400819889,83400819891,2,1110,1319,-10
83402666452,83402666454,2,1749,2484,-10
83404361481,83404361482,1,2021,1328,-10
83406645625,83406645626,1,1121,1818,-10
83409424126,83409424127,1,2707,2307,-10
83410189480,83410189482,2,1573,1384,-10
83413527709,83413527710,1,1468,1333,-10
83418012452,83418012454,2,951,1561,-10
83420251104,83420251106,2,1325,1177,-10
83421037077,83421037078,1,1317,1227,-10
83424705185,83424705188,3,1959,1266,-10
83428213335,83428213329,-6,1158,3802,-10
83430709360,83430709363,3,1602,1424,-10
83435183198,83435183202,4,1325,882,-10
83435596394,83435596396,2,1773,1507,-10
83437515869,83437515870,1,1599,1303,-10
83439820410,83439820414,4,1621,1240,-10
83440231414,83440231417,3,1840,1557,-10
83440664547,83440664547,0,1397,1547,-10
83441286385,83441286386,1,1248,1002,-10
83445245670,83445245673,3,1322,1197,-10
83446382865,83446382864,-1,1625,1377,-10
83447890922,83447890919,-3,976,2095,-10
83448804916,83448804934,18,1053,1325,-10
83452720306,83452720308,2,2109,1754,-10
83453123529,83453123530,1,1399,1205,-10
83456168931,83456168933,2,1489,1302,-10
83457230018,83457230018,0,2087,1719,-10
83457766321,83457766322,1,1581,1235,-10
83458693997,83458693999,2,1820,1746,-10
83460506348,83460506348,0,1688,2226,-10
83463156728,83463156746,18,15298,26611,-10
83465533438,83465533439,1,1918,2324,-10
83469167947,83469167949,2,1536,1615,-10
83469414774,83469414775,1,1545,1873,-10
83474386249,83474386247,-2,1399,3266,-10
83474552251,83474552254,3,1311,1526,-10
83477942769,83477942771,2,1946,1352,-10
83479718797,83479718799,2,1277,1301,-10
83481294259,83481294262,3,1506,1403,-10
83488343399,83488343403,4,1708,1373,-10
83490393554,83490393555,1,2034,2096,-10
83492896334,83492896336,2,1334,2028,-10
83494103858,83494103862,4,1809,1543,-10
83495402295,83495402294,-1,821,1286,-10
83498939267,83498939272,5,1817,1831,-10
83500345418,83500345421,3,1590,1230,-10
83501595577,83501595578,1,2114,2005,-10
83504340773,83504340776,3,1629,1321,-10
83505134297,83505134298,1,2040,1691,-10
83508246338,83508246342,4,2388,1883,-10
83508425029,83508425031,2,2712,1889,-10
83510341562,83510341553,-9,391,100,-10
83510843077,83510843078,1,2027,2171,-10
83511416738,83511416738,0,1527,1654,-10
83513606602,83513606605,3,1633,2068,-10
83513807933,83513807934,1,1666,1693,-10
83517042398,83517042398,0,1482,1657,-10
83517803337,83517803338,1,1456,1670,-10
83519336095,83519336098,3,1761,1921,-10
83522584360,83522584361,1,1677,2121,-10
83523585059,83523585059,0,2113,1943,-10
83523870605,83523870606,1,1475,877,-10
83523925646,83523925649,3,2067,1610,-10
83532133021,83532133021,0,1211,1145,-10
83532473967,83532473967,0,1470,1254,-10
83536563760,83536563761,1,2115,2343,-10
83540305001,83540305004,3,1714,1488,-10
83542442579,83542442582,3,1854,2209,-10
83544838074,83544838076,2,1369,1478,-10
83545550641,83545550642,1,1247,1615,-10
83546558340,83546558341,1,1573,1362,-10
83547453052,83547453054,2,1994,2181,-10
83547821529,83547821508,-21,1654,1751,-10
83548865876,83548865878,2,1514,1525,-10
83551600290,83551600293,3,1861,1713,-10
83552096387,83552096390,3,2027,1909,-10
83554134362,83554134362,0,1889,1945,-10
83555461263,83555461263,0,1600,1569,-10
83556029923,83556029922,-1,1651,2602,-10
83559172694,83559172697,3,1338,1308,-10
83562438978,83562438980,2,1102,1969,-10
83563219291,83563219271,-20,353,829,-10
83565370267,83565370269,2,1643,1862,-10
83569530594,83569530595,1,1922,1711,-10
83570910499,83570910501,2,1210,948,-10
83571124878,83571124882,4,2219,2232,-10
83571697853,83571697855,2,3580,2952,-10
83574518719,83574518726,7,2396,1548,-10
83574693971,83574693973,2,2384,2287,-10
83575906173,83575906173,0,1275,1261,-10
83578703117,83578703120,3,1362,1946,-10
83583067141,83583067136,-5,848,2451,-10
83583628875,83583628887,12,1277,1265,-10
83586035850,83586035851,1,1264,1442,-10
83587090902,83587090904,2,1668,1698,-10
83588749090,83588749095,5,1225,1301,-10
83589654632,83589654629,-3,1760,1534,-10
83590930379,83590930377,-2,1121,779,-10
83594362276,83594362277,1,1434,1259,-10
83595531706,83595531708,2,1432,1813,-10
83598153588,83598153590,2,1497,1751,-10
83598461173,83598461175,2,1500,1837,-10
83600295450,83600295452,2,1724,1681,-10
83602705156,83602705158,2,1755,1111,-10
83602799798,83602799800,2,1650,1584,-10
83608513702,83608513703,1,737,1176,-10
83617147669,83617147672,3,1033,1086,-10
83618146353,83618146358,5,3500,1676,-10
83620785719,83620785719,0,1123,1258,-10
83621320277,83621320278,1,1183,1466,-10
83622352206,83622352208,2,1965,1517,-10
83625394386,83625394389,3,1561,1524,-10
83631149477,83631149478,1,2169,1622,-10
83631419459,83631419461,2,1436,1616,-10
83633955710,83633955713,3,2124,1314,-10
83635272170,83635272173,3,1242,1520,-10
83635361549,83635361550,1,1759,1335,-10
83637241323,83637241326,3,1155,1504,-10
83637615896,83637615899,3,1804,1206,-10
83639294910,83639294906,-4,22884,51345,-10
83641197025,83641197025,0,1347,2138,-10
83641529994,83641529994,0,1779,1200,-10
83641908318,83641908323,5,1048,1164,-10
83646045118,83646045119,1,1153,1622,-10
83649962285,83649962277,-8,2115,1580,-10
83654119922,83654119925,3,2521,1804,-10
83654896405,83654896412,7,1423,983,-10
83659202478,83659202463,-15,1231,956,-10
83660754131,83660754133,2,1630,1705,-10
83663576786,83663576789,3,1603,1485,-10
83665289363,83665289363,0,1685,1734,-10
83666391594,83666391598,4,984,1221,-10
83667628128,83667628130,2,1449,1233,-10
83667812342,83667812343,1,1464,1243,-10
83670466415,83670466418,3,1604,1663,-10
83670549582,83670549582,0,1868,2326,-10
83672356428,83672356429,1,1736,2209,-10
83673630190,83673630191,1,2088,1763,-10
83674752064,83674752066,2,1555,1812,-10
83675820994,83675820994,0,1714,2165,-10
83679141159,83679141161,2,1493,1814,-10
83682314369,83682314372,3,1968,1872,-10
83685949849,83685949852,3,1797,1679,-10
83687416442,83687416444,2,1701,1300,-10
83687695557,83687695538,-19,690,1271,-10
83690486090,83690486091,1,2112,2321,-10
83690544376,83690544377,1,1594,1748,-10
83697186870,83697186871,1,2005,2119,-10
83698238154,83698238154,0,1497,2000,-10
83699089410,83699089412,2,1070,1416,-10
83700785785,83700785786,1,2068,1798,-10
83702751334,83702751337,3,1505,1599,-10
83702966465,83702966465,0,1841,2082,-10
83703044847,83703044849,2,1327,1682,-10
83703829910,83703829909,-1,1577,1335,-10
83706364182,83706364183,1,1691,1119,-10
83708181173,83708181174,1,1528,1513,-10
83709639156,83709639158,2,1650,1782,-10
83714935345,83714935347,2,1400,1627,-10
83716039631,83716039643,12,18844,7788,-10
83721783287,83721783284,-3,694,1392,-10
83727756509,83727756510,1,1395,1592,-10
83731356172,83731356169,-3,929,1724,-10
83732113486,83732113489,3,1469,1189,-10
83732494255,83732494259,4,1313,1063,-10
83735617176,83735617179,3,1498,1396,-10
83736317384,83736317386,2,1669,1968,-10
83737977664,83737977666,2,1471,1084,-10
83739791396,83739791399,3,1503,1243,-10
83739961027,83739961027,0,199,596,-10
83741452571,83741452570,-1,1455,2188,-10
83744123968,83744123971,3,1980,1811,-10
83745415149,83745415151,2,1258,1185,-10
83746878049,83746878050,1,1582,1644,-10
83748098672,83748098674,2,1309,1540,-10
83748680701,83748680703,2,1444,1379,-10
83751614180,83751614181,1,1687,1561,-10
83752854069,83752854074,5,1847,1480,-10
83755651886,83755651889,3,1536,1460,-10
83761066242,83761066242,0,1344,1374,-10
83764313165,83764313166,1,1050,1204,-10
83765234436,83765234439,3,1382,973,-10
83766719774,83766719776,2,1834,1471,-10
83770833469,83770833471,2,1950,2233,-10
83771543284,83771543283,-1,1640,1396,-10
83771946475,83771946477,2,1013,1100,-10
83776112568,83776112568,0,1402,1287,-10
83778666979,83778666980,1,1698,1700,-10
83780705185,83780705187,2,1605,1005,-10
83781408365,83781408351,-14,1465,1364,-10
83782456662,83782456663,1,1680,1525,-10
83789305942,83789305944,2,1666,1337,-10
83794983334,83794983336,2,1568,1406,-10
83797649126,83797649127,1,1203,1126,-10
83798706257,83798706259,2,1329,1467,-10
83801628310,83801628310,0,1106,1319,-10
83804334577,83804334578,1,1765,1266,-10
83806261274,83806261277,3,1741,1457,-10
83812131549,83812131551,2,1959,1905,-10
83815710809,83815710801,-8,1982,9518,-10
83816022390,83816022395,5,1175,1260,-10
83818386113,83818386114,1,2159,1458,-10
83818451602,83818451608,6,1283,1038,-10
83819631561,83819631562,1,1201,1585,-10
83819828721,83819828727,6,2798,1461,-10
83822133255,83822133256,1,1260,1491,-10
83831155830,83831155831,1,1556,1276,-10
83831806237,83831806238,1,1101,1021,-10
83834598688,83834598679,-9,31006,15257,-10
83835933901,83835933902,1,959,942,-10
83836380010,83836380013,3,1756,2080,-10
83837667073,83837667076,3,1567,1671,-10
83838926603,83838926605,2,1446,1567,-10
83844854304,83844854306,2,2206,2265,-10
83846503442,83846503446,4,1815,1676,-10
83847228682,83847228683,1,1498,1277,-10
83847646258,83847646259,1,2021,1776,-10
83852634380,83852634373,-7,1312,2944,-10
83857008689,83857008690,1,1543,1475,-10
83858346644,83858346645,1,1621,2114,-10
83862891685,83862891686,1,1456,810,-10
83863949023,83863949024,1,2406,1612,-10
83867024285,83867024286,1,1428,1225,-10
83867431398,83867431398,0,1187,1596,-10
83868841501,83868841501,0,1133,1386,-10
83871151535,83871151529,-6,45321,17018,-10
83871811385,83871811389,4,937,1213,-10
83874704503,83874704504,1,1654,1673,-10
83875862886,83875862887,1,1277,1361,-10
83877911973,83877911974,1,1666,2088,-10
83880010886,83880010887,1,830,1015,-10
83882669657,83882669658,1,1329,1134,-10
83882802736,83882802717,-19,1682,1459,-10
83883705495,83883705498,3,1351,1383,-10
83886160861,83886160861,0,1315,1359,-10
83889980090,83889980084,-6,1067,4221,-10
83892819169,83892819170,1,1671,1624,-10
83894038918,83894038918,0,1979,1913,-10
83894115101,83894115103,2,1194,1370,-10
83895272985,83895272975,-10,1331,1350,-10
83897090909,83897090910,1,1114,965,-10
83898618435,83898618438,3,1321,1478,-10
83898662808,83898662807,-1,1030,1246,-10
83903372338,83903372339,1,1543,1476,-10
83903706378,83903706378,0,1673,1211,-10
83905398611,83905398610,-1,1364,1311,-10
83906557746,83906557747,1,1515,845,-10
83910763918,83910763922,4,1181,1400,-10
83914368383,83914368385,2,1576,2143,-10
83914894685,83914894686,1,1580,1516,-10
83915838048,83915838051,3,959,1159,-10
83916328613,83916328615,2,1571,1541,-10
83918959762,83918959765,3,1656,1303,-10
83919606059,83919606063,4,1829,1396,-10
83920291602,83920291598,-4,1080,3970,-10
83921306305,83921306306,1,1072,1226,-10
83921596672,83921596674,2,2309,1864,-10
83933835749,83933835752,3,1472,1638,-10
83938574606,83938574608,2,1856,1663,-10
83941569161,83941569163,2,1849,1643,-10
83941775289,83941775296,7,2076,1209,-10
83941957406,83941957407,1,1499,1515,-10
83946288430,83946288431,1,1594,1090,-10
83948312099,83948312101,2,1471,1427,-10
83948518470,83948518472,2,1435,1499,-10
83949021627,83949021629,2,1106,1718,-10
83949284316,83949284318,2,1681,1673,-10
83950016387,83950016389,2,1298,1152,-10
83954267374,83954267374,0,1913,1639,-10
83955926330,83955926333,3,1373,1066,-10
83960539020,83960539023,3,2088,1481,-10
83969087398,83969087400,2,1187,1872,-10
83974785361,83974785362,1,1856,1526,-10
83981068163,83981068164,1,1063,1113,-10
83981582545,83981582547,2,1770,1254,-10
83982570364,83982570368,4,1248,1775,-10
83983650107,83983650112,5,12645,22563,-10
83985539992,83985539997,5,2394,1275,-10
83986181326,83986181328,2,1904,1842,-10
83987461103,83987461106,3,1648,1175,-10
83991833867,83991833869,2,1437,1405,-10
83994064325,83994064318,-7,2341,7433,-10
83998470662,83998470664,2,1832,2172,-10
84003797934,84003797939,5,2749,1919,-10
84005794248,84005794247,-1,934,1024,-10
84009049457,84009049458,1,1097,1334,-10
84009283846,84009283825,-21,115,1068,-10
84010978581,84010978580,-1,1538,1700,-10
84013503338,84013503339,1,1367,1601,-10
84015655109,84015655110,1,1789,1818,-10
84017989828,84017989830,2,1525,1567,-10
84019032741,84019032720,-21,1351,1094,-10
84020991679,84020991684,5,1777,1956,-10
84023283954,84023283954,0,1199,1452,-10
84024460312,84024460315,3,1474,1351,-10
84025462534,84025462536,2,1111,1385,-10
84028131011,84028131015,4,966,1116,-10
84029266951,84029266949,-2,1104,1284,-10
84032546363,84032546366,3,1315,1507,-10
84033353378,84033353380,2,2231,1500,-10
84035353265,84035353267,2,1957,1481,-10
84036549982,84036549984,2,1606,1672,-10
84036669022,84036669001,-21,1187,885,-10
84046762784,84046762787,3,1592,1334,-10
84047149351,84047149353,2,1018,1221,-10
84048956510,84048956510,0,1035,1508,-10
84055219992,84055219990,-2,1232,1442,-10
84056151607,84056151607,0,955,1294,-10
84056672294,84056672294,0,1016,921,-10
84059097395,84059097398,3,1145,1163,-10
84061484174,84061484177,3,1248,1218,-10
84065259522,84065259523,1,1038,1326,-10
84065946557,84065946559,2,1790,1541,-10
84068822046,84068822050,4,2044,1728,-10
84072159838,84072159839,1,1605,1650,-10
84073987871,84073987874,3,1934,1716,-10
84074015863,84074015865,2,1359,1322,-10
84076192679,84076192683,4,1182,1204,-10
84077527187,84077527188,1,1014,1293,-10
84083209251,84083209252,1,1805,1855,-10
84083978198,84083978200,2,2140,1205,-10
84085157106,84085157108,2,1010,1293,-10
84087929319,84087929322,3,1535,1675,-10
84089962328,84089962330,2,1437,1788,-10
84090405147,84090405145,-2,1115,1742,-10
84092324591,84092324594,3,1032,1378,-10
84103893147,84103893149,2,1407,1676,-10
84104455003,84104455004,1,1791,1616,-10
84104811781,84104811784,3,1781,1741,-10
84105783512,84105783514,2,1621,1496,-10
84106317016,84106317018,2,1621,1793,-10
84106550002,84106550004,2,1607,1358,-10
84117322847,84117322850,3,1647,1457,-10
84118359089,84118359091,2,1597,1483,-10
84119986505,84119986506,1,1688,1818,-10
84120920700,84120920701,1,1311,1450,-10
84121105521,84121105534,13,239,722,-10
84124608881,84124608884,3,1574,1411,-10
84131521266,84131521247,-19,33786,27208,-10
84136172981,84136172983,2,1448,1221,-10
84140342901,84140342905,4,1542,1761,-10
84141238174,84141238175,1,987,1092,-10
84141467056,84141467059,3,1974,1770,-10
84141924651,84141924656,5,2047,1875,-10
84142049830,84142049831,1,1405,1385,-10
84143632550,84143632549,-1,1380,1375,-10
84146555110,84146555111,1,2005,2208,-10
84148461853,84148461855,2,1455,1490,-10
84150924849,84150924849,0,1583,1986,-10
84151283465,84151283466,1,16368,16309,-10
84152823358,84152823362,4,1681,1317,-10
84156577266,84156577269,3,1839,1860,-10
84156663345,84156663348,3,1755,1607,-10
84158554796,84158554795,-1,1706,979,-10
84161412683,84161412685,2,1621,1290,-10
84168104966,84168104966,0,1790,1693,-10
84171894831,84171894834,3,837,1214,-10
84186902263,84186902261,-2,2180,3283,-10
84187571989,84187571990,1,1557,1958,-10
84191009826,84191009826,0,1665,2125,-10
84192441579,84192441581,2,2576,2046,-10
84193584871,84193584871,0,1272,1387,-10
84201831886,84201831887,1,1639,1399,-10
84203458749,84203458750,1,1349,1763,-10
84205552631,84205552634,3,1493,1342,-10
84209277179,84209277181,2,1670,1370,-10
84210220449,84210220449,0,1737,1894,-10
84212987386,84212987390,4,1597,1432,-10
84214892614,84214892615,1,1538,1315,-10
84215142461,84215142465,4,1947,1944,-10
84215356885,84215356904,19,1235,1357,-10
84217098563,84217098566,3,1336,1600,-10
84217165415,84217165416,1,1028,1165,-10
84217715162,84217715166,4,24539,25271,-10
84217853626,84217853627,1,2593,1915,-10
84219123026,84219123031,5,10282,21051,-10
84219697499,84219697490,-9,1187,2588,-10
84224482166,84224482167,1,1502,1277,-10
84226755338,84226755340,2,2015,2336,-10
84230255270,84230255271,1,1233,1254,-10
84235743441,84235743443,2,2162,1704,-10
84236638368,84236638371,3,1612,2024,-10
84238036578,84238036577,-1,1853,1676,-10
84238666031,84238666035,4,1569,979,-10
84238961531,84238961532,1,1590,1792,-10
84240010365,84240010366,1,1715,1874,-10
84242801510,84242801511,1,1794,1640,-10
84244486863,84244486866,3,1724,1108,-10
84245016838,84245016843,5,1723,1259,-10
84245663262,84245663267,5,1034,1304,-10
84246003910,84246003909,-1,1644,1461,-10
84247365949,84247365951,2,1264,1703,-10
84249060460,84249060460,0,1290,1679,-10
84251397178,84251397180,2,1129,1614,-10
84253149349,84253149350,1,1534,1349,-10
84254847390,84254847392,2,1217,1281,-10
84261013829,84261013830,1,1139,648,-10
84264250619,84264250621,2,1839,1721,-10
84265096070,84265096072,2,1067,1438,-10
84267746761,84267746765,4,1140,1667,-10
84270085070,84270085072,2,2038,1740,-10
84270554842,84270554843,1,1451,1843,-10
84271000417,84271000419,2,1882,1462,-10
84276485101,84276485100,-1,1547,1760,-10
84280873274,84280873275,1,1996,1889,-10
84281412209,84281412210,1,1781,1414,-10
84281605670,84281605671,1,2190,1703,-10
84282478014,84282478016,2,1789,1746,-10
84283785962,84283785963,1,1713,1478,-10
84284247098,84284247096,-2,999,2363,-10
84285937734,84285937734,0,1231,2318,-10
84286371691,84286371694,3,1173,1143,-10
84291158446,84291158447,1,1751,1339,-10
84291749859,84291749863,4,1841,996,-10
84293892229,84293892231,2,1477,1018,-10
84295310365,84295310367,2,1360,1360,-10
84297101330,84297101330,0,1644,1380,-10
84298219272,84298219274,2,1385,1052,-10
84298899270,84298899272,2,1708,1784,-10
84302910043,84302910043,0,1597,2282,-10
84303874573,84303874575,2,900,1373,-10
84304487418,84304487417,-1,830,2068,-10
84309780598,84309780601,3,1562,2109,-10
84312351731,84312351734,3,2183,1461,-10
84316312009,84316312011,2,2074,2068,-10
84322797399,84322797402,3,1719,1449,-10
84326338580,84326338581,1,1661,1653,-10
84327125219,84327125222,3,1705,1735,-10
84328789769,84328789773,4,1904,1221,-10
84328957254,84328957255,1,1354,1435,-10
84329565711,84329565714,3,1301,1488,-10
84331764199,84331764200,1,1727,1651,-10
84333273373,84333273378,5,961,1210,-10
84337308361,84337308362,1,1427,1638,-10
84343268981,84343268983,2,1322,1480,-10
84343765052,84343765055,3,1448,1273,-10
84343850965,84343850966,1,1658,1519,-10
84345658209,84345658225,16,868,1450,-10
84349726310,84349726313,3,1577,1287,-10
84351566993,84351566993,0,1343,2326,-10
84355039629,84355039630,1,1366,1609,-10
84355115538,84355115538,0,1386,1804,-10
84355310825,84355310828,3,1336,1796,-10
84358047079,84358047082,3,1326,1538,-10
84359850274,84359850275,1,2097,1684,-10
84360613537,84360613537,0,1463,1336,-10
84362547961,84362547964,3,1570,1645,-10
84363889138,84363889140,2,1715,1970,-10
84369260863,84369260862,-1,1899,2107,-10
84373810714,84373810717,3,1677,1700,-10
84374120061,84374120062,1,1426,2320,-10
84374943175,84374943177,2,1715,1356,-10
84379613596,84379613598,2,1181,1600,-10
84381225254,84381225256,2,1175,1316,-10
84384106474,84384106475,1,1477,1772,-10
84384947769,84384947770,1,1468,1711,-10
84385002901,84385002903,2,1996,1759,-10
84386198573,84386198578,5,2895,1655,-10
84388506063,84388506065,2,1569,1313,-10
84389181872,84389181875,3,1979,1807,-10
84397868226,84397868228,2,1416,1402,-10
84399096799,84399096802,3,1393,1447,-10
84399277454,84399277456,2,1186,1190,-10
84400557255,84400557255,0,1486,1120,-10
84403847795,84403847795,0,1619,1498,-10
84405681895,84405681894,-1,1811,2083,-10
84408219635,84408219635,0,1222,1509,-10
84408981755,84408981773,18,1030,2175,-10
84410014243,84410014246,3,1704,1358,-10
84411475083,84411475085,2,1605,1472,-10
84411982794,84411982797,3,1254,1660,-10
84416876375,84416876375,0,1438,1319,-10
84419692279,84419692282,3,1469,1880,-10
84425157009,84425157011,2,1588,1254,-10
84426427177,84426427177,0,1362,1440,-10
84430758905,84430758906,1,1945,1737,-10
84433135713,84433135717,4,1050,1317,-10
84434112602,84434112604,2,1005,1202,-10
84434700640,84434700641,1,1558,1060,-10
84435210866,84435210869,3,1064,1043,-10
84441464255,84441464257,2,1044,1370,-10
84441555874,84441555873,-1,999,1912,-10
84444369431,84444369409,-22,859,1923,-10
84447810673,84447810674,1,1820,2073,-10
84448282986,84448282987,1,635,1222,-10
84450615573,84450615572,-1,1458,1739,-10
84453195430,84453195433,3,1439,944,-10
84454056627,84454056626,-1,1342,1565,-10
84457410093,84457410096,3,2114,1929,-10
84459887808,84459887810,2,1364,1143,-10
84460253800,84460253802,2,1303,1261,-10
84463433557,84463433556,-1,2129,1762,-10
84464312953,84464312958,5,5533,2726,-10
84465795102,84465795104,2,1031,1590,-10
84468813559,84468813562,3,2885,2355,-10
84470309213,84470309212,-1,31581,50645,-10
84472951995,84472951999,4,1041,1145,-10
84473510179,84473510181,2,2318,1858,-10
84474802110,84474802111,1,1999,1710,-10
84477276065,84477276067,2,1434,1811,-10
84478386220,84478386225,5,1199,1130,-10
84481758138,84481758140,2,1249,1553,-10
84484402502,84484402504,2,1651,2270,-10
84485320241,84485320242,1,1339,1540,-10
84485950327,84485950329,2,1822,2052,-10
84487684378,84487684379,1,1063,1652,-10
84488145845,84488145846,1,1932,915,-10
84488824337,84488824338,1,1617,1837,-10
84495910888,84495910894,6,1917,1220,-10
84497313067,84497313070,3,1590,1362,-10
84499322128,84499322131,3,1608,1538,-10
84499996164,84499996166,2,1445,1328,-10
84502704926,84502704928,2,1886,1984,-10
84502998541,84502998543,2,1258,1352,-10
84504417283,84504417286,3,1783,1235,-10
84508338263,84508338266,3,2068,1527,-10
84509144443,84509144438,-5,1072,4140,-10
84509193155,84509193158,3,1584,1835,-10
84515290409,84515290410,1,2243,1257,-10
84516170482,84516170485,3,1547,2074,-10
84516255530,84516255531,1,1261,1618,-10
84519008689,84519008690,1,979,793,-10
84519319431,84519319433,2,1844,2299,-10
84521060826,84521060827,1,1250,1737,-10
84522044342,84522044343,1,1727,1292,-10
84530967004,84530967011,7,2959,1259,-10
84534087578,84534087580,2,1874,2067,-10
84534407687,84534407690,3,1679,1205,-10
84534571031,84534571032,1,1402,1684,-10
84536382942,84536382943,1,1199,1652,-10
84536960014,84536960016,2,2383,1868,-10
84538622519,84538622519,0,1144,1663,-10
84544335945,84544335947,2,1693,1369,-10
84547619947,84547619950,3,1740,2330,-10
84549280369,84549280371,2,1267,1371,-10
84553437986,84553437986,0,2161,1830,-10
84559287282,84559287284,2,2092,1742,-10
84560578381,84560578382,1,1295,1458,-10
84562796145,84562796147,2,2311,1846,-10
84562983027,84562983030,3,871,746,-10
84563471304,84563471304,0,1469,1652,-10
84568718722,84568718723,1,730,907,-10
84570492285,84570492287,2,1126,1393,-10
84571100368,84571100369,1,1702,1956,-10
84572855800,84572855800,0,1198,1750,-10
84574187602,84574187605,3,1900,1389,-10
84575857399,84575857402,3,1432,1362,-10
84576066493,84576066493,0,938,1753,-10
84577435518,84577435521,3,2425,1723,-10
84580467268,84580467269,1,2263,2117,-10
84583388062,84583388064,2,1098,2012,-10
84589744974,84589744977,3,2395,1651,-10
84589966419,84589966420,1,1261,1536,-10
84590230922,84590230923,1,2117,2395,-10
84590286149,84590286152,3,1459,1431,-10
84590813361,84590813362,1,2109,1637,-10
84598060557,84598060559,2,1466,1453,-10
84598375937,84598375923,-14,1463,1462,-10
84604541922,84604541922,0,1291,1170,-10
84605367408,84605367407,-1,1942,1543,-10
84606814279,84606814281,2,2023,2258,-10
84607475527,84607475529,2,1569,1907,-10
84612002033,84612002036,3,1320,1364,-10
84615047782,84615047786,4,1713,1766,-10
84621183220,84621183221,1,2000,1387,-10
84622351934,84622351937,3,1439,1742,-10
84623220510,84623220517,7,2414,1480,-10
84623900106,84623900113,7,14388,20688,-10
84627946598,84627946598,0,1518,1662,-10
84631060600,84631060605,5,2297,1898,-10
84638939682,84638939681,-1,1004,1753,-10
84639901602,84639901604,2,1729,1407,-10
84641568037,84641568040,3,2004,2233,-10
84643562079,84643562082,3,1613,1285,-10
84643697330,84643697332,2,1927,1167,-10
84644226161,84644226163,2,1393,1776,-10
84645555520,84645555528,8,2022,1749,-10
84645955989,84645955990,1,1349,1924,-10
84647997489,84647997491,2,2314,1898,-10
84650111661,84650111663,2,2086,1977,-10
84650260143,84650260147,4,1297,1061,-10
84658353266,84658353267,1,1334,1384,-10
84658425357,84658425358,1,1945,1802,-10
84659607345,84659607349,4,1702,1916,-10
84662841835,84662841838,3,1276,1287,-10
84663076015,84663076016,1,1116,1774,-10
84664227047,84664227049,2,1529,1219,-10
84666288799,84666288801,2,1490,1603,-10
84666564729,84666564732,3,2517,1784,-10
84669591088,84669591090,2,1249,1613,-10
84671844517,84671844519,2,1336,1870,-10
84672552529,84672552533,4,1377,1561,-10
84673512836,84673512838,2,1512,1173,-10
84676263577,84676263579,2,2057,1927,-10
84677458062,84677458065,3,1290,783,-10
84678018349,84678018347,-2,1296,1751,-10
84679328898,84679328878,-20,1203,1659,-10
84679387625,84679387617,-8,1356,1365,-10
84682407511,84682407513,2,1804,2332,-10
84686392431,84686392431,0,967,1627,-10
84689545519,84689545522,3,1654,1532,-10
84690392013,84690392014,1,1980,1480,-10
84691453695,84691453698,3,1418,1556,-10
84693699565,84693699571,6,1685,831,-10
84693739727,84693739727,0,1663,1238,-10
84695643816,84695643818,2,822,1207,-10
84698442822,84698442822,0,1229,1403,-10
84701078113,84701078114,1,1326,1328,-10
84701183518,84701183517,-1,1834,2211,-10
84703969450,84703969451,1,1211,1676,-10
84707577190,84707577188,-2,1114,1339,-10
84708314021,84708314024,3,1235,1385,-10
84711092861,84711092862,1,2256,1575,-10
84712896926,84712896931,5,2859,1666,-10
84713420806,84713420808,2,1474,1808,-10
84718288546,84718288548,2,1154,1492,-10
84723025822,84723025822,0,1390,1579,-10
84725334206,84725334208,2,1903,1970,-10
84727597457,84727597459,2,1410,1350,-10
84728819407,84728819408,1,1500,1814,-10
84732362693,84732362695,2,2629,1754,-10
84732683790,84732683793,3,2000,1388,-10
84733514086,84733514087,1,1380,1628,-10
84735265766,84735265766,0,1743,1487,-10
84736060947,84736060951,4,1196,942,-10
84740070077,84740070078,1,1570,1493,-10
84740549927,84740549929,2,804,1194,-10
84743916879,84743916881,2,1248,1291,-10
84744197303,84744197321,18,1391,1729,-10
84744967586,84744967601,15,1146,1154,-10
84745752378,84745752378,0,2223,1792,-10
84747089130,84747089133,3,1370,1703,-10
84751800494,84751800496,2,1366,1395,-10
84753121182,84753121187,5,1349,1536,-10
84756809222,84756809229,7,2727,1168,-10
84762135289,84762135293,4,2587,1346,-10
84762861362,84762861364,2,1716,1623,-10
84763116286,84763116265,-21,1735,1234,-10
84764274222,84764274223,1,1523,1307,-10
84766047552,84766047550,-2,1950,2919,-10
84769334567,84769334574,7,1917,1162,-10
84772849066,84772849067,1,1440,1739,-10
84775108642,84775108626,-16,1556,2192,-10
84775767783,84775767785,2,1178,1508,-10
84780542759,84780542757,-2,1124,1066,-10
84781271221,84781271224,3,1062,1200,-10
84784110386,84784110387,1,1185,1386,-10
84785162103,84785162104,1,2072,1819,-10
84785996289,84785996296,7,12197,38532,-10
84788245671,84788245675,4,1353,1385,-10
84789498604,84789498606,2,1489,1399,-10
84796303581,84796303582,1,1544,1543,-10
84798454069,84798454069,0,1735,1186,-10
84799717633,84799717634,1,1280,1165,-10
84800552966,84800552966,0,1127,1876,-10
84801330630,84801330630,0,1102,895,-10
84803022372,84803022373,1,974,1092,-10
84806347450,84806347451,1,1281,1629,-10
84807705286,84807705289,3,1715,1924,-10
84808903121,84808903123,2,1444,616,-10
84812207355,84812207356,1,1692,1753,-10
84814047023,84814047024,1,1027,1738,-10
84815587131,84815587134,3,1736,1484,-10
84818001861,84818001864,3,1976,1761,-10
84821085853,84821085852,-1,19781,24158,-10
84821354842,84821354840,-2,1565,2573,-10
84827369008,84827369010,2,9,1136,-10
84827584063,84827584065,2,1836,1139,-10
84829183682,84829183682,0,3233,3623,-10
84834933220,84834933223,3,1213,1187,-10
84836047082,84836047084,2,1423,1924,-10
84841314619,84841314620,1,1095,1121,-10
84842666901,84842666904,3,1836,2012,-10
84843268977,84843268993,16,16403,52494,-10
84843579898,84843579894,-4,1222,2911,-10
84844049236,84844049239,3,2565,1865,-10
84844354054,84844354056,2,1970,1455,-10
84849107251,84849107251,0,990,1138,-10
84850292083,84850292085,2,1799,1675,-10
84852118142,84852118144,2,1310,1243,-10
84853109869,84853109873,4,1235,1568,-10
84855366053,84855366054,1,1847,1666,-10
84855864212,84855864219,7,3440,1281,-10
84857663543,84857663544,1,1252,1910,-10
84858895379,84858895379,0,1381,2029,-10
84860293293,84860293298,5,1541,1740,-10
84862018507,84862018510,3,1762,1500,-10
84865173326,84865173329,3,1947,1991,-10
84867970538,84867970541,3,2146,1675,-10
84868712102,84868712107,5,1210,1338,-10
84869720942,84869720944,2,1345,1965,-10
84872517366,84872517369,3,1433,1271,-10
84873319380,84873319382,2,2064,2219,-10
84876014631,84876014632,1,1680,1710,-10
84876466942,84876466946,4,1805,1498,-10
84878823123,84878823125,2,989,753,-10
84883900666,84883900681,15,1113,1183,-10
84891014458,84891014461,3,1988,1305,-10
84891440821,84891440822,1,1857,1501,-10
84892368009,84892368015,6,1339,1148,-10
84893733957,84893733958,1,1173,1094,-10
84894021975,84894021976,1,1558,1649,-10
84895105088,84895105091,3,1140,1096,-10
84895170161,84895170167,6,2917,1051,-10
84895650965,84895650967,2,1536,1164,-10
84897275513,84897275515,2,1442,1913,-10
84899383198,84899383198,0,2217,2126,-10
84901607398,84901607401,3,1170,1757,-10
84902611171,84902611180,9,5696,2013,-10
84905689450,84905689451,1,1162,1055,-10
84906337187,84906337190,3,469,1605,-10
84908721843,84908721843,0,1370,1552,-10
84909544702,84909544702,0,1551,1870,-10
84913173366,84913173368,2,1204,1810,-10
84913957297,84913957301,4,2528,2257,-10
84920321483,84920321489,6,3094,1600,-10
84922804831,84922804834,3,2002,2080,-10
84923113567,84923113569,2,1581,2094,-10
84923987315,84923987318,3,2513,2029,-10
84925337403,84925337407,4,875,1091,-10
84926344176,84926344177,1,1333,1730,-10
84927589278,84927589279,1,2063,1888,-10
84929256402,84929256406,4,2003,1749,-10
84930460348,84930460350,2,1300,1204,-10
84932441475,84932441474,-1,960,590,-10
84932517202,84932517199,-3,1192,3694,-10
84937256934,84937256934,0,1462,1836,-10
84939325252,84939325253,1,1336,1400,-10
84945493398,84945493398,0,1550,1837,-10
84945603037,84945603037,0,2029,1970,-10
84948037817,84948037817,0,1297,1351,-10
84949321266,84949321269,3,1967,1886,-10
84949408181,84949408183,2,1814,1636,-10
84949667350,84949667351,1,1736,1433,-10
84950055995,84950055998,3,1377,1312,-10
84954857665,84954857667,2,1423,1256,-10
84955258718,84955258720,2,1662,1419,-10
84955974719,84955974721,2,2749,2674,-10
84956773840,84956773842,2,1685,1404,-10
84957215857,84957215853,-4,927,2089,-10
84960497654,84960497654,0,184,1028,-10
84964735117,84964735119,2,1375,1821,-10
84965298454,84965298455,1,1538,1512,-10
84966680090,84966680092,2,1781,1397,-10
84968298850,84968298852,2,1337,1442,-10
84968751892,84968751894,2,1413,1054,-10
84969942190,84969942194,4,1274,1004,-10
84971391830,84971391831,1,917,1943,-10
84972634419,84972634419,0,1019,1498,-10
84974366383,84974366385,2,1858,2315,-10
84976338655,84976338655,0,1216,1683,-10
84976432586,84976432590,4,1322,1195,-10
84979079713,84979079718,5,2707,1439,-10
84985983858,84985983862,4,1346,2028,-10
84986361024,84986361028,4,1741,2042,-10
84989775713,84989775716,3,1851,1480,-10
84992214346,84992214349,3,1916,1918,-10
84992736853,84992736857,4,2325,1280,-10
84996958133,84996958137,4,3328,1298,-10
84997622232,84997622234,2,1381,1860,-10
84997853909,84997853910,1,1706,1430,-10
85002191517,85002191519,2,2190,1750,-10
85003292077,85003292078,1,1619,1944,-10
85004769274,85004769275,1,1251,1164,-10
85006759274,85006759276,2,1489,1045,-10
85008106586,85008106586,0,1249,1318,-10
85010697593,85010697595,2,1427,1296,-10
85011176076,85011176079,3,1670,1506,-10
85018142633,85018142635,2,1322,1480,-10
85018303138,85018303139,1,1340,1485,-10
85019739975,85019739979,4,1821,1625,-10
85019780915,85019780916,1,1984,2161,-10
85021476757,85021476759,2,1151,1066,-10
85021508563,85021508565,2,1598,869,-10
85021701045,85021701046,1,1875,1242,-10
85022651571,85022651574,3,1417,1103,-10
85024159250,85024159257,7,1414,1113,-10
85024975862,85024975864,2,1953,1450,-10
85025038076,85025038078,2,1705,1408,-10
85025870230,85025870233,3,2429,1749,-10
85027091151,85027091154,3,1818,1319,-10
85027598028,85027598033,5,21629,26758,-10
85027645700,85027645702,2,1737,1651,-10
85030676388,85030676391,3,1813,1501,-10
85032926214,85032926216,2,2008,1433,-10
85036399310,85036399313,3,1322,1524,-10
85038451042,85038451044,2,1717,2158,-10
85039728717,85039728713,-4,1389,6050,-10
85042363689,85042363690,1,1489,1549,-10
85042597502,85042597502,0,1184,1154,-10
85042875010,85042874994,-16,1129,1131,-10
85044715102,85044715104,2,2167,1806,-10
85052214410,85052214411,1,1347,1619,-10
85054972184,85054972188,4,1157,810,-10
85056314270,85056314271,1,1517,2218,-10
85059122473,85059122474,1,1569,1484,-10
85061943889,85061943891,2,1313,1269,-10
85065840757,85065840757,0,1333,1301,-10
85067285506,85067285506,0,1853,2155,-10
85068735046,85068735050,4,3199,2943,-10
85070678105,85070678102,-3,20218,14527,-10
85072819939,85072819942,3,1477,1764,-10
85074207497,85074207502,5,2083,1299,-10
85075191159,85075191139,-20,1597,1489,-10
85075681660,85075681660,0,1346,1915,-10
85079258296,85079258296,0,1483,1774,-10
85081407457,85081407458,1,1474,1534,-10
85082014842,85082014844,2,1074,1724,-10
85082491292,85082491314,22,1342,1190,-10
85083329119,85083329123,4,1139,1571,-10
85085532776,85085532778,2,2002,1785,-10
85091626430,85091626433,3,892,893,-10
85091823254,85091823256,2,1425,1597,-10
85092406567,85092406571,4,2328,1829,-10
85096598762,85096598765,3,1666,1148,-10
85097203769,85097203771,2,1308,1780,-10
85098405373,85098405375,2,1415,2245,-10
85100350587,85100350588,1,1382,1994,-10
85104699137,85104699138,1,1443,1539,-10
85106539530,85106539531,1,1320,1950,-10
85106589155,85106589158,3,950,1064,-10
85107601527,85107601527,0,1183,1214,-10
85107657558,85107657559,1,1494,1430,-10
85111113352,85111113353,1,1505,1462,-10
85111312933,85111312935,2,1995,1568,-10
85111730828,85111730829,1,1101,966,-10
85112401522,85112401522,0,1242,1319,-10
85112964354,85112964348,-6,901,5906,-10
85114209354,85114209358,4,2018,1434,-10
85114304877,85114304883,6,3051,1207,-10
85116064558,85116064561,3,1809,1795,-10
85120000954,85120000957,3,2041,2125,-10
85120270354,85120270367,13,978,4002,-10
85129165873,85129165874,1,1727,1589,-10
85131465874,85131465875,1,1478,1721,-10
85131639651,85131639655,4,1573,1255,-10
85133981983,85133981987,4,2068,1379,-10
85134253670,85134253670,0,1565,1883,-10
85136245067,85136245069,2,1328,1645,-10
85139615284,85139615290,6,1237,829,-10
85140465687,85140465690,3,1673,1211,-10
85140715078,85140715083,5,993,1360,-10
85145417990,85145417993,3,1100,1062,-10
85146549313,85146549319,6,19089,25216,-10
85147837887,85147837889,2,1331,1370,-10
85149310985,85149310986,1,1508,1162,-10
85160272950,85160272951,1,1333,1762,-10
85161376027,85161376030,3,4160,3511,-10
85167960590,85167960591,1,1722,1282,-10
85172986681,85172986683,2,541,1098,-10
85176424930,85176424934,4,1525,1659,-10
85179048738,85179048739,1,1899,1994,-10
85179097443,85179097447,4,1347,1373,-10
85179199101,85179199102,1,1748,1699,-10
85179320226,85179320235,9,936,843,-10
85181569112,85181569114,2,1868,2092,-10
85181904602,85181904605,3,1755,1366,-10
85182390954,85182390957,3,1198,2114,-10
85182868942,85182868935,-7,749,2918,-10
85184997583,85184997585,2,999,1148,-10
85186770701,85186770683,-18,1378,1377,-10
85188471507,85188471508,1,954,1877,-10
85189084758,85189084759,1,1219,1336,-10
85190270858,85190270858,0,1075,1077,-10
85193726073,85193726078,5,2147,1281,-10
85194698026,85194698031,5,1149,1342,-10
85195656194,85195656193,-1,742,794,-10
85196530865,85196530864,-1,1101,1678,-10
85199028822,85199028824,2,1680,1826,-10
85199628525,85199628525,0,1712,1822,-10
85201485265,85201485267,2,2072,1477,-10
85203187411,85203187414,3,1482,1297,-10
85203655501,85203655502,1,1872,1349,-10
85203832544,85203832547,3,1547,1273,-10
85205874538,85205874539,1,1694,1513,-10
85206100866,85206100863,-3,904,2086,-10
85209024355,85209024355,0,1379,1324,-10
85209129379,85209129381,2,1508,1084,-10
85213051988,85213051971,-17,1164,944,-10
85213721148,85213721147,-1,1091,1259,-10
85214283584,85214283584,0,1773,2428,-10
85219688821,85219688821,0,1618,1230,-10
85220531759,85220531762,3,1530,1624,-10
85221257573,85221257574,1,1618,1326,-10
85223543488,85223543489,1,1064,780,-10
85225694695,85225694697,2,1327,1917,-10
85226744258,85226744258,0,2064,1950,-10
85228476848,85228476847,-1,1163,1803,-10
85229833616,85229833615,-1,1020,960,-10
85231609743,85231609746,3,1340,1328,-10
85232178547,85232178549,2,1709,1478,-10
85232427564,85232427545,-19,1542,1224,-10
85233734373,85233734374,1,1782,1498,-10
85234620895,85234620895,0,1397,1872,-10
85234699850,85234699851,1,1656,1134,-10
85239880572,85239880571,-1,1401,1532,-10
85240308754,85240308767,13,111,532,-10
85244647650,85244647648,-2,1398,1816,-10
85244890469,85244890471,2,2261,2324,-10
85248407183,85248407186,3,1483,1379,-10
85249544158,85249544159,1,1841,1969,-10
85249746961,85249746961,0,997,1317,-10
85251146216,85251146217,1,1657,1825,-10
85252357030,85252357032,2,2852,2228,-10
85252871194,85252871193,-1,1529,1222,-10
85254959921,85254959916,-5,1460,3382,-10
85260464602,85260464603,1,1268,1688,-10
85261713249,85261713252,3,1087,1231,-10
85264856857,85264856852,-5,1540,3134,-10
85265626617,85265626619,2,1746,1967,-10
85268049218,85268049219,1,3193,3344,-10
85272061120,85272061126,6,14272,2211,-10
85272729754,85272729757,3,3325,3191,-10
85278669756,85278669758,2,1449,1766,-10
85278978153,85278978152,-1,1607,1400,-10
85284539883,85284539861,-22,1412,1714,-10
85284760618,85284760633,15,1693,1514,-10
85285322142,85285322149,7,2492,1484,-10
85286945629,85286945633,4,1583,1202,-10
85290307954,85290307955,1,1525,1440,-10
85291140195,85291140195,0,1620,1792,-10
85292032990,85292032991,1,1552,1357,-10
85292211961,85292211966,5,2015,1312,-10
85293675821,85293675823,2,1655,1022,-10
85295552938,85295552941,3,1513,1539,-10
85296827410,85296827390,-20,1385,1438,-10
85298221262,85298221262,0,1211,948,-10
85300910774,85300910775,1,1134,1821,-10
85301637758,85301637763,5,1979,1267,-10
85305252707,85305252708,1,2141,1790,-10
85306447932,85306447935,3,1574,1330,-10
85307031378,85307031379,1,2092,1509,-10
85308892546,85308892546,0,1002,777,-10
85310525242,85310525243,1,1715,1367,-10
85310602505,85310602501,-4,25121,15810,-10
85313516543,85313516542,-1,1097,1862,-10
85315025932,85315025926,-6,1574,6142,-10
85317038231,85317038232,1,1773,1806,-10
85320648052,85320648053,1,1567,1443,-10
85324481018,85324481018,0,1766,1738,-10
85326414316,85326414313,-3,1159,1212,-10
85328551079,85328551081,2,1783,1322,-10
85328872290,85328872275,-15,2408,1653,-10
85329114441,85329114442,1,1413,1446,-10
85330132430,85330132432,2,1782,1496,-10
85330185177,85330185178,1,1174,1049,-10
85332149370,85332149375,5,1634,1201,-10
85332443603,85332443604,1,1469,1437,-10
85336011798,85336011798,0,832,1778,-10
85336668822,85336668833,11,617,2690,-10
85341216275,85341216275,0,1435,1200,-10
85341395358,85341395358,0,989,767,-10
85342110297,85342110300,3,2187,1558,-10
85344601520,85344601520,0,1186,1651,-10
85346274589,85346274586,-3,1669,1751,-10
85346827918,85346827922,4,2064,1414,-10
85346860750,85346860730,-20,2271,1863,-10
85348066027,85348066027,0,1147,1826,-10
85348128612,85348128613,1,1348,1280,-10
85352736718,85352736718,0,1309,1880,-10
85353500898,85353500882,-16,1239,1826,-10
85354989150,85354989151,1,923,1100,-10
85355803746,85355803747,1,1077,1543,-10
85357131437,85357131438,1,1738,1569,-10
85357662794,85357662794,0,1795,1544,-10
85358208568,85358208571,3,1661,1017,-10
85375656906,85375656910,4,2149,1389,-10
85375791575,85375791575,0,1521,622,-10
85381284011,85381284014,3,1308,1429,-10
85381420649,85381420650,1,1740,1873,-10
85381486127,85381486128,1,1994,1434,-10
85382433927,85382433929,2,1415,1349,-10
85382810525,85382810527,2,1284,1018,-10
85385639494,85385639496,2,1420,1788,-10
85386019694,85386019695,1,1365,1910,-10
85389984673,85389984674,1,1148,1380,-10
85391961379,85391961380,1,1833,1785,-10
85394731174,85394731177,3,2723,1456,-10
85397564016,85397564019,3,1009,885,-10
85400983326,85400983330,4,1664,1455,-10
85401177258,85401177263,5,1888,1640,-10
85402646702,85402646705,3,2029,1840,-10
85402689737,85402689739,2,1899,1934,-10
85402787431,85402787437,6,2722,2031,-10
85403655942,85403655944,2,1459,1668,-10
85405741407,85405741410,3,812,813,-10
85408443626,85408443627,1,1760,1792,-10
85409188262,85409188263,1,787,1234,-10
85410164290,85410164290,0,1614,1242,-10
85410521807,85410521811,4,1611,1138,-10
85411961015,85411961018,3,1306,1356,-10
85412546625,85412546626,1,1188,1303,-10
85412708989,85412708992,3,1481,1124,-10
85413329969,85413329972,3,1912,971,-10
85417843409,85417843411,2,1855,1472,-10
85418670818,85418670825,7,2908,1195,-10
85420518429,85420518430,1,1223,1519,-10
85424258130,85424258130,0,1493,1685,-10
85425491971,85425491971,0,1026,1264,-10
85429602618,85429602621,3,1279,1769,-10
85433382573,85433382576,3,1374,1722,-10
85435029466,85435029481,15,2026,1132,-10
85437179397,85437179398,1,2024,1363,-10
85437225518,85437225518,0,1580,1416,-10
85438224419,85438224424,5,1217,1424,-10
85440870368,85440870370,2,1967,1997,-10
85441282843,85441282850,7,71578,32996,-10
85443800751,85443800753,2,1096,1281,-10
85447545559,85447545562,3,1593,1199,-10
85450913751,85450913756,5,1242,1434,-10
85450966067,85450966072,5,2410,1623,-10
85452282519,85452282519,0,1187,1573,-10
85452979406,85452979407,1,1785,1770,-10
85453235766,85453235768,2,1443,1847,-10
85453558700,85453558702,2,1560,1450,-10
85456016338,85456016340,2,1822,1837,-10
85457221741,85457221743,2,1439,1081,-10
85459488144,85459488145,1,1864,2084,-10
85460105614,85460105614,0,1377,1420,-10
85461071844,85461071846,2,38041,35439,-10
85461380302,85461380303,1,1718,1764,-10
85463466185,85463466188,3,1134,1695,-10
85464904854,85464904858,4,1942,1903,-10
85465006005,85465006006,1,1095,1136,-10
85465749933,85465749932,-1,1028,2144,-10
85472940402,85472940405,3,2216,1599,-10
85473726342,85473726343,1,1478,1832,-10
85475483823,85475483826,3,1580,1670,-10
85477860352,85477860354,2,1792,1981,-10
85479623724,85479623725,1,1559,1571,-10
85481121554,85481121556,2,1227,1790,-10
85481418413,85481418413,0,1828,1970,-10
85481715314,85481715318,4,1502,1938,-10
85483126688,85483126691,3,1765,1696,-10
85488383373,85488383377,4,1794,1521,-10
85493827208,85493827209,1,1981,2781,-10
85495254508,85495254509,1,914,1462,-10
85501980299,85501980302,3,1906,2197,-10
85503166892,85503166895,3,1776,1309,-10
85503243433,85503243434,1,1066,1287,-10
85504775310,85504775313,3,1181,1444,-10
85504909202,85504909202,0,905,1335,-10
85506038026,85506038029,3,1968,2402,-10
85506090126,85506090130,4,1623,1317,-10
85506125974,85506125978,4,1925,1184,-10
85507139781,85507139782,1,1140,1461,-10
85508979098,85508979101,3,1671,1419,-10
85509275766,85509275769,3,1219,1209,-10
85510348145,85510348146,1,1515,1720,-10
85512505297,85512505303,6,2587,1394,-10
85513201874,85513201878,4,1519,1192,-10
85515951119,85515951120,1,1114,2069,-10
85516998758,85516998758,0,1546,1950,-10
85518424124,85518424125,1,1603,1989,-10
85525859170,85525859171,1,1817,1322,-10
85528013814,85528013812,-2,925,1071,-10
85529247919,85529247919,0,1703,1936,-10
85531320958,85531320958,0,2176,1713,-10
85533109342,85533109342,0,1792,1782,-10
85535545881,85535545882,1,1507,1950,-10
85536306609,85536306613,4,1547,1293,-10
85536828913,85536828914,1,1437,1207,-10
85537395646,85537395650,4,1996,1678,-10
85539789105,85539789108,3,1012,1283,-10
85548026395,85548026396,1,1308,1845,-10
85548313671,85548313674,3,1205,1053,-10
85549675349,85549675351,2,2560,2101,-10
85550934971,85550934974,3,1900,1539,-10
85551203545,85551203547,2,1235,859,-10
85557483994,85557483999,5,2080,1838,-10
85558962864,85558962866,2,2636,2136,-10
85560607941,85560607943,2,1821,1407,-10
85562070338,85562070342,4,1056,1193,-10
85565789774,85565789775,1,1847,1891,-10
85568103103,85568103106,3,1380,1491,-10
85570251921,85570251921,0,1239,1893,-10
85572025317,85572025318,1,1876,2113,-10
85573813525,85573813525,0,1510,1751,-10
85573976320,85573976321,1,2215,1211,-10
85574277260,85574277260,0,1162,2091,-10
85574451538,85574451538,0,1882,2243,-10
85577814746,85577814745,-1,653,1204,-10
85578071706,85578071710,4,1892,1889,-10
85578773874,85578773877,3,1618,1385,-10
85579186498,85579186501,3,2511,1520,-10
85580657772,85580657775,3,1706,1618,-10
85582207922,85582207925,3,1533,1166,-10
85586810749,85586810750,1,1680,2041,-10
85588277798,85588277800,2,6259,5660,-10
85596181489,85596181491,2,1644,1238,-10
85597598114,85597598117,3,1225,1664,-10
85599125346,85599125349,3,1509,1549,-10
85602800583,85602800582,-1,1028,1788,-10
85603007317,85603007322,5,2358,1533,-10
85603496546,85603496550,4,1672,1840,-10
85607390803,85607390803,0,1425,1495,-10
85608145806,85608145819,13,1627,1759,-10
85611516282,85611516286,4,1990,1600,-10
85612203350,85612203351,1,2009,1770,-10
85612872813,85612872815,2,1363,1246,-10
85618409206,85618409209,3,858,619,-10
85620994245,85620994247,2,1159,1010,-10
85621025178,85621025162,-16,1177,1165,-10
85623251990,85623251995,5,1369,1625,-10
85624734033,85624734035,2,1413,1041,-10
85625642027,85625642031,4,1770,1470,-10
85626990206,85626990209,3,1793,1732,-10
85627189652,85627189652,0,1626,1753,-10
85631397885,85631397887,2,831,945,-10
85636428211,85636428214,3,1913,1072,-10
85637254957,85637254958,1,1270,1396,-10
85640420644,85640420647,3,1970,1526,-10
85643233353,85643233354,1,1852,1575,-10
85644852574,85644852574,0,1428,1388,-10
85645902270,85645902269,-1,1899,1837,-10
85646518275,85646518267,-8,1078,914,-10
85649648510,85649648513,3,1668,1637,-10
85652723303,85652723303,0,909,1575,-10
85653815133,85653815135,2,1649,1272,-10
85656076007,85656076003,-4,1199,2930,-10
85657575610,85657575610,0,1204,2737,-10
85662087067,85662087069,2,1666,1456,-10
85663674651,85663674652,1,1404,1745,-10
85665538898,85665538899,1,1214,1174,-10
85667915366,85667915369,3,1496,1927,-10
85673343719,85673343722,3,1250,986,-10
85675601182,85675601185,3,1530,1319,-10
85678252800,85678252802,2,1893,1637,-10
85678730480,85678730483,3,1456,2362,-10
85679801320,85679801314,-6,1452,6850,-10
85687140272,85687140273,1,1305,1154,-10
85688726568,85688726570,2,1415,1213,-10
85691316456,85691316458,2,2394,2069,-10
85693008274,85693008275,1,1959,2698,-10
85697368575,85697368577,2,1158,1286,-10
85699589598,85699589602,4,1594,1152,-10
85701441179,85701441180,1,2062,1418,-10
85701826171,85701826171,0,1687,1523,-10
85704889441,85704889441,0,1376,1253,-10
85705170405,85705170404,-1,683,1447,-10
85705600764,85705600764,0,1311,1423,-10
85710499405,85710499410,5,1365,1028,-10
85711997813,85711997815,2,1529,1034,-10
85714458466,85714458466,0,1255,1299,-10
85714939002,85714939002,0,1273,1829,-10
85717174508,85717174509,1,1831,1164,-10
85717244218,85717244225,7,1669,1923,-10
85719689105,85719689107,2,1299,1536,-10
85723408957,85723408961,4,1652,1578,-10
85730051638,85730051639,1,1658,1042,-10
85730172687,85730172667,-20,1793,1474,-10
85730280286,85730280290,4,1498,1363,-10
85732263162,85732263166,4,1290,1489,-10
85733990754,85733990758,4,16268,12572,-10
85735809875,85735809874,-1,935,1493,-10
85738584501,85738584503,2,1311,1193,-10
85739019803,85739019788,-15,1300,734,-10
85745022708,85745022711,3,951,1112,-10
85747123990,85747123994,4,1202,1403,-10
85748673112,85748673116,4,1675,903,-10
85750622181,85750622186,5,2243,1015,-10
85751134241,85751134248,7,1815,1339,-10
85751284486,85751284466,-20,1016,1090,-10
85753090170,85753090171,1,1501,1189,-10
85755010554,85755010557,3,1451,1887,-10
85755800600,85755800591,-9,1147,1475,-10
85758930262,85758930265,3,1769,1481,-10
85759453889,85759453894,5,1648,1955,-10
85763401563,85763401565,2,1591,1290,-10
85763552366,85763552367,1,1791,1269,-10
85765095910,85765095912,2,1389,1970,-10
85765377765,85765377766,1,1730,1596,-10
85765635025,85765635030,5,1533,895,-10
85767074990,85767074993,3,1944,1873,-10
85767289410,85767289410,0,913,1396,-10
85768737310,85768737311,1,986,1639,-10
85770493301,85770493302,1,1017,1071,-10
85771753822,85771753822,0,1830,1888,-10
85773766092,85773766094,2,1909,1507,-10
85774798137,85774798141,4,4282,2358,-10
85774901467,85774901469,2,702,898,-10
85776725781,85776725761,-20,1597,1482,-10
85778634607,85778634608,1,1110,1641,-10
85778810390,85778810408,18,1077,1356,-10
85779349629,85779349632,3,1375,1907,-10
85779606518,85779606522,4,3372,3856,-10
85782010831,85782010836,5,1450,1578,-10
85783774673,85783774674,1,1492,1333,-10
85789417402,85789417403,1,1356,1380,-10
85789449239,85789449248,9,1851,1619,-10
85790954082,85790954086,4,1331,922,-10
85791573871,85791573883,12,1292,1521,-10
85792557646,85792557648,2,1941,1628,-10
85797594287,85797594289,2,2027,1191,-10
85799248543,85799248545,2,2012,2345,-10
85800185034,85800185033,-1,1738,1663,-10
85800931413,85800931414,1,1441,1581,-10
85806188495,85806188497,2,1308,1430,-10
85806613005,85806613008,3,2011,1603,-10
85807830145,85807830149,4,1744,1541,-10
85808342752,85808342754,2,1341,975,-10
85809571002,85809571009,7,3297,1571,-10
85813295477,85813295478,1,1742,1945,-10
85819834726,85819834730,4,1679,1496,-10
85820386163,85820386166,3,1499,1523,-10
85827056493,85827056494,1,1688,2300,-10
85828190421,85828190423,2,1839,2420,-10
85829967987,85829967982,-5,969,3462,-10
85832942603,85832942607,4,1705,1386,-10
85834706587,85834706587,0,1604,1489,-10
85835116599,85835116578,-21,1562,2298,-10
85835946381,85835946383,2,2042,1594,-10
85839735228,85839735232,4,2245,1844,-10
85840749755,85840749754,-1,728,1198,-10
85844299556,85844299558,2,1336,1211,-10
85844720413,85844720416,3,1512,1229,-10
85845591806,85845591809,3,1493,1451,-10
85847268070,85847268071,1,1615,2050,-10
85851456009,85851456011,2,1868,1622,-10
85858211659,85858211658,-1,1261,1921,-10
85862737601,85862737602,1,1350,1067,-10
85865253024,85865253026,2,1160,1736,-10
85868367124,85868367124,0,1423,1544,-10
85873172707,85873172711,4,1622,1896,-10
85873682190,85873682190,0,1519,1493,-10
85876166901,85876166903,2,1974,1705,-10
85876419254,85876419255,1,1138,1319,-10
85878359413,85878359414,1,1501,1206,-10
85881005453,85881005453,0,1743,2849,-10
85881118897,85881118877,-20,1288,1841,-10
85883016247,85883016253,6,12314,6936,-10
85884063271,85884063266,-5,1166,2395,-10
85884861191,85884861194,3,1446,1368,-10
85886767174,85886767175,1,1177,1350,-10
85891690554,85891690555,1,1475,1482,-10
85891811277,85891811278,1,1818,1410,-10
85892277142,85892277142,0,2574,2059,-10
85894239831,85894239834,3,1887,1649,-10
85894862202,85894862203,1,1755,1555,-10
85894932851,85894932851,0,916,736,-10
85896108142,85896108143,1,1998,1863,-10
85899205776,85899205778,2,1546,1430,-10
85900033767,85900033769,2,1212,1429,-10
85902078965,85902078967,2,2200,2050,-10
85902565499,85902565503,4,1702,1256,-10
85903250989,85903250991,2,1390,1682,-10
85904141741,85904141741,0,1266,1168,-10
85906880938,85906880941,3,1304,1284,-10
85908872218,85908872218,0,1435,1751,-10
85909580673,85909580674,1,1769,1772,-10
85915163005,85915163006,1,1334,1492,-10
85915726260,85915726262,2,1454,1282,-10
85916701401,85916701401,0,1534,2010,-10
85917568999,85917569001,2,1230,1927,-10
85917779507,85917779522,15,796,1612,-10
85920511002,85920511004,2,1847,1762,-10
85926324846,85926324847,1,1355,1143,-10
85926511746,85926511730,-16,1432,1223,-10
85928906410,85928906413,3,1194,1248,-10
85930524581,85930524584,3,1565,1622,-10
85931383295,85931383297,2,1588,1132,-10
85933554858,85933554861,3,1192,1164,-10
85934987719,85934987721,2,1750,1859,-10
85935655485,85935655491,6,1793,781,-10
85939095915,85939095914,-1,786,901,-10
85940098385,85940098394,9,10515,35950,-10
85941016282,85941016285,3,5172,3483,-10
85941496745,85941496747,2,1981,1417,-10
85945070114,85945070118,4,710,1070,-10
85945732227,85945732228,1,1377,1966,-10
85951490038,85951490040,2,12480,11349,-10
85952033083,85952033081,-2,796,1484,-10
85956065003,85956065004,1,1738,1885,-10
85956299818,85956299817,-1,1442,1689,-10
85956559613,85956559617,4,1780,1929,-10
85960074514,85960074517,3,1487,1463,-10
85961822661,85961822665,4,1238,1087,-10
85962721767,85962721771,4,1788,1366,-10
85965159306,85965159307,1,1153,1172,-10
85966201178,85966201180,2,1635,1631,-10
85970898417,85970898419,2,1646,1292,-10
85971207614,85971207616,2,1999,1421,-10
85972850194,85972850193,-1,1371,1224,-10
85973109522,85973109526,4,1493,1491,-10
85973280278,85973280281,3,1581,1208,-10
85975793370,85975793373,3,2102,1788,-10
85977025684,85977025687,3,1003,1359,-10
85978011594,85978011596,2,1247,1495,-10
85979106786,85979106787,1,2054,1508,-10
85979196673,85979196675,2,1713,1615,-10
85979408692,85979408689,-3,1057,1559,-10
85985731545,85985731547,2,1202,1239,-10
85987186062,85987186065,3,1610,1426,-10
85987680459,85987680462,3,1699,1738,-10
85987767217,85987767219,2,1559,1700,-10
85989525840,85989525841,1,1567,1604,-10
85993094234,85993094233,-1,1144,1676,-10
85993227322,85993227326,4,1661,1707,-10
85994486049,85994486053,4,1557,1219,-10
85994542542,85994542523,-19,1466,1043,-10
85995716542,85995716544,2,1480,1889,-10
85996441797,85996441798,1,1357,1421,-10
85996586131,85996586129,-2,3891,8609,-10
85997017043,85997017045,2,1147,1005,-10
85999314749,85999314749,0,1199,1271,-10
86002778754,86002778757,3,2004,1519,-10
86002932231,86002932232,1,1101,1607,-10
86004506078,86004506079,1,1611,1321,-10
86006938995,86006938994,-1,1518,2320,-10
86008604478,86008604478,0,937,1040,-10
86009544408,86009544398,-10,273,1892,-10
86011112226,86011112229,3,1128,1445,-10
86015980274,86015980275,1,1610,1840,-10
86016277362,86016277363,1,1670,2051,-10
86017000393,86017000389,-4,1431,3467,-10
86018310880,86018310881,1,1680,2028,-10
86018987690,86018987692,2,1789,1685,-10
86019164864,86019164866,2,1822,1457,-10
86022579374,86022579376,2,1788,2463,-10
86023343967,86023343967,0,1373,1590,-10
86025748920,86025748923,3,974,1141,-10
86026280819,86026280833,14,2320,1798,-10
86028951025,86028951017,-8,2082,6977,-10
86032604524,86032604526,2,2687,1971,-10
86033472854,86033472854,0,1563,1719,-10
86034097210,86034097210,0,1449,2162,-10
86034659845,86034659846,1,1230,1251,-10
86035039038,86035039017,-21,950,633,-10
86035755761,86035755761,0,1500,1541,-10
86036231673,86036231677,4,1115,1086,-10
86037121249,86037121251,2,809,982,-10
86037811989,86037811994,5,1513,1505,-10
86042663946,86042663946,0,1879,1491,-10
86042843891,86042843892,1,937,1526,-10
86046075406,86046075421,15,1064,1338,-10
86052429866,86052429859,-7,1243,4337,-10
86053004345,86053004356,11,10989,47147,-10
86055312715,86055312718,3,1921,1960,-10
86056846388,86056846390,2,1489,1338,-10
86057534250,86057534253,3,1668,1490,-10
86057591558,86057591538,-20,1587,1187,-10
86061295903,86061295904,1,1639,1955,-10
86066963615,86066963616,1,1074,1225,-10
86069300826,86069300833,7,1810,1382,-10
86071165749,86071165754,5,1969,1872,-10
86071800973,86071800973,0,1342,1636,-10
86072491383,86072491387,4,1503,1679,-10
86074154604,86074154605,1,1568,1904,-10
86074290457,86074290458,1,1737,1162,-10
86076719767,86076719769,2,1494,1986,-10
86080070178,86080070177,-1,1692,2548,-10
86081566792,86081566792,0,1870,2114,-10
86082616287,86082616289,2,1553,1373,-10
86083440182,86083440185,3,2010,1854,-10
86085790472,86085790472,0,1941,2583,-10
86085979971,86085979971,0,1233,1182,-10
86086351605,86086351606,1,1526,1669,-10
86087735884,86087735885,1,1372,2024,-10
86088633470,86088633470,0,1151,1841,-10
86089724502,86089724502,0,1578,1695,-10
86090575678,86090575682,4,1355,957,-10
86091853511,86091853513,2,1471,1659,-10
86092120126,86092120125,-1,1633,1414,-10
86092227081,86092227081,0,1801,2000,-10
86093701363,86093701366,3,2030,2236,-10
86097112537,86097112538,1,1880,2088,-10
86097814079,86097814081,2,844,1054,-10
86098867854,86098867855,1,1289,1133,-10
86099154006,86099154007,1,2029,1827,-10
86099952790,86099952790,0,1688,1500,-10
86104941413,86104941415,2,1315,1878,-10
86111992990,86111992985,-5,2427,5785,-10
86112672462,86112672463,1,1118,1288,-10
86112756049,86112756051,2,1217,1337,-10
86115832037,86115832038,1,1248,1327,-10
86117107842,86117107842,0,984,1525,-10
86117653969,86117653975,6,4661,1587,-10
86119031933,86119031934,1,1749,1375,-10
86119166171,86119166171,0,1592,1596,-10
86120145018,86120145023,5,4656,2008,-10
86120370468,86120370468,0,1470,2450,-10
86121537425,86121537430,5,1112,855,-10
86124923785,86124923787,2,1770,2099,-10
86128932450,86128932453,3,1735,1541,-10
86131410385,86131410386,1,1096,1513,-10
86134213064,86134213066,2,1702,2286,-10
86134789738,86134789738,0,998,1115,-10
86136823047,86136823046,-1,1183,1558,-10
86141595742,86141595743,1,1668,2398,-10
86142077382,86142077384,2,1293,1868,-10
86143328326,86143328327,1,1464,1915,-10
86144313890,86144313890,0,1795,1428,-10
86145613932,86145613931,-1,1463,1689,-10
86146968756,86146968757,1,7693,10597,-10
86148290644,86148290645,1,1614,1706,-10
86148526239,86148526239,0,2199,2177,-10
86151575434,86151575438,4,1166,1195,-10
86152760923,86152760924,1,1324,1445,-10
86156370201,86156370206,5,2640,1966,-10
86159432699,86159432700,1,1478,1607,-10
86161317042,86161317044,2,6324,32264,-10
86161495946,86161495947,1,1099,1401,-10
86163168966,86163168971,5,1105,764,-10
86163854942,86163854944,2,2003,1324,-10
86165382361,86165382370,9,9166,1910,-10
86165679793,86165679793,0,1160,1491,-10
86169001206,86169001207,1,1499,1457,-10
86170150278,86170150277,-1,1344,1627,-10
86171483197,86171483202,5,1438,1051,-10
86173661234,86173661234,0,2007,1834,-10
86174884334,86174884336,2,1704,2485,-10
86175130452,86175130456,4,1828,1682,-10
86175629417,86175629410,-7,773,1954,-10
86178194131,86178194132,1,2190,1740,-10
86178228586,86178228587,1,1310,1221,-10
86179795323,86179795323,0,1016,1348,-10
86179945565,86179945567,2,1403,1637,-10
86182595247,86182595247,0,945,1558,-10
86186376137,86186376141,4,1988,1985,-10
86191029138,86191029139,1,1588,1330,-10
86197806485,86197806488,3,1346,1311,-10
86199437297,86199437298,1,1675,871,-10
86199917406,86199917403,-3,1144,2703,-10
86201736322,86201736325,3,1427,1195,-10
86202125713,86202125714,1,1628,1312,-10
86204222171,86204222174,3,2411,2160,-10
86207013572,86207013573,1,1508,1769,-10
86207212750,86207212752,2,1542,1963,-10
86208836158,86208836161,3,1030,1338,-10
86211369250,86211369253,3,2001,2043,-10
86211441618,86211441623,5,3646,2499,-10
86211734010,86211734010,0,1804,1397,-10
86213307870,86213307872,2,1617,1795,-10
86214488794,86214488796,2,1652,1634,-10
86215414174,86215414170,-4,603,2363,-10
86218347460,86218347462,2,1506,2155,-10
86218842298,86218842282,-16,1339,1166,-10
86219508662,86219508665,3,1612,1546,-10
86219937367,86219937370,3,1839,1605,-10
86220891242,86220891243,1,1630,1307,-10
86220968172,86220968172,0,2772,4692,-10
86221563242,86221563244,2,1890,1825,-10
86222227002,86222227002,0,1419,1425,-10
86222646179,86222646181,2,866,943,-10
86223495783,86223495788,5,1694,1542,-10
86226208367,86226208368,1,3922,4166,-10
86226442206,86226442213,7,2065,1390,-10
86228021786,86228021791,5,1942,1656,-10
86228329676,86228329677,1,1854,1554,-10
86229960422,86229960424,2,1697,1285,-10
86231399508,86231399509,1,1471,1750,-10
86231497112,86231497106,-6,1352,1664,-10
86233493942,86233493943,1,1511,1353,-10
86237675246,86237675248,2,2135,1849,-10
86237738585,86237738587,2,1225,1258,-10
86240962701,86240962704,3,1840,1860,-10
86242959309,86242959310,1,1652,2348,-10
86243775096,86243775089,-7,655,9510,-10
86244768010,86244768012,2,1370,1615,-10
86245306829,86245306833,4,1896,1717,-10
86246636085,86246636086,1,1556,1911,-10
86248921678,86248921681,3,794,1365,-10
86249113146,86249113154,8,1996,1371,-10
86254839142,86254839139,-3,1105,1880,-10
86259700734,86259700735,1,1809,1997,-10
86259807418,86259807438,20,44249,18528,-10
86263429060,86263429062,2,1420,1457,-10
86266270970,86266270970,0,1296,1758,-10
86267695054,86267695055,1,1409,1453,-10
86269562512,86269562515,3,1378,1180,-10
86270314801,86270314782,-19,1220,1230,-10
86270621414,86270621419,5,1559,1477,-10
86273932057,86273932058,1,949,1011,-10
86275939797,86275939798,1,2182,1536,-10
86277170063,86277170064,1,1995,1704,-10
86283580858,86283580860,2,1734,1725,-10
86284716157,86284716158,1,1744,1243,-10
86285994228,86285994230,2,2470,2144,-10
86287650213,86287650215,2,1300,1273,-10
86289064291,86289064291,0,732,1300,-10
86291635728,86291635729,1,1476,1706,-10
86293192373,86293192378,5,1559,1965,-10
86295082078,86295082081,3,1732,1818,-10
86304922905,86304922906,1,922,1313,-10
86309924386,86309924389,3,1532,1589,-10
86314393091,86314393093,2,1857,1732,-10
86314737243,86314737246,3,1398,1540,-10
86315957611,86315957611,0,1070,1610,-10
86316445783,86316445787,4,1534,1554,-10
86317019787,86317019789,2,1614,1480,-10
86317626181,86317626182,1,1246,1044,-10
86320305970,86320305970,0,1440,1285,-10
86323483354,86323483359,5,3710,2780,-10
86323947250,86323947252,2,1770,1581,-10
86324001654,86324001657,3,1336,1274,-10
86327709985,86327709986,1,1260,1178,-10
86329921704,86329921714,10,10972,41885,-10
86330235081,86330235082,1,1610,1932,-10
86330926765,86330926767,2,1421,1605,-10
86332004146,86332004153,7,3406,1666,-10
86339040873,86339040874,1,1331,1467,-10
86339074863,86339074857,-6,2599,8833,-10
86340839850,86340839850,0,1654,1711,-10
86340990359,86340990361,2,1928,2136,-10
86342281937,86342281941,4,1211,927,-10
86347985502,86347985501,-1,1277,1384,-10
86349023513,86349023514,1,2039,1995,-10
86351491829,86351491830,1,1395,1345,-10
86357459182,86357459184,2,1454,1823,-10
86358634917,86358634924,7,16386,36527,-10
86361163882,86361163882,0,1592,1735,-10
86361858887,86361858889,2,1592,1084,-10
86363786121,86363786127,6,1858,1689,-10
86364170683,86364170693,10,14807,32667,-10
86364322900,86364322901,1,1387,1644,-10
86364818130,86364818134,4,1415,1363,-10
86367408622,86367408622,0,827,1573,-10
86367743184,86367743185,1,2156,1929,-10
86374780590,86374780593,3,1528,1545,-10
86375152335,86375152336,1,1525,1558,-10
86376258534,86376258533,-1,778,1418,-10
86377867279,86377867281,2,1237,1490,-10
86379196878,86379196881,3,2270,1783,-10
86379510217,86379510218,1,1561,1414,-10
86383534649,86383534651,2,1660,984,-10
86384652609,86384652611,2,1031,1231,-10
86385111861,86385111863,2,1662,1442,-10
86388301965,86388301967,2,1330,1556,-10
86388703705,86388703707,2,1858,1352,-10
86389564742,86389564726,-16,1195,1173,-10
86393851637,86393851637,0,2178,1721,-10
86394089886,86394089889,3,2168,1751,-10
86395620070,86395620069,-1,1924,2143,-10
86396715137,86396715138,1,1988,1537,-10
86398614117,86398614114,-3,2360,2533,-10
86401873689,86401873691,2,1046,1229,-10
86404562659,86404562659,0,989,925,-10
86404735540,86404735542,2,1400,1351,-10
86404848170,86404848190,20,932,3338,-10
86405058170,86405058172,2,1872,1266,-10
86406275075,86406275074,-1,1269,752,-10
86409404419,86409404422,3,1527,1077,-10
86414156086,86414156089,3,2115,2586,-10
86414431489,86414431490,1,1735,1874,-10
86414489083,86414489083,0,1074,1282,-10
86416660156,86416660138,-18,157,1165,-10
86418086334,86418086335,1,1778,2132,-10
86421104722,86421104721,-1,1260,1146,-10
86421536176,86421536170,-6,1015,5532,-10
86424964358,86424964361,3,2268,2125,-10
86427945628,86427945630,2,1528,1045,-10
86429491753,86429491755,2,1909,1627,-10
86429752100,86429752098,-2,1188,1206,-10
86438092266,86438092268,2,1892,2025,-10
86439494261,86439494262,1,1264,1121,-10
86442881024,86442881026,2,890,1213,-10
86446385783,86446385784,1,1338,1468,-10
86449631605,86449631606,1,1996,2292,-10
86453885490,86453885493,3,1578,1176,-10
86455368894,86455368894,0,1250,1465,-10
86456102895,86456102897,2,2020,2036,-10
86458265131,86458265131,0,987,1471,-10
86460918999,86460919006,7,6541,1848,-10
86463637748,86463637764,16,1520,1127,-10
86463778009,86463778010,1,1890,1462,-10
86465588874,86465588877,3,2219,1482,-10
86471937912,86471937913,1,1600,2213,-10
86473738919,86473738922,3,1618,1895,-10
86475633517,86475633519,2,1802,1606,-10
86478927086,86478927086,0,5910,8038,-10
86478989893,86478989894,1,1792,1488,-10
86479617983,86479617987,4,1403,1425,-10
86483497302,86483497303,1,1362,1074,-10
86484452546,86484452546,0,1496,1381,-10
86484674681,86484674683,2,1466,917,-10
86484912919,86484912922,3,2400,1628,-10
86488136798,86488136804,6,971,952,-10
86496808457,86496808458,1,1891,1556,-10
86498249830,86498249832,2,1665,1791,-10
86499870890,86499870894,4,1652,932,-10
86500631494,86500631496,2,798,1123,-10
86503130104,86503130104,0,1452,2190,-10
86504469878,86504469881,3,1998,2302,-10
86507213592,86507213592,0,1113,1301,-10
86510892698,86510892701,3,1486,1073,-10
86516952747,86516952750,3,1635,1370,-10
86517067065,86517067066,1,1444,2092,-10
86518921605,86518921606,1,1465,1420,-10
86520353497,86520353499,2,1399,1774,-10
86521461970,86521461971,1,1524,1826,-10
86521737178,86521737198,20,686,938,-10
86522006506,86522006509,3,1219,1284,-10
86524296258,86524296260,2,1078,1524,-10
86526111247,86526111249,2,1750,1165,-10
86526522162,86526522165,3,1657,1430,-10
86528086017,86528086018,1,1989,1459,-10
86528887339,86528887342,3,1068,1249,-10
86530572555,86530572559,4,2434,1764,-10
86531584725,86531584729,4,1156,1046,-10
86531796641,86531796649,8,2610,1194,-10
86533707032,86533707051,19,1119,1047,-10
86536368897,86536368899,2,1698,2068,-10
86537874693,86537874693,0,1441,1939,-10
86538232371,86538232373,2,2024,1924,-10
86538497843,86538497851,8,1649,1233,-10
86548702922,86548702926,4,1841,1328,-10
86550163710,86550163712,2,1163,1143,-10
86552745428,86552745430,2,1446,1513,-10
86556835643,86556835643,0,1435,1452,-10
86557571895,86557571894,-1,1636,1767,-10
86558997312,86558997313,1,2012,1943,-10
86559534274,86559534275,1,1442,1363,-10
86559731497,86559731491,-6,4258,8183,-10
86560987157,86560987159,2,1783,1625,-10
86561224999,86561225016,17,1405,1046,-10
86563944685,86563944686,1,1571,1488,-10
86564210830,86564210838,8,3305,1926,-10
86564705915,86564705917,2,941,1081,-10
86565628762,86565628766,4,3301,1367,-10
86567112705,86567112706,1,1384,1212,-10
86568788142,86568788146,4,1916,1161,-10
86572573309,86572573311,2,1619,1726,-10
86574019616,86574019618,2,1890,1005,-10
86575059599,86575059598,-1,1900,2700,-10
86575508391,86575508392,1,1528,1386,-10
86576106218,86576106218,0,2015,1778,-10
86582503361,86582503363,2,1807,1528,-10
86583759213,86583759215,2,1409,1246,-10
86585041960,86585041962,2,1220,1695,-10
86588171214,86588171215,1,1597,1064,-10
86590691085,86590691086,1,1356,1583,-10
86595438374,86595438378,4,1455,2057,-10
86601262482,86601262484,2,1260,1536,-10
86602149557,86602149559,2,1834,1995,-10
86606694078,86606694081,3,1015,1274,-10
86606870229,86606870229,0,1497,1739,-10
86607291835,86607291834,-1,1760,2432,-10
86612342388,86612342391,3,2255,2261,-10
86613660566,86613660569,3,1684,1662,-10
86616746145,86616746147,2,1555,1448,-10
86618564098,86618564100,2,2111,2151,-10
86619486178,86619486178,0,1505,1820,-10
86620894870,86620894871,1,1050,1188,-10
86623151770,86623151770,0,1599,1490,-10
86623296081,86623296083,2,2233,1239,-10
86623599474,86623599475,1,1308,1103,-10
86625899250,86625899250,0,1317,1503,-10
86628464678,86628464681,3,1962,1170,-10
86629338114,86629338116,2,1746,1220,-10
86630442805,86630442784,-21,2092,1732,-10
86632574190,86632574192,2,1683,1051,-10
86634281633,86634281631,-2,1663,2322,-10
86638331736,86638331738,2,1660,1211,-10
86641725983,86641725988,5,1297,856,-10
86642130842,86642130843,1,1872,2123,-10
86643790933,86643790933,0,1491,1328,-10
86650279855,86650279857,2,1521,1511,-10
86654070235,86654070243,8,1220,1347,-10
86654377934,86654377936,2,1953,2632,-10
86654715905,86654715909,4,1089,1262,-10
86655534110,86655534111,1,1312,2029,-10
86656098182,86656098185,3,1483,1299,-10
86660371660,86660371661,1,1658,2062,-10
86661762134,86661762135,1,1898,1861,-10
86662643186,86662643187,1,1679,2119,-10
86665223662,86665223665,3,1463,1922,-10
86665936109,86665936111,2,1472,1878,-10
86665981041,86665981041,0,2192,1695,-10
86670759478,86670759478,0,1248,1246,-10
86676329381,86676329381,0,1565,2089,-10
86677045498,86677045497,-1,1415,1227,-10
86679032291,86679032293,2,1634,1448,-10
86679188136,86679188139,3,1508,1498,-10
86681626052,86681626053,1,886,996,-10
86687476735,86687476736,1,1187,1349,-10
86688573542,86688573547,5,1355,1785,-10
86690188956,86690188958,2,1366,1354,-10
86692606384,86692606387,3,1016,1013,-10
86694241819,86694241823,4,1504,1266,-10
86697108973,86697108976,3,1892,2112,-10
86697348741,86697348742,1,1489,1495,-10
86699128214,86699128217,3,1325,1239,-10
86699554511,86699554515,4,2004,2080,-10
86703964894,86703964893,-1,893,2481,-10
86705936305,86705936310,5,1143,1487,-10
86710097724,86710097726,2,1538,1343,-10
86712205329,86712205331,2,1851,1867,-10
86713348197,86713348201,4,2022,1545,-10
86713906704,86713906707,3,2089,1462,-10
86714178498,86714178501,3,1947,1310,-10
86714485813,86714485816,3,1755,1054,-10
86714576762,86714576763,1,1574,1561,-10
86714840971,86714840967,-4,1050,2591,-10
86721975877,86721975876,-1,1214,1794,-10
86723113593,86723113594,1,1096,1190,-10
86726936590,86726936591,1,1760,1681,-10
86731530768,86731530768,0,1790,1504,-10
86732489149,86732489154,5,2186,1392,-10
86734586966,86734586967,1,1826,1285,-10
86736824853,86736824855,2,1449,1890,-10
86740236073,86740236076,3,1298,1269,-10
86741187633,86741187634,1,2019,1448,-10
86742218521,86742218522,1,1494,1554,-10
86745661862,86745661869,7,4969,1828,-10
86745916142,86745916145,3,1683,1623,-10
86751861254,86751861254,0,1735,1375,-10
86752585062,86752585063,1,1433,1541,-10
86761374142,86761374134,-8,1219,5323,-10
86763524770,86763524771,1,1484,1701,-10
86765719249,86765719247,-2,1176,2311,-10
86765860932,86765860934,2,1082,815,-10
86767744199,86767744200,1,1238,1594,-10
86768717488,86768717488,0,1869,2154,-10
86772730805,86772730807,2,1760,2130,-10
86774626539,86774626541,2,1305,1378,-10
86778544970,86778544972,2,1328,1400,-10
86781751681,86781751685,4,2856,1761,-10
86783472527,86783472527,0,1261,974,-10
86783835333,86783835334,1,1739,1980,-10
86785024098,86785024102,4,1367,1319,-10
86787159754,86787159751,-3,1020,2335,-10
86792510916,86792510917,1,1722,2059,-10
86792674918,86792674919,1,797,474,-10
86795128531,86795128534,3,2320,1517,-10
86796018862,86796018864,2,1384,1567,-10
86797320393,86797320395,2,1564,1748,-10
86797976762,86797976763,1,1036,987,-10
86800146948,86800146949,1,1662,1710,-10
86800172912,86800172911,-1,2342,4967,-10
86800607541,86800607543,2,1644,1328,-10
86801541485,86801541486,1,1645,1315,-10
86803857657,86803857659,2,1108,1930,-10
86805891051,86805891054,3,1367,1186,-10
86807381758,86807381759,1,1149,1485,-10
86813114425,86813114430,5,3166,1358,-10
86814746114,86814746118,4,1260,1168,-10
86818308272,86818308276,4,4055,2143,-10
86821781334,86821781336,2,1382,1467,-10
86823819410,86823819413,3,2343,1878,-10
86824296454,86824296455,1,1424,1516,-10
86824399282,86824399290,8,5204,1951,-10
86825700644,86825700646,2,969,1223,-10
86827767351,86827767353,2,1466,1434,-10
86829049394,86829049398,4,2730,1070,-10
86837419640,86837419638,-2,1413,1086,-10
86838400506,86838400501,-5,724,3428,-10
86839073496,86839073499,3,1297,1455,-10
86839931295,86839931298,3,1356,1654,-10
86842130683,86842130687,4,1687,1495,-10
86849472710,86849472713,3,1693,1017,-10
86849536154,86849536151,-3,1413,1885,-10
86850919229,86850919230,1,2106,1851,-10
86855620267,86855620269,2,1414,1626,-10
86856100520,86856100523,3,1872,1471,-10
86857849146,86857849148,2,44797,3559,-10
86858180295,86858180297,2,1608,1833,-10
86859904824,86859904826,2,1603,1347,-10
86860080349,86860080351,2,1315,1254,-10
86863970782,86863970786,4,1328,597,-10
86864221045,86864221046,1,1233,1018,-10
86869981246,86869981248,2,1533,1293,-10
86871364159,86871364161,2,575,965,-10
86875193925,86875193925,0,1373,1425,-10
86878775122,86878775122,0,1454,1432,-10
86887167697,86887167698,1,513,1030,-10
86892253299,86892253302,3,1883,1565,-10
86892448111,86892448111,0,1187,989,-10
86895692483,86895692480,-3,1604,3230,-10
86901894598,86901894602,4,1649,1531,-10
86903693250,86903693249,-1,801,1461,-10
86908344426,86908344428,2,1568,1457,-10
86909984605,86909984606,1,1371,1910,-10
86914549143,86914549146,3,1674,1169,-10
86919589321,86919589324,3,1440,1572,-10
86924214874,86924214875,1,1264,1050,-10
86927542475,86927542474,-1,1227,1593,-10
86927877206,86927877207,1,1689,1530,-10
86929805496,86929805498,2,2260,2232,-10
86935380950,86935380954,4,5225,2615,-10
86937995471,86937995473,2,1391,1367,-10
86939890814,86939890816,2,2052,1678,-10
86941999526,86941999522,-4,1160,3727,-10
86945711870,86945711874,4,1185,1522,-10
86946312098,86946312099,1,1383,1553,-10
86949509556,86949509558,2,2187,1632,-10
86950783574,86950783577,3,1732,1250,-10
86952713754,86952713757,3,2247,2060,-10
86956899053,86956899057,4,887,1360,-10
86959581839,86959581844,5,1558,1301,-10
86961258743,86961258745,2,1569,893,-10
86961456160,86961456162,2,1687,1447,-10
86963445514,86963445518,4,1418,1465,-10
86965166639,86965166641,2,1375,1166,-10
86966735469,86966735487,18,16353,27693,-10
86968332256,86968332257,1,1186,1576,-10
86969852146,86969852146,0,1478,2021,-10
86970364525,86970364528,3,2039,2065,-10
86970947740,86970947747,7,5371,2357,-10
86973683732,86973683734,2,1453,1963,-10
86973755124,86973755124,0,1886,1979,-10
86977347267,86977347265,-2,1140,1318,-10
86980275790,86980275794,4,1731,1819,-10
86980316351,86980316354,3,1643,1727,-10
86984167534,86984167533,-1,1078,1512,-10
86986310283,86986310287,4,1128,951,-10
86987682811,86987682813,2,1489,1500,-10
86988010410,86988010416,6,899,1315,-10
86989285715,86989285715,0,1400,1676,-10
86995371265,86995371266,1,1023,1773,-10
86997294457,86997294458,1,1240,2006,-10
86998778801,86998778805,4,1451,1673,-10
87001772010,87001772013,3,1643,1752,-10
87003848137,87003848139,2,1999,1405,-10
87012059177,87012059179,2,1331,1466,-10
87014830463,87014830463,0,1816,1464,-10
87015515269,87015515272,3,1304,1564,-10
87017823871,87017823874,3,2186,1291,-10
87019614982,87019614988,6,2665,1491,-10
87025398617,87025398618,1,1471,1394,-10
87026452742,87026452741,-1,1048,1353,-10
87038608037,87038608037,0,1761,1574,-10
87039630796,87039630798,2,1772,1853,-10
87044506282,87044506283,1,1319,1727,-10
87045126389,87045126392,3,1431,1059,-10
87048240764,87048240766,2,1603,1714,-10
87052450625,87052450627,2,1088,932,-10
87053807081,87053807082,1,1865,1882,-10
87054095131,87054095130,-1,3228,12032,-10
87056630178,87056630182,4,1640,1764,-10
87057845841,87057845843,2,1496,1622,-10
87059878873,87059878877,4,1672,1292,-10
87061677559,87061677562,3,3055,3032,-10
87064438277,87064438278,1,1827,1957,-10
87066482946,87066482947,1,1161,1253,-10
87075184071,87075184077,6,1518,1525,-10
87080021787,87080021789,2,2085,1704,-10
87085536117,87085536117,0,1496,1820,-10
87088057950,87088057952,2,36296,34860,-10
87090294138,87090294142,4,1408,1433,-10
87090707570,87090707574,4,1939,1397,-10
87092413811,87092413814,3,1371,1508,-10
87093958254,87093958254,0,1307,1707,-10
87096724699,87096724701,2,1811,2479,-10
87099448325,87099448327,2,1810,1900,-10
87100409280,87100409266,-14,204,1828,-10
87100576374,87100576377,3,876,927,-10
87102560163,87102560166,3,1328,1359,-10
87106362551,87106362551,0,971,881,-10
87106854507,87106854510,3,2198,1129,-10
87108216434,87108216436,2,1581,1523,-10
87109416941,87109416944,3,1899,1850,-10
87112344275,87112344277,2,834,1159,-10
87113102979,87113102982,3,1378,1348,-10
87115648878,87115648881,3,1390,1768,-10
87118864195,87118864198,3,2269,2134,-10
87119767918,87119767916,-2,1403,2290,-10
87120380699,87120380699,0,1281,1480,-10
87121369623,87121369626,3,1508,1132,-10
87122327289,87122327289,0,1630,1682,-10
87124006597,87124006602,5,1655,1360,-10
87126560550,87126560551,1,1855,1961,-10
87127298235,87127298237,2,1225,1552,-10
87127821778,87127821780,2,1738,1218,-10
87128793599,87128793598,-1,971,1406,-10
87129605238,87129605251,13,1296,1596,-10
87130056296,87130056297,1,1206,1232,-10
87134251331,87134251336,5,1851,1637,-10
87134382988,87134382986,-2,1518,2474,-10
87135056786,87135056783,-3,1321,1551,-10
87137270439,87137270439,0,1985,1730,-10
87138449941,87138449943,2,1600,1342,-10
87142666432,87142666437,5,1916,1865,-10
87145980415,87145980418,3,2021,1041,-10
87147470298,87147470299,1,1162,1486,-10
87152323063,87152323063,0,1108,1744,-10
87160757846,87160757838,-8,1585,1228,-10
87162004983,87162004983,0,2031,2206,-10
87162642037,87162642037,0,1265,1895,-10
87163123408,87163123410,2,2047,1590,-10
87167815494,87167815499,5,877,1181,-10
87169180513,87169180515,2,1985,2034,-10
87172024637,87172024640,3,2029,1770,-10
87174549042,87174549043,1,1704,1463,-10
87175210860,87175210864,4,17934,30596,-10
87175565967,87175565969,2,2043,1714,-10
87175608708,87175608712,4,1919,1398,-10
87179615101,87179615102,1,1978,1766,-10
87185045503,87185045499,-4,689,3257,-10
87189153527,87189153528,1,1523,1357,-10
87190656306,87190656307,1,1320,1331,-10
87191637648,87191637650,2,1305,1528,-10
87193822299,87193822301,2,994,1263,-10
87193938870,87193938873,3,1475,1597,-10
87195458234,87195458237,3,1796,1709,-10
87195961209,87195961210,1,1110,1247,-10
87197055192,87197055194,2,1680,2218,-10
87198406017,87198406022,5,2743,1785,-10
87199135518,87199135497,-21,1515,1590,-10
87200554708,87200554709,1,1892,1845,-10
87200947830,87200947828,-2,1899,2852,-10
87201322565,87201322567,2,1487,1541,-10
87202984143,87202984145,2,1266,1389,-10
87204060696,87204060701,5,2857,1536,-10
87207633476,87207633478,2,2027,1827,-10
87208786005,87208786004,-1,1251,1542,-10
87209327431,87209327435,4,1843,1283,-10
87210527533,87210527535,2,2162,1902,-10
87211181902,87211181903,1,1225,2198,-10
87214462885,87214462886,1,1472,1690,-10
87219822386,87219822389,3,23039,21588,-10
87220831420,87220831427,7,3864,1320,-10
87222799026,87222799027,1,1052,922,-10
87224954221,87224954223,2,1279,1605,-10
87225399409,87225399409,0,1082,1164,-10
87228738669,87228738672,3,1840,1514,-10
87230826322,87230826325,3,1704,1104,-10
87235425896,87235425897,1,1292,1484,-10
87243978611,87243978590,-21,1108,1667,-10
87245071804,87245071802,-2,2303,3969,-10
87245948174,87245948177,3,1213,1655,-10
87249434456,87249434458,2,3371,2867,-10
87252621797,87252621798,1,1964,1769,-10
87253432446,87253432449,3,1683,2158,-10
87253763626,87253763619,-7,1972,11676,-10
87254846215,87254846218,3,1104,937,-10
87255831322,87255831330,8,3021,1325,-10
87259671362,87259671365,3,1609,1842,-10
87260684501,87260684502,1,1850,1591,-10
87261295233,87261295236,3,1986,1154,-10
87265991133,87265991135,2,1316,1747,-10
87266185094,87266185098,4,1419,1069,-10
87266668998,87266669008,10,3199,1366,-10
87276301031,87276301031,0,1713,1486,-10
87276445845,87276445850,5,2450,1615,-10
87279423847,87279423849,2,1484,1123,-10
87279557757,87279557758,1,1474,1521,-10
87281728058,87281728062,4,786,840,-10
87281754970,87281754971,1,1108,1274,-10
87281819849,87281819849,0,1084,1103,-10
87282277427,87282277429,2,1385,1073,-10
87283147502,87283147504,2,1632,1513,-10
87284087906,87284087906,0,1476,2018,-10
87286003142,87286003145,3,1528,1188,-10
87286107139,87286107141,2,1791,2124,-10
87286534288,87286534290,2,1603,1727,-10
87287248551,87287248550,-1,1892,1902,-10
87290911138,87290911141,3,1273,1379,-10
87294719510,87294719514,4,1266,1432,-10
87294982842,87294982822,-20,1289,1138,-10
87296740585,87296740589,4,1470,1442,-10
87298302773,87298302775,2,3008,2469,-10
87298582106,87298582107,1,1353,1891,-10
87301926923,87301926925,2,901,979,-10
87302043982,87302043984,2,2281,2090,-10
87304662240,87304662242,2,1179,1339,-10
87307144290,87307144292,2,1807,1540,-10
87307485484,87307485490,6,6341,2564,-10
87311283471,87311283476,5,2151,1938,-10
87311738371,87311738373,2,1444,1837,-10
87326241794,87326241794,0,1535,1227,-10
87326433317,87326433320,3,1377,1941,-10
87329567872,87329567874,2,1324,1617,-10
87335408831,87335408834,3,1446,1407,-10
87337753211,87337753213,2,1768,1418,-10
87337969193,87337969194,1,1140,1017,-10
87338698073,87338698075,2,1574,1677,-10
87343319235,87343319237,2,1706,1294,-10
87348867937,87348867938,1,1221,1215,-10
87355399831,87355399832,1,1938,1543,-10
87358789116,87358789118,2,11500,11897,-10
87359560489,87359560490,1,1441,1881,-10
87361585499,87361585502,3,1142,1335,-10
87368603794,87368603797,3,1027,1401,-10
87369344813,87369344813,0,1645,1479,-10
87370103853,87370103858,5,3369,1887,-10
87370398072,87370398075,3,1197,1042,-10
87371932650,87371932654,4,1133,1207,-10
87373024574,87373024576,2,1115,1588,-10
87373561620,87373561639,19,766,993,-10
87374381811,87374381813,2,1784,1980,-10
87376046411,87376046413,2,1479,1856,-10
87376135262,87376135263,1,1530,1701,-10
87377255102,87377255102,0,1029,1311,-10
87379306432,87379306434,2,1948,1884,-10
87380459146,87380459146,0,1780,2392,-10
87381195220,87381195221,1,1464,1952,-10
87384606401,87384606404,3,1863,1560,-10
87384982301,87384982304,3,1727,1272,-10
87385783069,87385783069,0,1271,1557,-10
87386177291,87386177276,-15,1574,1366,-10
87387297546,87387297548,2,1480,1392,-10
87392052653,87392052654,1,1816,2117,-10
87392922675,87392922693,18,2129,1704,-10
87393377787,87393377791,4,2435,1546,-10
87395287272,87395287274,2,1829,1578,-10
87396926327,87396926327,0,1437,1777,-10
87398938868,87398938869,1,1580,1245,-10
87399938407,87399938411,4,1545,1061,-10
87401010482,87401010482,0,1182,1318,-10
87401273074,87401273076,2,1351,1429,-10
87403730888,87403730890,2,1354,1623,-10
87406384074,87406384076,2,2465,1858,-10
87412941507,87412941510,3,1533,1726,-10
87416102942,87416102946,4,1051,1215,-10
87417058250,87417058257,7,4663,1507,-10
87418018849,87418018850,1,1540,1403,-10
87418881479,87418881481,2,1372,1595,-10
87420813009,87420813010,1,2101,1997,-10
87420936028,87420936029,1,2247,2117,-10
87425342671,87425342671,0,1313,1342,-10
87425851967,87425851969,2,2006,2021,-10
87431821659,87431821662,3,1811,1812,-10
87432412584,87432412586,2,1786,1565,-10
87432441654,87432441655,1,1836,1982,-10
87432686390,87432686392,2,1122,1232,-10
87433758999,87433759001,2,1253,1903,-10
87434409357,87434409357,0,2074,1988,-10
87434814456,87434814457,1,785,812,-10
87435533422,87435533425,3,1264,1598,-10
87436750769,87436750769,0,1613,1477,-10
87439771754,87439771757,3,1429,1704,-10
87439959974,87439959974,0,1833,1591,-10
87443585295,87443585300,5,1738,1786,-10
87447345527,87447345530,3,1131,1110,-10
87447976669,87447976672,3,1710,1275,-10
87450501949,87450501952,3,1566,1376,-10
87453003333,87453003336,3,1770,1902,-10
87456055033,87456055034,1,1035,1114,-10
87456193790,87456193793,3,1239,1638,-10
87460668905,87460668906,1,1569,1681,-10
87464527607,87464527609,2,2231,1307,-10
87466029798,87466029802,4,1350,1254,-10
87466260330,87466260332,2,1647,1719,-10
87474510358,87474510358,0,1327,1245,-10
87475013622,87475013622,0,1382,2373,-10
87476078994,87476078994,0,1258,1468,-10
87477943702,87477943705,3,1634,1767,-10
87482466546,87482466549,3,1687,1865,-10
87484918986,87484918986,0,1727,2487,-10
87488051229,87488051234,5,1778,845,-10
87492939197,87492939198,1,1371,1239,-10
87495336987,87495336990,3,3617,2457,-10
87496376402,87496376403,1,1312,1235,-10
87499452686,87499452691,5,3214,1784,-10
87500006264,87500006265,1,1722,1954,-10
87500637734,87500637738,4,2617,1164,-10
87506217232,87506217229,-3,973,1177,-10
87507913511,87507913512,1,984,1264,-10
87512023485,87512023489,4,4272,2641,-10
87512219109,87512219114,5,9204,3864,-10
87513076234,87513076236,2,1983,1335,-10
87514435104,87514435107,3,1928,1203,-10
87518749096,87518749098,2,1328,1458,-10
87519210976,87519210985,9,43441,13484,-10
87521579285,87521579290,5,1473,1039,-10
87522654274,87522654274,0,1395,2045,-10
87524333299,87524333302,3,1678,1461,-10
87527610401,87527610402,1,1453,1694,-10
87528930766,87528930766,0,1014,1409,-10
87532248756,87532248759,3,1552,1243,-10
87535053322,87535053322,0,1462,2105,-10
87535867685,87535867687,2,1936,1673,-10
87538237335,87538237337,2,1175,1501,-10
87541066947,87541066946,-1,860,1023,-10
87541725853,87541725855,2,1524,1899,-10
87542094947,87542094930,-17,1348,1472,-10
87543301886,87543301888,2,2178,1716,-10
87543385371,87543385373,2,1623,1869,-10
87543747439,87543747439,0,1250,1526,-10
87544442064,87544442065,1,1163,1252,-10
87545697387,87545697390,3,1434,1209,-10
87548227269,87548227274,5,3343,1566,-10
87548915530,87548915533,3,1187,1519,-10
87549654559,87549654555,-4,1214,2099,-10
87550402958,87550402961,3,2398,1584,-10
87553090507,87553090506,-1,1511,1869,-10
87559841531,87559841530,-1,1178,1021,-10
87561643920,87561643922,2,2260,2280,-10
87561721488,87561721488,0,915,1684,-10
87565572134,87565572137,3,1491,1833,-10
87567287438,87567287438,0,1649,1002,-10
87569850116,87569850115,-1,1483,1466,-10
87570542710,87570542713,3,1877,2218,-10
87570707122,87570707123,1,1251,1705,-10
87570828568,87570828570,2,1807,1440,-10
87581531739,87581531740,1,1627,1658,-10
87581904786,87581904787,1,1697,1400,-10
87582538343,87582538345,2,1807,2303,-10
87583647073,87583647073,0,1375,1560,-10
87586277181,87586277184,3,2066,1474,-10
87587348557,87587348560,3,1476,1689,-10
87588020642,87588020644,2,1588,1934,-10
87597063286,87597063292,6,3968,1719,-10
87602243760,87602243762,2,1297,1339,-10
87604481126,87604481129,3,1731,1847,-10
87605168298,87605168292,-6,808,3945,-10
87609025133,87609025134,1,1427,1588,-10
87611225303,87611225305,2,1793,1745,-10
87613530201,87613530202,1,1387,1862,-10
87615325571,87615325571,0,1384,1518,-10
87615397102,87615397104,2,1567,1739,-10
87616738754,87616738756,2,1561,1717,-10
87617287002,87617286984,-18,2461,1059,-10
87618904278,87618904260,-18,807,283,-10
87620831282,87620831265,-17,1737,1376,-10
87630159346,87630159347,1,1250,1247,-10
87631399648,87631399651,3,1448,1750,-10
87632508884,87632508886,2,1567,1201,-10
87637464938,87637464939,1,1533,1316,-10
87637650201,87637650205,4,1166,1046,-10
87641280295,87641280297,2,952,1713,-10
87641732102,87641732102,0,1489,1951,-10
87642740977,87642740978,1,1688,1329,-10
87645573925,87645573926,1,1154,1342,-10
87647018525,87647018526,1,1091,1344,-10
87647908424,87647908428,4,1621,1042,-10
87651758585,87651758589,4,1972,1508,-10
87651927325,87651927328,3,2347,1573,-10
87653336722,87653336726,4,1144,1044,-10
87653755933,87653755935,2,1990,1915,-10
87655619815,87655619825,10,10840,33059,-10
87656771207,87656771209,2,1780,1479,-10
87661006262,87661006262,0,1454,1290,-10
87664120771,87664120773,2,1590,1733,-10
87664737075,87664737078,3,1415,1458,-10
87666599434,87666599436,2,1167,1696,-10
87667309193,87667309195,2,1729,2526,-10
87673220082,87673220082,0,1566,1685,-10
87676469962,87676469966,4,1605,1011,-10
87677323293,87677323294,1,1592,1002,-10
87679733628,87679733630,2,1265,1184,-10
87680582894,87680582874,-20,1074,496,-10
87682035606,87682035608,2,1000,1519,-10
87685704634,87685704640,6,4171,3163,-10
87690059782,87690059782,0,2041,2242,-10
87694066407,87694066408,1,1153,1456,-10
87694563025,87694563028,3,2015,1359,-10
87696459503,87696459503,0,1319,1002,-10
87699214822,87699214824,2,1448,2195,-10
87702118100,87702118098,-2,1112,2859,-10
87702374622,87702374622,0,1463,2273,-10
87706742122,87706742127,5,1178,1391,-10
87707321750,87707321752,2,1819,1293,-10
87708540988,87708540991,3,1746,1703,-10
87709318910,87709318911,1,1038,1045,-10
87710804099,87710804098,-1,1085,1312,-10
87714847726,87714847726,0,1727,2236,-10
87715241843,87715241846,3,1490,1701,-10
87716059626,87716059627,1,1363,1371,-10
87716521363,87716521365,2,1173,1189,-10
87721737933,87721737933,0,1580,1771,-10
87723290719,87723290726,7,3541,2667,-10
87725666452,87725666453,1,1623,1424,-10
87733703912,87733703905,-7,2012,8480,-10
87734254449,87734254450,1,1919,2495,-10
87745582465,87745582467,2,1631,1341,-10
87747436169,87747436169,0,1289,1474,-10
87747640191,87747640193,2,984,1290,-10
87748014849,87748014850,1,1704,807,-10
87749404369,87749404374,5,1556,1319,-10
87750682001,87750682007,6,1313,1288,-10
87752537520,87752537522,2,18994,7769,-10
87752678142,87752678143,1,1339,1585,-10
87757858170,87757858170,0,1804,1410,-10
87758103694,87758103695,1,1155,1492,-10
87764941685,87764941687,2,1688,1375,-10
87765466370,87765466373,3,1603,1596,-10
87766755932,87766755930,-2,1305,1598,-10
87768994935,87768994938,3,1786,1834,-10
87771297174,87771297175,1,2033,1965,-10
87774699848,87774699853,5,1689,1015,-10
87779747017,87779747019,2,1698,1479,-10
87781022150,87781022153,3,1361,2053,-10
87781633470,87781633471,1,1508,1510,-10
87781745218,87781745221,3,1121,1226,-10
87783305098,87783305098,0,1246,2329,-10
87786831727,87786831732,5,1258,1208,-10
87790099975,87790099959,-16,1671,12798,-10
87793729963,87793729968,5,1659,1405,-10
87795361098,87795361102,4,1526,1390,-10
87796290618,87796290620,2,1519,2027,-10
87797901478,87797901481,3,1675,1501,-10
87798888461,87798888464,3,1592,1752,-10
87800863049,87800863050,1,1950,1241,-10
87805590525,87805590526,1,1533,1368,-10
87810625491,87810625494,3,1656,1595,-10
87812567505,87812567506,1,1246,1384,-10
87813026438,87813026439,1,1487,1508,-10
87820394982,87820394983,1,1278,1702,-10
87820707956,87820707957,1,1796,2037,-10
87821055031,87821055034,3,1128,1389,-10
87824173431,87824173434,3,1576,1955,-10
87825209605,87825209612,7,1568,1359,-10
87827750703,87827750707,4,2803,1374,-10
87829057146,87829057147,1,1807,1838,-10
87829407572,87829407575,3,1439,1275,-10
87835297573,87835297575,2,1934,2035,-10
87835530849,87835530851,2,1316,1332,-10
87837520945,87837520943,-2,1240,2368,-10
87838432074,87838432074,0,903,988,-10
87845328066,87845328070,4,1200,1581,-10
87846522130,87846522130,0,1740,2044,-10
87847427438,87847427439,1,1640,1281,-10
87848352168,87848352169,1,1468,1067,-10
87848826659,87848826665,6,1420,897,-10
87852182630,87852182631,1,1469,1346,-10
87853474274,87853474277,3,1352,1545,-10
87855363994,87855363995,1,1885,1752,-10
87857331959,87857331968,9,4297,1293,-10
87860316246,87860316224,-22,1922,815,-10
87862077994,87862077996,2,1278,1126,-10
87863651433,87863651439,6,8853,4190,-10
87866585283,87866585285,2,2035,1887,-10
87866821742,87866821745,3,1335,1551,-10
87869320707,87869320709,2,1551,1569,-10
87869606050,87869606051,1,1496,1474,-10
87870692693,87870692694,1,1741,1236,-10
87870774007,87870774010,3,1168,1750,-10
87873278178,87873278181,3,1287,1162,-10
87876373398,87876373400,2,1358,1848,-10
87883331801,87883331802,1,1741,1414,-10
87883484632,87883484634,2,1702,1429,-10
87885734680,87885734683,3,1151,981,-10
87888059389,87888059390,1,1313,1632,-10
87891398598,87891398603,5,1939,1751,-10
87892677594,87892677596,2,1668,1327,-10
87894255296,87894255299,3,1866,1532,-10
87894671365,87894671365,0,1261,1450,-10
87898094827,87898094830,3,1169,1074,-10
87898580413,87898580414,1,1395,1871,-10
87901342355,87901342357,2,1377,1459,-10
87903312535,87903312535,0,1719,1914,-10
87904396582,87904396585,3,1315,1317,-10
87906031798,87906031799,1,1274,1673,-10
87907068924,87907068926,2,1767,1218,-10
87908404400,87908404398,-2,1812,2461,-10
87908622628,87908622630,2,1662,1758,-10
87910021617,87910021618,1,1129,1056,-10
87916418589,87916418592,3,1055,1879,-10
87919097054,87919097062,8,4476,1849,-10
87919145950,87919145954,4,1323,1652,-10
87920328165,87920328168,3,1415,1800,-10
87921000834,87921000836,2,2432,2061,-10
87923734174,87923734179,5,2032,1610,-10
87924999129,87924999131,2,1740,1325,-10
87926680581,87926680582,1,1352,998,-10
87930011918,87930011919,1,1633,1661,-10
87931359162,87931359162,0,1611,2678,-10
87931857137,87931857145,8,11491,42533,-10
87933737666,87933737668,2,1677,1585,-10
87934596417,87934596422,5,2724,1777,-10
87939085385,87939085387,2,1438,1105,-10
87941039462,87941039462,0,1412,1869,-10
87942000561,87942000563,2,1669,1425,-10
87942076463,87942076465,2,1370,1024,-10
87943525849,87943525850,1,1191,1615,-10
87944692709,87944692710,1,1990,1782,-10
87945189746,87945189748,2,1723,1814,-10
87949471778,87949471782,4,2286,1860,-10
87953750595,87953750598,3,943,1183,-10
87957049100,87957049103,3,1667,1375,-10
87958561286,87958561291,5,2764,1533,-10
87964379534,87964379535,1,1562,1751,-10
87966007155,87966007157,2,1161,1315,-10
87969985170,87969985174,4,1506,1146,-10
87970357151,87970357155,4,1548,1066,-10
87972563013,87972563014,1,714,639,-10
87975419953,87975419954,1,1768,1314,-10
87976550923,87976550926,3,1530,1718,-10
87978010821,87978010822,1,1794,1380,-10
87982174451,87982174452,1,1301,1093,-10
87985285234,87985285235,1,1890,1600,-10
87985427693,87985427675,-18,1657,1573,-10
87986510154,87986510158,4,1817,1748,-10
87987870547,87987870551,4,1658,1045,-10
87992308471,87992308471,0,981,1222,-10
87996128685,87996128686,1,1827,1372,-10
87996439935,87996439939,4,988,716,-10
87999670808,87999670807,-1,1239,1957,-10
88000326330,88000326331,1,1547,1912,-10
88001871094,88001871096,2,1686,1399,-10
88002996826,88002996828,2,459,806,-10
88006947977,88006947979,2,1852,1413,-10
88014648697,88014648694,-3,1742,2041,-10
88015455310,88015455313,3,1667,1865,-10
88017599586,88017599587,1,1182,1187,-10
88018050399,88018050403,4,1437,1467,-10
88019732194,88019732195,1,1647,1579,-10
88020636601,88020636603,2,1787,1641,-10
88021949605,88021949606,1,1923,1657,-10
88025652341,88025652343,2,1934,2432,-10
88026583422,88026583421,-1,4857,7942,-10
88029883435,88029883437,2,1761,1493,-10
88030694322,88030694325,3,1628,1491,-10
88031997222,88031997225,3,2163,1448,-10
88032125598,88032125601,3,1311,1302,-10
88036251880,88036251886,6,2738,1001,-10
88038539804,88038539806,2,1453,1209,-10
88039805759,88039805762,3,1745,1165,-10
88043315252,88043315255,3,2000,1253,-10
88045836927,88045836929,2,1306,2257,-10
88046246964,88046246966,2,1632,1349,-10
88046767421,88046767420,-1,1368,1376,-10
88048470962,88048470965,3,55,858,-10
88051150868,88051150890,22,1317,938,-10
88051245138,88051245138,0,1262,1106,-10
88055678719,88055678722,3,2029,1552,-10
88056490483,88056490485,2,975,1765,-10
88058973117,88058973119,2,1948,1533,-10
88059711098,88059711102,4,1231,1247,-10
88062357321,88062357323,2,1025,1919,-10
88067925996,88067925997,1,2327,1744,-10
88069724594,88069724597,3,1349,1505,-10
88070811090,88070811093,3,1174,1218,-10
88072360489,88072360470,-19,2164,2371,-10
88072803685,88072803686,1,1480,1453,-10
88076330781,88076330785,4,1194,1213,-10
88076862087,88076862090,3,1676,1524,-10
88080279157,88080279158,1,1629,1523,-10
88080660991,88080660993,2,1648,2067,-10
88082844751,88082844750,-1,1675,1612,-10
88087779558,88087779558,0,2181,1192,-10
88090529321,88090529318,-3,1367,3273,-10
88092956838,88092956839,1,1384,1771,-10
88096024266,88096024267,1,1222,1492,-10
88100968787,88100968787,0,1243,1504,-10
88102809869,88102809870,1,1255,1332,-10
88105454138,88105454139,1,1170,1693,-10
88109769126,88109769127,1,1264,1677,-10
88110085464,88110085487,23,1397,1348,-10
88110251980,88110251982,2,1879,1297,-10
88110482491,88110482489,-2,35535,30430,-10
88110552865,88110552862,-3,1188,1958,-10
88110987056,88110987057,1,1168,1261,-10
88114200831,88114200837,6,1811,1413,-10
88114887453,88114887454,1,1477,1317,-10
88117920181,88117920179,-2,1387,1742,-10
88118046894,88118046897,3,1879,1690,-10
88118684136,88118684139,3,1711,1592,-10
88119781239,88119781239,0,1567,2141,-10
88120435485,88120435486,1,1365,1908,-10
88127266166,88127266167,1,1582,1556,-10
88127774183,88127774182,-1,4591,7389,-10
88129211915,88129211916,1,1367,1304,-10
88130734430,88130734429,-1,1658,2417,-10
88132309064,88132309065,1,1697,1756,-10
88133200530,88133200531,1,1490,1102,-10
88134041145,88134041149,4,1824,1429,-10
88134744618,88134744621,3,1074,1387,-10
88138384386,88138384387,1,1090,691,-10
88142180315,88142180317,2,1215,1401,-10
88143088029,88143088031,2,1640,1296,-10
88143430265,88143430266,1,1697,1304,-10
88147379750,88147379750,0,1707,1858,-10
88148992500,88148992503,3,1803,1422,-10
88151065571,88151065573,2,2301,2381,-10
88152378618,88152378618,0,1349,1369,-10
88154095006,88154095009,3,1408,1503,-10
88155172906,88155172906,0,1040,1501,-10
88156472770,88156472770,0,1467,2486,-10
88157183298,88157183299,1,791,832,-10
88162139916,88162139917,1,1664,1831,-10
88162707201,88162707202,1,2004,1081,-10
88163116346,88163116348,2,1352,1800,-10
88165540798,88165540791,-7,2760,8467,-10
88170559289,88170559290,1,1298,1633,-10
88170591385,88170591387,2,1312,1275,-10
88170636451,88170636453,2,1368,1985,-10
88173318736,88173318738,2,1562,1353,-10
88179615704,88179615708,4,2596,1593,-10
88186785698,88186785699,1,1791,1824,-10
88192188909,88192188910,1,1397,2232,-10
88192373726,88192373730,4,1578,1398,-10
88193343869,88193343871,2,1177,1007,-10
88193898452,88193898454,2,1867,1393,-10
88194293937,88194293938,1,1694,1880,-10
88194797913,88194797894,-19,1707,1542,-10
88197485056,88197485058,2,2007,1057,-10
88199312462,88199312464,2,1747,1743,-10
88199821481,88199821485,4,1288,1264,-10
88203134181,88203134182,1,1979,2257,-10
88203631546,88203631545,-1,1327,1435,-10
88204551390,88204551390,0,1486,2236,-10
88208732395,88208732374,-21,2181,1812,-10
88208876566,88208876568,2,1158,893,-10
88209091445,88209091446,1,2076,1205,-10
88209908122,88209908123,1,1570,1344,-10
88209990310,88209990311,1,1434,1560,-10
88216048898,88216048901,3,1556,1255,-10
88217301038,88217301039,1,1061,1391,-10
88219579351,88219579354,3,1992,1592,-10
88219855497,88219855498,1,1573,1114,-10
88220515270,88220515270,0,1303,1581,-10
88221003156,88221003157,1,1024,1472,-10
88222118501,88222118503,2,1941,1604,-10
88222669446,88222669448,2,1361,1133,-10
88223359702,88223359701,-1,1400,1849,-10
88229311913,88229311915,2,1899,1756,-10
88232463009,88232463011,2,2125,800,-10
88232527735,88232527738,3,1115,1783,-10
88233427946,88233427950,4,1853,1041,-10
88237174902,88237174905,3,1370,1184,-10
88237671372,88237671374,2,1619,1696,-10
88239942009,88239942005,-4,1107,1867,-10
88241186669,88241186669,0,1494,1608,-10
88244782530,88244782531,1,1147,1287,-10
88245535222,88245535222,0,1747,1893,-10
88246568278,88246568279,1,1286,1704,-10
88251080650,88251080653,3,1583,2008,-10
88259018174,88259018176,2,1484,1516,-10
88259909815,88259909813,-2,1157,1476,-10
88265839568,88265839570,2,1508,1625,-10
88267292750,88267292753,3,1749,1579,-10
88267901390,88267901369,-21,1644,1786,-10
88268008371,88268008371,0,1443,1452,-10
88268132064,88268132066,2,1268,1167,-10
88272187247,88272187250,3,1816,1927,-10
88274384114,88274384119,5,2502,1475,-10
88274438704,88274438706,2,2031,1393,-10
88276175039,88276175039,0,834,1164,-10
88276500004,88276500006,2,1841,1182,-10
88277087200,88277087203,3,1380,1489,-10
88284580766,88284580768,2,1290,1481,-10
88285511059,88285511060,1,1726,1580,-10
88286754079,88286754081,2,1934,2296,-10
88286971604,88286971606,2,1501,1587,-10
88289604619,88289604619,0,1421,1715,-10
88290128437,88290128447,10,1194,1241,-10
88291974003,88291974005,2,1138,1338,-10
88292766303,88292766310,7,2813,1208,-10
88297254854,88297254859,5,2815,1485,-10
88301256058,88301256062,4,1141,1203,-10
88305238301,88305238293,-8,1206,1509,-10
88305354161,88305354161,0,1447,1170,-10
88308047000,88308047002,2,2063,1647,-10
88315393665,88315393667,2,1719,1222,-10
88316016142,88316016145,3,1264,1756,-10
88316519306,88316519309,3,1948,1626,-10
88323733427,88323733431,4,2058,1495,-10
88324471989,88324471990,1,1556,1580,-10
88325019638,88325019641,3,1770,1116,-10
88328616582,88328616582,0,1339,1827,-10
88333694826,88333694830,4,1485,1479,-10
88333919683,88333919685,2,1841,2152,-10
88335451310,88335451311,1,1358,1340,-10
88337782177,88337782179,2,1477,1442,-10
88338036700,88338036702,2,1536,1415,-10
88340719630,88340719640,10,12753,31760,-10
88341261934,88341261938,4,1383,1087,-10
88342097098,88342097098,0,874,1050,-10
88345686518,88345686499,-19,1620,1405,-10
88347194545,88347194546,1,1632,1391,-10
88349118170,88349118170,0,1621,2089,-10
88349849062,88349849062,0,1468,2082,-10
88351561365,88351561366,1,1741,1418,-10
88351973157,88351973146,-11,36202,16667,-10
88354683949,88354683950,1,1233,1373,-10
88356024581,88356024583,2,1286,1294,-10
88357433562,88357433565,3,1046,1313,-10
88359339822,88359339824,2,1721,1946,-10
88359407086,88359407089,3,1465,2086,-10
88359768308,88359768327,19,167,706,-10
88369463559,88369463562,3,1522,1437,-10
88371669220,88371669220,0,1776,16243,-10
88375995097,88375995099,2,1151,777,-10
88379878777,88379878779,2,1693,1552,-10
88382015114,88382015117,3,1825,1479,-10
88386054463,88386054466,3,1230,1097,-10
88387313076,88387313078,2,1435,1452,-10
88388373109,88388373112,3,2216,1365,-10
88389327540,88389327546,6,2234,1601,-10
88389959448,88389959450,2,1629,1439,-10
88391053259,88391053260,1,2108,1920,-10
88396030421,88396030422,1,2458,1733,-10
88397963230,88397963232,2,2583,2105,-10
88399531370,88399531366,-4,1094,1946,-10
88401671296,88401671295,-1,111,772,-10
88403923315,88403923324,9,7834,1420,-10
88409618986,88409618985,-1,1380,2350,-10
88422303058,88422303057,-1,684,1316,-10
88426068419,88426068423,4,1422,1516,-10
88428987545,88428987526,-19,1530,1296,-10
88432581108,88432581110,2,2218,1375,-10
88432669034,88432669035,1,1508,1584,-10
88432982463,88432982464,1,1412,1986,-10
88435799363,88435799363,0,1182,1172,-10
88436634060,88436634059,-1,1405,1449,-10
88437129452,88437129455,3,1462,1213,-10
88441191065,88441191066,1,1569,1503,-10
88441846175,88441846169,-6,1120,3522,-10
88442985074,88442985074,0,1306,1179,-10
88444260915,88444260916,1,1710,2121,-10
88444742845,88444742848,3,2312,1551,-10
88450067701,88450067702,1,1561,1568,-10
88450387674,88450387690,16,1611,882,-10
88453528012,88453528013,1,1734,1707,-10
88454915618,88454915618,0,1637,1585,-10
88455633009,88455633011,2,1664,1477,-10
88458726254,88458726249,-5,899,2424,-10
88459387122,88459387122,0,1640,1697,-10
88459923483,88459923486,3,1236,1144,-10
88461654717,88461654718,1,1138,1664,-10
88462925877,88462925878,1,1062,1011,-10
88464698735,88464698736,1,1257,1304,-10
88465300430,88465300430,0,1370,1230,-10
88472164487,88472164489,2,1189,1824,-10
88474416510,88474416510,0,1549,1555,-10
88475406337,88475406338,1,15422,15778,-10
88478639568,88478639571,3,1964,1345,-10
88486720648,88486720650,2,1827,1985,-10
88487272189,88487272190,1,1982,2235,-10
88489072434,88489072432,-2,1504,2977,-10
88489973534,88489973536,2,1505,2026,-10
88491831738,88491831739,1,1165,1233,-10
88492211658,88492211658,0,1142,2060,-10
88492282754,88492282752,-2,2285,4004,-10
88494055206,88494055207,1,1302,1392,-10
88498585462,88498585463,1,1607,1109,-10
88501239023,88501239024,1,1982,1489,-10
88504920297,88504920297,0,2155,2796,-10
88505757797,88505757799,2,1407,1265,-10
88507488699,88507488701,2,1185,1722,-10
88508796030,88508796030,0,1778,2694,-10
88510166344,88510166347,3,1597,1672,-10
88513783327,88513783327,0,1778,1703,-10
88520369406,88520369407,1,1442,1599,-10
88529330009,88529330011,2,1624,1308,-10
88532874127,88532874128,1,1085,1467,-10
88534054716,88534054718,2,1370,1397,-10
88535718358,88535718357,-1,1348,1423,-10
88537626690,88537626699,9,147,1074,-10
88540768949,88540768950,1,1375,2410,-10
88541420936,88541420938,2,1352,1558,-10
88542421955,88542421957,2,1577,1370,-10
88542918794,88542918797,3,1654,1847,-10
88543931735,88543931744,9,15590,31232,-10
88544481821,88544481822,1,1548,1591,-10
88550695854,88550695857,3,1272,1535,-10
88550850326,88550850327,1,1092,951,-10
88552650903,88552650903,0,1563,2009,-10
88558833508,88558833509,1,2172,2178,-10
88558912950,88558912953,3,1365,1874,-10
88559697759,88559697759,0,1962,2110,-10
88561782683,88561782685,2,1423,1747,-10
88562267115,88562267118,3,1298,1328,-10
88562473114,88562473117,3,1702,1702,-10
88563585311,88563585314,3,1860,1454,-10
88563817895,88563817898,3,1311,1430,-10
88564490598,88564490599,1,2252,2286,-10
88567848170,88567848173,3,1798,1495,-10
88569381981,88569381982,1,1365,1349,-10
88569554326,88569554325,-1,1472,2845,-10
88572408645,88572408646,1,1273,1275,-10
88577684749,88577684751,2,1225,1379,-10
88578508001,88578508003,2,2003,2309,-10
88581563335,88581563337,2,1175,1101,-10
88586373307,88586373304,-3,1163,2947,-10
88589445587,88589445589,2,1812,1479,-10
88592764906,88592764906,0,1143,1314,-10
88593182759,88593182758,-1,958,1251,-10
88593913991,88593913994,3,1295,1268,-10
88594494502,88594494482,-20,1327,997,-10
88595703609,88595703609,0,1041,937,-10
88597476707,88597476710,3,1536,1457,-10
88599219706,88599219706,0,1476,1679,-10
88604693994,88604693998,4,1016,1278,-10
88607130757,88607130758,1,1106,901,-10
88608741786,88608741786,0,809,859,-10
88610321229,88610321233,4,1764,1046,-10
88614941019,88614941021,2,1534,1572,-10
88615807522,88615807523,1,1268,1198,-10
88616930375,88616930378,3,1155,1354,-10
88619113875,88619113875,0,1385,1400,-10
88620079806,88620079808,2,1746,1157,-10
88621200846,88621200846,0,1646,1747,-10
88621692373,88621692385,12,1034,737,-10
88623162770,88623162765,-5,1363,1625,-10
88624004443,88624004447,4,1375,1282,-10
88625098790,88625098791,1,788,1049,-10
88625722642,88625722643,1,1247,974,-10
88626439393,88626439395,2,1677,1368,-10
88627829070,88627829070,0,1736,1562,-10
88630008811,88630008814,3,1355,1755,-10
88631344958,88631344960,2,1630,2043,-10
88636363226,88636363232,6,2402,1901,-10
88637372950,88637372953,3,1531,1538,-10
88641394278,88641394282,4,1473,937,-10
88643491932,88643491932,0,1226,1259,-10
88644028413,88644028414,1,1335,1430,-10
88645220743,88645220743,0,1579,1355,-10
88646221321,88646221323,2,2003,1904,-10
88646607849,88646607851,2,855,1610,-10
88648881604,88648881600,-4,1578,2339,-10
88649371605,88649371606,1,2219,1578,-10
88649911025,88649911026,1,1615,1335,-10
88654026135,88654026137,2,2091,1712,-10
88654608474,88654608475,1,1247,1398,-10
88656227732,88656227732,0,1800,1748,-10
88660658761,88660658765,4,1681,872,-10
88665535151,88665535151,0,1496,1513,-10
88667852357,88667852358,1,2004,2348,-10
88668850145,88668850147,2,1793,1784,-10
88672210859,88672210862,3,2187,1638,-10
88672393008,88672393010,2,1839,1370,-10
88672690119,88672690122,3,1179,1218,-10
88672983146,88672983147,1,1567,1872,-10
88674910411,88674910409,-2,1357,1784,-10
88676227530,88676227532,2,1030,888,-10
88680137602,88680137606,4,1842,1399,-10
88681667574,88681667575,1,1307,1891,-10
88681894928,88681894926,-2,1373,2132,-10
88685861444,88685861443,-1,1851,2132,-10
88686679431,88686679431,0,1146,1530,-10
88687508085,88687508086,1,1142,1358,-10
88688997900,88688997900,0,1206,1584,-10
88693142886,88693142886,0,1839,1581,-10
88693312250,88693312249,-1,1755,2029,-10
88694504169,88694504171,2,1774,1507,-10
88701514466,88701514469,3,2155,2416,-10
88701972304,88701972307,3,1400,1553,-10
88702991124,88702991125,1,1390,1409,-10
88709779962,88709779965,3,1655,1225,-10
88713706326,88713706326,0,1568,1593,-10
88723194617,88723194617,0,1409,1127,-10
88726184558,88726184562,4,1671,1244,-10
88730255307,88730255308,1,1364,1134,-10
88731526271,88731526272,1,1591,1850,-10
88732686150,88732686149,-1,1206,1113,-10
88735142154,88735142157,3,1890,1907,-10
88737523563,88737523560,-3,1633,3262,-10
88738164217,88738164221,4,1341,1170,-10
88739466437,88739466439,2,1359,1857,-10
88741720133,88741720135,2,665,986,-10
88742785207,88742785209,2,1384,1422,-10
88744174180,88744174181,1,1377,1528,-10
88744353194,88744353173,-21,1388,1551,-10
88745911727,88745911730,3,2420,1398,-10
88747137778,88747137780,2,1269,1126,-10
88747827617,88747827617,0,1403,1875,-10
88753858237,88753858224,-13,941,616,-10
88754389981,88754389983,2,1809,1309,-10
88754668964,88754668965,1,1701,1664,-10
88756715512,88756715514,2,1307,1105,-10
88761815746,88761815748,2,2046,1611,-10
88762744933,88762744953,20,1779,1149,-10
88770654433,88770654438,5,3491,1626,-10
88771277353,88771277359,6,3488,1405,-10
88774591580,88774591582,2,2432,1960,-10
88775059691,88775059692,1,1334,1242,-10
88775906424,88775906430,6,71183,37575,-10
88777681454,88777681457,3,4082,2400,-10
88781358861,88781358874,13,3423,379,-10
88783612054,88783612054,0,1186,1019,-10
88784770767,88784770769,2,2006,1626,-10
88791052594,88791052599,5,1705,1304,-10
88793039548,88793039551,3,1415,1597,-10
88794257865,88794257866,1,1979,1224,-10
88795701121,88795701123,2,1406,1157,-10
88797102365,88797102365,0,1871,1810,-10
88798696175,88798696182,7,24806,52071,-10
88799128567,88799128566,-1,1643,2032,-10
88800665740,88800665743,3,1886,2223,-10
88801400306,88801400307,1,1140,1419,-10
88806304228,88806304226,-2,1499,2015,-10
88807300222,88807300222,0,1420,1494,-10
88809701126,88809701129,3,1976,1992,-10
88811367490,88811367486,-4,1092,3931,-10
88811502433,88811502435,2,2352,2524,-10
88815504322,88815504323,1,1552,1343,-10
88816412291,88816412291,0,1076,1383,-10
88816544409,88816544406,-3,1407,1337,-10
88819459010,88819459011,1,1325,1582,-10
88822033791,88822033793,2,1319,2078,-10
88822676570,88822676573,3,1514,1044,-10
88823366846,88823366850,4,1874,1479,-10
88824358459,88824358449,-10,1728,1996,-10
88828440641,88828440641,0,1645,1146,-10
88828703266,88828703252,-14,1602,1791,-10
88831422910,88831422914,4,2130,1603,-10
88833780630,88833780631,1,1200,1337,-10
88834104278,88834104280,2,1675,1865,-10
88835648831,88835648832,1,1437,1242,-10
88838813203,88838813204,1,1940,1669,-10
88838844629,88838844631,2,1874,1969,-10
88841888271,88841888273,2,1348,1323,-10
88844491222,88844491223,1,1855,1427,-10
88845584113,88845584127,14,17783,43035,-10
88847741854,88847741855,1,1668,1717,-10
88849849823,88849849822,-1,1238,1975,-10
88851043430,88851043431,1,1148,758,-10
88859844848,88859844849,1,1647,2905,-10
88862256942,88862256945,3,1698,2147,-10
88866295008,88866295009,1,14643,16541,-10
88866419637,88866419641,4,1572,1443,-10
88867319909,88867319910,1,1692,2036,-10
88870735337,88870735338,1,2143,1596,-10
88873361009,88873361011,2,1774,1490,-10
88874299549,88874299554,5,2695,1316,-10
88875727630,88875727631,1,1927,1787,-10
88879510582,88879510583,1,1394,931,-10
88880352079,88880352081,2,1024,1306,-10
88884586439,88884586442,3,1432,1308,-10
88890473190,88890473191,1,1530,1299,-10
88891655451,88891655454,3,1924,1906,-10
88898985371,88898985374,3,1458,1272,-10
88903207255,88903207257,2,1560,2249,-10
88905503184,88905503186,2,1511,1116,-10
88906449337,88906449339,2,1580,1828,-10
88909903516,88909903517,1,1638,1275,-10
88913776866,88913776869,3,1337,1274,-10
88914388940,88914388920,-20,232,1407,-10
88922610625,88922610626,1,2252,1408,-10
88924534688,88924534690,2,1718,2271,-10
88924744873,88924744875,2,1523,1039,-10
88924817494,88924817472,-22,2897,3008,-10
88927248226,88927248230,4,1417,1726,-10
88927635324,88927635327,3,1621,1330,-10
88928332994,88928332995,1,1389,1024,-10
88928372051,88928372053,2,1545,2086,-10
88929340442,88929340451,9,1302,1549,-10
88934814477,88934814479,2,1578,1748,-10
88940012735,88940012739,4,2673,1772,-10
88940198009,88940198010,1,1712,1662,-10
88941732581,88941732581,0,848,1261,-10
88943159233,88943159237,4,2443,1826,-10
88944787766,88944787769,3,2412,1606,-10
88945746326,88945746327,1,2112,1955,-10
88950273762,88950273762,0,1514,1644,-10
88952576045,88952576050,5,3116,1592,-10
88953604492,88953604490,-2,1492,1253,-10
88960403718,88960403721,3,1463,1294,-10
88961072733,88961072734,1,1927,1158,-10
88964978602,88964978607,5,5228,3810,-10
88965748669,88965748671,2,1759,1457,-10
88968602993,88968602994,1,1465,1677,-10
88974628590,88974628591,1,1414,1923,-10
88975572104,88975572108,4,2360,1896,-10
88975965305,88975965306,1,1182,1176,-10
88981518272,88981518273,1,1965,1549,-10
88982694204,88982694203,-1,1389,1497,-10
88983954865,88983954866,1,1361,1525,-10
88987019196,88987019198,2,1263,1762,-10
88987125105,88987125085,-20,1830,1556,-10
88988774646,88988774649,3,1689,1846,-10
88988892905,88988892909,4,2079,1814,-10
88990989617,88990989618,1,1338,1955,-10
88991700747,88991700751,4,2197,1631,-10
88996252869,88996252869,0,1342,1774,-10
88996363203,88996363205,2,1687,1416,-10
88996658059,88996658063,4,1016,905,-10
89000197282,89000197284,2,1615,1426,-10
89002650945,89002650946,1,1507,1335,-10
89003992914,89003992914,0,822,1285,-10
89005027394,89005027394,0,1031,1285,-10
89007348519,89007348519,0,1380,1358,-10
89009073394,89009073391,-3,896,1055,-10
89010829225,89010829226,1,1832,1656,-10
89016871523,89016871527,4,1293,1693,-10
89018378751,89018378750,-1,1428,1515,-10
89019755958,89019755959,1,1599,1730,-10
89036552465,89036552466,1,1846,2184,-10
89037436230,89037436230,0,1332,1746,-10
89045381833,89045381831,-2,1057,1359,-10
89049864453,89049864447,-6,1584,6738,-10
89050729020,89050729023,3,1604,1535,-10
89052256399,89052256401,2,1924,2377,-10
89053052158,89053052158,0,1797,1908,-10
89055811404,89055811405,1,1702,1390,-10
89059255026,89059255031,5,1302,1400,-10
89064385095,89064385101,6,1645,1578,-10
89065167283,89065167287,4,1239,1340,-10
89067730270,89067730274,4,1674,1855,-10
89068337868,89068337874,6,1567,1388,-10
89068562014,89068562014,0,1530,3094,-10
89069960031,89069960031,0,1709,1717,-10
89077234402,89077234403,1,1115,1126,-10
89078126648,89078126634,-14,1604,2052,-10
89078541585,89078541603,18,325,1628,-10
89090401461,89090401463,2,1544,1064,-10
89091380395,89091380401,6,1136,982,-10
89092045952,89092045955,3,1848,1538,-10
89095855457,89095855461,4,1466,1632,-10
89095935323,89095935325,2,1127,1719,-10
89100442158,89100442159,1,1511,1512,-10
89101799125,89101799130,5,34422,37473,-10
89101898077,89101898080,3,1848,1821,-10
89107096758,89107096757,-1,1390,1422,-10
89109534941,89109534941,0,2042,1589,-10
89110496807,89110496810,3,2236,2426,-10
89113966782,89113966788,6,4298,1768,-10
89116110830,89116110834,4,3598,2080,-10
89117000638,89117000638,0,1526,1526,-10
89119862137,89119862139,2,1578,1598,-10
89124922409,89124922409,0,955,1761,-10
89128443831,89128443834,3,1469,1787,-10
89128476210,89128476211,1,1566,1509,-10
89128535772,89128535755,-17,2411,1216,-10
89130025617,89130025615,-2,1559,1527,-10
89130081807,89130081809,2,1191,1269,-10
89130335376,89130335377,1,1757,1510,-10
89130970350,89130970347,-3,1101,3192,-10
89131581950,89131581959,9,10279,27461,-10
89131612457,89131612458,1,1505,1455,-10
89132567851,89132567853,2,1792,1610,-10
89135923223,89135923222,-1,1601,1379,-10
89138279758,89138279757,-1,1107,1908,-10
89139231713,89139231714,1,1929,2042,-10
89139436274,89139436276,2,1796,1499,-10
89140008835,89140008841,6,1021,1340,-10
89141270090,89141270105,15,1044,5827,-10
89142866503,89142866504,1,2055,2589,-10
89148818045,89148818047,2,1513,1707,-10
89149527851,89149527853,2,1239,1580,-10
89151142554,89151142557,3,1980,1441,-10
89153434650,89153434652,2,1544,1193,-10
89154036188,89154036189,1,1223,1079,-10
89156079765,89156079765,0,1705,1517,-10
89159246182,89159246184,2,1077,1645,-10
89159518082,89159518086,4,1750,1441,-10
89160576136,89160576141,5,12418,6654,-10
89160782048,89160782047,-1,2376,1774,-10
89160969639,89160969639,0,829,735,-10
89162064529,89162064533,4,1158,1378,-10
89164502322,89164502324,2,895,989,-10
89165868771,89165868770,-1,1296,1195,-10
89166665957,89166665957,0,1174,1578,-10
89172785422,89172785425,3,1336,1296,-10
89173139818,89173139833,15,1069,1627,-10
89173681983,89173681984,1,976,1335,-10
89174167298,89174167301,3,1513,1320,-10
89174248694,89174248691,-3,1178,2384,-10
89174779963,89174779966,3,1894,1101,-10
89175029615,89175029618,3,1330,942,-10
89177559534,89177559536,2,1421,1767,-10
89178975726,89178975726,0,996,1484,-10
89180385284,89180385286,2,1731,2622,-10
89181757080,89181757079,-1,1230,1066,-10
89182221362,89182221350,-12,1578,1387,-10
89184086743,89184086744,1,1634,1588,-10
89185805361,89185805364,3,1188,1521,-10
89187663485,89187663488,3,2355,1915,-10
89190873386,89190873389,3,1977,2054,-10
89193703133,89193703134,1,1543,1726,-10
89195496734,89195496735,1,31962,19985,-10
89197733828,89197733830,2,1203,1775,-10
89199624822,89199624825,3,1437,1514,-10
89200111777,89200111783,6,2176,1768,-10
89200451975,89200451979,4,2914,1649,-10
89200592847,89200592845,-2,788,1318,-10
89200955093,89200955094,1,2132,2474,-10
89207100846,89207100849,3,3327,2378,-10
89207305131,89207305134,3,968,1397,-10
89208051141,89208051141,0,1324,2096,-10
89208283149,89208283151,2,2161,1532,-10
89210060114,89210060118,4,2261,1784,-10
89212105519,89212105512,-7,1870,10156,-10
89212650169,89212650171,2,1984,1426,-10
89213492972,89213492974,2,1817,1712,-10
89213724811,89213724813,2,950,949,-10
89215000802,89215000805,3,1952,1663,-10
89215940112,89215940112,0,1968,1874,-10
89218390077,89218390078,1,842,1086,-10
89219337988,89219337991,3,1572,1110,-10
89223003762,89223003767,5,1615,1248,-10
89225031379,89225031383,4,1688,1821,-10
89226665332,89226665332,0,1464,1643,-10
89230233138,89230233140,2,1605,1063,-10
89233927722,89233927725,3,1573,1264,-10
89234387382,89234387393,11,1230,1390,-10
89238008018,89238008021,3,1495,1696,-10
89241721346,89241721344,-2,2275,3174,-10
89244143182,89244143187,5,1441,1103,-10
89244960398,89244960399,1,1201,1279,-10
89245832768,89245832765,-3,1071,1734,-10
89249440715,89249440714,-1,1033,1897,-10
89250931734,89250931735,1,1472,1850,-10
89252151599,89252151601,2,1678,1594,-10
89254701693,89254701695,2,1524,963,-10
89256587113,89256587115,2,1061,1306,-10
89257419533,89257419534,1,1708,969,-10
89262357319,89262357321,2,3167,3366,-10
89262413921,89262413925,4,1616,1314,-10
89264018611,89264018610,-1,1058,1939,-10
89264265622,89264265623,1,1466,1802,-10
89264396453,89264396454,1,1252,1510,-10
89265726970,89265726969,-1,960,957,-10
89271207793,89271207796,3,2195,2097,-10
89271776746,89271776747,1,1843,1545,-10
89272030872,89272030888,16,18144,15722,-10
89273032228,89273032231,3,2025,1682,-10
89273614433,89273614434,1,919,2212,-10
89273883977,89273883978,1,1383,2378,-10
89274414392,89274414394,2,1687,1752,-10
89274815982,89274815985,3,1295,1787,-10
89275440537,89275440540,3,1689,1008,-10
89276838740,89276838741,1,1253,1475,-10
89277869718,89277869719,1,1093,1197,-10
89279194043,89279194045,2,1342,1440,-10
89282552197,89282552198,1,1374,1468,-10
89282602522,89282602543,21,1217,1189,-10
89282992399,89282992403,4,1678,1168,-10
89296231846,89296231846,0,1605,1795,-10
89296453450,89296453453,3,1583,1162,-10
89297776877,89297776877,0,1842,1266,-10
89301779500,89301779503,3,2203,1875,-10
89302483827,89302483823,-4,856,1250,-10
89304307718,89304307718,0,1587,1845,-10
89304374121,89304374112,-9,1267,946,-10
89306962366,89306962366,0,1524,734,-10
89307824546,89307824550,4,1254,1726,-10
89309118108,89309118108,0,33784,51910,-10
89309873730,89309873731,1,1661,1550,-10
89319827897,89319827900,3,2711,2210,-10
89323146985,89323146984,-1,658,1417,-10
89326296113,89326296115,2,1791,1431,-10
89327107546,89327107545,-1,815,1921,-10
89330568969,89330568972,3,2191,1613,-10
89331498506,89331498505,-1,1649,1375,-10
89336146798,89336146800,2,1244,959,-10
89336999682,89336999683,1,1458,1032,-10
89338399146,89338399149,3,1379,1120,-10
89338609234,89338609218,-16,1485,1131,-10
89339717398,89339717398,0,1449,1884,-10
89342203600,89342203601,1,1893,2001,-10
89342365235,89342365234,-1,1464,1417,-10
89342684646,89342684627,-19,1052,500,-10
89342719862,89342719865,3,1034,1060,-10
89348330588,89348330590,2,1639,1231,-10
89351804138,89351804141,3,1373,1427,-10
89351832621,89351832622,1,1429,1196,-10
89352229574,89352229552,-22,1357,1705,-10
89353932261,89353932262,1,1779,2119,-10
89355049293,89355049295,2,1451,1771,-10
89355208594,89355208594,0,1881,2007,-10
89356179535,89356179537,2,2648,2363,-10
89358589501,89358589502,1,1703,1583,-10
89360350738,89360350740,2,1760,1952,-10
89368132669,89368132671,2,1795,1265,-10
89368560431,89368560433,2,1669,1423,-10
89371230790,89371230794,4,2249,1274,-10
89374718417,89374718422,5,1718,1348,-10
89375177438,89375177440,2,2095,1784,-10
89379287831,89379287833,2,1272,1646,-10
89382146324,89382146325,1,1404,1397,-10
89384583420,89384583422,2,1296,1889,-10
89386802031,89386802051,20,1747,1204,-10
89390154127,89390154129,2,946,1095,-10
89399169902,89399169904,2,1347,1195,-10
89400810628,89400810629,1,1659,1573,-10
89404964166,89404964170,4,1416,561,-10
89405207062,89405207062,0,1213,896,-10
89407221544,89407221546,2,1209,1444,-10
89407702975,89407702982,7,9931,3885,-10
89412636641,89412636642,1,1826,1168,-10
89413640974,89413640978,4,1277,817,-10
89417873281,89417873285,4,2091,1049,-10
89418736288,89418736290,2,1070,1415,-10
89419804910,89419804892,-18,1658,1838,-10
89420999622,89420999625,3,1193,1545,-10
89421307139,89421307137,-2,1460,3744,-10
89422061275,89422061274,-1,1472,1470,-10
89423080613,89423080614,1,794,1272,-10
89425601609,89425601611,2,759,1231,-10
89430025073,89430025074,1,1744,1135,-10
89431870786,89431870786,0,1366,1431,-10
89432224810,89432224814,4,1692,1364,-10
89432973718,89432973719,1,1094,1578,-10
89436494543,89436494545,2,1552,1335,-10
89439762988,89439762991,3,1822,1505,-10
89456693717,89456693719,2,1068,1532,-10
89459123657,89459123659,2,1871,1407,-10
89459610840,89459610842,2,1395,1407,-10
89461692730,89461692731,1,1084,1376,-10
89462730125,89462730126,1,1193,1800,-10
89465522871,89465522871,0,1769,1529,-10
89465682063,89465682062,-1,1804,1745,-10
89466743969,89466743970,1,1620,1829,-10
89468297303,89468297303,0,1705,1709,-10
89469732978,89469732979,1,1562,1161,-10
89472916611,89472916611,0,1215,1793,-10
89474381759,89474381759,0,954,1530,-10
89476805638,89476805642,4,2050,1835,-10
89478197111,89478197113,2,1305,1911,-10
89484294094,89484294091,-3,2505,5091,-10
89484623089,89484623092,3,1086,1327,-10
89485171285,89485171290,5,2005,1308,-10
89487851406,89487851407,1,1428,1354,-10
89489681465,89489681467,2,2069,1878,-10
89490867566,89490867566,0,1534,1219,-10
89491426147,89491426149,2,1453,1473,-10
89493131738,89493131740,2,983,937,-10
89493785582,89493785583,1,965,975,-10
89498373667,89498373658,-9,801,4027,-10
89498812796,89498812799,3,1440,1385,-10
89499393527,89499393525,-2,1700,1944,-10
89500883834,89500883839,5,1724,1238,-10
89501928129,89501928130,1,1896,1348,-10
89502773225,89502773230,5,1698,1208,-10
89503116894,89503116893,-1,1307,1321,-10
89503777718,89503777719,1,1656,1262,-10
89503891994,89503891976,-18,2808,1274,-10
89507122347,89507122346,-1,1456,1326,-10
89507218066,89507218069,3,1720,2022,-10
89507643375,89507643375,0,1778,1378,-10
89510478961,89510478963,2,1684,1699,-10
89513577791,89513577793,2,2025,1803,-10
89515519442,89515519442,0,1664,1554,-10
89515586752,89515586733,-19,1171,2016,-10
89516165246,89516165249,3,1246,1683,-10
89520650823,89520650826,3,1209,1319,-10
89520920030,89520920033,3,1278,1982,-10
89522695279,89522695278,-1,1439,1487,-10
89523953433,89523953435,2,1626,1366,-10
89526596016,89526596018,2,1333,2123,-10
89528551041,89528551043,2,2167,2179,-10
89529184107,89529184097,-10,747,3057,-10
89531419389,89531419389,0,1202,1445,-10
89532128117,89532128118,1,1786,2380,-10
89537229594,89537229594,0,1645,1811,-10
89537617592,89537617593,1,2020,1663,-10
89539179963,89539179965,2,1931,1739,-10
89542916946,89542916942,-4,637,1638,-10
89545413414,89545413415,1,1424,1223,-10
89547042662,89547042665,3,1348,1773,-10
89547613705,89547613707,2,1065,1150,-10
89553893618,89553893619,1,1283,1406,-10
89554568158,89554568161,3,1414,1427,-10
89561220344,89561220346,2,1733,1200,-10
89561444310,89561444290,-20,1869,1401,-10
89563286067,89563286069,2,1745,1950,-10
89564040132,89564040133,1,1867,2201,-10
89567640682,89567640682,0,2287,3332,-10
89568813487,89568813489,2,2207,1809,-10
89569224617,89569224618,1,1799,1109,-10
89576544854,89576544855,1,1750,1919,-10
89576869908,89576869914,6,3052,1330,-10
89581800409,89581800410,1,1412,1263,-10
89584407847,89584407844,-3,30281,17397,-10
89585212189,89585212189,0,1194,894,-10
89588734197,89588734203,6,33451,12063,-10
89589536814,89589536813,-1,1413,1966,-10
89590037106,89590037109,3,1875,1682,-10
89590145194,89590145194,0,1285,1930,-10
89590782706,89590782710,4,1342,1161,-10
89594780758,89594780759,1,1805,1704,-10
89599221804,89599221807,3,1686,1295,-10
89601498810,89601498810,0,1278,1094,-10
89603198338,89603198330,-8,991,3284,-10
89604316794,89604316796,2,1118,1300,-10
89605950591,89605950592,1,1273,2023,-10
89609113001,89609113002,1,1825,2573,-10
89609633594,89609633597,3,4498,2276,-10
89612772537,89612772539,2,1410,1143,-10
89613423453,89613423455,2,1117,1453,-10
89615675135,89615675131,-4,1417,1523,-10
89616307721,89616307718,-3,1642,5700,-10
89624754590,89624754586,-4,1136,4281,-10
89626633168,89626633172,4,1494,1545,-10
89627907469,89627907472,3,1420,1670,-10
89629061547,89629061549,2,2034,1548,-10
89629525365,89629525344,-21,1022,1140,-10
89631435248,89631435249,1,1420,1426,-10
89632371698,89632371703,5,1876,1106,-10
89632464447,89632464456,9,1010,1751,-10
89634622551,89634622550,-1,913,1219,-10
89638861730,89638861731,1,1035,1183,-10
89641088193,89641088197,4,1302,1435,-10
89648903304,89648903307,3,1677,1530,-10
89650046846,89650046848,2,1450,2003,-10
89650453101,89650453103,2,1415,1158,-10
89654236998,89654237001,3,1669,1401,-10
89654889227,89654889224,-3,975,1543,-10
89657521878,89657521880,2,1373,1439,-10
89659600542,89659600543,1,1171,1178,-10
89660679655,89660679658,3,2135,1855,-10
89663122303,89663122305,2,2075,1896,-10
89663894930,89663894931,1,1650,1975,-10
89665922270,89665922271,1,2060,1353,-10
89668091279,89668091281,2,2172,1921,-10
89669366361,89669366362,1,1642,1191,-10
89674883634,89674883636,2,1957,2570,-10
89677177508,89677177512,4,1277,1145,-10
89681686937,89681686941,4,1833,1924,-10
89681961218,89681961221,3,1657,1496,-10
89683364798,89683364799,1,933,1409,-10
89684457123,89684457126,3,1774,1304,-10
89685869037,89685869020,-17,1093,674,-10
89686619166,89686619169,3,1267,1289,-10
89689154531,89689154547,16,1793,1364,-10
89689318193,89689318202,9,1417,1436,-10
89692769298,89692769296,-2,1138,2440,-10
89692929113,89692929093,-20,1124,1477,-10
89693735385,89693735387,2,1418,1612,-10
89693841354,89693841354,0,1219,1749,-10
89694128853,89694128854,1,1337,1269,-10
89694467866,89694467865,-1,1107,2420,-10
89695479720,89695479721,1,1810,1194,-10
89696054758,89696054759,1,1887,1628,-10
89699140504,89699140506,2,2130,1991,-10
89699449601,89699449602,1,2117,1888,-10
89699909970,89699909974,4,2018,1715,-10
89700791073,89700791074,1,1551,1703,-10
89703821648,89703821632,-16,1247,1378,-10
89704575552,89704575551,-1,1316,1314,-10
89709921861,89709921863,2,1334,1461,-10
89710087974,89710087979,5,1893,1421,-10
89712269886,89712269888,2,1112,1431,-10
89712864070,89712864071,1,1195,983,-10
89716561958,89716561958,0,2160,2022,-10
89717955401,89717955402,1,1799,1644,-10
89721453099,89721453101,2,977,1415,-10
89722012773,89722012775,2,1586,1451,-10
89725520909,89725520910,1,1428,1627,-10
89726467405,89726467407,2,2473,2105,-10
89731725917,89731725919,2,1215,2011,-10
89735601807,89735601810,3,1059,1501,-10
89735761147,89735761145,-2,717,1205,-10
89737782827,89737782829,2,838,1013,-10
89741049513,89741049517,4,1703,1971,-10
89742237845,89742237848,3,1675,1750,-10
89746740234,89746740238,4,1814,1470,-10
89746978070,89746978074,4,1642,1447,-10
89754528281,89754528282,1,1739,1837,-10
89755187275,89755187279,4,1688,1167,-10
89760293903,89760293905,2,1504,2031,-10
89763277881,89763277883,2,1831,1295,-10
89763524134,89763524145,11,1171,783,-10
89764962062,89764962066,4,2028,1689,-10
89766642526,89766642530,4,1715,1694,-10
89772604835,89772604837,2,897,837,-10
89779451924,89779451925,1,1213,1161,-10
89779490942,89779490922,-20,1741,1614,-10
89783612399,89783612402,3,1170,1243,-10
89785067356,89785067358,2,1729,1700,-10
89786525308,89786525311,3,1693,1534,-10
89789535097,89789535098,1,1255,1067,-10
89792374474,89792374475,1,1257,1211,-10
89794209418,89794209421,3,1239,1480,-10
89794620522,89794620522,0,1359,1386,-10
89795605521,89795605522,1,2300,2379,-10
89796051302,89796051303,1,1156,1299,-10
89801040090,89801040091,1,1460,1490,-10
89802121413,89802121414,1,1408,1306,-10
89803505734,89803505754,20,1533,1294,-10
89806833115,89806833117,2,1560,1672,-10
89808034082,89808034085,3,1859,1903,-10
89810554833,89810554833,0,1493,1623,-10
89811746967,89811746966,-1,1713,1660,-10
89812083042,89812083045,3,1346,1369,-10
89813466943,89813466944,1,1575,2149,-10
89813952843,89813952847,4,1434,1192,-10
89816275486,89816275486,0,1437,2004,-10
89817676682,89817676682,0,1684,1381,-10
89819553574,89819553570,-4,1142,2975,-10
89827225608,89827225610,2,2154,1861,-10
89827279890,89827279891,1,1796,1470,-10
89827834209,89827834213,4,1833,1725,-10
89830307290,89830307298,8,4810,1384,-10
89831787742,89831787743,1,1683,1254,-10
89833546109,89833546115,6,6267,2535,-10
89836945760,89836945761,1,1459,1601,-10
89838966692,89838966694,2,1940,1872,-10
89840914461,89840914461,0,1472,1432,-10
89844481854,89844481855,1,1259,1096,-10
89848036423,89848036426,3,1322,1053,-10
89848728725,89848728730,5,1710,1289,-10
89849880310,89849880310,0,1704,1545,-10
89851546742,89851546744,2,2358,1727,-10
89851940057,89851940059,2,1843,2106,-10
89852169104,89852169104,0,1273,1408,-10
89854451442,89854451448,6,5009,2331,-10
89855233775,89855233778,3,976,952,-10
89857085911,89857085914,3,1440,1738,-10
89859588477,89859588479,2,2230,1555,-10
89861464165,89861464167,2,1866,1623,-10
89862894434,89862894436,2,1332,1850,-10
89865089599,89865089601,2,1184,1001,-10
89865774774,89865774776,2,1759,1580,-10
89867432445,89867432445,0,1554,2217,-10
89868506619,89868506622,3,1789,1776,-10
89873370955,89873370955,0,890,1364,-10
89875673918,89875673920,2,1321,1451,-10
89879473814,89879473815,1,1353,1269,-10
89879774046,89879774047,1,1052,1012,-10
89880092081,89880092084,3,1627,2028,-10
89881609380,89881609384,4,1881,1327,-10
89881781018,89881781019,1,1741,1262,-10
89882195562,89882195565,3,1730,1162,-10
89884578595,89884578595,0,1409,1311,-10
89888566502,89888566506,4,1800,1732,-10
89889594157,89889594159,2,1570,1336,-10
89890032411,89890032412,1,2644,1315,-10
89898577579,89898577599,20,209,1920,-10
89899473154,89899473154,0,1534,1669,-10
89902692707,89902692713,6,3039,1844,-10
89907878507,89907878509,2,2089,2794,-10
89909143961,89909143964,3,1371,1013,-10
89910415718,89910415720,2,1579,1387,-10
89915497386,89915497391,5,6425,2764,-10
89916470122,89916470120,-2,1290,2156,-10
89916595765,89916595770,5,1486,987,-10
89919689583,89919689585,2,1351,1583,-10
89922166085,89922166082,-3,1278,1729,-10
89924368581,89924368581,0,1067,1524,-10
89924584194,89924584195,1,1583,2232,-10
89925087596,89925087597,1,1135,1703,-10
89929352950,89929352950,0,1329,1406,-10
89933461052,89933461074,22,1808,1355,-10
89934244654,89934244657,3,1624,1373,-10
89934321877,89934321878,1,923,1582,-10
89936367962,89936367963,1,1910,1782,-10
89939704370,89939704374,4,2533,1729,-10
89942140784,89942140801,17,481,2078,-10
89942537003,89942537002,-1,1203,1418,-10
89946187490,89946187493,3,1765,1309,-10
89949712567,89949712570,3,4002,2902,-10
89950988466,89950988468,2,1370,1650,-10
89953632838,89953632841,3,1225,1715,-10
89959027950,89959027952,2,2153,2392,-10
89960152175,89960152178,3,1853,1535,-10
89962555762,89962555764,2,2302,2482,-10
89962960816,89962960822,6,1555,972,-10
89966756225,89966756228,3,1535,1364,-10
89968254258,89968254260,2,53028,55336,-10
89970301101,89970301104,3,1995,1508,-10
89971765328,89971765330,2,1782,1269,-10
89978344889,89978344892,3,903,1635,-10
89982932557,89982932557,0,1376,1993,-10
89985677083,89985677085,2,1943,1925,-10
89987417598,89987417598,0,1407,907,-10
89989139371,89989139368,-3,1103,1810,-10
89990284477,89990284479,2,2634,2450,-10
89990866878,89990866881,3,1612,2002,-10
89990986813,89990986814,1,1534,1659,-10
89991395934,89991395936,2,1542,1910,-10
89991729016,89991729017,1,1500,1452,-10
89993741496,89993741498,2,2265,1416,-10
89996944821,89996944822,1,1356,1144,-10
89999513824,89999513826,2,1348,1590,-10
90000682502,90000682503,1,1522,1466,-10
90003614319,90003614318,-1,1353,1362,-10
90010036994,90010036995,1,1915,1778,-10
90010322471,90010322474,3,2597,1710,-10
90024732287,90024732288,1,1277,1350,-10
90025740689,90025740687,-2,1275,2434,-10
90028375991,90028375992,1,582,1011,-10
90029225551,90029225551,0,810,1369,-10
90029919916,90029919920,4,1674,1518,-10
90030072211,90030072210,-1,1342,1800,-10
90034743987,90034743990,3,2215,1240,-10
90040011576,90040011579,3,1826,1348,-10
90043702775,90043702773,-2,1397,1329,-10
90046022937,90046022934,-3,1177,1155,-10
90047356402,90047356404,2,1972,2006,-10
90047537001,90047537005,4,2835,2235,-10
90050461469,90050461470,1,1693,1576,-10
90054558803,90054558798,-5,728,2489,-10
90055437223,90055437225,2,1476,1812,-10
90057854492,90057854494,2,1297,1387,-10
90061756653,90061756655,2,967,1404,-10
90062086718,90062086722,4,1721,1527,-10
90062728247,90062728248,1,1121,2249,-10
90065363965,90065363966,1,1689,1433,-10
90065915892,90065915896,4,1575,1680,-10
90066587023,90066587022,-1,1350,1356,-10
90075376013,90075376016,3,1672,1524,-10
90075967497,90075967497,0,1355,1734,-10
90076758362,90076758362,0,1107,2072,-10
90077127028,90077127010,-18,996,1461,-10
90077897615,90077897616,1,2252,1795,-10
90080980295,90080980312,17,1764,1676,-10
90082179299,90082179301,2,2514,2149,-10
90085714750,90085714751,1,1553,1583,-10
90087211644,90087211647,3,886,1096,-10
90088254270,90088254273,3,1670,1324,-10
90091387226,90091387227,1,2115,2509,-10
90095223373,90095223374,1,1446,1360,-10
90095390587,90095390592,5,4285,2410,-10
90099213725,90099213729,4,1499,1444,-10
90107364694,90107364698,4,1483,1634,-10
90108318047,90108318049,2,1489,1541,-10
90108616229,90108616233,4,2048,1944,-10
90111464742,90111464743,1,1913,1507,-10
90113478883,90113478886,3,1089,1454,-10
90115021989,90115022009,20,1309,1255,-10
90120431309,90120431310,1,2196,1887,-10
90122138251,90122138248,-3,1145,1890,-10
90125470838,90125470843,5,2786,1404,-10
90128702387,90128702366,-21,1597,1370,-10
90129834894,90129834896,2,1625,1970,-10
90132357279,90132357280,1,1761,1737,-10
90138011410,90138011410,0,1315,1472,-10
90142711048,90142711051,3,1606,1598,-10
90145204695,90145204697,2,1364,1590,-10
90145273123,90145273126,3,978,1322,-10
90146001746,90146001746,0,1848,1068,-10
90148593533,90148593525,-8,1413,1163,-10
90150497041,90150497042,1,1481,1300,-10
90152707165,90152707166,1,1246,1533,-10
90153713799,90153713799,0,1283,1416,-10
90157263426,90157263430,4,1442,1176,-10
90157308095,90157308098,3,358,692,-10
90160627550,90160627551,1,1103,1085,-10
90161962021,90161962022,1,1580,1769,-10
90167361103,90167361105,2,6736,6191,-10
90169293416,90169293421,5,6767,4911,-10
90174930465,90174930468,3,2238,1698,-10
90175249717,90175249714,-3,1335,1435,-10
90175363258,90175363251,-7,1608,1447,-10
90176805075,90176805077,2,1214,1449,-10
90177031327,90177031329,2,1614,1407,-10
90177491742,90177491743,1,975,1443,-10
90179467314,90179467314,0,1977,2087,-10
90179795771,90179795773,2,1018,704,-10
90181875127,90181875130,3,1638,1848,-10
90185921265,90185921266,1,1658,1389,-10
90187913982,90187913985,3,1721,1203,-10
90189712546,90189712549,3,1262,1678,-10
90190207686,90190207681,-5,725,2002,-10
90193530674,90193530677,3,2375,1716,-10
90203453853,90203453854,1,1419,1475,-10
90204840030,90204840034,4,1687,1921,-10
90208129385,90208129385,0,1727,2845,-10
90209645781,90209645785,4,1285,1037,-10
90209782270,90209782274,4,1218,1042,-10
90210178765,90210178766,1,972,1407,-10
90220391931,90220391933,2,1567,1572,-10
90221919850,90221919853,3,2076,1754,-10
90222043637,90222043637,0,1126,1266,-10
90227626720,90227626743,23,1492,1607,-10
90228894433,90228894436,3,1427,1332,-10
90237856819,90237856820,1,1721,1830,-10
90243775932,90243775934,2,1534,1687,-10
90246154211,90246154210,-1,1554,2122,-10
90249672020,90249672026,6,3168,1658,-10
90249854669,90249854672,3,1564,1512,-10
90253261813,90253261815,2,1417,1942,-10
90254303587,90254303590,3,1462,1474,-10
90254478457,90254478459,2,1741,2066,-10
90255235742,90255235743,1,1103,1161,-10
90256247005,90256247007,2,1974,2062,-10
90256703053,90256703054,1,1520,1697,-10
90260186356,90260186359,3,1390,1403,-10
90260457679,90260457688,9,1643,1610,-10
90263869163,90263869158,-5,682,2446,-10
90265629337,90265629340,3,1843,1782,-10
90266483634,90266483628,-6,2544,7128,-10
90269645137,90269645140,3,1835,2014,-10
90272037593,90272037595,2,1111,1587,-10
90273951721,90273951722,1,1915,2037,-10
90275655958,90275655957,-1,1437,1514,-10
90282796486,90282796486,0,1437,1644,-10
90283942921,90283942924,3,3032,3500,-10
90285342198,90285342200,2,1685,1660,-10
90288614498,90288614498,0,1196,1776,-10
90296699965,90296699967,2,1841,1788,-10
90296894559,90296894561,2,1711,1013,-10
90298082900,90298082899,-1,1667,1391,-10
90300892099,90300892101,2,1734,1418,-10
90301437106,90301437100,-6,1169,4267,-10
90303043071,90303043074,3,1885,1838,-10
90303353083,90303353086,3,1915,1698,-10
90303830250,90303830250,0,922,1204,-10
90305549315,90305549319,4,1196,1456,-10
90306551987,90306551989,2,911,753,-10
90307889920,90307889923,3,1501,2110,-10
90308197097,90308197099,2,1712,1516,-10
90310715669,90310715671,2,1344,1512,-10
90313615383,90313615385,2,1836,2126,-10
90315991029,90315991032,3,2962,2354,-10
90316479935,90316479938,3,1242,1695,-10
90316635898,90316635899,1,865,1725,-10
90318444470,90318444472,2,1936,1649,-10
90318695613,90318695616,3,1353,1839,-10
90321110253,90321110257,4,2044,1981,-10
90321255223,90321255226,3,1311,959,-10
90321976175,90321976174,-1,1340,1611,-10
90322241966,90322241967,1,1216,1593,-10
90325456050,90325456050,0,1422,2034,-10
90327044652,90327044634,-18,1263,962,-10
90328212973,90328212974,1,1345,1442,-10
90328966403,90328966403,0,1296,751,-10
90329962557,90329962550,-7,1035,5895,-10
90331875394,90331875399,5,2219,1707,-10
90334845450,90334845450,0,1565,1735,-10
90335868408,90335868409,1,1986,1803,-10
90336823105,90336823107,2,1648,1667,-10
90339989002,90339989002,0,1440,1566,-10
90340683585,90340683586,1,1720,1811,-10
90341726092,90341726094,2,1224,1709,-10
90344237115,90344237125,10,1586,1531,-10
90348524125,90348524126,1,1442,1338,-10
90349216581,90349216583,2,1932,1449,-10
90349866256,90349866259,3,1317,1557,-10
90350345540,90350345542,2,2783,2130,-10
90354359646,90354359648,2,2904,1851,-10
90354678241,90354678242,1,1229,765,-10
90358373524,90358373525,1,1383,2142,-10
90361297578,90361297579,1,1866,1638,-10
90362094319,90362094320,1,1461,1350,-10
90363887379,90363887369,-10,1541,1226,-10
90364764610,90364764621,11,13868,8238,-10
90365812749,90365812751,2,1766,1990,-10
90367004954,90367004958,4,1555,1605,-10
90368099263,90368099283,20,1760,1690,-10
90368923432,90368923431,-1,1738,1894,-10
90369534799,90369534794,-5,1051,3746,-10
90371729438,90371729438,0,1228,959,-10
90373070338,90373070340,2,1482,990,-10
90374516706,90374516706,0,1425,1533,-10
90374690690,90374690692,2,2236,2372,-10
90375054145,90375054146,1,1442,1670,-10
90376916027,90376916027,0,819,922,-10
90381988940,90381988944,4,2021,1408,-10
90383248103,90383248102,-1,1321,2091,-10
90385680655,90385680643,-12,29247,16225,-10
90387148169,90387148170,1,2040,1584,-10
90388190035,90388190038,3,1460,1279,-10
90388408953,90388408955,2,1638,865,-10
90389637355,90389637358,3,1758,1777,-10
90389678916,90389678916,0,1542,1460,-10
90392392507,90392392510,3,1610,1208,-10
90395544877,90395544881,4,903,1248,-10
90396686850,90396686852,2,1552,1857,-10
90396950650,90396950653,3,2096,1700,-10
90398002999,90398003001,2,1355,1849,-10
90399498733,90399498733,0,2185,2121,-10
90399665373,90399665374,1,1282,1612,-10
90400207926,90400207930,4,1592,1667,-10
90401693296,90401693298,2,2163,1507,-10
90404536318,90404536322,4,1862,975,-10
90405851562,90405851564,2,2283,1968,-10
90405877230,90405877222,-8,1092,8490,-10
90406014866,90406014862,-4,252,9265,-10
90406512978,90406512980,2,1931,1469,-10
90406783145,90406783147,2,1881,1370,-10
90408409578,90408409577,-1,2669,2874,-10
90409527063,90409527067,4,1198,1217,-10
90410154578,90410154581,3,1034,1278,-10
90412425461,90412425464,3,1567,1600,-10
90414276869,90414276869,0,1188,1162,-10
90414375782,90414375783,1,1388,688,-10
90414695639,90414695641,2,1791,2513,-10
90415036541,90415036543,2,1797,1822,-10
90415063003,90415063005,2,1693,1853,-10
90416205967,90416205969,2,2349,1694,-10
90417997587,90417997589,2,1456,1886,-10
90422303401,90422303403,2,1549,1276,-10
90425561546,90425561548,2,1520,1136,-10
90429625365,90429625366,1,1306,1310,-10
90431077033,90431077036,3,1488,1643,-10
90432861987,90432861984,-3,1471,1057,-10
90434659673,90434659673,0,1896,1341,-10
90436390102,90436390102,0,1742,1757,-10
90442110682,90442110684,2,1254,1471,-10
90443877717,90443877719,2,2066,1399,-10
90445048501,90445048504,3,1870,1505,-10
90445094984,90445094987,3,1304,951,-10
90448444870,90448444865,-5,991,2399,-10
90451796654,90451796657,3,1969,1753,-10
90454818734,90454818737,3,1223,1999,-10
90456206365,90456206369,4,1185,1337,-10
90459384515,90459384518,3,2433,2011,-10
90463910875,90463910876,1,1715,1134,-10
90464204236,90464204235,-1,1820,2120,-10
90466462717,90466462719,2,1280,1307,-10
90468362522,90468362524,2,2330,1949,-10
90473300827,90473300829,2,1131,1528,-10
90476659692,90476659693,1,1692,1351,-10
90478230721,90478230722,1,1380,1390,-10
90480088572,90480088574,2,1030,1211,-10
90484752026,90484752029,3,1165,1433,-10
90485136223,90485136226,3,1764,1360,-10
90489132278,90489132281,3,1925,1797,-10
90494770979,90494770979,0,1432,1161,-10
90495784886,90495784889,3,1203,1245,-10
90497326191,90497326194,3,1519,1515,-10
90504325264,90504325266,2,908,1447,-10
90504481243,90504481232,-11,1871,1323,-10
90505265006,90505265009,3,1433,2072,-10
90506624055,90506624032,-23,1877,1478,-10
90507168263,90507168266,3,1443,1593,-10
90508285009,90508285010,1,1339,1189,-10
90513299361,90513299362,1,1525,1842,-10
90513861759,90513861762,3,1559,1329,-10
90519083815,90519083820,5,1740,1780,-10
90520225017,90520225020,3,2040,2084,-10
90520510525,90520510527,2,1310,1483,-10
90522297126,90522297129,3,1456,1467,-10
90525253409,90525253411,2,1159,1169,-10
90525645583,90525645585,2,1414,1388,-10
90526405822,90526405825,3,2804,2873,-10
90530752806,90530752810,4,1526,1814,-10
90530788578,90530788581,3,1524,1371,-10
90531375698,90531375699,1,1702,1816,-10
90532053224,90532053226,2,2154,1482,-10
90533220377,90533220378,1,2433,1943,-10
90533714886,90533714886,0,1884,2208,-10
90534099418,90534099420,2,1711,1748,-10
90536948173,90536948176,3,1730,1424,-10
90540364040,90540364042,2,2015,1714,-10
90540719157,90540719152,-5,1054,3679,-10
90542500839,90542500838,-1,1352,1145,-10
90546759682,90546759683,1,1698,1958,-10
90547495928,90547495930,2,1889,1122,-10
90548498230,90548498232,2,1427,1178,-10
90550375582,90550375560,-22,1595,524,-10
90554683761,90554683763,2,1782,1502,-10
90556640401,90556640399,-2,1267,1623,-10
90557944284,90557944286,2,1600,1736,-10
90563448938,90563448939,1,1401,1475,-10
90567390978,90567390978,0,1688,1324,-10
90568161611,90568161613,2,1230,1728,-10
90570773362,90570773365,3,1152,1319,-10
90572451994,90572451990,-4,1602,1453,-10
90573477060,90573477062,2,1951,2258,-10
90577709255,90577709256,1,1194,1062,-10
90579467158,90579467162,4,1697,1357,-10
90579875175,90579875178,3,1263,1234,-10
90582018143,90582018146,3,1929,1211,-10
90590232175,90590232170,-5,910,4119,-10
90591980444,90591980446,2,1471,1692,-10
90593271786,90593271789,3,1535,1760,-10
90594127582,90594127584,2,1703,1248,-10
90594666202,90594666204,2,1690,1725,-10
90595729131,90595729130,-1,1575,1883,-10
90599260431,90599260433,2,1478,1447,-10
90599671530,90599671532,2,2537,2512,-10
90602216212,90602216214,2,1738,1279,-10
90603414995,90603414998,3,1546,2032,-10
90606036858,90606036858,0,1148,1970,-10
90606890122,90606890125,3,2402,1898,-10
90607676202,90607676206,4,3483,1982,-10
90610244593,90610244594,1,2604,2632,-10
90614319865,90614319866,1,1489,1216,-10
90615730849,90615730857,8,3448,1695,-10
90621357557,90621357558,1,1866,1889,-10
90621401066,90621401069,3,1643,1337,-10
90622883253,90622883257,4,1428,1617,-10
90623048951,90623048955,4,1581,1567,-10
90627620618,90627620621,3,1640,1753,-10
90629945078,90629945071,-7,1074,5014,-10
90635352139,90635352142,3,1885,1393,-10
90635393247,90635393249,2,1079,1253,-10
90638111110,90638111111,1,1574,1308,-10
90639569699,90639569702,3,1609,1457,-10
90641405993,90641405994,1,1108,1538,-10
90642132462,90642132463,1,1761,2311,-10
90642485650,90642485654,4,1268,1613,-10
90644262542,90644262549,7,3047,1453,-10
90644803378,90644803383,5,1778,1104,-10
90645005606,90645005606,0,2313,2472,-10
90645330690,90645330693,3,1338,1765,-10
90645521510,90645521513,3,2354,1885,-10
90648277952,90648277954,2,2088,1897,-10
90650536896,90650536898,2,1485,1644,-10
90652036459,90652036459,0,1401,1824,-10
90653288134,90653288135,1,1264,1072,-10
90654477065,90654477067,2,1115,1194,-10
90656813015,90656813016,1,1615,1832,-10
90657036485,90657036489,4,1493,1873,-10
90658374787,90658374771,-16,1832,2578,-10
90661446330,90661446335,5,2456,1755,-10
90662054136,90662054137,1,1640,1607,-10
90663618502,90663618506,4,2029,1454,-10
90663666839,90663666836,-3,2594,6396,-10
90664197007,90664197002,-5,725,1907,-10
90666872574,90666872575,1,1226,2132,-10
90669936741,90669936743,2,3098,3169,-10
90677486118,90677486119,1,1602,1508,-10
90677624030,90677624031,1,1216,861,-10
90683367494,90683367496,2,1066,1448,-10
90685120854,90685120854,0,1528,1905,-10
90689420462,90689420465,3,1515,1193,-10
90690454998,90690455002,4,2608,1688,-10
90692416979,90692416981,2,1490,1882,-10
90693507929,90693507932,3,1371,1036,-10
90693600481,90693600484,3,1530,1856,-10
90696448714,90696448715,1,1811,1534,-10
90696554584,90696554586,2,1493,1653,-10
90698113478,90698113480,2,1615,1227,-10
90700523253,90700523256,3,1320,1892,-10
90703271410,90703271411,1,1041,1108,-10
90703600711,90703600712,1,1268,1466,-10
90709533417,90709533421,4,832,961,-10
90712163114,90712163098,-16,1482,1683,-10
90715031738,90715031741,3,2406,1845,-10
90717280123,90717280119,-4,1382,2540,-10
90723436149,90723436155,6,76115,36870,-10
90723583246,90723583246,0,998,1580,-10
90723662625,90723662626,1,1513,1729,-10
90725515560,90725515554,-6,2212,7582,-10
90726255208,90726255229,21,1490,1294,-10
90729122953,90729122954,1,2323,2219,-10
90731024918,90731024923,5,1266,1627,-10
90733676893,90733676895,2,1692,1489,-10
90738163651,90738163652,1,798,1389,-10
90740907517,90740907519,2,1617,1205,-10
90741407415,90741407417,2,1871,2284,-10
90743746805,90743746810,5,1921,1520,-10
90754199154,90754199154,0,1220,1799,-10
90755362469,90755362471,2,2404,2452,-10
90756074866,90756074867,1,1426,1252,-10
90756807259,90756807261,2,1566,1294,-10
90757006254,90757006256,2,1970,1937,-10
90760086758,90760086759,1,1472,1952,-10
90760965466,90760965466,0,1461,1487,-10
90761816906,90761816907,1,1331,1121,-10
90765740694,90765740698,4,1497,1610,-10
90766759945,90766759946,1,1556,1925,-10
90767597005,90767597008,3,1986,1970,-10
90768414311,90768414310,-1,1433,1899,-10
90770333407,90770333408,1,1174,1619,-10
90775684153,90775684154,1,2225,1831,-10
90779486832,90779486837,5,2530,1358,-10
90785169230,90785169231,1,1608,1172,-10
90786370560,90786370562,2,1843,1530,-10
90787076337,90787076337,0,1633,1555,-10
90787490829,90787490833,4,1935,1472,-10
90788038955,90788038958,3,1501,1515,-10
90792242823,90792242822,-1,1754,1340,-10
90792750342,90792750342,0,1402,1799,-10
90793525144,90793525146,2,1379,1315,-10
90796347411,90796347410,-1,1181,1261,-10
90798724558,90798724559,1,1387,1040,-10
90798832838,90798832831,-7,1197,6110,-10
90799857419,90799857421,2,2027,1922,-10
90799940686,90799940686,0,1162,1886,-10
90800257715,90800257718,3,1452,1841,-10
90802482264,90802482266,2,1577,1790,-10
90802761636,90802761640,4,2640,1787,-10
90804789269,90804789272,3,1607,1693,-10
90805308153,90805308150,-3,1507,3682,-10
90806074777,90806074779,2,1657,1744,-10
90807161865,90807161866,1,1439,1838,-10
90810328459,90810328462,3,1844,1883,-10
90810878279,90810878282,3,1058,1392,-10
90811626020,90811626022,2,1360,1640,-10
90817192704,90817192704,0,1911,2068,-10
90818390455,90818390459,4,2020,1494,-10
90821890469,90821890471,2,1949,1750,-10
90822521270,90822521271,1,1306,1681,-10
90826709341,90826709349,8,4223,1396,-10
90827444773,90827444779,6,3086,2052,-10
90828197962,90828197965,3,2152,1580,-10
90830700119,90830700122,3,1058,1035,-10
90832127104,90832127102,-2,1577,2358,-10
90832838322,90832838325,3,1044,1674,-10
90833859107,90833859110,3,1394,1302,-10
90839058014,90839058017,3,1813,1672,-10
90841242605,90841242609,4,3308,1561,-10
90841462823,90841462826,3,1382,926,-10
90845533853,90845533855,2,1128,1398,-10
90856394177,90856394183,6,3569,985,-10
90859285230,90859285234,4,2032,1365,-10
90863130843,90863130842,-1,932,1903,-10
90867690578,90867690582,4,1772,1315,-10
90868405544,90868405546,2,1631,1709,-10
90872399914,90872399915,1,1246,1430,-10
90873010069,90873010070,1,1455,1464,-10
90876050995,90876050995,0,1753,1669,-10
90878468263,90878468263,0,1713,1434,-10
90879574051,90879574051,0,1191,1288,-10
90881643983,90881643986,3,2106,1436,-10
90884597058,90884597062,4,1659,1380,-10
90885355253,90885355255,2,1404,1483,-10
90886753015,90886753018,3,1541,1652,-10
90886854323,90886854324,1,2619,2818,-10
90887607852,90887607855,3,1644,1496,-10
90892602145,90892602145,0,1252,1694,-10
90895974887,90895974888,1,1605,1603,-10
90896187881,90896187884,3,1425,1065,-10
90898374278,90898374277,-1,1399,1653,-10
90902605894,90902605895,1,2019,2384,-10
90903279826,90903279826,0,1207,1380,-10
90909382018,90909382021,3,1930,1910,-10
90911599517,90911599519,2,2420,2334,-10
90912034906,90912034908,2,1182,1154,-10
90912708582,90912708585,3,1317,1416,-10
90913651202,90913651202,0,981,978,-10
90914625354,90914625351,-3,1303,2268,-10
90916120242,90916120243,1,1784,1400,-10
90920467266,90920467266,0,1205,1170,-10
90925057549,90925057551,2,2175,1925,-10
90929926282,90929926284,2,2043,1661,-10
90934630417,90934630418,1,1765,2429,-10
90945897242,90945897243,1,2084,1738,-10
90947701914,90947701919,5,3311,1385,-10
90948024316,90948024318,2,1903,1548,-10
90951975219,90951975222,3,1405,1044,-10
90952645010,90952645012,2,1546,1378,-10
90953412674,90953412677,3,1269,1874,-10
90953514754,90953514754,0,1593,2066,-10
90954517891,90954517893,2,1836,1674,-10
90955844949,90955844950,1,1606,1532,-10
90956916584,90956916585,1,1424,1524,-10
90957015651,90957015633,-18,1310,1032,-10
90957702231,90957702231,0,1410,1414,-10
90957986621,90957986622,1,1887,2001,-10
90958184588,90958184588,0,1343,1427,-10
90964086833,90964086833,0,1260,1339,-10
90967407678,90967407681,3,1779,2020,-10
90968326942,90968326946,4,1458,1125,-10
90968491503,90968491502,-1,1020,1428,-10
90974487898,90974487898,0,1094,1988,-10
90975722846,90975722847,1,928,911,-10
90977199607,90977199610,3,1332,1232,-10
90981069477,90981069479,2,2160,1623,-10
90990923542,90990923544,2,1386,1352,-10
90992239210,90992239214,4,2074,2162,-10
90992926573,90992926577,4,1788,1865,-10
90993580025,90993580027,2,1076,999,-10
90993830706,90993830709,3,1774,1901,-10
90995075750,90995075751,1,1207,1619,-10
90995149065,90995149083,18,791,4482,-10
90995530179,90995530182,3,1444,1393,-10
91006217299,91006217301,2,1868,1395,-10
91006893289,91006893291,2,1520,1567,-10
91008827338,91008827341,3,1359,1792,-10
91009272069,91009272071,2,1457,1303,-10
91010820170,91010820173,3,1980,1875,-10
91011126635,91011126639,4,1955,1256,-10
91013218219,91013218222,3,1223,783,-10
91013463062,91013463065,3,1564,1559,-10
91015124442,91015124462,20,309,179,-10
91017043798,91017043798,0,1446,1749,-10
91019018392,91019018393,1,1438,1199,-10
91020312677,91020312679,2,1424,1573,-10
91023845609,91023845611,2,1707,1495,-10
91025022326,91025022327,1,1400,1541,-10
91027797225,91027797225,0,1124,1549,-10
91029031665,91029031662,-3,868,2281,-10
91030203631,91030203633,2,1490,1614,-10
91030381991,91030381993,2,1574,1146,-10
91030554370,91030554374,4,1904,1118,-10
91036562231,91036562234,3,7454,18940,-10
91040227802,91040227802,0,1640,1361,-10
91043582702,91043582704,2,1190,1359,-10
91046356943,91046356946,3,1904,1896,-10
91046391674,91046391675,1,1383,1434,-10
91051065391,91051065385,-6,1077,3745,-10
91052958378,91052958380,2,1718,1797,-10
91055178734,91055178737,3,2149,1468,-10
91061401329,91061401331,2,1928,1452,-10
91062487930,91062487934,4,1445,1647,-10
91068275471,91068275473,2,1177,1492,-10
91071870036,91071870037,1,1480,1455,-10
91071962869,91071962862,-7,944,5061,-10
91074014627,91074014630,3,1923,1621,-10
91074141417,91074141419,2,1831,1339,-10
91074592338,91074592354,16,1522,1475,-10
91076947394,91076947394,0,1805,1846,-10
91077516060,91077516063,3,1883,1692,-10
91080364759,91080364761,2,1562,1326,-10
91081891978,91081891982,4,1517,1499,-10
91082144299,91082144301,2,1193,908,-10
91086247021,91086247023,2,1876,1929,-10
91094223928,91094223930,2,2104,1493,-10
91098561964,91098561966,2,1932,1373,-10
91099769032,91099769031,-1,3552,16433,-10
91100067649,91100067651,2,2142,1389,-10
91101664846,91101664850,4,1688,1797,-10
91104276671,91104276672,1,911,1237,-10
91107483758,91107483761,3,1432,1750,-10
91107688822,91107688822,0,1200,1449,-10
91111155154,91111155157,3,1408,1486,-10
91111732781,91111732784,3,1622,1358,-10
91112365435,91112365437,2,1623,1605,-10
91112534319,91112534320,1,1505,2380,-10
91112841875,91112841879,4,1941,1255,-10
91114084202,91114084198,-4,876,1353,-10
91115049222,91115049222,0,1461,1628,-10
91119650258,91119650258,0,2095,1481,-10
91119983466,91119983471,5,2279,1244,-10
91126691942,91126691942,0,2141,1731,-10
91128592298,91128592300,2,1397,1328,-10
91129244346,91129244350,4,1666,1023,-10
91130268360,91130268362,2,1309,1357,-10
91131068511,91131068513,2,1290,1210,-10
91132099607,91132099609,2,953,1242,-10
91132304894,91132304893,-1,1365,1350,-10
91132533118,91132533121,3,1430,1546,-10
91133479786,91133479783,-3,2798,5459,-10
91135304047,91135304050,3,990,1156,-10
91138104397,91138104397,0,1454,1506,-10
91140137371,91140137370,-1,1804,2467,-10
91140692042,91140692044,2,1111,1835,-10
91141199648,91141199648,0,2180,1939,-10
91142039114,91142039116,2,1731,1925,-10
91143082551,91143082551,0,1179,2227,-10
91146550805,91146550811,6,3126,1870,-10
91148149518,91148149519,1,1617,1741,-10
91150431410,91150431410,0,1688,3374,-10
91150699886,91150699889,3,2493,1618,-10
91154733546,91154733547,1,1896,1606,-10
91155732175,91155732195,20,1762,1226,-10
91157331090,91157331089,-1,1720,1934,-10
91162309817,91162309820,3,1685,1450,-10
91163456122,91163456118,-4,1429,2917,-10
91166277267,91166277268,1,1398,1217,-10
91169893330,91169893330,0,1317,1648,-10
91171064901,91171064904,3,2337,2404,-10
91172140085,91172140086,1,1658,2099,-10
91176030434,91176030435,1,1395,1633,-10
91176809859,91176809866,7,2722,1366,-10
91179480827,91179480833,6,6057,2183,-10
91180227005,91180227006,1,1574,1507,-10
91181485343,91181485342,-1,1323,2475,-10
91182933326,91182933328,2,1588,1292,-10
91183203986,91183203987,1,886,1356,-10
91183546276,91183546278,2,1596,1083,-10
91190994498,91190994502,4,1400,1759,-10
91191442155,91191442157,2,1198,1487,-10
91193435987,91193435989,2,1627,1633,-10
91194181374,91194181377,3,1920,1768,-10
91197200873,91197200870,-3,1272,2317,-10
91197328731,91197328736,5,1171,849,-10
91200811609,91200811611,2,881,1912,-10
91202702178,91202702182,4,1565,1345,-10
91204336758,91204336762,4,1896,1375,-10
91204867451,91204867454,3,1179,1792,-10
91206653595,91206653597,2,1861,1848,-10
91208808600,91208808601,1,1171,1376,-10
91209815201,91209815202,1,972,1330,-10
91212666142,91212666144,2,1992,2136,-10
91218718562,91218718563,1,1513,1623,-10
91219112454,91219112453,-1,1496,1841,-10
91225956393,91225956394,1,2085,1815,-10
91226586746,91226586732,-14,1414,1107,-10
91227929503,91227929507,4,4177,2008,-10
91232579666,91232579666,0,908,1802,-10
91234343958,91234343961,3,1372,1519,-10
91235642966,91235642970,4,1724,1311,-10
91237790579,91237790579,0,1655,2282,-10
91238703947,91238703948,1,1434,1828,-10
91241290537,91241290537,0,1838,1090,-10
91242143090,91242143094,4,2134,1818,-10
91247349161,91247349157,-4,1304,2762,-10
91249979526,91249979527,1,1359,1615,-10
91250332873,91250332894,21,1342,1510,-10
91251581521,91251581524,3,2326,1529,-10
91252633457,91252633459,2,2520,2029,-10
91253079870,91253079873,3,1330,1031,-10
91253695425,91253695426,1,1919,1813,-10
91254083837,91254083839,2,1508,2035,-10
91254136526,91254136528,2,1793,1475,-10
91254165790,91254165794,4,2281,1626,-10
91256941969,91256941970,1,1496,1554,-10
91257935501,91257935501,0,1797,1885,-10
91260938727,91260938723,-4,1461,1503,-10
91262402750,91262402754,4,1384,1333,-10
91263088652,91263088654,2,1513,1543,-10
91265725755,91265725758,3,1689,1111,-10
91267467199,91267467216,17,1376,1231,-10
91269649910,91269649912,2,1754,1710,-10
91276259630,91276259634,4,1290,1029,-10
91278817345,91278817347,2,1490,1335,-10
91280078939,91280078941,2,1225,918,-10
91286050245,91286050245,0,1125,1166,-10
91287406670,91287406673,3,1103,756,-10
91291375159,91291375161,2,1523,1493,-10
91293815409,91293815413,4,1926,1401,-10
91295304174,91295304167,-7,2840,11337,-10
91295492062,91295492063,1,1789,2370,-10
91295529095,91295529097,2,1455,1157,-10
91295795546,91295795547,1,1782,1451,-10
91296736398,91296736400,2,2148,1863,-10
91297199650,91297199650,0,1568,1226,-10
91297583530,91297583533,3,1834,1665,-10
91302312707,91302312709,2,1350,1572,-10
91302379746,91302379736,-10,586,205,-10
91303632545,91303632549,4,1922,1466,-10
91305182082,91305182084,2,1217,908,-10
91306899506,91306899506,0,1912,1906,-10
91307557072,91307557074,2,1117,1304,-10
91308526146,91308526148,2,2400,1468,-10
91308575966,91308575981,15,12845,51678,-10
91308970718,91308970721,3,1922,1676,-10
91312938355,91312938353,-2,913,1378,-10
91313625334,91313625334,0,1214,1141,-10
91318182115,91318182119,4,1559,1774,-10
91322857461,91322857462,1,2632,1944,-10
91324283330,91324283334,4,5711,3476,-10
91326997547,91326997550,3,1197,1476,-10
91327478302,91327478305,3,1760,1553,-10
91335739076,91335739079,3,1661,1370,-10
91337452180,91337452183,3,1318,1575,-10
91342523237,91342523239,2,1830,1731,-10
91342911673,91342911675,2,1400,1297,-10
91342942355,91342942368,13,1430,1387,-10
91345059272,91345059274,2,1506,1965,-10
91346762647,91346762649,2,1678,2237,-10
91352522485,91352522486,1,1065,1225,-10
91356445474,91356445477,3,1336,1608,-10
91356886921,91356886923,2,1365,1658,-10
91358140575,91358140577,2,1896,2290,-10
91359938118,91359938120,2,1537,1070,-10
91360018074,91360018078,4,1641,1635,-10
91361572703,91361572711,8,6439,1460,-10
91362463124,91362463123,-1,1737,1652,-10
91366230466,91366230471,5,1001,1030,-10
91372362050,91372362051,1,2068,1601,-10
91376405431,91376405433,2,1378,1558,-10
91383882691,91383882695,4,3417,1906,-10
91386123086,91386123087,1,1390,1386,-10
91386788625,91386788627,2,924,200,-10
91387681162,91387681162,0,1344,1486,-10
91391277827,91391277829,2,1306,1671,-10
91391374101,91391374102,1,1284,1196,-10
91393436853,91393436856,3,1852,2140,-10
91396334681,91396334682,1,1473,1504,-10
91398710501,91398710507,6,3487,1471,-10
91402832526,91402832526,0,1460,1090,-10
91405012610,91405012611,1,1418,879,-10
91406554931,91406554931,0,1557,1070,-10
91407078326,91407078327,1,1379,1367,-10
91407734954,91407734955,1,2107,1770,-10
91408584331,91408584329,-2,1423,2770,-10
91408627162,91408627162,0,1512,1850,-10
91411170361,91411170365,4,3112,1475,-10
91412288192,91412288194,2,1274,1540,-10
91413943498,91413943500,2,1553,1798,-10
91414356366,91414356369,3,1825,1821,-10
91415520271,91415520274,3,1483,650,-10
91417895841,91417895843,2,1184,1668,-10
91420315846,91420315847,1,1454,1396,-10
91423071559,91423071565,6,4147,1364,-10
91423168402,91423168405,3,1563,1249,-10
91425817272,91425817274,2,839,1479,-10
91428730911,91428730912,1,1871,2756,-10
91430409992,91430409976,-16,4110,699,-10
91431716300,91431716283,-17,98,4,-10
91431852927,91431852930,3,1508,1328,-10
91438300564,91438300554,-10,1268,1064,-10
91439300208,91439300211,3,2466,1255,-10
91440443421,91440443422,1,1779,1841,-10
91441584746,91441584748,2,1553,1590,-10
91443781150,91443781150,0,1457,1489,-10
91444034953,91444034954,1,1624,1211,-10
91445352315,91445352318,3,955,1392,-10
91445972922,91445972923,1,2006,2075,-10
91447125119,91447125123,4,1926,1398,-10
91447395012,91447395015,3,2410,2205,-10
91450027937,91450027939,2,1773,2078,-10
91452413560,91452413563,3,1671,1303,-10
91454567055,91454567058,3,1753,1349,-10
91457424164,91457424167,3,1773,1322,-10
91459606618,91459606619,1,1713,1341,-10
91466671545,91466671549,4,2554,1399,-10
91468186991,91468186991,0,1231,913,-10
91469142165,91469142165,0,1580,1358,-10
91470013077,91470013078,1,1032,1267,-10
91470153662,91470153663,1,1921,1491,-10
91474747432,91474747435,3,1628,1465,-10
91478437291,91478437282,-9,702,6704,-10
91478703184,91478703205,21,1293,1375,-10
91483041783,91483041785,2,1556,1429,-10
91486776546,91486776546,0,1410,1362,-10
91487374566,91487374564,-2,1540,2632,-10
91490053413,91490053414,1,2137,2025,-10
91491155088,91491155091,3,1714,1421,-10
91492613789,91492613793,4,2131,1875,-10
91494525703,91494525706,3,1903,1392,-10
91497464131,91497464129,-2,1627,1694,-10
91500430514,91500430514,0,1245,2040,-10
91503721884,91503721886,2,1435,1786,-10
91503916694,91503916691,-3,1530,3638,-10
91505837306,91505837307,1,1739,1408,-10
91506420738,91506420738,0,1720,2246,-10
91507090398,91507090402,4,1883,1729,-10
91510098937,91510098938,1,1686,1584,-10
91513172454,91513172455,1,1611,1819,-10
91517772186,91517772187,1,1319,1242,-10
91518455542,91518455546,4,2048,1790,-10
91518929050,91518929053,3,1111,1013,-10
91519705940,91519705943,3,1621,1812,-10
91520594713,91520594714,1,1340,1305,-10
91521917643,91521917641,-2,904,1537,-10
91525351691,91525351691,0,1517,1314,-10
91526004097,91526004100,3,2494,1649,-10
91526320773,91526320774,1,2371,2163,-10
91529426645,91529426648,3,1458,1404,-10
91529531315,91529531297,-18,1239,1646,-10
91533197530,91533197533,3,1806,1951,-10
91536393034,91536393037,3,1530,1565,-10
91537534046,91537534051,5,1483,964,-10
91539685441,91539685442,1,1336,1555,-10
91540746665,91540746665,0,1899,1654,-10
91541165703,91541165706,3,1627,1558,-10
91544001341,91544001343,2,1553,1475,-10
91545669327,91545669325,-2,1377,1469,-10
91546912198,91546912202,4,1376,1531,-10
91547158566,91547158569,3,1291,2053,-10
91547575910,91547575913,3,1399,1209,-10
91550112190,91550112190,0,1713,1256,-10
91552737823,91552737826,3,1812,1784,-10
91553974982,91553974984,2,1388,1261,-10
91557983550,91557983546,-4,1049,1848,-10
91559054646,91559054648,2,2182,2326,-10
91560801886,91560801889,3,1498,1452,-10
91562309460,91562309479,19,1223,875,-10
91564877764,91564877769,5,6096,3136,-10
91565450114,91565450116,2,1225,1541,-10
91569798227,91569798231,4,1411,1616,-10
91572033609,91572033613,4,3484,1883,-10
91573252663,91573252666,3,1709,1120,-10
91576077939,91576077941,2,1812,1681,-10
91576412074,91576412076,2,1876,2048,-10
91577869419,91577869422,3,1435,1638,-10
91578604761,91578604762,1,2663,1955,-10
91581831010,91581831013,3,1425,1388,-10
91582980351,91582980351,0,965,837,-10
91584306186,91584306189,3,2174,2070,-10
91589677814,91589677816,2,1441,1135,-10
91591386590,91591386592,2,1312,1404,-10
91598119067,91598119070,3,1319,1545,-10
91598975697,91598975682,-15,1558,1186,-10
91599054686,91599054682,-4,1919,215,-10
91605914039,91605914041,2,1735,2080,-10
91606800464,91606800466,2,1719,1447,-10
91606949012,91606949014,2,1449,1933,-10
91607260991,91607260994,3,989,880,-10
91607717346,91607717348,2,1797,2017,-10
91611318094,91611318096,2,1325,1624,-10
91616294571,91616294575,4,1656,1889,-10
91619965342,91619965345,3,1259,1206,-10
91622274090,91622274090,0,1392,1598,-10
91627161842,91627161843,1,1762,1725,-10
91628316621,91628316624,3,2074,1899,-10
91630540760,91630540761,1,1080,1682,-10
91631268007,91631268009,2,1793,2027,-10
91633977661,91633977661,0,1687,1123,-10
91634398094,91634398096,2,1748,1937,-10
91638274771,91638274774,3,1739,1275,-10
91639546009,91639546010,1,1694,1291,-10
91642481207,91642481208,1,1734,1987,-10
91644349873,91644349876,3,1620,2144,-10
91644498701,91644498702,1,1568,910,-10
91645112566,91645112586,20,1272,1360,-10
91647464365,91647464366,1,1676,1442,-10
91647959156,91647959150,-6,1581,3721,-10
91651800915,91651800920,5,1783,1114,-10
91658339241,91658339246,5,2021,1119,-10
91658824024,91658824026,2,2183,2352,-10
91659009169,91659009171,2,1891,1434,-10
91659813547,91659813550,3,1352,1081,-10
91661576016,91661576017,1,1883,1713,-10
91663395701,91663395703,2,1202,1218,-10
91664280910,91664280889,-21,2243,760,-10
91666270876,91666270878,2,1819,1726,-10
91670112459,91670112462,3,1260,1688,-10
91671716241,91671716244,3,1656,1051,-10
91672642299,91672642298,-1,969,1570,-10
91674164266,91674164267,1,1565,1247,-10
91674534635,91674534635,0,1734,1614,-10
91674766605,91674766606,1,1303,1974,-10
91678974494,91678974492,-2,2024,1751,-10
91683042074,91683042075,1,1479,1615,-10
91683093897,91683093901,4,1912,1460,-10
91687347250,91687347254,4,2022,1730,-10
91689886433,91689886435,2,1260,1184,-10
91690922113,91690922119,6,1554,960,-10
91694100180,91694100181,1,1190,867,-10
91696040958,91696040961,3,1856,1910,-10
91699375136,91699375139,3,1308,1242,-10
91701444118,91701444121,3,1300,1382,-10
91703231586,91703231586,0,1775,2181,-10
91703402103,91703402107,4,1954,1592,-10
91706560021,91706560024,3,1542,1620,-10
91707317631,91707317634,3,1773,1398,-10
91708441406,91708441408,2,1603,1108,-10
91709640034,91709640034,0,981,2109,-10
91715929899,91715929902,3,1756,1568,-10
91716111030,91716111030,0,1377,1306,-10
91716297384,91716297379,-5,1361,1435,-10
91716908715,91716908718,3,835,1024,-10
91717471533,91717471533,0,1081,1678,-10
91718459317,91718459318,1,1340,1130,-10
91723216698,91723216698,0,1579,1749,-10
91724062998,91724062997,-1,1494,1698,-10
91728206701,91728206723,22,1404,1063,-10
91731696628,91731696630,2,1237,1434,-10
91732387549,91732387552,3,1685,1587,-10
91733350177,91733350180,3,1229,1388,-10
91735464742,91735464746,4,1754,1311,-10
91739644596,91739644600,4,2005,1356,-10
91744586203,91744586204,1,1756,1409,-10
91747047322,91747047323,1,1694,1114,-10
91748323921,91748323925,4,1227,1102,-10
91748883185,91748883186,1,1163,964,-10
91750323158,91750323160,2,1348,1513,-10
91752776110,91752776111,1,1339,1401,-10
91757651813,91757651815,2,1686,979,-10
91759462771,91759462774,3,1525,1882,-10
91762128264,91762128264,0,1251,2063,-10
91764129990,91764129990,0,1266,1407,-10
91765316498,91765316501,3,2179,1876,-10
91766664693,91766664695,2,1424,1021,-10
91767696316,91767696331,15,1825,1312,-10
91773909273,91773909279,6,3117,2137,-10
91773978070,91773978070,0,2804,4368,-10
91774419458,91774419461,3,1451,2032,-10
91778884603,91778884603,0,1295,1382,-10
91780934991,91780934993,2,1547,2255,-10
91782647058,91782647050,-8,1277,3713,-10
91784134618,91784134621,3,1942,1872,-10
91785472595,91785472595,0,1651,1728,-10
91787430206,91787430210,4,1943,1999,-10
91788550458,91788550459,1,1416,2297,-10
91791519405,91791519406,1,2245,2353,-10
91791947889,91791947892,3,1808,1973,-10
91795231945,91795231945,0,1597,1741,-10
91797123789,91797123786,-3,1831,3522,-10
91803879821,91803879824,3,1218,1402,-10
91804306362,91804306363,1,1611,1403,-10
91808435626,91808435627,1,1831,2097,-10
91808573784,91808573787,3,1914,1995,-10
91809752998,91809752999,1,1314,939,-10
91810082483,91810082486,3,1278,1659,-10
91810345296,91810345298,2,2130,1676,-10
91810751530,91810751533,3,1003,1567,-10
91811550658,91811550659,1,980,642,-10
91811713688,91811713691,3,1654,1215,-10
91813346553,91813346549,-4,1707,3094,-10
91817878064,91817878066,2,976,770,-10
91820279104,91820279106,2,1641,1390,-10
91821718998,91821718997,-1,1506,1994,-10
91823045503,91823045506,3,1044,1069,-10
91823711842,91823711842,0,1543,1993,-10
91826370299,91826370300,1,1289,1578,-10
91826893762,91826893763,1,1607,1230,-10
91827234469,91827234471,2,1521,1360,-10
91829667000,91829667001,1,2004,1664,-10
91830728747,91830728750,3,1068,1557,-10
91832019604,91832019606,2,2023,2056,-10
91834059037,91834059041,4,1566,2016,-10
91836697594,91836697597,3,1214,1709,-10
91837603900,91837603903,3,1933,1738,-10
91839967675,91839967670,-5,887,4154,-10
91841837489,91841837490,1,1460,2276,-10
91843273942,91843273939,-3,1431,1435,-10
91845009069,91845009071,2,1335,1450,-10
91845759364,91845759365,1,1912,1361,-10
91847049538,91847049540,2,1919,2046,-10
91848794918,91848794919,1,1171,1456,-10
91849660270,91849660270,0,1148,1062,-10
91858066755,91858066758,3,2402,1789,-10
91858266048,91858266050,2,1671,1958,-10
91861239230,91861239227,-3,811,1111,-10
91864659394,91864659395,1,1588,1407,-10
91866137297,91866137301,4,1804,1252,-10
91871266319,91871266322,3,1979,1717,-10
91871569927,91871569927,0,1040,1271,-10
91873236969,91873236971,2,1962,1914,-10
91874227583,91874227585,2,1630,1672,-10
91875187393,91875187394,1,1068,1521,-10
91875716505,91875716508,3,1514,1533,-10
91877934746,91877934751,5,21973,23240,-10
91880002883,91880002883,0,1934,1707,-10
91885004370,91885004377,7,2349,1608,-10
91888300490,91888300489,-1,923,2362,-10
91894647987,91894647967,-20,1463,1441,-10
91898267523,91898267525,2,2137,1820,-10
91900840722,91900840725,3,2297,1477,-10
91901969246,91901969250,4,1183,1212,-10
91902666649,91902666650,1,2094,1108,-10
91903914377,91903914378,1,1387,1254,-10
91905459405,91905459406,1,1929,1292,-10
91907307354,91907307355,1,2175,1401,-10
91908419526,91908419526,0,1621,2282,-10
91908764572,91908764583,11,1940,1735,-10
91909706129,91909706128,-1,38736,23950,-10
91911431623,91911431625,2,973,1288,-10
91914175062,91914175064,2,1267,1806,-10
91915714224,91915714224,0,2024,2006,-10
91917228606,91917228609,3,1139,1062,-10
91917617924,91917617926,2,1229,1067,-10
91921162470,91921162471,1,1516,1773,-10
91921203845,91921203846,1,1518,1521,-10
91922204184,91922204185,1,1715,1499,-10
91924357913,91924357935,22,1051,1261,-10
91925793738,91925793739,1,1783,2247,-10
91929482687,91929482690,3,1729,1682,-10
91930975895,91930975894,-1,2029,1605,-10
91932448239,91932448242,3,1260,1391,-10
91933470336,91933470338,2,1736,1486,-10
91934344582,91934344585,3,1387,1633,-10
91935628813,91935628814,1,1350,1403,-10
91939993289,91939993291,2,1172,1332,-10
91942647222,91942647220,-2,1080,1949,-10
91943253821,91943253822,1,2318,1697,-10
91943395781,91943395783,2,1096,1076,-10
91946241307,91946241308,1,1579,1790,-10
91946776082,91946776064,-18,1161,859,-10
91951073594,91951073596,2,1345,1117,-10
91951946378,91951946378,0,1705,2162,-10
91956854209,91956854213,4,1369,1559,-10
91958383777,91958383778,1,1607,1667,-10
91959476687,91959476666,-21,1625,1712,-10
91960447659,91960447663,4,1956,1518,-10
91962396098,91962396099,1,1144,1591,-10
91962516077,91962516079,2,1466,1493,-10
91962625782,91962625785,3,4164,3872,-10
91965112579,91965112557,-22,1714,1807,-10
91966787977,91966787979,2,1343,1409,-10
91968391189,91968391190,1,1624,1703,-10
91968696451,91968696450,-1,1189,1400,-10
91975152010,91975152011,1,1885,1035,-10
91984523502,91984523502,0,1234,1224,-10
91985139130,91985139130,0,1343,1522,-10
91987652666,91987652669,3,1339,1718,-10
91990566155,91990566155,0,1626,1736,-10
91993776473,91993776474,1,1042,1066,-10
91994636782,91994636784,2,1610,1175,-10
92002400956,92002400958,2,1263,1800,-10
92003255193,92003255195,2,1921,1652,-10
92008665904,92008665906,2,1329,1310,-10
92009667490,92009667494,4,1378,1226,-10
92011703316,92011703312,-4,1462,1600,-10
92013342793,92013342797,4,1559,1630,-10
92013890214,92013890217,3,1838,2010,-10
92018687162,92018687163,1,1551,1282,-10
92027151557,92027151556,-1,1739,4619,-10
92027393330,92027393333,3,1951,2081,-10
92027425395,92027425398,3,2045,2682,-10
92028398943,92028398945,2,1192,1984,-10
92028606514,92028606515,1,1428,1565,-10
92029613081,92029613082,1,2099,1998,-10
92030545809,92030545810,1,1535,902,-10
92030990274,92030990279,5,2242,1187,-10
92033645798,92033645801,3,2271,1978,-10
92035143693,92035143694,1,2028,1539,-10
92035629331,92035629318,-13,1759,1402,-10
92036884675,92036884677,2,2422,1993,-10
92039388590,92039388593,3,1612,1591,-10
92041330767,92041330766,-1,1217,1340,-10
92041379737,92041379738,1,1521,1234,-10
92045242419,92045242419,0,1849,1405,-10
92047976436,92047976433,-3,779,1768,-10
92048942908,92048942907,-1,1606,1825,-10
92051925165,92051925166,1,1526,1576,-10
92052997003,92052997006,3,1166,906,-10
92054578349,92054578352,3,1314,1117,-10
92054657698,92054657699,1,1400,1297,-10
92059921463,92059921465,2,1556,1544,-10
92060822462,92060822463,1,1419,1511,-10
92061333603,92061333602,-1,1185,1449,-10
92062065545,92062065547,2,1483,1369,-10
92064671921,92064671923,2,1540,1372,-10
92064948715,92064948721,6,1716,871,-10
92065478316,92065478330,14,1605,1220,-10
92067842687,92067842689,2,783,1109,-10
92069858171,92069858173,2,1825,1241,-10
92070668060,92070668064,4,2042,1837,-10
92073660637,92073660642,5,1265,1479,-10
92076273462,92076273462,0,1147,1788,-10
92080041994,92080041995,1,1432,1800,-10
92080627865,92080627866,1,1729,1757,-10
92081116635,92081116637,2,2178,1807,-10
92082412039,92082412040,1,1201,1516,-10
92085174632,92085174633,1,1531,1258,-10
92091361538,92091361538,0,1087,951,-10
92092210295,92092210296,1,1533,1222,-10
92094635899,92094635899,0,1296,1262,-10
92095053670,92095053673,3,1539,1340,-10
92097213558,92097213561,3,1783,1770,-10
92097591122,92097591124,2,1731,1819,-10
92099470775,92099470775,0,1550,1073,-10
92100838186,92100838190,4,1355,1387,-10
92101639066,92101639066,0,1581,1565,-10
92103467046,92103467045,-1,798,1325,-10
92104675365,92104675369,4,1932,1424,-10
92107144294,92107144275,-19,1620,1524,-10
92113861326,92113861326,0,1378,1400,-10
92114669130,92114669130,0,1025,1479,-10
92114819676,92114819678,2,1184,1234,-10
92118091929,92118091930,1,1271,1189,-10
92118375474,92118375475,1,1063,1477,-10
92120125014,92120125015,1,1577,1204,-10
92120853122,92120853119,-3,1297,2107,-10
92121125210,92121125211,1,1126,1770,-10
92122005198,92122005193,-5,1066,4912,-10
92122108418,92122108419,1,1666,936,-10
92123312747,92123312749,2,1448,1331,-10
92125573470,92125573478,8,1923,831,-10
92133458594,92133458594,0,915,914,-10
92137002341,92137002343,2,1783,1744,-10
92143790071,92143790073,2,1915,2057,-10
92148100810,92148100811,1,1737,2217,-10
92150861346,92150861346,0,1602,1451,-10
92151235910,92151235911,1,1681,1756,-10
92155734921,92155734927,6,1835,1288,-10
92156381438,92156381440,2,1592,1225,-10
92156683222,92156683243,21,1121,1649,-10
92158109590,92158109590,0,1352,1360,-10
92162103010,92162103011,1,1533,1812,-10
92163193141,92163193144,3,1315,1448,-10
92164362424,92164362413,-11,22783,16377,-10
92166492451,92166492454,3,1596,1468,-10
92167987177,92167987181,4,1444,1476,-10
92171469294,92171469294,0,1300,1353,-10
92171882026,92171882029,3,1440,1600,-10
92174774133,92174774134,1,1371,1261,-10
92178212611,92178212613,2,1422,1117,-10
92178612862,92178612867,5,1724,1698,-10
92180406959,92180406959,0,1405,1852,-10
92181361808,92181361810,2,1849,1557,-10
92185436137,92185436138,1,1342,1515,-10
92186673450,92186673451,1,959,1365,-10
92187271813,92187271815,2,1059,1111,-10
92191369135,92191369136,1,1802,1750,-10
92191787461,92191787461,0,1566,2067,-10
92192013855,92192013857,2,1688,1679,-10
92196181323,92196181324,1,1383,1678,-10
92197849296,92197849301,5,1516,1100,-10
92199162373,92199162374,1,1408,1709,-10
92201774804,92201774806,2,1285,1186,-10
92202098498,92202098501,3,1278,1173,-10
92206182370,92206182371,1,1407,1115,-10
92207308666,92207308666,0,1078,930,-10
92207572146,92207572148,2,1920,1615,-10
92208243559,92208243562,3,1514,1424,-10
92209959503,92209959506,3,1533,1103,-10
92210497471,92210497473,2,1092,1671,-10
92211815307,92211815309,2,1772,1676,-10
92212616014,92212616016,2,1936,2287,-10
92215448213,92215448220,7,959,909,-10
92218461862,92218461862,0,1340,1865,-10
92220044489,92220044489,0,1356,1816,-10
92222639801,92222639803,2,1402,1044,-10
92223940086,92223940088,2,1227,1522,-10
92226151386,92226151387,1,2075,2400,-10
92228935305,92228935306,1,1591,835,-10
92229014290,92229014291,1,1080,1229,-10
92229995961,92229995961,0,1971,2458,-10
92231359000,92231359002,2,1605,996,-10
92231968005,92231968006,1,2011,1502,-10
92233492572,92233492573,1,1141,1288,-10
92234057531,92234057533,2,1868,1804,-10
92234854202,92234854203,1,1576,1954,-10
92238392593,92238392594,1,1653,2282,-10
92244016075,92244016077,2,1145,1755,-10
92245003315,92245003317,2,2201,1774,-10
92245721542,92245721549,7,4629,2307,-10
92245899139,92245899142,3,1791,1636,-10
92246232641,92246232643,2,1568,1138,-10
92247994502,92247994505,3,1137,1641,-10
92248973233,92248973235,2,1736,1771,-10
92252399085,92252399087,2,2065,1552,-10
92253256053,92253256053,0,1271,1224,-10
92253979724,92253979726,2,1217,1087,-10
92254917087,92254917088,1,1486,1548,-10
92257119733,92257119734,1,900,1392,-10
92261709626,92261709625,-1,1573,1933,-10
92265180271,92265180258,-13,8644,37587,-10
92266119605,92266119607,2,2154,2482,-10
92267112743,92267112747,4,1886,1287,-10
92272413585,92272413588,3,1606,1856,-10
92274177897,92274177897,0,1773,1329,-10
92274968616,92274968607,-9,1381,1620,-10
92276611326,92276611327,1,1181,1091,-10
92277590770,92277590771,1,1300,1292,-10
92277691509,92277691511,2,1504,1154,-10
92278299973,92278299974,1,1374,2286,-10
92283065150,92283065151,1,1117,1011,-10
92283401362,92283401351,-11,998,1640,-10
92283847473,92283847478,5,1620,1066,-10
92285584658,92285584660,2,1184,1112,-10
92286906251,92286906253,2,1554,1440,-10
92288703223,92288703225,2,1617,1067,-10
92289448618,92289448618,0,1844,1260,-10
92293588341,92293588340,-1,1785,1924,-10
92294269034,92294269038,4,1653,1447,-10
92296376303,92296376307,4,1858,1862,-10
92300410666,92300410671,5,1706,1793,-10
92303895509,92303895511,2,2347,1857,-10
92307620442,92307620442,0,1600,1616,-10
92308586259,92308586259,0,1665,1560,-10
92314422266,92314422269,3,2227,1577,-10
92315336066,92315336064,-2,1417,1873,-10
92317177578,92317177580,2,1599,1847,-10
92317969328,92317969329,1,1401,1587,-10
92318805690,92318805689,-1,1701,1827,-10
92319209569,92319209570,1,1975,1514,-10
92319648282,92319648285,3,1003,1229,-10
92320293189,92320293193,4,1212,1210,-10
92321924487,92321924490,3,2340,1953,-10
92322086013,92322086014,1,1321,1276,-10
92324472538,92324472538,0,1593,1329,-10
92326112182,92326112190,8,3242,1335,-10
92328976767,92328976768,1,1352,2047,-10
92330914679,92330914681,2,1980,1885,-10
92334158719,92334158722,3,935,1128,-10
92339967790,92339967794,4,2273,1952,-10
92341499190,92341499194,4,1583,1096,-10
92341577197,92341577199,2,2338,1782,-10
92345778102,92345778104,2,1971,2020,-10
92345960546,92345960547,1,1437,1554,-10
92347885674,92347885674,0,1269,1546,-10
92348097511,92348097512,1,1765,1665,-10
92348359463,92348359461,-2,754,1735,-10
92349300302,92349300304,2,1656,1526,-10
92357247309,92357247309,0,1129,1614,-10
92357545908,92357545910,2,1345,1525,-10
92358451466,92358451466,0,1780,1361,-10
92361748272,92361748273,1,1171,1143,-10
92368807087,92368807087,0,1324,1565,-10
92368882780,92368882803,23,1220,931,-10
92370472824,92370472819,-5,61,1070,-10
92373902416,92373902416,0,1493,1606,-10
92376830559,92376830563,4,1334,1124,-10
92379656742,92379656745,3,803,1339,-10
92380205308,92380205311,3,1386,1287,-10
92384304549,92384304551,2,1243,1320,-10
92388450743,92388450746,3,1594,1325,-10
92388752995,92388752998,3,1853,1747,-10
92391715970,92391715972,2,2177,2070,-10
92392377887,92392377887,0,1270,2279,-10
92393245826,92393245828,2,2007,1391,-10
92393557417,92393557422,5,1755,1578,-10
92393675133,92393675137,4,1335,1168,-10
92394275899,92394275900,1,2147,2795,-10
92396220363,92396220365,2,1547,1553,-10
92398393387,92398393389,2,1979,2350,-10
92400962982,92400962961,-21,965,495,-10
92401804678,92401804660,-18,1244,897,-10
92402932731,92402932733,2,1337,1078,-10
92405370673,92405370677,4,1710,1261,-10
92412039685,92412039688,3,1480,1615,-10
92413476090,92413476070,-20,71,1218,-10
92415124679,92415124682,3,1680,2000,-10
92416429334,92416429335,1,1218,1311,-10
92418717478,92418717460,-18,1641,1544,-10
92418821507,92418821507,0,1414,1336,-10
92419181624,92419181626,2,1739,1462,-10
92425024415,92425024414,-1,1166,1530,-10
92426268381,92426268382,1,1565,1387,-10
92426388560,92426388559,-1,1552,1552,-10
92431917706,92431917709,3,1598,1460,-10
92434433250,92434433247,-3,590,1157,-10
92435908829,92435908831,2,1138,574,-10
92437651223,92437651226,3,1615,1436,-10
92437947697,92437947702,5,2790,2025,-10
92442050662,92442050665,3,1953,1174,-10
92443571298,92443571299,1,1684,1838,-10
92445562923,92445562926,3,965,1171,-10
92446595008,92446595007,-1,47971,16125,-10
92449303703,92449303706,3,1753,1280,-10
92449607848,92449607855,7,5902,2822,-10
92449830911,92449830911,0,1816,1060,-10
92450177083,92450177085,2,1237,1289,-10
92451405054,92451405057,3,1505,1353,-10
92451903918,92451903938,20,934,1710,-10
92452641469,92452641469,0,1438,1398,-10
92454831919,92454831921,2,1286,1420,-10
92455241615,92455241611,-4,1065,1448,-10
92458338334,92458338335,1,1649,1057,-10
92464347263,92464347264,1,1447,2002,-10
92464541023,92464541029,6,3660,1974,-10
92465318583,92465318586,3,1429,1456,-10
92466056302,92466056302,0,1500,1814,-10
92468036450,92468036453,3,1669,1421,-10
92468879290,92468879294,4,1337,1559,-10
92472276225,92472276226,1,1310,1307,-10
92478285679,92478285682,3,1261,1539,-10
92482636326,92482636326,0,1670,1460,-10
92483801965,92483801963,-2,1277,1380,-10
92486428742,92486428746,4,2056,1454,-10
92487236405,92487236406,1,1306,1257,-10
92488428096,92488428099,3,1682,2037,-10
92493279450,92493279453,3,1591,1590,-10
92493585956,92493585957,1,1810,1753,-10
92494842836,92494842838,2,1865,2128,-10
92499342957,92499342958,1,1424,1802,-10
92500648591,92500648593,2,1867,1775,-10
92504367761,92504367766,5,1496,960,-10
92505329765,92505329767,2,958,1053,-10
92506337037,92506337038,1,2108,1917,-10
92506910369,92506910372,3,1331,1693,-10
92508873411,92508873410,-1,1947,1833,-10
92509419562,92509419562,0,1577,1226,-10
92510268541,92510268543,2,1163,1024,-10
92510343347,92510343366,19,908,1165,-10
92512489902,92512489908,6,2374,1492,-10
92512847419,92512847435,16,1844,1406,-10
92515606070,92515606071,1,1591,1589,-10
92516419057,92516419058,1,898,951,-10
92518291184,92518291187,3,2109,1165,-10
92521745281,92521745281,0,2134,2108,-10
92522115984,92522115986,2,1295,1535,-10
92523755257,92523755259,2,786,1744,-10
92525135568,92525135574,6,162,1138,-10
92526473941,92526473942,1,1755,1543,-10
92526882707,92526882709,2,1431,1213,-10
92528191873,92528191874,1,1702,1300,-10
92528281446,92528281464,18,695,352,-10
92534801401,92534801402,1,1701,2038,-10
92538244447,92538244450,3,1791,1726,-10
92541170842,92541170837,-5,1439,4138,-10
92542934622,92542934626,4,1456,1499,-10
92543415292,92543415295,3,1434,1225,-10
92547509290,92547509292,2,1458,1375,-10
92547639002,92547639003,1,1733,1319,-10
92550046821,92550046842,21,2711,1699,-10
92550810098,92550810098,0,1753,1365,-10
92552024351,92552024353,2,2046,2094,-10
92559535738,92559535742,4,1019,1403,-10
92561784966,92561784967,1,1111,1129,-10
92562159783,92562159786,3,1807,1495,-10
92562416262,92562416259,-3,53683,46773,-10
92564151673,92564151676,3,45523,8442,-10
92564191408,92564191409,1,1295,1385,-10
92564821820,92564821823,3,1832,1794,-10
92565012422,92565012426,4,3083,2607,-10
92566068453,92566068453,0,1007,1445,-10
92566692391,92566692393,2,1570,1008,-10
92568403907,92568403910,3,2152,2015,-10
92568533912,92568533915,3,2124,1999,-10
92570444158,92570444159,1,1841,1250,-10
92570655143,92570655146,3,1864,1829,-10
92573358994,92573358996,2,1895,2044,-10
92580703693,92580703695,2,1733,1846,-10
92580737082,92580737084,2,2003,1835,-10
92581644327,92581644347,20,406,601,-10
92583023326,92583023324,-2,1145,2516,-10
92583543641,92583543640,-1,925,1272,-10
92584893002,92584893005,3,1811,1442,-10
92586661018,92586661020,2,1467,1840,-10
92588062890,92588062890,0,1410,2081,-10
92589551779,92589551767,-12,1017,1087,-10
92591185849,92591185850,1,2193,2087,-10
92592979510,92592979510,0,1531,1847,-10
92597287409,92597287406,-3,2808,3294,-10
92598034491,92598034493,2,1946,1580,-10
92601074830,92601074830,0,1085,1467,-10
92601632744,92601632747,3,3323,1668,-10
92602925405,92602925399,-6,2064,6984,-10
92603847910,92603847911,1,1348,1512,-10
92612038950,92612038951,1,1784,1646,-10
92613678406,92613678410,4,1089,1600,-10
92614726785,92614726786,1,1465,1466,-10
92616394127,92616394132,5,1464,1383,-10
92616999870,92616999870,0,1485,1233,-10
92617873618,92617873620,2,1867,1226,-10
92619314684,92619314686,2,1813,1503,-10
92620115437,92620115443,6,3299,1325,-10
92622937171,92622937174,3,1927,1564,-10
92629114503,92629114506,3,1878,1203,-10
92629764706,92629764711,5,1808,1436,-10
92632261164,92632261167,3,1477,1705,-10
92632299401,92632299402,1,1629,1287,-10
92632784518,92632784522,4,2216,1445,-10
92633433782,92633433783,1,1745,1377,-10
92634531457,92634531454,-3,961,2658,-10
92635246568,92635246571,3,1323,1266,-10
92645868562,92645868567,5,2160,1315,-10
92649193346,92649193347,1,1960,2096,-10
92651578717,92651578718,1,482,998,-10
92654136424,92654136426,2,1500,1021,-10
92654224194,92654224196,2,1709,1685,-10
92656185869,92656185872,3,1972,1767,-10
92660199634,92660199638,4,2908,2409,-10
92664475401,92664475403,2,1778,2039,-10
92666247714,92666247719,5,3029,1500,-10
92666400886,92666400892,6,3131,1382,-10
92669622451,92669622452,1,1316,1433,-10
92671506083,92671506086,3,1673,1349,-10
92671863081,92671863084,3,1891,1475,-10
92672273102,92672273108,6,2076,1689,-10
92672582461,92672582463,2,1305,1540,-10
92672663129,92672663132,3,1365,1333,-10
92675004819,92675004800,-19,1140,1213,-10
92679830607,92679830610,3,1382,1555,-10
92683842978,92683842978,0,1574,1941,-10
92684132564,92684132566,2,1263,1422,-10
92687604694,92687604693,-1,1505,2238,-10
92687730517,92687730518,1,2167,2390,-10
92690346346,92690346362,16,14148,55421,-10
92690462189,92690462190,1,1136,987,-10
92690775956,92690775936,-20,1500,1121,-10
92691305582,92691305587,5,1400,1144,-10
92693147762,92693147764,2,1585,1448,-10
92693864630,92693864630,0,1216,1606,-10
92694533212,92694533214,2,1297,1419,-10
92697275051,92697275054,3,1314,1197,-10
92699760322,92699760322,0,1789,1499,-10
92699986385,92699986387,2,1549,1682,-10
92703941519,92703941521,2,1548,2072,-10
92705983898,92705983899,1,1308,1071,-10
92711116903,92711116906,3,1602,1493,-10
92714475151,92714475153,2,1487,747,-10
92715352517,92715352518,1,1026,1614,-10
92715677566,92715677567,1,1438,1248,-10
92716003330,92716003332,2,996,1550,-10
92716173981,92716173996,15,1983,1482,-10
92720335078,92720335082,4,1944,1433,-10
92722226543,92722226523,-20,20486,27269,-10
92722566509,92722566513,4,1415,1317,-10
92722639602,92722639602,0,1513,1749,-10
92724623950,92724623934,-16,1238,1129,-10
92725065520,92725065526,6,248,1181,-10
92725306546,92725306550,4,1867,1675,-10
92726246503,92726246506,3,2062,1493,-10
92728424168,92728424170,2,1825,1968,-10
92731604879,92731604882,3,1676,1178,-10
92736530303,92736530303,0,1068,894,-10
92738126711,92738126712,1,1919,1569,-10
92741347758,92741347763,5,951,995,-10
92745425125,92745425126,1,1632,1393,-10
92745499254,92745499256,2,1204,1500,-10
92746061751,92746061754,3,1445,1592,-10
92748740074,92748740076,2,1204,1738,-10
92754698353,92754698354,1,1903,1145,-10
92756792882,92756792888,6,11694,26037,-10
92759596436,92759596436,0,2045,2180,-10
92759708331,92759708334,3,1321,1758,-10
92761868122,92761868125,3,2010,2194,-10
92767793853,92767793854,1,1260,1781,-10
92769946066,92769946068,2,1053,1095,-10
92770228639,92770228617,-22,1135,1637,-10
92770322087,92770322089,2,1318,1526,-10
92771558915,92771558922,7,1667,1124,-10
92771729528,92771729529,1,1298,1454,-10
92774382703,92774382708,5,4303,2734,-10
92778209851,92778209851,0,1523,2133,-10
92778485418,92778485421,3,1073,1587,-10
92787104938,92787104934,-4,1016,2009,-10
92792909890,92792909889,-1,1031,2132,-10
92794118870,92794118870,0,1150,1548,-10
92798238922,92798238922,0,1307,1758,-10
92799789899,92799789900,1,1354,1373,-10
92800949796,92800949798,2,1576,1600,-10
92802250217,92802250214,-3,38555,22991,-10
92803616962,92803616966,4,1609,882,-10
92807854789,92807854790,1,1711,1137,-10
92810619323,92810619323,0,1111,947,-10
92810854986,92810854988,2,1444,1757,-10
92815716863,92815716879,16,878,4424,-10
92823648147,92823648150,3,1524,1576,-10
92826662296,92826662298,2,1045,1416,-10
92827308030,92827308030,0,1169,1345,-10
92827439296,92827439297,1,2067,2100,-10
92832623023,92832623025,2,1572,1775,-10
92843649239,92843649241,2,1450,1439,-10
92843750770,92843750785,15,1433,1580,-10
92850315439,92850315456,17,1330,1328,-10
92857056290,92857056294,4,1339,1572,-10
92858781519,92858781518,-1,1560,2001,-10
92859114008,92859114009,1,1794,1735,-10
92859237466,92859237469,3,1094,1129,-10
92861011249,92861011250,1,2285,1591,-10
92863493401,92863493402,1,2009,1613,-10
92867342867,92867342870,3,1788,1043,-10
92867467198,92867467210,12,1712,2088,-10
92867726465,92867726482,17,1490,1484,-10
92870209114,92870209114,0,2051,2350,-10
92872669822,92872669817,-5,905,1445,-10
92873635734,92873635735,1,1555,1165,-10
92873978323,92873978313,-10,1266,5774,-10
92875477637,92875477638,1,791,960,-10
92878043247,92878043249,2,2490,2346,-10
92878517358,92878517359,1,1482,1976,-10
92883228458,92883228464,6,3005,1464,-10
92884962946,92884962952,6,1612,1413,-10
92885120057,92885120058,1,1913,1193,-10
92885604018,92885604021,3,2535,2305,-10
92888544313,92888544308,-5,28756,13525,-10
92890248454,92890248454,0,1195,1335,-10
92894180870,92894180873,3,1439,1607,-10
92895103711,92895103714,3,1420,1249,-10
92901783550,92901783554,4,2035,1963,-10
92902520545,92902520546,1,2011,1725,-10
92906198274,92906198281,7,1617,923,-10
92907183011,92907183013,2,1718,1595,-10
92907706918,92907706919,1,959,1009,-10
92912683883,92912683885,2,1459,1105,-10
92914683430,92914683434,4,1317,1178,-10
92914850070,92914850070,0,1820,1588,-10
92915494556,92915494557,1,2182,1944,-10
92922694883,92922694885,2,1450,1377,-10
92922986021,92922986022,1,1033,660,-10
92924718202,92924718198,-4,1571,2763,-10
92925088818,92925088818,0,1072,1383,-10
92926472766,92926472766,0,2430,3525,-10
92926844963,92926844966,3,1227,1284,-10
92928717326,92928717326,0,1389,1445,-10
92932141842,92932141843,1,1050,1735,-10
92933613522,92933613525,3,1794,1572,-10
92935060526,92935060530,4,1992,1554,-10
92935806232,92935806235,3,2237,1541,-10
92936805022,92936805024,2,1981,1543,-10
92942734794,92942734795,1,1125,1593,-10
92945009189,92945009192,3,2060,1779,-10
92945766665,92945766668,3,1754,2287,-10
92948499291,92948499289,-2,1097,1936,-10
92953256227,92953256230,3,1081,1282,-10
92954241393,92954241393,0,1191,1635,-10
92955344190,92955344192,2,1539,1619,-10
92963121566,92963121562,-4,3787,9966,-10
92965214986,92965214988,2,1231,1202,-10
92966280753,92966280746,-7,1786,1562,-10
92970982366,92970982371,5,1272,1329,-10
92974202492,92974202472,-20,1881,1642,-10
92979381265,92979381265,0,2361,3099,-10
92980702870,92980702870,0,1443,2289,-10
92985098369,92985098370,1,1614,1387,-10
92985925710,92985925713,3,814,1645,-10
92986589494,92986589497,3,3303,3452,-10
92989386558,92989386560,2,1715,1437,-10
92991294870,92991294873,3,1439,1491,-10
92993021023,92993021025,2,1174,1084,-10
92993221919,92993221929,10,1310,1431,-10
92993549040,92993549041,1,1584,1685,-10
92995616502,92995616502,0,919,752,-10
93003605549,93003605550,1,1263,1113,-10
93005680278,93005680278,0,1430,1560,-10
93005967195,93005967181,-14,1145,1144,-10
93008551631,93008551637,6,4783,1854,-10
93008592259,93008592261,2,1627,1420,-10
93008937298,93008937299,1,1564,1592,-10
93009980705,93009980701,-4,1001,1806,-10
93016762821,93016762818,-3,953,1929,-10
93018185657,93018185658,1,1709,1756,-10
93018441748,93018441754,6,3494,1595,-10
93022131527,93022131532,5,3456,1793,-10
93024903330,93024903334,4,1718,1202,-10
93027166980,93027166981,1,1480,1300,-10
93030813759,93030813762,3,1593,1523,-10
93031902370,93031902375,5,1345,2061,-10
93032411134,93032411135,1,1519,1760,-10
93036815956,93036815954,-2,1106,1900,-10
93041699830,93041699834,4,1337,1493,-10
93044129296,93044129299,3,1471,1519,-10
93046111812,93046111814,2,1096,1237,-10
93046423210,93046423210,0,977,1356,-10
93047046665,93047046671,6,1270,1045,-10
93049915670,93049915673,3,8038,5918,-10
93052792487,93052792487,0,1368,1786,-10
93057549508,93057549509,1,2964,3441,-10
93058203681,93058203683,2,1367,1518,-10
93067443361,93067443362,1,1500,1658,-10
93070895178,93070895179,1,1437,1837,-10
93071469586,93071469590,4,2002,2027,-10
93071776481,93071776485,4,1425,1472,-10
93073104461,93073104442,-19,3531,4525,-10
93073948222,93073948226,4,1924,1457,-10
93075258854,93075258857,3,1132,1054,-10
93076842297,93076842298,1,2344,2495,-10
93077519009,93077519010,1,1438,1686,-10
93078543766,93078543771,5,2173,1177,-10
93078647225,93078647233,8,2340,1000,-10
93082965386,93082965386,0,1188,1096,-10
93084380337,93084380338,1,1892,1372,-10
93084572805,93084572809,4,2036,1946,-10
93085677112,93085677113,1,1198,1465,-10
93087147500,93087147502,2,1541,1268,-10
93092807989,93092807990,1,2756,1657,-10
93093265302,93093265302,0,1343,1334,-10
93096181775,93096181777,2,1614,1903,-10
93097023389,93097023393,4,1877,1456,-10
93100279572,93100279573,1,1301,1889,-10
93100763042,93100763045,3,2398,2331,-10
93101096190,93101096189,-1,1327,1421,-10
93101311213,93101311214,1,1365,1760,-10
93101807591,93101807595,4,1652,1393,-10
93105040834,93105040836,2,1743,1682,-10
93107778898,93107778901,3,1799,1328,-10
93110128643,93110128645,2,1965,1535,-10
93113675579,93113675581,2,1256,1165,-10
93113994635,93113994631,-4,1243,3524,-10
93114866493,93114866496,3,1823,1963,-10
93117390031,93117390036,5,1362,1312,-10
93117997670,93117997675,5,3338,1440,-10
93118555174,93118555177,3,1494,1055,-10
93118668630,93118668636,6,1594,1181,-10
93120032501,93120032502,1,1527,1490,-10
93120224370,93120224370,0,1214,1385,-10
93120440628,93120440629,1,1574,1892,-10
93120938403,93120938406,3,1544,1340,-10
93121825895,93121825898,3,1237,1780,-10
93123939112,93123939115,3,2390,1520,-10
93124361403,93124361406,3,1215,1189,-10
93124482036,93124482037,1,1550,1349,-10
93124707583,93124707561,-22,1366,1554,-10
93125111847,93125111858,11,11078,35135,-10
93126154069,93126154071,2,1853,1381,-10
93127978614,93127978617,3,1436,1592,-10
93128860724,93128860724,0,1659,1796,-10
93129180542,93129180543,1,1427,1761,-10
93129301305,93129301309,4,2209,1837,-10
93130741278,93130741285,7,3004,1421,-10
93135587500,93135587499,-1,2399,2058,-10
93137762819,93137762820,1,1542,1295,-10
93138596778,93138596758,-20,1628,910,-10
93139627506,93139627510,4,2258,1673,-10
93140888843,93140888846,3,2031,1608,-10
93142341846,93142341850,4,1106,1652,-10
93145258686,93145258689,3,1709,1599,-10
93147366395,93147366397,2,1712,1584,-10
93147562381,93147562385,4,5201,2742,-10
93150827934,93150827938,4,2639,1528,-10
93154168813,93154168815,2,1869,2126,-10
93154832825,93154832825,0,1591,1225,-10
93157928112,93157928115,3,1181,1745,-10
93158794267,93158794266,-1,1140,905,-10
93159234973,93159234975,2,2064,1571,-10
93162312890,93162312892,2,946,1266,-10
93164970674,93164970674,0,1134,1312,-10
93165019658,93165019638,-20,1226,1463,-10
93165783087,93165783089,2,1495,1509,-10
93166436826,93166436827,1,1904,1838,-10
93173824786,93173824790,4,1052,946,-10
93176165590,93176165593,3,2046,2029,-10
93176891900,93176891903,3,1818,1306,-10
93177242978,93177242976,-2,3094,4330,-10
93178522527,93178522529,2,1244,1262,-10
93180977942,93180977946,4,1974,1622,-10
93182314768,93182314771,3,1460,1399,-10
93182968898,93182968899,1,909,928,-10
93183451074,93183451074,0,1671,1260,-10
93185000746,93185000750,4,1696,1700,-10
93186529406,93186529406,0,1430,1817,-10
93188326045,93188326046,1,1333,1048,-10
93190991602,93190991605,3,1791,2242,-10
93191566578,93191566580,2,1066,965,-10
93193111038,93193111041,3,1704,1170,-10
93197509643,93197509645,2,1080,1398,-10
93199893397,93199893398,1,750,880,-10
93200297886,93200297890,4,1776,1397,-10
93201028857,93201028859,2,1986,2727,-10
93202512495,93202512499,4,1503,1476,-10
93204030166,93204030167,1,1581,1502,-10
93204528320,93204528323,3,1907,1563,-10
93207284673,93207284674,1,1783,1472,-10
93208549782,93208549784,2,1551,1465,-10
93211566585,93211566590,5,1668,1316,-10
93214554387,93214554389,2,1586,2169,-10
93217503050,93217503054,4,1333,1506,-10
93221045816,93221045815,-1,1428,2391,-10
93221699858,93221699851,-7,26289,9883,-10
93225488529,93225488532,3,1842,1578,-10
93227661406,93227661405,-1,1197,1679,-10
93228699858,93228699864,6,7681,3984,-10
93231564291,93231564293,2,1771,1702,-10
93232043549,93232043549,0,1980,1957,-10
93235415166,93235415168,2,1695,928,-10
93236134685,93236134686,1,1368,1309,-10
93236217984,93236217968,-16,1390,1416,-10
93238022265,93238022248,-17,1549,800,-10
93242053093,93242053094,1,1583,1179,-10
93242606123,93242606118,-5,991,2649,-10
93252346106,93252346110,4,2086,1502,-10
93252844811,93252844811,0,1331,1273,-10
93253958948,93253958950,2,1455,1099,-10
93259704699,93259704701,2,1245,1325,-10
93264075410,93264075410,0,1438,1161,-10
93267593449,93267593453,4,1337,1443,-10
93270815294,93270815296,2,1692,1482,-10
93275518020,93275518021,1,1210,1218,-10
93276211198,93276211202,4,1618,1676,-10
93278733204,93278733206,2,1520,1224,-10
93280147069,93280147070,1,2184,2174,-10
93280953405,93280953407,2,2339,2051,-10
93281240831,93281240834,3,2455,1815,-10
93282669845,93282669848,3,1872,2215,-10
93282928443,93282928434,-9,21751,45288,-10
93284186138,93284186135,-3,576,1358,-10
93285650129,93285650130,1,2430,1741,-10
93285954494,93285954495,1,1412,1433,-10
93287472601,93287472602,1,1395,1524,-10
93291324208,93291324208,0,1678,2304,-10
93291448671,93291448673,2,1432,2125,-10
93294101207,93294101211,4,2737,1696,-10
93294990834,93294990835,1,1065,1507,-10
93295386668,93295386669,1,1570,1682,-10
93296794602,93296794603,1,1839,1773,-10
93297775546,93297775547,1,1595,1403,-10
93305265829,93305265830,1,1574,1713,-10
93306487175,93306487177,2,1573,1778,-10
93307874349,93307874351,2,1472,1519,-10
93309318662,93309318662,0,1467,2378,-10
93310545020,93310545017,-3,24144,16176,-10
93311108442,93311108443,1,1221,1788,-10
93315637386,93315637390,4,1614,1654,-10
93315736444,93315736438,-6,2125,6174,-10
93318067918,93318067918,0,1509,1760,-10
93318298939,93318298937,-2,1072,1686,-10
93318402233,93318402234,1,1571,1475,-10
93319969951,93319969954,3,1367,1561,-10
93323416612,93323416615,3,1199,1700,-10
93325643963,93325643963,0,1478,1543,-10
93325895406,93325895408,2,1848,1896,-10
93329299645,93329299650,5,4529,2582,-10
93332719634,93332719618,-16,879,1525,-10
93334043054,93334043055,1,1194,1513,-10
93339216167,93339216173,6,386,1184,-10
93345543080,93345543084,4,1653,1137,-10
93346847242,93346847224,-18,1390,702,-10
93348955095,93348955098,3,2118,1628,-10
93353477861,93353477862,1,1282,1362,-10
93354634021,93354634024,3,1643,2140,-10
93355162955,93355162956,1,2059,1787,-10
93355291853,93355291857,4,1221,1622,-10
93355483491,93355483492,1,1403,1242,-10
93355513272,93355513273,1,1755,1292,-10
93356039665,93356039667,2,1468,1210,-10
93359129739,93359129738,-1,1857,2095,-10
93362663562,93362663563,1,1606,1587,-10
93365695370,93365695370,0,1370,1107,-10
93366308637,93366308639,2,1772,1314,-10
93367150280,93367150281,1,1205,1682,-10
93368713870,93368713875,5,1965,1629,-10
93372702610,93372702597,-13,1748,1296,-10
93376245093,93376245094,1,13606,13832,-10
93376462507,93376462510,3,1317,1297,-10
93377049092,93377049097,5,1280,1660,-10
93379019359,93379019353,-6,2142,6284,-10
93384365266,93384365269,3,1688,1605,-10
93384666945,93384666947,2,1634,1269,-10
93386170585,93386170588,3,964,953,-10
93386803894,93386803894,0,1773,1362,-10
93388140210,93388140213,3,1792,1466,-10
93388387206,93388387208,2,1967,1905,-10
93392190355,93392190357,2,1185,1126,-10
93392849375,93392849374,-1,1652,3673,-10
93393856298,93393856299,1,1583,1243,-10
93394865668,93394865669,1,2418,1742,-10
93396153259,93396153261,2,1189,1525,-10
93399532850,93399532853,3,1632,1661,-10
93400423194,93400423197,3,1616,1518,-10
93401824153,93401824157,4,1653,1483,-10
93402843840,93402843842,2,2084,1360,-10
93404240521,93404240522,1,1141,1605,-10
93404740182,93404740185,3,2126,2192,-10
93406566125,93406566130,5,1456,1797,-10
93408452717,93408452725,8,2513,1417,-10
93409244317,93409244318,1,1422,1717,-10
93409281933,93409281934,1,1467,1659,-10
93410553382,93410553382,0,1725,1265,-10
93412913239,93412913245,6,1426,1533,-10
93415241090,93415241093,3,1214,1405,-10
93417752313,93417752318,5,1975,1325,-10
93420273142,93420273139,-3,1627,2303,-10
93422869302,93422869302,0,1538,1582,-10
93425117453,93425117454,1,1521,1873,-10
93427076858,93427076860,2,1306,2073,-10
93428194949,93428194950,1,1299,1689,-10
93429515211,93429515226,15,16055,21741,-10
93430124215,93430124218,3,1087,1574,-10
93430331554,93430331557,3,2128,2359,-10
93431130561,93431130561,0,1102,1348,-10
93432001361,93432001359,-2,1086,1799,-10
93432343386,93432343393,7,2525,1726,-10
93433933310,93433933313,3,1358,1366,-10
93434633227,93434633228,1,1355,1649,-10
93435577430,93435577431,1,1412,1354,-10
93437161402,93437161384,-18,2161,1335,-10
93443098670,93443098670,0,1878,1699,-10
93443317255,93443317259,4,1615,1810,-10
93448775119,93448775122,3,1667,1449,-10
93449706867,93449706871,4,2100,905,-10
93449832917,93449832921,4,1846,1562,-10
93456500930,93456500934,4,1399,1450,-10
93459691512,93459691515,3,1573,1568,-10
93465624574,93465624575,1,1339,1146,-10
93470134039,93470134041,2,1273,1683,-10
93472799618,93472799620,2,1515,2057,-10
93475636528,93475636528,0,1403,1440,-10
93481431469,93481431469,0,1248,1701,-10
93481505909,93481505910,1,1836,1361,-10
93482631363,93482631365,2,1887,1773,-10
93485178550,93485178550,0,1209,1692,-10
93487329570,93487329567,-3,1115,1514,-10
93489363346,93489363348,2,2243,1725,-10
93489570421,93489570424,3,1445,1301,-10
93490103450,93490103450,0,1040,1046,-10
93491960164,93491960166,2,1975,1627,-10
93492074582,93492074585,3,1430,1424,-10
93493546473,93493546475,2,1542,1274,-10
93497746296,93497746297,1,1462,2016,-10
93498690439,93498690441,2,1301,1877,-10
93499219546,93499219552,6,1795,1398,-10
93499497404,93499497405,1,1586,1478,-10
93500498814,93500498818,4,1091,2152,-10
93506964998,93506964999,1,1412,1312,-10
93512189778,93512189778,0,1164,1421,-10
93514832402,93514832405,3,1399,1766,-10
93516371636,93516371638,2,1308,1497,-10
93517172763,93517172767,4,1361,1452,-10
93517298937,93517298937,0,1132,1704,-10
93519304689,93519304689,0,1519,1503,-10
93519645521,93519645522,1,1421,1302,-10
93522070105,93522070106,1,1484,1838,-10
93524008427,93524008429,2,2020,1928,-10
93526215032,93526215033,1,1492,1437,-10
93526364232,93526364233,1,2302,1739,-10
93526448441,93526448448,7,1399,1495,-10
93527579618,93527579621,3,1651,1422,-10
93529443339,93529443336,-3,1025,2678,-10
93529504438,93529504440,2,1607,1802,-10
93531998845,93531998847,2,2343,2391,-10
93534900004,93534900007,3,2142,1025,-10
93536109858,93536109861,3,2469,1862,-10
93539969258,93539969259,1,1674,2311,-10
93544186654,93544186654,0,1194,1535,-10
93547461708,93547461708,0,1857,1479,-10
93548364239,93548364239,0,1222,1523,-10
93552221983,93552221986,3,1568,1280,-10
93555527990,93555527991,1,1348,1482,-10
93556457554,93556457556,2,1520,1227,-10
93557091774,93557091754,-20,1253,1478,-10
93559066998,93559066999,1,1435,1585,-10
93561796632,93561796633,1,1302,1346,-10
93563490646,93563490646,0,1080,1846,-10
93564162134,93564162136,2,2119,1920,-10
93565223541,93565223542,1,1730,2325,-10
93567803083,93567803084,1,1760,1574,-10
93569360987,93569360989,2,1159,1646,-10
93569839154,93569839153,-1,1837,1846,-10
93570405112,93570405111,-1,1648,1281,-10
93576040998,93576040999,1,1541,1514,-10
93580122559,93580122558,-1,848,1340,-10
93581905237,93581905231,-6,1423,1472,-10
93582258443,93582258438,-5,1161,2739,-10
93582696833,93582696835,2,1590,1755,-10
93583370974,93583370977,3,1542,1390,-10
93583428005,93583428028,23,975,348,-10
93588104418,93588104419,1,1933,3585,-10
93588775266,93588775286,20,1306,1506,-10
93592229658,93592229661,3,1487,1493,-10
93592700482,93592700485,3,1722,1823,-10
93592740497,93592740503,6,1773,957,-10
93594928947,93594928949,2,1386,1015,-10
93598776098,93598776102,4,1678,1347,-10
93601414669,93601414670,1,1759,1716,-10
93602052846,93602052849,3,1441,1467,-10
93603473797,93603473797,0,1589,1650,-10
93603566498,93603566503,5,1070,1406,-10
93610664270,93610664273,3,1468,1397,-10
93611170854,93611170857,3,1112,1368,-10
93616005429,93616005431,2,1163,1729,-10
93620665714,93620665717,3,1018,1297,-10
93620876267,93620876267,0,2081,1761,-10
93625991803,93625991802,-1,3058,4829,-10
93633148951,93633148953,2,1630,1590,-10
93634039490,93634039492,2,1643,1116,-10
93635658337,93635658333,-4,1834,7475,-10
93639597622,93639597623,1,1298,1526,-10
93641214800,93641214802,2,1583,1418,-10
93641508740,93641508742,2,2347,1832,-10
93641880815,93641880816,1,1787,1773,-10
93643121886,93643121886,0,1573,1399,-10
93643986217,93643986219,2,1595,1398,-10
93646915554,93646915549,-5,1011,3054,-10
93651583309,93651583311,2,828,862,-10
93655856826,93655856829,3,1067,1247,-10
93657398173,93657398175,2,2149,1749,-10
93657473607,93657473607,0,931,1533,-10
93664383975,93664383978,3,1238,1379,-10
93665256327,93665256330,3,1563,1275,-10
93665592256,93665592257,1,1750,949,-10
93666152154,93666152155,1,1450,1937,-10
93667955683,93667955687,4,2215,1549,-10
93669185822,93669185825,3,1806,1695,-10
93669504602,93669504617,15,6748,384,-10
93669942018,93669942021,3,1994,2077,-10
93671071447,93671071449,2,1614,1666,-10
93671273268,93671273271,3,1112,1142,-10
93674467977,93674467978,1,1612,1177,-10
93676516433,93676516435,2,1262,1241,-10
93676941679,93676941677,-2,1943,2485,-10
93678017490,93678017503,13,1682,1602,-10
93681761042,93681761045,3,1977,1711,-10
93686497473,93686497473,0,1192,1989,-10
93689084283,93689084281,-2,758,1186,-10
93692097886,93692097882,-4,502,1547,-10
93692495357,93692495359,2,2338,2156,-10
93693333329,93693333330,1,1437,1292,-10
93694157013,93694157014,1,1260,1379,-10
93696188321,93696188314,-7,1400,5516,-10
93699133881,93699133884,3,1237,1416,-10
93700076871,93700076865,-6,1252,5662,-10
93701502942,93701502945,3,1284,1419,-10
93703637507,93703637508,1,1308,1003,-10
93703951781,93703951783,2,1175,1153,-10
93706697938,93706697941,3,1538,1547,-10
93707024804,93707024806,2,1697,1459,-10
93707186297,93707186298,1,1229,1159,-10
93707246293,93707246272,-21,1468,1864,-10
93708311373,93708311376,3,889,1165,-10
93709269110,93709269111,1,1513,1807,-10
93711782685,93711782688,3,1707,1755,-10
93715333190,93715333190,0,1461,2067,-10
93716400837,93716400839,2,1377,1625,-10
93716523371,93716523373,2,2182,1476,-10
93717477854,93717477854,0,1580,1301,-10
93720706208,93720706209,1,1268,1332,-10
93722360286,93722360287,1,1687,1277,-10
93724014055,93724014058,3,1212,1336,-10
93724660637,93724660639,2,1093,835,-10
93729959146,93729959146,0,1278,1677,-10
93731185579,93731185581,2,1324,841,-10
93731804560,93731804552,-8,2048,32488,-10
93734945931,93734945933,2,1542,1542,-10
93734988082,93734988083,1,1779,1290,-10
93735681607,93735681607,0,986,1012,-10
93740406194,93740406195,1,932,914,-10
93745070511,93745070512,1,849,1236,-10
93746534842,93746534843,1,2110,1702,-10
93748178937,93748178938,1,1298,1154,-10
93748937954,93748937954,0,2273,2080,-10
93751575946,93751575947,1,1310,1618,-10
93751901774,93751901774,0,1821,1663,-10
93752167553,93752167556,3,1704,1332,-10
93752853671,93752853679,8,17908,41069,-10
93753935031,93753935034,3,1496,1858,-10
93757683590,93757683592,2,958,1412,-10
93757725141,93757725142,1,1652,1090,-10
93759821763,93759821763,0,1570,1492,-10
93760025222,93760025225,3,1654,1438,-10
93760915574,93760915576,2,1870,2147,-10
93762619835,93762619838,3,1633,1979,-10
93765661737,93765661738,1,2504,2221,-10
93766411086,93766411088,2,1977,1644,-10
93767345862,93767345868,6,13559,21825,-10
93773074098,93773074099,1,1297,1246,-10
93777238534,93777238542,8,5829,1027,-10
93779545586,93779545588,2,1852,1318,-10
93780118858,93780118860,2,1379,1658,-10
93781231348,93781231351,3,1629,1804,-10
93782286688,93782286689,1,946,1216,-10
93786775394,93786775396,2,1827,1236,-10
93790914119,93790914121,2,1542,1917,-10
93792216535,93792216539,4,1438,1404,-10
93792453177,93792453178,1,1291,1784,-10
93797449646,93797449647,1,1711,1386,-10
93797513440,93797513445,5,1592,1302,-10
93798734455,93798734459,4,1355,1115,-10
93804558716,93804558738,22,797,1096,-10
93806450298,93806450304,6,2497,1052,-10
93806989147,93806989146,-1,1437,2148,-10
93811303066,93811303069,3,1115,1012,-10
93813361759,93813361758,-1,1704,1636,-10
93813854970,93813854973,3,1386,1583,-10
93815556839,93815556839,0,1235,1826,-10
93815938210,93815938210,0,1302,1241,-10
93816011433,93816011434,1,1531,1160,-10
93816401395,93816401398,3,1670,1676,-10
93816530952,93816530954,2,2015,1497,-10
93819097438,93819097441,3,1278,1607,-10
93819814842,93819814847,5,2792,1471,-10
93820882993,93820882995,2,1205,1786,-10
93823413554,93823413558,4,1930,1920,-10
93824810986,93824810989,3,2455,2159,-10
93825748571,93825748574,3,1671,1242,-10
93827108014,93827108015,1,1742,1796,-10
93831270519,93831270521,2,1059,783,-10
93834575361,93834575361,0,1674,2454,-10
93836836730,93836836733,3,1422,1828,-10
93838387379,93838387381,2,1162,1448,-10
93838689855,93838689857,2,1812,949,-10
93841267694,93841267695,1,1036,1221,-10
93841588476,93841588495,19,763,1294,-10
93845596825,93845596826,1,1330,1008,-10
93846906711,93846906716,5,986,969,-10
93850075862,93850075862,0,1506,1406,-10
93850827681,93850827683,2,1691,1739,-10
93851330137,93851330138,1,1575,1669,-10
93855704218,93855704221,3,1266,1568,-10
93856946015,93856946016,1,1638,1701,-10
93858867833,93858867834,1,1690,1425,-10
93862158582,93862158583,1,2271,1521,-10
93862440127,93862440129,2,1253,1638,-10
93863919023,93863919025,2,1243,1559,-10
93867072535,93867072538,3,978,1149,-10
93867330233,93867330227,-6,871,3010,-10
93867361901,93867361902,1,1356,1458,-10
93869949041,93869949043,2,1045,1264,-10
93873150774,93873150775,1,1733,1353,-10
93874439847,93874439849,2,917,1634,-10
93875081047,93875081047,0,1568,1611,-10
93875914634,93875914630,-4,1379,1713,-10
93877716361,93877716362,1,1411,1705,-10
93879703640,93879703639,-1,1504,1331,-10
93884093158,93884093158,0,34125,42794,-10
93884773166,93884773168,2,1915,2162,-10
93886078519,93886078521,2,1850,2095,-10
93889431114,93889431116,2,2051,1478,-10
93892607266,93892607266,0,1266,1000,-10
93892856422,93892856422,0,1673,1500,-10
93897757865,93897757869,4,1342,1403,-10
93898652382,93898652384,2,1007,1287,-10
93901242093,93901242096,3,1428,1170,-10
93901535457,93901535458,1,1887,1177,-10
93901632300,93901632302,2,21271,20637,-10
93907061138,93907061137,-1,729,1195,-10
93907777853,93907777854,1,2040,2007,-10
93909878141,93909878142,1,1803,1951,-10
93913059909,93913059912,3,1524,1457,-10
93914451954,93914451955,1,1579,1317,-10
93917178590,93917178593,3,2684,2158,-10
93918119893,93918119896,3,1349,1361,-10
93919676017,93919676018,1,1231,1432,-10
93920322447,93920322453,6,2090,1451,-10
93921403916,93921403918,2,1436,1307,-10
93922413085,93922413087,2,1149,790,-10
93926209553,93926209553,0,2044,1799,-10
93926536769,93926536771,2,816,809,-10
93931705814,93931705818,4,1357,1035,-10
93932399275,93932399279,4,1326,761,-10
93941199110,93941199102,-8,408,1259,-10
93944367249,93944367251,2,1349,887,-10
93946038684,93946038685,1,2357,2468,-10
93950733924,93950733925,1,1453,2092,-10
93952242786,93952242785,-1,1178,1495,-10
93953351998,93953352000,2,1851,2077,-10
93956706531,93956706532,1,1285,2028,-10
93957708658,93957708662,4,1289,1082,-10
93958112518,93958112519,1,1707,1692,-10
93958260867,93958260869,2,1574,1190,-10
93958698314,93958698315,1,1665,2006,-10
93960884694,93960884695,1,1277,1491,-10
93963230801,93963230802,1,2387,1731,-10
93966699282,93966699282,0,1133,2143,-10
93967170898,93967170899,1,1825,2460,-10
93967940685,93967940685,0,1085,1438,-10
93969171620,93969171621,1,1364,1845,-10
93969635235,93969635238,3,1827,1640,-10
93973255776,93973255778,2,2307,2192,-10
93976860734,93976860736,2,1018,1212,-10
93977927338,93977927337,-1,1385,2161,-10
93980283538,93980283539,1,1826,2092,-10
93989932986,93989932987,1,2282,1626,-10
93991804336,93991804338,2,1590,2116,-10
93993416045,93993416046,1,1427,2068,-10
93997008412,93997008413,1,1517,1413,-10
93997623875,93997623882,7,2759,996,-10
93998017178,93998017179,1,1255,1219,-10
94003562662,94003562662,0,1706,2046,-10
94004155614,94004155616,2,1547,1662,-10
94006365252,94006365255,3,1674,1743,-10
94008952461,94008952463,2,1763,1986,-10
94011525573,94011525574,1,2194,1655,-10
94014811934,94014811939,5,1980,1143,-10
94016087125,94016087126,1,2062,1526,-10
94017919421,94017919422,1,1460,1720,-10
94018906931,94018906933,2,1587,1522,-10
94021863514,94021863519,5,2054,1184,-10
94022118806,94022118810,4,1876,1274,-10
94024724207,94024724210,3,2474,2094,-10
94025470397,94025470398,1,1953,1375,-10
94027378473,94027378475,2,1898,1264,-10
94028776703,94028776705,2,1543,1647,-10
94029158034,94029158035,1,1212,975,-10
94034029562,94034029550,-12,1473,1296,-10
94036070234,94036070235,1,1540,1356,-10
94036613234,94036613236,2,1686,1873,-10
94038157245,94038157247,2,1458,1047,-10
94039120309,94039120310,1,1359,773,-10
94040645595,94040645597,2,2234,2117,-10
94040736550,94040736553,3,1715,1918,-10
94046021282,94046021294,12,1703,1494,-10
94048706885,94048706888,3,1336,1619,-10
94051654911,94051654915,4,1756,1286,-10
94053743856,94053743858,2,1399,1958,-10
94057337026,94057337026,0,1279,971,-10
94057952226,94057952228,2,1415,1829,-10
94058501858,94058501860,2,1738,1266,-10
94058832957,94058832938,-19,2059,1782,-10
94059871995,94059871997,2,1747,2154,-10
94061351957,94061351959,2,1863,1682,-10
94061837578,94061837595,17,1391,1323,-10
94063816472,94063816473,1,1255,1661,-10
94065663389,94065663390,1,1347,1628,-10
94069948519,94069948521,2,1638,1157,-10
94075398081,94075398083,2,831,1031,-10
94078578580,94078578582,2,1611,1899,-10
94078621229,94078621230,1,652,1518,-10
94078797175,94078797177,2,1758,1905,-10
94082064954,94082064958,4,1267,1137,-10
94082631377,94082631387,10,2271,1895,-10
94083711771,94083711773,2,1292,2093,-10
94084898232,94084898230,-2,1362,1904,-10
94084977699,94084977676,-23,942,4452,-10
94085012571,94085012549,-22,1261,1071,-10
94085482233,94085482235,2,1599,1607,-10
94087106350,94087106353,3,2100,1541,-10
94089698425,94089698425,0,1819,2000,-10
94091852487,94091852483,-4,1230,2877,-10
94092966400,94092966401,1,1745,1207,-10
94093538648,94093538652,4,1962,1151,-10
94093906502,94093906506,4,1297,1297,-10
94095478119,94095478119,0,1735,1906,-10
94096042279,94096042283,4,2130,1310,-10
94097650707,94097650714,7,2732,1280,-10
94102099866,94102099869,3,1333,1204,-10
94102622557,94102622559,2,2037,1732,-10
94104808929,94104808934,5,1859,1019,-10
94108417296,94108417296,0,1366,1689,-10
94110892095,94110892098,3,1406,1381,-10
94111772050,94111772051,1,2047,2155,-10
94111917085,94111917084,-1,1584,1675,-10
94114324962,94114324962,0,1225,1784,-10
94114862012,94114862015,3,1751,1432,-10
94116744369,94116744370,1,1990,1519,-10
94116853123,94116853128,5,1557,1433,-10
94118252540,94118252542,2,2067,1344,-10
94121045207,94121045210,3,1570,1386,-10
94121521834,94121521835,1,1683,1365,-10
94123389576,94123389579,3,2025,1775,-10
94124478445,94124478446,1,1562,1525,-10
94125055978,94125055979,1,1644,1697,-10
94126295485,94126295494,9,8496,30514,-10
94130557100,94130557102,2,1539,1054,-10
94133260714,94133260717,3,1394,1257,-10
94135365560,94135365561,1,745,1185,-10
94137288882,94137288886,4,1593,1637,-10
94139906501,94139906503,2,1322,1407,-10
94141765880,94141765881,1,1414,1348,-10
94142381184,94142381186,2,1575,2052,-10
94146604995,94146605003,8,1334,1543,-10
94147343237,94147343238,1,1391,984,-10
94151061158,94151061162,4,1220,1035,-10
94152646289,94152646292,3,1602,1331,-10
94154800411,94154800415,4,1397,1401,-10
94154898798,94154898799,1,1307,1347,-10
94156856167,94156856168,1,1294,1425,-10
94159082075,94159082078,3,1682,1699,-10
94159882528,94159882530,2,1832,1415,-10
94159976011,94159976012,1,1193,1143,-10
94164801203,94164801205,2,1956,1601,-10
94166796414,94166796415,1,1174,1487,-10
94167624629,94167624630,1,1501,1773,-10
94167687530,94167687528,-2,877,1553,-10
94168269803,94168269806,3,1621,1324,-10
94170673797,94170673794,-3,904,2384,-10
94171770482,94171770485,3,1370,1740,-10
94172015818,94172015819,1,1084,953,-10
94173557544,94173557543,-1,1494,1138,-10
94174909519,94174909523,4,4085,2473,-10
94193309687,94193309691,4,1094,1389,-10
94194713358,94194713358,0,1380,1009,-10
94195643561,94195643566,5,1884,1361,-10
94196410958,94196410961,3,2014,1186,-10
94197968209,94197968210,1,2011,1972,-10
94200750861,94200750863,2,2293,1984,-10
94201793327,94201793327,0,1108,1227,-10
94202276858,94202276863,5,1366,1461,-10
94202635909,94202635911,2,1954,1205,-10
94211266534,94211266537,3,1669,1618,-10
94213320284,94213320285,1,1765,1590,-10
94214029853,94214029855,2,1211,1347,-10
94214257768,94214257777,9,1862,1422,-10
94215119536,94215119537,1,2450,2186,-10
94218150654,94218150657,3,1312,1293,-10
94218335497,94218335499,2,1264,1512,-10
94218662430,94218662431,1,1861,1820,-10
94222595937,94222595937,0,1371,1895,-10
94222854825,94222854806,-19,1253,1422,-10
94223785845,94223785846,1,1459,2035,-10
94225063674,94225063674,0,1364,1507,-10
94233831356,94233831357,1,1795,1873,-10
94236589185,94236589187,2,1845,2206,-10
94236723575,94236723579,4,1747,1340,-10
94237245763,94237245761,-2,1705,1479,-10
94238251078,94238251080,2,1868,1694,-10
94238689817,94238689819,2,1546,1692,-10
94244251272,94244251275,3,2386,1643,-10
94247661710,94247661713,3,1516,1553,-10
94251784837,94251784839,2,1376,1164,-10
94252460725,94252460726,1,1606,2138,-10
94253415994,94253415996,2,1252,1694,-10
94254108802,94254108802,0,1364,1464,-10
94268451239,94268451241,2,1705,1378,-10
94269460250,94269460242,-8,1103,1228,-10
94269565490,94269565480,-10,180,3482,-10
94272314617,94272314621,4,1898,1646,-10
94272629095,94272629095,0,1036,1719,-10
94273215830,94273215831,1,1759,1218,-10
94277396969,94277396973,4,2206,1489,-10
94281691750,94281691751,1,1207,1185,-10
94283709440,94283709443,3,1338,1275,-10
94284287982,94284287961,-21,1343,1386,-10
94286722033,94286722037,4,953,1483,-10
94288666682,94288666684,2,1587,1526,-10
94289046436,94289046437,1,1335,1191,-10
94299446132,94299446135,3,1782,1526,-10
94300209182,94300209185,3,1595,1552,-10
94304924143,94304924147,4,1470,1403,-10
94310688950,94310688950,0,1486,1474,-10
94310737262,94310737262,0,1468,1715,-10
94314909954,94314909957,3,1669,1974,-10
94320742525,94320742526,1,1230,1402,-10
94320799209,94320799210,1,1860,1704,-10
94321900340,94321900342,2,1526,1391,-10
94324501533,94324501536,3,1870,1451,-10
94326171250,94326171252,2,890,1147,-10
94329760023,94329760027,4,1386,1115,-10
94337397087,94337397090,3,1424,1517,-10
94341228908,94341228907,-1,1252,1196,-10
94342131281,94342131267,-14,1054,5158,-10
94343535909,94343535910,1,1290,1833,-10
94347497334,94347497335,1,1723,1266,-10
94349122240,94349122243,3,1769,1599,-10
94350352205,94350352213,8,1775,845,-10
94351787251,94351787254,3,1485,1641,-10
94351887830,94351887831,1,1805,1526,-10
94353676064,94353676067,3,1932,1636,-10
94358174721,94358174725,4,1662,1349,-10
94362680769,94362680771,2,1689,1485,-10
94363169496,94363169497,1,1201,1813,-10
94364237791,94364237794,3,1099,1384,-10
94365435119,94365435112,-7,812,6937,-10
94373498304,94373498309,5,1384,1160,-10
94378623621,94378623622,1,1621,1786,-10
94380956452,94380956453,1,1511,1393,-10
94382341042,94382341045,3,1835,1469,-10
94384822605,94384822606,1,1370,1572,-10
94388306014,94388306018,4,1275,1501,-10
94388415502,94388415503,1,1066,1010,-10
94402073589,94402073589,0,1985,1384,-10
94404827027,94404827030,3,1245,1031,-10
94406050781,94406050761,-20,1546,1601,-10
94406810946,94406810948,2,2037,2052,-10
94414709323,94414709323,0,1535,2076,-10
94416432259,94416432261,2,1415,1895,-10
94417486035,94417486038,3,1446,1413,-10
94418075347,94418075347,0,1187,1426,-10
94418794957,94418794958,1,1450,1409,-10
94419756632,94419756622,-10,1829,1758,-10
94421413902,94421413907,5,2039,1776,-10
94422171599,94422171598,-1,1393,1144,-10
94423881876,94423881877,1,1466,1592,-10
94426678762,94426678765,3,1439,1373,-10
94435839740,94435839741,1,1319,1974,-10
94437375617,94437375618,1,1470,1481,-10
94438527024,94438527023,-1,1502,1401,-10
94438756874,94438756858,-16,1186,1221,-10
94440651290,94440651294,4,1718,1509,-10
94441430643,94441430644,1,1751,1546,-10
94443447025,94443447026,1,1676,1436,-10
94447695463,94447695463,0,2286,2388,-10
94447859969,94447859970,1,1564,1732,-10
94448778342,94448778343,1,2201,1929,-10
94451369253,94451369255,2,1761,1673,-10
94457865695,94457865694,-1,1156,1686,-10
94458188282,94458188282,0,983,1124,-10
94460080738,94460080738,0,1786,1440,-10
94460613918,94460613911,-7,793,3028,-10
94461282999,94461283001,2,1322,1583,-10
94461315618,94461315620,2,1169,1498,-10
94466137771,94466137778,7,2394,1216,-10
94466467333,94466467335,2,1618,1145,-10
94466516156,94466516156,0,3708,12712,-10
94468052359,94468052360,1,1500,1150,-10
94469219882,94469219882,0,1676,1928,-10
94470303296,94470303298,2,1280,1283,-10
94473857272,94473857273,1,1905,1495,-10
94474255282,94474255283,1,2603,1670,-10
94477707550,94477707550,0,1910,2354,-10
94480121311,94480121302,-9,32303,13446,-10
94480272115,94480272118,3,1618,1578,-10
94480531650,94480531651,1,953,1069,-10
94483068395,94483068398,3,1263,1202,-10
94483665279,94483665280,1,1152,1434,-10
94494318206,94494318209,3,1078,1782,-10
94495091102,94495091101,-1,749,1291,-10
94497702993,94497702998,5,1167,1126,-10
94498844546,94498844546,0,1639,2073,-10
94499942642,94499942636,-6,909,4825,-10
94501240345,94501240346,1,1305,1679,-10
94503431069,94503431071,2,1864,1486,-10
94504945230,94504945232,2,1657,1727,-10
94505417427,94505417429,2,1714,1686,-10
94506854457,94506854457,0,1329,1845,-10
94509267778,94509267776,-2,2095,2038,-10
94509403255,94509403258,3,1502,1722,-10
94509940502,94509940502,0,1343,2046,-10
94510621010,94510621011,1,1718,2022,-10
94512388554,94512388557,3,1365,1885,-10
94513556827,94513556829,2,1445,1473,-10
94515293143,94515293142,-1,3143,4507,-10
94519169244,94519169239,-5,1171,3847,-10
94519227451,94519227454,3,2036,1629,-10
94519433637,94519433638,1,1256,1608,-10
94519971931,94519971918,-13,1474,1365,-10
94521487824,94521487823,-1,1270,1468,-10
94524525217,94524525218,1,1771,1533,-10
94529004943,94529004947,4,1758,1710,-10
94530156248,94530156250,2,2658,2126,-10
94530940460,94530940460,0,1286,1265,-10
94533145889,94533145893,4,1800,1189,-10
94535653329,94535653330,1,394,894,-10
94539410536,94539410537,1,2121,2018,-10
94545609194,94545609197,3,1499,1648,-10
94548494581,94548494563,-18,1599,1423,-10
94548965410,94548965407,-3,3754,10207,-10
94554603636,94554603640,4,1717,1643,-10
94555814705,94555814699,-6,1410,1598,-10
94557920929,94557920932,3,1564,1208,-10
94558694719,94558694724,5,1376,1506,-10
94559438169,94559438172,3,1816,1475,-10
94559495923,94559495924,1,1408,1599,-10
94559813002,94559813005,3,1146,1651,-10
94563211446,94563211449,3,1383,1664,-10
94563816686,94563816687,1,2049,1561,-10
94568143762,94568143765,3,1894,1518,-10
94568187596,94568187599,3,2085,1903,-10
94569289023,94569289018,-5,1804,3182,-10
94570588934,94570588935,1,1682,1695,-10
94573796942,94573796943,1,1465,1210,-10
94575517318,94575517320,2,2310,2196,-10
94576589673,94576589675,2,1180,1115,-10
94577442799,94577442801,2,1069,1215,-10
94580556398,94580556399,1,1010,1047,-10
94582836550,94582836554,4,1847,1472,-10
94585604190,94585604191,1,1520,1086,-10
94586261569,94586261570,1,2059,1754,-10
94587885182,94587885183,1,984,1233,-10
94588352421,94588352422,1,1678,1013,-10
94588389230,94588389233,3,1580,1524,-10
94589688794,94589688793,-1,1411,1361,-10
94590671536,94590671539,3,1663,1501,-10
94593412823,94593412824,1,1315,1281,-10
94593707964,94593707963,-1,1497,1981,-10
94596122769,94596122769,0,772,795,-10
94599864901,94599864880,-21,1986,1866,-10
94600314804,94600314803,-1,1807,1946,-10
94600704766,94600704767,1,1770,1523,-10
94602004888,94602004887,-1,1400,1335,-10
94603351568,94603351570,2,1361,1651,-10
94604031523,94604031524,1,1717,1932,-10
94606603787,94606603794,7,1905,907,-10
94609492849,94609492850,1,2409,1788,-10
94611499286,94611499289,3,1655,1327,-10
94617154090,94617154094,4,1778,1139,-10
94618717477,94618717479,2,1446,1099,-10
94620544925,94620544928,3,1600,1562,-10
94621645509,94621645515,6,21914,37244,-10
94623775498,94623775501,3,2734,2026,-10
94626806374,94626806378,4,1782,1675,-10
94626903474,94626903476,2,1677,1571,-10
94630166817,94630166818,1,1619,1893,-10
94630642902,94630642904,2,1541,1315,-10
94632028089,94632028091,2,1543,1411,-10
94635898155,94635898154,-1,1260,1226,-10
94639597734,94639597735,1,1182,885,-10
94641307938,94641307942,4,1521,1619,-10
94641355101,94641355102,1,1227,1597,-10
94642702337,94642702323,-14,1002,2005,-10
94644440849,94644440851,2,1573,1365,-10
94646107983,94646107986,3,1640,1449,-10
94653092818,94653092821,3,1645,1185,-10
94655083258,94655083261,3,2880,1679,-10
94655692662,94655692666,4,2317,1692,-10
94655773671,94655773673,2,1208,1351,-10
94664576046,94664576049,3,1046,1543,-10
94667642210,94667642210,0,1686,1836,-10
94667924151,94667924154,3,742,1154,-10
94671193022,94671193023,1,1695,1406,-10
94672480210,94672480211,1,1538,1442,-10
94676578102,94676578101,-1,1629,2068,-10
94681245955,94681245955,0,1320,1553,-10
94682700380,94682700379,-1,1623,2040,-10
94682999642,94682999642,0,2198,2542,-10
94683360114,94683360114,0,1502,1663,-10
94684601049,94684601052,3,768,956,-10
94685484000,94685484001,1,1568,1102,-10
94686860897,94686860898,1,2169,1699,-10
94689736442,94689736442,0,1266,1596,-10
94694684022,94694684022,0,2979,2588,-10
94695671878,94695671880,2,1919,2379,-10
94697817338,94697817342,4,3466,2065,-10
94700136793,94700136794,1,1055,921,-10
94700833755,94700833758,3,958,1549,-10
94703367494,94703367494,0,1398,1370,-10
94703609241,94703609243,2,2182,1404,-10
94704153017,94704153020,3,1835,1814,-10
94708212546,94708212545,-1,1577,2014,-10
94708287157,94708287158,1,1644,1413,-10
94710028216,94710028218,2,1902,1387,-10
94711364201,94711364204,3,1625,1417,-10
94715427970,94715427973,3,1176,1241,-10
94715910494,94715910492,-2,1265,3225,-10
94717470102,94717470104,2,1480,903,-10
94720955955,94720955958,3,785,1553,-10
94722440282,94722440285,3,1979,1735,-10
94730050545,94730050545,0,1665,2427,-10
94735223329,94735223334,5,2933,1603,-10
94738466342,94738466347,5,1493,1714,-10
94741969414,94741969415,1,1590,1191,-10
94742458331,94742458315,-16,1131,844,-10
94743331379,94743331381,2,1212,994,-10
94746186746,94746186726,-20,1696,1804,-10
94746773155,94746773161,6,1077,1161,-10
94748313876,94748313874,-2,2094,1942,-10
94749073269,94749073271,2,1563,875,-10
94754025109,94754025111,2,1869,1456,-10
94754140677,94754140678,1,1793,1469,-10
94756381835,94756381839,4,2082,1533,-10
94763657462,94763657463,1,2121,1259,-10
94766630242,94766630245,3,1455,1694,-10
94768061318,94768061324,6,2120,1510,-10
94771087845,94771087847,2,1678,1772,-10
94772479437,94772479439,2,1371,819,-10
94776287763,94776287766,3,1048,1503,-10
94778767887,94778767886,-1,1829,1617,-10
94781120112,94781120114,2,1030,1086,-10
94785266986,94785266987,1,1241,1660,-10
94785658329,94785658323,-6,1237,3580,-10
94786810440,94786810442,2,1500,1650,-10
94787293678,94787293678,0,2318,1233,-10
94788869401,94788869403,2,1525,991,-10
94792354889,94792354889,0,1733,1438,-10
94794159927,94794159928,1,1541,1420,-10
94798712674,94798712678,4,1584,1135,-10
94800977242,94800977243,1,1886,1250,-10
94802937281,94802937284,3,1546,1550,-10
94803427457,94803427459,2,1310,1861,-10
94803675493,94803675503,10,15558,20501,-10
94805173244,94805173225,-19,1674,1727,-10
94806479672,94806479679,7,262,1139,-10
94809271791,94809271793,2,1343,1469,-10
94811719317,94811719319,2,1307,1425,-10
94813647070,94813647071,1,1273,1391,-10
94815479239,94815479240,1,1658,1526,-10
94819152231,94819152233,2,1982,1666,-10
94821331450,94821331453,3,1929,1418,-10
94821805666,94821805666,0,1226,1709,-10
94830206093,94830206095,2,1813,1590,-10
94833496090,94833496093,3,1945,1887,-10
94834403372,94834403374,2,1879,1776,-10
94835993267,94835993265,-2,1095,1610,-10
94837628070,94837628075,5,2158,1207,-10
94840184409,94840184410,1,1728,1521,-10
94840999830,94840999833,3,1403,1387,-10
94841116316,94841116318,2,1752,1666,-10
94841622862,94841622866,4,1659,1084,-10
94842652386,94842652387,1,1325,1571,-10
94846761243,94846761246,3,1624,1818,-10
94847533714,94847533718,4,1673,1354,-10
94848120985,94848120987,2,1495,1911,-10
94849538954,94849538957,3,1529,1773,-10
94849838977,94849838963,-14,1613,1430,-10
94852550346,94852550345,-1,1431,2093,-10
94855089022,94855089024,2,1275,1946,-10
94857047704,94857047705,1,1711,1968,-10
94859828233,94859828234,1,1784,1548,-10
94862400847,94862400850,3,1805,1462,-10
94863099009,94863099013,4,1841,1492,-10
94865482155,94865482158,3,2070,1628,-10
94867820542,94867820545,3,2137,1591,-10
94868033122,94868033122,0,1408,2166,-10
94869796481,94869796481,0,4322,4555,-10
94870185566,94870185569,3,1887,1694,-10
94872805611,94872805614,3,1831,1897,-10
94875403713,94875403715,2,1634,1171,-10
94878043475,94878043473,-2,937,2923,-10
94878934288,94878934289,1,1823,1474,-10
94882017723,94882017724,1,1737,1509,-10
94882911899,94882911899,0,1766,2277,-10
94885243021,94885243022,1,1348,1216,-10
94890595483,94890595486,3,1969,1207,-10
94893920863,94893920865,2,1909,1677,-10
94897081018,94897081018,0,1374,991,-10
94899958547,94899958560,13,532,2019,-10
94905722874,94905722875,1,1490,1329,-10
94910056414,94910056421,7,2490,1091,-10
94914744778,94914744779,1,936,802,-10
94916928571,94916928574,3,1727,1648,-10
94917443764,94917443773,9,13963,38245,-10
94919253135,94919253137,2,1866,1979,-10
94920148186,94920148190,4,1342,1834,-10
94920793479,94920793480,1,1266,1594,-10
94920922871,94920922874,3,1642,1650,-10
94925832247,94925832249,2,1503,1474,-10
94926118593,94926118596,3,3566,1927,-10
94927957425,94927957426,1,1950,1836,-10
94932149893,94932149897,4,1218,846,-10
94934189681,94934189680,-1,1251,1272,-10
94935431458,94935431458,0,662,1033,-10
94939788630,94939788631,1,1437,987,-10
94942424666,94942424667,1,1199,1339,-10
94942856325,94942856322,-3,2687,4374,-10
94943743619,94943743618,-1,923,1109,-10
94952087402,94952087406,4,1138,1478,-10
94953242267,94953242269,2,1779,1544,-10
94955455950,94955455953,3,1096,1458,-10
94958165565,94958165564,-1,1776,1739,-10
94959681462,94959681462,0,1415,1432,-10
94960976958,94960976961,3,1214,1380,-10
94961933145,94961933148,3,1641,1336,-10
94962944742,94962944730,-12,1439,1344,-10
94963728017,94963728018,1,1717,1863,-10
94965426082,94965426082,0,1442,1897,-10
94968615507,94968615507,0,1246,1244,-10
94971214295,94971214298,3,1698,1935,-10
94972241940,94972241940,0,1835,1760,-10
94977405138,94977405140,2,1508,1647,-10
94978507926,94978507929,3,1806,1313,-10
94984577845,94984577847,2,2064,1049,-10
94989090253,94989090255,2,2329,1861,-10
94990748918,94990748921,3,1474,1726,-10
94991505986,94991505986,0,1540,1553,-10
94992060880,94992060882,2,1863,1826,-10
95002167641,95002167641,0,2504,3785,-10
95003787028,95003787028,0,1474,1580,-10
95010252411,95010252414,3,1394,1289,-10
95010961050,95010961052,2,1697,1850,-10
95010993578,95010993578,0,1648,1371,-10
95015538021,95015538024,3,1532,1393,-10
95016070869,95016070870,1,1292,1360,-10
95020181501,95020181506,5,1703,1466,-10
95020657037,95020657037,0,1905,1712,-10
95020832666,95020832667,1,1325,1480,-10
95023117495,95023117498,3,1407,1138,-10
95023569416,95023569417,1,1674,2227,-10
95027387741,95027387742,1,1091,875,-10
95027894302,95027894304,2,2047,1504,-10
95029622566,95029622569,3,2464,2302,-10
95031892903,95031892905,2,2368,1816,-10
95032247501,95032247501,0,1756,1841,-10
95035952045,95035952046,1,2054,2040,-10
95036493595,95036493600,5,2384,969,-10
95038310965,95038310965,0,1388,1021,-10
95042678694,95042678696,2,1324,1653,-10
95044459627,95044459628,1,1519,1326,-10
95048247218,95048247217,-1,1578,1789,-10
95050606791,95050606793,2,2587,2313,-10
95051541763,95051541766,3,1371,1488,-10
95051653110,95051653110,0,966,1239,-10
95053316119,95053316122,3,832,1463,-10
95055012923,95055012923,0,1610,1260,-10
95056512431,95056512433,2,1711,1596,-10
95056709388,95056709390,2,1838,1488,-10
95057187985,95057187987,2,1681,1666,-10
95059329989,95059329991,2,1480,1049,-10
95061879638,95061879627,-11,1473,431,-10
95063463515,95063463514,-1,1653,2077,-10
95069904852,95069904854,2,1965,1508,-10
95070162085,95070162086,1,1783,1363,-10
95070675830,95070675825,-5,29050,15513,-10
95071437377,95071437377,0,1765,1276,-10
95073375309,95073375310,1,1045,1102,-10
95073905327,95073905330,3,1694,1396,-10
95074431902,95074431902,0,1062,1605,-10
95075396576,95075396577,1,1851,1953,-10
95077031566,95077031566,0,1345,1384,-10
95078207862,95078207865,3,1970,1743,-10
95079864575,95079864577,2,1710,1522,-10
95080525967,95080525969,2,1332,1378,-10
95080761634,95080761654,20,40785,16271,-10
95084135079,95084135079,0,1527,1374,-10
95084628073,95084628066,-7,898,2545,-10
95086266495,95086266498,3,1399,1738,-10
95087443194,95087443202,8,1801,1488,-10
95088037514,95088037518,4,2255,2039,-10
95092757680,95092757681,1,1442,1564,-10
95094314070,95094314075,5,1936,1478,-10
95094976289,95094976305,16,1913,1015,-10
95095840647,95095840650,3,1795,1534,-10
95095880323,95095880325,2,1251,1355,-10
95096437438,95096437439,1,1229,1175,-10
95097321111,95097321114,3,1630,1613,-10
95098512195,95098512197,2,1526,1863,-10
95099015606,95099015601,-5,767,3774,-10
95102357326,95102357332,6,1682,1180,-10
95103567242,95103567245,3,1766,1610,-10
95104397850,95104397850,0,1286,1837,-10
95106156183,95106156182,-1,1516,1358,-10
95106998841,95106998848,7,2784,1448,-10
95107416919,95107416921,2,1473,1326,-10
95108175298,95108175299,1,1637,1172,-10
95114663107,95114663107,0,1258,1278,-10
95120776007,95120776009,2,1169,1203,-10
95124048030,95124048031,1,1526,1635,-10
95125650510,95125650513,3,1603,1332,-10
95128506307,95128506307,0,1972,2163,-10
95131572887,95131572887,0,1572,2084,-10
95136073897,95136073902,5,2343,1998,-10
95143442630,95143442630,0,1501,1788,-10
95145073325,95145073326,1,1836,1614,-10
95146218386,95146218387,1,1149,1851,-10
95149307986,95149307988,2,1365,1180,-10
95149753262,95149753262,0,1393,1209,-10
95150085808,95150085810,2,1926,19471,-10
95150405741,95150405739,-2,1761,1295,-10
95151506682,95151506682,0,1395,1872,-10
95153459454,95153459458,4,1228,1159,-10
95153599466,95153599467,1,1205,1235,-10
95155829770,95155829775,5,1954,2173,-10
95158656885,95158656882,-3,1886,4539,-10
95159387153,95159387155,2,1216,1749,-10
95160681342,95160681343,1,1782,1409,-10
95161786459,95161786462,3,1850,1803,-10
95164822598,95164822594,-4,1620,2451,-10
95166649113,95166649114,1,1220,1565,-10
95167525082,95167525085,3,1389,1168,-10
95167781693,95167781713,20,1684,1350,-10
95170640873,95170640874,1,2396,1490,-10
95170697645,95170697646,1,1248,1316,-10
95170891010,95170891009,-1,1598,2101,-10
95171579663,95171579666,3,1181,1497,-10
95171695417,95171695437,20,1645,3496,-10
95172207071,95172207071,0,1188,1756,-10
95173331770,95173331774,4,1457,1474,-10
95174940761,95174940761,0,1148,1119,-10
95177173172,95177173166,-6,2123,1994,-10
95179471390,95179471394,4,1266,1526,-10
95181448494,95181448494,0,1446,1393,-10
95183357001,95183357003,2,1897,1758,-10
95184658098,95184658101,3,1397,1272,-10
95185383577,95185383592,15,2060,1893,-10
95189274414,95189274417,3,1430,1462,-10
95190183931,95190183933,2,1323,1998,-10
95201814990,95201814991,1,1523,1412,-10
95205299261,95205299262,1,2021,1549,-10
95205801544,95205801546,2,2319,1785,-10
95207601111,95207601110,-1,1609,2000,-10
95208168196,95208168202,6,5405,1385,-10
95212320247,95212320250,3,1527,1785,-10
95214917844,95214917846,2,2027,1628,-10
95215452179,95215452182,3,1349,1006,-10
95215924474,95215924474,0,1645,1349,-10
95217407206,95217407207,1,1158,1427,-10
95218416955,95218416958,3,1920,2160,-10
95221789440,95221789443,3,2275,1572,-10
95225130353,95225130355,2,1850,1505,-10
95225610175,95225610176,1,1542,1478,-10
95228369946,95228369942,-4,1156,2345,-10
95230932699,95230932700,1,1663,2387,-10
95232195238,95232195242,4,1818,2053,-10
95233076687,95233076686,-1,1396,1850,-10
95234772577,95234772579,2,1620,1377,-10
95236426987,95236426990,3,1817,2255,-10
95239573921,95239573924,3,2036,1807,-10
95240990979,95240990982,3,2066,1026,-10
95245217751,95245217754,3,21697,34076,-10
95249839532,95249839535,3,1855,1709,-10
95251347291,95251347292,1,1676,1499,-10
95251543939,95251543938,-1,1142,1285,-10
95252362241,95252362246,5,2101,1809,-10
95252881371,95252881373,2,2061,2139,-10
95253061113,95253061115,2,1325,1134,-10
95253464305,95253464306,1,1180,1568,-10
95257480252,95257480253,1,1634,1598,-10
95259832598,95259832599,1,1777,2204,-10
95260499129,95260499131,2,1937,1945,-10
95262640142,95262640143,1,1129,1050,-10
95262846465,95262846467,2,1224,1180,-10
95263260422,95263260426,4,2149,1499,-10
95263541987,95263541990,3,1113,1257,-10
95264487784,95264487785,1,1613,1586,-10
95267650662,95267650666,4,1722,1385,-10
95269418617,95269418618,1,1453,1763,-10
95269976661,95269976661,0,1432,1379,-10
95270153319,95270153322,3,1870,1711,-10
95276085778,95276085779,1,2019,1967,-10
95281695974,95281695975,1,1811,1556,-10
95282806818,95282806822,4,1555,1406,-10
95284357398,95284357399,1,1423,1208,-10
95293658147,95293658149,2,1762,1401,-10
95297058131,95297058135,4,1679,1815,-10
95298172685,95298172687,2,1953,1421,-10
95300772960,95300772954,-6,1781,7310,-10
95301690048,95301690052,4,1230,1713,-10
95302918372,95302918374,2,1800,1802,-10
95304441706,95304441707,1,1333,1060,-10
95305972565,95305972566,1,1870,2258,-10
95306856812,95306856813,1,1863,1528,-10
95308416422,95308416425,3,1980,1905,-10
95314683492,95314683495,3,2097,1624,-10
95316621117,95316621117,0,843,1736,-10
95318483987,95318483984,-3,2327,6051,-10
95318534105,95318534107,2,1380,2082,-10
95321607324,95321607325,1,1621,1983,-10
95325739677,95325739678,1,1331,1142,-10
95332727382,95332727385,3,1263,1232,-10
95337276889,95337276889,0,1684,1540,-10
95338363735,95338363753,18,924,2777,-10
95344534131,95344534134,3,1626,1893,-10
95346714687,95346714691,4,1472,1355,-10
95346942978,95346942983,5,1029,1379,-10
95348386981,95348386982,1,1447,1532,-10
95350789077,95350789073,-4,754,1750,-10
95351875162,95351875165,3,1926,1374,-10
95352202017,95352202018,1,2171,2236,-10
95357021015,95357021015,0,1109,1693,-10
95358592521,95358592523,2,2088,1729,-10
95358835390,95358835388,-2,1530,1914,-10
95359031967,95359031968,1,1291,1789,-10
95359576239,95359576238,-1,10302,15873,-10
95360178560,95360178554,-6,1137,1653,-10
95360661254,95360661255,1,1465,1379,-10
95363257169,95363257171,2,1384,1966,-10
95366673081,95366673082,1,1533,1515,-10
95367705820,95367705819,-1,1206,1505,-10
95368091294,95368091296,2,1402,1792,-10
95369968971,95369968972,1,1498,1812,-10
95370792128,95370792127,-1,1133,1388,-10
95378442525,95378442526,1,1626,1607,-10
95381708999,95381709004,5,1529,1272,-10
95384158023,95384158022,-1,1693,1660,-10
95385237485,95385237486,1,1715,1642,-10
95386314111,95386314113,2,893,1173,-10
95388954983,95388954985,2,1551,1697,-10
95390579614,95390579618,4,1451,1385,-10
95391092877,95391092878,1,2615,2016,-10
95391860398,95391860400,2,1534,1394,-10
95392848789,95392848789,0,1040,1457,-10
95398505829,95398505832,3,1556,1824,-10
95400230831,95400230834,3,2260,1422,-10
95402270407,95402270411,4,1367,1238,-10
95403530577,95403530582,5,5230,1766,-10
95404536141,95404536142,1,1347,1287,-10
95407571460,95407571462,2,1275,1268,-10
95408043381,95408043382,1,1064,1152,-10
95408387029,95408387031,2,1848,2243,-10
95408639714,95408639715,1,1574,2417,-10
95409551562,95409551563,1,1392,2091,-10
95412163154,95412163155,1,1354,1741,-10
95412692863,95412692865,2,1042,1327,-10
95418338844,95418338847,3,1716,1401,-10
95423489297,95423489282,-15,2833,1162,-10
95426095424,95426095426,2,1333,1897,-10
95429948933,95429948938,5,1174,1130,-10
95431836025,95431836027,2,1482,1015,-10
95433204921,95433204924,3,1513,1347,-10
95435950322,95435950326,4,1709,1495,-10
95439595109,95439595110,1,1204,1341,-10
95441037698,95441037700,2,1720,1225,-10
95442608712,95442608714,2,1688,1509,-10
95442870494,95442870494,0,2137,2308,-10
95445896615,95445896619,4,2120,1845,-10
95448151894,95448151895,1,1425,1199,-10
95448839177,95448839178,1,1603,1483,-10
95450381734,95450381737,3,1587,1717,-10
95457753423,95457753425,2,1669,1674,-10
95457808290,95457808293,3,2770,1394,-10
95459593498,95459593498,0,1287,1393,-10
95460083855,95460083855,0,1867,1415,-10
95462217782,95462217783,1,1265,1153,-10
95464086205,95464086210,5,3573,1230,-10
95464719983,95464719985,2,1779,2034,-10
95466351681,95466351681,0,1432,1717,-10
95466708866,95466708867,1,1427,1728,-10
95469732777,95469732779,2,1110,1248,-10
95470524260,95470524263,3,1618,1342,-10
95474400549,95474400540,-9,1193,1041,-10
95475457332,95475457334,2,1665,1429,-10
95477558264,95477558266,2,1225,1589,-10
95477946390,95477946393,3,2169,1730,-10
95482693654,95482693654,0,855,1258,-10
95485837460,95485837460,0,1871,1967,-10
95487697886,95487697886,0,1464,1522,-10
95494652517,95494652519,2,1014,1361,-10
95495699973,95495699974,1,1333,1635,-10
95496670181,95496670177,-4,2646,5173,-10
95497811714,95497811716,2,1478,1574,-10
95498377597,95498377598,1,1453,1311,-10
95499228292,95499228290,-2,1340,2175,-10
95502305339,95502305341,2,1127,1319,-10
95505046078,95505046080,2,1646,1205,-10
95505783202,95505783205,3,1487,1761,-10
95506037936,95506037938,2,1345,1530,-10
95511699697,95511699690,-7,1288,2652,-10
95514935698,95514935698,0,1049,1398,-10
95520302431,95520302432,1,1375,1490,-10
95520444774,95520444778,4,1199,881,-10
95521507333,95521507330,-3,853,2120,-10
95523670208,95523670198,-10,7714,18772,-10
95524768017,95524768010,-7,2524,7572,-10
95526877928,95526877931,3,1370,822,-10
95528858136,95528858140,4,1021,1414,-10
95531134498,95531134502,4,1498,1679,-10
95536720866,95536720867,1,1386,1656,-10
95539684394,95539684397,3,1484,1545,-10
95544435935,95544435936,1,1457,1593,-10
95547407135,95547407134,-1,1642,1428,-10
95547893012,95547893018,6,1607,1025,-10
95549540978,95549540979,1,1421,1362,-10
95555005534,95555005534,0,1965,1747,-10
95555975082,95555975084,2,2060,1430,-10
95556045091,95556045091,0,944,924,-10
95561509181,95561509183,2,1929,1882,-10
95563969542,95563969545,3,1360,1484,-10
95565212765,95565212769,4,2052,1721,-10
95570063874,95570063875,1,2011,1942,-10
95571860758,95571860759,1,1611,1112,-10
95577348212,95577348213,1,1562,1964,-10
95577769695,95577769695,0,1032,1215,-10
95578797416,95578797418,2,1417,967,-10
95579019077,95579019078,1,1675,1890,-10
95579727224,95579727226,2,2442,2147,-10
95581683108,95581683108,0,1610,2610,-10
95582853443,95582853445,2,1160,1326,-10
95587088368,95587088370,2,1750,1948,-10
95587655629,95587655633,4,1374,1132,-10
95590598614,95590598615,1,1486,1670,-10
95593066561,95593066566,5,1973,1280,-10
95595034141,95595034143,2,1055,1237,-10
95595946513,95595946514,1,1180,1108,-10
95596128686,95596128687,1,1602,1490,-10
95599011493,95599011494,1,1220,1351,-10
95599925366,95599925386,20,1130,1357,-10
95600131304,95600131307,3,1545,1403,-10
95602250889,95602250890,1,1858,1895,-10
95602427154,95602427155,1,2021,1816,-10
95602564131,95602564134,3,1352,1806,-10
95603923189,95603923189,0,1106,1626,-10
95606319617,95606319618,1,1778,1899,-10
95608248396,95608248398,2,596,888,-10
95609699391,95609699392,1,2595,2449,-10
95618511757,95618511764,7,3215,1426,-10
95618639978,95618639979,1,1435,1051,-10
95619087190,95619087193,3,1882,1841,-10
95623833146,95623833146,0,1305,1991,-10
95624682889,95624682890,1,1887,2565,-10
95625359966,95625359967,1,1155,1179,-10
95625998217,95625998218,1,1660,1600,-10
95628900806,95628900809,3,1364,1004,-10
95629413540,95629413545,5,2509,1719,-10
95630521522,95630521523,1,2273,2258,-10
95633308770,95633308771,1,1448,1547,-10
95633468897,95633468898,1,1623,1144,-10
95637354957,95637354959,2,1952,1650,-10
95637680571,95637680573,2,1162,1343,-10
95638988590,95638988591,1,1672,1425,-10
95641138098,95641138098,0,1903,2166,-10
95643718041,95643718044,3,1889,1346,-10
95645231054,95645231054,0,1324,2029,-10
95645437442,95645437443,1,1212,1763,-10
95650946326,95650946326,0,1400,1175,-10
95657325232,95657325233,1,1186,1357,-10
95658354446,95658354447,1,1623,1392,-10
95658398728,95658398730,2,1676,1953,-10
95660542493,95660542494,1,1336,1372,-10
95661116854,95661116832,-22,1191,1277,-10
95664840026,95664840029,3,1713,947,-10
95669376471,95669376474,3,1456,1436,-10
95671087818,95671087821,3,1685,1614,-10
95671589134,95671589137,3,2045,2285,-10
95672872979,95672872982,3,1103,1587,-10
95681085467,95681085471,4,1741,1220,-10
95684045645,95684045647,2,1949,1244,-10
95684367498,95684367502,4,1426,1954,-10
95684883353,95684883354,1,1486,1632,-10
95685571687,95685571689,2,1551,1480,-10
95686112730,95686112731,1,2123,1724,-10
95686449007,95686449009,2,1643,1167,-10
95687711918,95687711918,0,1038,1787,-10
95687953534,95687953535,1,1310,1294,-10
95689765120,95689765122,2,1521,1857,-10
95691265235,95691265237,2,1431,1060,-10
95694634329,95694634330,1,1701,1598,-10
95695669904,95695669906,2,929,926,-10
95696896681,95696896681,0,1658,1128,-10
95698654846,95698654846,0,1112,2315,-10
95707676731,95707676732,1,1893,2435,-10
95708328306,95708328305,-1,1094,1654,-10
95709314133,95709314133,0,1677,1560,-10
95711138944,95711138945,1,1130,1230,-10
95712151130,95712151134,4,1700,2555,-10
95713562529,95713562531,2,1731,1565,-10
95714312517,95714312514,-3,1427,1991,-10
95715213891,95715213881,-10,1204,1285,-10
95715864882,95715864885,3,1329,1614,-10
95717943451,95717943454,3,1285,1597,-10
95722299349,95722299350,1,1945,1780,-10
95725947223,95725947223,0,1235,1587,-10
95730067826,95730067805,-21,1858,1696,-10
95731304943,95731304945,2,2008,2026,-10
95731409985,95731409986,1,1568,1972,-10
95736428718,95736428723,5,1537,1551,-10
95737969010,95737969012,2,1775,1583,-10
95739891375,95739891378,3,1530,1297,-10
95740428263,95740428263,0,1287,1940,-10
95741047502,95741047506,4,1183,1433,-10
95741879653,95741879655,2,1425,1317,-10
95744096553,95744096554,1,1951,2344,-10
95744762563,95744762572,9,4570,1827,-10
95745386829,95745386829,0,1358,1753,-10
95746383476,95746383478,2,1689,1673,-10
95749104937,95749104936,-1,1874,3164,-10
95750839162,95750839163,1,1824,1352,-10
95754267755,95754267758,3,2058,1346,-10
95754392329,95754392331,2,1381,1493,-10
95757284611,95757284618,7,4197,2048,-10
95759919235,95759919238,3,1916,1710,-10
95764091517,95764091515,-2,1187,1495,-10
95766238889,95766238904,15,566,2254,-10
95768387674,95768387682,8,3157,1294,-10
95770465762,95770465762,0,1594,1595,-10
95771884719,95771884722,3,2238,1904,-10
95773419621,95773419623,2,1809,1673,-10
95774519298,95774519298,0,1275,2165,-10
95776484926,95776484927,1,1521,966,-10
95777443073,95777443074,1,773,1026,-10
95780417236,95780417237,1,1450,1556,-10
95786221597,95786221603,6,8185,3327,-10
95786624443,95786624444,1,1194,1326,-10
95787401738,95787401731,-7,747,2790,-10
95787488269,95787488270,1,1550,1733,-10
95787730583,95787730587,4,1184,1224,-10
95789683018,95789683019,1,2014,1893,-10
95789965131,95789965131,0,1869,2395,-10
95790655314,95790655315,1,1316,1526,-10
95791994670,95791994675,5,3667,1306,-10
95794294103,95794294106,3,1379,1719,-10
95798180450,95798180452,2,1475,1251,-10
95798415501,95798415483,-18,1423,1026,-10
95800601706,95800601709,3,2353,1963,-10
95801418374,95801418394,20,1257,1559,-10
95803696181,95803696181,0,1785,2060,-10
95806612350,95806612351,1,1313,1640,-10
95808135615,95808135617,2,1690,1719,-10
95808280593,95808280594,1,914,1436,-10
95809171848,95809171851,3,1341,1389,-10
95810411048,95810411046,-2,1419,1798,-10
95812567587,95812567586,-1,1233,1475,-10
95813207946,95813207929,-17,2696,1504,-10
95814932698,95814932701,3,1042,1651,-10
95815076550,95815076551,1,1446,1690,-10
95815131594,95815131595,1,1877,1908,-10
95816005019,95816005019,0,1898,1427,-10
95816573548,95816573548,0,1650,1827,-10
95817528049,95817528045,-4,1130,1322,-10
95818833747,95818833750,3,1504,1516,-10
95819989937,95819989938,1,1318,1711,-10
95821228001,95821228002,1,1960,2051,-10
95823151283,95823151282,-1,1708,3521,-10
95823828594,95823828597,3,2408,2095,-10
95825431278,95825431279,1,1879,1176,-10
95825932704,95825932705,1,1454,1263,-10
95826778682,95826778679,-3,1121,1757,-10
95828174609,95828174610,1,1876,1068,-10
95828279948,95828279950,2,1536,1508,-10
95830099654,95830099657,3,1295,1399,-10
95831813547,95831813548,1,1207,1344,-10
95835266050,95835266053,3,856,1459,-10
95836336998,95836337000,2,1723,1565,-10
95837827054,95837827057,3,1561,1936,-10
95837947514,95837947533,19,2080,1197,-10
95842557126,95842557128,2,1448,1468,-10
95843136810,95843136811,1,1113,1000,-10
95845842307,95845842310,3,1396,1523,-10
95848441361,95848441364,3,1673,1244,-10
95850652643,95850652646,3,1741,1464,-10
95854350266,95854350267,1,1793,1413,-10
95857443557,95857443559,2,1206,1811,-10
95860079759,95860079762,3,1456,1953,-10
95860743623,95860743625,2,2058,1666,-10
95863321697,95863321703,6,2121,1249,-10
95867810762,95867810763,1,1687,1790,-10
95869147423,95869147425,2,2037,2113,-10
95869526317,95869526317,0,1238,1228,-10
95871171310,95871171312,2,1519,1385,-10
95871670669,95871670683,14,910,742,-10
95876929998,95876930003,5,1714,1564,-10
95878988919,95878988898,-21,2725,2402,-10
95881588929,95881588933,4,1907,1699,-10
95884249000,95884249002,2,1518,1314,-10
95886756662,95886756663,1,1055,858,-10
95887134794,95887134795,1,1210,1560,-10
95887797826,95887797828,2,1535,1922,-10
95888203086,95888203066,-20,1537,1207,-10
95892903351,95892903352,1,2120,2009,-10
95904897554,95904897555,1,1142,2313,-10
95905241106,95905241106,0,1609,1334,-10
95905669842,95905669842,0,1343,1360,-10
95905770041,95905770029,-12,927,1991,-10
95907370925,95907370926,1,1532,1439,-10
95908285105,95908285108,3,1730,1773,-10
95908632066,95908632070,4,4418,2221,-10
95911854148,95911854150,2,1426,1593,-10
95911881529,95911881517,-12,990,1922,-10
95913300614,95913300618,4,1677,2022,-10
95913862586,95913862587,1,1264,1871,-10
95919383771,95919383772,1,1759,1699,-10
95920886505,95920886505,0,1569,1892,-10
95921961225,95921961226,1,1557,1645,-10
95922420315,95922420318,3,1628,1610,-10
95927075687,95927075687,0,1511,1688,-10
95928183589,95928183582,-7,1620,8033,-10
95931986841,95931986850,9,15415,24899,-10
95933545053,95933545054,1,1373,1772,-10
95937806873,95937806875,2,1462,1435,-10
95938112771,95938112770,-1,1172,1155,-10
95940652125,95940652126,1,1319,1122,-10
95940808221,95940808225,4,15177,10887,-10
95945344556,95945344557,1,2246,2293,-10
95946136441,95946136445,4,2431,1720,-10
95951642090,95951642090,0,1305,2115,-10
95952079206,95952079209,3,1726,1390,-10
95955370319,95955370321,2,1586,1500,-10
95955750438,95955750442,4,1481,1670,-10
95956002719,95956002722,3,2660,2614,-10
95956782346,95956782348,2,1396,1603,-10
95959053094,95959053094,0,1453,1511,-10
95967192636,95967192622,-14,927,1094,-10
95970294366,95970294370,4,32714,18611,-10
95973421218,95973421220,2,1612,1722,-10
95974759182,95974759186,4,1250,879,-10
95975443146,95975443147,1,1505,2285,-10
95979876022,95979876027,5,1706,1374,-10
95980077503,95980077504,1,1006,1648,-10
95984069265,95984069266,1,999,945,-10
95984243927,95984243930,3,1456,1737,-10
95985209587,95985209589,2,1955,1767,-10
95989004487,95989004490,3,1803,1691,-10
95993440605,95993440606,1,1686,1152,-10
95993933616,95993933617,1,1794,1820,-10
95994511149,95994511150,1,1357,1305,-10
95995036475,95995036477,2,1791,1701,-10
95995769469,95995769470,1,1730,1743,-10
95996069650,95996069650,0,1114,925,-10
95999686096,95999686097,1,1581,1760,-10
96000152852,96000152856,4,2259,1441,-10
96002426830,96002426834,4,1647,1986,-10
96004631385,96004631388,3,1238,1071,-10
96004685361,96004685349,-12,1378,1106,-10
96005203254,96005203256,2,1576,1645,-10
96006460833,96006460834,1,1286,1309,-10
96007651278,96007651279,1,1413,1348,-10
96009913682,96009913678,-4,1623,5115,-10
96010376137,96010376138,1,1433,1349,-10
96012676619,96012676621,2,1139,1390,-10
96013248200,96013248202,2,1250,1322,-10
96016104789,96016104791,2,1684,1801,-10
96019529379,96019529381,2,1351,1780,-10
96019605527,96019605529,2,1330,1409,-10
96021494685,96021494687,2,1543,1636,-10
96023689740,96023689742,2,1320,1533,-10
96026200210,96026200213,3,1626,1383,-10
96028705333,96028705335,2,1592,1537,-10
96028757481,96028757484,3,1907,2478,-10
96030136134,96030136139,5,2146,1602,-10
96032967530,96032967531,1,1566,1243,-10
96033596942,96033596939,-3,1168,2418,-10
96037989970,96037989973,3,1357,1601,-10
96039481290,96039481292,2,1548,2505,-10
96039957222,96039957222,0,1675,2180,-10
96040856017,96040856019,2,1260,1355,-10
96040950888,96040950890,2,1788,1268,-10
96043984398,96043984403,5,1707,1304,-10
96044619495,96044619498,3,1415,1739,-10
96046031710,96046031712,2,1874,1742,-10
96049130711,96049130714,3,1419,1453,-10
96049951101,96049951102,1,860,1083,-10
96054784916,96054784922,6,1221,1520,-10
96057044558,96057044558,0,1105,1684,-10
96060821758,96060821758,0,1260,986,-10
96061867116,96061867118,2,2030,1558,-10
96064423760,96064423762,2,2018,2257,-10
96066754300,96066754293,-7,21409,19198,-10
96067360370,96067360373,3,1737,1520,-10
96067626126,96067626127,1,1006,1203,-10
96068126247,96068126246,-1,1630,1612,-10
96069143334,96069143335,1,1254,1246,-10
96070952271,96070952275,4,1607,1595,-10
96070987816,96070987818,2,2125,2053,-10
96071756031,96071756034,3,1285,1433,-10
96076127221,96076127223,2,1407,2039,-10
96077335979,96077335979,0,1507,1417,-10
96079259869,96079259870,1,1817,1316,-10
96079510402,96079510404,2,1287,1124,-10
96080189899,96080189900,1,1815,1820,-10
96080588754,96080588749,-5,1340,4922,-10
96081965841,96081965843,2,1787,1906,-10
96083169731,96083169736,5,1715,1847,-10
96083688082,96083688083,1,1394,1159,-10
96085886173,96085886170,-3,1038,3263,-10
96088459807,96088459810,3,2090,1977,-10
96089099724,96089099725,1,1913,1720,-10
96093222189,96093222192,3,1703,1620,-10
96093868107,96093868110,3,1249,1378,-10
96098171090,96098171091,1,799,1518,-10
96098904126,96098904127,1,1549,1631,-10
96101434350,96101434352,2,1858,1730,-10
96102828023,96102828023,0,1566,1354,-10
96104354885,96104354887,2,1533,1942,-10
96123676113,96123676121,8,30721,50631,-10
96124705666,96124705671,5,1453,969,-10
96125328721,96125328721,0,1326,1480,-10
96125487975,96125487977,2,1832,1667,-10
96127075794,96127075796,2,1586,1285,-10
96127766965,96127766966,1,1154,1015,-10
96128371800,96128371802,2,1099,1513,-10
96130257457,96130257460,3,1873,1317,-10
96130435491,96130435494,3,1839,1384,-10
96134166577,96134166582,5,2437,1310,-10
96134918281,96134918283,2,1765,1435,-10
96135378654,96135378659,5,1887,1295,-10
96135409837,96135409837,0,1855,1685,-10
96141446199,96141446198,-1,1587,2260,-10
96148074879,96148074880,1,1391,1357,-10
96148273078,96148273098,20,1594,1205,-10
96154261879,96154261888,9,13302,42344,-10
96157043598,96157043599,1,1481,1577,-10
96157089947,96157089951,4,1584,1227,-10
96158276630,96158276633,3,1534,1196,-10
96158633889,96158633893,4,898,980,-10
96158879962,96158879963,1,1256,1306,-10
96159254169,96159254170,1,1626,1460,-10
96161261175,96161261177,2,1972,2213,-10
96164405762,96164405762,0,1495,1818,-10
96164563759,96164563762,3,1860,1810,-10
96166392779,96166392780,1,1639,2110,-10
96167543966,96167543966,0,1238,2084,-10
96178762109,96178762101,-8,1923,12261,-10
96179171652,96179171655,3,1316,1178,-10
96183573026,96183573029,3,1525,1549,-10
96183648169,96183648171,2,1027,1512,-10
96184918482,96184918485,3,959,1479,-10
96185563325,96185563327,2,1315,1070,-10
96191188644,96191188645,1,1372,1822,-10
96195659401,96195659404,3,1595,1791,-10
96195987622,96195987624,2,1611,1809,-10
96197484979,96197484982,3,1017,1228,-10
96197614477,96197614458,-19,1653,1280,-10
96197693046,96197693046,0,1999,1346,-10
96199306938,96199306939,1,1437,1178,-10
96199443136,96199443137,1,1732,1580,-10
96201036319,96201036320,1,1287,1294,-10
96202650713,96202650715,2,1503,1960,-10
96205293269,96205293269,0,1114,2226,-10
96209914109,96209914111,2,1466,1683,-10
96210140250,96210140249,-1,1582,1964,-10
96210470606,96210470607,1,1337,1462,-10
96213374558,96213374573,15,1582,1599,-10
96215130531,96215130535,4,1532,1505,-10
96215379193,96215379194,1,1312,1056,-10
96219086759,96219086761,2,1738,1027,-10
96219372773,96219372774,1,1172,1800,-10
96222217755,96222217755,0,1312,1202,-10
96223075483,96223075481,-2,762,1104,-10
96224216142,96224216145,3,2012,1240,-10
96226042417,96226042418,1,1570,1564,-10
96233493110,96233493105,-5,1172,3433,-10
96235096581,96235096582,1,1415,1210,-10
96236144365,96236144361,-4,1176,2045,-10
96236410833,96236410837,4,4027,2650,-10
96236912283,96236912286,3,1458,1534,-10
96238709170,96238709172,2,1657,1783,-10
96238905649,96238905650,1,1661,1283,-10
96246380343,96246380342,-1,2107,2169,-10
96246571558,96246571559,1,900,1370,-10
96247830605,96247830605,0,1130,1406,-10
96249033197,96249033198,1,1414,1416,-10
96250850430,96250850431,1,1870,1764,-10
96250875660,96250875662,2,1622,1709,-10
96251284670,96251284673,3,1404,1738,-10
96252131815,96252131817,2,1402,1334,-10
96257251623,96257251626,3,2254,1589,-10
96260605082,96260605085,3,1168,1386,-10
96264461488,96264461490,2,1662,2045,-10
96265314590,96265314590,0,2127,2088,-10
96265371906,96265371907,1,1546,2373,-10
96265900361,96265900342,-19,216,785,-10
96269922156,96269922156,0,1728,2613,-10
96271954871,96271954874,3,1885,1642,-10
96273819674,96273819676,2,2089,1944,-10
96274260493,96274260489,-4,1204,1771,-10
96277157932,96277157935,3,5270,2243,-10
96277392938,96277392940,2,1187,1644,-10
96277676160,96277676147,-13,1105,1053,-10
96278558379,96278558379,0,1107,1111,-10
96279938214,96279938210,-4,1825,1700,-10
96280507657,96280507660,3,2224,1493,-10
96280614398,96280614396,-2,1021,2816,-10
96281326531,96281326535,4,2367,1741,-10
96281387851,96281387852,1,1269,1381,-10
96285481802,96285481806,4,2037,1944,-10
96285516168,96285516169,1,7855,8349,-10
96298045538,96298045539,1,2105,2232,-10
96302241780,96302241783,3,1563,1169,-10
96308726193,96308726196,3,1244,1310,-10
96311516825,96311516830,5,4442,2630,-10
96313540566,96313540570,4,1430,1339,-10
96314992918,96314992919,1,1562,1507,-10
96315360174,96315360175,1,1079,1821,-10
96317894546,96317894550,4,1384,1736,-10
96318072670,96318072670,0,1314,1353,-10
96323122145,96323122166,21,468,426,-10
96324363011,96324363012,1,1717,2203,-10
96326129921,96326129925,4,2414,1349,-10
96331736239,96331736239,0,1594,1364,-10
96332948070,96332948071,1,1420,1655,-10
96333543936,96333543937,1,1779,1615,-10
96333750699,96333750699,0,286,942,-10
96334703282,96334703282,0,1089,1983,-10
96334884500,96334884499,-1,1517,2229,-10
96337512797,96337512799,2,1458,1653,-10
96339236676,96339236678,2,2402,1882,-10
96339583298,96339583299,1,1451,1313,-10
96340129889,96340129898,9,1298,1672,-10
96340670489,96340670490,1,1356,1166,-10
96340983971,96340983973,2,1497,1325,-10
96341024267,96341024266,-1,1461,1717,-10
96341580252,96341580250,-2,1104,1060,-10
96343892514,96343892514,0,1536,2083,-10
96344355032,96344355035,3,1311,2539,-10
96346704805,96346704803,-2,1332,1528,-10
96349573586,96349573586,0,1504,1364,-10
96350291619,96350291622,3,1788,1797,-10
96350781630,96350781631,1,2117,2180,-10
96350921510,96350921513,3,1639,1699,-10
96352835779,96352835780,1,1437,1493,-10
96353247794,96353247794,0,989,1561,-10
96353296074,96353296076,2,1774,1716,-10
96354384909,96354384929,20,1730,1162,-10
96358046659,96358046662,3,1212,1593,-10
96360517970,96360517972,2,2463,2644,-10
96360875795,96360875797,2,1073,953,-10
96361263455,96361263454,-1,1589,1600,-10
96365327561,96365327563,2,1391,1056,-10
96367342508,96367342511,3,1415,1086,-10
96368277765,96368277767,2,1906,1928,-10
96370180222,96370180222,0,1777,1109,-10
96371512344,96371512343,-1,1553,2635,-10
96375996325,96375996326,1,1349,1546,-10
96377758195,96377758197,2,1658,2120,-10
96378769432,96378769433,1,1752,1872,-10
96379566820,96379566821,1,1282,1108,-10
96380560122,96380560123,1,2233,1674,-10
96381048687,96381048690,3,1663,1229,-10
96383080964,96383080966,2,2395,2126,-10
96384592219,96384592223,4,837,1218,-10
96387105278,96387105280,2,1503,1767,-10
96388427832,96388427850,18,471,741,-10
96389660802,96389660815,13,13378,38130,-10
96393069346,96393069346,0,1656,1924,-10
96393449003,96393449003,0,1552,1786,-10
96396332635,96396332636,1,1655,1733,-10
96396489783,96396489788,5,1468,916,-10
96397262005,96397262007,2,1439,1177,-10
96397840201,96397840203,2,1756,2117,-10
96401041130,96401041130,0,863,1953,-10
96403749764,96403749765,1,1851,1698,-10
96404539902,96404539906,4,1140,1736,-10
96404935597,96404935598,1,1824,1228,-10
96407879982,96407879985,3,1527,1521,-10
96415315329,96415315326,-3,1439,1698,-10
96416520782,96416520786,4,2214,2331,-10
96418995046,96418995050,4,1580,1650,-10
96420020515,96420020514,-1,1053,1766,-10
96420560033,96420560034,1,1276,1574,-10
96420918025,96420918026,1,1505,1351,-10
96423583559,96423583546,-13,1284,2249,-10
96423832805,96423832809,4,1274,1451,-10
96425542050,96425542051,1,2172,1572,-10
96426575723,96426575721,-2,1058,1981,-10
96426982405,96426982409,4,1503,1689,-10
96431860603,96431860605,2,1489,1599,-10
96436015071,96436015072,1,1811,1591,-10
96438307285,96438307288,3,1762,1410,-10
96438363322,96438363329,7,1607,1537,-10
96439487145,96439487146,1,1567,1623,-10
96442649378,96442649377,-1,1671,1527,-10
96445349918,96445349911,-7,1546,1956,-10
96448822138,96448822141,3,2072,1359,-10
96449113467,96449113474,7,1914,1652,-10
96450335062,96450335063,1,1322,1080,-10
96452239897,96452239898,1,1188,1745,-10
96453019928,96453019924,-4,1184,1973,-10
96457984950,96457984953,3,2015,1636,-10
96459281667,96459281671,4,1001,908,-10
96460695967,96460695965,-2,2975,4121,-10
96461224422,96461224425,3,1533,1480,-10
96462731057,96462731062,5,1887,1138,-10
96463597281,96463597283,2,1387,2318,-10
96464138944,96464138945,1,1886,1605,-10
96469223727,96469223730,3,2059,1514,-10
96470017933,96470017937,4,1405,1279,-10
96472761237,96472761239,2,1225,1543,-10
96474530171,96474530174,3,1239,1553,-10
96474891555,96474891537,-18,912,1343,-10
96477787389,96477787392,3,1644,1784,-10
96480164165,96480164181,16,15619,23382,-10
96481119330,96481119324,-6,1260,5781,-10
96482241501,96482241504,3,1903,1239,-10
96485883808,96485883809,1,1869,1430,-10
96489162514,96489162516,2,1661,1334,-10
96493652847,96493652866,19,1255,1594,-10
96495237435,96495237430,-5,1356,7115,-10
96496001711,96496001710,-1,1179,1405,-10
96501618662,96501618666,4,1905,2006,-10
96502829006,96502829007,1,1445,1131,-10
96504028449,96504028450,1,1842,2169,-10
96506651392,96506651393,1,1572,1708,-10
96519194432,96519194432,0,1980,1730,-10
96519502738,96519502739,1,1626,1479,-10
96520100799,96520100805,6,1434,763,-10
96523318760,96523318763,3,1699,1559,-10
96525681322,96525681329,7,2467,1422,-10
96525867825,96525867835,10,1239,1105,-10
96528832473,96528832473,0,1276,1150,-10
96529453154,96529453154,0,1676,1901,-10
96530029323,96530029322,-1,1427,1552,-10
96530897571,96530897574,3,1274,1417,-10
96535507758,96535507752,-6,2763,6358,-10
96536052111,96536052112,1,1252,1342,-10
96541907506,96541907506,0,1390,1616,-10
96543187583,96543187583,0,1256,1395,-10
96549664429,96549664429,0,1942,1673,-10
96551028465,96551028469,4,1351,1515,-10
96551549766,96551549770,4,2401,1508,-10
96554750175,96554750175,0,1079,1254,-10
96555144334,96555144334,0,1359,903,-10
96555724238,96555724241,3,1186,1445,-10
96557026255,96557026258,3,993,931,-10
96560506847,96560506849,2,1455,1020,-10
96563185928,96563185930,2,1670,2072,-10
96563692838,96563692839,1,1104,1540,-10
96567207110,96567207113,3,1711,1531,-10
96572000705,96572000705,0,1631,2627,-10
96573509146,96573509146,0,1708,1130,-10
96574389099,96574389102,3,1596,1676,-10
96574867031,96574867031,0,1736,1808,-10
96577371425,96577371426,1,1815,1930,-10
96583127054,96583127058,4,2131,1559,-10
96583499444,96583499442,-2,1808,1556,-10
96584835993,96584835994,1,1450,1257,-10
96592647198,96592647200,2,1907,2111,-10
96599451154,96599451154,0,1531,1950,-10
96600013445,96600013446,1,1874,1368,-10
96600555795,96600555794,-1,1285,1181,-10
96621540277,96621540278,1,1584,1916,-10
96622378563,96622378566,3,2038,1550,-10
96623308269,96623308269,0,1067,1074,-10
96634318503,96634318506,3,1328,2004,-10
96636820423,96636820427,4,2017,1899,-10
96638049083,96638049075,-8,1416,1474,-10
96638554021,96638554018,-3,1561,1772,-10
96641152563,96641152566,3,1285,1879,-10
96642864910,96642864912,2,1437,1776,-10
96643204685,96643204687,2,1784,1467,-10
96645160115,96645160119,4,1666,1446,-10
96646135272,96646135274,2,1663,1457,-10
96653974028,96653974029,1,1473,1231,-10
96654560227,96654560233,6,3432,960,-10
96657154473,96657154469,-4,655,1519,-10
96658817510,96658817514,4,903,1621,-10
96659941299,96659941303,4,991,806,-10
96664099107,96664099103,-4,1099,3120,-10
96669462242,96669462245,3,1721,1396,-10
96669699856,96669699858,2,1583,1679,-10
96670879561,96670879561,0,1392,1797,-10
96675996049,96675996056,7,5169,1905,-10
96677830765,96677830746,-19,1862,1184,-10
96684285827,96684285829,2,1179,954,-10
96685029128,96685029118,-10,899,2551,-10
96685958221,96685958223,2,1635,1779,-10
96687638753,96687638754,1,1378,1511,-10
96689389443,96689389445,2,1725,1690,-10
96692051192,96692051194,2,1683,1690,-10
96693965218,96693965219,1,1612,1402,-10
96694407280,96694407282,2,1725,1946,-10
96694931110,96694931115,5,1450,1628,-10
96697110760,96697110764,4,4150,2336,-10
96697617694,96697617694,0,1257,1381,-10
96701038256,96701038258,2,1591,1833,-10
96701773149,96701773151,2,1335,1335,-10
96703460295,96703460308,13,987,2363,-10
96707611034,96707611034,0,977,1070,-10
96713657798,96713657801,3,1527,1471,-10
96713908847,96713908848,1,1024,1455,-10
96719464154,96719464155,1,994,1553,-10
96722909695,96722909698,3,903,789,-10
96724539859,96724539862,3,1473,1411,-10
96725519808,96725519810,2,1298,1369,-10
96728626150,96728626153,3,1864,1897,-10
96729058868,96729058869,1,1455,1394,-10
96729270573,96729270574,1,1420,1130,-10
96729901855,96729901858,3,2069,2139,-10
96731187438,96731187442,4,1634,1612,-10
96732860861,96732860866,5,1399,714,-10
96737368755,96737368755,0,878,1887,-10
96739407388,96739407392,4,2048,2275,-10
96746972121,96746972122,1,1556,1499,-10
96748573550,96748573554,4,1549,1635,-10
96748615020,96748615021,1,2050,1301,-10
96749800082,96749800074,-8,902,1280,-10
96750972126,96750972126,0,1603,1855,-10
96751413958,96751413964,6,2536,1572,-10
96753048483,96753048485,2,1870,1489,-10
96753573344,96753573347,3,1129,1229,-10
96755198842,96755198839,-3,1696,1924,-10
96758040101,96758040106,5,2107,1597,-10
96758728270,96758728271,1,875,1295,-10
96759867250,96759867250,0,1285,1316,-10
96760730088,96760730093,5,1335,918,-10
96763003352,96763003354,2,1690,1330,-10
96767630450,96767630452,2,1211,1568,-10
96773512654,96773512656,2,942,1200,-10
96775479133,96775479134,1,1935,1807,-10
96777545406,96777545410,4,1602,1810,-10
96779287525,96779287528,3,2104,1787,-10
96780902817,96780902819,2,1203,1148,-10
96788185205,96788185204,-1,2663,4538,-10
96789802653,96789802656,3,1625,1763,-10
96791071405,96791071405,0,1469,1864,-10
96791173888,96791173893,5,4587,1797,-10
96791803282,96791803285,3,1939,1684,-10
96793795922,96793795924,2,1581,1552,-10
96795212053,96795212054,1,1317,1605,-10
96800264702,96800264703,1,1434,1738,-10
96804687536,96804687537,1,1205,1179,-10
96806126388,96806126391,3,1645,1478,-10
96807865410,96807865410,0,1453,1187,-10
96810648937,96810648938,1,2330,2047,-10
96812981631,96812981635,4,2688,2695,-10
96814720477,96814720477,0,1711,1244,-10
96817210032,96817210032,0,1438,2155,-10
96818511966,96818511971,5,3470,2372,-10
96820454145,96820454147,2,2029,1766,-10
96820550576,96820550586,10,17235,13824,-10
96822699152,96822699153,1,1717,1946,-10
96825426210,96825426211,1,1979,1050,-10
96825478555,96825478555,0,2535,3546,-10
96827879026,96827879027,1,1816,1458,-10
96829350714,96829350714,0,1566,1441,-10
96829421688,96829421691,3,1450,1421,-10
96829544977,96829544972,-5,1978,7019,-10
96831006722,96831006723,1,1525,1212,-10
96833895086,96833895089,3,1742,1804,-10
96838212839,96838212843,4,1946,1436,-10
96848487434,96848487434,0,1840,2284,-10
96849251411,96849251414,3,1779,1638,-10
96850869450,96850869452,2,1627,1798,-10
96855659531,96855659533,2,1969,1639,-10
96855914606,96855914626,20,1938,1892,-10
96858632523,96858632525,2,2099,2350,-10
96859452569,96859452572,3,1832,1874,-10
96860564826,96860564844,18,702,3932,-10
96861035450,96861035453,3,2693,1747,-10
96862453347,96862453351,4,1653,1693,-10
96862793251,96862793252,1,1796,1246,-10
96870200916,96870200917,1,1626,1583,-10
96872259143,96872259141,-2,1232,2558,-10
96873885622,96873885624,2,1321,1673,-10
96876813460,96876813462,2,1276,1440,-10
96879542862,96879542863,1,1627,1395,-10
96881138251,96881138255,4,1134,1399,-10
96881887178,96881887181,3,1682,1814,-10
96882088143,96882088141,-2,1831,1712,-10
96882324926,96882324930,4,1570,1682,-10
96883278712,96883278713,1,1571,1501,-10
96884269415,96884269418,3,2665,2253,-10
96889155710,96889155713,3,1154,996,-10
96889878207,96889878185,-22,699,411,-10
96891200274,96891200277,3,2287,1669,-10
96891461384,96891461385,1,1532,1470,-10
96894380626,96894380627,1,1217,1583,-10
96899498364,96899498376,12,8385,48485,-10
96899737302,96899737302,0,1273,1008,-10
96900844152,96900844154,2,1510,1429,-10
96905314629,96905314632,3,673,1163,-10
96907443150,96907443152,2,1567,1519,-10
96909226650,96909226652,2,1058,1245,-10
96912735620,96912735622,2,1972,2187,-10
96914912652,96914912653,1,1940,2162,-10
96919717258,96919717260,2,1373,2280,-10
96925686416,96925686416,0,1568,1519,-10
96926583694,96926583692,-2,2165,4510,-10
96927796755,96927796758,3,1550,1651,-10
96931599818,96931599822,4,1525,1150,-10
96934693934,96934693936,2,2111,1950,-10
96937368930,96937368930,0,2034,1626,-10
96941248125,96941248129,4,1223,1804,-10
96941536527,96941536529,2,1326,1067,-10
96943011251,96943011254,3,1001,1259,-10
96950289139,96950289138,-1,848,1249,-10
96953538898,96953538898,0,1991,2511,-10
96954053606,96954053601,-5,1189,4562,-10
96954621644,96954621645,1,2376,1974,-10
96954676859,96954676863,4,1241,1430,-10
96954834139,96954834141,2,1321,1306,-10
96955613195,96955613198,3,2020,1397,-10
96959650684,96959650685,1,2352,2285,-10
96960633038,96960633027,-11,2670,16526,-10
96961637874,96961637877,3,1601,1474,-10
96963136271,96963136273,2,3482,2598,-10
96965071751,96965071751,0,1453,1290,-10
96967572145,96967572132,-13,1597,1492,-10
96969975646,96969975647,1,1381,1601,-10
96972594766,96972594769,3,1342,1347,-10
96975803850,96975803851,1,1732,1485,-10
96978417926,96978417930,4,1815,1294,-10
96983781342,96983781334,-8,855,3185,-10
96986975363,96986975362,-1,1532,1923,-10
96987385258,96987385247,-11,1825,1682,-10
96988224275,96988224278,3,2244,1714,-10
96988294145,96988294146,1,1856,1603,-10
96990104674,96990104664,-10,152,1269,-10
96990645179,96990645194,15,356,1300,-10
96996908647,96996908649,2,1642,1419,-10
96997557933,96997557930,-3,1227,2764,-10
97000573827,97000573831,4,2032,1537,-10
97003813872,97003813875,3,1786,1241,-10
97003894297,97003894301,4,1410,1554,-10
97007743221,97007743222,1,2212,1732,-10
97009101857,97009101858,1,1531,1750,-10
97009230634,97009230635,1,2020,1418,-10
97010507420,97010507422,2,1464,1118,-10
97011917470,97011917473,3,1743,1494,-10
97012746675,97012746678,3,920,1269,-10
97015798289,97015798289,0,1117,1032,-10
97017406819,97017406822,3,1922,1491,-10
97018079078,97018079084,6,3014,1231,-10
97018878080,97018878082,2,1544,1809,-10
97022826678,97022826680,2,1567,1600,-10
97027887631,97027887630,-1,1196,1701,-10
97029369539,97029369540,1,1851,1798,-10
97031051937,97031051939,2,1166,1505,-10
97031665631,97031665633,2,1811,1544,-10
97032817535,97032817535,0,1241,1139,-10
97037375057,97037375058,1,1424,1251,-10
97038266930,97038266933,3,809,1423,-10
97040728452,97040728454,2,1637,1405,-10
97042156072,97042156072,0,1500,1832,-10
97042385373,97042385375,2,1353,1410,-10
97042447939,97042447959,20,1029,1449,-10
97045884086,97045884086,0,1222,719,-10
97045948114,97045948115,1,1601,1213,-10
97046271039,97046271041,2,1545,1849,-10
97048831901,97048831900,-1,1034,2115,-10
97050167213,97050167214,1,1676,1512,-10
97052891233,97052891235,2,1902,1777,-10
97053368957,97053368962,5,2352,1193,-10
97055945510,97055945514,4,1436,1242,-10
97058209487,97058209487,0,1190,1317,-10
97059691213,97059691214,1,1260,1571,-10
97061016252,97061016253,1,1487,1241,-10
97061915446,97061915447,1,1476,1626,-10
97064579753,97064579754,1,1554,1798,-10
97074567305,97074567310,5,2888,1402,-10
97075180567,97075180569,2,1488,2696,-10
97076717169,97076717170,1,1476,1047,-10
97077226172,97077226175,3,1121,1003,-10
97079957294,97079957294,0,1616,1685,-10
97082643961,97082643962,1,1512,1557,-10
97084985173,97084985172,-1,1397,1982,-10
97093248678,97093248679,1,1390,1827,-10
97097262698,97097262699,1,1290,930,-10
97099554810,97099554811,1,1490,2018,-10
97099679145,97099679145,0,1502,1730,-10
97100538177,97100538180,3,1280,1330,-10
97102814778,97102814779,1,1693,1271,-10
97104467418,97104467417,-1,1433,1224,-10
97107115677,97107115673,-4,1085,2353,-10
97109269145,97109269150,5,2015,1126,-10
97110661246,97110661247,1,1058,1075,-10
97113883391,97113883395,4,1551,1147,-10
97115130122,97115130125,3,1096,1569,-10
97117625026,97117625028,2,789,1005,-10
97120625854,97120625856,2,1346,1293,-10
97120782554,97120782558,4,1623,1461,-10
97121304151,97121304153,2,1638,1621,-10
97122914739,97122914739,0,1717,1389,-10
97129896260,97129896261,1,1522,1149,-10
97130747607,97130747611,4,1458,1233,-10
97138550281,97138550283,2,1548,1692,-10
97139407907,97139407910,3,1186,1613,-10
97139906113,97139906097,-16,1254,942,-10
97141743865,97141743865,0,1586,1872,-10
97142227389,97142227389,0,1245,1468,-10
97146819918,97146819922,4,1493,1359,-10
97147082781,97147082777,-4,5422,14781,-10
97155839577,97155839579,2,1088,1728,-10
97156257792,97156257795,3,1042,1121,-10
97156906551,97156906553,2,1216,1031,-10
97159229895,97159229896,1,1525,1636,-10
97159964690,97159964694,4,1412,1887,-10
97160455290,97160455285,-5,1248,1231,-10
97161390798,97161390799,1,1770,1927,-10
97163367402,97163367402,0,1814,1635,-10
97165618412,97165618411,-1,1286,1329,-10
97167502251,97167502254,3,1452,1503,-10
97168410778,97168410779,1,1324,1561,-10
97171129873,97171129875,2,1290,1134,-10
97175627292,97175627295,3,1536,1598,-10
97176117502,97176117505,3,1409,1166,-10
97178519384,97178519386,2,2143,2223,-10
97178633312,97178633314,2,1448,1469,-10
97179898005,97179898003,-2,113,553,-10
97185703575,97185703570,-5,1266,1249,-10
97185896867,97185896862,-5,100,978,-10
97190032287,97190032286,-1,1284,2382,-10
97191423813,97191423815,2,1103,1694,-10
97201595546,97201595549,3,1026,1412,-10
97204121712,97204121715,3,1888,1751,-10
97206166338,97206166341,3,1695,1975,-10
97207748746,97207748748,2,1483,1659,-10
97209786103,97209786105,2,1635,1614,-10
97210423999,97210423999,0,1924,2297,-10
97210616727,97210616728,1,1495,1465,-10
97211479677,97211479680,3,1923,2206,-10
97213375081,97213375081,0,1559,2119,-10
97213963934,97213963935,1,1224,1579,-10
97218109082,97218109082,0,1503,1502,-10
97218757659,97218757662,3,1832,1243,-10
97220090877,97220090872,-5,1424,3424,-10
97220531626,97220531626,0,1869,1569,-10
97226314482,97226314483,1,2041,1256,-10
97229502417,97229502418,1,1656,1923,-10
97233198794,97233198798,4,2398,1741,-10
97235625101,97235625103,2,2013,1448,-10
97238585109,97238585112,3,1663,1474,-10
97242940595,97242940589,-6,1736,9530,-10
97245565700,97245565702,2,2096,1816,-10
97246479820,97246479834,14,15929,40885,-10
97247656676,97247656681,5,1179,1500,-10
97247827358,97247827358,0,1250,1179,-10
97248225465,97248225466,1,877,936,-10
97253619457,97253619458,1,1096,1048,-10
97256935633,97256935637,4,1437,1308,-10
97259330927,97259330930,3,1954,2196,-10
97262161917,97262161922,5,1720,1557,-10
97262823713,97262823713,0,1610,1432,-10
97266935547,97266935550,3,1568,1376,-10
97268291019,97268291017,-2,975,2643,-10
97269661722,97269661723,1,1998,1517,-10
97271512296,97271512292,-4,23245,14355,-10
97272898437,97272898443,6,1692,918,-10
97273359490,97273359492,2,999,1382,-10
97274751046,97274751046,0,2459,1897,-10
97274958991,97274958989,-2,1511,2578,-10
97280620973,97280620974,1,1986,1662,-10
97282866291,97282866288,-3,1075,1764,-10
97282947046,97282947047,1,1860,1855,-10
97284722834,97284722834,0,1414,1369,-10
97285157864,97285157866,2,1965,1689,-10
97285560902,97285560903,1,1892,2047,-10
97290113123,97290113125,2,1650,1732,-10
97291114978,97291114979,1,1285,1070,-10
97293470117,97293470118,1,1383,1461,-10
97293830629,97293830626,-3,1234,1642,-10
97294674618,97294674622,4,2113,1408,-10
97294928129,97294928131,2,1640,1438,-10
97296064974,97296064975,1,1763,1213,-10
97298987976,97298987978,2,1791,1979,-10
97300572634,97300572636,2,1879,1692,-10
97300928986,97300928988,2,1528,1902,-10
97305932686,97305932689,3,1950,1877,-10
97307432546,97307432548,2,1857,2162,-10
97310227157,97310227159,2,1134,1773,-10
97318105052,97318105053,1,1814,1495,-10
97320656474,97320656479,5,2612,1358,-10
97325340482,97325340482,0,1108,1227,-10
97329170174,97329170176,2,1813,1595,-10
97331310047,97331310049,2,2379,1691,-10
97333494126,97333494129,3,1576,1033,-10
97335148594,97335148594,0,1371,1323,-10
97335967434,97335967439,5,2625,1254,-10
97338957867,97338957869,2,2561,1594,-10
97341322683,97341322686,3,1902,1554,-10
97342105942,97342105943,1,1309,1185,-10
97343008306,97343008306,0,1780,1711,-10
97346112916,97346112912,-4,1989,5388,-10
97347190670,97347190670,0,1779,1433,-10
97347419595,97347419597,2,1288,1330,-10
97348263552,97348263555,3,1769,981,-10
97349974871,97349974872,1,852,1837,-10
97354509489,97354509490,1,1532,1813,-10
97354534714,97354534715,1,1119,803,-10
97354548272,97354548272,0,178,172,-10
97354965422,97354965423,1,1021,2166,-10
97356493978,97356493979,1,1100,1164,-10
97360578243,97360578238,-5,1284,1775,-10
97363793046,97363793053,7,3947,1523,-10
97364200518,97364200500,-18,1076,687,-10
97364762705,97364762709,4,1544,1259,-10
97365495750,97365495753,3,1815,1436,-10
97368253520,97368253522,2,1555,2020,-10
97369134281,97369134282,1,1421,1450,-10
97369619733,97369619737,4,1461,1589,-10
97371394965,97371394967,2,1094,1874,-10
97375182938,97375182939,1,1530,1657,-10
97375851134,97375851134,0,1811,1920,-10
97377888290,97377888294,4,1818,1853,-10
97379981921,97379981922,1,1373,1556,-10
97387742177,97387742161,-16,1724,1510,-10
97389484754,97389484755,1,1417,1396,-10
97401614849,97401614850,1,1871,2174,-10
97402444774,97402444775,1,1744,1616,-10
97402886375,97402886376,1,2205,1649,-10
97405170222,97405170222,0,1965,1740,-10
97405350991,97405350990,-1,1090,1635,-10
97405832033,97405832036,3,1447,1533,-10
97406937774,97406937777,3,1962,1527,-10
97409538640,97409538641,1,2325,1873,-10
97412531114,97412531118,4,2046,1847,-10
97413171195,97413171197,2,1533,1753,-10
97417501364,97417501363,-1,21439,2674,-10
97419207897,97419207898,1,1612,1271,-10
97419395651,97419395653,2,1574,1135,-10
97419795949,97419795953,4,1706,1388,-10
97420968437,97420968437,0,1492,1565,-10
97422407509,97422407509,0,1780,1386,-10
97423434574,97423434577,3,2112,1848,-10
97426703498,97426703499,1,1963,2217,-10
97427503386,97427503388,2,1432,1435,-10
97429426755,97429426756,1,2032,1430,-10
97429614875,97429614877,2,787,1233,-10
97431310875,97431310878,3,2093,2008,-10
97432218286,97432218289,3,1612,1390,-10
97434196597,97434196598,1,2295,2083,-10
97434447554,97434447555,1,1745,2279,-10
97434513014,97434513018,4,1736,1383,-10
97435064643,97435064646,3,2420,1382,-10
97436711769,97436711770,1,1330,865,-10
97437402610,97437402614,4,1515,789,-10
97439628035,97439628043,8,10352,31553,-10
97442929846,97442929847,1,1035,1744,-10
97443008338,97443008347,9,1644,1418,-10
97444424794,97444424795,1,1520,1493,-10
97445417502,97445417501,-1,1866,2221,-10
97448492281,97448492283,2,2153,2078,-10
97448924690,97448924690,0,1320,1286,-10
97449002197,97449002192,-5,882,2773,-10
97450177311,97450177316,5,1272,1460,-10
97455619703,97455619706,3,1663,1993,-10
97459861541,97459861543,2,1566,1792,-10
97462403569,97462403571,2,1676,2171,-10
97462676423,97462676426,3,1995,1968,-10
97462722206,97462722206,0,1098,985,-10
97467778875,97467778878,3,1271,1296,-10
97469534925,97469534923,-2,1027,221,-10
97470413979,97470413981,2,1473,1401,-10
97474234218,97474234221,3,1506,1493,-10
97475173357,97475173358,1,1555,2313,-10
97477624373,97477624373,0,1688,1479,-10
97478018718,97478018714,-4,2329,4765,-10
97478472258,97478472259,1,1413,2302,-10
97479475082,97479475081,-1,1503,1628,-10
97485166548,97485166551,3,1890,2030,-10
97487648042,97487648042,0,977,1728,-10
97488128783,97488128785,2,1816,1676,-10
97493090531,97493090535,4,1120,970,-10
97494198798,97494198777,-21,865,1307,-10
97495340586,97495340589,3,1194,1336,-10
97496723223,97496723225,2,2224,1768,-10
97497990482,97497990482,0,977,1215,-10
97510555346,97510555348,2,2136,1527,-10
97513166594,97513166595,1,1236,1536,-10
97513480793,97513480796,3,1092,1647,-10
97513639723,97513639721,-2,1212,3090,-10
97514767679,97514767679,0,1735,1843,-10
97515714379,97515714381,2,1591,2107,-10
97522693581,97522693585,4,2161,1453,-10
97522931519,97522931519,0,1639,1822,-10
97524008754,97524008756,2,2360,2351,-10
97526461351,97526461354,3,1561,1896,-10
97526726325,97526726327,2,2084,1958,-10
97528182994,97528182996,2,2302,1430,-10
97530206355,97530206350,-5,1533,4367,-10
97530962489,97530962490,1,1798,1532,-10
97534492440,97534492443,3,1777,1256,-10
97534922918,97534922920,2,2053,2103,-10
97535939730,97535939731,1,1148,1124,-10
97536783031,97536783036,5,1409,1234,-10
97538187739,97538187742,3,1427,1046,-10
97540765637,97540765639,2,939,1532,-10
97552262548,97552262549,1,1554,1875,-10
97554724354,97554724356,2,1688,2040,-10
97554776962,97554776962,0,1787,2346,-10
97555686265,97555686267,2,2026,1541,-10
97558327642,97558327644,2,1602,1484,-10
97559459979,97559459981,2,1257,1324,-10
97564933916,97564933916,0,1534,1454,-10
97565641120,97565641119,-1,1495,2269,-10
97566611137,97566611135,-2,1640,3131,-10
97566864221,97566864225,4,1524,1112,-10
97573112981,97573112984,3,1325,1240,-10
97573217070,97573217086,16,16624,49686,-10
97575604454,97575604455,1,1670,1717,-10
97576274745,97576274745,0,1285,1481,-10
97581649515,97581649518,3,1432,1442,-10
97581741698,97581741698,0,1795,2020,-10
97583687830,97583687830,0,1482,1659,-10
97587825117,97587825117,0,1470,1849,-10
97590073115,97590073113,-2,1351,1452,-10
97592014999,97592015002,3,1206,1677,-10
97592982370,97592982370,0,1515,1579,-10
97593182547,97593182549,2,967,1485,-10
97594822529,97594822533,4,1549,1608,-10
97595165743,97595165746,3,1386,729,-10
97596669851,97596669854,3,1464,1189,-10
97601540263,97601540266,3,1019,1211,-10
97602166805,97602166806,1,1487,2025,-10
97602740545,97602740546,1,1247,1063,-10
97603717885,97603717889,4,1640,1160,-10
97604345337,97604345338,1,1165,1536,-10
97604698050,97604698053,3,2081,1604,-10
97605159845,97605159847,2,1485,1629,-10
97606958670,97606958674,4,2067,1392,-10
97610709897,97610709903,6,3169,1352,-10
97610987402,97610987402,0,1580,1829,-10
97612972055,97612972061,6,3039,2238,-10
97613603994,97613603992,-2,1453,1806,-10
97616390214,97616390217,3,1135,1713,-10
97617025371,97617025374,3,1454,1592,-10
97618970190,97618970192,2,1724,1586,-10
97620377337,97620377338,1,1595,1906,-10
97621022799,97621022802,3,1536,1172,-10
97623215016,97623215020,4,1958,1485,-10
97623835046,97623835047,1,1130,1470,-10
97624785131,97624785131,0,1031,846,-10
97625686106,97625686109,3,1567,1726,-10
97628377506,97628377509,3,22180,18710,-10
97630585175,97630585155,-20,2150,2230,-10
97631314899,97631314905,6,3382,1659,-10
97637687863,97637687866,3,1304,1045,-10
97637960068,97637960070,2,1487,1314,-10
97639718749,97639718751,2,1485,1864,-10
97651830215,97651830219,4,1627,1100,-10
97658105287,97658105289,2,1184,1540,-10
97659775906,97659775908,2,1588,1695,-10
97661088639,97661088641,2,2456,1326,-10
97666080257,97666080261,4,903,1162,-10
97666923006,97666923007,1,812,1381,-10
97667281645,97667281647,2,1422,1234,-10
97669041313,97669041313,0,1028,1479,-10
97669624135,97669624138,3,1277,1447,-10
97669750142,97669750143,1,1920,1360,-10
97672766718,97672766718,0,1588,1306,-10
97676177866,97676177866,0,1820,1838,-10
97678144549,97678144550,1,1486,1452,-10
97679521906,97679521906,0,740,1062,-10
97679834635,97679834637,2,2110,1935,-10
97680436750,97680436751,1,2173,2479,-10
97683559534,97683559535,1,1372,1469,-10
97683733515,97683733514,-1,1304,1908,-10
97684799887,97684799889,2,1882,1483,-10
97685167965,97685167966,1,1586,1566,-10
97690354229,97690354229,0,1283,1683,-10
97695341371,97695341373,2,1026,1000,-10
97697879420,97697879423,3,1101,1146,-10
97698490419,97698490420,1,1572,1611,-10
97700586894,97700586894,0,741,932,-10
97701397793,97701397793,0,1181,1483,-10
97701707033,97701707031,-2,963,759,-10
97702405738,97702405738,0,1294,1232,-10
97703295951,97703295954,3,1551,1207,-10
97706307665,97706307665,0,1544,1329,-10
97710674297,97710674298,1,1557,1628,-10
97712527745,97712527746,1,1585,1212,-10
97713331707,97713331710,3,902,603,-10
97714872727,97714872729,2,1419,1509,-10
97716907121,97716907125,4,1552,1077,-10
97718376554,97718376554,0,1324,1082,-10
97719396659,97719396662,3,1516,1504,-10
97719645832,97719645833,1,1362,1734,-10
97720652044,97720652039,-5,1803,3340,-10
97722641583,97722641583,0,1751,1391,-10
97724516644,97724516645,1,1502,1371,-10
97725071907,97725071909,2,1494,1425,-10
97727762470,97727762471,1,1604,1352,-10
97728238069,97728238070,1,1489,2016,-10
97732870765,97732870764,-1,1175,1935,-10
97734366462,97734366463,1,2623,1769,-10
97735917922,97735917914,-8,1353,1424,-10
97736250315,97736250314,-1,1658,1542,-10
97739576156,97739576158,2,1485,1565,-10
97740002676,97740002678,2,1958,1579,-10
97742525738,97742525732,-6,1192,3841,-10
97743071996,97743071984,-12,2248,363,-10
97744391379,97744391385,6,1557,1245,-10
97745127191,97745127191,0,1613,2134,-10
97746674589,97746674589,0,1941,1883,-10
97749542208,97749542210,2,1484,1206,-10
97750070994,97750071002,8,2211,1668,-10
97750881964,97750881967,3,1089,1325,-10
97751370214,97751370219,5,1891,1153,-10
97759644746,97759644746,0,1795,1589,-10
97760304755,97760304758,3,1850,1732,-10
97765124881,97765124883,2,1278,1517,-10
97766471652,97766471659,7,2387,42759,-10
97769906425,97769906428,3,2687,1283,-10
97772607996,97772607998,2,2121,1687,-10
97773127593,97773127594,1,1590,1364,-10
97780167975,97780167980,5,1724,1445,-10
97780395620,97780395625,5,843,1219,-10
97783294626,97783294629,3,1347,1748,-10
97788535726,97788535728,2,1235,1713,-10
97789335841,97789335842,1,1667,1860,-10
97790281075,97790281074,-1,1330,1817,-10
97790826838,97790826841,3,1319,1456,-10
97791963608,97791963610,2,1006,1181,-10
97792173482,97792173488,6,1254,1408,-10
97792903993,97792903994,1,766,1080,-10
97795859938,97795859942,4,1051,1538,-10
97795893623,97795893623,0,2021,1584,-10
97803849684,97803849685,1,1531,1255,-10
97808393715,97808393719,4,1265,923,-10
97808718659,97808718661,2,1657,1435,-10
97809585796,97809585796,0,1092,1271,-10
97811488203,97811488205,2,1557,1457,-10
97816835525,97816835529,4,1958,1451,-10
97817289470,97817289473,3,1897,1588,-10
97818983754,97818983757,3,1676,1361,-10
97819361949,97819361949,0,1398,1418,-10
97820698597,97820698600,3,1952,1490,-10
97823264941,97823264945,4,1915,1507,-10
97827567909,97827567918,9,14606,35885,-10
97833979016,97833979018,2,4011,3501,-10
97835437927,97835437922,-5,1208,2709,-10
97841207607,97841207610,3,1097,787,-10
97842070939,97842070946,7,2866,1834,-10
97842414922,97842414921,-1,1874,2579,-10
97843833493,97843833493,0,1939,1730,-10
97845143795,97845143798,3,2097,1578,-10
97846620607,97846620610,3,2265,1446,-10
97849542336,97849542339,3,925,1718,-10
97851056491,97851056495,4,1149,1250,-10
97851717850,97851717855,5,1993,1091,-10
97851938439,97851938441,2,1582,2103,-10
97853004902,97853004906,4,1455,2118,-10
97853234826,97853234826,0,1215,1859,-10
97853695408,97853695406,-2,1116,1583,-10
97853990090,97853990090,0,1465,1126,-10
97854623313,97854623313,0,1282,1554,-10
97855270896,97855270898,2,1153,1391,-10
97856485835,97856485837,2,1572,1656,-10
97857673257,97857673258,1,2102,2668,-10
97859767746,97859767745,-1,1824,1740,-10
97868394906,97868394908,2,1387,1988,-10
97868828618,97868828621,3,1407,1603,-10
97869095230,97869095233,3,1177,1104,-10
97872201440,97872201442,2,2305,1889,-10
97872228672,97872228674,2,1696,1858,-10
97873496860,97873496853,-7,1754,9092,-10
97875803683,97875803685,2,1145,1311,-10
97876193137,97876193142,5,2301,924,-10
97876255357,97876255371,14,1432,1229,-10
97879722093,97879722096,3,1502,1597,-10
97883646049,97883646051,2,1774,1576,-10
97888071124,97888071126,2,1264,1307,-10
97888490365,97888490366,1,838,1266,-10
97895887566,97895887569,3,3450,3140,-10
97899065102,97899065106,4,1629,1179,-10
97899105225,97899105226,1,1274,1531,-10
97902165154,97902165153,-1,925,2336,-10
97909343224,97909343223,-1,1450,1075,-10
97914911323,97914911325,2,1214,932,-10
97915969834,97915969835,1,1251,1461,-10
97918548874,97918548876,2,1884,2256,-10
97920231716,97920231718,2,1597,1189,-10
97926948071,97926948074,3,2030,1977,-10
97927063469,97927063472,3,1554,1139,-10
97930261711,97930261711,0,1188,1148,-10
97932960066,97932960068,2,1567,1443,-10
97937627842,97937627842,0,1398,1700,-10
97947978119,97947978117,-2,1609,1807,-10
97950759642,97950759646,4,1287,1736,-10
97952433214,97952433217,3,1907,2069,-10
97956143796,97956143797,1,1542,1186,-10
97963012796,97963012797,1,2131,1539,-10
97963248245,97963248248,3,1902,1469,-10
97965742237,97965742238,1,1837,1604,-10
97967227254,97967227257,3,1857,1842,-10
97967643593,97967643595,2,1054,1196,-10
97970364561,97970364562,1,1980,1869,-10
97973232685,97973232689,4,1181,1791,-10
97974500962,97974500962,0,1818,1372,-10
97974747209,97974747211,2,1654,814,-10
97975007626,97975007633,7,1284,1905,-10
97975844598,97975844602,4,1973,1226,-10
97978382955,97978382958,3,1931,1389,-10
97986898521,97986898523,2,2523,1577,-10
97987201109,97987201089,-20,1436,1586,-10
97987517463,97987517463,0,1618,1306,-10
97988915365,97988915368,3,1586,1418,-10
97992925352,97992925358,6,2688,1595,-10
97993478640,97993478641,1,1751,1824,-10
97995172794,97995172799,5,1961,1767,-10
97996980419,97996980418,-1,1165,1405,-10
97999095546,97999095548,2,1548,1425,-10
98002040566,98002040567,1,1253,2178,-10
98003767269,98003767270,1,1591,1528,-10
98004235665,98004235663,-2,1208,1703,-10
98006264170,98006264165,-5,898,2930,-10
98014037406,98014037407,1,1840,2152,-10
98015203859,98015203862,3,1498,1207,-10
98015321003,98015321007,4,1481,1623,-10
98015987448,98015987450,2,1350,1940,-10
98017025132,98017025134,2,1554,1351,-10
98025920782,98025920784,2,1318,1804,-10
98027938249,98027938257,8,5260,1582,-10
98028746456,98028746458,2,1591,1106,-10
98030784264,98030784266,2,2194,1384,-10
98031925393,98031925395,2,1619,1286,-10
98032651114,98032651116,2,1823,1506,-10
98034504006,98034504008,2,1723,1405,-10
98036008022,98036008008,-14,1864,1624,-10
98038344949,98038344954,5,2351,1414,-10
98041444852,98041444852,0,1851,1966,-10
98046326330,98046326331,1,1221,1478,-10
98049132763,98049132762,-1,2773,3952,-10
98054445397,98054445399,2,1650,1271,-10
98055247649,98055247641,-8,1371,330,-10
98056753697,98056753698,1,2325,1911,-10
98060365058,98060365062,4,2275,1038,-10
98060935739,98060935742,3,1469,1277,-10
98062925969,98062925969,0,2381,1709,-10
98065085705,98065085710,5,22040,22376,-10
98066421162,98066421165,3,1704,1585,-10
98066687565,98066687586,21,1359,1379,-10
98068390787,98068390789,2,1740,1467,-10
98070194100,98070194095,-5,12252,18981,-10
98070221496,98070221498,2,1619,1254,-10
98070927077,98070927078,1,1736,1714,-10
98075234187,98075234189,2,2435,1819,-10
98076221058,98076221060,2,1914,1592,-10
98077678131,98077678134,3,1823,1506,-10
98082120041,98082120043,2,1593,1976,-10
98083023851,98083023847,-4,889,1013,-10
98086255987,98086255987,0,1788,1589,-10
98090397154,98090397153,-1,1509,1563,-10
98092248609,98092248613,4,1605,1921,-10
98096049543,98096049520,-23,2240,1470,-10
98096215074,98096215070,-4,1883,5770,-10
98098350625,98098350618,-7,1616,3418,-10
98099238754,98099238755,1,753,580,-10
98106390258,98106390262,4,1767,1851,-10
98107124662,98107124663,1,1999,2164,-10
98108776098,98108776099,1,1551,1629,-10
98109091930,98109091929,-1,1569,2058,-10
98113895172,98113895174,2,1609,1495,-10
98114535131,98114535110,-21,85,3555,-10
98119325591,98119325594,3,1509,1301,-10
98125183830,98125183838,8,3193,1532,-10
98125468663,98125468666,3,1172,1257,-10
98126286878,98126286878,0,1552,1475,-10
98128255596,98128255597,1,1557,1194,-10
98128852667,98128852667,0,819,1074,-10
98129394088,98129394090,2,1072,1485,-10
98134239859,98134239859,0,1686,1446,-10
98137459240,98137459247,7,9501,27786,-10
98137886281,98137886283,2,2272,1946,-10
98138238786,98138238788,2,1406,1257,-10
98143096779,98143096782,3,1107,1585,-10
98148545926,98148545929,3,1935,1443,-10
98149920418,98149920420,2,1455,1604,-10
98151178865,98151178869,4,1836,1748,-10
98153810881,98153810882,1,1105,1047,-10
98154273541,98154273542,1,1326,1637,-10
98154718762,98154718762,0,1826,1584,-10
98157523440,98157523441,1,1015,1821,-10
98158407905,98158407907,2,1729,2011,-10
98159978993,98159978995,2,1787,1247,-10
98161673383,98161673384,1,1401,2631,-10
98163339413,98163339414,1,1863,1842,-10
98163639664,98163639666,2,2001,1983,-10
98163712629,98163712626,-3,1355,1659,-10
98167718821,98167718822,1,1583,1635,-10
98168458557,98168458561,4,1725,1483,-10
98169590009,98169590011,2,986,1553,-10
98171525549,98171525551,2,1057,1195,-10
98171561138,98171561150,12,12802,27526,-10
98173822841,98173822842,1,1487,1450,-10
98177558049,98177558052,3,1799,1586,-10
98180440699,98180440701,2,1744,1771,-10
98184094891,98184094893,2,1638,1463,-10
98185820396,98185820399,3,1375,1810,-10
98187855582,98187855587,5,1066,719,-10
98188658093,98188658093,0,1260,1731,-10
98189972399,98189972406,7,3152,1642,-10
98196362000,98196361980,-20,1294,1454,-10
98200888337,98200888337,0,1525,1708,-10
98203761888,98203761894,6,6002,1960,-10
98209393334,98209393333,-1,1266,1780,-10
98210646143,98210646143,0,1839,1587,-10
98211113822,98211113825,3,1513,1898,-10
98215055738,98215055741,3,2105,2122,-10
98218255750,98218255750,0,1258,1600,-10
98218667802,98218667802,0,1924,1514,-10
98219616226,98219616230,4,1217,1013,-10
98221362024,98221362026,2,1856,1889,-10
98224337075,98224337078,3,2315,2005,-10
98225321815,98225321833,18,1122,3218,-10
98225464063,98225464065,2,1667,1428,-10
98227672179,98227672179,0,2133,1905,-10
98227853361,98227853360,-1,1407,1601,-10
98230235968,98230235987,19,1501,1361,-10
98230505974,98230505977,3,1417,1271,-10
98231366337,98231366338,1,1148,1338,-10
98232050753,98232050754,1,1552,1360,-10
98235383758,98235383762,4,2275,1456,-10
98235773863,98235773867,4,1658,1381,-10
98237362507,98237362509,2,1181,1568,-10
98238759120,98238759123,3,1847,1460,-10
98239525607,98239525609,2,1822,1526,-10
98240143595,98240143597,2,1614,1580,-10
98241089649,98241089650,1,1761,1473,-10
98241386581,98241386578,-3,974,1844,-10
98244589106,98244589106,0,1781,1809,-10
98245818315,98245818319,4,1215,1327,-10
98248397470,98248397472,2,1488,1853,-10
98248644970,98248644984,14,1266,1482,-10
98251268470,98251268474,4,1780,1949,-10
98253739370,98253739371,1,1363,1531,-10
98254469827,98254469829,2,1638,1313,-10
98255504753,98255504755,2,1312,1434,-10
98257479265,98257479266,1,1536,1311,-10
98257771919,98257771916,-3,1006,2497,-10
98260141813,98260141821,8,3317,1699,-10
98261438564,98261438566,2,1890,1587,-10
98263182074,98263182073,-1,1461,1368,-10
98263703686,98263703686,0,1409,1717,-10
98264060192,98264060196,4,1584,1488,-10
98268094934,98268094937,3,1365,1813,-10
98268890925,98268890926,1,1273,1445,-10
98269524053,98269524055,2,1680,1703,-10
98272257199,98272257202,3,1111,1714,-10
98274304909,98274304909,0,1361,1659,-10
98274518449,98274518445,-4,1266,1874,-10
98275463763,98275463767,4,1886,947,-10
98278113439,98278113442,3,1443,1481,-10
98281234862,98281234863,1,2738,2093,-10
98281544346,98281544345,-1,850,1112,-10
98281580102,98281580080,-22,776,735,-10
98283028609,98283028610,1,1902,1500,-10
98286140319,98286140319,0,1853,1769,-10
98287453223,98287453224,1,1881,1856,-10
98287534805,98287534806,1,1435,1330,-10
98287943671,98287943670,-1,1753,1925,-10
98288469471,98288469473,2,1726,1877,-10
98289256474,98289256475,1,1436,1043,-10
98290751371,98290751370,-1,1523,2131,-10
98291944478,98291944480,2,2072,1288,-10
98299501123,98299501126,3,1185,1204,-10
98300419826,98300419827,1,1475,1185,-10
98301422665,98301422671,6,7777,2949,-10
98301610213,98301610216,3,1210,1435,-10
98302600263,98302600258,-5,1204,3938,-10
98305569751,98305569754,3,1628,1731,-10
98306207125,98306207126,1,1740,936,-10
98307856889,98307856890,1,1492,1787,-10
98308150067,98308150070,3,1433,1478,-10
98309376911,98309376911,0,1002,1486,-10
98309557155,98309557157,2,1638,1661,-10
98310030233,98310030236,3,1531,1617,-10
98310982209,98310982210,1,1701,1986,-10
98315997895,98315997895,0,1734,1838,-10
98318707978,98318707985,7,2789,1831,-10
98320730120,98320730121,1,2479,2035,-10
98320940461,98320940463,2,1289,1192,-10
98324969106,98324969100,-6,1384,1530,-10
98325559086,98325559087,1,1099,1033,-10
98325839169,98325839171,2,1941,1369,-10
98326251998,98326251998,0,1230,1821,-10
98327475475,98327475475,0,2209,2273,-10
98331982181,98331982182,1,1042,1884,-10
98333268541,98333268542,1,1089,1203,-10
98342217378,98342217380,2,693,796,-10
98342291336,98342291338,2,1001,1610,-10
98342997076,98342997078,2,1628,1783,-10
98352619010,98352619011,1,1460,1480,-10
98353876388,98353876389,1,1822,1028,-10
98359228255,98359228256,1,1351,2230,-10
98360161802,98360161804,2,1302,1372,-10
98360643635,98360643636,1,1344,1714,-10
98361067846,98361067851,5,1545,1194,-10
98361154265,98361154272,7,1595,1513,-10
98367669998,98367669999,1,1881,1276,-10
98370259621,98370259625,4,1648,1518,-10
98370818478,98370818481,3,1960,2386,-10
98373503166,98373503171,5,1717,1314,-10
98374251092,98374251098,6,2917,1468,-10
98374985385,98374985381,-4,726,2307,-10
98376301870,98376301871,1,1577,1575,-10
98380483559,98380483563,4,1745,1475,-10
98381167330,98381167331,1,1631,1334,-10
98381924961,98381924962,1,1097,1309,-10
98384555569,98384555569,0,1450,1832,-10
98387707249,98387707250,1,1661,1782,-10
98389248466,98389248468,2,1332,1204,-10
98389339314,98389339306,-8,678,2130,-10
98391443274,98391443274,0,1178,2582,-10
98392483291,98392483294,3,1983,1561,-10
98397486729,98397486730,1,1328,1559,-10
98401633734,98401633738,4,1267,845,-10
98405589726,98405589728,2,1921,1762,-10
98407984715,98407984715,0,2105,1579,-10
98408473519,98408473521,2,1293,1920,-10
98410627258,98410627258,0,1343,1332,-10
98410673072,98410673070,-2,62,1486,-10
98410729214,98410729214,0,2078,1883,-10
98411067778,98411067780,2,1373,1182,-10
98411421433,98411421437,4,4087,2013,-10
98413966007,98413966009,2,1363,1957,-10
98415313386,98415313390,4,1171,1235,-10
98418417673,98418417676,3,1295,1435,-10
98420336410,98420336409,-1,1348,2236,-10
98420950496,98420950481,-15,1057,1610,-10
98421114500,98421114502,2,1667,1938,-10
98421178457,98421178446,-11,1227,1075,-10
98421532762,98421532761,-1,1179,1255,-10
98424716438,98424716441,3,1657,1293,-10
98430802312,98430802314,2,1933,1391,-10
98431115058,98431115059,1,1805,1379,-10
98431400974,98431400977,3,1225,1407,-10
98433793637,98433793638,1,1978,1243,-10
98433885237,98433885240,3,1700,1461,-10
98437084246,98437084250,4,1116,1087,-10
98443299598,98443299617,19,498,168,-10
98445971402,98445971403,1,1871,1454,-10
98446628253,98446628255,2,1906,1412,-10
98450816309,98450816311,2,1539,1906,-10
98452641199,98452641184,-15,607,196,-10
98453281450,98453281455,5,1275,1367,-10
98453791288,98453791284,-4,1084,2474,-10
98455420398,98455420399,1,1968,1635,-10
98458108133,98458108137,4,1745,885,-10
98458998007,98458997987,-20,1231,1277,-10
98460571324,98460571347,23,1489,1757,-10
98461017439,98461017436,-3,1121,2337,-10
98462527586,98462527589,3,1327,1178,-10
98464205558,98464205560,2,2050,2177,-10
98464385083,98464385083,0,1239,1434,-10
98465311947,98465311955,8,16028,9192,-10
98467245422,98467245422,0,1681,2290,-10
98468443670,98468443670,0,1380,1394,-10
98469257521,98469257524,3,1449,1596,-10
98471848053,98471848057,4,1924,1873,-10
98475625582,98475625585,3,1864,1236,-10
98477004151,98477004153,2,1131,1717,-10
98477948915,98477948916,1,1726,1846,-10
98478570047,98478570049,2,1366,1694,-10
98479756733,98479756738,5,1542,1375,-10
98482158547,98482158548,1,1422,1698,-10
98483322146,98483322147,1,1246,1247,-10
98485574433,98485574434,1,1954,1838,-10
98485926740,98485926742,2,2144,1734,-10
98489168890,98489168891,1,1522,1345,-10
98489752638,98489752641,3,1386,1366,-10
98491358280,98491358282,2,1352,1080,-10
98491972723,98491972725,2,1400,2876,-10
98492864358,98492864361,3,1127,1556,-10
98493828077,98493828078,1,1845,1410,-10
98498738942,98498738945,3,2085,1493,-10
98500797646,98500797646,0,1176,1520,-10
98501966846,98501966846,0,1902,1742,-10
98502449641,98502449642,1,951,1136,-10
98502617618,98502617619,1,1115,1089,-10
98503107213,98503107215,2,1442,1487,-10
98503298982,98503298985,3,1386,1428,-10
98507719418,98507719413,-5,1553,5037,-10
98510022621,98510022621,0,1744,1420,-10
98512206743,98512206746,3,1360,1564,-10
98512880532,98512880526,-6,2289,6567,-10
98514152625,98514152626,1,1580,1643,-10
98514874729,98514874730,1,1661,1311,-10
98515140461,98515140463,2,1285,1285,-10
98519324776,98519324778,2,1423,1791,-10
98520079107,98520079106,-1,1382,2087,-10
98520590017,98520590017,0,978,1792,-10
98521625650,98521625651,1,1706,1663,-10
98521979472,98521979473,1,1713,1504,-10
98526232260,98526232262,2,1735,1100,-10
98526719418,98526719433,15,1756,1222,-10
98527334142,98527334145,3,1747,1244,-10
98527900629,98527900630,1,1838,1488,-10
98528452954,98528452959,5,3314,2308,-10
98532088081,98532088083,2,783,1337,-10
98532861651,98532861652,1,2742,1773,-10
98538965014,98538965017,3,1615,1201,-10
98541477324,98541477325,1,1643,1453,-10
98544372933,98544372934,1,1537,1287,-10
98544758107,98544758108,1,1800,1476,-10
98552118823,98552118825,2,988,909,-10
98553478170,98553478170,0,1018,2011,-10
98554625375,98554625375,0,1301,953,-10
98555849386,98555849387,1,2131,1222,-10
98556141536,98556141518,-18,1801,1726,-10
98557762314,98557762314,0,1984,1352,-10
98558640199,98558640201,2,1744,1630,-10
98559825914,98559825916,2,1790,1434,-10
98564075755,98564075757,2,2173,1758,-10
98566236352,98566236358,6,2237,837,-10
98567465441,98567465447,6,2461,958,-10
98567837586,98567837587,1,1122,1098,-10
98568881626,98568881629,3,1768,1372,-10
98578996748,98578996749,1,1611,1424,-10
98580971901,98580971886,-15,1039,938,-10
98583355754,98583355757,3,1444,1510,-10
98585199429,98585199431,2,1673,1310,-10
98586068314,98586068316,2,1317,2057,-10
98589232130,98589232131,1,1281,1551,-10
98590982305,98590982326,21,882,1330,-10
98591638186,98591638191,5,2366,1052,-10
98591989806,98591989810,4,1184,1401,-10
98600422359,98600422362,3,2354,1227,-10
98600905470,98600905471,1,1590,1882,-10
98601318186,98601318190,4,1868,1557,-10
98601931826,98601931827,1,1836,1204,-10
98602359389,98602359388,-1,1828,2178,-10
98603094806,98603094807,1,1582,1794,-10
98604466708,98604466710,2,1877,1743,-10
98604555790,98604555791,1,1274,1020,-10
98607382322,98607382333,11,1127,1265,-10
98610221660,98610221660,0,1445,1650,-10
98610631832,98610631834,2,1996,1961,-10
98613861429,98613861434,5,2643,1290,-10
98615160339,98615160338,-1,1555,1471,-10
98617046374,98617046376,2,1945,1798,-10
98617836494,98617836495,1,1556,1812,-10
98619013627,98619013629,2,1834,1672,-10
98619742531,98619742531,0,1301,1816,-10
98621150242,98621150242,0,2047,1858,-10
98621934750,98621934752,2,1264,1063,-10
98626869692,98626869694,2,2240,2275,-10
98627118261,98627118262,1,1434,1529,-10
98627520904,98627520894,-10,1172,1333,-10
98632348026,98632348031,5,1975,1288,-10
98632484747,98632484750,3,1549,1298,-10
98634307694,98634307697,3,1199,1396,-10
98634738089,98634738090,1,1407,1745,-10
98636569789,98636569793,4,1368,1115,-10
98637377800,98637377802,2,1874,1399,-10
98647264778,98647264780,2,1335,1471,-10
98652787193,98652787194,1,2318,1813,-10
98655390298,98655390302,4,1058,1321,-10
98655480273,98655480275,2,1945,2169,-10
98658018321,98658018322,1,1154,2450,-10
98660764233,98660764234,1,986,1398,-10
98660826846,98660826848,2,1845,1797,-10
98661345857,98661345862,5,1863,1286,-10
98669946322,98669946326,4,1464,1082,-10
98670874258,98670874260,2,1836,1422,-10
98673447311,98673447311,0,1303,1704,-10
98678241120,98678241123,3,1717,1667,-10
98679895025,98679895026,1,1734,1484,-10
98681469899,98681469895,-4,1762,2716,-10
98681526305,98681526307,2,1203,858,-10
98681786149,98681786150,1,2192,1544,-10
98682285649,98682285657,8,1213,1500,-10
98685003997,98685003997,0,1938,1539,-10
98691422417,98691422424,7,1999,1185,-10
98692965110,98692965114,4,1770,1322,-10
98696259818,98696259821,3,1956,1574,-10
98697207156,98697207156,0,1703,2117,-10
98705187762,98705187762,0,2261,2111,-10
98710807592,98710807610,18,1199,1250,-10
98714035103,98714035103,0,1212,1221,-10
98714358173,98714358175,2,1384,1288,-10
98715824485,98715824492,7,2418,1088,-10
98718343790,98718343793,3,2409,1227,-10
98722581930,98722581933,3,1207,1415,-10
98728872945,98728872947,2,1720,1523,-10
98731677510,98731677511,1,1234,1659,-10
98733836469,98733836471,2,1796,1286,-10
98734005959,98734005960,1,1719,1616,-10
98734738651,98734738655,4,1507,903,-10
98735721740,98735721743,3,1690,1837,-10
98740350213,98740350214,1,947,672,-10
98744753265,98744753269,4,1650,1258,-10
98747699042,98747699042,0,1325,1522,-10
98749022823,98749022824,1,1350,1286,-10
98749598087,98749598087,0,1164,1801,-10
98750706320,98750706322,2,1179,1591,-10
98754507569,98754507570,1,1953,1694,-10
98756007867,98756007870,3,1966,1369,-10
98757927034,98757927037,3,1299,1354,-10
98760318938,98760318941,3,1409,898,-10
98761356185,98761356182,-3,1607,3503,-10
98771922461,98771922463,2,1306,1449,-10
98773789958,98773789956,-2,1429,2563,-10
98778629865,98778629867,2,1125,1717,-10
98779962337,98779962339,2,1665,1586,-10
98783779419,98783779418,-1,1408,1107,-10
98783963443,98783963446,3,1486,1786,-10
98784393807,98784393810,3,1028,1101,-10
98784845385,98784845386,1,1261,1467,-10
98788449160,98788449164,4,3134,1675,-10
98788607466,98788607466,0,1968,1241,-10
98790679193,98790679199,6,2570,1276,-10
98796926990,98796926991,1,1908,1356,-10
98797306363,98797306363,0,1959,1927,-10
98798176574,98798176577,3,1440,2015,-10
98798433038,98798433034,-4,1038,2339,-10
98800536298,98800536301,3,1509,1100,-10
98801241461,98801241462,1,1444,1243,-10
98813075071,98813075074,3,1682,1525,-10
98814950446,98814950450,4,1772,1759,-10
98815009542,98815009560,18,1569,1120,-10
98815457137,98815457138,1,2110,1912,-10
98818379249,98818379250,1,1392,1557,-10
98820370767,98820370769,2,1891,1587,-10
98822817225,98822817222,-3,1233,2618,-10
98824785878,98824785878,0,1066,1146,-10
98825170685,98825170667,-18,1606,1303,-10
98825574841,98825574845,4,1913,1849,-10
98826140581,98826140583,2,1457,1620,-10
98828644866,98828644870,4,1558,1627,-10
98829451576,98829451570,-6,29397,14427,-10
98829671322,98829671325,3,1559,1545,-10
98836211301,98836211301,0,1697,1676,-10
98839700303,98839700307,4,1281,943,-10
98839876355,98839876356,1,1361,2017,-10
98841297926,98841297929,3,1128,1364,-10
98844438836,98844438842,6,4674,1598,-10
98847846164,98847846167,3,1785,1637,-10
98851588137,98851588133,-4,25128,14880,-10
98852657518,98852657518,0,1594,2208,-10
98853057595,98853057589,-6,1246,3494,-10
98856513994,98856513994,0,1496,1466,-10
98858908422,98858908419,-3,1766,2888,-10
98862944702,98862944708,6,5376,2235,-10
98864542625,98864542625,0,1647,1995,-10
98864843977,98864843978,1,2132,1459,-10
98865069946,98865069947,1,1429,1174,-10
98865836263,98865836258,-5,703,3489,-10
98872953294,98872953297,3,1338,1177,-10
98874993754,98874993750,-4,1192,1721,-10
98878287913,98878287910,-3,1511,1945,-10
98880483975,98880483979,4,1694,1410,-10
98881710013,98881710015,2,1302,1052,-10
98884433981,98884433982,1,763,1110,-10
98887445150,98887445147,-3,470,1153,-10
98888573502,98888573503,1,1365,1243,-10
98888981666,98888981669,3,1427,1356,-10
98889809545,98889809547,2,1878,1994,-10
98890780522,98890780527,5,1450,1606,-10
98899311789,98899311790,1,1322,915,-10
98900017717,98900017718,1,1399,1448,-10
98901299831,98901299838,7,3462,1468,-10
98902306147,98902306149,2,1552,1743,-10
98903163576,98903163580,4,1234,1531,-10
98904636118,98904636117,-1,1525,1620,-10
98906327430,98906327432,2,1389,1166,-10
98908860159,98908860161,2,1344,1563,-10
98912081374,98912081374,0,1444,1646,-10
98912634702,98912634705,3,1358,1459,-10
98914604806,98914604808,2,1293,1743,-10
98917578748,98917578750,2,1198,1247,-10
98918341936,98918341938,2,1759,1447,-10
98920374191,98920374193,2,1787,1812,-10
98920820366,98920820361,-5,834,2755,-10
98921141394,98921141393,-1,1155,2181,-10
98924769060,98924769058,-2,2032,1397,-10
98925225635,98925225629,-6,1040,2859,-10
98926351222,98926351225,3,1305,1390,-10
98927232891,98927232894,3,1117,1242,-10
98928661298,98928661300,2,1313,1436,-10
98929641970,98929641974,4,1464,1479,-10
98929827770,98929827771,1,1671,1578,-10
98930657697,98930657700,3,2256,1652,-10
98932814546,98932814544,-2,1367,1732,-10
98933005663,98933005665,2,1337,1763,-10
98934210426,98934210426,0,1676,847,-10
98937817583,98937817586,3,2413,2250,-10
98938424111,98938424114,3,1382,1396,-10
98939731282,98939731284,2,1346,1591,-10
98940159270,98940159270,0,1866,1853,-10
98943920598,98943920600,2,2154,1469,-10
98944099057,98944099058,1,1458,1767,-10
98947421346,98947421349,3,2017,1244,-10
98953128723,98953128723,0,1082,2100,-10
98954018591,98954018594,3,1564,1926,-10
98955138454,98955138457,3,2488,1933,-10
98955801733,98955801736,3,1827,1845,-10
98962557006,98962557009,3,1241,1005,-10
98964317871,98964317872,1,1190,1648,-10
98964999457,98964999460,3,1400,1802,-10
98967370331,98967370333,2,1595,1545,-10
98969899911,98969899917,6,955,1459,-10
98972564383,98972564386,3,1006,1359,-10
98972952512,98972952513,1,1828,1425,-10
98977897487,98977897489,2,1288,1758,-10
98979118406,98979118407,1,1429,1122,-10
98980702522,98980702523,1,1409,1498,-10
98981428225,98981428229,4,923,996,-10
98983185517,98983185518,1,1261,1384,-10
98990397678,98990397679,1,1424,1803,-10
98996777849,98996777831,-18,942,1298,-10
98997319046,98997319047,1,932,1209,-10
99000107354,99000107357,3,1777,2070,-10
99001039864,99001039865,1,2482,1972,-10
99002050361,99002050364,3,1995,1531,-10
99004406639,99004406640,1,1750,1492,-10
99004904121,99004904132,11,1678,1270,-10
99010572969,99010572974,5,1422,876,-10
99011282663,99011282666,3,2110,1690,-10
99011574097,99011574099,2,1682,2014,-10
99012365240,99012365242,2,1088,1276,-10
99012627930,99012627935,5,1168,1155,-10
99015606519,99015606521,2,1841,1460,-10
99017090408,99017090409,1,1184,1286,-10
99020321629,99020321630,1,2065,2538,-10
99021052642,99021052643,1,2387,1957,-10
99021991347,99021991350,3,920,1299,-10
99025090911,99025090913,2,1308,1898,-10
99029460218,99029460225,7,5897,2035,-10
99030231963,99030231967,4,1125,1527,-10
99032463154,99032463153,-1,1294,1416,-10
99033521104,99033521106,2,2119,1699,-10
99033548319,99033548322,3,1150,1081,-10
99035127247,99035127251,4,1246,1249,-10
99039813603,99039813605,2,1644,1765,-10
99039932568,99039932569,1,1508,1650,-10
99042163537,99042163539,2,1670,1536,-10
99043445263,99043445266,3,1472,1459,-10
99044968098,99044968098,0,967,1205,-10
99045168051,99045168051,0,1743,1312,-10
99046468149,99046468150,1,1705,1551,-10
99050602197,99050602199,2,908,1000,-10
99055774753,99055774746,-7,1369,4319,-10
99056240138,99056240137,-1,1557,1040,-10
99056941063,99056941066,3,1079,1429,-10
99059348138,99059348138,0,1520,1466,-10
99059604890,99059604892,2,1231,1369,-10
99060386695,99060386694,-1,1017,1189,-10
99065432421,99065432423,2,1347,1141,-10
99066311465,99066311467,2,1268,1224,-10
99067058917,99067058919,2,1061,1131,-10
99070164196,99070164177,-19,1135,1545,-10
99073346107,99073346106,-1,1291,2246,-10
99074144105,99074144106,1,1058,1055,-10
99075764558,99075764558,0,1296,1575,-10
99082936463,99082936466,3,1602,1513,-10
99083849699,99083849703,4,1841,1380,-10
99085712430,99085712431,1,2177,1548,-10
99086051363,99086051365,2,1820,1967,-10
99091386350,99091386352,2,2042,2504,-10
99091531205,99091531209,4,816,1080,-10
99092967955,99092967959,4,1066,1730,-10
99093941466,99093941468,2,1332,2123,-10
99103361374,99103361373,-1,1143,1912,-10
99104082113,99104082114,1,2007,1525,-10
99111428059,99111428061,2,1778,1611,-10
99113874038,99113874039,1,1760,1303,-10
99115385675,99115385679,4,1789,1636,-10
99115432312,99115432314,2,1518,1876,-10
99121211742,99121211743,1,1747,1673,-10
99123351682,99123351683,1,1365,1645,-10
99123667959,99123667961,2,1720,1356,-10
99124906933,99124906934,1,1865,1573,-10
99125115005,99125115006,1,1030,1370,-10
99127112066,99127112065,-1,1358,1315,-10
99129304574,99129304573,-1,1331,1970,-10
99130396094,99130396098,4,1646,1717,-10
99131014596,99131014603,7,1384,1522,-10
99132535861,99132535862,1,1804,1749,-10
99135556015,99135556018,3,1275,1979,-10
99135734970,99135734986,16,1319,1507,-10
99141203154,99141203155,1,1179,933,-10
99146559326,99146559329,3,1981,2326,-10
99147355939,99147355922,-17,1082,1458,-10
99149253290,99149253294,4,1860,937,-10
99151560870,99151560869,-1,1618,3024,-10
99153504675,99153504677,2,1427,1494,-10
99155224812,99155224815,3,907,785,-10
99155809763,99155809766,3,1280,2161,-10
99155933242,99155933243,1,1609,2028,-10
99157635725,99157635727,2,1572,1124,-10
99159184852,99159184850,-2,1291,2250,-10
99159799371,99159799374,3,1316,1417,-10
99160542027,99160542029,2,1464,1338,-10
99167268744,99167268745,1,1870,1856,-10
99168538737,99168538738,1,1478,1565,-10
99169470867,99169470870,3,1314,1534,-10
99171058311,99171058313,2,969,2004,-10
99174097523,99174097525,2,1629,1479,-10
99174558790,99174558787,-3,1370,1964,-10
99174676871,99174676870,-1,944,1372,-10
99176754871,99176754871,0,1449,2176,-10
99177317416,99177317418,2,1654,1249,-10
99177606188,99177606211,23,1037,1179,-10
99179281362,99179281367,5,1022,900,-10
99179885131,99179885118,-13,24944,15128,-10
99181766003,99181766006,3,1685,2120,-10
99183049584,99183049588,4,4353,2320,-10
99184496362,99184496360,-2,1350,1967,-10
99186105306,99186105306,0,1656,1648,-10
99186146111,99186146114,3,767,1247,-10
99187521882,99187521884,2,1972,1209,-10
99187755880,99187755879,-1,951,1480,-10
99190907804,99190907807,3,1745,1721,-10
99192484338,99192484342,4,2478,1299,-10
99195747543,99195747547,4,1314,915,-10
99198160965,99198160965,0,1787,1784,-10
99198514130,99198514130,0,1856,2135,-10
99198713651,99198713650,-1,1399,1221,-10
99202434303,99202434302,-1,1098,2031,-10
99205269641,99205269643,2,1245,1445,-10
99205543135,99205543134,-1,1727,1608,-10
99206275198,99206275200,2,1122,1162,-10
99206738283,99206738287,4,1099,1180,-10
99208748169,99208748174,5,2854,1344,-10
99208981447,99208981455,8,1172,924,-10
99212057678,99212057673,-5,725,2433,-10
99221524801,99221524806,5,1512,1533,-10
99222656396,99222656398,2,1650,1637,-10
99222739411,99222739412,1,1415,1792,-10
99223097349,99223097371,22,1317,1442,-10
99223797489,99223797491,2,1458,1215,-10
99225218185,99225218186,1,2104,1822,-10
99229352126,99229352128,2,1382,1474,-10
99233889334,99233889338,4,1354,1419,-10
99235383821,99235383821,0,1313,1407,-10
99239553463,99239553468,5,2003,1677,-10
99242701478,99242701479,1,1175,1680,-10
99244800339,99244800334,-5,1318,3802,-10
99249472266,99249472270,4,1481,1391,-10
99255743112,99255743113,1,1295,1206,-10
99256622790,99256622790,0,1441,1803,-10
99256713304,99256713307,3,2043,1446,-10
99258282708,99258282710,2,1753,1536,-10
99260105107,99260105109,2,1482,908,-10
99260856491,99260856489,-2,1649,1182,-10
99269479465,99269479467,2,1516,1552,-10
99271498951,99271498955,4,1717,1466,-10
99272120419,99272120422,3,1387,1411,-10
99272201746,99272201749,3,2126,1774,-10
99277274463,99277274461,-2,1131,2506,-10
99283002747,99283002747,0,1661,1607,-10
99284863437,99284863439,2,1446,1454,-10
99288302407,99288302409,2,1276,1469,-10
99288615622,99288615627,5,2003,1523,-10
99294640949,99294640952,3,1483,1878,-10
99297448679,99297448681,2,939,1101,-10
99300640730,99300640730,0,1818,1692,-10
99302465734,99302465735,1,1746,1849,-10
99303800925,99303800926,1,1571,1412,-10
99303907714,99303907715,1,1380,1369,-10
99304720967,99304720981,14,13358,49818,-10
99305102307,99305102315,8,1482,1584,-10
99305430761,99305430762,1,1142,1200,-10
99306859833,99306859834,1,1130,1218,-10
99310078134,99310078135,1,1820,1534,-10
99312222645,99312222646,1,1672,1626,-10
99313068426,99313068429,3,1399,1630,-10
99313293885,99313293907,22,2207,1259,-10
99315632447,99315632450,3,2091,1517,-10
99316456245,99316456247,2,1314,1181,-10
99324760884,99324760885,1,1736,1378,-10
99325687978,99325687978,0,1374,1005,-10
99326928109,99326928111,2,1487,1825,-10
99327827506,99327827508,2,1510,1684,-10
99328403676,99328403678,2,1920,2512,-10
99330268457,99330268457,0,2469,2880,-10
99331181692,99331181688,-4,34002,13526,-10
99333729354,99333729359,5,2212,1401,-10
99336166663,99336166664,1,1863,1807,-10
99336325419,99336325421,2,1270,1317,-10
99343939268,99343939270,2,1465,1437,-10
99345551290,99345551290,0,1235,1717,-10
99350159758,99350159761,3,1724,1768,-10
99354705570,99354705572,2,743,1045,-10
99358283767,99358283766,-1,1092,1416,-10
99358661938,99358661939,1,1608,1051,-10
99362218090,99362218096,6,2908,1718,-10
99362923046,99362923049,3,1318,1448,-10
99363522579,99363522581,2,1523,1778,-10
99363753203,99363753202,-1,1064,1164,-10
99364290073,99364290074,1,1333,1952,-10
99365834874,99365834873,-1,920,1132,-10
99372169165,99372169166,1,1641,1465,-10
99372737189,99372737192,3,1144,1084,-10
99373700783,99373700784,1,1136,1298,-10
99374600333,99374600333,0,2070,1250,-10
99374994600,99374994599,-1,2145,2124,-10
99375039729,99375039731,2,1313,1104,-10
99377406576,99377406577,1,1226,1556,-10
99377763566,99377763569,3,1925,1030,-10
99379434434,99379434436,2,1665,1651,-10
99380045706,99380045709,3,1273,1010,-10
99380866205,99380866210,5,2528,1353,-10
99381887983,99381887980,-3,1055,2985,-10
99382942322,99382942325,3,1115,1431,-10
99384554422,99384554420,-2,1261,2018,-10
99397596874,99397596873,-1,885,1020,-10
99398419337,99398419346,9,213,777,-10
99400320545,99400320548,3,1211,2036,-10
99401686486,99401686487,1,1023,1708,-10
99403467441,99403467443,2,1320,1622,-10
99404088665,99404088662,-3,995,2802,-10
99405848570,99405848560,-10,1463,511,-10
99411130135,99411130138,3,1251,1205,-10
99413664263,99413664267,4,3419,1352,-10
99415544875,99415544876,1,1551,1639,-10
99420236972,99420236974,2,2313,2009,-10
99422161767,99422161769,2,1513,1848,-10
99426815290,99426815294,4,1488,1634,-10
99429937403,99429937402,-1,1419,2049,-10
99431062268,99431062272,4,2490,1389,-10
99432331517,99432331517,0,2116,2238,-10
99433167325,99433167326,1,1461,2054,-10
99436785784,99436785789,5,1641,1921,-10
99440323275,99440323278,3,1230,1172,-10
99441010926,99441010927,1,1255,1214,-10
99442511708,99442511709,1,1299,1224,-10
99444958950,99444958951,1,1722,1565,-10
99445172299,99445172301,2,2500,2187,-10
99450547423,99450547427,4,2661,1852,-10
99450683670,99450683672,2,1351,1519,-10
99452442673,99452442678,5,1817,1108,-10
99454992469,99454992470,1,1522,1286,-10
99456396539,99456396539,0,567,751,-10
99456823458,99456823462,4,1321,1264,-10
99458427347,99458427350,3,1770,2118,-10
99459440033,99459440039,6,3000,1073,-10
99460100821,99460100822,1,1103,1460,-10
99460396623,99460396627,4,2085,1348,-10
99460588737,99460588741,4,1226,1424,-10
99462428558,99462428559,1,1797,2013,-10
99462791413,99462791419,6,3790,1949,-10
99462846666,99462846669,3,1113,1512,-10
99465122026,99465122030,4,1258,1418,-10
99465280518,99465280518,0,1264,1459,-10
99466448189,99466448171,-18,1127,1321,-10
99468751583,99468751590,7,5149,2321,-10
99470758439,99470758443,4,1560,1741,-10
99474360571,99474360571,0,1423,1566,-10
99476785823,99476785821,-2,1421,2085,-10
99477848651,99477848653,2,1474,1525,-10
99479008437,99479008438,1,2105,1483,-10
99479308925,99479308923,-2,1805,3629,-10
99480799623,99480799626,3,2067,1484,-10
99490593793,99490593795,2,1515,1610,-10
99493336385,99493336386,1,1627,1825,-10
99498235829,99498235830,1,1631,1802,-10
99501253810,99501253810,0,2365,3557,-10
99502243874,99502243877,3,1745,1394,-10
99504650420,99504650422,2,2628,2367,-10
99506661250,99506661244,-6,2346,7283,-10
99509353266,99509353267,1,1508,2365,-10
99511440938,99511440937,-1,1264,1436,-10
99511498846,99511498850,4,1654,1573,-10
99512404910,99512404911,1,1292,1521,-10
99513410786,99513410786,0,1461,1497,-10
99513687338,99513687341,3,1569,1336,-10
99513731876,99513731878,2,2160,1395,-10
99517053664,99517053666,2,1635,1298,-10
99519446644,99519446647,3,1231,1741,-10
99519843684,99519843690,6,2536,1058,-10
99524622282,99524622284,2,1216,1487,-10
99525499783,99525499786,3,1626,2034,-10
99525641972,99525641973,1,1215,1463,-10
99527340185,99527340188,3,1590,1632,-10
99530626322,99530626323,1,1044,966,-10
99531239603,99531239606,3,1305,731,-10
99533910841,99533910838,-3,1360,971,-10
99534017578,99534017579,1,1771,2381,-10
99535945498,99535945501,3,1451,1282,-10
99545442573,99545442577,4,1890,1897,-10
99546935907,99546935906,-1,818,768,-10
99547457315,99547457317,2,1808,1434,-10
99547690992,99547690990,-2,1176,2317,-10
99551439378,99551439383,5,2023,955,-10
99554202480,99554202473,-7,2037,7139,-10
99556108415,99556108416,1,1298,1527,-10
99558534767,99558534769,2,2187,1662,-10
99561059652,99561059654,2,2872,1748,-10
99561524594,99561524599,5,1680,1537,-10
99565368658,99565368660,2,3015,1924,-10
99566468975,99566468975,0,1429,1844,-10
99568720478,99568720478,0,1510,1398,-10
99572709177,99572709180,3,1484,1675,-10
99573068909,99573068911,2,1347,1257,-10
99573721370,99573721370,0,886,1165,-10
99576154919,99576154920,1,1798,1825,-10
99577140549,99577140550,1,1781,1883,-10
99578795019,99578795022,3,1928,1451,-10
99579385567,99579385566,-1,1858,2283,-10
99580370511,99580370514,3,1641,1438,-10
99583128015,99583128011,-4,1533,2403,-10
99584644495,99584644496,1,1368,1782,-10
99585409614,99585409613,-1,1302,1469,-10
99585897147,99585897143,-4,770,1012,-10
99587888357,99587888358,1,1623,1440,-10
99592585452,99592585454,2,1611,1286,-10
99593018889,99593018894,5,1505,1347,-10
99594369654,99594369660,6,1382,1552,-10
99595432919,99595432914,-5,1805,4728,-10
99595673559,99595673563,4,1541,989,-10
99597420366,99597420367,1,1008,857,-10
99597973694,99597973690,-4,639,1739,-10
99598761800,99598761802,2,1256,1259,-10
99600330066,99600330069,3,1382,1663,-10
99602909958,99602909961,3,1583,2027,-10
99604132663,99604132664,1,1516,2334,-10
99605201166,99605201166,0,940,954,-10
99608809307,99608809310,3,1401,1769,-10
99615050433,99615050434,1,1762,2123,-10
99618834308,99618834329,21,1125,1158,-10
99619725145,99619725146,1,1443,1811,-10
99620642354,99620642371,17,799,2129,-10
99620680386,99620680389,3,1532,1206,-10
99621927008,99621927001,-7,1733,8430,-10
99622121760,99622121761,1,1955,2090,-10
99623149310,99623149314,4,1856,2160,-10
99623879999,99623879978,-21,634,913,-10
99625708794,99625708814,20,264,1145,-10
99628349744,99628349744,0,2351,3224,-10
99629834275,99629834277,2,1396,1731,-10
99633662901,99633662903,2,1229,1147,-10
99636071541,99636071543,2,1462,1359,-10
99641338074,99641338076,2,1873,1816,-10
99641763109,99641763110,1,1567,1529,-10
99642700673,99642700674,1,1599,1574,-10
99644197313,99644197314,1,1583,1038,-10
99644297614,99644297614,0,958,847,-10
99645341216,99645341218,2,1459,1467,-10
99646057428,99646057429,1,1992,1979,-10
99648604629,99648604630,1,1547,1663,-10
99649013905,99649013907,2,1858,1226,-10
99657741571,99657741574,3,1294,1112,-10
99658939307,99658939310,3,1968,1567,-10
99661381941,99661381941,0,1093,916,-10
99661781333,99661781337,4,1865,1605,-10
99662280537,99662280537,0,1992,1607,-10
99663539389,99663539389,0,2333,1655,-10
99664471437,99664471440,3,1757,1126,-10
99666419646,99666419649,3,2413,1717,-10
99673163781,99673163782,1,1279,1249,-10
99677333916,99677333917,1,2211,1801,-10
99677491056,99677491057,1,1647,1692,-10
99681245889,99681245890,1,1479,1497,-10
99684927779,99684927782,3,1844,1197,-10
99686485506,99686485510,4,2077,1548,-10
99687580966,99687580971,5,1723,1328,-10
99687963235,99687963240,5,2614,1849,-10
99688642533,99688642535,2,1417,1128,-10
99689473768,99689473769,1,1456,1673,-10
99689540154,99689540159,5,2866,1136,-10
99689757441,99689757443,2,1617,1624,-10
99692253989,99692253995,6,2581,1052,-10
99694088907,99694088910,3,1294,1303,-10
99696635271,99696635274,3,1731,1788,-10
99697949594,99697949598,4,1352,1271,-10
99700371267,99700371268,1,1791,1232,-10
99700835279,99700835258,-21,1265,1546,-10
99705629534,99705629534,0,1656,1532,-10
99707576714,99707576715,1,1431,1425,-10
99708313843,99708313845,2,960,1681,-10
99714121356,99714121358,2,1123,1797,-10
99714422766,99714422769,3,1617,1398,-10
99716453998,99716453998,0,917,1201,-10
99724215221,99724215200,-21,1852,1443,-10
99724972362,99724972363,1,1659,1714,-10
99727901722,99727901722,0,1081,1131,-10
99732286669,99732286671,2,2359,1221,-10
99736205246,99736205249,3,1384,1108,-10
99738588562,99738588565,3,2091,1860,-10
99739931462,99739931463,1,1585,1388,-10
99746688798,99746688798,0,1443,1533,-10
99746880580,99746880599,19,244,1308,-10
99752545839,99752545841,2,1579,2974,-10
99754445841,99754445843,2,2159,1673,-10
99759780860,99759780860,0,1547,1425,-10
99763354959,99763354959,0,1071,1280,-10
99765085215,99765085218,3,1095,1269,-10
99767690683,99767690686,3,1176,1123,-10
99768242412,99768242410,-2,1207,1533,-10
99769089235,99769089235,0,1030,1458,-10
99771496293,99771496293,0,1999,1946,-10
99773206755,99773206754,-1,1333,1657,-10
99774396564,99774396567,3,1308,1224,-10
99776299058,99776299058,0,1339,1583,-10
99778099965,99778099966,1,1942,1597,-10
99778318385,99778318390,5,2010,1415,-10
99786332947,99786332948,1,1897,2267,-10
99790905766,99790905767,1,1242,1224,-10
99792693749,99792693755,6,5573,4041,-10
99793845624,99793845624,0,1219,1352,-10
99796921295,99796921297,2,1101,1457,-10
99797316638,99797316640,2,1576,1605,-10
99803157889,99803157890,1,1283,1366,-10
99804169304,99804169300,-4,1501,2549,-10
99807839859,99807839861,2,909,1270,-10
99813656568,99813656570,2,1161,1137,-10
99815469354,99815469359,5,1909,1089,-10
99818035166,99818035168,2,1270,1243,-10
99818572782,99818572795,13,1473,1573,-10
99821093012,99821093014,2,1856,1939,-10
99821976280,99821976281,1,1460,1519,-10
99826252024,99826252025,1,1335,1856,-10
99836757826,99836757832,6,1604,1620,-10
99837792291,99837792293,2,1397,1315,-10
99838726995,99838726995,0,1762,1455,-10
99839065271,99839065273,2,1369,1401,-10
99839836294,99839836294,0,1657,1925,-10
99840185993,99840185976,-17,765,1436,-10
99842903738,99842903741,3,1320,1556,-10
99844759420,99844759421,1,1405,1201,-10
99847671246,99847671247,1,1777,1857,-10
99850083002,99850082997,-5,1196,3029,-10
99853422330,99853422331,1,1810,1793,-10
99853593078,99853593078,0,1210,1371,-10
99854730263,99854730266,3,958,1219,-10
99856869216,99856869218,2,2101,2582,-10
99857067828,99857067830,2,1928,1883,-10
99861790410,99861790409,-1,1637,1746,-10
99862856386,99862856388,2,1016,1601,-10
99865777394,99865777394,0,1351,2381,-10
99868567702,99868567703,1,1287,1498,-10
99869703379,99869703379,0,1697,1590,-10
99870386170,99870386172,2,1572,1546,-10
99873538518,99873538522,4,1635,1478,-10
99879805328,99879805329,1,1704,1622,-10
99880855544,99880855546,2,1173,1549,-10
99881795529,99881795532,3,1561,2037,-10
99881853574,99881853574,0,1374,1272,-10
99882636713,99882636715,2,1522,1503,-10
99884173407,99884173409,2,1113,1507,-10
99885163498,99885163498,0,1681,1632,-10
99894829592,99894829591,-1,2233,2838,-10
99895571687,99895571691,4,1161,1123,-10
99910498101,99910498106,5,2456,1228,-10
99913544590,99913544591,1,1542,1521,-10
99913892701,99913892697,-4,1217,5373,-10
99915923913,99915923913,0,2115,2828,-10
99922513959,99922513959,0,1814,960,-10
99928657141,99928657143,2,1416,1788,-10
99930170711,99930170715,4,2859,1491,-10
99932818611,99932818614,3,1839,1582,-10
99932895584,99932895579,-5,2446,6330,-10
99933485886,99933485887,1,2222,2158,-10
99934801894,99934801895,1,1455,1941,-10
99941490254,99941490257,3,1414,1390,-10
99942680650,99942680651,1,1920,1742,-10
99943079286,99943079265,-21,1154,1062,-10
99944609689,99944609690,1,1326,1304,-10
99944811665,99944811666,1,1206,1072,-10
99945694363,99945694365,2,1062,1550,-10
99947849174,99947849181,7,1971,1149,-10
99951297685,99951297686,1,1394,1275,-10
99953742460,99953742462,2,2248,1891,-10
99954694669,99954694649,-20,1502,1253,-10
99960593258,99960593259,1,1377,1236,-10
99960936131,99960936135,4,2089,1677,-10
99963651707,99963651709,2,1821,1405,-10
99963744407,99963744408,1,1230,1184,-10
99967641291,99967641290,-1,1701,1258,-10
99967847718,99967847721,3,1088,1464,-10
99969771217,99969771222,5,1320,1706,-10
99971439983,99971439985,2,1554,1825,-10
99971899774,99971899774,0,1915,2036,-10
99973701302,99973701302,0,1465,1664,-10
99981271818,99981271832,14,1615,1452,-10
99983549328,99983549330,2,1376,1925,-10
99987912373,99987912374,1,1593,1951,-10
99989686216,99989686218,2,2060,1294,-10
99991189043,99991189045,2,1600,1767,-10
99992411029,99992411030,1,1282,1298,-10
99992643314,99992643315,1,1849,1654,-10
99996319018,99996319019,1,1228,1763,-10
99996779670,99996779671,1,1844,1646,-10
99998662897,99998662899,2,1780,1525,-10
99998779938,99998779940,2,1860,1884,-10
99998926198,99998926198,0,1550,1165,-10
100001596873,100001596877,4,1635,1662,-10
100003025876,100003025880,4,1455,1109,-10
100004330923,100004330926,3,1735,1151,-10
100005652562,100005652563,1,1308,1195,-10
100005885973,100005885976,3,1780,1294,-10
100009982761,100009982763,2,1139,1536,-10
100010672085,100010672086,1,1418,996,-10
100015592430,100015592431,1,1778,1712,-10
100016305286,100016305286,0,1515,1816,-10
100018875211,100018875213,2,1385,1500,-10
100019442958,100019442960,2,1181,1598,-10
100022156006,100022156007,1,1936,2062,-10
100023036189,100023036190,1,1381,1195,-10
100023599785,100023599786,1,1386,1541,-10
100024456516,100024456518,2,1716,1623,-10
100025677225,100025677226,1,1402,1181,-10
100026260555,100026260557,2,1210,1411,-10
100028122586,100028122586,0,1336,1259,-10
100028847640,100028847645,5,2953,1820,-10
100029278131,100029278133,2,2113,2099,-10
100033300018,100033300018,0,1772,1612,-10
100034197491,100034197493,2,1085,1779,-10
100035321648,100035321650,2,1145,1688,-10
100038500794,100038500799,5,1808,817,-10
100039048017,100039048018,1,1893,1900,-10
100041434342,100041434345,3,1612,1279,-10
100043963377,100043963379,2,1361,2016,-10
100044716810,100044716815,5,1496,1397,-10
100045833009,100045833011,2,1277,1367,-10
100046925825,100046925825,0,1456,1543,-10
100048820126,100048820125,-1,1618,2013,-10
100050511173,100050511177,4,1983,1421,-10
100052531846,100052531849,3,1765,2178,-10
100071451001,100071450980,-21,1952,1509,-10
100072397490,100072397490,0,1425,1361,-10
100075397661,100075397665,4,1340,1322,-10
100077927565,100077927566,1,1385,1164,-10
100081076189,100081076188,-1,1239,2086,-10
100088267666,100088267667,1,1695,1491,-10
100091703354,100091703354,0,1234,1612,-10
100092932562,100092932564,2,1527,1519,-10
100094587466,100094587468,2,2129,1645,-10
100095303071,100095303074,3,1468,1339,-10
100096780809,100096780810,1,1884,1470,-10
100099196898,100099196894,-4,1888,6149,-10
100099920026,100099920034,8,15611,26720,-10
100100119435,100100119437,2,1521,1384,-10
100100267354,100100267358,4,903,1276,-10
100106803047,100106803049,2,1755,1457,-10
100108192562,100108192566,4,1454,1443,-10
100109261764,100109261770,6,1782,918,-10
100111230602,100111230602,0,1547,1457,-10
100116768662,100116768663,1,1649,1407,-10
100117959238,100117959243,5,1242,1481,-10
100123064651,100123064653,2,1571,1815,-10
100123295651,100123295654,3,1791,1222,-10
100123478119,100123478121,2,1432,1293,-10
100126000563,100126000566,3,1509,1280,-10
100129171380,100129171379,-1,1620,1461,-10
100129301550,100129301553,3,6107,5438,-10
100130259030,100130259031,1,1395,1529,-10
100137206876,100137206878,2,1675,1919,-10
100140244838,100140244838,0,1746,1337,-10
100140842140,100140842146,6,5138,1976,-10
100144050855,100144050855,0,1728,1430,-10
100145701409,100145701408,-1,1826,3170,-10
100146936966,100146936971,5,1911,968,-10
100149778098,100149778098,0,1218,1623,-10
100150668810,100150668814,4,2254,1234,-10
100150824917,100150824923,6,1655,1279,-10
100152625938,100152625942,4,1534,1482,-10
100155089013,100155089013,0,1945,2032,-10
100156576882,100156576885,3,1447,1270,-10
100158109033,100158109033,0,1190,942,-10
100160264529,100160264532,3,1295,1149,-10
100164364162,100164364162,0,1858,1344,-10
100179449006,100179449007,1,1676,1579,-10
100181345214,100181345221,7,6927,3091,-10
100181510106,100181510101,-5,1518,4257,-10
100183957627,100183957627,0,2185,2023,-10
100188225110,100188225114,4,1964,1646,-10
100189796689,100189796691,2,1640,1352,-10
100191513166,100191513168,2,1972,1480,-10
100192222974,100192222975,1,819,980,-10
100194400041,100194400043,2,1124,1200,-10
100194743272,100194743273,1,2191,1495,-10
100195546774,100195546778,4,1583,1594,-10
100195663932,100195663934,2,1030,1445,-10
100198301855,100198301858,3,1529,1389,-10
100202940975,100202940977,2,1156,793,-10
100203109507,100203109509,2,2183,2033,-10
100204298209,100204298211,2,1418,1381,-10
100206923729,100206923730,1,1575,1745,-10
100213404046,100213404047,1,1523,1273,-10
100213929642,100213929643,1,1026,822,-10
100215055897,100215055899,2,1072,1004,-10
100218526148,100218526150,2,1722,1386,-10
100219323607,100219323606,-1,1266,1337,-10
100219973186,100219973189,3,1100,1438,-10
100220412026,100220412028,2,1470,1545,-10
100220852422,100220852422,0,1209,1296,-10
100226190910,100226190913,3,1133,967,-10
100227704386,100227704389,3,1272,1307,-10
100229745928,100229745931,3,1657,1126,-10
100229812145,100229812146,1,1486,1551,-10
100235061058,100235061062,4,1240,1060,-10
100235540413,100235540416,3,1749,1989,-10
100235956567,100235956569,2,1625,1395,-10
100238234542,100238234544,2,1964,1383,-10
100239537358,100239537358,0,1319,1674,-10
100244760868,100244760871,3,12265,8572,-10
100246875365,100246875366,1,1695,2152,-10
100252875509,100252875507,-2,1657,2279,-10
100254409132,100254409134,2,1497,1507,-10
100254557778,100254557780,2,888,1695,-10
100254944475,100254944479,4,1253,1258,-10
100255825157,100255825159,2,2005,1426,-10
100256463870,100256463870,0,1320,1544,-10
100261319061,100261319067,6,1373,1520,-10
100268576481,100268576482,1,1110,1625,-10
100269714846,100269714846,0,1904,1667,-10
100271248812,100271248814,2,2088,1860,-10
100271553665,100271553666,1,13495,14804,-10
100275012130,100275012130,0,998,890,-10
100279555191,100279555193,2,1390,1492,-10
100280239602,100280239586,-16,1835,1608,-10
100281931727,100281931732,5,13611,6682,-10
100282045869,100282045871,2,2137,1462,-10
100284584802,100284584806,4,2301,1726,-10
100287770837,100287770838,1,1570,1299,-10
100293363057,100293363059,2,1542,1587,-10
100295195512,100295195498,-14,1175,1503,-10
100299282488,100299282489,1,1551,1781,-10
100301625273,100301625274,1,1382,1307,-10
100304885371,100304885376,5,1307,1174,-10
100305836958,100305836961,3,1742,1061,-10
100307655842,100307655843,1,1640,1695,-10
100307962338,100307962342,4,1844,1704,-10
100309586655,100309586658,3,2376,2223,-10
100313087246,100313087257,11,4142,1360,-10
100317448798,100317448800,2,1255,1740,-10
100325911041,100325911043,2,1815,1611,-10
100326918988,100326918990,2,1788,1281,-10
100330294340,100330294342,2,1270,1318,-10
100332913011,100332913013,2,1832,1563,-10
100334668038,100334668041,3,1887,1777,-10
100336111332,100336111333,1,2389,1877,-10
100336853716,100336853719,3,2428,1691,-10
100340094866,100340094869,3,1734,1795,-10
100341102259,100341102260,1,1776,1666,-10
100341294743,100341294746,3,1947,1544,-10
100344583069,100344583071,2,857,1331,-10
100344680102,100344680102,0,1550,1507,-10
100346592105,100346592106,1,1312,1584,-10
100349574047,100349574050,3,1820,1398,-10
100352082055,100352082057,2,1090,1141,-10
100353417811,100353417811,0,1087,1077,-10
100354518887,100354518907,20,829,885,-10
100355243391,100355243393,2,1378,1328,-10
100357713586,100357713586,0,1193,1129,-10
100357905984,100357905986,2,1673,1553,-10
100359283917,100359283917,0,1101,1219,-10
100362546662,100362546663,1,982,1426,-10
100367939322,100367939325,3,3559,2330,-10
100372951682,100372951678,-4,1809,4378,-10
100374347822,100374347826,4,2294,2681,-10
100382247346,100382247346,0,1412,1427,-10
100383160150,100383160154,4,1741,1591,-10
100383758782,100383758783,1,891,1364,-10
100385620820,100385620820,0,1369,1692,-10
100386224170,100386224167,-3,1083,1478,-10
100386578332,100386578333,1,1843,1472,-10
100388796258,100388796260,2,2037,1484,-10
100391768292,100391768294,2,31364,106791,-10
100392261667,100392261669,2,1831,1487,-10
100393413890,100393413889,-1,1340,1643,-10
100393778443,100393778445,2,1634,1201,-10
100396712400,100396712402,2,2449,1906,-10
100401876554,100401876555,1,1595,1922,-10
100404869066,100404869071,5,1465,1701,-10
100405472278,100405472279,1,1108,1281,-10
100408816442,100408816444,2,1112,1256,-10
100411237765,100411237766,1,1329,1333,-10
100412274423,100412274425,2,1418,1303,-10
100414788219,100414788225,6,3209,1872,-10
100417967054,100417967058,4,2003,1600,-10
100418316492,100418316493,1,1918,1575,-10
100421368988,100421368990,2,1187,1662,-10
100423133890,100423133890,0,1312,2149,-10
100425271751,100425271753,2,2057,2434,-10
100427035782,100427035803,21,975,1656,-10
100429085568,100429085570,2,1485,1582,-10
100429360045,100429360046,1,1530,1472,-10
100432058429,100432058430,1,1098,1128,-10
100432528778,100432528780,2,2329,2047,-10
100434214886,100434214886,0,1760,1397,-10
100438360031,100438360033,2,1575,1971,-10
100439483938,100439483942,4,1407,1370,-10
100439516273,100439516270,-3,1232,1358,-10
100440593049,100440593050,1,971,1295,-10
100441348613,100441348614,1,1749,1272,-10
100441930827,100441930824,-3,909,2924,-10
100445359348,100445359350,2,1725,2101,-10
100446760126,100446760128,2,2140,1601,-10
100449585138,100449585138,0,1776,1878,-10
100450041296,100450041297,1,2000,1557,-10
100452929099,100452929102,3,1413,1436,-10
100453866973,100453866975,2,1217,1291,-10
100455736494,100455736497,3,1769,1861,-10
100460158302,100460158305,3,2589,1967,-10
100460477521,100460477523,2,1439,1701,-10
100462455753,100462455755,2,2272,1735,-10
100465207810,100465207810,0,1389,1231,-10
100468289801,100468289802,1,960,845,-10
100475967777,100475967766,-11,1397,1212,-10
100477678177,100477678178,1,1995,1523,-10
100477920890,100477920893,3,1288,745,-10
100478662390,100478662393,3,1462,1841,-10
100480014640,100480014643,3,2280,1799,-10
100480793042,100480793045,3,995,828,-10
100482198993,100482198995,2,1781,1482,-10
100488907784,100488907787,3,1371,1813,-10
100489415127,100489415129,2,1162,1335,-10
100489942633,100489942634,1,1309,1842,-10
100492457876,100492457878,2,1513,1328,-10
100494816164,100494816162,-2,2053,1934,-10
100494962627,100494962630,3,8601,7603,-10
100496502239,100496502241,2,1244,843,-10
100497012084,100497012085,1,1072,588,-10
100497809552,100497809554,2,2775,2448,-10
100499698981,100499698985,4,1024,997,-10
100500543813,100500543833,20,1790,1570,-10
100505676518,100505676521,3,1505,1641,-10
100506983169,100506983170,1,1504,1964,-10
100508517970,100508517970,0,1547,1684,-10
100510292093,100510292092,-1,1473,1971,-10
100510627805,100510627807,2,1050,1421,-10
100511970150,100511970151,1,1315,1296,-10
100512598451,100512598454,3,1003,1081,-10
100513104822,100513104827,5,2065,1811,-10
100517983091,100517983092,1,925,1447,-10
100518055106,100518055109,3,2137,1867,-10
100519764569,100519764570,1,1811,1673,-10
100523165368,100523165369,1,1279,1241,-10
100523893599,100523893596,-3,5907,13311,-10
100532162761,100532162765,4,3687,2641,-10
100533564920,100533564921,1,1432,1384,-10
100535316111,100535316112,1,1692,1628,-10
100537083590,100537083595,5,2497,1361,-10
100541423670,100541423674,4,1742,1642,-10
100545813813,100545813815,2,1749,2083,-10
100546107936,100546107937,1,1266,1173,-10
100546181467,100546181469,2,1072,1777,-10
100546504834,100546504834,0,1421,1730,-10
100546829105,100546829109,4,1996,1405,-10
100547029345,100547029350,5,3809,18658,-10
100549988165,100549988165,0,1473,1184,-10
100550869054,100550869051,-3,985,1828,-10
100552605430,100552605435,5,1646,1215,-10
100556681116,100556681115,-1,2377,2492,-10
100562864943,100562864943,0,1275,1472,-10
100563740303,100563740307,4,3034,1860,-10
100563961789,100563961794,5,1492,1605,-10
100566031055,100566031054,-1,1712,1188,-10
100566728885,100566728886,1,1136,1427,-10
100567812306,100567812306,0,1664,1669,-10
100568538738,100568538738,0,1510,1904,-10
100568881569,100568881570,1,1321,992,-10
100572135485,100572135486,1,1341,1847,-10
100573052055,100573052058,3,1937,2020,-10
100573109582,100573109583,1,1700,1643,-10
100574480790,100574480795,5,2498,1435,-10
100576208569,100576208570,1,1622,1038,-10
100581707877,100581707878,1,1882,1872,-10
100582414262,100582414262,0,2058,1948,-10
100583230207,100583230207,0,746,918,-10
100584412684,100584412685,1,1598,1339,-10
100586961117,100586961118,1,1528,1596,-10
100594404598,100594404600,2,2196,1862,-10
100595102227,100595102227,0,1453,1596,-10
100595148377,100595148374,-3,1221,1338,-10
100600384166,100600384170,4,2144,1729,-10
100600917377,100600917378,1,2287,1489,-10
100605191658,100605191661,3,2275,2258,-10
100605947205,100605947206,1,1321,1795,-10
100606804012,100606804013,1,1296,1395,-10
100609129428,100609129429,1,1376,1561,-10
100609321835,100609321833,-2,1475,2804,-10
100612665574,100612665575,1,1691,1195,-10
100616496402,100616496406,4,1313,1448,-10
100619396689,100619396690,1,1484,1386,-10
100620511669,100620511670,1,1611,2110,-10
100620633142,100620633143,1,2255,1578,-10
100620739264,100620739266,2,2396,2291,-10
100621643876,100621643875,-1,1815,1938,-10
100622346697,100622346702,5,7651,4915,-10
100622990654,100622990659,5,1555,1569,-10
100623205710,100623205716,6,11738,28102,-10
100625747149,100625747150,1,1143,1441,-10
100625888769,100625888774,5,1176,841,-10
100628946430,100628946431,1,2190,2005,-10
100630144890,100630144897,7,3650,1370,-10
100630320605,100630320605,0,1986,2410,-10
100631432825,100631432826,1,1138,1415,-10
100634512341,100634512342,1,1819,1623,-10
100639797815,100639797818,3,766,1043,-10
100641094092,100641094092,0,1845,1958,-10
100641944289,100641944291,2,1726,1456,-10
100642168073,100642168090,17,1053,1216,-10
100644942929,100644942930,1,1517,1347,-10
100645470115,100645470117,2,2402,1648,-10
100647771227,100647771230,3,1304,1660,-10
100648578090,100648578093,3,1256,1011,-10
100652259134,100652259135,1,1480,1459,-10
100652979972,100652979974,2,991,1450,-10
100655755781,100655755782,1,1344,2084,-10
100656680349,100656680350,1,1155,1310,-10
100657359893,100657359893,0,2262,2258,-10
100658017362,100658017364,2,1330,1630,-10
100658208418,100658208410,-8,726,2591,-10
100662443022,100662443022,0,1698,1509,-10
100671400489,100671400489,0,2043,1769,-10
100672684538,100672684543,5,2881,1696,-10
100673457762,100673457761,-1,1292,1215,-10
100675850083,100675850086,3,928,1354,-10
100677346887,100677346887,0,1391,2485,-10
100678268110,100678268102,-8,1160,3990,-10
100681419353,100681419353,0,1649,1269,-10
100682711461,100682711462,1,1388,1645,-10
100683328857,100683328861,4,1377,1426,-10
100683474501,100683474501,0,1573,1607,-10
100687386810,100687386810,0,2024,1697,-10
100688863610,100688863612,2,1117,1472,-10
100690845063,100690845065,2,830,1045,-10
100693130986,100693130988,2,2438,2181,-10
100696458452,100696458454,2,1583,2348,-10
100697894810,100697894814,4,1133,1708,-10
100699684995,100699684997,2,1069,1430,-10
100706772370,100706772374,4,2202,1757,-10
100708563743,100708563745,2,1755,1955,-10
100709002366,100709002368,2,1283,1521,-10
100710029435,100710029437,2,1264,1158,-10
100716214463,100716214464,1,1581,1437,-10
100717677105,100717677105,0,1647,1544,-10
100719695317,100719695318,1,1155,896,-10
100723222165,100723222170,5,3079,1192,-10
100724203797,100724203800,3,1844,1366,-10
100726839123,100726839125,2,1374,1476,-10
100731594374,100731594377,3,1305,1370,-10
100732618140,100732618142,2,1718,1994,-10
100734898697,100734898697,0,1844,2149,-10
100738285895,100738285894,-1,1338,2061,-10
100749397346,100749397351,5,1857,1373,-10
100750691010,100750691012,2,1262,1135,-10
100751302065,100751302069,4,2282,1125,-10
100752350114,100752350121,7,11871,4533,-10
100752664409,100752664410,1,1671,1442,-10
100759617649,100759617651,2,1452,1796,-10
100761042970,100761042973,3,1093,1432,-10
100765097563,100765097568,5,813,1150,-10
100768671883,100768671886,3,1905,1351,-10
100770476531,100770476536,5,1470,944,-10
100773989697,100773989699,2,1986,1112,-10
100774370725,100774370727,2,1332,1873,-10
100780416968,100780416971,3,2106,1704,-10
100782871461,100782871463,2,1296,1296,-10
100784431179,100784431175,-4,1657,5759,-10
100785838414,100785838417,3,1584,1351,-10
100787591693,100787591697,4,1696,1535,-10
100788150242,100788150242,0,945,1281,-10
100790550937,100790550942,5,2587,1247,-10
100793657281,100793657286,5,1542,1535,-10
100799166631,100799166633,2,1259,1690,-10
100804879136,100804879140,4,3133,1781,-10
100805247990,100805247993,3,1647,1785,-10
100810245208,100810245210,2,1596,1360,-10
100811158964,100811158966,2,1590,1502,-10
100811596717,100811596696,-21,1193,1430,-10
100813527926,100813527929,3,1516,1504,-10
100816697224,100816697229,5,1283,973,-10
100816889249,100816889248,-1,1546,2441,-10
100818155446,100818155449,3,1475,1174,-10
100819559704,100819559702,-2,2214,2029,-10
100822959781,100822959783,2,1355,1408,-10
100829131341,100829131340,-1,1152,1397,-10
100831996420,100831996419,-1,1960,2206,-10
100835312498,100835312498,0,1348,1882,-10
100835475779,100835475782,3,1840,1743,-10
100835842202,100835842204,2,2273,1325,-10
100836348177,100836348172,-5,645,1750,-10
100839457361,100839457363,2,1385,1175,-10
100840909540,100840909540,0,2224,1296,-10
100843155214,100843155214,0,1614,1625,-10
100846637499,100846637501,2,1345,1098,-10
100850209982,100850209983,1,2081,2358,-10
100851211526,100851211518,-8,1529,908,-10
100854972363,100854972362,-1,1204,2040,-10
100858710846,100858710848,2,2251,1872,-10
100859801565,100859801565,0,1492,1598,-10
100860678352,100860678349,-3,1182,2182,-10
100860769546,100860769547,1,1003,1184,-10
100861848804,100861848805,1,1860,2156,-10
100862302905,100862302907,2,1079,957,-10
100863778132,100863778130,-2,17928,15300,-10
100865333851,100865333854,3,1154,1884,-10
100866538954,100866538952,-2,1074,1497,-10
100868288641,100868288644,3,1061,1545,-10
100872060322,100872060326,4,1853,2697,-10
100873827583,100873827584,1,1289,1506,-10
100876255213,100876255216,3,1860,1650,-10
100878678399,100878678403,4,2486,2618,-10
100882398445,100882398445,0,1885,1254,-10
100882596852,100882596871,19,170,910,-10
100882893018,100882893016,-2,1539,2411,-10
100884918150,100884918150,0,1864,2105,-10
100885877011,100885877013,2,2626,2012,-10
100887400433,100887400436,3,1504,1939,-10
100887755520,100887755520,0,1285,1910,-10
100888797414,100888797410,-4,1004,3006,-10
100891005970,100891005969,-1,1517,1934,-10
100891424422,100891424425,3,1818,1663,-10
100894442002,100894442002,0,1469,1590,-10
100898269523,100898269525,2,926,1570,-10
100899569778,100899569771,-7,439,1396,-10
100900165674,100900165654,-20,1268,1473,-10
100903012886,100903012889,3,1705,1849,-10
100903158441,100903158444,3,1293,1799,-10
100904046327,100904046325,-2,1122,1555,-10
100906314763,100906314765,2,1442,1206,-10
100906915430,100906915429,-1,1199,1044,-10
100907242662,100907242662,0,1490,1507,-10
100908530917,100908530917,0,1344,1761,-10
100916391757,100916391758,1,1604,1868,-10
100916462767,100916462771,4,1616,1620,-10
100918134066,100918134066,0,921,1107,-10
100922276879,100922276882,3,1249,1061,-10
100926606191,100926606191,0,1705,1454,-10
100927631851,100927631853,2,1029,1506,-10
100928215241,100928215242,1,1428,1450,-10
100929596229,100929596232,3,1082,1263,-10
100930009649,100930009650,1,1245,1262,-10
100931185538,100931185540,2,1792,1615,-10
100933300317,100933300318,1,1543,1338,-10
100935591838,100935591839,1,1468,1671,-10
100939086592,100939086594,2,1612,1022,-10
100940538482,100940538485,3,1290,1715,-10
100942347488,100942347491,3,1200,1438,-10
100948988664,100948988665,1,1531,1373,-10
100951121937,100951121942,5,2412,1392,-10
100951833158,100951833160,2,1356,1198,-10
100952360494,100952360494,0,2119,1773,-10
100953224477,100953224480,3,1611,842,-10
100956386962,100956386962,0,1512,1765,-10
100958314023,100958314024,1,1861,3067,-10
100958687950,100958687950,0,1427,1226,-10
100960094935,100960094937,2,1819,1335,-10
100962874977,100962874995,18,16457,33293,-10
100966868459,100966868459,0,1508,1844,-10
100967057729,100967057729,0,1661,1141,-10
100967225381,100967225382,1,1781,1762,-10
100969653458,100969653461,3,1792,1522,-10
100974004979,100974004979,0,29225,1662,-10
100974628413,100974628415,2,1774,1101,-10
100976362392,100976362389,-3,1179,2637,-10
100978277417,100978277419,2,1662,1201,-10
100978587489,100978587491,2,1356,1207,-10
100978787138,100978787138,0,1707,1543,-10
100979073547,100979073546,-1,1224,1528,-10
100980700194,100980700196,2,1350,1219,-10
100982622529,100982622531,2,1425,1236,-10
100984946643,100984946645,2,1083,1443,-10
100987350505,100987350503,-2,1810,1820,-10
100987670731,100987670734,3,33747,30664,-10
100988303361,100988303362,1,1674,1619,-10
100989709694,100989709695,1,2394,2022,-10
100993380791,100993380801,10,917,945,-10
100994566605,100994566606,1,1606,1585,-10
100994624376,100994624379,3,1735,1554,-10
100995503047,100995503050,3,1590,1619,-10
100999438993,100999438995,2,1651,1265,-10
101001641853,101001641854,1,1963,1696,-10
101007040149,101007040158,9,25191,45319,-10
101011160078,101011160056,-22,1305,1672,-10
101013505058,101013505061,3,1325,1549,-10
101014242486,101014242488,2,1583,2213,-10
101017528553,101017528555,2,1709,1205,-10
101020829668,101020829668,0,1509,1481,-10
101021258432,101021258436,4,1887,1537,-10
101023042327,101023042327,0,1041,1178,-10
101023909937,101023909938,1,1382,1319,-10
101026167130,101026167132,2,1289,1404,-10
101028119755,101028119755,0,1233,1421,-10
101028643686,101028643691,5,958,809,-10
101031385725,101031385727,2,1253,1465,-10
101032989329,101032989329,0,1391,1100,-10
101035660623,101035660623,0,1216,1276,-10
101037742082,101037742085,3,1577,1658,-10
101039128438,101039128441,3,1225,1370,-10
101040301142,101040301144,2,1210,1143,-10
101041652574,101041652575,1,2496,1994,-10
101046939790,101046939794,4,1890,1013,-10
101048381029,101048381033,4,1631,1561,-10
101053544162,101053544160,-2,41184,21970,-10
101054435574,101054435577,3,3120,2274,-10
101057939052,101057939067,15,477,2535,-10
101058709354,101058709358,4,1994,2263,-10
101061632143,101061632145,2,1592,1815,-10
101064239593,101064239593,0,1258,1456,-10
101064686181,101064686181,0,1089,1663,-10
101064802124,101064802127,3,2270,2079,-10
101067900685,101067900687,2,1220,1807,-10
101069469361,101069469362,1,1536,1920,-10
101074598213,101074598196,-17,1256,1692,-10
101076636734,101076636733,-1,1194,964,-10
101077814353,101077814355,2,1516,1175,-10
101078500810,101078500814,4,1596,1536,-10
101078836804,101078836805,1,1959,1995,-10
101080087973,101080087975,2,1037,1337,-10
101084785109,101084785116,7,9981,43771,-10
101086928037,101086928039,2,1237,1885,-10
101089338572,101089338573,1,1535,1511,-10
101090314814,101090314817,3,1329,1256,-10
101092328564,101092328567,3,1159,665,-10
101094364354,101094364354,0,1368,1687,-10
101096752751,101096752751,0,1154,1578,-10
101099656730,101099656731,1,1711,2109,-10
101104654170,101104654171,1,1343,1567,-10
101109067414,101109067417,3,1434,1624,-10
101111902339,101111902340,1,1438,1588,-10
101113229855,101113229858,3,2334,1222,-10
101114197054,101114197056,2,1161,1489,-10
101116011230,101116011234,4,1014,1152,-10
101116376349,101116376352,3,2413,1544,-10
101116973715,101116973716,1,1632,1973,-10
101121073610,101121073610,0,2010,1331,-10
101121963664,101121963666,2,2487,1709,-10
101124521107,101124521105,-2,1243,1446,-10
101128093306,101128093313,7,1717,1428,-10
101128624759,101128624762,3,1577,1691,-10
101132830953,101132830954,1,1356,1398,-10
101136998280,101136998282,2,1728,1592,-10
101145479650,101145479654,4,1652,1647,-10
101146014681,101146014682,1,1465,1422,-10
101146051276,101146051280,4,1274,1566,-10
101146456136,101146456138,2,1229,1303,-10
101148851339,101148851335,-4,1106,1482,-10
101150619987,101150619991,4,1408,1742,-10
101151601453,101151601453,0,1817,1931,-10
101152172618,101152172619,1,1454,1434,-10
101153717259,101153717264,5,1373,1015,-10
101154175176,101154175179,3,1499,1818,-10
101154811265,101154811266,1,1759,1482,-10
101158124046,101158124050,4,1808,1701,-10
101158914839,101158914838,-1,1693,2046,-10
101164811758,101164811762,4,1527,1452,-10
101167229740,101167229743,3,1821,1148,-10
101167997196,101167997195,-1,594,1048,-10
101168574039,101168574042,3,2913,1279,-10
101169162773,101169162774,1,1503,1118,-10
101171053301,101171053301,0,1097,1300,-10
101171946654,101171946657,3,646,958,-10
101173014703,101173014706,3,2038,2242,-10
101173065310,101173065310,0,1090,1309,-10
101174104434,101174104435,1,1460,1286,-10
101174679098,101174679100,2,1210,1191,-10
101178077415,101178077418,3,1556,1610,-10
101178581321,101178581323,2,1784,1808,-10
101181408512,101181408511,-1,1422,2156,-10
101188077400,101188077398,-2,1252,1794,-10
101188205489,101188205490,1,2090,2254,-10
101189291335,101189291330,-5,9,985,-10
101190809616,101190809618,2,2740,1719,-10
101194107306,101194107306,0,2066,2012,-10
101196765778,101196765779,1,2045,1922,-10
101197255829,101197255834,5,1818,1146,-10
101198438703,101198438706,3,1488,1419,-10
101200599830,101200599831,1,1961,1268,-10
101201038894,101201038895,1,1611,1625,-10
101205099193,101205099187,-6,1505,3777,-10
101205497501,101205497502,1,1684,2055,-10
101206336911,101206336914,3,1321,1593,-10
101208293842,101208293846,4,1757,1200,-10
101208788415,101208788418,3,1452,1660,-10
101220214218,101220214219,1,1591,1969,-10
101220656201,101220656207,6,2191,1133,-10
101221745713,101221745715,2,1533,1565,-10
101222200891,101222200874,-17,1330,1357,-10
101224716882,101224716884,2,1208,1479,-10
101226103190,101226103190,0,1239,1575,-10
101229646923,101229646901,-22,1762,1863,-10
101229881270,101229881272,2,1686,1246,-10
101231800319,101231800321,2,1400,1207,-10
101232164681,101232164682,1,1110,1132,-10
101233029276,101233029278,2,1378,1030,-10
101236723597,101236723599,2,2151,2979,-10
101238681731,101238681734,3,1705,1470,-10
101240353026,101240353026,0,1712,1752,-10
101240430349,101240430350,1,1162,1216,-10
101240763262,101240763266,4,1993,1452,-10
101242888337,101242888338,1,1167,1300,-10
101245657103,101245657106,3,927,1109,-10
101249606533,101249606535,2,1756,1265,-10
101252949925,101252949929,4,2163,1387,-10
101254233117,101254233124,7,16412,6504,-10
101258459389,101258459392,3,16829,47591,-10
101261541478,101261541477,-1,1547,1694,-10
101261652262,101261652267,5,3125,1604,-10
101262085066,101262085069,3,1740,1641,-10
101262607301,101262607304,3,1172,1367,-10
101273975720,101273975721,1,1497,1930,-10
101276843551,101276843550,-1,1770,1154,-10
101278127522,101278127523,1,1311,1653,-10
101279359095,101279359097,2,2092,2143,-10
101285304981,101285304981,0,1719,1781,-10
101287234225,101287234226,1,1998,2408,-10
101289687278,101289687283,5,2051,1080,-10
101290002369,101290002384,15,1350,856,-10
101290264073,101290264074,1,1780,1782,-10
101292238509,101292238510,1,1645,1238,-10
101293868681,101293868683,2,1492,1562,-10
101295604091,101295604090,-1,1027,1314,-10
101295838736,101295838740,4,1416,1763,-10
101297456691,101297456693,2,1322,1404,-10
101299855613,101299855615,2,1465,1236,-10
101301391249,101301391248,-1,1061,1609,-10
101302907230,101302907233,3,2189,1609,-10
101303199435,101303199439,4,1354,952,-10
101306574646,101306574646,0,1236,1512,-10
101307453643,101307453643,0,1282,1507,-10
101308846656,101308846658,2,2824,1875,-10
101309887574,101309887578,4,1796,1687,-10
101313102963,101313102964,1,1231,1995,-10
101316807727,101316807726,-1,2249,5642,-10
101317874255,101317874258,3,1013,1053,-10
101319107818,101319107819,1,1806,1460,-10
101319288974,101319288977,3,1291,1413,-10
101322069870,101322069871,1,2066,1170,-10
101322448052,101322448054,2,2101,1699,-10
101323412170,101323412170,0,1038,1336,-10
101328061035,101328061032,-3,860,2534,-10
101337900911,101337900912,1,1246,1090,-10
101340566234,101340566238,4,1559,1633,-10
101346201770,101346201772,2,1798,1806,-10
101346946746,101346946746,0,1017,1593,-10
101347930734,101347930742,8,3042,1477,-10
101350070709,101350070712,3,1358,1664,-10
101350722154,101350722154,0,1338,2140,-10
101350766739,101350766741,2,1930,1332,-10
101351549470,101351549474,4,1845,1891,-10
101352103888,101352103893,5,1833,1035,-10
101358028222,101358028225,3,1361,1388,-10
101358525914,101358525914,0,1010,1634,-10
101367676846,101367676847,1,1418,1516,-10
101368232527,101368232525,-2,849,2087,-10
101368601399,101368601400,1,1644,1978,-10
101371789501,101371789505,4,1361,1670,-10
101373953320,101373953319,-1,1220,1599,-10
101378525223,101378525222,-1,1148,1841,-10
101387902622,101387902625,3,1285,1785,-10
101389943714,101389943715,1,1242,1602,-10
101392986925,101392986923,-2,1641,1941,-10
101393461852,101393461850,-2,2496,3481,-10
101394299138,101394299137,-1,1321,1713,-10
101396942690,101396942689,-1,1355,1993,-10
101399254682,101399254689,7,1684,1518,-10
101399433727,101399433729,2,2107,2172,-10
101400359413,101400359414,1,1239,1408,-10
101400800097,101400800098,1,1957,2464,-10
101401514850,101401514851,1,1168,1239,-10
101403768931,101403768928,-3,803,1820,-10
101407482415,101407482417,2,1832,1562,-10
101407809135,101407809136,1,1757,2294,-10
101419611966,101419611970,4,1233,1255,-10
101421643755,101421643758,3,1945,1920,-10
101422085630,101422085633,3,1630,1833,-10
101423542002,101423542005,3,1762,1663,-10
101434037475,101434037478,3,1343,1503,-10
101434597725,101434597729,4,1981,1870,-10
101434697830,101434697830,0,1248,1619,-10
101436796470,101436796471,1,1542,1639,-10
101439881541,101439881543,2,953,1737,-10
101441272351,101441272363,12,9457,42779,-10
101445135686,101445135688,2,1144,1272,-10
101447189855,101447189858,3,1484,1652,-10
101450945042,101450945043,1,1533,1202,-10
101453565128,101453565131,3,1651,1715,-10
101455659816,101455659817,1,1327,1154,-10
101464391653,101464391655,2,2016,1663,-10
101466737494,101466737493,-1,1457,2519,-10
101466918174,101466918174,0,1475,1588,-10
101467599826,101467599829,3,1973,1695,-10
101467980223,101467980227,4,2883,1218,-10
101468169466,101468169467,1,1317,1148,-10
101468708372,101468708374,2,2591,1955,-10
101471479875,101471479877,2,1137,1070,-10
101476478749,101476478750,1,1841,1804,-10
101478487920,101478487921,1,2088,1960,-10
101478547952,101478547953,1,1107,1213,-10
101479969194,101479969203,9,1094,1220,-10
101480762726,101480762727,1,971,889,-10
101483030943,101483030942,-1,1511,2547,-10
101483562728,101483562729,1,1877,1228,-10
101492682142,101492682143,1,1910,1808,-10
101493397717,101493397721,4,1735,1868,-10
101493778397,101493778400,3,1695,1561,-10
101498036260,101498036261,1,1361,1296,-10
101502863877,101502863882,5,1703,1284,-10
101504439534,101504439555,21,1151,1423,-10
101505385529,101505385534,5,1717,1338,-10
101505449268,101505449269,1,3954,4606,-10
101507364358,101507364358,0,1803,1512,-10
101509418434,101509418435,1,1428,1488,-10
101511415954,101511415958,4,1536,1293,-10
101511926962,101511926962,0,1712,2163,-10
101512394569,101512394573,4,1856,1462,-10
101513382926,101513382927,1,2224,1810,-10
101518466358,101518466351,-7,1296,5172,-10
101520050231,101520050233,2,1028,1234,-10
101520670724,101520670726,2,1408,1823,-10
101524733722,101524733723,1,1519,1231,-10
101525163680,101525163682,2,1248,1465,-10
101525657396,101525657399,3,2103,1411,-10
101526203517,101526203519,2,2129,1222,-10
101527603653,101527603652,-1,1581,1296,-10
101527723874,101527723878,4,1827,1336,-10
101528410045,101528410046,1,1800,1670,-10
101528663855,101528663855,0,1407,1782,-10
101529321352,101529321356,4,1481,1110,-10
101530526942,101530526945,3,1407,1241,-10
101533698345,101533698326,-19,1119,1425,-10
101534339924,101534339927,3,1872,1675,-10
101538339872,101538339877,5,41053,26880,-10
101538537131,101538537132,1,991,1567,-10
101540853267,101540853267,0,1194,1024,-10
101542396796,101542396798,2,1899,1495,-10
101544888985,101544888986,1,1492,972,-10
101552017172,101552017175,3,1980,1401,-10
101557305293,101557305293,0,1912,2013,-10
101557359218,101557359217,-1,1592,1379,-10
101558272527,101558272525,-2,1628,1485,-10
101566554350,101566554352,2,2061,1878,-10
101572258151,101572258152,1,571,830,-10
101574388379,101574388381,2,1687,1520,-10
101579187924,101579187925,1,1605,1862,-10
101580585914,101580585913,-1,1053,1901,-10
101588209639,101588209642,3,1420,1629,-10
101596880385,101596880387,2,1444,1407,-10
101598709208,101598709211,3,2324,1645,-10
101602104333,101602104334,1,2287,2397,-10
101610037354,101610037356,2,1071,1392,-10
101611449372,101611449375,3,2035,1400,-10
101615623846,101615623849,3,692,842,-10
101616886864,101616886867,3,1270,1454,-10
101618653232,101618653230,-2,2576,4035,-10
101620920245,101620920246,1,1397,1240,-10
101622422766,101622422769,3,1742,1849,-10
101625604780,101625604781,1,1357,1641,-10
101627652302,101627652303,1,1260,1114,-10
101628020204,101628020206,2,1534,1658,-10
101630434228,101630434233,5,259,710,-10
101632453577,101632453579,2,1064,1449,-10
101633049882,101633049887,5,1288,1242,-10
101633571014,101633571016,2,1518,967,-10
101634278286,101634278290,4,1155,1489,-10
101634587237,101634587238,1,1392,1249,-10
101642334482,101642334486,4,1059,641,-10
101644063499,101644063502,3,2006,1710,-10
101647159457,101647159457,0,1790,1662,-10
101651742455,101651742457,2,1280,1450,-10
101652773995,101652773998,3,1799,2160,-10
101653810341,101653810343,2,1651,1621,-10
101655176852,101655176854,2,2064,1402,-10
101657309566,101657309568,2,1856,1812,-10
101658586538,101658586530,-8,1829,7501,-10
101665561615,101665561618,3,1949,1510,-10
101669185009,101669185011,2,1399,1112,-10
101670212194,101670212195,1,1873,2126,-10
101672472157,101672472158,1,1227,1047,-10
101673998174,101673998174,0,1155,1105,-10
101677202799,101677202798,-1,1405,1644,-10
101678336217,101678336217,0,1773,1391,-10
101678936272,101678936273,1,1288,1383,-10
101679556485,101679556483,-2,1540,2687,-10
101679837389,101679837390,1,1502,1608,-10
101687330657,101687330658,1,1341,1374,-10
101687918762,101687918763,1,1346,1484,-10
101689325058,101689325059,1,1509,1261,-10
101690450445,101690450465,20,1279,1508,-10
101702236795,101702236799,4,1322,1660,-10
101703933237,101703933239,2,1680,1148,-10
101706274005,101706274006,1,1205,876,-10
101708845114,101708845115,1,1194,1632,-10
101708910794,101708910799,5,1785,1247,-10
101709196597,101709196600,3,2215,1481,-10
101709488045,101709488047,2,1495,1433,-10
101709650689,101709650709,20,2330,6944,-10
101712609857,101712609856,-1,1087,1807,-10
101717846236,101717846238,2,1999,1506,-10
101719727393,101719727394,1,1593,1689,-10
101720732001,101720732001,0,34523,42362,-10
101723627178,101723627181,3,1227,1733,-10
101723922066,101723922067,1,1393,2048,-10
101725738971,101725738973,2,1176,897,-10
101729551166,101729551167,1,2053,2185,-10
101729855030,101729855031,1,1861,1139,-10
101732493394,101732493395,1,1733,1742,-10
101737611365,101737611366,1,1804,1684,-10
101738931345,101738931345,0,1102,1771,-10
101739801367,101739801367,0,1462,1712,-10
101743733027,101743733031,4,1713,1590,-10
101744136286,101744136287,1,928,968,-10
101744212978,101744212981,3,1277,1124,-10
101748668808,101748668808,0,2010,1734,-10
101752131190,101752131193,3,1204,1004,-10
101758769398,101758769402,4,1321,1367,-10
101759768195,101759768195,0,1504,1650,-10
101763165926,101763165927,1,1589,1983,-10
101768289689,101768289691,2,13403,12245,-10
101768849243,101768849238,-5,1347,4035,-10
101769395873,101769395874,1,35260,32995,-10
101771488763,101771488766,3,1607,1338,-10
101776483561,101776483563,2,1174,1265,-10
101781618462,101781618463,1,1337,1055,-10
101784552859,101784552858,-1,1610,1893,-10
101784845103,101784845105,2,852,869,-10
101785486395,101785486394,-1,1714,1741,-10
101785735755,101785735760,5,719,690,-10
101787462983,101787462985,2,1349,1420,-10
101787764766,101787764768,2,1679,1566,-10
101788017714,101788017714,0,1019,1101,-10
101791264125,101791264126,1,1917,1388,-10
101793512402,101793512382,-20,1804,1700,-10
101793800779,101793800782,3,2094,1554,-10
101793920573,101793920575,2,1330,1380,-10
101794504589,101794504589,0,1862,2032,-10
101794721099,101794721102,3,1579,1463,-10
101799934750,101799934750,0,1265,1228,-10
101800982091,101800982091,0,1194,1476,-10
101805986103,101805986106,3,1481,1750,-10
101808270978,101808270980,2,1602,1334,-10
101809776947,101809776949,2,2270,1866,-10
101816136215,101816136217,2,1831,1033,-10
101817026602,101817026603,1,2393,2331,-10
101817732632,101817732633,1,1876,1901,-10
101819645180,101819645184,4,1478,1282,-10
101821424029,101821424033,4,2182,1687,-10
101823401008,101823401010,2,2927,2109,-10
101824284101,101824284103,2,1340,1398,-10
101827725423,101827725427,4,1462,1086,-10
101832785785,101832785785,0,1788,1211,-10
101836461330,101836461331,1,1643,1525,-10
101838720668,101838720671,3,2059,1595,-10
101839112206,101839112210,4,1242,1179,-10
101846011235,101846011237,2,1419,1135,-10
101846840979,101846840981,2,1303,1468,-10
101847419887,101847419890,3,1541,1727,-10
101851699879,101851699879,0,2293,2042,-10
101852929723,101852929725,2,1184,1332,-10
101854476375,101854476377,2,2229,1779,-10
101858011259,101858011258,-1,1893,3018,-10
101860322298,101860322298,0,1766,2112,-10
101862025187,101862025190,3,1210,983,-10
101864888930,101864888931,1,1398,1249,-10
101865360497,101865360506,9,1785,1603,-10
101867000812,101867000816,4,1579,1483,-10
101867047614,101867047594,-20,1403,1019,-10
101868013102,101868013103,1,1593,1381,-10
101870625638,101870625641,3,1673,1175,-10
101871897603,101871897604,1,1945,1377,-10
101874384749,101874384749,0,1460,1287,-10
101875439075,101875439077,2,843,1041,-10
101876998286,101876998285,-1,822,1806,-10
101877097719,101877097722,3,1582,1373,-10
101878164523,101878164519,-4,1012,2498,-10
101881530322,101881530322,0,1340,1267,-10
101888079887,101888079889,2,1821,1546,-10
101889357278,101889357279,1,1218,1142,-10
101890964949,101890964950,1,1449,1530,-10
101891049406,101891049406,0,1585,1643,-10
101892281830,101892281834,4,2162,1393,-10
101893047651,101893047649,-2,1111,1727,-10
101894639803,101894639806,3,1848,1549,-10
101897299903,101897299903,0,1085,1254,-10
101898421213,101898421214,1,1386,1589,-10
101899789167,101899789170,3,2100,1617,-10
101900241169,101900241171,2,1413,1452,-10
101900441277,101900441279,2,1625,1944,-10
101902224498,101902224493,-5,2105,7009,-10
101903663559,101903663562,3,2710,1380,-10
101906776762,101906776763,1,1848,1219,-10
101909250530,101909250530,0,1701,2371,-10
101909608248,101909608245,-3,22050,16490,-10
101913924995,101913924996,1,1676,1864,-10
101913951553,101913951546,-7,16434,19138,-10
101914535114,101914535114,0,1267,1684,-10
101915522520,101915522518,-2,1099,2142,-10
101923293774,101923293774,0,1597,2078,-10
101925062377,101925062378,1,1710,1351,-10
101928911930,101928911931,1,1245,1173,-10
101929252407,101929252411,4,11272,7204,-10
101930572770,101930572771,1,1714,1839,-10
101931157810,101931157812,2,1791,1731,-10
101931932111,101931932112,1,1982,1915,-10
101936001814,101936001816,2,1048,1285,-10
101937755590,101937755591,1,1549,1273,-10
101939040374,101939040376,2,1613,1812,-10
101942864029,101942864035,6,1421,1300,-10
101943099614,101943099614,0,1272,1318,-10
101945847815,101945847817,2,1930,2018,-10
101946395382,101946395380,-2,1371,1672,-10
101948172508,101948172510,2,1671,1246,-10
101949789977,101949789979,2,1978,1654,-10
101952765050,101952765052,2,1308,1652,-10
101953706163,101953706161,-2,766,1267,-10
101959093758,101959093759,1,1410,1738,-10
101962092565,101962092566,1,1296,2053,-10
101963437296,101963437311,15,243,830,-10
101963955695,101963955695,0,1499,1717,-10
101972182821,101972182822,1,1678,2033,-10
101974267575,101974267577,2,2147,1655,-10
101974799636,101974799639,3,1391,1145,-10
101975045105,101975045108,3,2017,1955,-10
101976973425,101976973426,1,882,1366,-10
101979167113,101979167114,1,1639,1684,-10
101983800623,101983800630,7,4605,2258,-10
101984147674,101984147652,-22,1901,1751,-10
101987181477,101987181479,2,1763,1767,-10
101991708152,101991708154,2,1855,1360,-10
101991763827,101991763828,1,1887,1919,-10
101992444781,101992444782,1,1308,1620,-10
101999171817,101999171818,1,1381,1142,-10
102000091306,102000091307,1,1865,1638,-10
102001056482,102001056486,4,722,1003,-10
102004992536,102004992537,1,1589,1434,-10
102005831018,102005831021,3,1532,2073,-10
102005950578,102005950581,3,1655,1556,-10
102008120827,102008120826,-1,1315,2091,-10
102008382674,102008382676,2,1712,1799,-10
102010719789,102010719787,-2,895,1569,-10
102011937370,102011937373,3,993,1063,-10
102012724921,102012724918,-3,1705,2930,-10
102013139590,102013139591,1,1465,1118,-10
102014945337,102014945338,1,1455,1869,-10
102015071783,102015071794,11,1413,1117,-10
102016309302,102016309304,2,1730,1075,-10
102017472235,102017472236,1,1411,1742,-10
102020014749,102020014751,2,1524,1577,-10
102021674401,102021674403,2,1209,1562,-10
102022617722,102022617724,2,1256,1080,-10
102024679747,102024679749,2,1310,1502,-10
102025985229,102025985234,5,2667,1974,-10
102032911789,102032911791,2,1853,2016,-10
102033153593,102033153597,4,2109,2215,-10
102034111611,102034111614,3,1932,1410,-10
102036703784,102036703786,2,1223,1231,-10
102041593368,102041593370,2,1518,1504,-10
102042315236,102042315238,2,2246,2056,-10
102045623917,102045623918,1,1624,1532,-10
102048905330,102048905330,0,1973,1977,-10
102052795045,102052795047,2,1668,2120,-10
102056876115,102056876117,2,1557,1233,-10
102056985983,102056985985,2,1567,1620,-10
102059417707,102059417709,2,1623,1388,-10
102061899235,102061899237,2,1424,1302,-10
102065905606,102065905609,3,2443,2026,-10
102066422777,102066422780,3,1827,1400,-10
102070844689,102070844694,5,4147,2750,-10
102071819318,102071819324,6,1015,1003,-10
102072521185,102072521186,1,1175,1063,-10
102075021458,102075021462,4,4280,2417,-10
102078472464,102078472466,2,2106,1586,-10
102086268898,102086268898,0,1288,1516,-10
102087337282,102087337285,3,1057,1282,-10
102088305569,102088305568,-1,1295,2419,-10
102090500150,102090500153,3,1503,1715,-10
102093869948,102093869950,2,1574,1171,-10
102094717956,102094717958,2,1274,1852,-10
102098121121,102098121123,2,1601,1802,-10
102098889702,102098889705,3,2004,1439,-10
102099602178,102099602181,3,1415,1185,-10
102099690362,102099690377,15,1042,972,-10
102100352938,102100352941,3,1795,1374,-10
102100713063,102100713062,-1,1899,1707,-10
102101022465,102101022466,1,1235,1256,-10
102103191819,102103191822,3,1814,1406,-10
102109220538,102109220538,0,1475,1949,-10
102110331504,102110331506,2,1345,1066,-10
102111090101,102111090102,1,1681,1711,-10
102111160595,102111160594,-1,3845,4975,-10
102113298071,102113298070,-1,1986,1669,-10
102114901435,102114901436,1,1414,1706,-10
102115900750,102115900755,5,1723,1942,-10
102119091651,102119091653,2,1219,1328,-10
102119296098,102119296100,2,1341,1546,-10
102120573658,102120573662,4,1696,1502,-10
102122456563,102122456563,0,1610,1590,-10
102123125495,102123125497,2,1505,1516,-10
102130258158,102130258159,1,14733,6119,-10
102131259426,102131259428,2,2013,1435,-10
102136884149,102136884150,1,1495,1780,-10
102137105138,102137105141,3,876,1491,-10
102138756013,102138756015,2,1392,1243,-10
102139080920,102139080924,4,1899,1431,-10
102140296698,102140296701,3,1382,1581,-10
102142066230,102142066231,1,1673,1982,-10
102143354715,102143354714,-1,2095,2007,-10
102144652978,102144652978,0,1846,1641,-10
102144851362,102144851364,2,1542,1769,-10
102150191241,102150191243,2,1493,1462,-10
102155676998,102155677003,5,942,1307,-10
102156953694,102156953696,2,1361,1325,-10
102157689133,102157689136,3,1657,1075,-10
102157722910,102157722912,2,1864,1925,-10
102158710537,102158710538,1,2125,1586,-10
102160345650,102160345652,2,1964,1423,-10
102163010806,102163010800,-6,1639,7969,-10
102175958333,102175958334,1,1915,2258,-10
102176372686,102176372690,4,1464,997,-10
102179024557,102179024559,2,2243,1679,-10
102180429110,102180429113,3,1458,1756,-10
102181796654,102181796655,1,1887,1669,-10
102182936387,102182936370,-17,1785,2819,-10
102187221816,102187221818,2,2086,1745,-10
102189658225,102189658227,2,1959,2282,-10
102190144204,102190144207,3,2200,1594,-10
102190873277,102190873296,19,425,203,-10
102194819146,102194819147,1,1165,1748,-10
102195058919,102195058915,-4,1177,2257,-10
102197177536,102197177539,3,1948,1620,-10
102198231741,102198231742,1,1518,1712,-10
102205324549,102205324548,-1,1452,1342,-10
102206282791,102206282792,1,981,986,-10
102208317353,102208317355,2,1723,2122,-10
102221307369,102221307370,1,1615,1595,-10
102221948571,102221948572,1,1113,1229,-10
102224394599,102224394601,2,1032,1313,-10
102226826405,102226826406,1,1378,1588,-10
102227691791,102227691791,0,1907,1641,-10
102227903453,102227903453,0,2285,2023,-10
102228140674,102228140675,1,1372,1092,-10
102236571462,102236571470,8,21909,54395,-10
102237260546,102237260549,3,1298,1420,-10
102237526542,102237526545,3,2060,2040,-10
102237583170,102237583171,1,1407,1532,-10
102239383843,102239383830,-13,940,1136,-10
102246493469,102246493470,1,1557,1662,-10
102249458638,102249458638,0,1793,1446,-10
102252834003,102252834004,1,1711,2081,-10
102253138376,102253138380,4,2999,1661,-10
102254337654,102254337655,1,1712,1661,-10
102256183027,102256183029,2,1028,1620,-10
102258376688,102258376689,1,1603,1602,-10
102258803710,102258803690,-20,1079,263,-10
102258962103,102258962107,4,1463,1516,-10
102260273798,102260273802,4,1550,1526,-10
102261640644,102261640647,3,2243,1113,-10
102262786843,102262786838,-5,1178,1415,-10
102268536540,102268536542,2,1932,1786,-10
102270622821,102270622823,2,1278,1427,-10
102271424866,102271424859,-7,1460,5263,-10
102271993811,102271993812,1,1499,2217,-10
102273332711,102273332711,0,1842,2048,-10
102280965448,102280965450,2,1355,1350,-10
102281604991,102281604995,4,1453,1159,-10
102282787205,102282787207,2,1455,1092,-10
102290917198,102290917202,4,1594,1752,-10
102291018861,102291018842,-19,1188,790,-10
102291836352,102291836355,3,1677,1547,-10
102292491852,102292491854,2,1324,1418,-10
102296716186,102296716190,4,1897,1965,-10
102300761998,102300762001,3,1546,1675,-10
102304142598,102304142596,-2,1288,2240,-10
102308727099,102308727101,2,1491,1267,-10
102308947910,102308947923,13,2187,1029,-10
102309332294,102309332298,4,1810,1770,-10
102310039750,102310039753,3,1773,1766,-10
102310806441,102310806443,2,1628,1508,-10
102312858169,102312858171,2,2146,1581,-10
102313415586,102313415585,-1,29948,22802,-10
102316016604,102316016607,3,1978,1563,-10
102317304822,102317304822,0,1245,1325,-10
102317880701,102317880702,1,1600,1620,-10
102318132558,102318132561,3,931,951,-10
102321959509,102321959517,8,156,8189,-10
102324207135,102324207136,1,1705,1827,-10
102324492294,102324492299,5,1610,1732,-10
102324983681,102324983682,1,1657,1806,-10
102325134299,102325134293,-6,1733,4361,-10
102326716840,102326716842,2,1709,1457,-10
102329098206,102329098207,1,904,1030,-10
102330286613,102330286615,2,1841,1249,-10
102331274746,102331274749,3,1344,1265,-10
102332975042,102332975045,3,1625,1840,-10
102333599665,102333599665,0,1594,1673,-10
102338016875,102338016881,6,1954,1579,-10
102339561261,102339561262,1,2338,2068,-10
102340187718,102340187719,1,1569,1008,-10
102345814946,102345814947,1,2269,1950,-10
102350190780,102350190781,1,1525,1609,-10
102350562409,102350562411,2,1801,1554,-10
102351294068,102351294071,3,882,1062,-10
102355611041,102355611041,0,1425,1170,-10
102358959593,102358959595,2,1317,1356,-10
102359152954,102359152954,0,1197,1986,-10
102360037035,102360037035,0,1840,1612,-10
102360858739,102360858741,2,1884,1745,-10
102361085311,102361085315,4,2482,1006,-10
102362810157,102362810159,2,1271,1479,-10
102364823330,102364823330,0,1179,1663,-10
102375192458,102375192460,2,1822,1179,-10
102376637315,102376637318,3,1456,1571,-10
102376729906,102376729906,0,553,1367,-10
102383803203,102383803204,1,2206,1909,-10
102384810551,102384810554,3,1685,1468,-10
102385005589,102385005591,2,1619,1641,-10
102385063747,102385063748,1,1674,1424,-10
102385255896,102385255915,19,294,743,-10
102392246947,102392246957,10,1394,1426,-10
102394091233,102394091225,-8,796,3377,-10
102394806482,102394806486,4,2265,1817,-10
102395703499,102395703499,0,1002,1432,-10
102397303726,102397303726,0,1836,2291,-10
102398133057,102398133058,1,1205,1970,-10
102398213195,102398213187,-8,786,1030,-10
102403185910,102403185910,0,1434,1066,-10
102409789690,102409789691,1,2144,1506,-10
102410385422,102410385424,2,953,1478,-10
102410777584,102410777587,3,2394,1705,-10
102410858789,102410858791,2,1523,956,-10
102410986724,102410986724,0,1276,1351,-10
102413402594,102413402597,3,1305,1881,-10
102416239163,102416239165,2,1636,1580,-10
102417133145,102417133151,6,3186,967,-10
102417494960,102417494962,2,1222,1906,-10
102418187138,102418187141,3,1735,1404,-10
102419033807,102419033807,0,1377,1669,-10
102419632339,102419632340,1,1335,1441,-10
102425647430,102425647433,3,2380,1699,-10
102426597172,102426597174,2,1377,1366,-10
102427482689,102427482691,2,826,1417,-10
102427630790,102427630797,7,2311,1209,-10
102428842941,102428842940,-1,28094,21215,-10
102429530415,102429530410,-5,1222,3702,-10
102429789751,102429789754,3,2149,2093,-10
102430864147,102430864150,3,1881,1715,-10
102436326130,102436326132,2,1385,1560,-10
102439089535,102439089540,5,921,951,-10
102439817355,102439817338,-17,1831,1207,-10
102440694614,102440694614,0,1249,2222,-10
102443075723,102443075726,3,1315,1303,-10
102444970649,102444970652,3,1264,1893,-10
102448216563,102448216564,1,1173,1484,-10
102448831447,102448831450,3,1291,997,-10
102449384673,102449384675,2,1840,1524,-10
102452287419,102452287419,0,1890,2352,-10
102452973201,102452973203,2,1445,1638,-10
102453243609,102453243598,-11,1267,1368,-10
102454084955,102454084949,-6,1288,1201,-10
102456889328,102456889327,-1,1085,896,-10
102466235096,102466235099,3,1565,1411,-10
102468085197,102468085198,1,1737,1146,-10
102469042325,102469042321,-4,1552,1553,-10
102469401413,102469401418,5,58519,30043,-10
102469702116,102469702126,10,1285,1454,-10
102470355631,102470355634,3,1656,2047,-10
102471740695,102471740696,1,1883,2121,-10
102472870537,102472870539,2,1431,1739,-10
102473315362,102473315363,1,1910,1367,-10
102473921662,102473921661,-1,1730,1375,-10
102475399433,102475399435,2,1735,1260,-10
102478887520,102478887521,1,1340,1705,-10
102485569364,102485569366,2,1069,960,-10
102486901676,102486901679,3,1845,1807,-10
102487687413,102487687417,4,3105,1299,-10
102488682582,102488682584,2,1579,1922,-10
102491213405,102491213407,2,1220,1078,-10
102492409412,102492409417,5,1371,1372,-10
102493986946,102493986949,3,1696,2079,-10
102496156165,102496156167,2,1171,1382,-10
102498374045,102498374047,2,1912,1265,-10
102499394377,102499394379,2,1840,1721,-10
102500120093,102500120096,3,1596,1593,-10
102502705110,102502705114,4,2637,1244,-10
102505212835,102505212839,4,2303,1189,-10
102505716530,102505716530,0,1089,1234,-10
102510838230,102510838234,4,1490,1564,-10
102512811688,102512811699,11,1206,1339,-10
102514552448,102514552449,1,1653,1406,-10
102521548201,102521548203,2,2032,1999,-10
102524889946,102524889948,2,1556,1583,-10
102528639287,102528639290,3,1097,847,-10
102535752615,102535752615,0,1047,908,-10
102538471349,102538471350,1,1139,1149,-10
102541856958,102541856960,2,1419,1265,-10
102541923657,102541923658,1,758,1272,-10
102542692949,102542692951,2,1549,1673,-10
102548074140,102548074137,-3,1463,2507,-10
102555863742,102555863744,2,1084,1415,-10
102557008145,102557008137,-8,1070,3898,-10
102559758777,102559758779,2,2485,2261,-10
102562151982,102562151985,3,2358,1322,-10
102563936725,102563936726,1,1343,1145,-10
102565928611,102565928612,1,1605,1968,-10
102568613516,102568613521,5,2535,1578,-10
102569995493,102569995496,3,2181,1615,-10
102572138661,102572138663,2,1392,1432,-10
102577843966,102577843969,3,1784,1305,-10
102578230481,102578230484,3,1406,1592,-10
102580103711,102580103712,1,1983,1164,-10
102583931278,102583931278,0,1599,1633,-10
102584640926,102584640925,-1,1192,1934,-10
102587823892,102587823885,-7,2249,10171,-10
102592317602,102592317602,0,1956,1957,-10
102593830329,102593830332,3,1530,1368,-10
102595175506,102595175507,1,1647,1799,-10
102599125035,102599125038,3,1313,1346,-10
102599743024,102599743025,1,2022,1466,-10
102599910017,102599910018,1,1253,1828,-10
102602469410,102602469412,2,1316,1358,-10
102602563754,102602563758,4,1047,860,-10
102604229555,102604229556,1,1435,1503,-10
102605116016,102605116017,1,1247,1223,-10
102605277836,102605277835,-1,1271,1438,-10
102606570450,102606570451,1,1227,1684,-10
102606788205,102606788206,1,1790,1513,-10
102607292290,102607292294,4,1034,1141,-10
102608860871,102608860871,0,2303,1855,-10
102609963425,102609963427,2,1544,2199,-10
102611008383,102611008386,3,905,991,-10
102614983230,102614983232,2,2104,1870,-10
102621442446,102621442447,1,1246,1325,-10
102622973366,102622973370,4,2197,1995,-10
102623992068,102623992067,-1,1980,1492,-10
102626052911,102626052907,-4,892,1074,-10
102627029279,102627029282,3,1037,1343,-10
102629929764,102629929766,2,2053,2575,-10
102631621138,102631621138,0,1416,1588,-10
102633356750,102633356751,1,1140,1840,-10
102633770728,102633770730,2,1255,1353,-10
102635060421,102635060422,1,1719,1340,-10
102636530923,102636530927,4,947,980,-10
102637339940,102637339934,-6,2286,7486,-10
102638639384,102638639386,2,1828,1262,-10
102640533822,102640533825,3,1809,1327,-10
102643803150,102643803154,4,1566,660,-10
102643919269,102643919269,0,1200,1942,-10
102645340094,102645340095,1,1648,1903,-10
102648881580,102648881581,1,947,1350,-10
102650255876,102650255878,2,1466,1902,-10
102651930444,102651930446,2,1562,1694,-10
102653488865,102653488867,2,1669,1301,-10
102654487194,102654487197,3,2307,1602,-10
102654546242,102654546256,14,1640,1504,-10
102654931144,102654931165,21,1607,1383,-10
102658751706,102658751707,1,1618,1446,-10
102659195137,102659195154,17,1494,1227,-10
102659780136,102659780139,3,1739,1494,-10
102660343396,102660343397,1,1511,1079,-10
102660694819,102660694823,4,1456,1309,-10
102661446957,102661446949,-8,42588,10082,-10
102664392310,102664392317,7,9150,3229,-10
102665344266,102665344271,5,1997,1531,-10
102666739694,102666739702,8,5134,2412,-10
102667257957,102667257959,2,1206,2073,-10
102670216529,102670216532,3,2443,1644,-10
102672668910,102672668914,4,1132,1480,-10
102675875970,102675875971,1,1431,1263,-10
102680673716,102680673718,2,1961,1452,-10
102680943892,102680943895,3,1882,1197,-10
102685856214,102685856217,3,1800,1552,-10
102687057115,102687057093,-22,1595,1838,-10
102690992388,102690992389,1,1671,1585,-10
102691577626,102691577628,2,1578,1522,-10
102692002037,102692002037,0,1951,1676,-10
102693202039,102693202037,-2,1717,2500,-10
102694116879,102694116883,4,1286,1702,-10
102694227345,102694227346,1,1685,1594,-10
102696834660,102696834661,1,1374,1703,-10
102700988323,102700988325,2,1056,936,-10
102702777401,102702777404,3,1943,1302,-10
102710383938,102710383940,2,2021,1378,-10
102715747307,102715747305,-2,1596,2894,-10
102719578062,102719578062,0,2277,2443,-10
102720576598,102720576603,5,1365,1175,-10
102726689305,102726689310,5,1783,1493,-10
102727844621,102727844621,0,1413,1898,-10
102732121639,102732121642,3,1117,864,-10
102735883511,102735883512,1,1572,1645,-10
102736141250,102736141252,2,1823,1592,-10
102736730554,102736730557,3,1854,1733,-10
102737045693,102737045694,1,1633,1520,-10
102739482863,102739482866,3,1698,1661,-10
102742168991,102742168995,4,1648,1687,-10
102747279946,102747279950,4,2179,1269,-10
102749003159,102749003162,3,1994,1674,-10
102749030303,102749030306,3,2170,1278,-10
102750337950,102750337953,3,796,1003,-10
102752691282,102752691286,4,956,1291,-10
102753463133,102753463134,1,3105,2821,-10
102757079380,102757079379,-1,1503,1524,-10
102757243747,102757243749,2,1491,1923,-10
102757784790,102757784782,-8,2123,6430,-10
102758922123,102758922125,2,1870,1538,-10
102762480135,102762480137,2,1203,1651,-10
102767557505,102767557507,2,2047,1753,-10
102768729877,102768729878,1,1898,2337,-10
102769738526,102769738525,-1,1298,1659,-10
102777336317,102777336319,2,1212,1294,-10
102779676758,102779676759,1,1770,1213,-10
102783011214,102783011215,1,1628,2015,-10
102785541130,102785541133,3,2746,1989,-10
102787278222,102787278223,1,1640,1402,-10
102787384153,102787384154,1,1461,1142,-10
102788817259,102788817262,3,1660,1534,-10
102788968642,102788968645,3,1483,1485,-10
102790634537,102790634539,2,1779,1849,-10
102790879622,102790879623,1,1056,1329,-10
102790993110,102790993110,0,1753,1821,-10
102793842444,102793842447,3,1734,1427,-10
102795077897,102795077896,-1,1620,1446,-10
102798798802,102798798807,5,1670,1759,-10
102802515257,102802515258,1,1465,1377,-10
102806225988,102806225989,1,1379,1167,-10
102810137955,102810137957,2,1460,1348,-10
102814157250,102814157254,4,2349,2050,-10
102818984818,102818984821,3,1541,1582,-10
102819803727,102819803738,11,1379,1060,-10
102821114406,102821114409,3,1893,1729,-10
102823275759,102823275763,4,1249,1184,-10
102824903211,102824903210,-1,1333,1675,-10
102826152135,102826152126,-9,27390,17649,-10
102826602281,102826602283,2,2300,2007,-10
102828039654,102828039657,3,1435,1680,-10
102833305493,102833305496,3,1333,1675,-10
102833548260,102833548273,13,4,941,-10
102833923153,102833923154,1,1208,1041,-10
102835236226,102835236229,3,1978,1757,-10
102835705359,102835705360,1,1621,1178,-10
102836054826,102836054821,-5,1796,6462,-10
102843467544,102843467546,2,1179,888,-10
102844666229,102844666230,1,2099,1352,-10
102851605687,102851605689,2,1696,2193,-10
102853345296,102853345302,6,2158,2537,-10
102857951647,102857951650,3,1851,1814,-10
102858611680,102858611682,2,1232,2002,-10
102866234799,102866234799,0,1001,1610,-10
102873550125,102873550127,2,1207,1390,-10
102876014854,102876014854,0,1757,2099,-10
102876421611,102876421613,2,1405,1246,-10
102877935802,102877935805,3,1632,1080,-10
102881486250,102881486251,1,2435,2467,-10
102881754067,102881754067,0,1456,1540,-10
102882827750,102882827754,4,925,1182,-10
102883622861,102883622863,2,1264,1203,-10
102883981111,102883981110,-1,1144,1224,-10
102885759243,102885759251,8,1896,1518,-10
102886988297,102886988298,1,1724,1658,-10
102887980983,102887980984,1,1190,1130,-10
102891895618,102891895618,0,1843,1766,-10
102891931940,102891931941,1,1864,1439,-10
102893870834,102893870835,1,1640,947,-10
102894850272,102894850274,2,655,627,-10
102897945191,102897945186,-5,1107,3436,-10
102902108983,102902108986,3,1862,1479,-10
102902263846,102902263847,1,1230,1529,-10
102903664493,102903664495,2,1819,1368,-10
102904090073,102904090073,0,1220,1081,-10
102910366857,102910366862,5,1799,1298,-10
102913317178,102913317169,-9,1676,1672,-10
102916126213,102916126217,4,1372,1835,-10
102920641209,102920641210,1,1662,2379,-10
102923749759,102923749761,2,1486,1312,-10
102929728204,102929728207,3,1813,1274,-10
102931402490,102931402493,3,1626,1477,-10
102933940733,102933940735,2,1713,2086,-10
102934469408,102934469410,2,1772,1179,-10
102934651245,102934651256,11,1709,1859,-10
102936171713,102936171714,1,1476,1293,-10
102937096312,102937096321,9,335,917,-10
102939171919,102939171922,3,1675,1549,-10
102947310782,102947310789,7,1775,1156,-10
102955369610,102955369611,1,1907,1936,-10
102957420528,102957420530,2,1272,1039,-10
102957575066,102957575067,1,1747,2021,-10
102959422106,102959422107,1,1440,1587,-10
102959867658,102959867657,-1,3415,3749,-10
102960746394,102960746396,2,1101,1557,-10
102962727681,102962727682,1,1462,1595,-10
102962996382,102962996382,0,1440,1658,-10
102964077059,102964077061,2,1437,1338,-10
102964440835,102964440837,2,1934,1233,-10
102965601863,102965601865,2,1425,1368,-10
102969574526,102969574521,-5,1174,6083,-10
102972826515,102972826514,-1,1056,926,-10
102973385158,102973385158,0,997,2134,-10
102973730059,102973730061,2,1906,1949,-10
102976863914,102976863915,1,1103,1247,-10
102977697606,102977697605,-1,1071,1419,-10
102978500554,102978500557,3,1788,1430,-10
102979157809,102979157812,3,1738,1641,-10
102984337415,102984337392,-23,1786,1219,-10
102985537598,102985537599,1,1721,1566,-10
102985602659,102985602662,3,1942,2173,-10
102989968937,102989968942,5,1852,1643,-10
102990219442,102990219442,0,1759,1367,-10
102991323987,102991323990,3,2112,1824,-10
102991562993,102991562998,5,1480,1547,-10
102991724475,102991724476,1,939,1534,-10
102993161543,102993161545,2,1254,1586,-10
102995036737,102995036738,1,990,1733,-10
102999478791,102999478797,6,1517,1563,-10
103005480866,103005480866,0,1391,1964,-10
103006436305,103006436294,-11,39519,16436,-10
103008132317,103008132318,1,1570,1714,-10
103009757253,103009757258,5,1346,933,-10
103009939855,103009939857,2,2317,1802,-10
103010076436,103010076437,1,1915,1564,-10
103010409245,103010409246,1,1879,1747,-10
103012126156,103012126158,2,949,1526,-10
103012679084,103012679086,2,1509,1048,-10
103013457761,103013457765,4,2080,1632,-10
103014375100,103014375101,1,1323,1336,-10
103015966768,103015966770,2,1530,948,-10
103019283687,103019283689,2,952,1342,-10
103019754470,103019754474,4,1935,1401,-10
103022789808,103022789810,2,1636,1837,-10
103024505148,103024505149,1,1375,1630,-10
103026229174,103026229176,2,1515,1499,-10
103027072662,103027072664,2,1173,1549,-10
103028684161,103028684162,1,1415,1719,-10
103033207325,103033207327,2,1605,1690,-10
103038282790,103038282790,0,977,1499,-10
103040620826,103040620829,3,1528,1413,-10
103041046103,103041046106,3,1324,1520,-10
103041169539,103041169542,3,1791,1705,-10
103043261296,103043261296,0,1532,1953,-10
103045940726,103045940725,-1,1903,1699,-10
103047362077,103047362083,6,3035,1180,-10
103049278799,103049278801,2,1653,1100,-10
103051073252,103051073256,4,1452,1380,-10
103054306926,103054306929,3,2301,1510,-10
103057993031,103057993032,1,1140,1181,-10
103064164447,103064164450,3,1270,1553,-10
103064699008,103064699009,1,1847,1954,-10
103068366772,103068366773,1,2138,1390,-10
103070393525,103070393526,1,2265,1638,-10
103070528626,103070528629,3,2165,1331,-10
103072614825,103072614823,-2,1276,1772,-10
103074109448,103074109450,2,1744,1133,-10
103074930226,103074930226,0,1906,1635,-10
103075740756,103075740763,7,5089,1825,-10
103077345134,103077345142,8,3341,1644,-10
103077647680,103077647683,3,1170,1281,-10
103077757915,103077757906,-9,160,664,-10
103083197398,103083197403,5,2569,1386,-10
103084744878,103084744879,1,1845,2080,-10
103084833365,103084833367,2,1848,1444,-10
103090162650,103090162643,-7,2166,7119,-10
103090304965,103090304970,5,1588,1323,-10
103090995951,103090995952,1,1747,1310,-10
103091147501,103091147504,3,1315,1245,-10
103092451767,103092451773,6,1910,778,-10
103094254379,103094254382,3,1954,1683,-10
103094535675,103094535675,0,1837,2204,-10
103100284644,103100284647,3,1804,1279,-10
103101888354,103101888358,4,1991,1638,-10
103105504790,103105504792,2,1036,1141,-10
103105955187,103105955186,-1,1418,1494,-10
103106996121,103106996119,-2,1871,13082,-10
103107314286,103107314286,0,1477,1914,-10
103108159938,103108159941,3,1056,1371,-10
103109311517,103109311525,8,10782,21720,-10
103110577710,103110577714,4,1591,1618,-10
103115748269,103115748272,3,1229,1230,-10
103116245803,103116245807,4,2365,1737,-10
103116330562,103116330566,4,1587,1312,-10
103118242020,103118242022,2,1336,1206,-10
103118856173,103118856155,-18,1373,703,-10
103124608158,103124608160,2,2154,1618,-10
103125315094,103125315098,4,1279,1802,-10
103132591942,103132591942,0,1418,1460,-10
103134254075,103134254077,2,2132,1902,-10
103141555317,103141555319,2,2160,1614,-10
103142905858,103142905864,6,1775,1462,-10
103143600275,103143600257,-18,1641,1393,-10
103145141406,103145141407,1,1482,1014,-10
103149271373,103149271376,3,1810,1559,-10
103149449405,103149449406,1,1555,1378,-10
103150268125,103150268126,1,1664,1581,-10
103150481601,103150481601,0,1381,1334,-10
103150733970,103150733971,1,1518,1574,-10
103152682178,103152682178,0,2137,2021,-10
103153412578,103153412578,0,1604,1617,-10
103153873148,103153873150,2,1458,1917,-10
103154096660,103154096659,-1,938,1571,-10
103155121253,103155121255,2,1048,1566,-10
103156138046,103156138048,2,1489,1536,-10
103157095800,103157095802,2,1221,1110,-10
103157301490,103157301493,3,2094,1193,-10
103161951337,103161951340,3,1857,1288,-10
103163871139,103163871143,4,1189,1334,-10
103168419964,103168419958,-6,2638,13549,-10
103169189974,103169189974,0,1779,1604,-10
103170763325,103170763328,3,1863,1686,-10
103171165475,103171165477,2,1183,1319,-10
103171876922,103171876925,3,1772,1525,-10
103172763212,103172763228,16,16008,20769,-10
103173821482,103173821483,1,1405,1030,-10
103174733811,103174733814,3,2155,1610,-10
103175742094,103175742099,5,1794,1290,-10
103176162782,103176162785,3,1637,1549,-10
103179939983,103179939986,3,1531,1412,-10
103180416586,103180416589,3,1521,1891,-10
103180818171,103180818173,2,1253,1508,-10
103181838565,103181838579,14,1412,1245,-10
103181893963,103181893945,-18,1440,1300,-10
103183511352,103183511355,3,1588,2138,-10
103183844848,103183844851,3,1754,1405,-10
103187317547,103187317550,3,1559,1546,-10
103189257858,103189257859,1,2034,2345,-10
103191205287,103191205288,1,1410,1931,-10
103191753238,103191753240,2,1649,1477,-10
103193037822,103193037824,2,1963,1707,-10
103193500141,103193500146,5,3076,1534,-10
103197702960,103197702962,2,1684,2388,-10
103197762862,103197762859,-3,1512,1913,-10
103201877470,103201877470,0,1089,1736,-10
103203796957,103203796959,2,1300,1665,-10
103204638374,103204638377,3,1950,2052,-10
103206235145,103206235147,2,2224,1545,-10
103206425489,103206425490,1,1538,1376,-10
103212903849,103212903852,3,1792,1897,-10
103215241863,103215241864,1,2231,2208,-10
103215621925,103215621926,1,1446,973,-10
103216785774,103216785777,3,1616,1813,-10
103220675803,103220675807,4,1869,1411,-10
103223030875,103223030854,-21,1177,1044,-10
103225442150,103225442154,4,1893,1246,-10
103227725923,103227725922,-1,1351,1991,-10
103229098916,103229098917,1,1317,1254,-10
103229467207,103229467209,2,1595,1692,-10
103229524257,103229524259,2,1347,1231,-10
103230458439,103230458443,4,1780,1314,-10
103232040945,103232040949,4,1459,1405,-10
103232560191,103232560193,2,1295,1590,-10
103232789182,103232789185,3,1763,1686,-10
103232871734,103232871734,0,1833,2470,-10
103234572074,103234572075,1,1960,1943,-10
103235900166,103235900145,-21,1277,1647,-10
103237690453,103237690455,2,1620,1221,-10
103238334972,103238334974,2,1875,1458,-10
103238610939,103238610941,2,2355,2183,-10
103240999269,103240999270,1,1079,1360,-10
103241132932,103241132933,1,1846,1573,-10
103241820831,103241820832,1,1336,1415,-10
103244372787,103244372788,1,900,728,-10
103246408403,103246408405,2,1539,1862,-10
103247229039,103247229040,1,1008,1362,-10
103248734196,103248734198,2,1720,1754,-10
103251897862,103251897870,8,3380,1304,-10
103253752115,103253752118,3,2016,1402,-10
103254102500,103254102503,3,2651,1423,-10
103254882858,103254882859,1,1628,1587,-10
103255558646,103255558650,4,1779,2358,-10
103256629783,103256629787,4,876,962,-10
103260340222,103260340215,-7,1903,10024,-10
103261189085,103261189086,1,1829,1630,-10
103262737438,103262737439,1,2128,1478,-10
103264666162,103264666166,4,1955,1203,-10
103265650828,103265650830,2,1267,1505,-10
103270148110,103270148114,4,1507,1208,-10
103271401802,103271401802,0,1591,1420,-10
103274360723,103274360726,3,2239,1760,-10
103275290018,103275290018,0,1163,1553,-10
103278319680,103278319682,2,1476,1524,-10
103284932342,103284932345,3,1194,1725,-10
103286904580,103286904581,1,2053,1925,-10
103291298961,103291298964,3,1941,1349,-10
103293062405,103293062410,5,1425,1422,-10
103294394123,103294394125,2,1237,1205,-10
103296206641,103296206642,1,1225,1361,-10
103296312133,103296312140,7,4144,1372,-10
103306879698,103306879698,0,1185,1599,-10
103308498308,103308498306,-2,1097,1822,-10
103309385428,103309385430,2,1805,1510,-10
103310249795,103310249799,4,1242,1150,-10
103311528390,103311528391,1,1211,1376,-10
103311826822,103311826828,6,15030,17358,-10
103311954048,103311954051,3,2129,1924,-10
103322223439,103322223441,2,1508,1449,-10
103326250075,103326250077,2,1165,1444,-10
103327374918,103327374919,1,1612,1598,-10
103328301482,103328301482,0,1090,1470,-10
103329275479,103329275481,2,1400,1359,-10
103330059798,103330059802,4,1828,1416,-10
103331735050,103331735053,3,1280,1120,-10
103337278352,103337278354,2,1401,1030,-10
103337676807,103337676809,2,2548,2140,-10
103337705585,103337705589,4,1770,1741,-10
103338382713,103338382717,4,1474,1466,-10
103350081314,103350081315,1,1333,1245,-10
103350157445,103350157446,1,1451,1951,-10
103351867209,103351867210,1,1561,1368,-10
103352581814,103352581814,0,1553,1539,-10
103359732362,103359732366,4,1114,1624,-10
103361805365,103361805367,2,1073,908,-10
103362478072,103362478075,3,1663,1901,-10
103369264218,103369264220,2,965,1354,-10
103371840313,103371840314,1,1517,1473,-10
103374502502,103374502503,1,1207,1290,-10
103376355985,103376355987,2,1307,1133,-10
103377640003,103377640006,3,1224,1643,-10
103378081249,103378081245,-4,916,1316,-10
103378989274,103378989275,1,1861,2064,-10
103386471578,103386471578,0,712,1267,-10
103389042390,103389042389,-1,1365,1290,-10
103392089524,103392089526,2,1587,1261,-10
103392827631,103392827632,1,1919,2156,-10
103392910173,103392910176,3,1528,1530,-10
103394807286,103394807287,1,1744,1358,-10
103397728770,103397728770,0,1122,589,-10
103398654356,103398654351,-5,1771,1181,-10
103401775054,103401775054,0,1625,1977,-10
103401930582,103401930583,1,1551,1703,-10
103409338366,103409338368,2,1181,1124,-10
103413858424,103413858426,2,1371,1446,-10
103417414238,103417414241,3,1606,1228,-10
103422235025,103422235026,1,1337,1255,-10
103423124310,103423124310,0,1986,1926,-10
103427869575,103427869574,-1,1230,1189,-10
103428925574,103428925575,1,1555,1169,-10
103433608980,103433608983,3,1085,1040,-10
103435817665,103435817668,3,2048,1279,-10
103437018810,103437018814,4,2514,1381,-10
103440395047,103440395050,3,1767,1618,-10
103441187538,103441187539,1,1614,1132,-10
103441922014,103441922017,3,2379,1596,-10
103442159654,103442159655,1,1564,1606,-10
103444181721,103444181721,0,2300,3327,-10
103445142406,103445142410,4,1854,1608,-10
103446073636,103446073654,18,1811,1946,-10
103448907337,103448907338,1,1789,2424,-10
103449341797,103449341799,2,1608,1678,-10
103451720828,103451720831,3,2543,1607,-10
103452528714,103452528715,1,914,1393,-10
103454938716,103454938717,1,1299,1224,-10
103457667566,103457667567,1,1623,2019,-10
103458546849,103458546850,1,1349,1479,-10
103458885038,103458885042,4,1516,1592,-10
103460278723,103460278725,2,1562,857,-10
103462231297,103462231301,4,1460,1782,-10
103462794897,103462794901,4,2524,1525,-10
103468470610,103468470613,3,1818,1390,-10
103469438695,103469438697,2,1037,1589,-10
103472884310,103472884311,1,1164,1229,-10
103475671996,103475671999,3,1197,1673,-10
103477439387,103477439387,0,1846,1491,-10
103478490336,103478490339,3,1544,1197,-10
103484831130,103484831133,3,1466,1374,-10
103487543687,103487543690,3,1520,1326,-10
103488278132,103488278134,2,1337,826,-10
103492711185,103492711186,1,1707,1853,-10
103493418643,103493418650,7,3658,1699,-10
103495762866,103495762871,5,2001,1827,-10
103496902129,103496902131,2,1372,1372,-10
103500931193,103500931197,4,1442,1396,-10
103501828601,103501828618,17,766,1795,-10
103502777760,103502777762,2,1908,1547,-10
103504643845,103504643848,3,1328,1425,-10
103504986498,103504986498,0,2050,1913,-10
103514024640,103514024639,-1,1069,1470,-10
103515585080,103515585081,1,2178,1368,-10
103516220030,103516220027,-3,1190,1709,-10
103519060310,103519060312,2,1448,1353,-10
103520863406,103520863409,3,1404,1689,-10
103531569591,103531569592,1,1605,1629,-10
103538091158,103538091159,1,1618,2165,-10
103538316033,103538316034,1,2077,1850,-10
103540327223,103540327226,3,2201,1755,-10
103546621426,103546621431,5,2400,1108,-10
103547986517,103547986519,2,1694,2038,-10
103548990822,103548990825,3,2213,1901,-10
103551315319,103551315319,0,1176,1479,-10
103552308781,103552308782,1,1115,1152,-10
103552759793,103552759793,0,1176,1309,-10
103553104028,103553104030,2,1678,1303,-10
103553422682,103553422686,4,1978,1560,-10
103554166763,103554166764,1,1625,1778,-10
103555141218,103555141221,3,2200,1501,-10
103555213520,103555213524,4,1645,1652,-10
103559052514,103559052514,0,1829,1107,-10
103561733309,103561733311,2,1302,1264,-10
103566842091,103566842092,1,1147,1605,-10
103569919708,103569919710,2,1975,2327,-10
103574085398,103574085402,4,1669,2115,-10
103576282861,103576282865,4,1018,948,-10
103578110014,103578110015,1,1450,1970,-10
103578910178,103578910177,-1,1538,2015,-10
103579552251,103579552269,18,50,650,-10
103583624222,103583624226,4,1301,1617,-10
103588915198,103588915199,1,1635,1047,-10
103589071785,103589071795,10,1262,1473,-10
103589852591,103589852594,3,2055,1893,-10
103592496842,103592496842,0,1541,1746,-10
103593201239,103593201241,2,1503,1485,-10
103595103091,103595103094,3,1595,1306,-10
103601320422,103601320423,1,1548,1854,-10
103603059373,103603059376,3,1286,1163,-10
103603426323,103603426336,13,1046,1013,-10
103604408562,103604408565,3,1508,1622,-10
103604813745,103604813747,2,1838,1460,-10
103608199828,103608199832,4,2249,1667,-10
103608437063,103608437066,3,1801,1849,-10
103609236311,103609236314,3,1317,1496,-10
103610736716,103610736718,2,1142,1095,-10
103611935239,103611935241,2,1931,1532,-10
103612231897,103612231900,3,1379,2240,-10
103614054173,103614054174,1,1342,1640,-10
103614460631,103614460634,3,898,1248,-10
103615814391,103615814385,-6,2621,7350,-10
103616627597,103616627600,3,1943,2116,-10
103617764230,103617764232,2,1705,1799,-10
103618353639,103618353641,2,2065,1325,-10
103619293126,103619293128,2,969,1116,-10
103623381778,103623381779,1,1358,1501,-10
103623994026,103623994027,1,1513,1667,-10
103624496434,103624496436,2,1317,1370,-10
103625634923,103625634929,6,10301,5443,-10
103626037496,103626037498,2,1494,1586,-10
103626158034,103626158034,0,1150,1430,-10
103626641707,103626641727,20,1160,3733,-10
103627759305,103627759307,2,1060,1396,-10
103628864716,103628864718,2,1410,1197,-10
103629307655,103629307658,3,1500,985,-10
103631875534,103631875533,-1,1222,1584,-10
103632832062,103632832065,3,1665,1420,-10
103639319334,103639319337,3,1529,2058,-10
103641295163,103641295167,4,1217,1283,-10
103642460306,103642460307,1,1478,1227,-10
103642502290,103642502289,-1,2154,3526,-10
103643607496,103643607497,1,1934,1849,-10
103643836450,103643836453,3,1031,1723,-10
103644412517,103644412520,3,1408,1152,-10
103645629505,103645629508,3,1721,1913,-10
103647028378,103647028380,2,1751,1765,-10
103647244466,103647244468,2,1489,1942,-10
103649723814,103649723816,2,1403,1303,-10
103650269870,103650269871,1,1601,1771,-10
103651154645,103651154649,4,1754,1538,-10
103653677531,103653677533,2,1353,1178,-10
103658231787,103658231786,-1,1168,1682,-10
103658950647,103658950648,1,1690,1536,-10
103660776780,103660776782,2,1633,1647,-10
103665330254,103665330255,1,1327,1099,-10
103666723836,103666723838,2,1256,1532,-10
103667570429,103667570430,1,1170,1275,-10
103667896538,103667896539,1,1602,951,-10
103668772249,103668772252,3,1576,1085,-10
103673735695,103673735698,3,1316,1181,-10
103677948145,103677948146,1,1231,1577,-10
103679195286,103679195288,2,1479,1481,-10
103683767375,103683767377,2,1779,1304,-10
103688876329,103688876331,2,1220,1348,-10
103694781021,103694781020,-1,1330,2307,-10
103696984346,103696984348,2,2307,2128,-10
103700316118,103700316121,3,1651,1397,-10
103705748587,103705748589,2,1016,1498,-10
103705969455,103705969455,0,916,1836,-10
103707770225,103707770226,1,1739,1573,-10
103710641386,103710641387,1,1755,940,-10
103710829699,103710829703,4,1500,938,-10
103712162867,103712162867,0,2017,1267,-10
103712820489,103712820490,1,1755,1597,-10
103714976954,103714976956,2,1544,1562,-10
103715414274,103715414275,1,1743,3166,-10
103716775383,103716775386,3,1770,2170,-10
103725306873,103725306875,2,1578,1461,-10
103725913296,103725913299,3,1570,1771,-10
103726263577,103726263572,-5,1690,5639,-10
103729726027,103729726028,1,1514,991,-10
103729904339,103729904321,-18,1344,1289,-10
103730093390,103730093389,-1,1186,1170,-10
103733143600,103733143603,3,1644,1684,-10
103733617590,103733617592,2,1566,1750,-10
103736261714,103736261717,3,1056,1399,-10
103737331914,103737331916,2,1605,1634,-10
103738594330,103738594329,-1,885,774,-10
103739096970,103739096970,0,1017,1362,-10
103741248157,103741248161,4,1980,1167,-10
103742405810,103742405813,3,2085,1543,-10
103749243108,103749243110,2,2286,2153,-10
103749701170,103749701183,13,1643,1873,-10
103750314741,103750314742,1,1456,2269,-10
103755114298,103755114298,0,1667,1291,-10
103758691494,103758691494,0,1517,1355,-10
103760203287,103760203289,2,905,1644,-10
103764124638,103764124641,3,1187,1631,-10
103765126998,103765127001,3,1440,1199,-10
103767390505,103767390507,2,1768,1243,-10
103770143806,103770143806,0,1113,1203,-10
103771200842,103771200842,0,1619,1266,-10
103771556729,103771556710,-19,1755,1161,-10
103772982369,103772982375,6,1422,1233,-10
103773545701,103773545702,1,1719,1653,-10
103774998406,103774998409,3,1424,1680,-10
103776244978,103776244977,-1,1231,1450,-10
103777460022,103777460024,2,2335,2391,-10
103779126527,103779126529,2,1786,1794,-10
103780020430,103780020429,-1,1730,2215,-10
103781261542,103781261546,4,1202,1588,-10
103781345227,103781345227,0,3044,1841,-10
103784601914,103784601919,5,1848,1665,-10
103786924917,103786924917,0,9832,11252,-10
103788474874,103788474875,1,1735,1123,-10
103788624371,103788624374,3,1055,1174,-10
103793581035,103793581037,2,2180,2410,-10
103794662874,103794662877,3,1741,1469,-10
103795551593,103795551595,2,1585,1550,-10
103798883709,103798883711,2,1252,1585,-10
103799795560,103799795561,1,1794,1129,-10
103804030843,103804030845,2,1695,1976,-10
103805111306,103805111310,4,1722,1508,-10
103808424659,103808424658,-1,1678,1817,-10
103808573984,103808573985,1,2047,1491,-10
103811289254,103811289256,2,1780,1605,-10
103813006706,103813006709,3,1711,1116,-10
103814651088,103814651096,8,4924,1836,-10
103815263674,103815263677,3,1422,1116,-10
103816454490,103816454493,3,1084,1198,-10
103820206738,103820206740,2,1265,1668,-10
103821756297,103821756319,22,99,1324,-10
103823495171,103823495174,3,1658,1394,-10
103824839791,103824839792,1,1091,1404,-10
103824885122,103824885131,9,974,1690,-10
103827842313,103827842321,8,12349,26169,-10
103828588466,103828588471,5,775,1397,-10
103830857648,103830857650,2,1054,1349,-10
103831230170,103831230170,0,1913,1721,-10
103831765906,103831765911,5,1890,2368,-10
103835127042,103835127043,1,1589,1685,-10
103841061378,103841061381,3,1524,2068,-10
103842436705,103842436707,2,1462,944,-10
103844884474,103844884477,3,1499,1966,-10
103847951748,103847951750,2,1313,1898,-10
103848492239,103848492240,1,1243,1356,-10
103848956486,103848956487,1,1414,1796,-10
103850528872,103850528872,0,1017,1304,-10
103853432182,103853432184,2,1370,654,-10
103856427364,103856427370,6,318,2676,-10
103858122199,103858122199,0,952,1086,-10
103859267688,103859267701,13,455,2573,-10
103863724901,103863724901,0,1706,1451,-10
103864590622,103864590624,2,812,823,-10
103866850664,103866850669,5,3812,2012,-10
103869126444,103869126445,1,1989,1911,-10
103869895135,103869895136,1,1133,1523,-10
103871704624,103871704641,17,1576,1360,-10
103872658465,103872658467,2,908,959,-10
103874944337,103874944338,1,1140,791,-10
103875373372,103875373368,-4,1845,3531,-10
103877328225,103877328222,-3,1310,2289,-10
103878644134,103878644134,0,1086,1256,-10
103878939202,103878939203,1,811,659,-10
103887590520,103887590522,2,2332,2138,-10
103887920766,103887920766,0,1663,1813,-10
103891085112,103891085115,3,1224,1101,-10
103893410637,103893410638,1,1113,1529,-10
103894046410,103894046410,0,1247,1328,-10
103894781572,103894781565,-7,851,2420,-10
103902716081,103902716083,2,1523,1713,-10
103905304374,103905304376,2,1409,1557,-10
103908551330,103908551333,3,1294,1960,-10
103910940675,103910940677,2,1617,1560,-10
103911220222,103911220220,-2,1318,2026,-10
103911467374,103911467378,4,1632,1561,-10
103911638622,103911638624,2,1380,1586,-10
103917444223,103917444224,1,1420,1480,-10
103918875746,103918875747,1,1364,1419,-10
103919774098,103919774100,2,1460,1668,-10
103921315042,103921315042,0,1024,1095,-10
103922211672,103922211670,-2,2509,3407,-10
103924741738,103924741741,3,1828,1667,-10
103925549774,103925549777,3,1829,1506,-10
103926440662,103926440664,2,1539,1489,-10
103935855422,103935855423,1,1678,1710,-10
103936675103,103936675107,4,1524,1797,-10
103938720934,103938720939,5,1327,923,-10
103945063424,103945063423,-1,1094,1597,-10
103945870759,103945870760,1,1612,1702,-10
103948122382,103948122382,0,1712,1814,-10
103950418361,103950418363,2,1482,1287,-10
103951047795,103951047798,3,1619,1689,-10
103951363674,103951363674,0,738,1193,-10
103954488556,103954488558,2,1597,1666,-10
103957199575,103957199576,1,1409,1716,-10
103957611522,103957611526,4,1792,1740,-10
103963851197,103963851200,3,1958,1704,-10
103966859874,103966859879,5,2110,1424,-10
103968944546,103968944546,0,1628,1659,-10
103971148075,103971148076,1,1369,1887,-10
103971281743,103971281743,0,1129,2739,-10
103974432121,103974432123,2,1699,1224,-10
103977194431,103977194432,1,1440,1510,-10
103977321658,103977321662,4,1826,1848,-10
103978617944,103978617946,2,1573,1654,-10
103979286777,103979286778,1,1536,1521,-10
103983485629,103983485635,6,2836,1208,-10
103989276765,103989276766,1,1659,1496,-10
103989508324,103989508326,2,1444,1705,-10
103993197614,103993197614,0,1307,1857,-10
103994710862,103994710867,5,848,745,-10
104000822611,104000822614,3,1644,1620,-10
104003144618,104003144621,3,1724,1741,-10
104004816735,104004816737,2,1553,1476,-10
104006674051,104006674054,3,1171,1538,-10
104007143803,104007143800,-3,277,1373,-10
104011580222,104011580224,2,2087,2191,-10
104013270094,104013270095,1,1283,1842,-10
104014055152,104014055154,2,1881,1507,-10
104015789165,104015789165,0,2195,2563,-10
104016186887,104016186888,1,1683,1874,-10
104019101641,104019101644,3,1980,1894,-10
104020561206,104020561206,0,1891,1497,-10
104021795141,104021795142,1,1385,1260,-10
104022193948,104022193950,2,1699,1205,-10
104031926462,104031926465,3,1761,1676,-10
104035275186,104035275187,1,1875,1588,-10
104036156107,104036156107,0,701,948,-10
104040044357,104040044358,1,1496,1350,-10
104040287798,104040287799,1,1851,1965,-10
104040593661,104040593664,3,2561,1606,-10
104046778434,104046778435,1,1802,1883,-10
104048342197,104048342199,2,1607,2228,-10
104050721556,104050721575,19,1364,1416,-10
104052491726,104052491729,3,1571,2031,-10
104054814652,104054814654,2,1479,1689,-10
104055029362,104055029378,16,2907,1348,-10
104057778018,104057778020,2,1580,2137,-10
104059125382,104059125385,3,859,1134,-10
104064197506,104064197509,3,1735,1508,-10
104066635778,104066635779,1,999,1512,-10
104067866233,104067866235,2,1657,1764,-10
104068181341,104068181343,2,1609,1222,-10
104070427866,104070427867,1,1611,1225,-10
104071031761,104071031763,2,1637,2036,-10
104072402819,104072402821,2,1289,2072,-10
104076811825,104076811826,1,1278,2015,-10
104077245881,104077245883,2,1347,1567,-10
104084196002,104084196005,3,2093,1833,-10
104084447451,104084447453,2,1760,2282,-10
104092180511,104092180511,0,1262,1564,-10
104097062501,104097062503,2,1924,1869,-10
104099305707,104099305710,3,1770,1564,-10
104099895302,104099895303,1,1119,1410,-10
104100973342,104100973322,-20,1770,2008,-10
104101111891,104101111895,4,1308,1349,-10
104102810625,104102810626,1,1247,1004,-10
104105105411,104105105413,2,1064,1297,-10
104105796522,104105796524,2,1832,1429,-10
104108212421,104108212421,0,1608,1434,-10
104108822617,104108822616,-1,1399,1599,-10
104111592173,104111592173,0,1348,1998,-10
104113390109,104113390109,0,1488,957,-10
104115216018,104115216022,4,1882,1527,-10
104115655918,104115655917,-1,1767,1514,-10
104120423280,104120423282,2,1670,1407,-10
104127323874,104127323877,3,1346,1161,-10
104130399006,104130399005,-1,1088,1128,-10
104134512682,104134512683,1,1306,1298,-10
104134550625,104134550629,4,2029,1523,-10
104135933957,104135933951,-6,1601,8111,-10
104136241830,104136241830,0,1680,1562,-10
104136573536,104136573538,2,2306,1718,-10
104139612927,104139612930,3,1321,1480,-10
104141907859,104141907865,6,939,1090,-10
104142073746,104142073749,3,1951,2079,-10
104142736551,104142736555,4,1444,1402,-10
104145703350,104145703351,1,1912,2006,-10
104147420849,104147420850,1,1532,1299,-10
104149921921,104149921923,2,1355,1123,-10
104152959459,104152959463,4,1139,1358,-10
104160992374,104160992378,4,1254,1203,-10
104165866185,104165866186,1,1603,1116,-10
104166528435,104166528437,2,1759,1859,-10
104169578385,104169578386,1,1867,1264,-10
104170895525,104170895526,1,1228,1944,-10
104171623114,104171623114,0,1620,1610,-10
104171803146,104171803149,3,1972,1982,-10
104174329216,104174329206,-10,759,733,-10
104175666426,104175666416,-10,1170,1736,-10
104176636890,104176636890,0,1412,1546,-10
104177296534,104177296536,2,1340,1538,-10
104177790347,104177790350,3,2024,1153,-10
104178152387,104178152391,4,1481,1212,-10
104178248999,104178248998,-1,1615,3133,-10
104178288811,104178288798,-13,1538,1489,-10
104181116598,104181116601,3,1601,1751,-10
104182338954,104182338958,4,2156,1818,-10
104182841258,104182841262,4,1710,1483,-10
104183400579,104183400581,2,1193,903,-10
104183798224,104183798224,0,1481,1386,-10
104186552478,104186552482,4,1816,1028,-10
104186612314,104186612297,-17,886,1033,-10
104188557123,104188557126,3,1372,2070,-10
104191101835,104191101837,2,1328,1733,-10
104191131438,104191131441,3,2278,1936,-10
104192305423,104192305423,0,741,1238,-10
104194129894,104194129895,1,1036,1291,-10
104196072803,104196072804,1,1964,1698,-10
104199501706,104199501711,5,1993,1432,-10
104200129294,104200129294,0,1235,1368,-10
104203038659,104203038661,2,1656,1529,-10
104205347129,104205347132,3,1580,1166,-10
104207644796,104207644801,5,1089,1605,-10
104208366211,104208366194,-17,45832,19820,-10
104208671763,104208671768,5,1785,885,-10
104209474991,104209474993,2,1047,1144,-10
104209792106,104209792110,4,1870,1662,-10
104217124119,104217124122,3,2154,1945,-10
104217470986,104217470989,3,2085,1697,-10
104222503534,104222503553,19,2025,1378,-10
104223219490,104223219496,6,1623,1856,-10
104223816234,104223816237,3,1629,1302,-10
104224175078,104224175059,-19,1198,676,-10
104224401937,104224401939,2,1295,1224,-10
104225873045,104225873048,3,1306,2131,-10
104235184819,104235184820,1,1507,1339,-10
104236359200,104236359200,0,1017,1786,-10
104239621278,104239621280,2,1283,1917,-10
104240117491,104240117493,2,2523,1677,-10
104240802770,104240802773,3,1964,1922,-10
104241778433,104241778438,5,1436,1507,-10
104243498964,104243498966,2,2015,1365,-10
104244927215,104244927217,2,1148,1355,-10
104246195884,104246195884,0,1464,1586,-10
104248707657,104248707660,3,1663,1546,-10
104249999287,104249999290,3,1992,1717,-10
104250746137,104250746139,2,1243,1294,-10
104252762659,104252762659,0,1132,842,-10
104255142412,104255142413,1,1561,1593,-10
104256177021,104256177023,2,1469,1341,-10
104257325386,104257325388,2,1687,1505,-10
104258789063,104258789063,0,1532,1644,-10
104259380869,104259380872,3,1865,1628,-10
104261119818,104261119819,1,1212,1292,-10
104265186288,104265186287,-1,1747,1687,-10
104269554747,104269554749,2,2087,1397,-10
104273255838,104273255837,-1,1531,1646,-10
104275018259,104275018262,3,2215,1627,-10
104276693598,104276693598,0,1590,1686,-10
104278081311,104278081311,0,1824,1601,-10
104279810610,104279810613,3,1191,1643,-10
104281539478,104281539479,1,1217,1772,-10
104290131051,104290131057,6,889,955,-10
104291456067,104291456069,2,1330,1281,-10
104293219022,104293219024,2,1616,1613,-10
104294079098,104294079103,5,2119,1700,-10
104295731057,104295731059,2,1365,1311,-10
104296064014,104296064014,0,1542,1733,-10
104297688828,104297688829,1,1225,1473,-10
104298248553,104298248554,1,1775,2055,-10
104299179906,104299179903,-3,1324,1295,-10
104301938574,104301938575,1,1528,870,-10
104302579404,104302579405,1,1324,993,-10
104303344367,104303344371,4,1787,1213,-10
104310193631,104310193633,2,1564,1660,-10
104312898654,104312898657,3,1498,1333,-10
104313727741,104313727743,2,1390,1524,-10
104318536787,104318536790,3,1712,1633,-10
104319520407,104319520409,2,1800,1614,-10
104320529821,104320529826,5,1210,962,-10
104322404361,104322404359,-2,1299,1168,-10
104322926321,104322926322,1,1318,1983,-10
104329955038,104329955039,1,1539,1605,-10
104330363448,104330363449,1,1478,1927,-10
104332319911,104332319909,-2,1182,1506,-10
104334252472,104334252473,1,1277,1286,-10
104334651518,104334651521,3,1498,1395,-10
104337193560,104337193562,2,1511,1232,-10
104339527666,104339527668,2,1544,1587,-10
104341189754,104341189757,3,1601,1577,-10
104342704990,104342704986,-4,1772,4692,-10
104343024353,104343024356,3,1364,1342,-10
104347051797,104347051799,2,2366,1817,-10
104350309140,104350309142,2,1139,1589,-10
104351015792,104351015794,2,1169,1641,-10
104354390350,104354390354,4,1188,1787,-10
104355704014,104355703995,-19,2014,1284,-10
104355732950,104355732954,4,2076,1327,-10
104357396014,104357396017,3,1484,1498,-10
104362552184,104362552177,-7,1430,4045,-10
104364763255,104364763258,3,1921,1784,-10
104365097975,104365097977,2,1281,1502,-10
104368263176,104368263178,2,1566,1329,-10
104368537826,104368537829,3,1890,2003,-10
104375482723,104375482726,3,1456,1492,-10
104378453346,104378453350,4,1246,1314,-10
104379937434,104379937434,0,1880,1630,-10
104382057263,104382057266,3,1772,1575,-10
104382966611,104382966609,-2,1104,1679,-10
104389659500,104389659503,3,883,1151,-10
104394272241,104394272243,2,1286,1139,-10
104399265134,104399265137,3,1435,1484,-10
104404406958,104404406961,3,2064,1379,-10
104405688206,104405688209,3,1482,1417,-10
104408569554,104408569558,4,915,1125,-10
104408913824,104408913822,-2,1229,1362,-10
104409533463,104409533443,-20,1764,1426,-10
104409817973,104409817976,3,1242,1307,-10
104418677161,104418677162,1,1959,1523,-10
104420529106,104420529108,2,1424,1343,-10
104423562074,104423562072,-2,1438,2853,-10
104426587448,104426587449,1,1345,1529,-10
104427889542,104427889547,5,2815,1960,-10
104428719094,104428719097,3,1483,1703,-10
104439582474,104439582475,1,1130,1166,-10
104443216297,104443216301,4,1380,1755,-10
104444117987,104444117988,1,1433,1844,-10
104444154877,104444154879,2,1098,1413,-10
104445015330,104445015328,-2,1130,2501,-10
104447356663,104447356665,2,1306,1258,-10
104447906255,104447906254,-1,1456,1663,-10
104448267759,104448267763,4,1075,1454,-10
104449764222,104449764223,1,1005,1455,-10
104450655599,104450655601,2,1373,2129,-10
104451320598,104451320598,0,2264,1931,-10
104451940620,104451940621,1,1550,1494,-10
104453190150,104453190150,0,1504,1481,-10
104459530189,104459530191,2,1495,1692,-10
104468108589,104468108590,1,1818,1930,-10
104470852501,104470852504,3,2509,2049,-10
104470906042,104470906046,4,2235,1888,-10
104474392505,104474392504,-1,2534,3314,-10
104481607171,104481607171,0,978,1773,-10
104484609966,104484609966,0,1177,1554,-10
104485049746,104485049748,2,1754,1049,-10
104487413617,104487413619,2,1611,1826,-10
104488571826,104488571826,0,1182,1547,-10
104491720747,104491720749,2,1493,1393,-10
104492664933,104492664939,6,2341,1175,-10
104494480909,104494480906,-3,1286,3139,-10
104495876905,104495876905,0,1761,2018,-10
104496148955,104496148956,1,1626,1150,-10
104498985498,104498985497,-1,1339,1481,-10
104500377442,104500377424,-18,1980,1270,-10
104501644285,104501644285,0,1565,1770,-10
104502463762,104502463767,5,1423,1958,-10
104506110053,104506110053,0,1345,1694,-10
104507732306,104507732307,1,1612,1161,-10
104511216930,104511216935,5,1755,1515,-10
104512202494,104512202494,0,1013,1717,-10
104512776055,104512776054,-1,1233,1621,-10
104513967510,104513967515,5,1371,1086,-10
104514656974,104514656974,0,1320,1190,-10
104514813870,104514813873,3,1951,1319,-10
104517031693,104517031695,2,1246,1100,-10
104522708127,104522708127,0,1016,2269,-10
104522851919,104522851919,0,1590,1024,-10
104528906726,104528906726,0,1647,1643,-10
104529449930,104529449933,3,2952,2383,-10
104533437244,104533437243,-1,1531,1712,-10
104534975305,104534975307,2,913,1823,-10
104535805501,104535805502,1,1298,1493,-10
104536385998,104536385999,1,1175,1251,-10
104538381356,104538381360,4,1253,1680,-10
104539985577,104539985579,2,1266,1054,-10
104542576379,104542576378,-1,894,1678,-10
104543802817,104543802818,1,1227,1335,-10
104543934487,104543934506,19,1311,1468,-10
104543976065,104543976066,1,1968,1374,-10
104546481318,104546481317,-1,1539,1924,-10
104547966306,104547966306,0,1155,1184,-10
104555162210,104555162203,-7,1174,4029,-10
104555566812,104555566812,0,1808,1583,-10
104555964218,104555964219,1,1556,1394,-10
104561221803,104561221801,-2,1317,1605,-10
104562658419,104562658422,3,1675,1718,-10
104563131390,104563131391,1,1478,1744,-10
104565062725,104565062726,1,1162,1126,-10
104566376967,104566376970,3,1483,1353,-10
104569553862,104569553864,2,1395,1704,-10
104572642402,104572642402,0,1632,1577,-10
104573006154,104573006156,2,1136,1595,-10
104573127538,104573127538,0,1905,1953,-10
104574700982,104574700982,0,871,1145,-10
104576126837,104576126838,1,1356,1203,-10
104580160883,104580160885,2,1147,1498,-10
104583394062,104583394063,1,1256,1269,-10
104586326039,104586326040,1,1409,1127,-10
104588843802,104588843802,0,1142,1094,-10
104590289404,104590289407,3,1468,691,-10
104593649851,104593649853,2,1243,1230,-10
104594680743,104594680737,-6,898,2091,-10
104594743356,104594743375,19,341,2241,-10
104597350014,104597350010,-4,1243,2753,-10
104602158689,104602158693,4,2111,1412,-10
104602513837,104602513838,1,1339,1082,-10
104602795241,104602795242,1,1166,1188,-10
104603062923,104603062923,0,1314,1571,-10
104604092345,104604092345,0,1657,1549,-10
104606739245,104606739246,1,1185,1137,-10
104607068997,104607068993,-4,970,2186,-10
104609567537,104609567539,2,1596,1475,-10
104611177778,104611177782,4,1192,1199,-10
104612458468,104612458472,4,2671,1611,-10
104612667841,104612667844,3,1837,1499,-10
104613966850,104613966856,6,2982,1279,-10
104614517493,104614517496,3,2148,1595,-10
104618161762,104618161766,4,1701,1349,-10
104620201657,104620201662,5,1239,1121,-10
104621636918,104621636919,1,1364,1333,-10
104622532617,104622532619,2,1707,1257,-10
104627902905,104627902906,1,2610,2282,-10
104633643547,104633643549,2,2837,2883,-10
104633845625,104633845625,0,2000,1424,-10
104634882681,104634882685,4,1936,1489,-10
104634976138,104634976138,0,1257,1664,-10
104636517071,104636517075,4,1566,921,-10
104644556886,104644556907,21,1491,1508,-10
104645326417,104645326415,-2,1512,2002,-10
104647432007,104647432012,5,1460,2112,-10
104648085350,104648085351,1,1700,1636,-10
104650086452,104650086469,17,403,1463,-10
104651803147,104651803149,2,1861,1435,-10
104652279749,104652279754,5,1734,1272,-10
104656967734,104656967736,2,1640,1721,-10
104657419788,104657419790,2,1442,1954,-10
104657876487,104657876493,6,1444,1066,-10
104659642582,104659642595,13,477,1577,-10
104661127051,104661127053,2,1140,1819,-10
104662678706,104662678709,3,862,1367,-10
104663923542,104663923544,2,2024,1638,-10
104669029127,104669029129,2,1304,1446,-10
104672074056,104672074059,3,1662,1412,-10
104678755218,104678755219,1,1401,970,-10
104680184722,104680184724,2,1449,1873,-10
104681304249,104681304250,1,1534,1712,-10
104683418986,104683418987,1,1543,1789,-10
104690523410,104690523410,0,1783,1616,-10
104693171901,104693171903,2,2455,1410,-10
104694026633,104694026632,-1,1235,1725,-10
104698906686,104698906689,3,2523,1957,-10
104701192683,104701192687,4,1589,1438,-10
104702184616,104702184618,2,1066,1162,-10
104702942429,104702942430,1,1204,1576,-10
104704758714,104704758716,2,1771,1768,-10
104705636547,104705636549,2,1155,1123,-10
104707978339,104707978340,1,1892,2784,-10
104711645946,104711645946,0,1267,1350,-10
104711831814,104711831816,2,1702,1873,-10
104713591562,104713591563,1,1194,1383,-10
104716181902,104716181905,3,1716,1751,-10
104719949228,104719949229,1,2329,2664,-10
104721728669,104721728669,0,1462,2243,-10
104722009486,104722009485,-1,1264,1210,-10
104723035448,104723035449,1,1827,1361,-10
104723768364,104723768365,1,1434,1312,-10
104725539882,104725539883,1,2197,2372,-10
104728350325,104728350326,1,1565,1598,-10
104728587784,104728587786,2,1295,1257,-10
104732067877,104732067878,1,1557,1405,-10
104733413702,104733413702,0,1066,1451,-10
104735005132,104735005134,2,1634,1859,-10
104735885415,104735885417,2,2103,1595,-10
104736236573,104736236573,0,1334,974,-10
104737791579,104737791567,-12,1306,1699,-10
104738998255,104738998256,1,1166,904,-10
104743979906,104743979909,3,1903,781,-10
104744566398,104744566400,2,1460,1876,-10
104746473429,104746473432,3,1910,1925,-10
104746601901,104746601902,1,1316,1488,-10
104748694202,104748694202,0,1540,1763,-10
104750545378,104750545386,8,2613,952,-10
104751292183,104751292186,3,1541,1750,-10
104752631398,104752631401,3,1048,828,-10
104754409367,104754409362,-5,18545,12640,-10
104758907411,104758907395,-16,1817,1335,-10
104764166899,104764166902,3,1537,1014,-10
104764385666,104764385670,4,1395,1039,-10
104764537649,104764537650,1,1360,1438,-10
104764655907,104764655906,-1,1709,2043,-10
104764906424,104764906426,2,1727,2122,-10
104765997730,104765997731,1,860,1149,-10
104769834893,104769834895,2,1837,1312,-10
104772905945,104772905946,1,592,1530,-10
104774137101,104774137103,2,1953,1142,-10
104774909788,104774909787,-1,2255,3838,-10
104777010896,104777010902,6,5442,3145,-10
104778379498,104778379494,-4,1368,3283,-10
104782320389,104782320392,3,1479,1598,-10
104784250942,104784250945,3,2018,1364,-10
104784447052,104784447048,-4,1028,130,-10
104784765326,104784765327,1,1532,1091,-10
104785675134,104785675137,3,1208,1353,-10
104789301227,104789301229,2,1649,1622,-10
104790745122,104790745124,2,2080,2062,-10
104791734360,104791734361,1,2257,2025,-10
104793209877,104793209878,1,1752,1747,-10
104794782231,104794782230,-1,2062,2100,-10
104796302994,104796302995,1,1126,1427,-10
104798162337,104798162316,-21,1860,2069,-10
104799356473,104799356475,2,1560,1826,-10
104800269635,104800269638,3,1503,1633,-10
104802222038,104802222038,0,768,1016,-10
104802860411,104802860413,2,1535,1547,-10
104804305590,104804305593,3,1531,1520,-10
104805090223,104805090222,-1,1086,1538,-10
104808277490,104808277490,0,1257,1646,-10
104811163133,104811163135,2,1492,1059,-10
104811336491,104811336494,3,2609,2118,-10
104813497350,104813497349,-1,1272,1745,-10
104816627620,104816627623,3,1751,1402,-10
104819557458,104819557458,0,1339,1236,-10
104819962968,104819962971,3,2231,2173,-10
104823825281,104823825283,2,1055,1415,-10
104824820214,104824820214,0,2164,1873,-10
104826206760,104826206761,1,1295,2053,-10
104827042739,104827042742,3,1876,1727,-10
104827507093,104827507094,1,2042,1867,-10
104827747966,104827747969,3,1615,1612,-10
104830310001,104830309999,-2,813,2041,-10
104832947772,104832947774,2,1952,1500,-10
104833716525,104833716526,1,1472,1730,-10
104835360619,104835360619,0,1958,1592,-10
104836254103,104836254105,2,1334,1924,-10
104836414882,104836414878,-4,1233,2598,-10
104837669013,104837669033,20,1587,1105,-10
104841482658,104841482661,3,1637,1670,-10
104844660202,104844660205,3,1036,1250,-10
104846450085,104846450085,0,6033,11185,-10
104846859223,104846859224,1,1074,1250,-10
104849843034,104849843037,3,2639,2176,-10
104850719323,104850719324,1,1746,1251,-10
104860921902,104860921903,1,782,1184,-10
104862710903,104862710904,1,851,1030,-10
104871084497,104871084497,0,1979,1589,-10
104874720687,104874720665,-22,1497,1155,-10
104874754918,104874754919,1,2018,1487,-10
104879882110,104879882109,-1,1854,1426,-10
104881973573,104881973575,2,1342,1568,-10
104882833018,104882833019,1,1280,1522,-10
104884126311,104884126314,3,1937,1355,-10
104886281368,104886281369,1,2526,2765,-10
104886660134,104886660139,5,3357,1968,-10
104889495354,104889495354,0,1123,1233,-10
104891233612,104891233615,3,2031,1827,-10
104895309767,104895309768,1,1040,1350,-10
104897679187,104897679191,4,1779,1461,-10
104898256382,104898256383,1,1330,1850,-10
104898548976,104898548979,3,1446,1466,-10
104899646725,104899646726,1,1605,1274,-10
104902886430,104902886434,4,1885,1396,-10
104905949628,104905949629,1,1373,1979,-10
104907904555,104907904556,1,1308,2254,-10
104910415683,104910415684,1,1162,2254,-10
104911862605,104911862606,1,1711,1984,-10
104912578386,104912578389,3,1325,1243,-10
104913707830,104913707834,4,1026,1199,-10
104922016910,104922016911,1,1364,1607,-10
104924119697,104924119698,1,2079,1564,-10
104925300539,104925300543,4,1624,2425,-10
104925669503,104925669505,2,807,1002,-10
104929433018,104929433019,1,1085,1129,-10
104931164952,104931164952,0,1598,1772,-10
104932723571,104932723573,2,2045,1773,-10
104932960539,104932960542,3,2137,2060,-10
104936346446,104936346449,3,1688,1961,-10
104937044899,104937044901,2,1549,1535,-10
104938732032,104938732034,2,1766,1747,-10
104943832133,104943832133,0,1390,1495,-10
104943879115,104943879117,2,1674,1568,-10
104945772757,104945772758,1,1656,1585,-10
104951448611,104951448612,1,1454,1510,-10
104952746096,104952746098,2,1802,1408,-10
104953762306,104953762310,4,1744,1466,-10
104958237066,104958237068,2,1769,1749,-10
104963704447,104963704451,4,1050,765,-10
104965499305,104965499306,1,1205,1514,-10
104969553727,104969553730,3,1722,1850,-10
104971432793,104971432794,1,1827,1852,-10
104973754385,104973754386,1,1660,1571,-10
104974037194,104974037195,1,1237,1465,-10
104975876845,104975876846,1,1263,1793,-10
104977521110,104977521111,1,1582,917,-10
104982204209,104982204209,0,1421,1677,-10
104982701102,104982701103,1,1902,2300,-10
104982985295,104982985295,0,1444,1741,-10
104985571309,104985571311,2,1321,658,-10
104991966069,104991966072,3,2050,1959,-10
104994916438,104994916439,1,1186,1475,-10
104996728894,104996728896,2,1774,2109,-10
104997055980,104997055982,2,1245,1483,-10
104998459687,104998459690,3,1418,893,-10
104999099977,104999099977,0,1291,1901,-10
105004117965,105004117966,1,1961,1961,-10
105009463414,105009463419,5,1199,1276,-10
105009889039,105009889041,2,1753,1530,-10
105010388814,105010388818,4,1830,2246,-10
105011051212,105011051214,2,1596,2136,-10
105012333961,105012333961,0,1476,1784,-10
105014351685,105014351685,0,1328,1173,-10
105016037095,105016037098,3,1545,1821,-10
105023041690,105023041704,14,1390,1277,-10
105023853298,105023853301,3,1316,1126,-10
105023960645,105023960652,7,1676,1358,-10
105024935546,105024935549,3,1640,1642,-10
105025403343,105025403345,2,1838,1297,-10
105026655861,105026655862,1,1314,2303,-10
105032098446,105032098449,3,1387,1669,-10
105033077953,105033077954,1,1509,1886,-10
105033217620,105033217620,0,2622,2708,-10
105036743445,105036743446,1,1394,1321,-10
105037109517,105037109518,1,1263,1381,-10
105038067878,105038067873,-5,888,3028,-10
105041053293,105041053295,2,1990,1924,-10
105041987281,105041987282,1,1403,1367,-10
105044461767,105044461767,0,1790,1354,-10
105045103666,105045103666,0,941,1822,-10
105047515104,105047515106,2,1639,1732,-10
105050531106,105050531107,1,1608,1531,-10
105053212852,105053212854,2,2239,1826,-10
105056583031,105056583033,2,1294,1052,-10
105057062343,105057062349,6,2383,1141,-10
105058415589,105058415591,2,1248,1584,-10
105058759051,105058759043,-8,1331,1477,-10
105060996103,105060996105,2,2505,2076,-10
105062139798,105062139801,3,1189,1152,-10
105062598766,105062598770,4,2097,1680,-10
105066254861,105066254865,4,1622,1552,-10
105066535665,105066535671,6,2131,881,-10
105071394719,105071394722,3,1616,1449,-10
105072863094,105072863098,4,1793,1726,-10
105073568554,105073568559,5,2269,1232,-10
105074269774,105074269778,4,1728,1529,-10
105078262246,105078262249,3,1486,1787,-10
105078297419,105078297419,0,1039,1097,-10
105078434284,105078434285,1,45230,26290,-10
105078722993,105078722994,1,1108,1455,-10
105079395698,105079395702,4,1861,871,-10
105081982248,105081982251,3,2258,1647,-10
105098851670,105098851673,3,2160,1478,-10
105099570371,105099570375,4,1142,1098,-10
105099642717,105099642721,4,2518,2033,-10
105100020113,105100020114,1,2178,2691,-10
105100672303,105100672305,2,1641,1437,-10
105101407802,105101407803,1,1699,1940,-10
105108977562,105108977562,0,1148,1143,-10
105109995467,105109995470,3,1832,1722,-10
105112181162,105112181163,1,1596,1622,-10
105118271064,105118271065,1,1721,1737,-10
105124051138,105124051140,2,1888,2078,-10
105128815709,105128815691,-18,1027,1074,-10
105129231461,105129231482,21,1539,1304,-10
105130827559,105130827562,3,1477,1636,-10
105130869832,105130869833,1,1334,1707,-10
105132378927,105132378929,2,1750,1717,-10
105132560815,105132560818,3,2192,1457,-10
105133944605,105133944610,5,3381,1288,-10
105134244473,105134244472,-1,1347,2523,-10
105135120234,105135120234,0,842,770,-10
105136176239,105136176243,4,1139,883,-10
105136600645,105136600650,5,22307,28397,-10
105137036679,105137036683,4,1928,1699,-10
105137623220,105137623219,-1,981,2368,-10
105140643154,105140643156,2,1530,1695,-10
105141583238,105141583235,-3,1164,1986,-10
105142444238,105142444241,3,1212,1512,-10
105143382347,105143382347,0,2228,2183,-10
105143921129,105143921129,0,1733,1668,-10
105146733159,105146733159,0,719,1488,-10
105149450194,105149450189,-5,2072,8333,-10
105151113006,105151113006,0,1239,1414,-10
105152076641,105152076643,2,1668,1877,-10
105155930818,105155930821,3,2394,1621,-10
105159354366,105159354363,-3,1805,2679,-10
105159602138,105159602141,3,1250,1464,-10
105159861794,105159861786,-8,1392,1037,-10
105161712405,105161712406,1,1217,1386,-10
105166065854,105166065858,4,1648,1571,-10
105169332075,105169332075,0,1463,1582,-10
105175461226,105175461228,2,2084,2233,-10
105178326458,105178326460,2,2141,1820,-10
105178750122,105178750130,8,845,1002,-10
105182068690,105182068695,5,2186,1324,-10
105185139806,105185139807,1,1331,1207,-10
105189019169,105189019172,3,1843,1731,-10
105194057358,105194057358,0,1114,1478,-10
105194811840,105194811841,1,1788,2178,-10
105195660907,105195660907,0,1148,1349,-10
105195731106,105195731107,1,1068,1124,-10
105197271057,105197271058,1,1617,1967,-10
105199560134,105199560136,2,1112,1010,-10
105200884485,105200884486,1,1604,1903,-10
105201519342,105201519344,2,1103,1202,-10
105202857130,105202857134,4,1426,1341,-10
105203638732,105203638737,5,1125,1112,-10
105205515574,105205515577,3,1860,1344,-10
105206281079,105206281079,0,2449,1444,-10
105207848274,105207848280,6,2506,1606,-10
105208097575,105208097577,2,1661,2074,-10
105209273311,105209273314,3,1512,1310,-10
105213806273,105213806273,0,2276,2192,-10
105214410076,105214410078,2,2126,1581,-10
105218058950,105218058950,0,1551,1361,-10
105220787266,105220787269,3,1325,978,-10
105224458324,105224458325,1,1375,1180,-10
105225147246,105225147249,3,2036,2091,-10
105225426236,105225426239,3,1673,1806,-10
105226521433,105226521434,1,2135,2723,-10
105226898383,105226898384,1,1394,1951,-10
105228203838,105228203845,7,8163,3866,-10
105230250429,105230250431,2,1821,1738,-10
105233075737,105233075738,1,1233,1858,-10
105233520846,105233520846,0,817,1086,-10
105235750663,105235750663,0,1452,1268,-10
105235967087,105235967064,-23,1425,1824,-10
105236880930,105236880941,11,1998,1843,-10
105244040469,105244040471,2,1107,1618,-10
105247534137,105247534139,2,1353,1332,-10
105250628274,105250628276,2,1634,1588,-10
105251050462,105251050462,0,1409,1534,-10
105252145733,105252145736,3,1789,1761,-10
105254075058,105254075058,0,1415,1895,-10
105257717194,105257717196,2,1369,1490,-10
105261847269,105261847270,1,1812,1719,-10
105264254938,105264254942,4,1575,1014,-10
105264531882,105264531882,0,1431,1411,-10
105266245678,105266245676,-2,1132,2015,-10
105267361391,105267361403,12,769,253,-10
105269875468,105269875470,2,1194,1347,-10
105270480820,105270480821,1,1350,1210,-10
105271809371,105271809373,2,1542,1770,-10
105273103702,105273103702,0,1234,1546,-10
105274120385,105274120386,1,1526,1518,-10
105275265999,105275266001,2,1119,1530,-10
105279954159,105279954157,-2,1394,1800,-10
105280809141,105280809142,1,1391,1072,-10
105281258934,105281258937,3,2921,2386,-10
105281328556,105281328558,2,1271,1413,-10
105282529947,105282529947,0,1218,792,-10
105287762371,105287762374,3,2101,1927,-10
105295693712,105295693715,3,1286,1470,-10
105296210986,105296210983,-3,1136,2252,-10
105297809026,105297809033,7,1778,1351,-10
105301268990,105301268994,4,1536,1395,-10
105305736472,105305736475,3,1827,1708,-10
105306185658,105306185660,2,1429,1428,-10
105307016089,105307016093,4,1208,1390,-10
105310192493,105310192494,1,1775,1334,-10
105310696770,105310696770,0,1412,1784,-10
105311873773,105311873774,1,1664,1662,-10
105314408193,105314408194,1,1199,1107,-10
105314852881,105314852882,1,1516,1299,-10
105315187296,105315187298,2,2050,824,-10
105315657583,105315657591,8,3507,1740,-10
105317283353,105317283354,1,2623,3691,-10
105320337633,105320337635,2,1393,1517,-10
105321700329,105321700331,2,1861,2054,-10
105325014861,105325014860,-1,1530,1810,-10
105326758894,105326758899,5,1477,1376,-10
105328232387,105328232390,3,2023,2052,-10
105330515211,105330515212,1,873,1606,-10
105332479037,105332479039,2,1852,1722,-10
105335804743,105335804724,-19,1421,1374,-10
105337146647,105337146649,2,2244,1992,-10
105337525332,105337525334,2,1146,868,-10
105340420522,105340420525,3,1749,1277,-10
105345592466,105345592469,3,1083,1186,-10
105346027578,105346027579,1,1419,1961,-10
105346219184,105346219186,2,1854,1847,-10
105349292546,105349292546,0,1592,1373,-10
105352792066,105352792066,0,1647,2042,-10
105360943881,105360943883,2,1715,1991,-10
105361306327,105361306327,0,1923,1812,-10
105361361785,105361361786,1,2448,1975,-10
105364223374,105364223378,4,1928,2100,-10
105365327634,105365327637,3,1522,1664,-10
105366316154,105366316161,7,1755,1866,-10
105368146313,105368146315,2,1813,1882,-10
105371214569,105371214573,4,2132,2187,-10
105372999526,105372999526,0,1341,1332,-10
105375480274,105375480279,5,1197,1131,-10
105376049663,105376049665,2,1747,1909,-10
105378449677,105378449679,2,932,1553,-10
105382126006,105382126007,1,2393,2025,-10
105383121740,105383121743,3,1577,1361,-10
105384773761,105384773765,4,1516,1424,-10
105385401188,105385401191,3,1331,883,-10
105389166165,105389166187,22,1292,1439,-10
105390672650,105390672654,4,978,1276,-10
105392671141,105392671144,3,1760,1537,-10
105396026691,105396026691,0,1594,1395,-10
105400262181,105400262182,1,1170,954,-10
105405109597,105405109597,0,1395,1325,-10
105410489703,105410489706,3,1636,1385,-10
105410589029,105410589030,1,1299,1847,-10
105411525874,105411525875,1,1521,1569,-10
105418877647,105418877667,20,1369,5365,-10
105419411380,105419411380,0,2564,1922,-10
105420922870,105420922871,1,1606,1235,-10
105421157323,105421157324,1,1636,1749,-10
105423273150,105423273152,2,1441,1579,-10
105425070895,105425070898,3,1175,779,-10
105430421390,105430421390,0,2909,2772,-10
105433730173,105433730175,2,1444,1658,-10
105433947523,105433947527,4,1443,1605,-10
105434796738,105434796740,2,2404,2359,-10
105440453377,105440453378,1,1537,1316,-10
105443209038,105443209043,5,2732,1622,-10
105448743036,105448743037,1,1387,1743,-10
105450996226,105450996229,3,2089,2582,-10
105453180365,105453180365,0,1817,2175,-10
105456355086,105456355086,0,955,1209,-10
105456427209,105456427210,1,1615,1603,-10
105458414826,105458414830,4,1615,1474,-10
105460009026,105460009027,1,1438,1419,-10
105461325138,105461325140,2,1411,1930,-10
105462850333,105462850334,1,1734,1502,-10
105466273705,105466273706,1,1205,1291,-10
105466431128,105466431135,7,1384,1121,-10
105471182757,105471182759,2,2362,1652,-10
105471516492,105471516503,11,1665,1679,-10
105473111925,105473111928,3,2435,1743,-10
105473196549,105473196551,2,1875,1165,-10
105474456206,105474456208,2,1087,1292,-10
105474853075,105474853078,3,1260,1508,-10
105476299607,105476299609,2,747,976,-10
105477409494,105477409497,3,1753,1619,-10
105478039279,105478039281,2,1715,1539,-10
105478426239,105478426241,2,1252,1196,-10
105480146387,105480146390,3,1756,1405,-10
105480840904,105480840906,2,1670,1397,-10
105483175907,105483175910,3,1748,1455,-10
105483213886,105483213890,4,1650,845,-10
105488814135,105488814138,3,2423,1661,-10
105491725961,105491725963,2,1906,1879,-10
105495642586,105495642588,2,1499,1287,-10
105500230899,105500230902,3,1997,1460,-10
105502290371,105502290371,0,1721,1426,-10
105503466672,105503466673,1,2136,1968,-10
105504576216,105504576219,3,1316,1305,-10
105508113144,105508113146,2,2508,1603,-10
105508926937,105508926939,2,1323,1635,-10
105510722874,105510722875,1,1585,1799,-10
105510777766,105510777766,0,1596,1901,-10
105511797888,105511797890,2,1884,2275,-10
105512900877,105512900878,1,1696,1064,-10
105516905620,105516905622,2,1768,1639,-10
105518007436,105518007435,-1,1447,1487,-10
105522611226,105522611230,4,2552,1854,-10
105523130037,105523130038,1,1543,1526,-10
105525051094,105525051095,1,1318,2053,-10
105525309806,105525309809,3,2045,1361,-10
105526627327,105526627325,-2,1196,1100,-10
105529299753,105529299755,2,1167,1669,-10
105534372154,105534372158,4,1529,1309,-10
105535485050,105535485053,3,1770,1471,-10
105538127598,105538127599,1,1649,1474,-10
105538359948,105538359950,2,2104,1508,-10
105544012367,105544012370,3,1663,1635,-10
105544174015,105544174017,2,1436,1261,-10
105548280574,105548280576,2,2225,1801,-10
105548641733,105548641725,-8,1232,6025,-10
105551012816,105551012817,1,1987,1657,-10
105552251666,105552251667,1,1880,1911,-10
105554818725,105554818725,0,1588,1808,-10
105555698835,105555698839,4,1315,1315,-10
105556310729,105556310729,0,1401,1833,-10
105560568205,105560568206,1,1351,1538,-10
105561011249,105561011251,2,836,1174,-10
105563127049,105563127052,3,1012,1476,-10
105567118628,105567118630,2,1788,1377,-10
105567475374,105567475376,2,1745,1767,-10
105568342774,105568342770,-4,1095,2986,-10
105573349398,105573349400,2,1822,1500,-10
105574653350,105574653354,4,1038,1228,-10
105578945998,105578945999,1,1603,1388,-10
105581859882,105581859884,2,1335,1404,-10
105582244000,105582244001,1,1616,1778,-10
105582501374,105582501379,5,2162,1047,-10
105586465242,105586465235,-7,1640,6666,-10
105592020245,105592020246,1,1853,1630,-10
105593288255,105593288256,1,1654,1544,-10
105595962107,105595962115,8,3113,1183,-10
105596769180,105596769183,3,1652,1216,-10
105598267064,105598267064,0,1848,1110,-10
105599980320,105599980322,2,1737,1444,-10
105601476621,105601476622,1,1543,1684,-10
105602222580,105602222580,0,694,565,-10
105603185630,105603185631,1,1646,1807,-10
105605440463,105605440467,4,1337,1512,-10
105605706970,105605706973,3,1631,1251,-10
105606144998,105606144998,0,1300,1685,-10
105607809776,105607809778,2,2000,1662,-10
105609960643,105609960646,3,1403,1103,-10
105611133225,105611133232,7,1240,1222,-10
105611713289,105611713282,-7,2076,7539,-10
105612456745,105612456741,-4,1136,4380,-10
105616002285,105616002282,-3,1409,2268,-10
105617726131,105617726142,11,392,2258,-10
105620865406,105620865407,1,871,1114,-10
105624212969,105624212970,1,1808,1370,-10
105625485254,105625485254,0,1382,1699,-10
105629926268,105629926270,2,1594,1701,-10
105630068894,105630068898,4,1285,1253,-10
105630262510,105630262510,0,1506,1679,-10
105631491154,105631491155,1,1298,1728,-10
105636263283,105636263286,3,1741,1606,-10
105636481060,105636481062,2,1566,1563,-10
105636732025,105636732026,1,2163,1030,-10
105637034585,105637034587,2,1556,1223,-10
105639041762,105639041763,1,1099,1147,-10
105640095400,105640095401,1,1497,1586,-10
105640175878,105640175880,2,1128,949,-10
105641115251,105641115254,3,1433,1452,-10
105644974804,105644974804,0,1880,1910,-10
105646053078,105646053081,3,1185,940,-10
105648342610,105648342613,3,1759,1728,-10
105648570860,105648570862,2,1878,1457,-10
105648652200,105648652203,3,2095,1233,-10
105651887026,105651887028,2,1351,1446,-10
105652249482,105652249482,0,1428,1494,-10
105654936607,105654936613,6,3201,2341,-10
105655429087,105655429089,2,1617,1720,-10
105655690043,105655690043,0,1224,1552,-10
105657905233,105657905239,6,7462,3326,-10
105658658474,105658658475,1,1583,1743,-10
105659094027,105659094029,2,1075,900,-10
105660108447,105660108441,-6,1051,5647,-10
105660998372,105660998373,1,1388,1627,-10
105662113203,105662113205,2,1644,1089,-10
105662623189,105662623191,2,2087,1945,-10
105666128835,105666128838,3,1214,889,-10
105668713704,105668713706,2,1526,1387,-10
105669331546,105669331547,1,1932,1727,-10
105673192313,105673192313,0,2186,1837,-10
105674663042,105674663044,2,2023,1271,-10
105680221219,105680221222,3,2302,1934,-10
105681027193,105681027196,3,1471,1383,-10
105682559350,105682559351,1,1222,1761,-10
105682856596,105682856599,3,1872,1527,-10
105688949099,105688949102,3,4058,2602,-10
105690280037,105690280034,-3,2807,5238,-10
105691571781,105691571782,1,1278,1563,-10
105693106211,105693106213,2,1599,1311,-10
105698962925,105698962926,1,1324,1195,-10
105700674280,105700674282,2,1508,1419,-10
105700860732,105700860727,-5,1091,3020,-10
105702320079,105702320082,3,1500,1737,-10
105704050022,105704050025,3,1136,1427,-10
105705945149,105705945150,1,1185,1551,-10
105706068182,105706068187,5,2117,1878,-10
105707052709,105707052713,4,1240,1336,-10
105709015124,105709015125,1,1392,1423,-10
105712480658,105712480659,1,1201,1305,-10
105716960435,105716960436,1,1534,1810,-10
105720097013,105720097017,4,2261,1657,-10
105725224710,105725224716,6,2830,1552,-10
105726142142,105726142144,2,1857,2289,-10
105728322271,105728322274,3,1660,1800,-10
105731063406,105731063406,0,1671,1767,-10
105732622505,105732622505,0,1471,1820,-10
105738781042,105738781049,7,2938,1512,-10
105739557954,105739557954,0,1226,1460,-10
105743741202,105743741202,0,1200,1302,-10
105743841990,105743841993,3,1041,771,-10
105748302700,105748302703,3,1524,1330,-10
105751360877,105751360877,0,1562,1512,-10
105751824158,105751824162,4,1962,1794,-10
105752424836,105752424841,5,2936,1667,-10
105753235686,105753235690,4,1753,1464,-10
105754369738,105754369738,0,1270,1561,-10
105758379535,105758379535,0,1354,1789,-10
105762653939,105762653938,-1,2953,4516,-10
105763276498,105763276501,3,170,1380,-10
105763655518,105763655519,1,1332,1284,-10
105766468207,105766468210,3,1774,1215,-10
105766921175,105766921178,3,1956,1939,-10
105767641835,105767641836,1,1314,1481,-10
105770587885,105770587886,1,2190,1987,-10
105771410689,105771410691,2,1061,901,-10
105772430739,105772430743,4,2511,1256,-10
105773472490,105773472493,3,1832,2128,-10
105778156244,105778156246,2,2082,1451,-10
105778925154,105778925157,3,1453,1268,-10
105779184770,105779184774,4,2208,1506,-10
105780418027,105780418030,3,1610,1402,-10
105782308817,105782308819,2,1382,1746,-10
105783991149,105783991149,0,1510,2338,-10
105791419436,105791419443,7,1812,775,-10
105792504536,105792504535,-1,1708,2086,-10
105794435058,105794435059,1,1480,1494,-10
105795170924,105795170932,8,72,1085,-10
105796230351,105796230351,0,1179,1438,-10
105798466840,105798466842,2,2094,1892,-10
105800733054,105800733056,2,2526,2128,-10
105804118655,105804118659,4,1706,1658,-10
105811697579,105811697579,0,1002,2036,-10
105815837066,105815837067,1,1566,1853,-10
105818125845,105818125849,4,1979,2026,-10
105819899751,105819899751,0,1703,2174,-10
105821210170,105821210173,3,1432,1814,-10
105822890922,105822890923,1,814,971,-10
105823500197,105823500197,0,1261,1287,-10
105825534527,105825534530,3,2124,1695,-10
105826251623,105826251630,7,4149,1265,-10
105826306901,105826306903,2,1582,1517,-10
105830401461,105830401462,1,1566,2111,-10
105831193164,105831193158,-6,1138,3711,-10
105836181850,105836181851,1,1350,2075,-10
105842945276,105842945279,3,2358,1351,-10
105846163447,105846163447,0,1167,990,-10
105847226519,105847226519,0,1404,1186,-10
105847416616,105847416618,2,1402,1007,-10
105849062833,105849062835,2,1311,1351,-10
105849273229,105849273230,1,2336,1988,-10
105850386991,105850386993,2,1608,813,-10
105853591781,105853591783,2,1574,1336,-10
105854889229,105854889230,1,1893,2255,-10
105856789003,105856789003,0,1620,1215,-10
105859360007,105859360010,3,1537,1661,-10
105861423186,105861423186,0,1085,1521,-10
105862664412,105862664414,2,1559,1447,-10
105872572297,105872572298,1,1640,1203,-10
105874998181,105874998183,2,1993,1420,-10
105878560421,105878560422,1,1955,1670,-10
105878742363,105878742366,3,1995,1395,-10
105879272735,105879272734,-1,1106,1279,-10
105879460147,105879460138,-9,109,615,-10
105880144938,105880144940,2,2265,1755,-10
105883486668,105883486668,0,1211,1130,-10
105883776884,105883776883,-1,1374,1885,-10
105887160376,105887160378,2,1381,1314,-10
105887304007,105887304009,2,1014,1207,-10
105890952958,105890952959,1,1209,1329,-10
105891318978,105891318982,4,1176,1198,-10
105891773181,105891773181,0,1512,1799,-10
105895331018,105895331023,5,1627,1478,-10
105900754507,105900754502,-5,1204,3376,-10
105901178113,105901178116,3,1289,1400,-10
105901833467,105901833466,-1,1128,1398,-10
105901941198,105901941203,5,1366,1410,-10
105905883604,105905883604,0,1582,1926,-10
105907747926,105907747930,4,1772,1132,-10
105908362253,105908362254,1,1734,1278,-10
105909747827,105909747830,3,1870,1335,-10
105910079893,105910079894,1,1747,1676,-10
105910521972,105910521973,1,1964,1454,-10
105911197261,105911197265,4,2258,2217,-10
105913682756,105913682762,6,2642,1315,-10
105915294665,105915294664,-1,33388,30687,-10
105915929977,105915929978,1,993,1296,-10
105918056295,105918056298,3,1541,1423,-10
105920167254,105920167257,3,1455,1643,-10
105921108101,105921108103,2,1708,1400,-10
105921523187,105921523183,-4,1576,3812,-10
105923077624,105923077624,0,1667,24455,-10
105923870078,105923870078,0,1528,1866,-10
105924148426,105924148429,3,1849,1450,-10
105927635021,105927635025,4,1727,1440,-10
105928304354,105928304358,4,1296,1211,-10
105930980481,105930980482,1,1724,1937,-10
105931468270,105931468269,-1,1074,1735,-10
105931789696,105931789678,-18,1213,1063,-10
105932012745,105932012747,2,1270,1414,-10
105933471982,105933471985,3,1640,1644,-10
105934552838,105934552843,5,7576,5416,-10
105937899319,105937899322,3,1745,1306,-10
105939466888,105939466891,3,1712,1348,-10
105940539850,105940539850,0,909,827,-10
105942193497,105942193498,1,1111,1619,-10
105943145437,105943145440,3,2651,1388,-10
105946581462,105946581463,1,1409,1390,-10
105946756487,105946756490,3,2103,2282,-10
105949338870,105949338870,0,1458,1777,-10
105956086593,105956086594,1,972,991,-10
105957330577,105957330578,1,1808,2203,-10
105958242449,105958242448,-1,1657,1681,-10
105958561775,105958561777,2,1478,1403,-10
105961692579,105961692570,-9,46857,66938,-10
105961857646,105961857628,-18,1605,1659,-10
105962041794,105962041795,1,1298,1394,-10
105967616830,105967616834,4,1728,1691,-10
105972803419,105972803422,3,2091,1410,-10
105973152663,105973152665,2,920,1024,-10
105973730605,105973730610,5,988,1054,-10
105975335410,105975335412,2,1050,1560,-10
105976190977,105976190985,8,954,1423,-10
105981945532,105981945534,2,1153,1657,-10
105984422127,105984422132,5,1471,1225,-10
105984552553,105984552554,1,1961,2170,-10
105986815277,105986815282,5,953,1323,-10
105989937204,105989937205,1,1797,1492,-10
105990560583,105990560585,2,1614,1710,-10
105999918704,105999918707,3,1589,1994,-10
106000238951,106000238950,-1,1079,1724,-10
106000909597,106000909597,0,1284,1009,-10
106001341607,106001341606,-1,1247,2396,-10
106004273322,106004273327,5,9473,5109,-10
106011936859,106011936862,3,2022,1271,-10
106012184826,106012184829,3,1132,1334,-10
106013732627,106013732630,3,1089,1851,-10
106014825254,106014825254,0,1259,1402,-10
106016167410,106016167411,1,809,1306,-10
106017430650,106017430650,0,2139,2199,-10
106018090654,106018090657,3,1371,1594,-10
106018396291,106018396293,2,1623,1739,-10
106021233215,106021233216,1,1547,2126,-10
106021459437,106021459430,-7,1411,3909,-10
106022930539,106022930540,1,1207,1535,-10
106028045537,106028045537,0,1308,1210,-10
106033141478,106033141479,1,1681,1820,-10
106033533117,106033533118,1,1276,1605,-10
106036438770,106036438769,-1,1320,1400,-10
106038940925,106038940926,1,2018,1209,-10
106040082557,106040082558,1,1538,1401,-10
106043015943,106043015947,4,1820,1523,-10
106046618279,106046618283,4,1664,1366,-10
106050031256,106050031259,3,1736,1327,-10
106050325277,106050325281,4,1456,1630,-10
106056033326,106056033333,7,5001,1236,-10
106058838383,106058838387,4,1709,1177,-10
106060664299,106060664299,0,585,688,-10
106063044986,106063044987,1,1118,1317,-10
106064039108,106064039109,1,1087,1563,-10
106064589177,106064589178,1,889,1260,-10
106067247543,106067247544,1,1605,1587,-10
106068622394,106068622399,5,807,1303,-10
106071376945,106071376947,2,1485,1665,-10
106072846098,106072846099,1,2189,1240,-10
106073251783,106073251784,1,1466,1686,-10
106076764467,106076764470,3,782,934,-10
106080272224,106080272227,3,1295,1457,-10
106081240761,106081240762,1,1644,1776,-10
106086208865,106086208866,1,1232,1524,-10
106087799481,106087799481,0,2867,1714,-10
106089097309,106089097309,0,1378,1550,-10
106089995158,106089995162,4,1353,1593,-10
106094866418,106094866422,4,2057,2044,-10
106095808494,106095808496,2,1457,1280,-10
106097183262,106097183265,3,1520,1307,-10
106098670498,106098670502,4,1255,1315,-10
106099695882,106099695902,20,1582,1402,-10
106101448654,106101448655,1,1462,1383,-10
106103602864,106103602866,2,1374,1443,-10
106104847366,106104847370,4,1271,1459,-10
106106835546,106106835549,3,2522,2201,-10
106108419724,106108419726,2,1524,1563,-10
106109112934,106109112938,4,1733,2422,-10
106110942159,106110942163,4,2043,1532,-10
106112321674,106112321677,3,1178,1110,-10
106115283034,106115283035,1,1148,1241,-10
106117077170,106117077191,21,1226,1328,-10
106118463850,106118463850,0,1221,1660,-10
106119496594,106119496597,3,1602,1313,-10
106119816197,106119816199,2,1449,1642,-10
106120735008,106120735006,-2,1291,1287,-10
106121956336,106121956337,1,1437,1202,-10
106123013394,106123013397,3,1896,1916,-10
106125164218,106125164222,4,1345,1219,-10
106126850590,106126850592,2,1278,1319,-10
106132839578,106132839578,0,856,1200,-10
106134603735,106134603738,3,1763,1404,-10
106135660395,106135660389,-6,849,2283,-10
106137922094,106137922095,1,1078,1179,-10
106141866110,106141866113,3,2234,1729,-10
106147638517,106147638519,2,1042,759,-10
106149050351,106149050353,2,1491,1938,-10
106150203667,106150203670,3,1053,973,-10
106152010040,106152010043,3,1816,1978,-10
106152379184,106152379186,2,1749,1815,-10
106153782305,106153782305,0,953,1405,-10
106155413621,106155413623,2,1010,589,-10
106156251641,106156251646,5,4894,2170,-10
106159027462,106159027463,1,1661,1116,-10
106162563218,106162563197,-21,1659,1259,-10
106164171759,106164171763,4,2212,1373,-10
106164485140,106164485142,2,1373,1693,-10
106165938569,106165938571,2,1351,1723,-10
106168445879,106168445881,2,1355,1116,-10
106169032776,106169032779,3,1362,1436,-10
106169338197,106169338200,3,2487,1535,-10
106171534690,106171534690,0,2367,3009,-10
106173421535,106173421537,2,1631,1490,-10
106174278650,106174278653,3,1702,1343,-10
106177110462,106177110463,1,1826,1686,-10
106177177789,106177177791,2,1135,1094,-10
106177341167,106177341169,2,1793,1927,-10
106180834813,106180834813,0,1613,2170,-10
106181047659,106181047662,3,1343,976,-10
106185268049,106185268046,-3,1927,1981,-10
106190740154,106190740155,1,1455,1476,-10
106192093494,106192093494,0,2146,2312,-10
106192408829,106192408830,1,1218,1555,-10
106192555311,106192555312,1,1551,1205,-10
106195387195,106195387190,-5,960,2433,-10
106195842941,106195842942,1,31752,26285,-10
106197658490,106197658493,3,2362,1552,-10
106198565861,106198565864,3,1437,1465,-10
106202997417,106202997417,0,1885,1985,-10
106205616704,106205616703,-1,1246,1951,-10
106211219924,106211219925,1,1522,1528,-10
106212472801,106212472799,-2,1521,2179,-10
106213411681,106213411683,2,1147,1097,-10
106218206312,106218206319,7,1806,1188,-10
106219639157,106219639139,-18,1715,2397,-10
106220104924,106220104927,3,1232,1361,-10
106221010929,106221010913,-16,1287,1329,-10
106221586814,106221586817,3,1354,1637,-10
106222196584,106222196585,1,1484,1170,-10
106232054048,106232054049,1,2522,2663,-10
106237568446,106237568449,3,2233,2616,-10
106239555598,106239555597,-1,1324,2524,-10
106239592786,106239592789,3,3357,2469,-10
106242010257,106242010260,3,1475,1655,-10
106244288142,106244288145,3,1536,985,-10
106245984932,106245984936,4,1913,1599,-10
106247460492,106247460493,1,1707,2247,-10
106250239530,106250239530,0,1614,1423,-10
106250965714,106250965717,3,2091,1623,-10
106251326266,106251326268,2,1580,1952,-10
106251498160,106251498162,2,1452,1555,-10
106257888366,106257888370,4,2276,1335,-10
106259505856,106259505858,2,1589,1771,-10
106261682976,106261682978,2,1945,1948,-10
106262710654,106262710658,4,931,1396,-10
106266383035,106266383034,-1,1106,1930,-10
106266434114,106266434114,0,1511,1242,-10
106267538607,106267538607,0,959,779,-10
106270319661,106270319663,2,1126,1042,-10
106270763518,106270763518,0,1390,1497,-10
106271903515,106271903517,2,1748,1634,-10
106272385509,106272385506,-3,725,906,-10
106273293880,106273293881,1,1519,1596,-10
106274281830,106274281829,-1,2022,1818,-10
106277186214,106277186216,2,1281,1176,-10
106281612421,106281612421,0,1873,1928,-10
106281752446,106281752447,1,1734,1834,-10
106281988651,106281988657,6,880,1305,-10
106284776422,106284776425,3,1672,1249,-10
106288344777,106288344775,-2,1507,1729,-10
106294328682,106294328683,1,1638,1286,-10
106296283276,106296283259,-17,1425,1150,-10
106297050666,106297050667,1,1506,1762,-10
106298736814,106298736819,5,1058,848,-10
106300308322,106300308324,2,1563,1765,-10
106302243797,106302243786,-11,16325,39659,-10
106304879834,106304879838,4,1287,1157,-10
106304945328,106304945326,-2,1423,1210,-10
106305630789,106305630790,1,1340,1306,-10
106307042644,106307042647,3,2630,1482,-10
106311453477,106311453478,1,1627,1525,-10
106315335086,106315335089,3,943,828,-10
106318194367,106318194369,2,1196,1380,-10
106319353955,106319353955,0,1693,1710,-10
106319955325,106319955330,5,1754,1023,-10
106320361151,106320361154,3,1147,1590,-10
106320594466,106320594467,1,1782,1475,-10
106328251030,106328251034,4,2023,1719,-10
106329408801,106329408804,3,1655,1152,-10
106331886214,106331886214,0,2046,1600,-10
106333293940,106333293942,2,896,954,-10
106333476596,106333476578,-18,1157,1304,-10
106334379316,106334379319,3,1684,1320,-10
106335220236,106335220239,3,1760,1313,-10
106339703181,106339703184,3,1515,1865,-10
106342430921,106342430922,1,1217,1177,-10
106342674785,106342674785,0,1542,1185,-10
106345281159,106345281162,3,2143,1446,-10
106348656614,106348656617,3,1200,1120,-10
106350777686,106350777687,1,1482,1092,-10
106361096334,106361096337,3,2620,2144,-10
106362260710,106362260702,-8,23348,14413,-10
106362436870,106362436874,4,2310,1919,-10
106362608865,106362608866,1,1090,1191,-10
106362815820,106362815822,2,1645,1481,-10
106363979694,106363979693,-1,2052,2013,-10
106366642934,106366642937,3,930,1476,-10
106366855698,106366855701,3,1379,1512,-10
106366948027,106366948029,2,1836,2236,-10
106367774327,106367774327,0,1036,1398,-10
106368945789,106368945793,4,1522,1224,-10
106371444366,106371444366,0,1478,1470,-10
106375362160,106375362162,2,1861,1784,-10
106375926345,106375926367,22,1683,1234,-10
106377496350,106377496351,1,1401,1387,-10
106378090852,106378090870,18,1286,1234,-10
106386845086,106386845094,8,1889,911,-10
106387191818,106387191822,4,1733,1442,-10
106388314278,106388314281,3,1708,1277,-10
106391877575,106391877578,3,1394,1518,-10
106393176555,106393176559,4,1533,1210,-10
106394954267,106394954269,2,881,1522,-10
106396367763,106396367746,-17,795,1063,-10
106406531909,106406531910,1,1735,808,-10
106408008221,106408008222,1,1430,1379,-10
106408656174,106408656176,2,1575,1478,-10
106408743141,106408743144,3,1719,1577,-10
106418646051,106418646053,2,1277,1219,-10
106419548717,106419548721,4,956,1022,-10
106422014836,106422014838,2,1356,1692,-10
106425006222,106425006223,1,1177,1455,-10
106426375910,106426375913,3,2376,1554,-10
106427178974,106427178975,1,1606,1394,-10
106427564379,106427564382,3,11492,10589,-10
106430720294,106430720297,3,1863,1650,-10
106436561768,106436561769,1,2006,1581,-10
106443079030,106443079031,1,1356,1952,-10
106446721225,106446721227,2,1287,1460,-10
106446937241,106446937244,3,1450,1440,-10
106449498549,106449498551,2,1477,967,-10
106449742666,106449742667,1,1712,1391,-10
106455647171,106455647169,-2,1164,1793,-10
106455792235,106455792236,1,1890,1666,-10
106456533150,106456533150,0,1299,1708,-10
106459278250,106459278251,1,1437,1723,-10
106459519506,106459519508,2,2241,1630,-10
106465102064,106465102065,1,1220,1515,-10
106466059346,106466059347,1,1803,1548,-10
106467110190,106467110196,6,1460,1345,-10
106468226640,106468226643,3,2070,1817,-10
106470783055,106470783057,2,1791,1401,-10
106470857354,106470857356,2,1726,1561,-10
106475331566,106475331570,4,1341,1301,-10
106476163013,106476163014,1,1192,1885,-10
106485128765,106485128775,10,1087,923,-10
106485903758,106485903758,0,1162,1070,-10
106487022859,106487022860,1,1386,2138,-10
106488209444,106488209445,1,1813,1876,-10
106489718142,106489718144,2,976,896,-10
106489843230,106489843231,1,688,1569,-10
106492757886,106492757889,3,1926,1175,-10
106495897947,106495897948,1,1340,1761,-10
106498001438,106498001438,0,1413,1891,-10
106499155521,106499155522,1,1643,1566,-10
106501010970,106501010973,3,2058,1641,-10
106505910638,106505910639,1,2039,1857,-10
106508677734,106508677736,2,1220,1206,-10
106509275457,106509275458,1,1192,1788,-10
106510696212,106510696215,3,2523,1632,-10
106511948751,106511948757,6,4095,1400,-10
106512176610,106512176614,4,2746,2050,-10
106512233769,106512233774,5,65237,34656,-10
106514116484,106514116467,-17,1155,795,-10
106516088081,106516088083,2,1532,1372,-10
106518302802,106518302803,1,1209,1811,-10
106521634548,106521634535,-13,1449,836,-10
106522249539,106522249541,2,1756,1517,-10
106522649935,106522649935,0,1682,1230,-10
106523489388,106523489387,-1,2277,4027,-10
106525414157,106525414157,0,1339,1501,-10
106526663565,106526663570,5,5281,20836,-10
106527648021,106527648022,1,2210,2172,-10
106529236650,106529236651,1,1686,1240,-10
106531477092,106531477097,5,1115,1402,-10
106531827150,106531827152,2,1324,1735,-10
106534022272,106534022275,3,1918,1306,-10
106535726506,106535726506,0,1494,1420,-10
106535915451,106535915457,6,5504,2153,-10
106539351563,106539351562,-1,1690,2043,-10
106541454231,106541454234,3,1412,1114,-10
106543800928,106543800930,2,1673,1592,-10
106544315237,106544315239,2,1816,1315,-10
106548042326,106548042328,2,1330,1721,-10
106548243880,106548243882,2,1679,1062,-10
106549442806,106549442807,1,1632,1591,-10
106550987729,106550987730,1,1586,1918,-10
106557524956,106557524955,-1,1137,2093,-10
106559262234,106559262235,1,2255,1744,-10
106559547048,106559547049,1,2082,1838,-10
106560980513,106560980515,2,1925,1771,-10
106562253181,106562253180,-1,2258,3475,-10
106566034403,106566034403,0,1285,1729,-10
106567778377,106567778377,0,1261,1374,-10
106575255502,106575255506,4,1461,1919,-10
106576005617,106576005619,2,1686,2500,-10
106576342823,106576342825,2,1188,1068,-10
106577036608,106577036609,1,1741,1503,-10
106578552984,106578552984,0,1875,2056,-10
106580878567,106580878567,0,959,1290,-10
106581579305,106581579307,2,1656,1515,-10
106584863502,106584863502,0,1524,1396,-10
106590899305,106590899307,2,1186,1159,-10
106593878876,106593878876,0,930,1126,-10
106597244233,106597244235,2,217,937,-10
106598890060,106598890062,2,1540,966,-10
106601576870,106601576870,0,1202,1635,-10
106603304149,106603304149,0,750,542,-10
106605637230,106605637230,0,1648,1878,-10
106605871835,106605871837,2,1363,1385,-10
106606694923,106606694926,3,2025,1600,-10
106609553051,106609553055,4,1701,1502,-10
106612854855,106612854855,0,841,1594,-10
106619107718,106619107721,3,2205,1299,-10
106623795316,106623795318,2,577,898,-10
106625302072,106625302073,1,1465,1432,-10
106626768975,106626768976,1,3373,3520,-10
106627928712,106627928713,1,1154,1270,-10
106628984685,106628984686,1,1372,1758,-10
106630091145,106630091146,1,1780,1177,-10
106630173794,106630173796,2,1424,1054,-10
106630253123,106630253127,4,1779,1839,-10
106630779525,106630779526,1,1957,1868,-10
106631824552,106631824569,17,491,1303,-10
106638330110,106638330109,-1,1188,1887,-10
106639184746,106639184749,3,702,1162,-10
106639913701,106639913702,1,1490,1575,-10
106642359563,106642359562,-1,1251,1922,-10
106642764276,106642764277,1,1539,1617,-10
106647089707,106647089710,3,1752,1901,-10
106647209408,106647209411,3,1221,1495,-10
106649484412,106649484413,1,1620,2083,-10
106653508540,106653508542,2,764,1036,-10
106654228301,106654228304,3,1986,1917,-10
106656352925,106656352928,3,1378,1555,-10
106657481231,106657481233,2,1300,1422,-10
106658075972,106658075972,0,1345,1911,-10
106660462338,106660462344,6,16218,8357,-10
106663984855,106663984859,4,1754,1242,-10
106665599312,106665599314,2,1920,2095,-10
106668292614,106668292617,3,1805,1806,-10
106670684745,106670684747,2,2195,2161,-10
106672041431,106672041431,0,1910,1818,-10
106676193854,106676193853,-1,1635,2059,-10
106681711134,106681711139,5,1740,1173,-10
106684252334,106684252336,2,1749,1147,-10
106685336757,106685336760,3,1926,959,-10
106685391838,106685391841,3,1548,1117,-10
106686386901,106686386901,0,1036,1843,-10
106686905624,106686905626,2,1631,1834,-10
106693303853,106693303857,4,1219,1445,-10
106694648041,106694648037,-4,1462,2493,-10
106696470428,106696470430,2,1292,1386,-10
106698723460,106698723462,2,1179,1457,-10
106699928871,106699928873,2,1236,2075,-10
106701476228,106701476229,1,1106,1332,-10
106705665469,106705665470,1,2171,1365,-10
106705779073,106705779074,1,1375,1247,-10
106706843477,106706843479,2,1477,1177,-10
106707212391,106707212395,4,1365,1328,-10
106710274135,106710274136,1,1896,1595,-10
106712906428,106712906430,2,1578,1542,-10
106715276421,106715276423,2,1092,2217,-10
106717335015,106717335018,3,1550,1161,-10
106717991450,106717991464,14,1443,1318,-10
106718257033,106718257033,0,1183,1338,-10
106720026867,106720026870,3,1655,2074,-10
106722058003,106722057985,-18,1349,1325,-10
106725332009,106725332010,1,1261,935,-10
106726255587,106726255579,-8,1659,1505,-10
106733854890,106733854894,4,1590,1375,-10
106736706807,106736706811,4,2022,1859,-10
106737419826,106737419829,3,2007,2070,-10
106741913473,106741913474,1,1606,2140,-10
106745803880,106745803880,0,1296,1170,-10
106748464871,106748464874,3,1208,1479,-10
106748744994,106748744977,-17,488,231,-10
106749000642,106749000645,3,1361,1189,-10
106751071397,106751071398,1,1710,1270,-10
106752912861,106752912865,4,1268,1617,-10
106753096125,106753096126,1,1206,1490,-10
106753925564,106753925563,-1,1333,2051,-10
106754967882,106754967885,3,2102,1793,-10
106762151271,106762151275,4,1483,1054,-10
106764964558,106764964560,2,1451,1754,-10
106768580168,106768580169,1,1687,1593,-10
106769913930,106769913930,0,1179,1474,-10
106770402779,106770402783,4,1465,1659,-10
106771876385,106771876386,1,1861,1454,-10
106772438861,106772438862,1,1500,1259,-10
106778276970,106778276971,1,1568,1212,-10
106779302556,106779302556,0,1693,1520,-10
106779397986,106779398000,14,1524,1389,-10
106787025136,106787025136,0,1589,1477,-10
106790749892,106790749894,2,1459,1702,-10
106791375937,106791375938,1,1870,1309,-10
106795274645,106795274649,4,2391,1624,-10
106795923054,106795923058,4,11934,6995,-10
106797174374,106797174374,0,1751,1986,-10
106797833581,106797833581,0,1155,888,-10
106798997747,106798997749,2,1172,1140,-10
106800794042,106800794044,2,1050,1563,-10
106803839120,106803839117,-3,1293,2250,-10
106803958955,106803958938,-17,1315,1403,-10
106806366237,106806366237,0,1757,2031,-10
106807390592,106807390593,1,1363,1208,-10
106807581210,106807581210,0,1680,1899,-10
106810118346,106810118345,-1,1647,1690,-10
106810182233,106810182235,2,1214,1155,-10
106813805751,106813805754,3,928,1247,-10
106814591546,106814591549,3,1720,1277,-10
106814651511,106814651513,2,1686,1594,-10
106815681696,106815681700,4,1355,1175,-10
106815815797,106815815800,3,1291,1310,-10
106816587018,106816587000,-18,919,1232,-10
106818747694,106818747695,1,1752,1880,-10
106820078069,106820078070,1,1144,926,-10
106822895872,106822895875,3,2041,1048,-10
106826279610,106826279609,-1,1352,1729,-10
106829440649,106829440651,2,1552,1202,-10
106831449549,106831449549,0,1203,1629,-10
106833517374,106833517375,1,1653,1550,-10
106836698056,106836698057,1,738,853,-10
106841847037,106841847039,2,1849,1300,-10
106842850131,106842850132,1,1599,1665,-10
106843390766,106843390768,2,1868,1492,-10
106844846466,106844846471,5,1533,1544,-10
106847585826,106847585829,3,2057,1809,-10
106848230765,106848230766,1,2009,1768,-10
106849897234,106849897234,0,2233,3316,-10
106850920061,106850920065,4,1425,1376,-10
106852994026,106852994026,0,1289,1355,-10
106853127782,106853127782,0,1690,1465,-10
106853948755,106853948756,1,1630,1602,-10
106854589171,106854589173,2,1425,1619,-10
106856675722,106856675717,-5,1112,3023,-10
106859278830,106859278834,4,1500,1757,-10
106861104750,106861104729,-21,1441,1765,-10
106862599031,106862599029,-2,2503,3886,-10
106863185702,106863185705,3,1945,1480,-10
106863487854,106863487859,5,1556,1521,-10
106867879266,106867879268,2,1281,1511,-10
106869877650,106869877653,3,1642,1521,-10
106872146358,106872146359,1,1224,1278,-10
106874488010,106874488010,0,1705,1370,-10
106874774996,106874774998,2,2098,2280,-10
106875419908,106875419910,2,1099,1013,-10
106875621146,106875621146,0,1162,1619,-10
106875972261,106875972262,1,1274,1599,-10
106876233266,106876233260,-6,29827,15750,-10
106876480896,106876480897,1,1455,1584,-10
106877648117,106877648118,1,1490,1644,-10
106877798006,106877798007,1,1486,1977,-10
106880240367,106880240371,4,1373,1564,-10
106880776389,106880776391,2,1293,1541,-10
106884440343,106884440346,3,1313,1233,-10
106885581951,106885581951,0,1877,1869,-10
106887591059,106887591060,1,852,768,-10
106890704154,106890704156,2,2390,1615,-10
106890738454,106890738458,4,2188,1588,-10
106891677302,106891677302,0,1418,1773,-10
106891923199,106891923203,4,1532,1454,-10
106892677798,106892677801,3,1724,1611,-10
106895274702,106895274705,3,1937,1738,-10
106895557182,106895557161,-21,1839,1784,-10
106895713330,106895713347,17,1258,1537,-10
106897013807,106897013802,-5,560,1405,-10
106900695818,106900695819,1,1779,1505,-10
106903242949,106903242949,0,2005,2974,-10
106908304546,106908304550,4,1423,1217,-10
106908525190,106908525191,1,1537,1405,-10
106910734095,106910734097,2,1160,1071,-10
106912056509,106912056510,1,1661,1705,-10
106916880937,106916880938,1,1450,1212,-10
106917306873,106917306873,0,1262,923,-10
106918771389,106918771390,1,2118,1709,-10
106923581911,106923581915,4,1381,1198,-10
106927959965,106927959968,3,1526,1750,-10
106928620189,106928620192,3,1129,1125,-10
106931054859,106931054861,2,1525,926,-10
106940999212,106940999214,2,1489,1461,-10
106941873672,106941873676,4,1415,1283,-10
106946696602,106946696602,0,2057,2328,-10
106951878931,106951878931,0,1156,1587,-10
106952815083,106952815085,2,1371,1227,-10
106953698370,106953698373,3,1524,1488,-10
106954429053,106954429054,1,1670,1815,-10
106955286165,106955286166,1,1852,1466,-10
106956261614,106956261617,3,1430,1644,-10
106956449877,106956449878,1,1770,1810,-10
106964173151,106964173154,3,2930,2421,-10
106965332950,106965332950,0,1599,2170,-10
106968368933,106968368935,2,1322,756,-10
106969392918,106969392922,4,2312,1207,-10
106974180172,106974180176,4,1332,1315,-10
106984405626,106984405628,2,949,1234,-10
106986824731,106986824733,2,1293,1558,-10
106987239333,106987239333,0,1773,2142,-10
106987488964,106987488965,1,1917,1496,-10
106987594286,106987594298,12,1147,932,-10
106988424722,106988424723,1,1983,2383,-10
106988692478,106988692478,0,1318,1918,-10
106989785537,106989785537,0,1578,1358,-10
106993103126,106993103127,1,1354,1253,-10
106993192853,106993192856,3,2300,2087,-10
106993504722,106993504726,4,1100,1065,-10
106993633465,106993633466,1,1829,1391,-10
106995608099,106995608101,2,1762,2406,-10
106997515212,106997515211,-1,1228,2715,-10
106999610022,106999610025,3,1511,2111,-10
107000506774,107000506777,3,1806,1671,-10
107003321075,107003321078,3,1606,1858,-10
107006794957,107006794960,3,1514,1381,-10
107008750585,107008750588,3,1252,1118,-10
107009614070,107009614067,-3,875,1363,-10
107010676335,107010676337,2,2037,1926,-10
107013099385,107013099385,0,3122,3012,-10
107015284939,107015284939,0,1122,1389,-10
107015318113,107015318114,1,1341,1269,-10
107015810437,107015810440,3,729,1524,-10
107016880329,107016880329,0,1043,1370,-10
107019629372,107019629374,2,1345,1684,-10
107022131814,107022131817,3,1415,1376,-10
107024944475,107024944477,2,1515,1291,-10
107025207934,107025207937,3,1817,1976,-10
107026351771,107026351774,3,2718,1858,-10
107027035716,107027035718,2,1614,1561,-10
107028229494,107028229494,0,1541,1361,-10
107028387274,107028387269,-5,1687,1427,-10
107031164150,107031164150,0,1661,1702,-10
107035284020,107035284036,16,2028,1235,-10
107039443726,107039443730,4,1607,1805,-10
107039852805,107039852807,2,1735,1679,-10
107042455831,107042455834,3,1589,1579,-10
107042685974,107042685977,3,1578,1128,-10
107046465092,107046465086,-6,2218,7590,-10
107046574754,107046574755,1,1982,1794,-10
107048904144,107048904143,-1,1672,1799,-10
107050623921,107050623922,1,1385,1767,-10
107053197511,107053197514,3,1893,1815,-10
107057088204,107057088206,2,1262,1385,-10
107057714983,107057714986,3,1437,1622,-10
107063840546,107063840549,3,1664,1538,-10
107064333866,107064333865,-1,1342,1286,-10
107064873279,107064873282,3,1135,1348,-10
107065227400,107065227401,1,1472,1849,-10
107066331698,107066331700,2,1877,1495,-10
107066939330,107066939350,20,1637,1359,-10
107067123322,107067123326,4,1983,1236,-10
107068697677,107068697678,1,1346,1352,-10
107071262622,107071262623,1,1548,1601,-10
107071964474,107071964476,2,1152,1436,-10
107072595291,107072595293,2,698,310,-10
107075389519,107075389525,6,2813,1136,-10
107078054309,107078054312,3,2060,1677,-10
107078939598,107078939598,0,1422,1448,-10
107081417562,107081417559,-3,813,3092,-10
107082611212,107082611214,2,2820,2373,-10
107085983164,107085983166,2,753,1019,-10
107086703647,107086703654,7,1148,1225,-10
107088810486,107088810487,1,1179,1850,-10
107090444018,107090444019,1,1448,1867,-10
107091467825,107091467827,2,1388,1484,-10
107099537423,107099537425,2,1801,1924,-10
107100173778,107100173779,1,1621,1476,-10
107102414926,107102414934,8,5147,950,-10
107105599773,107105599775,2,1570,1251,-10
107106730281,107106730282,1,929,1117,-10
107107289757,107107289755,-2,1992,1435,-10
107108321082,107108321083,1,1623,1989,-10
107109738852,107109738834,-18,1558,1001,-10
107113529394,107113529397,3,1449,1650,-10
107113577838,107113577848,10,1675,1482,-10
107115744433,107115744435,2,1908,2191,-10
107118554537,107118554539,2,1387,1397,-10
107121347559,107121347559,0,1593,1795,-10
107122953578,107122953578,0,1626,1546,-10
107124906495,107124906498,3,2153,1593,-10
107125182211,107125182209,-2,961,1668,-10
107126122480,107126122481,1,1808,2105,-10
107126556294,107126556296,2,1422,1355,-10
107131852657,107131852659,2,1519,1286,-10
107135382749,107135382750,1,1585,1461,-10
107140596874,107140596874,0,1169,1492,-10
107140802887,107140802881,-6,1323,5817,-10
107141220273,107141220274,1,1651,1413,-10
107142036562,107142036564,2,988,1406,-10
107143264434,107143264436,2,1156,1230,-10
107145907154,107145907156,2,891,1843,-10
107146306361,107146306356,-5,1926,3993,-10
107150141521,107150141522,1,1439,1192,-10
107152342909,107152342909,0,1383,1522,-10
107152452629,107152452633,4,1370,1264,-10
107154769396,107154769398,2,752,1819,-10
107156252442,107156252445,3,1649,1328,-10
107159645577,107159645577,0,1431,1896,-10
107162284853,107162284854,1,1611,1397,-10
107162836281,107162836282,1,1069,1014,-10
107164179297,107164179298,1,1459,1544,-10
107168206429,107168206429,0,2298,2630,-10
107170626726,107170626732,6,1085,1242,-10
107171387606,107171387605,-1,1432,1786,-10
107172148254,107172148258,4,1534,984,-10
107174688798,107174688804,6,50,2292,-10
107176522872,107176522874,2,1484,1332,-10
107177015216,107177015221,5,3589,2487,-10
107177509183,107177509186,3,1463,1321,-10
107178101066,107178101068,2,1137,1351,-10
107180827234,107180827238,4,1177,918,-10
107181606474,107181606478,4,1882,1052,-10
107181874609,107181874610,1,1255,1677,-10
107183325105,107183325106,1,1102,1656,-10
107184493006,107184493009,3,1603,1668,-10
107185573320,107185573321,1,1762,1807,-10
107187041768,107187041771,3,1746,915,-10
107189813574,107189813573,-1,1269,1194,-10
107191447321,107191447323,2,1494,1001,-10
107192896855,107192896856,1,1403,1343,-10
107194616453,107194616454,1,1284,1462,-10
107197389868,107197389869,1,1448,1278,-10
107198088970,107198088973,3,1797,1907,-10
107201604127,107201604144,17,2191,1385,-10
107203998670,107203998670,0,1757,2117,-10
107209184605,107209184606,1,1550,2241,-10
107211540438,107211540442,4,2285,1712,-10
107214059570,107214059571,1,2140,1957,-10
107214118413,107214118413,0,1436,1373,-10
107218222800,107218222801,1,1879,1907,-10
107218741491,107218741493,2,1326,1176,-10
107220002360,107220002362,2,2081,1959,-10
107223535257,107223535258,1,1350,1347,-10
107228816965,107228816967,2,1185,1478,-10
107228929900,107228929903,3,1340,1257,-10
107234764417,107234764419,2,1387,937,-10
107234978506,107234978509,3,1557,1529,-10
107236449735,107236449739,4,1705,1437,-10
107244399079,107244399081,2,1449,1129,-10
107244806995,107244806998,3,1206,1254,-10
107248194274,107248194277,3,2145,1502,-10
107248860983,107248860985,2,1257,1554,-10
107249963329,107249963310,-19,1037,1052,-10
107250487179,107250487197,18,1252,1940,-10
107251042630,107251042631,1,1825,1975,-10
107256144089,107256144089,0,1092,1503,-10
107258013165,107258013170,5,1464,1514,-10
107259189712,107259189712,0,2048,1649,-10
107259930061,107259930043,-18,1936,1311,-10
107261319215,107261319209,-6,898,4269,-10
107263153729,107263153731,2,1881,1940,-10
107264029286,107264029288,2,2039,2147,-10
107266391246,107266391245,-1,1982,2376,-10
107268067919,107268067898,-21,1211,807,-10
107271070135,107271070134,-1,1506,2186,-10
107272889253,107272889259,6,1851,1579,-10
107273909827,107273909827,0,1786,1637,-10
107275828395,107275828403,8,2994,1366,-10
107277071194,107277071195,1,829,1207,-10
107278971018,107278971019,1,1823,1826,-10
107280905682,107280905681,-1,1582,1664,-10
107281134409,107281134410,1,1753,1032,-10
107283020763,107283020762,-1,1402,1482,-10
107284791587,107284791571,-16,1874,1307,-10
107289917009,107289917010,1,1540,1889,-10
107292750430,107292750431,1,1901,1727,-10
107296877413,107296877413,0,1535,1417,-10
107299053151,107299053132,-19,1452,1697,-10
107301259879,107301259880,1,1304,1498,-10
107302679114,107302679116,2,1591,1748,-10
107307032507,107307032511,4,1359,1485,-10
107308897599,107308897602,3,1108,1607,-10
107311438518,107311438520,2,1598,1851,-10
107311746929,107311746930,1,1354,1211,-10
107316754711,107316754713,2,1800,1520,-10
107319598473,107319598474,1,976,1276,-10
107320880089,107320880091,2,1691,1791,-10
107321032278,107321032279,1,2328,2085,-10
107323002852,107323002852,0,1452,1999,-10
107324807238,107324807241,3,1236,906,-10
107325289464,107325289464,0,2071,1835,-10
107327315499,107327315500,1,1225,1648,-10
107337453416,107337453414,-2,1102,1445,-10
107338908189,107338908191,2,1903,2016,-10
107339951919,107339951922,3,1921,2194,-10
107340055889,107340055892,3,1938,2198,-10
107340407586,107340407586,0,1364,1584,-10
107341491842,107341491841,-1,1263,1276,-10
107342524951,107342524955,4,1277,1640,-10
107343155030,107343155030,0,1109,1121,-10
107347178298,107347178302,4,1286,848,-10
107348775926,107348775929,3,2275,2412,-10
107352479641,107352479642,1,2254,2172,-10
107352799482,107352799486,4,1551,773,-10
107353780497,107353780498,1,1366,1098,-10
107356228226,107356228227,1,1182,1537,-10
107356572371,107356572373,2,961,1790,-10
107357727510,107357727513,3,1490,1469,-10
107362734945,107362734946,1,1504,1732,-10
107364750895,107364750898,3,2114,1459,-10
107364950324,107364950327,3,1223,1446,-10
107368722254,107368722254,0,1338,1311,-10
107369071824,107369071826,2,1659,1305,-10
107369227783,107369227786,3,1641,1299,-10
107374401215,107374401215,0,1702,1918,-10
107376208077,107376208078,1,1634,1948,-10
107377028661,107377028662,1,1632,1773,-10
107381164180,107381164182,2,1320,1534,-10
107382849674,107382849677,3,1147,1250,-10
107385720275,107385720278,3,1888,1740,-10
107386628393,107386628395,2,903,721,-10
107387529176,107387529178,2,778,860,-10
107389449779,107389449783,4,1747,1907,-10
107392872610,107392872610,0,1353,1425,-10
107393623297,107393623298,1,1954,1365,-10
107397842495,107397842495,0,1441,1309,-10
107399876829,107399876830,1,1296,1593,-10
107400232261,107400232262,1,1855,1711,-10
107402933059,107402933058,-1,28956,38790,-10
107403545775,107403545782,7,2140,1174,-10
107404571165,107404571165,0,1314,928,-10
107406229326,107406229330,4,1605,1920,-10
107409370225,107409370227,2,1643,1475,-10
107410356201,107410356209,8,4123,1379,-10
107410462308,107410462310,2,1015,1461,-10
107413783681,107413783684,3,2163,1331,-10
107414292539,107414292539,0,1184,932,-10
107416630285,107416630287,2,1094,1671,-10
107419590931,107419590929,-2,1051,2148,-10
107422123653,107422123655,2,1349,1027,-10
107424950228,107424950226,-2,933,1709,-10
107425061434,107425061435,1,1291,1348,-10
107425548178,107425548180,2,1150,1447,-10
107425986750,107425986754,4,1372,1681,-10
107430375125,107430375127,2,1524,1541,-10
107430848536,107430848535,-1,2019,2094,-10
107433908511,107433908511,0,1540,1566,-10
107434203566,107434203570,4,2319,1704,-10
107434671908,107434671897,-11,1402,3048,-10
107435625305,107435625306,1,1774,2068,-10
107435709009,107435709008,-1,1238,1309,-10
107439376466,107439376469,3,1558,1490,-10
107440348821,107440348822,1,1904,1737,-10
107441885486,107441885485,-1,1390,1641,-10
107447173253,107447173255,2,1532,1272,-10
107448006609,107448006610,1,1842,1956,-10
107452579829,107452579831,2,1799,1794,-10
107452698569,107452698570,1,1772,1659,-10
107453202475,107453202475,0,1546,1686,-10
107454785971,107454785971,0,1402,1209,-10
107456522245,107456522246,1,1585,1353,-10
107457457512,107457457514,2,2125,1948,-10
107469100310,107469100311,1,1605,1226,-10
107472685799,107472685800,1,1485,1337,-10
107474569385,107474569388,3,1775,1871,-10
107476278168,107476278169,1,1734,1328,-10
107476326526,107476326529,3,1445,1844,-10
107479010966,107479010968,2,2064,1400,-10
107480716497,107480716496,-1,1560,1691,-10
107483141066,107483141072,6,2967,1254,-10
107484243062,107484243040,-22,1254,1839,-10
107485260651,107485260654,3,2346,1772,-10
107486100456,107486100458,2,1110,956,-10
107486790993,107486790994,1,1080,1148,-10
107486846893,107486846894,1,1612,1625,-10
107488503238,107488503238,0,1298,1314,-10
107489176307,107489176311,4,1197,1273,-10
107495869613,107495869614,1,2094,1874,-10
107499604377,107499604379,2,1443,1909,-10
107501832218,107501832223,5,2396,1625,-10
107501921946,107501921951,5,2291,1304,-10
107506508351,107506508351,0,1362,1426,-10
107507797970,107507797973,3,1527,1222,-10
107508075310,107508075292,-18,1553,1386,-10
107510819889,107510819890,1,1361,1534,-10
107523228939,107523228942,3,1821,1807,-10
107526036435,107526036434,-1,1847,1334,-10
107528294513,107528294516,3,1027,1357,-10
107533360294,107533360297,3,1588,1782,-10
107533729546,107533729547,1,1853,1661,-10
107536631049,107536631048,-1,1532,2275,-10
107536998372,107536998389,17,1626,3856,-10
107543895387,107543895387,0,1226,1657,-10
107545144669,107545144671,2,1569,1599,-10
107546086337,107546086339,2,1597,1326,-10
107552212614,107552212612,-2,1395,2117,-10
107553741270,107553741270,0,1452,1429,-10
107556274666,107556274666,0,1436,2220,-10
107557361510,107557361515,5,1183,1178,-10
107558614182,107558614184,2,1853,1505,-10
107560929534,107560929536,2,1926,1397,-10
107561390174,107561390177,3,1423,1951,-10
107565174024,107565174024,0,1075,1859,-10
107565530977,107565530974,-3,1051,1171,-10
107566232474,107566232477,3,1721,1848,-10
107567639447,107567639446,-1,1085,1329,-10
107569154642,107569154641,-1,1165,1581,-10
107570285866,107570285871,5,2261,1124,-10
107571431170,107571431171,1,1746,1540,-10
107573417201,107573417201,0,791,995,-10
107577155946,107577155948,2,1514,1591,-10
107577850917,107577850918,1,1396,2104,-10
107578782082,107578782086,4,1528,1392,-10
107581498013,107581498014,1,1360,1379,-10
107586799903,107586799905,2,1592,1082,-10
107586903917,107586903917,0,1924,1946,-10
107587286714,107587286717,3,1199,1492,-10
107589149402,107589149403,1,2208,1611,-10
107591178994,107591178996,2,1398,1638,-10
107594010478,107594010482,4,1176,1041,-10
107596592367,107596592369,2,1716,1892,-10
107597939368,107597939369,1,1508,1751,-10
107597995606,107597995606,0,1280,1445,-10
107603135865,107603135867,2,1793,1292,-10
107606364225,107606364229,4,2071,1920,-10
107611444386,107611444389,3,1360,1554,-10
107611532318,107611532318,0,2101,1582,-10
107614335471,107614335470,-1,1261,1639,-10
107615710943,107615710947,4,1688,1318,-10
107615914923,107615914938,15,883,996,-10
107616836566,107616836566,0,1678,1709,-10
107619674511,107619674513,2,1187,1581,-10
107621099813,107621099817,4,1610,1347,-10
107621253942,107621253945,3,976,884,-10
107623159222,107623159225,3,1823,1787,-10
107626575730,107626575731,1,1489,1465,-10
107627184904,107627184906,2,2989,3108,-10
107628130165,107628130168,3,1804,1255,-10
107635111063,107635111062,-1,1874,1753,-10
107635604481,107635604482,1,1387,1142,-10
107638835094,107638835097,3,1569,1431,-10
107639239227,107639239230,3,1767,1266,-10
107647254625,107647254628,3,1244,1668,-10
107648205059,107648205061,2,1447,1119,-10
107652390445,107652390451,6,1704,1013,-10
107653365586,107653365588,2,1850,2111,-10
107657627833,107657627834,1,1753,1427,-10
107660831177,107660831178,1,1496,1244,-10
107662311571,107662311574,3,2713,1639,-10
107671706410,107671706415,5,1453,1171,-10
107677583203,107677583206,3,2077,1525,-10
107678506286,107678506282,-4,1346,3999,-10
107681132294,107681132295,1,758,625,-10
107681433922,107681433923,1,1858,1884,-10
107682617918,107682617921,3,1581,1726,-10
107685908274,107685908277,3,1532,1293,-10
107686384663,107686384664,1,1684,1860,-10
107689240822,107689240824,2,1200,1372,-10
107695125289,107695125290,1,1874,1079,-10
107695408023,107695408026,3,853,1129,-10
107697117438,107697117440,2,1573,1617,-10
107704477538,107704477540,2,1912,1467,-10
107705860931,107705860925,-6,2664,7079,-10
107706136272,107706136274,2,1991,1891,-10
107706491348,107706491345,-3,1448,1928,-10
107710153566,107710153567,1,1184,1472,-10
107711574321,107711574322,1,1346,1189,-10
107714916544,107714916545,1,2063,2326,-10
107718215294,107718215296,2,1435,1457,-10
107720197069,107720197070,1,1116,1382,-10
107722794248,107722794246,-2,1060,991,-10
107724547058,107724547059,1,2602,1978,-10
107725308620,107725308623,3,1245,1359,-10
107725938344,107725938346,2,1054,1409,-10
107726566150,107726566151,1,1291,1830,-10
107728963707,107728963707,0,814,796,-10
107729576262,107729576263,1,1193,2372,-10
107732546491,107732546489,-2,1406,1422,-10
107735750484,107735750488,4,2042,2196,-10
107736066036,107736066055,19,2048,1848,-10
107738925590,107738925594,4,1490,1272,-10
107739920133,107739920116,-17,1781,1688,-10
107742015910,107742015930,20,1305,1164,-10
107744478863,107744478863,0,1125,1049,-10
107745780486,107745780487,1,1318,1380,-10
107746805135,107746805137,2,1152,1635,-10
107747402709,107747402706,-3,1052,1104,-10
107748716317,107748716318,1,1348,1347,-10
107753346969,107753346971,2,1512,1539,-10
107754261591,107754261590,-1,1247,1734,-10
107757530857,107757530862,5,2730,1555,-10
107758163418,107758163424,6,1916,1323,-10
107763471398,107763471399,1,1439,1062,-10
107765130711,107765130713,2,1559,1814,-10
107766095187,107766095189,2,1602,1359,-10
107766278147,107766278151,4,1437,1282,-10
107766906472,107766906490,18,1693,1174,-10
107768836531,107768836535,4,1225,1505,-10
107771426808,107771426808,0,1198,1286,-10
107772558202,107772558204,2,1855,1701,-10
107773218375,107773218378,3,1140,1340,-10
107779106193,107779106195,2,1640,1758,-10
107779268913,107779268915,2,3542,3076,-10
107782981481,107782981483,2,1722,1407,-10
107800173965,107800173966,1,1424,1363,-10
107800791187,107800791190,3,1299,1282,-10
107803155645,107803155645,0,1476,1393,-10
107803950849,107803950852,3,2037,1885,-10
107804005246,107804005246,0,1289,776,-10
107806092289,107806092291,2,1722,1419,-10
107806304586,107806304587,1,2397,2267,-10
107811644530,107811644533,3,1579,1694,-10
107812191994,107812191995,1,1663,1920,-10
107816412029,107816412027,-2,1803,1514,-10
107817659646,107817659652,6,6574,2267,-10
107819580660,107819580662,2,1340,1473,-10
107820780590,107820780591,1,1530,2007,-10
107822087405,107822087406,1,1462,1311,-10
107826717323,107826717335,12,749,2771,-10
107830329522,107830329523,1,1912,1766,-10
107832159983,107832159985,2,3214,2771,-10
107835064235,107835064236,1,1021,1856,-10
107837081104,107837081107,3,1298,1112,-10
107837592428,107837592431,3,1465,1051,-10
107837933901,107837933904,3,1973,2096,-10
107842138494,107842138495,1,1986,1605,-10
107842801884,107842801880,-4,1795,4175,-10
107843832757,107843832758,1,1785,1654,-10
107843998178,107843998182,4,1119,1349,-10
107844849258,107844849261,3,1605,1994,-10
107845838028,107845838027,-1,1566,2313,-10
107846225906,107846225909,3,1395,1092,-10
107851140081,107851140082,1,1650,1195,-10
107852925401,107852925402,1,981,1224,-10
107853740669,107853740670,1,1853,2604,-10
107854358236,107854358242,6,1636,1532,-10
107856447427,107856447430,3,1345,1462,-10
107857935493,107857935495,2,1386,2188,-10
107860679051,107860679051,0,1237,1292,-10
107862353739,107862353750,11,885,747,-10
107865322013,107865322019,6,20587,25608,-10
107866986738,107866986739,1,1166,1163,-10
107867345821,107867345825,4,1431,1436,-10
107868794625,107868794629,4,1695,1790,-10
107871016518,107871016522,4,1145,1607,-10
107875507789,107875507788,-1,1748,1863,-10
107881645565,107881645566,1,1335,975,-10
107893811682,107893811682,0,1420,1525,-10
107894822678,107894822683,5,1282,1143,-10
107899886350,107899886352,2,2529,1671,-10
107900266854,107900266856,2,1534,1668,-10
107901703193,107901703194,1,1036,1152,-10
107902802977,107902802979,2,1709,1590,-10
107905624886,107905624890,4,995,1164,-10
107906135157,107906135158,1,1477,1611,-10
107906420574,107906420577,3,1718,1494,-10
107908711219,107908711221,2,1321,1402,-10
107918965157,107918965160,3,1526,1246,-10
107919622526,107919622527,1,1437,1210,-10
107921004434,107921004437,3,1816,1396,-10
107927168803,107927168806,3,1638,1538,-10
107929544960,107929544962,2,1537,1367,-10
107930381773,107930381778,5,988,1076,-10
107930727506,107930727510,4,1538,1083,-10
107933677207,107933677209,2,1992,1780,-10
107934676925,107934676926,1,1327,1292,-10
107934992641,107934992643,2,1632,1727,-10
107935240747,107935240749,2,1855,1158,-10
107936802906,107936802908,2,1551,1739,-10
107944947121,107944947122,1,1328,1461,-10
107945825289,107945825290,1,1539,1656,-10
107949539597,107949539600,3,1952,1174,-10
107952694350,107952694355,5,1407,1004,-10
107953650161,107953650163,2,2375,1522,-10
107955357907,107955357909,2,2459,2345,-10
107962224633,107962224628,-5,18872,17777,-10
107962621559,107962621560,1,1296,1198,-10
107962806666,107962806659,-7,26628,12695,-10
107964422514,107964422517,3,1032,1176,-10
107970115350,107970115350,0,662,513,-10
107972469418,107972469421,3,1192,1298,-10
107973217522,107973217524,2,1646,2064,-10
107976711995,107976711993,-2,1060,1692,-10
107976852914,107976852915,1,2339,1200,-10
107979854219,107979854198,-21,1162,1195,-10
107980413694,107980413698,4,1290,1569,-10
107980907709,107980907692,-17,1080,1177,-10
107982258318,107982258323,5,3800,1374,-10
107985003097,107985003099,2,1487,1828,-10
107985707890,107985707891,1,1225,2065,-10
107987764127,107987764129,2,1389,1464,-10
107988652785,107988652786,1,1609,1740,-10
107989450086,107989450085,-1,1160,1404,-10
107990782778,107990782779,1,1413,1054,-10
107993614083,107993614065,-18,866,906,-10
107995730910,107995730913,3,1687,1664,-10
107996614605,107996614606,1,1843,1847,-10
107997712814,107997712814,0,1546,1277,-10
107998003050,107998003051,1,1437,1748,-10
107998874645,107998874647,2,1796,1379,-10
108000571388,108000571390,2,1463,1622,-10
108000734548,108000734550,2,1841,1810,-10
108001071749,108001071751,2,1665,1911,-10
108004189430,108004189426,-4,1826,5970,-10
108010493357,108010493358,1,1394,1208,-10
108016821173,108016821177,4,1931,1259,-10
108018037054,108018037055,1,1408,1433,-10
108020677073,108020677077,4,2019,1455,-10
108021132169,108021132169,0,1545,1046,-10
108023503867,108023503857,-10,27517,17314,-10
108024167930,108024167910,-20,868,639,-10
108025462932,108025462933,1,1666,2025,-10
108027022539,108027022542,3,763,1123,-10
108029348637,108029348639,2,1286,1499,-10
108036224850,108036224851,1,2004,1986,-10
108036661151,108036661153,2,1779,1856,-10
108038430330,108038430334,4,3884,2358,-10
108043172067,108043172062,-5,993,1930,-10
108043463715,108043463718,3,1208,1694,-10
108044500655,108044500657,2,1905,2025,-10
108048804801,108048804799,-2,1666,2763,-10
108051755773,108051755774,1,1047,1466,-10
108052801545,108052801546,1,1148,1525,-10
108054497130,108054497134,4,2011,1373,-10
108055069866,108055069869,3,1284,1826,-10
108056644046,108056644032,-14,902,528,-10
108057224337,108057224338,1,1985,2487,-10
108059849141,108059849144,3,1789,1191,-10
108060287153,108060287156,3,1644,1275,-10
108061499761,108061499763,2,2237,2022,-10
108065042150,108065042145,-5,754,1830,-10
108066724294,108066724298,4,1599,1227,-10
108067209026,108067209026,0,1466,1858,-10
108073323471,108073323471,0,1022,1716,-10
108074739894,108074739898,4,1235,1470,-10
108074814090,108074814091,1,1663,1671,-10
108076503691,108076503693,2,1356,1921,-10
108080588461,108080588468,7,10739,27628,-10
108085160983,108085160986,3,1868,1130,-10
108087161314,108087161315,1,1133,1098,-10
108091497862,108091497866,4,2092,1550,-10
108091631186,108091631190,4,1449,1441,-10
108095076653,108095076654,1,1078,845,-10
108096561478,108096561478,0,1640,1804,-10
108098548631,108098548635,4,1404,1290,-10
108098868337,108098868339,2,1463,1398,-10
108099877704,108099877708,4,2394,1809,-10
108101737683,108101737684,1,1808,1488,-10
108101944494,108101944495,1,1159,1294,-10
108103926527,108103926531,4,1142,1227,-10
108105899226,108105899227,1,1083,1513,-10
108105933973,108105933971,-2,1061,2152,-10
108106441031,108106441030,-1,1152,1855,-10
108106776375,108106776377,2,1313,1307,-10
108107569227,108107569232,5,1424,1698,-10
108108071171,108108071174,3,1965,1629,-10
108108180274,108108180275,1,1852,1896,-10
108109407202,108109407206,4,1756,1320,-10
108113829649,108113829652,3,1562,1758,-10
108115544642,108115544644,2,1258,1335,-10
108116310657,108116310657,0,1853,1524,-10
108120629973,108120629978,5,1275,1106,-10
108120786356,108120786339,-17,1389,1520,-10
108120940759,108120940761,2,1168,1060,-10
108122730458,108122730459,1,1868,1584,-10
108122760040,108122760034,-6,1066,3025,-10
108126631117,108126631117,0,1599,1502,-10
108130383493,108130383495,2,1903,1624,-10
108131279466,108131279465,-1,1344,1520,-10
108135066609,108135066607,-2,1119,1435,-10
108136546517,108136546518,1,1479,1791,-10
108137591459,108137591461,2,1570,2007,-10
108139108648,108139108649,1,805,997,-10
108139912486,108139912488,2,1542,1490,-10
108140132708,108140132709,1,1629,2279,-10
108141501878,108141501882,4,1220,1088,-10
108142692058,108142692059,1,2023,1543,-10
108144079999,108144080001,2,2409,1995,-10
108148938497,108148938500,3,1741,1443,-10
108151596706,108151596706,0,1501,1911,-10
108153513496,108153513498,2,1501,1440,-10
108153774749,108153774751,2,2115,2119,-10
108158382676,108158382678,2,1715,1113,-10
108158481724,108158481725,1,1841,1762,-10
108162578238,108162578240,2,1488,1500,-10
108167826728,108167826730,2,1776,1949,-10
108174616074,108174616075,1,1475,1018,-10
108174813683,108174813677,-6,1868,10088,-10
108177732750,108177732754,4,1609,1289,-10
108178344638,108178344639,1,1581,1836,-10
108180601273,108180601274,1,1346,1856,-10
108181199489,108181199490,1,1769,1296,-10
108183339846,108183339850,4,1768,1675,-10
108184615855,108184615857,2,1754,1191,-10
108186927841,108186927843,2,1530,1836,-10
108191983790,108191983795,5,1767,1690,-10
108192204954,108192204957,3,2032,2127,-10
108193316438,108193316439,1,2254,2090,-10
108195793249,108195793253,4,2651,1576,-10
108196938089,108196938089,0,1805,1118,-10
108199712186,108199712198,12,1189,776,-10
108202041731,108202041733,2,922,1284,-10
108203503790,108203503789,-1,1117,2196,-10
108207610099,108207610102,3,1498,1259,-10
108208400338,108208400347,9,1196,1122,-10
108211210457,108211210458,1,1532,1391,-10
108217701867,108217701870,3,1808,900,-10
108222020566,108222020567,1,1579,991,-10
108222928201,108222928205,4,1260,1261,-10
108226288474,108226288474,0,973,1673,-10
108227453226,108227453226,0,1864,1685,-10
108230855175,108230855178,3,1108,927,-10
108231636890,108231636890,0,1529,1266,-10
108234152401,108234152403,2,1717,1327,-10
108234548958,108234548960,2,1421,1228,-10
108238973503,108238973506,3,1159,1570,-10
108243674239,108243674242,3,1488,1501,-10
108244916561,108244916568,7,3068,1424,-10
108246111651,108246111653,2,1491,1503,-10
108246571170,108246571170,0,1137,1707,-10
108247564095,108247564097,2,1966,1954,-10
108251135406,108251135408,2,1972,1566,-10
108252407733,108252407713,-20,846,939,-10
108253555823,108253555839,16,11834,48942,-10
108259430638,108259430640,2,1720,1337,-10
108264195131,108264195136,5,9850,4959,-10
108270916562,108270916565,3,1428,1571,-10
108271810493,108271810495,2,1215,1186,-10
108274279494,108274279494,0,1214,1648,-10
108275264394,108275264395,1,1794,2128,-10
108276366093,108276366095,2,1026,1158,-10
108279159601,108279159604,3,1559,1306,-10
108280619506,108280619509,3,1419,1309,-10
108280700658,108280700659,1,945,2002,-10
108282125625,108282125625,0,1131,1244,-10
108282950544,108282950545,1,2036,2128,-10
108286013786,108286013802,16,182,653,-10
108286267609,108286267612,3,1785,2270,-10
108286881897,108286881899,2,2004,1710,-10
108287507314,108287507317,3,1821,1600,-10
108289022851,108289022853,2,2335,2161,-10
108290767018,108290766998,-20,1356,1350,-10
108292415223,108292415224,1,1353,1379,-10
108293217170,108293217174,4,1922,1626,-10
108296088355,108296088357,2,1292,2027,-10
108296836483,108296836487,4,1717,1323,-10
108297202747,108297202750,3,2033,1839,-10
108298778757,108298778759,2,1844,1586,-10
108300875722,108300875726,4,1301,1310,-10
108302703678,108302703679,1,1849,1050,-10
108305615782,108305615782,0,1601,1484,-10
108306110200,108306110202,2,2322,1554,-10
108308229445,108308229447,2,1186,1186,-10
108309068000,108309067997,-3,1533,3257,-10
108309836957,108309836961,4,779,596,-10
108311628879,108311628881,2,1579,1902,-10
108313352824,108313352826,2,1527,1669,-10
108313808512,108313808514,2,1112,1525,-10
108316471266,108316471268,2,1411,1548,-10
108322534376,108322534379,3,1046,1958,-10
108324486891,108324486895,4,1624,1476,-10
108325079704,108325079707,3,1552,1646,-10
108326629106,108326629107,1,1714,1481,-10
108327840193,108327840193,0,1747,1491,-10
108327940859,108327940873,14,1292,1389,-10
108328514048,108328514049,1,1200,1400,-10
108329469710,108329469711,1,1181,1618,-10
108334891491,108334891493,2,1330,1382,-10
108336510166,108336510167,1,1799,2155,-10
108340576244,108340576247,3,1678,1290,-10
108342067321,108342067325,4,1616,1573,-10
108343050598,108343050597,-1,1272,1676,-10
108344357548,108344357554,6,2895,1276,-10
108345490661,108345490666,5,1860,1046,-10
108346971543,108346971542,-1,1184,1419,-10
108347258887,108347258891,4,535,670,-10
108354824764,108354824767,3,1526,1257,-10
108362687370,108362687371,1,1629,1537,-10
108363695800,108363695802,2,1510,1617,-10
108366793375,108366793378,3,1067,1128,-10
108370611919,108370611922,3,2428,1632,-10
108372275525,108372275526,1,1379,1463,-10
108376618019,108376618014,-5,1157,2071,-10
108376656069,108376656071,2,1622,1562,-10
108380041617,108380041617,0,1718,2019,-10
108380188286,108380188286,0,1426,1334,-10
108382438961,108382438962,1,1770,1568,-10
108383285487,108383285490,3,1530,1263,-10
108386056329,108386056331,2,1654,1461,-10
108390337511,108390337515,4,1839,1637,-10
108391295030,108391295031,1,1329,1389,-10
108393529042,108393529043,1,957,1324,-10
108394536775,108394536777,2,2038,1676,-10
108396924478,108396924479,1,1283,1291,-10
108401263082,108401263083,1,879,1291,-10
108402610001,108402610002,1,1687,1734,-10
108402983184,108402983185,1,2181,1540,-10
108404729634,108404729635,1,1710,1417,-10
108405860659,108405860661,2,1158,1474,-10
108408891635,108408891637,2,1965,1221,-10
108412532288,108412532290,2,1453,949,-10
108412695544,108412695545,1,1643,1264,-10
108414902627,108414902630,3,1524,1506,-10
108415181829,108415181831,2,1349,1409,-10
108416646802,108416646806,4,1196,686,-10
108419890369,108419890370,1,1325,1263,-10
108420990923,108420990925,2,1647,1959,-10
108423598373,108423598374,1,2268,1847,-10
108426034681,108426034683,2,1811,1184,-10
108427183558,108427183562,4,1808,1026,-10
108429703726,108429703727,1,1508,1608,-10
108430208967,108430208970,3,1668,1301,-10
108434951314,108434951314,0,1530,1691,-10
108435484099,108435484103,4,2005,1608,-10
108438307515,108438307517,2,1169,1056,-10
108441004662,108441004663,1,1837,1958,-10
108442981734,108442981734,0,1801,1722,-10
108444082485,108444082491,6,2396,1609,-10
108446239445,108446239448,3,2426,1732,-10
108452566750,108452566755,5,1816,1484,-10
108456647768,108456647766,-2,1175,2131,-10
108459620349,108459620351,2,1637,1728,-10
108459738906,108459738908,2,1676,2426,-10
108460291991,108460291994,3,1281,1080,-10
108460474833,108460474835,2,1979,1236,-10
108460652614,108460652614,0,1658,1967,-10
108464104506,108464104507,1,1723,1757,-10
108464359582,108464359578,-4,1112,1557,-10
108464899718,108464899718,0,1693,1425,-10
108467281221,108467281224,3,1838,1572,-10
108468321409,108468321410,1,699,922,-10
108470201115,108470201116,1,1330,1563,-10
108473323482,108473323486,4,2006,1722,-10
108474002610,108474002613,3,1564,1654,-10
108475142523,108475142527,4,2119,1679,-10
108481328685,108481328685,0,1410,1308,-10
108481626431,108481626431,0,1644,1358,-10
108482117005,108482117026,21,846,1089,-10
108483187295,108483187305,10,1155,1275,-10
108484691665,108484691671,6,1871,1127,-10
108485881466,108485881467,1,953,1247,-10
108487579230,108487579231,1,1099,1649,-10
108488784391,108488784391,0,1736,1436,-10
108491703230,108491703231,1,1683,1428,-10
108492710242,108492710243,1,1811,1693,-10
108493969710,108493969712,2,1265,1719,-10
108495208526,108495208528,2,1588,1221,-10
108503089136,108503089138,2,1100,1223,-10
108504818306,108504818308,2,1515,1605,-10
108509734327,108509734326,-1,1553,963,-10
108513145054,108513145034,-20,1679,1409,-10
108517202674,108517202670,-4,874,1758,-10
108518386670,108518386671,1,1448,1749,-10
108519791390,108519791391,1,1719,1820,-10
108525197965,108525197966,1,1464,1554,-10
108527557619,108527557617,-2,1198,1484,-10
108531355467,108531355467,0,941,1025,-10
108536040040,108536040042,2,1891,1451,-10
108537628129,108537628130,1,985,656,-10
108538333356,108538333357,1,2282,2250,-10
108539714025,108539714027,2,1328,1520,-10
108541507542,108541507546,4,1933,1205,-10
108542795258,108542795263,5,2471,1400,-10
108543649502,108543649503,1,1794,1314,-10
108545767370,108545767372,2,1932,1455,-10
108547243471,108547243471,0,1281,1194,-10
108547554803,108547554797,-6,1240,5872,-10
108548432228,108548432225,-3,4962,9308,-10
108551927741,108551927738,-3,902,1690,-10
108554346542,108554346545,3,1617,1863,-10
108555416618,108555416617,-1,678,2119,-10
108557460374,108557460378,4,1510,1492,-10
108558188589,108558188591,2,2115,2289,-10
108560066099,108560066093,-6,860,2163,-10
108560868485,108560868479,-6,2060,7607,-10
108561231676,108561231677,1,1633,1374,-10
108561299621,108561299623,2,1895,1833,-10
108561771505,108561771507,2,1645,1884,-10
108563629194,108563629193,-1,888,1846,-10
108564535025,108564535026,1,1463,1559,-10
108569351378,108569351380,2,1208,798,-10
108571085023,108571085025,2,1660,1572,-10
108574721641,108574721642,1,1209,1312,-10
108582350689,108582350693,4,1149,1593,-10
108584611602,108584611607,5,1281,1767,-10
108588209417,108588209419,2,699,881,-10
108589322202,108589322193,-9,1132,1233,-10
108592036533,108592036535,2,1876,1620,-10
108592143071,108592143074,3,1313,1456,-10
108593245454,108593245457,3,1229,1626,-10
108594134115,108594134118,3,1502,1314,-10
108599664690,108599664694,4,1029,1597,-10
108600655235,108600655243,8,2283,1139,-10
108602792105,108602792103,-2,1183,1270,-10
108606349974,108606349970,-4,1283,1783,-10
108611097603,108611097606,3,1038,1774,-10
108612186275,108612186274,-1,1440,1594,-10
108617586022,108617586023,1,1620,1561,-10
108618689534,108618689537,3,1980,1958,-10
108620720718,108620720721,3,2129,1656,-10
108621304414,108621304425,11,1531,855,-10
108623611767,108623611762,-5,1023,1776,-10
108625149893,108625149890,-3,1978,5035,-10
108632702565,108632702544,-21,2278,1808,-10
108637016943,108637016946,3,1371,1691,-10
108647609863,108647609865,2,1487,1684,-10
108649866989,108649866986,-3,1237,1615,-10
108653551081,108653551082,1,1307,1650,-10
108655509121,108655509122,1,1930,1753,-10
108656704782,108656704781,-1,1400,1860,-10
108657038789,108657038784,-5,933,3010,-10
108658221318,108658221319,1,1159,1358,-10
108665334328,108665334330,2,1721,1440,-10
108668822245,108668822247,2,1804,1432,-10
108675096287,108675096290,3,1667,1241,-10
108676595538,108676595539,1,1484,1987,-10
108678691736,108678691743,7,4924,1639,-10
108680199061,108680199063,2,1495,1344,-10
108683881016,108683881014,-2,865,869,-10
108684235335,108684235338,3,1647,2458,-10
108688704103,108688704105,2,1739,1236,-10
108689974778,108689974781,3,1494,1408,-10
108690766617,108690766620,3,2039,2999,-10
108694462314,108694462314,0,1892,1879,-10
108696892878,108696892879,1,1787,1088,-10
108697082018,108697082023,5,954,761,-10
108698646306,108698646305,-1,1096,2306,-10
108700875218,108700875221,3,1583,1071,-10
108701916717,108701916698,-19,514,545,-10
108702055668,108702055673,5,2232,1113,-10
108703726235,108703726237,2,4944,19221,-10
108703956034,108703956038,4,1353,1425,-10
108705941230,108705941233,3,2169,2244,-10
108707545961,108707545961,0,2184,1647,-10
108708963194,108708963195,1,1922,1563,-10
108710733982,108710733977,-5,1727,5119,-10
108711233627,108711233628,1,1506,1698,-10
108711864678,108711864681,3,1519,1317,-10
108714718061,108714718062,1,3373,3655,-10
108720170930,108720170930,0,1490,1771,-10
108723539025,108723539027,2,1382,1531,-10
108725299554,108725299557,3,1964,1898,-10
108728751772,108728751774,2,997,1491,-10
108729563970,108729563972,2,1638,2087,-10
108731782527,108731782527,0,1750,2465,-10
108732068519,108732068522,3,1365,1609,-10
108735048139,108735048141,2,1982,1638,-10
108737171797,108737171798,1,1117,1263,-10
108738252754,108738252758,4,1433,1748,-10
108738499838,108738499841,3,1969,1809,-10
108739101412,108739101414,2,1556,1691,-10
108740691891,108740691893,2,1597,1632,-10
108745257181,108745257182,1,1480,1615,-10
108745503076,108745503078,2,1605,1277,-10
108745658519,108745658519,0,1692,1814,-10
108747110607,108747110587,-20,6386,2014,-10
108748985398,108748985399,1,1736,1828,-10
108752001094,108752001094,0,2019,1376,-10
108753436858,108753436858,0,1415,1966,-10
108761212784,108761212786,2,1227,1415,-10
108765297557,108765297558,1,1570,1374,-10
108767513920,108767513921,1,1450,1226,-10
108769923418,108769923421,3,1304,1352,-10
108772934393,108772934392,-1,1579,2512,-10
108775898109,108775898112,3,1391,1805,-10
108782907430,108782907432,2,1711,1805,-10
108783410087,108783410107,20,1146,1608,-10
108787525449,108787525452,3,2364,1669,-10
108791307621,108791307622,1,1448,1505,-10
108791960417,108791960424,7,2613,1112,-10
108793371678,108793371679,1,2579,2582,-10
108796652609,108796652614,5,1030,844,-10
108800106844,108800106846,2,889,1018,-10
108801372868,108801372871,3,1666,981,-10
108802534542,108802534543,1,1397,1300,-10
108802876333,108802876335,2,2124,1650,-10
108805992345,108805992346,1,638,1267,-10
108806118230,108806118234,4,1271,1452,-10
108807710485,108807710465,-20,1265,661,-10
108812084451,108812084452,1,1676,1630,-10
108814248257,108814248259,2,2034,1181,-10
108816586990,108816586992,2,1440,2072,-10
108821276021,108821276021,0,1662,1747,-10
108822546435,108822546438,3,1208,1775,-10
108823458131,108823458133,2,1756,1709,-10
108825967550,108825967552,2,2279,2070,-10
108827738608,108827738609,1,1380,1903,-10
108831030091,108831030090,-1,1345,2244,-10
108831513804,108831513805,1,1422,809,-10
108831925207,108831925188,-19,2147,1665,-10
108832373397,108832373399,2,1548,1545,-10
108836638374,108836638377,3,1413,1860,-10
108837003359,108837003358,-1,1842,2363,-10
108837115999,108837116000,1,19530,31904,-10
108837366274,108837366275,1,1821,1916,-10
108851873763,108851873765,2,1020,1329,-10
108854466180,108854466182,2,2115,1240,-10
108856953385,108856953385,0,2038,1927,-10
108858821488,108858821490,2,1369,1607,-10
108859139202,108859139204,2,1969,1828,-10
108860759874,108860759877,3,1627,2273,-10
108862192378,108862192378,0,1828,1957,-10
108865481983,108865481987,4,1682,1133,-10
108867965645,108867965646,1,1596,1093,-10
108870160595,108870160598,3,1609,1591,-10
108871074942,108871074945,3,2009,1534,-10
108871456378,108871456383,5,1465,1571,-10
108873231371,108873231374,3,1658,1417,-10
108876275962,108876275963,1,1341,1061,-10
108879682525,108879682522,-3,1579,1527,-10
108880853955,108880853958,3,2007,1570,-10
108881645115,108881645114,-1,1001,1789,-10
108883078322,108883078323,1,946,1552,-10
108886440139,108886440142,3,1723,1547,-10
108886605281,108886605282,1,1582,1440,-10
108888376809,108888376801,-8,1466,1444,-10
108891539629,108891539631,2,1742,1889,-10
108893477891,108893477894,3,1832,2217,-10
108893821016,108893821018,2,1872,1810,-10
108898632085,108898632085,0,1828,1200,-10
108906485360,108906485362,2,1634,1588,-10
108907825808,108907825809,1,1507,1409,-10
108908394453,108908394451,-2,26732,45845,-10
108908677334,108908677335,1,1810,1599,-10
108909095522,108909095522,0,1076,1598,-10
108911028702,108911028706,4,2065,1340,-10
108911705429,108911705432,3,1090,1725,-10
108915469958,108915469959,1,1578,1968,-10
108916392790,108916392794,4,1286,1310,-10
108918268084,108918268085,1,1507,1743,-10
108918509434,108918509437,3,1158,1319,-10
108925952780,108925952782,2,1042,1222,-10
108926665637,108926665639,2,1861,1745,-10
108927808035,108927808030,-5,994,3876,-10
108931997487,108931997501,14,993,1152,-10
108933119594,108933119589,-5,530,1717,-10
108934430486,108934430490,4,2475,1244,-10
108934563243,108934563241,-2,1482,2696,-10
108935517740,108935517741,1,2231,1763,-10
108935862020,108935862020,0,1332,1508,-10
108938713082,108938713085,3,1604,1171,-10
108950078649,108950078650,1,1336,1877,-10
108951208706,108951208710,4,1287,1759,-10
108952213198,108952213201,3,1493,1396,-10
108953310515,108953310515,0,1156,1318,-10
108954739701,108954739703,2,2108,2434,-10
108955989654,108955989653,-1,1385,1344,-10
108957957642,108957957644,2,1800,1123,-10
108958249794,108958249794,0,1644,1987,-10
108959316122,108959316124,2,1547,1896,-10
108961078414,108961078414,0,919,1263,-10
108965591570,108965591569,-1,1092,1227,-10
108966524498,108966524501,3,2509,1930,-10
108966956189,108966956191,2,1515,1279,-10
108971369706,108971369708,2,1342,1580,-10
108971574993,108971574995,2,1722,1700,-10
108973643635,108973643637,2,996,1480,-10
108974483639,108974483641,2,1648,1208,-10
108976276798,108976276801,3,1498,1286,-10
108978663767,108978663767,0,1279,1276,-10
108981273309,108981273311,2,1894,1181,-10
108988797358,108988797355,-3,1182,2436,-10
108989646065,108989646066,1,1911,2172,-10
108995744146,108995744146,0,1002,1476,-10
108996976148,108996976150,2,1827,2181,-10
108999385145,108999385146,1,1674,1370,-10
109000874157,109000874160,3,1455,1820,-10
109006029011,109006029013,2,1204,1808,-10
109006167945,109006167935,-10,895,945,-10
109006767441,109006767442,1,1249,1021,-10
109011194846,109011194845,-1,1657,2638,-10
109014184270,109014184271,1,935,973,-10
109015492398,109015492401,3,1262,1069,-10
109016474465,109016474462,-3,1538,2011,-10
109016696485,109016696496,11,1409,1478,-10
109021511015,109021511017,2,1583,1891,-10
109027522701,109027522703,2,1740,1450,-10
109034810851,109034810853,2,962,1080,-10
109037318858,109037318857,-1,1093,1955,-10
109039121730,109039121730,0,941,1148,-10
109040443359,109040443362,3,1728,1756,-10
109045000490,109045000490,0,2003,1240,-10
109046969674,109046969678,4,1633,1447,-10
109047014578,109047014578,0,1706,1791,-10
109047993022,109047993023,1,1154,1618,-10
109048163597,109048163597,0,1420,1291,-10
109049369087,109049369089,2,1090,1547,-10
109049953847,109049953850,3,2003,2140,-10
109053990446,109053990447,1,1286,2062,-10
109054480925,109054480929,4,1768,1822,-10
109056878817,109056878819,2,1657,1252,-10
109057077659,109057077659,0,1486,2070,-10
109059076080,109059076082,2,1134,870,-10
109059280582,109059280587,5,984,1140,-10
109059936442,109059936443,1,1738,1565,-10
109064990245,109064990245,0,1000,971,-10
109065919446,109065919424,-22,1911,1381,-10
109066052728,109066052729,1,1662,1654,-10
109068740397,109068740397,0,1032,1103,-10
109068941490,109068941492,2,1215,1801,-10
109073960238,109073960231,-7,696,2612,-10
109074298534,109074298535,1,1218,1875,-10
109074869512,109074869515,3,1604,1607,-10
109074969581,109074969585,4,1536,1337,-10
109076076116,109076076116,0,965,1185,-10
109077079642,109077079643,1,1318,935,-10
109079497124,109079497123,-1,1390,1112,-10
109081721908,109081721910,2,1568,1570,-10
109083126708,109083126714,6,3080,1258,-10
109083361467,109083361474,7,2485,1678,-10
109085045516,109085045518,2,1865,1722,-10
109085785652,109085785655,3,1236,816,-10
109085927447,109085927464,17,1913,1132,-10
109086626507,109086626513,6,1629,1660,-10
109088282067,109088282066,-1,1027,1602,-10
109088820144,109088820147,3,1747,1719,-10
109090106898,109090106899,1,1196,1182,-10
109093112307,109093112309,2,1740,1564,-10
109094879164,109094879166,2,1613,1411,-10
109097763009,109097763013,4,2852,2498,-10
109099366212,109099366212,0,1046,1292,-10
109100568123,109100568126,3,2140,1306,-10
109102724595,109102724597,2,1562,1817,-10
109103091445,109103091446,1,1784,1595,-10
109104958927,109104958929,2,2167,1768,-10
109105183248,109105183250,2,1634,1801,-10
109105501490,109105501494,4,2067,1521,-10
109105919048,109105919067,19,967,914,-10
109107376401,109107376416,15,1532,1763,-10
109109117890,109109117890,0,2275,2083,-10
109110981426,109110981427,1,1485,1575,-10
109113988405,109113988407,2,1695,974,-10
109115208957,109115208959,2,2346,1816,-10
109116986565,109116986565,0,1993,1828,-10
109117757801,109117757801,0,1725,1959,-10
109117923618,109117923622,4,1184,1437,-10
109127351681,109127351678,-3,2155,4507,-10
109129661415,109129661417,2,1337,1179,-10
109134260999,109134260998,-1,1538,1375,-10
109134905530,109134905534,4,1381,1249,-10
109138143989,109138143990,1,1879,1614,-10
109139741125,109139741127,2,1086,1419,-10
109140639462,109140639464,2,981,1685,-10
109141199035,109141199038,3,795,878,-10
109141921965,109141921968,3,1506,1295,-10
109149328949,109149328946,-3,1190,1975,-10
109150881097,109150881097,0,1615,1195,-10
109151608557,109151608561,4,2156,1193,-10
109157678844,109157678848,4,1220,1020,-10
109158071427,109158071426,-1,1593,1814,-10
109159914761,109159914766,5,1675,1187,-10
109164574474,109164574474,0,1870,1446,-10
109164823790,109164823793,3,1539,1526,-10
109165474118,109165474118,0,959,884,-10
109167622390,109167622390,0,1466,1497,-10
109168195685,109168195686,1,1555,1742,-10
109168693224,109168693227,3,1473,1535,-10
109170999582,109170999582,0,1967,2155,-10
109172086351,109172086353,2,993,765,-10
109173558525,109173558522,-3,908,1042,-10
109175144848,109175144850,2,1243,1518,-10
109175509546,109175509550,4,1233,1379,-10
109175824115,109175824119,4,4426,2758,-10
109176695834,109176695836,2,1310,1435,-10
109181753137,109181753137,0,1717,1721,-10
109181908087,109181908088,1,999,1366,-10
109182937905,109182937907,2,1637,1096,-10
109187263283,109187263284,1,1682,1515,-10
109187827354,109187827355,1,1415,1639,-10
109189248497,109189248499,2,1408,1598,-10
109193789001,109193789002,1,1638,1520,-10
109199833064,109199833066,2,1763,1851,-10
109201022537,109201022541,4,1588,1368,-10
109203752505,109203752506,1,1400,1350,-10
109204008507,109204008508,1,1014,1696,-10
109205210372,109205210373,1,1902,1837,-10
109208374813,109208374814,1,1890,1773,-10
109209368391,109209368394,3,1025,1405,-10
109220513185,109220513187,2,1689,1704,-10
109220578473,109220578469,-4,1381,3803,-10
109225268098,109225268100,2,1833,2291,-10
109226724710,109226724711,1,1535,1293,-10
109232328211,109232328213,2,1163,1990,-10
109235484096,109235484098,2,1838,1496,-10
109236563939,109236563938,-1,1283,1622,-10
109241704526,109241704530,4,806,1365,-10
109243483940,109243483945,5,2047,1258,-10
109243868066,109243868071,5,1506,1243,-10
109245120598,109245120599,1,1535,1693,-10
109245568731,109245568735,4,1418,1194,-10
109250697477,109250697479,2,1672,1987,-10
109253154525,109253154527,2,1701,1971,-10
109253731376,109253731377,1,2543,1913,-10
109263614923,109263614925,2,1476,1407,-10
109265037366,109265037366,0,1250,1625,-10
109269505246,109269505247,1,1864,1530,-10
109269929150,109269929151,1,1290,1309,-10
109271076443,109271076445,2,1090,1480,-10
109273035153,109273035159,6,1763,1843,-10
109275570171,109275570174,3,1959,2423,-10
109277895504,109277895498,-6,1261,2738,-10
109283276400,109283276402,2,1949,1277,-10
109284002335,109284002338,3,1218,1504,-10
109284185214,109284185217,3,1406,1475,-10
109285324444,109285324446,2,2241,1685,-10
109287121646,109287121659,13,9162,37260,-10
109289041851,109289041853,2,1382,1779,-10
109289185998,109289185998,0,1945,2072,-10
109290532171,109290532170,-1,1230,1566,-10
109293143070,109293143070,0,1688,1541,-10
109297024227,109297024227,0,1956,2674,-10
109298556165,109298556166,1,2322,2246,-10
109299387269,109299387271,2,1489,1476,-10
109299829522,109299829523,1,1455,1765,-10
109300994253,109300994254,1,1641,1552,-10
109308178892,109308178890,-2,1534,2010,-10
109310401760,109310401763,3,2173,1751,-10
109312345635,109312345636,1,2153,1448,-10
109317338903,109317338906,3,1618,1939,-10
109317859861,109317859861,0,1474,1368,-10
109322312371,109322312373,2,1457,1864,-10
109323870413,109323870414,1,1856,1728,-10
109324099047,109324099050,3,1943,2071,-10
109326448827,109326448829,2,1778,2297,-10
109327212058,109327212062,4,2128,1691,-10
109328058362,109328058364,2,1567,1672,-10
109330784775,109330784777,2,982,1105,-10
109331162280,109331162283,3,1687,1539,-10
109332572405,109332572407,2,1706,1350,-10
109332620926,109332620928,2,1722,1512,-10
109333771004,109333771006,2,1747,1578,-10
109335029890,109335029889,-1,1394,2722,-10
109340536083,109340536084,1,1344,1589,-10
109341512929,109341512929,0,1602,1814,-10
109341956602,109341956605,3,1971,2044,-10
109345460951,109345460954,3,1841,1226,-10
109345949586,109345949589,3,1965,2032,-10
109346499086,109346499071,-15,1899,1406,-10
109348000698,109348000701,3,1734,1576,-10
109350127615,109350127610,-5,1498,3006,-10
109351424879,109351424881,2,1704,1374,-10
109353471724,109353471726,2,1319,1515,-10
109354028497,109354028497,0,1021,1622,-10
109354865188,109354865188,0,1399,1208,-10
109355372526,109355372527,1,1995,1297,-10
109358327405,109358327409,4,1289,1378,-10
109359719758,109359719760,2,1039,1418,-10
109361681649,109361681653,4,2100,1525,-10
109363082992,109363082991,-1,1048,1502,-10
109363587082,109363587086,4,1651,1399,-10
109363840416,109363840417,1,1787,1490,-10
109366943490,109366943492,2,1788,1654,-10
109368695905,109368695905,0,2145,2066,-10
109368874581,109368874582,1,1495,1746,-10
109375804691,109375804686,-5,1201,1240,-10
109376631578,109376631582,4,2220,1841,-10
109377278634,109377278637,3,1764,1358,-10
109387669395,109387669398,3,1751,2328,-10
109389055763,109389055765,2,1408,1219,-10
109390133158,109390133158,0,1907,2012,-10
109392420826,109392420827,1,2074,1922,-10
109393096681,109393096682,1,1408,1287,-10
109394105966,109394105966,0,1102,1546,-10
109395798142,109395798144,2,1575,1440,-10
109396533690,109396533694,4,2010,1732,-10
109397239650,109397239652,2,1410,1368,-10
109401137171,109401137174,3,1933,1800,-10
109403886140,109403886142,2,1214,1743,-10
109405035994,109405035996,2,1577,983,-10
109406331526,109406331530,4,1328,1399,-10
109407014838,109407014839,1,1887,1414,-10
109409075393,109409075395,2,1493,1347,-10
109409645543,109409645562,19,1737,2036,-10
109412652962,109412652955,-7,1511,7703,-10
109412763240,109412763241,1,152,1459,-10
109415206031,109415206031,0,1490,2582,-10
109417008223,109417008225,2,1205,1388,-10
109417849002,109417849003,1,1261,1845,-10
109418475635,109418475636,1,1153,1134,-10
109418930060,109418930061,1,1732,2106,-10
109419513982,109419513981,-1,969,1268,-10
109421024158,109421024159,1,985,1491,-10
109422953349,109422953351,2,1521,1505,-10
109423856658,109423856661,3,920,1439,-10
109426182577,109426182573,-4,1125,1344,-10
109428407933,109428407933,0,1781,1729,-10
109431627855,109431627858,3,1726,1834,-10
109434687585,109434687588,3,1468,1672,-10
109435270670,109435270674,4,1053,1344,-10
109435925875,109435925877,2,1339,1707,-10
109440567034,109440567039,5,2008,985,-10
109444036838,109444036859,21,1655,1444,-10
109449070482,109449070486,4,1319,1518,-10
109453633158,109453633159,1,1443,1675,-10
109462898567,109462898570,3,1346,1297,-10
109463844910,109463844911,1,2622,3196,-10
109466223726,109466223728,2,1379,1634,-10
109468651618,109468651622,4,1575,1173,-10
109469858022,109469858022,0,1404,1830,-10
109470084699,109470084682,-17,1170,1155,-10
109473502920,109473502921,1,1548,2027,-10
109474065773,109474065777,4,1748,1575,-10
109474790070,109474790072,2,1577,973,-10
109475549035,109475549035,0,1205,1071,-10
109477663543,109477663546,3,1254,1726,-10
109478025782,109478025781,-1,1783,1308,-10
109479818996,109479819000,4,2516,1572,-10
109481129606,109481129611,5,2503,1265,-10
109481839534,109481839553,19,984,198,-10
109483084218,109483084219,1,1478,1064,-10
109483847164,109483847169,5,2092,1586,-10
109484568041,109484568042,1,1684,1965,-10
109485960675,109485960677,2,1295,1656,-10
109488596290,109488596293,3,1768,1734,-10
109490255148,109490255150,2,1301,1077,-10
109490503378,109490503381,3,354,675,-10
109490994121,109490994122,1,1536,1430,-10
109492623750,109492623753,3,1446,1297,-10
109495455395,109495455394,-1,960,2209,-10
109501600385,109501600388,3,2135,1602,-10
109503583931,109503583931,0,1659,1568,-10
109504141439,109504141440,1,1301,1629,-10
109509696366,109509696344,-22,1266,1084,-10
109511464439,109511464440,1,1449,1162,-10
109514573878,109514573881,3,1923,1321,-10
109514796500,109514796503,3,1087,1838,-10
109521237127,109521237128,1,1413,1647,-10
109523561835,109523561830,-5,2187,7557,-10
109523832262,109523832263,1,1831,1990,-10
109525139197,109525139194,-3,901,1964,-10
109525180315,109525180318,3,1763,1543,-10
109533006594,109533006591,-3,3843,10711,-10
109534623291,109534623291,0,1359,1237,-10
109535653694,109535653698,4,1702,1664,-10
109537964763,109537964761,-2,1348,1196,-10
109538665723,109538665724,1,2143,2074,-10
109538940923,109538940938,15,1490,1739,-10
109539548407,109539548410,3,1339,1479,-10
109540080250,109540080250,0,1155,1842,-10
109541698202,109541698202,0,1731,919,-10
109542540997,109542540998,1,1291,1460,-10
109543924518,109543924521,3,1735,1912,-10
109546534029,109546534033,4,1484,1137,-10
109546724433,109546724437,4,1563,1522,-10
109547826269,109547826266,-3,2231,2135,-10
109550404354,109550404375,21,1617,2038,-10
109550971570,109550971573,3,1620,1345,-10
109551516822,109551516824,2,1463,1675,-10
109552321655,109552321657,2,1905,1667,-10
109553591874,109553591874,0,1201,1577,-10
109556178646,109556178650,4,1857,1391,-10
109556835537,109556835555,18,2022,1564,-10
109557153627,109557153630,3,1207,1171,-10
109557916359,109557916359,0,1174,1301,-10
109559696287,109559696290,3,1829,2160,-10
109560034793,109560034797,4,2259,1626,-10
109562750124,109562750117,-7,12041,16550,-10
109563651426,109563651426,0,1680,1561,-10
109563808359,109563808359,0,1120,1441,-10
109570749733,109570749737,4,1164,1700,-10
109570787541,109570787542,1,2558,1684,-10
109571909043,109571909022,-21,3260,1896,-10
109574723967,109574723966,-1,1007,1545,-10
109576080653,109576080654,1,1863,1855,-10
109577839857,109577839859,2,1849,1510,-10
109580910431,109580910434,3,961,977,-10
109582030901,109582030905,4,1541,1222,-10
109584226231,109584226226,-5,1768,5734,-10
109584835393,109584835393,0,1521,1682,-10
109585775526,109585775528,2,1138,815,-10
109589120550,109589120551,1,1245,1846,-10
109590955315,109590955319,4,1554,1385,-10
109592177822,109592177801,-21,2171,1715,-10
109593233112,109593233115,3,2009,1942,-10
109593688724,109593688733,9,12312,28172,-10
109594678533,109594678536,3,1406,1612,-10
109599944347,109599944352,5,1180,995,-10
109600376913,109600376914,1,1926,2113,-10
109602220917,109602220922,5,32980,17957,-10
109602396646,109602396645,-1,1215,1256,-10
109603451742,109603451747,5,1903,1206,-10
109603796905,109603796905,0,1478,1849,-10
109606279759,109606279762,3,2214,2017,-10
109608353126,109608353126,0,1306,1490,-10
109609880374,109609880378,4,1796,1388,-10
109610014714,109610014718,4,1720,1133,-10
109612091353,109612091366,13,286,3678,-10
109612975345,109612975347,2,1960,1651,-10
109613677866,109613677867,1,1857,1580,-10
109614053927,109614053927,0,1559,1705,-10
109619219647,109619219649,2,1200,1507,-10
109619569798,109619569802,4,938,1094,-10
109624467269,109624467272,3,2063,1369,-10
109628732598,109628732595,-3,1234,1738,-10
109629551778,109629551776,-2,1562,3260,-10
109633616327,109633616327,0,1579,1731,-10
109633816290,109633816292,2,1340,1085,-10
109636211766,109636211771,5,2585,1550,-10
109636294507,109636294509,2,1278,1325,-10
109637496317,109637496319,2,1461,1243,-10
109637928342,109637928343,1,1483,1796,-10
109638490688,109638490690,2,2754,2254,-10
109644656317,109644656320,3,1645,1470,-10
109645040499,109645040506,7,1850,982,-10
109648081427,109648081430,3,1876,1678,-10
109649332710,109649332712,2,2146,1735,-10
109650275075,109650275077,2,1777,1245,-10
109651570903,109651570907,4,1727,1466,-10
109654631058,109654631059,1,1493,1589,-10
109657890369,109657890370,1,1669,1440,-10
109661576338,109661576341,3,1709,1325,-10
109662622978,109662622982,4,1288,1323,-10
109673087257,109673087256,-1,1237,1736,-10
109673443067,109673443071,4,1013,1170,-10
109679684433,109679684433,0,17999,18641,-10
109680825230,109680825230,0,1456,1521,-10
109683015098,109683015103,5,1729,2453,-10
109683954947,109683954948,1,1148,1596,-10
109685080080,109685080083,3,1230,1201,-10
109685468397,109685468399,2,1944,1321,-10
109688006617,109688006620,3,1992,2278,-10
109691776752,109691776755,3,2051,1435,-10
109692239774,109692239776,2,1509,1406,-10
109702933725,109702933724,-1,1364,1090,-10
109707327030,109707327028,-2,2333,4571,-10
109708352961,109708352963,2,1849,1855,-10
109709753246,109709753247,1,1709,1776,-10
109714599520,109714599519,-1,2086,1596,-10
109716035080,109716035083,3,2151,2243,-10
109720703562,109720703564,2,1609,1689,-10
109728876465,109728876469,4,3530,2718,-10
109730391409,109730391411,2,1676,1590,-10
109732308454,109732308454,0,1642,2037,-10
109733587277,109733587278,1,1572,1219,-10
109734221478,109734221482,4,1741,1548,-10
109734649347,109734649349,2,1667,1557,-10
109734909197,109734909199,2,1987,2099,-10
109743838185,109743838186,1,1905,1562,-10
109746934883,109746934886,3,1442,1961,-10
109752489290,109752489290,0,761,693,-10
109753102480,109753102481,1,1339,1560,-10
109753724049,109753724049,0,1211,1415,-10
109753890865,109753890858,-7,2254,6316,-10
109755023983,109755023986,3,1911,1417,-10
109755497961,109755497962,1,1870,1585,-10
109756362883,109756362885,2,1598,1691,-10
109757695022,109757695024,2,2509,1635,-10
109758606750,109758606751,1,1392,1656,-10
109759989766,109759989771,5,1568,1210,-10
109763715724,109763715727,3,1551,875,-10
109768844827,109768844830,3,1848,1858,-10
109769635643,109769635645,2,1718,1561,-10
109770137461,109770137463,2,1468,1261,-10
109770842510,109770842510,0,946,739,-10
109774740910,109774740909,-1,2209,2150,-10
109774851047,109774851048,1,1382,1316,-10
109781158970,109781158975,5,256,4682,-10
109783855458,109783855461,3,1357,1872,-10
109786187671,109786187675,4,1701,1311,-10
109790764729,109790764731,2,2213,1591,-10
109793382329,109793382331,2,1674,1199,-10
109794694455,109794694456,1,1181,1644,-10
109796169381,109796169384,3,1695,1531,-10
109800154039,109800154043,4,1572,1556,-10
109801012358,109801012359,1,1726,1521,-10
109804351858,109804351862,4,2101,1925,-10
109804564668,109804564670,2,1596,1213,-10
109805625880,109805625879,-1,1146,1770,-10
109809585969,109809585971,2,1467,1676,-10
109817056905,109817056906,1,1784,1420,-10
109819837615,109819837621,6,2172,1192,-10
109820045935,109820045938,3,1615,1944,-10
109820539439,109820539439,0,2119,1659,-10
109820811157,109820811157,0,1081,1274,-10
109826442675,109826442674,-1,975,1208,-10
109830346345,109830346345,0,1712,1944,-10
109831936298,109831936299,1,2067,1731,-10
109833897163,109833897165,2,1283,1973,-10
109835454154,109835454155,1,1349,990,-10
109835888553,109835888554,1,1843,1651,-10
109836868926,109836868929,3,1144,1234,-10
109839257630,109839257630,0,905,845,-10
109844758823,109844758824,1,1088,1236,-10
109847054732,109847054734,2,1187,1171,-10
109847270570,109847270573,3,1979,1558,-10
109849104905,109849104906,1,1509,1303,-10
109849806983,109849806985,2,1269,1160,-10
109855262883,109855262886,3,1377,1678,-10
109858254430,109858254431,1,1774,1364,-10
109858460655,109858460656,1,1428,1270,-10
109860696839,109860696841,2,1346,1078,-10
109864132946,109864132946,0,1659,1967,-10
109864196590,109864196592,2,1642,2025,-10
109866864743,109866864744,1,803,1153,-10
109871109169,109871109170,1,2143,1813,-10
109872085800,109872085801,1,1365,1565,-10
109873208801,109873208803,2,1157,1914,-10
109873940186,109873940189,3,1281,1600,-10
109874282645,109874282645,0,1644,1716,-10
109874308797,109874308798,1,1057,1353,-10
109877893139,109877893142,3,1426,1650,-10
109878507995,109878507998,3,1402,1058,-10
109879076824,109879076825,1,1949,1285,-10
109886433771,109886433769,-2,1091,1111,-10
109889181001,109889181003,2,813,1514,-10
109890683406,109890683408,2,1651,1812,-10
109893955498,109893955502,4,1129,1099,-10
109895532427,109895532421,-6,972,5231,-10
109897841418,109897841419,1,2059,1930,-10
109900730797,109900730816,19,946,1060,-10
109900808010,109900808012,2,1807,1328,-10
109904794514,109904794515,1,1164,1144,-10
109908547996,109908547997,1,770,1398,-10
109909026961,109909026972,11,39530,10675,-10
109912730051,109912730053,2,1241,1746,-10
109913305610,109913305614,4,1822,1636,-10
109915247693,109915247694,1,1853,1933,-10
109915646656,109915646658,2,2375,1791,-10
109917753450,109917753453,3,1619,1025,-10
109919829429,109919829434,5,3356,1623,-10
109921947666,109921947674,8,5471,1900,-10
109927460146,109927460148,2,1329,1112,-10
109928764234,109928764231,-3,665,892,-10
109932137953,109932137956,3,1672,1401,-10
109936914802,109936914803,1,1674,1794,-10
109937384803,109937384797,-6,1680,6599,-10
109939386143,109939386144,1,2285,1985,-10
109940342842,109940342845,3,1065,1314,-10
109941144635,109941144638,3,1722,1432,-10
109942199211,109942199212,1,1250,1706,-10
109942413570,109942413572,2,1973,2548,-10
109945414234,109945414239,5,2751,2143,-10
109946415529,109946415526,-3,1318,3257,-10
109946978120,109946978122,2,1342,1606,-10
109948314334,109948314336,2,2051,1704,-10
109949771825,109949771826,1,1163,1198,-10
109951052146,109951052150,4,2017,1834,-10
109951465566,109951465567,1,1297,1833,-10
109952291994,109952291997,3,1477,1844,-10
109954722132,109954722134,2,1512,1761,-10
109958911433,109958911433,0,1520,1224,-10
109959354317,109959354319,2,1466,1508,-10
109960312129,109960312129,0,1009,1110,-10
109960677481,109960677479,-2,1016,995,-10
109963684917,109963684919,2,1408,1426,-10
109969495129,109969495133,4,1598,1423,-10
109970516505,109970516507,2,1902,1422,-10
109971728585,109971728589,4,795,1524,-10
109981992230,109981992230,0,1529,1215,-10
109984193512,109984193514,2,880,1420,-10
109986274582,109986274583,1,1760,1512,-10
109987173742,109987173746,4,2169,1785,-10
109989227700,109989227701,1,2124,1905,-10
109992298019,109992298023,4,1753,1413,-10
110000162855,110000162855,0,1371,1302,-10
110003687337,110003687339,2,1267,1481,-10
110007891913,110007891914,1,1794,2100,-10
110019677392,110019677393,1,1650,2107,-10
110022448078,110022448077,-1,1356,1272,-10
110023194827,110023194829,2,1570,1608,-10
110025386955,110025386950,-5,1799,5955,-10
110025731436,110025731437,1,1661,1873,-10
110027798477,110027798479,2,1791,1920,-10
110028227519,110028227521,2,1205,1094,-10
110033839863,110033839866,3,1794,1310,-10
110035643092,110035643092,0,1421,1594,-10
110037781637,110037781639,2,1787,1048,-10
110038806352,110038806355,3,1733,1674,-10
110038924617,110038924621,4,1171,1329,-10
110039415912,110039415913,1,1563,1514,-10
110040241718,110040241723,5,3846,2897,-10
110040570018,110040570019,1,1633,1307,-10
110040749246,110040749248,2,1500,889,-10
110041831621,110041831622,1,1437,1397,-10
110043269246,110043269247,1,1536,1261,-10
110059172882,110059172883,1,1214,1239,-10
110061410186,110061410191,5,1694,1135,-10
110064645366,110064645367,1,1398,2215,-10
110066033790,110066033795,5,2032,1383,-10
110067071999,110067071990,-9,995,5380,-10
110067403233,110067403234,1,1446,1771,-10
110068782673,110068782674,1,2363,2284,-10
110072270267,110072270265,-2,1447,1559,-10
110072536030,110072536033,3,1562,1746,-10
110074101810,110074101813,3,1767,1342,-10
110077964614,110077964613,-1,1087,1622,-10
110079360644,110079360646,2,1423,1397,-10
110079820782,110079820782,0,1127,1261,-10
110084974729,110084974731,2,1727,1692,-10
110087860386,110087860391,5,2054,2150,-10
110090861263,110090861262,-1,1376,1382,-10
110091521819,110091521822,3,1662,1172,-10
110092636655,110092636654,-1,672,1227,-10
110096811774,110096811777,3,1907,1418,-10
110100895820,110100895823,3,1663,1863,-10
110102647495,110102647497,2,1586,1848,-10
110103055748,110103055749,1,2188,1664,-10
110104237918,110104237918,0,1279,1754,-10
110104489990,110104489993,3,1638,2865,-10
110111563178,110111563179,1,1502,1177,-10
110112267009,110112267024,15,1488,1176,-10
110114427304,110114427306,2,2186,2344,-10
110119659190,110119659191,1,1232,1870,-10
110123388389,110123388391,2,1752,1273,-10
110124374362,110124374364,2,2181,1859,-10
110125493337,110125493338,1,1492,1426,-10
110127138526,110127138526,0,1344,1552,-10
110127938452,110127938455,3,1848,2055,-10
110129083410,110129083408,-2,1240,1688,-10
110129803872,110129803874,2,1508,1337,-10
110130468041,110130468042,1,1685,1883,-10
110131819297,110131819299,2,1939,1285,-10
110132833710,110132833691,-19,1784,569,-10
110133357229,110133357235,6,1034,1211,-10
110134884190,110134884191,1,1524,1688,-10
110140884919,110140884921,2,1857,1730,-10
110142051514,110142051515,1,1691,2401,-10
110142774670,110142774672,2,895,1337,-10
110146140143,110146140144,1,1463,1419,-10
110146490854,110146490857,3,835,1541,-10
110148138974,110148138975,1,1610,1414,-10
110148318137,110148318134,-3,1029,2735,-10
110148595169,110148595170,1,2055,1578,-10
110152459220,110152459222,2,1414,1640,-10
110155427074,110155427075,1,2005,1783,-10
110156005178,110156005179,1,1336,1241,-10
110159036243,110159036242,-1,1276,2036,-10
110159581534,110159581538,4,1833,2171,-10
110160737960,110160737960,0,1373,1915,-10
110161263532,110161263518,-14,488,181,-10
110162018759,110162018762,3,1574,1436,-10
110162108107,110162108115,8,1418,1487,-10
110166307163,110166307166,3,2191,1516,-10
110167809766,110167809767,1,978,1252,-10
110168879428,110168879431,3,1734,1461,-10
110170025352,110170025357,5,2229,1529,-10
110171647286,110171647287,1,2021,2330,-10
110171847941,110171847944,3,2014,1323,-10
110174268343,110174268342,-1,1839,1943,-10
110174565649,110174565654,5,1057,1112,-10
110174629178,110174629180,2,1829,1613,-10
110175786296,110175786302,6,2056,1210,-10
110176004792,110176004797,5,2055,1338,-10
110180179003,110180179004,1,1478,1734,-10
110181702728,110181702729,1,1748,1680,-10
110184124970,110184124971,1,1805,1809,-10
110189017410,110189017414,4,1536,1742,-10
110189273181,110189273181,0,5530,7516,-10
110191925651,110191925655,4,1455,1300,-10
110193656482,110193656482,0,1566,1571,-10
110194963585,110194963586,1,1450,1430,-10
110196449858,110196449855,-3,1330,1832,-10
110196941947,110196941951,4,1820,1531,-10
110197000150,110197000151,1,1549,1745,-10
110197791059,110197791061,2,1094,1495,-10
110199421302,110199421303,1,1407,1424,-10
110201936094,110201936094,0,1636,1755,-10
110203362043,110203362043,0,1480,1244,-10
110205026221,110205026222,1,1391,1821,-10
110205420534,110205420535,1,1203,1132,-10
110209062172,110209062175,3,19286,57338,-10
110209817643,110209817644,1,1332,1873,-10
110210110965,110210110965,0,1564,1619,-10
110211448237,110211448241,4,2813,1935,-10
110211774470,110211774474,4,1106,1350,-10
110212381329,110212381314,-15,489,466,-10
110213471995,110213471994,-1,1218,1929,-10
110214976987,110214976989,2,1246,1119,-10
110215134571,110215134572,1,1331,1867,-10
110218251209,110218251212,3,1577,1511,-10
110218280802,110218280808,6,1776,1086,-10
110219314945,110219314945,0,1247,1274,-10
110221327214,110221327217,3,1701,1548,-10
110223006907,110223006910,3,1129,1574,-10
110225346077,110225346089,12,914,840,-10
110228109681,110228109683,2,2065,1912,-10
110229078674,110229078675,1,1622,1497,-10
110233292728,110233292735,7,2142,39816,-10
110234041814,110234041817,3,1188,1240,-10
110235147724,110235147720,-4,1194,1666,-10
110236732481,110236732487,6,1953,881,-10
110237543195,110237543195,0,998,1544,-10
110241354315,110241354318,3,2233,1838,-10
110243574258,110243574259,1,1416,1564,-10
110245724466,110245724470,4,1129,1198,-10
110247288130,110247288134,4,1469,1664,-10
110249037737,110249037740,3,1162,1591,-10
110249359622,110249359630,8,1545,1057,-10
110249700883,110249700874,-9,2030,1402,-10
110252226453,110252226457,4,27349,34008,-10
110252703878,110252703875,-3,1303,2695,-10
110253079259,110253079263,4,1251,966,-10
110258333949,110258333950,1,2349,3068,-10
110259110615,110259110615,0,1680,1280,-10
110259270726,110259270726,0,1362,1558,-10
110260089511,110260089514,3,1782,1955,-10
110261164441,110261164442,1,1299,1023,-10
110261549910,110261549911,1,1620,1113,-10
110262684055,110262684057,2,1756,1141,-10
110264993223,110264993226,3,1776,2003,-10
110267653806,110267653807,1,1569,1480,-10
110268462886,110268462865,-21,2115,1090,-10
110269077726,110269077728,2,1224,1597,-10
110271100498,110271100499,1,1856,1410,-10
110271497344,110271497346,2,1878,1834,-10
110272510794,110272510794,0,1077,1289,-10
110274582466,110274582468,2,1534,2572,-10
110275424423,110275424424,1,1752,1776,-10
110281003209,110281003210,1,1456,1272,-10
110282342834,110282342838,4,1515,1095,-10
110282517379,110282517386,7,803,1314,-10
110284018139,110284018144,5,1407,1525,-10
110284722334,110284722330,-4,1261,4115,-10
110286984107,110286984111,4,932,1258,-10
110288703415,110288703416,1,1245,1724,-10
110289927635,110289927639,4,2110,1755,-10
110291958093,110291958094,1,1504,1797,-10
110292030652,110292030659,7,2394,1145,-10
110292922414,110292922413,-1,800,1972,-10
110295877319,110295877321,2,1689,1647,-10
110296123267,110296123267,0,1352,1285,-10
110296355805,110296355806,1,1757,1466,-10
110300241424,110300241424,0,1513,1621,-10
110300946925,110300946922,-3,1900,1741,-10
110309971715,110309971718,3,2090,1560,-10
110311480533,110311480545,12,1741,1443,-10
110311775562,110311775564,2,1176,1072,-10
110312252269,110312252273,4,1748,1618,-10
110318529625,110318529627,2,1305,1615,-10
110331522720,110331522730,10,20571,24889,-10
110332606607,110332606608,1,1889,1276,-10
110333062246,110333062246,0,1188,1709,-10
110339228083,110339228087,4,908,1348,-10
110339483382,110339483385,3,989,1583,-10
110340037717,110340037716,-1,1351,2128,-10
110342051280,110342051282,2,1516,1502,-10
110342901473,110342901474,1,2120,1769,-10
110343431787,110343431786,-1,1642,1740,-10
110343505551,110343505552,1,1922,2051,-10
110344114184,110344114167,-17,2271,1964,-10
110346078306,110346078309,3,1651,1409,-10
110347315058,110347315059,1,2143,1463,-10
110348426949,110348426951,2,1231,897,-10
110352542082,110352542084,2,1994,1120,-10
110352674942,110352674945,3,2002,1784,-10
110352926711,110352926709,-2,1809,3764,-10
110353647235,110353647234,-1,7777,14816,-10
110355119776,110355119778,2,1656,1279,-10
110362177418,110362177422,4,2260,1794,-10
110362550131,110362550143,12,232,996,-10
110364660192,110364660193,1,1615,1447,-10
110364893934,110364893939,5,1582,1260,-10
110366658077,110366658079,2,1655,1423,-10
110371239041,110371239042,1,1668,1710,-10
110372702452,110372702454,2,2071,1821,-10
110375088179,110375088182,3,1962,1404,-10
110376594901,110376594901,0,1418,1579,-10
110378725653,110378725652,-1,1260,1781,-10
110381569062,110381569062,0,1516,2795,-10
110384175162,110384175164,2,1999,1719,-10
110385721353,110385721356,3,1597,1949,-10
110386855970,110386855965,-5,1305,3224,-10
110390356091,110390356086,-5,1156,2024,-10
110391254239,110391254239,0,1368,1593,-10
110391776352,110391776354,2,1253,1804,-10
110392348879,110392348879,0,1638,1577,-10
110394568097,110394568098,1,1267,1754,-10
110394612147,110394612149,2,1462,1362,-10
110397388811,110397388810,-1,1237,2052,-10
110400651042,110400651042,0,903,1206,-10
110402068578,110402068579,1,1555,1396,-10
110403762298,110403762301,3,1871,1850,-10
110404435691,110404435695,4,1911,1309,-10
110409899925,110409899927,2,1166,1447,-10
110412236627,110412236630,3,1190,1183,-10
110413001534,110413001538,4,1798,1391,-10
110413170708,110413170710,2,1366,1482,-10
110413930602,110413930604,2,1783,1797,-10
110414434850,110414434852,2,2358,1839,-10
110416257501,110416257502,1,1428,1321,-10
110416748716,110416748717,1,2006,2009,-10
110419881114,110419881115,1,1644,1116,-10
110430751881,110430751882,1,1829,1599,-10
110430882245,110430882226,-19,1760,1689,-10
110437632085,110437632090,5,1839,1788,-10
110439733783,110439733785,2,1373,1678,-10
110442071337,110442071338,1,1455,1764,-10
110443392689,110443392691,2,2117,1849,-10
110445647760,110445647755,-5,1269,2778,-10
110448143473,110448143476,3,1818,1617,-10
110448712258,110448712259,1,1513,1057,-10
110448854943,110448854942,-1,1318,1384,-10
110451151758,110451151762,4,1926,1708,-10
110452121178,110452121179,1,1613,1987,-10
110452810475,110452810478,3,1716,2059,-10
110455428871,110455428874,3,1683,1777,-10
110456267808,110456267810,2,1252,1368,-10
110457366867,110457366867,0,986,1184,-10
110459447718,110459447721,3,1341,1503,-10
110460476376,110460476378,2,1360,1300,-10
110460878754,110460878752,-2,1078,1369,-10
110461683141,110461683142,1,1392,1608,-10
110466509077,110466509080,3,1710,1647,-10
110468397110,110468397111,1,1602,1198,-10
110469681192,110469681194,2,1593,1434,-10
110470547658,110470547660,2,1507,1710,-10
110472852918,110472852920,2,1353,999,-10
110475204141,110475204143,2,1254,1607,-10
110475379497,110475379500,3,1798,1219,-10
110479357826,110479357828,2,1837,1590,-10
110480010521,110480010527,6,1493,1143,-10
110483301329,110483301333,4,1249,832,-10
110487516785,110487516786,1,1285,1226,-10
110491959777,110491959775,-2,2192,4980,-10
110495320999,110495320993,-6,1186,6478,-10
110499883543,110499883545,2,1598,1457,-10
110502342976,110502342978,2,1953,1814,-10
110507292881,110507292886,5,2802,1621,-10
110507828612,110507828613,1,1437,2080,-10
110508465932,110508465951,19,1175,1311,-10
110510721377,110510721379,2,1509,1617,-10
110511066996,110511066998,2,1559,1495,-10
110512087225,110512087206,-19,1770,1712,-10
110513279763,110513279764,1,1209,1331,-10
110518941699,110518941702,3,1320,1231,-10
110520415630,110520415629,-1,1612,1760,-10
110523185432,110523185435,3,1420,1196,-10
110524250454,110524250456,2,1225,1422,-10
110525329818,110525329832,14,1464,1843,-10
110525380364,110525380366,2,1892,2169,-10
110527214801,110527214803,2,1626,1585,-10
110527432338,110527432342,4,1406,1539,-10
110530558977,110530558974,-3,786,2155,-10
110532798109,110532798112,3,2211,1810,-10
110533038984,110533038985,1,1023,1049,-10
110535341481,110535341482,1,1609,2145,-10
110537897441,110537897443,2,1203,1778,-10
110537923320,110537923323,3,1639,1582,-10
110540878238,110540878242,4,1332,1644,-10
110541367932,110541367936,4,1871,1419,-10
110543966180,110543966186,6,446,797,-10
110547574151,110547574150,-1,1053,865,-10
110549278759,110549278761,2,1281,1479,-10
110549729055,110549729057,2,1670,1635,-10
110555428007,110555428010,3,1839,1403,-10
110556840467,110556840470,3,1394,1310,-10
110557096670,110557096674,4,1882,1540,-10
110559839407,110559839406,-1,2008,2851,-10
110562587634,110562587634,0,1865,1757,-10
110563333135,110563333135,0,1491,1575,-10
110565795605,110565795611,6,1391,1279,-10
110566923385,110566923386,1,2366,1940,-10
110569401775,110569401774,-1,1256,1752,-10
110571966674,110571966675,1,1003,1126,-10
110573069889,110573069893,4,1324,1240,-10
110575832688,110575832690,2,5583,6139,-10
110578431283,110578431287,4,1950,1693,-10
110579989810,110579989817,7,1885,1354,-10
110580343256,110580343260,4,1428,1377,-10
110581918386,110581918386,0,1283,1529,-10
110582429139,110582429139,0,1371,853,-10
110583425981,110583425982,1,1605,1782,-10
110583478707,110583478713,6,3042,2229,-10
110585089327,110585089326,-1,977,1399,-10
110589205218,110589205221,3,2033,1474,-10
110590723479,110590723483,4,1590,1284,-10
110592638693,110592638694,1,2242,1683,-10
110593296377,110593296378,1,1913,1149,-10
110599526397,110599526402,5,1902,1342,-10
110601217094,110601217096,2,1144,1787,-10
110602085919,110602085917,-2,1036,3034,-10
110602903106,110602903107,1,1268,1881,-10
110603686397,110603686397,0,2232,2023,-10
110612627893,110612627893,0,2117,1287,-10
110616282653,110616282654,1,2425,1951,-10
110617365479,110617365481,2,1900,1338,-10
110618851865,110618851867,2,2143,1238,-10
110620330591,110620330594,3,1732,1697,-10
110620532882,110620532882,0,2288,1721,-10
110621379307,110621379314,7,2350,1027,-10
110621531028,110621531030,2,1777,1536,-10
110622143678,110622143681,3,1801,1790,-10
110622811021,110622811023,2,1569,1884,-10
110624388686,110624388686,0,1123,955,-10
110627381607,110627381604,-3,860,2415,-10
110628580615,110628580614,-1,1098,1688,-10
110633193028,110633193029,1,1398,1766,-10
110634896362,110634896364,2,1111,1379,-10
110638951404,110638951406,2,1862,1580,-10
110642704471,110642704473,2,1506,1893,-10
110643498793,110643498793,0,1387,1354,-10
110643879526,110643879527,1,1251,1526,-10
110644432779,110644432783,4,1348,1240,-10
110647839898,110647839913,15,1449,1098,-10
110650811602,110650811603,1,1699,1312,-10
110654713681,110654713684,3,5827,28197,-10
110655085732,110655085734,2,1804,1987,-10
110656638620,110656638622,2,2286,2302,-10
110657747281,110657747282,1,1558,1394,-10
110659797725,110659797727,2,1822,1220,-10
110661744586,110661744589,3,978,1359,-10
110664709839,110664709837,-2,2221,4052,-10
110664811528,110664811530,2,1406,1459,-10
110666204207,110666204209,2,1445,1355,-10
110669378332,110669378337,5,2435,1210,-10
110673138225,110673138227,2,1999,1593,-10
110674211830,110674211831,1,1106,1537,-10
110678129637,110678129638,1,1665,1424,-10
110685112647,110685112649,2,1245,1293,-10
110686090759,110686090760,1,1040,1828,-10
110686195966,110686195967,1,1546,1669,-10
110688340121,110688340121,0,1549,1724,-10
110688803692,110688803696,4,1429,1423,-10
110690051788,110690051789,1,2148,1802,-10
110692679018,110692679018,0,1938,1757,-10
110695233574,110695233578,4,1057,1399,-10
110700139194,110700139194,0,1264,1160,-10
110702998720,110702998722,2,1599,1626,-10
110703717838,110703717839,1,1450,1182,-10
110706411999,110706412003,4,1877,1994,-10
110706468623,110706468625,2,1638,1720,-10
110707103634,110707103634,0,1797,1608,-10
110709085921,110709085922,1,1992,2183,-10
110713239380,110713239381,1,1617,1779,-10
110715492020,110715492022,2,851,1025,-10
110719125778,110719125774,-4,1194,2635,-10
110721136448,110721136450,2,1485,1647,-10
110721709783,110721709786,3,1381,1815,-10
110721840126,110721840130,4,3260,1399,-10
110724407058,110724407061,3,1200,1769,-10
110728975278,110728975281,3,1178,1189,-10
110731029836,110731029825,-11,176,778,-10
110732809977,110732809978,1,4860,18136,-10
110734260975,110734260978,3,962,1079,-10
110734655763,110734655766,3,1892,1193,-10
110741150944,110741150946,2,1532,1492,-10
110742416616,110742416614,-2,1130,1654,-10
110747082300,110747082301,1,1297,1243,-10
110747416390,110747416391,1,1744,1848,-10
110750418858,110750418862,4,2011,1980,-10
110751492478,110751492480,2,1651,1648,-10
110752560278,110752560279,1,857,770,-10
110755469264,110755469267,3,1192,1626,-10
110755563033,110755563018,-15,1649,1589,-10
110761952079,110761952080,1,1471,1339,-10
110764459216,110764459216,0,1867,1779,-10
110768197030,110768197031,1,2265,1511,-10
110768292935,110768292938,3,1434,1236,-10
110769349930,110769349935,5,1129,874,-10
110770248013,110770248009,-4,2027,4766,-10
110772773010,110772773005,-5,13287,15912,-10
110773319705,110773319710,5,1627,1276,-10
110773922839,110773922838,-1,1188,1241,-10
110775735950,110775735943,-7,2427,6819,-10
110777956665,110777956667,2,901,1221,-10
110780188270,110780188270,0,1216,1906,-10
110784150175,110784150178,3,1405,1108,-10
110785361089,110785361091,2,1334,1312,-10
110786864111,110786864114,3,1844,2388,-10
110788039674,110788039673,-1,1580,1883,-10
110788283267,110788283270,3,2336,1673,-10
110797649758,110797649755,-3,1240,1337,-10
110797763297,110797763278,-19,1315,1489,-10
110799856597,110799856598,1,1850,2127,-10
110801442313,110801442314,1,1803,1367,-10
110803161813,110803161814,1,1894,1539,-10
110803553323,110803553326,3,1597,1252,-10
110807219634,110807219635,1,1381,1586,-10
110807286320,110807286322,2,1229,1942,-10
110807348122,110807348106,-16,1547,1293,-10
110809385374,110809385378,4,1042,1253,-10
110814458774,110814458772,-2,1161,2512,-10
110826257429,110826257434,5,1766,1109,-10
110828522579,110828522582,3,1980,1537,-10
110829744698,110829744707,9,2858,823,-10
110830076354,110830076362,8,2592,2308,-10
110833207445,110833207445,0,1467,1309,-10
110834160838,110834160841,3,1687,1459,-10
110835867176,110835867179,3,1862,1342,-10
110839729249,110839729251,2,1329,1484,-10
110840203690,110840203691,1,1249,1351,-10
110846015465,110846015469,4,16387,9168,-10
110846445466,110846445467,1,1435,1932,-10
110848232466,110848232467,1,1650,1576,-10
110849869223,110849869225,2,1464,1302,-10
110852853774,110852853773,-1,1825,1758,-10
110853065426,110853065426,0,1970,1860,-10
110856500717,110856500722,5,1726,1328,-10
110857869755,110857869758,3,1402,1586,-10
110859101489,110859101490,1,1471,1203,-10
110860126994,110860126993,-1,1743,1209,-10
110860406045,110860406047,2,1895,2055,-10
110861874478,110861874480,2,1594,1645,-10
110865994655,110865994659,4,944,1222,-10
110869525466,110869525467,1,1120,1466,-10
110870850068,110870850069,1,1986,1863,-10
110871364491,110871364473,-18,1279,1193,-10
110874821611,110874821614,3,2118,1690,-10
110879327103,110879327107,4,1441,1212,-10
110883007513,110883007514,1,1776,1513,-10
110885373377,110885373377,0,1826,1707,-10
110885888414,110885888415,1,1452,1434,-10
110886332810,110886332813,3,1581,1559,-10
110888683471,110888683474,3,1427,1138,-10
110888808317,110888808297,-20,1589,1640,-10
110891595017,110891595019,2,1823,1441,-10
110892861216,110892861215,-1,984,1910,-10
110895641434,110895641438,4,1606,2038,-10
110896097918,110896097918,0,914,879,-10
110907102967,110907102969,2,1547,2000,-10
110911070186,110911070187,1,1390,1400,-10
110911500921,110911500925,4,1976,2103,-10
110912732097,110912732097,0,1236,2252,-10
110913110754,110913110753,-1,1400,2291,-10
110916761434,110916761434,0,1776,1713,-10
110919324522,110919324523,1,1466,1431,-10
110920455134,110920455138,4,1247,1308,-10
110921648143,110921648146,3,1048,836,-10
110921871659,110921871661,2,1164,852,-10
110926216984,110926216988,4,1842,1779,-10
110927509131,110927509134,3,1429,1645,-10
110928558598,110928558597,-1,1776,2498,-10
110932278721,110932278723,2,1429,1567,-10
110941123363,110941123366,3,1909,1404,-10
110941285174,110941285193,19,1362,1822,-10
110941782578,110941782580,2,1085,1231,-10
110943512874,110943512874,0,1734,1598,-10
110944606203,110944606202,-1,1129,2009,-10
110947036430,110947036431,1,1265,1488,-10
110948405646,110948405647,1,1245,908,-10
110949461865,110949461866,1,1526,1554,-10
110951128805,110951128806,1,1078,1551,-10
110953861626,110953861626,0,1184,1072,-10
110954788674,110954788675,1,1562,1438,-10
110956053375,110956053378,3,1168,1651,-10
110958813156,110958813157,1,1279,1661,-10
110959472013,110959472015,2,1501,1612,-10
110960711814,110960711817,3,1389,1573,-10
110963013770,110963013771,1,1559,1302,-10
110963999867,110963999870,3,1407,1203,-10
110964729014,110964729016,2,1377,1026,-10
110968455898,110968455897,-1,1523,2151,-10
110971889375,110971889375,0,1074,1178,-10
110974839117,110974839119,2,1650,1371,-10
110976620621,110976620623,2,824,922,-10
110977863535,110977863538,3,1690,1536,-10
110978094999,110978095001,2,1416,1694,-10
110979313307,110979313306,-1,823,1309,-10
110982160362,110982160367,5,2096,1848,-10
110982986719,110982986718,-1,1623,1102,-10
110986614881,110986614880,-1,1840,1380,-10
110988431578,110988431582,4,1434,1157,-10
110989019561,110989019565,4,1676,1635,-10
110989088309,110989088321,12,1069,1312,-10
110993476970,110993476971,1,1139,1411,-10
110993780344,110993780344,0,1554,1099,-10
110997525810,110997525812,2,1083,861,-10
111004208644,111004208645,1,1600,1477,-10
111005541647,111005541647,0,1175,1244,-10
111009219369,111009219370,1,1507,1850,-10
111011837494,111011837494,0,1454,2032,-10
111012254298,111012254299,1,1264,1813,-10
111015644904,111015644907,3,1797,1688,-10
111016541742,111016541745,3,1254,1498,-10
111019052564,111019052566,2,1902,1875,-10
111021339514,111021339515,1,1532,852,-10
111023662182,111023662182,0,1590,1718,-10
111024160631,111024160633,2,1354,1463,-10
111025408254,111025408257,3,3224,2058,-10
111025576333,111025576335,2,1275,1472,-10
111028299951,111028299953,2,1308,1737,-10
111030980134,111030980136,2,1232,1600,-10
111032033036,111032033039,3,2215,1135,-10
111032703838,111032703839,1,883,1312,-10
111033481334,111033481337,3,1528,1661,-10
111036867193,111036867193,0,1012,1307,-10
111039216447,111039216449,2,792,870,-10
111039388292,111039388275,-17,1173,1010,-10
111040505034,111040505035,1,1633,1624,-10
111041988474,111041988475,1,1523,1211,-10
111043834962,111043834961,-1,1607,1464,-10
111044260333,111044260315,-18,1882,1773,-10
111047748344,111047748339,-5,1429,3674,-10
111048153057,111048153074,17,835,2478,-10
111051277934,111051277939,5,2169,1591,-10
111052430443,111052430443,0,1137,1399,-10
111053764667,111053764666,-1,1102,1188,-10
111055299963,111055299965,2,770,793,-10
111059033376,111059033377,1,1100,1248,-10
111067153181,111067153183,2,1195,1003,-10
111068186762,111068186762,0,1487,1640,-10
111069778291,111069778293,2,2074,1849,-10
111069954985,111069955003,18,1868,1386,-10
111073438754,111073438758,4,1579,1243,-10
111075536226,111075536228,2,974,648,-10
111076027799,111076027798,-1,1862,1609,-10
111077268246,111077268249,3,1815,1740,-10
111077659417,111077659418,1,1028,1086,-10
111078493916,111078493917,1,1055,1111,-10
111079592582,111079592586,4,1182,1614,-10
111081622802,111081622803,1,1640,2159,-10
111081881457,111081881458,1,1216,1567,-10
111091079438,111091079452,14,1840,1532,-10
111091292143,111091292160,17,1382,1266,-10
111092339209,111092339209,0,1348,1296,-10
111093213426,111093213427,1,1186,2034,-10
111099610846,111099610852,6,2626,1041,-10
111106124802,111106124802,0,994,1334,-10
111108491423,111108491426,3,1406,1223,-10
111111600020,111111600019,-1,1900,2046,-10
111112158382,111112158385,3,1674,1073,-10
111112588739,111112588741,2,1924,1758,-10
111113545503,111113545505,2,1524,1257,-10
111113975441,111113975442,1,1958,1692,-10
111116222497,111116222498,1,1914,1635,-10
111122408483,111122408486,3,1607,1519,-10
111123190118,111123190122,4,1943,2080,-10
111123426214,111123426218,4,1919,1324,-10
111123472310,111123472311,1,1393,1483,-10
111123611080,111123611083,3,1422,1326,-10
111124454393,111124454395,2,837,736,-10
111125654086,111125654087,1,1552,1369,-10
111130623505,111130623507,2,1667,1588,-10
111131678558,111131678557,-1,1417,2239,-10
111131774016,111131774017,1,1084,1042,-10
111136717018,111136717018,0,1229,1592,-10
111139205459,111139205458,-1,1018,1453,-10
111140780877,111140780879,2,1240,1406,-10
111143175225,111143175226,1,1326,1363,-10
111145302756,111145302756,0,1671,1495,-10
111146865400,111146865401,1,1784,1617,-10
111157193151,111157193149,-2,1690,2662,-10
111159411688,111159411686,-2,773,1624,-10
111159877081,111159877082,1,1345,1600,-10
111163755650,111163755650,0,1632,1684,-10
111164795642,111164795645,3,1218,1247,-10
111165315706,111165315710,4,1331,1475,-10
111165342610,111165342613,3,2017,2088,-10
111166350854,111166350856,2,1380,1646,-10
111166568438,111166568443,5,4456,1985,-10
111167290323,111167290327,4,1394,1127,-10
111168358156,111168358159,3,2237,2070,-10
111168908026,111168908027,1,1384,1085,-10
111169405730,111169405725,-5,886,2803,-10
111169565803,111169565806,3,1088,1308,-10
111171337267,111171337267,0,1325,851,-10
111172330393,111172330411,18,1483,1435,-10
111173376261,111173376263,2,1048,888,-10
111177712067,111177712071,4,1717,1877,-10
111178162097,111178162098,1,1868,1305,-10
111181138651,111181138654,3,1637,996,-10
111181961433,111181961435,2,2297,1736,-10
111182623075,111182623078,3,1862,1503,-10
111183743219,111183743222,3,1975,2404,-10
111188799721,111188799722,1,1278,1630,-10
111190261422,111190261425,3,1145,1933,-10
111191118503,111191118505,2,1947,1483,-10
111192457558,111192457561,3,1554,1031,-10
111193284559,111193284561,2,993,793,-10
111194914286,111194914286,0,1150,1565,-10
111195496213,111195496216,3,1177,1313,-10
111202611014,111202611017,3,1638,1395,-10
111204124634,111204124634,0,1383,1521,-10
111207353133,111207353136,3,1520,1733,-10
111208368660,111208368661,1,1541,1431,-10
111208659383,111208659384,1,1510,1278,-10
111210024666,111210024669,3,1530,1339,-10
111211732226,111211732219,-7,796,4662,-10
111211760570,111211760574,4,1625,1656,-10
111212377602,111212377602,0,1025,994,-10
111212848699,111212848691,-8,1581,1585,-10
111213837002,111213837002,0,2209,2276,-10
111214469737,111214469738,1,1443,1339,-10
111215557862,111215557864,2,1125,1416,-10
111217400069,111217400071,2,1500,1344,-10
111220736882,111220736882,0,1444,1323,-10
111221398597,111221398603,6,1999,1392,-10
111222306848,111222306849,1,1984,1696,-10
111224799663,111224799665,2,1739,1494,-10
111227015444,111227015445,1,1188,1525,-10
111228355297,111228355298,1,1284,1453,-10
111229143444,111229143447,3,1423,1497,-10
111234255297,111234255297,0,594,797,-10
111236093309,111236093310,1,1934,1269,-10
111239316854,111239316854,0,1772,1889,-10
111239978480,111239978478,-2,21564,8878,-10
111240362210,111240362211,1,2012,2053,-10
111240831850,111240831850,0,1039,838,-10
111245821431,111245821433,2,1708,1460,-10
111248174712,111248174713,1,1384,1945,-10
111249148538,111249148541,3,1542,1352,-10
111249211882,111249211884,2,1384,1866,-10
111251228420,111251228421,1,1225,1384,-10
111251674555,111251674560,5,1796,1241,-10
111258011825,111258011826,1,1259,1379,-10
111259201115,111259201117,2,1815,2124,-10
111260028945,111260028946,1,1211,1621,-10
111260597333,111260597337,4,1755,1551,-10
111262686730,111262686734,4,2802,1864,-10
111263821283,111263821278,-5,1188,4603,-10
111264228085,111264228086,1,1206,1785,-10
111265050181,111265050183,2,2035,1851,-10
111265758526,111265758528,2,1415,1491,-10
111270531670,111270531672,2,1738,2170,-10
111274810806,111274810809,3,1163,1549,-10
111276050345,111276050346,1,1274,2090,-10
111276281910,111276281913,3,1361,1465,-10
111277377271,111277377274,3,946,1241,-10
111279115370,111279115374,4,2504,2331,-10
111279347160,111279347163,3,2004,1537,-10
111280664162,111280664162,0,1763,1295,-10
111281750042,111281750041,-1,1835,1989,-10
111285853149,111285853151,2,1958,1507,-10
111286226496,111286226496,0,1599,1382,-10
111288322393,111288322394,1,1597,1928,-10
111289962315,111289962317,2,1233,1220,-10
111294916881,111294916881,0,2419,1586,-10
111295170599,111295170602,3,1926,1110,-10
111301154298,111301154295,-3,1096,2112,-10
111301536074,111301536074,0,1220,1415,-10
111302468030,111302468010,-20,1646,1102,-10
111303707334,111303707337,3,991,1409,-10
111304866248,111304866249,1,1735,1460,-10
111305918711,111305918714,3,1588,1419,-10
111309181478,111309181480,2,1032,1211,-10
111313097558,111313097559,1,1641,1621,-10
111314861002,111314861006,4,1669,1307,-10
111318743640,111318743638,-2,580,1162,-10
111318976368,111318976391,23,1314,1163,-10
111321582583,111321582586,3,870,1586,-10
111322017302,111322017306,4,2205,1710,-10
111322567055,111322567058,3,1749,1128,-10
111324595167,111324595174,7,1531,1427,-10
111324950742,111324950749,7,3276,1897,-10
111327948067,111327948069,2,1756,949,-10
111328298865,111328298875,10,1934,1256,-10
111328943473,111328943478,5,1143,1078,-10
111331472214,111331472218,4,1785,1403,-10
111332157684,111332157680,-4,1286,1641,-10
111332194162,111332194167,5,1651,1413,-10
111332681382,111332681383,1,1926,2334,-10
111334410809,111334410809,0,1128,2309,-10
111336840878,111336840883,5,2576,1278,-10
111338718037,111338718041,4,1795,1721,-10
111340622140,111340622140,0,1535,1575,-10
111345312007,111345312008,1,980,900,-10
111349472229,111349472231,2,1911,1526,-10
111353330645,111353330646,1,1631,2000,-10
111354027075,111354027078,3,1882,1437,-10
111356592726,111356592726,0,1138,1424,-10
111359877652,111359877652,0,1461,1283,-10
111361833421,111361833427,6,1828,807,-10
111362097657,111362097659,2,1735,1231,-10
111363595205,111363595186,-19,2345,2450,-10
111367738377,111367738379,2,1477,1682,-10
111368772052,111368772053,1,1660,1269,-10
111370606911,111370606914,3,1664,1482,-10
111371249091,111371249087,-4,857,1865,-10
111372234422,111372234423,1,1635,1622,-10
111380829831,111380829835,4,1780,1896,-10
111381766973,111381766973,0,1164,1497,-10
111382182861,111382182866,5,1202,1407,-10
111382368851,111382368854,3,1179,1470,-10
111383711331,111383711333,2,894,996,-10
111385352807,111385352807,0,806,1067,-10
111387151898,111387151900,2,1795,1548,-10
111388192694,111388192694,0,2014,1445,-10
111389816037,111389816040,3,2376,1834,-10
111392580722,111392580722,0,1466,2067,-10
111392638317,111392638323,6,1746,781,-10
111393815274,111393815277,3,1591,2527,-10
111394967783,111394967781,-2,2588,5248,-10
111395434154,111395434154,0,1851,2333,-10
111396685044,111396685046,2,1876,1956,-10
111397383020,111397383022,2,1784,1719,-10
111398167935,111398167912,-23,1459,1113,-10
111404794714,111404794715,1,1326,1195,-10
111408989600,111408989603,3,1663,1418,-10
111411910598,111411910597,-1,1370,1361,-10
111416519446,111416519447,1,1676,1403,-10
111417306679,111417306682,3,1757,1374,-10
111418261683,111418261685,2,1432,1773,-10
111418393934,111418393937,3,1460,1463,-10
111419898478,111419898479,1,1750,1600,-10
111421596469,111421596474,5,1362,1674,-10
111426015707,111426015710,3,1522,1276,-10
111426472201,111426472205,4,1976,1338,-10
111428052041,111428052041,0,1484,2091,-10
111428157609,111428157612,3,1169,1573,-10
111429370376,111429370368,-8,735,5556,-10
111429765637,111429765638,1,1690,1430,-10
111435863397,111435863399,2,1815,1218,-10
111437550265,111437550266,1,1021,1246,-10
111437960266,111437960280,14,1416,1075,-10
111438792657,111438792661,4,16634,10943,-10
111439145774,111439145777,3,1838,1910,-10
111440432626,111440432629,3,1220,2056,-10
111441246675,111441246677,2,2346,1646,-10
111441426799,111441426798,-1,1712,1739,-10
111441808881,111441808883,2,1703,1363,-10
111445483552,111445483553,1,1773,1841,-10
111445684144,111445684147,3,2079,1420,-10
111447255234,111447255232,-2,1363,1420,-10
111454587434,111454587430,-4,2432,5078,-10
111456558061,111456558059,-2,1168,1377,-10
111459148222,111459148224,2,2179,1931,-10
111463762469,111463762473,4,1369,1295,-10
111465180694,111465180696,2,1223,1783,-10
111473419293,111473419294,1,906,1293,-10
111476969994,111476969996,2,1557,1932,-10
111478177529,111478177534,5,3427,1532,-10
111480168718,111480168719,1,1750,978,-10
111480650779,111480650781,2,917,950,-10
111482832837,111482832839,2,1319,1285,-10
111483248590,111483248590,0,1234,1631,-10
111483465151,111483465153,2,1802,2297,-10
111484963787,111484963790,3,1407,1699,-10
111487025842,111487025841,-1,1514,1522,-10
111487292614,111487292615,1,1205,1981,-10
111487793133,111487793134,1,1308,1227,-10
111488102178,111488102181,3,947,1294,-10
111489182300,111489182301,1,1514,1411,-10
111495834278,111495834281,3,1919,1518,-10
111496278422,111496278417,-5,2622,4619,-10
111500615153,111500615154,1,1165,1345,-10
111502505589,111502505591,2,1727,1606,-10
111503624890,111503624892,2,1704,1753,-10
111503716030,111503716034,4,1628,1305,-10
111504351466,111504351468,2,1513,1332,-10
111506003382,111506003382,0,1260,1585,-10
111507986174,111507986174,0,2060,1848,-10
111508161519,111508161522,3,1599,2060,-10
111509672819,111509672829,10,12320,44962,-10
111509996378,111509996380,2,1325,1634,-10
111514484143,111514484146,3,1581,1056,-10
111516815789,111516815794,5,1209,1742,-10
111519126030,111519126031,1,1144,1294,-10
111520662327,111520662322,-5,1080,1944,-10
111520705362,111520705363,1,1127,1350,-10
111523050009,111523050011,2,1425,993,-10
111524330502,111524330502,0,1802,1645,-10
111526310610,111526310611,1,1276,1245,-10
111526595506,111526595506,0,1031,1336,-10
111527162537,111527162538,1,1474,1937,-10
111527639389,111527639395,6,1400,1393,-10
111530133601,111530133605,4,1729,1397,-10
111530747670,111530747685,15,14691,46514,-10
111530847238,111530847238,0,1188,1165,-10
111531395259,111531395262,3,1465,1101,-10
111531706455,111531706458,3,2667,1882,-10
111535812254,111535812251,-3,2386,4197,-10
111536354170,111536354172,2,1395,1513,-10
111538250101,111538250098,-3,1281,3073,-10
111538501916,111538501915,-1,1158,1175,-10
111541360203,111541360205,2,2089,1763,-10
111543603569,111543603579,10,1627,1229,-10
111545242226,111545242229,3,2167,1853,-10
111548397977,111548397980,3,901,1084,-10
111549931235,111549931238,3,1934,1836,-10
111554691808,111554691809,1,896,1405,-10
111559462046,111559462050,4,1961,1788,-10
111559765433,111559765435,2,2389,1083,-10
111560884587,111560884590,3,1511,1402,-10
111562170918,111562170918,0,1806,1830,-10
111562543880,111562543885,5,3005,1538,-10
111565381398,111565381405,7,1207,1113,-10
111566025402,111566025407,5,1418,1000,-10
111568599142,111568599142,0,1100,1317,-10
111570058508,111570058511,3,1619,1227,-10
111572815871,111572815873,2,839,1427,-10
111574770502,111574770505,3,1070,2058,-10
111575314577,111575314582,5,1044,1646,-10
111575876853,111575876855,2,1751,1949,-10
111578299207,111578299209,2,1431,1121,-10
111578824767,111578824768,1,1515,1512,-10
111579272483,111579272468,-15,2035,2021,-10
111580853530,111580853534,4,825,1316,-10
111586089979,111586089980,1,1316,1217,-10
111588067968,111588067969,1,1457,1366,-10
111589562351,111589562354,3,1627,1287,-10
111594269817,111594269820,3,3737,3512,-10
111599086201,111599086202,1,1388,1507,-10
111612175871,111612175874,3,1252,1357,-10
111613928309,111613928313,4,1927,1693,-10
111616733378,111616733381,3,1369,1517,-10
111620955270,111620955273,3,1355,1409,-10
111621800330,111621800334,4,1153,1001,-10
111625394281,111625394282,1,2009,1385,-10
111629242461,111629242462,1,1698,1729,-10
111630970681,111630970682,1,1742,1443,-10
111633330331,111633330332,1,961,1347,-10
111634608997,111634608999,2,1223,1361,-10
111636449150,111636449154,4,1588,986,-10
111641455515,111641455516,1,1725,2021,-10
111642266510,111642266512,2,2298,1747,-10
111643541137,111643541139,2,2214,1375,-10
111647769642,111647769645,3,1350,1120,-10
111649107070,111649107071,1,1481,1377,-10
111649905629,111649905634,5,2687,1705,-10
111650057182,111650057192,10,2030,1165,-10
111651405682,111651405687,5,951,1113,-10
111652353944,111652353943,-1,1448,1160,-10
111655238098,111655238099,1,1904,1532,-10
111660602072,111660602074,2,1590,1921,-10
111671715599,111671715602,3,892,1098,-10
111675157072,111675157074,2,1353,934,-10
111675838264,111675838267,3,1505,1094,-10
111676116786,111676116789,3,747,1004,-10
111681707122,111681707122,0,1864,1936,-10
111682602705,111682602705,0,1639,1531,-10
111684821949,111684821950,1,2311,2197,-10
111687542656,111687542657,1,1278,1898,-10
111689344970,111689344971,1,1496,1088,-10
111689397847,111689397847,0,1794,1384,-10
111692665229,111692665234,5,1181,1273,-10
111704246609,111704246610,1,1254,2101,-10
111708047235,111708047238,3,1156,1263,-10
111709831995,111709831990,-5,1010,2697,-10
111710453350,111710453355,5,839,1067,-10
111714672681,111714672682,1,1639,1560,-10
111714987539,111714987518,-21,1028,1379,-10
111715408867,111715408864,-3,2122,3729,-10
111716308875,111716308882,7,2556,1309,-10
111717171751,111717171754,3,1773,1183,-10
111717517315,111717517316,1,1340,1973,-10
111724566974,111724566978,4,1983,1402,-10
111729317898,111729317899,1,1526,1264,-10
111732386630,111732386634,4,1320,1346,-10
111733092020,111733092018,-2,801,961,-10
111736472467,111736472471,4,1376,970,-10
111737199774,111737199786,12,1988,1249,-10
111739462870,111739462871,1,1740,1872,-10
111742801709,111742801711,2,1661,1473,-10
111744291357,111744291358,1,37859,41731,-10
111744896225,111744896227,2,1397,1472,-10
111748061912,111748061914,2,1596,1347,-10
111750102917,111750102916,-1,29490,24308,-10
111750479225,111750479228,3,1325,1387,-10
111751492785,111751492786,1,1784,1651,-10
111754383237,111754383241,4,1140,1419,-10
111759373861,111759373862,1,763,884,-10
111760345478,111760345496,18,2646,1472,-10
111763111427,111763111430,3,1529,1346,-10
111763251627,111763251610,-17,794,677,-10
111763328548,111763328566,18,951,1004,-10
111766084202,111766084203,1,805,1573,-10
111769353359,111769353361,2,1655,1330,-10
111770458826,111770458815,-11,3765,13039,-10
111771626541,111771626544,3,2035,1590,-10
111779930933,111779930934,1,1287,1723,-10
111779979822,111779979825,3,1186,1524,-10
111782344194,111782344175,-19,1696,1802,-10
111785172417,111785172419,2,1492,1752,-10
111790818379,111790818376,-3,724,1858,-10
111793545457,111793545457,0,1224,1437,-10
111798329682,111798329686,4,1092,1547,-10
111802157501,111802157502,1,1018,1010,-10
111804779227,111804779227,0,1533,1660,-10
111807320794,111807320795,1,1118,1611,-10
111809599295,111809599297,2,2087,1775,-10
111811676041,111811676041,0,1282,1178,-10
111812376926,111812376920,-6,873,2216,-10
111815898361,111815898363,2,955,1313,-10
111819003456,111819003458,2,1368,1185,-10
111820596467,111820596471,4,1342,1470,-10
111823452426,111823452430,4,1554,1232,-10
111823663575,111823663575,0,1334,1465,-10
111824929889,111824929890,1,1734,2010,-10
111825271458,111825271457,-1,1411,1662,-10
111825565964,111825565977,13,712,2359,-10
111828211731,111828211732,1,1791,2172,-10
111828690617,111828690618,1,1574,1209,-10
111831184437,111831184439,2,1233,1639,-10
111832272705,111832272705,0,1459,1574,-10
111834616969,111834616968,-1,1870,1576,-10
111838445633,111838445637,4,2282,1575,-10
111841515637,111841515637,0,1000,2009,-10
111842356046,111842356047,1,1625,1385,-10
111844855765,111844855766,1,1388,1378,-10
111846520055,111846520034,-21,1328,1953,-10
111847073990,111847073993,3,1783,1274,-10
111850569760,111850569771,11,1323,971,-10
111851540113,111851540135,22,1847,1330,-10
111851699486,111851699486,0,1462,1566,-10
111853245787,111853245787,0,1348,1651,-10
111857053023,111857053026,3,1334,1447,-10
111858518679,111858518682,3,1226,1534,-10
111859462547,111859462548,1,1533,2472,-10
111859797986,111859797991,5,1459,1374,-10
111860158401,111860158402,1,1530,2023,-10
111866193191,111866193194,3,1452,1704,-10
111867992586,111867992589,3,1132,1290,-10
111870756185,111870756187,2,1470,1590,-10
111871119770,111871119771,1,1305,1453,-10
111871609525,111871609526,1,911,977,-10
111872005918,111872005919,1,1639,1244,-10
111874515813,111874515813,0,1461,1465,-10
111874786621,111874786623,2,1362,1362,-10
111875582058,111875582060,2,1805,1577,-10
111877601567,111877601570,3,1369,1630,-10
111881631918,111881631922,4,1205,1388,-10
111881935213,111881935214,1,1431,1250,-10
111888457903,111888457914,11,703,311,-10
111891112457,111891112462,5,1802,1319,-10
111892357778,111892357778,0,1276,966,-10
111893679284,111893679287,3,1589,1131,-10
111895272521,111895272523,2,1333,1740,-10
111896666849,111896666853,4,1507,1514,-10
111899816595,111899816597,2,1249,1288,-10
111901151823,111901151824,1,1577,1530,-10
111903851517,111903851518,1,814,1430,-10
111907802995,111907802996,1,1051,1130,-10
111909065878,111909065881,3,1139,1133,-10
111910117509,111910117510,1,1669,2189,-10
111911533177,111911533179,2,1443,1349,-10
111914746289,111914746290,1,937,1431,-10
111916827014,111916827020,6,2368,1304,-10
111920348375,111920348375,0,1605,1510,-10
111921452638,111921452642,4,1289,1121,-10
111928362547,111928362546,-1,1269,2012,-10
111929127386,111929127387,1,1313,1413,-10
111929752404,111929752402,-2,1399,1872,-10
111932611706,111932611707,1,1546,1383,-10
111934046154,111934046158,4,1946,2081,-10
111934766703,111934766706,3,2151,1562,-10
111936048638,111936048639,1,1439,1779,-10
111937026175,111937026173,-2,1481,2186,-10
111938394926,111938394927,1,1052,1282,-10
111939894145,111939894144,-1,2065,1697,-10
111940729491,111940729490,-1,1873,1803,-10
111941206581,111941206582,1,1870,1164,-10
111943659431,111943659435,4,779,820,-10
111945384905,111945384908,3,1399,1357,-10
111945569534,111945569537,3,1338,1320,-10
111947349317,111947349339,22,1296,1500,-10
111950354462,111950354465,3,1908,2175,-10
111952222819,111952222821,2,1721,2490,-10
111952519493,111952519497,4,1606,1447,-10
111956039590,111956039591,1,1350,1203,-10
111957345281,111957345277,-4,1152,4243,-10
111959506717,111959506718,1,2061,1471,-10
111959977738,111959977741,3,1873,1740,-10
111961112929,111961112932,3,1514,1327,-10
111962717030,111962717034,4,1428,1429,-10
111963615905,111963615909,4,1588,1338,-10
111966784245,111966784247,2,1528,1431,-10
111969623321,111969623321,0,1575,1687,-10
111975234774,111975234776,2,1704,1568,-10
111976573278,111976573280,2,1224,1126,-10
111977918612,111977918614,2,961,1395,-10
111981911225,111981911227,2,1591,2044,-10
111986993222,111986993220,-2,1082,2354,-10
111990706073,111990706080,7,6665,1812,-10
111990925697,111990925697,0,1307,1170,-10
111998126619,111998126619,0,1595,2362,-10
112001526750,112001526753,3,1775,1844,-10
112004378083,112004378084,1,1285,1009,-10
112006059420,112006059422,2,1924,1925,-10
112007590408,112007590409,1,1469,1557,-10
112008220961,112008220962,1,1853,2278,-10
112014295297,112014295298,1,1534,1641,-10
112015140457,112015140458,1,1756,1354,-10
112015571799,112015571810,11,10191,39038,-10
112017751646,112017751657,11,11317,45395,-10
112021743017,112021743020,3,1427,2184,-10
112022299241,112022299242,1,1796,1607,-10
112023534181,112023534183,2,1845,1508,-10
112024391731,112024391733,2,1451,1926,-10
112024433993,112024433994,1,1998,2158,-10
112026279399,112026279401,2,1392,1828,-10
112029702257,112029702258,1,1656,1143,-10
112031015675,112031015677,2,1248,1439,-10
112031282111,112031282115,4,1153,1159,-10
112032900199,112032900183,-16,1003,1405,-10
112035320795,112035320797,2,1513,1013,-10
112035761318,112035761320,2,1582,1404,-10
112042445502,112042445497,-5,1806,5630,-10
112044553198,112044553197,-1,1800,1630,-10
112044939949,112044939949,0,1798,1549,-10
112046235411,112046235417,6,3049,1172,-10
112046729182,112046729182,0,1481,1716,-10
112047351084,112047351088,4,1279,1401,-10
112049531794,112049531797,3,1367,1009,-10
112051231762,112051231765,3,1759,1841,-10
112054356134,112054356136,2,1579,1610,-10
112054758158,112054758157,-1,1090,1141,-10
112055412743,112055412746,3,1321,1293,-10
112057653672,112057653675,3,1690,1741,-10
112065100090,112065100093,3,1888,1881,-10
112069888454,112069888457,3,1616,1809,-10
112074043014,112074043015,1,1411,2093,-10
112075053213,112075053214,1,1633,1625,-10
112082185295,112082185298,3,1949,1464,-10
112085247455,112085247457,2,1899,1852,-10
112088420846,112088420849,3,1787,1870,-10
112089389345,112089389346,1,1228,1601,-10
112091984838,112091984843,5,2635,876,-10
112092604530,112092604544,14,1769,1325,-10
112093984436,112093984435,-1,1479,1503,-10
112096579782,112096579786,4,1409,1370,-10
112096991921,112096991922,1,1773,1947,-10
112098924801,112098924803,2,1605,1011,-10
112100735845,112100735847,2,1228,1203,-10
112100982157,112100982157,0,1360,1713,-10
112105854163,112105854165,2,1390,2032,-10
112106035698,112106035692,-6,767,2841,-10
112106540205,112106540205,0,2082,1475,-10
112110123767,112110123769,2,1340,1436,-10
112114147596,112114147597,1,1946,2053,-10
112114905637,112114905639,2,1829,1410,-10
112116684045,112116684045,0,1830,2315,-10
112119718290,112119718271,-19,1873,1073,-10
112123271889,112123271893,4,1779,1410,-10
112124555545,112124555550,5,2051,1398,-10
112126447629,112126447629,0,1213,1712,-10
112130764068,112130764071,3,1030,947,-10
112134114400,112134114403,3,1722,1483,-10
112135707278,112135707282,4,1292,1377,-10
112140291425,112140291426,1,2033,1486,-10
112141641797,112141641797,0,1453,1490,-10
112142007158,112142007154,-4,1414,7417,-10
112143512936,112143512938,2,1147,1434,-10
112143796278,112143796281,3,1218,947,-10
112144344102,112144344082,-20,2260,866,-10
112149919338,112149919332,-6,1172,3958,-10
112155558524,112155558523,-1,1314,1781,-10
112155768066,112155768053,-13,1056,1011,-10
112158664738,112158664742,4,1353,1656,-10
112159148718,112159148718,0,1481,1268,-10
112160386269,112160386270,1,1329,1313,-10
112161690637,112161690639,2,1257,1563,-10
112163256967,112163256970,3,1453,1545,-10
112164178963,112164178965,2,1887,1795,-10
112164746334,112164746336,2,2018,1828,-10
112169034319,112169034319,0,1446,1176,-10
112184859876,112184859870,-6,1704,4162,-10
112190781823,112190781826,3,1592,1250,-10
112192450394,112192450397,3,976,1541,-10
112196039229,112196039231,2,2015,1696,-10
112199196961,112199196962,1,1269,1174,-10
112203063786,112203063789,3,1232,1698,-10
112207117265,112207117268,3,1485,1348,-10
112207457612,112207457612,0,1152,1085,-10
112209348889,112209348873,-16,646,1398,-10
112209782938,112209782938,0,1325,1022,-10
112210504725,112210504734,9,8831,25889,-10
112211023166,112211023166,0,1334,2590,-10
112213497345,112213497346,1,1787,1315,-10
112215868941,112215868942,1,1629,2069,-10
112217693896,112217693903,7,3722,1058,-10
112217792981,112217792993,12,1005,1092,-10
112221363866,112221363868,2,1619,1273,-10
112225463811,112225463810,-1,2270,2180,-10
112225764898,112225764900,2,1314,1719,-10
112226324610,112226324611,1,2116,1627,-10
112227915602,112227915605,3,1474,1631,-10
112229993989,112229993995,6,2411,875,-10
112231328671,112231328672,1,1721,1448,-10
112231858415,112231858418,3,1088,1319,-10
112232770491,112232770493,2,1888,1886,-10
112233556197,112233556199,2,1340,1380,-10
112233771721,112233771724,3,1485,1428,-10
112234455147,112234455150,3,1745,1336,-10
112236651966,112236651971,5,1314,1155,-10
112238095930,112238095931,1,2114,1319,-10
112242676935,112242676930,-5,1065,4769,-10
112248735400,112248735401,1,1118,1494,-10
112250051667,112250051667,0,1322,1878,-10
112252224833,112252224834,1,1673,1399,-10
112252333846,112252333846,0,1069,1247,-10
112253097983,112253097983,0,1881,1812,-10
112256986612,112256986614,2,1759,1430,-10
112257128937,112257128939,2,1349,1595,-10
112261333422,112261333419,-3,1040,833,-10
112261388651,112261388650,-1,638,1254,-10
112262362630,112262362642,12,13762,4067,-10
112272996079,112272996081,2,1417,1350,-10
112273181279,112273181283,4,1096,677,-10
112283309295,112283309297,2,1455,1722,-10
112287347720,112287347722,2,1393,1286,-10
112288262185,112288262186,1,1439,1563,-10
112292326715,112292326717,2,1979,1818,-10
112294128145,112294128147,2,1768,1470,-10
112297241718,112297241718,0,1720,1508,-10
112297618498,112297618498,0,994,1188,-10
112299288945,112299288946,1,1118,1070,-10
112299979303,112299979283,-20,1096,1424,-10
112302836857,112302836869,12,1493,1485,-10
112304950470,112304950463,-7,1175,2884,-10
112305469515,112305469516,1,1700,2494,-10
112306751990,112306751994,4,1479,1285,-10
112311379077,112311379078,1,1925,1735,-10
112314072707,112314072710,3,1276,1344,-10
112318606958,112318606963,5,1459,1430,-10
112322513877,112322513877,0,2429,1370,-10
112330057762,112330057774,12,332,1920,-10
112330831165,112330831167,2,1721,1532,-10
112332009946,112332009947,1,1146,2039,-10
112335547139,112335547141,2,1509,1427,-10
112336745681,112336745682,1,1683,1212,-10
112341118801,112341118803,2,1421,1577,-10
112343659523,112343659522,-1,1252,1911,-10
112349693598,112349693601,3,1515,1896,-10
112354330418,112354330418,0,1450,1575,-10
112355266762,112355266762,0,1722,2114,-10
112355989248,112355989250,2,1045,989,-10
112357172703,112357172723,20,1240,1640,-10
112358860982,112358860986,4,1338,1300,-10
112359142491,112359142494,3,1793,1555,-10
112362751047,112362751049,2,1816,1729,-10
112364738115,112364738117,2,1333,1429,-10
112370370102,112370370102,0,1677,1745,-10
112373530304,112373530307,3,2303,1434,-10
112374308515,112374308521,6,5628,1857,-10
112374440440,112374440450,10,1512,1204,-10
112375728961,112375728963,2,1702,1376,-10
112376196646,112376196641,-5,928,2335,-10
112376898390,112376898393,3,1996,1522,-10
112377063506,112377063489,-17,1055,991,-10
112380080625,112380080627,2,1414,1663,-10
112381578676,112381578678,2,1447,1476,-10
112383039791,112383039791,0,1160,1911,-10
112383506748,112383506750,2,1930,1351,-10
112384875479,112384875482,3,1163,1483,-10
112388226040,112388226042,2,1677,1960,-10
112390161934,112390161934,0,1449,1294,-10
112393950035,112393950037,2,1045,1306,-10
112394082692,112394082704,12,9813,52198,-10
112394295629,112394295632,3,1693,1430,-10
112398141399,112398141400,1,1319,1739,-10
112401808685,112401808688,3,1856,1204,-10
112404708769,112404708772,3,1528,1492,-10
112405348141,112405348141,0,1661,1793,-10
112405733992,112405733993,1,1123,1181,-10
112406514290,112406514293,3,1257,1292,-10
112407013667,112407013668,1,2060,1553,-10
112407481978,112407481979,1,1602,2331,-10
112409283417,112409283437,20,1450,1950,-10
112412261706,112412261701,-5,2418,9243,-10
112413804942,112413804943,1,1339,1265,-10
112416081715,112416081720,5,928,748,-10
112416126246,112416126246,0,1444,1587,-10
112418995593,112418995597,4,1042,1382,-10
112419077866,112419077868,2,1206,1179,-10
112419769311,112419769313,2,1028,1032,-10
112421769754,112421769756,2,1024,1162,-10
112422181820,112422181818,-2,1302,1423,-10
112423260678,112423260684,6,3476,1638,-10
112425012554,112425012557,3,1850,911,-10
112431837602,112431837605,3,1018,1477,-10
112431875966,112431875977,11,1210,1288,-10
112432836746,112432836749,3,1667,1618,-10
112433411577,112433411578,1,1783,1890,-10
112433894946,112433894950,4,1769,1625,-10
112434083917,112434083918,1,983,1085,-10
112434644100,112434644096,-4,267,10664,-10
112435657062,112435657066,4,1194,915,-10
112441236962,112441236966,4,1869,1846,-10
112443314137,112443314126,-11,1377,1203,-10
112446601707,112446601713,6,2530,1150,-10
112452621634,112452621636,2,2883,3330,-10
112453204210,112453204213,3,957,1354,-10
112454277058,112454277059,1,1991,1227,-10
112457795575,112457795575,0,1354,1263,-10
112459185763,112459185766,3,1469,1771,-10
112459460166,112459460171,5,1632,1530,-10
112459594216,112459594219,3,2317,1348,-10
112460045417,112460045421,4,1330,1105,-10
112460824878,112460824879,1,1152,1353,-10
112467128238,112467128219,-19,1500,1115,-10
112468114114,112468114115,1,1325,1144,-10
112470036594,112470036588,-6,1443,5175,-10
112470200495,112470200496,1,968,1047,-10
112473031804,112473031807,3,1362,1712,-10
112486883477,112486883475,-2,2004,3083,-10
112491208194,112491208199,5,2998,1177,-10
112493631768,112493631772,4,1733,1443,-10
112496381370,112496381370,0,2099,1548,-10
112498124222,112498124215,-7,1624,6648,-10
112506104533,112506104534,1,760,884,-10
112506693240,112506693222,-18,1690,1554,-10
112510460875,112510460871,-4,873,1443,-10
112515475671,112515475673,2,1336,2156,-10
112519919506,112519919509,3,971,1279,-10
112523824822,112523824820,-2,972,2151,-10
112524433912,112524433914,2,1579,1258,-10
112525578891,112525578894,3,1903,2232,-10
112530040032,112530040035,3,1714,1319,-10
112531116189,112531116191,2,1823,1199,-10
112531746494,112531746495,1,1784,1914,-10
112533230721,112533230721,0,1105,1265,-10
112535871342,112535871346,4,1469,1510,-10
112536165578,112536165582,4,1904,1208,-10
112538541753,112538541754,1,1064,1069,-10
112540405229,112540405231,2,2236,1618,-10
112541173663,112541173665,2,983,959,-10
112544307422,112544307426,4,2461,1880,-10
112550520481,112550520483,2,1159,1640,-10
112553075895,112553075899,4,2400,1770,-10
112555412710,112555412713,3,2340,1495,-10
112558436420,112558436422,2,1361,1333,-10
112559024426,112559024429,3,2684,1686,-10
112561852696,112561852699,3,1401,1316,-10
112564428995,112564428997,2,1474,1621,-10
112566478058,112566478061,3,1451,1328,-10
112567003845,112567003846,1,1702,1164,-10
112567137355,112567137357,2,1292,1224,-10
112569977175,112569977177,2,1803,1879,-10
112576363581,112576363581,0,1498,1746,-10
112576874607,112576874608,1,850,1597,-10
112578658913,112578658916,3,1723,1451,-10
112578772199,112578772202,3,1496,1474,-10
112582221409,112582221414,5,1687,1328,-10
112582460184,112582460189,5,1965,1063,-10
112582685971,112582685968,-3,723,2873,-10
112583045006,112583045004,-2,1004,2331,-10
112585641695,112585641699,4,1633,976,-10
112588962089,112588962096,7,6441,3060,-10
112593044093,112593044072,-21,1780,872,-10
112596320218,112596320223,5,4245,2337,-10
112599137961,112599137962,1,1803,1662,-10
112600134157,112600134164,7,2414,1014,-10
112603884450,112603884452,2,1642,2016,-10
112606049849,112606049851,2,1846,1390,-10
112607637496,112607637499,3,1404,1336,-10
112608051051,112608051053,2,2019,2064,-10
112608268463,112608268464,1,1656,1345,-10
112610308300,112610308299,-1,780,1789,-10
112611119713,112611119713,0,1732,1487,-10
112614010553,112614010555,2,1105,887,-10
112617216271,112617216273,2,1443,1512,-10
112617566981,112617566983,2,1825,1767,-10
112624912742,112624912744,2,1785,1706,-10
112631285837,112631285839,2,1398,1096,-10
112631977778,112631977779,1,1526,1302,-10
112632521369,112632521370,1,1432,1318,-10
112634312934,112634312937,3,1854,1609,-10
112639778220,112639778223,3,1420,1519,-10
112640700470,112640700466,-4,1263,3037,-10
112645863069,112645863069,0,1077,2410,-10
112648746505,112648746506,1,2061,1972,-10
112651722998,112651722999,1,2970,2007,-10
112657432607,112657432611,4,1303,638,-10
112658898802,112658898803,1,1240,1511,-10
112659052670,112659052672,2,2088,1639,-10
112659500989,112659500989,0,1118,1883,-10
112660796427,112660796428,1,1835,1778,-10
112665244446,112665244450,4,1994,1208,-10
112665414694,112665414694,0,822,765,-10
112666067056,112666067058,2,1815,2007,-10
112666808366,112666808368,2,977,1298,-10
112668497529,112668497524,-5,1418,1371,-10
112669532855,112669532857,2,1491,1313,-10
112671816767,112671816769,2,1411,1641,-10
112673466189,112673466191,2,1869,1599,-10
112677890077,112677890079,2,1487,1268,-10
112677994787,112677994786,-1,917,1255,-10
112678734986,112678734986,0,1338,1820,-10
112685182509,112685182510,1,1566,1544,-10
112685796272,112685796273,1,1767,1849,-10
112686169327,112686169331,4,1644,1450,-10
112686727251,112686727253,2,1219,1614,-10
112687707998,112687708001,3,2586,1946,-10
112688030309,112688030309,0,1862,1527,-10
112688971129,112688971133,4,10832,5781,-10
112691239646,112691239648,2,1418,1422,-10
112692059162,112692059165,3,1658,1456,-10
112692244838,112692244849,11,1118,889,-10
112694503437,112694503437,0,2146,2091,-10
112694727118,112694727119,1,1223,1726,-10
112695655153,112695655154,1,2032,1876,-10
112695759569,112695759569,0,1837,1632,-10
112696253714,112696253714,0,1677,1933,-10
112705113349,112705113349,0,1565,2203,-10
112706462549,112706462551,2,1453,1471,-10
112708807247,112708807248,1,1448,1828,-10
112709357946,112709357931,-15,2121,1560,-10
112709619697,112709619698,1,1764,1729,-10
112714105257,112714105259,2,1328,1094,-10
112715223143,112715223145,2,1845,1234,-10
112717797442,112717797449,7,1800,1545,-10
112718166602,112718166603,1,2472,1801,-10
112719721555,112719721555,0,2044,2474,-10
112724438739,112724438742,3,1445,1315,-10
112728385616,112728385617,1,1944,1513,-10
112729290402,112729290402,0,2120,2375,-10
112730624225,112730624227,2,1809,2333,-10
112732416879,112732416874,-5,909,4098,-10
112733627834,112733627835,1,1634,1613,-10
112733844329,112733844330,1,1424,1338,-10
112734936267,112734936269,2,1627,1708,-10
112735459794,112735459795,1,1479,1599,-10
112736757725,112736757727,2,1041,1405,-10
112739019871,112739019873,2,2239,1870,-10
112739962217,112739962222,5,1879,1518,-10
112741733924,112741733928,4,1260,1239,-10
112742047611,112742047613,2,1266,1942,-10
112745518718,112745518723,5,1939,1950,-10
112748044514,112748044515,1,1087,1194,-10
112748282779,112748282784,5,2765,1778,-10
112748564730,112748564730,0,1813,1443,-10
112751434786,112751434789,3,1607,1244,-10
112753211226,112753211230,4,1734,1725,-10
112755031243,112755031248,5,1348,1604,-10
112757060964,112757060966,2,1639,1372,-10
112758399971,112758399973,2,1489,1902,-10
112759266157,112759266159,2,1554,1596,-10
112761047674,112761047674,0,946,1713,-10
112761413227,112761413227,0,1275,1330,-10
112762054042,112762054045,3,1183,1314,-10
112763324119,112763324122,3,1605,1847,-10
112763566753,112763566758,5,4680,2390,-10
112765768981,112765768983,2,1223,1209,-10
112766180275,112766180278,3,1603,1366,-10
112767122829,112767122828,-1,715,1958,-10
112767732823,112767732822,-1,1398,1231,-10
112769762547,112769762547,0,1603,1718,-10
112773215819,112773215824,5,1105,914,-10
112774671233,112774671231,-2,2122,1997,-10
112776513819,112776513818,-1,1072,2155,-10
112776664029,112776664031,2,1345,1630,-10
112777700322,112777700323,1,861,1289,-10
112781383849,112781383850,1,1684,1864,-10
112783906973,112783906976,3,1615,1386,-10
112787145514,112787145514,0,1711,1605,-10
112790773278,112790773278,0,1597,1651,-10
112794592720,112794592723,3,16557,12649,-10
112796594774,112796594777,3,1234,1127,-10
112797841184,112797841186,2,1369,1218,-10
112799134186,112799134183,-3,1435,2877,-10
112800406977,112800406980,3,1971,1972,-10
112802324253,112802324254,1,1137,1057,-10
112804127889,112804127890,1,1613,1557,-10
112804760339,112804760341,2,1249,1295,-10
112810688693,112810688694,1,1335,1534,-10
112811799974,112811799974,0,1384,1446,-10
112812723788,112812723788,0,806,1193,-10
112814552786,112814552787,1,1108,1492,-10
112820117422,112820117415,-7,2377,6820,-10
112826306709,112826306713,4,15120,10562,-10
112826616987,112826616988,1,1204,2298,-10
112830218435,112830218433,-2,1293,3269,-10
112830647539,112830647541,2,1305,1739,-10
112834682319,112834682325,6,1291,1553,-10
112835317659,112835317661,2,1731,1782,-10
112836930297,112836930298,1,1298,1471,-10
112838229076,112838229078,2,2086,1848,-10
112838455438,112838455443,5,4657,3357,-10
112842254194,112842254195,1,1535,1595,-10
112842989546,112842989548,2,1487,1012,-10
112845531656,112845531658,2,1920,1894,-10
112845764277,112845764277,0,1483,1392,-10
112848246606,112848246608,2,1203,1365,-10
112855761066,112855761068,2,1397,1222,-10
112856464742,112856464742,0,804,1200,-10
112859221759,112859221756,-3,1553,3236,-10
112860061488,112860061486,-2,1147,1385,-10
112865697967,112865697967,0,1568,1547,-10
112867479410,112867479411,1,1043,1185,-10
112868294575,112868294574,-1,1293,1435,-10
112868687481,112868687485,4,1253,857,-10
112871908278,112871908280,2,1562,1907,-10
112876536212,112876536206,-6,1639,1763,-10
112882208113,112882208117,4,1157,1198,-10
112885283589,112885283591,2,1324,1154,-10
112887094830,112887094833,3,930,834,-10
112887921857,112887921858,1,2746,1998,-10
112888593046,112888593048,2,1441,1480,-10
112889789602,112889789607,5,1087,928,-10
112889911635,112889911643,8,1517,1653,-10
112891456287,112891456289,2,1610,1838,-10
112891888034,112891888038,4,1954,1446,-10
112892761925,112892761925,0,1596,2044,-10
112893654962,112893654964,2,1133,1166,-10
112896728521,112896728523,2,1510,1346,-10
112899971751,112899971754,3,1448,750,-10
112900324069,112900324050,-19,1323,1136,-10
112900536490,112900536486,-4,1612,1188,-10
112902454922,112902454925,3,1776,1719,-10
112903569405,112903569407,2,1516,1455,-10
112906349761,112906349765,4,1485,1713,-10
112906954893,112906954876,-17,1400,1549,-10
112909352676,112909352677,1,1673,1763,-10
112909707721,112909707723,2,1064,1276,-10
112910437153,112910437154,1,1528,2373,-10
112910935659,112910935659,0,50,957,-10
112911502309,112911502309,0,2462,2807,-10
112912163247,112912163246,-1,1637,1246,-10
112914329397,112914329398,1,1607,1355,-10
112916902959,112916902962,3,1577,1209,-10
112920219375,112920219376,1,1373,1560,-10
112921153418,112921153416,-2,1459,1869,-10
112922528399,112922528399,0,1184,1884,-10
112923028483,112923028482,-1,957,1710,-10
112923405638,112923405641,3,1505,1504,-10
112930479160,112930479164,4,1598,1417,-10
112931452687,112931452689,2,977,1237,-10
112935630083,112935630086,3,1954,1565,-10
112940879601,112940879605,4,1486,1368,-10
112944450055,112944450057,2,1091,1273,-10
112947266258,112947266259,1,1259,1506,-10
112956959398,112956959400,2,1407,1558,-10
112966453365,112966453366,1,2220,1930,-10
112967007522,112967007523,1,1358,1312,-10
112967973890,112967973892,2,1492,2221,-10
112968554113,112968554116,3,1094,1293,-10
112968873713,112968873723,10,1204,1198,-10
112970067050,112970067050,0,1351,1884,-10
112971139838,112971139839,1,1304,1589,-10
112974234658,112974234659,1,1552,1875,-10
112974293573,112974293575,2,1228,1510,-10
112982429646,112982429650,4,1168,1076,-10
112982750966,112982750966,0,1410,1449,-10
112987417373,112987417374,1,1754,1644,-10
112989539362,112989539365,3,1592,1672,-10
112990260099,112990260098,-1,100651,46826,-10
112992462842,112992462863,21,1274,1579,-10
112994989493,112994989497,4,942,1523,-10
112996104283,112996104284,1,1326,1832,-10
112996424274,112996424294,20,403,597,-10
112997977286,112997977287,1,948,1125,-10
113000526832,113000526833,1,1179,1597,-10
113001758082,113001758083,1,1298,1697,-10
113003950585,113003950587,2,1438,1170,-10
113004216916,113004216934,18,600,835,-10
113009643134,113009643137,3,1289,1302,-10
113010878406,113010878406,0,1662,2001,-10
113012094366,113012094367,1,1679,1502,-10
113012660656,113012660658,2,1803,1101,-10
113013882056,113013882056,0,1806,1483,-10
113014848622,113014848624,2,1671,1835,-10
113015938986,113015938986,0,1324,1740,-10
113016558640,113016558639,-1,1496,1882,-10
113021592264,113021592266,2,1914,1969,-10
113022504190,113022504190,0,876,1115,-10
113022917895,113022917897,2,2179,1553,-10
113026081312,113026081315,3,1676,1204,-10
113026975099,113026975101,2,1872,1952,-10
113027616438,113027616445,7,4308,1064,-10
113030431399,113030431402,3,1383,1226,-10
113033728791,113033728791,0,941,1113,-10
113033764041,113033764063,22,450,1939,-10
113034465864,113034465863,-1,1112,1186,-10
113035102417,113035102423,6,2156,1467,-10
113035756999,113035757018,19,1576,1358,-10
113042019488,113042019490,2,2023,1998,-10
113044904453,113044904455,2,2575,3912,-10
113045536217,113045536219,2,1636,1523,-10
113050605751,113050605753,2,1722,1555,-10
113051000956,113051000957,1,1270,1661,-10
113053122576,113053122578,2,1384,923,-10
113055121153,113055121155,2,1796,1028,-10
113056655932,113056655936,4,2126,2032,-10
113057883733,113057883733,0,1613,1288,-10
113058048740,113058048739,-1,1769,2588,-10
113062236393,113062236392,-1,1135,1261,-10
113063891509,113063891512,3,1541,1223,-10
113064368061,113064368062,1,1125,1160,-10
113065842072,113065842070,-2,1851,2752,-10
113070419697,113070419698,1,1887,1895,-10
113070466082,113070466082,0,1653,1405,-10
113071192274,113071192274,0,1310,1130,-10
113076471183,113076471186,3,1089,1368,-10
113077318157,113077318158,1,1321,1754,-10
113079869691,113079869690,-1,923,1990,-10
113080739044,113080739046,2,1653,1315,-10
113080798489,113080798489,0,816,770,-10
113081514061,113081514057,-4,1295,2683,-10
113082428049,113082428046,-3,1850,1749,-10
113082986450,113082986450,0,1025,1257,-10
113086251188,113086251189,1,1520,1570,-10
113087102613,113087102613,0,1782,1355,-10
113089371089,113089371092,3,1367,1539,-10
113090257786,113090257789,3,2124,2518,-10
113097395304,113097395306,2,1321,1382,-10
113097595663,113097595664,1,1532,1477,-10
113103626884,113103626885,1,2320,1848,-10
113104991471,113104991475,4,968,778,-10
113107218334,113107218335,1,1763,1587,-10
113107750847,113107750850,3,1647,1649,-10
113108212234,113108212238,4,1134,1353,-10
113110505035,113110505030,-5,1274,1643,-10
113115291576,113115291578,2,1363,1515,-10
113115366074,113115366076,2,1934,1557,-10
113115750451,113115750454,3,1553,1883,-10
113120987172,113120987173,1,2257,2025,-10
113122281762,113122281762,0,2087,1440,-10
113123249225,113123249221,-4,1819,5749,-10
113129748383,113129748385,2,981,801,-10
113134093822,113134093824,2,1036,1076,-10
113134252204,113134252208,4,1038,1371,-10
113136853997,113136853999,2,1785,1749,-10
113137690335,113137690335,0,1385,1344,-10
113137814020,113137814021,1,1306,1216,-10
113138267064,113138267065,1,2573,1940,-10
113139145950,113139145953,3,1917,1350,-10
113139443846,113139443846,0,1654,1537,-10
113140195418,113140195417,-1,1064,947,-10
113140447073,113140447072,-1,1876,2172,-10
113150759134,113150759141,7,2508,698,-10
113154329971,113154329974,3,1260,1450,-10
113155593157,113155593159,2,3412,3101,-10
113156061657,113156061659,2,1723,1541,-10
113156095329,113156095330,1,1865,1679,-10
113158175026,113158175026,0,1079,1617,-10
113158774283,113158774275,-8,994,1397,-10
113159309213,113159309215,2,1187,1416,-10
113161471238,113161471239,1,1175,1756,-10
113162203349,113162203350,1,2119,1744,-10
113162323419,113162323419,0,1473,1478,-10
113163127149,113163127150,1,1333,1593,-10
113163804416,113163804410,-6,1362,7379,-10
113165299326,113165299328,2,810,1130,-10
113167918526,113167918528,2,1226,1336,-10
113170476399,113170476401,2,1679,2018,-10
113170633904,113170633908,4,1700,1620,-10
113171024502,113171024502,0,1140,1370,-10
113176004907,113176004906,-1,1398,1260,-10
113176780246,113176780246,0,1827,1799,-10
113176911742,113176911744,2,1493,1199,-10
113177325197,113177325198,1,1940,1929,-10
113177729413,113177729414,1,1411,1177,-10
113178296831,113178296833,2,1731,2199,-10
113180327015,113180327017,2,1021,1179,-10
113180728814,113180728815,1,1803,1520,-10
113183107080,113183107082,2,1656,1803,-10
113184611534,113184611537,3,1389,1760,-10
113186166200,113186166202,2,754,1533,-10
113188665190,113188665191,1,629,853,-10
113188878930,113188878922,-8,892,2744,-10
113190646219,113190646214,-5,1074,1809,-10
113195508014,113195508017,3,2111,1226,-10
113197522469,113197522471,2,1362,1621,-10
113197571055,113197571057,2,2200,1959,-10
113199536750,113199536751,1,1469,1541,-10
113200312499,113200312504,5,1963,1352,-10
113202038417,113202038418,1,1151,1544,-10
113202318619,113202318605,-14,1283,1668,-10
113202901632,113202901636,4,1847,1359,-10
113206818922,113206818927,5,2318,1109,-10
113208840122,113208840124,2,2090,1632,-10
113209152028,113209152049,21,1863,1638,-10
113211158254,113211158252,-2,1772,2531,-10
113212833238,113212833239,1,1042,1422,-10
113215804517,113215804519,2,1063,1134,-10
113217153273,113217153274,1,1594,1582,-10
113218590646,113218590646,0,2108,2173,-10
113218949111,113218949113,2,1511,903,-10
113221217473,113221217475,2,2107,1116,-10
113221533089,113221533090,1,2075,2111,-10
113222093084,113222093094,10,151,267,-10
113223438538,113223438540,2,2043,2040,-10
113227701512,113227701513,1,1190,804,-10
113231841738,113231841740,2,1227,905,-10
113232357733,113232357735,2,1483,1175,-10
113234504670,113234504671,1,1606,1102,-10
113235545591,113235545593,2,1361,1796,-10
113239171351,113239171354,3,2279,1660,-10
113240745001,113240745002,1,1334,1467,-10
113241725152,113241725175,23,1090,1720,-10
113242505592,113242505592,0,1880,1482,-10
113245635158,113245635162,4,1804,2056,-10
113252694079,113252694077,-2,1291,1469,-10
113255456894,113255456895,1,1662,1860,-10
113257765910,113257765913,3,1337,1316,-10
113261678289,113261678292,3,1422,1553,-10
113262815546,113262815549,3,1831,1782,-10
113264240517,113264240518,1,770,988,-10
113265876522,113265876526,4,1184,1031,-10
113268836114,113268836115,1,1547,1201,-10
113272198071,113272198073,2,1301,1959,-10
113274842350,113274842351,1,1206,1415,-10
113277176830,113277176831,1,3402,2943,-10
113277615630,113277615632,2,1445,1490,-10
113278397445,113278397451,6,1580,1097,-10
113280057475,113280057477,2,1118,1284,-10
113286032482,113286032485,3,958,1178,-10
113290158709,113290158712,3,1368,1895,-10
113290707370,113290707370,0,1777,2172,-10
113293720737,113293720738,1,1268,820,-10
113295325125,113295325127,2,2025,1286,-10
113299947111,113299947110,-1,1905,1660,-10
113300474719,113300474719,0,922,1006,-10
113303099561,113303099554,-7,1722,5486,-10
113303367125,113303367129,4,1721,1240,-10
113303528837,113303528838,1,1976,1842,-10
113305008536,113305008538,2,2192,1701,-10
113307286394,113307286395,1,1384,1758,-10
113309886783,113309886783,0,1399,1233,-10
113312547842,113312547843,1,1329,1930,-10
113313997123,113313997125,2,1981,1903,-10
113314598650,113314598653,3,1964,1638,-10
113318046793,113318046795,2,1272,1764,-10
113318724784,113318724785,1,1571,1869,-10
113321191950,113321191951,1,1295,1406,-10
113323523499,113323523499,0,1116,1644,-10
113323898097,113323898098,1,1249,1698,-10
113325601810,113325601811,1,1091,1215,-10
113325642343,113325642345,2,1055,1097,-10
113327126343,113327126346,3,1079,1257,-10
113331000945,113331000946,1,1276,1295,-10
113331856630,113331856631,1,1720,1990,-10
113332028241,113332028243,2,1712,1144,-10
113332635604,113332635607,3,1624,1139,-10
113332919355,113332919358,3,1782,1592,-10
113335309580,113335309580,0,1308,1761,-10
113346444898,113346444902,4,1592,1138,-10
113350482639,113350482641,2,1627,2136,-10
113353283061,113353283063,2,1480,1594,-10
113353556390,113353556395,5,2676,1274,-10
113354144850,113354144851,1,1183,1155,-10
113354315553,113354315553,0,1083,1131,-10
113356307191,113356307191,0,1639,1472,-10
113356522697,113356522698,1,1241,839,-10
113358992440,113358992443,3,2085,1211,-10
113361984622,113361984627,5,1800,1172,-10
113363925916,113363925915,-1,1403,1232,-10
113365365656,113365365657,1,427,36,-10
113366255644,113366255645,1,1796,2088,-10
113366342403,113366342402,-1,1041,1937,-10
113366545215,113366545218,3,1264,1605,-10
113368882993,113368882994,1,1649,862,-10
113370739405,113370739407,2,1608,1502,-10
113371145508,113371145505,-3,169,900,-10
113373476369,113373476370,1,933,1654,-10
113375405200,113375405202,2,2107,2027,-10
113375598411,113375598413,2,1434,1228,-10
113375643558,113375643563,5,1677,1427,-10
113378045975,113378045974,-1,1495,1230,-10
113379225749,113379225740,-9,1649,400,-10
113381592777,113381592779,2,1847,1774,-10
113382293537,113382293540,3,1795,1750,-10
113384012263,113384012266,3,1338,1430,-10
113386747139,113386747142,3,2047,1481,-10
113387733883,113387733885,2,1190,1730,-10
113390348199,113390348201,2,1418,1338,-10
113396170571,113396170576,5,2259,1671,-10
113397408336,113397408337,1,681,1264,-10
113397704781,113397704784,3,1727,1664,-10
113398917561,113398917566,5,612,975,-10
113399437847,113399437846,-1,995,1625,-10
113401218961,113401218966,5,1853,1314,-10
113405795755,113405795761,6,1449,1420,-10
113407331467,113407331470,3,1293,1607,-10
113409214547,113409214550,3,1142,1604,-10
113410065823,113410065823,0,1864,1218,-10
113411530340,113411530342,2,1708,1757,-10
113412640841,113412640842,1,1437,1884,-10
113413224767,113413224769,2,1339,1508,-10
113414915022,113414915026,4,1676,1699,-10
113418495766,113418495766,0,1577,1516,-10
113421058133,113421058131,-2,1570,2081,-10
113422544213,113422544215,2,1468,1969,-10
113422675451,113422675453,2,1181,1325,-10
113423153950,113423153952,2,1409,1212,-10
113423233526,113423233527,1,1625,1988,-10
113424665886,113424665887,1,1681,1563,-10
113426024772,113426024771,-1,1746,1795,-10
113427580343,113427580346,3,1897,1274,-10
113428097055,113428097057,2,1929,1099,-10
113431917506,113431917507,1,1383,1392,-10
113432986978,113432986980,2,1591,1668,-10
113435068147,113435068150,3,1467,1548,-10
113435222781,113435222783,2,1699,1275,-10
113436103310,113436103312,2,1541,1403,-10
113436238883,113436238878,-5,24451,13605,-10
113439316880,113439316881,1,1898,1540,-10
113439387776,113439387778,2,2092,1255,-10
113439563483,113439563486,3,1540,1206,-10
113443706358,113443706358,0,1786,1568,-10
113444430575,113444430573,-2,1305,1455,-10
113445780601,113445780602,1,1260,1182,-10
113446507454,113446507458,4,1386,1176,-10
113452960942,113452960944,2,1288,1331,-10
113453624239,113453624242,3,1903,1102,-10
113458687826,113458687828,2,1937,1625,-10
113460077590,113460077591,1,1720,2184,-10
113461027791,113461027794,3,1060,1377,-10
113465517196,113465517198,2,1391,1427,-10
113467067176,113467067175,-1,1248,1285,-10
113470606974,113470606979,5,1510,1056,-10
113471359465,113471359467,2,1951,1644,-10
113471768956,113471768958,2,1574,1888,-10
113471985566,113471985570,4,2525,1424,-10
113472167365,113472167367,2,1506,1240,-10
113472435686,113472435686,0,1228,1904,-10
113473348814,113473348816,2,1556,1650,-10
113473638592,113473638594,2,1905,1990,-10
113474063272,113474063275,3,951,1295,-10
113480292294,113480292294,0,1858,1346,-10
113482193132,113482193135,3,1743,1835,-10
113484745731,113484745734,3,1908,2484,-10
113486629474,113486629475,1,695,990,-10
113487592702,113487592705,3,1503,1409,-10
113490356933,113490356933,0,1215,2100,-10
113491043646,113491043646,0,1591,1592,-10
113493390898,113493390900,2,1989,1659,-10
113494738763,113494738764,1,1600,1686,-10
113498279953,113498279955,2,1515,1399,-10
113498476066,113498476067,1,1219,1410,-10
113498530778,113498530783,5,1653,1492,-10
113500865693,113500865697,4,1473,1299,-10
113501269492,113501269499,7,1182,949,-10
113507068681,113507068683,2,1396,1538,-10
113509001334,113509001337,3,1913,1413,-10
113513850279,113513850278,-1,1415,1173,-10
113514773752,113514773751,-1,1657,2003,-10
113519140299,113519140299,0,986,1541,-10
113523138787,113523138790,3,1594,1610,-10
113523887745,113523887748,3,1585,792,-10
113524884198,113524884199,1,1677,1577,-10
113525054218,113525054234,16,2735,1692,-10
113530063608,113530063613,5,1638,1224,-10
113533535386,113533535390,4,1063,1466,-10
113536433381,113536433386,5,993,1650,-10
113537500354,113537500355,1,1692,1096,-10
113544470966,113544470969,3,1177,1873,-10
113546035963,113546035966,3,1613,1704,-10
113547132603,113547132603,0,1113,1288,-10
113548135679,113548135681,2,17586,35789,-10
113548758012,113548758016,4,2184,2062,-10
113550459542,113550459544,2,939,907,-10
113551224139,113551224140,1,1019,1481,-10
113553060813,113553060809,-4,2368,4577,-10
113555795354,113555795356,2,1568,1712,-10
113556073904,113556073906,2,1555,873,-10
113558688405,113558688405,0,1460,1973,-10
113561083928,113561083931,3,1548,1514,-10
113563903267,113563903274,7,10199,2755,-10
113564602754,113564602756,2,1379,1322,-10
113566352263,113566352266,3,1581,1366,-10
113566378782,113566378784,2,2205,1434,-10
113566788002,113566788004,2,2027,1397,-10
113568813768,113568813769,1,1377,1358,-10
113569336922,113569336924,2,1715,1395,-10
113570717178,113570717179,1,1213,1189,-10
113576816846,113576816850,4,1163,1416,-10
113577380234,113577380236,2,1612,1415,-10
113579834434,113579834440,6,1613,956,-10
113579907863,113579907865,2,1996,1721,-10
113583549251,113583549246,-5,1078,3440,-10
113586666394,113586666394,0,1798,1489,-10
113587577155,113587577159,4,1640,1777,-10
113590504610,113590504606,-4,668,1764,-10
113591987229,113591987231,2,1688,1606,-10
113593998291,113593998291,0,1036,1581,-10
113594176442,113594176431,-11,1122,1229,-10
113594858352,113594858371,19,837,3603,-10
113598294435,113598294437,2,1747,1674,-10
113598958592,113598958594,2,1626,1213,-10
113600958056,113600958059,3,1306,1230,-10
113602831502,113602831504,2,1563,1736,-10
113603264699,113603264704,5,2218,1519,-10
113615922408,113615922411,3,1973,1291,-10
113616655060,113616655062,2,2295,1782,-10
113617664291,113617664295,4,1517,956,-10
113617822450,113617822449,-1,1563,2374,-10
113622624111,113622624110,-1,1669,1731,-10
113622958654,113622958657,3,1287,1875,-10
113626959046,113626959047,1,1300,1362,-10
113630840579,113630840582,3,1470,1436,-10
113631906459,113631906462,3,939,1193,-10
113632463675,113632463678,3,1369,1031,-10
113634616800,113634616803,3,1004,1259,-10
113637403635,113637403642,7,1673,1509,-10
113638549547,113638549549,2,2013,1856,-10
113642516855,113642516857,2,1688,1266,-10
113642898222,113642898223,1,1446,1510,-10
113645219765,113645219766,1,1765,1314,-10
113645396442,113645396437,-5,892,2936,-10
113645809529,113645809532,3,1664,1724,-10
113646197445,113646197447,2,2188,1475,-10
113649944845,113649944842,-3,1457,1789,-10
113650389182,113650389184,2,1726,1053,-10
113650539982,113650539982,0,925,2011,-10
113651850825,113651850827,2,987,1470,-10
113652959350,113652959349,-1,1349,2475,-10
113660166641,113660166643,2,1601,1455,-10
113667388982,113667388990,8,3967,1287,-10
113668527866,113668527866,0,1219,1540,-10
113675151688,113675151685,-3,1007,2043,-10
113677693299,113677693301,2,1695,1769,-10
113679365886,113679365880,-6,17634,13787,-10
113679894002,113679894017,15,1987,1185,-10
113680161013,113680161014,1,1375,1652,-10
113680919475,113680919477,2,1548,2116,-10
113683279958,113683279938,-20,1078,1080,-10
113683825430,113683825431,1,1386,990,-10
113687881132,113687881114,-18,1162,1086,-10
113688821769,113688821769,0,1990,2432,-10
113690029768,113690029769,1,1675,1590,-10
113694097038,113694097038,0,1489,2124,-10
113694234390,113694234392,2,1358,1065,-10
113695273442,113695273425,-17,1400,666,-10
113698954330,113698954330,0,1536,1767,-10
113702754003,113702754005,2,1942,1453,-10
113703675754,113703675757,3,921,1295,-10
113705013393,113705013395,2,2036,1760,-10
113705714978,113705714982,4,1356,1472,-10
113705833323,113705833301,-22,1495,1502,-10
113706199852,113706199854,2,1197,1582,-10
113711675802,113711675803,1,1817,1521,-10
113712624315,113712624316,1,1853,1695,-10
113717068903,113717068909,6,2386,1402,-10
113717328703,113717328705,2,1653,1763,-10
113724603556,113724603557,1,1569,1345,-10
113725323290,113725323291,1,1063,1545,-10
113728900898,113728900899,1,1472,1470,-10
113729184739,113729184739,0,1765,1894,-10
113729703227,113729703233,6,2510,1069,-10
113733905035,113733905038,3,1442,1576,-10
113734170210,113734170212,2,1768,1586,-10
113737470826,113737470830,4,1420,1637,-10
113739573469,113739573470,1,1847,1715,-10
113743461062,113743461064,2,1198,1567,-10
113744122161,113744122163,2,1754,1508,-10
113744164819,113744164822,3,1470,1292,-10
113745759365,113745759364,-1,1926,2018,-10
113748651132,113748651134,2,2201,1522,-10
113749321109,113749321110,1,1314,1503,-10
113750815742,113750815743,1,1286,1091,-10
113751009882,113751009885,3,1728,1816,-10
113751213362,113751213376,14,1420,1482,-10
113754095410,113754095413,3,1516,1597,-10
113754576226,113754576228,2,1325,1261,-10
113759252084,113759252086,2,1690,1187,-10
113761432433,113761432435,2,1607,1326,-10
113762462374,113762462376,2,1690,1590,-10
113763319493,113763319495,2,1293,1018,-10
113763539644,113763539647,3,1920,2429,-10
113765763572,113765763577,5,2049,1336,-10
113768731433,113768731435,2,1317,1601,-10
113772657450,113772657452,2,1496,1362,-10
113774074622,113774074623,1,1059,1311,-10
113776343757,113776343758,1,1189,1634,-10
113778110524,113778110526,2,1326,1390,-10
113779274478,113779274481,3,1474,1269,-10
113784422506,113784422510,4,1798,1318,-10
113791393625,113791393625,0,1166,1410,-10
113792543076,113792543075,-1,1511,1811,-10
113798107197,113798107199,2,1473,1215,-10
113798681670,113798681665,-5,24007,16413,-10
113800663951,113800663954,3,1695,1293,-10
113803391486,113803391486,0,1394,1526,-10
113804220151,113804220128,-23,475,388,-10
113806342259,113806342259,0,1600,1372,-10
113807063142,113807063142,0,910,946,-10
113807795149,113807795150,1,1708,1790,-10
113808464287,113808464291,4,1076,1139,-10
113808803339,113808803317,-22,1598,1704,-10
113810051086,113810051090,4,1634,1582,-10
113810503982,113810503985,3,1278,1462,-10
113811161097,113811161099,2,1073,1347,-10
113811620742,113811620742,0,1501,1811,-10
113813412727,113813412728,1,1630,1783,-10
113814888945,113814888945,0,1493,2533,-10
113815122947,113815122949,2,1691,1146,-10
113817788274,113817788276,2,1482,1143,-10
113818992243,113818992243,0,2022,2185,-10
113819156675,113819156683,8,3299,1450,-10
113819237251,113819237252,1,1366,1657,-10
113823827637,113823827642,5,2389,1707,-10
113825814490,113825814495,5,1984,931,-10
113826433783,113826433787,4,1275,864,-10
113830741667,113830741668,1,1788,1945,-10
113831647124,113831647126,2,1482,1543,-10
113834245009,113834245009,0,1858,1783,-10
113839029685,113839029687,2,1750,1347,-10
113839561938,113839561938,0,1749,1709,-10
113842023898,113842023902,4,1427,1419,-10
113843080330,113843080334,4,1727,1854,-10
113843786348,113843786351,3,1344,1439,-10
113844090985,113844090986,1,1259,1556,-10
113846962874,113846962876,2,1350,1310,-10
113847538329,113847538333,4,1556,2093,-10
113850499870,113850499874,4,957,1566,-10
113851138590,113851138592,2,1751,1766,-10
113851491218,113851491220,2,1584,1848,-10
113851638913,113851638906,-7,2874,6931,-10
113852620125,113852620127,2,1630,1986,-10
113854065988,113854065990,2,1839,2038,-10
113857948606,113857948608,2,1874,1575,-10
113859064571,113859064571,0,1378,1604,-10
113859500062,113859500063,1,1769,1762,-10
113859556324,113859556326,2,1877,1309,-10
113860295455,113860295457,2,1027,1220,-10
113860887054,113860887055,1,1041,900,-10
113867754145,113867754146,1,1920,1785,-10
113868932453,113868932454,1,1309,765,-10
113872351346,113872351350,4,2312,1966,-10
113873898774,113873898782,8,6299,2106,-10
113873977901,113873977902,1,1144,991,-10
113875931085,113875931087,2,1391,1364,-10
113876020769,113876020749,-20,1372,1372,-10
113879768722,113879768722,0,1591,1224,-10
113881873177,113881873179,2,1315,1181,-10
113884439227,113884439229,2,1713,1809,-10
113885995691,113885995694,3,844,1306,-10
113887289640,113887289641,1,1306,1374,-10
113888266104,113888266105,1,1471,2202,-10
113893810286,113893810289,3,2050,1722,-10
113897087653,113897087656,3,1507,1338,-10
113898373287,113898373289,2,1234,1318,-10
113898757038,113898757039,1,1362,1336,-10
113900246967,113900246965,-2,2753,5189,-10
113900527310,113900527311,1,1028,1889,-10
113901138457,113901138460,3,1803,1407,-10
113902384173,113902384176,3,1292,1281,-10
113903210224,113903210243,19,1555,1441,-10
113903662415,113903662424,9,1875,1075,-10
113907019696,113907019697,1,1174,883,-10
113912763441,113912763444,3,2218,2420,-10
113914304218,113914304221,3,2197,1416,-10
113915484187,113915484189,2,1479,1824,-10
113915948601,113915948604,3,1552,1518,-10
113915992366,113915992367,1,1503,1776,-10
113917196286,113917196288,2,2099,1440,-10
113917659986,113917659992,6,1512,1168,-10
113919181113,113919181114,1,1076,792,-10
113920569217,113920569218,1,2215,2183,-10
113922258154,113922258156,2,1352,1419,-10
113922368749,113922368749,0,1337,1744,-10
113923066027,113923066027,0,1666,1761,-10
113923441925,113923441927,2,2308,1742,-10
113924205467,113924205469,2,1545,1262,-10
113924315109,113924315110,1,1168,1279,-10
113926922727,113926922731,4,1260,1408,-10
113930106086,113930106087,1,1274,1963,-10
113932434527,113932434530,3,1334,1528,-10
113934562206,113934562206,0,1162,1345,-10
113937430414,113937430414,0,1313,1343,-10
113939610449,113939610455,6,2460,1235,-10
113940557463,113940557465,2,1876,1942,-10
113942945450,113942945453,3,1099,1227,-10
113944898253,113944898255,2,1858,1763,-10
113947033974,113947033973,-1,878,1143,-10
113949557513,113949557514,1,3445,3878,-10
113950019565,113950019568,3,4295,32303,-10
113950227919,113950227922,3,1369,1640,-10
113951948025,113951948028,3,1172,1165,-10
113954594225,113954594226,1,1695,988,-10
113959397456,113959397457,1,1645,1343,-10
113959685455,113959685454,-1,1845,1503,-10
113961395602,113961395603,1,1381,1126,-10
113963440715,113963440715,0,1585,1197,-10
113963777230,113963777229,-1,957,1383,-10
113964454596,113964454599,3,1128,1042,-10
113964843241,113964843227,-14,2504,902,-10
113965183880,113965183879,-1,1171,1410,-10
113970978954,113970978957,3,1594,1397,-10
113975997901,113975997897,-4,34049,14226,-10
113976384026,113976384027,1,2213,1890,-10
113976603797,113976603801,4,1896,1357,-10
113978822107,113978822107,0,954,1311,-10
113979986532,113979986514,-18,1206,1416,-10
113984478366,113984478369,3,1369,1536,-10
113984531174,113984531178,4,1015,1364,-10
113985710803,113985710782,-21,1097,1339,-10
113988219391,113988219395,4,1138,1454,-10
113992163054,113992163055,1,1605,1618,-10
113992884373,113992884366,-7,1101,4827,-10
113993488602,113993488604,2,2117,2311,-10
113999180290,113999180294,4,1757,1398,-10
114008320094,114008320098,4,1350,1263,-10
114009467781,114009467785,4,1689,1449,-10
114011589957,114011589959,2,1315,1373,-10
114013159353,114013159354,1,1604,1488,-10
114013569299,114013569298,-1,1393,1929,-10
114013866069,114013866072,3,1822,1550,-10
114016033529,114016033530,1,2254,1737,-10
114020855185,114020855186,1,882,944,-10
114021749332,114021749331,-1,1527,1856,-10
114022095515,114022095517,2,1207,1758,-10
114024927194,114024927189,-5,921,2416,-10
114027158962,114027158965,3,2572,1856,-10
114028550202,114028550204,2,1432,1202,-10
114028720990,114028720994,4,1469,1342,-10
114034540018,114034540022,4,1915,800,-10
114036728202,114036728201,-1,1498,2951,-10
114038829039,114038829042,3,1437,1333,-10
114038992555,114038992555,0,1202,1271,-10
114040198191,114040198191,0,1944,2592,-10
114041971499,114041971501,2,1663,1647,-10
114042011790,114042011793,3,1766,1602,-10
114042393601,114042393605,4,412,3361,-10
114046272339,114046272342,3,1834,1659,-10
114048482141,114048482144,3,2600,2447,-10
114048628713,114048628715,2,1370,1244,-10
114052666532,114052666534,2,1329,1057,-10
114052745285,114052745285,0,1447,1702,-10
114054988117,114054988115,-2,3138,4150,-10
114057027993,114057027994,1,1287,1325,-10
114059877796,114059877798,2,1310,1185,-10
114064755247,114064755250,3,1356,1071,-10
114066286609,114066286609,0,1618,1421,-10
114067601630,114067601634,4,1557,1575,-10
114071445423,114071445423,0,1448,1467,-10
114074532209,114074532212,3,2577,1546,-10
114075788601,114075788603,2,1967,1656,-10
114078017000,114078016999,-1,1615,1435,-10
114079495902,114079495905,3,1591,1552,-10
114079566157,114079566159,2,2230,1665,-10
114079602405,114079602406,1,2011,1440,-10
114082455750,114082455756,6,3311,2076,-10
114084062202,114084062204,2,1262,1386,-10
114086433348,114086433347,-1,1554,1338,-10
114091801345,114091801347,2,1322,1254,-10
114097644037,114097644040,3,1817,2107,-10
114099118165,114099118165,0,1610,1768,-10
114100066005,114100066006,1,1572,1483,-10
114100441869,114100441870,1,1295,1367,-10
114101000577,114101000573,-4,1617,4027,-10
114103646801,114103646798,-3,1173,2287,-10
114104368434,114104368437,3,129,9579,-10
114109235169,114109235173,4,1707,1434,-10
114110981630,114110981629,-1,1883,2531,-10
114113187191,114113187191,0,1961,1843,-10
114114953523,114114953529,6,2151,1131,-10
114115149066,114115149069,3,2272,1469,-10
114115872749,114115872751,2,1787,1017,-10
114119900063,114119900067,4,1744,1233,-10
114120166210,114120166210,0,916,1053,-10
114121192870,114121192872,2,1644,1583,-10
114122245886,114122245889,3,1491,1214,-10
114123879749,114123879751,2,1504,1922,-10
114123983070,114123983073,3,1438,1516,-10
114125516067,114125516067,0,1189,1507,-10
114128833270,114128833272,2,1884,1615,-10
114132005702,114132005705,3,733,999,-10
114132121983,114132121987,4,1616,1432,-10
114132329525,114132329527,2,1344,1452,-10
114137657614,114137657618,4,2275,1976,-10
114139373714,114139373715,1,1364,1111,-10
114139580361,114139580363,2,1433,1317,-10
114141432583,114141432585,2,1677,1900,-10
114143127167,114143127169,2,918,1358,-10
114143854874,114143854874,0,961,822,-10
114146640301,114146640302,1,1083,1039,-10
114146954812,114146954817,5,1483,1381,-10
114147221747,114147221746,-1,1221,1956,-10
114147695765,114147695768,3,2009,1230,-10
114149431593,114149431598,5,4505,2141,-10
114152320314,114152320316,2,1527,1155,-10
114153352331,114153352336,5,1840,1444,-10
114154975122,114154975123,1,1434,2037,-10
114158872249,114158872250,1,2039,1383,-10
114159418950,114159418952,2,1345,1741,-10
114160558045,114160558047,2,1242,1395,-10
114164409938,114164409941,3,1341,1679,-10
114165220647,114165220647,0,1129,1342,-10
114165829752,114165829754,2,1849,1782,-10
114167176769,114167176771,2,2021,2274,-10
114171711975,114171711975,0,972,1034,-10
114174243402,114174243404,2,1908,1990,-10
114175364645,114175364647,2,1102,1275,-10
114175833930,114175833930,0,1904,2334,-10
114176058879,114176058882,3,1827,1792,-10
114176569642,114176569647,5,1013,1354,-10
114180588320,114180588322,2,1094,1065,-10
114181245006,114181245001,-5,491,2714,-10
114181312481,114181312482,1,1490,1936,-10
114181538835,114181538837,2,1644,1591,-10
114182877578,114182877579,1,1821,1642,-10
114186524593,114186524594,1,1272,1925,-10
114187565550,114187565556,6,1793,956,-10
114189514428,114189514430,2,1715,1026,-10
114192875765,114192875765,0,1409,1453,-10
114193467794,114193467795,1,1019,882,-10
114195260218,114195260228,10,1033,1529,-10
114198133468,114198133470,2,981,2049,-10
114202730039,114202730043,4,1639,1134,-10
114206185807,114206185809,2,1456,1386,-10
114206427761,114206427764,3,1189,1281,-10
114207244179,114207244181,2,1564,1646,-10
114208391354,114208391354,0,1208,1450,-10
114212546405,114212546412,7,3716,1893,-10
114213381841,114213381844,3,2205,1636,-10
114216265999,114216266002,3,1459,1486,-10
114221796338,114221796339,1,1524,2147,-10
114223716139,114223716142,3,1749,1656,-10
114223975565,114223975567,2,1736,1685,-10
114224063059,114224063061,2,2000,2246,-10
114225314030,114225314031,1,1425,1458,-10
114227896307,114227896309,2,1204,1699,-10
114230536139,114230536140,1,915,1868,-10
114230614221,114230614225,4,1765,1373,-10
114232768988,114232768992,4,2672,1712,-10
114233204831,114233204832,1,1131,1175,-10
114238363490,114238363492,2,1674,1638,-10
114243613652,114243613654,2,1191,1693,-10
114245111076,114245111078,2,1938,1514,-10
114245182279,114245182279,0,1089,1082,-10
114247991041,114247991041,0,985,1181,-10
114251370906,114251370909,3,3016,3437,-10
114251913214,114251913217,3,1755,1433,-10
114252531796,114252531798,2,1708,1493,-10
114253500889,114253500890,1,1316,2006,-10
114260378314,114260378317,3,1363,1471,-10
114263246263,114263246265,2,829,1225,-10
114263873511,114263873512,1,1532,1566,-10
114264243850,114264243857,7,1671,1737,-10
114266733042,114266733045,3,1644,1573,-10
114270426659,114270426662,3,2306,1352,-10
114271702083,114271702086,3,2180,2152,-10
114272578437,114272578439,2,1285,1118,-10
114279929354,114279929356,2,1683,1051,-10
114281058694,114281058696,2,1378,2016,-10
114282381017,114282381017,0,1525,1756,-10
114282938670,114282938673,3,1947,1595,-10
114285074551,114285074559,8,1577,1410,-10
114285981063,114285981061,-2,1245,1554,-10
114286201257,114286201259,2,1568,2088,-10
114287116938,114287116938,0,1495,1470,-10
114287883609,114287883610,1,1118,1370,-10
114289684206,114289684207,1,877,1027,-10
114292672217,114292672220,3,1635,1802,-10
114294714103,114294714107,4,2167,1050,-10
114298514286,114298514289,3,1720,1339,-10
114298810189,114298810193,4,1446,1496,-10
114303223566,114303223569,3,1590,1598,-10
114304513639,114304513657,18,742,848,-10
114306116100,114306116098,-2,2477,2337,-10
114307490973,114307490975,2,1180,1279,-10
114311596794,114311596797,3,1641,1761,-10
114312567203,114312567203,0,1429,1548,-10
114315957377,114315957379,2,865,981,-10
114318313316,114318313309,-7,1666,6009,-10
114319347282,114319347285,3,1443,1749,-10
114323654366,114323654370,4,2368,1690,-10
114324613931,114324613931,0,2029,2137,-10
114328507000,114328506997,-3,20701,17090,-10
114330337578,114330337580,2,1678,1937,-10
114330694583,114330694577,-6,1034,2330,-10
114331701691,114331701686,-5,1605,1493,-10
114332056979,114332056978,-1,330,1076,-10
114334405258,114334405258,0,1061,1925,-10
114335759641,114335759643,2,2264,2653,-10
114337271798,114337271801,3,1675,1294,-10
114337825538,114337825539,1,2024,2160,-10
114340476388,114340476401,13,65,1169,-10
114341818602,114341818589,-13,1368,1141,-10
114342589250,114342589269,19,1285,1215,-10
114344281106,114344281107,1,1971,1482,-10
114344943871,114344943848,-23,1024,1430,-10
114346895474,114346895477,3,1578,1240,-10
114347275909,114347275909,0,2027,1944,-10
114347409828,114347409831,3,1656,1756,-10
114347877045,114347877048,3,1532,1460,-10
114347908913,114347908915,2,1694,1889,-10
114348282879,114348282882,3,1328,1026,-10
114348626082,114348626086,4,1188,1226,-10
114349343398,114349343399,1,1189,1472,-10
114351958357,114351958359,2,1491,1305,-10
114352644740,114352644742,2,1500,1153,-10
114353408510,114353408513,3,1764,1385,-10
114359762454,114359762453,-1,1446,1861,-10
114363866762,114363866762,0,1873,2794,-10
114370553377,114370553377,0,1287,1654,-10
114372997837,114372997841,4,1654,1238,-10
114377159954,114377159949,-5,17052,16176,-10
114378780103,114378780105,2,1178,1535,-10
114379044240,114379044244,4,1128,1435,-10
114380177010,114380176988,-22,1354,1609,-10
114381268381,114381268382,1,1453,2025,-10
114383249612,114383249615,3,1674,1596,-10
114384080727,114384080730,3,1512,1619,-10
114387438841,114387438842,1,1720,875,-10
114387496938,114387496946,8,437,35,-10
114390043215,114390043218,3,2094,1927,-10
114395230561,114395230566,5,1443,1123,-10
114395589138,114395589141,3,1269,1356,-10
114396868162,114396868164,2,1341,2005,-10
114398041610,114398041611,1,1218,1912,-10
114400053071,114400053074,3,869,1126,-10
114402256542,114402256544,2,1742,1401,-10
114403087034,114403087038,4,2661,1298,-10
114404830239,114404830256,17,1251,1412,-10
114404919124,114404919128,4,1280,1328,-10
114405719065,114405719067,2,1005,1259,-10
114409397422,114409397423,1,1608,1764,-10
114410983722,114410983725,3,1940,1791,-10
114411656912,114411656914,2,1958,1741,-10
114415566898,114415566902,4,1842,1552,-10
114416442334,114416442334,0,1376,1546,-10
114421658599,114421658600,1,1535,1510,-10
114422557133,114422557132,-1,945,1103,-10
114422744405,114422744409,4,1910,1818,-10
114422953211,114422953211,0,1628,1832,-10
114423971160,114423971162,2,1588,1255,-10
114424352515,114424352519,4,779,950,-10
114426466669,114426466673,4,1233,1044,-10
114429664509,114429664510,1,2163,1756,-10
114430960922,114430960926,4,559,1420,-10
114433998139,114433998141,2,1887,1814,-10
114441013259,114441013254,-5,1385,1244,-10
114442195278,114442195282,4,1449,1272,-10
114443315082,114443315082,0,1459,1780,-10
114444107079,114444107083,4,2019,1839,-10
114448862294,114448862298,4,1786,1396,-10
114453024001,114453024003,2,1721,1549,-10
114453210626,114453210629,3,1758,2096,-10
114453605888,114453605894,6,4978,2717,-10
114460149463,114460149464,1,949,1075,-10
114466860426,114466860429,3,1684,1409,-10
114468729124,114468729125,1,1574,1901,-10
114469587383,114469587384,1,2253,1767,-10
114472558055,114472558059,4,2159,1596,-10
114473887727,114473887733,6,2725,1785,-10
114474744979,114474744983,4,2592,1807,-10
114475835661,114475835673,12,11872,45195,-10
114477403522,114477403525,3,1687,1687,-10
114478479495,114478479497,2,1841,2162,-10
114479105528,114479105531,3,1334,1045,-10
114481509863,114481509862,-1,1894,1650,-10
114483932783,114483932785,2,1698,1632,-10
114484708402,114484708397,-5,982,3874,-10
114488096276,114488096278,2,1216,1261,-10
114489917639,114489917641,2,1141,1388,-10
114494874796,114494874794,-2,1302,2015,-10
114496105982,114496105983,1,1191,1629,-10
114496267077,114496267078,1,2113,1568,-10
114499152453,114499152457,4,1357,1192,-10
114500323441,114500323443,2,1370,1331,-10
114501697177,114501697178,1,1796,2034,-10
114502146062,114502146065,3,2310,2079,-10
114503624938,114503624933,-5,1544,5322,-10
114504558978,114504558982,4,1527,1248,-10
114505506399,114505506401,2,1153,1157,-10
114509193921,114509193922,1,1502,1351,-10
114511815277,114511815279,2,1494,2017,-10
114512791381,114512791382,1,1937,1751,-10
114513288895,114513288895,0,1370,1427,-10
114514057875,114514057861,-14,1406,1653,-10
114516429630,114516429633,3,1462,1198,-10
114518736280,114518736282,2,1348,1771,-10
114520278933,114520278935,2,1360,1639,-10
114520373671,114520373673,2,1579,1479,-10
114521151608,114521151590,-18,1777,1647,-10
114522102517,114522102518,1,2214,1931,-10
114524850989,114524850992,3,1542,1803,-10
114526554194,114526554197,3,1293,1022,-10
114526820994,114526820995,1,1349,1935,-10
114528441760,114528441762,2,1624,1743,-10
114529997030,114529997039,9,4219,1753,-10
114530523246,114530523247,1,1149,1518,-10
114535928310,114535928309,-1,1184,1722,-10
114536365394,114536365395,1,1562,1645,-10
114540546766,114540546769,3,1472,1249,-10
114541172720,114541172721,1,1728,2090,-10
114542287762,114542287767,5,1268,1455,-10
114546472238,114546472240,2,1949,1473,-10
114548376490,114548376492,2,1841,1675,-10
114558237744,114558237746,2,1922,1269,-10
114561704514,114561704511,-3,2540,4698,-10
114563560666,114563560668,2,745,1266,-10
114571435870,114571435872,2,2272,1998,-10
114574057490,114574057493,3,1642,2062,-10
114574223545,114574223546,1,870,965,-10
114574769853,114574769856,3,1330,1521,-10
114575705595,114575705597,2,1255,1305,-10
114576801411,114576801414,3,732,1225,-10
114576976857,114576976859,2,1172,1630,-10
114585489597,114585489578,-19,1343,1842,-10
114585947823,114585947827,4,1657,1146,-10
114589071136,114589071138,2,914,972,-10
114590225674,114590225675,1,1077,1327,-10
114592880903,114592880906,3,1307,1061,-10
114596038966,114596038970,4,2199,1674,-10
114597306089,114597306091,2,1440,1518,-10
114599321235,114599321238,3,1211,1282,-10
114602750326,114602750328,2,1447,1568,-10
114603297001,114603297006,5,1884,2094,-10
114604135461,114604135459,-2,968,2230,-10
114606268216,114606268218,2,1451,1392,-10
114606553554,114606553550,-4,22678,61568,-10
114607413178,114607413179,1,1372,1287,-10
114607509016,114607509018,2,1344,1527,-10
114607717098,114607717102,4,2697,1520,-10
114610273986,114610273988,2,1322,1246,-10
114612305354,114612305358,4,1405,1411,-10
114613726980,114613726982,2,1233,1075,-10
114621113138,114621113138,0,1322,1530,-10
114623932717,114623932717,0,1308,1176,-10
114627434774,114627434777,3,1826,1293,-10
114627703520,114627703523,3,1628,1089,-10
114630713725,114630713729,4,2289,1540,-10
114631910654,114631910655,1,1664,1400,-10
114633710560,114633710562,2,1302,1527,-10
114635156936,114635156938,2,2146,1998,-10
114636894396,114636894401,5,2968,1418,-10
114637514022,114637514024,2,2292,2156,-10
114641701783,114641701785,2,1219,1748,-10
114644089724,114644089722,-2,1502,2706,-10
114645909997,114645910000,3,2088,1486,-10
114648172546,114648172547,1,1283,1769,-10
114650442846,114650442849,3,1750,1516,-10
114652568906,114652568907,1,1397,1599,-10
114653359090,114653359090,0,1165,1217,-10
114653951456,114653951457,1,1573,1791,-10
114654323112,114654323109,-3,959,1731,-10
114655692983,114655692986,3,1770,2151,-10
114656615718,114656615718,0,1289,1590,-10
114657832834,114657832835,1,2341,2135,-10
114658173750,114658173751,1,2030,1135,-10
114658582096,114658582097,1,788,1099,-10
114659724710,114659724713,3,1429,1486,-10
114659854631,114659854634,3,1452,1066,-10
114663929846,114663929849,3,1883,1661,-10
114665224529,114665224530,1,1799,1114,-10
114666007784,114666007785,1,1043,1676,-10
114667801273,114667801274,1,2489,2558,-10
114668249797,114668249799,2,1528,1067,-10
114668443623,114668443626,3,1676,2165,-10
114669329214,114669329222,8,1855,1196,-10
114672731209,114672731209,0,902,786,-10
114673001642,114673001643,1,1199,861,-10
114673302686,114673302689,3,1767,1576,-10
114673775480,114673775482,2,1402,1998,-10
114678363808,114678363809,1,1344,1201,-10
114679481361,114679481364,3,1865,1719,-10
114679700670,114679700651,-19,491,732,-10
114681625267,114681625270,3,1488,1810,-10
114682238296,114682238286,-10,844,732,-10
114683038386,114683038386,0,1472,1690,-10
114696265177,114696265180,3,2003,1615,-10
114699377806,114699377809,3,1526,1381,-10
114700919221,114700919222,1,1636,1546,-10
114708302443,114708302446,3,1138,1479,-10
114710102715,114710102718,3,1357,1551,-10
114713561137,114713561137,0,1035,710,-10
114716186825,114716186826,1,732,681,-10
114716613162,114716613150,-12,1154,1079,-10
114719123892,114719123891,-1,1282,1640,-10
114723775185,114723775189,4,1424,1836,-10
114723852269,114723852272,3,1880,1734,-10
114726052014,114726052016,2,1497,1525,-10
114729010866,114729010867,1,1865,1803,-10
114730223673,114730223677,4,2158,1580,-10
114732822672,114732822673,1,1997,1525,-10
114735946118,114735946122,4,3983,1686,-10
114738319144,114738319147,3,2018,1631,-10
114738694038,114738694041,3,1192,1072,-10
114740913696,114740913699,3,1276,1348,-10
114741855150,114741855154,4,1583,1735,-10
114744752690,114744752691,1,2029,1493,-10
114744856063,114744856065,2,1089,1700,-10
114751060589,114751060590,1,1785,1733,-10
114753066350,114753066353,3,1188,1388,-10
114756313240,114756313241,1,2095,1410,-10
114758385530,114758385531,1,1804,1883,-10
114762306662,114762306666,4,1843,1505,-10
114765133966,114765133967,1,972,1011,-10
114766154197,114766154197,0,1497,1340,-10
114766526046,114766526047,1,1256,1804,-10
114766571712,114766571694,-18,1500,1267,-10
114769081294,114769081294,0,1566,1509,-10
114769236128,114769236130,2,1316,1333,-10
114771278903,114771278906,3,1611,1418,-10
114771714839,114771714841,2,1530,825,-10
114778193144,114778193145,1,2063,2781,-10
114779134607,114779134610,3,1478,1685,-10
114788042054,114788042055,1,1370,1536,-10
114788124336,114788124338,2,1290,1502,-10
114788985050,114788985052,2,2292,2066,-10
114793787078,114793787078,0,2295,2303,-10
114794715178,114794715181,3,1312,1365,-10
114794843838,114794843842,4,1383,1284,-10
114795174921,114795174927,6,2125,1476,-10
114798274789,114798274790,1,1413,1780,-10
114798599969,114798599970,1,2288,3009,-10
114799321474,114799321475,1,1109,1804,-10
114800882662,114800882664,2,2190,2191,-10
114805821206,114805821204,-2,1382,2220,-10
114806733023,114806733026,3,1352,1649,-10
114808354398,114808354398,0,994,1251,-10
114810190687,114810190689,2,1636,1925,-10
114812082569,114812082568,-1,898,1704,-10
114813242385,114813242386,1,1634,1706,-10
114813497171,114813497173,2,1612,1889,-10
114815185214,114815185217,3,1915,2069,-10
114815421137,114815421136,-1,1038,1158,-10
114816122431,114816122431,0,1474,1552,-10
114816512587,114816512592,5,1998,1401,-10
114816568658,114816568660,2,1419,2237,-10
114818374644,114818374645,1,1428,1843,-10
114818611870,114818611871,1,1371,1593,-10
114821047441,114821047447,6,2483,918,-10
114825155907,114825155910,3,1311,1290,-10
114827369721,114827369722,1,1518,1561,-10
114828451640,114828451642,2,1437,1505,-10
114828783245,114828783245,0,1498,1250,-10
114830917869,114830917871,2,1432,1289,-10
114832278112,114832278114,2,1678,1569,-10
114832548814,114832548818,4,2104,1534,-10
114835189848,114835189849,1,1596,1721,-10
114837139893,114837139894,1,2067,1493,-10
114839765370,114839765370,0,1787,2099,-10
114840880698,114840880698,0,1299,1128,-10
114844667310,114844667310,0,1407,1370,-10
114845557498,114845557495,-3,1081,2010,-10
114846635242,114846635245,3,1962,1811,-10
114847506324,114847506322,-2,1727,2150,-10
114848106153,114848106135,-18,860,818,-10
114852113022,114852113020,-2,1320,2338,-10
114855307017,114855307017,0,1662,1659,-10
114855339879,114855339881,2,1039,927,-10
114856500922,114856500923,1,1072,1210,-10
114859163339,114859163342,3,955,1376,-10
114863604119,114863604121,2,1247,1812,-10
114863719171,114863719174,3,2189,1569,-10
114867620252,114867620258,6,2434,1286,-10
114874495740,114874495741,1,2000,2041,-10
114877911862,114877911863,1,1512,1144,-10
114879041685,114879041686,1,1532,1639,-10
114879558040,114879558042,2,1620,1264,-10
114879905749,114879905753,4,1203,1353,-10
114880302001,114880302002,1,1803,1434,-10
114884217221,114884217223,2,1440,1478,-10
114887031385,114887031386,1,1228,1355,-10
114888902215,114888902209,-6,2037,7034,-10
114891054645,114891054649,4,2179,1508,-10
114893381693,114893381697,4,844,1538,-10
114896851973,114896851971,-2,1974,1828,-10
114897646972,114897646973,1,1559,1390,-10
114898804335,114898804336,1,994,1290,-10
114899701535,114899701535,0,1337,1184,-10
114902029018,114902029017,-1,1351,1741,-10
114902814717,114902814722,5,1685,1126,-10
114905687358,114905687362,4,1024,1450,-10
114906366175,114906366174,-1,829,1861,-10
114906627180,114906627182,2,1533,1618,-10
114910116642,114910116642,0,1628,1209,-10
114911147190,114911147191,1,745,610,-10
114911283495,114911283498,3,1389,1511,-10
114911817432,114911817433,1,1543,1685,-10
114913751994,114913751998,4,1951,1641,-10
114916485418,114916485422,4,1275,1169,-10
114918568378,114918568379,1,1336,1360,-10
114920286621,114920286622,1,1189,1199,-10
114923111987,114923111990,3,1409,1332,-10
114928745982,114928745978,-4,391,1016,-10
114930173113,114930173114,1,1620,1821,-10
114930858076,114930858074,-2,1035,1468,-10
114930980498,114930980487,-11,1363,1344,-10
114931831583,114931831560,-23,1236,1002,-10
114933126439,114933126442,3,1436,1651,-10
114933823218,114933823221,3,2310,1886,-10
114933912191,114933912194,3,1617,896,-10
114934209657,114934209664,7,3783,1495,-10
114935399809,114935399810,1,2186,1788,-10
114936017486,114936017489,3,1926,1938,-10
114936221299,114936221301,2,874,1472,-10
114937521895,114937521897,2,1096,1335,-10
114939582478,114939582480,2,1778,1431,-10
114942512702,114942512703,1,1339,1521,-10
114943076762,114943076766,4,1991,1709,-10
114943979685,114943979687,2,1662,1180,-10
114944151213,114944151214,1,1264,1059,-10
114944397921,114944397925,4,2047,1700,-10
114947621510,114947621512,2,1706,2112,-10
114948639803,114948639806,3,1579,1265,-10
114948987582,114948987583,1,1748,1095,-10
114949717301,114949717303,2,2007,1796,-10
114951761872,114951761874,2,1377,1153,-10
114959056234,114959056234,0,2344,2104,-10
114973474210,114973474213,3,993,1748,-10
114975222631,114975222636,5,2195,1863,-10
114975325366,114975325371,5,1531,1619,-10
114976153280,114976153282,2,1550,1463,-10
114976907791,114976907793,2,1454,1288,-10
114977435358,114977435361,3,2024,2206,-10
114979314340,114979314341,1,1682,1451,-10
114980261810,114980261809,-1,3248,3923,-10
114981383396,114981383397,1,1577,1489,-10
114995683080,114995683082,2,1101,974,-10
114996951694,114996951690,-4,1397,3064,-10
114997330021,114997330023,2,1460,1620,-10
114998096980,114998096982,2,1730,1551,-10
114998283721,114998283723,2,1394,1343,-10
114998601178,114998601180,2,1893,1726,-10
115007592684,115007592687,3,1228,1242,-10
115010046649,115010046652,3,1210,1234,-10
115011298613,115011298615,2,1457,1365,-10
115013356291,115013356294,3,1874,1503,-10
115013900961,115013900964,3,1696,1453,-10
115016831705,115016831710,5,2445,1428,-10
115017924554,115017924554,0,2753,2094,-10
115020964571,115020964572,1,1272,1758,-10
115022725071,115022725073,2,1030,1471,-10
115023749887,115023749890,3,1697,1272,-10
115028280482,115028280483,1,1052,1105,-10
115029369555,115029369558,3,1801,2013,-10
115029881090,115029881093,3,1471,1319,-10
115032856098,115032856098,0,2023,1347,-10
115033846628,115033846632,4,1439,1367,-10
115034639709,115034639711,2,1375,1809,-10
115038124956,115038124958,2,1717,1088,-10
115040318754,115040318754,0,1689,1569,-10
115041680405,115041680411,6,6240,2440,-10
115043561155,115043561156,1,1690,1749,-10
115043658717,115043658720,3,1506,1534,-10
115044438929,115044438929,0,1451,1332,-10
115046753758,115046753761,3,1391,1442,-10
115047451563,115047451547,-16,978,2708,-10
115050827121,115050827121,0,1943,1201,-10
115050923506,115050923502,-4,4885,13031,-10
115051486017,115051486018,1,1526,1400,-10
115053419230,115053419231,1,1783,1154,-10
115055653656,115055653657,1,1732,1825,-10
115056505569,115056505570,1,1707,1234,-10
115057950954,115057950955,1,1802,1460,-10
115058451034,115058451036,2,1963,1292,-10
115060745690,115060745697,7,12242,19694,-10
115061591185,115061591189,4,1753,1420,-10
115062674630,115062674631,1,1367,1821,-10
115063192958,115063192960,2,1590,1153,-10
115068526357,115068526356,-1,1870,1347,-10
115069960386,115069960390,4,1229,1469,-10
115075632110,115075632114,4,1983,1723,-10
115078890950,115078890951,1,1768,1561,-10
115082089839,115082089842,3,1701,1668,-10
115083868862,115083868847,-15,1096,1172,-10
115084688691,115084688693,2,1911,1333,-10
115087215483,115087215486,3,2167,1774,-10
115089793454,115089793457,3,1093,1603,-10
115094945105,115094945107,2,1700,1325,-10
115095212414,115095212396,-18,1954,1353,-10
115097183167,115097183171,4,2917,1777,-10
115099754592,115099754594,2,1816,1701,-10
115104721973,115104721975,2,1583,1763,-10
115105957649,115105957651,2,1533,1493,-10
115108670378,115108670380,2,2184,1865,-10
115109056382,115109056386,4,1950,2124,-10
115113057953,115113057946,-7,1015,12289,-10
115114076857,115114076858,1,1629,1486,-10
115121217002,115121217009,7,4252,2172,-10
115123559868,115123559869,1,1717,1729,-10
115127453714,115127453715,1,1613,1458,-10
115128839431,115128839434,3,1971,1283,-10
115130064790,115130064794,4,1700,1554,-10
115131502194,115131502196,2,2375,1681,-10
115134148170,115134148173,3,1156,1496,-10
115149822498,115149822503,5,1024,763,-10
115151460057,115151460059,2,1779,2019,-10
115151595441,115151595444,3,1459,1117,-10
115151889096,115151889098,2,1597,1547,-10
115153951487,115153951490,3,2008,1808,-10
115154641330,115154641335,5,3429,2051,-10
115154859000,115154859001,1,2158,1587,-10
115156669921,115156669917,-4,1387,3705,-10
115156958830,115156958831,1,1910,1297,-10
115158984475,115158984478,3,1608,1543,-10
115159511628,115159511631,3,1768,1522,-10
115161136994,115161136996,2,1784,1854,-10
115163809789,115163809791,2,1493,1333,-10
115165255166,115165255169,3,2246,1910,-10
115166092696,115166092698,2,1492,2166,-10
115166578705,115166578709,4,2219,1327,-10
115167194866,115167194868,2,1777,1366,-10
115171862463,115171862466,3,1792,1623,-10
115172036962,115172036966,4,1840,1247,-10
115172488803,115172488804,1,1092,1583,-10
115174520919,115174520922,3,1997,1991,-10
115175318006,115175318002,-4,1864,5449,-10
115175801707,115175801710,3,1624,1422,-10
115178195604,115178195605,1,1718,1533,-10
115179691570,115179691572,2,2068,1688,-10
115183165508,115183165511,3,1568,1672,-10
115186195331,115186195333,2,1661,1059,-10
115187043393,115187043395,2,2053,1162,-10
115188127381,115188127382,1,1829,1489,-10
115188225723,115188225725,2,1313,1620,-10
115190571282,115190571283,1,1439,1199,-10
115191171351,115191171354,3,1758,1548,-10
115199443598,115199443599,1,1322,1632,-10
115201985095,115201985097,2,1622,1590,-10
115203702382,115203702384,2,1548,1617,-10
115204045827,115204045829,2,1408,1682,-10
115206055953,115206055953,0,1358,1326,-10
115208924382,115208924387,5,2118,1397,-10
115211321351,115211321348,-3,1534,2196,-10
115212818425,115212818427,2,1664,1937,-10
115219972660,115219972663,3,1145,1175,-10
115223508702,115223508706,4,1205,1533,-10
115226192259,115226192263,4,1529,1959,-10
115226285075,115226285076,1,2175,1936,-10
115226497866,115226497866,0,2167,2143,-10
115228029495,115228029504,9,1373,734,-10
115228982452,115228982455,3,1699,1663,-10
115230087168,115230087169,1,1500,1895,-10
115230337466,115230337470,4,1626,1821,-10
115233253601,115233253602,1,916,1374,-10
115240036531,115240036534,3,1546,1447,-10
115243487098,115243487100,2,2062,1407,-10
115245297837,115245297838,1,1777,1470,-10
115247241370,115247241370,0,996,1475,-10
115249054947,115249054949,2,1775,1568,-10
115249168886,115249168886,0,1513,2199,-10
115250710672,115250710674,2,1656,1512,-10
115252817178,115252817182,4,2078,2100,-10
115253496643,115253496644,1,1357,1846,-10
115255108414,115255108417,3,1837,1723,-10
115256380265,115256380266,1,456,667,-10
115258755713,115258755716,3,2491,2156,-10
115259190011,115259190014,3,1564,1877,-10
115259457719,115259457729,10,1359,1069,-10
115260764477,115260764479,2,1317,1434,-10
115261255699,115261255701,2,1496,2122,-10
115261382025,115261382027,2,1488,1688,-10
115262104783,115262104791,8,15613,11866,-10
115262827144,115262827146,2,1318,2023,-10
115267420495,115267420498,3,1522,1391,-10
115268755077,115268755078,1,1232,1919,-10
115269730319,115269730321,2,1959,2077,-10
115272045524,115272045526,2,1459,1163,-10
115274378830,115274378833,3,1450,1264,-10
115275330258,115275330258,0,1399,1573,-10
115276253099,115276253101,2,2021,2235,-10
115276941349,115276941351,2,921,1238,-10
115277598211,115277598210,-1,1167,1002,-10
115279724115,115279724111,-4,1140,2811,-10
115280596443,115280596447,4,2042,1447,-10
115283140384,115283140383,-1,1377,1513,-10
115283964016,115283964010,-6,34037,13828,-10
115284730611,115284730614,3,1613,1623,-10
115289370545,115289370546,1,1987,2056,-10
115290336003,115290336006,3,1457,1673,-10
115290886799,115290886802,3,1779,1484,-10
115293692358,115293692358,0,1724,1225,-10
115295968357,115295968358,1,1263,1113,-10
115300196946,115300196948,2,1703,1322,-10
115300980221,115300980222,1,1533,1649,-10
115302638789,115302638790,1,1982,1743,-10
115302872552,115302872553,1,1696,1539,-10
115307638929,115307638931,2,1353,1491,-10
115311049990,115311049989,-1,1431,1852,-10
115314412956,115314412958,2,1414,1855,-10
115314659493,115314659493,0,1316,2087,-10
115319736727,115319736726,-1,1231,1315,-10
115322460258,115322460258,0,1609,1367,-10
115323582145,115323582146,1,1309,1464,-10
115325315882,115325315882,0,1640,1182,-10
115326771715,115326771718,3,1071,905,-10
115326877241,115326877242,1,1553,1965,-10
115327913719,115327913726,7,4058,1658,-10
115328922362,115328922365,3,1575,2163,-10
115329654522,115329654523,1,1734,1736,-10
115331702768,115331702770,2,1995,1822,-10
115333284142,115333284142,0,1414,1228,-10
115334063819,115334063821,2,1563,1787,-10
115334831042,115334831045,3,1478,1707,-10
115335062280,115335062283,3,1955,1583,-10
115336094240,115336094242,2,1854,2298,-10
115337911994,115337911994,0,1642,2331,-10
115339124566,115339124567,1,1726,1308,-10
115340402553,115340402554,1,1588,1521,-10
115342756994,115342756997,3,1622,1576,-10
115345668330,115345668333,3,1978,2256,-10
115346626776,115346626778,2,998,1926,-10
115349237454,115349237459,5,1199,1217,-10
115351570555,115351570556,1,1465,1655,-10
115351918738,115351918739,1,1500,1427,-10
115353029937,115353029942,5,1665,1320,-10
115354912898,115354912899,1,1138,1121,-10
115356599443,115356599443,0,1399,1177,-10
115357303531,115357303520,-11,1656,1803,-10
115357518130,115357518135,5,1095,1207,-10
115357964890,115357964893,3,1382,1379,-10
115359909789,115359909790,1,1816,1651,-10
115361877506,115361877503,-3,1545,3388,-10
115362331362,115362331382,20,775,1785,-10
115364726536,115364726538,2,1912,1661,-10
115364836298,115364836301,3,1831,1189,-10
115365599937,115365599938,1,1311,1355,-10
115371789881,115371789882,1,1306,729,-10
115375919784,115375919786,2,1547,1403,-10
115377812654,115377812658,4,1948,1061,-10
115380668211,115380668210,-1,990,1319,-10
115384361376,115384361378,2,2036,1575,-10
115386489590,115386489594,4,1032,1218,-10
115392144495,115392144498,3,1510,1258,-10
115392268357,115392268353,-4,1366,3514,-10
115393147967,115393147952,-15,700,1398,-10
115394340607,115394340609,2,1585,2574,-10
115395223245,115395223252,7,2726,1114,-10
115397802018,115397802021,3,1389,1028,-10
115399570638,115399570639,1,1705,1408,-10
115401119411,115401119410,-1,1745,2504,-10
115402295616,115402295618,2,1455,1616,-10
115403795010,115403795016,6,15038,19844,-10
115406050977,115406050977,0,2259,2062,-10
115410697701,115410697703,2,1382,1050,-10
115412250847,115412250847,0,1411,1056,-10
115420320836,115420320837,1,1600,1632,-10
115428863559,115428863559,0,1449,1587,-10
115429288738,115429288739,1,1653,1410,-10
115431153554,115431153557,3,1449,1896,-10
115432417371,115432417363,-8,952,2460,-10
115432947172,115432947172,0,1762,1496,-10
115433307494,115433307495,1,1212,1163,-10
115433725078,115433725079,1,1557,1205,-10
115435282781,115435282782,1,844,1223,-10
115435724992,115435724994,2,2175,1767,-10
115438464894,115438464891,-3,960,1680,-10
115441654697,115441654699,2,1009,1567,-10
115443922414,115443922417,3,988,1474,-10
115446744813,115446744814,1,1110,1484,-10
115448229024,115448229026,2,1088,765,-10
115448442286,115448442264,-22,1943,1579,-10
115449837959,115449837962,3,1540,2011,-10
115450572046,115450572048,2,2214,1879,-10
115451850867,115451850861,-6,949,6424,-10
115453060277,115453060277,0,2237,1986,-10
115453730802,115453730802,0,791,1004,-10
115455631506,115455631507,1,1851,1734,-10
115457515531,115457515533,2,1304,1832,-10
115460383119,115460383123,4,2032,2016,-10
115462250913,115462250915,2,1722,1323,-10
115462924271,115462924273,2,944,729,-10
115465568056,115465568057,1,2029,1648,-10
115466466987,115466466990,3,2137,1474,-10
115469251961,115469251962,1,1275,875,-10
115471110083,115471110081,-2,1353,894,-10
115472386506,115472386507,1,1432,1328,-10
115473529425,115473529427,2,2032,1454,-10
115474735962,115474735965,3,1471,1260,-10
115474873941,115474873944,3,1108,1111,-10
115475376418,115475376422,4,771,1232,-10
115475937327,115475937329,2,1358,1318,-10
115476694245,115476694251,6,13573,20878,-10
115481864223,115481864225,2,2199,2188,-10
115486827706,115486827707,1,1209,1175,-10
115493995887,115493995890,3,2026,1803,-10
115494160962,115494160964,2,1450,1378,-10
115495517757,115495517759,2,2236,2200,-10
115499164310,115499164312,2,1275,1359,-10
115499536602,115499536603,1,1531,1654,-10
115499882710,115499882710,0,1118,944,-10
115501452273,115501452281,8,1205,1094,-10
115503244846,115503244849,3,1621,1944,-10
115503698537,115503698538,1,1298,1931,-10
115508733484,115508733491,7,7932,30349,-10
115508938897,115508938899,2,1638,1568,-10
115510249822,115510249822,0,1153,1346,-10
115519542050,115519542054,4,1328,1405,-10
115521127799,115521127791,-8,1156,1283,-10
115521820609,115521820612,3,1361,1248,-10
115522930422,115522930419,-3,1178,3208,-10
115523177151,115523177152,1,1354,1404,-10
115523290800,115523290795,-5,20938,67151,-10
115524859541,115524859542,1,786,791,-10
115526830473,115526830476,3,1757,1523,-10
115527700169,115527700171,2,1375,1432,-10
115532143377,115532143392,15,1358,1816,-10
115533785676,115533785679,3,1962,1113,-10
115536120598,115536120601,3,2030,1641,-10
115537752838,115537752837,-1,1139,1419,-10
115539574598,115539574600,2,1611,2351,-10
115539962016,115539962018,2,1593,1406,-10
115541439440,115541439442,2,1906,2119,-10
115543080731,115543080734,3,1386,1118,-10
115547732870,115547732870,0,1655,1420,-10
115549404599,115549404599,0,1935,1637,-10
115551661324,115551661341,17,241,1046,-10
115552958605,115552958606,1,1449,1509,-10
115553268999,115553269000,1,1563,1533,-10
115555623230,115555623209,-21,2016,1281,-10
115555774986,115555774988,2,1333,1215,-10
115557082485,115557082489,4,1665,1571,-10
115559063387,115559063390,3,1378,1191,-10
115559217683,115559217685,2,1375,1455,-10
115561193453,115561193455,2,1819,1703,-10
115562771051,115562771035,-16,1176,1157,-10
115563280202,115563280206,4,2271,1524,-10
115563834982,115563834983,1,2008,1838,-10
115563962854,115563962856,2,1394,1115,-10
115566202473,115566202479,6,1413,1601,-10
115567316009,115567316009,0,1221,1962,-10
115567510350,115567510353,3,2216,1597,-10
115569442601,115569442603,2,1325,1368,-10
115570168102,115570168105,3,1268,1474,-10
115571437122,115571437125,3,1217,1553,-10
115578375402,115578375403,1,1451,1978,-10
115581186225,115581186225,0,1679,1807,-10
115587023412,115587023418,6,2601,1446,-10
115591672972,115591672974,2,1072,1441,-10
115593109948,115593109950,2,1130,1312,-10
115593347783,115593347786,3,1100,1367,-10
115594125903,115594125907,4,1460,1092,-10
115596300994,115596300996,2,1644,1703,-10
115599212654,115599212649,-5,507,1433,-10
115602952391,115602952392,1,1198,1449,-10
115605156958,115605156961,3,1829,1985,-10
115607461462,115607461465,3,1626,1384,-10
115610152155,115610152134,-21,1988,1464,-10
115611684505,115611684503,-2,1337,2268,-10
115613683805,115613683806,1,1933,1513,-10
115616711990,115616711996,6,16488,30410,-10
115617066341,115617066342,1,1782,1382,-10
115619824386,115619824390,4,1655,1310,-10
115622107707,115622107709,2,2366,1890,-10
115624354390,115624354390,0,1003,844,-10
115626585506,115626585511,5,2322,1381,-10
115626765628,115626765630,2,1403,1363,-10
115628676456,115628676456,0,1749,2129,-10
115629354803,115629354806,3,2020,1633,-10
115630380714,115630380716,2,1919,1705,-10
115634838239,115634838239,0,1196,1849,-10
115636472436,115636472437,1,1755,1316,-10
115642048647,115642048652,5,1848,1316,-10
115642117725,115642117725,0,1432,1334,-10
115645065614,115645065618,4,1917,2148,-10
115645128935,115645128936,1,1655,1704,-10
115647122906,115647122906,0,1600,1870,-10
115650298254,115650298253,-1,1522,1829,-10
115650756031,115650756031,0,817,1503,-10
115650857466,115650857467,1,1807,1513,-10
115651190378,115651190379,1,2131,1213,-10
115651256155,115651256155,0,1333,1492,-10
115651556963,115651556966,3,1497,1258,-10
115651816954,115651816956,2,1817,1201,-10
115654437821,115654437826,5,2594,1331,-10
115654648126,115654648129,3,1559,1962,-10
115654964499,115654964495,-4,1626,2820,-10
115662477382,115662477385,3,1743,1749,-10
115663544451,115663544455,4,1653,1464,-10
115664448765,115664448767,2,36142,31289,-10
115665312382,115665312385,3,1009,871,-10
115665691140,115665691135,-5,1506,3239,-10
115665951239,115665951238,-1,1190,1670,-10
115668303451,115668303455,4,1495,1462,-10
115670050837,115670050841,4,1305,1425,-10
115672020250,115672020253,3,1209,1283,-10
115682176985,115682176987,2,2297,1846,-10
115682573841,115682573844,3,1563,1548,-10
115686794802,115686794805,3,1524,1702,-10
115686839189,115686839191,2,1393,1361,-10
115689754635,115689754635,0,1384,1224,-10
115691177589,115691177592,3,1601,1806,-10
115694613742,115694613745,3,1239,1190,-10
115695566579,115695566577,-2,1973,2489,-10
115698784179,115698784181,2,1437,1528,-10
115699685671,115699685674,3,1727,1322,-10
115702195786,115702195789,3,1399,1191,-10
115703380622,115703380624,2,2116,1512,-10
115704476873,115704476875,2,1616,1622,-10
115705710301,115705710318,17,908,12,-10
115708056181,115708056161,-20,1780,1694,-10
115708135515,115708135518,3,1464,2090,-10
115709071597,115709071597,0,1656,1568,-10
115710829053,115710829033,-20,1446,1289,-10
115716661721,115716661724,3,1444,1572,-10
115717517826,115717517830,4,1386,1574,-10
115719640224,115719640225,1,1784,1686,-10
115720305207,115720305210,3,1120,1094,-10
115722421439,115722421438,-1,1372,1192,-10
115723660575,115723660579,4,2258,2353,-10
115726046438,115726046440,2,1579,1626,-10
115726101853,115726101854,1,1241,1228,-10
115726519527,115726519529,2,1718,1283,-10
115730983051,115730983051,0,763,1292,-10
115734458672,115734458673,1,1725,1480,-10
115734719401,115734719405,4,1856,1463,-10
115735267598,115735267602,4,1605,1289,-10
115737292691,115737292683,-8,885,4914,-10
115737372554,115737372554,0,1333,1378,-10
115738155025,115738155026,1,1141,1042,-10
115739825998,115739826005,7,3141,1363,-10
115741064426,115741064428,2,1983,1622,-10
115741204102,115741204097,-5,2881,7094,-10
115741288227,115741288227,0,1624,1140,-10
115742304461,115742304461,0,1685,1447,-10
115742892366,115742892366,0,1579,1823,-10
115744170885,115744170889,4,1847,1322,-10
115745980346,115745980346,0,959,1356,-10
115752562221,115752562222,1,1110,1829,-10
115754217721,115754217723,2,1444,1730,-10
115756470779,115756470782,3,1194,1309,-10
115757615898,115757615898,0,2032,2013,-10
115757929566,115757929569,3,1206,1104,-10
115758320947,115758320949,2,2392,1897,-10
115758362766,115758362767,1,1024,789,-10
115758890764,115758890766,2,1874,1583,-10
115759381529,115759381530,1,1627,1742,-10
115760353305,115760353307,2,975,2236,-10
115768382876,115768382879,3,1919,1205,-10
115771192455,115771192458,3,1892,1664,-10
115773626985,115773626986,1,1949,1570,-10
115777555220,115777555224,4,1667,1619,-10
115786682981,115786682982,1,1965,1988,-10
115787152994,115787152988,-6,667,1404,-10
115789092903,115789092905,2,1733,1453,-10
115790198992,115790198994,2,1349,1904,-10
115790482966,115790482964,-2,1000,2372,-10
115791539062,115791539063,1,1171,1209,-10
115791997385,115791997387,2,1408,907,-10
115794834177,115794834184,7,3183,1227,-10
115796997494,115796997495,1,1648,1670,-10
115798495219,115798495219,0,1431,1499,-10
115798669814,115798669816,2,1174,1714,-10
115800300569,115800300569,0,1929,1989,-10
115801039766,115801039767,1,1765,1951,-10
115801327043,115801327046,3,991,1061,-10
115804499389,115804499391,2,1358,1760,-10
115805190859,115805190862,3,1102,1145,-10
115812180657,115812180657,0,1569,1353,-10
115814090253,115814090260,7,10315,22230,-10
115814812129,115814812130,1,1651,1483,-10
115815553983,115815553985,2,1393,1532,-10
115816730820,115816730821,1,1544,1146,-10
115816846938,115816846938,0,1454,1596,-10
115818486628,115818486632,4,1951,1627,-10
115819271718,115819271719,1,1219,1412,-10
115820345115,115820345118,3,2125,1745,-10
115823131947,115823131952,5,1840,1883,-10
115824620134,115824620138,4,1775,1660,-10
115824886914,115824886914,0,1933,2242,-10
115827296650,115827296652,2,1610,1965,-10
115828832582,115828832586,4,1272,1402,-10
115830486530,115830486531,1,2160,2544,-10
115830726018,115830726021,3,1863,1765,-10
115832541837,115832541839,2,1649,1771,-10
115833719959,115833719961,2,1436,1479,-10
115836316606,115836316608,2,2439,1636,-10
115839304470,115839304471,1,2399,2048,-10
115840899650,115840899655,5,1483,1109,-10
115841679110,115841679113,3,1375,873,-10
115843101269,115843101271,2,1160,1204,-10
115844824947,115844824949,2,1140,1592,-10
115845596382,115845596382,0,1371,1658,-10
115846488006,115846488006,0,1470,1426,-10
115849749746,115849749746,0,1070,1433,-10
115852927710,115852927710,0,933,1638,-10
115853403326,115853403327,1,1375,1599,-10
115853659818,115853659817,-1,1557,1321,-10
115854377802,115854377803,1,1516,1524,-10
115857693538,115857693543,5,1810,708,-10
115857886358,115857886378,20,1557,1316,-10
115858261725,115858261728,3,1280,1120,-10
115861575374,115861575374,0,1979,1796,-10
115861647411,115861647415,4,1374,936,-10
115862615122,115862615123,1,1312,1474,-10
115864277162,115864277164,2,2101,1746,-10
115865484045,115865484047,2,855,1154,-10
115867441800,115867441801,1,1350,1155,-10
115867768238,115867768241,3,1880,2275,-10
115867861929,115867861934,5,1749,1146,-10
115869725658,115869725660,2,1542,1772,-10
115871977287,115871977288,1,1915,1691,-10
115874608765,115874608768,3,1308,1734,-10
115876020740,115876020734,-6,2185,9165,-10
115881973061,115881973066,5,1285,1096,-10
115883216786,115883216788,2,1838,1221,-10
115884385143,115884385147,4,1752,1486,-10
115886526626,115886526629,3,1529,1722,-10
115887455931,115887455932,1,1418,1425,-10
115887880702,115887880705,3,1442,1787,-10
115889439388,115889439388,0,1605,2207,-10
115890509004,115890509004,0,1252,1063,-10
115892196747,115892196748,1,1934,1743,-10
115895736233,115895736230,-3,1268,2362,-10
115898408026,115898408029,3,1867,1861,-10
115901315338,115901315340,2,2697,1889,-10
115903312542,115903312545,3,2365,1793,-10
115904218321,115904218330,9,2082,1698,-10
115904653506,115904653523,17,1961,1936,-10
115904865236,115904865240,4,1612,1650,-10
115905108112,115905108112,0,1989,1462,-10
115905871375,115905871377,2,1712,1402,-10
115908469837,115908469839,2,1557,1164,-10
115909011178,115909011183,5,3596,1488,-10
115909203589,115909203586,-3,1081,2128,-10
115909519043,115909519047,4,1719,1180,-10
115909662954,115909662956,2,970,1781,-10
115910498345,115910498347,2,1347,1399,-10
115912970146,115912970147,1,805,776,-10
115913624862,115913624841,-21,1046,1167,-10
115915513487,115915513491,4,1210,1343,-10
115916028034,115916028039,5,1779,896,-10
115918935187,115918935180,-7,2280,8104,-10
115919132938,115919132939,1,1993,2352,-10
115921680769,115921680773,4,1460,1505,-10
115922637033,115922637038,5,2784,2832,-10
115931096754,115931096754,0,1536,1669,-10
115932276855,115932276857,2,1291,1674,-10
115932391554,115932391559,5,1416,1161,-10
115933437094,115933437113,19,189,507,-10
115934074548,115934074551,3,1368,1551,-10
115935315575,115935315575,0,1222,1196,-10
115936664730,115936664731,1,1686,1979,-10
115940020056,115940020058,2,1805,1745,-10
115942306693,115942306696,3,1464,1521,-10
115946022331,115946022330,-1,1134,1036,-10
115949197313,115949197307,-6,1320,4816,-10
115950360866,115950360870,4,2065,1112,-10
115952014970,115952014971,1,1824,1553,-10
115954232857,115954232858,1,1367,1617,-10
115954959657,115954959653,-4,581,2164,-10
115957655717,115957655718,1,2028,2390,-10
115958596639,115958596649,10,9890,31497,-10
115961238123,115961238125,2,1347,1449,-10
115966088135,115966088137,2,1562,1885,-10
115967558927,115967558930,3,2099,1872,-10
115969600776,115969600779,3,1646,1914,-10
115976830925,115976830926,1,1159,1826,-10
115978124184,115978124186,2,1451,1784,-10
115978269617,115978269619,2,1976,1783,-10
115983187584,115983187585,1,1293,1573,-10
115983790013,115983790014,1,1355,1546,-10
115984035693,115984035691,-2,2068,3372,-10
115984498682,115984498685,3,1796,1642,-10
115987748461,115987748464,3,1608,1767,-10
115989649796,115989649797,1,1742,1613,-10
115990882382,115990882383,1,1844,1378,-10
115992103350,115992103351,1,47431,62529,-10
115992213484,115992213502,18,1301,1351,-10
115993358697,115993358698,1,1297,1823,-10
115993437822,115993437823,1,747,1202,-10
115994117134,115994117136,2,1200,986,-10
115995560670,115995560677,7,4695,2046,-10
115998116212,115998116212,0,1825,2050,-10
116000193726,116000193727,1,1208,1326,-10
116001568491,116001568493,2,1590,1496,-10
116002970745,116002970745,0,1243,2034,-10
116015557829,116015557831,2,1256,1846,-10
116018371217,116018371217,0,1761,2090,-10
116018768007,116018768010,3,1167,1843,-10
116020256282,116020256282,0,1330,1288,-10
116022697021,116022697023,2,1440,811,-10
116026248904,116026248907,3,1862,1417,-10
116026810341,116026810346,5,3678,1510,-10
116028237778,116028237780,2,1776,1340,-10
116028777330,116028777333,3,1826,1417,-10
116030144886,116030144883,-3,288,663,-10
116030227785,116030227786,1,940,439,-10
116030601637,116030601638,1,1312,939,-10
116032882150,116032882150,0,1318,1493,-10
116035257660,116035257642,-18,1320,1975,-10
116035555895,116035555894,-1,2021,2396,-10
116035631597,116035631599,2,1848,1739,-10
116035801206,116035801209,3,1651,1500,-10
116036986922,116036986923,1,1533,1342,-10
116040784458,116040784459,1,1421,1090,-10
116041359859,116041359864,5,1682,1452,-10
116047542602,116047542603,1,1393,1127,-10
116048731733,116048731733,0,1434,2250,-10
116053800450,116053800450,0,903,1491,-10
116054105909,116054105911,2,1077,1425,-10
116056475722,116056475726,4,1217,928,-10
116056985460,116056985460,0,1429,1706,-10
116060026493,116060026493,0,1066,1278,-10
116061542560,116061542563,3,1181,1241,-10
116062299319,116062299321,2,2031,1974,-10
116066042275,116066042277,2,8083,19754,-10
116066459247,116066459262,15,9121,56000,-10
116067232946,116067232951,5,2286,1018,-10
116070721311,116070721316,5,2150,1236,-10
116071880582,116071880585,3,1214,1858,-10
116071951396,116071951397,1,1235,1407,-10
116076811390,116076811391,1,1204,1499,-10
116076914649,116076914652,3,41196,32667,-10
116077022900,116077022902,2,2007,960,-10
116081242043,116081242037,-6,1763,5154,-10
116084317337,116084317338,1,1489,1476,-10
116084530900,116084530901,1,1516,1340,-10
116084889752,116084889754,2,2098,1835,-10
116087000309,116087000310,1,1373,1136,-10
116088291243,116088291247,4,1708,1528,-10
116091901979,116091901979,0,2033,1460,-10
116093795142,116093795145,3,1564,1365,-10
116093996526,116093996531,5,1792,851,-10
116094580731,116094580714,-17,1516,896,-10
116100362770,116100362771,1,1315,1463,-10
116101851261,116101851261,0,1968,2247,-10
116104617742,116104617747,5,1688,1503,-10
116106126497,116106126498,1,1067,1902,-10
116107495626,116107495626,0,1249,1159,-10
116112865521,116112865523,2,2118,1702,-10
116113031850,116113031852,2,1619,1544,-10
116117644903,116117644907,4,1107,910,-10
116119225642,116119225645,3,1514,1638,-10
116119729037,116119729038,1,1413,1172,-10
116122976134,116122976137,3,1669,1959,-10
116126903298,116126903301,3,2274,2102,-10
116129009687,116129009688,1,1464,1813,-10
116132898449,116132898451,2,2397,2004,-10
116133132408,116133132411,3,1673,1072,-10
116137345287,116137345290,3,1401,1947,-10
116140282987,116140282989,2,2347,1840,-10
116143844130,116143844130,0,2071,1256,-10
116145405730,116145405738,8,5614,2160,-10
116145643877,116145643878,1,1603,1648,-10
116146469994,116146469996,2,1492,1661,-10
116148511269,116148511272,3,1598,1164,-10
116148685462,116148685464,2,1664,1759,-10
116155564695,116155564697,2,1322,1440,-10
116155709889,116155709892,3,1530,1353,-10
116160341487,116160341488,1,1605,1878,-10
116166413802,116166413804,2,2261,1908,-10
116166809610,116166809612,2,1159,1261,-10
116172081329,116172081326,-3,1403,2296,-10
116178778483,116178778483,0,643,975,-10
116183722647,116183722649,2,1355,1268,-10
116183950446,116183950446,0,1278,2053,-10
116185134158,116185134163,5,1898,1615,-10
116185980476,116185980475,-1,1490,1131,-10
116186816414,116186816416,2,1506,1212,-10
116188012048,116188012046,-2,1461,1736,-10
116188254538,116188254542,4,1317,1648,-10
116189961197,116189961200,3,2151,2381,-10
116190295146,116190295147,1,1370,1332,-10
116190867446,116190867449,3,1859,1303,-10
116191868719,116191868721,2,1835,2170,-10
116197164241,116197164242,1,1172,1590,-10
116200006840,116200006843,3,1318,1647,-10
116200816390,116200816391,1,1331,1848,-10
116200874527,116200874532,5,1957,1277,-10
116203091370,116203091374,4,1365,1732,-10
116203124337,116203124339,2,899,841,-10
116204296844,116204296846,2,1616,1451,-10
116205197251,116205197249,-2,1652,1469,-10
116206623376,116206623378,2,1622,1327,-10
116206846799,116206846801,2,980,950,-10
116209009268,116209009269,1,1524,1654,-10
116211042934,116211042937,3,1853,1839,-10
116211675203,116211675203,0,955,1511,-10
116215033473,116215033475,2,1054,1172,-10
116215912387,116215912387,0,1425,1496,-10
116221776878,116221776873,-5,959,3591,-10
116222813203,116222813206,3,1337,1716,-10
116225876005,116225876007,2,1833,1177,-10
116226999361,116226999363,2,1986,1608,-10
116227109758,116227109758,0,2183,1615,-10
116229876414,116229876417,3,1499,1712,-10
116231278082,116231278086,4,2147,2072,-10
116233175795,116233175795,0,812,1363,-10
116233872099,116233872097,-2,1004,2621,-10
116236616833,116236616835,2,2131,1596,-10
116237165497,116237165504,7,15291,26925,-10
116242873240,116242873242,2,1554,1466,-10
116244339864,116244339866,2,2189,1453,-10
116246819766,116246819766,0,1441,1835,-10
116250220117,116250220120,3,827,1300,-10
116253933580,116253933582,2,1642,1844,-10
116255173281,116255173283,2,1896,1308,-10
116256660530,116256660530,0,1105,823,-10
116259534062,116259534065,3,1788,1692,-10
116261735903,116261735903,0,1337,1279,-10
116264604711,116264604713,2,1033,888,-10
116268207458,116268207461,3,1381,1489,-10
116271668227,116271668229,2,1555,1450,-10
116272250278,116272250279,1,1982,1746,-10
116273347623,116273347618,-5,1150,1148,-10
116275361882,116275361882,0,1720,1759,-10
116277981469,116277981471,2,1595,2243,-10
116279056650,116279056655,5,2012,1024,-10
116280728566,116280728567,1,1740,1349,-10
116281698723,116281698726,3,2091,1606,-10
116282200417,116282200419,2,1241,1729,-10
116283467813,116283467813,0,2008,2232,-10
116283865672,116283865674,2,1851,1441,-10
116285157766,116285157766,0,1601,1374,-10
116301506933,116301506934,1,2004,1494,-10
116301581305,116301581306,1,1231,1165,-10
116302041769,116302041772,3,1604,1574,-10
116303935747,116303935750,3,1885,1448,-10
116304793176,116304793177,1,1562,1112,-10
116305162481,116305162483,2,1766,1195,-10
116306951497,116306951499,2,1741,1230,-10
116310214731,116310214731,0,1760,1462,-10
116311373206,116311373208,2,1636,1306,-10
116312015421,116312015423,2,1371,1502,-10
116313522532,116313522533,1,1425,1237,-10
116313822154,116313822156,2,1612,1628,-10
116315865842,116315865844,2,2317,1893,-10
116317375423,116317375424,1,1462,1382,-10
116319412968,116319412969,1,1691,1336,-10
116324111314,116324111315,1,1467,1471,-10
116324445115,116324445105,-10,28927,19030,-10
116325538438,116325538442,4,1715,1460,-10
116328281552,116328281554,2,1564,1558,-10
116329684740,116329684734,-6,2148,5950,-10
116329941509,116329941510,1,2164,1494,-10
116330017851,116330017852,1,2141,2028,-10
116330131969,116330131971,2,1595,1613,-10
116331968473,116331968485,12,890,999,-10
116332563442,116332563443,1,1502,1689,-10
116335312021,116335312023,2,2070,1905,-10
116335833887,116335833890,3,1048,1179,-10
116336208360,116336208362,2,1193,1346,-10
116336698082,116336698064,-18,5320,2138,-10
116336974590,116336974593,3,1573,1524,-10
116337269839,116337269841,2,1237,1599,-10
116340036466,116340036473,7,3001,1281,-10
116341264908,116341264909,1,1817,1758,-10
116342040606,116342040606,0,1214,2033,-10
116343950159,116343950162,3,1308,1824,-10
116345247351,116345247354,3,1554,1465,-10
116347544406,116347544407,1,1015,862,-10
116352709046,116352709048,2,1488,1544,-10
116357346687,116357346688,1,2010,1335,-10
116358903839,116358903842,3,1686,1563,-10
116359346634,116359346629,-5,823,1544,-10
116359909274,116359909274,0,1176,1608,-10
116360935026,116360935029,3,1214,1267,-10
116364780438,116364780441,3,1393,1806,-10
116367912945,116367912946,1,1777,2006,-10
116368458896,116368458917,21,1034,930,-10
116370731280,116370731282,2,1445,1264,-10
116371729010,116371728989,-21,1811,1575,-10
116373552533,116373552535,2,1441,1621,-10
116375801218,116375801219,1,1507,1845,-10
116378451837,116378451839,2,1710,1568,-10
116382251397,116382251399,2,1418,1694,-10
116382714552,116382714553,1,1839,1950,-10
116383711313,116383711313,0,1378,1199,-10
116385136845,116385136846,1,1458,1271,-10
116387712490,116387712485,-5,1337,4917,-10
116390356753,116390356754,1,2007,1193,-10
116391972209,116391972211,2,1447,1658,-10
116394523336,116394523338,2,1896,2414,-10
116398715013,116398715015,2,1736,1240,-10
116399644244,116399644227,-17,1902,841,-10
116402561975,116402561976,1,1952,2395,-10
116402925808,116402925810,2,1208,1261,-10
116404531382,116404531382,0,1574,1317,-10
116408688739,116408688740,1,1229,1028,-10
116411306828,116411306830,2,2099,2037,-10
116412539810,116412539812,2,1760,1421,-10
116413467030,116413467031,1,1550,1836,-10
116416060317,116416060321,4,1435,609,-10
116417307488,116417307488,0,1928,2072,-10
116417442526,116417442528,2,1567,1384,-10
116420980816,116420980817,1,1922,1450,-10
116423027961,116423027962,1,1432,1383,-10
116423370765,116423370767,2,1144,1391,-10
116425053896,116425053896,0,1528,1429,-10
116426479999,116426480002,3,1321,1509,-10
116426978700,116426978690,-10,2,848,-10
116428239722,116428239724,2,1510,1113,-10
116433290734,116433290734,0,1366,1154,-10
116433802288,116433802290,2,1888,1827,-10
116434873975,116434873978,3,1848,1605,-10
116439542590,116439542592,2,2092,1866,-10
116440638203,116440638202,-1,1939,1947,-10
116441915887,116441915887,0,1764,1945,-10
116443188001,116443188005,4,1631,1473,-10
116443504222,116443504224,2,1773,1592,-10
116444484801,116444484803,2,1415,1273,-10
116445336769,116445336771,2,1610,2341,-10
116445992863,116445992865,2,1723,1665,-10
116446145869,116446145870,1,1236,1200,-10
116448676652,116448676654,2,1472,1162,-10
116453444189,116453444190,1,1605,1397,-10
116458160275,116458160277,2,1632,1353,-10
116461114945,116461114950,5,3609,1929,-10
116462412565,116462412545,-20,1043,1214,-10
116463432092,116463432109,17,15669,31108,-10
116464195842,116464195845,3,2520,2437,-10
116466508304,116466508306,2,1071,1361,-10
116467659831,116467659832,1,1459,1119,-10
116468397609,116468397611,2,1529,1189,-10
116473088018,116473088020,2,941,1816,-10
116475096725,116475096725,0,1494,1563,-10
116478884359,116478884362,3,1606,1127,-10
116481750266,116481750266,0,1479,1286,-10
116485647466,116485647466,0,1476,1406,-10
116487157952,116487157954,2,2015,1812,-10
116490367333,116490367337,4,2213,1189,-10
116491870006,116491870008,2,1427,1848,-10
116491973001,116491973002,1,1217,1593,-10
116493256534,116493256538,4,1771,1789,-10
116494077610,116494077613,3,2062,1990,-10
116494107826,116494107827,1,1489,1558,-10
116497753035,116497753037,2,1637,1547,-10
116502465064,116502465066,2,2017,1937,-10
116504017433,116504017433,0,1297,1591,-10
116505395504,116505395506,2,1377,1293,-10
116513359685,116513359687,2,1539,1701,-10
116514034462,116514034462,0,1452,1345,-10
116515103099,116515103094,-5,1188,2565,-10
116518950830,116518950833,3,1786,1418,-10
116521286816,116521286817,1,2987,2033,-10
116522960149,116522960150,1,1565,1696,-10
116523071043,116523071044,1,705,1044,-10
116526756880,116526756879,-1,1506,1450,-10
116529814529,116529814529,0,935,1343,-10
116532780787,116532780790,3,1726,2298,-10
116533528699,116533528699,0,1015,914,-10
116536243729,116536243737,8,10021,25950,-10
116543322022,116543322026,4,1171,1308,-10
116544453434,116544453435,1,1382,1337,-10
116549823388,116549823390,2,2161,1475,-10
116562201914,116562201917,3,1373,1438,-10
116568614089,116568614090,1,1264,953,-10
116568812323,116568812323,0,1281,1332,-10
116569970024,116569970026,2,2512,1745,-10
116572926874,116572926876,2,1428,1476,-10
116573580832,116573580831,-1,1199,1959,-10
116575219658,116575219659,1,1712,2349,-10
116580196974,116580196975,1,912,1004,-10
116582493138,116582493143,5,2038,1430,-10
116584089810,116584089814,4,1426,1321,-10
116585410143,116585410144,1,1499,1517,-10
116591929025,116591929026,1,1199,1538,-10
116593511289,116593511293,4,1755,1458,-10
116601570378,116601570381,3,1192,1266,-10
116603422286,116603422289,3,1571,1571,-10
116610434957,116610434962,5,1908,1582,-10
116611214244,116611214244,0,1673,1520,-10
116612305226,116612305232,6,2198,1049,-10
116612731290,116612731293,3,1475,2081,-10
116616131331,116616131333,2,1475,1059,-10
116618462683,116618462684,1,1556,2054,-10
116619084240,116619084243,3,1298,876,-10
116620928209,116620928210,1,1171,1407,-10
116622472417,116622472419,2,992,1035,-10
116634835844,116634835865,21,2009,1841,-10
116636968838,116636968839,1,1747,1483,-10
116639347975,116639347975,0,891,1189,-10
116645223152,116645223157,5,1471,785,-10
116646839902,116646839907,5,1034,1137,-10
116648165114,116648165117,3,2584,2031,-10
116650111571,116650111573,2,1842,1797,-10
116650513256,116650513257,1,891,935,-10
116654048208,116654048209,1,1311,1755,-10
116654977622,116654977624,2,1513,1879,-10
116657811766,116657811769,3,1876,1712,-10
116658458178,116658458182,4,1683,1642,-10
116659858387,116659858390,3,1541,1512,-10
116661962054,116661962057,3,2307,1984,-10
116663041898,116663041898,0,11831,15911,-10
116666827381,116666827381,0,1459,1526,-10
116670133700,116670133698,-2,1400,1931,-10
116677292902,116677292905,3,1620,1779,-10
116678752562,116678752564,2,1450,1520,-10
116679165628,116679165633,5,1470,1085,-10
116680775886,116680775888,2,1988,1755,-10
116682423686,116682423707,21,1426,2826,-10
116682627560,116682627561,1,1493,1186,-10
116683506755,116683506734,-21,1769,1172,-10
116688917379,116688917380,1,1280,1355,-10
116689050806,116689050811,5,1413,1270,-10
116691670566,116691670567,1,1876,1455,-10
116691738911,116691738914,3,1933,1465,-10
116697363673,116697363674,1,1670,2407,-10
116697704090,116697704090,0,1661,1470,-10
116700714844,116700714843,-1,1095,1455,-10
116702818714,116702818718,4,1104,1370,-10
116706506576,116706506579,3,1354,1679,-10
116709361390,116709361385,-5,1063,5477,-10
116714723414,116714723414,0,894,920,-10
116719747439,116719747438,-1,1005,1888,-10
116721200456,116721200458,2,2141,2259,-10
116722559986,116722559990,4,2148,1633,-10
116726074234,116726074237,3,1622,1121,-10
116729083493,116729083496,3,1380,1693,-10
116731325885,116731325887,2,1363,1191,-10
116733813861,116733813863,2,1871,1588,-10
116738558622,116738558625,3,1524,1067,-10
116747692162,116747692165,3,2363,1821,-10
116747952388,116747952391,3,1696,1823,-10
116752073412,116752073414,2,1744,1829,-10
116752932201,116752932202,1,1746,1353,-10
116753441745,116753441747,2,2160,1661,-10
116754783674,116754783670,-4,1141,3108,-10
116755138759,116755138759,0,1960,1688,-10
116757754196,116757754194,-2,1833,1892,-10
116758229863,116758229862,-1,1031,1702,-10
116759156201,116759156203,2,1513,1014,-10
116760092086,116760092087,1,3173,4593,-10
116767499030,116767499034,4,1206,904,-10
116769697946,116769697947,1,1846,1401,-10
116772820063,116772820071,8,8498,2622,-10
116773993185,116773993183,-2,1294,1333,-10
116774341018,116774341013,-5,1653,1933,-10
116774608406,116774608409,3,1447,1163,-10
116776964897,116776964899,2,1177,1573,-10
116778973890,116778973890,0,1378,1708,-10
116780249291,116780249292,1,1329,1824,-10
116781814985,116781814986,1,1596,1904,-10
116782548991,116782548990,-1,1274,779,-10
116786595116,116786595122,6,1223,1178,-10
116790210522,116790210522,0,1655,1860,-10
116791068881,116791068884,3,1653,1805,-10
116791431149,116791431150,1,1147,1375,-10
116791504225,116791504215,-10,1157,1033,-10
116792196317,116792196318,1,1736,1314,-10
116792936706,116792936708,2,1492,1643,-10
116793215170,116793215178,8,1106,969,-10
116800673042,116800673043,1,1569,1663,-10
116800817502,116800817505,3,1605,1406,-10
116802319548,116802319549,1,1535,2094,-10
116804761338,116804761337,-1,782,1139,-10
116806427412,116806427411,-1,1511,1710,-10
116808363216,116808363203,-13,1360,1056,-10
116809275786,116809275788,2,1585,1539,-10
116810357934,116810357935,1,1220,1442,-10
116817457718,116817457718,0,1263,1806,-10
116817717878,116817717880,2,1782,1547,-10
116818322809,116818322809,0,1580,1188,-10
116821053926,116821053929,3,1889,1580,-10
116821280739,116821280754,15,1948,1758,-10
116823023341,116823023343,2,1056,1159,-10
116824286706,116824286706,0,1716,1825,-10
116832302169,116832302172,3,1701,1418,-10
116834310319,116834310321,2,1738,2203,-10
116835163128,116835163127,-1,1400,1904,-10
116835621181,116835621182,1,1507,1413,-10
116837770570,116837770570,0,519,406,-10
116838731635,116838731633,-2,1377,1613,-10
116842124323,116842124315,-8,6011,16950,-10
116843285974,116843285973,-1,2582,4462,-10
116845556018,116845556022,4,1310,1384,-10
116847511797,116847511801,4,1636,1738,-10
116848414174,116848414175,1,1302,1932,-10
116848560492,116848560498,6,2427,1362,-10
116849282250,116849282250,0,1530,1622,-10
116853398787,116853398789,2,1162,1358,-10
116855378541,116855378542,1,1868,1340,-10
116856189136,116856189140,4,1536,1831,-10
116856400172,116856400191,19,1242,1841,-10
116858283411,116858283414,3,2605,1053,-10
116859593179,116859593185,6,1908,1318,-10
116860224149,116860224168,19,1244,1379,-10
116865686791,116865686794,3,1912,1499,-10
116866067617,116866067618,1,1831,1448,-10
116866325228,116866325231,3,2206,1854,-10
116867781854,116867781856,2,1443,1475,-10
116869092253,116869092255,2,1839,1427,-10
116872771332,116872771334,2,2098,1533,-10
116876576606,116876576607,1,1669,1369,-10
116878651676,116878651679,3,1633,1239,-10
116881650277,116881650270,-7,1277,5346,-10
116883929629,116883929629,0,1345,1660,-10
116884292054,116884292055,1,2015,1652,-10
116884836823,116884836829,6,1024,1033,-10
116886901306,116886901308,2,1333,1500,-10
116888496598,116888496593,-5,2035,6194,-10
116892464324,116892464325,1,1812,1720,-10
116894049476,116894049479,3,2090,2188,-10
116896324735,116896324737,2,1223,1227,-10
116896697707,116896697708,1,1425,1519,-10
116896847077,116896847077,0,1023,1344,-10
116902095781,116902095785,4,1642,748,-10
116905968930,116905968931,1,2489,2019,-10
116908864110,116908864110,0,1899,1259,-10
116909849038,116909849040,2,1534,1980,-10
116912535684,116912535690,6,37593,6806,-10
116913275186,116913275186,0,2381,1810,-10
116920562537,116920562539,2,1735,1597,-10
116921163195,116921163197,2,1651,1664,-10
116927815442,116927815445,3,1506,1511,-10
116928761115,116928761119,4,1833,1428,-10
116929063102,116929063102,0,1053,1103,-10
116931998592,116931998595,3,1908,1737,-10
116932287411,116932287413,2,1927,1502,-10
116932332290,116932332293,3,1449,1215,-10
116932690571,116932690574,3,1035,1455,-10
116932790538,116932790540,2,1747,1560,-10
116934885910,116934885913,3,2116,1250,-10
116935583286,116935583286,0,1534,2495,-10
116938701137,116938701138,1,1929,1847,-10
116939912935,116939912937,2,1502,1573,-10
116942428085,116942428085,0,2055,1478,-10
116943516947,116943516950,3,915,923,-10
116943989900,116943989901,1,1629,1693,-10
116944781074,116944781076,2,1482,1494,-10
116945172853,116945172855,2,1611,1556,-10
116946366158,116946366161,3,2706,1972,-10
116948515563,116948515562,-1,1465,1343,-10
116950557381,116950557382,1,1706,1888,-10
116951806547,116951806549,2,1632,1016,-10
116951964655,116951964632,-23,1210,1362,-10
116952603047,116952603047,0,689,1547,-10
116954112629,116954112646,17,17469,53374,-10
116955322187,116955322186,-1,889,1097,-10
116957390890,116957390893,3,1858,1603,-10
116958452446,116958452441,-5,950,2674,-10
116961580845,116961580845,0,1252,1527,-10
116964037094,116964037092,-2,1366,2070,-10
116964728363,116964728365,2,1922,1887,-10
116965491345,116965491346,1,1757,1713,-10
116967167042,116967167042,0,1159,1342,-10
116967931574,116967931571,-3,1442,1058,-10
116975701085,116975701085,0,1530,1439,-10
116976243123,116976243122,-1,1326,1524,-10
116979032982,116979032978,-4,799,2743,-10
116979448047,116979448047,0,1562,1441,-10
116980992953,116980992957,4,1485,1768,-10
116983676953,116983676954,1,1188,1268,-10
116986161933,116986161931,-2,46915,18958,-10
116988884033,116988884034,1,1922,2160,-10
116990133582,116990133583,1,1081,1002,-10
116990276898,116990276900,2,1943,1403,-10
116991494482,116991494482,0,1179,1291,-10
116993098917,116993098923,6,1786,1350,-10
116994570782,116994570786,4,1741,1543,-10
116994637059,116994637062,3,1151,1402,-10
116997821830,116997821833,3,1624,1181,-10
116997878821,116997878822,1,1712,2091,-10
116999027406,116999027409,3,1431,1484,-10
117000390657,117000390660,3,1712,1208,-10
117001906994,117001906997,3,1945,1445,-10
117003954151,117003954154,3,1687,1524,-10
117005669218,117005669221,3,1091,961,-10
117007170683,117007170688,5,1997,1506,-10
117009931730,117009931734,4,1638,1074,-10
117012230762,117012230765,3,1585,1463,-10
117013329525,117013329524,-1,1862,1531,-10
117019743977,117019743978,1,1844,1852,-10
117020862378,117020862382,4,1646,1284,-10
117026244942,117026244946,4,1617,1362,-10
117026637349,117026637350,1,1171,1604,-10
117029427992,117029427992,0,1875,2506,-10
117031269686,117031269688,2,1121,1382,-10
117031822830,117031822831,1,1591,1780,-10
117033147371,117033147373,2,1854,1076,-10
117033879697,117033879700,3,2011,1804,-10
117034955008,117034955010,2,2317,2190,-10
117035576546,117035576546,0,1956,2816,-10
117037149802,117037149801,-1,1692,2401,-10
117040214316,117040214313,-3,714,1458,-10
117043362097,117043362098,1,1498,1589,-10
117043517009,117043517010,1,1551,1710,-10
117046635109,117046635113,4,1701,1349,-10
117050123293,117050123297,4,1546,1613,-10
117050898795,117050898796,1,1418,831,-10
117054393479,117054393479,0,1276,1221,-10
117059006698,117059006701,3,1594,1817,-10
117063067006,117063067005,-1,1356,1549,-10
117064088635,117064088634,-1,928,1280,-10
117065651832,117065651835,3,1595,992,-10
117066203075,117066203083,8,386,177,-10
117066834226,117066834226,0,1520,1324,-10
117066975290,117066975284,-6,837,3611,-10
117071811290,117071811294,4,1500,1389,-10
117072062651,117072062651,0,806,1117,-10
117075379710,117075379710,0,2209,1938,-10
117080571546,117080571545,-1,1426,1580,-10
117086434085,117086434084,-1,1510,1962,-10
117091226617,117091226618,1,1117,1370,-10
117095334605,117095334598,-7,1077,4755,-10
117096632451,117096632453,2,1334,1658,-10
117098447247,117098447250,3,1277,1553,-10
117099295378,117099295380,2,1677,1708,-10
117099618425,117099618425,0,1370,1300,-10
117101006505,117101006506,1,1914,1711,-10
117102040382,117102040384,2,1834,1362,-10
117103533849,117103533850,1,1449,1590,-10
117106115046,117106115047,1,1529,1867,-10
117106401982,117106401985,3,1166,1211,-10
117106522532,117106522533,1,1657,1483,-10
117107679694,117107679697,3,1410,1218,-10
117109218553,117109218554,1,1704,1513,-10
117115519630,117115519632,2,2066,1946,-10
117116230865,117116230868,3,1558,1745,-10
117121904994,117121904994,0,1528,1788,-10
117123468150,117123468148,-2,1677,1103,-10
117125901445,117125901447,2,1126,1392,-10
117129794490,117129794490,0,1367,1196,-10
117130248948,117130248947,-1,1278,1537,-10
117130454462,117130454465,3,1655,1360,-10
117131323465,117131323484,19,1516,1373,-10
117132026004,117132026007,3,2122,1619,-10
117133164275,117133164278,3,1390,1484,-10
117135203330,117135203333,3,1368,1165,-10
117135727902,117135727903,1,1549,1737,-10
117138768477,117138768478,1,1521,1358,-10
117139109914,117139109923,9,1413,1185,-10
117140395790,117140395791,1,1416,1383,-10
117140607591,117140607594,3,1338,1258,-10
117141774697,117141774699,2,1434,1708,-10
117142497017,117142497018,1,1161,1356,-10
117143451719,117143451722,3,1125,831,-10
117147050230,117147050232,2,1448,1517,-10
117149916749,117149916750,1,2217,1755,-10
117150872286,117150872285,-1,1484,1502,-10
117156942837,117156942839,2,1225,1124,-10
117159784535,117159784537,2,2030,1527,-10
117160193851,117160193854,3,1259,1553,-10
117166374643,117166374644,1,1754,1640,-10
117168124495,117168124494,-1,1461,1428,-10
117169101405,117169101406,1,805,860,-10
117173596582,117173596585,3,1313,1617,-10
117175664370,117175664371,1,1199,1305,-10
117177293818,117177293813,-5,2613,6856,-10
117179481703,117179481705,2,1535,1202,-10
117185169977,117185169977,0,1117,1181,-10
117189597071,117189597070,-1,1651,1971,-10
117193110865,117193110867,2,2120,1832,-10
117195122393,117195122394,1,1978,1343,-10
117202832209,117202832210,1,1026,1566,-10
117206433255,117206433257,2,2028,1582,-10
117207600033,117207600035,2,1282,703,-10
117208617996,117208617997,1,1125,1274,-10
117210083061,117210083062,1,1962,1946,-10
117210815422,117210815423,1,1549,1539,-10
117213199955,117213199956,1,1408,1473,-10
117218123901,117218123899,-2,1489,3386,-10
117219115174,117219115175,1,1411,1376,-10
117224438862,117224438861,-1,1513,2390,-10
117225764723,117225764729,6,1670,1272,-10
117226659148,117226659151,3,1385,1624,-10
117231717905,117231717905,0,1813,1824,-10
117235333860,117235333863,3,1389,1375,-10
117237493086,117237493088,2,1487,1097,-10
117238686950,117238686953,3,1692,1714,-10
117239847747,117239847750,3,2607,1966,-10
117241538054,117241538055,1,1691,1441,-10
117242160586,117242160586,0,1827,1903,-10
117243041298,117243041298,0,1079,1042,-10
117244641302,117244641300,-2,1225,1964,-10
117247350410,117247350410,0,1353,1748,-10
117250983366,117250983368,2,1849,1638,-10
117253801657,117253801659,2,983,796,-10
117260202697,117260202699,2,1764,1810,-10
117263024502,117263024505,3,1708,1866,-10
117263868095,117263868097,2,2107,2326,-10
117265988354,117265988354,0,1400,1657,-10
117273542769,117273542770,1,1161,1798,-10
117274492950,117274492949,-1,1337,1303,-10
117274774866,117274774875,9,1690,1038,-10
117276561080,117276561082,2,1276,1407,-10
117278838319,117278838320,1,1359,2058,-10
117279612401,117279612402,1,1441,1291,-10
117290872659,117290872661,2,1496,1429,-10
117291175390,117291175370,-20,1846,1181,-10
117294312398,117294312402,4,1294,979,-10
117295632158,117295632161,3,1385,1604,-10
117296944354,117296944355,1,1148,1205,-10
117305056495,117305056492,-3,1710,1771,-10
117305384106,117305384110,4,1286,1328,-10
117309665971,117309665973,2,1388,1550,-10
117314978899,117314978897,-2,1764,2319,-10
117316394301,117316394302,1,2544,2758,-10
117319164096,117319164096,0,1668,1838,-10
117321457383,117321457364,-19,1602,1599,-10
117322324019,117322324027,8,4393,1232,-10
117322674802,117322674803,1,3405,2444,-10
117323146173,117323146175,2,1497,1240,-10
117323689182,117323689186,4,1876,952,-10
117325080925,117325080930,5,1458,1223,-10
117327457998,117327458001,3,1505,927,-10
117328450842,117328450845,3,1482,1183,-10
117328857794,117328857794,0,1626,1970,-10
117329619906,117329619909,3,2122,1424,-10
117334350594,117334350596,2,1744,1367,-10
117334417019,117334417000,-19,888,865,-10
117336779252,117336779254,2,1770,1332,-10
117338113782,117338113784,2,1745,1743,-10
117338408739,117338408743,4,1370,1859,-10
117340095446,117340095450,4,826,1031,-10
117341142095,117341142097,2,2518,2547,-10
117342554634,117342554638,4,1475,1298,-10
117343454650,117343454654,4,1649,1195,-10
117351429973,117351429974,1,808,968,-10
117351458312,117351458305,-7,1780,1927,-10
117351958076,117351958079,3,1823,1417,-10
117355295557,117355295558,1,1607,1506,-10
117360228870,117360228870,0,1596,1594,-10
117360650357,117360650358,1,2052,1625,-10
117362737142,117362737142,0,1009,1427,-10
117365844455,117365844458,3,2415,1759,-10
117366184666,117366184670,4,1654,1466,-10
117367628036,117367628035,-1,1522,2030,-10
117374171235,117374171237,2,1682,1583,-10
117375709819,117375709823,4,1701,1398,-10
117376515691,117376515690,-1,911,1933,-10
117378736426,117378736428,2,985,1156,-10
117379784320,117379784311,-9,1619,1190,-10
117381002730,117381002731,1,1677,1588,-10
117381634016,117381634018,2,912,1411,-10
117382569566,117382569569,3,1707,1381,-10
117384835253,117384835255,2,1686,1616,-10
117386515755,117386515763,8,2021,1001,-10
117387004932,117387004933,1,1866,1410,-10
117394625921,117394625922,1,1522,1827,-10
117395303078,117395303080,2,1152,1181,-10
117395938246,117395938250,4,1194,914,-10
117396217018,117396217020,2,1362,1365,-10
117396373139,117396373142,3,1286,1309,-10
117397554070,117397554071,1,1215,1341,-10
117400277629,117400277630,1,1455,1163,-10
117401141496,117401141498,2,1407,1691,-10
117407929645,117407929638,-7,988,3956,-10
117409733140,117409733143,3,1818,1748,-10
117410226317,117410226320,3,1647,2116,-10
117413027723,117413027725,2,1368,1418,-10
117414908164,117414908166,2,1526,1445,-10
117415980351,117415980353,2,1675,1546,-10
117416843174,117416843174,0,2368,2112,-10
117417240491,117417240493,2,1661,2045,-10
117418290411,117418290413,2,1621,2042,-10
117418900846,117418900847,1,1292,1405,-10
117419716823,117419716823,0,1900,2072,-10
117429713080,117429713083,3,1729,2035,-10
117429806664,117429806669,5,9524,35504,-10
117431158283,117431158285,2,1841,1279,-10
117432317108,117432317111,3,2274,1983,-10
117432914401,117432914402,1,1499,1426,-10
117433399497,117433399502,5,1847,766,-10
117441516807,117441516811,4,1415,1298,-10
117441796479,117441796480,1,1360,1666,-10
117442762430,117442762410,-20,1167,993,-10
117444862403,117444862405,2,974,1478,-10
117447062418,117447062422,4,1093,974,-10
117451066957,117451066960,3,1713,2064,-10
117453716074,117453716075,1,1655,2270,-10
117455022408,117455022410,2,1242,1449,-10
117455134778,117455134782,4,1442,1961,-10
117455560458,117455560461,3,1971,1272,-10
117455857019,117455857019,0,1899,1903,-10
117456269206,117456269206,0,1509,1587,-10
117457429280,117457429282,2,1510,1666,-10
117458975952,117458975953,1,1498,1496,-10
117459201101,117459201103,2,1136,1402,-10
117461201793,117461201794,1,1872,1306,-10
117461684651,117461684653,2,1488,1268,-10
117463768302,117463768303,1,1524,1380,-10
117466104889,117466104890,1,1446,802,-10
117469235237,117469235239,2,1388,1698,-10
117471366778,117471366781,3,2036,1585,-10
117472771809,117472771811,2,1720,1680,-10
117477503495,117477503498,3,2761,2260,-10
117478768401,117478768405,4,2400,1222,-10
117479651365,117479651365,0,2143,1698,-10
117484547207,117484547203,-4,1507,5235,-10
117486633410,117486633411,1,1165,1319,-10
117488344758,117488344758,0,1611,1738,-10
117490390225,117490390234,9,8494,42489,-10
117494346562,117494346565,3,1894,1455,-10
117494411890,117494411891,1,1646,1371,-10
117495512632,117495512633,1,2513,1677,-10
117499005453,117499005455,2,1310,1564,-10
117501055993,117501055987,-6,2312,8447,-10
117501682828,117501682829,1,1780,1832,-10
117501750739,117501750743,4,1244,1769,-10
117504681094,117504681094,0,1816,1706,-10
117505518970,117505518974,4,988,1787,-10
117512257085,117512257088,3,3885,2769,-10
117513970454,117513970455,1,1016,1112,-10
117517681187,117517681188,1,1204,1872,-10
117517807046,117517807049,3,1854,1252,-10
117518898894,117518898895,1,1430,1140,-10
117521225746,117521225749,3,1941,1646,-10
117528043851,117528043853,2,1292,1758,-10
117531868843,117531868845,2,1486,1276,-10
117532728295,117532728299,4,1679,1155,-10
117536807597,117536807599,2,1745,1782,-10
117538610532,117538610534,2,2287,1162,-10
117539114658,117539114662,4,2044,1607,-10
117539443539,117539443542,3,1115,779,-10
117542128160,117542128163,3,1620,1318,-10
117543195340,117543195342,2,1659,1386,-10
117545214261,117545214263,2,1364,1329,-10
117549287878,117549287883,5,2292,1414,-10
117549968067,117549968071,4,1162,1354,-10
117550142127,117550142138,11,1195,598,-10
117551152719,117551152720,1,1436,1529,-10
117552514317,117552514314,-3,1142,3649,-10
117553903542,117553903542,0,1708,1994,-10
117556672332,117556672334,2,1156,1271,-10
117557861833,117557861835,2,1627,1369,-10
117563840034,117563840035,1,1663,1567,-10
117564814798,117564814804,6,2749,1141,-10
117568367150,117568367153,3,1452,2051,-10
117569800272,117569800274,2,1300,1569,-10
117572018647,117572018650,3,1373,1418,-10
117572269326,117572269328,2,1388,1396,-10
117572838063,117572838066,3,1846,1677,-10
117578815791,117578815794,3,1506,1333,-10
117584975792,117584975795,3,1446,1330,-10
117586984944,117586984941,-3,1039,989,-10
117588237838,117588237858,20,1420,1392,-10
117590856675,117590856678,3,1714,1544,-10
117590965906,117590965906,0,1188,1229,-10
117595279204,117595279206,2,1500,1622,-10
117595765343,117595765347,4,2275,1822,-10
117597495793,117597495815,22,296,4744,-10
117598287594,117598287596,2,1663,1840,-10
117598691806,117598691807,1,1276,1278,-10
117599201309,117599201309,0,1703,1614,-10
117602484745,117602484749,4,2124,1721,-10
117605877166,117605877164,-2,1039,1542,-10
117609995785,117609995790,5,2399,1687,-10
117611702244,117611702246,2,1585,1061,-10
117613073638,117613073639,1,1609,1378,-10
117614340518,117614340518,0,1862,1865,-10
117614468401,117614468401,0,1953,1641,-10
117617469693,117617469699,6,3777,1675,-10
117621681342,117621681347,5,1532,1194,-10
117625558193,117625558183,-10,25274,17742,-10
117627331775,117627331775,0,907,1266,-10
117630264689,117630264690,1,1658,1631,-10
117633139446,117633139450,4,2052,2001,-10
117635922708,117635922709,1,1193,2000,-10
117636563861,117636563861,0,1877,1615,-10
117637850731,117637850736,5,1274,975,-10
117638031770,117638031772,2,1520,1753,-10
117640049312,117640049314,2,1579,2164,-10
117641624980,117641624982,2,1920,1680,-10
117644409321,117644409326,5,1690,1544,-10
117645284077,117645284098,21,1355,1113,-10
117646590483,117646590482,-1,839,1565,-10
117647365646,117647365649,3,2044,1619,-10
117650181858,117650181858,0,1847,1862,-10
117651346590,117651346592,2,1390,1404,-10
117653630557,117653630558,1,3024,2577,-10
117655448784,117655448786,2,1821,1657,-10
117656319565,117656319570,5,2397,1516,-10
117659679390,117659679395,5,1685,1259,-10
117659829794,117659829801,7,1795,1373,-10
117664892118,117664892120,2,2760,1815,-10
117672185375,117672185377,2,1946,1812,-10
117673055535,117673055536,1,1402,1384,-10
117676788654,117676788657,3,2384,1763,-10
117683939822,117683939821,-1,963,1100,-10
117686713487,117686713489,2,1153,1157,-10
117697173912,117697173912,0,1401,781,-10
117701290225,117701290228,3,1105,1124,-10
117705636140,117705636142,2,2246,2705,-10
117706261238,117706261239,1,1134,1547,-10
117707803802,117707803799,-3,1006,3477,-10
117725425270,117725425270,0,1318,1913,-10
117729374405,117729374406,1,1704,1443,-10
117731201077,117731201077,0,1421,1401,-10
117732592273,117732592274,1,1585,1307,-10
117734220230,117734220231,1,1629,1125,-10
117736342609,117736342610,1,1948,2141,-10
117744227756,117744227757,1,1825,1413,-10
117748722066,117748722067,1,1256,1397,-10
117749653133,117749653131,-2,1346,1799,-10
117749973103,117749973106,3,1454,1389,-10
117760178494,117760178498,4,1422,1230,-10
117761011456,117761011459,3,1102,1236,-10
117766354953,117766354954,1,1078,1227,-10
117767320086,117767320086,0,1193,1763,-10
117768497529,117768497531,2,1952,1362,-10
117768541433,117768541434,1,1581,1007,-10
117772741742,117772741749,7,5590,3426,-10
117775632969,117775632971,2,1557,1388,-10
117777136183,117777136185,2,2682,2079,-10
117777289345,117777289346,1,1291,991,-10
117779773347,117779773348,1,1835,2230,-10
117781204116,117781204118,2,1813,1855,-10
117784161355,117784161356,1,1437,1631,-10
117785902550,117785902554,4,980,1167,-10
117792885566,117792885566,0,1342,1684,-10
117794863702,117794863704,2,909,1306,-10
117796006385,117796006382,-3,1055,2019,-10
117797772714,117797772716,2,1387,1358,-10
117798642519,117798642521,2,1717,1467,-10
117800068207,117800068209,2,1219,1217,-10
117800865999,117800866001,2,1460,1606,-10
117803679224,117803679209,-15,1326,1684,-10
117808119195,117808119197,2,1360,1709,-10
117809689025,117809689027,2,2612,3104,-10
117814791891,117814791895,4,1608,1382,-10
117820010917,117820010917,0,1831,1844,-10
117820731250,117820731254,4,1487,1847,-10
117821576501,117821576515,14,14319,50655,-10
117823164953,117823164955,2,1818,1581,-10
117826045767,117826045770,3,1767,1633,-10
117827068997,117827069001,4,2128,1225,-10
117827416265,117827416259,-6,1650,5976,-10
117831600769,117831600770,1,1637,1291,-10
117836583850,117836583854,4,2481,1734,-10
117836944055,117836944057,2,1917,2103,-10
117837620278,117837620278,0,1437,1429,-10
117838519623,117838519624,1,1591,1578,-10
117839622754,117839622757,3,1843,1474,-10
117840094486,117840094493,7,2758,1803,-10
117840403817,117840403823,6,3494,1255,-10
117840445598,117840445601,3,805,198,-10
117843315910,117843315911,1,1753,1860,-10
117843549174,117843549178,4,2657,1404,-10
117845852910,117845852911,1,1891,1858,-10
117846018515,117846018516,1,1188,1238,-10
117848070682,117848070682,0,1432,1069,-10
117848667146,117848667147,1,1890,1741,-10
117848965192,117848965198,6,3112,1380,-10
117850200041,117850200045,4,2282,1616,-10
117851144615,117851144618,3,1635,2029,-10
117852049146,117852049152,6,1634,1252,-10
117852639436,117852639437,1,1419,2215,-10
117855865679,117855865687,8,17399,37735,-10
117856586974,117856586975,1,1006,1740,-10
117857327601,117857327605,4,1356,1513,-10
117857802318,117857802296,-22,1476,1199,-10
117859093120,117859093118,-2,934,1126,-10
117863517282,117863517286,4,1599,1316,-10
117864823132,117864823133,1,1604,1394,-10
117868178561,117868178561,0,1492,1602,-10
117869834950,117869834954,4,2073,1116,-10
117871024262,117871024268,6,3864,2157,-10
117872945394,117872945395,1,1063,1222,-10
117877791353,117877791355,2,1142,1103,-10
117878326891,117878326893,2,1339,1601,-10
117878961437,117878961439,2,758,1162,-10
117883732598,117883732598,0,1015,1095,-10
117883843737,117883843737,0,1796,1409,-10
117885688425,117885688424,-1,1002,2043,-10
117888562906,117888562906,0,2011,1643,-10
117891412122,117891412125,3,1509,1185,-10
117896354528,117896354539,11,14111,28610,-10
117899367403,117899367405,2,1636,1555,-10
117902769449,117902769450,1,1368,1200,-10
117905033124,117905033126,2,2238,2360,-10
117906950798,117906950802,4,1685,1704,-10
117907177844,117907177846,2,1548,1464,-10
117908452894,117908452895,1,1725,1472,-10
117909032346,117909032346,0,1460,2128,-10
117909059860,117909059862,2,1753,1764,-10
117909775760,117909775761,1,1458,1726,-10
117911252531,117911252532,1,1465,1286,-10
117911704890,117911704907,17,1225,1164,-10
117919368508,117919368510,2,1767,2734,-10
117919921009,117919921008,-1,1204,1510,-10
117920852787,117920852791,4,874,674,-10
117923641885,117923641891,6,2462,1204,-10
117923994974,117923994952,-22,2911,1508,-10
117924166881,117924166884,3,1935,1896,-10
117924706046,117924706047,1,1918,1593,-10
117926962005,117926962007,2,1706,1582,-10
117928321706,117928321707,1,1351,1639,-10
117929687046,117929687049,3,1697,1304,-10
117931139844,117931139839,-5,813,4479,-10
117932517429,117932517430,1,1365,1236,-10
117936766280,117936766281,1,1818,2138,-10
117938732468,117938732471,3,1569,1129,-10
117939699402,117939699404,2,5661,20700,-10
117939946187,117939946186,-1,914,938,-10
117945399637,117945399638,1,1676,1444,-10
117947271807,117947271808,1,2002,1501,-10
117948210934,117948210934,0,1192,1587,-10
117952887266,117952887267,1,1804,1534,-10
117953157042,117953157044,2,1677,1637,-10
117954078245,117954078248,3,1658,1586,-10
117957106341,117957106343,2,1593,1210,-10
117958704131,117958704133,2,1686,1749,-10
117959090674,117959090676,2,1554,1653,-10
117959233285,117959233287,2,2182,1684,-10
117959320442,117959320443,1,1806,1935,-10
117959992021,117959992022,1,1985,1840,-10
117963224829,117963224830,1,1878,2075,-10
117965733474,117965733474,0,1837,1458,-10
117965873298,117965873296,-2,815,1148,-10
117972917016,117972917018,2,1762,1474,-10
117977013526,117977013526,0,1544,1455,-10
117977241482,117977241483,1,1894,2179,-10
117977682631,117977682634,3,1579,1903,-10
117977863674,117977863676,2,1432,930,-10
117979565062,117979565064,2,1563,1372,-10
117981887236,117981887239,3,2071,2123,-10
117982742666,117982742668,2,1901,1971,-10
117987244395,117987244396,1,1525,1591,-10
117987630605,117987630605,0,1532,1250,-10
117989458369,117989458371,2,1463,1352,-10
117992931798,117992931801,3,1061,883,-10
118005941880,118005941882,2,1463,1322,-10
118006208370,118006208373,3,1905,1709,-10
118006712541,118006712542,1,1668,2102,-10
118009774077,118009774077,0,1469,1903,-10
118010272489,118010272493,4,1536,1249,-10
118012453462,118012453466,4,2732,1580,-10
118013957138,118013957138,0,1285,1470,-10
118016557770,118016557773,3,1369,1001,-10
118016953845,118016953846,1,1640,1406,-10
118017750986,118017750987,1,1326,1618,-10
118021519153,118021519153,0,2020,2094,-10
118021822587,118021822591,4,951,673,-10
118029151033,118029151034,1,1447,1523,-10
118032215487,118032215486,-1,1530,1535,-10
118033249245,118033249251,6,2763,1590,-10
118038136128,118038136129,1,1520,1579,-10
118039770302,118039770305,3,2890,1705,-10
118040604089,118040604091,2,1956,1463,-10
118044826586,118044826587,1,1442,1707,-10
118048680321,118048680323,2,1881,1252,-10
118050361922,118050361925,3,1807,1764,-10
118053429257,118053429259,2,1720,1520,-10
118053763121,118053763125,4,1516,1886,-10
118056279526,118056279528,2,1866,1603,-10
118062494527,118062494526,-1,1123,1356,-10
118062522794,118062522794,0,1555,1419,-10
118062578422,118062578425,3,1921,1610,-10
118062778163,118062778179,16,1241,1230,-10
118065110732,118065110735,3,1451,1640,-10
118067057158,118067057158,0,1588,2154,-10
118067351918,118067351918,0,1358,1789,-10
118070100185,118070100186,1,1521,1635,-10
118072028490,118072028494,4,1861,1891,-10
118073341004,118073341005,1,1587,2075,-10
118074972687,118074972689,2,2206,2004,-10
118077529085,118077529088,3,2231,2124,-10
118079150141,118079150142,1,1067,1162,-10
118080389890,118080389894,4,2080,1079,-10
118082065242,118082065244,2,1170,1842,-10
118083168053,118083168053,0,1629,1867,-10
118084501277,118084501278,1,1782,1934,-10
118084712663,118084712671,8,3252,1200,-10
118086537394,118086537400,6,6567,2679,-10
118086673385,118086673388,3,5569,21641,-10
118086922802,118086922803,1,1663,1907,-10
118091719835,118091719839,4,1528,1515,-10
118093393394,118093393399,5,1496,1511,-10
118093927218,118093927220,2,1788,2008,-10
118095531615,118095531629,14,1422,1096,-10
118096887865,118096887865,0,1170,1125,-10
118097582623,118097582625,2,2014,2064,-10
118099301261,118099301262,1,1156,1681,-10
118104046099,118104046103,4,1665,1600,-10
118109219934,118109219935,1,1323,1304,-10
118109958720,118109958704,-16,1170,1853,-10
118113091126,118113091120,-6,756,3363,-10
118117684521,118117684523,2,2052,1686,-10
118118958299,118118958300,1,1302,1405,-10
118120679257,118120679257,0,936,977,-10
118121819249,118121819251,2,1493,1125,-10
118122476313,118122476315,2,1429,944,-10
118124151858,118124151858,0,1718,1203,-10
118125154645,118125154646,1,1319,1723,-10
118127126563,118127126565,2,1775,1540,-10
118128548657,118128548659,2,1198,1433,-10
118128954611,118128954614,3,1340,1192,-10
118132851028,118132851029,1,1402,1102,-10
118135013175,118135013174,-1,1401,1856,-10
118138094470,118138094468,-2,1542,1914,-10
118143110021,118143110023,2,1950,1613,-10
118143976293,118143976296,3,1267,2096,-10
118144511162,118144511158,-4,999,3257,-10
118145826955,118145826954,-1,1257,1201,-10
118146214162,118146214162,0,1552,2291,-10
118146485930,118146485934,4,1358,1137,-10
118148714461,118148714464,3,1734,1291,-10
118152623189,118152623190,1,1479,1316,-10
118153772190,118153772191,1,1075,784,-10
118153887046,118153887046,0,1289,1259,-10
118154865745,118154865742,-3,1440,2093,-10
118155786706,118155786709,3,1438,999,-10
118156435086,118156435087,1,1272,1046,-10
118161800976,118161800978,2,1863,1987,-10
118169069339,118169069341,2,1372,1666,-10
118169297450,118169297450,0,1815,2160,-10
118172515926,118172515925,-1,1713,1175,-10
118177521180,118177521181,1,1178,1463,-10
118182134397,118182134398,1,1521,1613,-10
118184491203,118184491200,-3,1109,1722,-10
118189001700,118189001702,2,1530,1725,-10
118189651198,118189651198,0,1277,1040,-10
118190848983,118190848986,3,1223,1380,-10
118190915591,118190915591,0,913,1678,-10
118191689318,118191689318,0,9914,12110,-10
118192950648,118192950649,1,1723,1320,-10
118193104147,118193104131,-16,758,815,-10
118194195838,118194195839,1,1388,1207,-10
118194323966,118194323970,4,1162,1370,-10
118195177826,118195177827,1,1510,1878,-10
118196675936,118196675938,2,1301,1302,-10
118197749382,118197749382,0,1249,1457,-10
118200184222,118200184227,5,850,400,-10
118200536851,118200536851,0,2100,1533,-10
118201631842,118201631861,19,68,2060,-10
118205283257,118205283257,0,1839,2423,-10
118205684362,118205684364,2,1873,1527,-10
118206071055,118206071057,2,1344,1309,-10
118206343579,118206343581,2,1640,1441,-10
118209014045,118209014045,0,1747,1974,-10
118212964230,118212964233,3,1565,1903,-10
118213582471,118213582452,-19,1981,1560,-10
118214984035,118214984037,2,1108,1548,-10
118222770549,118222770551,2,1404,1505,-10
118222922472,118222922474,2,1702,2430,-10
118223807534,118223807535,1,2040,1427,-10
118223932063,118223932066,3,1915,1694,-10
118225971735,118225971737,2,1314,2039,-10
118227450643,118227450646,3,1498,1571,-10
118228653219,118228653221,2,1153,1079,-10
118229753905,118229753906,1,1699,1351,-10
118231982233,118231982234,1,1150,1628,-10
118235678357,118235678351,-6,1109,3980,-10
118236956773,118236956773,0,1370,1581,-10
118238503385,118238503386,1,1204,1390,-10
118240383649,118240383650,1,1968,1717,-10
118244471691,118244471693,2,1942,1405,-10
118248825998,118248826000,2,1363,1738,-10
118253341150,118253341151,1,1442,1086,-10
118254564882,118254564886,4,2399,1213,-10
118258722262,118258722250,-12,1895,1902,-10
118259220488,118259220494,6,3395,1304,-10
118259996996,118259996998,2,1746,1200,-10
118264199658,118264199657,-1,1177,1651,-10
118265174128,118265174129,1,1652,1675,-10
118265679635,118265679638,3,1792,1141,-10
118266108514,118266108513,-1,1177,1460,-10
118271115036,118271115037,1,2904,4017,-10
118272300824,118272300825,1,1905,1091,-10
118275273179,118275273182,3,1664,1759,-10
118275955286,118275955285,-1,1533,2410,-10
118276142606,118276142607,1,1209,1305,-10
118277434451,118277434454,3,1584,1289,-10
118278101914,118278101912,-2,1283,2126,-10
118279454778,118279454781,3,1482,1247,-10
118279693683,118279693686,3,1993,1870,-10
118280226205,118280226206,1,2048,1981,-10
118280478467,118280478468,1,1482,1569,-10
118282179820,118282179818,-2,1430,2308,-10
118284443554,118284443550,-4,1440,1076,-10
118286836801,118286836802,1,1742,1137,-10
118290550190,118290550192,2,1760,2055,-10
118293989413,118293989418,5,3330,1703,-10
118300742149,118300742151,2,1193,1011,-10
118301094644,118301094645,1,1082,1483,-10
118301507089,118301507089,0,1372,1490,-10
118302019281,118302019282,1,2178,1732,-10
118302474951,118302474953,2,1807,1430,-10
118304356312,118304356314,2,1483,2265,-10
118309735009,118309735021,12,1483,1307,-10
118311429927,118311429930,3,1727,1324,-10
118313315398,118313315401,3,1248,1374,-10
118318325993,118318325990,-3,910,1592,-10
118318493331,118318493334,3,1642,1920,-10
118319499828,118319499834,6,2006,1061,-10
118321741917,118321741919,2,1489,1240,-10
118321891097,118321891099,2,1414,1389,-10
118322043343,118322043345,2,2345,1563,-10
118322248854,118322248856,2,2032,1867,-10
118324297362,118324297364,2,1437,1527,-10
118327859899,118327859900,1,1975,1888,-10
118328999502,118328999505,3,1059,1196,-10
118330950294,118330950293,-1,1488,1357,-10
118332314753,118332314753,0,1457,1784,-10
118332831274,118332831278,4,1390,903,-10
118333155671,118333155671,0,1313,896,-10
118335709180,118335709186,6,2805,1092,-10
118339930898,118339930902,4,1889,1355,-10
118346168874,118346168877,3,2494,1657,-10
118347738549,118347738550,1,1862,1738,-10
118348512169,118348512173,4,1298,1065,-10
118349709366,118349709368,2,1700,1994,-10
118350688168,118350688169,1,717,930,-10
118351259141,118351259140,-1,1371,1748,-10
118353647679,118353647680,1,2291,1453,-10
118353959160,118353959160,0,1642,1739,-10
118355021920,118355021922,2,1462,1495,-10
118356026776,118356026759,-17,180,444,-10
118356648247,118356648249,2,1252,1314,-10
118359554006,118359554007,1,2253,2261,-10
118360529573,118360529575,2,1718,1284,-10
118361195392,118361195385,-7,34322,13504,-10
118363268094,118363268095,1,1181,918,-10
118363580448,118363580441,-7,767,9188,-10
118364462331,118364462336,5,1166,1387,-10
118367691570,118367691571,1,1110,1123,-10
118369041467,118369041470,3,1796,1335,-10
118370269589,118370269589,0,1089,870,-10
118370955138,118370955138,0,1796,1171,-10
118373613410,118373613413,3,1392,1355,-10
118374782245,118374782246,1,1693,1436,-10
118375857971,118375857990,19,226,1328,-10
118378335147,118378335149,2,1481,1282,-10
118380627302,118380627306,4,2131,2085,-10
118380716516,118380716525,9,18752,25584,-10
118383974993,118383974997,4,1308,1215,-10
118387684518,118387684516,-2,1288,2381,-10
118388284811,118388284815,4,1492,1082,-10
118390205886,118390205887,1,1103,1920,-10
118393025108,118393025110,2,2109,1822,-10
118393847910,118393847916,6,2771,1204,-10
118396126560,118396126561,1,1784,1347,-10
118401132440,118401132441,1,1374,1547,-10
118401661480,118401661484,4,1727,1352,-10
118403057659,118403057662,3,1625,1587,-10
118403169966,118403169968,2,1144,972,-10
118403999378,118403999378,0,2007,1537,-10
118405602737,118405602741,4,2293,1920,-10
118406461422,118406461427,5,2137,1677,-10
118407493277,118407493278,1,1664,2091,-10
118410215211,118410215211,0,1425,1453,-10
118414692843,118414692838,-5,946,1242,-10
118415426303,118415426304,1,1094,1324,-10
118424060370,118424060373,3,874,1067,-10
118425634939,118425634941,2,1427,1523,-10
118426920423,118426920427,4,1858,912,-10
118429143575,118429143574,-1,1770,1481,-10
118429405250,118429405253,3,2577,1804,-10
118430323754,118430323755,1,1642,1977,-10
118433192730,118433192734,4,1560,1143,-10
118433587509,118433587511,2,1014,1268,-10
118434715917,118434715917,0,994,1457,-10
118435243262,118435243264,2,1406,1507,-10
118435498198,118435498201,3,1796,1861,-10
118440256630,118440256635,5,1155,1692,-10
118440851508,118440851508,0,1493,1994,-10
118442528741,118442528743,2,2228,2129,-10
118443589110,118443589111,1,1437,1796,-10
118444065295,118444065297,2,1987,1879,-10
118444465030,118444465029,-1,2340,4173,-10
118446770029,118446770032,3,1849,1406,-10
118450021066,118450021066,0,1649,1017,-10
118451652877,118451652879,2,28876,25754,-10
118453794878,118453794882,4,1716,1406,-10
118455225813,118455225819,6,2636,1015,-10
118456789351,118456789351,0,1080,1390,-10
118458457122,118458457124,2,1291,1298,-10
118461167217,118461167221,4,1296,1133,-10
118461889752,118461889754,2,1901,1466,-10
118465992925,118465992926,1,2459,1914,-10
118466192666,118466192666,0,1294,1284,-10
118469150968,118469150970,2,1260,1244,-10
118470574442,118470574443,1,1780,1434,-10
118470780757,118470780760,3,1824,1386,-10
118474075879,118474075882,3,844,1288,-10
118474473395,118474473399,4,1828,1341,-10
118476505329,118476505331,2,1472,1645,-10
118477001783,118477001771,-12,1340,449,-10
118480858495,118480858498,3,1546,1256,-10
118484283284,118484283286,2,1892,1238,-10
118484422545,118484422546,1,1281,1732,-10
118484753036,118484753038,2,1410,1067,-10
118488979579,118488979582,3,1307,1198,-10
118490854089,118490854091,2,2150,1976,-10
118492449861,118492449863,2,1716,1167,-10
118493063034,118493063049,15,1411,4602,-10
118495076726,118495076726,0,1925,1964,-10
118496115272,118496115275,3,1391,1117,-10
118497386860,118497386862,2,1432,1767,-10
118498355110,118498355114,4,1842,1633,-10
118499517546,118499517548,2,1348,1829,-10
118502193707,118502193710,3,1809,1298,-10
118508593822,118508593822,0,1387,1142,-10
118511802627,118511802633,6,6049,2563,-10
118512271441,118512271458,17,778,3163,-10
118514715714,118514715712,-2,937,1638,-10
118515887414,118515887415,1,2039,1415,-10
118518016142,118518016146,4,1806,1317,-10
118522165648,118522165650,2,1288,1247,-10
118523525907,118523525908,1,1354,1845,-10
118529920733,118529920731,-2,900,1330,-10
118533121197,118533121198,1,1494,2031,-10
118535593170,118535593171,1,1322,1509,-10
118549762338,118549762338,0,1438,1199,-10
118550137730,118550137731,1,1487,1889,-10
118550784781,118550784783,2,1007,1180,-10
118551567102,118551567104,2,1451,1793,-10
118552647635,118552647655,20,671,600,-10
118554108189,118554108189,0,2641,2218,-10
118554765917,118554765919,2,1340,1304,-10
118556305568,118556305565,-3,1094,1701,-10
118556669443,118556669445,2,1517,1188,-10
118559450661,118559450664,3,1546,1683,-10
118561252379,118561252394,15,1306,905,-10
118564043846,118564043846,0,1353,1749,-10
118565334155,118565334135,-20,1411,1447,-10
118567591281,118567591283,2,1548,1567,-10
118567965534,118567965534,0,1398,1263,-10
118571123547,118571123549,2,1553,1260,-10
118571840494,118571840495,1,1864,1649,-10
118575323789,118575323792,3,925,1376,-10
118576211182,118576211184,2,1471,1780,-10
118577989329,118577989330,1,1973,1547,-10
118579307532,118579307541,9,1596,1189,-10
118584471775,118584471774,-1,1317,1517,-10
118584949779,118584949781,2,1143,1687,-10
118585404205,118585404207,2,1755,1591,-10
118587196510,118587196513,3,1573,1380,-10
118587502384,118587502386,2,1429,969,-10
118588797755,118588797757,2,1236,1288,-10
118589268430,118589268433,3,930,1528,-10
118591910185,118591910188,3,2011,1545,-10
118592563187,118592563191,4,2378,1983,-10
118593451631,118593451631,0,1193,1269,-10
118594473443,118594473445,2,1628,1707,-10
118599069093,118599069097,4,1198,1657,-10
118599418519,118599418521,2,1382,1841,-10
118601879922,118601879906,-16,42,635,-10
118602399981,118602399982,1,1196,1368,-10
118604968742,118604968744,2,1789,1387,-10
118605964388,118605964390,2,1884,1560,-10
118609419190,118609419185,-5,1859,6782,-10
118609559379,118609559378,-1,1131,1973,-10
118609974530,118609974531,1,2296,2043,-10
118610849569,118610849571,2,1367,1481,-10
118611360937,118611360939,2,1797,2052,-10
118611641069,118611641074,5,1836,1394,-10
118612888572,118612888573,1,1692,1822,-10
118614107887,118614107886,-1,830,1948,-10
118616907526,118616907527,1,1536,1332,-10
118619827439,118619827440,1,963,1444,-10
118625024682,118625024682,0,1605,1289,-10
118626703710,118626703712,2,1964,2013,-10
118629232638,118629232643,5,1900,1304,-10
118631095558,118631095558,0,946,1450,-10
118631679338,118631679342,4,1182,1395,-10
118635830073,118635830075,2,2095,1463,-10
118636192737,118636192739,2,1791,1719,-10
118636528981,118636528983,2,1688,1484,-10
118642690018,118642690021,3,1980,1485,-10
118646288686,118646288690,4,1528,1037,-10
118650417355,118650417350,-5,1064,1329,-10
118652567345,118652567347,2,1472,1475,-10
118655119399,118655119400,1,1698,1891,-10
118656078215,118656078216,1,861,1692,-10
118656962741,118656962742,1,1246,1053,-10
118657382187,118657382186,-1,9147,15509,-10
118658053599,118658053601,2,1560,1993,-10
118659178119,118659178122,3,1459,1280,-10
118659478497,118659478482,-15,827,615,-10
118660750277,118660750278,1,1911,1688,-10
118661326594,118661326595,1,1654,1085,-10
118663113449,118663113451,2,1530,1653,-10
118663770890,118663770890,0,1512,1790,-10
118666719742,118666719743,1,1349,1308,-10
118667114827,118667114829,2,1495,1551,-10
118667854632,118667854634,2,1070,1057,-10
118671663607,118671663604,-3,2222,4894,-10
118672500336,118672500338,2,2489,1608,-10
118679438296,118679438299,3,1623,1404,-10
118681151557,118681151558,1,1702,1749,-10
118681288879,118681288882,3,2177,1252,-10
118683884014,118683884017,3,1941,2324,-10
118684232822,118684232826,4,1276,1407,-10
118688511210,118688511212,2,1906,1915,-10
118689579248,118689579250,2,2326,1711,-10
118690148931,118690148931,0,1281,1220,-10
118690736657,118690736658,1,1707,1572,-10
118692316527,118692316526,-1,3817,9214,-10
